step_arrived;step_collisions;step_duration;step_ended;step_halting;step_inserted;step_loaded;step_meanSpeed;step_meanSpeedRelative;step_meanTravelTime;step_meanWaitingTime;step_running;step_teleports;step_time;step_waiting
0;0;625721713;0;1;84;245;16.47;1.17;-1.00;0.00;84;0;0.00;161
0;0;625721751;0;1;99;245;15.35;1.07;-1.00;0.15;99;0;1.00;146
0;0;625721752;0;1;116;245;14.58;1.00;-1.00;0.42;116;0;2.00;129
0;0;625721754;0;2;131;245;13.39;0.91;-1.00;0.72;131;0;3.00;114
0;0;625721756;0;2;143;245;12.36;0.83;-1.00;0.99;143;0;4.00;102
0;0;625721758;0;4;150;245;11.54;0.78;-1.00;1.18;150;0;5.00;95
0;0;625721760;0;8;163;245;10.83;0.73;-1.00;1.56;163;0;6.00;82
0;0;625721762;0;10;168;245;10.44;0.70;-1.00;1.73;168;0;7.00;77
0;0;625721764;0;18;177;246;9.98;0.66;-1.00;2.05;177;0;8.00;69
0;0;625721767;0;17;183;247;9.81;0.65;-1.00;2.27;183;0;9.00;64
0;0;625721769;0;17;188;247;9.67;0.64;-1.00;2.44;188;0;10.00;59
0;0;625721771;0;23;194;248;9.44;0.62;-1.00;2.65;194;0;11.00;54
1;0;625721774;1;26;198;248;9.19;0.61;12.00;2.84;197;0;12.00;50
1;0;625721776;1;30;200;248;9.12;0.60;12.00;2.94;199;0;13.00;48
1;0;625721779;1;33;205;248;9.18;0.60;12.00;3.21;204;0;14.00;43
1;0;625721782;1;36;208;252;9.32;0.61;12.00;3.25;207;0;15.00;44
1;0;625721786;1;39;212;252;9.40;0.61;12.00;3.49;211;0;16.00;40
1;0;625721790;1;44;215;252;9.35;0.60;12.00;3.68;214;0;17.00;37
1;0;625721793;1;48;220;255;9.47;0.61;12.00;3.92;219;0;18.00;35
2;0;625721796;2;51;221;255;9.51;0.61;15.50;3.99;219;0;19.00;34
3;0;625721800;3;54;225;255;9.63;0.61;17.00;4.21;222;0;20.00;30
4;0;625721803;4;60;229;259;9.77;0.62;18.00;4.16;225;0;21.00;30
4;0;625721807;4;66;238;260;9.68;0.61;18.00;4.68;234;0;22.00;22
5;0;625721812;5;69;240;260;9.51;0.59;19.00;4.84;235;0;23.00;20
5;0;625721816;5;69;246;264;9.31;0.58;19.00;5.07;241;0;24.00;18
5;0;625721820;5;74;248;264;9.11;0.57;19.00;5.16;243;0;25.00;16
5;0;625721824;5;78;252;264;9.03;0.56;19.00;5.33;247;0;26.00;12
5;0;625721827;5;81;255;265;8.97;0.56;19.00;5.47;250;0;27.00;10
6;0;625721832;6;85;256;265;9.01;0.56;19.83;5.56;250;0;28.00;9
6;0;625721836;6;86;261;271;8.88;0.55;19.83;5.48;255;0;29.00;10
6;0;625721843;6;88;262;271;8.94;0.55;19.83;5.57;256;0;30.00;9
7;0;625721846;7;92;263;272;8.84;0.54;21.00;5.55;256;0;31.00;9
7;0;625721857;7;97;266;272;8.76;0.54;21.00;5.74;259;0;32.00;6
7;0;625721861;7;100;266;272;8.79;0.54;21.00;5.74;259;0;33.00;6
7;0;625721865;7;104;267;272;8.87;0.55;21.00;5.85;260;0;34.00;5
8;0;625721868;8;107;267;272;8.92;0.55;22.75;5.85;259;0;35.00;5
10;0;625721872;10;111;280;284;9.08;0.56;24.40;5.62;270;0;36.00;4
10;0;625721878;10;117;280;284;9.03;0.56;24.40;5.62;270;0;37.00;4
10;0;625721882;10;117;280;284;8.91;0.55;24.40;5.62;270;0;38.00;4
10;0;625721886;10;119;280;284;8.80;0.55;24.40;5.62;270;0;39.00;4
11;0;625721890;11;123;280;284;8.59;0.53;25.82;5.62;269;0;40.00;4
11;0;625721894;11;121;280;284;8.41;0.52;25.82;5.62;269;0;41.00;4
12;0;625721898;12;123;284;288;8.40;0.52;26.92;5.56;272;0;42.00;4
14;0;625721902;14;126;284;288;8.28;0.51;28.71;5.56;270;0;43.00;4
16;0;625721907;16;130;287;292;8.16;0.50;29.31;5.51;271;0;44.00;5
16;0;625721912;16;135;289;294;8.03;0.50;29.31;5.47;273;0;45.00;5
17;0;625721916;17;137;290;294;7.90;0.49;29.82;5.46;273;0;46.00;4
17;0;625721920;17;140;290;294;7.74;0.48;29.82;5.46;273;0;47.00;4
17;0;625721924;17;143;302;307;7.99;0.49;29.82;5.25;285;0;48.00;5
19;0;625721930;19;144;302;307;7.78;0.48;31.53;5.25;283;0;49.00;5
19;0;625721935;19;144;302;307;7.74;0.48;31.53;5.25;283;0;50.00;5
20;0;625721940;20;147;303;308;7.66;0.47;32.45;5.23;283;0;51.00;5
20;0;625721943;20;152;304;309;7.63;0.47;32.45;5.22;284;0;52.00;5
20;0;625721947;20;151;304;309;7.62;0.47;32.45;5.22;284;0;53.00;5
21;0;625721950;21;151;306;312;7.61;0.47;31.76;5.18;285;0;54.00;6
22;0;625721954;22;153;306;312;7.48;0.46;32.73;5.18;284;0;55.00;6
23;0;625721959;23;144;307;312;7.43;0.46;33.74;5.17;284;0;56.00;5
24;0;625721963;24;140;307;312;7.34;0.45;33.75;5.17;283;0;57.00;5
24;0;625721968;24;142;311;318;7.37;0.46;33.75;5.12;287;0;58.00;7
25;0;625721972;25;140;311;318;7.37;0.45;34.76;5.12;286;0;59.00;7
26;0;625721977;26;143;312;318;7.42;0.46;35.58;5.11;286;0;60.00;6
27;0;625721981;27;144;313;318;7.46;0.46;36.52;5.11;286;0;61.00;5
27;0;625721984;27;146;317;322;7.52;0.46;36.52;5.06;290;0;62.00;5
27;0;625721988;27;149;318;323;7.67;0.47;36.52;5.04;291;0;63.00;5
29;0;625721991;29;151;318;323;7.68;0.47;37.14;5.04;289;0;64.00;5
29;0;625721995;29;152;319;324;7.73;0.47;37.14;5.03;290;0;65.00;5
29;0;625721999;29;156;319;324;7.78;0.48;37.14;5.03;290;0;66.00;5
29;0;625722002;29;145;319;324;7.89;0.48;37.14;5.03;290;0;67.00;5
30;0;625722006;30;138;319;324;7.97;0.49;37.97;5.03;289;0;68.00;5
31;0;625722009;31;135;319;324;8.05;0.49;37.61;5.03;288;0;69.00;5
33;0;625722012;33;131;319;324;8.13;0.50;39.58;5.03;286;0;70.00;5
36;0;625722016;36;130;319;324;8.22;0.50;41.39;5.03;283;0;71.00;5
36;0;625722019;36;135;353;394;8.33;0.51;41.39;4.54;317;0;72.00;41
36;0;625722030;36;126;354;395;8.47;0.52;41.39;4.53;318;0;73.00;41
36;0;625722043;36;120;362;395;8.95;0.55;41.39;4.48;326;0;74.00;33
37;0;625722049;37;116;363;395;9.15;0.56;42.30;4.47;326;0;75.00;32
37;0;625722054;37;115;367;395;9.44;0.57;42.30;4.47;330;0;76.00;28
37;0;625722059;37;116;369;395;9.64;0.59;42.30;4.47;332;0;77.00;26
37;0;625722064;37;112;373;395;9.85;0.60;42.30;4.49;336;0;78.00;22
37;0;625722069;37;110;375;395;9.88;0.60;42.30;4.50;338;0;79.00;20
38;0;625722082;38;111;377;396;9.88;0.60;42.84;4.52;339;0;80.00;19
39;0;625722094;39;116;380;397;9.93;0.60;43.82;4.53;341;0;81.00;17
41;0;625722100;41;119;382;397;9.86;0.60;45.54;4.54;341;0;82.00;15
41;0;625722114;41;122;386;401;9.64;0.58;45.54;4.51;345;0;83.00;15
42;0;625722120;42;126;386;401;9.49;0.57;46.45;4.51;344;0;84.00;15
42;0;625722133;42;128;386;401;9.33;0.57;46.45;4.51;344;0;85.00;15
43;0;625722145;43;130;386;401;9.07;0.55;47.37;4.51;343;0;86.00;15
44;0;625722150;44;132;390;407;8.91;0.54;48.27;4.47;346;0;87.00;17
44;0;625722155;44;136;390;407;8.83;0.54;48.27;4.47;346;0;88.00;17
46;0;625722160;46;139;391;407;8.63;0.52;50.04;4.47;345;0;89.00;16
46;1;625722167;46;139;394;413;8.61;0.52;50.04;4.43;348;1;90.00;19
46;1;625722192;46;141;395;413;8.67;0.53;50.04;4.42;349;1;91.00;18
48;1;625722197;48;141;395;413;8.64;0.52;51.79;4.42;347;1;92.00;18
50;1;625722201;50;138;397;414;8.58;0.52;53.32;4.41;347;1;93.00;17
51;1;625722206;51;137;398;415;8.61;0.52;54.12;4.40;347;1;94.00;17
54;1;625722210;54;135;399;415;8.63;0.52;56.20;4.40;345;1;95.00;16
56;1;625722215;56;136;409;428;8.56;0.52;57.63;4.30;353;1;96.00;19
57;1;625722220;57;136;410;428;8.66;0.53;58.32;4.29;353;1;97.00;18
59;1;625722225;59;135;410;428;8.59;0.52;59.64;4.29;351;1;98.00;18
59;1;625722230;59;132;411;429;8.73;0.53;59.64;4.28;352;1;99.00;18
61;1;625722236;61;130;411;429;8.74;0.53;59.77;4.28;350;1;100.00;18
61;1;625722246;61;129;413;433;8.78;0.53;59.77;4.26;352;1;101.00;20
61;1;625722252;61;124;414;433;8.85;0.54;59.77;4.26;353;1;102.00;19
63;1;625722256;63;122;418;437;8.75;0.53;61.13;4.22;355;1;103.00;19
64;1;625722262;64;115;418;437;8.81;0.54;61.47;4.22;354;1;104.00;19
65;1;625722270;65;114;418;437;9.00;0.55;62.12;4.22;353;1;105.00;19
65;1;625722277;65;106;418;437;9.18;0.56;62.12;4.22;353;1;106.00;19
66;1;625722282;66;101;418;437;9.38;0.57;62.76;4.22;352;1;107.00;19
67;1;625722287;67;94;429;449;9.66;0.59;63.31;4.12;362;1;108.00;20
68;1;625722293;68;91;430;449;9.85;0.60;63.99;4.11;362;1;109.00;19
69;1;625722299;69;82;430;449;9.99;0.61;64.62;4.11;361;1;110.00;19
69;1;625722304;69;77;430;449;10.19;0.62;64.62;4.11;361;1;111.00;19
69;1;625722311;69;77;430;449;10.47;0.64;64.62;4.11;361;1;112.00;19
69;1;625722319;69;75;430;449;10.66;0.65;64.62;4.11;361;1;113.00;19
69;1;625722326;69;71;431;450;10.84;0.66;64.62;4.10;362;1;114.00;19
69;1;625722333;69;72;431;450;10.98;0.67;64.62;4.10;362;1;115.00;19
69;1;625722340;69;71;435;456;11.15;0.68;64.62;4.07;366;1;116.00;21
69;1;625722348;69;70;438;457;11.32;0.69;64.62;4.32;369;1;117.00;19
71;1;625722355;71;73;438;457;11.38;0.70;64.94;4.32;367;1;118.00;19
73;1;625722361;73;75;440;457;11.45;0.70;66.34;4.67;367;1;119.00;17
75;1;625722369;75;74;444;462;11.57;0.70;67.75;4.63;369;1;120.00;18
76;1;625722375;76;73;444;462;11.66;0.71;68.42;4.63;368;1;121.00;18
77;1;625722383;77;76;445;462;11.68;0.71;69.10;4.73;368;1;122.00;17
77;1;625722388;77;77;448;463;11.79;0.72;69.10;5.09;371;1;123.00;15
79;1;625722395;79;80;452;467;11.75;0.72;70.16;5.06;373;1;124.00;15
80;1;625722401;80;80;455;467;11.82;0.72;70.81;5.53;375;1;125.00;12
81;1;625722407;81;83;457;470;11.97;0.73;71.35;5.51;376;1;126.00;13
82;1;625722413;82;86;460;470;12.02;0.73;72.01;5.88;378;1;127.00;10
82;1;625722420;82;86;462;470;12.08;0.74;72.01;5.98;380;1;128.00;8
82;1;625722427;82;87;464;470;12.05;0.74;72.01;6.17;382;1;129.00;6
84;1;625722434;84;88;469;474;11.97;0.73;73.26;6.33;385;1;130.00;5
86;1;625722443;86;88;470;474;12.02;0.74;74.37;6.32;384;1;131.00;4
88;1;625722451;88;88;470;474;12.09;0.74;75.65;6.32;382;1;132.00;4
89;1;625722458;89;89;472;474;12.01;0.73;76.07;6.38;383;1;133.00;2
90;1;625722469;90;91;473;475;12.01;0.74;75.51;6.37;383;1;134.00;2
91;1;625722482;91;91;475;477;12.00;0.73;76.16;6.34;384;1;135.00;2
92;1;625722495;92;95;476;477;11.99;0.74;76.67;6.41;384;1;136.00;1
93;1;625722505;93;96;478;478;12.02;0.74;77.32;6.42;385;1;137.00;0
97;1;625722519;97;99;478;478;12.00;0.74;79.05;6.42;381;1;138.00;0
99;1;625722534;99;100;478;478;12.04;0.74;79.94;6.42;379;1;139.00;0
102;1;625722546;102;102;478;478;11.81;0.72;81.00;6.42;376;1;140.00;0
103;1;625722565;103;104;478;478;11.58;0.71;81.23;6.42;375;1;141.00;0
105;1;625722574;105;107;478;478;11.41;0.70;82.02;6.42;373;1;142.00;0
106;1;625722585;106;108;478;478;11.27;0.70;82.18;6.42;372;1;143.00;0
107;1;625722595;107;129;551;605;11.03;0.70;82.08;5.58;444;1;144.00;54
109;1;625722614;109;124;556;606;11.10;0.70;81.83;5.54;447;1;145.00;50
112;1;625722621;112;122;565;606;11.07;0.70;83.46;5.48;453;1;146.00;41
115;1;625722629;115;122;570;606;11.02;0.69;84.93;5.46;455;1;147.00;36
115;1;625722636;115;128;576;606;10.98;0.69;84.93;5.44;461;1;148.00;30
117;1;625722644;117;126;583;606;10.79;0.68;85.41;5.44;466;1;149.00;23
118;1;625722654;118;126;588;611;10.60;0.66;85.94;5.44;470;1;150.00;23
118;1;625722665;118;125;590;611;10.63;0.66;85.94;5.45;472;1;151.00;21
118;1;625722673;118;127;594;612;10.60;0.66;85.94;5.45;476;1;152.00;18
123;1;625722681;123;126;595;613;10.58;0.66;87.20;5.46;472;1;153.00;18
124;2;625722689;124;127;596;613;10.61;0.66;87.73;5.47;472;2;154.00;17
127;2;625722717;127;131;599;614;10.55;0.66;88.16;5.47;472;2;155.00;15
127;2;625722725;127;135;601;614;10.59;0.66;88.16;5.49;474;2;156.00;13
128;2;625722733;128;140;602;614;10.49;0.65;88.66;5.50;474;2;157.00;12
130;2;625722739;130;144;604;614;10.44;0.65;88.81;5.53;474;2;158.00;10
132;2;625722747;132;148;607;618;10.34;0.64;89.31;5.53;475;2;159.00;11
133;2;625722754;133;155;608;618;10.16;0.63;89.71;5.55;475;2;160.00;10
135;2;625722761;135;154;610;618;9.98;0.62;90.21;5.58;475;2;161.00;8
136;2;625722768;136;158;613;621;9.86;0.61;90.74;5.58;477;2;162.00;8
137;2;625722775;137;157;613;621;9.78;0.61;91.27;5.58;476;2;163.00;8
141;2;625722782;141;155;614;621;9.69;0.60;92.59;5.58;473;2;164.00;7
142;2;625722790;142;158;617;625;9.62;0.59;93.00;5.56;475;2;165.00;8
145;2;625722797;145;157;618;626;9.52;0.59;94.28;5.55;473;2;166.00;8
145;2;625722810;145;152;618;626;9.48;0.58;94.28;5.55;473;2;167.00;8
147;3;625722816;147;155;623;630;9.33;0.58;95.05;5.57;476;3;168.00;7
150;3;625722835;150;159;625;630;9.19;0.57;95.17;5.56;475;3;169.00;5
150;3;625722842;150;150;625;630;9.19;0.57;95.17;5.56;475;3;170.00;5
153;3;625722854;153;144;629;631;9.27;0.57;95.86;5.61;476;3;171.00;2
154;3;625722860;154;135;630;631;9.27;0.57;96.21;5.62;476;3;172.00;1
154;3;625722867;154;137;635;637;9.34;0.58;96.21;5.58;481;3;173.00;2
156;3;625722881;156;133;635;637;9.37;0.58;96.43;5.58;479;3;174.00;2
156;3;625722889;156;129;636;638;9.37;0.58;96.43;5.58;480;3;175.00;2
158;3;625722896;158;130;638;638;9.27;0.57;96.97;5.61;480;3;176.00;0
159;3;625722903;159;128;638;638;9.33;0.57;97.33;5.61;479;3;177.00;0
159;3;625722911;159;128;638;638;9.48;0.58;97.33;5.61;479;3;178.00;0
161;3;625722917;161;127;638;638;9.54;0.59;97.68;5.61;477;3;179.00;0
163;3;625722927;163;133;667;672;9.63;0.60;97.56;5.36;504;3;180.00;5
163;3;625722938;163;121;667;672;9.75;0.60;97.56;5.36;504;3;181.00;5
164;3;625722946;164;121;669;672;9.86;0.61;97.61;5.35;505;3;182.00;3
166;3;625722954;166;124;669;672;9.97;0.62;98.61;5.35;503;3;183.00;3
167;3;625722969;167;132;670;672;10.10;0.62;98.67;5.35;503;3;184.00;2
170;3;625722978;170;136;670;672;10.04;0.62;99.48;5.35;500;3;185.00;2
170;3;625722990;170;141;675;676;10.12;0.62;99.48;5.32;505;3;186.00;1
171;3;625722998;171;144;675;676;10.12;0.62;99.23;5.32;504;3;187.00;1
172;3;625723005;172;150;678;680;10.05;0.62;99.19;5.32;506;3;188.00;2
174;3;625723013;174;151;679;681;9.91;0.61;99.53;5.31;505;3;189.00;2
175;3;625723025;175;162;680;681;9.82;0.61;100.00;5.30;505;3;190.00;1
178;3;625723037;178;169;680;681;9.71;0.60;100.58;5.30;502;3;191.00;1
180;3;625723046;180;174;693;694;9.73;0.60;100.61;5.21;513;3;192.00;1
181;3;625723057;181;173;694;694;9.73;0.60;100.97;5.21;513;3;193.00;0
187;3;625723066;187;174;694;694;9.65;0.60;100.35;5.21;507;3;194.00;0
191;3;625723074;191;178;695;695;9.51;0.58;100.94;5.20;504;3;195.00;0
194;3;625723082;194;183;696;696;9.41;0.58;101.04;5.19;502;3;196.00;0
198;3;625723090;198;184;696;696;9.27;0.57;101.10;5.19;498;3;197.00;0
200;3;625723099;200;186;698;699;9.08;0.56;100.51;5.18;498;3;198.00;1
203;3;625723108;203;191;699;699;8.95;0.55;101.58;5.17;496;3;199.00;0
204;3;625723116;204;195;699;699;8.76;0.54;101.36;5.17;495;3;200.00;0
206;3;625723127;206;197;699;699;8.59;0.53;101.15;5.17;493;3;201.00;0
207;3;625723134;207;205;703;705;8.50;0.52;101.64;5.15;496;3;202.00;2
207;3;625723142;207;208;703;705;8.41;0.52;101.64;5.15;496;3;203.00;2
211;3;625723149;211;215;705;705;8.24;0.51;101.91;5.14;494;3;204.00;0
212;3;625723156;212;218;705;705;8.16;0.50;101.72;5.14;493;3;205.00;0
216;3;625723164;216;223;709;709;8.07;0.49;101.56;5.12;493;3;206.00;0
219;3;625723172;219;228;710;710;7.96;0.49;102.92;5.11;491;3;207.00;0
220;3;625723182;220;234;710;710;7.80;0.48;103.37;5.11;490;3;208.00;0
221;3;625723200;221;236;711;711;7.68;0.47;103.79;5.11;490;3;209.00;0
222;3;625723215;222;238;711;711;7.48;0.46;103.40;5.11;489;3;210.00;0
225;3;625723222;225;241;711;711;7.28;0.45;103.10;5.11;486;3;211.00;0
225;3;625723229;225;248;711;711;7.33;0.45;103.10;5.11;486;3;212.00;0
225;3;625723236;225;252;711;711;7.32;0.45;103.10;5.11;486;3;213.00;0
226;3;625723244;226;254;711;711;7.28;0.45;103.16;5.11;485;3;214.00;0
227;3;625723251;227;259;711;711;7.23;0.44;102.84;5.11;484;3;215.00;0
228;3;625723258;228;274;754;781;7.41;0.46;103.15;4.82;526;3;216.00;27
228;3;625723273;228;259;756;782;7.48;0.46;103.15;4.81;528;3;217.00;26
228;3;625723280;228;250;763;782;7.61;0.47;103.15;4.78;535;3;218.00;19
228;3;625723287;228;230;766;782;7.78;0.48;103.15;4.77;538;3;219.00;16
229;3;625723295;229;216;768;782;7.97;0.49;103.66;4.77;539;3;220.00;14
229;3;625723303;229;208;771;782;8.27;0.51;103.66;4.77;542;3;221.00;11
231;3;625723311;231;201;774;782;8.45;0.52;104.42;4.78;543;3;222.00;8
233;3;625723320;233;193;777;782;8.56;0.52;105.39;4.79;544;3;223.00;5
234;3;625723329;234;188;779;783;8.66;0.53;105.88;4.79;545;3;224.00;4
236;3;625723337;236;183;782;785;8.80;0.54;106.26;4.79;546;3;225.00;3
237;3;625723353;237;171;785;785;8.99;0.55;106.42;4.80;548;3;226.00;0
238;3;625723362;238;159;789;789;9.01;0.55;106.92;4.78;551;3;227.00;0
240;3;625723371;240;151;789;789;9.13;0.56;107.71;4.78;549;3;228.00;0
240;4;625723379;240;141;789;789;9.26;0.57;107.71;4.78;549;4;229.00;0
241;4;625723401;241;129;789;789;9.40;0.58;108.15;4.78;548;4;230.00;0
243;4;625723411;243;125;794;795;9.53;0.58;108.73;4.75;551;4;231.00;1
245;4;625723432;245;118;794;795;9.65;0.59;109.20;4.75;549;4;232.00;1
246;4;625723441;246;116;795;795;9.77;0.60;108.87;4.75;549;4;233.00;0
246;4;625723456;246;112;797;798;9.97;0.61;108.87;4.74;551;4;234.00;1
249;5;625723465;249;110;798;798;10.13;0.62;109.08;4.74;549;5;235.00;0
249;5;625723492;249;109;798;798;10.25;0.63;109.08;4.74;549;5;236.00;0
251;5;625723501;251;106;799;799;10.26;0.63;109.48;4.73;548;5;237.00;0
253;5;625723510;253;104;800;800;10.34;0.63;109.62;4.73;547;5;238.00;0
255;5;625723519;255;100;800;800;10.27;0.62;110.24;4.73;545;5;239.00;0
258;5;625723536;258;105;824;826;10.11;0.62;110.51;4.59;566;5;240.00;2
259;5;625723547;259;102;825;826;10.14;0.62;110.93;4.58;566;5;241.00;1
261;5;625723555;261;99;826;826;10.23;0.63;111.71;4.58;565;5;242.00;0
267;5;625723563;267;105;827;827;10.30;0.63;113.19;4.58;560;5;243.00;0
268;5;625723572;268;109;827;827;10.36;0.63;113.67;4.58;559;5;244.00;0
271;5;625723580;271;112;830;831;10.31;0.63;114.32;4.56;559;5;245.00;1
272;5;625723589;272;113;830;831;10.34;0.63;114.28;4.56;558;5;246.00;1
272;5;625723598;272;117;835;835;10.30;0.63;114.28;4.54;563;5;247.00;0
275;5;625723606;275;121;835;835;10.32;0.63;115.45;4.54;560;5;248.00;0
279;5;625723615;279;127;835;835;10.33;0.63;116.61;4.54;556;5;249.00;0
281;5;625723628;281;131;835;835;10.29;0.63;117.16;4.54;554;5;250.00;0
282;5;625723636;282;135;835;835;10.17;0.62;117.13;4.54;553;5;251.00;0
283;5;625723644;283;140;846;847;10.09;0.62;117.54;4.48;563;5;252.00;1
285;5;625723652;285;141;846;847;10.02;0.61;117.48;4.48;561;5;253.00;1
290;5;625723660;290;144;847;847;9.97;0.61;118.30;4.48;557;5;254.00;0
292;5;625723667;292;151;847;847;9.97;0.61;118.57;4.48;555;5;255.00;0
292;5;625723675;292;155;847;847;9.97;0.61;118.57;4.48;555;5;256.00;0
293;5;625723682;293;158;847;847;9.92;0.60;118.55;4.48;554;5;257.00;0
293;5;625723690;293;160;848;848;9.91;0.60;118.55;4.48;555;5;258.00;0
295;5;625723697;295;162;848;848;9.88;0.60;118.83;4.48;553;5;259.00;0
296;6;625723709;296;161;853;854;9.91;0.60;118.82;4.46;557;6;260.00;1
297;6;625723724;297;157;854;855;9.98;0.61;118.81;4.45;557;6;261.00;1
300;6;625723735;300;149;855;855;9.98;0.61;119.29;4.45;555;6;262.00;0
301;7;625723743;301;145;855;855;10.01;0.61;119.51;4.45;554;7;263.00;0
302;7;625723757;302;144;859;859;10.02;0.61;119.40;4.43;557;7;264.00;0
303;7;625723765;303;139;859;859;10.09;0.61;119.54;4.43;556;7;265.00;0
305;7;625723777;305;138;859;859;10.16;0.62;119.91;4.43;554;7;266.00;0
309;7;625723784;309;136;860;860;10.25;0.62;120.64;4.43;551;7;267.00;0
316;7;625723795;316;137;864;864;10.25;0.62;120.75;4.41;548;7;268.00;0
317;7;625723804;317;134;864;864;10.38;0.63;121.15;4.41;547;7;269.00;0
322;7;625723813;322;127;867;870;10.46;0.63;121.88;4.39;545;7;270.00;3
324;7;625723821;324;123;867;870;10.50;0.63;122.58;4.39;543;7;271.00;3
327;7;625723829;327;116;868;870;10.60;0.64;122.93;4.39;541;7;272.00;2
327;7;625723837;327;111;868;870;10.74;0.65;122.93;4.39;541;7;273.00;2
329;7;625723845;329;110;871;874;10.92;0.66;122.98;4.38;542;7;274.00;3
331;7;625723854;331;109;871;874;11.03;0.67;123.45;4.38;540;7;275.00;3
335;7;625723866;335;104;872;874;11.17;0.68;124.21;4.39;537;7;276.00;2
336;7;625723874;336;96;872;874;11.34;0.69;124.24;4.39;536;7;277.00;2
339;7;625723881;339;93;874;875;11.46;0.70;124.43;4.38;535;7;278.00;1
339;7;625723891;339;88;875;876;11.59;0.70;124.43;4.38;536;7;279.00;1
341;7;625723900;341;86;876;876;11.55;0.70;124.18;4.38;535;7;280.00;0
341;7;625723908;341;84;877;877;11.56;0.70;124.18;4.38;536;7;281.00;0
343;7;625723917;343;82;877;877;11.52;0.70;124.06;4.38;534;7;282.00;0
344;7;625723927;344;82;877;877;11.55;0.70;124.10;4.38;533;7;283.00;0
347;7;625723937;347;81;877;877;11.56;0.70;124.20;4.38;530;7;284.00;0
349;7;625723946;349;84;877;877;11.68;0.71;124.56;4.38;528;7;285.00;0
349;7;625723955;349;84;877;877;11.74;0.71;124.56;4.38;528;7;286.00;0
352;7;625723964;352;84;877;877;11.78;0.71;125.31;4.38;525;7;287.00;0
353;7;625723972;353;99;947;1004;11.40;0.70;125.36;4.06;594;7;288.00;57
354;7;625723993;354;91;949;1005;11.49;0.71;125.52;4.05;595;7;289.00;56
355;7;625724002;355;87;956;1005;11.58;0.71;125.98;4.03;601;7;290.00;49
355;7;625724011;355;90;958;1005;11.62;0.71;125.98;4.03;603;7;291.00;47
355;7;625724025;355;89;963;1005;11.67;0.72;125.98;4.03;608;7;292.00;42
355;7;625724035;355;92;969;1005;11.67;0.72;125.98;4.04;614;7;293.00;36
358;8;625724051;358;89;974;1005;11.69;0.72;126.03;4.05;616;8;294.00;31
360;8;625724070;360;88;976;1005;11.76;0.72;126.06;4.05;616;8;295.00;29
362;8;625724080;362;87;979;1006;11.88;0.73;126.60;4.07;617;8;296.00;27
366;8;625724090;366;90;983;1007;11.96;0.73;126.35;4.09;617;8;297.00;24
368;8;625724100;368;92;987;1007;12.00;0.74;126.38;4.11;619;8;298.00;20
368;8;625724110;368;94;990;1008;11.97;0.74;126.38;4.13;622;8;299.00;18
371;8;625724123;371;99;993;1014;11.92;0.73;126.79;4.15;622;8;300.00;21
371;8;625724139;371;102;996;1014;11.87;0.73;126.79;4.17;625;8;301.00;18
373;8;625724151;373;109;998;1014;11.78;0.73;127.02;4.18;625;8;302.00;16
375;8;625724161;375;111;1003;1018;11.76;0.73;127.57;4.21;628;8;303.00;15
377;8;625724172;377;120;1004;1018;11.68;0.72;128.41;4.22;627;8;304.00;14
380;8;625724182;380;127;1007;1018;11.56;0.71;129.44;4.24;627;8;305.00;11
383;8;625724199;383;134;1010;1021;11.52;0.71;130.29;4.24;627;8;306.00;11
388;8;625724210;388;137;1011;1021;11.52;0.71;131.13;4.25;623;8;307.00;10
389;8;625724225;389;143;1012;1021;11.47;0.71;131.58;4.25;623;8;308.00;9
391;8;625724236;391;148;1015;1025;11.39;0.70;131.84;4.24;624;8;309.00;10
394;8;625724247;394;148;1016;1026;11.30;0.69;132.39;4.24;622;8;310.00;10
398;8;625724257;398;152;1016;1026;11.17;0.68;132.35;4.24;618;8;311.00;10
400;8;625724267;400;155;1019;1030;11.08;0.68;132.94;4.23;619;8;312.00;11
403;8;625724277;403;162;1022;1030;10.93;0.67;133.08;4.24;619;8;313.00;8
404;8;625724287;404;162;1022;1030;10.80;0.66;133.52;4.24;618;8;314.00;8
404;8;625724296;404;168;1024;1032;10.63;0.65;133.52;4.23;620;8;315.00;8
406;8;625724305;406;172;1024;1032;10.42;0.64;133.80;4.23;618;8;316.00;8
409;8;625724315;409;176;1028;1038;10.28;0.63;134.49;4.22;619;8;317.00;10
411;8;625724324;411;183;1029;1038;10.12;0.62;134.30;4.23;618;8;318.00;9
411;8;625724333;411;178;1030;1039;10.04;0.62;134.30;4.23;619;8;319.00;9
413;8;625724342;413;178;1031;1039;10.03;0.62;134.85;4.26;618;8;320.00;8
415;8;625724352;415;182;1034;1039;9.93;0.61;135.11;4.29;619;8;321.00;5
418;8;625724360;418;186;1035;1039;9.95;0.61;135.50;4.30;617;8;322.00;4
421;8;625724370;421;186;1035;1039;9.98;0.61;135.55;4.30;614;8;323.00;4
422;8;625724379;422;192;1047;1051;9.99;0.61;135.68;4.30;625;8;324.00;4
425;8;625724389;425;193;1048;1051;9.99;0.61;135.66;4.30;623;8;325.00;3
427;8;625724398;427;197;1049;1051;9.98;0.61;136.00;4.30;622;8;326.00;2
429;8;625724407;429;200;1051;1051;9.94;0.61;136.26;4.33;622;8;327.00;0
430;8;625724416;430;201;1051;1051;9.91;0.61;136.41;4.33;621;8;328.00;0
432;8;625724425;432;205;1051;1051;9.92;0.61;136.44;4.33;619;8;329.00;0
436;8;625724435;436;208;1055;1055;9.82;0.60;136.97;4.32;619;8;330.00;0
436;8;625724444;436;210;1055;1055;9.72;0.59;136.97;4.32;619;8;331.00;0
439;8;625724458;439;216;1058;1059;9.64;0.59;138.25;4.31;619;8;332.00;1
441;8;625724473;441;218;1060;1060;9.52;0.58;138.36;4.30;619;8;333.00;0
444;8;625724484;444;218;1060;1060;9.40;0.57;138.65;4.30;616;8;334.00;0
449;8;625724494;449;220;1060;1060;9.24;0.56;140.06;4.30;611;8;335.00;0
452;8;625724506;452;226;1072;1073;9.01;0.55;140.16;4.25;620;8;336.00;1
456;8;625724519;456;224;1072;1073;8.84;0.54;140.98;4.25;616;8;337.00;1
458;8;625724530;458;232;1073;1073;8.71;0.53;141.36;4.25;615;8;338.00;0
462;8;625724549;462;237;1074;1074;8.40;0.51;142.13;4.25;612;8;339.00;0
465;8;625724558;465;228;1075;1075;8.13;0.50;142.31;4.25;610;8;340.00;0
469;8;625724571;469;221;1075;1075;7.93;0.49;142.99;4.25;606;8;341.00;0
471;8;625724582;471;217;1077;1078;7.91;0.49;143.24;4.24;606;8;342.00;1
473;8;625724593;473;218;1078;1078;7.95;0.49;143.76;4.24;605;8;343.00;0
476;8;625724604;476;228;1078;1078;7.97;0.49;144.47;4.24;602;8;344.00;0
478;8;625724612;478;234;1078;1078;7.96;0.49;144.33;4.24;600;8;345.00;0
481;8;625724619;481;226;1083;1084;8.01;0.50;145.47;4.22;602;8;346.00;1
484;8;625724627;484;221;1083;1084;7.95;0.49;145.55;4.22;599;8;347.00;1
489;8;625724636;489;217;1084;1084;7.93;0.49;145.98;4.22;595;8;348.00;0
491;8;625724644;491;220;1084;1084;7.88;0.48;145.75;4.22;593;8;349.00;0
493;8;625724652;493;220;1088;1088;7.85;0.48;145.90;4.21;595;8;350.00;0
497;8;625724659;497;223;1089;1089;7.77;0.48;145.18;4.20;592;8;351.00;0
501;8;625724668;501;227;1089;1089;7.72;0.47;145.07;4.20;588;8;352.00;0
501;8;625724677;501;228;1090;1090;7.80;0.48;145.07;4.20;589;8;353.00;0
505;8;625724685;505;231;1090;1090;7.76;0.48;145.06;4.20;585;8;354.00;0
509;8;625724693;509;230;1090;1090;7.73;0.48;144.91;4.20;581;8;355.00;0
516;8;625724701;516;235;1090;1090;7.62;0.47;145.39;4.20;574;8;356.00;0
517;8;625724709;517;233;1090;1090;7.65;0.47;145.38;4.20;573;8;357.00;0
520;8;625724722;520;242;1090;1090;7.63;0.47;145.87;4.20;570;8;358.00;0
522;8;625724730;522;243;1090;1090;7.58;0.47;146.49;4.20;568;8;359.00;0
526;8;625724740;526;263;1158;1215;7.85;0.49;146.44;3.95;632;8;360.00;57
527;8;625724759;527;259;1165;1216;7.90;0.50;146.67;3.94;638;8;361.00;51
531;8;625724775;531;253;1176;1216;7.96;0.50;146.96;3.92;645;8;362.00;40
533;8;625724784;533;247;1182;1216;7.98;0.50;147.08;3.91;649;8;363.00;34
538;8;625724793;538;240;1189;1216;7.95;0.50;147.87;3.91;651;8;364.00;27
542;8;625724804;542;241;1195;1216;7.83;0.49;148.53;3.92;653;8;365.00;21
544;8;625724814;544;239;1199;1216;7.84;0.49;148.65;3.93;655;8;366.00;17
545;8;625724823;545;240;1202;1216;7.72;0.48;148.44;3.93;657;8;367.00;14
547;8;625724833;547;247;1208;1217;7.67;0.47;148.35;3.95;661;8;368.00;9
547;8;625724843;547;255;1210;1218;7.64;0.47;148.35;3.95;663;8;369.00;8
550;8;625724852;550;258;1211;1218;7.57;0.47;148.36;3.95;661;8;370.00;7
556;8;625724862;556;248;1217;1222;7.49;0.46;148.75;3.96;661;8;371.00;5
559;8;625724873;559;244;1217;1222;7.41;0.46;148.45;3.96;658;8;372.00;5
561;8;625724884;561;244;1218;1222;7.35;0.45;148.95;3.96;657;8;373.00;4
561;8;625724897;561;245;1219;1222;7.42;0.46;148.95;3.97;658;8;374.00;3
563;8;625724908;563;242;1224;1228;7.51;0.46;149.18;3.97;661;8;375.00;4
564;8;625724919;564;237;1224;1228;7.74;0.48;149.39;3.97;660;8;376.00;4
568;8;625724938;568;235;1227;1228;7.90;0.49;149.66;3.98;659;8;377.00;1
570;8;625724957;570;234;1229;1231;8.08;0.49;149.50;3.97;659;8;378.00;2
572;8;625724976;572;230;1231;1231;8.26;0.50;149.45;3.98;659;8;379.00;0
573;9;625724986;573;231;1231;1231;8.42;0.51;149.35;3.98;658;9;380.00;0
575;9;625725008;575;229;1232;1232;8.54;0.52;149.64;3.98;657;9;381.00;0
575;10;625725021;575;230;1233;1233;8.63;0.52;149.64;3.98;658;10;382.00;0
575;10;625725052;575;230;1233;1233;8.69;0.53;149.64;3.98;658;10;383.00;0
577;10;625725063;577;233;1246;1246;8.75;0.53;149.32;3.94;669;10;384.00;0
579;10;625725081;579;233;1246;1246;8.77;0.53;149.14;3.94;667;10;385.00;0
580;10;625725091;580;237;1246;1246;8.77;0.53;149.24;3.94;666;10;386.00;0
582;10;625725102;582;226;1247;1247;8.78;0.53;148.81;3.93;665;10;387.00;0
582;10;625725113;582;217;1247;1247;8.85;0.54;148.81;3.93;665;10;388.00;0
583;10;625725124;583;211;1250;1251;8.91;0.54;148.61;3.93;667;10;389.00;1
585;10;625725144;585;207;1251;1251;8.94;0.54;148.91;3.93;666;10;390.00;0
585;10;625725161;585;208;1255;1255;8.98;0.55;148.91;3.92;670;10;391.00;0
588;10;625725178;588;212;1255;1255;8.92;0.54;149.52;3.92;667;10;392.00;0
589;10;625725190;589;211;1255;1255;8.92;0.54;149.93;3.92;666;10;393.00;0
591;10;625725201;591;211;1255;1255;8.90;0.54;149.93;3.92;664;10;394.00;0
593;10;625725213;593;210;1255;1255;8.86;0.54;150.27;3.92;662;10;395.00;0
595;10;625725225;595;204;1266;1267;8.96;0.55;150.73;3.88;671;10;396.00;1
596;10;625725237;596;196;1266;1267;9.00;0.55;150.90;3.88;670;10;397.00;1
601;10;625725248;601;181;1267;1267;9.05;0.55;152.25;3.88;666;10;398.00;0
603;10;625725260;603;172;1267;1267;9.14;0.56;152.12;3.88;664;10;399.00;0
606;10;625725273;606;166;1267;1267;9.19;0.56;152.58;3.88;661;10;400.00;0
607;10;625725288;607;163;1267;1267;9.31;0.57;152.91;3.88;660;10;401.00;0
610;10;625725300;610;163;1268;1268;9.44;0.58;153.42;3.88;658;10;402.00;0
613;10;625725310;613;162;1268;1268;9.48;0.58;153.78;3.88;655;10;403.00;0
616;10;625725321;616;167;1273;1274;9.61;0.59;153.95;3.87;657;10;404.00;1
620;10;625725333;620;169;1276;1276;9.68;0.59;155.15;3.86;656;10;405.00;0
623;10;625725344;623;169;1276;1276;9.78;0.60;155.37;3.86;653;10;406.00;0
625;10;625725354;625;163;1276;1276;9.92;0.61;155.86;3.86;651;10;407.00;0
627;10;625725364;627;159;1280;1280;10.01;0.61;156.15;3.85;653;10;408.00;0
630;10;625725375;630;158;1280;1280;10.09;0.62;156.94;3.85;650;10;409.00;0
634;10;625725384;634;165;1280;1280;10.13;0.62;157.13;3.85;646;10;410.00;0
636;10;625725394;636;158;1281;1281;10.17;0.62;157.29;3.85;645;10;411.00;0
639;10;625725403;639;151;1285;1285;10.12;0.62;157.61;3.84;646;10;412.00;0
639;10;625725413;639;148;1285;1285;10.23;0.62;157.61;3.84;646;10;413.00;0
642;10;625725422;642;142;1287;1288;10.29;0.63;157.81;3.83;645;10;414.00;1
645;10;625725432;645;147;1287;1288;10.39;0.63;158.44;3.83;642;10;415.00;1
650;11;625725442;650;146;1288;1288;10.56;0.64;159.46;3.83;638;11;416.00;0
652;11;625725469;652;147;1288;1288;10.70;0.65;159.75;3.83;636;11;417.00;0
655;11;625725484;655;149;1291;1292;10.81;0.66;160.57;3.82;636;11;418.00;1
660;11;625725495;660;147;1291;1292;10.87;0.66;161.29;3.82;631;11;419.00;1
664;12;625725506;664;147;1292;1292;10.90;0.66;161.72;3.82;628;12;420.00;0
667;12;625725533;667;150;1292;1292;10.90;0.66;162.17;3.82;625;12;421.00;0
670;12;625725542;670;154;1293;1293;10.88;0.66;162.56;3.82;623;12;422.00;0
670;12;625725551;670;154;1294;1294;10.93;0.67;162.56;3.82;624;12;423.00;0
672;12;625725559;672;158;1294;1294;10.85;0.66;162.90;3.82;622;12;424.00;0
675;12;625725573;675;161;1295;1295;10.82;0.66;163.64;3.81;620;12;425.00;0
678;12;625725582;678;163;1295;1295;10.74;0.66;164.35;3.81;617;12;426.00;0
680;12;625725590;680;163;1295;1295;10.63;0.65;164.47;3.81;615;12;427.00;0
681;12;625725598;681;165;1295;1295;10.57;0.65;164.51;3.81;614;12;428.00;0
685;12;625725606;685;167;1295;1295;10.50;0.64;164.90;3.81;610;12;429.00;0
686;12;625725614;686;162;1295;1295;10.46;0.64;165.07;3.81;609;12;430.00;0
687;12;625725622;687;154;1295;1295;10.45;0.64;165.44;3.81;608;12;431.00;0
689;12;625725630;689;179;1375;1422;9.97;0.62;165.30;3.59;686;12;432.00;47
692;12;625725649;692;162;1375;1423;10.02;0.62;165.54;3.59;683;12;433.00;48
695;12;625725657;695;154;1381;1423;10.12;0.63;165.65;3.59;686;12;434.00;42
697;12;625725666;697;144;1382;1423;10.18;0.63;165.80;3.59;685;12;435.00;41
701;12;625725674;701;142;1387;1423;10.24;0.63;166.11;3.59;686;12;436.00;36
705;12;625725682;705;143;1388;1423;10.22;0.63;166.49;3.59;683;12;437.00;35
708;12;625725690;708;143;1392;1423;10.21;0.63;166.78;3.60;684;12;438.00;31
712;12;625725705;712;150;1394;1423;10.24;0.63;166.96;3.60;682;12;439.00;29
716;12;625725714;716;146;1397;1424;10.27;0.63;167.41;3.61;681;12;440.00;27
719;12;625725727;719;146;1399;1425;10.27;0.63;167.80;3.62;680;12;441.00;26
722;12;625725736;722;133;1403;1425;10.35;0.63;167.64;3.64;681;12;442.00;22
725;12;625725744;725;135;1406;1426;10.33;0.63;167.77;3.65;681;12;443.00;20
727;12;625725758;727;130;1408;1426;10.42;0.64;167.85;3.66;681;12;444.00;18
729;12;625725767;729;125;1412;1426;10.48;0.64;167.89;3.69;683;12;445.00;14
733;12;625725776;733;126;1416;1426;10.45;0.64;168.42;3.72;683;12;446.00;10
734;12;625725785;734;121;1418;1430;10.44;0.64;168.41;3.72;684;12;447.00;12
738;12;625725795;738;121;1419;1430;10.35;0.63;169.12;3.73;681;12;448.00;11
743;12;625725804;743;121;1421;1430;10.31;0.63;169.35;3.74;678;12;449.00;9
745;12;625725815;745;117;1424;1436;10.32;0.63;169.65;3.75;679;12;450.00;12
748;12;625725824;748;118;1425;1436;10.34;0.63;169.66;3.75;677;12;451.00;11
750;12;625725833;750;119;1426;1436;10.36;0.63;169.46;3.75;676;12;452.00;10
752;12;625725843;752;120;1429;1440;10.37;0.63;169.59;3.74;677;12;453.00;11
754;12;625725852;754;116;1431;1441;10.39;0.63;169.67;3.74;677;12;454.00;10
757;12;625725867;757;119;1432;1441;10.42;0.63;169.91;3.74;675;12;455.00;9
759;12;625725876;759;120;1435;1445;10.43;0.63;169.83;3.75;676;12;456.00;10
761;12;625725886;761;123;1436;1445;10.46;0.64;169.82;3.75;675;12;457.00;9
764;12;625725896;764;124;1437;1445;10.54;0.64;170.33;3.76;673;12;458.00;8
765;12;625725905;765;124;1440;1446;10.58;0.64;170.23;3.78;675;12;459.00;6
767;12;625725914;767;124;1440;1446;10.63;0.64;170.41;3.78;673;12;460.00;6
768;12;625725930;768;125;1445;1452;10.65;0.65;170.32;3.79;677;12;461.00;7
770;12;625725940;770;129;1445;1452;10.56;0.64;170.14;3.79;675;12;462.00;7
771;12;625725950;771;128;1447;1453;10.50;0.64;170.05;3.81;676;12;463.00;6
773;12;625725959;773;132;1447;1453;10.41;0.63;169.90;3.81;674;12;464.00;6
774;12;625725969;774;133;1448;1453;10.40;0.63;170.19;3.81;674;12;465.00;5
774;12;625725978;774;136;1448;1453;10.46;0.64;170.19;3.81;674;12;466.00;5
775;12;625725987;775;138;1448;1453;10.51;0.64;170.10;3.81;673;12;467.00;5
776;12;625725996;776;140;1457;1465;10.65;0.65;170.11;3.79;681;12;468.00;8
776;12;625726007;776;143;1457;1465;10.80;0.66;170.11;3.79;681;12;469.00;8
777;12;625726016;777;142;1461;1465;10.93;0.67;170.22;3.80;684;12;470.00;4
782;12;625726026;782;145;1461;1465;10.99;0.67;170.60;3.80;679;12;471.00;4
782;12;625726036;782;150;1461;1465;11.05;0.67;170.60;3.80;679;12;472.00;4
784;12;625726045;784;153;1462;1465;11.03;0.67;170.70;3.82;678;12;473.00;3
789;12;625726054;789;158;1465;1469;10.98;0.67;170.56;3.81;676;12;474.00;4
789;12;625726065;789;157;1465;1469;11.00;0.67;170.56;3.81;676;12;475.00;4
792;12;625726074;792;158;1470;1473;11.02;0.67;170.47;3.82;678;12;476.00;3
793;12;625726084;793;162;1471;1474;11.02;0.67;170.49;3.82;678;12;477.00;3
798;12;625726094;798;167;1474;1474;10.90;0.66;170.47;3.82;676;12;478.00;0
799;12;625726109;799;172;1474;1474;10.77;0.66;170.31;3.82;675;12;479.00;0
799;12;625726121;799;175;1493;1500;10.67;0.65;170.31;3.77;694;12;480.00;7
799;12;625726131;799;178;1494;1500;10.60;0.65;170.31;3.77;695;12;481.00;6
802;12;625726140;802;181;1497;1500;10.60;0.65;170.17;3.77;695;12;482.00;3
805;12;625726150;805;185;1500;1501;10.58;0.65;170.35;3.77;695;12;483.00;1
806;12;625726159;806;190;1502;1502;10.54;0.64;170.38;3.76;696;12;484.00;0
807;12;625726169;807;198;1502;1502;10.43;0.64;170.31;3.76;695;12;485.00;0
809;12;625726178;809;200;1504;1505;10.34;0.63;170.18;3.76;695;12;486.00;1
810;12;625726192;810;205;1505;1505;10.26;0.63;170.12;3.76;695;12;487.00;0
811;12;625726201;811;211;1505;1505;10.20;0.63;170.07;3.76;694;12;488.00;0
817;12;625726210;817;212;1505;1505;10.11;0.62;170.00;3.76;688;12;489.00;0
818;12;625726220;818;215;1510;1511;10.10;0.62;169.95;3.75;692;12;490.00;1
820;12;625726229;820;215;1510;1511;10.01;0.61;169.96;3.75;690;12;491.00;1
823;12;625726238;823;215;1511;1511;9.90;0.61;170.37;3.75;688;12;492.00;0
824;12;625726247;824;217;1511;1511;9.84;0.60;170.24;3.75;687;12;493.00;0
827;12;625726255;827;222;1515;1515;9.73;0.60;170.07;3.74;688;12;494.00;0
829;12;625726264;829;225;1517;1517;9.72;0.60;169.95;3.74;688;12;495.00;0
830;12;625726272;830;228;1517;1517;9.67;0.59;170.00;3.74;687;12;496.00;0
833;12;625726281;833;233;1518;1518;9.67;0.59;169.74;3.73;685;12;497.00;0
835;12;625726289;835;238;1518;1518;9.67;0.59;169.61;3.73;683;12;498.00;0
837;12;625726297;837;239;1518;1518;9.63;0.59;169.87;3.73;681;12;499.00;0
843;12;625726306;843;238;1518;1518;9.52;0.58;169.51;3.73;675;12;500.00;0
848;12;625726318;848;242;1518;1518;9.40;0.57;169.96;3.73;670;12;501.00;0
850;12;625726326;850;242;1518;1518;9.28;0.57;169.72;3.73;668;12;502.00;0
851;12;625726333;851;247;1518;1518;9.17;0.56;169.69;3.73;667;12;503.00;0
855;12;625726340;855;257;1558;1588;9.15;0.56;170.28;3.64;703;12;504.00;30
860;12;625726353;860;253;1559;1589;8.98;0.55;171.11;3.64;699;12;505.00;30
861;12;625726361;861;257;1566;1589;8.86;0.54;171.41;3.63;705;12;506.00;23
863;12;625726368;863;253;1571;1589;8.71;0.53;171.62;3.63;708;12;507.00;18
864;12;625726376;864;253;1576;1589;8.63;0.53;171.56;3.63;712;12;508.00;13
870;12;625726383;870;260;1577;1589;8.45;0.52;171.87;3.63;707;12;509.00;12
871;12;625726392;871;252;1579;1589;8.35;0.51;171.92;3.63;708;12;510.00;10
873;12;625726400;873;250;1584;1589;8.28;0.51;172.25;3.64;711;12;511.00;5
874;12;625726407;874;248;1585;1590;8.24;0.50;172.09;3.65;711;12;512.00;5
878;12;625726414;878;248;1589;1591;8.16;0.50;172.23;3.65;711;12;513.00;2
879;12;625726422;879;244;1589;1591;8.10;0.49;172.13;3.65;710;12;514.00;2
882;12;625726430;882;248;1595;1595;8.06;0.49;172.53;3.65;713;12;515.00;0
886;12;625726438;886;252;1595;1595;8.01;0.49;173.30;3.65;709;12;516.00;0
888;12;625726447;888;253;1595;1595;8.09;0.49;173.18;3.65;707;12;517.00;0
893;12;625726455;893;255;1595;1595;8.07;0.49;173.98;3.65;702;12;518.00;0
894;13;625726463;894;259;1600;1601;8.10;0.49;174.20;3.64;706;13;519.00;1
897;13;625726487;897;255;1600;1601;8.13;0.50;174.64;3.64;703;13;520.00;1
902;13;625726498;902;254;1601;1601;8.15;0.50;175.10;3.64;699;13;521.00;0
903;13;625726512;903;251;1603;1604;8.24;0.50;175.32;3.64;700;13;522.00;1
908;13;625726527;908;236;1604;1604;8.24;0.50;175.73;3.64;696;13;523.00;0
911;13;625726543;911;221;1604;1604;8.25;0.50;176.31;3.64;693;13;524.00;0
913;13;625726559;913;215;1605;1605;8.33;0.51;176.51;3.64;692;13;525.00;0
916;13;625726573;916;205;1606;1606;8.37;0.51;176.48;3.63;690;13;526.00;0
919;13;625726588;919;202;1606;1606;8.45;0.52;176.95;3.63;687;13;527.00;0
923;14;625726601;923;200;1619;1619;8.54;0.53;176.59;3.60;696;14;528.00;0
926;14;625726626;926;188;1619;1619;8.59;0.53;177.17;3.60;693;14;529.00;0
930;14;625726652;930;187;1619;1619;8.63;0.53;177.58;3.60;689;14;530.00;0
934;14;625726664;934;185;1620;1620;8.70;0.54;177.70;3.60;686;14;531.00;0
938;14;625726675;938;189;1620;1620;8.74;0.54;177.51;3.60;682;14;532.00;0
942;14;625726687;942;185;1623;1624;8.82;0.54;177.87;3.60;681;14;533.00;1
944;14;625726698;944;182;1623;1624;8.88;0.55;177.86;3.60;679;14;534.00;1
952;14;625726715;952;180;1628;1628;8.90;0.55;178.35;3.59;676;14;535.00;0
954;14;625726727;954;179;1628;1628;8.95;0.55;178.47;3.59;674;14;536.00;0
962;14;625726738;962;181;1628;1628;8.85;0.54;178.39;3.59;666;14;537.00;0
964;14;625726750;964;180;1628;1628;8.84;0.54;178.53;3.59;664;14;538.00;0
965;14;625726761;965;178;1628;1628;8.84;0.54;178.47;3.59;663;14;539.00;0
968;14;625726774;968;185;1655;1662;8.90;0.55;178.68;3.53;687;14;540.00;7
972;14;625726788;972;186;1655;1662;8.94;0.55;178.61;3.53;683;14;541.00;7
976;14;625726799;976;189;1659;1662;8.95;0.55;178.92;3.53;683;14;542.00;3
980;14;625726810;980;192;1659;1662;8.99;0.55;179.08;3.53;679;14;543.00;3
982;14;625726821;982;194;1660;1662;9.02;0.55;179.06;3.53;678;14;544.00;2
984;14;625726832;984;193;1660;1662;9.05;0.55;179.25;3.53;676;14;545.00;2
986;14;625726844;986;192;1662;1663;9.04;0.55;179.30;3.53;676;14;546.00;1
986;14;625726854;986;192;1662;1663;9.07;0.55;179.30;3.53;676;14;547.00;1
990;14;625726866;990;194;1667;1669;9.10;0.56;179.22;3.53;677;14;548.00;2
993;14;625726885;993;199;1668;1670;9.17;0.56;179.31;3.52;675;14;549.00;2
994;14;625726897;994;204;1669;1670;9.18;0.56;179.44;3.52;675;14;550.00;1
995;14;625726908;995;205;1669;1670;9.15;0.56;179.59;3.52;674;14;551.00;1
999;14;625726919;999;209;1674;1674;9.08;0.55;179.69;3.52;675;14;552.00;0
1001;14;625726937;1001;216;1674;1674;8.98;0.55;179.62;3.52;673;14;553.00;0
1003;14;625726947;1003;221;1674;1674;8.94;0.55;179.72;3.52;671;14;554.00;0
1006;14;625726958;1006;232;1675;1675;8.89;0.54;179.90;3.51;669;14;555.00;0
1007;14;625726970;1007;231;1679;1679;8.86;0.54;180.06;3.51;672;14;556.00;0
1010;14;625726981;1010;220;1679;1679;8.85;0.54;180.23;3.51;669;14;557.00;0
1013;14;625726999;1013;215;1681;1682;8.84;0.54;180.43;3.50;668;14;558.00;1
1016;14;625727010;1016;205;1681;1682;8.89;0.54;180.71;3.50;665;14;559.00;1
1019;14;625727022;1019;202;1682;1682;8.94;0.55;180.99;3.50;663;14;560.00;0
1023;14;625727033;1023;208;1682;1682;8.95;0.55;181.29;3.50;659;14;561.00;0
1026;14;625727044;1026;212;1685;1686;8.97;0.55;181.52;3.50;659;14;562.00;1
1030;14;625727055;1030;211;1685;1686;8.98;0.55;181.89;3.50;655;14;563.00;1
1035;14;625727067;1035;211;1686;1686;9.03;0.55;182.71;3.50;651;14;564.00;0
1036;14;625727078;1036;209;1686;1686;9.13;0.56;182.81;3.50;650;14;565.00;0
1039;14;625727090;1039;195;1687;1687;9.14;0.56;183.32;3.50;648;14;566.00;0
1043;14;625727101;1043;183;1688;1688;9.26;0.56;183.51;3.49;645;14;567.00;0
1046;14;625727114;1046;173;1688;1688;9.35;0.57;183.44;3.49;642;14;568.00;0
1050;14;625727125;1050;164;1689;1689;9.39;0.57;184.05;3.49;639;14;569.00;0
1052;14;625727139;1052;161;1689;1689;9.44;0.57;184.25;3.49;637;14;570.00;0
1054;14;625727158;1054;157;1689;1689;9.55;0.58;184.25;3.49;635;14;571.00;0
1058;14;625727169;1058;158;1689;1689;9.58;0.58;184.56;3.49;631;14;572.00;0
1060;14;625727181;1060;163;1689;1689;9.68;0.59;184.73;3.49;629;14;573.00;0
1062;14;625727193;1062;164;1689;1689;9.75;0.59;185.00;3.49;627;14;574.00;0
1064;14;625727204;1064;170;1689;1689;9.83;0.60;185.36;3.49;625;14;575.00;0
1065;14;625727216;1065;196;1770;1816;9.70;0.60;185.52;3.34;705;14;576.00;46
1069;14;625727241;1069;177;1773;1817;9.68;0.60;186.19;3.33;704;14;577.00;44
1071;14;625727260;1071;164;1781;1817;9.74;0.60;186.26;3.33;710;14;578.00;36
1073;14;625727272;1073;159;1784;1817;9.81;0.61;186.44;3.32;711;14;579.00;33
1074;14;625727282;1074;154;1787;1817;9.91;0.61;186.40;3.33;713;14;580.00;30
1076;14;625727293;1076;152;1789;1817;10.00;0.62;186.50;3.33;713;14;581.00;28
1077;14;625727304;1077;150;1793;1817;10.07;0.62;186.39;3.33;716;14;582.00;24
1080;14;625727317;1080;150;1794;1817;10.02;0.62;186.56;3.34;714;14;583.00;23
1084;14;625727329;1084;147;1799;1818;10.04;0.62;186.60;3.35;715;14;584.00;19
1086;14;625727341;1086;155;1801;1820;10.02;0.62;186.70;3.35;715;14;585.00;19
1091;14;625727352;1091;162;1806;1820;10.07;0.62;186.85;3.37;715;14;586.00;14
1091;15;625727363;1091;165;1811;1821;10.12;0.62;186.85;3.38;720;15;587.00;10
1097;15;625727388;1097;179;1813;1821;10.12;0.62;187.04;3.39;716;15;588.00;8
1101;15;625727400;1101;180;1815;1821;10.17;0.62;187.66;3.40;714;15;589.00;6
1102;15;625727412;1102;182;1816;1821;10.22;0.63;187.96;3.41;714;15;590.00;5
1105;15;625727423;1105;184;1819;1825;10.26;0.63;188.19;3.41;714;15;591.00;6
1107;15;625727442;1107;187;1821;1825;10.30;0.63;188.58;3.42;714;15;592.00;4
1111;15;625727454;1111;186;1821;1825;10.36;0.63;189.13;3.42;710;15;593.00;4
1113;15;625727466;1113;186;1824;1828;10.43;0.64;189.44;3.42;711;15;594.00;4
1115;15;625727478;1115;187;1824;1828;10.48;0.64;189.33;3.42;709;15;595.00;4
1116;15;625727493;1116;184;1825;1828;10.60;0.65;189.31;3.43;709;15;596.00;3
1118;15;625727505;1118;188;1829;1832;10.62;0.65;189.14;3.43;711;15;597.00;3
1118;15;625727517;1118;192;1831;1833;10.77;0.66;189.14;3.43;713;15;598.00;2
1121;15;625727528;1121;187;1831;1833;10.88;0.66;189.24;3.43;710;15;599.00;2
1123;15;625727542;1123;186;1842;1859;10.87;0.66;189.41;3.41;719;15;600.00;17
1124;15;625727567;1124;177;1843;1859;10.90;0.66;189.45;3.41;719;15;601.00;16
1126;15;625727584;1126;175;1844;1859;10.94;0.67;189.36;3.41;718;15;602.00;15
1129;15;625727596;1129;173;1846;1860;10.95;0.67;189.58;3.41;717;15;603.00;14
1132;15;625727607;1132;171;1848;1860;10.93;0.66;190.03;3.41;716;15;604.00;12
1135;15;625727619;1135;172;1852;1866;10.93;0.66;189.88;3.41;717;15;605.00;14
1138;15;625727630;1138;164;1852;1866;10.92;0.66;190.16;3.41;714;15;606.00;14
1141;15;625727641;1141;165;1853;1867;10.91;0.66;190.01;3.41;712;15;607.00;14
1147;15;625727653;1147;163;1854;1867;10.91;0.66;190.43;3.41;707;15;608.00;13
1148;15;625727664;1148;162;1854;1867;10.95;0.66;190.64;3.41;706;15;609.00;13
1151;15;625727675;1151;160;1855;1867;10.89;0.66;190.91;3.41;704;15;610.00;12
1155;15;625727685;1155;155;1856;1867;10.86;0.66;191.13;3.42;701;15;611.00;11
1156;15;625727696;1156;145;1864;1879;10.88;0.66;191.09;3.40;708;15;612.00;15
1160;15;625727708;1160;135;1866;1879;10.78;0.65;191.96;3.41;706;15;613.00;13
1165;15;625727719;1165;130;1869;1879;10.68;0.65;192.56;3.41;704;15;614.00;10
1166;15;625727735;1166;126;1871;1879;10.68;0.65;192.61;3.42;705;15;615.00;8
1173;15;625727751;1173;121;1872;1879;10.66;0.65;192.73;3.42;699;15;616.00;7
1176;15;625727762;1176;117;1872;1879;10.72;0.65;192.94;3.42;696;15;617.00;7
1178;15;625727773;1178;110;1875;1883;10.80;0.65;193.10;3.42;697;15;618.00;8
1184;15;625727783;1184;106;1875;1883;10.87;0.66;193.42;3.42;691;15;619.00;8
1188;15;625727800;1188;100;1878;1887;10.89;0.66;193.92;3.42;690;15;620.00;9
1190;15;625727811;1190;105;1880;1888;10.99;0.67;193.73;3.42;690;15;621.00;8
1194;15;625727823;1194;102;1881;1888;11.09;0.67;194.02;3.42;687;15;622.00;7
1195;15;625727834;1195;102;1881;1888;11.21;0.68;194.17;3.42;686;15;623.00;7
1200;15;625727844;1200;104;1889;1901;11.29;0.68;193.97;3.41;689;15;624.00;12
1203;15;625727855;1203;106;1889;1901;11.36;0.69;193.94;3.41;686;15;625.00;12
1206;16;625727864;1206;104;1889;1901;11.37;0.69;193.99;3.41;683;16;626.00;12
1208;16;625727885;1208;113;1892;1902;11.33;0.69;194.25;3.43;684;16;627.00;10
1211;16;625727896;1211;118;1892;1903;11.33;0.68;194.46;3.43;681;16;628.00;11
1212;16;625727912;1212;120;1893;1903;11.28;0.68;194.69;3.43;681;16;629.00;10
1216;16;625727925;1216;122;1897;1909;11.25;0.68;194.88;3.44;681;16;630.00;12
1222;16;625727937;1222;126;1898;1909;11.23;0.68;195.17;3.43;676;16;631.00;11
1224;16;625727948;1224;129;1899;1909;11.28;0.68;195.28;3.43;675;16;632.00;10
1227;16;625727960;1227;132;1899;1909;11.31;0.68;195.39;3.43;672;16;633.00;10
1227;16;625727971;1227;133;1903;1915;11.33;0.69;195.39;3.43;676;16;634.00;12
1228;16;625727982;1228;136;1903;1915;11.20;0.68;195.26;3.43;675;16;635.00;12
1229;16;625727993;1229;137;1905;1915;11.14;0.68;195.31;3.45;676;16;636.00;10
1231;16;625728004;1231;141;1905;1915;11.10;0.67;195.20;3.45;674;16;637.00;10
1232;16;625728015;1232;144;1909;1919;11.00;0.67;195.23;3.44;677;16;638.00;10
1234;16;625728026;1234;151;1910;1920;10.93;0.66;195.04;3.44;676;16;639.00;10
1238;16;625728038;1238;160;1912;1920;10.80;0.66;194.84;3.46;674;16;640.00;8
1241;16;625728049;1241;169;1913;1921;10.73;0.65;194.85;3.46;672;16;641.00;8
1242;16;625728059;1242;173;1915;1921;10.64;0.65;194.97;3.49;673;16;642.00;6
1243;16;625728080;1243;173;1916;1921;10.57;0.64;194.98;3.49;673;16;643.00;5
1246;16;625728090;1246;180;1917;1921;10.51;0.64;194.74;3.50;671;16;644.00;4
1247;16;625728100;1247;185;1917;1921;10.46;0.64;194.71;3.50;670;16;645.00;4
1247;16;625728110;1247;191;1917;1921;10.32;0.63;194.71;3.50;670;16;646.00;4
1250;16;625728119;1250;193;1920;1921;10.16;0.62;194.58;3.53;670;16;647.00;1
1251;16;625728129;1251;198;1955;1991;10.14;0.62;194.48;3.47;704;16;648.00;36
1255;16;625728152;1255;202;1958;1992;9.99;0.61;194.13;3.48;703;16;649.00;34
1256;16;625728162;1256;205;1972;1992;10.00;0.61;194.01;3.47;716;16;650.00;20
1258;16;625728171;1258;209;1974;1992;9.93;0.61;194.01;3.47;716;16;651.00;18
1258;16;625728181;1258;212;1980;1992;9.98;0.61;194.01;3.47;722;16;652.00;12
1258;16;625728190;1258;214;1984;1992;9.99;0.61;194.01;3.47;726;16;653.00;8
1259;16;625728200;1259;217;1989;1992;9.98;0.61;193.95;3.48;730;16;654.00;3
1260;16;625728211;1260;223;1990;1992;9.86;0.60;193.98;3.48;730;16;655.00;2
1262;16;625728225;1262;227;1992;1993;9.79;0.60;193.78;3.48;730;16;656.00;1
1263;16;625728235;1263;236;1993;1994;9.70;0.59;193.69;3.48;730;16;657.00;1
1264;16;625728246;1264;246;1994;1994;9.56;0.58;193.54;3.48;730;16;658.00;0
1265;16;625728255;1265;242;1998;1998;9.45;0.58;193.45;3.48;733;16;659.00;0
1268;16;625728268;1268;243;1998;1998;9.30;0.57;193.44;3.48;730;16;660.00;0
1270;16;625728278;1270;246;1998;1998;9.16;0.56;193.48;3.48;728;16;661.00;0
1271;16;625728288;1271;253;1998;1998;9.03;0.55;193.51;3.48;727;16;662.00;0
1272;16;625728297;1272;259;2003;2004;8.98;0.55;193.37;3.47;731;16;663.00;1
1273;16;625728307;1273;264;2004;2004;8.91;0.54;193.32;3.47;731;16;664.00;0
1273;16;625728318;1273;272;2004;2004;8.81;0.54;193.32;3.47;731;16;665.00;0
1274;16;625728327;1274;277;2007;2007;8.75;0.53;193.29;3.46;733;16;666.00;0
1276;16;625728337;1276;284;2007;2007;8.65;0.53;193.16;3.46;731;16;667.00;0
1277;16;625728346;1277;286;2007;2007;8.53;0.52;193.10;3.46;730;16;668.00;0
1280;16;625728355;1280;291;2008;2008;8.45;0.51;192.89;3.46;728;16;669.00;0
1283;16;625728364;1283;292;2009;2009;8.38;0.51;193.01;3.46;726;16;670.00;0
1286;16;625728375;1286;300;2009;2009;8.24;0.50;192.89;3.46;723;16;671.00;0
1288;16;625728384;1288;309;2022;2022;8.08;0.49;192.98;3.44;734;16;672.00;0
1290;16;625728394;1290;315;2022;2022;8.00;0.49;193.07;3.44;732;16;673.00;0
1292;16;625728403;1292;314;2022;2022;7.86;0.48;192.81;3.44;730;16;674.00;0
1297;16;625728411;1297;307;2024;2024;7.75;0.47;192.78;3.44;727;16;675.00;0
1300;16;625728421;1300;289;2024;2024;7.62;0.46;193.07;3.44;724;16;676.00;0
1303;16;625728430;1303;289;2027;2028;7.54;0.46;193.19;3.43;724;16;677.00;1
1307;16;625728439;1307;284;2028;2028;7.42;0.45;193.67;3.43;721;16;678.00;0
1310;16;625728447;1310;279;2032;2032;7.34;0.45;193.79;3.43;722;16;679.00;0
1311;16;625728456;1311;261;2032;2032;7.35;0.45;193.97;3.43;721;16;680.00;0
1313;16;625728465;1313;251;2032;2032;7.35;0.45;194.12;3.43;719;16;681.00;0
1316;16;625728479;1316;238;2032;2032;7.37;0.45;194.41;3.43;716;16;682.00;0
1318;16;625728493;1318;233;2032;2032;7.42;0.45;194.49;3.43;714;16;683.00;0
1321;16;625728506;1321;223;2043;2044;7.55;0.46;195.02;3.41;722;16;684.00;1
1325;16;625728532;1325;220;2044;2044;7.59;0.46;195.09;3.41;719;16;685.00;0
1326;16;625728548;1326;221;2044;2044;7.69;0.47;195.25;3.41;718;16;686.00;0
1329;16;625728564;1329;208;2044;2044;7.71;0.47;195.58;3.41;715;16;687.00;0
1332;16;625728578;1332;204;2044;2044;7.73;0.47;195.99;3.41;712;16;688.00;0
1334;16;625728593;1334;201;2044;2044;7.82;0.48;196.14;3.41;710;16;689.00;0
1335;16;625728607;1335;202;2045;2045;7.91;0.48;196.24;3.41;710;16;690.00;0
1337;16;625728619;1337;202;2045;2045;7.99;0.49;196.57;3.41;708;16;691.00;0
1339;16;625728630;1339;195;2050;2051;8.26;0.50;196.59;3.40;711;16;692.00;1
1340;16;625728642;1340;194;2052;2052;8.42;0.52;196.79;3.40;712;16;693.00;0
1343;16;625728654;1343;195;2052;2052;8.55;0.52;196.99;3.40;709;16;694.00;0
1343;16;625728666;1343;193;2052;2052;8.67;0.53;196.99;3.40;709;16;695.00;0
1345;16;625728676;1345;189;2056;2056;8.75;0.54;197.13;3.39;711;16;696.00;0
1347;16;625728689;1347;187;2056;2056;8.86;0.54;197.16;3.39;709;16;697.00;0
1350;16;625728700;1350;186;2056;2056;8.96;0.55;197.38;3.39;706;16;698.00;0
1356;16;625728711;1356;179;2057;2057;9.02;0.55;197.81;3.39;701;16;699.00;0
1360;16;625728723;1360;171;2061;2061;9.03;0.55;198.15;3.39;701;16;700.00;0
1363;16;625728739;1363;162;2061;2061;9.05;0.55;198.02;3.39;698;16;701.00;0
1369;16;625728751;1369;164;2063;2064;9.10;0.55;198.31;3.38;694;16;702.00;1
1374;16;625728771;1374;160;2063;2064;9.18;0.56;198.51;3.38;689;16;703.00;1
1378;16;625728782;1378;154;2064;2064;9.27;0.56;198.44;3.38;686;16;704.00;0
1380;16;625728794;1380;155;2064;2064;9.39;0.57;198.68;3.38;684;16;705.00;0
1382;16;625728806;1382;154;2067;2068;9.55;0.58;198.83;3.38;685;16;706.00;1
1390;16;625728818;1390;152;2067;2068;9.47;0.58;199.04;3.38;677;16;707.00;1
1395;16;625728830;1395;148;2068;2068;9.48;0.58;199.06;3.38;673;16;708.00;0
1399;16;625728842;1399;147;2068;2068;9.50;0.58;198.95;3.38;669;16;709.00;0
1403;16;625728854;1403;145;2069;2069;9.57;0.58;199.02;3.38;666;16;710.00;0
1408;16;625728867;1408;144;2070;2070;9.62;0.58;199.36;3.38;662;16;711.00;0
1414;16;625728879;1414;147;2070;2070;9.73;0.59;199.71;3.38;656;16;712.00;0
1419;16;625728891;1419;149;2071;2071;9.83;0.59;199.83;3.37;652;16;713.00;0
1422;16;625728903;1422;147;2071;2071;9.97;0.60;200.03;3.37;649;16;714.00;0
1425;16;625728915;1425;150;2071;2071;10.07;0.61;200.21;3.37;646;16;715.00;0
1427;16;625728927;1427;145;2071;2071;10.18;0.62;200.43;3.37;644;16;716.00;0
1431;16;625728939;1431;145;2071;2071;10.19;0.62;200.53;3.37;640;16;717.00;0
1435;16;625728952;1435;145;2071;2071;10.27;0.62;200.58;3.37;636;16;718.00;0
1437;16;625728966;1437;150;2071;2071;10.30;0.63;200.66;3.37;634;16;719.00;0
1439;16;625728981;1439;189;2191;2301;10.21;0.64;200.68;3.19;752;16;720.00;110
1441;16;625729022;1441;181;2200;2302;10.16;0.64;200.74;3.18;759;16;721.00;102
1446;16;625729037;1446;164;2212;2302;10.18;0.64;200.83;3.18;766;16;722.00;90
1450;16;625729052;1450;168;2222;2302;10.12;0.63;201.04;3.18;772;16;723.00;80
1453;16;625729065;1453;161;2228;2302;10.07;0.63;201.22;3.18;775;16;724.00;74
1455;16;625729079;1455;166;2234;2302;9.95;0.62;201.40;3.18;779;16;725.00;68
1460;16;625729098;1460;170;2241;2302;9.82;0.61;201.54;3.19;781;16;726.00;61
1462;16;625729111;1462;165;2245;2302;9.77;0.61;201.51;3.20;783;16;727.00;57
1464;16;625729125;1464;168;2250;2303;9.68;0.60;201.88;3.21;786;16;728.00;53
1470;16;625729138;1470;174;2255;2304;9.57;0.60;202.27;3.22;785;16;729.00;49
1473;16;625729152;1473;177;2262;2304;9.55;0.60;202.33;3.24;789;16;730.00;42
1475;16;625729165;1475;181;2265;2305;9.54;0.59;202.46;3.25;790;16;731.00;40
1478;16;625729179;1478;190;2270;2305;9.47;0.59;202.78;3.27;792;16;732.00;35
1483;16;625729192;1483;194;2273;2305;9.47;0.59;202.80;3.28;790;16;733.00;32
1488;16;625729206;1488;202;2277;2305;9.39;0.58;202.88;3.30;789;16;734.00;28
1493;16;625729221;1493;207;2281;2309;9.37;0.58;203.01;3.30;788;16;735.00;28
1495;16;625729248;1495;199;2282;2309;9.40;0.58;203.28;3.31;787;16;736.00;27
1499;16;625729262;1499;194;2284;2309;9.42;0.58;203.58;3.32;785;16;737.00;25
1500;16;625729276;1500;192;2288;2312;9.49;0.58;203.56;3.34;788;16;738.00;24
1501;16;625729290;1501;195;2288;2312;9.54;0.59;203.74;3.34;787;16;739.00;24
1504;16;625729303;1504;194;2290;2312;9.61;0.59;203.75;3.35;786;16;740.00;22
1509;16;625729323;1509;196;2294;2316;9.65;0.59;203.70;3.35;785;16;741.00;22
1509;16;625729337;1509;196;2298;2317;9.76;0.60;203.70;3.37;789;16;742.00;19
1514;16;625729350;1514;198;2299;2317;9.81;0.60;203.91;3.38;785;16;743.00;18
1516;16;625729364;1516;202;2303;2321;9.83;0.60;204.02;3.39;787;16;744.00;18
1520;16;625729379;1520;211;2306;2321;9.80;0.60;204.26;3.41;786;16;745.00;15
1522;16;625729393;1522;214;2306;2321;9.84;0.60;204.42;3.41;784;16;746.00;15
1525;16;625729406;1525;207;2306;2322;9.91;0.61;204.60;3.41;781;16;747.00;16
1528;16;625729419;1528;207;2307;2322;9.86;0.60;204.90;3.41;779;16;748.00;15
1531;16;625729433;1531;209;2313;2328;9.82;0.60;205.07;3.42;782;16;749.00;15
1534;16;625729448;1534;206;2315;2328;9.83;0.60;205.16;3.43;781;16;750.00;13
1537;16;625729460;1537;205;2317;2329;9.83;0.60;205.26;3.44;780;16;751.00;12
1542;16;625729475;1542;208;2317;2329;9.86;0.60;205.39;3.44;775;16;752.00;12
1548;16;625729495;1548;204;2318;2329;9.83;0.60;205.59;3.44;770;16;753.00;11
1550;16;625729510;1550;208;2318;2329;9.90;0.61;205.63;3.44;768;16;754.00;11
1553;16;625729523;1553;208;2319;2329;9.91;0.61;205.75;3.45;766;16;755.00;10
1557;16;625729536;1557;208;2330;2341;9.96;0.61;205.82;3.43;773;16;756.00;11
1561;16;625729549;1561;215;2331;2341;9.94;0.61;205.84;3.44;770;16;757.00;10
1561;16;625729561;1561;222;2331;2341;9.91;0.61;205.84;3.44;770;16;758.00;10
1565;16;625729573;1565;220;2331;2341;9.88;0.60;205.85;3.44;766;16;759.00;10
1567;16;625729585;1567;226;2332;2341;9.88;0.60;205.85;3.44;765;16;760.00;9
1570;16;625729597;1570;232;2333;2341;9.86;0.60;205.87;3.44;763;16;761.00;8
1571;16;625729609;1571;233;2337;2345;9.84;0.60;205.85;3.44;766;16;762.00;8
1572;16;625729621;1572;237;2337;2345;9.86;0.60;206.02;3.44;765;16;763.00;8
1574;16;625729632;1574;238;2340;2349;9.92;0.61;206.01;3.43;766;16;764.00;9
1576;16;625729644;1576;240;2343;2351;9.89;0.61;206.11;3.43;767;16;765.00;8
1578;16;625729655;1578;245;2343;2351;9.83;0.60;206.18;3.43;765;16;766.00;8
1580;16;625729666;1580;250;2343;2351;9.74;0.60;206.42;3.43;763;16;767.00;8
1580;16;625729677;1580;253;2353;2364;9.73;0.60;206.42;3.41;773;16;768.00;11
1584;16;625729690;1584;249;2353;2364;9.68;0.59;206.56;3.41;769;16;769.00;11
1585;16;625729701;1585;246;2354;2364;9.66;0.59;206.50;3.41;769;16;770.00;10
1587;16;625729712;1587;235;2356;2365;9.62;0.59;206.56;3.43;769;16;771.00;9
1593;16;625729722;1593;236;2356;2366;9.56;0.58;206.57;3.43;763;16;772.00;10
1598;16;625729734;1598;230;2356;2366;9.51;0.58;206.61;3.43;758;16;773.00;10
1598;16;625729745;1598;228;2358;2369;9.50;0.58;206.61;3.43;760;16;774.00;11
1601;16;625729756;1601;224;2358;2369;9.45;0.58;206.72;3.43;757;16;775.00;11
1607;16;625729767;1607;221;2359;2369;9.48;0.58;206.98;3.43;752;16;776.00;10
1610;16;625729777;1610;222;2359;2369;9.45;0.58;207.08;3.43;749;16;777.00;10
1614;16;625729787;1614;224;2363;2375;9.46;0.58;207.19;3.43;749;16;778.00;12
1616;16;625729798;1616;223;2363;2375;9.46;0.58;207.44;3.43;747;16;779.00;12
1619;16;625729810;1619;225;2364;2375;9.45;0.58;207.52;3.43;745;16;780.00;11
1622;16;625729820;1622;220;2364;2375;9.45;0.58;207.73;3.43;742;16;781.00;11
1623;16;625729830;1623;215;2367;2379;9.42;0.57;207.68;3.42;744;16;782.00;12
1627;16;625729841;1627;210;2368;2380;9.37;0.57;207.89;3.42;741;16;783.00;12
1633;16;625729851;1633;200;2368;2380;9.33;0.57;208.02;3.42;735;16;784.00;12
1634;16;625729862;1634;199;2370;2381;9.32;0.57;208.02;3.42;736;16;785.00;11
1638;16;625729872;1638;192;2370;2381;9.31;0.57;208.06;3.42;732;16;786.00;11
1641;16;625729882;1641;181;2370;2381;9.28;0.56;208.04;3.42;729;16;787.00;11
1644;16;625729893;1644;177;2370;2381;9.26;0.56;207.88;3.42;726;16;788.00;11
1644;16;625729902;1644;176;2370;2381;9.31;0.57;207.88;3.42;726;16;789.00;11
1646;16;625729912;1646;177;2370;2381;9.34;0.57;207.71;3.42;724;16;790.00;11
1646;16;625729923;1646;173;2370;2381;9.45;0.58;207.71;3.42;724;16;791.00;11
1649;16;625729933;1649;176;2401;2451;9.51;0.58;207.65;3.38;752;16;792.00;50
1651;16;625729954;1651;174;2401;2452;9.54;0.58;207.51;3.38;750;16;793.00;51
1652;16;625729965;1652;173;2408;2452;9.65;0.59;207.43;3.38;756;16;794.00;44
1657;16;625729979;1657;172;2409;2452;9.71;0.59;207.26;3.38;752;16;795.00;43
1657;16;625729991;1657;170;2412;2452;9.79;0.60;207.26;3.38;755;16;796.00;40
1657;16;625730001;1657;173;2415;2452;9.78;0.60;207.26;3.41;758;16;797.00;37
1661;16;625730012;1661;180;2418;2452;9.83;0.60;207.08;3.41;757;16;798.00;34
1662;16;625730024;1662;179;2418;2452;9.74;0.59;207.04;3.41;756;16;799.00;34
1662;16;625730036;1662;185;2424;2453;9.74;0.59;207.04;3.45;762;16;800.00;29
1665;16;625730056;1665;186;2425;2454;9.74;0.59;206.97;3.45;760;16;801.00;29
1668;16;625730068;1668;188;2431;2454;9.73;0.59;206.74;3.47;763;16;802.00;23
1668;16;625730079;1668;193;2440;2458;9.74;0.59;206.74;3.51;772;16;803.00;18
1673;16;625730091;1673;193;2440;2458;9.67;0.59;206.46;3.51;767;16;804.00;18
1674;16;625730103;1674;200;2440;2458;9.62;0.59;206.42;3.51;766;16;805.00;18
1678;16;625730114;1678;205;2441;2458;9.53;0.58;206.16;3.54;763;16;806.00;17
1679;16;625730125;1679;212;2446;2464;9.48;0.58;206.26;3.55;767;16;807.00;18
1679;16;625730138;1679;223;2447;2464;9.48;0.58;206.26;3.55;768;16;808.00;17
1681;16;625730149;1681;226;2450;2464;9.43;0.57;206.20;3.59;769;16;809.00;14
1681;16;625730163;1681;238;2454;2470;9.45;0.58;206.20;3.60;773;16;810.00;16
1682;16;625730174;1682;239;2455;2470;9.40;0.57;206.11;3.61;773;16;811.00;15
1686;16;625730185;1686;246;2458;2470;9.30;0.57;205.90;3.65;772;16;812.00;12
1688;16;625730201;1688;247;2459;2471;9.09;0.55;205.82;3.66;771;16;813.00;12
1692;16;625730212;1692;254;2463;2472;8.88;0.54;205.55;3.70;771;16;814.00;9
1695;16;625730223;1695;259;2465;2472;8.67;0.53;205.61;3.70;770;16;815.00;7
1697;16;625730235;1697;267;2474;2485;8.57;0.52;205.74;3.70;777;16;816.00;11
1697;16;625730246;1697;276;2479;2485;8.54;0.52;205.74;3.74;782;16;817.00;6
1698;16;625730257;1698;283;2480;2485;8.51;0.52;205.68;3.75;782;16;818.00;5
1701;16;625730267;1701;287;2482;2486;8.49;0.52;205.45;3.75;781;16;819.00;4
1701;16;625730277;1701;290;2484;2486;8.45;0.52;205.45;3.76;783;16;820.00;2
1702;16;625730288;1702;295;2488;2490;8.42;0.51;205.34;3.75;786;16;821.00;2
1702;16;625730298;1702;305;2490;2490;8.42;0.51;205.34;3.75;788;16;822.00;0
1703;16;625730309;1703;316;2494;2494;8.33;0.51;205.28;3.75;791;16;823.00;0
1704;16;625730320;1704;318;2494;2494;8.21;0.50;205.24;3.75;790;16;824.00;0
1705;16;625730330;1705;326;2494;2494;8.04;0.49;205.22;3.75;789;16;825.00;0
1708;16;625730340;1708;335;2494;2494;7.86;0.48;205.17;3.75;786;16;826.00;0
1709;16;625730350;1709;328;2494;2494;7.74;0.47;205.11;3.75;785;16;827.00;0
1712;16;625730359;1712;321;2505;2506;7.74;0.47;205.02;3.73;793;16;828.00;1
1715;16;625730371;1715;314;2506;2506;7.71;0.47;204.91;3.73;791;16;829.00;0
1717;16;625730381;1717;311;2506;2506;7.68;0.47;205.03;3.73;789;16;830.00;0
1717;16;625730391;1717;302;2506;2506;7.71;0.47;205.03;3.73;789;16;831.00;0
1718;16;625730401;1718;298;2506;2506;7.77;0.47;204.97;3.73;788;16;832.00;0
1719;16;625730411;1719;292;2506;2506;7.79;0.48;204.98;3.73;787;16;833.00;0
1719;16;625730431;1719;291;2507;2507;7.81;0.48;204.98;3.73;788;16;834.00;0
1720;16;625730442;1720;289;2507;2507;7.91;0.48;204.93;3.73;787;16;835.00;0
1721;16;625730452;1721;287;2512;2513;8.07;0.49;204.90;3.73;791;16;836.00;1
1722;16;625730464;1722;286;2514;2514;8.19;0.50;204.85;3.72;792;16;837.00;0
1723;16;625730475;1723;287;2514;2514;8.25;0.50;204.86;3.72;791;16;838.00;0
1723;16;625730487;1723;286;2514;2514;8.29;0.51;204.86;3.72;791;16;839.00;0
1723;16;625730505;1723;289;2519;2519;8.37;0.51;204.86;3.72;796;16;840.00;0
1724;16;625730521;1724;289;2519;2519;8.31;0.51;204.94;3.72;795;16;841.00;0
1728;16;625730538;1728;295;2519;2519;8.21;0.50;204.72;3.72;791;16;842.00;0
1731;16;625730553;1731;298;2520;2520;8.14;0.50;204.91;3.71;789;16;843.00;0
1734;16;625730570;1734;301;2524;2524;8.02;0.49;205.11;3.71;790;16;844.00;0
1737;16;625730587;1737;306;2524;2524;7.92;0.48;205.13;3.71;787;16;845.00;0
1739;16;625730602;1739;309;2526;2527;7.85;0.48;205.34;3.71;787;16;846.00;1
1742;16;625730614;1742;316;2527;2527;7.85;0.48;205.58;3.71;785;16;847.00;0
1746;16;625730625;1746;310;2527;2527;7.77;0.47;205.89;3.71;781;16;848.00;0
1749;16;625730636;1749;313;2527;2527;7.71;0.47;206.16;3.71;778;16;849.00;0
1752;16;625730648;1752;297;2530;2531;7.74;0.47;206.34;3.70;778;16;850.00;1
1756;16;625730659;1756;282;2530;2531;7.76;0.47;206.59;3.70;774;16;851.00;1
1760;16;625730670;1760;281;2531;2531;7.78;0.48;207.20;3.70;771;16;852.00;0
1762;16;625730684;1762;271;2531;2531;7.94;0.49;207.11;3.70;769;16;853.00;0
1765;16;625730693;1765;265;2532;2532;7.99;0.49;207.37;3.70;767;16;854.00;0
1766;16;625730704;1766;261;2534;2534;8.08;0.50;207.57;3.70;768;16;855.00;0
1774;16;625730713;1774;263;2534;2534;8.13;0.50;207.66;3.70;760;16;856.00;0
1777;16;625730723;1777;248;2535;2535;8.19;0.50;208.12;3.70;758;16;857.00;0
1785;16;625730733;1785;239;2535;2535;8.23;0.50;208.49;3.70;750;16;858.00;0
1788;16;625730752;1788;231;2535;2535;8.29;0.51;208.91;3.70;747;16;859.00;0
1789;16;625730762;1789;225;2535;2535;8.35;0.51;209.03;3.70;746;16;860.00;0
1794;16;625730772;1794;219;2535;2535;8.39;0.51;209.46;3.70;741;16;861.00;0
1796;16;625730781;1796;211;2535;2535;8.45;0.52;209.56;3.70;739;16;862.00;0
1801;16;625730790;1801;205;2535;2535;8.53;0.52;209.87;3.70;734;16;863.00;0
1806;16;625730800;1806;215;2614;2662;8.61;0.53;209.82;3.59;808;16;864.00;48
1808;16;625730821;1808;202;2618;2663;8.71;0.54;209.77;3.58;810;16;865.00;45
1813;16;625730831;1813;200;2623;2663;8.81;0.55;210.06;3.58;810;16;866.00;40
1817;16;625730842;1817;195;2627;2663;8.96;0.55;210.39;3.58;810;16;867.00;36
1820;16;625730853;1820;188;2629;2663;9.04;0.56;210.34;3.58;809;16;868.00;34
1825;16;625730863;1825;187;2631;2663;9.07;0.56;210.74;3.58;806;16;869.00;32
1831;16;625730876;1831;185;2634;2663;9.06;0.56;210.79;3.58;803;16;870.00;29
1833;16;625730887;1833;188;2637;2663;9.03;0.56;210.84;3.59;804;16;871.00;26
1837;16;625730898;1837;194;2640;2664;9.07;0.56;210.81;3.59;803;16;872.00;24
1838;16;625730910;1838;197;2643;2665;9.14;0.56;210.88;3.60;805;16;873.00;22
1842;16;625730921;1842;205;2646;2665;9.13;0.56;211.28;3.61;804;16;874.00;19
1846;16;625730934;1846;208;2650;2666;9.11;0.56;211.34;3.61;804;16;875.00;16
1852;16;625730946;1852;225;2653;2666;9.09;0.56;211.84;3.62;801;16;876.00;13
1859;16;625730957;1859;227;2656;2666;9.04;0.56;212.05;3.63;797;16;877.00;10
1863;16;625730971;1863;230;2659;2666;9.07;0.56;212.14;3.64;796;16;878.00;7
1869;16;625730986;1869;226;2663;2670;9.10;0.56;212.36;3.66;794;16;879.00;7
1872;16;625731002;1872;231;2666;2670;9.14;0.56;212.41;3.67;794;16;880.00;4
1875;16;625731017;1875;234;2668;2670;9.18;0.56;212.57;3.67;793;16;881.00;2
1880;16;625731031;1880;229;2671;2673;9.19;0.56;212.59;3.67;791;16;882.00;2
1886;16;625731046;1886;226;2671;2673;9.22;0.56;212.69;3.67;785;16;883.00;2
1892;16;625731061;1892;223;2672;2673;9.18;0.56;212.56;3.67;780;16;884.00;1
1897;16;625731075;1897;223;2676;2677;9.17;0.56;212.48;3.66;779;16;885.00;1
1900;16;625731089;1900;223;2678;2678;9.18;0.56;212.54;3.66;778;16;886.00;0
1902;16;625731102;1902;222;2678;2678;9.22;0.56;212.64;3.66;776;16;887.00;0
1904;16;625731116;1904;225;2682;2682;9.36;0.57;212.71;3.66;778;16;888.00;0
1913;16;625731136;1913;229;2682;2682;9.40;0.57;212.85;3.66;769;16;889.00;0
1914;16;625731150;1914;224;2682;2682;9.49;0.58;212.82;3.66;768;16;890.00;0
1919;16;625731164;1919;224;2683;2683;9.51;0.58;212.87;3.66;764;16;891.00;0
1924;16;625731179;1924;222;2683;2683;9.50;0.58;212.96;3.66;759;16;892.00;0
1926;16;625731195;1926;225;2688;2689;9.51;0.58;213.00;3.65;762;16;893.00;1
1929;17;625731217;1929;227;2688;2689;9.47;0.58;213.27;3.65;759;17;894.00;1
1932;17;625731259;1932;228;2690;2690;9.42;0.58;213.44;3.65;758;17;895.00;0
1937;17;625731271;1937;235;2690;2690;9.29;0.57;213.53;3.65;753;17;896.00;0
1939;17;625731290;1939;220;2690;2690;9.25;0.57;213.79;3.65;751;17;897.00;0
1941;17;625731302;1941;206;2690;2690;9.29;0.57;213.97;3.65;749;17;898.00;0
1946;17;625731314;1946;201;2690;2690;9.22;0.56;214.49;3.65;744;17;899.00;0
1948;17;625731328;1948;205;2718;2736;9.16;0.56;214.65;3.61;770;17;900.00;18
1953;17;625731350;1953;199;2720;2736;9.14;0.56;214.99;3.61;767;17;901.00;16
1957;17;625731363;1957;198;2722;2736;9.19;0.56;214.95;3.61;765;17;902.00;14
1960;17;625731374;1960;195;2722;2736;9.24;0.57;214.99;3.61;762;17;903.00;14
1963;17;625731387;1963;195;2723;2736;9.28;0.57;215.04;3.61;760;17;904.00;13
1968;17;625731398;1968;198;2723;2736;9.28;0.57;215.13;3.61;755;17;905.00;13
1970;17;625731417;1970;186;2729;2740;9.29;0.57;215.26;3.61;759;17;906.00;11
1974;17;625731430;1974;177;2730;2740;9.31;0.57;215.41;3.61;756;17;907.00;10
1977;17;625731442;1977;169;2734;2744;9.35;0.57;215.59;3.61;757;17;908.00;10
1980;17;625731455;1980;166;2735;2745;9.39;0.57;215.72;3.61;755;17;909.00;10
1984;17;625731466;1984;167;2736;2745;9.40;0.57;215.81;3.61;752;17;910.00;9
1987;17;625731480;1987;166;2736;2745;9.45;0.58;215.97;3.61;749;17;911.00;9
1990;17;625731497;1990;168;2745;2758;9.56;0.58;216.10;3.60;755;17;912.00;13
1995;17;625731510;1995;168;2746;2758;9.57;0.58;216.26;3.60;751;17;913.00;12
1996;17;625731524;1996;171;2746;2758;9.62;0.59;216.25;3.60;750;17;914.00;12
2000;17;625731537;2000;172;2747;2759;9.65;0.59;216.20;3.60;747;17;915.00;12
2002;17;625731549;2002;179;2748;2760;9.61;0.59;216.24;3.61;746;17;916.00;12
2005;17;625731562;2005;175;2749;2760;9.55;0.58;216.16;3.61;744;17;917.00;11
2005;17;625731574;2005;173;2752;2763;9.58;0.59;216.16;3.61;747;17;918.00;11
2009;17;625731586;2009;170;2752;2763;9.64;0.59;216.16;3.61;743;17;919.00;11
2013;17;625731599;2013;169;2752;2763;9.61;0.59;216.42;3.61;739;17;920.00;11
2017;17;625731611;2017;171;2753;2763;9.63;0.58;216.38;3.61;736;17;921.00;10
2018;17;625731623;2018;162;2757;2769;9.70;0.59;216.51;3.61;739;17;922.00;12
2022;18;625731635;2022;157;2757;2769;9.67;0.59;216.56;3.61;735;18;923.00;12
2025;18;625731663;2025;158;2759;2769;9.70;0.59;216.60;3.62;734;18;924.00;10
2031;18;625731680;2031;155;2759;2769;9.69;0.59;216.79;3.62;728;18;925.00;10
2031;18;625731691;2031;159;2763;2773;9.64;0.58;216.79;3.62;732;18;926.00;10
2034;18;625731703;2034;156;2765;2774;9.60;0.58;216.74;3.62;731;18;927.00;9
2035;18;625731714;2035;158;2765;2774;9.57;0.58;216.74;3.62;730;18;928.00;9
2038;18;625731725;2038;161;2766;2775;9.47;0.57;216.66;3.62;728;18;929.00;9
2039;18;625731738;2039;169;2768;2775;9.37;0.57;216.69;3.64;729;18;930.00;7
2041;18;625731754;2041;171;2769;2775;9.37;0.57;216.75;3.64;728;18;931.00;6
2041;18;625731769;2041;176;2769;2775;9.35;0.57;216.75;3.64;728;18;932.00;6
2043;18;625731780;2043;184;2770;2775;9.29;0.56;216.74;3.65;727;18;933.00;5
2044;18;625731790;2044;190;2770;2775;9.24;0.56;216.88;3.65;726;18;934.00;5
2044;18;625731801;2044;198;2771;2775;9.19;0.56;216.88;3.65;727;18;935.00;4
2045;18;625731811;2045;216;2813;2845;8.96;0.55;216.91;3.60;768;18;936.00;32
2045;18;625731829;2045;214;2815;2846;8.99;0.55;216.91;3.61;770;18;937.00;31
2049;18;625731844;2049;217;2822;2846;9.04;0.55;217.13;3.60;773;18;938.00;24
2051;18;625731854;2051;219;2825;2846;9.07;0.55;217.13;3.60;774;18;939.00;21
2053;18;625731865;2053;214;2828;2846;9.06;0.55;217.09;3.60;775;18;940.00;18
2054;18;625731875;2054;217;2830;2846;9.08;0.55;217.07;3.60;776;18;941.00;16
2056;18;625731886;2056;221;2834;2846;9.09;0.56;217.15;3.61;778;18;942.00;12
2057;18;625731897;2057;227;2835;2846;9.19;0.56;217.09;3.61;778;18;943.00;11
2059;18;625731908;2059;223;2839;2847;9.28;0.57;217.13;3.62;780;18;944.00;8
2061;18;625731919;2061;223;2843;2849;9.28;0.57;217.23;3.62;782;18;945.00;6
2064;18;625731930;2064;217;2844;2849;9.19;0.56;217.23;3.62;780;18;946.00;5
2066;18;625731941;2066;215;2847;2853;9.19;0.56;217.16;3.61;781;18;947.00;6
2069;18;625731952;2069;214;2847;2853;9.09;0.56;217.36;3.61;778;18;948.00;6
2073;18;625731962;2073;210;2847;2853;8.99;0.55;217.66;3.61;774;18;949.00;6
2077;18;625731973;2077;210;2847;2853;8.87;0.54;217.67;3.61;770;18;950.00;6
2079;18;625731984;2079;210;2850;2859;8.76;0.54;217.55;3.61;771;18;951.00;9
2080;18;625731994;2080;201;2850;2859;8.66;0.53;217.66;3.61;770;18;952.00;9
2083;18;625732005;2083;198;2852;2859;8.63;0.53;217.60;3.62;769;18;953.00;7
2087;18;625732016;2087;195;2854;2862;8.60;0.53;217.58;3.62;767;18;954.00;8
2092;18;625732026;2092;191;2857;2862;8.55;0.53;217.44;3.63;765;18;955.00;5
2098;18;625732037;2098;188;2857;2862;8.56;0.52;217.28;3.63;759;18;956.00;5
2100;18;625732048;2100;188;2857;2863;8.61;0.53;217.37;3.63;757;18;957.00;6
2105;18;625732057;2105;189;2858;2864;8.62;0.53;217.34;3.63;753;18;958.00;6
2109;18;625732068;2109;188;2858;2864;8.58;0.52;217.29;3.63;749;18;959.00;6
2111;18;625732081;2111;192;2875;2890;8.57;0.52;217.20;3.61;764;18;960.00;15
2111;18;625732093;2111;186;2876;2890;8.63;0.53;217.20;3.60;765;18;961.00;14
2114;18;625732103;2114;192;2878;2890;8.70;0.53;216.99;3.60;764;18;962.00;12
2118;18;625732115;2118;194;2879;2891;8.70;0.53;216.85;3.60;761;18;963.00;12
2118;18;625732126;2118;196;2879;2891;8.72;0.53;216.85;3.60;761;18;964.00;12
2122;18;625732136;2122;200;2881;2895;8.74;0.53;216.69;3.60;759;18;965.00;14
2123;18;625732147;2123;208;2882;2895;8.80;0.54;216.64;3.60;759;18;966.00;13
2128;18;625732158;2128;213;2885;2899;8.74;0.53;216.42;3.60;757;18;967.00;14
2129;18;625732169;2129;220;2885;2899;8.82;0.54;216.40;3.60;756;18;968.00;14
2131;18;625732180;2131;224;2888;2899;8.86;0.54;216.27;3.63;757;18;969.00;11
2133;18;625732190;2133;225;2888;2899;8.84;0.54;216.12;3.63;755;18;970.00;11
2135;18;625732200;2135;225;2889;2899;8.83;0.54;216.14;3.64;754;18;971.00;10
2136;19;625732211;2136;228;2899;2911;8.80;0.54;216.16;3.64;763;19;972.00;12
2138;19;625732238;2138;230;2900;2911;8.71;0.53;216.15;3.64;762;19;973.00;11
2140;19;625732249;2140;236;2902;2911;8.68;0.53;216.19;3.64;762;19;974.00;9
2141;19;625732260;2141;235;2902;2911;8.65;0.53;216.21;3.64;761;19;975.00;9
2142;19;625732270;2142;234;2902;2911;8.67;0.53;216.23;3.64;760;19;976.00;9
2143;19;625732280;2143;241;2903;2911;8.59;0.53;216.24;3.64;760;19;977.00;8
2144;19;625732290;2144;247;2904;2912;8.59;0.53;216.25;3.65;760;19;978.00;8
2147;19;625732300;2147;243;2904;2912;8.59;0.52;216.29;3.65;757;19;979.00;8
2149;19;625732316;2149;237;2911;2918;8.60;0.52;216.23;3.67;762;19;980.00;7
2152;19;625732327;2152;235;2913;2919;8.63;0.52;216.20;3.66;761;19;981.00;6
2153;19;625732339;2153;242;2913;2919;8.67;0.53;216.17;3.66;760;19;982.00;6
2155;19;625732349;2155;237;2915;2919;8.69;0.53;216.09;3.68;760;19;983.00;4
2159;19;625732360;2159;226;2918;2923;8.71;0.53;216.00;3.67;759;19;984.00;5
2161;19;625732371;2161;222;2918;2923;8.73;0.53;215.98;3.67;757;19;985.00;5
2162;19;625732382;2162;220;2920;2923;8.76;0.53;215.92;3.68;758;19;986.00;3
2163;19;625732393;2163;222;2921;2924;8.80;0.53;215.94;3.68;758;19;987.00;3
2165;19;625732403;2165;224;2926;2928;8.86;0.54;215.84;3.68;761;19;988.00;2
2165;19;625732414;2165;222;2927;2928;8.98;0.54;215.84;3.68;762;19;989.00;1
2165;19;625732426;2165;220;2931;2934;9.02;0.55;215.84;3.68;766;19;990.00;3
2167;19;625732448;2167;221;2932;2934;9.05;0.55;215.79;3.68;765;19;991.00;2
2170;19;625732459;2170;226;2933;2934;9.06;0.55;215.71;3.68;763;19;992.00;1
2170;19;625732476;2170;228;2933;2934;9.02;0.55;215.71;3.68;763;19;993.00;1
2172;19;625732487;2172;231;2936;2938;9.01;0.55;215.72;3.68;764;19;994.00;2
2172;19;625732504;2172;233;2937;2938;8.92;0.54;215.72;3.68;765;19;995.00;1
2173;19;625732523;2173;234;2937;2938;8.82;0.54;215.68;3.68;764;19;996.00;1
2174;19;625732539;2174;237;2938;2938;8.72;0.53;215.67;3.68;764;19;997.00;0
2176;19;625732557;2176;239;2939;2939;8.59;0.52;215.78;3.68;763;19;998.00;0
2177;19;625732574;2177;235;2940;2940;8.57;0.52;215.71;3.67;763;19;999.00;0
2181;19;625732592;2181;232;2940;2940;8.44;0.51;215.66;3.67;759;19;1000.00;0
2182;19;625732620;2182;232;2941;2941;8.37;0.51;215.63;3.67;759;19;1001.00;0
2184;19;625732630;2184;234;2941;2941;8.34;0.51;215.51;3.67;757;19;1002.00;0
2186;19;625732640;2186;232;2941;2941;8.37;0.51;215.51;3.67;755;19;1003.00;0
2188;19;625732650;2188;224;2941;2941;8.38;0.51;215.65;3.67;753;19;1004.00;0
2190;19;625732660;2190;225;2941;2941;8.37;0.51;215.65;3.67;751;19;1005.00;0
2191;19;625732669;2191;225;2941;2941;8.41;0.51;215.65;3.67;750;19;1006.00;0
2193;19;625732679;2193;226;2941;2941;8.39;0.51;215.89;3.67;748;19;1007.00;0
2193;19;625732688;2193;252;3018;3068;8.50;0.53;215.89;3.58;825;19;1008.00;50
2194;19;625732709;2194;244;3023;3069;8.51;0.53;215.99;3.58;829;19;1009.00;46
2196;19;625732720;2196;236;3030;3069;8.57;0.53;216.18;3.57;834;19;1010.00;39
2199;19;625732730;2199;232;3037;3069;8.59;0.53;216.19;3.57;838;19;1011.00;32
2203;19;625732740;2203;234;3043;3069;8.59;0.53;216.51;3.57;840;19;1012.00;26
2207;19;625732750;2207;233;3047;3069;8.53;0.53;216.64;3.57;840;19;1013.00;22
2213;19;625732760;2213;233;3052;3069;8.48;0.52;216.58;3.58;839;19;1014.00;17
2216;19;625732771;2216;235;3054;3069;8.39;0.52;216.69;3.58;838;19;1015.00;15
2219;19;625732782;2219;245;3057;3070;8.32;0.51;216.66;3.58;838;19;1016.00;13
2225;19;625732792;2225;254;3058;3071;8.21;0.50;216.73;3.58;833;19;1017.00;13
2230;19;625732803;2230;263;3060;3071;8.10;0.50;216.81;3.59;830;19;1018.00;11
2230;19;625732813;2230;262;3061;3072;8.02;0.49;216.81;3.59;831;19;1019.00;11
2235;19;625732825;2235;253;3063;3072;7.94;0.49;217.03;3.59;828;19;1020.00;9
2240;19;625732835;2240;252;3064;3072;7.88;0.48;217.40;3.60;824;19;1021.00;8
2241;19;625732846;2241;241;3065;3072;7.84;0.48;217.49;3.60;824;19;1022.00;7
2245;19;625732856;2245;240;3068;3076;7.84;0.48;217.86;3.60;823;19;1023.00;8
2248;19;625732868;2248;246;3069;3076;7.81;0.48;218.16;3.61;821;19;1024.00;7
2253;19;625732879;2253;240;3071;3076;7.81;0.48;218.55;3.61;818;19;1025.00;5
2257;19;625732890;2257;244;3073;3079;7.89;0.48;218.70;3.62;816;19;1026.00;6
2260;19;625732909;2260;241;3075;3079;7.93;0.49;218.65;3.62;815;19;1027.00;4
2264;19;625732920;2264;234;3077;3079;7.98;0.49;219.03;3.63;813;19;1028.00;2
2267;19;625732932;2267;228;3083;3083;8.03;0.49;219.15;3.62;816;19;1029.00;0
2269;19;625732944;2269;227;3084;3084;8.19;0.50;219.13;3.62;815;19;1030.00;0
2274;19;625732956;2274;220;3084;3084;8.30;0.51;219.46;3.62;810;19;1031.00;0
2277;19;625732968;2277;212;3088;3088;8.47;0.52;219.60;3.62;811;19;1032.00;0
2279;19;625732981;2279;209;3088;3088;8.52;0.52;219.75;3.62;809;19;1033.00;0
2285;19;625732992;2285;205;3088;3088;8.57;0.52;219.95;3.62;803;19;1034.00;0
2286;19;625733004;2286;200;3090;3090;8.65;0.53;219.91;3.61;804;19;1035.00;0
2291;19;625733015;2291;196;3090;3090;8.68;0.53;220.24;3.61;799;19;1036.00;0
2294;20;625733034;2294;193;3095;3096;8.77;0.54;220.33;3.61;801;20;1037.00;1
2296;20;625733056;2296;190;3095;3096;8.89;0.55;220.37;3.61;799;20;1038.00;1
2302;20;625733073;2302;193;3097;3097;8.91;0.55;220.54;3.61;795;20;1039.00;0
2304;20;625733088;2304;196;3097;3097;8.96;0.55;220.73;3.61;793;20;1040.00;0
2311;20;625733101;2311;197;3097;3097;8.97;0.55;221.13;3.61;786;20;1041.00;0
2317;20;625733130;2317;191;3097;3097;8.99;0.55;221.31;3.61;780;20;1042.00;0
2321;20;625733151;2321;188;3097;3097;9.06;0.56;221.54;3.61;776;20;1043.00;0
2325;20;625733162;2325;184;3108;3109;9.26;0.57;221.87;3.60;783;20;1044.00;1
2333;20;625733182;2333;179;3108;3109;9.24;0.57;222.00;3.60;775;20;1045.00;1
2338;20;625733195;2338;176;3109;3109;9.32;0.57;222.23;3.60;771;20;1046.00;0
2344;20;625733208;2344;179;3109;3109;9.37;0.57;222.44;3.60;765;20;1047.00;0
2349;20;625733220;2349;176;3109;3109;9.39;0.57;222.55;3.60;760;20;1048.00;0
2356;20;625733233;2356;175;3109;3109;9.43;0.57;222.64;3.60;753;20;1049.00;0
2360;20;625733247;2360;180;3115;3115;9.50;0.58;222.85;3.59;755;20;1050.00;0
2368;20;625733260;2368;182;3115;3115;9.57;0.58;223.62;3.59;747;20;1051.00;0
2370;20;625733273;2370;186;3118;3119;9.72;0.59;223.77;3.59;748;20;1052.00;1
2374;20;625733285;2374;189;3120;3120;9.77;0.59;224.01;3.59;746;20;1053.00;0
2379;20;625733297;2379;186;3120;3120;9.76;0.59;224.28;3.59;741;20;1054.00;0
2384;20;625733307;2384;187;3120;3120;9.74;0.59;224.48;3.59;736;20;1055.00;0
2390;20;625733320;2390;188;3133;3133;9.68;0.59;224.68;3.57;743;20;1056.00;0
2393;20;625733332;2393;184;3133;3133;9.68;0.59;224.71;3.57;740;20;1057.00;0
2395;20;625733344;2395;182;3133;3133;9.73;0.59;224.74;3.57;738;20;1058.00;0
2400;20;625733354;2400;184;3134;3134;9.72;0.59;224.71;3.57;734;20;1059.00;0
2403;20;625733366;2403;187;3135;3135;9.69;0.59;224.64;3.57;732;20;1060.00;0
2410;20;625733377;2410;189;3135;3135;9.64;0.59;224.75;3.57;725;20;1061.00;0
2413;20;625733390;2413;195;3137;3138;9.69;0.59;224.73;3.57;724;20;1062.00;1
2416;20;625733402;2416;193;3137;3138;9.69;0.59;224.82;3.57;721;20;1063.00;1
2421;20;625733412;2421;195;3138;3138;9.65;0.59;225.01;3.57;717;20;1064.00;0
2425;20;625733423;2425;197;3138;3138;9.56;0.58;224.91;3.57;713;20;1065.00;0
2430;20;625733434;2430;200;3143;3144;9.52;0.58;224.84;3.56;713;20;1066.00;1
2431;20;625733446;2431;189;3143;3144;9.44;0.57;224.89;3.56;712;20;1067.00;1
2434;20;625733457;2434;184;3144;3144;9.39;0.57;224.99;3.56;710;20;1068.00;0
2437;20;625733468;2437;189;3144;3144;9.36;0.57;225.18;3.56;707;20;1069.00;0
2439;20;625733478;2439;189;3147;3148;9.36;0.57;225.18;3.56;708;20;1070.00;1
2444;20;625733490;2444;190;3148;3149;9.35;0.57;225.31;3.56;704;20;1071.00;1
2447;20;625733503;2447;192;3149;3149;9.35;0.57;225.31;3.56;702;20;1072.00;0
2450;20;625733513;2450;194;3150;3150;9.35;0.57;225.63;3.56;700;20;1073.00;0
2453;20;625733524;2453;196;3150;3150;9.32;0.57;225.83;3.56;697;20;1074.00;0
2456;20;625733534;2456;200;3150;3150;9.31;0.57;225.81;3.56;694;20;1075.00;0
2460;20;625733545;2460;192;3150;3150;9.27;0.56;225.87;3.56;690;20;1076.00;0
2462;20;625733556;2462;181;3150;3150;9.28;0.57;225.92;3.56;688;20;1077.00;0
2465;20;625733572;2465;170;3150;3150;9.37;0.57;225.88;3.56;685;20;1078.00;0
2469;20;625733582;2469;165;3150;3150;9.34;0.57;226.01;3.56;681;20;1079.00;0
2473;20;625733605;2473;193;3235;3275;9.12;0.56;226.25;3.46;762;20;1080.00;40
2474;20;625733625;2474;176;3240;3276;9.10;0.56;226.22;3.46;766;20;1081.00;36
2475;20;625733637;2475;168;3248;3276;9.11;0.56;226.33;3.46;773;20;1082.00;28
2476;20;625733648;2476;160;3250;3276;9.13;0.56;226.37;3.46;774;20;1083.00;26
2479;20;625733659;2479;161;3254;3276;9.13;0.56;226.35;3.46;775;20;1084.00;22
2483;20;625733670;2483;164;3257;3276;9.13;0.56;226.39;3.46;774;20;1085.00;19
2485;20;625733680;2485;173;3261;3276;9.10;0.56;226.42;3.46;776;20;1086.00;15
2488;20;625733691;2488;162;3262;3276;9.04;0.56;226.41;3.46;774;20;1087.00;14
2489;20;625733702;2489;163;3265;3277;9.06;0.56;226.53;3.47;776;20;1088.00;12
2494;20;625733713;2494;170;3265;3278;8.97;0.55;226.53;3.47;771;20;1089.00;13
2495;20;625733724;2495;170;3267;3278;8.85;0.54;226.58;3.47;772;20;1090.00;11
2498;20;625733735;2498;167;3273;3282;8.76;0.54;226.57;3.47;775;20;1091.00;9
2498;20;625733746;2498;179;3275;3282;8.67;0.53;226.57;3.47;777;20;1092.00;7
2498;20;625733756;2498;181;3276;3282;8.62;0.53;226.57;3.48;778;20;1093.00;6
2500;20;625733766;2500;183;3277;3282;8.57;0.53;226.50;3.48;777;20;1094.00;5
2500;20;625733777;2500;191;3282;3288;8.50;0.52;226.50;3.48;782;20;1095.00;6
2504;20;625733788;2504;198;3282;3288;8.51;0.52;226.49;3.48;778;20;1096.00;6
2505;20;625733798;2505;205;3283;3288;8.53;0.52;226.43;3.48;778;20;1097.00;5
2506;20;625733809;2506;213;3285;3291;8.51;0.52;226.38;3.47;779;20;1098.00;6
2506;20;625733819;2506;214;3285;3291;8.51;0.52;226.38;3.47;779;20;1099.00;6
2507;20;625733835;2507;216;3286;3291;8.45;0.52;226.35;3.47;779;20;1100.00;5
2508;20;625733849;2508;225;3287;3292;8.40;0.52;226.33;3.47;779;20;1101.00;5
2510;20;625733859;2510;230;3288;3293;8.43;0.52;226.36;3.47;778;20;1102.00;5
2511;20;625733869;2511;231;3288;3293;8.42;0.52;226.32;3.47;777;20;1103.00;5
2511;20;625733879;2511;237;3298;3306;8.43;0.52;226.32;3.46;787;20;1104.00;8
2514;20;625733895;2514;243;3298;3306;8.46;0.52;226.33;3.46;784;20;1105.00;8
2516;20;625733905;2516;244;3298;3306;8.45;0.52;226.23;3.46;782;20;1106.00;8
2519;20;625733920;2519;253;3299;3307;8.46;0.52;226.16;3.46;780;20;1107.00;8
2522;20;625733930;2522;255;3299;3307;8.46;0.52;226.07;3.46;777;20;1108.00;8
2524;20;625733940;2524;262;3302;3311;8.51;0.52;226.08;3.46;778;20;1109.00;9
2525;20;625733951;2525;258;3303;3311;8.53;0.52;226.02;3.46;778;20;1110.00;8
2528;20;625733961;2528;258;3306;3315;8.48;0.52;225.89;3.45;778;20;1111.00;9
2530;20;625733972;2530;257;3306;3315;8.49;0.52;226.02;3.45;776;20;1112.00;9
2536;20;625733981;2536;257;3306;3315;8.43;0.52;225.91;3.45;770;20;1113.00;9
2538;20;625733991;2538;254;3306;3315;8.39;0.51;225.80;3.45;768;20;1114.00;9
2544;20;625734001;2544;253;3306;3315;8.33;0.51;225.57;3.45;762;20;1115.00;9
2545;20;625734010;2545;256;3316;3327;8.39;0.52;225.52;3.44;771;20;1116.00;11
2549;20;625734020;2549;251;3317;3327;8.39;0.51;225.50;3.44;768;20;1117.00;10
2551;20;625734029;2551;247;3318;3327;8.40;0.52;225.48;3.45;767;20;1118.00;9
2554;20;625734038;2554;243;3318;3327;8.41;0.52;225.50;3.45;764;20;1119.00;9
2555;20;625734047;2555;237;3318;3327;8.35;0.51;225.51;3.45;763;20;1120.00;9
2561;20;625734055;2561;237;3318;3327;8.27;0.51;225.50;3.45;757;20;1121.00;9
2564;20;625734065;2564;233;3318;3328;8.21;0.50;225.39;3.45;754;20;1122.00;10
2564;20;625734074;2564;232;3320;3328;8.20;0.50;225.39;3.47;756;20;1123.00;8
2569;20;625734082;2569;227;3324;3334;8.09;0.49;225.29;3.47;755;20;1124.00;10
2570;20;625734091;2570;227;3330;3336;8.05;0.49;225.33;3.49;760;20;1125.00;6
2573;20;625734105;2573;228;3330;3336;8.02;0.49;225.31;3.49;757;20;1126.00;6
2578;20;625734115;2578;229;3330;3336;8.01;0.49;225.16;3.49;752;20;1127.00;6
2578;20;625734124;2578;229;3333;3340;8.08;0.49;225.16;3.49;755;20;1128.00;7
2580;20;625734132;2580;225;3334;3340;8.09;0.49;225.11;3.50;754;20;1129.00;6
2582;20;625734142;2582;227;3334;3340;8.09;0.49;225.11;3.50;752;20;1130.00;6
2583;20;625734151;2583;210;3336;3341;8.19;0.50;225.06;3.51;753;20;1131.00;5
2586;20;625734160;2586;196;3339;3345;8.19;0.50;224.91;3.51;753;20;1132.00;6
2587;20;625734169;2587;184;3339;3345;8.27;0.50;224.90;3.51;752;20;1133.00;6
2589;20;625734178;2589;181;3341;3348;8.48;0.51;224.80;3.51;752;20;1134.00;7
2591;20;625734188;2591;173;3342;3348;8.65;0.52;224.80;3.51;751;20;1135.00;6
2591;20;625734197;2591;167;3342;3348;8.77;0.53;224.80;3.51;751;20;1136.00;6
2594;20;625734206;2594;155;3342;3348;8.95;0.54;224.79;3.51;748;20;1137.00;6
2596;20;625734222;2596;153;3345;3352;9.13;0.55;224.67;3.50;749;20;1138.00;7
2598;21;625734232;2598;149;3345;3352;9.28;0.56;224.67;3.50;747;21;1139.00;7
2598;21;625734254;2598;142;3346;3352;9.36;0.57;224.67;3.50;748;21;1140.00;6
2600;22;625734263;2600;137;3346;3352;9.48;0.57;224.62;3.50;746;22;1141.00;6
2600;22;625734285;2600;132;3346;3353;9.59;0.58;224.62;3.50;746;22;1142.00;7
2603;22;625734295;2603;132;3347;3354;9.70;0.59;224.54;3.50;744;22;1143.00;7
2603;22;625734305;2603;134;3347;3354;9.78;0.59;224.54;3.50;744;22;1144.00;7
2603;22;625734315;2603;133;3348;3355;9.91;0.60;224.54;3.50;745;22;1145.00;7
2604;22;625734330;2604;131;3348;3355;9.97;0.61;224.55;3.50;744;22;1146.00;7
2607;23;625734340;2607;136;3348;3355;9.99;0.61;224.58;3.50;741;23;1147.00;7
2608;23;625734361;2608;138;3348;3355;9.98;0.60;224.59;3.50;740;23;1148.00;7
2609;23;625734371;2609;143;3348;3355;9.99;0.61;224.60;3.50;739;23;1149.00;7
2609;23;625734381;2609;144;3349;3355;10.01;0.61;224.60;3.51;740;23;1150.00;6
2609;24;625734390;2609;144;3350;3355;10.04;0.61;224.60;3.52;741;24;1151.00;5
2610;24;625734411;2610;165;3420;3482;10.09;0.62;224.58;3.45;810;24;1152.00;62
2612;24;625734430;2612;158;3426;3483;10.07;0.62;224.67;3.46;814;24;1153.00;57
2615;24;625734448;2615;157;3432;3483;10.12;0.62;224.61;3.45;817;24;1154.00;51
2616;24;625734460;2616;160;3437;3483;10.08;0.62;224.59;3.46;821;24;1155.00;46
2618;24;625734471;2618;158;3446;3483;10.09;0.62;224.50;3.48;828;24;1156.00;37
2620;24;625734483;2620;163;3446;3483;10.08;0.62;224.45;3.48;826;24;1157.00;37
2622;25;625734503;2622;166;3453;3483;10.03;0.62;224.63;3.48;831;25;1158.00;30
2628;25;625734540;2628;167;3455;3483;10.04;0.62;224.69;3.49;827;25;1159.00;28
2630;25;625734558;2630;170;3458;3484;10.04;0.62;224.77;3.49;828;25;1160.00;26
2636;25;625734577;2636;172;3463;3485;10.05;0.62;224.99;3.50;827;25;1161.00;22
2639;25;625734598;2639;172;3465;3485;9.95;0.61;225.08;3.50;826;25;1162.00;20
2641;25;625734613;2641;181;3470;3486;9.84;0.60;225.25;3.51;829;25;1163.00;16
2645;25;625734626;2645;189;3476;3486;9.73;0.60;225.44;3.53;831;25;1164.00;10
2646;25;625734639;2646;193;3478;3486;9.57;0.59;225.38;3.53;832;25;1165.00;8
2650;25;625734651;2650;202;3480;3486;9.36;0.57;225.51;3.54;830;25;1166.00;6
2653;25;625734664;2653;206;3484;3490;9.22;0.57;225.65;3.54;831;25;1167.00;6
2654;25;625734676;2654;215;3486;3490;9.10;0.56;225.60;3.55;832;25;1168.00;4
2656;25;625734689;2656;217;3487;3490;8.94;0.55;225.77;3.55;831;25;1169.00;3
2659;25;625734703;2659;224;3491;3496;8.80;0.54;226.05;3.55;832;25;1170.00;5
2660;25;625734716;2660;223;3491;3496;8.67;0.53;226.20;3.55;831;25;1171.00;5
2661;25;625734728;2661;226;3492;3496;8.58;0.53;226.27;3.55;831;25;1172.00;4
2663;25;625734741;2663;238;3496;3500;8.48;0.52;226.36;3.55;833;25;1173.00;4
2666;25;625734755;2666;235;3498;3501;8.45;0.52;226.38;3.55;832;25;1174.00;3
2670;25;625734766;2670;238;3499;3501;8.47;0.52;226.57;3.55;829;25;1175.00;2
2672;25;625734777;2672;234;3503;3505;8.58;0.53;226.44;3.54;831;25;1176.00;2
2677;25;625734788;2677;231;3504;3505;8.63;0.53;226.60;3.54;827;25;1177.00;1
2681;25;625734800;2681;237;3504;3505;8.61;0.53;226.74;3.54;823;25;1178.00;1
2683;25;625734811;2683;236;3506;3506;8.58;0.52;226.74;3.55;823;25;1179.00;0
2684;25;625734822;2684;239;3506;3506;8.52;0.52;226.82;3.55;822;25;1180.00;0
2690;25;625734832;2690;237;3511;3512;8.45;0.51;226.92;3.54;821;25;1181.00;1
2694;25;625734844;2694;241;3512;3512;8.34;0.51;226.95;3.54;818;25;1182.00;0
2699;25;625734854;2699;244;3513;3513;8.23;0.50;226.86;3.54;814;25;1183.00;0
2704;25;625734864;2704;244;3513;3513;8.10;0.49;226.99;3.54;809;25;1184.00;0
2708;25;625734874;2708;246;3513;3513;7.99;0.49;227.29;3.54;805;25;1185.00;0
2712;25;625734884;2712;251;3513;3513;7.87;0.48;227.33;3.54;801;25;1186.00;0
2716;25;625734893;2716;252;3513;3513;7.72;0.47;227.50;3.54;797;25;1187.00;0
2719;25;625734903;2719;255;3524;3525;7.67;0.47;227.59;3.53;805;25;1188.00;1
2720;25;625734914;2720;257;3524;3525;7.60;0.46;227.70;3.53;804;25;1189.00;1
2725;25;625734924;2725;247;3525;3525;7.48;0.46;227.94;3.53;800;25;1190.00;0
2727;25;625734944;2727;240;3525;3525;7.49;0.46;228.08;3.53;798;25;1191.00;0
2730;25;625734954;2730;236;3525;3525;7.55;0.46;228.12;3.53;795;25;1192.00;0
2731;25;625734964;2731;224;3525;3525;7.59;0.46;228.20;3.53;794;25;1193.00;0
2735;25;625734975;2735;224;3529;3529;7.60;0.46;228.43;3.53;794;25;1194.00;0
2737;25;625734985;2737;222;3529;3529;7.67;0.47;228.48;3.53;792;25;1195.00;0
2741;25;625734994;2741;222;3532;3533;7.73;0.47;228.77;3.52;791;25;1196.00;1
2744;25;625735005;2744;216;3533;3534;7.75;0.47;228.99;3.52;789;25;1197.00;1
2748;25;625735015;2748;211;3534;3534;7.85;0.48;229.00;3.52;786;25;1198.00;0
2749;25;625735025;2749;205;3534;3534;7.95;0.49;229.04;3.52;785;25;1199.00;0
2752;25;625735039;2752;211;3558;3575;7.95;0.49;229.20;3.50;806;25;1200.00;17
2755;25;625735059;2755;200;3559;3575;8.03;0.49;229.28;3.50;804;25;1201.00;16
2760;25;625735070;2760;195;3561;3575;8.07;0.49;229.44;3.50;801;25;1202.00;14
2763;25;625735080;2763;194;3564;3576;8.16;0.50;229.60;3.50;801;25;1203.00;12
2767;25;625735092;2767;198;3568;3577;8.23;0.50;229.67;3.50;801;25;1204.00;9
2770;25;625735103;2770;197;3570;3577;8.26;0.50;229.67;3.50;800;25;1205.00;7
2772;25;625735114;2772;191;3572;3580;8.40;0.51;229.62;3.50;800;25;1206.00;8
2777;25;625735125;2777;189;3573;3580;8.45;0.51;229.82;3.50;796;25;1207.00;7
2781;25;625735136;2781;186;3573;3580;8.51;0.52;229.83;3.50;792;25;1208.00;7
2785;25;625735147;2785;189;3574;3580;8.56;0.52;229.88;3.50;789;25;1209.00;6
2788;25;625735157;2788;185;3579;3586;8.66;0.53;229.91;3.50;791;25;1210.00;7
2791;25;625735169;2791;179;3581;3586;8.60;0.53;229.87;3.50;790;25;1211.00;5
2794;25;625735180;2794;176;3581;3586;8.59;0.53;230.07;3.50;787;25;1212.00;5
2796;25;625735198;2796;176;3582;3586;8.60;0.53;230.05;3.50;786;25;1213.00;4
2799;25;625735210;2799;178;3586;3590;8.66;0.53;230.19;3.49;787;25;1214.00;4
2805;25;625735222;2805;179;3588;3592;8.72;0.53;230.13;3.49;783;25;1215.00;4
2812;25;625735234;2812;182;3588;3592;8.81;0.54;230.62;3.49;776;25;1216.00;4
2818;25;625735245;2818;187;3590;3593;8.90;0.54;230.87;3.50;772;25;1217.00;3
2821;25;625735257;2821;192;3590;3593;8.97;0.55;230.98;3.50;769;25;1218.00;3
2827;25;625735268;2827;196;3590;3593;8.97;0.55;231.28;3.50;763;25;1219.00;3
2829;25;625735280;2829;200;3590;3593;8.95;0.55;231.57;3.50;761;25;1220.00;3
2836;25;625735291;2836;201;3590;3593;8.92;0.55;231.62;3.50;754;25;1221.00;3
2840;25;625735303;2840;206;3590;3593;8.76;0.54;231.78;3.50;750;25;1222.00;3
2844;25;625735315;2844;212;3591;3593;8.68;0.53;231.93;3.50;747;25;1223.00;2
2850;25;625735326;2850;236;3633;3663;8.57;0.53;232.10;3.46;783;25;1224.00;30
2854;25;625735343;2854;232;3635;3664;8.57;0.53;232.21;3.46;781;25;1225.00;29
2857;25;625735354;2857;232;3639;3664;8.64;0.53;232.32;3.46;782;25;1226.00;25
2860;25;625735365;2860;228;3642;3664;8.66;0.53;232.32;3.46;782;25;1227.00;22
2866;25;625735376;2866;232;3646;3666;8.62;0.53;232.37;3.46;780;25;1228.00;20
2869;25;625735387;2869;238;3647;3666;8.62;0.53;232.31;3.46;778;25;1229.00;19
2874;25;625735400;2874;243;3651;3666;8.63;0.53;232.41;3.47;777;25;1230.00;15
2880;25;625735410;2880;243;3652;3666;8.58;0.53;232.36;3.47;772;25;1231.00;14
2883;25;625735420;2883;251;3656;3667;8.58;0.53;232.55;3.47;773;25;1232.00;11
2887;25;625735431;2887;257;3659;3668;8.44;0.52;232.68;3.48;772;25;1233.00;9
2890;25;625735443;2890;268;3663;3668;8.30;0.51;232.59;3.49;773;25;1234.00;5
2896;25;625735453;2896;276;3669;3672;8.16;0.50;232.64;3.49;773;25;1235.00;3
2898;25;625735465;2898;288;3670;3672;8.02;0.49;232.57;3.49;772;25;1236.00;2
2900;25;625735476;2900;284;3670;3672;8.06;0.50;232.78;3.49;770;25;1237.00;2
2901;25;625735487;2901;282;3671;3672;8.04;0.50;232.78;3.49;770;25;1238.00;1
2903;25;625735499;2903;279;3677;3678;8.11;0.50;232.78;3.49;774;25;1239.00;1
2909;25;625735511;2909;279;3678;3678;8.12;0.50;233.09;3.49;769;25;1240.00;0
2913;25;625735523;2913;278;3678;3678;8.17;0.50;232.99;3.49;765;25;1241.00;0
2916;25;625735534;2916;281;3681;3681;8.21;0.50;233.30;3.49;765;25;1242.00;0
2919;25;625735551;2919;284;3681;3681;8.21;0.50;233.28;3.49;762;25;1243.00;0
2922;25;625735562;2922;284;3681;3681;8.18;0.50;233.47;3.49;759;25;1244.00;0
2925;25;625735572;2925;284;3682;3682;8.10;0.49;233.45;3.49;757;25;1245.00;0
2929;25;625735583;2929;269;3683;3683;8.13;0.50;233.53;3.49;754;25;1246.00;0
2931;25;625735599;2931;254;3683;3683;8.11;0.49;233.57;3.49;752;25;1247.00;0
2935;25;625735610;2935;255;3695;3696;8.16;0.50;233.50;3.48;760;25;1248.00;1
2938;25;625735622;2938;245;3696;3696;8.25;0.50;233.50;3.48;758;25;1249.00;0
2938;25;625735632;2938;248;3696;3696;8.33;0.51;233.50;3.48;758;25;1250.00;0
2941;25;625735642;2941;247;3697;3697;8.38;0.51;233.44;3.47;756;25;1251.00;0
2944;25;625735654;2944;244;3697;3697;8.42;0.51;233.34;3.47;753;25;1252.00;0
2945;25;625735664;2945;241;3700;3701;8.51;0.52;233.32;3.47;755;25;1253.00;1
2945;25;625735674;2945;246;3700;3701;8.57;0.52;233.32;3.47;755;25;1254.00;1
2947;25;625735685;2947;244;3705;3705;8.60;0.52;233.30;3.47;758;25;1255.00;0
2950;25;625735695;2950;241;3705;3705;8.61;0.52;233.32;3.47;755;25;1256.00;0
2951;25;625735706;2951;239;3705;3705;8.65;0.53;233.25;3.47;754;25;1257.00;0
2953;25;625735716;2953;237;3705;3705;8.64;0.52;233.20;3.47;752;25;1258.00;0
2955;25;625735726;2955;232;3705;3705;8.58;0.52;233.12;3.47;750;25;1259.00;0
2959;25;625735738;2959;237;3730;3739;8.56;0.52;233.06;3.45;771;25;1260.00;9
2960;25;625735751;2960;231;3730;3739;8.53;0.52;233.02;3.45;770;25;1261.00;9
2962;25;625735761;2962;233;3732;3739;8.59;0.52;232.93;3.45;770;25;1262.00;7
2963;25;625735771;2963;233;3732;3739;8.56;0.52;232.96;3.45;769;25;1263.00;7
2966;25;625735785;2966;233;3734;3739;8.49;0.52;233.01;3.45;768;25;1264.00;5
2968;25;625735795;2968;237;3735;3739;8.43;0.51;232.92;3.45;767;25;1265.00;4
2970;25;625735811;2970;240;3735;3740;8.38;0.51;232.85;3.45;765;25;1266.00;5
2972;25;625735820;2972;244;3737;3740;8.32;0.51;232.81;3.45;765;25;1267.00;3
2973;25;625735829;2973;247;3740;3746;8.29;0.51;232.76;3.45;767;25;1268.00;6
2975;25;625735839;2975;250;3742;3747;8.24;0.50;232.64;3.44;767;25;1269.00;5
2978;26;625735849;2978;252;3743;3747;8.14;0.50;232.57;3.45;765;26;1270.00;4
2979;26;625735868;2979;260;3744;3747;8.03;0.49;232.55;3.45;765;26;1271.00;3
2982;26;625735878;2982;265;3746;3751;7.89;0.48;232.50;3.44;764;26;1272.00;5
2983;26;625735893;2983;271;3747;3751;7.79;0.48;232.64;3.44;764;26;1273.00;4
2987;26;625735906;2987;279;3747;3751;7.66;0.47;232.57;3.44;760;26;1274.00;4
2988;26;625735915;2988;286;3748;3752;7.56;0.46;232.57;3.44;760;26;1275.00;4
2989;26;625735924;2989;296;3751;3756;7.54;0.46;232.55;3.44;762;26;1276.00;5
2992;26;625735933;2992;305;3751;3756;7.51;0.46;232.44;3.44;759;26;1277.00;5
2992;26;625735942;2992;312;3753;3759;7.52;0.46;232.44;3.44;761;26;1278.00;6
2993;26;625735951;2993;321;3754;3759;7.47;0.46;232.45;3.44;761;26;1279.00;5
2995;26;625735959;2995;315;3754;3759;7.45;0.45;232.46;3.44;759;26;1280.00;5
2995;26;625735967;2995;310;3754;3759;7.43;0.45;232.46;3.44;759;26;1281.00;5
2996;26;625735976;2996;303;3757;3763;7.44;0.45;232.45;3.44;761;26;1282.00;6
2999;26;625735985;2999;285;3757;3763;7.47;0.46;232.45;3.44;758;26;1283.00;6
3002;26;625735995;3002;271;3758;3763;7.49;0.46;232.41;3.44;756;26;1284.00;5
3002;26;625736004;3002;256;3758;3763;7.55;0.46;232.41;3.44;756;26;1285.00;5
3004;26;625736012;3004;249;3758;3764;7.59;0.46;232.41;3.44;754;26;1286.00;6
3008;26;625736027;3008;239;3759;3765;7.69;0.47;232.35;3.44;751;26;1287.00;6
3009;26;625736037;3009;235;3759;3765;7.72;0.47;232.34;3.44;750;26;1288.00;6
3012;26;625736046;3012;223;3760;3766;7.76;0.47;232.46;3.44;748;26;1289.00;6
3015;26;625736056;3015;210;3760;3766;7.77;0.47;232.47;3.44;745;26;1290.00;6
3016;26;625736066;3016;201;3760;3766;7.83;0.48;232.44;3.44;744;26;1291.00;6
3019;26;625736074;3019;191;3760;3766;7.88;0.48;232.41;3.44;741;26;1292.00;6
3021;26;625736094;3021;182;3760;3766;7.91;0.48;232.44;3.44;739;26;1293.00;6
3023;26;625736103;3023;178;3761;3766;8.00;0.49;232.39;3.44;738;26;1294.00;5
3025;26;625736112;3025;169;3761;3766;8.03;0.49;232.40;3.44;736;26;1295.00;5
3027;26;625736121;3027;185;3826;3893;8.19;0.50;232.33;3.39;799;26;1296.00;67
3029;26;625736139;3029;172;3826;3894;8.28;0.51;232.29;3.39;797;26;1297.00;68
3031;26;625736149;3031;158;3833;3894;8.46;0.52;232.22;3.39;802;26;1298.00;61
3032;26;625736158;3032;155;3835;3894;8.54;0.53;232.28;3.39;803;26;1299.00;59
3035;26;625736169;3035;150;3839;3894;8.67;0.53;232.27;3.39;804;26;1300.00;55
3035;26;625736183;3035;153;3842;3894;8.72;0.54;232.27;3.39;807;26;1301.00;52
3036;26;625736193;3036;148;3844;3894;8.87;0.54;232.27;3.39;808;26;1302.00;50
3036;26;625736202;3036;145;3846;3894;8.95;0.55;232.27;3.40;810;26;1303.00;48
3039;26;625736212;3039;144;3851;3895;9.04;0.55;232.26;3.40;812;26;1304.00;44
3042;26;625736229;3042;148;3853;3897;9.10;0.56;232.32;3.40;811;26;1305.00;44
3045;26;625736241;3045;143;3858;3897;9.19;0.56;232.39;3.41;813;26;1306.00;39
3047;26;625736252;3047;148;3861;3898;9.25;0.57;232.33;3.42;814;26;1307.00;37
3051;26;625736263;3051;149;3865;3898;9.31;0.57;232.24;3.43;814;26;1308.00;33
3053;26;625736274;3053;148;3869;3898;9.32;0.57;232.19;3.43;816;26;1309.00;29
3055;26;625736285;3055;152;3872;3898;9.28;0.57;232.20;3.44;817;26;1310.00;26
3057;26;625736295;3057;152;3877;3902;9.26;0.57;232.20;3.45;820;26;1311.00;25
3061;26;625736307;3061;163;3881;3902;9.11;0.56;232.22;3.46;820;26;1312.00;21
3064;26;625736320;3064;164;3881;3902;9.07;0.55;232.35;3.46;817;26;1313.00;21
3067;26;625736331;3067;164;3884;3905;9.05;0.55;232.46;3.47;817;26;1314.00;21
3069;26;625736348;3069;161;3886;3905;8.98;0.55;232.49;3.47;817;26;1315.00;19
3072;26;625736360;3072;163;3889;3905;8.99;0.55;232.70;3.49;817;26;1316.00;16
3074;26;625736371;3074;173;3894;3909;8.89;0.54;232.70;3.49;820;26;1317.00;15
3078;26;625736383;3078;173;3896;3910;8.91;0.54;232.73;3.49;818;26;1318.00;14
3082;26;625736395;3082;177;3898;3910;8.99;0.54;232.82;3.50;816;26;1319.00;12
3084;26;625736409;3084;180;3902;3915;9.07;0.55;232.91;3.51;818;26;1320.00;13
3086;26;625736421;3086;184;3904;3915;9.08;0.55;232.99;3.51;818;26;1321.00;11
3088;26;625736434;3088;183;3904;3915;9.06;0.55;233.05;3.51;816;26;1322.00;11
3089;26;625736445;3089;189;3907;3916;9.05;0.55;233.15;3.53;818;26;1323.00;9
3090;26;625736457;3090;191;3907;3916;9.04;0.55;233.23;3.53;817;26;1324.00;9
3095;26;625736470;3095;198;3913;3922;9.06;0.55;233.44;3.54;818;26;1325.00;9
3095;26;625736482;3095;204;3913;3922;9.06;0.55;233.44;3.54;818;26;1326.00;9
3097;26;625736495;3097;199;3915;3923;9.02;0.55;233.56;3.54;818;26;1327.00;8
3098;26;625736512;3098;205;3916;3923;9.00;0.55;233.66;3.55;818;26;1328.00;7
3102;26;625736537;3102;201;3916;3923;8.97;0.55;233.82;3.55;814;26;1329.00;7
3105;26;625736558;3105;202;3917;3923;8.93;0.54;233.98;3.56;812;26;1330.00;6
3107;26;625736575;3107;202;3917;3923;8.92;0.54;234.05;3.56;810;26;1331.00;6
3108;26;625736591;3108;208;3927;3935;9.00;0.55;234.00;3.55;819;26;1332.00;8
3114;26;625736608;3114;209;3932;3935;8.96;0.54;234.25;3.58;818;26;1333.00;3
3116;26;625736622;3116;211;3933;3935;9.02;0.55;234.39;3.58;817;26;1334.00;2
3117;26;625736634;3117;214;3934;3935;9.04;0.55;234.35;3.58;817;26;1335.00;1
3120;26;625736646;3120;217;3934;3935;8.98;0.55;234.44;3.58;814;26;1336.00;1
3122;26;625736657;3122;216;3934;3935;8.96;0.55;234.51;3.58;812;26;1337.00;1
3125;26;625736668;3125;228;3939;3939;8.85;0.54;234.54;3.58;814;26;1338.00;0
3127;26;625736680;3127;222;3939;3939;8.76;0.53;234.59;3.58;812;26;1339.00;0
3130;26;625736690;3130;221;3942;3943;8.74;0.53;234.70;3.58;812;26;1340.00;1
3131;26;625736702;3131;221;3943;3944;8.70;0.53;234.75;3.57;812;26;1341.00;1
3134;26;625736713;3134;220;3944;3944;8.62;0.53;234.87;3.57;810;26;1342.00;0
3134;26;625736724;3134;223;3944;3944;8.62;0.53;234.87;3.57;810;26;1343.00;0
3138;26;625736735;3138;220;3956;3957;8.60;0.53;235.15;3.56;818;26;1344.00;1
3142;26;625736747;3142;221;3957;3957;8.64;0.53;235.32;3.56;815;26;1345.00;0
3144;26;625736758;3144;220;3957;3957;8.68;0.53;235.28;3.56;813;26;1346.00;0
3148;26;625736768;3148;225;3958;3958;8.75;0.53;235.38;3.56;810;26;1347.00;0
3151;26;625736779;3151;223;3959;3959;8.81;0.54;235.71;3.56;808;26;1348.00;0
3153;26;625736790;3153;227;3959;3959;8.86;0.54;235.73;3.56;806;26;1349.00;0
3157;26;625736802;3157;229;3962;3968;8.78;0.54;235.91;3.56;805;26;1350.00;6
3161;26;625736814;3161;231;3963;3968;8.69;0.53;235.94;3.56;802;26;1351.00;5
3164;26;625736824;3164;233;3964;3968;8.62;0.53;236.00;3.56;800;26;1352.00;4
3168;26;625736834;3168;239;3964;3968;8.53;0.52;236.11;3.56;796;26;1353.00;4
3172;26;625736844;3172;232;3969;3974;8.51;0.52;236.17;3.56;797;26;1354.00;5
3175;26;625736854;3175;235;3969;3974;8.48;0.52;236.23;3.56;794;26;1355.00;5
3180;26;625736864;3180;240;3970;3974;8.44;0.52;236.33;3.56;790;26;1356.00;4
3183;26;625736874;3183;244;3970;3974;8.42;0.52;236.60;3.56;787;26;1357.00;4
3187;26;625736883;3187;251;3975;3978;8.28;0.51;236.72;3.55;788;26;1358.00;3
3193;26;625736894;3193;243;3977;3979;8.18;0.50;236.89;3.55;784;26;1359.00;2
3197;26;625736903;3197;233;3978;3979;8.08;0.49;237.02;3.55;781;26;1360.00;1
3205;26;625736913;3205;222;3979;3980;7.93;0.48;237.17;3.55;774;26;1361.00;1
3210;26;625736923;3210;220;3979;3980;7.89;0.48;237.28;3.55;769;26;1362.00;1
3213;26;625736933;3213;216;3979;3980;7.88;0.48;237.27;3.55;766;26;1363.00;1
3217;26;625736942;3217;211;3979;3980;7.97;0.49;237.36;3.55;762;26;1364.00;1
3219;26;625736952;3219;207;3979;3980;8.07;0.49;237.43;3.55;760;26;1365.00;1
3225;26;625736962;3225;207;3979;3980;8.10;0.50;237.56;3.55;754;26;1366.00;1
3229;26;625736973;3229;204;3979;3980;8.15;0.50;237.62;3.55;750;26;1367.00;1
3233;26;625736982;3233;208;4022;4050;8.28;0.51;237.70;3.52;789;26;1368.00;28
3237;26;625736998;3237;199;4027;4051;8.39;0.51;237.65;3.51;790;26;1369.00;24
3239;26;625737008;3239;197;4032;4051;8.58;0.53;237.70;3.51;793;26;1370.00;19
3245;26;625737018;3245;198;4037;4051;8.70;0.53;237.80;3.51;792;26;1371.00;14
3248;26;625737029;3248;196;4041;4051;8.82;0.54;237.83;3.51;793;26;1372.00;10
3253;26;625737040;3253;193;4044;4051;8.86;0.54;237.74;3.51;791;26;1373.00;7
3257;26;625737051;3257;197;4047;4051;8.91;0.54;237.90;3.51;790;26;1374.00;4
3262;26;625737062;3262;200;4047;4051;8.85;0.54;237.89;3.51;785;26;1375.00;4
3266;26;625737074;3266;204;4049;4052;8.86;0.54;237.97;3.51;783;26;1376.00;3
3271;26;625737084;3271;204;4050;4053;8.88;0.54;237.88;3.51;779;26;1377.00;3
3273;26;625737095;3273;206;4051;4053;8.94;0.55;237.87;3.52;778;26;1378.00;2
3279;26;625737106;3279;202;4054;4057;8.96;0.55;237.89;3.51;775;26;1379.00;3
3283;26;625737119;3283;210;4054;4057;9.06;0.55;237.83;3.51;771;26;1380.00;3
3287;26;625737130;3287;214;4054;4057;9.04;0.55;237.72;3.51;767;26;1381.00;3
3292;26;625737151;3292;215;4054;4057;8.96;0.54;237.77;3.51;762;26;1382.00;3
3293;26;625737171;3293;212;4059;4063;9.00;0.55;237.77;3.51;766;26;1383.00;4
3297;26;625737184;3297;216;4060;4063;8.99;0.55;237.88;3.51;763;26;1384.00;3
3302;26;625737198;3302;215;4061;4063;8.97;0.55;237.78;3.51;759;26;1385.00;2
3305;26;625737219;3305;222;4063;4066;8.98;0.55;237.86;3.51;758;26;1386.00;3
3307;26;625737231;3307;227;4063;4066;8.92;0.54;237.81;3.51;756;26;1387.00;3
3316;26;625737250;3316;238;4065;4066;8.79;0.54;238.05;3.52;749;26;1388.00;1
3320;26;625737262;3320;232;4066;4067;8.66;0.53;238.16;3.52;746;26;1389.00;1
3321;26;625737273;3321;234;4068;4068;8.61;0.53;238.18;3.52;747;26;1390.00;0
3329;26;625737284;3329;237;4068;4068;8.45;0.52;238.33;3.52;739;26;1391.00;0
3333;26;625737294;3333;240;4081;4081;8.41;0.51;238.58;3.51;748;26;1392.00;0
3335;26;625737306;3335;244;4081;4081;8.37;0.51;238.65;3.51;746;26;1393.00;0
3339;26;625737317;3339;244;4081;4081;8.32;0.51;238.71;3.51;742;26;1394.00;0
3340;26;625737337;3340;251;4083;4083;8.27;0.51;238.71;3.51;743;26;1395.00;0
3349;26;625737347;3349;259;4083;4083;8.16;0.50;238.70;3.51;734;26;1396.00;0
3353;26;625737359;3353;266;4086;4087;8.07;0.49;238.97;3.51;733;26;1397.00;1
3355;26;625737370;3355;276;4086;4087;8.02;0.49;238.93;3.51;731;26;1398.00;1
3361;26;625737387;3361;276;4091;4091;7.98;0.49;239.06;3.50;730;26;1399.00;0
3362;26;625737401;3362;281;4091;4091;7.92;0.48;239.06;3.50;729;26;1400.00;0
3364;26;625737417;3364;288;4091;4091;7.86;0.48;239.19;3.50;727;26;1401.00;0
3366;26;625737428;3366;295;4091;4091;7.77;0.47;239.27;3.50;725;26;1402.00;0
3369;26;625737438;3369;303;4091;4091;7.67;0.47;239.31;3.50;722;26;1403.00;0
3372;26;625737448;3372;309;4102;4103;7.74;0.47;239.28;3.49;730;26;1404.00;1
3375;26;625737462;3375;316;4102;4103;7.62;0.46;239.22;3.49;727;26;1405.00;1
3379;26;625737474;3379;318;4103;4103;7.53;0.46;239.14;3.49;724;26;1406.00;0
3380;26;625737484;3380;312;4103;4103;7.52;0.46;239.14;3.49;723;26;1407.00;0
3382;26;625737497;3382;306;4103;4103;7.54;0.46;239.09;3.49;721;26;1408.00;0
3384;26;625737508;3384;308;4103;4103;7.52;0.46;239.01;3.49;719;26;1409.00;0
3385;26;625737521;3385;306;4104;4104;7.56;0.46;238.97;3.49;719;26;1410.00;0
3386;26;625737532;3386;305;4104;4104;7.52;0.46;238.94;3.49;718;26;1411.00;0
3387;26;625737543;3387;309;4109;4110;7.52;0.46;238.87;3.49;722;26;1412.00;1
3389;26;625737554;3389;313;4110;4111;7.49;0.46;238.82;3.49;721;26;1413.00;1
3393;26;625737565;3393;316;4111;4111;7.45;0.45;238.60;3.49;718;26;1414.00;0
3395;26;625737576;3395;321;4111;4111;7.46;0.45;238.54;3.49;716;26;1415.00;0
3396;26;625737587;3396;313;4115;4115;7.54;0.46;238.52;3.49;719;26;1416.00;0
3398;26;625737597;3398;305;4115;4115;7.56;0.46;238.52;3.49;717;26;1417.00;0
3400;26;625737608;3400;297;4115;4115;7.60;0.46;238.45;3.49;715;26;1418.00;0
3402;26;625737617;3402;293;4116;4116;7.62;0.47;238.39;3.48;714;26;1419.00;0
3405;26;625737627;3405;287;4120;4120;7.56;0.46;238.28;3.48;715;26;1420.00;0
3406;27;625737637;3406;286;4120;4120;7.56;0.46;238.31;3.48;714;27;1421.00;0
3408;27;625737663;3408;281;4122;4123;7.69;0.47;238.30;3.48;714;27;1422.00;1
3408;27;625737674;3408;279;4122;4123;7.78;0.47;238.30;3.48;714;27;1423.00;1
3408;27;625737685;3408;275;4123;4123;7.85;0.48;238.30;3.48;715;27;1424.00;0
3411;27;625737696;3411;272;4123;4123;7.91;0.48;238.27;3.48;712;27;1425.00;0
3415;27;625737707;3415;262;4126;4127;7.91;0.48;238.30;3.48;711;27;1426.00;1
3415;27;625737719;3415;258;4126;4127;8.01;0.49;238.30;3.48;711;27;1427.00;1
3417;27;625737729;3417;254;4127;4127;8.07;0.49;238.19;3.48;710;27;1428.00;0
3419;27;625737740;3419;251;4127;4127;8.06;0.49;238.19;3.48;708;27;1429.00;0
3419;27;625737750;3419;242;4128;4128;8.07;0.49;238.19;3.48;709;27;1430.00;0
3421;27;625737760;3421;243;4129;4129;8.12;0.50;238.21;3.48;708;27;1431.00;0
3422;27;625737770;3422;248;4129;4129;8.04;0.49;238.18;3.48;707;27;1432.00;0
3425;27;625737779;3425;246;4130;4130;8.01;0.49;238.14;3.48;705;27;1433.00;0
3426;27;625737789;3426;247;4130;4130;7.99;0.49;238.13;3.48;704;27;1434.00;0
3428;27;625737798;3428;239;4130;4130;8.01;0.49;238.10;3.48;702;27;1435.00;0
3430;27;625737809;3430;229;4130;4130;8.05;0.49;238.09;3.48;700;27;1436.00;0
3430;27;625737818;3430;229;4130;4130;8.18;0.50;238.09;3.48;700;27;1437.00;0
3433;27;625737828;3433;222;4130;4130;8.29;0.51;238.09;3.48;697;27;1438.00;0
3436;27;625737838;3436;212;4130;4130;8.42;0.51;238.13;3.48;694;27;1439.00;0
3438;27;625737850;3438;252;4244;4360;8.40;0.53;238.09;3.38;806;27;1440.00;116
3440;27;625737883;3440;241;4247;4361;8.55;0.54;238.10;3.38;807;27;1441.00;114
3441;27;625737894;3441;220;4258;4361;8.72;0.55;238.08;3.38;817;27;1442.00;103
3442;27;625737905;3442;215;4263;4361;8.78;0.55;238.07;3.38;821;27;1443.00;98
3442;27;625737916;3442;209;4271;4361;8.87;0.55;238.07;3.38;829;27;1444.00;90
3445;27;625737932;3445;205;4276;4361;8.87;0.55;237.98;3.38;831;27;1445.00;85
3447;27;625737943;3447;212;4282;4361;8.83;0.55;237.89;3.38;835;27;1446.00;79
3447;27;625737966;3447;217;4285;4361;8.78;0.55;237.89;3.39;838;27;1447.00;76
3450;27;625737977;3450;219;4292;4362;8.74;0.54;237.90;3.39;842;27;1448.00;70
3452;27;625737989;3452;227;4296;4363;8.73;0.54;237.86;3.40;844;27;1449.00;67
3455;27;625738001;3455;219;4298;4363;8.71;0.54;237.90;3.40;843;27;1450.00;65
3456;27;625738012;3456;225;4303;4364;8.63;0.53;237.87;3.41;847;27;1451.00;61
3457;27;625738024;3457;220;4306;4364;8.60;0.53;237.93;3.42;849;27;1452.00;58
3457;27;625738035;3457;219;4307;4364;8.58;0.53;237.93;3.42;850;27;1453.00;57
3458;27;625738047;3458;218;4312;4364;8.55;0.53;237.97;3.43;854;27;1454.00;52
3460;27;625738059;3460;220;4315;4368;8.51;0.52;237.97;3.43;855;27;1455.00;53
3463;27;625738071;3463;216;4315;4368;8.49;0.52;237.99;3.43;852;27;1456.00;53
3467;27;625738083;3467;211;4319;4368;8.52;0.52;237.91;3.44;852;27;1457.00;49
3470;27;625738096;3470;216;4322;4371;8.55;0.52;237.88;3.45;852;27;1458.00;49
3474;27;625738108;3474;217;4323;4371;8.70;0.53;237.99;3.45;849;27;1459.00;48
3476;27;625738119;3476;212;4324;4371;8.79;0.54;238.12;3.46;848;27;1460.00;47
3479;27;625738130;3479;206;4330;4375;8.83;0.54;238.16;3.47;851;27;1461.00;45
3482;27;625738146;3482;200;4334;4376;8.79;0.54;238.21;3.47;852;27;1462.00;42
3486;27;625738157;3486;195;4335;4376;8.81;0.54;238.26;3.48;849;27;1463.00;41
3488;27;625738168;3488;189;4337;4380;8.83;0.54;238.25;3.48;849;27;1464.00;43
3492;27;625738185;3492;190;4340;4380;8.85;0.54;238.33;3.49;848;27;1465.00;40
3495;27;625738196;3495;190;4341;4380;8.90;0.54;238.50;3.50;846;27;1466.00;39
3501;27;625738207;3501;185;4343;4381;8.86;0.54;238.47;3.50;842;27;1467.00;38
3504;27;625738218;3504;179;4343;4381;8.95;0.54;238.51;3.50;839;27;1468.00;38
3506;27;625738229;3506;181;4347;4387;9.01;0.55;238.55;3.51;841;27;1469.00;40
3508;27;625738242;3508;176;4347;4387;9.03;0.55;238.70;3.51;839;27;1470.00;40
3509;27;625738253;3509;170;4347;4388;9.11;0.55;238.77;3.51;838;27;1471.00;41
3513;27;625738264;3513;169;4349;4388;9.19;0.56;238.97;3.53;836;27;1472.00;39
3516;27;625738275;3516;166;4349;4388;9.27;0.56;239.05;3.53;833;27;1473.00;39
3519;27;625738287;3519;163;4351;4388;9.32;0.57;239.06;3.54;832;27;1474.00;37
3522;27;625738298;3522;162;4351;4388;9.38;0.57;239.09;3.54;829;27;1475.00;37
3523;27;625738310;3523;161;4361;4400;9.53;0.58;239.06;3.54;838;27;1476.00;39
3524;27;625738324;3524;167;4362;4400;9.59;0.58;239.12;3.54;838;27;1477.00;38
3526;27;625738336;3526;170;4365;4400;9.65;0.58;239.14;3.56;839;27;1478.00;35
3528;27;625738354;3528;176;4367;4400;9.73;0.59;239.10;3.56;839;27;1479.00;33
3530;27;625738366;3530;173;4369;4400;9.81;0.59;239.15;3.57;839;27;1480.00;31
3533;27;625738378;3533;175;4371;4400;9.80;0.60;239.36;3.58;838;27;1481.00;29
3537;27;625738391;3537;171;4374;4404;9.82;0.60;239.40;3.57;837;27;1482.00;30
3538;27;625738404;3538;170;4375;4404;9.85;0.60;239.44;3.58;837;27;1483.00;29
3541;27;625738417;3541;169;4379;4408;9.82;0.60;239.51;3.58;838;27;1484.00;29
3544;27;625738429;3544;169;4382;4410;9.83;0.60;239.65;3.59;838;27;1485.00;28
3544;27;625738442;3544;171;4382;4410;9.89;0.60;239.65;3.59;838;27;1486.00;28
3547;27;625738454;3547;173;4382;4410;9.93;0.60;239.68;3.59;835;27;1487.00;28
3550;27;625738468;3550;176;4392;4423;9.94;0.60;239.69;3.59;842;27;1488.00;31
3553;27;625738482;3553;178;4392;4423;9.90;0.60;239.80;3.59;839;27;1489.00;31
3556;27;625738495;3556;180;4395;4423;9.91;0.60;239.89;3.62;839;27;1490.00;28
3559;27;625738520;3559;183;4396;4424;9.96;0.60;239.87;3.62;837;27;1491.00;28
3561;27;625738552;3561;192;4398;4425;9.96;0.60;239.94;3.64;837;27;1492.00;27
3564;27;625738573;3564;192;4399;4425;9.89;0.60;239.97;3.65;835;27;1493.00;26
3566;27;625738593;3566;193;4402;4428;9.90;0.60;239.93;3.66;836;27;1494.00;26
3569;27;625738612;3569;197;4403;4428;9.94;0.61;240.02;3.67;834;27;1495.00;25
3573;27;625738627;3573;201;4405;4428;9.93;0.61;240.05;3.69;832;27;1496.00;23
3577;27;625738642;3577;208;4408;4428;9.92;0.61;240.04;3.72;831;27;1497.00;20
3578;27;625738658;3578;210;4414;4434;9.94;0.61;240.08;3.74;836;27;1498.00;20
3581;27;625738673;3581;214;4417;4434;9.90;0.61;240.21;3.77;836;27;1499.00;17
3584;28;625738691;3584;220;4421;4453;9.82;0.60;240.20;3.76;837;28;1500.00;32
3587;28;625738729;3587;225;4425;4453;9.77;0.60;240.28;3.78;838;28;1501.00;28
3590;28;625738742;3590;226;4428;4457;9.72;0.59;240.47;3.78;838;28;1502.00;29
3591;28;625738761;3591;226;4431;4458;9.70;0.59;240.47;3.79;840;28;1503.00;27
3596;28;625738776;3596;231;4433;4458;9.59;0.58;240.55;3.80;837;28;1504.00;25
3597;28;625738789;3597;231;4434;4459;9.47;0.58;240.62;3.80;837;28;1505.00;25
3601;28;625738810;3601;242;4439;4459;9.36;0.57;240.74;3.84;838;28;1506.00;20
3603;28;625738823;3603;246;4440;4459;9.28;0.56;240.74;3.84;837;28;1507.00;19
3605;28;625738837;3605;249;4442;4459;9.17;0.56;240.86;3.85;837;28;1508.00;17
3606;28;625738850;3606;250;4442;4459;9.14;0.56;240.85;3.85;836;28;1509.00;17
3610;28;625738864;3610;250;4444;4459;9.10;0.55;240.96;3.87;834;28;1510.00;15
3615;28;625738877;3615;243;4444;4459;9.02;0.55;241.19;3.87;829;28;1511.00;15
3617;28;625738891;3617;250;4478;4529;8.94;0.55;241.30;3.86;861;28;1512.00;51
3621;28;625738912;3621;248;4480;4530;8.96;0.55;241.24;3.86;859;28;1513.00;50
3625;28;625738925;3625;249;4488;4530;8.95;0.55;241.26;3.86;863;28;1514.00;42
3625;28;625738937;3625;254;4492;4530;9.01;0.55;241.26;3.86;867;28;1515.00;38
3626;28;625738950;3626;253;4498;4530;9.04;0.55;241.25;3.86;872;28;1516.00;32
3629;28;625738963;3629;253;4498;4530;9.08;0.55;241.30;3.86;869;28;1517.00;32
3631;28;625738977;3631;258;4502;4530;9.11;0.56;241.27;3.87;871;28;1518.00;28
3634;28;625738989;3634;257;4504;4530;9.13;0.56;241.19;3.87;870;28;1519.00;26
3635;28;625739002;3635;262;4505;4531;9.09;0.55;241.26;3.87;870;28;1520.00;26
3638;28;625739016;3638;266;4508;4532;9.11;0.55;241.20;3.87;870;28;1521.00;24
3640;28;625739028;3640;267;4510;4532;9.06;0.55;241.29;3.88;870;28;1522.00;22
3643;28;625739041;3643;274;4513;4536;8.87;0.54;241.28;3.87;870;28;1523.00;23
3647;28;625739055;3647;278;4518;4536;8.75;0.53;241.38;3.89;871;28;1524.00;18
3653;28;625739067;3653;286;4518;4536;8.57;0.52;241.41;3.89;865;28;1525.00;18
3657;28;625739079;3657;284;4518;4536;8.42;0.51;241.43;3.89;861;28;1526.00;18
3662;28;625739091;3662;287;4522;4542;8.30;0.51;241.36;3.88;860;28;1527.00;20
3665;28;625739104;3665;284;4522;4542;8.15;0.50;241.50;3.88;857;28;1528.00;20
3670;28;625739116;3670;285;4522;4542;7.91;0.48;241.40;3.88;852;28;1529.00;20
3673;28;625739131;3673;278;4526;4548;7.68;0.47;241.51;3.89;853;28;1530.00;22
3676;28;625739144;3676;272;4526;4548;7.56;0.46;241.58;3.89;850;28;1531.00;22
3677;28;625739156;3677;276;4526;4548;7.53;0.46;241.63;3.89;849;28;1532.00;22
3682;28;625739167;3682;275;4528;4549;7.49;0.46;241.58;3.89;846;28;1533.00;21
3688;28;625739185;3688;278;4529;4550;7.46;0.46;241.61;3.89;841;28;1534.00;21
3694;28;625739198;3694;274;4530;4550;7.47;0.46;241.73;3.90;836;28;1535.00;20
3697;28;625739210;3697;270;4542;4563;7.49;0.46;241.82;3.89;845;28;1536.00;21
3701;28;625739224;3701;263;4543;4563;7.58;0.46;241.94;3.90;842;28;1537.00;20
3702;28;625739236;3702;255;4543;4563;7.74;0.47;242.00;3.90;841;28;1538.00;20
3708;28;625739248;3708;249;4546;4564;7.82;0.48;242.15;3.91;838;28;1539.00;18
3711;28;625739261;3711;245;4546;4564;7.93;0.49;242.31;3.91;835;28;1540.00;18
3717;28;625739273;3717;244;4551;4568;7.96;0.49;242.53;3.93;834;28;1541.00;17
3720;28;625739286;3720;238;4551;4568;8.03;0.49;242.64;3.93;831;28;1542.00;17
3727;28;625739298;3727;240;4556;4572;8.02;0.49;242.82;3.92;829;28;1543.00;16
3728;28;625739311;3728;245;4556;4572;8.11;0.50;242.85;3.92;828;28;1544.00;16
3734;28;625739324;3734;248;4557;4572;8.11;0.50;242.84;3.93;823;28;1545.00;15
3739;28;625739336;3739;247;4557;4572;8.06;0.49;242.76;3.93;818;28;1546.00;15
3742;28;625739349;3742;251;4557;4572;7.99;0.49;242.84;3.93;815;28;1547.00;15
3746;28;625739361;3746;258;4570;4584;7.99;0.49;242.77;3.94;824;28;1548.00;14
3752;28;625739374;3752;264;4570;4584;7.89;0.48;242.70;3.94;818;28;1549.00;14
3754;28;625739386;3754;269;4571;4584;7.82;0.48;242.75;3.95;817;28;1550.00;13
3757;28;625739398;3757;275;4571;4584;7.77;0.48;242.76;3.95;814;28;1551.00;13
3763;28;625739410;3763;276;4571;4584;7.72;0.47;242.83;3.95;808;28;1552.00;13
3765;28;625739422;3765;278;4572;4584;7.67;0.47;242.89;3.95;807;28;1553.00;12
3771;28;625739434;3771;283;4574;4585;7.62;0.46;243.05;3.96;803;28;1554.00;11
3775;28;625739447;3775;289;4575;4587;7.48;0.46;243.03;3.96;800;28;1555.00;12
3779;28;625739460;3779;296;4580;4593;7.38;0.45;243.09;3.97;801;28;1556.00;13
3780;28;625739478;3780;302;4581;4594;7.32;0.45;243.13;3.97;801;28;1557.00;13
3783;28;625739490;3783;306;4582;4594;7.23;0.44;243.15;3.97;799;28;1558.00;12
3787;28;625739505;3787;312;4583;4594;7.07;0.43;243.14;3.98;796;28;1559.00;11
3790;28;625739521;3790;315;4588;4599;7.01;0.43;243.09;3.97;798;28;1560.00;11
3795;28;625739534;3795;323;4589;4599;6.98;0.43;243.00;3.98;794;28;1561.00;10
3802;28;625739547;3802;331;4589;4599;6.90;0.42;242.85;3.98;787;28;1562.00;10
3803;28;625739560;3803;330;4591;4600;6.93;0.42;242.87;3.99;788;28;1563.00;9
3805;28;625739572;3805;330;4596;4604;6.92;0.42;242.88;3.99;791;28;1564.00;8
3807;28;625739585;3807;332;4597;4604;6.94;0.42;242.80;3.99;790;28;1565.00;7
3812;28;625739597;3812;334;4599;4607;6.90;0.42;242.58;3.99;787;28;1566.00;8
3813;28;625739609;3813;338;4600;4607;6.84;0.42;242.55;4.00;787;28;1567.00;7
3819;28;625739621;3819;347;4601;4607;6.72;0.41;242.38;4.00;782;28;1568.00;6
3822;28;625739632;3822;353;4602;4607;6.64;0.41;242.27;4.01;780;28;1569.00;5
3825;28;625739644;3825;363;4604;4611;6.59;0.40;242.30;4.01;779;28;1570.00;7
3829;28;625739656;3829;368;4604;4611;6.52;0.40;242.34;4.01;775;28;1571.00;7
3829;28;625739666;3829;377;4604;4611;6.45;0.39;242.34;4.01;775;28;1572.00;7
3831;28;625739676;3831;389;4605;4611;6.33;0.38;242.37;4.01;774;28;1573.00;6
3831;28;625739687;3831;394;4606;4612;6.29;0.38;242.37;4.01;775;28;1574.00;6
3833;28;625739703;3833;398;4610;4614;6.24;0.38;242.43;4.01;777;28;1575.00;4
3837;28;625739713;3837;404;4610;4614;6.17;0.38;242.41;4.01;773;28;1576.00;4
3840;28;625739723;3840;401;4613;4615;6.15;0.38;242.41;4.02;773;28;1577.00;2
3841;28;625739734;3841;399;4613;4615;6.15;0.38;242.46;4.02;772;28;1578.00;2
3841;28;625739744;3841;397;4614;4615;6.10;0.37;242.46;4.02;773;28;1579.00;1
3841;28;625739754;3841;397;4614;4615;6.09;0.37;242.46;4.02;773;28;1580.00;1
3844;28;625739764;3844;393;4614;4615;6.14;0.38;242.43;4.02;770;28;1581.00;1
3846;28;625739778;3846;389;4614;4615;6.24;0.38;242.52;4.02;768;28;1582.00;1
3849;28;625739788;3849;387;4614;4615;6.31;0.39;242.57;4.02;765;28;1583.00;1
3852;28;625739804;3852;405;4687;4742;6.63;0.41;242.53;3.95;835;28;1584.00;55
3853;28;625739827;3853;396;4690;4743;6.69;0.42;242.54;3.95;837;28;1585.00;53
3858;28;625739839;3858;375;4699;4743;6.75;0.42;242.58;3.95;841;28;1586.00;44
3860;28;625739850;3860;346;4704;4743;6.90;0.43;242.54;3.95;844;28;1587.00;39
3863;28;625739862;3863;322;4709;4743;7.03;0.43;242.44;3.95;846;28;1588.00;34
3864;28;625739873;3864;301;4713;4743;7.14;0.44;242.49;3.95;849;28;1589.00;30
3865;28;625739888;3865;294;4718;4743;7.29;0.45;242.49;3.95;853;28;1590.00;25
3866;28;625739900;3866;287;4721;4743;7.52;0.46;242.52;3.95;855;28;1591.00;22
3867;29;625739913;3867;277;4726;4744;7.73;0.47;242.53;3.97;859;29;1592.00;18
3869;29;625739939;3869;266;4728;4745;7.85;0.48;242.50;3.97;859;29;1593.00;17
3869;29;625739953;3869;255;4732;4745;8.03;0.49;242.50;3.98;863;29;1594.00;13
3871;29;625739972;3871;252;4733;4746;8.16;0.50;242.49;3.98;862;29;1595.00;13
3874;29;625739985;3874;244;4735;4746;8.24;0.50;242.54;3.98;861;29;1596.00;11
3877;29;625740019;3877;243;4737;4746;8.31;0.51;242.57;3.99;860;29;1597.00;9
3877;29;625740044;3877;236;4737;4746;8.39;0.51;242.57;3.99;860;29;1598.00;9
3879;29;625740058;3879;240;4740;4750;8.47;0.52;242.52;3.99;861;29;1599.00;10
3880;29;625740075;3880;237;4743;4750;8.55;0.52;242.51;3.99;863;29;1600.00;7
3882;29;625740099;3882;233;4744;4750;8.61;0.53;242.60;3.99;862;29;1601.00;6
3883;29;625740113;3883;225;4747;4753;8.66;0.53;242.59;3.99;864;29;1602.00;6
3883;29;625740127;3883;226;4747;4753;8.75;0.53;242.59;3.99;864;29;1603.00;6
3883;29;625740141;3883;228;4747;4753;8.86;0.54;242.59;3.99;864;29;1604.00;6
3884;29;625740156;3884;231;4751;4757;8.92;0.55;242.60;3.99;867;29;1605.00;6
3886;29;625740170;3886;227;4752;4758;9.02;0.55;242.66;3.99;866;29;1606.00;6
3889;29;625740187;3889;231;4752;4758;9.02;0.55;242.59;3.99;863;29;1607.00;6
3891;30;625740203;3891;230;4755;4762;9.15;0.56;242.61;3.99;864;30;1608.00;7
3895;30;625740234;3895;229;4755;4762;9.15;0.56;242.64;3.99;860;30;1609.00;7
3896;30;625740254;3896;230;4755;4762;9.18;0.56;242.62;3.99;859;30;1610.00;7
3900;30;625740273;3900;230;4756;4763;9.19;0.56;242.60;3.99;856;30;1611.00;7
3902;30;625740287;3902;227;4756;4763;9.21;0.56;242.63;3.99;854;30;1612.00;7
3905;30;625740301;3905;232;4760;4769;9.24;0.56;242.76;3.98;855;30;1613.00;9
3907;30;625740318;3907;234;4760;4769;9.25;0.56;242.77;3.98;853;30;1614.00;9
3909;30;625740331;3909;234;4761;4770;9.20;0.56;242.91;3.98;852;30;1615.00;9
3912;30;625740345;3912;234;4761;4770;9.21;0.56;242.91;3.98;849;30;1616.00;9
3917;30;625740357;3917;241;4761;4770;9.24;0.56;242.99;3.98;844;30;1617.00;9
3918;30;625740371;3918;240;4761;4770;9.27;0.57;243.10;3.98;843;30;1618.00;9
3922;30;625740383;3922;245;4761;4770;9.23;0.56;243.13;3.98;839;30;1619.00;9
3925;30;625740396;3925;249;4782;4806;9.22;0.56;243.27;3.97;857;30;1620.00;24
3928;30;625740412;3928;249;4783;4806;9.19;0.56;243.28;3.97;855;30;1621.00;23
3932;30;625740425;3932;240;4784;4806;9.16;0.56;243.43;3.96;852;30;1622.00;22
3935;30;625740438;3935;229;4785;4806;9.19;0.56;243.59;3.96;850;30;1623.00;21
3938;30;625740451;3938;220;4787;4806;9.34;0.57;243.59;3.97;849;30;1624.00;19
3942;30;625740463;3942;218;4787;4806;9.40;0.57;243.67;3.97;845;30;1625.00;19
3945;30;625740476;3945;211;4791;4810;9.45;0.58;243.70;3.97;846;30;1626.00;19
3947;30;625740489;3947;201;4791;4810;9.53;0.58;243.79;3.97;844;30;1627.00;19
3950;30;625740504;3950;193;4795;4814;9.54;0.58;243.93;3.97;845;30;1628.00;19
3953;30;625740521;3953;188;4797;4815;9.58;0.59;243.95;3.97;844;30;1629.00;18
3956;30;625740538;3956;185;4797;4815;9.56;0.58;244.00;3.97;841;30;1630.00;18
3961;30;625740557;3961;180;4797;4815;9.60;0.59;244.12;3.97;836;30;1631.00;18
3966;30;625740573;3966;177;4806;4828;9.47;0.58;244.23;3.96;840;30;1632.00;22
3969;30;625740595;3969;172;4806;4828;9.45;0.58;244.27;3.96;837;30;1633.00;22
3976;30;625740615;3976;169;4806;4828;9.42;0.57;244.38;3.96;830;30;1634.00;22
3979;30;625740630;3979;161;4808;4829;9.48;0.58;244.39;3.97;829;30;1635.00;21
3985;30;625740645;3985;156;4808;4830;9.54;0.58;244.53;3.97;823;30;1636.00;22
3988;30;625740659;3988;154;4808;4830;9.69;0.59;244.60;3.97;820;30;1637.00;22
3990;30;625740673;3990;143;4811;4833;9.82;0.60;244.57;3.98;821;30;1638.00;22
3994;30;625740686;3994;139;4812;4833;9.94;0.60;244.69;3.98;818;30;1639.00;21
3995;30;625740699;3995;138;4813;4833;10.03;0.61;244.75;3.98;818;30;1640.00;20
3998;30;625740711;3998;134;4813;4833;10.00;0.61;244.75;3.98;815;30;1641.00;20
4002;30;625740724;4002;130;4818;4839;10.03;0.61;244.79;3.98;816;30;1642.00;21
4004;30;625740737;4004;131;4820;4839;10.03;0.61;244.85;3.99;816;30;1643.00;19
4008;30;625740749;4008;133;4820;4839;10.02;0.61;244.88;3.99;812;30;1644.00;19
4013;30;625740763;4013;128;4820;4839;10.04;0.61;245.02;3.99;807;30;1645.00;19
4016;30;625740782;4016;128;4823;4843;10.06;0.61;245.03;3.98;807;30;1646.00;20
4018;30;625740795;4018;130;4826;4844;10.12;0.61;245.03;4.00;808;30;1647.00;18
4022;30;625740808;4022;132;4826;4844;10.22;0.62;245.14;4.00;804;30;1648.00;18
4022;30;625740821;4022;133;4827;4845;10.28;0.62;245.14;4.00;805;30;1649.00;18
4026;30;625740836;4026;138;4828;4845;10.29;0.62;245.19;4.01;802;30;1650.00;17
4028;30;625740849;4028;137;4828;4845;10.28;0.62;245.25;4.01;800;30;1651.00;17
4028;30;625740862;4028;139;4828;4845;10.28;0.62;245.25;4.01;800;30;1652.00;17
4031;30;625740875;4031;143;4829;4845;10.24;0.62;245.28;4.01;798;30;1653.00;16
4036;30;625740888;4036;152;4829;4845;10.24;0.62;245.37;4.01;793;30;1654.00;16
4037;30;625740902;4037;152;4829;4845;10.24;0.62;245.40;4.01;792;30;1655.00;16
4039;30;625740915;4039;162;4867;4915;10.24;0.63;245.37;3.99;828;30;1656.00;48
4039;30;625740936;4039;156;4869;4916;10.30;0.63;245.37;3.99;830;30;1657.00;47
4042;30;625740950;4042;159;4878;4916;10.34;0.63;245.37;3.99;836;30;1658.00;38
4044;30;625740966;4044;159;4880;4916;10.31;0.63;245.39;4.00;836;30;1659.00;36
4045;30;625740981;4045;164;4886;4916;10.34;0.63;245.43;4.01;841;30;1660.00;30
4048;30;625740996;4048;167;4887;4916;10.38;0.64;245.46;4.01;839;30;1661.00;29
4049;30;625741009;4049;165;4895;4916;10.37;0.63;245.54;4.04;846;30;1662.00;21
4056;30;625741024;4056;165;4896;4916;10.28;0.63;245.41;4.04;840;30;1663.00;20
4060;30;625741046;4060;168;4900;4917;10.24;0.62;245.31;4.04;840;30;1664.00;17
4060;30;625741067;4060;176;4907;4919;10.26;0.63;245.31;4.06;847;30;1665.00;12
4066;30;625741082;4066;177;4907;4919;10.19;0.62;245.38;4.06;841;30;1666.00;12
4069;30;625741103;4069;174;4910;4923;10.09;0.62;245.40;4.06;841;30;1667.00;13
4074;30;625741117;4074;176;4911;4923;10.00;0.61;245.43;4.07;837;30;1668.00;12
4078;30;625741130;4078;183;4913;4923;9.85;0.60;245.55;4.08;835;30;1669.00;10
4080;30;625741146;4080;190;4913;4923;9.79;0.60;245.58;4.08;833;30;1670.00;10
4082;30;625741158;4082;196;4919;4929;9.76;0.60;245.65;4.09;837;30;1671.00;10
4084;30;625741173;4084;197;4919;4929;9.68;0.59;245.63;4.09;835;30;1672.00;10
4087;30;625741186;4087;199;4920;4929;9.69;0.59;245.76;4.09;833;30;1673.00;9
4089;30;625741199;4089;208;4923;4932;9.64;0.59;245.72;4.09;834;30;1674.00;9
4093;30;625741212;4093;212;4926;4932;9.57;0.58;245.71;4.10;833;30;1675.00;6
4096;30;625741226;4096;218;4927;4932;9.45;0.58;245.76;4.11;831;30;1676.00;5
4098;30;625741245;4098;218;4928;4933;9.36;0.57;245.77;4.11;830;30;1677.00;5
4100;30;625741258;4100;224;4930;4934;9.28;0.57;245.74;4.11;830;30;1678.00;4
4104;30;625741272;4104;229;4930;4934;9.16;0.56;245.74;4.11;826;30;1679.00;4
4108;30;625741286;4108;234;4949;4960;8.98;0.55;245.71;4.10;841;30;1680.00;11
4110;30;625741304;4110;226;4951;4960;8.86;0.54;245.65;4.10;841;30;1681.00;9
4112;30;625741318;4112;223;4955;4960;8.81;0.54;245.65;4.10;843;30;1682.00;5
4116;30;625741330;4116;225;4956;4961;8.83;0.54;245.73;4.10;840;30;1683.00;5
4121;30;625741342;4121;228;4956;4961;8.77;0.54;245.71;4.10;835;30;1684.00;5
4122;30;625741357;4122;234;4959;4965;8.82;0.54;245.71;4.09;837;30;1685.00;6
4124;30;625741369;4124;235;4959;4965;8.76;0.53;245.70;4.09;835;30;1686.00;6
4127;30;625741387;4127;238;4963;4969;8.67;0.53;245.66;4.09;836;30;1687.00;6
4132;30;625741400;4132;245;4965;4969;8.59;0.52;245.72;4.10;833;30;1688.00;4
4134;30;625741418;4134;249;4965;4969;8.55;0.52;245.65;4.10;831;30;1689.00;4
4136;30;625741430;4136;257;4965;4969;8.47;0.52;245.68;4.10;829;30;1690.00;4
4141;30;625741441;4141;268;4965;4969;8.40;0.51;245.80;4.10;824;30;1691.00;4
4145;30;625741452;4145;267;4978;4981;8.38;0.51;245.80;4.10;833;30;1692.00;3
4147;30;625741465;4147;281;4978;4981;8.27;0.51;245.77;4.10;831;30;1693.00;3
4155;30;625741476;4155;282;4980;4981;8.16;0.50;245.67;4.10;825;30;1694.00;1
4161;30;625741488;4161;290;4980;4981;8.08;0.49;245.66;4.10;819;30;1695.00;1
4163;30;625741498;4163;288;4980;4981;7.97;0.49;245.65;4.10;817;30;1696.00;1
4167;30;625741509;4167;290;4980;4981;7.76;0.47;245.89;4.10;813;30;1697.00;1
4172;30;625741520;4172;296;4981;4982;7.48;0.46;246.01;4.10;809;30;1698.00;1
4175;30;625741530;4175;307;4981;4982;7.28;0.45;246.06;4.10;806;30;1699.00;1
4179;30;625741541;4179;302;4986;4988;7.16;0.44;246.19;4.09;807;30;1700.00;2
4183;30;625741556;4183;296;4987;4989;7.06;0.43;246.20;4.09;804;30;1701.00;2
4187;30;625741566;4187;295;4988;4989;6.97;0.43;246.25;4.09;801;30;1702.00;1
4191;30;625741576;4191;291;4988;4989;6.90;0.42;246.44;4.09;797;30;1703.00;1
4193;30;625741586;4193;292;4992;4993;6.88;0.42;246.45;4.09;799;30;1704.00;1
4197;30;625741596;4197;291;4992;4993;6.81;0.42;246.58;4.09;795;30;1705.00;1
4199;30;625741606;4199;299;4992;4993;6.80;0.42;246.60;4.09;793;30;1706.00;1
4202;30;625741616;4202;299;4993;4994;6.83;0.42;246.66;4.09;791;30;1707.00;1
4204;30;625741626;4204;302;4997;4998;6.81;0.42;246.68;4.09;793;30;1708.00;1
4207;30;625741636;4207;295;4997;4998;6.82;0.42;246.64;4.09;790;30;1709.00;1
4209;30;625741649;4209;294;5000;5004;6.95;0.43;246.69;4.08;791;30;1710.00;4
4213;30;625741659;4213;299;5000;5004;6.92;0.43;246.72;4.08;787;30;1711.00;4
4215;30;625741669;4215;300;5001;5004;6.94;0.43;246.74;4.08;786;30;1712.00;3
4217;30;625741680;4217;303;5001;5004;6.92;0.43;246.74;4.08;784;30;1713.00;3
4221;30;625741689;4221;302;5004;5008;6.95;0.43;246.75;4.08;783;30;1714.00;4
4225;30;625741700;4225;305;5004;5008;6.95;0.43;246.62;4.08;779;30;1715.00;4
4232;30;625741710;4232;308;5005;5008;6.87;0.42;246.59;4.08;773;30;1716.00;3
4235;30;625741720;4235;306;5006;5008;6.87;0.42;246.61;4.08;771;30;1717.00;2
4239;30;625741729;4239;305;5007;5009;6.83;0.42;246.59;4.08;768;30;1718.00;2
4244;30;625741739;4244;301;5009;5010;6.78;0.42;246.59;4.08;765;30;1719.00;1
4251;30;625741750;4251;303;5009;5010;6.71;0.41;246.48;4.08;758;30;1720.00;1
4253;30;625741761;4253;302;5010;5011;6.76;0.41;246.41;4.08;757;30;1721.00;1
4257;30;625741777;4257;301;5010;5011;6.79;0.42;246.41;4.08;753;30;1722.00;1
4262;30;625741786;4262;296;5010;5011;6.76;0.42;246.28;4.08;748;30;1723.00;1
4266;30;625741795;4266;293;5010;5011;6.79;0.42;246.22;4.08;744;30;1724.00;1
4268;30;625741805;4268;297;5010;5011;6.79;0.42;246.20;4.08;742;30;1725.00;1
4270;30;625741816;4270;298;5010;5011;6.87;0.42;246.25;4.08;740;30;1726.00;1
4273;30;625741826;4273;302;5010;5011;6.90;0.42;246.19;4.08;737;30;1727.00;1
4275;30;625741836;4275;317;5082;5138;7.35;0.46;246.22;4.02;807;30;1728.00;56
4279;30;625741860;4279;316;5085;5139;7.33;0.45;246.15;4.02;806;30;1729.00;54
4282;30;625741871;4282;318;5097;5139;7.46;0.46;246.06;4.02;815;30;1730.00;42
4286;30;625741882;4286;316;5098;5139;7.46;0.46;246.04;4.02;812;30;1731.00;41
4289;30;625741894;4289;319;5106;5139;7.59;0.47;246.00;4.02;817;30;1732.00;33
4292;30;625741905;4292;326;5111;5139;7.66;0.47;245.97;4.02;819;30;1733.00;28
4297;30;625741916;4297;332;5116;5139;7.66;0.47;245.95;4.02;819;30;1734.00;23
4298;30;625741934;4298;336;5118;5139;7.71;0.47;246.00;4.02;820;30;1735.00;21
4299;31;625741945;4299;342;5121;5140;7.77;0.48;245.98;4.02;822;31;1736.00;19
4299;31;625741970;4299;348;5125;5141;7.79;0.48;245.98;4.03;826;31;1737.00;16
4302;31;625741982;4302;355;5129;5141;7.73;0.48;246.01;4.04;827;31;1738.00;12
4302;31;625741995;4302;345;5131;5142;7.66;0.47;246.01;4.04;829;31;1739.00;11
4303;31;625742009;4303;337;5133;5142;7.68;0.47;246.02;4.04;830;31;1740.00;9
4305;31;625742022;4305;338;5134;5142;7.70;0.48;246.01;4.04;829;31;1741.00;8
4308;31;625742034;4308;335;5136;5142;7.69;0.47;246.06;4.05;828;31;1742.00;6
4311;31;625742046;4311;340;5138;5146;7.67;0.47;246.04;4.05;827;31;1743.00;8
4315;31;625742060;4315;338;5140;5146;7.65;0.47;246.07;4.05;825;31;1744.00;6
4316;31;625742073;4316;337;5141;5146;7.73;0.48;246.10;4.05;825;31;1745.00;5
4319;31;625742085;4319;332;5143;5149;7.80;0.48;246.14;4.05;824;31;1746.00;6
4320;31;625742098;4320;316;5145;5149;7.91;0.48;246.09;4.06;825;31;1747.00;4
4323;31;625742112;4323;302;5146;5149;8.01;0.49;246.14;4.05;823;31;1748.00;3
4326;31;625742130;4326;293;5151;5153;8.13;0.50;246.12;4.05;825;31;1749.00;2
4328;32;625742144;4328;282;5152;5154;8.26;0.50;246.02;4.05;824;32;1750.00;2
4330;32;625742173;4330;278;5152;5154;8.33;0.51;245.98;4.05;822;32;1751.00;2
4332;32;625742187;4332;270;5156;5158;8.43;0.51;246.01;4.05;824;32;1752.00;2
4335;33;625742201;4335;264;5156;5158;8.49;0.52;245.89;4.05;821;33;1753.00;2
4337;33;625742226;4337;264;5156;5158;8.55;0.52;246.04;4.05;819;33;1754.00;2
4339;33;625742243;4339;262;5158;5160;8.58;0.52;246.00;4.05;819;33;1755.00;2
4342;33;625742264;4342;254;5159;5160;8.61;0.52;245.97;4.05;817;33;1756.00;1
4344;33;625742277;4344;249;5164;5166;8.66;0.53;245.93;4.05;820;33;1757.00;2
4346;33;625742292;4346;234;5165;5166;8.78;0.53;245.93;4.05;819;33;1758.00;1
4346;33;625742305;4346;230;5166;5167;8.86;0.54;245.93;4.05;820;33;1759.00;1
4349;33;625742319;4349;227;5167;5167;8.99;0.54;245.89;4.05;818;33;1760.00;0
4352;33;625742332;4352;226;5167;5167;9.04;0.55;246.08;4.05;815;33;1761.00;0
4353;33;625742346;4353;222;5167;5167;9.13;0.55;246.06;4.05;814;33;1762.00;0
4355;33;625742359;4355;228;5167;5167;9.18;0.55;246.08;4.05;812;33;1763.00;0
4356;33;625742372;4356;232;5177;5179;9.26;0.56;246.10;4.05;821;33;1764.00;2
4358;33;625742387;4358;241;5178;5179;9.23;0.56;246.05;4.04;820;33;1765.00;1
4359;33;625742400;4359;241;5178;5179;9.28;0.56;246.04;4.04;819;33;1766.00;1
4362;33;625742414;4362;242;5178;5179;9.28;0.56;246.08;4.04;816;33;1767.00;1
4363;33;625742427;4363;239;5178;5179;9.30;0.56;246.08;4.04;815;33;1768.00;1
4365;33;625742440;4365;236;5178;5179;9.26;0.56;246.06;4.04;813;33;1769.00;1
4366;33;625742455;4366;236;5181;5183;9.22;0.56;246.06;4.04;815;33;1770.00;2
4369;33;625742469;4369;235;5181;5183;9.23;0.56;246.12;4.04;812;33;1771.00;2
4370;33;625742482;4370;229;5184;5187;9.25;0.56;246.15;4.04;814;33;1772.00;3
4371;33;625742495;4371;231;5185;5188;9.23;0.56;246.14;4.04;814;33;1773.00;3
4372;33;625742514;4372;234;5186;5188;9.19;0.56;246.16;4.04;814;33;1774.00;2
4375;33;625742535;4375;241;5186;5188;9.22;0.56;246.19;4.04;811;33;1775.00;2
4377;33;625742552;4377;249;5196;5201;9.25;0.56;246.22;4.03;819;33;1776.00;5
4383;33;625742573;4383;245;5196;5201;9.20;0.56;246.41;4.03;813;33;1777.00;5
4385;33;625742593;4385;245;5197;5201;9.18;0.56;246.44;4.03;812;33;1778.00;4
4389;33;625742611;4389;247;5198;5202;9.20;0.56;246.55;4.03;809;33;1779.00;4
4393;33;625742627;4393;249;5198;5203;9.18;0.56;246.65;4.03;805;33;1780.00;5
4396;33;625742641;4396;252;5198;5203;9.23;0.56;246.65;4.03;802;33;1781.00;5
4399;33;625742654;4399;253;5200;5206;9.29;0.57;246.75;4.03;801;33;1782.00;6
4401;33;625742667;4401;251;5200;5206;9.26;0.56;246.81;4.03;799;33;1783.00;6
4404;33;625742681;4404;252;5201;5206;9.34;0.57;246.83;4.03;797;33;1784.00;5
4408;33;625742695;4408;257;5201;5206;9.35;0.57;246.87;4.03;793;33;1785.00;5
4410;33;625742707;4410;257;5205;5212;9.38;0.57;246.95;4.03;795;33;1786.00;7
4412;33;625742722;4412;257;5205;5212;9.43;0.58;246.97;4.03;793;33;1787.00;7
4414;33;625742735;4414;250;5206;5212;9.40;0.57;247.02;4.03;792;33;1788.00;6
4418;33;625742747;4418;250;5206;5212;9.40;0.57;247.05;4.03;788;33;1789.00;6
4422;33;625742761;4422;244;5209;5216;9.37;0.57;247.08;4.02;787;33;1790.00;7
4426;33;625742774;4426;239;5210;5217;9.49;0.58;247.12;4.02;784;33;1791.00;7
4428;33;625742786;4428;231;5210;5217;9.60;0.59;247.15;4.02;782;33;1792.00;7
4432;33;625742798;4432;221;5211;5218;9.68;0.59;247.13;4.02;779;33;1793.00;7
4439;33;625742810;4439;209;5211;5218;9.67;0.59;247.15;4.02;772;33;1794.00;7
4443;33;625742823;4443;202;5211;5218;9.71;0.59;247.25;4.02;768;33;1795.00;7
4445;33;625742836;4445;200;5211;5218;9.77;0.60;247.27;4.02;766;33;1796.00;7
4450;33;625742848;4450;189;5211;5218;9.81;0.60;247.34;4.02;761;33;1797.00;7
4454;33;625742859;4454;183;5211;5218;9.85;0.60;247.48;4.02;757;33;1798.00;7
4457;33;625742871;4457;178;5211;5218;9.78;0.60;247.51;4.02;754;33;1799.00;7
4460;33;625742885;4460;192;5275;5356;9.52;0.59;247.59;3.97;815;33;1800.00;81
4465;33;625742917;4465;173;5275;5357;9.51;0.59;247.68;3.97;810;33;1801.00;82
4469;33;625742930;4469;161;5285;5357;9.57;0.59;247.76;3.97;816;33;1802.00;72
4471;33;625742943;4471;151;5290;5357;9.60;0.59;247.85;3.97;819;33;1803.00;67
4475;33;625742955;4475;146;5293;5357;9.62;0.59;247.93;3.97;818;33;1804.00;64
4479;33;625742969;4479;147;5302;5357;9.62;0.59;248.03;3.98;823;33;1805.00;55
4483;33;625742983;4483;145;5305;5357;9.65;0.59;248.09;3.99;822;33;1806.00;52
4490;33;625742996;4490;144;5308;5357;9.65;0.59;248.12;3.99;818;33;1807.00;49
4495;33;625743008;4495;139;5311;5358;9.69;0.59;248.15;3.99;816;33;1808.00;47
4498;33;625743028;4498;144;5313;5359;9.82;0.60;248.20;3.99;815;33;1809.00;46
4503;34;625743041;4503;141;5316;5359;9.84;0.60;248.21;3.99;813;34;1810.00;43
4506;34;625743074;4506;135;5320;5363;9.87;0.60;248.29;3.99;814;34;1811.00;43
4508;34;625743087;4508;134;5321;5363;9.87;0.60;248.30;3.99;813;34;1812.00;42
4510;34;625743101;4510;131;5324;5363;9.79;0.60;248.35;4.00;814;34;1813.00;39
4515;34;625743118;4515;134;5325;5363;9.71;0.59;248.32;4.00;810;34;1814.00;38
4517;34;625743132;4517;135;5329;5369;9.67;0.59;248.39;4.00;812;34;1815.00;40
4523;34;625743151;4523;135;5329;5369;9.65;0.59;248.44;4.00;806;34;1816.00;40
4526;34;625743166;4526;136;5330;5369;9.69;0.59;248.42;4.01;804;34;1817.00;39
4527;34;625743178;4527;142;5334;5372;9.75;0.59;248.44;4.01;807;34;1818.00;38
4530;34;625743192;4530;140;5336;5372;9.87;0.60;248.45;4.01;806;34;1819.00;36
4533;34;625743204;4533;136;5336;5372;9.94;0.60;248.46;4.01;803;34;1820.00;36
4535;34;625743216;4535;137;5338;5373;10.00;0.61;248.55;4.02;803;34;1821.00;35
4538;34;625743227;4538;137;5339;5374;10.09;0.61;248.59;4.02;801;34;1822.00;35
4538;34;625743239;4538;137;5341;5374;10.18;0.62;248.59;4.03;803;34;1823.00;33
4540;34;625743250;4540;136;5349;5387;10.19;0.62;248.56;4.02;809;34;1824.00;38
4545;34;625743271;4545;136;5351;5387;10.24;0.62;248.53;4.03;806;34;1825.00;36
4549;34;625743283;4549;138;5352;5387;10.30;0.63;248.61;4.03;803;34;1826.00;35
4552;35;625743295;4552;143;5355;5388;10.33;0.63;248.61;4.03;803;35;1827.00;33
4557;35;625743321;4557;145;5355;5388;10.27;0.63;248.69;4.03;798;35;1828.00;33
4559;35;625743333;4559;145;5360;5392;10.21;0.62;248.74;4.05;801;35;1829.00;32
4562;35;625743352;4562;148;5362;5392;10.12;0.62;248.70;4.06;800;35;1830.00;30
4564;35;625743371;4564;152;5365;5396;10.00;0.61;248.84;4.06;801;35;1831.00;31
4566;35;625743393;4566;159;5367;5396;9.94;0.61;248.79;4.06;801;35;1832.00;29
4568;35;625743405;4568;169;5369;5396;9.93;0.61;248.84;4.07;801;35;1833.00;27
4572;35;625743418;4572;168;5371;5396;9.87;0.60;248.90;4.08;799;35;1834.00;25
4576;35;625743431;4576;172;5374;5396;9.89;0.60;248.86;4.09;798;35;1835.00;22
4579;35;625743443;4579;177;5386;5408;9.97;0.61;249.00;4.09;807;35;1836.00;22
4582;35;625743457;4582;177;5387;5408;10.00;0.61;248.96;4.10;805;35;1837.00;21
4587;35;625743471;4587;181;5388;5408;9.96;0.61;249.12;4.10;801;35;1838.00;20
4589;35;625743485;4589;190;5389;5408;9.97;0.61;249.12;4.11;800;35;1839.00;19
4591;35;625743499;4591;198;5389;5408;9.95;0.61;249.14;4.11;798;35;1840.00;19
4594;35;625743514;4594;204;5391;5408;9.91;0.61;249.14;4.12;797;35;1841.00;17
4596;35;625743527;4596;207;5392;5409;9.81;0.60;249.18;4.13;796;35;1842.00;17
4598;35;625743540;4598;214;5392;5409;9.75;0.60;249.23;4.13;794;35;1843.00;17
4599;35;625743552;4599;223;5397;5415;9.73;0.60;249.20;4.13;798;35;1844.00;18
4603;35;625743565;4603;224;5400;5417;9.66;0.59;249.23;4.13;797;35;1845.00;17
4607;35;625743577;4607;227;5401;5417;9.60;0.59;249.32;4.14;794;35;1846.00;16
4611;35;625743588;4611;230;5402;5417;9.45;0.58;249.31;4.14;791;35;1847.00;15
4612;35;625743601;4612;240;5407;5421;9.34;0.57;249.27;4.15;795;35;1848.00;14
4614;35;625743612;4614;241;5408;5421;9.19;0.56;249.22;4.16;794;35;1849.00;13
4615;35;625743624;4615;235;5408;5421;9.11;0.56;249.20;4.16;793;35;1850.00;13
4617;35;625743640;4617;231;5411;5422;9.09;0.56;249.29;4.16;794;35;1851.00;11
4619;35;625743652;4619;233;5414;5426;9.04;0.55;249.38;4.16;795;35;1852.00;12
4622;36;625743664;4622;233;5415;5426;8.97;0.55;249.41;4.16;793;36;1853.00;11
4625;36;625743688;4625;235;5417;5429;8.98;0.55;249.44;4.16;792;36;1854.00;12
4625;36;625743700;4625;241;5417;5429;9.01;0.55;249.44;4.16;792;36;1855.00;12
4627;36;625743712;4627;240;5419;5429;8.98;0.55;249.48;4.16;792;36;1856.00;10
4632;36;625743724;4632;237;5419;5429;8.88;0.54;249.48;4.16;787;36;1857.00;10
4633;36;625743735;4633;243;5423;5433;8.88;0.54;249.52;4.16;790;36;1858.00;10
4635;36;625743748;4635;245;5423;5433;8.85;0.54;249.54;4.16;788;36;1859.00;10
4637;36;625743760;4637;250;5425;5433;8.72;0.53;249.50;4.16;788;36;1860.00;8
4640;36;625743770;4640;258;5425;5433;8.61;0.53;249.60;4.16;785;36;1861.00;8
4643;36;625743780;4643;257;5426;5434;8.44;0.52;249.59;4.16;783;36;1862.00;8
4645;36;625743790;4645;261;5427;5435;8.34;0.51;249.50;4.16;782;36;1863.00;8
4652;36;625743800;4652;265;5427;5435;8.14;0.50;249.44;4.16;775;36;1864.00;8
4653;36;625743811;4653;275;5428;5436;8.02;0.49;249.40;4.16;775;36;1865.00;8
4656;36;625743821;4656;278;5428;5436;7.84;0.48;249.46;4.16;772;36;1866.00;8
4661;36;625743831;4661;287;5428;5436;7.63;0.47;249.46;4.16;767;36;1867.00;8
4662;36;625743840;4662;296;5428;5436;7.47;0.46;249.46;4.16;766;36;1868.00;8
4668;36;625743849;4668;299;5428;5436;7.22;0.44;249.34;4.16;760;36;1869.00;8
4670;36;625743857;4670;292;5428;5436;7.09;0.44;249.42;4.16;758;36;1870.00;8
4673;36;625743883;4673;294;5428;5436;6.93;0.43;249.42;4.16;755;36;1871.00;8
4677;36;625743892;4677;315;5502;5563;7.14;0.45;249.41;4.10;825;36;1872.00;61
4679;36;625743914;4679;310;5506;5564;7.08;0.44;249.42;4.10;827;36;1873.00;58
4682;36;625743924;4682;305;5515;5564;7.14;0.45;249.43;4.10;833;36;1874.00;49
4685;36;625743934;4685;302;5520;5564;7.21;0.45;249.47;4.10;835;36;1875.00;44
4688;36;625743944;4688;304;5525;5564;7.29;0.45;249.39;4.10;837;36;1876.00;39
4689;37;625743954;4689;303;5530;5564;7.28;0.45;249.43;4.10;841;37;1877.00;34
4691;37;625743980;4691;303;5534;5564;7.32;0.45;249.44;4.10;843;37;1878.00;30
4693;37;625743991;4693;300;5536;5564;7.25;0.45;249.43;4.10;843;37;1879.00;28
4694;37;625744006;4694;304;5541;5565;7.24;0.45;249.46;4.10;847;37;1880.00;24
4701;37;625744018;4701;307;5544;5566;7.26;0.45;249.56;4.10;843;37;1881.00;22
4702;37;625744029;4702;312;5547;5568;7.26;0.45;249.60;4.11;845;37;1882.00;21
4704;37;625744040;4704;312;5550;5569;7.16;0.44;249.60;4.11;846;37;1883.00;19
4707;37;625744051;4707;310;5552;5569;7.07;0.44;249.67;4.11;845;37;1884.00;17
4713;37;625744061;4713;314;5553;5569;6.99;0.43;249.74;4.11;840;37;1885.00;16
4714;37;625744072;4714;319;5555;5569;6.97;0.43;249.78;4.12;841;37;1886.00;14
4716;37;625744083;4716;330;5558;5573;6.92;0.43;249.73;4.12;842;37;1887.00;15
4717;37;625744094;4717;340;5559;5573;6.83;0.42;249.77;4.12;842;37;1888.00;14
4721;37;625744105;4721;349;5560;5573;6.71;0.41;249.80;4.12;839;37;1889.00;13
4724;37;625744117;4724;354;5563;5579;6.67;0.41;249.71;4.12;839;37;1890.00;16
4729;37;625744129;4729;347;5564;5579;6.68;0.41;249.63;4.12;835;37;1891.00;15
4733;37;625744141;4733;334;5565;5579;6.70;0.41;249.62;4.12;832;37;1892.00;14
4735;37;625744153;4735;324;5570;5583;6.74;0.41;249.61;4.12;835;37;1893.00;13
4739;37;625744164;4739;322;5572;5584;6.87;0.42;249.64;4.12;833;37;1894.00;12
4741;37;625744177;4741;319;5573;5584;6.92;0.43;249.59;4.12;832;37;1895.00;11
4744;37;625744189;4744;311;5578;5588;7.03;0.43;249.62;4.11;834;37;1896.00;10
4749;37;625744201;4749;308;5578;5588;7.04;0.43;249.60;4.11;829;37;1897.00;10
4752;37;625744214;4752;306;5578;5588;7.11;0.43;249.57;4.11;826;37;1898.00;10
4756;37;625744226;4756;307;5579;5589;7.17;0.44;249.58;4.11;823;37;1899.00;10
4760;37;625744239;4760;306;5579;5589;7.20;0.44;249.57;4.11;819;37;1900.00;10
4764;37;625744263;4764;304;5584;5595;7.26;0.44;249.59;4.11;820;37;1901.00;11
4765;37;625744279;4765;308;5584;5595;7.31;0.45;249.62;4.11;819;37;1902.00;11
4771;37;625744291;4771;301;5586;5596;7.33;0.45;249.69;4.11;815;37;1903.00;10
4775;37;625744303;4775;298;5587;5596;7.37;0.45;249.64;4.13;812;37;1904.00;9
4777;37;625744320;4777;295;5587;5596;7.46;0.45;249.57;4.13;810;37;1905.00;9
4777;37;625744333;4777;297;5587;5596;7.57;0.46;249.57;4.13;810;37;1906.00;9
4782;37;625744344;4782;298;5587;5596;7.59;0.46;249.79;4.13;805;37;1907.00;9
4783;37;625744356;4783;301;5598;5608;7.75;0.47;249.75;4.12;815;37;1908.00;10
4784;37;625744369;4784;296;5598;5608;7.79;0.47;249.80;4.12;814;37;1909.00;10
4789;37;625744381;4789;298;5599;5608;7.78;0.47;249.80;4.12;810;37;1910.00;9
4790;37;625744393;4790;295;5599;5608;7.71;0.47;249.83;4.12;809;37;1911.00;9
4792;37;625744404;4792;307;5599;5608;7.70;0.47;249.83;4.12;807;37;1912.00;9
4794;37;625744418;4794;307;5599;5608;7.68;0.47;249.85;4.12;805;37;1913.00;9
4797;37;625744430;4797;310;5602;5612;7.70;0.47;249.91;4.12;805;37;1914.00;10
4800;37;625744443;4800;317;5602;5612;7.65;0.47;250.01;4.12;802;37;1915.00;10
4801;37;625744455;4801;321;5605;5616;7.59;0.46;250.01;4.12;804;37;1916.00;11
4803;37;625744468;4803;312;5606;5617;7.52;0.46;250.00;4.11;803;37;1917.00;11
4808;37;625744481;4808;307;5608;5617;7.51;0.46;249.95;4.13;800;37;1918.00;9
4810;37;625744493;4810;308;5608;5617;7.56;0.46;249.95;4.13;798;37;1919.00;9
4813;37;625744511;4813;313;5630;5646;7.66;0.47;249.94;4.12;817;37;1920.00;16
4815;37;625744530;4815;304;5631;5646;7.65;0.47;250.03;4.14;816;37;1921.00;15
4819;37;625744548;4819;307;5633;5646;7.71;0.47;250.03;4.14;814;37;1922.00;13
4821;37;625744569;4821;301;5635;5647;7.81;0.47;250.02;4.14;814;37;1923.00;12
4825;37;625744588;4825;300;5636;5648;7.83;0.48;249.99;4.16;811;37;1924.00;12
4826;37;625744616;4826;300;5636;5648;7.83;0.48;250.09;4.16;810;37;1925.00;12
4828;37;625744649;4828;286;5639;5651;7.89;0.48;250.04;4.16;811;37;1926.00;12
4829;37;625744662;4829;279;5640;5651;7.88;0.48;250.05;4.18;811;37;1927.00;11
4830;37;625744674;4830;271;5640;5651;7.91;0.48;250.03;4.18;810;37;1928.00;11
4832;37;625744689;4832;267;5640;5651;7.97;0.49;250.07;4.18;808;37;1929.00;11
4835;37;625744702;4835;264;5644;5657;8.07;0.49;250.00;4.18;809;37;1930.00;13
4837;37;625744715;4837;261;5645;5657;8.15;0.50;250.02;4.18;808;37;1931.00;12
4837;37;625744733;4837;255;5645;5657;8.24;0.50;250.02;4.18;808;37;1932.00;12
4840;37;625744745;4840;254;5645;5657;8.30;0.50;250.08;4.18;805;37;1933.00;12
4842;37;625744757;4842;254;5648;5661;8.32;0.51;250.10;4.17;806;37;1934.00;13
4844;37;625744770;4844;260;5650;5663;8.34;0.51;250.06;4.17;806;37;1935.00;13
4846;37;625744782;4846;267;5650;5663;8.32;0.51;250.05;4.17;804;37;1936.00;13
4849;37;625744794;4849;259;5651;5664;8.34;0.51;250.05;4.17;802;37;1937.00;13
4853;37;625744806;4853;255;5651;5664;8.33;0.51;250.07;4.17;798;37;1938.00;13
4854;37;625744818;4854;251;5651;5664;8.29;0.50;250.08;4.17;797;37;1939.00;13
4860;37;625744829;4860;242;5651;5664;8.22;0.50;250.18;4.17;791;37;1940.00;13
4866;38;625744841;4866;241;5652;5664;8.21;0.50;250.11;4.20;786;38;1941.00;12
4869;38;625744865;4869;233;5652;5664;8.27;0.50;250.18;4.20;783;38;1942.00;12
4869;38;625744876;4869;228;5652;5664;8.33;0.51;250.18;4.20;783;38;1943.00;12
4872;38;625744887;4872;245;5697;5734;8.18;0.50;250.15;4.16;825;38;1944.00;37
4874;38;625744905;4874;238;5697;5735;8.29;0.50;250.12;4.16;823;38;1945.00;38
4875;38;625744926;4875;231;5703;5735;8.50;0.52;250.20;4.16;828;38;1946.00;32
4877;38;625744938;4877;222;5706;5735;8.63;0.53;250.20;4.16;829;38;1947.00;29
4878;38;625744948;4878;219;5712;5735;8.81;0.54;250.25;4.16;834;38;1948.00;23
4882;38;625744959;4882;219;5714;5735;8.83;0.54;250.39;4.16;832;38;1949.00;21
4885;38;625744972;4885;217;5716;5737;8.89;0.54;250.46;4.16;831;38;1950.00;21
4887;38;625744984;4887;217;5716;5737;8.96;0.55;250.43;4.16;829;38;1951.00;21
4893;38;625744995;4893;217;5719;5738;8.98;0.55;250.46;4.16;826;38;1952.00;19
4894;38;625745007;4894;215;5720;5739;9.06;0.55;250.48;4.16;826;38;1953.00;19
4895;38;625745018;4895;223;5721;5739;9.10;0.55;250.50;4.16;826;38;1954.00;18
4898;38;625745029;4898;222;5725;5743;9.06;0.55;250.47;4.19;827;38;1955.00;18
4900;38;625745041;4900;227;5726;5743;9.07;0.55;250.48;4.19;826;38;1956.00;17
4902;38;625745052;4902;231;5726;5743;9.09;0.55;250.51;4.19;824;38;1957.00;17
4905;38;625745063;4905;224;5726;5743;9.02;0.55;250.54;4.19;821;38;1958.00;17
4908;38;625745074;4908;223;5731;5749;9.01;0.55;250.51;4.18;823;38;1959.00;18
4909;38;625745085;4909;223;5731;5749;8.97;0.55;250.52;4.18;822;38;1960.00;18
4910;38;625745096;4910;228;5731;5749;8.90;0.54;250.52;4.18;821;38;1961.00;18
4912;38;625745114;4912;228;5734;5752;8.92;0.54;250.57;4.18;822;38;1962.00;18
4915;38;625745125;4915;228;5735;5752;8.92;0.54;250.62;4.20;820;38;1963.00;17
4918;38;625745136;4918;225;5735;5752;8.92;0.54;250.66;4.20;817;38;1964.00;17
4920;38;625745148;4920;223;5735;5753;8.95;0.55;250.72;4.20;815;38;1965.00;18
4924;38;625745159;4924;219;5736;5754;8.88;0.54;250.77;4.20;812;38;1966.00;18
4925;38;625745170;4925;219;5736;5754;8.88;0.54;250.82;4.20;811;38;1967.00;18
4930;38;625745180;4930;218;5745;5767;8.78;0.54;250.80;4.19;815;38;1968.00;22
4936;38;625745193;4936;211;5745;5767;8.75;0.54;250.84;4.19;809;38;1969.00;22
4941;38;625745204;4941;208;5745;5767;8.74;0.53;250.84;4.19;804;38;1970.00;22
4941;38;625745215;4941;208;5746;5768;8.72;0.53;250.84;4.19;805;38;1971.00;22
4945;38;625745225;4945;198;5747;5768;8.64;0.53;250.79;4.20;802;38;1972.00;21
4951;38;625745235;4951;198;5750;5772;8.63;0.53;250.86;4.20;799;38;1973.00;22
4956;38;625745246;4956;187;5752;5772;8.64;0.53;250.97;4.21;796;38;1974.00;20
4961;38;625745258;4961;177;5755;5776;8.60;0.52;250.85;4.21;794;38;1975.00;21
4965;38;625745269;4965;171;5756;5776;8.64;0.53;250.97;4.22;791;38;1976.00;20
4968;38;625745280;4968;167;5756;5776;8.73;0.53;250.95;4.22;788;38;1977.00;20
4973;38;625745290;4973;162;5756;5776;8.75;0.53;251.01;4.22;783;38;1978.00;20
4975;38;625745301;4975;153;5756;5776;8.78;0.53;251.12;4.22;781;38;1979.00;20
4976;38;625745313;4976;152;5775;5810;8.81;0.54;251.17;4.21;799;38;1980.00;35
4978;38;625745326;4978;147;5777;5810;8.80;0.54;251.17;4.22;799;38;1981.00;33
4980;38;625745336;4980;143;5778;5810;8.83;0.54;251.17;4.22;798;38;1982.00;32
4984;38;625745347;4984;147;5779;5810;8.84;0.54;251.27;4.22;795;38;1983.00;31
4984;38;625745357;4984;148;5779;5810;8.88;0.54;251.27;4.22;795;38;1984.00;31
4986;38;625745368;4986;148;5780;5810;9.00;0.55;251.42;4.22;794;38;1985.00;30
4987;38;625745379;4987;150;5781;5811;9.08;0.55;251.48;4.23;794;38;1986.00;30
4990;38;625745400;4990;145;5783;5811;9.16;0.56;251.55;4.23;793;38;1987.00;28
4994;38;625745411;4994;143;5785;5817;9.18;0.56;251.58;4.23;791;38;1988.00;32
4997;38;625745423;4997;141;5787;5818;9.26;0.56;251.49;4.23;790;38;1989.00;31
5002;38;625745434;5002;145;5788;5818;9.25;0.56;251.43;4.23;786;38;1990.00;30
5004;38;625745455;5004;143;5790;5818;9.28;0.56;251.49;4.23;786;38;1991.00;28
5006;38;625745467;5006;143;5793;5822;9.32;0.57;251.53;4.23;787;38;1992.00;29
5011;38;625745479;5011;148;5794;5822;9.26;0.56;251.55;4.24;783;38;1993.00;28
5013;38;625745491;5013;157;5795;5822;9.31;0.57;251.61;4.24;782;38;1994.00;27
5014;38;625745505;5014;163;5796;5823;9.33;0.57;251.66;4.24;782;38;1995.00;27
5015;38;625745520;5015;170;5801;5827;9.39;0.57;251.66;4.25;786;38;1996.00;26
5017;38;625745532;5017;171;5802;5827;9.36;0.57;251.75;4.26;785;38;1997.00;25
5022;38;625745544;5022;170;5804;5830;9.38;0.57;251.84;4.26;782;38;1998.00;26
5025;38;625745557;5025;167;5806;5830;9.42;0.57;251.85;4.26;781;38;1999.00;24
5027;38;625745569;5027;162;5807;5830;9.45;0.57;251.84;4.27;780;38;2000.00;23
5028;38;625745585;5028;167;5808;5830;9.42;0.57;251.92;4.28;780;38;2001.00;22
5029;38;625745595;5029;169;5812;5834;9.53;0.58;251.95;4.28;783;38;2002.00;22
5029;38;625745606;5029;178;5813;5834;9.55;0.58;251.95;4.29;784;38;2003.00;21
5029;38;625745622;5029;184;5814;5834;9.57;0.58;251.95;4.29;785;38;2004.00;20
5030;38;625745632;5030;184;5815;5834;9.55;0.58;251.95;4.30;785;38;2005.00;19
5033;38;625745648;5033;189;5816;5835;9.52;0.58;251.95;4.31;783;38;2006.00;19
5034;38;625745658;5034;193;5818;5836;9.52;0.58;252.06;4.31;784;38;2007.00;18
5040;38;625745668;5040;198;5818;5836;9.52;0.58;252.10;4.31;778;38;2008.00;18
5043;38;625745679;5043;207;5820;5837;9.43;0.57;252.05;4.32;777;38;2009.00;17
5046;38;625745691;5046;213;5820;5837;9.37;0.57;251.98;4.32;774;38;2010.00;17
5049;38;625745701;5049;214;5821;5837;9.29;0.57;251.94;4.33;772;38;2011.00;16
5050;38;625745711;5050;220;5822;5837;9.21;0.56;251.96;4.34;772;38;2012.00;15
5052;38;625745721;5052;222;5823;5837;9.15;0.56;251.95;4.35;771;38;2013.00;14
5053;38;625745730;5053;226;5823;5837;9.06;0.55;251.92;4.35;770;38;2014.00;14
5056;38;625745739;5056;230;5825;5837;8.94;0.55;251.89;4.36;769;38;2015.00;12
5059;38;625745749;5059;254;5891;5964;8.95;0.55;251.83;4.31;832;38;2016.00;73
5060;38;625745768;5060;256;5897;5965;8.78;0.54;251.91;4.32;837;38;2017.00;68
5063;38;625745777;5063;255;5906;5965;8.66;0.54;251.89;4.33;843;38;2018.00;59
5066;38;625745787;5066;255;5909;5965;8.53;0.53;251.83;4.33;843;38;2019.00;56
5070;38;625745796;5070;254;5917;5965;8.48;0.53;251.73;4.34;847;38;2020.00;48
5073;38;625745806;5073;248;5923;5965;8.45;0.52;251.66;4.34;850;38;2021.00;42
5076;38;625745820;5076;252;5931;5965;8.37;0.52;251.60;4.35;855;38;2022.00;34
5078;38;625745830;5078;252;5937;5965;8.41;0.52;251.60;4.35;859;38;2023.00;28
5081;38;625745840;5081;255;5942;5966;8.34;0.52;251.47;4.35;861;38;2024.00;24
5082;38;625745855;5082;259;5945;5968;8.34;0.51;251.48;4.35;863;38;2025.00;23
5083;38;625745865;5083;267;5948;5968;8.33;0.51;251.46;4.35;865;38;2026.00;20
5087;38;625745875;5087;273;5949;5969;8.27;0.51;251.41;4.36;862;38;2027.00;20
5088;38;625745886;5088;277;5951;5969;8.21;0.50;251.39;4.36;863;38;2028.00;18
5091;38;625745896;5091;283;5953;5969;8.10;0.50;251.34;4.36;862;38;2029.00;16
5092;38;625745906;5092;287;5955;5969;7.99;0.49;251.46;4.36;863;38;2030.00;14
5095;38;625745916;5095;295;5958;5973;7.86;0.48;251.41;4.37;863;38;2031.00;15
5095;38;625745927;5095;307;5962;5973;7.68;0.47;251.41;4.37;867;38;2032.00;11
5098;38;625745942;5098;315;5962;5973;7.51;0.46;251.39;4.37;864;38;2033.00;11
5100;38;625745951;5100;322;5965;5976;7.40;0.45;251.37;4.38;865;38;2034.00;11
5103;38;625745961;5103;331;5967;5976;7.19;0.44;251.29;4.38;864;38;2035.00;9
5106;38;625745976;5106;338;5968;5976;7.03;0.43;251.28;4.38;862;38;2036.00;8
5108;38;625745986;5108;343;5972;5980;6.89;0.42;251.28;4.37;864;38;2037.00;8
5114;38;625745995;5114;349;5974;5981;6.69;0.41;251.30;4.37;860;38;2038.00;7
5116;38;625746004;5116;356;5974;5981;6.48;0.40;251.37;4.37;858;38;2039.00;7
5120;38;625746014;5120;351;5980;5986;6.39;0.39;251.28;4.37;860;38;2040.00;6
5123;38;625746025;5123;343;5980;5986;6.24;0.38;251.31;4.37;857;38;2041.00;6
5124;38;625746033;5124;346;5980;5986;6.12;0.38;251.34;4.37;856;38;2042.00;6
5125;38;625746042;5125;340;5981;5987;6.12;0.38;251.38;4.37;856;38;2043.00;6
5128;38;625746051;5128;336;5981;5987;6.13;0.38;251.32;4.37;853;38;2044.00;6
5128;38;625746060;5128;331;5986;5993;6.23;0.38;251.32;4.37;858;38;2045.00;7
5131;38;625746070;5131;329;5987;5993;6.32;0.39;251.40;4.37;856;38;2046.00;6
5133;38;625746080;5133;319;5988;5994;6.41;0.39;251.42;4.37;855;38;2047.00;6
5137;38;625746090;5137;309;5988;5994;6.48;0.40;251.37;4.37;851;38;2048.00;6
5138;38;625746100;5138;303;5988;5994;6.62;0.41;251.39;4.37;850;38;2049.00;6
5140;38;625746110;5140;295;5988;5994;6.73;0.41;251.47;4.37;848;38;2050.00;6
5143;38;625746120;5143;278;5988;5994;6.84;0.42;251.47;4.37;845;38;2051.00;6
5145;38;625746129;5145;275;5999;6006;6.98;0.43;251.45;4.36;854;38;2052.00;7
5150;38;625746150;5150;266;5999;6006;7.00;0.43;251.46;4.36;849;38;2053.00;7
5152;38;625746161;5152;262;6000;6006;7.10;0.43;251.46;4.36;848;38;2054.00;6
5155;38;625746171;5155;252;6000;6006;7.18;0.44;251.45;4.36;845;38;2055.00;6
5156;38;625746182;5156;249;6000;6006;7.30;0.45;251.43;4.36;844;38;2056.00;6
5159;38;625746192;5159;245;6000;6006;7.38;0.45;251.44;4.36;841;38;2057.00;6
5162;38;625746203;5162;246;6004;6010;7.44;0.45;251.43;4.35;842;38;2058.00;6
5166;38;625746214;5166;245;6004;6010;7.49;0.46;251.32;4.35;838;38;2059.00;6
5170;38;625746225;5170;252;6007;6014;7.63;0.46;251.32;4.35;837;38;2060.00;7
5171;38;625746236;5171;252;6008;6015;7.74;0.47;251.36;4.35;837;38;2061.00;7
5171;38;625746247;5171;256;6009;6015;7.81;0.48;251.36;4.35;838;38;2062.00;6
5174;38;625746258;5174;261;6009;6015;7.81;0.48;251.34;4.35;835;38;2063.00;6
5177;38;625746269;5177;256;6022;6028;7.86;0.48;251.49;4.34;845;38;2064.00;6
5181;38;625746281;5181;256;6022;6028;7.89;0.48;251.56;4.34;841;38;2065.00;6
5184;38;625746292;5184;255;6022;6028;7.88;0.48;251.67;4.34;838;38;2066.00;6
5190;38;625746303;5190;250;6023;6029;7.90;0.48;251.92;4.34;833;38;2067.00;6
5194;38;625746314;5194;253;6024;6030;7.86;0.48;251.92;4.34;830;38;2068.00;6
5198;38;625746325;5198;254;6024;6030;7.82;0.48;252.00;4.34;826;38;2069.00;6
5204;38;625746337;5204;254;6027;6036;7.86;0.48;252.03;4.34;823;38;2070.00;9
5207;38;625746349;5207;258;6027;6036;7.90;0.48;252.10;4.34;820;38;2071.00;9
5213;38;625746360;5213;260;6028;6036;7.93;0.48;252.18;4.34;815;38;2072.00;8
5217;38;625746370;5217;259;6028;6036;7.93;0.48;252.22;4.34;811;38;2073.00;8
5222;38;625746381;5222;260;6033;6042;7.97;0.49;252.31;4.34;811;38;2074.00;9
5229;38;625746393;5229;264;6033;6042;7.97;0.49;252.27;4.34;804;38;2075.00;9
5232;38;625746404;5232;267;6035;6042;7.95;0.49;252.40;4.36;803;38;2076.00;7
5238;38;625746415;5238;273;6035;6042;7.93;0.48;252.43;4.36;797;38;2077.00;7
5239;38;625746426;5239;273;6040;6046;7.93;0.48;252.52;4.36;801;38;2078.00;6
5242;38;625746437;5242;273;6041;6047;7.97;0.49;252.55;4.36;799;38;2079.00;6
5246;38;625746448;5246;275;6042;6047;7.87;0.48;252.56;4.36;796;38;2080.00;5
5249;38;625746460;5249;283;6043;6048;7.84;0.48;252.56;4.36;794;38;2081.00;5
5252;38;625746471;5252;283;6043;6048;7.78;0.48;252.55;4.36;791;38;2082.00;5
5256;38;625746482;5256;287;6043;6048;7.70;0.47;252.53;4.36;787;38;2083.00;5
5258;38;625746492;5258;288;6043;6048;7.56;0.46;252.59;4.36;785;38;2084.00;5
5259;38;625746503;5259;289;6043;6048;7.54;0.46;252.63;4.36;784;38;2085.00;5
5264;38;625746521;5264;291;6043;6048;7.55;0.46;252.73;4.36;779;38;2086.00;5
5265;38;625746538;5265;285;6043;6048;7.56;0.46;252.75;4.36;778;38;2087.00;5
5265;38;625746556;5265;289;6089;6118;7.66;0.47;252.75;4.32;824;38;2088.00;29
5267;38;625746584;5267;280;6090;6119;7.69;0.47;252.80;4.32;823;38;2089.00;29
5270;38;625746601;5270;273;6095;6119;7.81;0.48;252.79;4.32;825;38;2090.00;24
5273;38;625746619;5273;275;6099;6119;7.95;0.48;252.74;4.32;826;38;2091.00;20
5277;38;625746635;5277;272;6102;6119;8.03;0.49;252.80;4.32;825;38;2092.00;17
5279;38;625746649;5279;274;6106;6119;8.19;0.50;252.86;4.32;827;38;2093.00;13
5280;38;625746664;5280;280;6108;6119;8.26;0.50;252.84;4.32;828;38;2094.00;11
5282;38;625746678;5282;285;6109;6119;8.29;0.50;252.83;4.32;827;38;2095.00;10
5286;38;625746691;5286;274;6111;6120;8.33;0.51;252.82;4.32;825;38;2096.00;9
5288;38;625746706;5288;261;6112;6121;8.34;0.51;252.76;4.32;824;38;2097.00;9
5291;38;625746728;5291;257;6113;6121;8.33;0.51;252.80;4.32;822;38;2098.00;8
5293;38;625746743;5293;252;6116;6125;8.26;0.50;252.86;4.32;823;38;2099.00;9
5297;38;625746765;5297;252;6120;6140;8.22;0.50;253.04;4.32;823;38;2100.00;20
5300;38;625746793;5300;247;6120;6140;8.26;0.50;253.13;4.32;820;38;2101.00;20
5303;38;625746807;5303;251;6120;6140;8.30;0.51;253.12;4.32;817;38;2102.00;20
5304;38;625746821;5304;254;6123;6146;8.38;0.51;253.11;4.31;819;38;2103.00;23
5310;38;625746834;5310;249;6123;6146;8.44;0.51;253.24;4.31;813;38;2104.00;23
5313;38;625746848;5313;246;6123;6146;8.50;0.52;253.27;4.31;810;38;2105.00;23
5314;38;625746861;5314;244;6127;6149;8.60;0.52;253.29;4.31;813;38;2106.00;22
5315;38;625746874;5315;236;6127;6149;8.69;0.53;253.30;4.31;812;38;2107.00;22
5317;38;625746888;5317;230;6127;6149;8.76;0.53;253.33;4.31;810;38;2108.00;22
5320;38;625746902;5320;222;6127;6150;8.80;0.54;253.36;4.31;807;38;2109.00;23
5326;38;625746916;5326;212;6128;6151;8.77;0.53;253.30;4.31;802;38;2110.00;23
5329;38;625746930;5329;208;6128;6151;8.81;0.53;253.44;4.31;799;38;2111.00;23
5331;38;625746943;5331;207;6139;6164;8.90;0.54;253.45;4.31;808;38;2112.00;25
5334;38;625746957;5334;196;6139;6164;8.97;0.54;253.45;4.31;805;38;2113.00;25
5335;38;625746971;5335;192;6139;6164;9.02;0.55;253.43;4.31;804;38;2114.00;25
5337;38;625746984;5337;193;6141;6166;9.09;0.55;253.41;4.31;804;38;2115.00;25
5340;39;625746997;5340;198;6141;6166;9.12;0.55;253.52;4.31;801;39;2116.00;25
5344;39;625747028;5344;195;6143;6170;9.17;0.55;253.55;4.31;799;39;2117.00;27
5347;39;625747043;5347;196;6145;6170;9.16;0.55;253.56;4.31;798;39;2118.00;25
5349;39;625747057;5349;197;6148;6174;9.10;0.55;253.60;4.31;799;39;2119.00;26
5350;39;625747070;5350;198;6148;6174;9.18;0.55;253.60;4.31;798;39;2120.00;26
5353;39;625747083;5353;202;6148;6174;9.29;0.56;253.65;4.31;795;39;2121.00;26
5355;39;625747096;5355;208;6148;6174;9.38;0.57;253.68;4.31;793;39;2122.00;26
5356;40;625747109;5356;210;6149;6174;9.43;0.57;253.65;4.31;793;40;2123.00;25
5360;40;625747129;5360;212;6158;6186;9.46;0.57;253.82;4.31;798;40;2124.00;28
5360;41;625747156;5360;211;6158;6186;9.48;0.57;253.82;4.31;798;41;2125.00;28
5362;41;625747177;5362;211;6159;6186;9.50;0.58;253.89;4.31;797;41;2126.00;27
5363;41;625747194;5363;211;6161;6186;9.57;0.58;253.89;4.32;798;41;2127.00;25
5364;41;625747211;5364;212;6161;6186;9.60;0.58;253.87;4.32;797;41;2128.00;25
5366;41;625747230;5366;212;6164;6186;9.58;0.58;253.88;4.33;798;41;2129.00;22
5368;41;625747244;5368;210;6167;6187;9.57;0.58;253.83;4.35;799;41;2130.00;20
5370;41;625747257;5370;207;6167;6187;9.46;0.57;253.84;4.35;797;41;2131.00;20
5373;41;625747275;5373;202;6171;6193;9.35;0.57;253.80;4.35;798;41;2132.00;22
5373;41;625747287;5373;200;6173;6194;9.24;0.56;253.80;4.35;800;41;2133.00;21
5378;41;625747299;5378;194;6173;6194;9.08;0.55;253.79;4.35;795;41;2134.00;21
5380;41;625747318;5380;195;6174;6194;8.93;0.54;253.77;4.35;794;41;2135.00;20
5382;41;625747330;5382;190;6178;6198;8.86;0.54;253.77;4.35;796;41;2136.00;20
5383;41;625747342;5383;182;6179;6198;8.81;0.54;253.80;4.35;796;41;2137.00;19
5383;41;625747353;5383;175;6179;6198;8.78;0.53;253.80;4.35;796;41;2138.00;19
5385;41;625747365;5385;174;6180;6199;8.78;0.54;253.81;4.35;795;41;2139.00;19
5385;41;625747376;5385;173;6183;6203;8.79;0.54;253.81;4.35;798;41;2140.00;20
5387;41;625747387;5387;171;6183;6203;8.80;0.54;253.85;4.35;796;41;2141.00;20
5390;41;625747399;5390;159;6185;6206;8.78;0.54;253.82;4.35;795;41;2142.00;21
5393;41;625747410;5393;159;6186;6206;8.80;0.54;253.77;4.35;793;41;2143.00;20
5399;41;625747422;5399;155;6186;6206;8.77;0.54;253.79;4.35;787;41;2144.00;20
5403;41;625747434;5403;153;6188;6206;8.77;0.54;253.77;4.37;785;41;2145.00;18
5406;41;625747445;5406;156;6191;6210;8.84;0.54;253.77;4.36;785;41;2146.00;19
5411;41;625747457;5411;160;6192;6210;8.87;0.54;253.83;4.36;781;41;2147.00;18
5414;41;625747470;5414;158;6193;6210;8.85;0.54;253.85;4.42;779;41;2148.00;17
5414;41;625747482;5414;160;6193;6210;8.95;0.55;253.85;4.42;779;41;2149.00;17
5420;41;625747493;5420;158;6194;6211;8.90;0.55;253.97;4.45;774;41;2150.00;17
5424;41;625747504;5424;160;6195;6212;8.90;0.54;253.93;4.45;771;41;2151.00;17
5426;41;625747517;5426;157;6195;6212;8.89;0.54;253.89;4.45;769;41;2152.00;17
5431;41;625747528;5431;155;6197;6213;8.93;0.55;253.95;4.47;766;41;2153.00;16
5434;41;625747540;5434;162;6197;6213;8.93;0.55;253.95;4.47;763;41;2154.00;16
5436;41;625747551;5436;163;6197;6213;8.92;0.54;253.96;4.47;761;41;2155.00;16
5440;41;625747563;5440;170;6198;6213;8.89;0.54;254.00;4.49;758;41;2156.00;15
5443;41;625747574;5443;174;6198;6213;8.87;0.54;253.97;4.49;755;41;2157.00;15
5443;41;625747585;5443;171;6198;6213;8.87;0.54;253.97;4.49;755;41;2158.00;15
5447;41;625747596;5447;174;6198;6213;8.86;0.54;253.93;4.49;751;41;2159.00;15
5449;41;625747614;5449;210;6294;6443;8.87;0.56;253.95;4.42;845;41;2160.00;149
5449;41;625747652;5449;210;6296;6444;8.78;0.55;253.95;4.42;847;41;2161.00;148
5450;41;625747663;5450;205;6307;6444;8.86;0.55;253.94;4.41;857;41;2162.00;137
5452;41;625747675;5452;204;6314;6444;8.90;0.56;253.95;4.41;862;41;2163.00;130
5454;41;625747686;5454;205;6322;6444;8.81;0.55;253.95;4.41;868;41;2164.00;122
5455;41;625747697;5455;203;6330;6444;8.79;0.55;253.96;4.41;875;41;2165.00;114
5457;41;625747709;5457;204;6337;6444;8.72;0.54;253.94;4.42;880;41;2166.00;107
5461;41;625747720;5461;208;6341;6444;8.65;0.54;253.84;4.42;880;41;2167.00;103
5463;41;625747732;5463;217;6347;6445;8.56;0.53;253.75;4.42;884;41;2168.00;98
5465;41;625747744;5465;224;6350;6446;8.52;0.53;253.71;4.42;885;41;2169.00;96
5467;41;625747756;5467;230;6358;6446;8.47;0.53;253.70;4.43;891;41;2170.00;88
5471;41;625747769;5471;238;6362;6447;8.43;0.52;253.63;4.43;891;41;2171.00;85
5474;41;625747781;5474;246;6369;6447;8.30;0.51;253.68;4.45;895;41;2172.00;78
5478;41;625747793;5478;259;6372;6447;8.18;0.51;253.66;4.46;894;41;2173.00;75
5485;41;625747806;5485;261;6374;6447;8.10;0.50;253.51;4.47;889;41;2174.00;73
5486;41;625747824;5486;267;6379;6451;8.02;0.49;253.49;4.48;893;41;2175.00;72
5486;41;625747837;5486;271;6380;6451;8.02;0.49;253.49;4.48;894;41;2176.00;71
5486;41;625747849;5486;277;6383;6451;7.94;0.49;253.49;4.49;897;41;2177.00;68
5488;41;625747862;5488;277;6389;6454;7.89;0.48;253.45;4.50;901;41;2178.00;65
5488;41;625747874;5488;287;6392;6454;7.86;0.48;253.45;4.53;904;41;2179.00;62
5489;41;625747886;5489;293;6395;6454;7.77;0.48;253.41;4.55;906;41;2180.00;59
5489;41;625747898;5489;306;6401;6458;7.68;0.47;253.41;4.56;912;41;2181.00;57
5491;41;625747910;5491;311;6405;6459;7.55;0.46;253.41;4.57;914;41;2182.00;54
5493;41;625747922;5493;318;6408;6459;7.48;0.46;253.43;4.58;915;41;2183.00;51
5497;41;625747935;5497;325;6413;6463;7.37;0.45;253.40;4.60;916;41;2184.00;50
5498;41;625747946;5498;337;6415;6463;7.30;0.45;253.40;4.60;917;41;2185.00;48
5500;41;625747958;5500;341;6417;6463;7.25;0.44;253.31;4.61;917;41;2186.00;46
5502;41;625747970;5502;343;6420;6464;7.16;0.44;253.27;4.62;918;41;2187.00;44
5502;41;625747981;5502;350;6425;6464;7.09;0.43;253.27;4.63;923;41;2188.00;39
5503;41;625747992;5503;354;6431;6470;7.05;0.43;253.25;4.64;928;41;2189.00;39
5506;41;625748006;5506;358;6433;6470;6.93;0.42;253.16;4.65;927;41;2190.00;37
5506;41;625748018;5506;366;6435;6471;6.88;0.42;253.16;4.66;929;41;2191.00;36
5507;41;625748029;5507;374;6438;6471;6.85;0.42;253.13;4.67;931;41;2192.00;33
5508;41;625748040;5508;376;6440;6471;6.79;0.42;253.09;4.68;932;41;2193.00;31
5511;41;625748051;5511;381;6441;6471;6.72;0.41;253.00;4.68;930;41;2194.00;30
5511;41;625748062;5511;367;6445;6471;6.68;0.41;253.00;4.69;934;41;2195.00;26
5512;41;625748073;5512;358;6454;6483;6.74;0.41;253.11;4.69;942;41;2196.00;29
5514;41;625748087;5514;355;6456;6483;6.75;0.41;253.09;4.69;942;41;2197.00;27
5516;41;625748099;5516;354;6457;6483;6.78;0.41;253.04;4.69;941;41;2198.00;26
5517;41;625748116;5517;355;6460;6483;6.85;0.42;253.01;4.70;943;41;2199.00;23
5517;41;625748129;5517;357;6460;6483;6.89;0.42;253.01;4.70;943;41;2200.00;23
5520;41;625748144;5520;354;6460;6483;6.89;0.42;252.95;4.70;940;41;2201.00;23
5523;41;625748157;5523;350;6464;6487;6.82;0.42;252.96;4.70;941;41;2202.00;23
5525;41;625748171;5525;348;6464;6487;6.82;0.42;252.92;4.70;939;41;2203.00;23
5526;41;625748182;5526;343;6469;6491;6.77;0.41;252.93;4.70;943;41;2204.00;22
5528;41;625748195;5528;343;6471;6493;6.69;0.41;252.95;4.70;943;41;2205.00;22
5530;41;625748207;5530;351;6473;6493;6.58;0.40;252.95;4.71;943;41;2206.00;20
5535;41;625748225;5535;352;6474;6493;6.50;0.40;252.91;4.71;939;41;2207.00;19
5536;41;625748236;5536;352;6484;6506;6.43;0.39;252.94;4.70;948;41;2208.00;22
5538;41;625748249;5538;358;6485;6506;6.38;0.39;253.01;4.70;947;41;2209.00;21
5540;41;625748260;5540;341;6487;6508;6.37;0.39;253.02;4.70;947;41;2210.00;21
5542;41;625748272;5542;344;6489;6509;6.37;0.39;253.03;4.70;947;41;2211.00;20
5544;42;625748284;5544;335;6490;6510;6.34;0.39;253.07;4.70;946;42;2212.00;20
5547;42;625748302;5547;330;6491;6510;6.35;0.39;253.07;4.70;944;42;2213.00;19
5549;42;625748314;5549;326;6494;6513;6.40;0.39;253.08;4.70;945;42;2214.00;19
5553;42;625748331;5553;330;6494;6513;6.44;0.40;253.16;4.70;941;42;2215.00;19
5556;42;625748343;5556;325;6494;6513;6.46;0.40;253.21;4.70;938;42;2216.00;19
5558;42;625748356;5558;318;6494;6513;6.56;0.40;253.27;4.70;936;42;2217.00;19
5561;42;625748367;5561;320;6498;6519;6.70;0.41;253.37;4.70;937;42;2218.00;21
5563;42;625748380;5563;310;6498;6519;6.81;0.42;253.42;4.70;935;42;2219.00;21
5567;42;625748395;5567;305;6500;6519;6.85;0.42;253.45;4.70;933;42;2220.00;19
5572;42;625748407;5572;300;6500;6519;6.90;0.43;253.57;4.70;928;42;2221.00;19
5580;42;625748420;5580;294;6507;6523;6.94;0.43;253.59;4.72;927;42;2222.00;16
5584;42;625748438;5584;286;6508;6524;6.97;0.43;253.61;4.72;924;42;2223.00;16
5588;42;625748451;5588;287;6508;6524;7.01;0.43;253.57;4.72;920;42;2224.00;16
5594;42;625748466;5594;289;6509;6525;7.07;0.43;253.64;4.72;915;42;2225.00;16
5600;42;625748479;5600;291;6509;6525;7.06;0.43;253.68;4.72;909;42;2226.00;16
5601;42;625748492;5601;289;6509;6525;7.11;0.44;253.64;4.72;908;42;2227.00;16
5609;42;625748504;5609;282;6509;6525;7.15;0.44;253.76;4.72;900;42;2228.00;16
5613;42;625748523;5613;280;6509;6525;7.14;0.44;253.87;4.72;896;42;2229.00;16
5617;42;625748543;5617;274;6509;6525;7.20;0.44;253.87;4.72;892;42;2230.00;16
5623;42;625748564;5623;273;6509;6525;7.24;0.44;254.02;4.72;886;42;2231.00;16
5626;42;625748582;5626;268;6546;6595;7.43;0.45;254.07;4.69;920;42;2232.00;49
5630;42;625748620;5630;263;6548;6596;7.53;0.46;254.08;4.69;918;42;2233.00;48
5636;42;625748639;5636;262;6557;6596;7.61;0.47;254.01;4.69;921;42;2234.00;39
5638;42;625748655;5638;258;6558;6596;7.73;0.47;254.01;4.69;920;42;2235.00;38
5643;42;625748669;5643;260;6562;6596;7.77;0.47;254.18;4.69;919;42;2236.00;34
5649;42;625748685;5649;258;6566;6596;7.83;0.48;254.35;4.69;917;42;2237.00;30
5653;42;625748703;5653;256;6571;6596;7.86;0.48;254.45;4.69;918;42;2238.00;25
5657;42;625748725;5657;265;6573;6596;7.87;0.48;254.55;4.69;916;42;2239.00;23
5660;42;625748741;5660;268;6575;6597;7.92;0.48;254.53;4.69;915;42;2240.00;22
5666;42;625748757;5666;271;6576;6598;7.93;0.49;254.57;4.69;910;42;2241.00;22
5672;42;625748772;5672;267;6577;6598;7.95;0.48;254.66;4.69;905;42;2242.00;21
5675;42;625748788;5675;267;6581;6602;7.97;0.49;254.62;4.70;906;42;2243.00;21
5680;42;625748803;5680;275;6581;6602;7.98;0.49;254.74;4.70;901;42;2244.00;21
5682;42;625748819;5682;278;6581;6602;7.97;0.49;254.82;4.70;899;42;2245.00;21
5684;42;625748834;5684;284;6581;6602;7.96;0.49;254.90;4.70;897;42;2246.00;21
5687;42;625748848;5687;285;6585;6608;8.01;0.49;255.02;4.69;898;42;2247.00;23
5693;42;625748863;5693;291;6585;6608;8.01;0.49;255.06;4.69;892;42;2248.00;23
5698;42;625748879;5698;285;6586;6608;8.04;0.49;255.09;4.69;888;42;2249.00;22
5702;42;625748895;5702;287;6589;6614;8.05;0.49;255.21;4.69;887;42;2250.00;25
5706;42;625748911;5706;294;6590;6614;8.03;0.49;255.34;4.69;884;42;2251.00;24
5708;42;625748925;5708;304;6590;6614;7.96;0.48;255.37;4.69;882;42;2252.00;24
5713;42;625748939;5713;304;6591;6615;7.87;0.48;255.36;4.69;878;42;2253.00;24
5718;42;625748954;5718;307;6592;6616;7.81;0.48;255.49;4.69;874;42;2254.00;24
5721;42;625748969;5721;313;6593;6616;7.79;0.47;255.58;4.69;872;42;2255.00;23
5723;42;625748984;5723;317;6603;6629;7.83;0.48;255.63;4.68;880;42;2256.00;26
5728;42;625748998;5728;305;6604;6629;7.80;0.47;255.87;4.68;876;42;2257.00;25
5730;42;625749013;5730;295;6604;6629;7.88;0.48;255.94;4.68;874;42;2258.00;25
5732;42;625749028;5732;290;6605;6630;7.92;0.48;255.94;4.68;873;42;2259.00;25
5735;42;625749041;5735;292;6605;6630;7.92;0.48;255.94;4.68;870;42;2260.00;25
5739;42;625749056;5739;293;6608;6634;7.96;0.49;256.05;4.68;869;42;2261.00;26
5741;43;625749071;5741;287;6608;6634;8.02;0.49;256.09;4.68;867;43;2262.00;26
5746;43;625749095;5746;290;6612;6638;8.04;0.49;256.10;4.68;866;43;2263.00;26
5747;43;625749110;5747;290;6612;6638;8.06;0.49;256.08;4.68;865;43;2264.00;26
5751;43;625749129;5751;291;6612;6638;8.11;0.49;256.12;4.68;861;43;2265.00;26
5754;43;625749151;5754;282;6612;6638;8.14;0.50;256.10;4.68;858;43;2266.00;26
5756;43;625749165;5756;271;6612;6638;8.20;0.50;256.15;4.68;856;43;2267.00;26
5760;43;625749180;5760;264;6621;6650;8.24;0.50;256.19;4.67;861;43;2268.00;29
5761;43;625749195;5761;254;6621;6650;8.38;0.51;256.20;4.67;860;43;2269.00;29
5766;43;625749209;5766;244;6623;6650;8.50;0.52;256.20;4.67;857;43;2270.00;27
5768;43;625749224;5768;243;6623;6650;8.62;0.52;256.26;4.67;855;43;2271.00;27
5772;43;625749239;5772;246;6623;6650;8.70;0.53;256.27;4.67;851;43;2272.00;27
5774;43;625749254;5774;251;6623;6650;8.71;0.53;256.28;4.67;849;43;2273.00;27
5777;44;625749269;5777;248;6623;6651;8.75;0.53;256.30;4.67;846;44;2274.00;28
5780;44;625749295;5780;248;6623;6651;8.77;0.53;256.31;4.67;843;44;2275.00;28
5783;44;625749317;5783;249;6627;6657;8.77;0.53;256.30;4.67;844;44;2276.00;30
5787;44;625749333;5787;233;6628;6658;8.85;0.54;256.35;4.67;841;44;2277.00;30
5789;44;625749348;5789;227;6629;6658;8.93;0.54;256.31;4.67;840;44;2278.00;29
5792;44;625749361;5792;221;6629;6658;8.92;0.54;256.34;4.67;837;44;2279.00;29
5797;44;625749377;5797;217;6633;6663;8.94;0.54;256.34;4.67;836;44;2280.00;30
5799;44;625749392;5799;210;6633;6663;8.96;0.54;256.41;4.67;834;44;2281.00;30
5802;44;625749405;5802;207;6633;6663;9.00;0.55;256.42;4.67;831;44;2282.00;30
5807;44;625749419;5807;205;6634;6664;8.99;0.55;256.57;4.67;827;44;2283.00;30
5811;44;625749433;5811;201;6637;6668;8.95;0.54;256.56;4.66;826;44;2284.00;31
5813;44;625749446;5813;203;6637;6668;8.93;0.54;256.60;4.66;824;44;2285.00;31
5817;44;625749462;5817;201;6639;6671;8.91;0.54;256.74;4.66;822;44;2286.00;32
5820;44;625749477;5820;202;6639;6671;8.91;0.54;256.71;4.66;819;44;2287.00;32
5822;44;625749493;5822;201;6640;6671;8.85;0.54;256.72;4.66;818;44;2288.00;31
5822;44;625749505;5822;192;6640;6671;8.88;0.54;256.72;4.66;818;44;2289.00;31
5823;44;625749520;5823;192;6643;6675;8.83;0.54;256.72;4.66;820;44;2290.00;32
5823;44;625749535;5823;197;6643;6675;8.81;0.54;256.72;4.66;820;44;2291.00;32
5824;44;625749547;5824;195;6644;6675;8.83;0.54;256.70;4.66;820;44;2292.00;31
5826;44;625749560;5826;196;6645;6675;8.78;0.53;256.77;4.68;819;44;2293.00;30
5827;44;625749572;5827;195;6645;6676;8.76;0.53;256.75;4.68;818;44;2294.00;31
5830;44;625749584;5830;200;6647;6678;8.71;0.53;256.77;4.68;817;44;2295.00;31
5831;44;625749596;5831;203;6647;6678;8.67;0.53;256.77;4.68;816;44;2296.00;31
5831;44;625749608;5831;211;6648;6679;8.65;0.53;256.77;4.68;817;44;2297.00;31
5833;44;625749624;5833;210;6648;6679;8.56;0.52;256.75;4.68;815;44;2298.00;31
5835;44;625749641;5835;213;6648;6679;8.44;0.51;256.84;4.68;813;44;2299.00;31
5837;44;625749653;5837;212;6648;6679;8.37;0.51;256.82;4.68;811;44;2300.00;31
5841;44;625749669;5841;214;6648;6679;8.31;0.51;256.86;4.68;807;44;2301.00;31
5843;44;625749679;5843;211;6648;6679;8.30;0.51;256.87;4.68;805;44;2302.00;31
5845;44;625749689;5845;209;6648;6679;8.26;0.50;256.87;4.68;803;44;2303.00;31
5846;44;625749699;5846;229;6718;6806;8.19;0.51;256.86;4.63;872;44;2304.00;88
5850;44;625749719;5850;217;6718;6807;8.15;0.50;256.86;4.63;868;44;2305.00;89
5853;44;625749730;5853;208;6727;6807;8.26;0.51;256.88;4.65;874;44;2306.00;80
5854;44;625749741;5854;195;6729;6807;8.26;0.51;256.97;4.65;875;44;2307.00;78
5855;44;625749751;5855;194;6734;6807;8.30;0.51;257.00;4.65;879;44;2308.00;73
5859;44;625749761;5859;191;6739;6807;8.27;0.51;257.01;4.65;880;44;2309.00;68
5863;44;625749773;5863;194;6745;6807;8.24;0.51;257.03;4.65;882;44;2310.00;62
5866;44;625749783;5866;195;6747;6807;8.21;0.50;257.02;4.65;881;44;2311.00;60
5871;44;625749794;5871;187;6751;6808;8.20;0.50;257.01;4.67;880;44;2312.00;57
5871;44;625749804;5871;198;6755;6809;8.20;0.50;257.01;4.67;884;44;2313.00;54
5876;44;625749814;5876;198;6759;6809;8.16;0.50;256.92;4.69;883;44;2314.00;50
5878;44;625749826;5878;197;6763;6810;8.12;0.50;256.95;4.70;885;44;2315.00;47
5883;44;625749837;5883;195;6765;6810;8.05;0.49;256.92;4.70;882;44;2316.00;45
5886;44;625749847;5886;193;6766;6810;7.97;0.49;256.95;4.70;880;44;2317.00;44
5890;44;625749857;5890;193;6768;6810;7.87;0.48;256.91;4.71;878;44;2318.00;42
5893;44;625749867;5893;191;6770;6814;7.77;0.47;256.86;4.71;877;44;2319.00;44
5893;44;625749878;5893;197;6772;6814;7.69;0.47;256.86;4.71;879;44;2320.00;42
5895;44;625749888;5895;191;6773;6814;7.55;0.46;256.82;4.71;878;44;2321.00;41
5897;44;625749898;5897;197;6776;6817;7.50;0.46;256.81;4.73;879;44;2322.00;41
5899;44;625749909;5899;196;6777;6817;7.42;0.45;256.78;4.73;878;44;2323.00;40
5902;44;625749920;5902;200;6778;6817;7.37;0.45;256.69;4.73;876;44;2324.00;39
5902;44;625749930;5902;204;6782;6821;7.39;0.45;256.69;4.73;880;44;2325.00;39
5903;44;625749941;5903;209;6783;6822;7.42;0.45;256.67;4.73;880;44;2326.00;39
5906;44;625749951;5906;216;6784;6822;7.39;0.45;256.63;4.73;878;44;2327.00;38
5908;44;625749961;5908;219;6786;6826;7.38;0.45;256.60;4.73;878;44;2328.00;40
5910;44;625749972;5910;220;6786;6826;7.33;0.45;256.57;4.73;876;44;2329.00;40
5912;44;625749982;5912;224;6787;6826;7.26;0.44;256.54;4.73;875;44;2330.00;39
5914;44;625749993;5914;236;6788;6827;7.20;0.44;256.51;4.73;874;44;2331.00;39
5917;44;625750003;5917;244;6788;6827;7.16;0.43;256.47;4.73;871;44;2332.00;39
5920;44;625750014;5920;251;6792;6833;7.19;0.44;256.41;4.73;872;44;2333.00;41
5920;44;625750025;5920;257;6792;6833;7.21;0.44;256.41;4.73;872;44;2334.00;41
5923;44;625750035;5923;261;6794;6834;7.21;0.44;256.34;4.74;871;44;2335.00;40
5923;44;625750046;5923;265;6794;6834;7.24;0.44;256.34;4.74;871;44;2336.00;40
5923;44;625750056;5923;275;6794;6834;7.24;0.44;256.34;4.74;871;44;2337.00;40
5923;44;625750066;5923;277;6794;6834;7.19;0.44;256.34;4.74;871;44;2338.00;40
5923;44;625750077;5923;280;6795;6834;7.14;0.43;256.34;4.75;872;44;2339.00;39
5924;44;625750088;5924;293;6817;6870;7.19;0.44;256.31;4.74;893;44;2340.00;53
5925;44;625750101;5925;295;6820;6870;7.17;0.44;256.29;4.75;895;44;2341.00;50
5927;44;625750112;5927;299;6823;6870;7.11;0.43;256.31;4.76;896;44;2342.00;47
5928;44;625750123;5928;295;6826;6870;7.12;0.43;256.30;4.77;898;44;2343.00;44
5928;44;625750133;5928;299;6827;6870;7.12;0.43;256.30;4.78;899;44;2344.00;43
5929;44;625750144;5929;300;6828;6870;7.10;0.43;256.31;4.78;899;44;2345.00;42
5930;44;625750154;5930;303;6834;6874;7.15;0.44;256.28;4.80;904;44;2346.00;40
5932;44;625750164;5932;296;6834;6874;7.18;0.44;256.26;4.80;902;44;2347.00;40
5933;44;625750182;5933;288;6839;6878;7.24;0.44;256.25;4.82;906;44;2348.00;39
5935;44;625750192;5935;283;6841;6879;7.28;0.44;256.20;4.82;906;44;2349.00;38
5936;44;625750203;5936;277;6843;6879;7.26;0.44;256.19;4.83;907;44;2350.00;36
5937;44;625750214;5937;272;6844;6879;7.23;0.44;256.18;4.84;907;44;2351.00;35
5938;44;625750224;5938;274;6856;6892;7.16;0.44;256.14;4.83;918;44;2352.00;36
5939;44;625750235;5939;271;6856;6892;7.16;0.44;256.13;4.83;917;44;2353.00;36
5942;44;625750257;5942;268;6858;6892;7.11;0.43;256.09;4.85;916;44;2354.00;34
5944;44;625750267;5944;268;6860;6893;7.05;0.43;256.09;4.85;916;44;2355.00;33
5944;44;625750277;5944;269;6861;6894;7.05;0.43;256.09;4.86;917;44;2356.00;33
5945;44;625750288;5945;276;6861;6894;7.08;0.43;256.06;4.86;916;44;2357.00;33
5947;44;625750303;5947;282;6865;6897;7.08;0.43;256.04;4.88;918;44;2358.00;32
5948;44;625750322;5948;278;6865;6897;7.08;0.43;256.05;4.88;917;44;2359.00;32
5948;44;625750336;5948;280;6868;6897;7.09;0.43;256.05;4.90;920;44;2360.00;29
5949;44;625750350;5949;276;6868;6897;7.12;0.43;256.01;4.90;919;44;2361.00;29
5949;44;625750362;5949;276;6872;6903;7.16;0.44;256.01;4.89;923;44;2362.00;31
5951;44;625750375;5951;272;6874;6903;7.12;0.43;256.02;4.91;923;44;2363.00;29
5951;44;625750386;5951;272;6875;6903;7.19;0.44;256.02;4.91;924;44;2364.00;28
5953;44;625750398;5953;275;6875;6903;7.20;0.44;256.00;4.91;922;44;2365.00;28
5954;44;625750409;5954;277;6880;6907;7.20;0.44;255.97;4.92;926;44;2366.00;27
5955;44;625750421;5955;281;6882;6908;7.20;0.44;255.96;4.93;927;44;2367.00;26
5958;44;625750433;5958;281;6884;6908;7.25;0.44;255.92;4.94;926;44;2368.00;24
5959;44;625750444;5959;278;6885;6909;7.30;0.44;255.92;4.94;926;44;2369.00;24
5960;44;625750457;5960;280;6885;6909;7.35;0.45;255.90;4.94;925;44;2370.00;24
5963;44;625750468;5963;280;6888;6909;7.33;0.45;255.98;4.95;925;44;2371.00;21
5965;44;625750480;5965;285;6888;6909;7.33;0.45;256.01;4.95;923;44;2372.00;21
5967;44;625750491;5967;285;6890;6909;7.30;0.45;256.02;4.96;923;44;2373.00;19
5970;44;625750503;5970;277;6890;6909;7.27;0.44;256.00;4.96;920;44;2374.00;19
5974;44;625750518;5974;283;6890;6909;7.21;0.44;256.03;4.96;916;44;2375.00;19
5978;44;625750533;5978;280;6933;6979;7.27;0.45;256.04;4.93;955;44;2376.00;46
5982;44;625750558;5982;282;6936;6980;7.12;0.44;256.08;4.93;954;44;2377.00;44
5986;44;625750580;5986;293;6943;6980;7.03;0.43;256.16;4.93;957;44;2378.00;37
5991;44;625750598;5991;302;6948;6980;6.92;0.42;256.15;4.93;957;44;2379.00;32
5994;44;625750618;5994;291;6954;6980;6.90;0.42;256.16;4.93;960;44;2380.00;26
5999;44;625750636;5999;284;6956;6980;6.89;0.42;256.21;4.93;957;44;2381.00;24
6001;44;625750651;6001;284;6960;6980;6.92;0.42;256.24;4.93;959;44;2382.00;20
6007;44;625750664;6007;286;6961;6980;6.90;0.42;256.29;4.93;954;44;2383.00;19
6010;44;625750678;6010;292;6964;6981;6.93;0.42;256.36;4.93;954;44;2384.00;17
6013;44;625750698;6013;292;6966;6983;6.98;0.43;256.39;4.92;953;44;2385.00;17
6019;44;625750713;6019;296;6966;6983;6.97;0.43;256.54;4.92;947;44;2386.00;17
6021;44;625750726;6021;297;6970;6987;6.98;0.43;256.54;4.92;949;44;2387.00;17
6024;44;625750740;6024;299;6970;6987;6.99;0.43;256.65;4.92;946;44;2388.00;17
6030;44;625750754;6030;297;6970;6987;6.97;0.43;256.82;4.92;940;44;2389.00;17
6033;44;625750767;6033;306;6970;6987;7.03;0.43;256.84;4.92;937;44;2390.00;17
6035;44;625750780;6035;301;6975;6993;7.06;0.43;256.94;4.92;940;44;2391.00;18
6042;44;625750793;6042;299;6976;6993;7.05;0.43;257.07;4.95;934;44;2392.00;17
6044;44;625750807;6044;300;6977;6993;7.09;0.43;257.09;4.95;933;44;2393.00;16
6047;44;625750821;6047;303;6979;6996;7.15;0.44;257.12;4.95;932;44;2394.00;17
6051;44;625750835;6051;295;6980;6996;7.25;0.45;257.29;4.95;929;44;2395.00;16
6056;44;625750849;6056;295;6980;6996;7.36;0.45;257.34;4.95;924;44;2396.00;16
6060;44;625750863;6060;284;6981;6997;7.49;0.46;257.30;4.95;921;44;2397.00;16
6068;44;625750876;6068;278;6982;6998;7.55;0.46;257.31;4.95;914;44;2398.00;16
6071;44;625750890;6071;280;6982;6998;7.56;0.46;257.29;4.95;911;44;2399.00;16
6078;44;625750906;6078;282;7006;7057;7.60;0.47;257.38;4.93;928;44;2400.00;51
6082;44;625750933;6082;264;7007;7057;7.66;0.47;257.48;4.93;925;44;2401.00;50
6088;44;625750947;6088;257;7010;7057;7.65;0.47;257.52;4.93;922;44;2402.00;47
6094;44;625750962;6094;254;7011;7058;7.70;0.47;257.66;4.93;917;44;2403.00;47
6097;44;625750977;6097;256;7013;7058;7.69;0.47;257.71;4.93;916;44;2404.00;45
6104;44;625750998;6104;257;7015;7062;7.65;0.47;257.77;4.93;911;44;2405.00;47
6107;44;625751013;6107;260;7017;7062;7.61;0.47;257.78;4.93;910;44;2406.00;45
6109;44;625751028;6109;261;7021;7066;7.70;0.47;257.83;4.93;912;44;2407.00;45
6115;44;625751043;6115;265;7022;7066;7.63;0.47;257.91;4.93;907;44;2408.00;44
6120;44;625751058;6120;266;7022;7066;7.60;0.46;258.12;4.93;902;44;2409.00;44
6124;44;625751072;6124;268;7023;7066;7.62;0.47;258.25;4.93;899;44;2410.00;43
6130;44;625751087;6130;268;7024;7066;7.60;0.47;258.35;4.96;894;44;2411.00;42
6135;44;625751101;6135;278;7033;7078;7.67;0.47;258.43;4.96;898;44;2412.00;45
6138;44;625751117;6138;279;7034;7078;7.69;0.47;258.43;4.96;896;44;2413.00;44
6141;44;625751130;6141;282;7035;7078;7.70;0.47;258.51;4.96;894;44;2414.00;43
6144;44;625751146;6144;284;7035;7078;7.67;0.47;258.57;4.96;891;44;2415.00;43
6149;44;625751160;6149;285;7036;7078;7.67;0.47;258.63;4.96;887;44;2416.00;42
6152;44;625751174;6152;287;7036;7078;7.64;0.47;258.65;4.96;884;44;2417.00;42
6154;44;625751189;6154;295;7036;7079;7.59;0.46;258.64;4.96;882;44;2418.00;43
6158;44;625751203;6158;294;7037;7079;7.57;0.46;258.59;4.96;879;44;2419.00;42
6160;44;625751217;6160;296;7042;7085;7.60;0.46;258.70;4.97;882;44;2420.00;43
6161;44;625751232;6161;299;7044;7086;7.60;0.46;258.69;5.00;883;44;2421.00;42
6166;44;625751245;6166;297;7045;7086;7.58;0.46;258.71;5.00;879;44;2422.00;41
6171;44;625751259;6171;296;7045;7086;7.50;0.46;258.79;5.00;874;44;2423.00;41
6174;44;625751273;6174;303;7047;7090;7.46;0.45;258.81;5.00;873;44;2424.00;43
6177;44;625751287;6177;304;7048;7090;7.45;0.45;258.79;5.00;871;44;2425.00;42
6179;44;625751300;6179;303;7048;7090;7.51;0.46;258.84;5.00;869;44;2426.00;42
6183;44;625751312;6183;295;7050;7091;7.44;0.45;258.89;5.04;867;44;2427.00;41
6185;44;625751327;6185;287;7056;7095;7.43;0.45;258.97;5.05;871;44;2428.00;39
6188;44;625751341;6188;288;7057;7095;7.42;0.45;259.01;5.05;869;44;2429.00;38
6191;44;625751356;6191;282;7060;7101;7.41;0.45;259.05;5.05;869;44;2430.00;41
6194;44;625751378;6194;281;7061;7101;7.41;0.45;259.05;5.05;867;44;2431.00;40
6199;44;625751395;6199;277;7061;7101;7.46;0.45;259.28;5.05;862;44;2432.00;40
6200;44;625751410;6200;278;7062;7101;7.53;0.46;259.39;5.05;862;44;2433.00;39
6206;44;625751425;6206;282;7066;7105;7.58;0.46;259.44;5.05;860;44;2434.00;39
6208;44;625751440;6208;274;7067;7105;7.66;0.47;259.50;5.05;859;44;2435.00;38
6213;44;625751453;6213;258;7068;7105;7.70;0.47;259.54;5.05;855;44;2436.00;37
6216;44;625751467;6216;250;7069;7105;7.79;0.47;259.55;5.05;853;44;2437.00;36
6219;44;625751488;6219;240;7070;7106;7.87;0.48;259.62;5.05;851;44;2438.00;36
6222;44;625751504;6222;235;7072;7107;7.91;0.48;259.66;5.09;850;44;2439.00;35
6222;44;625751520;6222;231;7073;7107;7.95;0.48;259.66;5.10;851;44;2440.00;34
6227;44;625751533;6227;225;7074;7108;7.97;0.49;259.76;5.10;847;44;2441.00;34
6230;44;625751548;6230;214;7074;7108;8.04;0.49;259.82;5.10;844;44;2442.00;34
6231;44;625751563;6231;215;7074;7108;8.13;0.49;259.83;5.10;843;44;2443.00;34
6235;44;625751585;6235;213;7074;7108;8.21;0.50;259.82;5.10;839;44;2444.00;34
6236;44;625751598;6236;214;7075;7108;8.35;0.51;259.83;5.10;839;44;2445.00;33
6237;44;625751611;6237;206;7075;7108;8.47;0.52;259.87;5.10;838;44;2446.00;33
6240;44;625751625;6240;206;7075;7108;8.45;0.51;259.87;5.10;835;44;2447.00;33
6241;44;625751638;6241;212;7138;7235;8.66;0.53;259.86;5.06;897;44;2448.00;97
6242;44;625751663;6242;204;7142;7236;8.71;0.54;259.93;5.05;900;44;2449.00;94
6245;44;625751677;6245;195;7149;7236;8.74;0.54;259.93;5.06;904;44;2450.00;87
6247;44;625751692;6247;190;7153;7236;8.82;0.54;259.97;5.06;906;44;2451.00;83
6249;44;625751711;6249;181;7157;7236;8.86;0.55;259.95;5.06;908;44;2452.00;79
6250;44;625751725;6250;183;7159;7236;8.94;0.55;260.01;5.06;909;44;2453.00;77
6256;44;625751744;6256;181;7164;7236;8.99;0.55;260.05;5.10;908;44;2454.00;72
6258;44;625751763;6258;183;7167;7236;8.98;0.55;260.04;5.10;909;44;2455.00;69
6263;44;625751782;6263;189;7171;7237;8.94;0.55;260.22;5.11;908;44;2456.00;66
6268;44;625751795;6268;192;7174;7238;8.85;0.54;260.31;5.15;906;44;2457.00;64
6269;44;625751810;6269;206;7178;7238;8.86;0.54;260.36;5.15;909;44;2458.00;60
6272;44;625751823;6272;206;7180;7239;8.83;0.54;260.37;5.15;908;44;2459.00;59
6273;44;625751839;6273;213;7182;7239;8.79;0.54;260.36;5.15;909;44;2460.00;57
6277;44;625751853;6277;218;7186;7239;8.76;0.54;260.40;5.20;909;44;2461.00;53
6279;44;625751867;6279;220;7190;7239;8.70;0.53;260.54;5.21;911;44;2462.00;49
6282;44;625751880;6282;230;7193;7243;8.60;0.53;260.61;5.21;911;44;2463.00;50
6282;44;625751894;6282;238;7196;7243;8.50;0.52;260.61;5.25;914;44;2464.00;47
6288;44;625751912;6288;245;7198;7243;8.40;0.52;260.74;5.26;910;44;2465.00;45
6292;44;625751925;6292;254;7200;7246;8.32;0.51;260.77;5.26;908;44;2466.00;46
6292;44;625751944;6292;260;7202;7246;8.29;0.51;260.77;5.26;910;44;2467.00;44
6296;44;625751957;6296;271;7206;7246;8.13;0.50;260.78;5.32;910;44;2468.00;40
6299;44;625751971;6299;280;7210;7250;8.04;0.49;260.85;5.32;911;44;2469.00;40
6303;44;625751983;6303;278;7215;7251;7.96;0.49;260.78;5.36;912;44;2470.00;36
6303;44;625751997;6303;269;7215;7251;7.95;0.49;260.78;5.36;912;44;2471.00;36
6307;44;625752009;6307;265;7217;7255;7.96;0.49;260.75;5.36;910;44;2472.00;38
6310;44;625752022;6310;267;7218;7255;7.94;0.49;260.70;5.40;908;44;2473.00;37
6311;44;625752035;6311;266;7218;7255;7.90;0.48;260.67;5.40;907;44;2474.00;37
6314;44;625752047;6314;262;7220;7257;7.76;0.47;260.57;5.39;906;44;2475.00;37
6318;44;625752060;6318;263;7221;7257;7.66;0.47;260.54;5.42;903;44;2476.00;36
6320;44;625752072;6320;266;7225;7263;7.60;0.46;260.56;5.41;905;44;2477.00;38
6321;44;625752085;6321;259;7225;7263;7.57;0.46;260.57;5.41;904;44;2478.00;38
6325;44;625752097;6325;256;7227;7264;7.51;0.46;260.50;5.44;902;44;2479.00;37
6329;44;625752109;6329;256;7227;7264;7.41;0.45;260.63;5.44;898;44;2480.00;37
6331;44;625752121;6331;250;7227;7264;7.34;0.45;260.60;5.44;896;44;2481.00;37
6333;44;625752133;6333;237;7228;7264;7.29;0.45;260.65;5.46;895;44;2482.00;36
6337;44;625752144;6337;230;7228;7264;7.24;0.44;260.64;5.46;891;44;2483.00;36
6340;44;625752155;6340;227;7237;7276;7.21;0.44;260.65;5.45;897;44;2484.00;39
6342;44;625752168;6342;223;7241;7276;7.14;0.44;260.71;5.49;899;44;2485.00;35
6347;44;625752181;6347;230;7242;7276;7.10;0.43;260.66;5.49;895;44;2486.00;34
6350;44;625752192;6350;222;7243;7276;7.05;0.43;260.66;5.50;893;44;2487.00;33
6353;44;625752203;6353;222;7243;7276;7.01;0.43;260.63;5.50;890;44;2488.00;33
6356;44;625752215;6356;226;7243;7276;6.95;0.42;260.63;5.50;887;44;2489.00;33
6358;44;625752228;6358;220;7246;7280;6.96;0.42;260.59;5.50;888;44;2490.00;34
6359;44;625752240;6359;224;7247;7280;6.96;0.42;260.63;5.51;888;44;2491.00;33
6360;44;625752251;6360;235;7250;7284;6.96;0.42;260.60;5.51;890;44;2492.00;34
6362;44;625752263;6362;244;7253;7285;6.95;0.42;260.59;5.52;891;44;2493.00;32
6364;44;625752280;6364;241;7253;7285;6.91;0.42;260.56;5.52;889;44;2494.00;32
6364;44;625752290;6364;242;7254;7285;6.91;0.42;260.56;5.53;890;44;2495.00;31
6367;44;625752302;6367;246;7263;7298;6.90;0.42;260.62;5.52;896;44;2496.00;35
6369;44;625752314;6369;250;7265;7298;6.82;0.41;260.62;5.54;896;44;2497.00;33
6372;44;625752325;6372;250;7265;7298;6.76;0.41;260.54;5.54;893;44;2498.00;33
6373;44;625752337;6373;238;7266;7299;6.83;0.41;260.51;5.54;893;44;2499.00;33
6374;44;625752349;6374;228;7266;7300;6.90;0.42;260.50;5.54;892;44;2500.00;34
6376;44;625752365;6376;225;7266;7300;6.94;0.42;260.45;5.54;890;44;2501.00;34
6378;44;625752377;6378;219;7269;7303;7.00;0.42;260.40;5.55;891;44;2502.00;34
6380;44;625752389;6380;217;7270;7303;7.08;0.43;260.37;5.55;890;44;2503.00;33
6380;44;625752403;6380;209;7270;7303;7.16;0.43;260.37;5.55;890;44;2504.00;33
6381;44;625752415;6381;207;7270;7303;7.25;0.44;260.39;5.55;889;44;2505.00;33
6383;44;625752426;6383;202;7274;7309;7.41;0.45;260.39;5.55;891;44;2506.00;35
6383;45;625752445;6383;198;7275;7309;7.48;0.45;260.39;5.55;892;45;2507.00;34
6383;45;625752469;6383;199;7277;7309;7.50;0.45;260.39;5.57;894;45;2508.00;32
6385;46;625752482;6385;196;7277;7309;7.56;0.46;260.35;5.57;892;46;2509.00;32
6386;46;625752505;6386;194;7283;7313;7.56;0.46;260.31;5.60;897;46;2510.00;30
6386;46;625752522;6386;197;7284;7314;7.60;0.46;260.31;5.60;898;46;2511.00;30
6387;46;625752537;6387;202;7284;7314;7.65;0.46;260.32;5.60;897;46;2512.00;30
6387;46;625752553;6387;204;7286;7315;7.72;0.47;260.32;5.60;899;46;2513.00;29
6388;46;625752571;6388;206;7287;7315;7.77;0.47;260.33;5.60;899;46;2514.00;28
6390;46;625752591;6390;214;7290;7315;7.79;0.47;260.29;5.64;900;46;2515.00;25
6391;46;625752610;6391;217;7292;7315;7.83;0.47;260.30;5.66;901;46;2516.00;23
6391;46;625752627;6391;220;7295;7315;7.88;0.48;260.30;5.69;904;46;2517.00;20
6392;46;625752641;6392;222;7295;7315;7.89;0.48;260.28;5.69;903;46;2518.00;20
6392;46;625752661;6392;223;7296;7315;7.89;0.48;260.28;5.70;904;46;2519.00;19
6394;46;625752676;6394;227;7351;7440;8.03;0.49;260.28;5.67;957;46;2520.00;89
6397;46;625752704;6397;226;7357;7441;8.03;0.49;260.34;5.68;960;46;2521.00;84
6398;46;625752718;6398;225;7369;7441;8.09;0.50;260.31;5.68;971;46;2522.00;72
6402;46;625752731;6402;228;7375;7441;8.11;0.50;260.31;5.69;973;46;2523.00;66
6404;46;625752744;6404;217;7381;7441;8.07;0.50;260.36;5.69;977;46;2524.00;60
6406;46;625752757;6406;221;7386;7441;8.00;0.49;260.40;5.69;980;46;2525.00;55
6408;46;625752770;6408;229;7394;7441;7.94;0.49;260.43;5.70;986;46;2526.00;47
6411;46;625752783;6411;231;7396;7441;7.85;0.48;260.43;5.70;985;46;2527.00;45
6413;46;625752796;6413;232;7403;7442;7.81;0.48;260.50;5.72;990;46;2528.00;39
6415;46;625752809;6415;235;7407;7443;7.83;0.48;260.50;5.72;992;46;2529.00;36
6422;46;625752823;6422;235;7411;7443;7.78;0.48;260.48;5.73;989;46;2530.00;32
6424;46;625752836;6424;244;7416;7447;7.73;0.47;260.53;5.73;992;46;2531.00;31
6426;46;625752850;6426;238;7420;7447;7.67;0.47;260.55;5.74;994;46;2532.00;27
6431;46;625752863;6431;242;7420;7447;7.59;0.46;260.50;5.74;989;46;2533.00;27
6433;46;625752877;6433;236;7423;7447;7.52;0.46;260.48;5.74;990;46;2534.00;24
6434;46;625752891;6434;241;7427;7453;7.54;0.46;260.49;5.75;993;46;2535.00;26
6436;46;625752905;6436;240;7427;7453;7.54;0.46;260.53;5.75;991;46;2536.00;26
6438;46;625752919;6438;247;7430;7455;7.55;0.46;260.57;5.75;992;46;2537.00;25
6442;46;625752940;6442;257;7433;7458;7.59;0.46;260.59;5.75;991;46;2538.00;25
6443;46;625752954;6443;264;7434;7458;7.61;0.47;260.57;5.75;991;46;2539.00;24
6445;46;625752969;6445;271;7434;7458;7.63;0.47;260.62;5.75;989;46;2540.00;24
6448;46;625752981;6448;280;7435;7459;7.57;0.46;260.67;5.76;987;46;2541.00;24
6451;46;625752996;6451;284;7437;7460;7.48;0.46;260.66;5.76;986;46;2542.00;23
6454;46;625753010;6454;287;7438;7460;7.40;0.45;260.67;5.77;984;46;2543.00;22
6459;46;625753024;6459;299;7451;7473;7.30;0.45;260.78;5.77;992;46;2544.00;22
6465;46;625753039;6465;297;7454;7473;7.19;0.44;260.90;5.78;989;46;2545.00;19
6469;46;625753054;6469;305;7454;7473;7.11;0.43;261.00;5.78;985;46;2546.00;19
6473;46;625753068;6473;311;7455;7474;7.03;0.43;261.03;5.78;982;46;2547.00;19
6476;46;625753081;6476;310;7456;7474;6.99;0.43;261.02;5.78;980;46;2548.00;18
6481;46;625753095;6481;317;7459;7478;6.91;0.42;261.09;5.78;978;46;2549.00;19
6486;46;625753111;6486;307;7461;7481;6.83;0.42;261.16;5.78;975;46;2550.00;20
6491;46;625753125;6491;297;7468;7485;6.76;0.42;261.19;5.78;977;46;2551.00;17
6496;46;625753139;6496;296;7469;7485;6.70;0.41;261.12;5.79;973;46;2552.00;16
6500;46;625753152;6500;290;7469;7485;6.71;0.41;261.19;5.79;969;46;2553.00;16
6503;46;625753165;6503;288;7471;7485;6.72;0.41;261.27;5.79;968;46;2554.00;14
6507;46;625753178;6507;281;7471;7485;6.73;0.41;261.34;5.79;964;46;2555.00;14
6510;46;625753191;6510;279;7482;7497;6.86;0.42;261.41;5.78;972;46;2556.00;15
6513;46;625753206;6513;269;7482;7497;6.95;0.43;261.51;5.78;969;46;2557.00;15
6518;46;625753220;6518;275;7482;7497;6.97;0.43;261.53;5.78;964;46;2558.00;15
6522;46;625753233;6522;261;7482;7497;7.01;0.43;261.64;5.78;960;46;2559.00;15
6527;46;625753248;6527;264;7482;7497;7.05;0.43;261.78;5.78;955;46;2560.00;15
6529;46;625753261;6529;258;7482;7497;7.14;0.44;261.79;5.78;953;46;2561.00;15
6535;46;625753275;6535;260;7482;7498;7.18;0.44;261.90;5.78;947;46;2562.00;16
6540;46;625753288;6540;258;7482;7498;7.24;0.44;261.89;5.78;942;46;2563.00;16
6542;46;625753301;6542;262;7486;7504;7.35;0.45;261.99;5.78;944;46;2564.00;18
6546;46;625753316;6546;255;7489;7506;7.42;0.46;262.03;5.77;943;46;2565.00;17
6552;46;625753331;6552;260;7489;7506;7.49;0.46;262.17;5.77;937;46;2566.00;17
6556;46;625753345;6556;264;7489;7506;7.63;0.47;262.16;5.77;933;46;2567.00;17
6564;46;625753358;6564;257;7492;7510;7.74;0.48;262.27;5.77;928;46;2568.00;18
6569;46;625753372;6569;249;7492;7510;7.84;0.48;262.40;5.77;923;46;2569.00;18
6572;46;625753387;6572;247;7492;7510;7.96;0.49;262.37;5.77;920;46;2570.00;18
6577;47;625753403;6577;240;7493;7511;8.00;0.49;262.43;5.77;916;47;2571.00;18
6581;47;625753434;6581;239;7496;7515;8.02;0.49;262.54;5.77;915;47;2572.00;19
6587;47;625753449;6587;232;7496;7515;8.02;0.49;262.46;5.77;909;47;2573.00;19
6593;47;625753463;6593;234;7498;7518;8.05;0.49;262.53;5.77;905;47;2574.00;20
6596;47;625753479;6596;232;7499;7518;8.16;0.50;262.58;5.77;903;47;2575.00;19
6600;47;625753493;6600;234;7499;7518;8.22;0.50;262.61;5.77;899;47;2576.00;19
6606;47;625753507;6606;227;7499;7518;8.24;0.50;262.61;5.77;893;47;2577.00;19
6610;47;625753521;6610;227;7502;7522;8.35;0.51;262.61;5.77;892;47;2578.00;20
6617;47;625753536;6617;221;7502;7522;8.29;0.51;262.58;5.77;885;47;2579.00;20
6621;47;625753554;6621;222;7503;7522;8.23;0.50;262.63;5.77;882;47;2580.00;19
6627;47;625753569;6627;221;7503;7522;8.15;0.50;262.70;5.77;876;47;2581.00;19
6628;47;625753585;6628;222;7503;7523;8.18;0.50;262.74;5.77;875;47;2582.00;20
6629;47;625753599;6629;226;7504;7524;8.22;0.50;262.71;5.76;875;47;2583.00;20
6634;47;625753613;6634;231;7504;7524;8.19;0.50;262.78;5.76;870;47;2584.00;20
6637;47;625753628;6637;234;7505;7525;8.18;0.50;262.79;5.76;868;47;2585.00;20
6638;47;625753643;6638;235;7505;7525;8.20;0.50;262.79;5.76;867;47;2586.00;20
6642;47;625753656;6642;244;7505;7525;8.20;0.50;262.84;5.76;863;47;2587.00;20
6649;47;625753669;6649;249;7505;7525;8.19;0.50;262.90;5.76;856;47;2588.00;20
6651;47;625753683;6651;252;7505;7525;8.21;0.50;262.86;5.76;854;47;2589.00;20
6655;47;625753695;6655;255;7505;7525;8.09;0.50;262.83;5.76;850;47;2590.00;20
6660;47;625753709;6660;258;7505;7525;7.95;0.49;262.83;5.76;845;47;2591.00;20
6662;47;625753721;6662;279;7573;7652;8.10;0.50;262.88;5.71;911;47;2592.00;79
6668;47;625753747;6668;275;7576;7653;8.05;0.50;262.80;5.71;908;47;2593.00;77
6672;47;625753761;6672;285;7586;7653;7.97;0.49;262.87;5.71;914;47;2594.00;67
6675;47;625753777;6675;287;7588;7653;7.89;0.49;262.89;5.71;913;47;2595.00;65
6678;47;625753789;6678;291;7592;7653;7.86;0.49;262.93;5.70;914;47;2596.00;61
6684;47;625753799;6684;276;7596;7653;7.83;0.48;263.02;5.70;912;47;2597.00;57
6686;47;625753817;6686;278;7600;7653;7.82;0.48;263.02;5.70;914;47;2598.00;53
6691;47;625753829;6691;277;7606;7653;7.81;0.48;263.09;5.71;915;47;2599.00;47
6693;48;625753843;6693;272;7610;7654;7.81;0.48;263.10;5.71;917;48;2600.00;44
6696;48;625753866;6696;277;7613;7655;7.80;0.48;263.11;5.71;917;48;2601.00;42
6699;48;625753882;6699;272;7614;7655;7.82;0.48;263.11;5.71;915;48;2602.00;41
6700;48;625753901;6700;274;7616;7656;7.82;0.48;263.11;5.71;916;48;2603.00;40
6703;48;625753914;6703;269;7617;7656;7.77;0.48;263.12;5.71;914;48;2604.00;39
6705;48;625753927;6705;268;7619;7656;7.74;0.47;263.23;5.71;914;48;2605.00;37
6712;48;625753939;6712;255;7620;7656;7.67;0.47;263.33;5.71;908;48;2606.00;36
6715;48;625753958;6715;251;7623;7660;7.70;0.47;263.37;5.71;908;48;2607.00;37
6717;48;625753977;6717;248;7624;7660;7.77;0.47;263.36;5.71;907;48;2608.00;36
6718;48;625753990;6718;245;7626;7660;7.87;0.48;263.36;5.72;908;48;2609.00;34
6719;48;625754004;6719;244;7629;7666;7.87;0.48;263.32;5.72;910;48;2610.00;37
6720;48;625754028;6720;246;7631;7666;7.91;0.48;263.29;5.72;911;48;2611.00;35
6724;48;625754041;6724;254;7631;7666;7.90;0.48;263.51;5.72;907;48;2612.00;35
6725;48;625754054;6725;250;7635;7670;7.89;0.48;263.50;5.71;910;48;2613.00;35
6729;48;625754066;6729;251;7637;7671;7.93;0.49;263.47;5.71;908;48;2614.00;34
6732;48;625754080;6732;251;7637;7671;7.93;0.48;263.43;5.71;905;48;2615.00;34
6732;48;625754092;6732;249;7641;7675;7.96;0.49;263.43;5.71;909;48;2616.00;34
6733;48;625754104;6733;241;7642;7675;8.02;0.49;263.42;5.71;909;48;2617.00;33
6736;48;625754117;6736;238;7642;7675;8.06;0.49;263.40;5.71;906;48;2618.00;33
6740;48;625754129;6740;240;7643;7676;8.12;0.49;263.41;5.71;903;48;2619.00;33
6741;48;625754141;6741;241;7643;7676;8.17;0.50;263.41;5.71;902;48;2620.00;33
6743;48;625754154;6743;243;7647;7682;8.17;0.50;263.38;5.71;904;48;2621.00;35
6746;48;625754166;6746;244;7647;7682;8.18;0.50;263.39;5.71;901;48;2622.00;35
6749;48;625754178;6749;243;7648;7683;8.13;0.49;263.37;5.71;899;48;2623.00;35
6750;48;625754190;6750;243;7648;7683;8.12;0.49;263.34;5.71;898;48;2624.00;35
6753;48;625754203;6753;245;7648;7683;8.08;0.49;263.28;5.71;895;48;2625.00;35
6755;48;625754215;6755;246;7648;7683;8.07;0.49;263.26;5.71;893;48;2626.00;35
6757;48;625754226;6757;250;7648;7683;8.07;0.49;263.23;5.71;891;48;2627.00;35
6757;48;625754238;6757;249;7658;7695;8.09;0.49;263.23;5.70;901;48;2628.00;37
6758;48;625754250;6758;256;7659;7695;8.10;0.49;263.20;5.70;901;48;2629.00;36
6759;48;625754261;6759;265;7659;7695;8.07;0.49;263.18;5.70;900;48;2630.00;36
6760;48;625754273;6760;267;7659;7695;8.02;0.49;263.16;5.70;899;48;2631.00;36
6761;48;625754284;6761;272;7659;7695;7.98;0.48;263.13;5.70;898;48;2632.00;36
6764;48;625754295;6764;278;7659;7695;7.89;0.48;263.07;5.70;895;48;2633.00;36
6765;48;625754307;6765;284;7662;7699;7.80;0.47;263.08;5.70;897;48;2634.00;37
6768;48;625754318;6768;290;7662;7699;7.73;0.47;263.20;5.70;894;48;2635.00;37
6770;48;625754335;6770;292;7665;7703;7.69;0.47;263.17;5.70;895;48;2636.00;38
6773;48;625754347;6773;298;7666;7704;7.60;0.46;263.08;5.69;893;48;2637.00;38
6774;48;625754358;6774;304;7667;7704;7.51;0.46;263.09;5.69;893;48;2638.00;37
6777;48;625754368;6777;310;7667;7704;7.38;0.45;263.12;5.69;890;48;2639.00;37
6779;48;625754380;6779;314;7686;7733;7.23;0.44;263.13;5.68;907;48;2640.00;47
6780;48;625754392;6780;311;7687;7733;7.17;0.44;263.15;5.68;907;48;2641.00;46
6785;48;625754403;6785;308;7690;7733;7.10;0.43;263.16;5.68;905;48;2642.00;43
6786;48;625754413;6786;306;7692;7734;7.10;0.43;263.18;5.68;906;48;2643.00;42
6787;48;625754424;6787;304;7693;7735;7.05;0.43;263.15;5.68;906;48;2644.00;42
6789;48;625754434;6789;299;7693;7735;6.99;0.42;263.16;5.68;904;48;2645.00;42
6790;48;625754445;6790;300;7696;7738;7.02;0.43;263.16;5.67;906;48;2646.00;42
6790;48;625754454;6790;307;7696;7738;7.00;0.43;263.16;5.67;906;48;2647.00;42
6793;48;625754464;6793;304;7696;7738;6.97;0.42;263.14;5.67;903;48;2648.00;42
6794;48;625754475;6794;307;7696;7738;6.93;0.42;263.14;5.67;902;48;2649.00;42
6796;48;625754484;6796;303;7700;7744;6.82;0.41;263.19;5.67;904;48;2650.00;44
6799;48;625754495;6799;288;7700;7744;6.74;0.41;263.21;5.67;901;48;2651.00;44
6799;48;625754505;6799;270;7701;7744;6.75;0.41;263.21;5.67;902;48;2652.00;43
6803;48;625754515;6803;254;7702;7744;6.70;0.41;263.22;5.69;899;48;2653.00;42
6805;48;625754531;6805;245;7706;7748;6.73;0.41;263.20;5.70;901;48;2654.00;42
6808;48;625754560;6808;236;7708;7750;6.75;0.41;263.23;5.70;900;48;2655.00;42
6811;48;625754580;6811;225;7709;7750;6.80;0.41;263.24;5.71;898;48;2656.00;41
6814;48;625754598;6814;220;7710;7751;6.96;0.42;263.23;5.71;896;48;2657.00;41
6815;48;625754616;6815;216;7710;7751;7.12;0.43;263.36;5.71;895;48;2658.00;41
6817;48;625754633;6817;213;7710;7751;7.19;0.44;263.37;5.71;893;48;2659.00;41
6821;48;625754646;6821;211;7711;7751;7.22;0.44;263.33;5.72;890;48;2660.00;40
6821;48;625754666;6821;209;7711;7751;7.29;0.44;263.33;5.72;890;48;2661.00;40
6822;48;625754679;6822;205;7711;7751;7.31;0.45;263.31;5.72;889;48;2662.00;40
6823;48;625754693;6823;200;7711;7751;7.36;0.45;263.31;5.72;888;48;2663.00;40
6824;48;625754706;6824;203;7746;7821;7.58;0.46;263.27;5.70;922;48;2664.00;75
6828;48;625754734;6828;195;7749;7822;7.66;0.47;263.28;5.70;921;48;2665.00;73
6828;48;625754748;6828;190;7755;7822;7.78;0.48;263.28;5.69;927;48;2666.00;67
6832;48;625754762;6832;189;7759;7822;7.87;0.48;263.21;5.69;927;48;2667.00;63
6835;48;625754776;6835;186;7762;7822;7.93;0.48;263.19;5.69;927;48;2668.00;60
6835;48;625754789;6835;179;7764;7822;7.99;0.49;263.19;5.69;929;48;2669.00;58
6838;48;625754803;6838;180;7767;7822;7.96;0.48;263.17;5.69;929;48;2670.00;55
6840;48;625754817;6840;184;7770;7822;8.00;0.49;263.19;5.69;930;48;2671.00;52
6843;49;625754830;6843;185;7774;7823;8.07;0.49;263.20;5.69;931;49;2672.00;49
6845;49;625754856;6845;183;7777;7824;8.11;0.49;263.23;5.69;932;49;2673.00;47
6847;49;625754874;6847;185;7779;7824;8.12;0.49;263.18;5.69;932;49;2674.00;45
6849;49;625754888;6849;191;7782;7828;8.09;0.49;263.16;5.69;933;49;2675.00;46
6853;49;625754902;6853;190;7782;7828;8.04;0.49;263.21;5.69;929;49;2676.00;46
6855;49;625754916;6855;191;7783;7828;8.03;0.49;263.20;5.70;928;49;2677.00;45
6858;49;625754929;6858;189;7783;7828;8.09;0.49;263.13;5.70;925;49;2678.00;45
6862;49;625754943;6862;190;7788;7834;8.08;0.49;263.18;5.71;926;49;2679.00;46
6863;49;625754958;6863;192;7790;7834;8.07;0.49;263.19;5.72;927;49;2680.00;44
6867;49;625754972;6867;195;7790;7834;8.08;0.49;263.23;5.72;923;49;2681.00;44
6869;49;625754985;6869;196;7793;7837;8.05;0.49;263.19;5.74;924;49;2682.00;44
6875;49;625754998;6875;206;7794;7837;8.01;0.49;263.28;5.75;919;49;2683.00;43
6876;49;625755012;6876;208;7796;7837;8.05;0.49;263.25;5.76;920;49;2684.00;41
6878;49;625755025;6878;215;7797;7838;7.99;0.48;263.30;5.77;919;49;2685.00;41
6880;49;625755037;6880;222;7798;7839;7.94;0.48;263.40;5.77;918;49;2686.00;41
6883;49;625755049;6883;224;7800;7839;7.85;0.48;263.41;5.79;917;49;2687.00;39
6885;49;625755062;6885;232;7811;7852;7.83;0.48;263.48;5.78;926;49;2688.00;41
6887;49;625755076;6887;226;7812;7852;7.82;0.47;263.46;5.78;925;49;2689.00;40
6890;49;625755090;6890;228;7813;7852;7.78;0.47;263.49;5.79;923;49;2690.00;39
6891;49;625755110;6891;227;7815;7853;7.74;0.47;263.55;5.80;924;49;2691.00;38
6896;49;625755124;6896;235;7816;7853;7.70;0.47;263.54;5.80;920;49;2692.00;37
6899;49;625755138;6899;239;7820;7857;7.69;0.47;263.62;5.81;921;49;2693.00;37
6900;49;625755152;6900;237;7821;7857;7.63;0.47;263.60;5.81;921;49;2694.00;36
6902;49;625755164;6902;244;7826;7861;7.60;0.46;263.73;5.82;924;49;2695.00;35
6906;49;625755177;6906;242;7827;7861;7.53;0.46;263.78;5.83;921;49;2696.00;34
6908;49;625755190;6908;249;7827;7861;7.46;0.46;263.81;5.83;919;49;2697.00;34
6908;49;625755204;6908;243;7830;7861;7.42;0.45;263.81;5.87;922;49;2698.00;31
6911;49;625755217;6911;237;7830;7861;7.38;0.45;263.84;5.87;919;49;2699.00;31
6915;49;625755232;6915;238;7853;7910;7.45;0.46;263.91;5.86;938;49;2700.00;57
6919;49;625755255;6919;240;7855;7910;7.48;0.46;263.92;5.86;936;49;2701.00;55
6921;49;625755267;6921;239;7858;7910;7.48;0.46;263.97;5.87;937;49;2702.00;52
6923;49;625755281;6923;239;7861;7910;7.49;0.46;264.01;5.87;938;49;2703.00;49
6924;49;625755293;6924;240;7865;7910;7.52;0.46;264.03;5.88;941;49;2704.00;45
6927;49;625755305;6927;238;7866;7910;7.51;0.46;264.13;5.88;939;49;2705.00;44
6929;49;625755318;6929;237;7867;7911;7.55;0.46;264.22;5.88;938;49;2706.00;44
6931;49;625755331;6931;235;7871;7911;7.59;0.46;264.26;5.91;940;49;2707.00;40
6936;49;625755344;6936;234;7874;7917;7.63;0.47;264.29;5.90;938;49;2708.00;43
6938;49;625755358;6938;240;7877;7918;7.67;0.47;264.36;5.91;939;49;2709.00;41
6940;49;625755372;6940;250;7879;7918;7.67;0.47;264.43;5.91;939;49;2710.00;39
6945;49;625755384;6945;251;7879;7918;7.62;0.46;264.50;5.91;934;49;2711.00;39
6949;49;625755397;6949;255;7883;7922;7.57;0.46;264.54;5.92;934;49;2712.00;39
6952;49;625755410;6952;261;7884;7922;7.50;0.46;264.64;5.92;932;49;2713.00;38
6957;49;625755423;6957;253;7887;7922;7.40;0.45;264.62;5.93;930;49;2714.00;35
6961;49;625755437;6961;258;7888;7923;7.35;0.45;264.75;5.93;927;49;2715.00;35
6965;49;625755450;6965;267;7892;7927;7.22;0.44;264.97;5.93;927;49;2716.00;35
6968;49;625755463;6968;271;7893;7927;7.12;0.43;264.93;5.94;925;49;2717.00;34
6973;49;625755479;6973;273;7895;7930;7.00;0.43;265.04;5.94;922;49;2718.00;35
6978;49;625755494;6978;273;7899;7930;6.84;0.42;265.03;5.95;921;49;2719.00;31
6982;49;625755506;6982;266;7899;7930;6.71;0.41;265.03;5.95;917;49;2720.00;31
6985;49;625755520;6985;252;7899;7930;6.68;0.41;265.05;5.95;914;49;2721.00;31
6987;49;625755533;6987;248;7903;7934;6.69;0.41;265.04;5.95;916;49;2722.00;31
6990;49;625755545;6990;245;7903;7934;6.76;0.41;265.12;5.95;913;49;2723.00;31
6993;49;625755557;6993;243;7906;7934;6.83;0.42;265.20;5.95;913;49;2724.00;28
6997;49;625755571;6997;249;7907;7934;6.85;0.42;265.26;5.95;910;49;2725.00;27
7000;49;625755583;7000;251;7907;7935;6.90;0.42;265.26;5.95;907;49;2726.00;28
7003;49;625755595;7003;239;7909;7936;6.99;0.43;265.32;5.95;906;49;2727.00;27
7007;49;625755608;7007;231;7910;7936;7.10;0.43;265.46;5.96;903;49;2728.00;26
7010;49;625755620;7010;219;7911;7937;7.19;0.44;265.53;5.96;901;49;2729.00;26
7012;49;625755635;7012;217;7911;7937;7.29;0.45;265.58;5.96;899;49;2730.00;26
7019;49;625755647;7019;220;7912;7937;7.32;0.45;265.62;5.96;893;49;2731.00;25
7024;49;625755660;7024;222;7912;7937;7.39;0.45;265.74;5.96;888;49;2732.00;25
7026;49;625755673;7026;218;7913;7937;7.45;0.46;265.73;5.96;887;49;2733.00;24
7031;49;625755685;7031;220;7915;7937;7.48;0.46;265.77;5.97;884;49;2734.00;22
7038;49;625755698;7038;225;7916;7937;7.45;0.46;265.78;5.97;878;49;2735.00;21
7041;49;625755711;7041;232;7981;8064;7.71;0.48;265.80;5.92;940;49;2736.00;83
7047;49;625755737;7047;233;7986;8065;7.65;0.47;265.94;5.92;939;49;2737.00;79
7051;49;625755750;7051;230;7989;8065;7.73;0.48;265.96;5.92;938;49;2738.00;76
7059;49;625755763;7059;231;7995;8065;7.70;0.48;266.18;5.92;936;49;2739.00;70
7065;49;625755777;7065;237;7999;8065;7.76;0.48;266.13;5.92;934;49;2740.00;66
7069;49;625755790;7069;246;8001;8065;7.78;0.48;266.24;5.92;932;49;2741.00;64
7072;49;625755803;7072;244;8004;8065;7.77;0.48;266.27;5.92;932;49;2742.00;61
7077;49;625755817;7077;250;8006;8065;7.69;0.48;266.33;5.92;929;49;2743.00;59
7079;49;625755830;7079;251;8009;8066;7.72;0.48;266.41;5.92;930;49;2744.00;57
7087;49;625755844;7087;252;8017;8068;7.65;0.47;266.48;5.92;930;49;2745.00;51
7092;49;625755858;7092;259;8018;8068;7.62;0.47;266.48;5.92;926;49;2746.00;50
7097;49;625755871;7097;258;8021;8069;7.60;0.47;266.51;5.93;924;49;2747.00;48
7101;49;625755884;7101;260;8026;8069;7.62;0.47;266.59;5.93;925;49;2748.00;43
7104;49;625755898;7104;258;8029;8069;7.57;0.47;266.68;5.93;925;49;2749.00;40
7109;49;625755911;7109;260;8030;8069;7.59;0.47;266.71;5.93;921;49;2750.00;39
7111;49;625755924;7111;260;8034;8073;7.50;0.46;266.75;5.93;923;49;2751.00;39
7115;49;625755945;7115;263;8037;8073;7.42;0.46;266.86;5.94;922;49;2752.00;36
7121;49;625755963;7121;266;8038;8073;7.31;0.45;266.88;5.94;917;49;2753.00;35
7122;49;625755977;7122;273;8042;8076;7.29;0.45;266.87;5.94;920;49;2754.00;34
7125;49;625755996;7125;274;8045;8076;7.25;0.45;266.95;5.94;920;49;2755.00;31
7133;49;625756009;7133;282;8047;8076;7.18;0.44;266.91;5.94;914;49;2756.00;29
7137;49;625756022;7137;283;8050;8080;7.23;0.45;266.92;5.94;913;49;2757.00;30
7140;49;625756036;7140;289;8051;8081;7.24;0.45;266.88;5.94;911;49;2758.00;30
7146;49;625756049;7146;290;8051;8081;7.20;0.44;266.85;5.94;905;49;2759.00;30
7149;49;625756070;7149;292;8055;8086;7.19;0.44;266.84;5.94;906;49;2760.00;31
7153;49;625756082;7153;294;8055;8086;7.17;0.44;266.83;5.94;902;49;2761.00;31
7154;49;625756096;7154;300;8055;8086;7.19;0.44;266.86;5.94;901;49;2762.00;31
7158;49;625756109;7158;307;8056;8087;7.18;0.44;266.89;5.94;898;49;2763.00;31
7160;49;625756122;7160;313;8056;8087;7.18;0.44;266.85;5.94;896;49;2764.00;31
7163;49;625756135;7163;321;8060;8093;7.11;0.44;266.91;5.93;897;49;2765.00;33
7168;49;625756149;7168;328;8060;8093;7.00;0.43;266.93;5.93;892;49;2766.00;33
7173;49;625756162;7173;314;8061;8094;6.96;0.43;266.96;5.93;888;49;2767.00;33
7176;49;625756175;7176;308;8061;8094;6.92;0.42;266.92;5.93;885;49;2768.00;33
7180;49;625756188;7180;305;8061;8094;6.93;0.42;267.03;5.93;881;49;2769.00;33
7180;49;625756201;7180;307;8061;8094;6.95;0.43;267.03;5.93;881;49;2770.00;33
7183;49;625756213;7183;315;8061;8094;7.01;0.43;266.99;5.93;878;49;2771.00;33
7183;49;625756228;7183;310;8071;8106;7.19;0.44;266.99;5.93;888;49;2772.00;35
7186;49;625756242;7186;311;8071;8106;7.25;0.44;266.99;5.93;885;49;2773.00;35
7190;49;625756255;7190;316;8072;8106;7.34;0.45;266.93;5.93;882;49;2774.00;34
7194;49;625756268;7194;321;8072;8106;7.36;0.45;266.93;5.93;878;49;2775.00;34
7197;49;625756286;7197;303;8072;8106;7.35;0.45;267.00;5.93;875;49;2776.00;34
7199;49;625756299;7199;290;8072;8106;7.42;0.45;266.99;5.93;873;49;2777.00;34
7200;49;625756312;7200;281;8075;8110;7.51;0.46;266.95;5.92;875;49;2778.00;35
7201;49;625756325;7201;269;8075;8110;7.52;0.46;266.95;5.92;874;49;2779.00;35
7206;49;625756339;7206;259;8078;8114;7.49;0.46;266.99;5.92;872;49;2780.00;36
7207;49;625756353;7207;252;8080;8115;7.53;0.46;267.00;5.92;873;49;2781.00;35
7211;49;625756368;7211;249;8080;8115;7.51;0.46;267.03;5.92;869;49;2782.00;35
7213;49;625756386;7213;246;8080;8115;7.51;0.46;266.99;5.92;867;49;2783.00;35
7215;49;625756400;7215;257;8091;8128;7.62;0.46;266.98;5.95;876;49;2784.00;37
7217;49;625756414;7217;259;8091;8128;7.66;0.47;266.99;5.95;874;49;2785.00;37
7219;49;625756426;7219;267;8092;8128;7.65;0.47;266.97;5.94;873;49;2786.00;36
7221;49;625756440;7221;260;8093;8129;7.67;0.47;266.94;5.94;872;49;2787.00;36
7223;49;625756452;7223;262;8093;8130;7.69;0.47;266.89;5.94;870;49;2788.00;37
7224;49;625756465;7224;267;8093;8130;7.70;0.47;266.88;5.94;869;49;2789.00;37
7225;49;625756481;7225;269;8096;8136;7.73;0.47;266.86;5.94;871;49;2790.00;40
7228;49;625756499;7228;272;8097;8136;7.70;0.47;266.80;5.94;869;49;2791.00;39
7229;49;625756512;7229;272;8097;8136;7.66;0.47;266.80;5.94;868;49;2792.00;39
7231;49;625756529;7231;283;8098;8136;7.58;0.46;266.80;5.94;867;49;2793.00;38
7234;49;625756552;7234;286;8101;8142;7.53;0.46;266.77;5.94;867;49;2794.00;41
7236;49;625756571;7236;294;8102;8142;7.43;0.45;266.77;5.94;866;49;2795.00;40
7239;49;625756588;7239;298;8102;8142;7.35;0.45;266.71;5.94;863;49;2796.00;40
7239;49;625756605;7239;304;8103;8142;7.34;0.45;266.71;5.94;864;49;2797.00;39
7241;49;625756620;7241;305;8107;8146;7.26;0.44;266.77;5.97;866;49;2798.00;39
7243;49;625756647;7243;309;8109;8147;7.22;0.44;266.75;5.97;866;49;2799.00;38
7245;49;625756662;7245;309;8109;8147;7.08;0.43;266.72;5.97;864;49;2800.00;38
7246;49;625756679;7246;313;8110;8148;7.05;0.43;266.71;5.97;864;49;2801.00;38
7247;49;625756692;7247;318;8110;8148;6.98;0.42;266.70;5.97;863;49;2802.00;38
7250;49;625756704;7250;308;8110;8148;6.97;0.42;266.78;5.97;860;49;2803.00;38
7250;49;625756718;7250;295;8110;8148;6.96;0.42;266.78;5.97;860;49;2804.00;38
7250;49;625756730;7250;284;8110;8148;6.91;0.42;266.78;5.97;860;49;2805.00;38
7251;49;625756743;7251;281;8110;8148;6.89;0.42;266.77;5.97;859;49;2806.00;38
7253;49;625756755;7253;282;8110;8148;6.91;0.42;266.77;5.97;857;49;2807.00;38
7254;49;625756767;7254;299;8153;8218;6.90;0.42;266.76;5.94;899;49;2808.00;65
7254;49;625756785;7254;281;8153;8219;6.95;0.42;266.76;5.94;899;49;2809.00;66
7255;49;625756798;7255;272;8159;8219;7.05;0.43;266.75;5.93;904;49;2810.00;60
7256;49;625756811;7256;260;8164;8219;7.12;0.43;266.74;5.93;908;49;2811.00;55
7256;49;625756824;7256;251;8168;8219;7.21;0.44;266.74;5.93;912;49;2812.00;51
7261;50;625756837;7261;243;8171;8219;7.29;0.44;266.69;5.93;910;50;2813.00;48
7262;50;625756861;7262;242;8173;8219;7.39;0.45;266.70;5.93;911;50;2814.00;46
7264;50;625756873;7264;240;8173;8219;7.41;0.45;266.72;5.93;909;50;2815.00;46
7265;50;625756894;7265;235;8176;8220;7.47;0.45;266.72;5.93;911;50;2816.00;44
7266;50;625756905;7266;230;8177;8221;7.51;0.46;266.74;5.93;911;50;2817.00;44
7266;50;625756917;7266;231;8178;8221;7.48;0.45;266.74;5.93;912;50;2818.00;43
7267;50;625756929;7267;228;8181;8225;7.42;0.45;266.73;5.93;914;50;2819.00;44
7269;50;625756943;7269;229;8181;8225;7.41;0.45;266.71;5.93;912;50;2820.00;44
7270;50;625756955;7270;223;8181;8225;7.38;0.45;266.69;5.93;911;50;2821.00;44
7274;50;625756967;7274;212;8181;8225;7.36;0.45;266.65;5.93;907;50;2822.00;44
7275;50;625756978;7275;203;8185;8231;7.35;0.45;266.63;5.93;910;50;2823.00;46
7277;50;625756989;7277;199;8187;8231;7.40;0.45;266.61;5.96;910;50;2824.00;44
7279;50;625757000;7279;197;8190;8231;7.42;0.45;266.59;6.02;911;50;2825.00;41
7279;50;625757013;7279;194;8192;8234;7.52;0.46;266.59;6.02;913;50;2826.00;42
7284;50;625757025;7284;200;8193;8234;7.50;0.46;266.75;6.05;909;50;2827.00;41
7290;50;625757037;7290;205;8194;8234;7.55;0.46;266.76;6.05;904;50;2828.00;40
7292;50;625757049;7292;203;8195;8235;7.63;0.46;266.79;6.09;903;50;2829.00;40
7296;50;625757060;7296;195;8196;8236;7.69;0.47;266.82;6.09;900;50;2830.00;40
7298;50;625757072;7298;186;8197;8236;7.75;0.47;266.77;6.13;899;50;2831.00;39
7300;50;625757083;7300;185;8206;8249;7.81;0.47;266.87;6.12;906;50;2832.00;43
7304;50;625757096;7304;182;8206;8249;7.85;0.47;266.87;6.12;902;50;2833.00;43
7307;50;625757108;7307;188;8207;8249;7.94;0.48;266.91;6.16;900;50;2834.00;42
7311;50;625757119;7311;182;8209;8251;8.03;0.49;266.94;6.16;898;50;2835.00;42
7314;50;625757130;7314;175;8209;8251;8.09;0.49;266.97;6.16;895;50;2836.00;42
7317;50;625757142;7317;179;8213;8255;8.20;0.50;266.94;6.16;896;50;2837.00;42
7318;50;625757154;7318;182;8215;8255;8.27;0.50;267.01;6.19;897;50;2838.00;40
7322;50;625757165;7322;186;8218;8259;8.26;0.50;267.03;6.19;896;50;2839.00;41
7323;50;625757177;7323;175;8220;8259;8.28;0.50;267.00;6.23;897;50;2840.00;39
7326;50;625757189;7326;179;8220;8259;8.24;0.50;266.99;6.23;894;50;2841.00;39
7328;50;625757201;7328;181;8220;8259;8.26;0.50;266.98;6.23;892;50;2842.00;39
7330;50;625757212;7330;185;8221;8259;8.19;0.50;267.03;6.27;891;50;2843.00;38
7333;50;625757224;7333;185;8231;8271;8.24;0.50;267.00;6.26;898;50;2844.00;40
7336;50;625757236;7336;189;8232;8271;8.18;0.50;267.10;6.26;896;50;2845.00;39
7340;50;625757249;7340;184;8232;8271;8.13;0.49;267.11;6.26;892;50;2846.00;39
7340;50;625757261;7340;186;8232;8271;8.23;0.50;267.11;6.26;892;50;2847.00;39
7342;50;625757272;7342;196;8232;8271;8.31;0.51;267.14;6.26;890;50;2848.00;39
7345;50;625757284;7345;196;8234;8271;8.31;0.51;267.20;6.29;889;50;2849.00;37
7345;50;625757298;7345;198;8236;8274;8.30;0.51;267.20;6.28;891;50;2850.00;38
7350;50;625757311;7350;187;8236;8274;8.30;0.50;267.35;6.28;886;50;2851.00;38
7352;50;625757323;7352;192;8241;8280;8.35;0.51;267.37;6.29;889;50;2852.00;39
7354;50;625757336;7354;188;8244;8281;8.44;0.51;267.43;6.31;890;50;2853.00;37
7356;50;625757348;7356;193;8245;8281;8.45;0.52;267.47;6.32;889;50;2854.00;36
7361;50;625757360;7361;195;8246;8281;8.44;0.51;267.55;6.33;885;50;2855.00;35
7363;50;625757372;7363;199;8249;8285;8.49;0.52;267.53;6.33;886;50;2856.00;36
7364;50;625757384;7364;199;8251;8285;8.46;0.52;267.58;6.35;887;50;2857.00;34
7366;50;625757397;7366;201;8252;8285;8.49;0.52;267.61;6.36;886;50;2858.00;33
7370;50;625757409;7370;201;8254;8286;8.50;0.52;267.67;6.37;884;50;2859.00;32
7373;50;625757420;7373;198;8258;8290;8.51;0.52;267.73;6.38;885;50;2860.00;32
7375;50;625757432;7375;208;8259;8290;8.54;0.52;267.73;6.39;884;50;2861.00;31
7379;50;625757444;7379;211;8262;8293;8.57;0.52;267.76;6.40;883;50;2862.00;31
7384;50;625757457;7384;210;8262;8293;8.54;0.52;267.84;6.40;878;50;2863.00;31
7386;50;625757469;7386;217;8264;8295;8.43;0.51;267.86;6.39;878;50;2864.00;31
7388;50;625757481;7388;219;8267;8295;8.40;0.51;267.89;6.42;879;50;2865.00;28
7392;50;625757493;7392;212;8270;8299;8.39;0.51;267.97;6.41;878;50;2866.00;29
7393;50;625757504;7393;214;8271;8299;8.35;0.51;267.95;6.41;878;50;2867.00;28
7395;50;625757516;7395;214;8273;8299;8.31;0.51;267.95;6.43;878;50;2868.00;26
7398;50;625757527;7398;212;8273;8299;8.21;0.50;268.03;6.43;875;50;2869.00;26
7400;50;625757539;7400;213;8275;8300;8.03;0.49;268.05;6.45;875;50;2870.00;25
7401;50;625757551;7401;211;8276;8301;7.96;0.48;268.08;6.45;875;50;2871.00;25
7404;50;625757562;7404;212;8276;8301;7.90;0.48;268.13;6.45;872;50;2872.00;25
7407;50;625757573;7407;213;8279;8302;7.88;0.48;268.11;6.46;872;50;2873.00;23
7410;50;625757584;7410;212;8279;8302;7.83;0.48;268.22;6.46;869;50;2874.00;23
7412;50;625757595;7412;214;8279;8302;7.87;0.48;268.24;6.46;867;50;2875.00;23
7413;50;625757606;7413;213;8281;8302;7.88;0.48;268.23;6.48;868;50;2876.00;21
7417;50;625757617;7417;212;8281;8302;7.87;0.48;268.24;6.48;864;50;2877.00;21
7419;50;625757628;7419;215;8281;8302;7.88;0.48;268.29;6.48;862;50;2878.00;21
7419;50;625757639;7419;216;8283;8302;7.91;0.48;268.29;6.49;864;50;2879.00;19
7421;50;625757651;7421;257;8384;8532;7.93;0.49;268.36;6.41;963;50;2880.00;148
7424;50;625757681;7424;246;8388;8533;7.88;0.49;268.42;6.41;964;50;2881.00;145
7425;50;625757694;7425;236;8398;8533;7.90;0.49;268.44;6.41;973;50;2882.00;135
7430;50;625757705;7430;232;8403;8533;7.78;0.48;268.49;6.41;973;50;2883.00;130
7431;50;625757717;7431;236;8409;8533;7.80;0.48;268.47;6.41;978;50;2884.00;124
7439;50;625757729;7439;241;8418;8533;7.76;0.48;268.54;6.42;979;50;2885.00;115
7445;50;625757741;7445;238;8422;8533;7.70;0.48;268.55;6.42;977;50;2886.00;111
7445;50;625757752;7445;241;8428;8533;7.68;0.48;268.55;6.42;983;50;2887.00;105
7453;50;625757763;7453;251;8434;8534;7.58;0.47;268.59;6.43;981;50;2888.00;100
7457;50;625757775;7457;255;8437;8535;7.52;0.47;268.58;6.43;980;50;2889.00;98
7459;50;625757785;7459;246;8444;8535;7.48;0.46;268.60;6.43;985;50;2890.00;91
7463;50;625757797;7463;245;8449;8536;7.38;0.46;268.67;6.44;986;50;2891.00;87
7467;50;625757808;7467;247;8452;8536;7.26;0.45;268.79;6.44;985;50;2892.00;84
7470;50;625757820;7470;245;8456;8536;7.15;0.44;268.85;6.44;986;50;2893.00;80
7476;50;625757832;7476;260;8459;8536;7.03;0.44;268.94;6.45;983;50;2894.00;77
7479;50;625757844;7479;267;8465;8540;6.94;0.43;269.00;6.45;986;50;2895.00;75
7482;50;625757856;7482;278;8469;8540;6.85;0.42;269.05;6.45;987;50;2896.00;71
7487;50;625757867;7487;284;8472;8540;6.79;0.42;269.19;6.46;985;50;2897.00;68
7488;50;625757879;7488;286;8477;8543;6.86;0.42;269.16;6.46;989;50;2898.00;66
7493;50;625757891;7493;288;8479;8543;6.90;0.43;269.19;6.46;986;50;2899.00;64
7495;50;625757904;7495;290;8481;8543;6.96;0.43;269.17;6.47;986;50;2900.00;62
7499;50;625757920;7499;278;8488;8547;6.96;0.43;269.22;6.47;989;50;2901.00;59
7504;50;625757932;7504;280;8491;8548;6.98;0.43;269.21;6.48;987;50;2902.00;57
7505;50;625757945;7505;285;8495;8548;7.02;0.43;269.19;6.48;990;50;2903.00;53
7509;50;625757957;7509;278;8499;8552;7.08;0.44;269.25;6.48;990;50;2904.00;53
7514;50;625757970;7514;279;8501;8552;7.09;0.44;269.21;6.48;987;50;2905.00;51
7517;50;625757982;7517;283;8504;8552;7.08;0.44;269.25;6.49;987;50;2906.00;48
7521;50;625757994;7521;288;8506;8553;7.10;0.44;269.30;6.49;985;50;2907.00;47
7526;50;625758006;7526;293;8506;8553;7.08;0.43;269.29;6.49;980;50;2908.00;47
7532;50;625758018;7532;295;8512;8559;7.03;0.43;269.40;6.49;980;50;2909.00;47
7537;50;625758032;7537;297;8513;8559;6.93;0.42;269.48;6.49;976;50;2910.00;46
7541;50;625758045;7541;297;8515;8560;6.87;0.42;269.52;6.50;974;50;2911.00;45
7548;50;625758057;7548;300;8515;8560;6.83;0.42;269.55;6.50;967;50;2912.00;45
7550;50;625758074;7550;294;8516;8560;6.85;0.42;269.55;6.50;966;50;2913.00;44
7554;50;625758087;7554;294;8517;8560;6.81;0.42;269.60;6.50;963;50;2914.00;43
7558;50;625758099;7558;303;8517;8560;6.74;0.41;269.63;6.50;959;50;2915.00;43
7561;50;625758111;7561;307;8528;8572;6.74;0.41;269.63;6.50;967;50;2916.00;44
7566;50;625758123;7566;316;8529;8572;6.64;0.40;269.82;6.51;963;50;2917.00;43
7570;50;625758135;7570;323;8531;8572;6.62;0.40;269.81;6.51;961;50;2918.00;41
7575;50;625758147;7575;326;8532;8572;6.58;0.40;269.93;6.54;957;50;2919.00;40
7575;50;625758159;7575;330;8533;8572;6.54;0.40;269.93;6.55;958;50;2920.00;39
7578;50;625758171;7578;340;8533;8572;6.50;0.40;269.90;6.55;955;50;2921.00;39
7580;50;625758183;7580;341;8537;8576;6.57;0.40;269.91;6.55;957;50;2922.00;39
7584;50;625758195;7584;344;8537;8576;6.58;0.40;269.95;6.55;953;50;2923.00;39
7587;50;625758207;7587;348;8541;8580;6.61;0.41;269.91;6.55;954;50;2924.00;39
7588;50;625758218;7588;351;8544;8582;6.69;0.41;269.93;6.55;956;50;2925.00;38
7588;50;625758231;7588;356;8544;8582;6.68;0.41;269.93;6.55;956;50;2926.00;38
7589;50;625758242;7589;358;8546;8582;6.65;0.41;269.93;6.56;957;50;2927.00;36
7592;50;625758254;7592;357;8554;8595;6.70;0.41;269.92;6.55;962;50;2928.00;41
7594;50;625758267;7594;354;8554;8595;6.65;0.41;269.94;6.55;960;50;2929.00;41
7597;50;625758278;7597;358;8556;8595;6.62;0.41;269.99;6.55;959;50;2930.00;39
7599;50;625758289;7599;363;8558;8596;6.56;0.40;269.96;6.59;959;50;2931.00;38
7601;50;625758300;7601;371;8558;8597;6.51;0.40;269.91;6.59;957;50;2932.00;39
7606;50;625758311;7606;383;8558;8597;6.44;0.39;269.85;6.59;952;50;2933.00;39
7611;50;625758322;7611;387;8561;8600;6.39;0.39;269.79;6.62;950;50;2934.00;39
7614;50;625758334;7614;402;8561;8600;6.36;0.39;269.72;6.62;947;50;2935.00;39
7618;50;625758346;7618;404;8562;8600;6.29;0.38;269.68;6.62;944;50;2936.00;38
7621;50;625758362;7621;405;8563;8600;6.24;0.38;269.66;6.65;942;50;2937.00;37
7624;50;625758374;7624;399;8567;8606;6.26;0.38;269.65;6.65;943;50;2938.00;39
7625;50;625758388;7625;398;8567;8606;6.21;0.38;269.62;6.65;942;50;2939.00;39
7628;50;625758403;7628;398;8569;8606;6.21;0.38;269.60;6.68;941;50;2940.00;37
7630;50;625758415;7630;390;8569;8606;6.22;0.38;269.56;6.68;939;50;2941.00;37
7632;50;625758428;7632;387;8572;8610;6.31;0.39;269.53;6.68;940;50;2942.00;38
7635;50;625758440;7635;390;8573;8611;6.35;0.39;269.49;6.68;938;50;2943.00;38
7637;50;625758454;7637;388;8573;8611;6.40;0.39;269.49;6.68;936;50;2944.00;38
7638;50;625758472;7638;385;8574;8612;6.44;0.39;269.46;6.68;936;50;2945.00;38
7639;50;625758485;7639;373;8574;8612;6.49;0.40;269.45;6.68;935;50;2946.00;38
7644;50;625758498;7644;361;8574;8612;6.51;0.40;269.38;6.68;930;50;2947.00;38
7644;50;625758512;7644;355;8574;8612;6.57;0.40;269.38;6.68;930;50;2948.00;38
7648;50;625758528;7648;352;8574;8612;6.63;0.41;269.39;6.68;926;50;2949.00;38
7650;50;625758551;7650;347;8574;8612;6.67;0.41;269.39;6.68;924;50;2950.00;38
7650;50;625758583;7650;348;8574;8612;6.75;0.41;269.39;6.68;924;50;2951.00;38
7652;50;625758599;7652;350;8608;8682;6.87;0.42;269.41;6.65;956;50;2952.00;74
7652;50;625758626;7652;341;8608;8683;6.94;0.43;269.41;6.65;956;50;2953.00;75
7653;50;625758643;7653;341;8615;8683;7.07;0.43;269.44;6.65;962;50;2954.00;68
7654;50;625758656;7654;331;8618;8683;7.16;0.44;269.43;6.65;964;50;2955.00;65
7656;50;625758671;7656;316;8622;8683;7.29;0.45;269.48;6.65;966;50;2956.00;61
7658;50;625758688;7658;307;8626;8683;7.39;0.45;269.47;6.64;968;50;2957.00;57
7660;50;625758702;7660;298;8631;8683;7.51;0.46;269.46;6.64;971;50;2958.00;52
7661;50;625758716;7661;289;8632;8683;7.54;0.46;269.45;6.64;971;50;2959.00;51
7662;50;625758739;7662;288;8635;8684;7.58;0.46;269.45;6.64;973;50;2960.00;49
7662;50;625758757;7662;283;8636;8685;7.65;0.47;269.45;6.64;974;50;2961.00;49
7663;50;625758771;7663;275;8637;8685;7.67;0.47;269.44;6.64;974;50;2962.00;48
7665;51;625758784;7665;269;8640;8689;7.67;0.47;269.42;6.64;975;51;2963.00;49
7667;51;625758809;7667;261;8640;8689;7.70;0.47;269.39;6.64;973;51;2964.00;49
7671;52;625758829;7671;259;8640;8689;7.66;0.47;269.39;6.64;969;52;2965.00;49
7671;52;625758856;7671;259;8640;8689;7.68;0.47;269.39;6.64;969;52;2966.00;49
7672;52;625758869;7672;256;8643;8695;7.66;0.47;269.39;6.64;971;52;2967.00;52
7673;52;625758889;7673;263;8643;8695;7.62;0.46;269.46;6.64;970;52;2968.00;52
7676;52;625758902;7676;253;8645;8695;7.59;0.46;269.46;6.67;969;52;2969.00;50
7677;52;625758917;7677;262;8648;8701;7.59;0.46;269.45;6.67;971;52;2970.00;53
7679;52;625758938;7679;263;8649;8701;7.58;0.46;269.45;6.67;970;52;2971.00;52
7681;52;625758951;7681;265;8649;8701;7.59;0.46;269.44;6.67;968;52;2972.00;52
7683;52;625758964;7683;269;8650;8702;7.60;0.46;269.41;6.67;967;52;2973.00;52
7683;52;625758977;7683;279;8651;8703;7.63;0.46;269.41;6.67;968;52;2974.00;52
7687;52;625758989;7687;278;8652;8703;7.57;0.46;269.39;6.67;965;52;2975.00;51
7690;52;625759001;7690;275;8660;8716;7.60;0.46;269.44;6.66;970;52;2976.00;56
7691;52;625759016;7691;279;8661;8716;7.57;0.46;269.43;6.66;970;52;2977.00;55
7693;52;625759029;7693;276;8661;8716;7.54;0.46;269.43;6.66;968;52;2978.00;55
7694;52;625759041;7694;277;8662;8717;7.55;0.46;269.46;6.66;968;52;2979.00;55
7698;52;625759053;7698;274;8662;8717;7.55;0.46;269.51;6.66;964;52;2980.00;55
7699;52;625759067;7699;270;8664;8721;7.65;0.47;269.50;6.66;965;52;2981.00;57
7703;52;625759080;7703;266;8664;8721;7.67;0.47;269.48;6.66;961;52;2982.00;57
7706;52;625759094;7706;261;8668;8725;7.64;0.47;269.56;6.65;962;52;2983.00;57
7708;52;625759107;7708;267;8668;8725;7.62;0.46;269.58;6.65;960;52;2984.00;57
7711;52;625759120;7711;264;8668;8725;7.62;0.46;269.62;6.65;957;52;2985.00;57
7716;52;625759133;7716;253;8668;8725;7.57;0.46;269.67;6.65;952;52;2986.00;57
7719;52;625759145;7719;250;8669;8725;7.53;0.46;269.69;6.69;950;52;2987.00;56
7723;52;625759157;7723;248;8678;8737;7.53;0.46;269.72;6.68;955;52;2988.00;59
7724;52;625759170;7724;244;8679;8737;7.56;0.46;269.74;6.69;955;52;2989.00;58
7728;52;625759182;7728;245;8681;8737;7.56;0.46;269.73;6.69;953;52;2990.00;56
7730;52;625759194;7730;241;8681;8737;7.56;0.46;269.77;6.69;951;52;2991.00;56
7734;52;625759206;7734;236;8681;8737;7.56;0.46;269.82;6.69;947;52;2992.00;56
7739;52;625759220;7739;222;8681;8737;7.56;0.46;269.81;6.69;942;52;2993.00;56
7740;52;625759232;7740;224;8683;8738;7.55;0.46;269.79;6.70;943;52;2994.00;55
7742;52;625759245;7742;213;8685;8738;7.55;0.46;269.78;6.72;943;52;2995.00;53
7744;52;625759258;7744;212;8688;8744;7.57;0.46;269.78;6.72;944;52;2996.00;56
7747;52;625759270;7747;210;8690;8745;7.66;0.46;269.79;6.72;943;52;2997.00;55
7753;52;625759282;7753;204;8692;8745;7.63;0.46;269.78;6.78;939;52;2998.00;53
7755;52;625759294;7755;194;8692;8745;7.67;0.47;269.83;6.78;937;52;2999.00;53
7758;52;625759309;7758;194;8696;8765;7.70;0.47;269.88;6.77;938;52;3000.00;69
7762;52;625759327;7762;188;8698;8765;7.76;0.47;269.87;6.79;936;52;3001.00;67
7765;52;625759339;7765;182;8698;8765;7.78;0.47;269.89;6.79;933;52;3002.00;67
7765;52;625759352;7765;186;8699;8766;7.87;0.48;269.89;6.79;934;52;3003.00;67
7768;52;625759363;7768;185;8702;8770;7.88;0.48;269.95;6.79;934;52;3004.00;68
7771;52;625759376;7771;187;8703;8770;7.94;0.48;269.88;6.79;932;52;3005.00;67
7774;52;625759388;7774;178;8705;8773;7.99;0.48;269.96;6.79;931;52;3006.00;68
7776;52;625759407;7776;173;8706;8773;8.05;0.49;269.95;6.79;930;52;3007.00;67
7780;52;625759419;7780;166;8707;8773;8.07;0.49;270.05;6.80;927;52;3008.00;66
7783;52;625759433;7783;174;8708;8773;8.14;0.49;270.10;6.80;925;52;3009.00;65
7788;52;625759445;7788;170;8710;8777;8.21;0.50;270.15;6.80;922;52;3010.00;67
7791;52;625759459;7791;167;8713;8777;8.18;0.49;270.21;6.82;922;52;3011.00;64
7792;52;625759472;7792;165;8713;8777;8.28;0.50;270.20;6.82;921;52;3012.00;64
7795;52;625759484;7795;175;8719;8777;8.31;0.50;270.18;6.83;924;52;3013.00;58
7798;52;625759496;7798;169;8720;8778;8.40;0.51;270.18;6.83;922;52;3014.00;58
7800;52;625759510;7800;171;8724;8780;8.42;0.51;270.15;6.83;924;52;3015.00;56
7802;52;625759524;7802;173;8724;8780;8.45;0.51;270.25;6.83;922;52;3016.00;56
7804;52;625759536;7804;178;8727;8781;8.49;0.51;270.29;6.83;923;52;3017.00;54
7805;52;625759549;7805;181;8727;8781;8.49;0.51;270.36;6.83;922;52;3018.00;54
7808;52;625759562;7808;179;8728;8781;8.52;0.52;270.39;6.83;920;52;3019.00;53
7811;52;625759576;7811;187;8730;8781;8.51;0.52;270.49;6.86;919;52;3020.00;51
7813;52;625759588;7813;196;8731;8781;8.56;0.52;270.49;6.86;918;52;3021.00;50
7815;52;625759601;7815;191;8732;8781;8.65;0.52;270.54;6.87;917;52;3022.00;49
7819;52;625759614;7819;193;8733;8781;8.68;0.53;270.61;6.89;914;52;3023.00;48
7820;52;625759626;7820;221;8796;8908;8.71;0.53;270.65;6.84;976;52;3024.00;112
7823;52;625759648;7823;213;8804;8909;8.73;0.54;270.68;6.87;981;52;3025.00;105
7826;52;625759662;7826;207;8808;8909;8.80;0.54;270.73;6.86;982;52;3026.00;101
7831;52;625759675;7831;209;8813;8909;8.80;0.54;270.76;6.88;982;52;3027.00;96
7832;52;625759689;7832;214;8818;8909;8.83;0.54;270.81;6.89;986;52;3028.00;91
7835;52;625759701;7835;209;8823;8909;8.85;0.54;270.84;6.90;988;52;3029.00;86
7835;52;625759716;7835;210;8829;8909;8.86;0.54;270.84;6.90;994;52;3030.00;80
7839;52;625759728;7839;207;8833;8909;8.91;0.55;271.04;6.92;994;52;3031.00;76
7842;52;625759742;7842;202;8840;8910;8.97;0.55;271.13;6.93;998;52;3032.00;70
7847;52;625759755;7847;207;8843;8911;9.02;0.55;271.10;6.94;996;52;3033.00;68
7851;52;625759768;7851;214;8848;8911;9.02;0.55;271.12;6.95;997;52;3034.00;63
7855;52;625759782;7855;214;8853;8912;8.93;0.55;271.14;6.95;998;52;3035.00;59
7858;52;625759794;7858;210;8856;8912;8.82;0.54;271.22;6.97;998;52;3036.00;56
7862;52;625759807;7862;218;8861;8912;8.74;0.54;271.30;6.97;999;52;3037.00;51
7864;52;625759821;7864;220;8864;8912;8.59;0.53;271.33;6.98;1000;52;3038.00;48
7869;52;625759833;7869;225;8868;8916;8.45;0.52;271.36;6.99;999;52;3039.00;48
7873;52;625759846;7873;226;8870;8916;8.38;0.51;271.47;6.99;997;52;3040.00;46
7876;52;625759859;7876;236;8872;8916;8.33;0.51;271.49;7.00;996;52;3041.00;44
7882;52;625759872;7882;243;8874;8919;8.26;0.50;271.46;7.00;992;52;3042.00;45
7889;52;625759885;7889;240;8876;8919;8.17;0.50;271.55;7.00;987;52;3043.00;43
7890;52;625759899;7890;248;8879;8919;8.13;0.50;271.54;7.02;989;52;3044.00;40
7894;52;625759911;7894;254;8885;8923;8.01;0.49;271.63;7.02;991;52;3045.00;38
7896;52;625759924;7896;260;8886;8924;8.01;0.49;271.63;7.02;990;52;3046.00;38
7898;52;625759937;7898;263;8888;8924;7.94;0.49;271.62;7.03;990;52;3047.00;36
7900;52;625759951;7900;267;8891;8928;7.90;0.48;271.68;7.03;991;52;3048.00;37
7905;52;625759966;7905;274;8891;8928;7.82;0.48;271.74;7.03;986;52;3049.00;37
7907;53;625759982;7907;279;8892;8928;7.75;0.48;271.76;7.03;985;53;3050.00;36
7910;53;625760008;7910;281;8893;8929;7.66;0.47;271.75;7.03;983;53;3051.00;36
7918;53;625760027;7918;283;8894;8929;7.48;0.46;271.79;7.04;976;53;3052.00;35
7919;53;625760040;7919;288;8899;8935;7.39;0.45;271.82;7.04;980;53;3053.00;36
7924;53;625760053;7924;290;8900;8935;7.31;0.45;271.82;7.04;976;53;3054.00;35
7930;53;625760065;7930;299;8901;8936;7.22;0.44;271.91;7.04;971;53;3055.00;35
7935;53;625760077;7935;295;8902;8936;7.10;0.44;271.88;7.05;967;53;3056.00;34
7942;53;625760090;7942;300;8903;8936;6.96;0.43;271.89;7.05;961;53;3057.00;33
7945;53;625760102;7945;311;8903;8936;6.84;0.42;271.92;7.05;958;53;3058.00;33
7951;53;625760114;7951;316;8906;8936;6.64;0.41;272.01;7.07;955;53;3059.00;30
7955;53;625760133;7955;313;8932;8972;6.62;0.41;272.12;7.06;977;53;3060.00;40
7956;53;625760149;7956;313;8932;8972;6.54;0.40;272.16;7.06;976;53;3061.00;40
7960;53;625760161;7960;320;8936;8972;6.50;0.40;272.23;7.06;976;53;3062.00;36
7965;53;625760172;7965;314;8937;8972;6.39;0.39;272.27;7.06;972;53;3063.00;35
7966;53;625760184;7966;320;8939;8972;6.35;0.39;272.24;7.06;973;53;3064.00;33
7970;53;625760195;7970;331;8939;8972;6.29;0.39;272.33;7.06;969;53;3065.00;33
7972;53;625760207;7972;329;8944;8976;6.32;0.39;272.35;7.06;972;53;3066.00;32
7973;53;625760220;7973;328;8944;8976;6.33;0.39;272.36;7.06;971;53;3067.00;32
7978;53;625760232;7978;332;8948;8980;6.34;0.39;272.43;7.06;970;53;3068.00;32
7982;53;625760245;7982;340;8949;8981;6.36;0.39;272.53;7.06;967;53;3069.00;32
7985;53;625760257;7985;342;8950;8981;6.33;0.39;272.51;7.06;965;53;3070.00;31
7988;53;625760268;7988;344;8951;8981;6.34;0.39;272.54;7.06;963;53;3071.00;30
7991;53;625760280;7991;346;8962;8994;6.36;0.39;272.55;7.05;971;53;3072.00;32
7994;53;625760297;7994;339;8963;8994;6.38;0.39;272.53;7.05;969;53;3073.00;31
7997;53;625760310;7997;343;8963;8994;6.39;0.39;272.53;7.05;966;53;3074.00;31
8002;53;625760322;8002;346;8964;8995;6.39;0.39;272.56;7.05;962;53;3075.00;31
8006;53;625760335;8006;359;8964;8996;6.39;0.39;272.46;7.05;958;53;3076.00;32
8009;53;625760347;8009;359;8964;8996;6.41;0.39;272.44;7.05;955;53;3077.00;32
8012;53;625760365;8012;353;8966;8999;6.49;0.40;272.44;7.05;954;53;3078.00;33
8016;53;625760377;8016;348;8966;8999;6.48;0.40;272.43;7.05;950;53;3079.00;33
8017;53;625760388;8017;340;8967;8999;6.48;0.40;272.45;7.05;950;53;3080.00;32
8025;53;625760400;8025;338;8967;8999;6.36;0.39;272.41;7.05;942;53;3081.00;32
8026;53;625760412;8026;345;8971;9005;6.34;0.39;272.40;7.05;945;53;3082.00;34
8030;53;625760425;8030;346;8971;9005;6.31;0.39;272.40;7.05;941;53;3083.00;34
8037;53;625760436;8037;359;8972;9005;6.21;0.38;272.43;7.05;935;53;3084.00;33
8039;53;625760449;8039;365;8972;9005;6.13;0.38;272.43;7.05;933;53;3085.00;33
8046;53;625760461;8046;368;8976;9009;6.06;0.37;272.43;7.07;930;53;3086.00;33
8049;53;625760475;8049;374;8977;9010;6.03;0.37;272.42;7.06;928;53;3087.00;33
8052;53;625760487;8052;376;8977;9010;6.00;0.37;272.53;7.06;925;53;3088.00;33
8058;53;625760499;8058;371;8978;9011;5.89;0.36;272.47;7.06;920;53;3089.00;33
8064;53;625760514;8064;378;8978;9011;5.82;0.36;272.46;7.06;914;53;3090.00;33
8066;53;625760532;8066;381;8978;9011;5.83;0.36;272.43;7.06;912;53;3091.00;33
8070;53;625760550;8070;385;8978;9011;5.80;0.35;272.40;7.06;908;53;3092.00;33
8074;53;625760568;8074;385;8978;9011;5.78;0.35;272.46;7.06;904;53;3093.00;33
8077;53;625760589;8077;390;8978;9011;5.75;0.35;272.43;7.06;901;53;3094.00;33
8079;53;625760608;8079;392;8978;9011;5.73;0.35;272.41;7.06;899;53;3095.00;33
8081;53;625760623;8081;400;9016;9081;5.95;0.36;272.35;7.03;935;53;3096.00;65
8082;53;625760651;8082;399;9017;9082;5.97;0.37;272.33;7.03;935;53;3097.00;65
8085;53;625760665;8085;400;9025;9082;6.10;0.37;272.38;7.03;940;53;3098.00;57
8087;53;625760678;8087;399;9028;9082;6.17;0.38;272.38;7.03;941;53;3099.00;54
8088;53;625760693;8088;400;9034;9082;6.26;0.38;272.36;7.03;946;53;3100.00;48
8092;53;625760711;8092;412;9038;9082;6.29;0.38;272.38;7.02;946;53;3101.00;44
8093;53;625760724;8093;412;9041;9082;6.32;0.39;272.37;7.02;948;53;3102.00;41
8095;53;625760738;8095;417;9042;9082;6.32;0.39;272.36;7.02;947;53;3103.00;40
8097;53;625760754;8097;428;9044;9083;6.32;0.39;272.39;7.02;947;53;3104.00;39
8100;53;625760768;8100;428;9046;9085;6.28;0.38;272.35;7.02;946;53;3105.00;39
8103;53;625760783;8103;442;9047;9085;6.16;0.38;272.29;7.02;944;53;3106.00;38
8103;53;625760797;8103;428;9050;9089;6.14;0.38;272.29;7.02;947;53;3107.00;39
8106;53;625760812;8106;415;9050;9089;6.17;0.38;272.32;7.02;944;53;3108.00;39
8109;53;625760826;8109;406;9050;9089;6.23;0.38;272.30;7.02;941;53;3109.00;39
8111;53;625760840;8111;395;9050;9089;6.32;0.39;272.42;7.02;939;53;3110.00;39
8111;53;625760853;8111;385;9054;9095;6.47;0.40;272.42;7.02;943;53;3111.00;41
8114;53;625760868;8114;378;9054;9095;6.54;0.40;272.41;7.02;940;53;3112.00;41
8117;53;625760889;8117;372;9055;9095;6.69;0.41;272.40;7.02;938;53;3113.00;40
8119;53;625760910;8119;368;9057;9098;6.82;0.42;272.39;7.02;938;53;3114.00;41
8120;53;625760924;8120;363;9057;9098;6.91;0.42;272.39;7.02;937;53;3115.00;41
8122;53;625760939;8122;344;9058;9098;7.04;0.43;272.35;7.02;936;53;3116.00;40
8125;53;625760963;8125;327;9058;9099;7.14;0.44;272.33;7.02;933;53;3117.00;41
8129;53;625760985;8129;322;9059;9100;7.25;0.44;272.35;7.01;930;53;3118.00;41
8130;53;625761000;8130;305;9059;9100;7.32;0.45;272.34;7.01;929;53;3119.00;41
8131;53;625761016;8131;300;9079;9126;7.55;0.46;272.31;7.00;948;53;3120.00;47
8133;53;625761034;8133;288;9080;9126;7.67;0.47;272.29;7.00;947;53;3121.00;46
8135;53;625761050;8135;287;9081;9126;7.81;0.48;272.27;7.00;946;53;3122.00;45
8136;53;625761064;8136;284;9082;9127;7.94;0.48;272.26;7.00;946;53;3123.00;45
8138;53;625761079;8138;279;9082;9127;7.97;0.49;272.23;7.00;944;53;3124.00;45
8140;53;625761101;8140;281;9085;9131;8.05;0.49;272.21;7.00;945;53;3125.00;46
8142;53;625761116;8142;285;9085;9131;8.08;0.49;272.23;7.00;943;53;3126.00;46
8144;53;625761132;8144;283;9089;9135;8.07;0.49;272.22;6.99;945;53;3127.00;46
8148;53;625761147;8148;273;9089;9135;8.06;0.49;272.23;6.99;941;53;3128.00;46
8148;53;625761162;8148;268;9089;9135;8.03;0.49;272.23;6.99;941;53;3129.00;46
8151;53;625761176;8151;261;9089;9135;7.99;0.49;272.24;6.99;938;53;3130.00;46
8156;53;625761191;8156;259;9089;9135;7.98;0.49;272.29;6.99;933;53;3131.00;46
8157;53;625761207;8157;256;9100;9147;8.07;0.49;272.28;7.01;943;53;3132.00;47
8160;53;625761224;8160;252;9100;9147;8.10;0.49;272.25;7.01;940;53;3133.00;47
8166;53;625761238;8166;248;9101;9147;8.05;0.49;272.36;7.01;935;53;3134.00;46
8167;53;625761257;8167;245;9101;9147;8.08;0.49;272.38;7.01;934;53;3135.00;46
8170;53;625761279;8170;247;9101;9147;8.06;0.49;272.48;7.01;931;53;3136.00;46
8172;53;625761295;8172;251;9101;9147;8.10;0.49;272.47;7.01;929;53;3137.00;46
8176;53;625761308;8176;250;9101;9148;8.10;0.49;272.49;7.01;925;53;3138.00;47
8179;53;625761321;8179;252;9101;9148;8.10;0.49;272.49;7.01;922;53;3139.00;47
8182;53;625761343;8182;251;9105;9154;8.09;0.49;272.48;7.01;923;53;3140.00;49
8183;53;625761356;8183;255;9106;9155;8.09;0.49;272.51;7.01;923;53;3141.00;49
8186;53;625761368;8186;259;9107;9155;8.06;0.49;272.55;7.01;921;53;3142.00;48
8187;53;625761381;8187;263;9107;9155;8.08;0.49;272.61;7.01;920;53;3143.00;48
8190;53;625761394;8190;271;9110;9159;8.11;0.49;272.68;7.01;920;53;3144.00;49
8193;53;625761407;8193;269;9110;9159;8.08;0.49;272.67;7.01;917;53;3145.00;49
8194;53;625761419;8194;271;9110;9159;8.03;0.49;272.67;7.01;916;53;3146.00;49
8196;53;625761431;8196;275;9112;9160;7.96;0.49;272.70;7.03;916;53;3147.00;48
8200;53;625761443;8200;283;9115;9164;7.86;0.48;272.76;7.03;915;53;3148.00;49
8202;53;625761456;8202;292;9115;9164;7.80;0.48;272.77;7.03;913;53;3149.00;49
8205;53;625761469;8205;281;9118;9170;7.74;0.47;272.82;7.03;913;53;3150.00;52
8207;53;625761482;8207;285;9118;9170;7.71;0.47;272.80;7.03;911;53;3151.00;52
8208;53;625761493;8208;283;9119;9170;7.68;0.47;272.80;7.03;911;53;3152.00;51
8211;53;625761505;8211;278;9119;9170;7.62;0.46;272.91;7.03;908;53;3153.00;51
8215;53;625761519;8215;269;9122;9174;7.61;0.46;273.01;7.03;907;53;3154.00;52
8219;53;625761537;8219;268;9122;9174;7.62;0.46;273.02;7.03;903;53;3155.00;52
8223;53;625761550;8223;264;9123;9174;7.67;0.47;273.07;7.03;900;53;3156.00;51
8228;53;625761562;8228;266;9123;9174;7.68;0.47;273.18;7.03;895;53;3157.00;51
8232;53;625761574;8232;262;9124;9175;7.66;0.47;273.25;7.03;892;53;3158.00;51
8235;53;625761587;8235;253;9125;9176;7.61;0.46;273.29;7.03;890;53;3159.00;51
8236;53;625761598;8236;251;9126;9176;7.63;0.46;273.35;7.03;890;53;3160.00;50
8240;53;625761609;8240;250;9127;9177;7.61;0.46;273.36;7.03;887;53;3161.00;50
8245;53;625761620;8245;241;9128;9177;7.54;0.46;273.36;7.06;883;53;3162.00;49
8248;53;625761631;8248;231;9128;9177;7.52;0.46;273.42;7.06;880;53;3163.00;49
8250;53;625761643;8250;226;9129;9177;7.60;0.46;273.41;7.07;879;53;3164.00;48
8254;53;625761655;8254;215;9129;9177;7.63;0.46;273.42;7.07;875;53;3165.00;48
8257;53;625761666;8257;210;9130;9177;7.65;0.47;273.44;7.08;873;53;3166.00;47
8260;53;625761677;8260;209;9131;9177;7.71;0.47;273.46;7.11;871;53;3167.00;46
8267;53;625761688;8267;221;9197;9304;7.72;0.48;273.46;7.06;930;53;3168.00;107
8269;53;625761709;8269;209;9199;9305;7.74;0.48;273.46;7.06;930;53;3169.00;106
8273;53;625761722;8273;198;9208;9305;7.85;0.48;273.48;7.09;935;53;3170.00;97
8278;53;625761734;8278;196;9212;9305;7.93;0.49;273.52;7.09;934;53;3171.00;93
8281;53;625761747;8281;188;9218;9305;8.08;0.49;273.52;7.12;937;53;3172.00;87
8282;53;625761759;8282;190;9223;9305;8.21;0.50;273.53;7.11;941;53;3173.00;82
8286;53;625761774;8286;191;9228;9305;8.36;0.51;273.50;7.15;942;53;3174.00;77
8287;53;625761786;8287;193;9231;9305;8.49;0.52;273.52;7.15;944;53;3175.00;74
8289;53;625761799;8289;186;9236;9306;8.59;0.52;273.54;7.14;947;53;3176.00;70
8291;53;625761812;8291;181;9241;9307;8.69;0.53;273.53;7.18;950;53;3177.00;66
8294;53;625761826;8294;182;9243;9307;8.79;0.54;273.61;7.18;949;53;3178.00;64
8297;53;625761838;8297;179;9244;9308;8.91;0.54;273.68;7.18;947;53;3179.00;64
8299;53;625761853;8299;182;9248;9308;8.96;0.55;273.70;7.21;949;53;3180.00;60
8302;53;625761865;8302;185;9249;9308;9.03;0.55;273.80;7.21;947;53;3181.00;59
8306;53;625761878;8306;191;9251;9308;8.98;0.55;273.83;7.21;945;53;3182.00;57
8308;53;625761891;8308;193;9256;9312;8.96;0.55;273.87;7.25;948;53;3183.00;56
8311;53;625761904;8311;201;9257;9312;8.92;0.54;273.89;7.25;946;53;3184.00;55
8313;53;625761917;8313;210;9259;9312;8.92;0.54;273.94;7.25;946;53;3185.00;53
8315;53;625761930;8315;212;9263;9315;8.85;0.54;273.97;7.26;948;53;3186.00;52
8318;53;625761950;8318;219;9263;9315;8.88;0.54;274.07;7.26;945;53;3187.00;52
8320;53;625761963;8320;223;9264;9315;8.90;0.54;274.09;7.26;944;53;3188.00;51
8324;53;625761976;8324;230;9268;9319;8.83;0.54;274.11;7.25;944;53;3189.00;51
8327;53;625761989;8327;236;9271;9320;8.83;0.54;274.16;7.28;944;53;3190.00;49
8327;53;625762002;8327;241;9273;9322;8.83;0.54;274.16;7.28;946;53;3191.00;49
8330;53;625762015;8330;244;9276;9326;8.89;0.54;274.20;7.28;946;53;3192.00;50
8334;53;625762028;8334;251;9278;9326;8.88;0.54;274.24;7.30;944;53;3193.00;48
8338;53;625762041;8338;256;9278;9326;8.90;0.54;274.19;7.30;940;53;3194.00;48
8342;53;625762054;8342;256;9281;9328;8.91;0.54;274.24;7.31;939;53;3195.00;47
8344;53;625762067;8344;254;9283;9328;8.86;0.54;274.32;7.34;939;53;3196.00;45
8344;53;625762080;8344;252;9287;9334;8.84;0.54;274.32;7.34;943;53;3197.00;47
8349;53;625762093;8349;255;9289;9334;8.78;0.53;274.39;7.36;940;53;3198.00;45
8352;53;625762106;8352;258;9291;9335;8.69;0.53;274.41;7.37;939;53;3199.00;44
8354;53;625762119;8354;263;9291;9335;8.58;0.52;274.40;7.37;937;53;3200.00;44
8359;53;625762135;8359;260;9292;9335;8.45;0.51;274.42;7.38;933;53;3201.00;43
8360;53;625762152;8360;262;9293;9335;8.40;0.51;274.44;7.39;933;53;3202.00;42
8362;53;625762164;8362;258;9294;9335;8.37;0.51;274.51;7.40;932;53;3203.00;41
8365;53;625762176;8365;264;9304;9347;8.37;0.51;274.53;7.39;939;53;3204.00;43
8369;53;625762189;8369;268;9305;9347;8.30;0.51;274.67;7.40;936;53;3205.00;42
8372;53;625762201;8372;268;9308;9347;8.28;0.50;274.68;7.41;936;53;3206.00;39
8375;53;625762218;8375;271;9308;9347;8.23;0.50;274.65;7.41;933;53;3207.00;39
8377;53;625762230;8377;278;9310;9347;8.14;0.50;274.68;7.42;933;53;3208.00;37
8379;53;625762241;8379;283;9310;9347;8.09;0.49;274.67;7.42;931;53;3209.00;37
8380;53;625762260;8380;285;9314;9351;7.94;0.49;274.70;7.42;934;53;3210.00;37
8383;53;625762271;8383;281;9315;9351;7.90;0.48;274.77;7.43;932;53;3211.00;36
8385;53;625762282;8385;282;9318;9355;7.91;0.48;274.77;7.43;933;53;3212.00;37
8387;53;625762293;8387;285;9319;9356;7.86;0.48;274.78;7.43;932;53;3213.00;37
8390;53;625762304;8390;291;9323;9356;7.79;0.48;274.79;7.46;933;53;3214.00;33
8392;53;625762321;8392;288;9324;9356;7.77;0.48;274.83;7.47;932;53;3215.00;32
8397;53;625762332;8397;296;9336;9369;7.71;0.47;274.85;7.46;939;53;3216.00;33
8400;53;625762349;8400;295;9337;9369;7.71;0.47;274.83;7.47;937;53;3217.00;32
8403;53;625762360;8403;304;9337;9369;7.67;0.47;274.80;7.47;934;53;3218.00;32
8406;53;625762370;8406;309;9340;9370;7.61;0.46;274.77;7.48;934;53;3219.00;30
8411;53;625762386;8411;311;9340;9371;7.51;0.46;274.81;7.48;929;53;3220.00;31
8411;53;625762397;8411;315;9342;9371;7.47;0.46;274.81;7.49;931;53;3221.00;29
8413;53;625762408;8413;323;9344;9374;7.40;0.45;274.83;7.49;931;53;3222.00;30
8416;53;625762419;8416;324;9344;9374;7.32;0.45;274.84;7.49;928;53;3223.00;30
8420;53;625762429;8420;331;9346;9374;7.24;0.44;274.83;7.50;926;53;3224.00;28
8425;53;625762439;8425;327;9347;9374;7.21;0.44;274.91;7.50;922;53;3225.00;27
8431;53;625762449;8431;331;9352;9380;7.10;0.43;274.89;7.50;921;53;3226.00;28
8433;53;625762461;8433;334;9353;9380;6.99;0.43;274.91;7.50;920;53;3227.00;27
8438;53;625762471;8438;339;9354;9380;6.81;0.42;275.09;7.50;916;53;3228.00;26
8442;53;625762481;8442;343;9356;9380;6.60;0.40;275.07;7.51;914;53;3229.00;24
8444;53;625762490;8444;344;9359;9384;6.40;0.39;275.08;7.51;915;53;3230.00;25
8448;53;625762500;8448;348;9361;9385;6.24;0.38;275.07;7.52;913;53;3231.00;24
8452;53;625762510;8452;344;9362;9385;6.18;0.38;275.07;7.52;910;53;3232.00;23
8453;53;625762520;8453;343;9363;9386;6.15;0.38;275.08;7.52;910;53;3233.00;23
8458;53;625762534;8458;351;9365;9386;6.10;0.37;275.01;7.53;907;53;3234.00;21
8462;53;625762547;8462;354;9365;9386;6.07;0.37;274.92;7.53;903;53;3235.00;21
8467;53;625762562;8467;357;9366;9386;6.03;0.37;274.87;7.53;899;53;3236.00;20
8471;53;625762577;8471;356;9367;9386;5.99;0.37;274.84;7.53;896;53;3237.00;19
8474;53;625762596;8474;352;9367;9386;5.96;0.36;274.77;7.53;893;53;3238.00;19
8475;53;625762613;8475;349;9369;9386;5.93;0.36;274.79;7.53;894;53;3239.00;17
8478;53;625762631;8478;343;9420;9511;6.27;0.39;274.73;7.49;942;53;3240.00;91
8480;53;625762662;8480;352;9426;9512;6.30;0.39;274.79;7.49;946;53;3241.00;86
8482;53;625762674;8482;352;9438;9512;6.39;0.39;274.81;7.48;956;53;3242.00;74
8487;53;625762687;8487;346;9446;9512;6.33;0.39;274.77;7.48;959;53;3243.00;66
8489;53;625762700;8489;355;9450;9512;6.30;0.39;274.82;7.48;961;53;3244.00;62
8493;53;625762713;8493;359;9454;9512;6.24;0.38;274.76;7.48;961;53;3245.00;58
8495;53;625762725;8495;368;9458;9512;6.21;0.38;274.76;7.48;963;53;3246.00;54
8498;53;625762737;8498;369;9461;9512;6.19;0.38;274.74;7.48;963;53;3247.00;51
8502;53;625762751;8502;375;9465;9513;6.23;0.38;274.72;7.48;963;53;3248.00;48
8505;53;625762764;8505;378;9468;9514;6.25;0.38;274.72;7.47;963;53;3249.00;46
8507;53;625762778;8507;374;9470;9514;6.24;0.38;274.83;7.48;963;53;3250.00;44
8508;53;625762791;8508;378;9477;9518;6.25;0.38;274.87;7.47;969;53;3251.00;41
8511;53;625762805;8511;386;9478;9518;6.16;0.38;274.83;7.47;967;53;3252.00;40
8512;53;625762817;8512;394;9479;9518;6.13;0.38;274.84;7.48;967;53;3253.00;39
8514;53;625762830;8514;402;9479;9518;6.11;0.38;274.84;7.48;965;53;3254.00;39
8517;53;625762843;8517;407;9483;9524;6.05;0.37;274.85;7.47;966;53;3255.00;41
8519;53;625762856;8519;404;9484;9524;6.02;0.37;274.86;7.47;965;53;3256.00;40
8522;53;625762868;8522;408;9484;9524;5.98;0.37;274.85;7.47;962;53;3257.00;40
8526;53;625762882;8526;417;9486;9527;5.91;0.36;274.88;7.47;960;53;3258.00;41
8528;53;625762895;8528;400;9488;9527;5.88;0.36;274.93;7.51;960;53;3259.00;39
8532;53;625762909;8532;387;9488;9527;5.89;0.36;274.92;7.51;956;53;3260.00;39
8536;53;625762923;8536;379;9488;9528;5.90;0.36;274.86;7.51;952;53;3261.00;40
8541;53;625762936;8541;368;9489;9529;5.92;0.36;274.88;7.51;948;53;3262.00;40
8545;53;625762949;8545;362;9489;9529;5.97;0.37;274.92;7.51;944;53;3263.00;40
8548;53;625762963;8548;357;9500;9542;6.10;0.37;274.91;7.50;952;53;3264.00;42
8551;53;625762978;8551;356;9500;9542;6.17;0.38;274.94;7.50;949;53;3265.00;42
8551;53;625763004;8551;353;9500;9542;6.26;0.38;274.94;7.50;949;53;3266.00;42
8554;53;625763024;8554;347;9501;9543;6.36;0.39;274.95;7.50;947;53;3267.00;42
8556;53;625763037;8556;360;9501;9543;6.46;0.40;274.94;7.50;945;53;3268.00;42
8559;53;625763051;8559;357;9504;9547;6.55;0.40;274.88;7.50;945;53;3269.00;43
8561;53;625763068;8561;351;9504;9547;6.61;0.40;274.87;7.50;943;53;3270.00;43
8565;53;625763081;8565;352;9508;9551;6.69;0.41;274.82;7.49;943;53;3271.00;43
8566;53;625763096;8566;348;9508;9551;6.72;0.41;274.81;7.49;942;53;3272.00;43
8568;53;625763109;8568;349;9508;9551;6.73;0.41;274.84;7.49;940;53;3273.00;43
8571;53;625763123;8571;350;9509;9551;6.73;0.41;274.91;7.53;938;53;3274.00;42
8573;53;625763137;8573;352;9509;9551;6.76;0.41;274.89;7.53;936;53;3275.00;42
8574;53;625763151;8574;355;9519;9563;6.90;0.42;274.88;7.53;945;53;3276.00;44
8576;53;625763166;8576;349;9519;9563;6.98;0.43;274.87;7.53;943;53;3277.00;44
8577;53;625763180;8577;348;9520;9563;7.07;0.43;274.87;7.53;943;53;3278.00;43
8581;53;625763194;8581;349;9520;9563;7.11;0.43;274.91;7.53;939;53;3279.00;43
8585;53;625763209;8585;344;9520;9563;7.17;0.44;274.93;7.53;935;53;3280.00;43
8586;53;625763224;8586;340;9520;9563;7.22;0.44;274.97;7.53;934;53;3281.00;43
8588;53;625763238;8588;339;9521;9564;7.22;0.44;275.01;7.57;933;53;3282.00;43
8589;53;625763253;8589;342;9521;9564;7.28;0.44;275.01;7.57;932;53;3283.00;43
8591;53;625763267;8591;340;9525;9570;7.34;0.45;275.00;7.56;934;53;3284.00;45
8595;53;625763287;8595;351;9527;9572;7.33;0.45;275.03;7.56;932;53;3285.00;45
8598;53;625763302;8598;340;9528;9572;7.32;0.45;275.03;7.56;930;53;3286.00;44
8601;53;625763322;8601;328;9528;9572;7.34;0.45;275.05;7.56;927;53;3287.00;44
8605;53;625763337;8605;322;9531;9576;7.35;0.45;275.08;7.56;926;53;3288.00;45
8608;53;625763351;8608;314;9531;9576;7.39;0.45;275.23;7.56;923;53;3289.00;45
8611;53;625763365;8611;303;9531;9576;7.45;0.45;275.24;7.56;920;53;3290.00;45
8616;53;625763379;8616;302;9532;9577;7.53;0.46;275.30;7.56;916;53;3291.00;45
8617;53;625763396;8617;300;9535;9581;7.63;0.46;275.31;7.56;918;53;3292.00;46
8618;53;625763410;8618;302;9535;9581;7.75;0.47;275.32;7.56;917;53;3293.00;46
8624;53;625763425;8624;303;9537;9584;7.83;0.48;275.30;7.56;913;53;3294.00;47
8625;53;625763439;8625;303;9537;9584;7.89;0.48;275.29;7.56;912;53;3295.00;47
8628;53;625763454;8628;302;9538;9584;7.95;0.48;275.31;7.56;910;53;3296.00;46
8632;53;625763473;8632;300;9538;9584;7.92;0.48;275.38;7.56;906;53;3297.00;46
8632;53;625763490;8632;293;9541;9588;7.89;0.48;275.38;7.55;909;53;3298.00;47
8634;53;625763508;8634;294;9541;9588;7.81;0.47;275.44;7.55;907;53;3299.00;47
8637;53;625763527;8637;291;9545;9607;7.82;0.47;275.44;7.55;908;53;3300.00;62
8639;53;625763548;8639;289;9545;9607;7.78;0.47;275.48;7.55;906;53;3301.00;62
8641;53;625763563;8641;291;9546;9608;7.75;0.47;275.51;7.55;905;53;3302.00;62
8643;53;625763577;8643;290;9547;9609;7.75;0.47;275.52;7.55;904;53;3303.00;62
8646;53;625763591;8646;288;9547;9609;7.71;0.47;275.57;7.55;901;53;3304.00;62
8649;53;625763604;8649;292;9548;9610;7.73;0.47;275.60;7.55;899;53;3305.00;62
8651;53;625763617;8651;290;9549;9610;7.68;0.47;275.61;7.55;898;53;3306.00;61
8656;53;625763630;8656;295;9549;9610;7.63;0.46;275.60;7.55;893;53;3307.00;61
8659;53;625763645;8659;297;9551;9610;7.58;0.46;275.62;7.59;892;53;3308.00;59
8663;53;625763656;8663;295;9551;9610;7.55;0.46;275.60;7.59;888;53;3309.00;59
8668;53;625763669;8668;292;9551;9610;7.53;0.46;275.60;7.59;883;53;3310.00;59
8671;53;625763682;8671;301;9552;9610;7.53;0.46;275.71;7.59;881;53;3311.00;58
8673;53;625763695;8673;320;9620;9737;7.51;0.46;275.68;7.54;947;53;3312.00;117
8674;53;625763720;8674;310;9624;9738;7.50;0.46;275.71;7.54;950;53;3313.00;114
8675;53;625763733;8675;308;9629;9738;7.53;0.47;275.76;7.53;954;53;3314.00;109
8677;53;625763746;8677;306;9631;9738;7.55;0.47;275.76;7.53;954;53;3315.00;107
8679;53;625763765;8679;307;9634;9738;7.62;0.47;275.75;7.53;955;53;3316.00;104
8681;53;625763778;8681;303;9636;9738;7.64;0.47;275.78;7.53;955;53;3317.00;102
8683;53;625763795;8683;303;9639;9738;7.63;0.47;275.80;7.53;956;53;3318.00;99
8686;54;625763808;8686;306;9642;9738;7.60;0.47;275.85;7.53;956;54;3319.00;96
8688;54;625763838;8688;303;9646;9739;7.58;0.47;275.90;7.53;958;54;3320.00;93
8688;54;625763852;8688;302;9648;9740;7.54;0.46;275.90;7.53;960;54;3321.00;92
8693;54;625763865;8693;301;9650;9740;7.57;0.46;275.88;7.54;957;54;3322.00;90
8693;54;625763878;8693;292;9654;9741;7.60;0.47;275.88;7.54;961;54;3323.00;87
8697;54;625763891;8697;297;9657;9741;7.57;0.46;275.95;7.54;960;54;3324.00;84
8699;54;625763903;8699;297;9659;9741;7.57;0.46;275.97;7.58;960;54;3325.00;82
8702;54;625763917;8702;294;9661;9741;7.60;0.47;276.00;7.59;959;54;3326.00;80
8703;54;625763930;8703;297;9663;9745;7.58;0.46;276.02;7.59;960;54;3327.00;82
8707;54;625763943;8707;293;9664;9745;7.62;0.47;276.09;7.59;957;54;3328.00;81
8711;54;625763957;8711;288;9666;9745;7.62;0.46;276.09;7.59;955;54;3329.00;79
8711;54;625763973;8711;279;9669;9751;7.68;0.47;276.09;7.59;958;54;3330.00;82
8714;54;625763986;8714;284;9669;9751;7.62;0.46;276.10;7.59;955;54;3331.00;82
8721;54;625763998;8721;274;9670;9751;7.56;0.46;276.14;7.59;949;54;3332.00;81
8725;54;625764012;8725;273;9674;9755;7.52;0.46;276.20;7.59;949;54;3333.00;81
8725;54;625764026;8725;265;9675;9756;7.56;0.46;276.20;7.59;950;54;3334.00;81
8727;54;625764039;8727;267;9680;9756;7.54;0.46;276.20;7.61;953;54;3335.00;76
8732;54;625764053;8732;260;9683;9760;7.59;0.46;276.19;7.65;951;54;3336.00;77
8733;54;625764067;8733;250;9684;9760;7.68;0.47;276.19;7.65;951;54;3337.00;76
8737;54;625764079;8737;245;9685;9760;7.68;0.47;276.19;7.66;948;54;3338.00;75
8742;54;625764092;8742;250;9686;9761;7.72;0.47;276.17;7.65;944;54;3339.00;75
8743;54;625764106;8743;242;9687;9761;7.80;0.47;276.23;7.66;944;54;3340.00;74
8744;54;625764119;8744;242;9691;9767;7.87;0.48;276.23;7.66;947;54;3341.00;76
8746;54;625764133;8746;242;9692;9767;7.90;0.48;276.24;7.70;946;54;3342.00;75
8751;54;625764147;8751;230;9694;9768;7.89;0.48;276.34;7.70;943;54;3343.00;74
8754;54;625764161;8754;234;9695;9768;7.87;0.48;276.33;7.73;941;54;3344.00;73
8757;54;625764180;8757;237;9695;9768;7.83;0.47;276.38;7.73;938;54;3345.00;73
8757;54;625764194;8757;235;9696;9768;7.84;0.47;276.38;7.74;939;54;3346.00;72
8759;54;625764206;8759;234;9698;9768;7.85;0.48;276.37;7.77;939;54;3347.00;70
8761;54;625764221;8761;234;9709;9780;7.88;0.48;276.37;7.76;948;54;3348.00;71
8765;54;625764236;8765;232;9712;9780;7.84;0.48;276.55;7.77;947;54;3349.00;68
8768;54;625764250;8768;233;9712;9780;7.79;0.47;276.60;7.77;944;54;3350.00;68
8772;54;625764264;8772;238;9716;9780;7.74;0.47;276.55;7.81;944;54;3351.00;64
8773;54;625764278;8773;244;9718;9780;7.77;0.47;276.54;7.81;945;54;3352.00;62
8776;54;625764291;8776;242;9718;9780;7.82;0.47;276.59;7.81;942;54;3353.00;62
8778;54;625764304;8778;245;9723;9784;7.82;0.47;276.59;7.81;945;54;3354.00;61
8782;54;625764318;8782;244;9724;9784;7.85;0.48;276.63;7.81;942;54;3355.00;60
8786;54;625764331;8786;242;9728;9788;7.88;0.48;276.66;7.81;942;54;3356.00;60
8789;54;625764346;8789;239;9730;9789;7.98;0.48;276.70;7.81;941;54;3357.00;59
8794;54;625764360;8794;244;9731;9789;8.02;0.48;276.73;7.81;937;54;3358.00;58
8797;54;625764374;8797;254;9732;9789;8.00;0.48;276.71;7.81;935;54;3359.00;57
8799;54;625764390;8799;262;9751;9818;7.90;0.48;276.73;7.82;952;54;3360.00;67
8801;54;625764406;8801;259;9753;9818;7.88;0.48;276.77;7.82;952;54;3361.00;65
8804;54;625764420;8804;271;9757;9818;7.84;0.47;276.83;7.84;953;54;3362.00;61
8805;54;625764434;8805;282;9759;9819;7.82;0.47;276.84;7.84;954;54;3363.00;60
8805;54;625764447;8805;289;9761;9820;7.84;0.48;276.84;7.84;956;54;3364.00;59
8805;54;625764466;8805;292;9763;9820;7.79;0.47;276.84;7.86;958;54;3365.00;57
8806;54;625764480;8806;298;9767;9823;7.80;0.47;276.82;7.86;961;54;3366.00;56
8809;54;625764494;8809;303;9767;9823;7.77;0.47;276.83;7.86;958;54;3367.00;56
8812;54;625764507;8812;310;9769;9823;7.74;0.47;276.84;7.88;957;54;3368.00;54
8813;54;625764520;8813;317;9769;9823;7.68;0.47;276.86;7.88;956;54;3369.00;54
8817;54;625764538;8817;317;9775;9829;7.61;0.46;276.85;7.90;958;54;3370.00;54
8818;54;625764559;8818;322;9776;9829;7.54;0.46;276.87;7.90;958;54;3371.00;53
8820;54;625764581;8820;320;9776;9829;7.47;0.46;276.95;7.90;956;54;3372.00;53
8821;54;625764598;8821;322;9778;9829;7.43;0.45;276.93;7.92;957;54;3373.00;51
8823;54;625764618;8823;325;9782;9833;7.38;0.45;276.99;7.93;959;54;3374.00;51
8823;54;625764650;8823;338;9784;9835;7.33;0.45;276.99;7.93;961;54;3375.00;51
8826;54;625764665;8826;347;9786;9835;7.23;0.44;277.00;7.95;960;54;3376.00;49
8827;54;625764676;8827;350;9787;9836;7.16;0.44;276.98;7.95;960;54;3377.00;49
8830;54;625764688;8830;356;9787;9836;7.07;0.43;276.96;7.95;957;54;3378.00;49
8830;54;625764700;8830;350;9787;9836;6.99;0.43;276.96;7.95;957;54;3379.00;49
8832;54;625764713;8832;351;9789;9836;6.90;0.42;276.91;7.97;957;54;3380.00;47
8834;54;625764724;8834;355;9791;9836;6.84;0.42;276.87;7.98;957;54;3381.00;45
8835;54;625764736;8835;355;9791;9836;6.74;0.41;276.88;7.98;956;54;3382.00;45
8836;54;625764748;8836;355;9791;9836;6.67;0.41;276.85;7.98;955;54;3383.00;45
8840;54;625764759;8840;361;9829;9906;6.83;0.42;276.85;7.97;989;54;3384.00;77
8842;54;625764777;8842;360;9832;9907;6.79;0.42;276.81;7.97;990;54;3385.00;75
8844;54;625764789;8844;371;9842;9907;6.81;0.42;276.82;7.97;998;54;3386.00;65
8849;54;625764799;8849;372;9847;9907;6.73;0.41;276.75;7.97;998;54;3387.00;60
8852;54;625764811;8852;372;9850;9907;6.70;0.41;276.69;7.97;998;54;3388.00;57
8853;54;625764822;8853;375;9857;9907;6.69;0.41;276.68;8.00;1004;54;3389.00;50
8856;54;625764834;8856;377;9861;9907;6.64;0.41;276.65;8.00;1005;54;3390.00;46
8856;55;625764846;8856;388;9865;9907;6.60;0.40;276.65;8.01;1009;55;3391.00;42
8862;55;625764864;8862;388;9868;9908;6.53;0.40;276.58;8.01;1006;55;3392.00;40
8864;55;625764881;8864;394;9870;9909;6.45;0.40;276.58;8.01;1006;55;3393.00;39
8868;55;625764893;8868;396;9872;9909;6.34;0.39;276.62;8.02;1004;55;3394.00;37
8873;55;625764904;8873;402;9875;9913;6.19;0.38;276.56;8.02;1002;55;3395.00;38
8875;55;625764917;8875;407;9876;9913;6.04;0.37;276.54;8.03;1001;55;3396.00;37
8879;55;625764929;8879;420;9877;9913;5.89;0.36;276.51;8.03;998;55;3397.00;36
8881;55;625764940;8881;433;9878;9913;5.71;0.35;276.50;8.03;997;55;3398.00;35
8883;55;625764950;8883;436;9882;9919;5.59;0.34;276.50;8.03;999;55;3399.00;37
8888;55;625764963;8888;434;9882;9919;5.53;0.34;276.51;8.03;994;55;3400.00;37
8891;55;625764979;8891;429;9885;9919;5.47;0.33;276.53;8.04;994;55;3401.00;34
8893;55;625764990;8893;439;9887;9922;5.45;0.33;276.55;8.04;994;55;3402.00;35
8897;55;625765001;8897;441;9888;9922;5.36;0.33;276.52;8.04;991;55;3403.00;34
8900;55;625765011;8900;442;9888;9922;5.29;0.32;276.50;8.04;988;55;3404.00;34
8905;55;625765021;8905;451;9889;9923;5.28;0.32;276.46;8.04;984;55;3405.00;34
8907;55;625765032;8907;456;9890;9924;5.28;0.32;276.47;8.04;983;55;3406.00;34
8908;55;625765043;8908;452;9890;9924;5.28;0.32;276.48;8.04;982;55;3407.00;34
8910;55;625765053;8910;452;9903;9937;5.34;0.33;276.51;8.04;993;55;3408.00;34
8911;55;625765065;8911;449;9903;9937;5.35;0.33;276.52;8.04;992;55;3409.00;34
8914;55;625765076;8914;443;9904;9937;5.38;0.33;276.51;8.04;990;55;3410.00;33
8918;55;625765087;8918;433;9905;9938;5.43;0.33;276.45;8.04;987;55;3411.00;33
8921;55;625765098;8921;408;9906;9938;5.52;0.34;276.45;8.07;985;55;3412.00;32
8924;55;625765110;8924;399;9909;9942;5.65;0.34;276.41;8.07;985;55;3413.00;33
8925;55;625765121;8925;400;9910;9942;5.70;0.35;276.43;8.07;985;55;3414.00;32
8928;55;625765132;8928;391;9913;9946;5.78;0.35;276.42;8.07;985;55;3415.00;33
8932;55;625765145;8932;385;9913;9946;5.80;0.35;276.40;8.07;981;55;3416.00;33
8937;55;625765156;8937;377;9913;9946;5.82;0.36;276.42;8.07;976;55;3417.00;33
8940;55;625765174;8940;367;9913;9946;5.88;0.36;276.49;8.07;973;55;3418.00;33
8943;55;625765186;8943;366;9913;9946;5.93;0.36;276.47;8.07;970;55;3419.00;33
8945;55;625765199;8945;364;9939;9980;6.14;0.38;276.46;8.05;994;55;3420.00;41
8950;55;625765214;8950;357;9940;9980;6.21;0.38;276.49;8.05;990;55;3421.00;40
8951;55;625765227;8951;357;9942;9980;6.32;0.39;276.49;8.04;991;55;3422.00;38
8953;55;625765238;8953;357;9942;9980;6.38;0.39;276.47;8.04;989;55;3423.00;38
8957;55;625765252;8957;352;9942;9980;6.39;0.39;276.44;8.04;985;55;3424.00;38
8959;55;625765264;8959;350;9942;9980;6.45;0.39;276.43;8.04;983;55;3425.00;38
8960;55;625765277;8960;341;9942;9981;6.54;0.40;276.43;8.04;982;55;3426.00;39
8961;55;625765289;8961;339;9942;9981;6.59;0.40;276.51;8.04;981;55;3427.00;39
8963;55;625765301;8963;340;9946;9987;6.70;0.41;276.50;8.04;983;55;3428.00;41
8965;55;625765314;8965;341;9948;9988;6.79;0.42;276.50;8.04;983;55;3429.00;40
8966;55;625765326;8966;338;9948;9988;6.86;0.42;276.50;8.04;982;55;3430.00;40
8970;55;625765338;8970;337;9948;9988;6.87;0.42;276.50;8.04;978;55;3431.00;40
8975;55;625765352;8975;334;9951;9992;6.88;0.42;276.53;8.04;976;55;3432.00;41
8981;55;625765365;8981;340;9951;9992;6.87;0.42;276.55;8.04;970;55;3433.00;41
8985;55;625765378;8985;337;9951;9992;6.88;0.42;276.61;8.04;966;55;3434.00;41
8987;55;625765390;8987;342;9952;9993;6.85;0.42;276.58;8.04;965;55;3435.00;41
8989;55;625765403;8989;346;9955;9997;6.87;0.42;276.63;8.03;966;55;3436.00;42
8993;55;625765416;8993;342;9955;9997;6.85;0.42;276.68;8.03;962;55;3437.00;42
8997;55;625765434;8997;339;9957;10000;6.85;0.42;276.69;8.03;960;55;3438.00;43
8998;55;625765447;8998;334;9958;10000;6.87;0.42;276.74;8.03;960;55;3439.00;42
9003;55;625765459;9003;332;9959;10000;6.89;0.42;276.82;8.07;956;55;3440.00;41
9007;55;625765472;9007;333;9959;10000;6.92;0.42;276.93;8.07;952;55;3441.00;41
9013;55;625765485;9013;331;9962;10004;6.96;0.43;276.94;8.06;949;55;3442.00;42
9019;55;625765499;9019;328;9962;10004;6.93;0.42;277.04;8.06;943;55;3443.00;42
9023;55;625765511;9023;329;9963;10004;6.89;0.42;277.06;8.06;940;55;3444.00;41
9026;55;625765524;9026;332;9963;10004;6.83;0.42;277.08;8.06;937;55;3445.00;41
9029;55;625765537;9029;331;9963;10005;6.82;0.42;277.15;8.06;934;55;3446.00;42
9033;55;625765551;9033;321;9964;10006;6.82;0.42;277.17;8.06;931;55;3447.00;42
9038;55;625765564;9038;316;9964;10006;6.78;0.42;277.23;8.06;926;55;3448.00;42
9041;55;625765577;9041;308;9965;10007;6.80;0.42;277.26;8.06;924;55;3449.00;42
9044;55;625765591;9044;303;9965;10007;6.83;0.42;277.31;8.06;921;55;3450.00;42
9047;55;625765604;9047;294;9965;10007;6.86;0.42;277.40;8.06;918;55;3451.00;42
9050;55;625765616;9050;288;9965;10007;6.93;0.42;277.45;8.06;915;55;3452.00;42
9055;55;625765628;9055;287;9965;10007;6.97;0.43;277.48;8.06;910;55;3453.00;42
9058;55;625765641;9058;290;9965;10007;7.04;0.43;277.51;8.06;907;55;3454.00;42
9062;55;625765653;9062;291;9966;10007;7.09;0.43;277.57;8.10;904;55;3455.00;41
9065;55;625765666;9065;303;10038;10134;7.38;0.46;277.58;8.04;973;55;3456.00;96
9068;55;625765707;9068;276;10040;10135;7.46;0.46;277.65;8.04;972;55;3457.00;95
9071;55;625765720;9071;256;10048;10135;7.66;0.47;277.71;8.03;977;55;3458.00;87
9074;55;625765738;9074;248;10051;10135;7.79;0.48;277.76;8.03;977;55;3459.00;84
9077;55;625765751;9077;240;10054;10135;7.90;0.49;277.87;8.03;977;55;3460.00;81
9079;55;625765769;9079;235;10056;10135;7.98;0.49;277.89;8.03;977;55;3461.00;79
9081;55;625765783;9081;234;10058;10135;8.03;0.50;277.92;8.03;977;55;3462.00;77
9089;55;625765801;9089;237;10059;10135;8.03;0.49;278.02;8.03;970;55;3463.00;76
9091;55;625765815;9091;239;10062;10136;8.06;0.50;278.07;8.03;971;55;3464.00;74
9095;55;625765830;9095;240;10068;10138;8.04;0.49;278.14;8.06;973;55;3465.00;70
9096;55;625765844;9096;258;10070;10138;8.02;0.49;278.18;8.06;974;55;3466.00;68
9101;55;625765857;9101;267;10074;10139;7.95;0.49;278.25;8.06;973;55;3467.00;65
9106;55;625765873;9106;269;10076;10139;7.87;0.48;278.25;8.06;970;55;3468.00;63
9108;55;625765887;9108;268;10079;10139;7.89;0.48;278.28;8.06;971;55;3469.00;60
9112;55;625765901;9112;271;10082;10139;7.85;0.48;278.28;8.07;970;55;3470.00;57
9115;55;625765914;9115;272;10086;10143;7.79;0.48;278.31;8.07;971;55;3471.00;57
9117;55;625765930;9117;276;10088;10143;7.78;0.48;278.32;8.07;971;55;3472.00;55
9120;55;625765944;9120;270;10089;10143;7.77;0.47;278.34;8.07;969;55;3473.00;54
9121;55;625765957;9121;268;10091;10146;7.75;0.47;278.31;8.07;970;55;3474.00;55
9123;55;625765970;9123;264;10092;10146;7.71;0.47;278.30;8.07;969;55;3475.00;54
9126;55;625765982;9126;264;10093;10146;7.73;0.47;278.38;8.07;967;55;3476.00;53
9127;55;625765995;9127;265;10096;10150;7.76;0.47;278.41;8.06;969;55;3477.00;54
9127;55;625766009;9127;267;10098;10151;7.78;0.48;278.41;8.06;971;55;3478.00;53
9131;55;625766022;9131;262;10098;10151;7.76;0.47;278.42;8.06;967;55;3479.00;53
9132;55;625766037;9132;265;10103;10156;7.81;0.48;278.40;8.06;971;55;3480.00;53
9134;55;625766049;9134;266;10103;10156;7.78;0.48;278.38;8.06;969;55;3481.00;53
9136;55;625766062;9136;272;10103;10156;7.77;0.47;278.39;8.06;967;55;3482.00;53
9137;55;625766074;9137;274;10104;10157;7.78;0.47;278.39;8.06;967;55;3483.00;53
9137;55;625766087;9137;278;10104;10157;7.75;0.47;278.39;8.06;967;55;3484.00;53
9138;55;625766106;9138;287;10108;10163;7.74;0.47;278.38;8.06;970;55;3485.00;55
9141;55;625766119;9141;288;10108;10163;7.70;0.47;278.38;8.06;967;55;3486.00;55
9143;55;625766132;9143;286;10109;10164;7.71;0.47;278.36;8.06;966;55;3487.00;55
9145;56;625766145;9145;278;10109;10164;7.67;0.47;278.36;8.06;964;56;3488.00;55
9145;56;625766171;9145;282;10109;10164;7.66;0.47;278.36;8.06;964;56;3489.00;55
9148;56;625766184;9148;278;10109;10164;7.62;0.46;278.34;8.06;961;56;3490.00;55
9149;56;625766197;9149;276;10109;10164;7.68;0.47;278.38;8.06;960;56;3491.00;55
9151;56;625766209;9151;266;10118;10176;7.72;0.47;278.37;8.05;967;56;3492.00;58
9152;56;625766222;9152;263;10119;10176;7.77;0.47;278.36;8.05;967;56;3493.00;57
9155;56;625766235;9155;255;10120;10176;7.80;0.47;278.37;8.05;965;56;3494.00;56
9157;56;625766248;9157;248;10120;10176;7.86;0.48;278.34;8.05;963;56;3495.00;56
9162;56;625766260;9162;249;10120;10176;7.86;0.48;278.36;8.05;958;56;3496.00;56
9164;56;625766272;9164;244;10120;10176;7.88;0.48;278.37;8.05;956;56;3497.00;56
9165;56;625766284;9165;239;10123;10180;7.91;0.48;278.36;8.05;958;56;3498.00;57
9168;56;625766296;9168;240;10123;10180;7.93;0.48;278.44;8.05;955;56;3499.00;57
9171;56;625766309;9171;235;10126;10184;7.87;0.48;278.45;8.04;955;56;3500.00;58
9174;56;625766329;9174;231;10129;10185;7.77;0.47;278.48;8.07;955;56;3501.00;56
9181;56;625766343;9181;217;10129;10185;7.64;0.46;278.45;8.07;948;56;3502.00;56
9184;56;625766356;9184;226;10129;10185;7.53;0.46;278.49;8.07;945;56;3503.00;56
9188;56;625766369;9188;227;10139;10198;7.46;0.45;278.57;8.07;951;56;3504.00;59
9192;56;625766388;9192;222;10140;10198;7.45;0.45;278.59;8.08;948;56;3505.00;58
9194;56;625766402;9194;211;10140;10198;7.47;0.45;278.61;8.08;946;56;3506.00;58
9197;56;625766415;9197;220;10141;10199;7.53;0.46;278.65;8.08;944;56;3507.00;58
9201;56;625766427;9201;219;10141;10200;7.56;0.46;278.71;8.08;940;56;3508.00;59
9205;56;625766438;9205;207;10141;10200;7.56;0.46;278.74;8.08;936;56;3509.00;59
9208;56;625766451;9208;205;10144;10206;7.61;0.46;278.75;8.08;936;56;3510.00;62
9213;56;625766463;9213;210;10145;10206;7.59;0.46;278.75;8.08;932;56;3511.00;61
9214;56;625766475;9214;199;10146;10206;7.61;0.46;278.78;8.07;932;56;3512.00;60
9216;56;625766486;9216;199;10146;10206;7.62;0.46;278.88;8.07;930;56;3513.00;60
9220;56;625766497;9220;192;10150;10212;7.65;0.46;278.96;8.07;930;56;3514.00;62
9223;56;625766510;9223;193;10151;10212;7.62;0.46;279.02;8.11;928;56;3515.00;61
9229;56;625766526;9229;194;10152;10212;7.56;0.46;279.04;8.11;923;56;3516.00;60
9229;56;625766550;9229;196;10153;10212;7.51;0.46;279.04;8.11;924;56;3517.00;59
9232;56;625766570;9232;197;10157;10216;7.46;0.45;279.07;8.10;925;56;3518.00;59
9234;56;625766588;9234;206;10159;10219;7.47;0.45;279.07;8.10;925;56;3519.00;60
9236;56;625766607;9236;208;10160;10219;7.43;0.45;279.08;8.10;924;56;3520.00;59
9238;56;625766625;9238;211;10161;10220;7.40;0.45;279.12;8.10;923;56;3521.00;59
9240;56;625766644;9240;213;10162;10220;7.38;0.45;279.15;8.11;922;56;3522.00;58
9242;56;625766658;9242;214;10162;10220;7.33;0.45;279.15;8.11;920;56;3523.00;58
9244;56;625766672;9244;215;10162;10220;7.32;0.44;279.19;8.11;918;56;3524.00;58
9245;56;625766687;9245;210;10162;10220;7.33;0.45;279.18;8.11;917;56;3525.00;58
9246;56;625766700;9246;215;10163;10220;7.34;0.45;279.24;8.12;917;56;3526.00;57
9252;56;625766713;9252;218;10163;10220;7.34;0.45;279.21;8.12;911;56;3527.00;57
9254;56;625766728;9254;227;10198;10290;7.55;0.46;279.24;8.09;944;56;3528.00;92
9255;56;625766748;9255;230;10199;10291;7.40;0.45;279.32;8.10;944;56;3529.00;92
9257;56;625766763;9257;231;10209;10291;7.40;0.45;279.33;8.11;952;56;3530.00;82
9258;56;625766776;9258;231;10214;10291;7.35;0.45;279.32;8.11;956;56;3531.00;77
9262;56;625766789;9262;240;10219;10291;7.32;0.45;279.34;8.11;957;56;3532.00;72
9262;56;625766808;9262;246;10222;10291;7.30;0.45;279.34;8.13;960;56;3533.00;69
9265;56;625766822;9265;250;10227;10291;7.22;0.44;279.42;8.13;962;56;3534.00;64
9269;56;625766837;9269;252;10228;10291;7.13;0.43;279.39;8.14;959;56;3535.00;63
9273;56;625766850;9273;257;10233;10292;7.07;0.43;279.30;8.15;960;56;3536.00;59
9275;56;625766863;9275;269;10237;10293;7.05;0.43;279.36;8.16;962;56;3537.00;56
9275;56;625766879;9275;275;10240;10293;7.05;0.43;279.36;8.18;965;56;3538.00;53
9279;56;625766892;9279;279;10243;10297;6.95;0.42;279.30;8.18;964;56;3539.00;54
9279;56;625766908;9279;284;10244;10297;6.90;0.42;279.30;8.19;965;56;3540.00;53
9279;56;625766921;9279;285;10245;10297;6.77;0.41;279.30;8.19;966;56;3541.00;52
9279;56;625766933;9279;292;10246;10297;6.68;0.41;279.30;8.21;967;56;3542.00;51
9281;56;625766946;9281;293;10252;10303;6.64;0.41;279.32;8.22;971;56;3543.00;51
9281;56;625766960;9281;302;10252;10303;6.58;0.40;279.32;8.22;971;56;3544.00;51
9283;56;625766973;9283;308;10254;10303;6.58;0.40;279.32;8.23;971;56;3545.00;49
9285;56;625766986;9285;319;10256;10306;6.57;0.40;279.29;8.23;971;56;3546.00;50
9286;56;625767004;9286;319;10258;10306;6.54;0.40;279.29;8.23;972;56;3547.00;48
9289;56;625767016;9289;324;10259;10306;6.39;0.39;279.23;8.24;970;56;3548.00;47
9291;56;625767029;9291;327;10260;10307;6.24;0.38;279.21;8.24;969;56;3549.00;47
9293;56;625767042;9293;333;10261;10308;6.13;0.37;279.16;8.24;968;56;3550.00;47
9294;56;625767054;9294;334;10262;10308;6.08;0.37;279.17;8.26;968;56;3551.00;46
9294;56;625767066;9294;332;10274;10321;6.08;0.37;279.17;8.25;980;56;3552.00;47
9296;56;625767079;9296;337;10274;10321;6.07;0.37;279.11;8.25;978;56;3553.00;47
9297;56;625767092;9297;341;10276;10321;6.06;0.37;279.09;8.26;979;56;3554.00;45
9299;56;625767103;9299;346;10279;10323;6.06;0.37;279.03;8.27;980;56;3555.00;44
9301;56;625767114;9301;355;10279;10323;6.07;0.37;279.02;8.27;978;56;3556.00;44
9304;56;625767126;9304;356;10283;10327;6.08;0.37;279.02;8.27;979;56;3557.00;44
9306;56;625767139;9306;363;10284;10327;6.07;0.37;278.99;8.27;978;56;3558.00;43
9308;56;625767151;9308;371;10287;10331;6.10;0.37;278.97;8.27;979;56;3559.00;44
9310;56;625767162;9310;368;10290;10331;6.05;0.37;279.04;8.30;980;56;3560.00;41
9312;56;625767174;9312;370;10290;10331;5.92;0.36;279.02;8.30;978;56;3561.00;41
9317;56;625767192;9317;370;10291;10331;5.75;0.35;278.96;8.31;974;56;3562.00;40
9318;56;625767204;9318;361;10291;10331;5.67;0.34;278.95;8.31;973;56;3563.00;40
9320;56;625767215;9320;354;10301;10343;5.65;0.34;278.93;8.30;981;56;3564.00;42
9323;56;625767229;9323;353;10304;10343;5.58;0.34;278.91;8.33;981;56;3565.00;39
9324;56;625767241;9324;354;10305;10343;5.52;0.34;278.90;8.33;981;56;3566.00;38
9327;56;625767253;9327;355;10305;10343;5.49;0.34;278.88;8.33;978;56;3567.00;38
9330;56;625767264;9330;354;10306;10343;5.43;0.33;278.85;8.33;976;56;3568.00;37
9332;56;625767276;9332;350;10309;10343;5.36;0.33;278.86;8.35;977;56;3569.00;34
9332;56;625767294;9332;339;10309;10344;5.39;0.33;278.86;8.35;977;56;3570.00;35
9336;56;625767305;9336;327;10310;10344;5.37;0.33;278.86;8.36;974;56;3571.00;34
9340;56;625767323;9340;321;10315;10350;5.43;0.33;278.87;8.36;975;56;3572.00;35
9342;56;625767335;9342;319;10318;10351;5.53;0.34;278.83;8.36;976;56;3573.00;33
9344;56;625767348;9344;322;10318;10351;5.61;0.34;278.87;8.36;974;56;3574.00;33
9346;56;625767360;9346;319;10318;10351;5.67;0.35;278.88;8.36;972;56;3575.00;33
9347;56;625767372;9347;315;10323;10355;5.76;0.35;278.90;8.37;976;56;3576.00;32
9349;56;625767384;9349;316;10323;10355;5.81;0.35;278.94;8.37;974;56;3577.00;32
9352;56;625767403;9352;305;10323;10355;5.86;0.36;278.89;8.37;971;56;3578.00;32
9353;56;625767416;9353;309;10326;10356;5.92;0.36;278.87;8.37;973;56;3579.00;30
9355;56;625767428;9355;305;10329;10360;6.00;0.37;278.87;8.37;974;56;3580.00;31
9355;56;625767441;9355;305;10329;10360;6.11;0.37;278.87;8.37;974;56;3581.00;31
9356;56;625767454;9356;296;10332;10363;6.21;0.38;278.88;8.40;976;56;3582.00;31
9358;56;625767466;9358;290;10333;10363;6.35;0.39;278.87;8.40;975;56;3583.00;30
9364;56;625767480;9364;291;10333;10363;6.37;0.39;278.99;8.40;969;56;3584.00;30
9364;56;625767494;9364;290;10333;10363;6.45;0.39;278.99;8.40;969;56;3585.00;30
9368;56;625767506;9368;288;10336;10367;6.55;0.40;279.07;8.40;968;56;3586.00;31
9373;56;625767520;9373;285;10336;10367;6.61;0.40;279.14;8.40;963;56;3587.00;31
9378;56;625767534;9378;287;10337;10367;6.66;0.40;279.15;8.40;959;56;3588.00;30
9384;56;625767547;9384;288;10337;10367;6.68;0.41;279.19;8.40;953;56;3589.00;30
9390;56;625767562;9390;288;10337;10368;6.70;0.41;279.21;8.40;947;56;3590.00;31
9391;56;625767576;9391;289;10338;10369;6.77;0.41;279.22;8.40;947;56;3591.00;31
9397;56;625767590;9397;288;10338;10369;6.74;0.41;279.22;8.40;941;56;3592.00;31
9399;56;625767603;9399;291;10339;10370;6.77;0.41;279.24;8.40;940;56;3593.00;31
9403;56;625767617;9403;297;10339;10370;6.79;0.41;279.23;8.40;936;56;3594.00;31
9407;56;625767631;9407;289;10339;10370;6.82;0.42;279.27;8.40;932;56;3595.00;31
9411;56;625767647;9411;298;10339;10370;6.89;0.42;279.34;8.40;928;56;3596.00;31
9416;56;625767659;9416;300;10339;10370;6.90;0.42;279.41;8.40;923;56;3597.00;31
9418;56;625767671;9418;292;10339;10370;6.98;0.43;279.44;8.40;921;56;3598.00;31
9422;56;625767683;9422;289;10339;10370;7.04;0.43;279.42;8.40;917;56;3599.00;31
9426;56;625767698;9426;321;10449;10623;7.39;0.46;279.43;8.31;1023;56;3600.00;174
9430;56;625767733;9430;317;10455;10624;7.40;0.46;279.42;8.34;1025;56;3601.00;169
9434;56;625767748;9434;304;10470;10624;7.55;0.47;279.41;8.33;1036;56;3602.00;154
9437;56;625767761;9437;293;10477;10624;7.62;0.48;279.44;8.33;1040;56;3603.00;147
9444;56;625767774;9444;291;10484;10624;7.67;0.48;279.47;8.32;1040;56;3604.00;140
9450;56;625767794;9450;294;10492;10624;7.66;0.48;279.51;8.32;1042;56;3605.00;132
9456;56;625767808;9456;289;10499;10624;7.62;0.48;279.54;8.32;1043;56;3606.00;125
9459;56;625767822;9459;293;10503;10624;7.65;0.48;279.56;8.32;1044;56;3607.00;121
9463;56;625767840;9463;291;10510;10625;7.63;0.47;279.54;8.32;1047;56;3608.00;115
9465;56;625767860;9465;301;10514;10626;7.58;0.47;279.57;8.32;1049;56;3609.00;112
9466;56;625767874;9466;309;10518;10626;7.53;0.47;279.58;8.32;1052;56;3610.00;108
9471;56;625767897;9471;314;10522;10627;7.44;0.46;279.57;8.32;1051;56;3611.00;105
9473;56;625767911;9473;318;10524;10627;7.43;0.46;279.63;8.32;1051;56;3612.00;103
9477;56;625767925;9477;324;10527;10627;7.39;0.46;279.72;8.32;1050;56;3613.00;100
9480;56;625767939;9480;330;10529;10627;7.35;0.46;279.73;8.32;1049;56;3614.00;98
9483;56;625767953;9483;335;10535;10631;7.28;0.45;279.77;8.36;1052;56;3615.00;96
9488;56;625767967;9488;340;10535;10631;7.20;0.45;279.82;8.36;1047;56;3616.00;96
9492;56;625767981;9492;341;10538;10631;7.12;0.44;279.83;8.36;1046;56;3617.00;93
9495;56;625767995;9495;343;10541;10634;7.12;0.44;279.89;8.36;1046;56;3618.00;93
9501;56;625768010;9501;338;10542;10634;7.13;0.44;279.94;8.36;1041;56;3619.00;92
9503;56;625768024;9503;338;10544;10634;7.16;0.44;280.01;8.40;1041;56;3620.00;90
9506;56;625768038;9506;344;10551;10638;7.17;0.44;279.99;8.40;1045;56;3621.00;87
9512;56;625768052;9512;341;10555;10639;7.16;0.44;280.01;8.41;1043;56;3622.00;84
9516;56;625768067;9516;342;10556;10639;7.16;0.44;280.10;8.41;1040;56;3623.00;83
9520;56;625768081;9520;346;10557;10643;7.19;0.44;280.12;8.41;1037;56;3624.00;86
9523;56;625768095;9523;349;10558;10643;7.24;0.44;280.27;8.41;1035;56;3625.00;85
9527;56;625768110;9527;340;10560;10643;7.25;0.44;280.33;8.41;1033;56;3626.00;83
9530;56;625768124;9530;327;10563;10644;7.31;0.45;280.43;8.41;1033;56;3627.00;81
9532;56;625768138;9532;316;10563;10644;7.34;0.45;280.46;8.41;1031;56;3628.00;81
9536;56;625768153;9536;309;10568;10650;7.37;0.45;280.58;8.41;1032;56;3629.00;82
9541;56;625768171;9541;301;10570;10650;7.38;0.45;280.58;8.41;1029;56;3630.00;80
9546;56;625768186;9546;294;10570;10651;7.44;0.45;280.69;8.41;1024;56;3631.00;81
9547;56;625768202;9547;298;10571;10651;7.55;0.46;280.68;8.41;1024;56;3632.00;80
9551;56;625768218;9551;303;10573;10651;7.57;0.46;280.74;8.42;1022;56;3633.00;78
9552;56;625768234;9552;303;10575;10651;7.58;0.46;280.77;8.45;1023;56;3634.00;76
9554;56;625768249;9554;301;10576;10651;7.55;0.46;280.84;8.45;1022;56;3635.00;75
9555;56;625768265;9555;301;10585;10663;7.52;0.46;280.87;8.45;1030;56;3636.00;78
9558;56;625768281;9558;300;10585;10663;7.54;0.46;280.94;8.45;1027;56;3637.00;78
9561;56;625768302;9561;299;10587;10663;7.53;0.46;280.94;8.48;1026;56;3638.00;76
9563;56;625768317;9563;292;10588;10663;7.51;0.46;280.92;8.49;1025;56;3639.00;75
9566;56;625768333;9566;286;10588;10663;7.48;0.46;281.03;8.49;1022;56;3640.00;75
9567;56;625768349;9567;293;10589;10663;7.47;0.45;281.02;8.49;1022;56;3641.00;74
9570;56;625768363;9570;300;10592;10667;7.45;0.45;281.07;8.48;1022;56;3642.00;75
9573;56;625768377;9573;291;10592;10667;7.45;0.45;281.06;8.48;1019;56;3643.00;75
9573;56;625768393;9573;298;10597;10671;7.48;0.46;281.06;8.49;1024;56;3644.00;74
9575;56;625768408;9575;298;10601;10673;7.47;0.45;281.05;8.52;1026;56;3645.00;72
9577;57;625768422;9577;303;10601;10673;7.50;0.46;281.05;8.52;1024;57;3646.00;72
9580;57;625768453;9580;298;10601;10673;7.49;0.46;281.07;8.52;1021;57;3647.00;72
9585;57;625768467;9585;296;10610;10686;7.49;0.46;281.27;8.51;1025;57;3648.00;76
9587;57;625768483;9587;296;10610;10686;7.53;0.46;281.26;8.51;1023;57;3649.00;76
9588;57;625768497;9588;294;10610;10686;7.54;0.46;281.25;8.51;1022;57;3650.00;76
9590;57;625768511;9590;302;10611;10687;7.49;0.46;281.29;8.51;1021;57;3651.00;76
9592;57;625768525;9592;305;10611;10688;7.45;0.45;281.33;8.51;1019;57;3652.00;77
9593;57;625768543;9593;310;10611;10688;7.40;0.45;281.33;8.51;1018;57;3653.00;77
9594;57;625768569;9594;311;10613;10691;7.34;0.45;281.30;8.51;1019;57;3654.00;78
9596;57;625768589;9596;321;10613;10691;7.25;0.44;281.36;8.51;1017;57;3655.00;78
9597;57;625768609;9597;313;10614;10691;7.22;0.44;281.36;8.51;1017;57;3656.00;77
9599;57;625768629;9599;308;10614;10691;7.16;0.44;281.42;8.51;1015;57;3657.00;77
9604;57;625768651;9604;310;10618;10697;7.13;0.43;281.46;8.51;1014;57;3658.00;79
9606;57;625768668;9606;304;10618;10697;7.09;0.43;281.42;8.51;1012;57;3659.00;79
9608;57;625768686;9608;308;10619;10697;7.07;0.43;281.41;8.51;1011;57;3660.00;78
9608;57;625768702;9608;304;10619;10697;7.04;0.43;281.41;8.51;1011;57;3661.00;78
9609;57;625768715;9609;307;10623;10701;6.96;0.42;281.40;8.54;1014;57;3662.00;78
9610;57;625768731;9610;304;10624;10702;6.94;0.42;281.42;8.54;1014;57;3663.00;78
9613;57;625768745;9613;297;10624;10702;6.92;0.42;281.38;8.54;1011;57;3664.00;78
9615;57;625768759;9615;302;10625;10703;6.85;0.42;281.39;8.54;1010;57;3665.00;78
9620;57;625768774;9620;298;10625;10703;6.81;0.42;281.44;8.54;1005;57;3666.00;78
9622;57;625768788;9622;300;10625;10703;6.79;0.41;281.47;8.54;1003;57;3667.00;78
9623;58;625768808;9623;297;10626;10703;6.76;0.41;281.46;8.55;1003;58;3668.00;77
9626;58;625768837;9626;298;10626;10703;6.69;0.41;281.49;8.55;1000;58;3669.00;77
9628;58;625768850;9628;297;10627;10703;6.67;0.41;281.53;8.59;999;58;3670.00;76
9630;58;625768863;9630;295;10627;10703;6.62;0.40;281.60;8.59;997;58;3671.00;76
9636;58;625768876;9636;293;10657;10773;6.57;0.40;281.67;8.60;1021;58;3672.00;116
9637;58;625768895;9637;285;10659;10774;6.51;0.40;281.68;8.60;1022;58;3673.00;115
9640;58;625768912;9640;277;10666;10774;6.51;0.40;281.69;8.61;1026;58;3674.00;108
9643;58;625768927;9643;273;10673;10774;6.53;0.40;281.69;8.67;1030;58;3675.00;101
9646;58;625768943;9646;262;10679;10774;6.55;0.40;281.69;8.66;1033;58;3676.00;95
9648;58;625768957;9648;259;10681;10774;6.54;0.40;281.71;8.66;1033;58;3677.00;93
9652;58;625768970;9652;260;10687;10774;6.61;0.40;281.65;8.70;1035;58;3678.00;87
9654;58;625768983;9654;261;10687;10774;6.64;0.40;281.61;8.70;1033;58;3679.00;87
9655;58;625769003;9655;256;10689;10775;6.72;0.41;281.59;8.70;1034;58;3680.00;86
9657;58;625769017;9657;251;10691;10776;6.72;0.41;281.55;8.74;1034;58;3681.00;85
9658;58;625769032;9658;251;10692;10776;6.72;0.41;281.56;8.74;1034;58;3682.00;84
9659;58;625769046;9659;239;10695;10780;6.72;0.41;281.56;8.74;1036;58;3683.00;85
9663;58;625769060;9663;251;10696;10780;6.65;0.40;281.51;8.77;1033;58;3684.00;84
9664;58;625769076;9664;250;10696;10780;6.63;0.40;281.51;8.77;1032;58;3685.00;84
9669;58;625769090;9669;254;10697;10780;6.58;0.40;281.42;8.78;1028;58;3686.00;83
9671;58;625769111;9671;262;10700;10786;6.64;0.40;281.42;8.78;1029;58;3687.00;86
9673;58;625769125;9673;265;10701;10786;6.72;0.41;281.38;8.78;1028;58;3688.00;85
9675;58;625769138;9675;273;10704;10786;6.72;0.41;281.34;8.79;1029;58;3689.00;82
9676;58;625769152;9676;281;10707;10792;6.77;0.41;281.33;8.78;1031;58;3690.00;85
9677;58;625769165;9677;286;10707;10792;6.77;0.41;281.31;8.78;1030;58;3691.00;85
9681;58;625769178;9681;290;10710;10792;6.74;0.41;281.23;8.79;1029;58;3692.00;82
9682;58;625769192;9682;288;10711;10793;6.71;0.41;281.21;8.79;1029;58;3693.00;82
9684;58;625769204;9684;292;10713;10794;6.75;0.41;281.16;8.79;1029;58;3694.00;81
9687;58;625769217;9687;292;10714;10794;6.67;0.41;281.30;8.79;1027;58;3695.00;80
9691;58;625769229;9691;300;10725;10807;6.60;0.40;281.25;8.79;1034;58;3696.00;82
9691;58;625769243;9691;302;10725;10807;6.52;0.40;281.25;8.79;1034;58;3697.00;82
9692;58;625769255;9692;316;10728;10807;6.44;0.39;281.24;8.81;1036;58;3698.00;79
9693;58;625769267;9693;318;10730;10808;6.41;0.39;281.24;8.81;1037;58;3699.00;78
9696;58;625769281;9696;323;10734;10808;6.32;0.38;281.23;8.84;1038;58;3700.00;74
9699;58;625769297;9699;333;10736;10812;6.27;0.38;281.19;8.84;1037;58;3701.00;76
9701;58;625769310;9701;338;10739;10812;6.22;0.38;281.14;8.86;1038;58;3702.00;73
9702;58;625769323;9702;336;10744;10816;6.19;0.38;281.11;8.86;1042;58;3703.00;72
9706;58;625769335;9706;347;10744;10816;6.14;0.37;281.05;8.86;1038;58;3704.00;72
9708;58;625769348;9708;349;10745;10816;6.13;0.37;281.02;8.87;1037;58;3705.00;71
9710;58;625769368;9710;357;10747;10816;6.13;0.37;281.00;8.89;1037;58;3706.00;69
9712;58;625769379;9712;356;10748;10816;6.08;0.37;280.97;8.90;1036;58;3707.00;68
9713;58;625769392;9713;360;10759;10828;6.12;0.37;280.97;8.91;1046;58;3708.00;69
9715;58;625769405;9715;366;10761;10828;6.12;0.37;280.97;8.92;1046;58;3709.00;67
9715;58;625769418;9715;373;10763;10828;6.09;0.37;280.97;8.94;1048;58;3710.00;65
9716;58;625769429;9716;370;10763;10828;6.12;0.37;280.96;8.94;1047;58;3711.00;65
9717;58;625769441;9717;372;10767;10828;6.12;0.37;280.99;8.97;1050;58;3712.00;61
9717;58;625769453;9717;370;10767;10828;6.12;0.37;280.99;8.97;1050;58;3713.00;61
9718;58;625769465;9718;373;10772;10829;6.11;0.37;280.97;9.00;1054;58;3714.00;57
9718;58;625769477;9718;359;10773;10829;6.11;0.37;280.97;9.01;1055;58;3715.00;56
9719;58;625769490;9719;346;10777;10835;6.13;0.38;280.97;9.01;1058;58;3716.00;58
9721;58;625769503;9721;336;10781;10836;6.12;0.37;280.97;9.02;1060;58;3717.00;55
9725;58;625769515;9725;340;10783;10836;6.09;0.37;281.07;9.03;1058;58;3718.00;53
9729;58;625769528;9729;337;10783;10836;6.11;0.37;281.11;9.03;1054;58;3719.00;53
9730;58;625769543;9730;324;10789;10841;6.17;0.38;281.12;9.05;1059;58;3720.00;52
9732;58;625769559;9732;323;10790;10841;6.15;0.38;281.09;9.06;1058;58;3721.00;51
9732;58;625769579;9732;318;10791;10841;6.14;0.37;281.09;9.07;1059;58;3722.00;50
9735;58;625769594;9735;316;10793;10842;6.13;0.37;281.08;9.07;1058;58;3723.00;49
9735;58;625769607;9735;314;10798;10846;6.19;0.38;281.08;9.09;1063;58;3724.00;48
9735;58;625769621;9735;309;10798;10846;6.23;0.38;281.08;9.09;1063;58;3725.00;48
9737;58;625769634;9737;307;10801;10849;6.27;0.38;281.04;9.09;1064;58;3726.00;48
9737;58;625769648;9737;314;10804;10849;6.33;0.39;281.04;9.10;1067;58;3727.00;45
9738;58;625769661;9738;313;10804;10849;6.41;0.39;281.03;9.10;1066;58;3728.00;45
9740;58;625769675;9740;316;10806;10849;6.44;0.39;280.99;9.11;1066;58;3729.00;43
9742;58;625769687;9742;323;10810;10853;6.47;0.39;280.96;9.11;1068;58;3730.00;43
9744;58;625769701;9744;328;10813;10853;6.42;0.39;280.94;9.12;1069;58;3731.00;40
9747;58;625769714;9747;331;10813;10853;6.38;0.39;280.96;9.12;1066;58;3732.00;40
9748;58;625769727;9748;337;10813;10853;6.36;0.39;280.95;9.12;1065;58;3733.00;40
9754;58;625769745;9754;339;10814;10854;6.28;0.38;281.00;9.13;1060;58;3734.00;40
9754;58;625769757;9754;340;10816;10856;6.28;0.38;281.00;9.12;1062;58;3735.00;40
9759;58;625769770;9759;333;10816;10856;6.21;0.38;281.02;9.12;1057;58;3736.00;40
9763;58;625769782;9763;343;10818;10857;6.14;0.37;281.09;9.13;1055;58;3737.00;39
9767;58;625769794;9767;342;10819;10857;6.02;0.37;281.14;9.14;1052;58;3738.00;38
9769;58;625769807;9769;343;10819;10857;5.93;0.36;281.14;9.14;1050;58;3739.00;38
9774;58;625769819;9774;343;10820;10857;5.84;0.36;281.12;9.14;1046;58;3740.00;37
9777;58;625769831;9777;338;10821;10857;5.76;0.35;281.23;9.15;1044;58;3741.00;36
9781;58;625769843;9781;339;10821;10857;5.66;0.35;281.30;9.15;1040;58;3742.00;36
9784;58;625769854;9784;342;10822;10857;5.59;0.34;281.26;9.15;1038;58;3743.00;35
9786;58;625769866;9786;352;10891;10984;5.91;0.37;281.31;9.10;1105;58;3744.00;93
9788;58;625769890;9788;346;10895;10985;5.91;0.37;281.37;9.10;1107;58;3745.00;90
9792;58;625769903;9792;338;10907;10985;5.98;0.37;281.38;9.10;1115;58;3746.00;78
9796;58;625769917;9796;337;10910;10985;5.99;0.37;281.42;9.09;1114;58;3747.00;75
9800;58;625769931;9800;334;10915;10985;6.05;0.37;281.42;9.09;1115;58;3748.00;70
9804;58;625769946;9804;327;10920;10985;6.09;0.38;281.50;9.09;1116;58;3749.00;65
9807;58;625769963;9807;321;10924;10990;6.17;0.38;281.53;9.09;1117;58;3750.00;66
9811;58;625769978;9811;327;10927;10990;6.17;0.38;281.60;9.09;1116;58;3751.00;63
9815;58;625769992;9815;322;10932;10991;6.25;0.38;281.64;9.09;1117;58;3752.00;59
9819;58;625770008;9819;328;10935;10992;6.34;0.39;281.73;9.09;1116;58;3753.00;57
9824;58;625770029;9824;332;10937;10992;6.36;0.39;281.80;9.09;1113;58;3754.00;55
9826;58;625770044;9826;338;10938;10993;6.36;0.39;281.81;9.09;1112;58;3755.00;55
9830;58;625770059;9830;339;10940;10993;6.39;0.39;281.82;9.09;1110;58;3756.00;53
9831;58;625770074;9831;338;10941;10993;6.45;0.40;281.81;9.09;1110;58;3757.00;52
9837;58;625770088;9837;344;10943;10993;6.44;0.39;281.86;9.09;1106;58;3758.00;50
9842;58;625770103;9842;341;10946;10997;6.48;0.40;281.89;9.09;1104;58;3759.00;51
9845;58;625770119;9845;340;10949;10997;6.52;0.40;281.98;9.09;1104;58;3760.00;48
9846;58;625770134;9846;339;10951;10997;6.55;0.40;281.96;9.09;1105;58;3761.00;46
9849;58;625770149;9849;333;10953;11000;6.56;0.40;282.01;9.09;1104;58;3762.00;47
9852;58;625770170;9852;332;10953;11000;6.61;0.40;282.01;9.09;1101;58;3763.00;47
9856;58;625770186;9856;327;10953;11000;6.67;0.41;282.05;9.09;1097;58;3764.00;47
9860;58;625770200;9860;327;10956;11004;6.73;0.41;282.14;9.08;1096;58;3765.00;48
9864;58;625770218;9864;332;10957;11005;6.81;0.42;282.15;9.08;1093;58;3766.00;48
9869;58;625770232;9869;328;10958;11005;6.80;0.42;282.23;9.08;1089;58;3767.00;47
9872;58;625770246;9872;330;10961;11009;6.84;0.42;282.30;9.08;1089;58;3768.00;48
9879;58;625770260;9879;327;10961;11009;6.82;0.42;282.37;9.08;1082;58;3769.00;48
9883;58;625770274;9883;331;10963;11009;6.81;0.42;282.39;9.08;1080;58;3770.00;46
9888;58;625770288;9888;321;10965;11010;6.85;0.42;282.37;9.08;1077;58;3771.00;45
9893;58;625770302;9893;322;10965;11010;6.91;0.42;282.49;9.08;1072;58;3772.00;45
9897;58;625770315;9897;323;10969;11016;6.98;0.42;282.55;9.08;1072;58;3773.00;47
9902;58;625770329;9902;318;10969;11016;6.99;0.43;282.58;9.08;1067;58;3774.00;47
9905;58;625770343;9905;328;10970;11017;6.99;0.42;282.63;9.08;1065;58;3775.00;47
9909;58;625770362;9909;328;10970;11017;6.98;0.43;282.68;9.08;1061;58;3776.00;47
9913;58;625770380;9913;329;10971;11017;6.97;0.43;282.75;9.12;1058;58;3777.00;46
9915;58;625770394;9915;325;10971;11017;7.06;0.43;282.73;9.12;1056;58;3778.00;46
9921;58;625770409;9921;321;10971;11017;7.07;0.43;282.78;9.12;1050;58;3779.00;46
9928;58;625770424;9928;328;10996;11053;7.16;0.44;282.85;9.10;1068;58;3780.00;57
9931;58;625770440;9931;330;10997;11053;7.11;0.44;282.85;9.10;1066;58;3781.00;56
9935;58;625770460;9935;337;10999;11053;7.07;0.43;282.88;9.10;1064;58;3782.00;54
9941;58;625770474;9941;341;10999;11053;7.00;0.43;282.87;9.10;1058;58;3783.00;54
9945;58;625770487;9945;344;11000;11053;6.96;0.43;282.89;9.10;1055;58;3784.00;53
9950;58;625770501;9950;348;11000;11053;6.90;0.42;282.88;9.10;1050;58;3785.00;53
9955;58;625770515;9955;357;11004;11057;6.88;0.42;282.94;9.09;1049;58;3786.00;53
9959;58;625770529;9959;342;11004;11057;6.86;0.42;282.98;9.09;1045;58;3787.00;53
9962;58;625770548;9962;335;11007;11061;6.87;0.42;283.04;9.09;1045;58;3788.00;54
9967;58;625770574;9967;332;11009;11062;6.90;0.42;283.04;9.09;1042;58;3789.00;53
9969;58;625770603;9969;334;11010;11062;6.94;0.42;283.09;9.09;1041;58;3790.00;52
9974;58;625770629;9974;327;11010;11062;6.94;0.42;283.12;9.09;1036;58;3791.00;52
9979;58;625770653;9979;328;11020;11075;6.99;0.43;283.28;9.08;1041;58;3792.00;55
9981;58;625770674;9981;326;11020;11075;7.02;0.43;283.26;9.08;1039;58;3793.00;55
9984;58;625770692;9984;329;11021;11075;7.07;0.43;283.33;9.08;1037;58;3794.00;54
9987;58;625770709;9987;328;11022;11076;7.08;0.43;283.39;9.08;1035;58;3795.00;54
9988;58;625770725;9988;316;11022;11077;7.16;0.44;283.42;9.08;1034;58;3796.00;55
9993;58;625770742;9993;302;11023;11077;7.20;0.44;283.54;9.12;1030;58;3797.00;54
9995;58;625770758;9995;284;11025;11080;7.34;0.45;283.49;9.12;1030;58;3798.00;55
9997;58;625770774;9997;273;11025;11080;7.43;0.45;283.54;9.12;1028;58;3799.00;55
10001;58;625770790;10001;261;11026;11080;7.50;0.46;283.61;9.12;1025;58;3800.00;54
10010;58;625770812;10010;252;11026;11080;7.51;0.46;283.69;9.12;1016;58;3801.00;54
10010;58;625770829;10010;245;11030;11086;7.60;0.46;283.69;9.11;1020;58;3802.00;56
10013;58;625770845;10013;239;11030;11086;7.61;0.46;283.73;9.11;1017;58;3803.00;56
10016;58;625770860;10016;237;11031;11086;7.62;0.46;283.79;9.11;1015;58;3804.00;55
10020;58;625770876;10020;240;11031;11086;7.59;0.46;283.76;9.11;1011;58;3805.00;55
10023;58;625770898;10023;248;11034;11090;7.54;0.46;283.79;9.11;1011;58;3806.00;56
10026;58;625770946;10026;238;11035;11091;7.53;0.46;283.81;9.11;1009;58;3807.00;56
10028;58;625770981;10028;233;11035;11091;7.46;0.45;283.83;9.11;1007;58;3808.00;56
10032;58;625771000;10032;229;11036;11092;7.41;0.45;283.89;9.11;1004;58;3809.00;56
10033;58;625771023;10033;222;11036;11092;7.41;0.45;283.89;9.11;1003;58;3810.00;56
10037;58;625771044;10037;217;11036;11092;7.38;0.45;283.92;9.11;999;58;3811.00;56
10040;58;625771063;10040;217;11036;11092;7.38;0.45;283.93;9.11;996;58;3812.00;56
10041;58;625771081;10041;221;11036;11092;7.39;0.45;283.92;9.11;995;58;3813.00;56
10046;58;625771104;10046;227;11036;11092;7.38;0.45;284.08;9.11;990;58;3814.00;56
10049;58;625771124;10049;233;11036;11092;7.41;0.45;284.06;9.11;987;58;3815.00;56
10053;58;625771151;10053;246;11073;11162;7.39;0.45;284.08;9.08;1020;58;3816.00;89
10054;58;625771179;10054;238;11074;11163;7.42;0.45;284.08;9.08;1020;58;3817.00;89
10054;58;625771195;10054;235;11078;11163;7.45;0.45;284.08;9.08;1024;58;3818.00;85
10057;58;625771223;10057;234;11082;11163;7.43;0.45;284.09;9.07;1025;58;3819.00;81
10060;58;625771241;10060;245;11085;11163;7.38;0.45;284.08;9.07;1025;58;3820.00;78
10061;58;625771258;10061;246;11091;11163;7.33;0.45;284.07;9.07;1030;58;3821.00;72
10063;58;625771273;10063;251;11094;11163;7.23;0.44;284.13;9.07;1031;58;3822.00;69
10064;58;625771296;10064;256;11097;11163;7.16;0.44;284.12;9.11;1033;58;3823.00;66
10065;58;625771313;10065;256;11100;11164;7.14;0.44;284.10;9.11;1035;58;3824.00;64
10066;58;625771331;10066;260;11103;11166;7.10;0.43;284.08;9.11;1037;58;3825.00;63
10069;58;625771347;10069;267;11104;11166;7.06;0.43;284.13;9.11;1035;58;3826.00;62
10069;58;625771362;10069;264;11107;11170;6.96;0.43;284.13;9.11;1038;58;3827.00;63
10071;58;625771379;10071;275;11107;11170;6.88;0.42;284.11;9.11;1036;58;3828.00;63
10072;58;625771394;10072;289;11107;11170;6.81;0.42;284.13;9.11;1035;58;3829.00;63
10076;58;625771410;10076;287;11107;11170;6.69;0.41;284.13;9.11;1031;58;3830.00;63
10076;58;625771425;10076;281;11110;11176;6.65;0.41;284.13;9.10;1034;58;3831.00;66
10080;58;625771444;10080;284;11111;11176;6.57;0.40;284.14;9.10;1031;58;3832.00;65
10082;58;625771461;10082;287;11111;11176;6.54;0.40;284.11;9.10;1029;58;3833.00;65
10085;58;625771480;10085;286;11113;11179;6.55;0.40;284.07;9.10;1028;58;3834.00;66
10087;58;625771497;10087;286;11113;11179;6.54;0.40;284.06;9.10;1026;58;3835.00;66
10091;58;625771513;10091;291;11114;11179;6.51;0.40;284.05;9.10;1023;58;3836.00;65
10093;58;625771529;10093;299;11114;11180;6.48;0.40;284.02;9.10;1021;58;3837.00;66
10099;58;625771547;10099;298;11116;11181;6.38;0.39;283.97;9.14;1017;58;3838.00;65
10101;58;625771565;10101;289;11116;11181;6.33;0.39;283.95;9.14;1015;58;3839.00;65
10105;58;625771584;10105;292;11131;11207;6.28;0.38;283.95;9.13;1026;58;3840.00;76
10108;58;625771602;10108;288;11131;11207;6.17;0.38;283.94;9.13;1023;58;3841.00;76
10110;58;625771616;10110;283;11133;11207;6.10;0.37;283.93;9.13;1023;58;3842.00;74
10115;58;625771631;10115;278;11137;11208;5.98;0.36;283.91;9.16;1022;58;3843.00;71
10117;58;625771646;10117;281;11137;11208;5.95;0.36;283.96;9.16;1020;58;3844.00;71
10119;58;625771660;10119;277;11140;11212;5.96;0.36;283.93;9.17;1021;58;3845.00;72
10123;58;625771676;10123;276;11141;11214;5.98;0.36;283.95;9.17;1018;58;3846.00;73
10130;58;625771690;10130;265;11145;11218;5.95;0.36;283.86;9.17;1015;58;3847.00;73
10134;58;625771704;10134;263;11146;11218;5.94;0.36;283.96;9.17;1012;58;3848.00;72
10140;58;625771718;10140;256;11146;11218;5.89;0.36;283.90;9.17;1006;58;3849.00;72
10143;58;625771732;10143;251;11146;11218;5.86;0.36;283.87;9.17;1003;58;3850.00;72
10146;58;625771747;10146;253;11146;11218;5.83;0.36;283.84;9.17;1000;58;3851.00;72
10148;58;625771760;10148;250;11157;11230;5.87;0.36;283.79;9.16;1009;58;3852.00;73
10150;58;625771774;10150;246;11157;11230;5.89;0.36;283.75;9.16;1007;58;3853.00;73
10154;58;625771792;10154;252;11158;11230;5.87;0.36;283.71;9.20;1004;58;3854.00;72
10156;58;625771805;10156;251;11158;11230;5.85;0.36;283.67;9.20;1002;58;3855.00;72
10158;58;625771818;10158;248;11158;11230;5.86;0.36;283.67;9.20;1000;58;3856.00;72
10159;58;625771831;10159;256;11158;11230;5.85;0.36;283.65;9.20;999;58;3857.00;72
10159;58;625771844;10159;249;11159;11231;5.89;0.36;283.65;9.20;1000;58;3858.00;72
10161;58;625771857;10161;258;11159;11231;5.87;0.36;283.65;9.20;998;58;3859.00;72
10162;58;625771871;10162;261;11164;11237;5.89;0.36;283.63;9.20;1002;58;3860.00;73
10163;58;625771892;10163;257;11167;11238;5.92;0.36;283.63;9.20;1004;58;3861.00;71
10165;58;625771907;10165;264;11169;11238;5.90;0.36;283.65;9.20;1004;58;3862.00;69
10167;58;625771922;10167;269;11170;11238;5.89;0.36;283.63;9.21;1003;58;3863.00;68
10168;58;625771936;10168;272;11172;11242;5.90;0.36;283.60;9.21;1004;58;3864.00;70
10169;58;625771950;10169;274;11173;11242;5.92;0.36;283.59;9.21;1004;58;3865.00;69
10172;58;625771964;10172;282;11173;11242;5.92;0.36;283.55;9.21;1001;58;3866.00;69
10174;58;625771980;10174;275;11176;11243;5.90;0.36;283.55;9.22;1002;58;3867.00;67
10175;58;625771997;10175;271;11180;11247;5.94;0.36;283.55;9.22;1005;58;3868.00;67
10175;58;625772012;10175;267;11180;11247;5.94;0.36;283.55;9.22;1005;58;3869.00;67
10177;58;625772027;10177;267;11184;11253;6.04;0.37;283.52;9.23;1007;58;3870.00;69
10181;58;625772041;10181;261;11186;11253;6.10;0.37;283.59;9.24;1005;58;3871.00;67
10184;58;625772056;10184;256;11188;11253;6.20;0.37;283.60;9.25;1004;58;3872.00;65
10186;58;625772072;10186;245;11189;11253;6.24;0.38;283.59;9.26;1003;58;3873.00;64
10186;58;625772087;10186;247;11192;11257;6.36;0.38;283.59;9.26;1006;58;3874.00;65
10188;58;625772102;10188;244;11194;11257;6.39;0.39;283.54;9.28;1006;58;3875.00;63
10189;58;625772116;10189;242;11195;11257;6.47;0.39;283.52;9.28;1006;58;3876.00;62
10189;58;625772138;10189;241;11198;11257;6.54;0.40;283.52;9.30;1009;58;3877.00;59
10190;58;625772151;10190;234;11198;11258;6.53;0.40;283.51;9.30;1008;58;3878.00;60
10191;58;625772170;10191;236;11200;11259;6.52;0.40;283.51;9.31;1009;58;3879.00;59
10191;58;625772184;10191;241;11201;11259;6.56;0.40;283.51;9.32;1010;58;3880.00;58
10193;58;625772197;10193;246;11203;11260;6.62;0.40;283.49;9.33;1010;58;3881.00;57
10194;58;625772220;10194;248;11204;11260;6.61;0.40;283.50;9.33;1010;58;3882.00;56
10195;58;625772238;10195;244;11206;11260;6.61;0.40;283.51;9.35;1011;58;3883.00;54
10195;58;625772251;10195;247;11206;11260;6.59;0.40;283.51;9.35;1011;58;3884.00;54
10195;58;625772265;10195;255;11207;11260;6.52;0.40;283.51;9.36;1012;58;3885.00;53
10196;58;625772280;10196;257;11208;11260;6.47;0.39;283.50;9.36;1012;58;3886.00;52
10199;58;625772295;10199;260;11209;11260;6.49;0.40;283.48;9.38;1010;58;3887.00;51
10200;58;625772310;10200;286;11276;11387;6.68;0.41;283.47;9.34;1076;58;3888.00;111
10201;58;625772344;10201;276;11280;11388;6.69;0.41;283.45;9.33;1079;58;3889.00;108
10203;58;625772364;10203;265;11290;11388;6.74;0.42;283.44;9.34;1087;58;3890.00;98
10206;58;625772376;10206;270;11296;11388;6.79;0.42;283.47;9.34;1090;58;3891.00;92
10208;58;625772390;10208;269;11302;11388;6.85;0.42;283.56;9.33;1094;58;3892.00;86
10210;58;625772405;10210;271;11307;11388;6.89;0.42;283.59;9.33;1097;58;3893.00;81
10212;58;625772420;10212;277;11314;11388;6.90;0.43;283.61;9.35;1102;58;3894.00;74
10213;58;625772436;10213;271;11319;11388;6.91;0.43;283.59;9.35;1106;58;3895.00;69
10217;58;625772457;10217;274;11323;11389;6.95;0.43;283.62;9.36;1106;58;3896.00;66
10218;58;625772474;10218;277;11326;11390;6.99;0.43;283.66;9.36;1108;58;3897.00;64
10221;58;625772491;10221;288;11328;11390;7.03;0.43;283.66;9.37;1107;58;3898.00;62
10223;58;625772507;10223;295;11329;11391;6.99;0.43;283.72;9.37;1106;58;3899.00;62
10225;58;625772526;10225;305;11336;11406;6.83;0.42;283.75;9.37;1111;58;3900.00;70
10228;58;625772551;10228;305;11337;11406;6.70;0.41;283.76;9.38;1109;58;3901.00;69
10231;58;625772578;10231;316;11339;11406;6.58;0.40;283.79;9.38;1108;58;3902.00;67
10234;58;625772607;10234;324;11343;11410;6.46;0.40;283.83;9.39;1109;58;3903.00;67
10238;58;625772630;10238;327;11345;11410;6.38;0.39;283.89;9.39;1107;58;3904.00;65
10242;58;625772653;10242;336;11345;11410;6.29;0.39;283.94;9.39;1103;58;3905.00;65
10248;58;625772669;10248;349;11350;11413;6.21;0.38;283.97;9.40;1102;58;3906.00;63
10251;58;625772697;10251;356;11351;11413;6.13;0.38;284.01;9.40;1100;58;3907.00;62
10255;58;625772714;10255;371;11353;11413;6.01;0.37;284.10;9.41;1098;58;3908.00;60
10257;58;625772730;10257;378;11358;11417;5.93;0.36;284.14;9.41;1101;58;3909.00;59
10264;58;625772754;10264;376;11359;11418;5.88;0.36;284.13;9.41;1095;58;3910.00;59
10269;58;625772774;10269;367;11360;11418;5.78;0.35;284.18;9.42;1091;58;3911.00;58
10271;58;625772790;10271;374;11365;11422;5.78;0.35;284.23;9.42;1094;58;3912.00;57
10273;58;625772808;10273;371;11366;11422;5.74;0.35;284.29;9.42;1093;58;3913.00;56
10279;58;625772824;10279;370;11367;11422;5.68;0.35;284.36;9.43;1088;58;3914.00;55
10282;58;625772840;10282;367;11369;11424;5.65;0.35;284.38;9.43;1087;58;3915.00;55
10287;58;625772865;10287;368;11371;11424;5.63;0.34;284.41;9.44;1084;58;3916.00;53
10289;58;625772882;10289;363;11376;11430;5.69;0.35;284.43;9.45;1087;58;3917.00;54
10294;58;625772899;10294;366;11376;11430;5.68;0.35;284.51;9.45;1082;58;3918.00;54
10297;58;625772915;10297;364;11377;11431;5.73;0.35;284.57;9.45;1080;58;3919.00;54
10299;58;625772931;10299;359;11377;11431;5.80;0.35;284.59;9.45;1078;58;3920.00;54
10300;58;625772949;10300;356;11377;11431;5.89;0.36;284.63;9.45;1077;58;3921.00;54
10304;58;625772965;10304;353;11378;11431;5.94;0.36;284.69;9.45;1074;58;3922.00;53
10310;58;625772985;10310;346;11378;11431;5.97;0.36;284.76;9.45;1068;58;3923.00;53
10311;58;625773001;10311;339;11387;11443;6.11;0.37;284.79;9.44;1076;58;3924.00;56
10314;58;625773022;10314;334;11387;11443;6.19;0.38;284.86;9.44;1073;58;3925.00;56
10318;58;625773040;10318;338;11388;11443;6.21;0.38;284.85;9.44;1070;58;3926.00;55
10322;58;625773057;10322;333;11390;11443;6.26;0.38;284.92;9.45;1068;58;3927.00;53
10326;58;625773076;10326;331;11390;11443;6.32;0.39;285.07;9.45;1064;58;3928.00;53
10329;58;625773098;10329;325;11390;11443;6.42;0.39;285.13;9.45;1061;58;3929.00;53
10334;58;625773116;10334;323;11393;11447;6.44;0.39;285.21;9.44;1059;58;3930.00;54
10335;58;625773137;10335;325;11393;11447;6.51;0.40;285.22;9.44;1058;58;3931.00;54
10339;58;625773156;10339;328;11395;11451;6.56;0.40;285.28;9.44;1056;58;3932.00;56
10343;58;625773174;10343;336;11397;11452;6.56;0.40;285.36;9.44;1054;58;3933.00;55
10346;58;625773193;10346;334;11397;11452;6.60;0.40;285.41;9.44;1051;58;3934.00;55
10350;58;625773215;10350;338;11400;11452;6.60;0.41;285.47;9.49;1050;58;3935.00;52
10356;58;625773233;10356;341;11410;11465;6.58;0.40;285.52;9.48;1054;58;3936.00;55
10361;58;625773254;10361;339;11410;11465;6.55;0.40;285.58;9.48;1049;58;3937.00;55
10367;58;625773273;10367;340;11410;11465;6.50;0.40;285.67;9.48;1043;58;3938.00;55
10372;58;625773299;10372;336;11412;11466;6.52;0.40;285.77;9.48;1040;58;3939.00;54
10376;58;625773315;10376;338;11412;11467;6.55;0.40;285.81;9.48;1036;58;3940.00;55
10382;58;625773330;10382;339;11413;11467;6.59;0.40;285.81;9.48;1031;58;3941.00;54
10386;58;625773348;10386;340;11416;11470;6.66;0.41;285.79;9.48;1030;58;3942.00;54
10392;58;625773364;10392;342;11417;11470;6.71;0.41;285.83;9.48;1025;58;3943.00;53
10397;58;625773383;10397;338;11418;11470;6.74;0.41;285.88;9.48;1021;58;3944.00;52
10399;58;625773406;10399;331;11419;11470;6.83;0.42;285.88;9.48;1020;58;3945.00;51
10402;58;625773425;10402;330;11423;11476;6.88;0.42;285.88;9.48;1021;58;3946.00;53
10407;58;625773443;10407;328;11424;11476;6.86;0.42;285.88;9.48;1017;58;3947.00;52
10407;58;625773463;10407;335;11425;11476;6.86;0.42;285.88;9.48;1018;58;3948.00;51
10410;58;625773483;10410;342;11427;11476;6.82;0.42;285.85;9.52;1017;58;3949.00;49
10414;58;625773507;10414;346;11430;11480;6.78;0.41;285.92;9.52;1016;58;3950.00;50
10416;58;625773526;10416;349;11431;11481;6.76;0.41;285.93;9.52;1015;58;3951.00;50
10418;58;625773550;10418;351;11431;11481;6.76;0.41;285.97;9.52;1013;58;3952.00;50
10421;58;625773566;10421;360;11432;11482;6.75;0.41;286.07;9.52;1011;58;3953.00;50
10424;58;625773583;10424;363;11433;11482;6.68;0.41;286.08;9.56;1009;58;3954.00;49
10429;58;625773600;10429;370;11433;11482;6.61;0.40;286.09;9.56;1004;58;3955.00;49
10434;58;625773615;10434;380;11433;11482;6.51;0.40;286.19;9.56;999;58;3956.00;49
10436;58;625773630;10436;370;11433;11482;6.48;0.40;286.24;9.56;997;58;3957.00;49
10441;58;625773646;10441;364;11434;11482;6.37;0.39;286.30;9.59;993;58;3958.00;48
10444;58;625773664;10444;364;11434;11482;6.36;0.39;286.30;9.59;990;58;3959.00;48
10447;58;625773680;10447;384;11506;11607;6.50;0.40;286.32;9.53;1059;58;3960.00;101
10449;58;625773711;10449;380;11509;11608;6.53;0.40;286.39;9.55;1060;58;3961.00;99
10455;58;625773735;10455;370;11514;11608;6.60;0.41;286.45;9.55;1059;58;3962.00;94
10456;58;625773758;10456;362;11518;11608;6.64;0.41;286.49;9.55;1062;59;3963.00;90
10462;58;625773787;10462;359;11522;11608;6.68;0.41;286.52;9.55;1060;59;3964.00;86
10466;58;625773804;10466;356;11526;11608;6.74;0.41;286.57;9.55;1060;59;3965.00;82
10470;58;625773821;10470;349;11529;11608;6.79;0.42;286.64;9.54;1059;59;3966.00;79
10475;58;625773839;10475;337;11530;11608;6.80;0.42;286.71;9.54;1055;59;3967.00;78
10478;58;625773856;10478;333;11534;11609;6.84;0.42;286.69;9.54;1056;59;3968.00;75
10482;58;625773880;10482;328;11535;11610;6.84;0.42;286.76;9.54;1053;59;3969.00;75
10487;58;625773898;10487;319;11537;11610;6.85;0.42;286.77;9.54;1050;59;3970.00;73
10487;58;625773914;10487;320;11542;11614;6.82;0.42;286.77;9.54;1055;59;3971.00;72
10491;58;625773932;10491;322;11545;11614;6.72;0.41;286.83;9.57;1054;59;3972.00;69
10494;58;625773955;10494;322;11545;11614;6.66;0.41;286.85;9.57;1051;59;3973.00;69
10497;58;625773972;10497;326;11546;11614;6.60;0.40;286.91;9.57;1049;59;3974.00;68
10499;58;625773987;10499;329;11550;11620;6.63;0.41;286.95;9.57;1051;59;3975.00;70
10503;58;625774005;10503;332;11550;11620;6.62;0.40;287.02;9.57;1047;59;3976.00;70
10504;58;625774031;10504;324;11551;11620;6.69;0.41;287.00;9.57;1047;59;3977.00;69
10507;58;625774047;10507;320;11554;11623;6.74;0.41;287.01;9.57;1047;59;3978.00;69
10508;58;625774065;10508;311;11554;11623;6.82;0.42;287.01;9.57;1046;59;3979.00;69
10511;58;625774085;10511;305;11554;11623;6.87;0.42;287.03;9.57;1043;59;3980.00;69
10512;58;625774102;10512;301;11554;11624;6.95;0.42;287.08;9.57;1042;59;3981.00;70
10513;58;625774118;10513;297;11555;11625;7.03;0.43;287.06;9.57;1042;59;3982.00;70
10516;58;625774135;10516;298;11555;11625;7.06;0.43;287.16;9.57;1039;59;3983.00;70
10521;58;625774153;10521;301;11565;11638;7.04;0.43;287.14;9.56;1044;59;3984.00;73
10523;58;625774173;10523;295;11565;11638;7.00;0.43;287.18;9.56;1042;59;3985.00;73
10525;58;625774190;10525;301;11565;11638;6.94;0.42;287.17;9.56;1040;59;3986.00;73
10527;58;625774207;10527;303;11566;11639;6.92;0.42;287.13;9.56;1039;59;3987.00;73
10529;58;625774225;10529;305;11566;11639;6.84;0.42;287.21;9.56;1037;59;3988.00;73
10530;58;625774243;10530;308;11569;11643;6.83;0.42;287.20;9.55;1039;59;3989.00;74
10533;58;625774262;10533;311;11570;11643;6.80;0.42;287.19;9.55;1037;59;3990.00;73
10536;58;625774284;10536;314;11573;11647;6.75;0.41;287.16;9.55;1037;59;3991.00;74
10538;58;625774299;10538;320;11573;11647;6.70;0.41;287.16;9.55;1035;59;3992.00;74
10541;58;625774314;10541;327;11573;11647;6.64;0.41;287.14;9.55;1032;59;3993.00;74
10542;58;625774329;10542;325;11573;11647;6.59;0.40;287.13;9.55;1031;59;3994.00;74
10543;58;625774343;10543;328;11573;11647;6.54;0.40;287.10;9.55;1030;59;3995.00;74
10545;58;625774358;10545;340;11583;11659;6.47;0.40;287.12;9.54;1038;59;3996.00;76
10546;58;625774375;10546;339;11584;11659;6.43;0.39;287.09;9.54;1038;59;3997.00;75
10549;58;625774389;10549;343;11584;11659;6.35;0.39;287.05;9.54;1035;59;3998.00;75
10551;58;625774403;10551;345;11584;11659;6.28;0.38;287.02;9.54;1033;59;3999.00;75
10557;58;625774418;10557;343;11584;11659;6.19;0.38;286.92;9.54;1027;59;4000.00;75
10558;58;625774437;10558;340;11584;11659;6.15;0.38;286.91;9.54;1026;59;4001.00;75
10559;58;625774453;10559;339;11584;11660;6.07;0.37;286.92;9.54;1025;59;4002.00;76
10562;58;625774474;10562;332;11584;11660;6.04;0.37;286.87;9.54;1022;59;4003.00;76
10562;58;625774489;10562;327;11588;11666;6.06;0.37;286.87;9.54;1026;59;4004.00;78
10563;58;625774503;10563;330;11591;11668;6.06;0.37;286.87;9.54;1028;59;4005.00;77
10565;58;625774521;10565;326;11591;11668;6.06;0.37;286.87;9.54;1026;59;4006.00;77
10568;58;625774534;10568;330;11591;11668;6.04;0.37;286.86;9.54;1023;59;4007.00;77
10571;58;625774551;10571;328;11594;11672;6.07;0.37;286.90;9.54;1023;59;4008.00;78
10576;58;625774569;10576;328;11594;11672;5.97;0.37;286.89;9.54;1018;59;4009.00;78
10579;58;625774588;10579;320;11594;11672;5.89;0.36;286.93;9.54;1015;59;4010.00;78
10581;58;625774607;10581;327;11596;11673;5.85;0.36;286.92;9.57;1015;59;4011.00;77
10583;58;625774623;10583;329;11599;11677;5.79;0.35;286.91;9.57;1016;59;4012.00;78
10586;58;625774641;10586;322;11599;11677;5.70;0.35;286.89;9.57;1013;59;4013.00;78
10589;58;625774657;10589;318;11601;11680;5.62;0.34;286.87;9.57;1012;59;4014.00;79
10589;58;625774673;10589;313;11603;11680;5.58;0.34;286.87;9.58;1014;59;4015.00;77
10591;58;625774686;10591;311;11604;11680;5.48;0.33;286.85;9.61;1013;59;4016.00;76
10594;58;625774699;10594;309;11604;11680;5.43;0.33;286.85;9.61;1010;59;4017.00;76
10595;58;625774712;10595;309;11607;11684;5.48;0.33;286.83;9.61;1012;59;4018.00;77
10597;58;625774725;10597;296;11608;11684;5.52;0.34;286.81;9.65;1011;59;4019.00;76
10599;58;625774739;10599;281;11609;11684;5.60;0.34;286.77;9.65;1010;59;4020.00;75
10600;58;625774759;10600;278;11609;11684;5.70;0.35;286.79;9.65;1009;59;4021.00;75
10601;58;625774773;10601;265;11610;11685;5.76;0.35;286.77;9.68;1009;59;4022.00;75
10601;58;625774785;10601;257;11611;11686;5.86;0.36;286.77;9.68;1010;59;4023.00;75
10602;58;625774798;10602;249;11611;11686;5.94;0.36;286.76;9.68;1009;59;4024.00;75
10602;58;625774810;10602;249;11613;11687;6.03;0.37;286.76;9.72;1011;59;4025.00;74
10602;58;625774823;10602;247;11613;11687;6.11;0.37;286.76;9.72;1011;59;4026.00;74
10608;58;625774836;10608;247;11614;11687;6.15;0.37;286.70;9.72;1006;59;4027.00;73
10608;58;625774850;10608;241;11614;11687;6.26;0.38;286.70;9.72;1006;59;4028.00;73
10610;58;625774868;10610;235;11615;11687;6.33;0.38;286.71;9.75;1005;59;4029.00;72
10610;58;625774881;10610;232;11615;11687;6.37;0.39;286.71;9.75;1005;59;4030.00;72
10611;58;625774894;10611;235;11615;11687;6.40;0.39;286.74;9.75;1004;59;4031.00;72
10611;58;625774907;10611;250;11679;11814;6.65;0.41;286.74;9.70;1068;59;4032.00;135
10613;58;625774934;10613;242;11682;11815;6.65;0.41;286.72;9.70;1069;59;4033.00;133
10616;58;625774948;10616;241;11692;11815;6.71;0.41;286.71;9.69;1076;59;4034.00;123
10617;58;625774962;10617;230;11696;11815;6.80;0.42;286.71;9.69;1079;59;4035.00;119
10617;58;625774977;10617;229;11705;11815;6.91;0.43;286.71;9.70;1088;59;4036.00;110
10621;58;625774991;10621;226;11711;11815;6.96;0.43;286.73;9.70;1090;59;4037.00;104
10622;58;625775005;10622;227;11715;11815;6.96;0.43;286.74;9.70;1093;59;4038.00;100
10625;58;625775020;10625;226;11719;11815;6.94;0.42;286.73;9.70;1094;59;4039.00;96
10628;58;625775035;10628;221;11725;11816;6.93;0.42;286.68;9.72;1097;59;4040.00;91
10630;58;625775050;10630;220;11726;11817;6.95;0.42;286.69;9.72;1096;59;4041.00;91
10631;58;625775065;10631;220;11731;11817;6.99;0.43;286.67;9.74;1100;59;4042.00;86
10632;58;625775080;10632;217;11732;11818;7.01;0.43;286.66;9.74;1100;59;4043.00;86
10636;58;625775096;10636;218;11734;11818;6.96;0.43;286.72;9.76;1098;59;4044.00;84
10639;58;625775112;10639;236;11736;11818;6.93;0.42;286.74;9.76;1097;59;4045.00;82
10640;58;625775127;10640;235;11739;11818;6.92;0.42;286.77;9.78;1099;59;4046.00;79
10642;58;625775141;10642;243;11741;11822;6.92;0.43;286.80;9.78;1099;59;4047.00;81
10645;58;625775162;10645;247;11744;11822;6.89;0.42;286.85;9.78;1099;59;4048.00;78
10647;58;625775178;10647;251;11746;11822;6.90;0.42;286.91;9.80;1099;59;4049.00;76
10648;58;625775195;10648;256;11751;11828;6.94;0.43;286.95;9.80;1103;59;4050.00;77
10649;58;625775210;10649;261;11753;11828;6.96;0.43;286.93;9.82;1104;59;4051.00;75
10653;58;625775228;10653;263;11755;11828;6.95;0.43;286.97;9.83;1102;59;4052.00;73
10654;58;625775249;10654;263;11759;11832;6.90;0.42;287.01;9.83;1105;59;4053.00;73
10657;58;625775265;10657;269;11762;11833;6.90;0.42;287.01;9.85;1105;59;4054.00;71
10660;58;625775279;10660;275;11762;11833;6.84;0.42;287.09;9.85;1102;59;4055.00;71
10664;58;625775295;10664;284;11768;11837;6.80;0.42;287.16;9.87;1104;59;4056.00;69
10668;58;625775310;10668;292;11768;11837;6.70;0.41;287.17;9.87;1100;59;4057.00;69
10668;58;625775326;10668;297;11771;11837;6.64;0.41;287.17;9.90;1103;59;4058.00;66
10671;58;625775340;10671;299;11772;11838;6.57;0.40;287.19;9.89;1101;59;4059.00;66
10672;58;625775355;10672;298;11773;11838;6.56;0.40;287.23;9.89;1101;59;4060.00;65
10674;58;625775370;10674;298;11778;11844;6.55;0.40;287.30;9.92;1104;59;4061.00;66
10678;58;625775385;10678;302;11779;11844;6.50;0.40;287.36;9.91;1101;59;4062.00;65
10679;58;625775399;10679;298;11779;11845;6.49;0.40;287.35;9.91;1100;59;4063.00;66
10681;58;625775419;10681;302;11782;11845;6.46;0.40;287.43;9.94;1101;59;4064.00;63
10684;58;625775433;10684;298;11782;11845;6.46;0.40;287.40;9.94;1098;59;4065.00;63
10688;58;625775455;10688;301;11782;11845;6.41;0.39;287.46;9.94;1094;59;4066.00;63
10688;58;625775471;10688;297;11784;11845;6.38;0.39;287.46;9.96;1096;59;4067.00;61
10691;58;625775484;10691;296;11794;11857;6.41;0.39;287.52;9.95;1103;59;4068.00;63
10693;58;625775498;10693;294;11794;11857;6.40;0.39;287.59;9.95;1101;59;4069.00;63
10694;58;625775512;10694;294;11797;11857;6.36;0.39;287.58;9.97;1103;59;4070.00;60
10697;58;625775525;10697;293;11797;11857;6.33;0.39;287.65;9.97;1100;59;4071.00;60
10701;58;625775539;10701;292;11797;11857;6.28;0.38;287.65;9.97;1096;59;4072.00;60
10705;58;625775552;10705;292;11799;11857;6.23;0.38;287.63;9.98;1094;59;4073.00;58
10709;58;625775567;10709;296;11802;11861;6.19;0.38;287.70;9.98;1093;59;4074.00;59
10712;58;625775580;10712;295;11804;11861;6.15;0.38;287.78;10.00;1092;59;4075.00;57
10714;58;625775593;10714;300;11808;11865;6.14;0.37;287.80;10.00;1094;59;4076.00;57
10721;58;625775606;10721;303;11810;11866;6.06;0.37;287.84;10.01;1089;59;4077.00;56
10725;58;625775620;10725;309;11811;11866;6.02;0.37;287.99;10.01;1086;59;4078.00;55
10731;58;625775632;10731;316;11811;11866;5.90;0.36;288.09;10.01;1080;59;4079.00;55
10736;58;625775646;10736;319;11830;11895;5.84;0.36;288.04;9.99;1094;59;4080.00;65
10739;58;625775661;10739;309;11833;11895;5.84;0.36;288.11;10.01;1094;59;4081.00;62
10745;58;625775673;10745;312;11837;11895;5.83;0.36;288.22;10.02;1092;59;4082.00;58
10751;58;625775685;10751;316;11840;11896;5.88;0.36;288.26;10.01;1089;59;4083.00;56
10756;58;625775697;10756;315;11843;11897;5.86;0.36;288.29;10.02;1087;59;4084.00;54
10760;58;625775710;10760;315;11843;11897;5.90;0.36;288.34;10.02;1083;59;4085.00;54
10763;58;625775722;10763;318;11848;11900;5.94;0.36;288.37;10.03;1085;59;4086.00;52
10769;58;625775734;10769;322;11848;11900;5.95;0.36;288.44;10.03;1079;59;4087.00;52
10773;58;625775747;10773;311;11848;11900;6.00;0.37;288.54;10.03;1075;59;4088.00;52
10777;58;625775759;10777;313;11850;11900;6.03;0.37;288.54;10.04;1073;59;4089.00;50
10783;58;625775771;10783;317;11854;11906;6.07;0.37;288.64;10.04;1071;59;4090.00;52
10784;58;625775784;10784;315;11855;11906;6.16;0.38;288.62;10.04;1071;59;4091.00;51
10789;58;625775796;10789;309;11855;11906;6.21;0.38;288.64;10.04;1066;59;4092.00;51
10792;58;625775815;10792;313;11855;11906;6.26;0.38;288.64;10.04;1063;59;4093.00;51
10796;58;625775828;10796;317;11858;11910;6.31;0.39;288.67;10.03;1062;59;4094.00;52
10799;58;625775841;10799;316;11860;11912;6.40;0.39;288.74;10.03;1061;59;4095.00;52
10803;58;625775854;10803;317;11860;11912;6.45;0.39;288.73;10.03;1057;59;4096.00;52
10812;58;625775867;10812;319;11861;11913;6.48;0.40;288.76;10.03;1049;59;4097.00;52
10818;58;625775880;10818;315;11861;11913;6.48;0.40;288.78;10.03;1043;59;4098.00;52
10821;58;625775892;10821;319;11861;11913;6.56;0.40;288.82;10.03;1040;59;4099.00;52
10823;58;625775906;10823;315;11861;11913;6.63;0.41;288.86;10.03;1038;59;4100.00;52
10829;58;625775922;10829;317;11861;11913;6.65;0.41;288.90;10.03;1032;59;4101.00;52
10832;58;625775935;10832;317;11861;11913;6.69;0.41;288.95;10.03;1029;59;4102.00;52
10837;58;625775948;10837;317;11861;11913;6.70;0.41;288.97;10.03;1024;59;4103.00;52
10841;58;625775961;10841;329;11902;11983;6.73;0.41;288.96;10.00;1061;59;4104.00;81
10846;58;625775980;10846;322;11902;11984;6.79;0.42;288.93;10.00;1056;59;4105.00;82
10853;58;625775993;10853;319;11908;11984;6.89;0.42;289.10;9.99;1055;59;4106.00;76
10859;58;625776007;10859;322;11909;11984;6.96;0.42;289.24;9.99;1050;59;4107.00;75
10862;58;625776020;10862;326;11913;11984;7.10;0.43;289.28;9.99;1051;59;4108.00;71
10866;58;625776033;10866;331;11915;11984;7.23;0.44;289.33;9.99;1049;59;4109.00;69
10870;58;625776049;10870;333;11918;11984;7.29;0.44;289.38;9.99;1048;59;4110.00;66
10875;58;625776062;10875;332;11920;11984;7.27;0.44;289.49;9.99;1045;59;4111.00;64
10876;58;625776075;10876;340;11923;11985;7.26;0.44;289.54;9.99;1047;59;4112.00;62
10883;58;625776089;10883;345;11925;11986;7.20;0.44;289.61;9.99;1042;59;4113.00;61
10890;58;625776102;10890;343;11926;11986;7.10;0.43;289.68;9.99;1036;59;4114.00;60
10894;58;625776116;10894;349;11928;11990;7.11;0.43;289.61;9.98;1034;59;4115.00;62
10899;58;625776136;10899;351;11928;11990;7.05;0.43;289.70;9.98;1029;59;4116.00;62
10902;58;625776150;10902;352;11928;11990;7.00;0.43;289.71;9.98;1026;59;4117.00;62
10904;58;625776163;10904;363;11928;11990;6.97;0.42;289.76;9.98;1024;59;4118.00;62
10910;58;625776176;10910;363;11932;11996;6.94;0.42;289.78;9.98;1022;59;4119.00;64
10913;58;625776189;10913;364;11933;11996;6.89;0.42;289.81;9.98;1020;59;4120.00;63
10917;58;625776202;10917;367;11935;11996;6.83;0.42;289.86;9.98;1018;59;4121.00;61
10919;58;625776215;10919;372;11937;11999;6.79;0.41;289.91;9.98;1018;59;4122.00;62
10921;58;625776228;10921;380;11939;11999;6.74;0.41;289.92;9.98;1018;59;4123.00;60
10925;58;625776240;10925;392;11940;11999;6.72;0.41;289.94;9.98;1015;59;4124.00;59
10928;58;625776253;10928;398;11940;12000;6.65;0.41;289.94;9.98;1012;59;4125.00;60
10932;58;625776266;10932;410;11942;12001;6.57;0.40;289.95;10.02;1010;59;4126.00;59
10934;58;625776279;10934;404;11942;12001;6.53;0.40;289.96;10.02;1008;59;4127.00;59
10939;58;625776292;10939;402;11953;12014;6.50;0.40;289.98;10.01;1014;59;4128.00;61
10942;58;625776306;10942;403;11953;12014;6.44;0.39;289.97;10.01;1011;59;4129.00;61
10946;58;625776319;10946;399;11953;12014;6.35;0.39;289.99;10.01;1007;59;4130.00;61
10950;58;625776331;10950;398;11954;12015;6.35;0.38;289.97;10.01;1004;59;4131.00;61
10953;58;625776344;10953;402;11954;12015;6.29;0.38;289.97;10.01;1001;59;4132.00;61
10955;58;625776356;10955;407;11957;12019;6.33;0.38;290.05;10.01;1002;59;4133.00;62
10956;58;625776369;10956;407;11957;12019;6.35;0.39;290.08;10.01;1001;59;4134.00;62
10957;58;625776381;10957;406;11961;12023;6.37;0.39;290.06;10.01;1004;59;4135.00;62
10960;58;625776399;10960;399;11961;12023;6.36;0.39;290.09;10.01;1001;59;4136.00;62
10967;58;625776417;10967;393;11961;12023;6.33;0.38;290.20;10.01;994;59;4137.00;62
10972;58;625776430;10972;389;11961;12023;6.30;0.38;290.29;10.01;989;59;4138.00;62
10974;58;625776443;10974;380;11961;12023;6.31;0.38;290.33;10.01;987;59;4139.00;62
10975;58;625776457;10975;378;11985;12057;6.34;0.39;290.32;9.99;1010;59;4140.00;72
10976;58;625776472;10976;375;11986;12057;6.34;0.39;290.31;9.99;1010;59;4141.00;71
10978;58;625776485;10978;367;11987;12057;6.37;0.39;290.28;9.99;1009;59;4142.00;70
10981;58;625776497;10981;367;11987;12057;6.37;0.39;290.26;9.99;1006;59;4143.00;70
10981;58;625776509;10981;360;11988;12057;6.41;0.39;290.26;9.99;1007;59;4144.00;69
10983;58;625776522;10983;364;11988;12057;6.45;0.39;290.25;9.99;1005;59;4145.00;69
10985;58;625776534;10985;353;11989;12058;6.50;0.40;290.21;9.98;1004;59;4146.00;69
10988;58;625776548;10988;340;11989;12058;6.52;0.40;290.17;9.98;1001;59;4147.00;69
10989;58;625776567;10989;337;11993;12064;6.56;0.40;290.16;9.98;1004;59;4148.00;71
10992;58;625776586;10992;340;11994;12065;6.58;0.40;290.11;9.98;1002;59;4149.00;71
10995;58;625776608;10995;338;11995;12065;6.58;0.40;290.15;9.98;1000;59;4150.00;70
10997;58;625776627;10997;343;11995;12065;6.54;0.40;290.11;9.98;998;59;4151.00;70
10998;58;625776656;10998;347;11999;12069;6.52;0.40;290.19;9.98;1001;59;4152.00;70
11001;58;625776672;11001;347;11999;12069;6.42;0.39;290.14;9.98;998;59;4153.00;70
11005;58;625776687;11005;353;11999;12069;6.29;0.38;290.14;9.98;994;59;4154.00;70
11008;58;625776700;11008;350;12000;12070;6.23;0.38;290.09;9.98;992;59;4155.00;70
11011;58;625776715;11011;355;12003;12074;6.12;0.37;290.06;9.98;992;59;4156.00;71
11012;58;625776729;11012;355;12003;12074;6.04;0.37;290.05;9.98;991;59;4157.00;71
11015;58;625776743;11015;359;12005;12077;6.02;0.37;289.99;9.97;990;59;4158.00;72
11016;58;625776757;11016;362;12005;12077;5.94;0.36;289.97;9.97;989;59;4159.00;72
11017;58;625776771;11017;362;12007;12077;5.93;0.36;289.96;10.02;990;59;4160.00;70
11018;58;625776790;11018;366;12007;12077;5.90;0.36;290.01;10.02;989;59;4161.00;70
11018;58;625776802;11018;373;12010;12081;5.86;0.36;290.01;10.02;992;59;4162.00;71
11020;58;625776814;11020;376;12010;12081;5.80;0.35;290.00;10.02;990;59;4163.00;71
11021;58;625776826;11021;376;12011;12081;5.75;0.35;289.99;10.02;990;59;4164.00;70
11022;58;625776838;11022;374;12011;12081;5.71;0.35;290.07;10.02;989;59;4165.00;70
11024;58;625776851;11024;379;12011;12082;5.68;0.35;290.05;10.02;987;59;4166.00;71
11024;58;625776863;11024;376;12012;12083;5.63;0.34;290.05;10.02;988;59;4167.00;71
11024;58;625776875;11024;383;12012;12083;5.55;0.34;290.05;10.02;988;59;4168.00;71
11025;58;625776887;11025;383;12013;12084;5.45;0.33;290.03;10.01;988;59;4169.00;71
11025;58;625776901;11025;382;12013;12084;5.41;0.33;290.03;10.01;988;59;4170.00;71
11027;58;625776919;11027;359;12013;12084;5.37;0.33;290.03;10.01;986;59;4171.00;71
11029;58;625776932;11029;345;12013;12084;5.35;0.33;290.03;10.01;984;59;4172.00;71
11029;58;625776944;11029;330;12015;12086;5.37;0.33;290.03;10.01;986;59;4173.00;71
11031;58;625776957;11031;320;12015;12086;5.39;0.33;290.09;10.01;984;59;4174.00;71
11033;58;625776971;11033;304;12015;12086;5.43;0.33;290.09;10.01;982;59;4175.00;71
11037;58;625776984;11037;321;12084;12213;5.59;0.35;290.09;9.96;1047;59;4176.00;129
11039;58;625777011;11039;297;12085;12214;5.64;0.35;290.09;9.96;1046;59;4177.00;129
11043;58;625777031;11043;273;12091;12214;5.71;0.35;290.08;10.00;1048;59;4178.00;123
11046;58;625777045;11046;265;12096;12214;5.81;0.36;290.06;10.00;1050;59;4179.00;118
11048;58;625777058;11048;261;12100;12214;5.92;0.36;290.05;9.99;1052;59;4180.00;114
11049;58;625777071;11049;255;12106;12214;6.01;0.37;290.02;9.99;1057;59;4181.00;108
11051;58;625777085;11051;239;12108;12214;6.10;0.38;290.00;9.99;1057;59;4182.00;106
11056;58;625777099;11056;236;12111;12214;6.17;0.38;290.05;9.99;1055;59;4183.00;103
11057;58;625777118;11057;236;12112;12215;6.27;0.38;290.04;9.99;1055;59;4184.00;103
11060;58;625777132;11060;232;12119;12217;6.35;0.39;290.03;10.01;1059;59;4185.00;98
11060;58;625777148;11060;228;12121;12217;6.41;0.39;290.03;10.01;1061;59;4186.00;96
11065;58;625777161;11065;229;12125;12218;6.48;0.40;290.01;10.01;1060;59;4187.00;93
11067;58;625777176;11067;218;12127;12218;6.54;0.40;290.02;10.01;1060;59;4188.00;91
11068;58;625777190;11068;222;12128;12218;6.58;0.40;290.01;10.01;1060;59;4189.00;90
11069;58;625777203;11069;218;12130;12218;6.60;0.40;290.06;10.06;1061;59;4190.00;88
11071;58;625777217;11071;213;12133;12222;6.64;0.41;290.04;10.06;1062;59;4191.00;89
11074;58;625777232;11074;214;12134;12222;6.60;0.40;290.10;10.06;1060;59;4192.00;88
11077;58;625777246;11077;208;12136;12222;6.59;0.40;290.14;10.06;1059;59;4193.00;86
11080;58;625777261;11080;210;12139;12225;6.67;0.41;290.16;10.11;1059;59;4194.00;86
11081;58;625777275;11081;213;12140;12225;6.74;0.41;290.18;10.11;1059;59;4195.00;85
11086;58;625777289;11086;216;12140;12225;6.77;0.41;290.20;10.11;1054;59;4196.00;85
11088;58;625777303;11088;211;12145;12229;6.82;0.42;290.17;10.10;1057;59;4197.00;84
11092;58;625777318;11092;206;12147;12230;6.89;0.42;290.22;10.15;1055;59;4198.00;83
11095;58;625777334;11095;203;12148;12230;6.95;0.42;290.25;10.15;1053;59;4199.00;82
11097;58;625777351;11097;210;12159;12264;7.00;0.43;290.25;10.20;1062;59;4200.00;105
11102;58;625777372;11102;211;12160;12264;7.01;0.43;290.23;10.20;1058;59;4201.00;104
11106;58;625777387;11106;208;12164;12264;7.02;0.43;290.29;10.20;1058;59;4202.00;100
11107;58;625777402;11107;208;12165;12265;7.09;0.43;290.30;10.20;1058;59;4203.00;100
11111;58;625777417;11111;204;12165;12265;7.12;0.43;290.34;10.20;1054;59;4204.00;100
11112;58;625777431;11112;211;12169;12271;7.20;0.44;290.34;10.20;1057;59;4205.00;102
11113;58;625777446;11113;207;12170;12271;7.25;0.44;290.35;10.19;1057;59;4206.00;101
11116;58;625777462;11116;212;12172;12272;7.28;0.44;290.33;10.19;1056;59;4207.00;100
11117;58;625777477;11117;217;12173;12272;7.33;0.44;290.38;10.19;1056;59;4208.00;99
11118;58;625777492;11118;220;12174;12272;7.36;0.45;290.41;10.21;1056;59;4209.00;98
11120;58;625777507;11120;217;12175;12272;7.37;0.45;290.46;10.22;1055;59;4210.00;97
11124;58;625777522;11124;222;12175;12272;7.39;0.45;290.51;10.22;1051;59;4211.00;97
11124;58;625777539;11124;229;12185;12284;7.51;0.46;290.51;10.22;1061;59;4212.00;99
11126;58;625777563;11126;231;12190;12284;7.54;0.46;290.59;10.24;1064;59;4213.00;94
11130;58;625777579;11130;229;12190;12284;7.60;0.46;290.63;10.24;1060;59;4214.00;94
11133;58;625777596;11133;232;12192;12284;7.62;0.46;290.63;10.27;1059;59;4215.00;92
11136;58;625777611;11136;232;12192;12284;7.64;0.46;290.67;10.27;1056;59;4216.00;92
11139;58;625777627;11139;227;12194;12284;7.69;0.47;290.68;10.29;1055;59;4217.00;90
11141;58;625777643;11141;232;12200;12288;7.67;0.47;290.71;10.30;1059;59;4218.00;88
11145;58;625777658;11145;229;12202;12288;7.67;0.47;290.79;10.32;1057;59;4219.00;86
11147;58;625777679;11147;234;12205;12292;7.68;0.47;290.86;10.33;1058;59;4220.00;87
11152;58;625777694;11152;234;12207;12293;7.63;0.46;290.86;10.34;1055;59;4221.00;86
11157;58;625777710;11157;233;12208;12293;7.55;0.46;290.91;10.35;1051;59;4222.00;85
11159;58;625777725;11159;239;12209;12293;7.51;0.46;290.89;10.36;1050;59;4223.00;84
11162;58;625777740;11162;244;12218;12306;7.46;0.46;290.95;10.35;1056;59;4224.00;88
11166;58;625777756;11166;247;12221;12306;7.40;0.45;291.03;10.38;1055;59;4225.00;85
11168;58;625777771;11168;253;12221;12306;7.33;0.45;291.06;10.38;1053;59;4226.00;85
11172;58;625777784;11172;253;12224;12307;7.30;0.45;291.13;10.39;1052;59;4227.00;83
11176;58;625777798;11176;263;12224;12308;7.26;0.44;291.16;10.39;1048;59;4228.00;84
11177;58;625777813;11177;267;12226;12308;7.27;0.44;291.21;10.41;1049;59;4229.00;82
11180;58;625777829;11180;268;12232;12314;7.27;0.44;291.21;10.42;1052;59;4230.00;82
11183;58;625777844;11183;267;12234;12314;7.27;0.44;291.25;10.43;1051;59;4231.00;80
11184;58;625777858;11184;267;12235;12314;7.29;0.44;291.23;10.43;1051;59;4232.00;79
11187;58;625777872;11187;268;12236;12314;7.28;0.44;291.31;10.44;1049;59;4233.00;78
11190;58;625777885;11190;269;12240;12320;7.31;0.45;291.33;10.44;1050;59;4234.00;80
11191;58;625777900;11191;274;12241;12320;7.30;0.45;291.33;10.45;1050;59;4235.00;79
11194;58;625777914;11194;282;12241;12320;7.30;0.45;291.41;10.45;1047;59;4236.00;79
11197;58;625777928;11197;282;12244;12320;7.24;0.44;291.43;10.47;1047;59;4237.00;76
11198;58;625777942;11198;290;12247;12324;7.17;0.44;291.42;10.46;1049;59;4238.00;77
11200;58;625777956;11200;292;12249;12325;7.10;0.43;291.49;10.47;1049;59;4239.00;76
11205;58;625777971;11205;294;12250;12325;7.06;0.43;291.51;10.48;1045;59;4240.00;75
11207;58;625777985;11207;303;12252;12326;7.04;0.43;291.51;10.48;1045;59;4241.00;74
11212;58;625777999;11212;306;12253;12326;6.95;0.42;291.57;10.49;1041;59;4242.00;73
11213;58;625778012;11213;304;12255;12326;6.93;0.42;291.55;10.50;1042;59;4243.00;71
11216;58;625778026;11216;306;12255;12326;6.86;0.42;291.59;10.50;1039;59;4244.00;71
11219;58;625778045;11219;311;12257;12326;6.77;0.41;291.59;10.51;1038;59;4245.00;69
11224;58;625778061;11224;303;12259;12326;6.64;0.41;291.62;10.52;1035;59;4246.00;67
11232;58;625778077;11232;304;12260;12326;6.47;0.40;291.61;10.52;1028;59;4247.00;66
11234;58;625778095;11234;317;12298;12396;6.36;0.39;291.64;10.51;1064;59;4248.00;98
11239;58;625778117;11239;318;12299;12397;6.26;0.38;291.78;10.51;1060;59;4249.00;98
11242;58;625778132;11242;313;12305;12397;6.20;0.38;291.79;10.51;1063;59;4250.00;92
11247;58;625778147;11247;307;12308;12397;6.09;0.37;291.84;10.51;1061;59;4251.00;89
11250;58;625778170;11250;308;12313;12397;6.07;0.37;291.83;10.52;1063;59;4252.00;84
11255;58;625778185;11255;308;12315;12397;6.03;0.37;291.89;10.52;1060;59;4253.00;82
11258;58;625778203;11258;314;12324;12397;6.02;0.37;291.94;10.53;1066;59;4254.00;73
11261;58;625778222;11261;321;12328;12397;6.03;0.37;291.99;10.54;1067;59;4255.00;69
11267;58;625778242;11267;317;12331;12398;6.03;0.37;291.99;10.54;1064;59;4256.00;67
11271;58;625778265;11271;316;12335;12399;6.05;0.37;292.02;10.54;1064;59;4257.00;64
11277;58;625778284;11277;314;12339;12399;6.07;0.37;292.10;10.54;1062;59;4258.00;60
11279;58;625778301;11279;319;12342;12403;6.13;0.37;292.13;10.54;1063;59;4259.00;61
11281;58;625778319;11281;323;12343;12403;6.16;0.38;292.11;10.54;1062;59;4260.00;60
11285;58;625778337;11285;322;12345;12403;6.17;0.38;292.13;10.54;1060;59;4261.00;58
11290;58;625778361;11290;321;12345;12403;6.16;0.38;292.31;10.54;1055;59;4262.00;58
11291;58;625778381;11291;324;12348;12409;6.14;0.38;292.32;10.54;1057;59;4263.00;61
11296;58;625778397;11296;328;12349;12409;6.17;0.38;292.38;10.54;1053;59;4264.00;60
11300;58;625778411;11300;321;12349;12409;6.16;0.38;292.40;10.54;1049;59;4265.00;60
11306;58;625778430;11306;321;12352;12412;6.20;0.38;292.44;10.54;1046;59;4266.00;60
11312;58;625778444;11312;322;12353;12412;6.24;0.38;292.47;10.54;1041;59;4267.00;59
11316;58;625778458;11316;322;12355;12412;6.22;0.38;292.46;10.54;1039;59;4268.00;57
11322;58;625778473;11322;311;12356;12413;6.24;0.38;292.55;10.54;1034;59;4269.00;57
11324;59;625778488;11324;315;12358;12414;6.27;0.38;292.55;10.54;1034;60;4270.00;56
11326;59;625778519;11326;310;12359;12414;6.30;0.39;292.59;10.54;1033;60;4271.00;55
11330;59;625778535;11330;318;12371;12427;6.33;0.39;292.55;10.53;1041;60;4272.00;56
11335;59;625778555;11335;319;12371;12427;6.33;0.39;292.53;10.53;1036;60;4273.00;56
11338;59;625778583;11338;324;12372;12427;6.33;0.39;292.54;10.53;1034;60;4274.00;55
11347;59;625778606;11347;332;12374;12429;6.34;0.39;292.55;10.53;1027;60;4275.00;55
11350;59;625778627;11350;332;12374;12429;6.39;0.39;292.58;10.53;1024;60;4276.00;55
11356;59;625778647;11356;335;12378;12433;6.35;0.39;292.62;10.53;1022;60;4277.00;55
11359;59;625778673;11359;339;12378;12433;6.36;0.39;292.60;10.53;1019;60;4278.00;55
11362;59;625778690;11362;341;12381;12437;6.34;0.39;292.67;10.52;1019;60;4279.00;56
11367;59;625778705;11367;343;12381;12437;6.33;0.39;292.65;10.52;1014;60;4280.00;56
11372;59;625778720;11372;346;12381;12437;6.33;0.39;292.74;10.52;1009;60;4281.00;56
11378;59;625778735;11378;345;12382;12437;6.27;0.38;292.72;10.57;1004;60;4282.00;55
11380;59;625778750;11380;350;12382;12437;6.26;0.38;292.71;10.57;1002;60;4283.00;55
11384;59;625778763;11384;356;12391;12449;6.31;0.38;292.84;10.57;1007;60;4284.00;58
11384;59;625778777;11384;360;12392;12449;6.29;0.38;292.84;10.56;1008;60;4285.00;57
11387;60;625778790;11387;365;12393;12449;6.30;0.38;292.92;10.56;1006;61;4286.00;56
11390;60;625778818;11390;378;12393;12449;6.28;0.38;292.89;10.56;1003;61;4287.00;56
11391;60;625778832;11391;383;12394;12449;6.29;0.38;292.88;10.61;1003;61;4288.00;55
11394;60;625778845;11394;389;12394;12449;6.28;0.38;292.86;10.61;1000;61;4289.00;55
11396;60;625778859;11396;398;12394;12450;6.23;0.38;292.91;10.61;998;61;4290.00;56
11400;60;625778871;11400;407;12394;12450;6.18;0.38;292.89;10.61;994;61;4291.00;56
11402;60;625778883;11402;413;12398;12456;6.13;0.37;292.87;10.60;996;61;4292.00;58
11404;60;625778896;11404;422;12400;12457;6.08;0.37;292.85;10.60;996;61;4293.00;57
11406;60;625778909;11406;427;12400;12457;6.01;0.37;292.81;10.60;994;61;4294.00;57
11410;60;625778923;11410;436;12400;12457;5.93;0.36;292.76;10.60;990;61;4295.00;57
11411;60;625778937;11411;445;12403;12461;5.90;0.36;292.77;10.60;992;61;4296.00;58
11413;60;625778950;11413;441;12403;12461;5.87;0.36;292.75;10.60;990;61;4297.00;58
11415;60;625778963;11415;443;12403;12461;5.87;0.36;292.74;10.60;988;61;4298.00;58
11417;60;625778984;11417;442;12404;12462;5.92;0.36;292.71;10.60;987;61;4299.00;58
11419;60;625779004;11419;441;12407;12466;5.99;0.37;292.69;10.60;988;61;4300.00;59
11420;60;625779024;11420;441;12407;12466;6.00;0.37;292.68;10.60;987;61;4301.00;59
11424;60;625779039;11424;444;12409;12469;6.04;0.37;292.74;10.59;985;61;4302.00;60
11428;60;625779052;11428;445;12410;12469;6.03;0.37;292.73;10.59;982;61;4303.00;59
11429;60;625779067;11429;449;12410;12469;6.05;0.37;292.71;10.59;981;61;4304.00;59
11434;60;625779080;11434;448;12410;12469;6.01;0.37;292.70;10.59;976;61;4305.00;59
11438;60;625779094;11438;437;12413;12473;5.95;0.36;292.64;10.59;975;61;4306.00;60
11439;60;625779108;11439;426;12413;12473;5.95;0.36;292.63;10.59;974;61;4307.00;60
11442;60;625779122;11442;413;12414;12473;5.99;0.37;292.58;10.59;972;61;4308.00;59
11444;60;625779144;11444;404;12414;12473;6.00;0.37;292.57;10.59;970;61;4309.00;59
11447;60;625779159;11447;393;12414;12474;6.06;0.37;292.62;10.59;967;61;4310.00;60
11448;60;625779173;11448;386;12415;12475;6.13;0.37;292.62;10.59;967;61;4311.00;60
11453;60;625779187;11453;379;12415;12475;6.14;0.37;292.58;10.59;962;61;4312.00;60
11454;60;625779201;11454;369;12416;12476;6.22;0.38;292.59;10.59;962;61;4313.00;60
11456;60;625779220;11456;368;12416;12476;6.20;0.38;292.57;10.59;960;61;4314.00;60
11458;60;625779233;11458;365;12416;12476;6.22;0.38;292.54;10.59;958;61;4315.00;60
11460;60;625779246;11460;371;12416;12476;6.24;0.38;292.54;10.59;956;61;4316.00;60
11460;60;625779260;11460;369;12416;12476;6.29;0.38;292.54;10.59;956;61;4317.00;60
11460;60;625779274;11460;366;12416;12476;6.34;0.39;292.54;10.59;956;61;4318.00;60
11460;60;625779288;11460;362;12417;12476;6.38;0.39;292.54;10.63;957;61;4319.00;59
11461;60;625779303;11461;408;12530;12706;6.51;0.41;292.53;10.54;1069;61;4320.00;176
11462;60;625779338;11462;402;12533;12707;6.47;0.40;292.52;10.54;1071;61;4321.00;174
11464;60;625779355;11464;379;12541;12707;6.48;0.40;292.51;10.53;1077;61;4322.00;166
11464;60;625779372;11464;360;12546;12707;6.48;0.41;292.51;10.53;1082;61;4323.00;161
11465;60;625779388;11465;352;12552;12707;6.45;0.40;292.49;10.53;1087;61;4324.00;155
11470;60;625779405;11470;339;12557;12707;6.40;0.40;292.53;10.52;1087;61;4325.00;150
11472;60;625779426;11472;335;12563;12707;6.40;0.40;292.55;10.52;1091;61;4326.00;144
11472;60;625779448;11472;335;12568;12707;6.41;0.40;292.55;10.52;1096;61;4327.00;139
11472;60;625779475;11472;334;12573;12708;6.44;0.40;292.55;10.52;1101;61;4328.00;135
11475;60;625779492;11475;330;12576;12709;6.45;0.40;292.56;10.52;1101;61;4329.00;133
11477;60;625779509;11477;338;12579;12709;6.48;0.41;292.59;10.52;1102;61;4330.00;130
11478;60;625779526;11478;340;12584;12710;6.51;0.41;292.58;10.52;1106;61;4331.00;126
11480;60;625779541;11480;345;12587;12710;6.51;0.41;292.67;10.52;1107;61;4332.00;123
11482;60;625779568;11482;352;12588;12710;6.49;0.40;292.65;10.52;1106;61;4333.00;122
11484;60;625779584;11484;357;12591;12710;6.46;0.40;292.67;10.52;1107;61;4334.00;119
11486;60;625779607;11486;362;12595;12714;6.40;0.40;292.66;10.56;1109;61;4335.00;119
11488;60;625779628;11488;368;12599;12714;6.39;0.40;292.65;10.56;1111;61;4336.00;115
11489;60;625779644;11489;372;12602;12714;6.35;0.39;292.67;10.56;1113;61;4337.00;112
11490;60;625779659;11490;372;12604;12717;6.32;0.39;292.67;10.56;1114;61;4338.00;113
11491;60;625779675;11491;377;12607;12717;6.27;0.39;292.66;10.56;1116;61;4339.00;110
11492;60;625779693;11492;379;12608;12717;6.24;0.38;292.65;10.56;1116;61;4340.00;109
11495;60;625779711;11495;374;12612;12721;6.23;0.38;292.63;10.56;1117;61;4341.00;109
11498;60;625779728;11498;380;12614;12722;6.21;0.38;292.59;10.56;1116;61;4342.00;108
11501;60;625779749;11501;380;12616;12722;6.21;0.38;292.58;10.61;1115;61;4343.00;106
11502;60;625779764;11502;378;12618;12726;6.26;0.38;292.56;10.61;1116;61;4344.00;108
11506;60;625779785;11506;373;12619;12726;6.26;0.38;292.62;10.61;1113;61;4345.00;107
11509;60;625779801;11509;374;12621;12726;6.21;0.38;292.67;10.65;1112;61;4346.00;105
11511;60;625779815;11511;365;12622;12727;6.23;0.38;292.67;10.65;1111;61;4347.00;105
11512;60;625779829;11512;361;12622;12727;6.24;0.38;292.73;10.65;1110;61;4348.00;105
11515;60;625779843;11515;354;12625;12733;6.24;0.38;292.77;10.64;1110;61;4349.00;108
11518;60;625779862;11518;344;12626;12733;6.24;0.38;292.76;10.68;1108;61;4350.00;107
11523;60;625779876;11523;342;12627;12734;6.17;0.38;292.80;10.68;1104;61;4351.00;107
11526;60;625779891;11526;338;12628;12734;6.12;0.37;292.79;10.72;1102;61;4352.00;106
11529;60;625779905;11529;334;12629;12734;6.10;0.37;292.85;10.72;1100;61;4353.00;105
11532;60;625779919;11532;327;12631;12734;6.08;0.37;292.89;10.76;1099;61;4354.00;103
11534;60;625779933;11534;323;12633;12734;6.07;0.37;292.95;10.79;1099;61;4355.00;101
11538;60;625779949;11538;327;12643;12746;6.14;0.37;292.92;10.81;1105;61;4356.00;103
11541;60;625779964;11541;315;12644;12746;6.15;0.37;292.96;10.81;1103;61;4357.00;102
11544;60;625779979;11544;313;12645;12746;6.20;0.38;293.00;10.81;1101;61;4358.00;101
11548;60;625779994;11548;298;12645;12746;6.26;0.38;292.98;10.81;1097;61;4359.00;101
11550;60;625780008;11550;293;12646;12746;6.33;0.39;292.99;10.84;1096;61;4360.00;100
11552;60;625780023;11552;285;12647;12746;6.36;0.39;293.01;10.86;1095;61;4361.00;99
11555;60;625780039;11555;272;12650;12750;6.41;0.39;293.04;10.85;1095;61;4362.00;100
11558;60;625780056;11558;272;12650;12750;6.48;0.39;293.06;10.85;1092;61;4363.00;100
11563;60;625780073;11563;265;12653;12754;6.55;0.40;293.10;10.88;1090;61;4364.00;101
11564;60;625780094;11564;261;12655;12756;6.69;0.40;293.10;10.88;1091;61;4365.00;101
11565;60;625780118;11565;258;12656;12756;6.77;0.41;293.14;10.88;1091;61;4366.00;100
11565;60;625780133;11565;259;12658;12756;6.81;0.41;293.14;10.88;1093;61;4367.00;98
11569;60;625780147;11569;259;12667;12769;6.86;0.42;293.29;10.87;1098;61;4368.00;102
11573;60;625780165;11573;257;12668;12769;6.90;0.42;293.31;10.91;1095;61;4369.00;101
11576;60;625780181;11576;260;12669;12769;6.95;0.42;293.37;10.91;1093;61;4370.00;100
11577;60;625780197;11577;261;12670;12770;7.01;0.43;293.36;10.91;1093;61;4371.00;100
11580;60;625780214;11580;257;12670;12771;7.09;0.43;293.46;10.91;1090;61;4372.00;101
11581;60;625780231;11581;260;12671;12771;7.18;0.43;293.46;10.91;1090;61;4373.00;100
11582;60;625780251;11582;256;12673;12774;7.27;0.44;293.50;10.91;1091;61;4374.00;101
11583;60;625780267;11583;254;12674;12774;7.38;0.45;293.54;10.91;1091;61;4375.00;100
11586;60;625780282;11586;260;12675;12774;7.46;0.45;293.62;10.91;1089;61;4376.00;99
11588;60;625780298;11588;262;12675;12774;7.53;0.46;293.67;10.91;1087;61;4377.00;99
11590;60;625780314;11590;260;12680;12780;7.64;0.46;293.68;10.91;1090;61;4378.00;100
11594;60;625780330;11594;259;12681;12780;7.67;0.47;293.75;10.91;1087;61;4379.00;99
11598;60;625780349;11598;261;12683;12780;7.65;0.46;293.75;10.93;1085;61;4380.00;97
11601;60;625780365;11601;264;12683;12780;7.65;0.46;293.76;10.93;1082;61;4381.00;97
11606;60;625780382;11606;264;12688;12784;7.57;0.46;293.79;10.94;1082;61;4382.00;96
11609;60;625780398;11609;269;12690;12785;7.56;0.46;293.85;10.96;1081;61;4383.00;95
11610;60;625780415;11610;280;12693;12785;7.55;0.46;293.92;10.98;1083;61;4384.00;92
11612;60;625780431;11612;289;12695;12786;7.56;0.46;293.94;10.99;1083;61;4385.00;91
11613;60;625780447;11613;289;12696;12786;7.55;0.46;293.97;11.00;1083;61;4386.00;90
11616;60;625780463;11616;293;12697;12786;7.55;0.46;293.96;11.00;1081;61;4387.00;89
11619;60;625780479;11619;296;12701;12786;7.57;0.46;294.01;11.04;1082;61;4388.00;85
11621;60;625780497;11621;297;12701;12786;7.59;0.46;294.02;11.04;1080;61;4389.00;85
11624;60;625780514;11624;299;12703;12786;7.60;0.46;294.04;11.05;1079;61;4390.00;83
11626;60;625780530;11626;299;12705;12786;7.57;0.46;294.12;11.07;1079;61;4391.00;81
11629;60;625780548;11629;309;12743;12856;7.66;0.47;294.11;11.06;1114;61;4392.00;113
11632;60;625780583;11632;316;12747;12857;7.68;0.47;294.11;11.08;1115;61;4393.00;110
11636;60;625780610;11636;319;12756;12857;7.70;0.47;294.18;11.08;1120;61;4394.00;101
11643;60;625780638;11643;319;12758;12857;7.61;0.47;294.24;11.08;1115;61;4395.00;99
11647;60;625780661;11647;322;12764;12857;7.58;0.46;294.34;11.09;1117;61;4396.00;93
11649;60;625780684;11649;332;12767;12857;7.52;0.46;294.40;11.09;1118;61;4397.00;90
11656;60;625780702;11656;332;12772;12857;7.44;0.45;294.41;11.11;1116;61;4398.00;85
11660;60;625780723;11660;331;12775;12857;7.42;0.45;294.40;11.11;1115;61;4399.00;82
11660;60;625780745;11660;326;12779;12858;7.45;0.46;294.40;11.12;1119;61;4400.00;79
11665;60;625780774;11665;320;12783;12859;7.44;0.45;294.52;11.12;1118;61;4401.00;76
11668;60;625780797;11668;319;12787;12859;7.39;0.45;294.53;11.13;1119;61;4402.00;72
11671;60;625780820;11671;316;12790;12863;7.32;0.45;294.54;11.14;1119;61;4403.00;73
11674;60;625780841;11674;317;12791;12863;7.24;0.44;294.65;11.15;1117;61;4404.00;72
11676;60;625780860;11676;320;12791;12863;7.21;0.44;294.65;11.15;1115;61;4405.00;72
11678;60;625780879;11678;326;12792;12863;7.21;0.44;294.68;11.15;1114;61;4406.00;71
11683;60;625780900;11683;326;12797;12869;7.18;0.44;294.85;11.16;1114;61;4407.00;72
11683;60;625780920;11683;334;12798;12869;7.18;0.44;294.85;11.16;1115;61;4408.00;71
11686;60;625780939;11686;341;12799;12869;7.14;0.44;294.88;11.16;1113;61;4409.00;70
11687;60;625780958;11687;341;12806;12875;7.14;0.44;294.88;11.17;1119;61;4410.00;69
11692;60;625780978;11692;352;12807;12875;7.10;0.43;294.96;11.17;1115;61;4411.00;68
11693;60;625780995;11693;349;12808;12875;7.04;0.43;294.98;11.18;1115;61;4412.00;67
11698;60;625781013;11698;349;12809;12876;6.93;0.42;295.06;11.18;1111;61;4413.00;67
11702;60;625781036;11702;355;12810;12877;6.82;0.42;295.05;11.18;1108;61;4414.00;67
11706;60;625781055;11706;363;12811;12877;6.73;0.41;295.01;11.19;1105;61;4415.00;66
11709;60;625781073;11709;374;12823;12890;6.62;0.40;295.00;11.18;1114;61;4416.00;67
11713;60;625781094;11713;377;12824;12890;6.47;0.39;295.01;11.19;1111;61;4417.00;66
11714;60;625781111;11714;385;12824;12890;6.36;0.39;295.03;11.19;1110;61;4418.00;66
11718;60;625781128;11718;394;12826;12891;6.27;0.38;295.13;11.19;1108;61;4419.00;65
11721;60;625781146;11721;385;12827;12891;6.17;0.38;295.19;11.20;1106;61;4420.00;64
11724;60;625781163;11724;385;12831;12895;6.13;0.37;295.24;11.19;1107;61;4421.00;64
11728;60;625781179;11728;384;12832;12895;6.09;0.37;295.22;11.20;1104;61;4422.00;63
11729;60;625781196;11729;383;12835;12899;6.08;0.37;295.23;11.20;1106;61;4423.00;64
11734;60;625781213;11734;374;12836;12899;6.02;0.37;295.20;11.20;1102;61;4424.00;63
11738;60;625781231;11738;372;12839;12899;5.99;0.37;295.19;11.22;1101;61;4425.00;60
11743;60;625781256;11743;372;12840;12899;5.97;0.36;295.25;11.22;1097;61;4426.00;59
11749;60;625781273;11749;369;12840;12899;5.92;0.36;295.31;11.22;1091;61;4427.00;59
11750;60;625781290;11750;371;12851;12911;5.98;0.37;295.33;11.22;1101;61;4428.00;60
11755;60;625781310;11755;371;12852;12911;5.95;0.36;295.35;11.22;1097;61;4429.00;59
11756;60;625781326;11756;365;12854;12911;5.96;0.37;295.37;11.22;1098;61;4430.00;57
11759;60;625781346;11759;366;12855;12911;5.94;0.36;295.37;11.25;1096;61;4431.00;56
11762;60;625781362;11762;362;12855;12911;5.98;0.37;295.35;11.25;1093;61;4432.00;56
11764;60;625781377;11764;363;12855;12911;5.98;0.37;295.34;11.25;1091;61;4433.00;56
11769;60;625781393;11769;374;12855;12912;5.98;0.37;295.36;11.25;1086;61;4434.00;57
11770;60;625781408;11770;371;12855;12912;6.05;0.37;295.35;11.25;1085;61;4435.00;57
11777;60;625781423;11777;370;12859;12918;6.11;0.37;295.35;11.25;1082;61;4436.00;59
11779;60;625781438;11779;372;12860;12919;6.15;0.38;295.38;11.25;1081;61;4437.00;59
11785;60;625781453;11785;379;12861;12919;6.18;0.38;295.39;11.25;1076;61;4438.00;58
11789;60;625781473;11789;377;12861;12919;6.21;0.38;295.36;11.25;1072;61;4439.00;58
11790;60;625781489;11790;389;12865;12924;6.24;0.38;295.37;11.25;1075;61;4440.00;59
11793;60;625781505;11793;388;12865;12924;6.27;0.38;295.37;11.25;1072;61;4441.00;59
11795;60;625781521;11795;390;12865;12924;6.27;0.38;295.40;11.25;1070;61;4442.00;59
11803;60;625781536;11803;385;12866;12925;6.27;0.38;295.40;11.24;1063;61;4443.00;59
11808;60;625781557;11808;389;12869;12929;6.22;0.38;295.38;11.24;1061;61;4444.00;60
11814;60;625781579;11814;392;12869;12929;6.14;0.37;295.34;11.24;1055;61;4445.00;60
11818;60;625781599;11818;400;12871;12932;6.12;0.37;295.31;11.24;1053;61;4446.00;61
11822;60;625781617;11822;398;12871;12932;6.08;0.37;295.34;11.24;1049;61;4447.00;61
11828;60;625781631;11828;407;12872;12932;6.04;0.37;295.34;11.24;1044;61;4448.00;60
11830;60;625781644;11830;411;12872;12932;5.99;0.37;295.34;11.24;1042;61;4449.00;60
11833;60;625781657;11833;413;12875;12936;6.00;0.37;295.31;11.24;1042;61;4450.00;61
11840;60;625781670;11840;418;12875;12936;5.95;0.36;295.34;11.24;1035;61;4451.00;61
11842;60;625781683;11842;425;12876;12936;5.95;0.36;295.35;11.24;1034;61;4452.00;60
11845;60;625781695;11845;427;12876;12936;5.93;0.36;295.30;11.24;1031;61;4453.00;60
11852;60;625781707;11852;431;12876;12937;5.88;0.36;295.23;11.24;1024;61;4454.00;61
11854;60;625781720;11854;436;12878;12939;5.89;0.36;295.22;11.23;1024;61;4455.00;61
11861;60;625781732;11861;434;12878;12939;5.83;0.36;295.12;11.23;1017;61;4456.00;61
11864;60;625781745;11864;436;12879;12940;5.82;0.36;295.10;11.23;1015;61;4457.00;61
11866;60;625781758;11866;440;12879;12940;5.82;0.36;295.10;11.23;1013;61;4458.00;61
11871;60;625781770;11871;440;12879;12940;5.76;0.35;295.08;11.23;1008;61;4459.00;61
11873;60;625781786;11873;447;12879;12940;5.75;0.35;295.05;11.23;1006;61;4460.00;61
11876;60;625781798;11876;450;12880;12940;5.71;0.35;295.10;11.27;1004;61;4461.00;60
11878;60;625781810;11878;456;12880;12940;5.63;0.34;295.08;11.27;1002;61;4462.00;60
11880;60;625781822;11880;458;12880;12940;5.57;0.34;295.04;11.27;1000;61;4463.00;60
11883;60;625781834;11883;473;12946;13067;5.94;0.37;295.02;11.21;1063;61;4464.00;121
11885;60;625781856;11885;475;12948;13068;5.91;0.36;294.99;11.21;1063;61;4465.00;120
11888;60;625781869;11888;480;12958;13068;5.94;0.37;294.99;11.21;1070;61;4466.00;110
11888;60;625781881;11888;469;12961;13068;5.97;0.37;294.99;11.20;1073;61;4467.00;107
11890;60;625781894;11890;464;12966;13068;6.01;0.37;294.98;11.20;1076;61;4468.00;102
11892;60;625781905;11892;460;12971;13068;6.07;0.37;294.97;11.20;1079;61;4469.00;97
11895;60;625781920;11895;458;12977;13068;6.13;0.38;294.97;11.20;1082;61;4470.00;91
11898;60;625781933;11898;458;12981;13068;6.19;0.38;294.97;11.20;1083;61;4471.00;87
11899;60;625781946;11899;456;12986;13069;6.17;0.38;294.95;11.19;1087;61;4472.00;83
11900;60;625781966;11900;467;12989;13070;6.17;0.38;294.96;11.19;1089;61;4473.00;81
11902;60;625781986;11902;470;12991;13070;6.15;0.38;295.00;11.19;1089;61;4474.00;79
11907;60;625781999;11907;458;12992;13071;6.09;0.37;294.93;11.19;1085;61;4475.00;79
11908;60;625782013;11908;438;12994;13071;6.12;0.38;294.92;11.19;1086;61;4476.00;77
11909;60;625782027;11909;424;12995;13071;6.18;0.38;294.91;11.19;1086;61;4477.00;76
11911;60;625782042;11911;417;12997;13071;6.26;0.38;294.92;11.19;1086;61;4478.00;74
11911;60;625782056;11911;405;12999;13075;6.34;0.39;294.92;11.19;1088;61;4479.00;76
11912;60;625782070;11912;396;13001;13075;6.44;0.39;294.91;11.19;1089;61;4480.00;74
11915;60;625782085;11915;391;13002;13075;6.52;0.40;294.88;11.19;1087;61;4481.00;73
11916;60;625782105;11916;381;13004;13078;6.64;0.41;294.88;11.19;1088;61;4482.00;74
11918;60;625782120;11918;373;13005;13078;6.78;0.41;294.87;11.19;1087;61;4483.00;73
11918;60;625782135;11918;359;13006;13078;6.89;0.42;294.87;11.19;1088;61;4484.00;72
11920;60;625782149;11920;350;13009;13082;6.95;0.42;294.86;11.19;1089;61;4485.00;73
11921;60;625782164;11921;350;13011;13083;7.01;0.43;294.85;11.19;1090;61;4486.00;72
11923;60;625782179;11923;345;13011;13083;7.01;0.43;294.84;11.19;1088;61;4487.00;72
11924;60;625782193;11924;336;13014;13087;7.02;0.43;294.83;11.18;1090;61;4488.00;73
11925;60;625782214;11925;335;13014;13087;7.01;0.43;294.81;11.18;1089;61;4489.00;73
11927;60;625782229;11927;322;13014;13087;7.04;0.43;294.78;11.18;1087;61;4490.00;73
11927;60;625782243;11927;316;13016;13088;7.07;0.43;294.78;11.22;1089;61;4491.00;72
11927;60;625782258;11927;301;13016;13088;7.08;0.43;294.78;11.22;1089;61;4492.00;72
11928;60;625782273;11928;296;13020;13094;7.11;0.43;294.75;11.22;1092;61;4493.00;74
11929;60;625782290;11929;303;13020;13094;7.12;0.43;294.74;11.22;1091;61;4494.00;74
11930;60;625782304;11930;305;13021;13095;7.22;0.44;294.73;11.22;1091;61;4495.00;74
11933;60;625782319;11933;296;13021;13095;7.20;0.44;294.75;11.22;1088;61;4496.00;74
11937;60;625782334;11937;298;13021;13095;7.16;0.44;294.81;11.22;1084;61;4497.00;74
11938;60;625782349;11938;297;13021;13095;7.17;0.44;294.80;11.22;1083;61;4498.00;74
11943;60;625782363;11943;297;13021;13095;7.12;0.43;294.85;11.22;1078;61;4499.00;74
11945;60;625782381;11945;310;13042;13145;7.13;0.43;294.83;11.20;1097;61;4500.00;103
11952;60;625782405;11952;304;13042;13147;7.07;0.43;294.82;11.20;1090;61;4501.00;105
11955;60;625782419;11955;303;13044;13147;7.08;0.43;294.86;11.20;1089;61;4502.00;103
11958;60;625782434;11958;307;13045;13147;6.99;0.43;294.88;11.20;1087;61;4503.00;102
11960;60;625782448;11960;307;13047;13147;6.99;0.43;294.92;11.20;1087;61;4504.00;100
11963;60;625782462;11963;306;13047;13147;7.00;0.43;294.96;11.20;1084;61;4505.00;100
11963;60;625782477;11963;310;13053;13151;7.00;0.43;294.96;11.19;1090;61;4506.00;98
11965;60;625782490;11965;311;13054;13151;7.00;0.43;294.98;11.19;1089;61;4507.00;97
11967;60;625782504;11967;316;13059;13155;7.02;0.43;295.00;11.23;1092;61;4508.00;96
11969;60;625782521;11969;322;13061;13156;6.98;0.43;295.02;11.23;1092;61;4509.00;95
11972;60;625782537;11972;317;13062;13156;6.93;0.42;295.08;11.23;1090;61;4510.00;94
11976;60;625782552;11976;310;13062;13156;6.90;0.42;295.16;11.23;1086;61;4511.00;94
11978;60;625782574;11978;310;13069;13169;6.94;0.42;295.19;11.23;1091;61;4512.00;100
11981;60;625782594;11981;314;13069;13169;6.93;0.42;295.19;11.23;1088;61;4513.00;100
11983;60;625782615;11983;307;13070;13169;6.93;0.42;295.21;11.23;1087;61;4514.00;99
11985;60;625782636;11985;307;13072;13170;6.90;0.42;295.30;11.23;1087;61;4515.00;98
11988;60;625782657;11988;295;13072;13171;6.84;0.42;295.34;11.23;1084;61;4516.00;99
11991;60;625782676;11991;296;13072;13171;6.82;0.42;295.37;11.23;1081;61;4517.00;99
11993;60;625782691;11993;301;13074;13174;6.87;0.42;295.38;11.22;1081;61;4518.00;100
11998;60;625782714;11998;290;13074;13174;6.86;0.42;295.41;11.22;1076;61;4519.00;100
12004;60;625782728;12004;294;13075;13174;6.82;0.42;295.40;11.22;1071;61;4520.00;99
12007;60;625782742;12007;293;13076;13174;6.83;0.42;295.39;11.23;1069;61;4521.00;98
12009;60;625782756;12009;281;13079;13180;6.83;0.42;295.40;11.22;1070;61;4522.00;101
12011;60;625782770;12011;278;13079;13180;6.85;0.42;295.40;11.22;1068;61;4523.00;101
12017;60;625782784;12017;264;13080;13180;6.80;0.41;295.47;11.27;1063;61;4524.00;100
12022;60;625782798;12022;259;13082;13180;6.77;0.41;295.47;11.28;1060;61;4525.00;98
12025;60;625782813;12025;252;13085;13184;6.76;0.41;295.50;11.28;1060;61;4526.00;99
12029;60;625782826;12029;235;13087;13185;6.73;0.41;295.54;11.28;1058;61;4527.00;98
12032;60;625782840;12032;230;13087;13185;6.72;0.41;295.51;11.28;1055;61;4528.00;98
12037;60;625782853;12037;233;13088;13186;6.80;0.41;295.67;11.28;1051;61;4529.00;98
12040;60;625782870;12040;229;13088;13186;6.90;0.42;295.73;11.28;1048;61;4530.00;98
12043;60;625782884;12043;226;13089;13186;6.93;0.42;295.75;11.28;1046;61;4531.00;97
12047;60;625782897;12047;226;13089;13186;6.99;0.43;295.74;11.28;1042;61;4532.00;97
12050;60;625782910;12050;225;13090;13186;7.09;0.43;295.74;11.28;1040;61;4533.00;96
12054;60;625782924;12054;223;13091;13186;7.20;0.44;295.69;11.32;1037;61;4534.00;95
12058;60;625782938;12058;219;13091;13186;7.29;0.44;295.68;11.32;1033;61;4535.00;95
12061;60;625782951;12061;228;13128;13256;7.38;0.45;295.71;11.29;1067;61;4536.00;128
12065;60;625782973;12065;221;13131;13257;7.37;0.45;295.74;11.30;1066;61;4537.00;126
12070;60;625782987;12070;212;13135;13257;7.38;0.45;295.88;11.29;1065;61;4538.00;122
12073;60;625783001;12073;210;13140;13257;7.41;0.45;295.94;11.29;1067;61;4539.00;117
12076;60;625783015;12076;207;13144;13257;7.41;0.45;296.01;11.29;1068;61;4540.00;113
12082;60;625783029;12082;209;13146;13257;7.43;0.45;296.15;11.29;1064;61;4541.00;111
12083;60;625783043;12083;212;13153;13257;7.47;0.45;296.13;11.30;1070;61;4542.00;104
12087;60;625783056;12087;214;13154;13257;7.51;0.46;296.17;11.30;1067;61;4543.00;103
12089;60;625783071;12089;215;13158;13258;7.59;0.46;296.25;11.30;1069;61;4544.00;100
12091;60;625783086;12091;213;13164;13260;7.62;0.46;296.26;11.30;1073;61;4545.00;96
12099;60;625783102;12099;214;13166;13260;7.55;0.46;296.23;11.31;1067;61;4546.00;94
12102;60;625783117;12102;215;13170;13264;7.51;0.46;296.22;11.30;1068;61;4547.00;94
12103;60;625783131;12103;214;13171;13264;7.55;0.46;296.21;11.31;1068;61;4548.00;93
12105;60;625783145;12105;216;13171;13264;7.55;0.46;296.21;11.31;1066;61;4549.00;93
12108;60;625783158;12108;222;13174;13264;7.55;0.46;296.25;11.33;1066;61;4550.00;90
12114;60;625783172;12114;225;13178;13270;7.56;0.46;296.28;11.33;1064;61;4551.00;92
12116;60;625783188;12116;232;13180;13270;7.59;0.46;296.34;11.33;1064;61;4552.00;90
12118;60;625783202;12118;234;13182;13270;7.58;0.46;296.36;11.35;1064;61;4553.00;88
12122;60;625783216;12122;243;13186;13273;7.57;0.46;296.39;11.35;1064;61;4554.00;87
12125;60;625783231;12125;248;13189;13273;7.62;0.46;296.45;11.37;1064;61;4555.00;84
12127;60;625783246;12127;251;13190;13273;7.69;0.47;296.47;11.37;1063;61;4556.00;83
12132;60;625783259;12132;252;13193;13274;7.68;0.47;296.43;11.39;1061;61;4557.00;81
12135;60;625783273;12135;254;13195;13275;7.67;0.47;296.46;11.39;1060;61;4558.00;80
12140;60;625783292;12140;254;13196;13275;7.64;0.46;296.47;11.40;1056;61;4559.00;79
12142;60;625783314;12142;257;13215;13301;7.54;0.46;296.50;11.39;1073;61;4560.00;86
12146;60;625783340;12146;253;13217;13301;7.46;0.45;296.59;11.41;1071;61;4561.00;84
12150;60;625783356;12150;252;13218;13301;7.49;0.45;296.58;11.41;1068;61;4562.00;83
12151;60;625783375;12151;260;13220;13302;7.49;0.46;296.61;11.42;1069;61;4563.00;82
12153;60;625783395;12153;261;13221;13302;7.48;0.45;296.65;11.42;1068;61;4564.00;81
12156;60;625783409;12156;269;13225;13306;7.44;0.45;296.67;11.44;1069;61;4565.00;81
12158;60;625783424;12158;277;13227;13306;7.35;0.45;296.78;11.44;1069;61;4566.00;79
12161;60;625783437;12161;275;13232;13310;7.25;0.44;296.81;11.45;1071;61;4567.00;78
12168;60;625783450;12168;286;13232;13310;7.10;0.43;296.85;11.45;1064;61;4568.00;78
12169;60;625783464;12169;287;13235;13310;7.02;0.43;296.86;11.47;1066;61;4569.00;75
12175;60;625783478;12175;286;13235;13310;6.95;0.42;296.97;11.47;1060;61;4570.00;75
12175;60;625783491;12175;279;13236;13310;6.93;0.42;296.97;11.48;1061;61;4571.00;74
12180;60;625783503;12180;280;13247;13322;6.88;0.42;297.03;11.47;1067;61;4572.00;75
12180;60;625783518;12180;279;13248;13322;6.87;0.42;297.03;11.48;1068;61;4573.00;74
12182;60;625783529;12182;288;13249;13322;6.87;0.42;297.11;11.48;1067;61;4574.00;73
12184;60;625783542;12184;290;13249;13322;6.87;0.42;297.18;11.48;1065;61;4575.00;73
12186;60;625783556;12186;292;13251;13322;6.84;0.42;297.22;11.50;1065;61;4576.00;71
12188;60;625783568;12188;294;13251;13322;6.84;0.42;297.25;11.50;1063;61;4577.00;71
12192;60;625783581;12192;302;13252;13323;6.81;0.41;297.34;11.51;1060;61;4578.00;71
12195;60;625783594;12195;312;13252;13323;6.77;0.41;297.41;11.51;1057;61;4579.00;71
12197;60;625783606;12197;320;13258;13329;6.73;0.41;297.40;11.51;1061;61;4580.00;71
12200;60;625783618;12200;321;13260;13330;6.69;0.41;297.52;11.52;1060;61;4581.00;70
12204;60;625783630;12204;334;13261;13330;6.59;0.40;297.54;11.52;1057;61;4582.00;69
12207;60;625783642;12207;338;13261;13330;6.46;0.39;297.60;11.52;1054;61;4583.00;69
12211;60;625783653;12211;342;13265;13334;6.37;0.39;297.63;11.53;1054;61;4584.00;69
12217;60;625783665;12217;348;13267;13334;6.21;0.38;297.66;11.55;1050;61;4585.00;67
12219;60;625783677;12219;353;13268;13334;6.12;0.37;297.69;11.56;1049;61;4586.00;66
12221;60;625783688;12221;363;13269;13335;6.03;0.37;297.70;11.56;1048;61;4587.00;66
12226;60;625783698;12226;376;13272;13339;5.87;0.36;297.66;11.56;1046;61;4588.00;67
12228;60;625783710;12228;386;13273;13339;5.72;0.35;297.66;11.57;1045;61;4589.00;66
12232;60;625783722;12232;387;13277;13345;5.61;0.34;297.66;11.57;1045;61;4590.00;68
12234;60;625783734;12234;385;13277;13345;5.47;0.34;297.68;11.57;1043;61;4591.00;68
12237;60;625783745;12237;386;13279;13345;5.43;0.33;297.69;11.58;1042;61;4592.00;66
12240;60;625783755;12240;381;13281;13345;5.41;0.33;297.67;11.59;1041;61;4593.00;64
12243;60;625783766;12243;379;13283;13349;5.42;0.33;297.70;11.59;1040;61;4594.00;66
12245;60;625783777;12245;385;13285;13349;5.42;0.33;297.68;11.60;1040;61;4595.00;64
12250;60;625783788;12250;382;13286;13349;5.40;0.33;297.68;11.61;1036;61;4596.00;63
12255;60;625783799;12255;385;13288;13349;5.39;0.33;297.69;11.62;1033;61;4597.00;61
12258;60;625783810;12258;381;13288;13350;5.43;0.33;297.69;11.62;1030;61;4598.00;62
12258;60;625783822;12258;383;13290;13351;5.52;0.34;297.69;11.61;1032;61;4599.00;61
12260;60;625783834;12260;388;13290;13351;5.52;0.34;297.71;11.61;1030;61;4600.00;61
12264;60;625783850;12264;397;13291;13352;5.53;0.34;297.70;11.61;1027;61;4601.00;61
12268;60;625783862;12268;408;13291;13352;5.52;0.34;297.70;11.61;1023;61;4602.00;61
12269;60;625783873;12269;403;13291;13352;5.54;0.34;297.71;11.61;1022;61;4603.00;61
12274;60;625783884;12274;405;13291;13352;5.45;0.33;297.66;11.61;1017;61;4604.00;61
12278;60;625783895;12278;413;13291;13352;5.40;0.33;297.63;11.61;1013;61;4605.00;61
12282;60;625783906;12282;411;13291;13352;5.40;0.33;297.59;11.61;1009;61;4606.00;61
12285;60;625783916;12285;414;13291;13352;5.36;0.33;297.59;11.61;1006;61;4607.00;61
12288;60;625783927;12288;418;13353;13479;5.83;0.36;297.58;11.56;1065;61;4608.00;126
12292;60;625783948;12292;420;13355;13480;5.84;0.36;297.55;11.56;1063;61;4609.00;125
12297;60;625783960;12297;420;13366;13480;5.96;0.37;297.52;11.55;1069;61;4610.00;114
12302;60;625783972;12302;422;13370;13480;5.97;0.37;297.47;11.55;1068;61;4611.00;110
12305;60;625783984;12305;419;13376;13480;5.96;0.37;297.45;11.54;1071;61;4612.00;104
12306;60;625783996;12306;429;13383;13480;5.97;0.37;297.43;11.54;1077;61;4613.00;97
12309;60;625784007;12309;429;13388;13480;5.95;0.37;297.45;11.54;1079;61;4614.00;92
12311;60;625784020;12311;436;13391;13480;5.87;0.36;297.43;11.59;1080;61;4615.00;89
12320;60;625784032;12320;439;13394;13481;5.83;0.36;297.34;11.58;1074;61;4616.00;87
12323;60;625784045;12323;438;13396;13482;5.84;0.36;297.40;11.58;1073;61;4617.00;86
12329;60;625784058;12329;444;13401;13482;5.82;0.36;297.35;11.58;1072;61;4618.00;81
12331;60;625784071;12331;453;13403;13483;5.80;0.36;297.34;11.58;1072;61;4619.00;80
12334;60;625784086;12334;450;13404;13483;5.77;0.36;297.32;11.58;1070;61;4620.00;79
12338;60;625784098;12338;462;13405;13483;5.70;0.35;297.36;11.58;1067;61;4621.00;78
12339;60;625784110;12339;462;13407;13483;5.68;0.35;297.36;11.58;1068;61;4622.00;76
12342;60;625784122;12342;466;13410;13487;5.67;0.35;297.36;11.58;1068;61;4623.00;77
12344;61;625784135;12344;480;13412;13487;5.63;0.35;297.35;11.58;1068;62;4624.00;75
12347;61;625784164;12347;481;13413;13487;5.54;0.34;297.42;11.58;1066;62;4625.00;74
12349;61;625784176;12349;482;13416;13490;5.53;0.34;297.42;11.58;1067;62;4626.00;74
12350;61;625784189;12350;469;13417;13490;5.54;0.34;297.41;11.58;1067;62;4627.00;73
12351;61;625784201;12351;461;13418;13490;5.58;0.34;297.40;11.58;1067;62;4628.00;72
12357;61;625784213;12357;463;13421;13494;5.62;0.35;297.30;11.58;1064;62;4629.00;73
12359;61;625784226;12359;460;13423;13495;5.65;0.35;297.27;11.58;1064;62;4630.00;72
12361;61;625784238;12361;456;13423;13495;5.69;0.35;297.30;11.58;1062;62;4631.00;72
12364;61;625784251;12364;455;13427;13499;5.75;0.35;297.30;11.62;1063;62;4632.00;72
12366;61;625784264;12366;458;13427;13499;5.84;0.36;297.29;11.62;1061;62;4633.00;72
12369;61;625784276;12369;458;13427;13499;5.87;0.36;297.29;11.62;1058;62;4634.00;72
12369;61;625784289;12369;456;13429;13501;6.00;0.37;297.29;11.62;1060;62;4635.00;72
12370;61;625784302;12370;455;13429;13501;6.08;0.37;297.29;11.62;1059;62;4636.00;72
12378;61;625784315;12378;437;13433;13507;6.08;0.37;297.26;11.62;1055;62;4637.00;74
12379;61;625784328;12379;421;13433;13507;6.15;0.37;297.25;11.62;1054;62;4638.00;74
12381;61;625784341;12381;410;13434;13508;6.21;0.38;297.28;11.62;1053;62;4639.00;74
12383;61;625784354;12383;406;13434;13508;6.25;0.38;297.26;11.62;1051;62;4640.00;74
12384;61;625784367;12384;399;13434;13508;6.34;0.39;297.23;11.62;1050;62;4641.00;74
12386;61;625784381;12386;396;13434;13508;6.42;0.39;297.22;11.62;1048;62;4642.00;74
12387;61;625784394;12387;383;13434;13508;6.47;0.39;297.21;11.62;1047;62;4643.00;74
12389;61;625784407;12389;380;13444;13520;6.60;0.40;297.20;11.61;1055;62;4644.00;76
12390;61;625784427;12390;382;13445;13520;6.64;0.40;297.20;11.61;1055;62;4645.00;75
12392;61;625784440;12392;371;13446;13520;6.70;0.41;297.18;11.66;1054;62;4646.00;74
12393;61;625784454;12393;369;13446;13520;6.82;0.41;297.16;11.66;1053;62;4647.00;74
12396;61;625784468;12396;362;13446;13520;6.89;0.42;297.21;11.66;1050;62;4648.00;74
12397;61;625784482;12397;356;13446;13520;6.98;0.42;297.25;11.66;1049;62;4649.00;74
12399;61;625784497;12399;355;13451;13526;7.01;0.43;297.28;11.65;1052;62;4650.00;75
12400;61;625784512;12400;355;13451;13526;7.07;0.43;297.29;11.65;1051;62;4651.00;75
12405;61;625784526;12405;363;13454;13530;7.10;0.43;297.31;11.65;1049;62;4652.00;76
12408;61;625784540;12408;352;13456;13531;7.14;0.43;297.28;11.65;1048;62;4653.00;75
12412;61;625784554;12412;343;13456;13531;7.15;0.43;297.31;11.65;1044;62;4654.00;75
12415;61;625784575;12415;346;13456;13531;7.14;0.43;297.35;11.65;1041;62;4655.00;75
12420;61;625784603;12420;352;13467;13544;7.22;0.44;297.38;11.64;1047;62;4656.00;77
12425;61;625784626;12425;345;13467;13544;7.22;0.44;297.41;11.64;1042;62;4657.00;77
12426;61;625784649;12426;347;13467;13544;7.31;0.44;297.40;11.64;1041;62;4658.00;77
12431;61;625784671;12431;349;13468;13545;7.29;0.44;297.43;11.64;1037;62;4659.00;77
12435;62;625784690;12435;342;13468;13546;7.26;0.44;297.47;11.64;1033;63;4660.00;78
12438;62;625784725;12438;336;13468;13546;7.22;0.44;297.49;11.64;1030;63;4661.00;78
12441;62;625784741;12441;330;13470;13549;7.19;0.44;297.63;11.64;1029;63;4662.00;79
12443;62;625784758;12443;331;13470;13549;7.14;0.43;297.66;11.64;1027;63;4663.00;79
12447;62;625784773;12447;323;13471;13549;7.13;0.43;297.74;11.64;1024;63;4664.00;78
12449;62;625784789;12449;328;13471;13549;7.13;0.43;297.77;11.64;1022;63;4665.00;78
12450;62;625784804;12450;333;13475;13555;7.14;0.43;297.80;11.63;1025;63;4666.00;80
12454;62;625784819;12454;334;13475;13555;7.11;0.43;297.84;11.63;1021;63;4667.00;80
12456;62;625784835;12456;335;13476;13555;7.14;0.43;297.88;11.63;1020;63;4668.00;79
12457;62;625784849;12457;335;13476;13555;7.14;0.43;297.91;11.63;1019;63;4669.00;79
12460;62;625784864;12460;338;13479;13559;7.10;0.43;297.95;11.63;1019;63;4670.00;80
12462;62;625784878;12462;341;13480;13560;7.11;0.43;298.00;11.63;1018;63;4671.00;80
12468;62;625784893;12468;342;13480;13560;7.01;0.43;298.17;11.63;1012;63;4672.00;80
12471;62;625784907;12471;344;13481;13561;6.96;0.42;298.15;11.63;1010;63;4673.00;80
12474;62;625784922;12474;347;13481;13561;6.93;0.42;298.17;11.63;1007;63;4674.00;80
12477;62;625784938;12477;346;13481;13561;6.87;0.42;298.20;11.63;1004;63;4675.00;80
12478;62;625784953;12478;346;13481;13561;6.80;0.41;298.22;11.63;1003;63;4676.00;80
12479;62;625784967;12479;347;13481;13561;6.78;0.41;298.22;11.63;1002;63;4677.00;80
12480;62;625784981;12480;348;13481;13561;6.80;0.41;298.24;11.63;1001;63;4678.00;80
12483;62;625784994;12483;348;13481;13561;6.76;0.41;298.24;11.63;998;63;4679.00;80
12483;62;625785011;12483;364;13543;13686;6.69;0.41;298.24;11.63;1060;63;4680.00;143
12486;62;625785038;12486;348;13544;13687;6.69;0.41;298.28;11.63;1058;63;4681.00;143
12486;62;625785054;12486;337;13554;13687;6.80;0.42;298.28;11.62;1068;63;4682.00;133
12486;62;625785068;12486;328;13555;13687;6.84;0.42;298.28;11.62;1069;63;4683.00;132
12488;62;625785083;12488;318;13560;13687;6.89;0.42;298.25;11.62;1072;63;4684.00;127
12491;62;625785098;12491;306;13564;13687;6.96;0.43;298.29;11.62;1073;63;4685.00;123
12494;62;625785111;12494;311;13569;13687;7.00;0.43;298.34;11.61;1075;63;4686.00;118
12502;62;625785124;12502;305;13573;13687;6.98;0.43;298.38;11.61;1071;63;4687.00;114
12506;62;625785138;12506;301;13577;13688;7.05;0.43;298.42;11.61;1071;63;4688.00;111
12509;62;625785153;12509;298;13580;13689;7.06;0.43;298.43;11.61;1071;63;4689.00;109
12516;62;625785166;12516;291;13581;13689;7.00;0.43;298.45;11.61;1065;63;4690.00;108
12519;62;625785180;12519;287;13584;13693;6.93;0.42;298.47;11.61;1065;63;4691.00;109
12522;62;625785193;12522;282;13585;13693;6.83;0.42;298.51;11.61;1063;63;4692.00;108
12526;62;625785206;12526;279;13586;13693;6.74;0.41;298.56;11.61;1060;63;4693.00;107
12530;62;625785220;12530;280;13588;13693;6.63;0.40;298.59;11.62;1058;63;4694.00;105
12531;62;625785235;12531;283;13592;13699;6.60;0.40;298.62;11.67;1061;63;4695.00;107
12535;62;625785250;12535;282;13593;13699;6.55;0.40;298.64;11.69;1058;63;4696.00;106
12536;62;625785264;12536;273;13594;13699;6.57;0.40;298.68;11.68;1058;63;4697.00;105
12539;62;625785277;12539;276;13597;13702;6.62;0.40;298.73;11.68;1058;63;4698.00;105
12543;62;625785291;12543;277;13597;13702;6.65;0.41;298.74;11.68;1054;63;4699.00;105
12547;62;625785305;12547;270;13597;13702;6.67;0.41;298.76;11.68;1050;63;4700.00;105
12549;62;625785323;12549;268;13598;13703;6.67;0.41;298.75;11.73;1049;63;4701.00;105
12552;62;625785346;12552;265;13599;13704;6.70;0.41;298.81;11.73;1047;63;4702.00;105
12554;62;625785360;12554;261;13599;13704;6.69;0.41;298.80;11.73;1045;63;4703.00;105
12558;62;625785374;12558;261;13609;13717;6.72;0.41;298.81;11.77;1051;63;4704.00;108
12561;62;625785389;12561;261;13609;13717;6.76;0.41;298.78;11.77;1048;63;4705.00;108
12564;62;625785403;12564;269;13609;13717;6.81;0.41;298.85;11.77;1045;63;4706.00;108
12567;62;625785416;12567;262;13613;13718;6.83;0.42;298.84;11.81;1046;63;4707.00;105
12569;62;625785429;12569;263;13613;13718;6.87;0.42;298.89;11.81;1044;63;4708.00;105
12572;62;625785443;12572;268;13615;13722;6.93;0.42;298.92;11.81;1043;63;4709.00;107
12575;62;625785465;12575;271;13619;13722;6.97;0.42;298.93;11.82;1044;63;4710.00;103
12579;62;625785480;12579;276;13622;13726;6.93;0.42;298.97;11.82;1043;63;4711.00;104
12579;62;625785494;12579;274;13623;13726;6.95;0.42;298.97;11.82;1044;63;4712.00;103
12583;62;625785508;12583;271;13623;13726;6.99;0.42;299.00;11.82;1040;63;4713.00;103
12585;62;625785522;12585;278;13624;13726;7.03;0.43;299.01;11.82;1039;63;4714.00;102
12586;62;625785535;12586;275;13624;13726;7.11;0.43;299.04;11.82;1038;63;4715.00;102
12589;62;625785548;12589;273;13635;13738;7.17;0.43;299.09;11.82;1046;63;4716.00;103
12589;62;625785564;12589;279;13637;13738;7.19;0.44;299.09;11.82;1048;63;4717.00;101
12591;62;625785578;12591;283;13637;13738;7.17;0.44;299.16;11.82;1046;63;4718.00;101
12593;62;625785592;12593;286;13637;13738;7.13;0.43;299.16;11.82;1044;63;4719.00;101
12596;62;625785605;12596;290;13640;13738;7.12;0.43;299.18;11.84;1044;63;4720.00;98
12598;62;625785626;12598;289;13640;13738;7.17;0.44;299.18;11.84;1042;63;4721.00;98
12603;62;625785639;12603;285;13642;13739;7.15;0.43;299.27;11.86;1039;63;4722.00;97
12603;62;625785653;12603;278;13643;13739;7.17;0.44;299.27;11.86;1040;63;4723.00;96
12605;62;625785665;12605;283;13647;13745;7.27;0.44;299.32;11.86;1042;63;4724.00;98
12609;62;625785679;12609;276;13652;13747;7.28;0.44;299.47;11.90;1043;63;4725.00;95
12609;62;625785693;12609;282;13653;13747;7.35;0.45;299.47;11.89;1044;63;4726.00;94
12614;62;625785706;12614;290;13653;13747;7.34;0.45;299.49;11.89;1039;63;4727.00;94
12617;62;625785719;12617;289;13658;13751;7.36;0.45;299.53;11.91;1041;63;4728.00;93
12617;62;625785732;12617;286;13659;13751;7.38;0.45;299.53;11.93;1042;63;4729.00;92
12621;62;625785744;12621;289;13660;13751;7.34;0.45;299.68;11.93;1039;63;4730.00;91
12623;62;625785757;12623;289;13662;13752;7.31;0.45;299.70;11.94;1039;63;4731.00;90
12624;62;625785770;12624;291;13666;13756;7.29;0.44;299.70;11.94;1042;63;4732.00;90
12627;62;625785781;12627;296;13667;13756;7.22;0.44;299.72;11.96;1040;63;4733.00;89
12630;62;625785794;12630;304;13670;13759;7.17;0.44;299.75;11.96;1040;63;4734.00;89
12631;62;625785808;12631;303;13671;13759;7.16;0.44;299.74;11.97;1040;63;4735.00;88
12633;62;625785820;12633;310;13672;13759;7.12;0.44;299.80;11.97;1039;63;4736.00;87
12638;62;625785833;12638;317;13674;13759;7.03;0.43;299.83;11.99;1036;63;4737.00;85
12640;62;625785852;12640;321;13678;13763;7.04;0.43;299.80;11.99;1038;63;4738.00;85
12641;62;625785864;12641;324;13681;13763;6.97;0.42;299.80;12.01;1040;63;4739.00;82
12643;62;625785878;12643;325;13681;13763;6.92;0.42;299.78;12.01;1038;63;4740.00;82
12646;62;625785890;12646;323;13682;13763;6.87;0.42;299.86;12.01;1036;63;4741.00;81
12647;62;625785903;12647;319;13682;13764;6.80;0.42;299.84;12.01;1035;63;4742.00;82
12650;62;625785915;12650;324;13685;13765;6.79;0.42;299.89;12.03;1035;63;4743.00;80
12653;62;625785928;12653;324;13686;13765;6.72;0.41;299.86;12.03;1033;63;4744.00;79
12656;62;625785940;12656;321;13688;13766;6.67;0.41;299.87;12.05;1032;63;4745.00;78
12657;62;625785953;12657;329;13688;13766;6.66;0.41;299.85;12.05;1031;63;4746.00;78
12658;62;625785965;12658;332;13689;13766;6.65;0.41;299.84;12.06;1031;63;4747.00;77
12659;62;625785977;12659;337;13689;13766;6.63;0.41;299.88;12.06;1030;63;4748.00;77
12660;62;625785988;12660;340;13692;13766;6.59;0.40;299.86;12.09;1032;63;4749.00;74
12662;62;625786000;12662;338;13692;13766;6.48;0.40;299.89;12.09;1030;63;4750.00;74
12664;62;625786011;12664;347;13692;13766;6.39;0.39;299.85;12.09;1028;63;4751.00;74
12671;62;625786023;12671;365;13758;13893;6.50;0.40;299.95;12.05;1087;63;4752.00;135
12672;62;625786044;12672;365;13759;13894;6.40;0.40;299.93;12.05;1087;63;4753.00;135
12676;62;625786056;12676;362;13772;13894;6.40;0.40;299.93;12.05;1096;63;4754.00;122
12679;62;625786069;12679;373;13776;13894;6.32;0.39;299.89;12.05;1097;63;4755.00;118
12683;62;625786081;12683;375;13782;13894;6.27;0.39;299.87;12.04;1099;63;4756.00;112
12687;62;625786093;12687;378;13787;13894;6.16;0.38;299.87;12.05;1100;63;4757.00;107
12690;62;625786105;12690;382;13792;13894;6.02;0.37;299.83;12.06;1102;63;4758.00;102
12693;62;625786117;12693;385;13794;13894;5.91;0.37;299.81;12.06;1101;63;4759.00;100
12698;62;625786128;12698;379;13800;13895;5.77;0.36;299.78;12.09;1102;63;4760.00;95
12703;62;625786140;12703;379;13803;13896;5.71;0.35;299.69;12.09;1100;63;4761.00;93
12707;62;625786152;12707;383;13807;13896;5.63;0.35;299.68;12.09;1100;63;4762.00;89
12708;62;625786164;12708;392;13812;13897;5.57;0.34;299.66;12.09;1104;63;4763.00;85
12711;62;625786176;12711;394;13814;13897;5.53;0.34;299.63;12.09;1103;63;4764.00;83
12714;62;625786187;12714;406;13820;13897;5.48;0.34;299.63;12.11;1106;63;4765.00;77
12715;62;625786199;12715;422;13820;13897;5.42;0.34;299.62;12.11;1105;63;4766.00;77
12719;62;625786211;12719;427;13824;13901;5.35;0.33;299.62;12.11;1105;63;4767.00;77
12721;62;625786229;12721;432;13827;13901;5.35;0.33;299.63;12.11;1106;63;4768.00;74
12724;62;625786246;12724;431;13827;13901;5.37;0.33;299.62;12.11;1103;63;4769.00;74
12727;62;625786260;12727;438;13830;13907;5.38;0.33;299.60;12.11;1103;63;4770.00;77
12729;62;625786273;12729;441;13831;13907;5.39;0.33;299.60;12.11;1102;63;4771.00;76
12731;62;625786284;12731;444;13832;13907;5.40;0.33;299.62;12.11;1101;63;4772.00;75
12734;62;625786296;12734;438;13836;13911;5.41;0.33;299.60;12.10;1102;63;4773.00;75
12737;62;625786309;12737;437;13837;13912;5.38;0.33;299.68;12.10;1100;63;4774.00;75
12741;62;625786321;12741;445;13838;13912;5.36;0.33;299.68;12.10;1097;63;4775.00;74
12743;62;625786333;12743;434;13841;13916;5.38;0.33;299.71;12.10;1098;63;4776.00;75
12745;62;625786346;12745;437;13842;13916;5.39;0.33;299.70;12.10;1097;63;4777.00;74
12748;62;625786358;12748;446;13842;13916;5.36;0.33;299.72;12.10;1094;63;4778.00;74
12753;62;625786370;12753;432;13843;13917;5.37;0.33;299.71;12.10;1090;63;4779.00;74
12757;62;625786384;12757;415;13843;13917;5.43;0.33;299.63;12.10;1086;63;4780.00;74
12762;62;625786397;12762;407;13848;13923;5.53;0.34;299.60;12.10;1086;63;4781.00;75
12765;62;625786411;12765;400;13848;13923;5.60;0.34;299.61;12.10;1083;63;4782.00;75
12769;62;625786424;12769;400;13848;13924;5.70;0.35;299.57;12.10;1079;63;4783.00;76
12773;62;625786437;12773;395;13848;13924;5.74;0.35;299.58;12.10;1075;63;4784.00;76
12775;62;625786451;12775;389;13848;13924;5.78;0.36;299.54;12.10;1073;63;4785.00;76
12779;62;625786465;12779;390;13848;13924;5.83;0.36;299.49;12.10;1069;63;4786.00;76
12781;62;625786479;12781;392;13848;13924;5.91;0.36;299.49;12.10;1067;63;4787.00;76
12784;62;625786491;12784;397;13857;13936;5.99;0.37;299.48;12.09;1073;63;4788.00;79
12787;62;625786511;12787;404;13857;13936;5.99;0.37;299.48;12.09;1070;63;4789.00;79
12793;62;625786537;12793;402;13859;13936;6.08;0.37;299.52;12.09;1066;63;4790.00;77
12793;62;625786550;12793;408;13859;13936;6.17;0.38;299.52;12.09;1066;63;4791.00;77
12799;62;625786565;12799;409;13859;13936;6.21;0.38;299.54;12.09;1060;63;4792.00;77
12800;62;625786585;12800;404;13859;13936;6.27;0.38;299.55;12.09;1059;63;4793.00;77
12803;62;625786604;12803;407;13862;13940;6.40;0.39;299.54;12.08;1059;63;4794.00;78
12804;62;625786635;12804;409;13862;13940;6.47;0.40;299.54;12.08;1058;63;4795.00;78
12809;62;625786655;12809;409;13865;13944;6.51;0.40;299.52;12.08;1056;63;4796.00;79
12811;62;625786677;12811;408;13866;13945;6.54;0.40;299.55;12.08;1055;63;4797.00;79
12811;62;625786694;12811;414;13867;13945;6.58;0.40;299.55;12.08;1056;63;4798.00;78
12816;62;625786709;12816;423;13867;13945;6.53;0.40;299.55;12.08;1051;63;4799.00;78
12820;62;625786726;12820;431;13889;13986;6.57;0.40;299.53;12.11;1069;63;4800.00;97
12823;62;625786749;12823;428;13890;13986;6.50;0.40;299.55;12.11;1067;63;4801.00;96
12826;62;625786765;12826;424;13892;13986;6.45;0.39;299.63;12.11;1066;63;4802.00;94
12828;62;625786778;12828;425;13893;13987;6.39;0.39;299.64;12.11;1065;63;4803.00;94
12832;62;625786792;12832;439;13894;13988;6.35;0.39;299.69;12.11;1062;63;4804.00;94
12833;62;625786806;12833;445;13895;13988;6.27;0.38;299.71;12.11;1062;63;4805.00;93
12837;62;625786819;12837;454;13899;13991;6.24;0.38;299.70;12.10;1062;63;4806.00;92
12840;62;625786833;12840;444;13901;13991;6.25;0.38;299.73;12.10;1061;63;4807.00;90
12843;62;625786847;12843;439;13901;13991;6.25;0.38;299.77;12.10;1058;63;4808.00;90
12848;62;625786861;12848;429;13901;13991;6.19;0.38;299.75;12.10;1053;63;4809.00;90
12850;62;625786875;12850;424;13906;13997;6.18;0.38;299.85;12.10;1056;63;4810.00;91
12855;62;625786889;12855;423;13907;13997;6.15;0.37;299.99;12.10;1052;63;4811.00;90
12855;62;625786902;12855;426;13908;13997;6.17;0.38;299.99;12.10;1053;63;4812.00;89
12858;62;625786916;12858;428;13909;13997;6.12;0.37;300.01;12.10;1051;63;4813.00;88
12860;62;625786938;12860;425;13912;14001;6.14;0.37;300.05;12.10;1052;63;4814.00;89
12866;62;625786952;12866;426;13914;14003;6.14;0.37;300.11;12.09;1048;63;4815.00;89
12870;62;625786966;12870;415;13914;14003;6.14;0.37;300.22;12.09;1044;63;4816.00;89
12874;62;625786981;12874;403;13915;14004;6.17;0.38;300.28;12.09;1041;63;4817.00;89
12876;62;625786995;12876;395;13915;14004;6.21;0.38;300.31;12.09;1039;63;4818.00;89
12878;62;625787014;12878;381;13916;14004;6.27;0.38;300.32;12.09;1038;63;4819.00;88
12881;62;625787028;12881;376;13916;14004;6.30;0.38;300.34;12.09;1035;63;4820.00;88
12882;62;625787041;12882;368;13916;14004;6.34;0.39;300.38;12.09;1034;63;4821.00;88
12886;62;625787055;12886;362;13916;14004;6.35;0.39;300.45;12.09;1030;63;4822.00;88
12890;62;625787069;12890;366;13916;14004;6.33;0.39;300.53;12.09;1026;63;4823.00;88
12893;62;625787082;12893;375;13959;14074;6.36;0.39;300.51;12.06;1066;63;4824.00;115
12898;62;625787102;12898;365;13960;14075;6.31;0.38;300.59;12.06;1062;63;4825.00;115
12902;62;625787122;12902;355;13965;14075;6.36;0.39;300.65;12.05;1063;63;4826.00;110
12905;62;625787136;12905;343;13967;14075;6.37;0.39;300.65;12.05;1062;63;4827.00;108
12908;62;625787150;12908;339;13970;14077;6.37;0.39;300.71;12.05;1062;63;4828.00;107
12913;62;625787170;12913;330;13972;14077;6.33;0.38;300.76;12.05;1059;63;4829.00;105
12915;62;625787185;12915;325;13975;14077;6.34;0.38;300.77;12.05;1060;63;4830.00;102
12920;62;625787199;12920;328;13977;14077;6.29;0.38;300.81;12.05;1057;63;4831.00;100
12922;63;625787213;12922;328;13979;14078;6.30;0.38;300.81;12.05;1057;64;4832.00;99
12923;63;625787236;12923;329;13982;14079;6.36;0.39;300.80;12.05;1059;64;4833.00;97
12925;63;625787250;12925;329;13984;14079;6.42;0.39;300.87;12.05;1059;64;4834.00;95
12928;63;625787264;12928;331;13988;14083;6.47;0.39;300.89;12.05;1060;64;4835.00;95
12931;63;625787279;12931;331;13989;14083;6.46;0.39;300.90;12.04;1058;64;4836.00;94
12934;63;625787299;12934;339;13991;14083;6.46;0.39;300.94;12.05;1057;64;4837.00;92
12936;63;625787313;12936;334;13991;14083;6.54;0.40;301.01;12.05;1055;64;4838.00;92
12937;63;625787326;12937;334;13996;14089;6.59;0.40;301.00;12.04;1059;64;4839.00;93
12937;63;625787340;12937;335;13996;14089;6.66;0.40;301.00;12.04;1059;64;4840.00;93
12938;63;625787354;12938;344;13996;14089;6.73;0.41;301.03;12.04;1058;64;4841.00;93
12939;63;625787367;12939;342;13999;14092;6.77;0.41;301.03;12.04;1060;64;4842.00;93
12941;63;625787389;12941;342;14000;14092;6.78;0.41;301.07;12.04;1059;64;4843.00;92
12942;63;625787404;12942;340;14000;14092;6.78;0.41;301.06;12.04;1058;64;4844.00;92
12942;63;625787419;12942;342;14000;14093;6.74;0.41;301.06;12.04;1058;64;4845.00;93
12945;63;625787434;12945;345;14001;14094;6.71;0.41;301.04;12.04;1056;64;4846.00;93
12946;63;625787449;12946;341;14001;14094;6.69;0.41;301.07;12.04;1055;64;4847.00;93
12947;63;625787463;12947;347;14012;14107;6.69;0.41;301.08;12.03;1065;64;4848.00;95
12951;63;625787479;12951;356;14012;14107;6.61;0.40;301.09;12.03;1061;64;4849.00;95
12952;63;625787508;12952;350;14012;14107;6.53;0.40;301.10;12.03;1060;64;4850.00;95
12954;63;625787523;12954;346;14013;14108;6.46;0.39;301.09;12.03;1059;64;4851.00;95
12956;63;625787537;12956;341;14013;14108;6.39;0.39;301.10;12.03;1057;64;4852.00;95
12958;63;625787550;12958;341;14016;14112;6.34;0.39;301.11;12.03;1058;64;4853.00;96
12959;63;625787565;12959;336;14016;14112;6.30;0.38;301.10;12.03;1057;64;4854.00;96
12964;63;625787579;12964;333;14020;14116;6.28;0.38;301.07;12.02;1056;64;4855.00;96
12965;63;625787593;12965;332;14020;14116;6.31;0.38;301.07;12.02;1055;64;4856.00;96
12970;63;625787607;12970;326;14020;14116;6.28;0.38;301.11;12.02;1050;64;4857.00;96
12975;63;625787621;12975;322;14020;14116;6.28;0.38;301.18;12.02;1045;64;4858.00;96
12979;63;625787634;12979;314;14020;14116;6.27;0.38;301.26;12.02;1041;64;4859.00;96
12984;63;625787650;12984;303;14040;14150;6.26;0.38;301.30;12.01;1056;64;4860.00;110
12985;63;625787666;12985;293;14041;14150;6.26;0.38;301.37;12.01;1056;64;4861.00;109
12990;63;625787680;12990;283;14041;14150;6.21;0.38;301.41;12.01;1051;64;4862.00;109
12993;63;625787693;12993;274;14042;14150;6.28;0.38;301.42;12.01;1049;64;4863.00;108
12995;63;625787706;12995;261;14042;14150;6.34;0.39;301.44;12.01;1047;64;4864.00;108
13000;63;625787719;13000;263;14045;14150;6.37;0.39;301.48;12.04;1045;64;4865.00;105
13001;63;625787734;13001;250;14045;14151;6.45;0.39;301.47;12.04;1044;64;4866.00;106
13004;63;625787747;13004;243;14046;14151;6.50;0.39;301.54;12.03;1042;64;4867.00;105
13007;63;625787760;13007;239;14049;14157;6.51;0.40;301.55;12.03;1042;64;4868.00;108
13010;63;625787775;13010;231;14051;14158;6.55;0.40;301.54;12.03;1041;64;4869.00;107
13012;63;625787789;13012;225;14051;14158;6.53;0.40;301.63;12.03;1039;64;4870.00;107
13014;63;625787803;13014;226;14052;14158;6.52;0.40;301.64;12.03;1038;64;4871.00;106
13016;63;625787817;13016;216;14054;14162;6.56;0.40;301.61;12.03;1038;64;4872.00;108
13019;63;625787831;13019;224;14056;14162;6.57;0.40;301.67;12.03;1037;64;4873.00;106
13021;63;625787844;13021;223;14057;14162;6.61;0.40;301.68;12.08;1036;64;4874.00;105
13022;63;625787858;13022;235;14058;14163;6.68;0.41;301.70;12.08;1036;64;4875.00;105
13022;63;625787872;13022;233;14061;14167;6.69;0.41;301.70;12.08;1039;64;4876.00;106
13027;63;625787885;13027;234;14062;14167;6.72;0.41;301.66;12.08;1035;64;4877.00;105
13031;63;625787899;13031;223;14064;14170;6.76;0.41;301.66;12.08;1033;64;4878.00;106
13034;63;625787912;13034;223;14065;14170;6.76;0.41;301.66;12.07;1031;64;4879.00;105
13039;63;625787926;13039;228;14066;14170;6.73;0.41;301.71;12.08;1027;64;4880.00;104
13039;63;625787940;13039;222;14066;14170;6.74;0.41;301.71;12.08;1027;64;4881.00;104
13040;63;625787953;13040;241;14069;14174;6.80;0.41;301.71;12.07;1029;64;4882.00;105
13045;63;625787968;13045;235;14071;14174;6.78;0.41;301.72;12.13;1026;64;4883.00;103
13050;63;625787982;13050;250;14072;14174;6.78;0.41;301.77;12.13;1022;64;4884.00;102
13053;63;625787996;13053;255;14073;14174;6.74;0.41;301.83;12.13;1020;64;4885.00;101
13054;63;625788010;13054;259;14073;14175;6.74;0.41;301.82;12.13;1019;64;4886.00;102
13055;63;625788024;13055;260;14074;14176;6.73;0.41;301.84;12.12;1019;64;4887.00;102
13056;63;625788039;13056;264;14074;14176;6.78;0.41;301.82;12.12;1018;64;4888.00;102
13056;63;625788053;13056;269;14076;14177;6.78;0.41;301.82;12.13;1020;64;4889.00;101
13059;63;625788068;13059;277;14077;14177;6.72;0.41;301.83;12.15;1018;64;4890.00;100
13060;63;625788082;13060;281;14077;14177;6.72;0.41;301.83;12.15;1017;64;4891.00;100
13064;63;625788096;13064;290;14077;14177;6.67;0.41;301.87;12.15;1013;64;4892.00;100
13065;63;625788109;13065;296;14079;14177;6.69;0.41;301.89;12.18;1014;64;4893.00;98
13066;63;625788122;13066;299;14079;14177;6.65;0.41;301.99;12.18;1013;64;4894.00;98
13070;63;625788136;13070;303;14081;14177;6.58;0.40;301.99;12.20;1011;64;4895.00;96
13071;63;625788149;13071;328;14144;14304;6.77;0.42;301.99;12.15;1073;64;4896.00;160
13076;63;625788175;13076;321;14147;14305;6.68;0.41;301.92;12.14;1071;64;4897.00;158
13078;63;625788188;13078;320;14159;14305;6.75;0.42;301.94;12.15;1081;64;4898.00;146
13080;63;625788202;13080;326;14165;14305;6.72;0.41;301.91;12.15;1085;64;4899.00;140
13081;63;625788217;13081;326;14173;14305;6.70;0.41;301.93;12.15;1092;64;4900.00;132
13083;63;625788235;13083;329;14180;14305;6.66;0.41;301.92;12.17;1097;64;4901.00;125
13086;63;625788248;13086;337;14185;14305;6.63;0.41;301.86;12.17;1099;64;4902.00;120
13088;63;625788268;13088;338;14189;14305;6.62;0.41;301.83;12.17;1101;64;4903.00;116
13091;63;625788282;13091;341;14195;14306;6.59;0.41;301.78;12.19;1104;64;4904.00;111
13091;63;625788296;13091;343;14199;14308;6.52;0.40;301.78;12.19;1108;64;4905.00;109
13093;63;625788311;13093;351;14203;14308;6.49;0.40;301.77;12.20;1110;64;4906.00;105
13095;63;625788325;13095;353;14204;14309;6.39;0.39;301.75;12.20;1109;64;4907.00;105
13098;63;625788340;13098;360;14207;14309;6.30;0.39;301.71;12.22;1109;64;4908.00;102
13100;63;625788352;13100;360;14208;14309;6.24;0.38;301.68;12.22;1108;64;4909.00;101
13104;63;625788366;13104;359;14212;14309;6.17;0.38;301.62;12.23;1108;64;4910.00;97
13105;63;625788380;13105;363;14214;14313;6.09;0.37;301.60;12.23;1109;64;4911.00;99
13106;63;625788396;13106;378;14217;14313;6.04;0.37;301.60;12.23;1111;64;4912.00;96
13106;63;625788409;13106;375;14219;14313;6.02;0.37;301.60;12.25;1113;64;4913.00;94
13107;63;625788422;13107;380;14222;14316;6.03;0.37;301.58;12.25;1115;64;4914.00;94
13108;63;625788436;13108;385;14224;14316;5.98;0.37;301.57;12.26;1116;64;4915.00;92
13110;63;625788450;13110;387;14225;14316;5.93;0.36;301.53;12.26;1115;64;4916.00;91
13112;63;625788463;13112;397;14228;14320;5.87;0.36;301.58;12.26;1116;64;4917.00;92
13113;63;625788477;13113;399;14232;14321;5.85;0.36;301.59;12.27;1119;64;4918.00;89
13114;63;625788490;13114;405;14234;14321;5.83;0.36;301.57;12.28;1120;64;4919.00;87
13114;63;625788505;13114;407;14239;14326;5.80;0.36;301.57;12.29;1125;64;4920.00;87
13118;63;625788518;13118;417;14240;14326;5.71;0.35;301.57;12.30;1122;64;4921.00;86
13122;63;625788530;13122;423;14241;14326;5.62;0.34;301.57;12.31;1119;64;4922.00;85
13124;63;625788543;13124;424;14243;14327;5.48;0.34;301.57;12.32;1119;64;4923.00;84
13126;63;625788555;13126;424;14244;14327;5.38;0.33;301.55;12.33;1118;64;4924.00;83
13131;63;625788574;13131;430;14249;14333;5.26;0.32;301.56;12.34;1118;64;4925.00;84
13135;63;625788601;13135;424;14250;14333;5.06;0.31;301.57;12.35;1115;64;4926.00;83
13138;63;625788621;13138;429;14251;14334;4.93;0.30;301.53;12.35;1113;64;4927.00;83
13142;63;625788639;13142;438;14252;14334;4.79;0.29;301.50;12.36;1110;64;4928.00;82
13145;63;625788658;13145;453;14253;14334;4.63;0.28;301.48;12.37;1108;64;4929.00;81
13147;63;625788674;13147;435;14253;14334;4.55;0.28;301.48;12.37;1106;64;4930.00;81
13153;63;625788689;13153;423;14255;14334;4.46;0.27;301.46;12.38;1102;64;4931.00;79
13155;63;625788703;13155;414;14265;14346;4.55;0.28;301.46;12.38;1110;64;4932.00;81
13157;63;625788718;13157;401;14266;14346;4.60;0.28;301.48;12.38;1109;64;4933.00;80
13159;63;625788732;13159;405;14268;14346;4.68;0.29;301.49;12.39;1109;64;4934.00;78
13159;63;625788746;13159;403;14268;14346;4.77;0.29;301.49;12.39;1109;64;4935.00;78
13162;63;625788759;13162;407;14269;14346;4.85;0.30;301.50;12.40;1107;64;4936.00;77
13164;63;625788774;13164;397;14269;14346;4.95;0.30;301.53;12.40;1105;64;4937.00;77
13166;63;625788789;13166;389;14272;14350;5.10;0.31;301.53;12.40;1106;64;4938.00;78
13169;63;625788802;13169;387;14272;14350;5.17;0.32;301.52;12.40;1103;64;4939.00;78
13169;63;625788823;13169;384;14275;14354;5.30;0.32;301.52;12.40;1106;64;4940.00;79
13170;63;625788839;13170;368;14277;14355;5.37;0.33;301.54;12.45;1107;64;4941.00;78
13173;63;625788853;13173;376;14278;14355;5.46;0.33;301.53;12.45;1105;64;4942.00;77
13176;63;625788868;13176;373;14278;14355;5.46;0.34;301.52;12.45;1102;64;4943.00;77
13177;63;625788883;13177;375;14289;14368;5.63;0.34;301.51;12.44;1112;64;4944.00;79
13182;63;625788898;13182;377;14289;14368;5.65;0.35;301.49;12.44;1107;64;4945.00;79
13186;63;625788912;13186;367;14289;14368;5.72;0.35;301.50;12.44;1103;64;4946.00;79
13188;63;625788926;13188;369;14290;14369;5.78;0.35;301.48;12.44;1102;64;4947.00;79
13189;63;625788940;13189;370;14290;14370;5.82;0.36;301.49;12.44;1101;64;4948.00;80
13194;63;625788955;13194;369;14290;14370;5.86;0.36;301.47;12.44;1096;64;4949.00;80
13198;63;625788971;13198;370;14294;14379;5.94;0.36;301.42;12.44;1096;64;4950.00;85
13202;63;625788987;13202;373;14296;14379;5.97;0.36;301.46;12.43;1094;64;4951.00;83
13206;63;625789001;13206;364;14297;14379;6.00;0.37;301.48;12.43;1091;64;4952.00;82
13208;63;625789016;13208;363;14297;14379;6.03;0.37;301.50;12.43;1089;64;4953.00;82
13211;63;625789030;13211;360;14301;14385;6.10;0.37;301.53;12.43;1090;64;4954.00;84
13214;63;625789045;13214;362;14301;14385;6.13;0.38;301.54;12.43;1087;64;4955.00;84
13220;63;625789067;13220;367;14302;14385;6.12;0.37;301.50;12.43;1082;64;4956.00;83
13226;63;625789083;13226;364;14303;14385;6.13;0.38;301.51;12.43;1077;64;4957.00;82
13231;63;625789098;13231;363;14306;14389;6.14;0.37;301.51;12.43;1075;64;4958.00;83
13234;63;625789115;13234;373;14308;14390;6.15;0.38;301.53;12.43;1074;64;4959.00;82
13238;63;625789129;13238;376;14308;14390;6.16;0.38;301.54;12.43;1070;64;4960.00;82
13242;63;625789145;13242;382;14309;14391;6.25;0.38;301.55;12.42;1067;64;4961.00;82
13248;63;625789161;13248;378;14309;14391;6.24;0.38;301.65;12.42;1061;64;4962.00;82
13254;63;625789177;13254;374;14309;14391;6.24;0.38;301.67;12.42;1055;64;4963.00;82
13258;63;625789192;13258;384;14309;14391;6.32;0.38;301.73;12.42;1051;64;4964.00;82
13262;63;625789208;13262;390;14309;14391;6.41;0.39;301.71;12.42;1047;64;4965.00;82
13265;63;625789224;13265;387;14309;14391;6.52;0.40;301.69;12.42;1044;64;4966.00;82
13268;63;625789239;13268;383;14309;14391;6.58;0.40;301.74;12.42;1041;64;4967.00;82
13273;63;625789254;13273;399;14354;14461;6.69;0.41;301.70;12.39;1081;64;4968.00;107
13276;63;625789277;13276;394;14354;14462;6.73;0.41;301.74;12.39;1078;64;4969.00;108
13281;63;625789292;13281;388;14359;14462;6.75;0.41;301.75;12.38;1078;64;4970.00;103
13285;63;625789308;13285;387;14362;14462;6.79;0.41;301.80;12.43;1077;64;4971.00;100
13288;63;625789325;13288;386;14364;14462;6.79;0.41;301.84;12.43;1076;64;4972.00;98
13290;63;625789348;13290;386;14368;14462;6.84;0.42;301.91;12.43;1078;64;4973.00;94
13291;63;625789364;13291;385;14370;14462;6.84;0.42;301.94;12.43;1079;64;4974.00;92
13293;63;625789379;13293;391;14373;14462;6.84;0.42;301.98;12.43;1080;64;4975.00;89
13295;63;625789401;13295;398;14375;14463;6.74;0.41;302.02;12.43;1080;64;4976.00;88
13300;63;625789423;13300;385;14377;14464;6.64;0.40;302.08;12.43;1077;64;4977.00;87
13305;63;625789439;13305;391;14378;14464;6.59;0.40;302.08;12.43;1073;64;4978.00;86
13310;63;625789456;13310;391;14381;14468;6.51;0.40;302.11;12.42;1071;64;4979.00;87
13313;63;625789475;13313;388;14381;14468;6.46;0.39;302.20;12.42;1068;64;4980.00;87
13315;63;625789491;13315;389;14381;14468;6.42;0.39;302.25;12.42;1066;64;4981.00;87
13316;63;625789507;13316;394;14381;14468;6.41;0.39;302.28;12.42;1065;64;4982.00;87
13320;63;625789523;13320;397;14386;14474;6.46;0.39;302.33;12.47;1066;64;4983.00;88
13324;63;625789540;13324;397;14386;14474;6.47;0.39;302.38;12.47;1062;64;4984.00;88
13329;63;625789556;13329;393;14387;14474;6.47;0.39;302.41;12.47;1058;64;4985.00;87
13330;63;625789572;13330;377;14389;14477;6.55;0.40;302.42;12.47;1059;64;4986.00;88
13334;63;625789589;13334;367;14390;14477;6.59;0.40;302.45;12.47;1056;64;4987.00;87
13335;63;625789606;13335;363;14390;14477;6.71;0.41;302.47;12.47;1055;64;4988.00;87
13339;63;625789622;13339;352;14390;14478;6.79;0.41;302.48;12.47;1051;64;4989.00;88
13340;63;625789639;13340;341;14391;14479;6.89;0.42;302.47;12.47;1051;64;4990.00;88
13344;63;625789654;13344;338;14391;14479;6.92;0.42;302.51;12.47;1047;64;4991.00;88
13347;63;625789670;13347;333;14402;14492;6.98;0.43;302.49;12.46;1055;64;4992.00;90
13351;63;625789686;13351;331;14402;14492;6.93;0.42;302.47;12.46;1051;64;4993.00;90
13354;63;625789708;13354;331;14402;14492;6.87;0.42;302.52;12.46;1048;64;4994.00;90
13358;63;625789724;13358;336;14404;14494;6.82;0.42;302.53;12.46;1046;64;4995.00;90
13361;63;625789740;13361;335;14404;14494;6.79;0.41;302.56;12.46;1043;64;4996.00;90
13365;63;625789755;13365;332;14407;14498;6.75;0.41;302.64;12.45;1042;64;4997.00;91
13369;63;625789771;13369;321;14407;14498;6.67;0.41;302.68;12.45;1038;64;4998.00;91
13375;63;625789786;13375;319;14411;14502;6.59;0.40;302.72;12.45;1036;64;4999.00;91
13378;63;625789803;13378;311;14411;14502;6.55;0.40;302.73;12.45;1033;64;5000.00;91
13382;63;625789822;13382;305;14411;14502;6.53;0.40;302.73;12.45;1029;64;5001.00;91
13384;63;625789838;13384;307;14411;14502;6.57;0.40;302.74;12.45;1027;64;5002.00;91
13385;63;625789852;13385;302;14411;14502;6.56;0.40;302.73;12.45;1026;64;5003.00;91
13386;63;625789866;13386;299;14421;14514;6.64;0.40;302.76;12.44;1035;64;5004.00;93
13388;63;625789882;13388;294;14421;14514;6.72;0.41;302.75;12.44;1033;64;5005.00;93
13392;63;625789897;13392;288;14422;14514;6.73;0.41;302.73;12.44;1030;64;5006.00;92
13393;63;625789912;13393;284;14422;14514;6.75;0.41;302.74;12.44;1029;64;5007.00;92
13394;63;625789926;13394;281;14422;14514;6.79;0.41;302.73;12.44;1028;64;5008.00;92
13396;63;625789944;13396;283;14422;14514;6.79;0.41;302.75;12.44;1026;64;5009.00;92
13396;63;625789961;13396;281;14422;14515;6.78;0.41;302.75;12.44;1026;64;5010.00;93
13397;63;625789975;13397;283;14422;14515;6.80;0.41;302.76;12.44;1025;64;5011.00;93
13398;63;625789990;13398;288;14427;14521;6.81;0.41;302.76;12.49;1029;64;5012.00;94
13399;63;625790005;13399;288;14428;14522;6.77;0.41;302.79;12.48;1029;64;5013.00;94
13403;63;625790020;13403;284;14429;14522;6.80;0.41;302.86;12.48;1026;64;5014.00;93
13405;63;625790034;13405;286;14429;14522;6.75;0.41;302.85;12.48;1024;64;5015.00;93
13407;63;625790047;13407;285;14432;14526;6.69;0.41;302.84;12.48;1025;64;5016.00;94
13408;63;625790062;13408;283;14432;14526;6.60;0.40;302.83;12.48;1024;64;5017.00;94
13408;63;625790075;13408;284;14432;14526;6.52;0.40;302.83;12.48;1024;64;5018.00;94
13409;63;625790089;13409;279;14433;14527;6.48;0.39;302.83;12.48;1024;64;5019.00;94
13410;63;625790108;13410;275;14436;14531;6.43;0.39;302.87;12.48;1026;64;5020.00;95
13410;63;625790122;13410;272;14436;14531;6.38;0.39;302.87;12.48;1026;64;5021.00;95
13411;63;625790136;13411;264;14438;14534;6.34;0.39;302.86;12.48;1027;64;5022.00;96
13411;63;625790150;13411;253;14438;14534;6.33;0.39;302.86;12.48;1027;64;5023.00;96
13416;63;625790164;13416;250;14439;14534;6.27;0.38;302.86;12.48;1023;64;5024.00;95
13419;63;625790177;13419;242;14439;14534;6.20;0.38;302.85;12.48;1020;64;5025.00;95
13424;63;625790191;13424;246;14442;14538;6.20;0.38;302.94;12.47;1018;64;5026.00;96
13427;63;625790205;13427;249;14442;14538;6.19;0.38;302.96;12.47;1015;64;5027.00;96
13431;63;625790218;13431;249;14443;14538;6.20;0.38;302.97;12.47;1012;64;5028.00;95
13434;63;625790231;13434;244;14443;14538;6.19;0.38;302.96;12.47;1009;64;5029.00;95
13435;63;625790244;13435;246;14443;14539;6.17;0.38;302.94;12.47;1008;64;5030.00;96
13440;63;625790256;13440;245;14444;14540;6.07;0.37;302.94;12.47;1004;64;5031.00;96
13445;63;625790270;13445;236;14444;14540;5.99;0.36;303.01;12.47;999;64;5032.00;96
13449;63;625790282;13449;235;14445;14541;5.89;0.36;303.06;12.47;996;64;5033.00;96
13451;64;625790295;13451;227;14447;14541;5.84;0.35;303.05;12.54;996;65;5034.00;94
13454;64;625790325;13454;229;14448;14541;5.84;0.35;303.08;12.56;994;65;5035.00;93
13457;64;625790338;13457;226;14449;14541;5.83;0.35;303.17;12.61;992;65;5036.00;92
13459;64;625790350;13459;220;14449;14541;5.80;0.35;303.17;12.61;990;65;5037.00;92
13465;64;625790362;13465;220;14449;14541;5.77;0.35;303.24;12.61;984;65;5038.00;92
13469;64;625790375;13469;218;14450;14541;5.79;0.35;303.33;12.66;981;65;5039.00;91
13470;64;625790388;13470;250;14550;14771;6.06;0.38;303.31;12.57;1080;65;5040.00;221
13474;64;625790424;13474;246;14553;14772;6.05;0.38;303.36;12.57;1079;65;5041.00;219
13475;64;625790438;13475;233;14562;14772;6.12;0.38;303.41;12.57;1087;65;5042.00;210
13476;64;625790452;13476;225;14564;14772;6.13;0.38;303.39;12.57;1088;65;5043.00;208
13477;64;625790467;13477;221;14574;14772;6.21;0.39;303.38;12.56;1097;65;5044.00;198
13478;64;625790481;13478;223;14578;14772;6.31;0.39;303.37;12.56;1100;65;5045.00;194
13480;64;625790497;13480;215;14585;14772;6.36;0.39;303.34;12.55;1105;65;5046.00;187
13480;64;625790510;13480;220;14592;14772;6.43;0.40;303.34;12.55;1112;65;5047.00;180
13481;64;625790526;13481;216;14598;14773;6.51;0.40;303.33;12.55;1117;65;5048.00;175
13485;64;625790541;13485;221;14599;14774;6.55;0.41;303.29;12.55;1114;65;5049.00;175
13486;64;625790556;13486;226;14603;14774;6.61;0.41;303.27;12.55;1117;65;5050.00;171
13487;64;625790576;13487;229;14607;14775;6.63;0.41;303.29;12.55;1120;65;5051.00;168
13489;64;625790598;13489;231;14611;14775;6.61;0.41;303.37;12.56;1122;65;5052.00;164
13492;64;625790621;13492;232;14614;14775;6.59;0.41;303.37;12.56;1122;65;5053.00;161
13493;64;625790645;13493;235;14620;14775;6.59;0.41;303.36;12.56;1127;65;5054.00;155
13495;64;625790667;13495;236;14623;14779;6.58;0.41;303.41;12.56;1128;65;5055.00;156
13497;64;625790686;13497;237;14626;14779;6.56;0.40;303.43;12.58;1129;65;5056.00;153
13500;64;625790705;13500;240;14629;14779;6.50;0.40;303.43;12.58;1129;65;5057.00;150
13504;64;625790722;13504;239;14632;14782;6.44;0.40;303.38;12.58;1128;65;5058.00;150
13505;64;625790739;13505;246;14636;14782;6.39;0.39;303.36;12.58;1131;65;5059.00;146
13506;64;625790755;13506;244;14641;14782;6.39;0.39;303.37;12.60;1135;65;5060.00;141
13506;64;625790773;13506;253;14647;14786;6.40;0.39;303.37;12.60;1141;65;5061.00;139
13509;64;625790790;13509;252;14650;14787;6.40;0.39;303.34;12.61;1141;65;5062.00;137
13510;64;625790806;13510;269;14653;14787;6.41;0.40;303.43;12.63;1143;65;5063.00;134
13513;64;625790821;13513;279;14655;14791;6.40;0.39;303.39;12.63;1142;65;5064.00;136
13514;64;625790838;13514;289;14659;14791;6.41;0.39;303.40;12.65;1145;65;5065.00;132
13517;64;625790854;13517;294;14663;14791;6.42;0.40;303.36;12.65;1146;65;5066.00;128
13520;64;625790870;13520;309;14666;14792;6.41;0.39;303.31;12.67;1146;65;5067.00;126
13521;64;625790887;13521;307;14668;14792;6.36;0.39;303.28;12.67;1147;65;5068.00;124
13522;64;625790908;13522;317;14674;14798;6.34;0.39;303.27;12.68;1152;65;5069.00;124
13526;64;625790927;13526;322;14674;14798;6.27;0.38;303.30;12.68;1148;65;5070.00;124
13529;64;625790946;13529;338;14676;14799;6.22;0.38;303.29;12.70;1147;65;5071.00;123
13533;64;625790963;13533;353;14679;14799;6.09;0.37;303.26;12.70;1146;65;5072.00;120
13535;64;625790979;13535;369;14680;14799;6.01;0.37;303.22;12.71;1145;65;5073.00;119
13539;64;625790994;13539;372;14682;14799;5.93;0.36;303.20;12.72;1143;65;5074.00;117
13540;64;625791009;13540;385;14684;14799;5.84;0.36;303.21;12.73;1144;65;5075.00;115
13542;64;625791024;13542;391;14697;14811;5.79;0.35;303.19;12.72;1155;65;5076.00;114
13543;64;625791042;13543;394;14699;14811;5.68;0.35;303.17;12.74;1156;65;5077.00;112
13544;64;625791057;13544;402;14703;14811;5.56;0.34;303.15;12.76;1159;65;5078.00;108
13545;64;625791072;13545;411;14704;14811;5.44;0.33;303.14;12.76;1159;65;5079.00;107
13547;64;625791088;13547;412;14706;14811;5.35;0.33;303.11;12.76;1159;65;5080.00;105
13547;64;625791104;13547;414;14709;14811;5.33;0.33;303.11;12.78;1162;65;5081.00;102
13548;64;625791118;13548;424;14713;14815;5.28;0.32;303.10;12.77;1165;65;5082.00;102
13549;64;625791132;13549;409;14715;14815;5.24;0.32;303.09;12.79;1166;65;5083.00;100
13550;64;625791146;13550;396;14718;14819;5.28;0.32;303.08;12.78;1168;65;5084.00;101
13554;64;625791161;13554;395;14721;14821;5.29;0.32;303.17;12.79;1167;65;5085.00;100
13555;64;625791176;13555;394;14723;14821;5.37;0.33;303.16;12.80;1168;65;5086.00;98
13556;64;625791191;13556;394;14723;14821;5.40;0.33;303.14;12.80;1167;65;5087.00;98
13556;64;625791207;13556;396;14734;14834;5.49;0.34;303.14;12.80;1178;65;5088.00;100
13556;64;625791222;13556;392;14735;14834;5.57;0.34;303.14;12.80;1179;65;5089.00;99
13558;64;625791243;13558;390;14736;14834;5.66;0.35;303.11;12.80;1178;65;5090.00;98
13560;64;625791259;13560;385;14739;14835;5.69;0.35;303.10;12.81;1179;65;5091.00;96
13562;64;625791274;13562;379;14739;14836;5.70;0.35;303.09;12.81;1177;65;5092.00;97
13564;64;625791296;13564;371;14739;14836;5.69;0.35;303.07;12.81;1175;65;5093.00;97
13566;64;625791317;13566;372;14742;14839;5.71;0.35;303.06;12.82;1176;65;5094.00;97
13568;64;625791333;13568;371;14743;14839;5.74;0.35;303.05;12.82;1175;65;5095.00;96
13570;64;625791348;13570;379;14743;14839;5.73;0.35;303.07;12.82;1173;65;5096.00;96
13576;64;625791362;13576;381;14743;14839;5.64;0.35;303.05;12.82;1167;65;5097.00;96
13577;64;625791376;13577;395;14747;14845;5.67;0.35;303.03;12.82;1170;65;5098.00;98
13579;64;625791392;13579;403;14748;14845;5.64;0.35;303.05;12.82;1169;65;5099.00;97
13582;64;625791409;13582;400;14758;14864;5.56;0.34;303.05;12.87;1176;65;5100.00;106
13583;64;625791432;13583;393;14759;14864;5.56;0.34;303.04;12.87;1176;65;5101.00;105
13587;64;625791446;13587;390;14762;14868;5.54;0.34;303.08;12.87;1175;65;5102.00;106
13589;64;625791461;13589;387;14763;14869;5.59;0.34;303.08;12.87;1174;65;5103.00;106
13592;64;625791478;13592;400;14765;14869;5.59;0.34;303.15;12.89;1173;65;5104.00;104
13596;64;625791493;13596;394;14766;14870;5.65;0.35;303.19;12.88;1170;65;5105.00;104
13602;64;625791507;13602;390;14769;14870;5.60;0.34;303.25;12.88;1167;65;5106.00;101
13604;64;625791527;13604;383;14769;14870;5.62;0.34;303.29;12.88;1165;65;5107.00;101
13605;64;625791540;13605;390;14769;14870;5.68;0.35;303.30;12.88;1164;65;5108.00;101
13611;64;625791554;13611;385;14773;14870;5.66;0.35;303.41;12.92;1162;65;5109.00;97
13614;64;625791570;13614;379;14773;14870;5.67;0.35;303.46;12.92;1159;65;5110.00;97
13616;64;625791586;13616;375;14775;14870;5.67;0.35;303.46;12.92;1159;65;5111.00;95
13619;64;625791600;13619;376;14809;14940;5.77;0.35;303.50;12.89;1190;65;5112.00;131
13626;64;625791621;13626;374;14811;14941;5.78;0.35;303.53;12.89;1185;65;5113.00;130
13631;64;625791636;13631;370;14819;14941;5.86;0.36;303.55;12.88;1188;65;5114.00;122
13636;64;625791650;13636;364;14823;14941;5.93;0.36;303.52;12.88;1187;65;5115.00;118
13638;64;625791663;13638;368;14826;14941;6.02;0.37;303.52;12.88;1188;65;5116.00;115
13643;64;625791677;13643;366;14829;14941;6.07;0.37;303.60;12.88;1186;65;5117.00;112
13646;64;625791690;13646;373;14831;14941;6.10;0.37;303.58;12.88;1185;65;5118.00;110
13648;64;625791703;13648;376;14833;14941;6.11;0.37;303.65;12.88;1185;65;5119.00;108
13652;64;625791718;13652;384;14835;14942;6.10;0.37;303.68;12.88;1183;65;5120.00;107
13656;64;625791731;13656;379;14838;14943;6.14;0.37;303.69;12.87;1182;65;5121.00;105
13660;64;625791745;13660;378;14839;14943;6.13;0.37;303.72;12.87;1179;65;5122.00;104
13662;64;625791759;13662;387;14843;14947;6.14;0.38;303.78;12.87;1181;65;5123.00;104
13666;64;625791774;13666;387;14843;14947;6.16;0.38;303.86;12.87;1177;65;5124.00;104
13671;64;625791788;13671;388;14843;14947;6.18;0.38;303.79;12.87;1172;65;5125.00;104
13675;64;625791803;13675;391;14843;14947;6.17;0.38;303.86;12.87;1168;65;5126.00;104
13681;64;625791817;13681;389;14846;14953;6.17;0.38;303.99;12.87;1165;65;5127.00;107
13684;64;625791833;13684;388;14847;14953;6.18;0.38;303.94;12.87;1163;65;5128.00;106
13690;64;625791847;13690;386;14848;14953;6.20;0.38;304.01;12.87;1158;65;5129.00;105
13695;64;625791870;13695;387;14851;14959;6.24;0.38;304.07;12.87;1156;65;5130.00;108
13699;64;625791885;13699;389;14851;14959;6.25;0.38;304.10;12.87;1152;65;5131.00;108
13705;64;625791899;13705;394;14854;14959;6.23;0.38;304.18;12.92;1149;65;5132.00;105
13710;64;625791915;13710;403;14854;14960;6.24;0.38;304.22;12.92;1144;65;5133.00;106
13714;64;625791930;13714;410;14857;14961;6.24;0.38;304.27;12.93;1143;65;5134.00;104
13720;64;625791945;13720;406;14857;14961;6.23;0.38;304.25;12.93;1137;65;5135.00;104
13721;64;625791959;13721;409;14865;14974;6.23;0.38;304.23;12.92;1144;65;5136.00;109
13727;64;625791974;13727;406;14867;14974;6.24;0.38;304.24;12.92;1140;65;5137.00;107
13730;64;625791989;13730;407;14868;14974;6.28;0.38;304.24;12.92;1138;65;5138.00;106
13735;64;625792003;13735;407;14870;14975;6.29;0.38;304.32;12.92;1135;65;5139.00;105
13738;64;625792018;13738;412;14872;14975;6.31;0.39;304.38;12.92;1134;65;5140.00;103
13744;64;625792032;13744;413;14875;14979;6.28;0.38;304.38;12.92;1131;65;5141.00;104
13748;64;625792048;13748;423;14876;14979;6.24;0.38;304.52;12.92;1128;65;5142.00;103
13752;64;625792064;13752;424;14880;14983;6.26;0.38;304.56;12.92;1128;65;5143.00;103
13754;64;625792079;13754;428;14881;14983;6.25;0.38;304.57;12.92;1127;65;5144.00;102
13757;64;625792093;13757;436;14881;14983;6.21;0.38;304.59;12.92;1124;65;5145.00;102
13760;64;625792107;13760;440;14882;14983;6.17;0.38;304.65;12.92;1122;65;5146.00;101
13761;64;625792121;13761;438;14882;14983;6.14;0.38;304.71;12.92;1121;65;5147.00;101
13762;64;625792136;13762;429;14891;14995;6.17;0.38;304.72;12.91;1129;65;5148.00;104
13769;64;625792151;13769;423;14894;14995;6.17;0.38;304.81;12.97;1125;65;5149.00;101
13774;64;625792166;13774;418;14895;14995;6.18;0.38;304.84;12.97;1121;65;5150.00;100
13776;64;625792181;13776;420;14896;14995;6.17;0.38;304.86;12.97;1120;65;5151.00;99
13779;64;625792195;13779;423;14896;14995;6.14;0.38;304.91;12.97;1117;65;5152.00;99
13782;64;625792209;13782;421;14896;14995;6.10;0.37;304.90;12.97;1114;65;5153.00;99
13787;64;625792223;13787;425;14897;14996;6.05;0.37;304.93;12.97;1110;65;5154.00;99
13789;64;625792237;13789;433;14899;14998;6.00;0.37;304.98;12.96;1110;65;5155.00;99
13794;64;625792252;13794;422;14902;15004;6.01;0.37;305.00;12.96;1108;65;5156.00;102
13800;64;625792267;13800;417;14903;15005;6.09;0.37;305.01;12.96;1103;65;5157.00;102
13804;64;625792281;13804;414;14905;15005;6.11;0.37;305.02;13.02;1101;65;5158.00;100
13807;64;625792303;13807;407;14906;15005;6.13;0.37;305.04;13.02;1099;65;5159.00;99
13811;64;625792318;13811;399;14911;15010;6.12;0.37;305.02;13.01;1100;65;5160.00;99
13814;64;625792340;13814;404;14911;15010;6.11;0.37;305.06;13.01;1097;65;5161.00;99
13817;64;625792354;13817;400;14911;15010;6.15;0.37;305.05;13.01;1094;65;5162.00;99
13819;64;625792368;13819;399;14912;15011;6.19;0.38;305.08;13.01;1093;65;5163.00;99
13821;64;625792382;13821;393;14915;15015;6.16;0.37;305.08;13.01;1094;65;5164.00;100
13823;64;625792401;13823;394;14915;15015;6.14;0.37;305.09;13.01;1092;65;5165.00;100
13825;64;625792415;13825;396;14918;15018;6.15;0.37;305.10;13.01;1093;65;5166.00;100
13827;64;625792429;13827;390;14918;15018;6.12;0.37;305.17;13.01;1091;65;5167.00;100
13829;64;625792443;13829;393;14918;15018;6.14;0.37;305.22;13.01;1089;65;5168.00;100
13830;64;625792457;13830;385;14918;15018;6.14;0.37;305.22;13.01;1088;65;5169.00;100
13832;64;625792470;13832;387;14921;15022;6.13;0.37;305.31;13.00;1089;65;5170.00;101
13835;64;625792484;13835;373;14922;15022;6.18;0.37;305.30;13.00;1087;65;5171.00;100
13838;64;625792498;13838;369;14922;15022;6.22;0.38;305.43;13.00;1084;65;5172.00;100
13842;64;625792511;13842;365;14922;15022;6.23;0.38;305.43;13.00;1080;65;5173.00;100
13844;64;625792525;13844;360;14922;15023;6.21;0.38;305.51;13.00;1078;65;5174.00;101
13845;64;625792539;13845;361;14924;15025;6.20;0.38;305.54;13.00;1079;65;5175.00;101
13849;64;625792552;13849;358;14924;15025;6.15;0.37;305.67;13.00;1075;65;5176.00;101
13852;64;625792565;13852;353;14925;15026;6.14;0.37;305.70;13.00;1073;65;5177.00;101
13854;64;625792586;13854;346;14925;15026;6.14;0.37;305.67;13.00;1071;65;5178.00;101
13856;64;625792616;13856;357;14925;15026;6.13;0.37;305.68;13.00;1069;65;5179.00;101
13857;64;625792638;13857;361;14925;15026;6.16;0.37;305.67;13.00;1068;65;5180.00;101
13858;64;625792660;13858;357;14925;15026;6.15;0.37;305.67;13.00;1067;65;5181.00;101
13860;64;625792682;13860;359;14925;15026;6.15;0.37;305.66;13.00;1065;65;5182.00;101
13861;64;625792697;13861;363;14925;15026;6.15;0.37;305.71;13.00;1064;65;5183.00;101
13862;64;625792714;13862;393;14996;15153;6.18;0.38;305.71;12.94;1134;65;5184.00;157
13866;64;625792743;13866;383;14997;15154;6.14;0.38;305.74;12.94;1131;65;5185.00;157
13867;64;625792759;13867;373;15004;15154;6.22;0.38;305.73;12.93;1137;65;5186.00;150
13869;64;625792774;13869;371;15005;15154;6.21;0.38;305.74;12.93;1136;65;5187.00;149
13869;64;625792789;13869;375;15013;15154;6.26;0.39;305.74;12.98;1144;65;5188.00;141
13871;64;625792805;13871;384;15016;15154;6.29;0.39;305.74;12.98;1145;65;5189.00;138
13873;64;625792823;13873;377;15022;15154;6.36;0.39;305.72;12.98;1149;65;5190.00;132
13876;64;625792838;13876;377;15023;15154;6.31;0.39;305.68;12.98;1147;65;5191.00;131
13876;64;625792854;13876;370;15027;15155;6.33;0.39;305.68;12.98;1151;65;5192.00;128
13878;64;625792875;13878;366;15030;15156;6.30;0.39;305.67;12.98;1152;65;5193.00;126
13878;64;625792892;13878;365;15033;15156;6.28;0.39;305.67;12.98;1155;65;5194.00;123
13880;64;625792908;13880;365;15035;15157;6.27;0.38;305.67;12.98;1155;65;5195.00;122
13883;64;625792929;13883;365;15037;15157;6.24;0.38;305.67;12.98;1154;65;5196.00;120
13884;64;625792946;13884;363;15038;15157;6.23;0.38;305.67;12.98;1154;65;5197.00;119
13885;64;625792961;13885;362;15039;15157;6.18;0.38;305.68;12.98;1154;65;5198.00;118
13888;64;625792976;13888;357;15041;15161;6.12;0.38;305.66;12.98;1153;65;5199.00;120
13890;64;625792991;13890;368;15042;15161;6.04;0.37;305.67;12.98;1152;65;5200.00;119
13894;64;625793010;13894;367;15045;15161;5.88;0.36;305.64;13.03;1151;65;5201.00;116
13897;64;625793025;13897;362;15047;15164;5.79;0.35;305.71;13.03;1150;65;5202.00;117
13899;64;625793040;13899;369;15048;15164;5.66;0.35;305.70;13.03;1149;65;5203.00;116
13903;64;625793054;13903;367;15048;15164;5.52;0.34;305.67;13.03;1145;65;5204.00;116
13907;64;625793069;13907;366;15054;15168;5.44;0.33;305.63;13.10;1147;65;5205.00;114
13908;64;625793093;13908;356;15055;15169;5.41;0.33;305.61;13.10;1147;65;5206.00;114
13911;64;625793108;13911;360;15057;15169;5.38;0.33;305.61;13.12;1146;65;5207.00;112
13913;64;625793122;13913;352;15059;15173;5.38;0.33;305.59;13.11;1146;65;5208.00;114
13918;64;625793136;13918;361;15060;15173;5.36;0.33;305.58;13.11;1142;65;5209.00;113
13918;64;625793151;13918;350;15060;15173;5.37;0.33;305.58;13.11;1142;65;5210.00;113
13922;64;625793164;13922;351;15061;15174;5.37;0.33;305.52;13.11;1139;65;5211.00;113
13924;64;625793180;13924;353;15061;15174;5.39;0.33;305.49;13.11;1137;65;5212.00;113
13926;64;625793194;13926;356;15064;15180;5.43;0.33;305.47;13.11;1138;65;5213.00;116
13930;64;625793209;13930;359;15065;15180;5.39;0.33;305.42;13.11;1135;65;5214.00;115
13933;64;625793223;13933;363;15066;15180;5.37;0.33;305.38;13.11;1133;65;5215.00;114
13936;64;625793237;13936;360;15066;15181;5.35;0.32;305.33;13.11;1130;65;5216.00;115
13937;64;625793252;13937;358;15066;15181;5.37;0.33;305.31;13.11;1129;65;5217.00;115
13938;64;625793267;13938;368;15067;15181;5.35;0.32;305.29;13.11;1129;65;5218.00;114
13940;64;625793281;13940;373;15067;15181;5.30;0.32;305.26;13.11;1127;65;5219.00;114
13941;64;625793297;13941;377;15086;15217;5.39;0.33;305.28;13.10;1145;65;5220.00;131
13942;64;625793317;13942;377;15089;15217;5.42;0.33;305.28;13.10;1147;65;5221.00;128
13943;64;625793331;13943;378;15091;15217;5.48;0.33;305.28;13.09;1148;65;5222.00;126
13945;64;625793345;13945;375;15092;15217;5.46;0.33;305.28;13.09;1147;65;5223.00;125
13946;64;625793359;13946;374;15094;15217;5.45;0.33;305.28;13.09;1148;65;5224.00;123
13949;64;625793381;13949;378;15096;15217;5.43;0.33;305.34;13.09;1147;65;5225.00;121
13949;64;625793398;13949;378;15099;15221;5.46;0.33;305.34;13.09;1150;65;5226.00;122
13951;64;625793413;13951;382;15100;15221;5.52;0.34;305.31;13.09;1149;65;5227.00;121
13952;64;625793427;13952;387;15103;15225;5.54;0.34;305.30;13.09;1151;65;5228.00;122
13952;64;625793442;13952;392;15106;15226;5.62;0.34;305.30;13.08;1154;65;5229.00;120
13952;64;625793457;13952;392;15108;15226;5.68;0.35;305.30;13.10;1156;65;5230.00;118
13954;64;625793472;13954;394;15109;15226;5.68;0.35;305.29;13.10;1155;65;5231.00;117
13956;64;625793487;13956;396;15120;15239;5.63;0.34;305.26;13.11;1164;65;5232.00;119
13959;64;625793502;13959;403;15121;15239;5.60;0.34;305.27;13.12;1162;65;5233.00;118
13959;64;625793517;13959;399;15122;15239;5.59;0.34;305.27;13.12;1163;65;5234.00;117
13961;64;625793531;13961;393;15126;15240;5.61;0.34;305.26;13.14;1165;65;5235.00;114
13962;64;625793547;13962;382;15126;15241;5.64;0.34;305.25;13.14;1164;65;5236.00;115
13964;64;625793574;13964;383;15129;15241;5.67;0.34;305.23;13.17;1165;65;5237.00;112
13967;64;625793592;13967;379;15131;15244;5.72;0.35;305.23;13.17;1164;65;5238.00;113
13967;64;625793608;13967;374;15132;15244;5.73;0.35;305.23;13.18;1165;65;5239.00;112
13969;64;625793624;13969;368;15135;15244;5.76;0.35;305.24;13.19;1166;65;5240.00;109
13969;64;625793640;13969;364;15136;15244;5.82;0.35;305.24;13.21;1167;65;5241.00;108
13971;64;625793654;13971;363;15140;15250;5.85;0.35;305.23;13.20;1169;65;5242.00;110
13972;64;625793670;13972;365;15142;15250;5.84;0.35;305.22;13.22;1170;65;5243.00;108
13972;64;625793684;13972;365;15143;15250;5.85;0.36;305.22;13.22;1171;65;5244.00;107
13972;64;625793703;13972;367;15144;15250;5.86;0.36;305.22;13.22;1172;65;5245.00;106
13973;64;625793716;13973;357;15149;15254;5.85;0.36;305.21;13.23;1176;65;5246.00;105
13974;64;625793729;13974;361;15150;15255;5.85;0.36;305.22;13.23;1176;65;5247.00;105
13976;64;625793743;13976;361;15151;15255;5.84;0.35;305.23;13.25;1175;65;5248.00;104
13977;64;625793756;13977;355;15152;15256;5.86;0.36;305.21;13.25;1175;65;5249.00;104
13981;64;625793771;13981;346;15153;15256;5.85;0.36;305.19;13.26;1172;65;5250.00;103
13983;64;625793784;13983;339;15155;15256;5.81;0.35;305.16;13.26;1172;65;5251.00;101
13983;65;625793798;13983;328;15156;15256;5.83;0.35;305.16;13.27;1173;66;5252.00;100
13984;65;625793827;13984;335;15157;15256;5.84;0.35;305.15;13.28;1173;66;5253.00;99
13984;65;625793841;13984;340;15158;15256;5.86;0.36;305.15;13.28;1174;66;5254.00;98
13985;65;625793858;13985;336;15159;15256;5.84;0.35;305.14;13.29;1174;66;5255.00;97
13987;65;625793871;13987;346;15200;15326;5.98;0.36;305.11;13.25;1213;66;5256.00;126
13989;65;625793890;13989;342;15204;15327;5.99;0.36;305.09;13.27;1215;66;5257.00;123
13989;65;625793903;13989;340;15212;15327;6.03;0.37;305.09;13.26;1223;66;5258.00;115
13992;65;625793921;13992;348;15217;15327;6.05;0.37;305.08;13.27;1225;66;5259.00;110
13995;65;625793935;13995;349;15221;15327;5.98;0.36;305.15;13.27;1226;66;5260.00;106
13996;65;625793948;13996;351;15226;15327;5.92;0.36;305.18;13.26;1230;66;5261.00;101
13996;65;625793961;13996;360;15228;15327;5.89;0.36;305.18;13.26;1232;66;5262.00;99
14000;65;625793974;14000;365;15233;15327;5.79;0.35;305.19;13.31;1233;66;5263.00;94
14005;65;625793987;14005;372;15234;15328;5.75;0.35;305.21;13.31;1229;66;5264.00;94
14008;65;625794000;14008;379;15237;15330;5.68;0.35;305.27;13.32;1229;66;5265.00;93
14011;65;625794014;14011;387;15238;15330;5.62;0.34;305.27;13.33;1227;66;5266.00;92
14014;65;625794027;14014;388;15241;15334;5.57;0.34;305.24;13.32;1227;66;5267.00;93
14018;65;625794041;14018;398;15242;15334;5.51;0.34;305.28;13.34;1224;66;5268.00;92
14023;65;625794054;14023;402;15243;15334;5.46;0.33;305.35;13.34;1220;66;5269.00;91
14027;65;625794067;14027;398;15243;15334;5.44;0.33;305.37;13.34;1216;66;5270.00;91
14032;65;625794081;14032;398;15250;15340;5.43;0.33;305.51;13.35;1218;66;5271.00;90
14034;65;625794095;14034;397;15250;15340;5.42;0.33;305.55;13.35;1216;66;5272.00;90
14037;65;625794108;14037;400;15251;15340;5.43;0.33;305.56;13.36;1214;66;5273.00;89
14041;65;625794122;14041;396;15255;15343;5.43;0.33;305.59;13.37;1214;66;5274.00;88
14043;65;625794136;14043;407;15256;15343;5.46;0.33;305.60;13.37;1213;66;5275.00;87
14048;65;625794149;14048;406;15256;15343;5.49;0.34;305.66;13.37;1208;66;5276.00;87
14051;65;625794163;14051;410;15256;15344;5.53;0.34;305.75;13.37;1205;66;5277.00;88
14054;65;625794177;14054;408;15257;15345;5.61;0.34;305.79;13.37;1203;66;5278.00;88
14058;65;625794191;14058;400;15257;15345;5.61;0.34;305.84;13.37;1199;66;5279.00;88
14064;65;625794207;14064;401;15277;15371;5.66;0.34;305.90;13.36;1213;66;5280.00;94
14068;65;625794223;14068;391;15278;15371;5.72;0.35;305.94;13.35;1210;66;5281.00;93
14071;65;625794237;14071;384;15279;15371;5.83;0.36;305.96;13.35;1208;66;5282.00;92
14076;65;625794251;14076;382;15280;15372;5.93;0.36;306.01;13.35;1204;66;5283.00;92
14079;65;625794265;14079;368;15280;15372;6.01;0.37;306.04;13.35;1201;66;5284.00;92
14083;65;625794280;14083;367;15284;15376;6.10;0.37;306.07;13.35;1201;66;5285.00;92
14086;65;625794295;14086;365;15284;15376;6.14;0.37;306.11;13.35;1198;66;5286.00;92
14093;65;625794309;14093;366;15287;15379;6.19;0.38;306.23;13.35;1194;66;5287.00;92
14096;65;625794324;14096;363;15287;15380;6.24;0.38;306.25;13.35;1191;66;5288.00;93
14102;65;625794338;14102;361;15287;15380;6.30;0.38;306.35;13.35;1185;66;5289.00;93
14107;65;625794354;14107;360;15287;15380;6.32;0.39;306.43;13.35;1180;66;5290.00;93
14110;65;625794375;14110;360;15287;15380;6.34;0.39;306.46;13.35;1177;66;5291.00;93
14117;66;625794390;14117;364;15295;15392;6.35;0.39;306.46;13.34;1178;67;5292.00;97
14122;66;625794423;14122;366;15295;15392;6.36;0.39;306.52;13.34;1173;67;5293.00;97
14128;66;625794438;14128;366;15297;15392;6.37;0.39;306.58;13.34;1169;67;5294.00;95
14134;66;625794459;14134;372;15297;15392;6.37;0.39;306.72;13.34;1163;67;5295.00;95
14138;66;625794473;14138;377;15298;15392;6.40;0.39;306.80;13.40;1160;67;5296.00;94
14143;66;625794494;14143;387;15298;15392;6.46;0.39;306.80;13.40;1155;67;5297.00;94
14146;66;625794508;14146;382;15298;15393;6.48;0.39;306.88;13.40;1152;67;5298.00;95
14153;66;625794523;14153;383;15298;15393;6.47;0.39;306.89;13.40;1145;67;5299.00;95
14159;66;625794538;14159;388;15302;15399;6.50;0.40;306.95;13.40;1143;67;5300.00;97
14165;66;625794558;14165;388;15304;15400;6.50;0.40;307.03;13.40;1139;67;5301.00;96
14168;66;625794578;14168;396;15304;15400;6.47;0.39;307.08;13.40;1136;67;5302.00;96
14173;66;625794603;14173;400;15304;15400;6.45;0.39;307.10;13.40;1131;67;5303.00;96
14178;66;625794629;14178;410;15307;15404;6.46;0.39;307.17;13.39;1129;67;5304.00;97
14183;66;625794656;14183;404;15307;15404;6.46;0.39;307.25;13.39;1124;67;5305.00;97
14186;66;625794681;14186;411;15307;15404;6.43;0.39;307.33;13.39;1121;67;5306.00;97
14189;66;625794705;14189;417;15308;15405;6.42;0.39;307.41;13.39;1119;67;5307.00;97
14195;66;625794722;14195;415;15311;15409;6.39;0.39;307.50;13.39;1116;67;5308.00;98
14197;66;625794739;14197;425;15311;15409;6.37;0.39;307.54;13.39;1114;67;5309.00;98
14203;66;625794759;14203;427;15314;15415;6.31;0.38;307.55;13.39;1111;67;5310.00;101
14206;66;625794778;14206;433;15315;15415;6.21;0.38;307.63;13.39;1109;67;5311.00;100
14208;66;625794796;14208;426;15316;15415;6.17;0.38;307.62;13.39;1108;67;5312.00;99
14211;66;625794812;14211;425;15316;15415;6.12;0.37;307.67;13.39;1105;67;5313.00;99
14215;66;625794829;14215;429;15319;15419;6.11;0.37;307.68;13.38;1104;67;5314.00;100
14219;66;625794845;14219;429;15319;15419;6.05;0.37;307.72;13.38;1100;67;5315.00;100
14223;66;625794861;14223;439;15320;15419;6.01;0.37;307.77;13.38;1097;67;5316.00;99
14226;66;625794877;14226;433;15320;15419;5.98;0.36;307.76;13.38;1094;67;5317.00;99
14231;66;625794894;14231;422;15321;15420;6.02;0.37;307.75;13.38;1090;67;5318.00;99
14234;66;625794910;14234;419;15322;15421;6.12;0.37;307.75;13.38;1088;68;5319.00;99
14235;66;625794937;14235;414;15322;15421;6.18;0.38;307.74;13.38;1087;68;5320.00;99
14238;66;625794954;14238;412;15323;15422;6.22;0.38;307.74;13.38;1085;68;5321.00;99
14243;66;625794971;14243;410;15323;15422;6.23;0.38;307.75;13.38;1080;68;5322.00;99
14245;66;625794987;14245;414;15323;15422;6.25;0.38;307.77;13.38;1078;68;5323.00;99
14248;66;625795002;14248;416;15323;15422;6.21;0.38;307.79;13.38;1075;68;5324.00;99
14252;66;625795018;14252;418;15323;15422;6.15;0.37;307.87;13.38;1071;68;5325.00;99
14255;66;625795034;14255;410;15323;15422;6.12;0.37;307.96;13.38;1068;68;5326.00;99
14257;66;625795050;14257;404;15323;15422;6.17;0.37;307.95;13.38;1066;68;5327.00;99
14259;66;625795066;14259;434;15395;15549;6.16;0.38;308.01;13.32;1136;68;5328.00;154
14260;66;625795094;14260;417;15395;15550;6.20;0.38;308.00;13.32;1135;68;5329.00;155
14264;66;625795112;14264;402;15398;15550;6.25;0.39;308.06;13.32;1134;68;5330.00;152
14266;66;625795129;14266;394;15402;15550;6.28;0.39;308.08;13.31;1136;68;5331.00;148
14267;66;625795147;14267;383;15404;15550;6.36;0.39;308.09;13.31;1137;68;5332.00;146
14272;66;625795162;14272;385;15406;15550;6.45;0.40;308.07;13.31;1134;68;5333.00;144
14276;66;625795178;14276;387;15410;15550;6.53;0.40;308.11;13.31;1134;68;5334.00;140
14277;66;625795194;14277;386;15410;15550;6.59;0.41;308.13;13.31;1133;68;5335.00;140
14281;66;625795210;14281;381;15417;15551;6.65;0.41;308.15;13.31;1136;68;5336.00;134
14283;66;625795227;14283;377;15418;15552;6.65;0.41;308.15;13.31;1135;68;5337.00;134
14286;66;625795244;14286;380;15423;15552;6.69;0.41;308.18;13.31;1137;68;5338.00;129
14288;66;625795261;14288;365;15427;15553;6.66;0.41;308.17;13.31;1139;68;5339.00;126
14290;66;625795279;14290;363;15433;15553;6.68;0.41;308.21;13.31;1143;68;5340.00;120
14292;66;625795296;14292;360;15434;15553;6.63;0.41;308.19;13.31;1142;68;5341.00;119
14295;66;625795313;14295;360;15437;15553;6.60;0.41;308.29;13.31;1142;68;5342.00;116
14297;66;625795329;14297;363;15439;15557;6.56;0.40;308.36;13.30;1142;68;5343.00;118
14301;66;625795345;14301;366;15441;15557;6.49;0.40;308.37;13.30;1140;68;5344.00;116
14304;66;625795361;14304;367;15442;15557;6.42;0.39;308.37;13.30;1138;68;5345.00;115
14306;66;625795377;14306;374;15445;15560;6.36;0.39;308.39;13.30;1139;68;5346.00;115
14308;66;625795393;14308;379;15446;15560;6.32;0.39;308.38;13.30;1138;68;5347.00;114
14310;66;625795408;14310;386;15447;15560;6.26;0.38;308.43;13.30;1137;68;5348.00;113
14315;66;625795424;14315;404;15450;15564;6.18;0.38;308.42;13.30;1135;68;5349.00;114
14318;66;625795440;14318;406;15452;15565;6.12;0.37;308.43;13.30;1134;68;5350.00;113
14320;66;625795456;14320;415;15452;15565;6.04;0.37;308.44;13.30;1132;68;5351.00;113
14320;66;625795472;14320;422;15456;15569;6.01;0.37;308.44;13.30;1136;68;5352.00;113
14321;66;625795487;14321;431;15456;15569;5.93;0.36;308.44;13.30;1135;68;5353.00;113
14323;66;625795502;14323;430;15456;15569;5.86;0.36;308.48;13.30;1133;68;5354.00;113
14326;66;625795517;14326;436;15458;15571;5.81;0.35;308.48;13.29;1132;68;5355.00;113
14327;66;625795532;14327;447;15458;15571;5.75;0.35;308.47;13.29;1131;68;5356.00;113
14328;66;625795546;14328;447;15462;15577;5.69;0.35;308.46;13.29;1134;68;5357.00;115
14329;66;625795561;14329;463;15462;15577;5.61;0.34;308.45;13.29;1133;68;5358.00;115
14329;66;625795576;14329;466;15463;15577;5.57;0.34;308.45;13.29;1134;68;5359.00;114
14331;66;625795590;14331;473;15463;15578;5.51;0.34;308.43;13.29;1132;68;5360.00;115
14333;66;625795605;14333;470;15463;15578;5.48;0.34;308.39;13.29;1130;68;5361.00;115
14337;66;625795621;14337;466;15463;15578;5.39;0.33;308.35;13.29;1126;68;5362.00;115
14341;66;625795634;14341;469;15463;15578;5.30;0.32;308.31;13.29;1122;68;5363.00;115
14342;66;625795648;14342;456;15472;15590;5.32;0.32;308.31;13.28;1130;68;5364.00;118
14346;66;625795663;14346;453;15473;15590;5.26;0.32;308.29;13.35;1127;68;5365.00;117
14347;66;625795678;14347;452;15474;15590;5.30;0.33;308.28;13.35;1127;68;5366.00;116
14351;66;625795691;14351;447;15474;15590;5.29;0.33;308.30;13.35;1123;68;5367.00;116
14354;66;625795704;14354;450;15474;15590;5.28;0.33;308.30;13.35;1120;68;5368.00;116
14359;66;625795717;14359;443;15474;15590;5.29;0.33;308.25;13.35;1115;68;5369.00;116
14363;66;625795732;14363;438;15477;15594;5.25;0.32;308.24;13.35;1114;68;5370.00;117
14365;66;625795745;14365;433;15477;15594;5.24;0.32;308.30;13.35;1112;68;5371.00;117
14368;66;625795759;14368;427;15481;15598;5.19;0.32;308.32;13.35;1113;68;5372.00;117
14372;66;625795771;14372;424;15482;15599;5.13;0.31;308.27;13.35;1110;68;5373.00;117
14374;66;625795783;14374;408;15484;15599;5.10;0.31;308.27;13.36;1110;68;5374.00;115
14380;66;625795796;14380;410;15485;15599;5.05;0.31;308.25;13.37;1105;68;5375.00;114
14380;66;625795808;14380;410;15495;15612;5.10;0.31;308.25;13.37;1115;68;5376.00;117
14388;66;625795820;14388;403;15495;15612;5.09;0.31;308.22;13.37;1107;68;5377.00;117
14390;66;625795832;14390;397;15496;15612;5.11;0.31;308.21;13.37;1106;68;5378.00;116
14390;66;625795844;14390;400;15497;15613;5.17;0.32;308.21;13.36;1107;68;5379.00;116
14394;66;625795855;14394;401;15497;15614;5.16;0.32;308.16;13.36;1103;68;5380.00;117
14397;66;625795868;14397;406;15498;15614;5.18;0.32;308.12;13.43;1101;68;5381.00;116
14398;66;625795880;14398;408;15500;15617;5.21;0.32;308.11;13.43;1102;68;5382.00;117
14399;66;625795892;14399;410;15502;15617;5.20;0.32;308.10;13.50;1103;68;5383.00;115
14401;66;625795903;14401;405;15502;15617;5.17;0.32;308.08;13.50;1101;68;5384.00;115
14401;66;625795914;14401;409;15503;15617;5.18;0.32;308.08;13.57;1102;68;5385.00;114
14402;66;625795926;14402;415;15507;15623;5.21;0.32;308.07;13.56;1105;68;5386.00;116
14403;66;625795938;14403;400;15507;15623;5.18;0.32;308.05;13.56;1104;68;5387.00;116
14405;66;625795950;14405;393;15509;15623;5.18;0.32;308.03;13.63;1104;68;5388.00;114
14407;66;625795962;14407;391;15509;15623;5.17;0.31;308.03;13.63;1102;68;5389.00;114
14411;66;625795974;14411;382;15513;15627;5.15;0.31;308.05;13.69;1102;68;5390.00;114
14412;66;625795987;14412;379;15514;15628;5.21;0.32;308.04;13.69;1102;68;5391.00;114
14413;66;625795999;14413;370;15514;15628;5.26;0.32;308.04;13.69;1101;68;5392.00;114
14414;66;625796011;14414;372;15516;15629;5.33;0.32;308.03;13.76;1102;68;5393.00;113
14418;66;625796025;14418;366;15516;15629;5.41;0.33;308.12;13.76;1098;68;5394.00;113
14418;66;625796037;14418;359;15517;15629;5.51;0.33;308.12;13.76;1099;68;5395.00;112
14419;66;625796049;14419;351;15517;15629;5.58;0.34;308.11;13.76;1098;68;5396.00;112
14420;66;625796072;14420;353;15517;15629;5.64;0.34;308.10;13.76;1097;68;5397.00;112
14421;66;625796091;14421;354;15517;15629;5.68;0.34;308.10;13.76;1096;68;5398.00;112
14424;66;625796103;14424;355;15518;15629;5.72;0.35;308.10;13.77;1094;68;5399.00;111
