step_arrived;step_collisions;step_duration;step_ended;step_halting;step_inserted;step_loaded;step_meanSpeed;step_meanSpeedRelative;step_meanTravelTime;step_meanWaitingTime;step_running;step_teleports;step_time;step_waiting
0;0;626455449;0;1;85;245;16.20;1.14;-1.00;0.00;85;0;0.00;160
0;0;626455476;0;1;97;245;15.46;1.07;-1.00;0.12;97;0;1.00;148
0;0;626455477;0;0;113;245;14.86;1.02;-1.00;0.39;113;0;2.00;132
0;0;626455478;0;3;127;245;13.59;0.92;-1.00;0.68;127;0;3.00;118
0;0;626455479;0;2;141;245;12.62;0.85;-1.00;1.01;141;0;4.00;104
0;0;626455480;0;6;151;245;11.61;0.78;-1.00;1.27;151;0;5.00;94
0;0;626455482;0;5;161;245;11.00;0.74;-1.00;1.57;161;0;6.00;84
0;0;626455484;0;9;165;245;10.59;0.71;-1.00;1.70;165;0;7.00;80
0;0;626455485;0;15;172;246;10.14;0.67;-1.00;1.95;172;0;8.00;74
0;0;626455487;0;16;177;247;9.76;0.65;-1.00;2.15;177;0;9.00;70
0;0;626455489;0;20;185;247;9.56;0.63;-1.00;2.49;185;0;10.00;62
0;0;626455491;0;24;190;248;9.41;0.62;-1.00;2.66;190;0;11.00;58
1;0;626455493;1;28;195;248;9.18;0.61;12.00;2.90;194;0;12.00;53
1;0;626455495;1;30;204;248;9.10;0.59;12.00;3.35;203;0;13.00;44
1;0;626455498;1;34;207;248;9.12;0.59;12.00;3.50;206;0;14.00;41
1;0;626455500;1;35;215;252;9.08;0.59;12.00;3.87;214;0;15.00;37
1;0;626455503;1;41;217;252;9.04;0.58;12.00;3.94;216;0;16.00;35
1;0;626455506;1;45;221;252;9.05;0.58;12.00;4.12;220;0;17.00;31
1;0;626455509;1;47;225;255;9.04;0.57;12.00;4.28;224;0;18.00;30
1;0;626455512;1;52;226;255;9.07;0.57;12.00;4.35;225;0;19.00;29
1;0;626455515;1;53;228;255;9.09;0.57;12.00;4.49;227;0;20.00;27
5;0;626455518;5;57;232;259;9.10;0.57;19.20;4.43;227;0;21.00;27
5;0;626455522;5;65;237;260;9.05;0.57;19.20;4.71;232;0;22.00;23
6;0;626455525;6;66;239;260;8.98;0.56;19.50;4.82;233;0;23.00;21
6;0;626455527;6;72;246;264;8.96;0.56;19.50;5.08;240;0;24.00;18
6;0;626455530;6;75;247;264;8.97;0.56;19.50;5.09;241;0;25.00;17
6;0;626455533;6;78;249;264;8.94;0.56;19.50;5.25;243;0;26.00;15
6;0;626455537;6;83;252;265;8.97;0.56;19.50;5.40;246;0;27.00;13
6;0;626455540;6;85;252;265;8.97;0.56;19.50;5.40;246;0;28.00;13
6;0;626455543;6;91;259;271;8.81;0.55;19.50;5.61;253;0;29.00;12
7;0;626455549;7;91;259;271;8.73;0.54;20.57;5.61;252;0;30.00;12
7;0;626455551;7;92;262;272;8.63;0.53;20.57;5.79;255;0;31.00;10
7;0;626455555;7;93;262;272;8.52;0.53;20.57;5.79;255;0;32.00;10
7;0;626455558;7;97;264;272;8.46;0.52;20.57;5.85;257;0;33.00;8
8;0;626455561;8;104;264;272;8.30;0.51;21.63;5.85;256;0;34.00;8
9;0;626455564;9;108;265;272;8.29;0.51;23.11;5.91;256;0;35.00;7
10;0;626455568;10;115;276;284;8.40;0.52;24.00;5.67;266;0;36.00;8
10;0;626455572;10;117;277;284;8.31;0.52;24.00;5.72;267;0;37.00;7
10;0;626455575;10;121;277;284;8.24;0.51;24.00;5.72;267;0;38.00;7
11;0;626455578;11;123;277;284;8.22;0.51;25.36;5.72;266;0;39.00;7
12;0;626455581;12;121;278;284;8.15;0.50;26.17;5.74;266;0;40.00;6
13;0;626455584;13;124;279;284;8.04;0.50;27.08;5.77;266;0;41.00;5
13;0;626455587;13;131;284;288;8.05;0.50;27.08;5.70;271;0;42.00;4
14;0;626455591;14;133;284;288;7.84;0.49;26.71;5.70;270;0;43.00;4
14;0;626455594;14;137;287;292;7.70;0.48;26.71;5.65;273;0;44.00;5
15;0;626455598;15;139;289;294;7.70;0.48;27.93;5.61;274;0;45.00;5
17;0;626455601;17;141;290;294;7.65;0.47;29.41;5.60;273;0;46.00;4
17;0;626455604;17;143;290;294;7.69;0.48;29.41;5.60;273;0;47.00;4
17;0;626455607;17;143;302;307;8.00;0.49;29.41;5.38;285;0;48.00;5
18;0;626455610;18;147;302;307;7.88;0.49;30.11;5.38;284;0;49.00;5
18;0;626455613;18;147;302;307;7.72;0.48;30.11;5.38;284;0;50.00;5
18;0;626455617;18;148;303;308;7.65;0.48;30.11;5.37;285;0;51.00;5
18;0;626455620;18;151;304;309;7.58;0.47;30.11;5.35;286;0;52.00;5
20;0;626455623;20;154;304;309;7.48;0.46;30.60;5.35;284;0;53.00;5
20;0;626455626;20;154;306;312;7.58;0.47;30.60;5.32;286;0;54.00;6
22;0;626455629;22;155;306;312;7.41;0.46;31.77;5.32;284;0;55.00;6
22;0;626455631;22;142;307;312;7.35;0.45;31.77;5.31;285;0;56.00;5
23;0;626455635;23;139;307;312;7.32;0.45;32.87;5.31;284;0;57.00;5
23;0;626455638;23;142;312;318;7.36;0.45;32.87;5.24;289;0;58.00;6
24;0;626455641;24;142;312;318;7.33;0.45;33.88;5.24;288;0;59.00;6
24;0;626455646;24;144;313;318;7.40;0.45;33.88;5.23;289;0;60.00;5
24;0;626455649;24;146;313;318;7.46;0.46;33.88;5.23;289;0;61.00;5
25;0;626455652;25;149;317;322;7.48;0.46;33.84;5.18;292;0;62.00;5
28;0;626455656;28;150;318;323;7.47;0.46;35.32;5.16;290;0;63.00;5
28;0;626455659;28;155;318;323;7.56;0.46;35.32;5.16;290;0;64.00;5
29;0;626455662;29;156;319;324;7.65;0.47;36.17;5.15;290;0;65.00;5
29;0;626455665;29;157;319;324;7.70;0.47;36.17;5.15;290;0;66.00;5
29;0;626455668;29;146;319;324;7.82;0.48;36.17;5.15;290;0;67.00;5
30;0;626455673;30;141;319;324;7.95;0.49;37.23;5.15;289;0;68.00;5
32;0;626455676;32;137;319;324;8.02;0.49;39.22;5.15;287;0;69.00;5
32;0;626455680;32;133;319;324;8.15;0.50;39.22;5.15;287;0;70.00;5
32;0;626455684;32;130;319;324;8.40;0.51;39.22;5.15;287;0;71.00;5
32;0;626455689;32;136;356;394;8.53;0.52;39.22;4.61;324;0;72.00;38
32;0;626455698;32;128;357;395;8.65;0.53;39.22;4.60;325;0;73.00;38
32;0;626455708;32;120;363;395;8.97;0.55;39.22;4.56;331;0;74.00;32
35;0;626455712;35;116;368;395;9.27;0.57;41.91;4.54;333;0;75.00;27
35;0;626455716;35;112;373;395;9.59;0.59;41.91;4.53;338;0;76.00;22
35;0;626455720;35;110;376;395;9.75;0.60;41.91;4.53;341;0;77.00;19
35;0;626455724;35;110;378;395;9.83;0.60;41.91;4.54;343;0;78.00;17
35;0;626455734;35;111;378;395;9.92;0.61;41.91;4.54;343;0;79.00;17
38;0;626455738;38;111;380;396;9.90;0.60;44.34;4.54;342;0;80.00;16
38;0;626455748;38;112;381;397;9.90;0.60;44.34;4.53;343;0;81.00;16
39;1;626455752;39;115;382;397;9.94;0.60;45.31;4.54;343;1;82.00;15
39;1;626455768;39;122;386;401;9.73;0.59;45.31;4.51;347;1;83.00;15
40;1;626455773;40;125;386;401;9.69;0.59;46.02;4.51;346;1;84.00;15
41;1;626455777;41;127;386;401;9.59;0.58;46.98;4.51;345;1;85.00;15
41;1;626455781;41;126;386;401;9.35;0.57;46.98;4.51;345;1;86.00;15
41;1;626455784;41;127;390;407;9.14;0.56;46.98;4.47;349;1;87.00;17
42;1;626455788;42;134;390;407;8.93;0.54;47.95;4.47;348;1;88.00;17
42;1;626455792;42;135;391;407;8.90;0.54;47.95;4.47;349;1;89.00;16
42;1;626455798;42;135;394;413;8.92;0.54;47.95;4.43;352;1;90.00;19
44;1;626455803;44;133;395;413;8.83;0.54;49.91;4.43;351;1;91.00;18
45;1;626455807;45;134;395;413;8.80;0.54;50.84;4.43;350;1;92.00;18
46;1;626455817;46;133;397;414;8.83;0.54;51.76;4.41;351;1;93.00;17
49;1;626455820;49;132;398;415;8.77;0.54;54.35;4.40;349;1;94.00;17
49;1;626455825;49;135;399;415;8.83;0.54;54.35;4.41;350;1;95.00;16
51;1;626455830;51;138;409;428;8.70;0.53;54.57;4.30;358;1;96.00;19
53;1;626455841;53;139;410;428;8.67;0.53;56.15;4.29;357;1;97.00;18
57;1;626455845;57;139;410;428;8.64;0.53;59.09;4.29;353;1;98.00;18
58;1;626455850;58;136;411;429;8.80;0.54;59.76;4.28;353;1;99.00;18
60;1;626455855;60;136;411;429;8.85;0.54;60.98;4.28;351;1;100.00;18
60;1;626455863;60;133;413;433;8.97;0.55;60.98;4.26;353;1;101.00;20
62;1;626455868;62;126;413;433;9.04;0.55;62.31;4.26;351;1;102.00;20
63;1;626455873;63;120;418;437;8.98;0.55;62.81;4.23;355;1;103.00;19
63;1;626455878;63;116;419;437;9.03;0.55;62.81;4.30;356;1;104.00;18
64;1;626455884;64;108;419;437;9.10;0.55;63.45;4.30;355;1;105.00;18
65;1;626455888;65;99;419;437;9.26;0.56;63.78;4.30;354;1;106.00;18
65;1;626455893;65;93;419;437;9.34;0.57;63.78;4.30;354;1;107.00;18
66;1;626455898;66;88;430;449;9.51;0.58;64.41;4.19;364;1;108.00;19
67;1;626455904;67;85;431;449;9.62;0.59;65.07;4.18;364;1;109.00;18
67;1;626455908;67;82;431;449;9.77;0.60;65.07;4.18;364;1;110.00;18
68;1;626455913;68;79;431;449;9.92;0.61;65.72;4.18;363;1;111.00;18
68;1;626455918;68;77;431;449;10.02;0.61;65.72;4.18;363;1;112.00;18
69;1;626455923;69;73;431;449;10.23;0.63;66.41;4.18;362;1;113.00;18
69;1;626455928;69;72;432;450;10.41;0.64;66.41;4.17;363;1;114.00;18
69;1;626455934;69;68;432;450;10.58;0.65;66.41;4.17;363;1;115.00;18
70;1;626455939;70;66;436;456;10.81;0.66;66.81;4.14;366;1;116.00;20
70;2;626455945;70;67;439;457;10.99;0.67;66.81;4.38;369;2;117.00;18
72;2;626455958;72;70;439;457;11.13;0.68;67.51;4.38;367;2;118.00;18
73;2;626455969;73;68;439;457;11.28;0.69;68.21;4.38;366;2;119.00;18
74;2;626455977;74;73;446;462;11.44;0.70;68.86;4.80;372;2;120.00;16
76;2;626455985;76;73;446;462;11.50;0.70;70.18;4.80;370;2;121.00;16
76;2;626455991;76;78;447;462;11.56;0.70;70.18;4.90;371;2;122.00;15
77;2;626455997;77;77;449;463;11.61;0.71;70.87;5.16;372;2;123.00;14
78;2;626456004;78;76;457;467;11.49;0.70;71.54;5.69;379;2;124.00;10
78;2;626456011;78;78;457;467;11.57;0.71;71.54;5.69;379;2;125.00;10
79;2;626456017;79;79;460;470;11.65;0.71;72.22;5.82;381;2;126.00;10
79;2;626456024;79;82;462;470;11.66;0.71;72.22;6.00;383;2;127.00;8
80;2;626456030;80;85;466;470;11.70;0.71;72.89;6.16;386;2;128.00;4
81;2;626456036;81;87;466;470;11.74;0.72;73.14;6.16;385;2;129.00;4
81;2;626456042;81;89;469;474;11.83;0.72;73.14;6.25;388;2;130.00;5
81;2;626456049;81;88;470;474;11.95;0.73;73.14;6.24;389;2;131.00;4
83;2;626456055;83;89;472;474;12.09;0.74;74.27;6.30;389;2;132.00;2
87;2;626456062;87;88;473;474;12.13;0.74;76.46;6.36;386;2;133.00;1
90;2;626456069;90;88;474;475;12.17;0.75;78.16;6.35;384;2;134.00;1
93;2;626456075;93;90;477;477;12.14;0.74;78.20;6.34;384;2;135.00;0
93;2;626456084;93;90;477;477;12.19;0.75;78.20;6.34;384;2;136.00;0
94;2;626456093;94;91;478;478;12.21;0.75;78.80;6.33;384;2;137.00;0
96;2;626456100;96;95;478;478;12.16;0.75;79.28;6.33;382;2;138.00;0
98;2;626456110;98;96;478;478;12.02;0.74;79.43;6.33;380;2;139.00;0
100;2;626456122;100;97;478;478;11.86;0.73;80.60;6.33;378;2;140.00;0
101;2;626456132;101;98;478;478;11.69;0.72;80.49;6.33;377;2;141.00;0
107;2;626456138;107;100;478;478;11.46;0.70;82.60;6.33;371;2;142.00;0
108;2;626456146;108;104;478;478;11.37;0.70;83.16;6.33;370;2;143.00;0
109;2;626456154;109;129;554;605;10.85;0.69;83.68;5.47;445;2;144.00;51
113;2;626456179;113;120;559;606;10.71;0.67;84.31;5.43;446;2;145.00;47
114;2;626456189;114;115;567;606;10.71;0.67;84.50;5.38;453;2;146.00;39
114;2;626456197;114;120;570;606;10.65;0.67;84.50;5.37;456;2;147.00;36
116;2;626456206;116;123;575;606;10.65;0.67;85.56;5.36;459;2;148.00;31
119;2;626456216;119;123;576;606;10.58;0.66;86.98;5.36;457;2;149.00;30
120;2;626456232;120;119;580;611;10.61;0.66;87.40;5.35;460;2;150.00;31
120;2;626456248;120;118;583;611;10.60;0.66;87.40;5.36;463;2;151.00;28
120;2;626456260;120;119;586;612;10.65;0.66;87.40;5.37;466;2;152.00;26
120;2;626456270;120;118;588;613;10.76;0.67;87.40;5.38;468;2;153.00;25
124;2;626456279;124;121;590;613;10.73;0.67;88.39;5.40;466;2;154.00;23
127;2;626456286;127;123;595;614;10.70;0.67;89.76;5.42;468;2;155.00;19
128;2;626456293;128;124;599;614;10.73;0.67;90.23;5.46;471;2;156.00;15
129;2;626456299;129;128;602;614;10.72;0.67;90.75;5.49;473;2;157.00;12
131;2;626456306;131;132;604;614;10.70;0.66;91.69;5.52;473;2;158.00;10
132;2;626456313;132;137;607;618;10.71;0.66;92.11;5.52;475;2;159.00;11
134;2;626456320;134;143;609;618;10.58;0.65;92.89;5.55;475;2;160.00;9
137;2;626456326;137;146;610;618;10.41;0.64;92.45;5.56;473;2;161.00;8
137;2;626456333;137;150;612;621;10.33;0.64;92.45;5.57;475;2;162.00;9
143;2;626456339;143;150;613;621;10.16;0.63;94.12;5.56;470;2;163.00;8
143;2;626456346;143;149;614;621;10.09;0.62;94.12;5.57;471;2;164.00;7
144;2;626456352;144;152;617;625;9.94;0.61;94.44;5.55;473;2;165.00;8
144;2;626456358;144;148;618;626;9.81;0.60;94.44;5.55;474;2;166.00;8
146;2;626456364;146;147;618;626;9.68;0.60;94.45;5.55;472;2;167.00;8
148;2;626456371;148;147;623;630;9.63;0.59;94.47;5.51;475;2;168.00;7
150;3;626456377;150;149;624;630;9.51;0.59;95.15;5.54;474;3;169.00;6
151;3;626456396;151;141;625;630;9.48;0.59;95.48;5.56;474;3;170.00;5
152;3;626456402;152;135;626;631;9.55;0.59;95.97;5.55;474;3;171.00;5
155;3;626456415;155;130;629;631;9.54;0.59;96.86;5.62;474;3;172.00;2
157;3;626456421;157;129;633;637;9.58;0.59;97.65;5.59;476;3;173.00;4
158;3;626456428;158;126;633;637;9.60;0.59;97.66;5.59;475;3;174.00;4
160;3;626456434;160;125;634;638;9.63;0.59;98.54;5.58;474;3;175.00;4
161;3;626456447;161;125;635;638;9.65;0.59;98.72;5.59;474;3;176.00;3
162;4;626456453;162;121;636;638;9.77;0.60;99.09;5.63;474;4;177.00;2
162;4;626456473;162;117;637;638;9.82;0.60;99.09;5.63;475;4;178.00;1
162;4;626456479;162;116;638;638;9.82;0.60;99.09;5.63;476;4;179.00;0
163;4;626456488;163;117;669;672;9.83;0.61;98.85;5.37;506;4;180.00;3
163;4;626456497;163;116;670;672;9.84;0.61;98.85;5.36;507;4;181.00;2
164;4;626456503;164;116;671;672;9.85;0.61;98.91;5.36;507;4;182.00;1
164;4;626456510;164;123;672;672;9.92;0.61;98.91;5.35;508;4;183.00;0
165;4;626456516;165;126;672;672;10.03;0.62;99.42;5.35;507;4;184.00;0
168;4;626456524;168;132;672;672;10.05;0.62;99.46;5.35;504;4;185.00;0
170;4;626456531;170;137;676;676;9.98;0.62;99.96;5.33;506;4;186.00;0
173;4;626456539;173;144;676;676;9.91;0.61;100.65;5.33;503;4;187.00;0
174;4;626456546;174;149;679;680;9.79;0.61;100.60;5.31;505;4;188.00;1
177;4;626456553;177;152;680;681;9.64;0.60;101.06;5.30;503;4;189.00;1
180;4;626456560;180;158;681;681;9.47;0.59;101.73;5.30;501;4;190.00;0
184;4;626456567;184;164;681;681;9.37;0.58;101.04;5.30;497;4;191.00;0
190;4;626456574;190;176;694;694;9.31;0.57;101.76;5.20;504;4;192.00;0
192;4;626456582;192;179;694;694;9.16;0.57;102.03;5.20;502;4;193.00;0
193;4;626456590;193;182;694;694;9.05;0.56;101.88;5.20;501;4;194.00;0
196;4;626456597;196;185;695;695;8.98;0.55;101.84;5.19;499;4;195.00;0
198;4;626456605;198;185;696;696;8.85;0.55;101.33;5.19;498;4;196.00;0
203;4;626456613;203;187;696;696;8.78;0.54;101.98;5.19;493;4;197.00;0
206;4;626456621;206;194;698;699;8.81;0.54;101.68;5.17;492;4;198.00;1
210;4;626456629;210;198;699;699;8.67;0.53;102.04;5.16;489;4;199.00;0
210;4;626456650;210;199;699;699;8.55;0.52;102.04;5.16;489;4;200.00;0
212;4;626456667;212;205;699;699;8.50;0.52;101.90;5.16;487;4;201.00;0
213;4;626456674;213;208;704;705;8.40;0.51;101.69;5.13;491;4;202.00;1
213;4;626456681;213;213;704;705;8.32;0.51;101.69;5.13;491;4;203.00;1
214;4;626456689;214;218;705;705;8.29;0.51;101.50;5.13;491;4;204.00;0
216;4;626456697;216;220;705;705;8.12;0.50;101.76;5.13;489;4;205.00;0
217;4;626456708;217;225;709;709;8.06;0.49;101.41;5.11;492;4;206.00;0
217;4;626456718;217;234;710;710;7.95;0.49;101.41;5.10;493;4;207.00;0
218;4;626456727;218;237;710;710;7.80;0.48;101.54;5.10;492;4;208.00;0
220;4;626456735;220;236;711;711;7.72;0.47;101.75;5.10;491;4;209.00;0
220;4;626456743;220;243;711;711;7.67;0.47;101.75;5.10;491;4;210.00;0
221;4;626456749;221;246;711;711;7.55;0.46;101.41;5.10;490;4;211.00;0
222;4;626456755;222;253;711;711;7.42;0.46;101.89;5.10;489;4;212.00;0
223;4;626456760;223;257;711;711;7.36;0.45;101.53;5.10;488;4;213.00;0
223;4;626456766;223;262;711;711;7.36;0.46;101.53;5.10;488;4;214.00;0
223;4;626456772;223;262;711;711;7.34;0.45;101.53;5.10;488;4;215.00;0
225;4;626456778;225;272;753;781;7.49;0.46;102.09;4.81;528;4;216.00;28
227;4;626456795;227;258;755;782;7.50;0.46;103.10;4.80;528;4;217.00;27
227;5;626456806;227;249;762;782;7.60;0.47;103.10;4.78;535;5;218.00;20
227;5;626456821;227;227;765;782;7.78;0.48;103.10;4.77;538;5;219.00;17
227;5;626456829;227;219;769;782;8.00;0.49;103.10;4.76;542;5;220.00;13
229;5;626456837;229;208;772;782;8.19;0.50;104.11;4.77;543;5;221.00;10
231;5;626456845;231;202;778;782;8.39;0.52;104.50;4.78;547;5;222.00;4
232;5;626456853;232;195;779;782;8.52;0.52;104.83;4.78;547;5;223.00;3
233;5;626456861;233;191;782;783;8.67;0.53;105.31;4.78;549;5;224.00;1
236;5;626456874;236;184;784;785;8.76;0.54;106.54;4.77;548;5;225.00;1
237;5;626456888;237;162;785;785;8.89;0.54;106.69;4.78;548;5;226.00;0
239;6;626456903;239;152;789;789;9.00;0.55;107.49;4.76;550;6;227.00;0
240;7;626456944;240;141;789;789;9.16;0.56;107.39;4.76;549;7;228.00;0
241;8;626456975;241;139;789;789;9.30;0.57;107.04;4.76;548;8;229.00;0
244;8;626457005;244;131;789;789;9.42;0.58;107.73;4.76;545;8;230.00;0
244;9;626457024;244;126;794;795;9.55;0.58;107.73;4.73;550;9;231.00;1
246;9;626457052;246;122;794;795;9.76;0.60;108.20;4.73;548;9;232.00;1
248;9;626457065;248;116;795;795;9.93;0.61;108.30;4.73;547;9;233.00;0
250;9;626457089;250;113;797;798;9.99;0.61;108.72;4.72;547;9;234.00;1
251;10;626457101;251;111;798;798;10.13;0.62;109.19;4.71;547;10;235.00;0
254;10;626457127;254;108;798;798;10.15;0.62;109.69;4.71;544;10;236.00;0
255;10;626457139;255;99;799;799;10.24;0.62;110.15;4.71;544;10;237.00;0
259;10;626457150;259;91;800;800;10.36;0.63;111.25;4.71;541;10;238.00;0
261;10;626457161;261;92;800;800;10.45;0.64;110.77;4.71;539;10;239.00;0
261;10;626457174;261;96;824;826;10.39;0.64;110.77;4.57;563;10;240.00;2
265;10;626457190;265;89;825;826;10.49;0.64;111.83;4.56;560;10;241.00;1
267;10;626457207;267;93;826;826;10.56;0.65;112.27;4.56;559;10;242.00;0
269;10;626457217;269;94;827;827;10.50;0.64;112.67;4.56;558;10;243.00;0
270;10;626457228;270;98;827;827;10.52;0.64;112.63;4.56;557;10;244.00;0
272;10;626457238;272;99;830;831;10.55;0.64;113.06;4.54;558;10;245.00;1
274;10;626457247;274;106;830;831;10.60;0.65;112.97;4.54;556;10;246.00;1
277;10;626457262;277;109;835;835;10.58;0.65;113.88;4.52;558;10;247.00;0
281;10;626457280;281;117;835;835;10.54;0.64;115.25;4.52;554;10;248.00;0
283;10;626457291;283;121;835;835;10.56;0.64;115.94;4.52;552;10;249.00;0
286;10;626457310;286;127;835;835;10.51;0.64;116.48;4.52;549;10;250.00;0
287;10;626457319;287;129;835;835;10.46;0.64;116.63;4.52;548;10;251.00;0
288;10;626457327;288;137;846;847;10.44;0.64;116.69;4.46;558;10;252.00;1
289;10;626457336;289;142;846;847;10.35;0.63;116.66;4.46;557;10;253.00;1
289;10;626457345;289;143;847;847;10.32;0.63;116.66;4.46;558;10;254.00;0
289;10;626457354;289;145;847;847;10.21;0.62;116.66;4.46;558;10;255.00;0
291;10;626457363;291;149;847;847;10.18;0.62;116.71;4.46;556;10;256.00;0
294;10;626457373;294;155;847;847;10.12;0.62;117.36;4.46;553;10;257.00;0
294;10;626457384;294;158;848;848;10.06;0.61;117.36;4.46;554;10;258.00;0
296;10;626457394;296;160;848;848;10.05;0.61;117.66;4.46;552;10;259.00;0
297;10;626457403;297;156;853;854;10.01;0.61;118.09;4.44;556;10;260.00;1
298;10;626457413;298;149;854;855;9.97;0.61;118.09;4.43;556;10;261.00;1
300;11;626457421;300;149;855;855;9.99;0.61;118.25;4.43;555;11;262.00;0
300;11;626457456;300;144;855;855;10.02;0.61;118.25;4.43;555;11;263.00;0
303;11;626457466;303;139;859;859;10.03;0.61;118.95;4.41;556;11;264.00;0
306;11;626457477;306;135;859;859;10.02;0.61;119.12;4.41;553;11;265.00;0
310;11;626457487;310;133;859;859;10.15;0.61;119.55;4.41;549;11;266.00;0
311;11;626457497;311;130;860;860;10.24;0.62;119.79;4.41;549;11;267.00;0
313;11;626457507;313;134;864;864;10.23;0.62;119.86;4.39;551;11;268.00;0
317;11;626457519;317;131;864;864;10.32;0.62;120.26;4.39;547;11;269.00;0
317;11;626457531;317;127;867;870;10.40;0.63;120.26;4.37;550;11;270.00;3
321;11;626457543;321;124;867;870;10.47;0.63;121.21;4.37;546;11;271.00;3
323;11;626457553;323;114;868;870;10.60;0.64;121.59;4.37;545;11;272.00;2
327;11;626457563;327;111;868;870;10.69;0.65;122.65;4.37;541;11;273.00;2
329;11;626457572;329;106;871;874;10.81;0.65;122.77;4.36;542;11;274.00;3
331;11;626457582;331;102;871;874;10.90;0.66;123.51;4.36;540;11;275.00;3
333;11;626457594;333;98;872;874;11.05;0.67;123.94;4.37;539;11;276.00;2
335;11;626457604;335;93;872;874;11.17;0.68;124.42;4.37;537;11;277.00;2
338;11;626457613;338;95;874;875;11.24;0.68;124.50;4.36;536;11;278.00;1
340;11;626457623;340;88;875;876;11.31;0.68;124.56;4.36;535;11;279.00;1
341;11;626457633;341;82;876;876;11.31;0.69;124.39;4.36;535;11;280.00;0
343;11;626457643;343;78;877;877;11.33;0.69;124.36;4.36;534;11;281.00;0
344;11;626457656;344;75;877;877;11.37;0.69;124.19;4.36;533;11;282.00;0
345;11;626457668;345;78;877;877;11.42;0.69;123.92;4.36;532;11;283.00;0
346;11;626457681;346;81;877;877;11.48;0.70;123.96;4.36;531;11;284.00;0
346;11;626457693;346;78;877;877;11.41;0.69;123.96;4.36;531;11;285.00;0
347;11;626457704;347;76;877;877;11.41;0.69;123.89;4.36;530;11;286.00;0
351;11;626457718;351;77;877;877;11.41;0.69;123.99;4.36;526;11;287.00;0
354;11;626457731;354;97;944;1004;11.01;0.68;124.49;4.05;590;11;288.00;60
354;11;626457763;354;84;948;1005;11.04;0.68;124.49;4.04;594;11;289.00;57
355;11;626457774;355;81;954;1005;11.12;0.69;124.80;4.03;599;11;290.00;51
356;11;626457785;356;90;957;1005;11.21;0.69;124.86;4.02;601;11;291.00;48
358;11;626457796;358;84;962;1005;11.39;0.70;125.68;4.02;604;11;292.00;43
359;11;626457809;359;83;964;1005;11.47;0.71;125.65;4.02;605;11;293.00;41
360;11;626457820;360;86;968;1005;11.55;0.71;126.03;4.03;608;11;294.00;37
361;11;626457832;361;87;972;1005;11.66;0.72;126.50;4.04;611;11;295.00;33
364;11;626457848;364;86;975;1006;11.88;0.73;126.29;4.06;611;11;296.00;31
365;11;626457860;365;86;978;1007;12.01;0.74;126.35;4.07;613;11;297.00;29
368;11;626457882;368;87;982;1007;12.11;0.74;126.49;4.10;614;11;298.00;25
369;11;626457894;369;92;984;1008;12.16;0.75;126.31;4.11;615;11;299.00;24
370;11;626457913;370;92;989;1014;12.10;0.74;126.19;4.15;619;11;300.00;25
371;11;626457931;371;94;992;1014;11.99;0.74;126.37;4.18;621;11;301.00;22
374;11;626457951;374;100;995;1014;11.87;0.73;127.18;4.21;621;11;302.00;19
375;11;626457965;375;104;1000;1018;11.76;0.72;127.41;4.24;625;11;303.00;18
376;11;626457978;376;112;1003;1018;11.64;0.72;127.69;4.25;627;11;304.00;15
376;11;626457996;376;119;1004;1018;11.54;0.71;127.69;4.26;628;11;305.00;14
379;11;626458012;379;126;1009;1021;11.49;0.71;127.75;4.27;630;11;306.00;12
382;11;626458030;382;131;1009;1021;11.32;0.70;128.93;4.27;627;11;307.00;12
385;11;626458044;385;136;1010;1021;11.27;0.69;129.44;4.29;625;11;308.00;11
387;12;626458063;387;144;1014;1025;11.09;0.68;130.30;4.29;627;12;309.00;11
391;12;626458091;391;147;1015;1026;11.00;0.68;131.37;4.28;624;12;310.00;11
391;12;626458102;391;153;1015;1026;10.90;0.67;131.37;4.28;624;12;311.00;11
396;12;626458112;396;158;1020;1030;10.79;0.67;131.76;4.27;624;12;312.00;10
399;12;626458123;399;163;1020;1030;10.64;0.66;132.78;4.27;621;12;313.00;10
401;12;626458131;401;165;1020;1030;10.55;0.65;132.85;4.27;619;12;314.00;10
406;12;626458141;406;170;1023;1032;10.33;0.64;133.72;4.27;617;12;315.00;9
407;12;626458161;407;172;1023;1032;10.19;0.63;133.99;4.27;616;12;316.00;9
412;12;626458171;412;179;1028;1038;10.02;0.62;134.01;4.27;616;12;317.00;10
413;12;626458181;413;183;1028;1038;9.92;0.61;134.15;4.27;615;12;318.00;10
418;12;626458193;418;183;1029;1039;9.70;0.60;134.96;4.27;611;12;319.00;10
419;12;626458206;419;183;1031;1039;9.62;0.59;135.39;4.31;612;12;320.00;8
421;12;626458218;421;188;1032;1039;9.54;0.59;136.20;4.32;611;12;321.00;7
421;13;626458229;421;187;1032;1039;9.53;0.59;136.20;4.32;611;13;322.00;7
424;13;626458252;424;193;1034;1039;9.56;0.59;135.90;4.35;610;13;323.00;5
425;13;626458268;425;199;1047;1051;9.66;0.59;136.20;4.35;622;13;324.00;4
427;13;626458284;427;198;1047;1051;9.64;0.59;136.29;4.35;620;13;325.00;4
429;13;626458303;429;199;1049;1051;9.63;0.59;136.39;4.39;620;13;326.00;2
430;13;626458311;430;200;1050;1051;9.67;0.59;136.49;4.40;620;13;327.00;1
433;13;626458320;433;204;1050;1051;9.71;0.59;136.82;4.40;617;13;328.00;1
435;13;626458328;435;207;1051;1051;9.71;0.60;136.75;4.40;616;13;329.00;0
437;13;626458339;437;207;1055;1055;9.66;0.59;137.14;4.38;618;13;330.00;0
440;13;626458348;440;212;1055;1055;9.63;0.59;137.88;4.38;615;13;331.00;0
442;13;626458357;442;209;1058;1059;9.65;0.59;138.41;4.37;616;13;332.00;1
445;13;626458366;445;214;1060;1060;9.46;0.58;138.78;4.37;615;13;333.00;0
445;13;626458374;445;213;1060;1060;9.43;0.58;138.78;4.37;615;13;334.00;0
449;13;626458384;449;217;1060;1060;9.26;0.57;139.58;4.37;611;13;335.00;0
453;13;626458394;453;218;1073;1073;9.08;0.55;139.82;4.31;620;13;336.00;0
458;13;626458403;458;225;1073;1073;8.91;0.54;140.31;4.31;615;13;337.00;0
461;13;626458411;461;227;1073;1073;8.73;0.54;141.12;4.31;612;13;338.00;0
465;13;626458418;465;234;1074;1074;8.55;0.52;141.40;4.31;609;13;339.00;0
469;13;626458427;469;222;1075;1075;8.35;0.51;141.74;4.31;606;13;340.00;0
474;13;626458435;474;217;1075;1075;8.27;0.51;142.29;4.31;601;13;341.00;0
477;13;626458447;477;218;1077;1078;8.32;0.51;143.03;4.30;600;13;342.00;1
482;13;626458455;482;216;1077;1078;8.31;0.51;144.22;4.30;595;13;343.00;1
486;13;626458465;486;220;1078;1078;8.32;0.51;144.98;4.30;592;13;344.00;0
486;13;626458474;486;220;1078;1078;8.32;0.51;144.98;4.30;592;13;345.00;0
489;13;626458482;489;222;1083;1084;8.34;0.51;145.81;4.28;594;13;346.00;1
491;13;626458490;491;217;1084;1084;8.37;0.52;146.10;4.28;593;13;347.00;0
493;13;626458500;493;215;1084;1084;8.36;0.51;146.29;4.28;591;13;348.00;0
496;13;626458508;496;214;1084;1084;8.27;0.51;146.95;4.28;588;13;349.00;0
501;13;626458517;501;219;1088;1088;8.13;0.50;147.51;4.27;587;13;350.00;0
505;13;626458525;505;220;1089;1089;8.06;0.49;147.30;4.26;584;13;351.00;0
510;13;626458538;510;221;1089;1089;7.96;0.49;147.53;4.26;579;13;352.00;0
515;13;626458547;515;222;1090;1090;7.95;0.49;147.89;4.26;575;13;353.00;0
519;13;626458556;519;215;1090;1090;7.82;0.48;147.67;4.26;571;13;354.00;0
524;13;626458565;524;221;1090;1090;7.80;0.48;147.33;4.26;566;13;355.00;0
526;13;626458573;526;215;1090;1090;7.82;0.48;147.48;4.26;564;13;356.00;0
529;13;626458582;529;217;1090;1090;7.83;0.48;147.58;4.26;561;13;357.00;0
529;13;626458590;529;222;1090;1090;7.82;0.48;147.58;4.26;561;13;358.00;0
532;13;626458598;532;227;1090;1090;7.76;0.48;147.63;4.26;558;13;359.00;0
534;14;626458607;534;245;1158;1215;7.95;0.50;147.58;4.01;624;14;360.00;57
537;14;626458643;537;246;1163;1216;7.89;0.49;147.98;4.00;626;14;361.00;53
539;14;626458652;539;243;1175;1216;7.87;0.49;148.01;3.98;636;14;362.00;41
544;14;626458662;544;249;1190;1216;7.70;0.48;147.95;3.97;646;14;363.00;26
544;14;626458672;544;249;1195;1216;7.74;0.48;147.95;3.97;651;14;364.00;21
548;14;626458682;548;249;1199;1216;7.66;0.47;148.92;3.97;651;14;365.00;17
548;14;626458692;548;249;1203;1216;7.64;0.47;148.92;3.98;655;14;366.00;13
549;14;626458702;549;253;1204;1216;7.58;0.47;149.18;3.98;655;14;367.00;12
550;14;626458712;550;256;1209;1217;7.56;0.47;149.25;3.99;659;14;368.00;8
553;14;626458723;553;262;1209;1218;7.54;0.46;149.45;3.99;656;14;369.00;9
554;14;626458737;554;268;1210;1218;7.45;0.46;149.32;3.99;656;14;370.00;8
554;14;626458748;554;262;1216;1222;7.43;0.46;149.32;3.99;662;14;371.00;6
556;14;626458760;556;250;1217;1222;7.44;0.46;149.27;4.00;661;14;372.00;5
556;14;626458772;556;250;1217;1222;7.50;0.46;149.27;4.00;661;14;373.00;5
556;14;626458782;556;242;1218;1222;7.59;0.47;149.27;4.00;662;14;374.00;4
559;14;626458793;559;242;1223;1228;7.64;0.47;149.02;4.00;664;14;375.00;5
559;14;626458805;559;239;1224;1228;7.75;0.48;149.02;4.01;665;14;376.00;4
561;14;626458816;561;240;1224;1228;7.89;0.48;149.18;4.01;663;14;377.00;4
562;14;626458830;562;239;1227;1231;8.03;0.49;149.14;4.01;665;14;378.00;4
562;14;626458848;562;235;1228;1231;8.22;0.50;149.14;4.01;666;14;379.00;3
565;14;626458858;565;231;1228;1231;8.32;0.51;149.53;4.01;663;14;380.00;3
567;14;626458882;567;232;1229;1232;8.35;0.51;149.43;4.00;662;14;381.00;3
568;14;626458895;568;234;1231;1233;8.38;0.51;149.78;4.00;663;14;382.00;2
570;14;626458906;570;233;1231;1233;8.44;0.52;149.77;4.00;661;14;383.00;2
572;14;626458928;572;235;1244;1246;8.54;0.52;149.60;3.96;672;14;384.00;2
574;14;626458942;574;233;1244;1246;8.56;0.52;149.76;3.96;670;14;385.00;2
576;14;626458954;576;230;1244;1246;8.53;0.52;149.44;3.96;668;14;386.00;2
579;14;626458964;579;220;1245;1247;8.60;0.52;149.39;3.96;666;14;387.00;2
579;14;626458975;579;217;1245;1247;8.68;0.53;149.39;3.96;666;14;388.00;2
580;14;626458997;580;216;1248;1251;8.78;0.53;149.19;3.95;668;14;389.00;3
582;14;626459014;582;212;1248;1251;8.84;0.54;149.44;3.95;666;14;390.00;3
584;14;626459032;584;212;1253;1255;8.95;0.54;149.96;3.94;669;14;391.00;2
586;14;626459051;586;210;1253;1255;8.96;0.54;150.24;3.94;667;14;392.00;2
589;14;626459066;589;219;1253;1255;9.03;0.55;150.86;3.94;664;14;393.00;2
593;14;626459081;593;219;1253;1255;9.01;0.55;151.01;3.94;660;14;394.00;2
594;14;626459102;594;215;1253;1255;9.03;0.55;150.81;3.94;659;14;395.00;2
598;14;626459117;598;201;1264;1267;9.10;0.55;151.24;3.91;666;14;396.00;3
601;14;626459133;601;193;1265;1267;9.20;0.56;151.71;3.90;664;14;397.00;2
603;14;626459148;603;178;1265;1267;9.23;0.56;152.12;3.90;662;14;398.00;2
607;14;626459163;607;168;1265;1267;9.34;0.57;152.83;3.90;658;14;399.00;2
610;14;626459178;610;157;1266;1267;9.33;0.57;153.19;3.93;656;14;400.00;1
611;14;626459202;611;155;1266;1267;9.39;0.57;153.36;3.93;655;14;401.00;1
612;14;626459216;612;150;1267;1268;9.47;0.58;153.72;3.93;655;14;402.00;1
614;14;626459230;614;151;1267;1268;9.54;0.58;154.31;3.93;653;14;403.00;1
617;14;626459247;617;154;1272;1274;9.63;0.59;154.61;3.92;655;14;404.00;2
621;14;626459263;621;159;1275;1276;9.77;0.60;155.72;3.91;654;14;405.00;1
623;14;626459288;623;160;1275;1276;9.82;0.60;156.34;3.91;652;14;406.00;1
623;14;626459310;623;160;1275;1276;9.94;0.61;156.34;3.91;652;14;407.00;1
625;14;626459323;625;155;1279;1280;9.97;0.61;156.56;3.90;654;14;408.00;1
628;14;626459337;628;151;1279;1280;10.00;0.61;156.87;3.90;651;14;409.00;1
631;14;626459348;631;152;1279;1280;10.08;0.62;157.53;3.90;648;14;410.00;1
633;14;626459361;633;153;1280;1281;10.15;0.62;157.84;3.90;647;14;411.00;1
635;14;626459376;635;153;1284;1285;10.16;0.62;158.33;3.89;649;14;412.00;1
639;14;626459393;639;147;1284;1285;10.20;0.63;158.98;3.89;645;14;413.00;1
639;14;626459417;639;142;1286;1288;10.28;0.63;158.98;3.88;647;14;414.00;2
641;14;626459430;641;145;1287;1288;10.30;0.63;159.67;3.92;646;14;415.00;1
647;14;626459442;647;150;1288;1288;10.32;0.63;160.35;3.92;641;14;416.00;0
649;14;626459465;649;156;1288;1288;10.37;0.64;160.61;3.92;639;14;417.00;0
653;14;626459482;653;159;1291;1292;10.48;0.64;160.86;3.91;638;14;418.00;1
660;14;626459493;660;160;1291;1292;10.48;0.64;161.71;3.91;631;14;419.00;1
663;14;626459506;663;161;1292;1292;10.49;0.64;162.40;3.91;629;14;420.00;0
664;14;626459527;664;163;1292;1292;10.49;0.64;162.76;3.91;628;14;421.00;0
668;14;626459546;668;164;1293;1293;10.45;0.64;162.72;3.91;625;14;422.00;0
670;14;626459562;670;165;1294;1294;10.50;0.64;162.77;3.91;624;14;423.00;0
672;14;626459577;672;170;1294;1294;10.45;0.64;163.10;3.91;622;14;424.00;0
677;14;626459597;677;171;1295;1295;10.35;0.63;163.60;3.90;618;14;425.00;0
678;14;626459615;678;173;1295;1295;10.24;0.62;163.67;3.90;617;14;426.00;0
680;14;626459625;680;173;1295;1295;10.22;0.62;164.09;3.90;615;14;427.00;0
682;14;626459638;682;176;1295;1295;10.19;0.62;164.39;3.90;613;14;428.00;0
684;14;626459648;684;178;1295;1295;10.19;0.62;164.86;3.90;611;14;429.00;0
687;14;626459658;687;173;1295;1295;10.19;0.62;164.76;3.90;608;14;430.00;0
689;14;626459669;689;168;1295;1295;10.19;0.62;164.79;3.90;606;14;431.00;0
690;14;626459681;690;196;1373;1422;9.66;0.60;164.96;3.68;683;14;432.00;49
694;14;626459713;694;172;1375;1423;9.72;0.60;164.77;3.68;681;14;433.00;48
696;14;626459725;696;153;1379;1423;9.89;0.61;164.68;3.68;683;14;434.00;44
701;14;626459738;701;142;1381;1423;9.99;0.61;165.31;3.67;680;14;435.00;42
701;14;626459749;701;136;1384;1423;10.15;0.62;165.31;3.67;683;14;436.00;39
702;14;626459767;702;135;1385;1423;10.20;0.63;165.60;3.68;683;14;437.00;38
704;14;626459780;704;138;1388;1423;10.27;0.63;165.70;3.68;684;14;438.00;35
707;15;626459792;707;140;1391;1423;10.29;0.63;166.41;3.69;684;15;439.00;32
710;15;626459820;710;138;1395;1424;10.40;0.64;166.78;3.70;685;15;440.00;29
711;15;626459832;711;137;1396;1425;10.45;0.64;166.91;3.70;685;15;441.00;29
716;15;626459843;716;132;1400;1425;10.46;0.64;167.69;3.72;684;15;442.00;25
722;15;626459856;722;133;1401;1426;10.39;0.64;168.01;3.73;679;15;443.00;25
725;15;626459868;725;124;1406;1426;10.37;0.64;167.77;3.76;681;15;444.00;20
728;15;626459880;728;119;1411;1426;10.30;0.63;167.93;3.79;683;15;445.00;15
731;15;626459894;731;112;1415;1426;10.24;0.63;168.09;3.81;684;15;446.00;11
735;15;626459905;735;109;1417;1430;10.16;0.62;167.87;3.82;682;15;447.00;13
738;15;626459917;738;118;1419;1430;10.15;0.62;168.18;3.84;681;15;448.00;11
739;15;626459929;739;118;1420;1430;10.15;0.62;168.37;3.85;681;15;449.00;10
741;15;626459942;741;118;1424;1436;10.17;0.62;168.51;3.85;683;15;450.00;12
742;15;626459961;742;120;1425;1436;10.20;0.62;168.60;3.85;683;15;451.00;11
746;15;626459974;746;122;1426;1436;10.13;0.62;168.94;3.85;680;15;452.00;10
747;15;626459987;747;123;1429;1440;10.14;0.62;169.30;3.85;682;15;453.00;11
751;15;626460000;751;119;1431;1441;10.16;0.62;169.28;3.85;680;15;454.00;10
753;15;626460029;753;122;1432;1441;10.19;0.62;169.63;3.85;679;15;455.00;9
756;15;626460047;756;123;1435;1445;10.29;0.63;169.53;3.85;679;15;456.00;10
758;15;626460061;758;123;1436;1445;10.39;0.63;169.29;3.86;678;15;457.00;9
758;15;626460072;758;123;1437;1445;10.59;0.65;169.29;3.86;679;15;458.00;8
760;15;626460082;760;122;1438;1446;10.70;0.65;169.18;3.86;678;15;459.00;8
761;15;626460093;761;123;1440;1446;10.76;0.66;169.09;3.88;679;15;460.00;6
761;15;626460105;761;125;1444;1452;10.76;0.66;169.09;3.88;683;15;461.00;8
762;15;626460119;762;122;1446;1452;10.71;0.65;169.24;3.89;684;15;462.00;6
765;15;626460131;765;125;1446;1453;10.64;0.65;169.07;3.89;681;15;463.00;7
767;15;626460147;767;128;1447;1453;10.55;0.64;169.14;3.91;680;15;464.00;6
769;15;626460157;769;131;1447;1453;10.50;0.64;169.42;3.91;678;15;465.00;6
770;15;626460170;770;138;1448;1453;10.49;0.64;169.43;3.92;678;15;466.00;5
772;15;626460181;772;135;1448;1453;10.50;0.64;169.80;3.92;676;15;467.00;5
775;15;626460191;775;138;1457;1465;10.58;0.64;169.87;3.89;682;15;468.00;8
778;16;626460204;778;141;1457;1465;10.64;0.65;169.68;3.89;679;16;469.00;8
780;16;626460224;780;143;1461;1465;10.65;0.65;169.71;3.91;681;16;470.00;4
782;16;626460235;782;145;1461;1465;10.68;0.65;169.74;3.91;679;16;471.00;4
783;16;626460251;783;148;1461;1465;10.79;0.66;169.67;3.91;678;16;472.00;4
788;16;626460263;788;151;1462;1465;10.78;0.66;169.89;3.92;674;16;473.00;3
790;16;626460275;790;153;1465;1469;10.78;0.66;169.91;3.92;675;16;474.00;4
790;16;626460287;790;155;1466;1469;10.82;0.66;169.91;3.93;676;16;475.00;3
791;16;626460298;791;161;1469;1473;10.92;0.67;169.93;3.92;678;16;476.00;4
794;16;626460310;794;163;1470;1474;10.91;0.67;169.88;3.92;676;16;477.00;4
797;16;626460325;797;166;1472;1474;10.89;0.66;170.09;3.93;675;16;478.00;2
799;16;626460347;799;170;1474;1474;10.84;0.66;170.00;3.93;675;16;479.00;0
802;16;626460363;802;173;1493;1500;10.75;0.66;169.67;3.88;691;16;480.00;7
805;16;626460378;805;177;1493;1500;10.69;0.65;169.63;3.88;688;16;481.00;7
810;16;626460390;810;177;1496;1500;10.62;0.65;169.42;3.88;686;16;482.00;4
813;16;626460404;813;181;1499;1501;10.58;0.65;169.59;3.87;686;16;483.00;2
813;16;626460417;813;188;1502;1502;10.50;0.64;169.59;3.87;689;16;484.00;0
814;16;626460428;814;196;1502;1502;10.37;0.63;169.62;3.87;688;16;485.00;0
815;16;626460439;815;200;1504;1505;10.23;0.63;169.57;3.87;689;16;486.00;1
818;16;626460450;818;201;1504;1505;10.13;0.62;169.47;3.87;686;16;487.00;1
819;16;626460461;819;209;1505;1505;10.06;0.62;169.41;3.87;686;16;488.00;0
820;16;626460481;820;209;1505;1505;9.97;0.61;169.27;3.87;685;16;489.00;0
822;16;626460492;822;208;1510;1511;9.97;0.61;169.09;3.86;688;16;490.00;1
825;16;626460512;825;212;1510;1511;9.83;0.60;169.35;3.86;685;16;491.00;1
825;16;626460526;825;215;1511;1511;9.67;0.59;169.35;3.86;686;16;492.00;0
826;16;626460537;826;218;1511;1511;9.55;0.58;169.53;3.86;685;16;493.00;0
828;16;626460548;828;218;1515;1515;9.44;0.58;169.36;3.85;687;16;494.00;0
828;16;626460559;828;223;1517;1517;9.40;0.58;169.36;3.84;689;16;495.00;0
831;16;626460569;831;222;1517;1517;9.38;0.58;169.06;3.84;686;16;496.00;0
831;16;626460579;831;221;1518;1518;9.43;0.58;169.06;3.84;687;16;497.00;0
833;16;626460588;833;224;1518;1518;9.45;0.58;168.88;3.84;685;16;498.00;0
835;16;626460598;835;229;1518;1518;9.50;0.58;168.72;3.84;683;16;499.00;0
840;16;626460609;840;232;1518;1518;9.42;0.58;168.31;3.84;678;16;500.00;0
841;16;626460625;841;234;1518;1518;9.32;0.57;168.19;3.84;677;16;501.00;0
843;16;626460634;843;237;1518;1518;9.17;0.56;168.22;3.84;675;16;502.00;0
847;16;626460644;847;242;1518;1518;9.04;0.55;168.25;3.84;671;16;503.00;0
851;16;626460655;851;251;1557;1588;9.06;0.56;168.64;3.75;706;16;504.00;31
857;16;626460673;857;251;1561;1589;8.86;0.54;168.93;3.74;704;16;505.00;28
863;16;626460685;863;257;1571;1589;8.81;0.54;169.07;3.73;708;16;506.00;18
866;16;626460696;866;261;1572;1589;8.65;0.53;169.41;3.73;706;16;507.00;17
867;16;626460709;867;262;1578;1589;8.57;0.53;169.72;3.73;711;16;508.00;11
871;16;626460719;871;267;1581;1589;8.48;0.52;170.16;3.73;710;16;509.00;8
871;16;626460728;871;260;1586;1589;8.46;0.52;170.16;3.74;715;16;510.00;3
876;16;626460736;876;256;1587;1589;8.41;0.51;171.04;3.74;711;16;511.00;2
877;16;626460744;877;255;1589;1590;8.42;0.51;171.02;3.74;712;16;512.00;1
882;16;626460751;882;251;1591;1591;8.37;0.51;170.89;3.74;709;16;513.00;0
884;16;626460760;884;253;1591;1591;8.38;0.51;171.47;3.74;707;16;514.00;0
885;16;626460768;885;255;1595;1595;8.29;0.51;171.33;3.73;710;16;515.00;0
888;16;626460782;888;258;1595;1595;8.22;0.50;171.72;3.73;707;16;516.00;0
891;16;626460791;891;254;1595;1595;8.22;0.50;172.54;3.73;704;16;517.00;0
893;16;626460799;893;256;1595;1595;8.19;0.50;172.83;3.73;702;16;518.00;0
898;16;626460807;898;256;1600;1601;8.16;0.50;173.80;3.73;702;16;519.00;1
899;16;626460816;899;262;1600;1601;8.17;0.50;173.74;3.73;701;16;520.00;1
901;16;626460824;901;265;1601;1601;8.21;0.50;174.27;3.73;700;16;521.00;0
904;16;626460833;904;260;1603;1604;8.20;0.50;174.41;3.72;699;16;522.00;1
907;16;626460841;907;247;1604;1604;8.19;0.50;174.81;3.72;697;16;523.00;0
908;16;626460850;908;233;1604;1604;8.23;0.50;175.04;3.72;696;16;524.00;0
911;16;626460859;911;225;1605;1605;8.22;0.50;175.00;3.72;694;16;525.00;0
916;16;626460867;916;216;1606;1606;8.21;0.50;175.41;3.72;690;16;526.00;0
917;16;626460876;917;215;1606;1606;8.21;0.50;175.64;3.72;689;16;527.00;0
923;16;626460885;923;210;1619;1619;8.29;0.51;175.66;3.69;696;16;528.00;0
925;16;626460896;925;205;1619;1619;8.37;0.51;175.60;3.69;694;16;529.00;0
926;16;626460915;926;197;1619;1619;8.45;0.52;175.75;3.69;693;16;530.00;0
932;16;626460932;932;196;1620;1620;8.52;0.52;176.04;3.68;688;16;531.00;0
933;16;626460947;933;199;1620;1620;8.60;0.52;175.91;3.68;687;16;532.00;0
936;16;626460956;936;191;1623;1624;8.70;0.53;176.33;3.68;687;16;533.00;1
940;16;626460966;940;189;1623;1624;8.81;0.54;176.34;3.68;683;16;534.00;1
941;16;626460976;941;185;1627;1628;8.99;0.55;176.37;3.67;686;16;535.00;1
945;16;626460986;945;180;1627;1628;9.01;0.55;176.26;3.67;682;16;536.00;1
949;16;626461003;949;184;1627;1628;9.03;0.55;176.82;3.67;678;16;537.00;1
954;16;626461019;954;182;1628;1628;8.98;0.55;177.56;3.67;674;16;538.00;0
956;16;626461034;956;194;1628;1628;9.05;0.55;177.61;3.67;672;16;539.00;0
959;16;626461053;959;195;1657;1662;9.11;0.56;177.91;3.61;698;16;540.00;5
962;16;626461074;962;195;1657;1662;9.14;0.56;178.31;3.61;695;16;541.00;5
966;16;626461096;966;194;1659;1662;9.18;0.56;178.77;3.61;693;16;542.00;3
969;16;626461112;969;195;1659;1662;9.21;0.56;179.00;3.61;690;16;543.00;3
972;16;626461124;972;202;1660;1662;9.19;0.56;179.29;3.61;688;16;544.00;2
974;16;626461135;974;200;1660;1662;9.24;0.57;179.13;3.61;686;16;545.00;2
976;16;626461147;976;204;1662;1663;9.27;0.57;179.22;3.61;686;16;546.00;1
978;16;626461157;978;208;1662;1663;9.28;0.57;179.38;3.61;684;16;547.00;1
980;16;626461167;980;205;1667;1669;9.23;0.57;179.61;3.60;687;16;548.00;2
984;16;626461179;984;210;1668;1670;9.23;0.57;179.64;3.60;684;16;549.00;2
988;16;626461190;988;210;1669;1670;9.21;0.57;179.80;3.60;681;16;550.00;1
993;16;626461200;993;208;1669;1670;9.11;0.56;179.46;3.60;676;16;551.00;1
998;16;626461211;998;212;1674;1674;9.01;0.55;179.86;3.59;676;16;552.00;0
1004;16;626461222;1004;215;1674;1674;8.91;0.55;180.02;3.59;670;16;553.00;0
1006;16;626461234;1006;222;1674;1674;8.82;0.54;180.17;3.59;668;16;554.00;0
1008;16;626461245;1008;230;1675;1675;8.79;0.54;180.78;3.59;667;16;555.00;0
1014;16;626461258;1014;235;1679;1679;8.74;0.53;180.74;3.59;665;16;556.00;0
1017;16;626461270;1017;224;1679;1679;8.80;0.54;181.10;3.59;662;16;557.00;0
1021;16;626461287;1021;217;1681;1682;8.79;0.54;181.66;3.58;660;16;558.00;1
1026;16;626461297;1026;209;1681;1682;8.83;0.54;181.88;3.58;655;16;559.00;1
1028;16;626461308;1028;204;1682;1682;8.94;0.54;182.23;3.58;654;16;560.00;0
1030;16;626461318;1030;202;1682;1682;9.02;0.55;182.57;3.58;652;16;561.00;0
1036;16;626461329;1036;205;1685;1686;8.99;0.54;182.96;3.58;649;16;562.00;1
1036;16;626461340;1036;201;1685;1686;9.02;0.55;182.96;3.58;649;16;563.00;1
1038;16;626461350;1038;205;1686;1686;9.08;0.55;183.54;3.58;648;16;564.00;0
1040;16;626461360;1040;201;1686;1686;9.10;0.55;183.75;3.58;646;16;565.00;0
1042;16;626461370;1042;192;1687;1687;9.16;0.55;184.08;3.57;645;16;566.00;0
1045;16;626461380;1045;182;1688;1688;9.26;0.56;184.10;3.57;643;16;567.00;0
1046;16;626461391;1046;167;1688;1688;9.38;0.57;184.12;3.57;642;16;568.00;0
1049;16;626461401;1049;158;1689;1689;9.52;0.58;184.37;3.57;640;16;569.00;0
1050;16;626461414;1050;153;1689;1689;9.64;0.59;184.56;3.57;639;16;570.00;0
1053;16;626461424;1053;150;1689;1689;9.62;0.59;185.12;3.57;636;16;571.00;0
1056;16;626461435;1056;152;1689;1689;9.63;0.59;185.39;3.57;633;16;572.00;0
1060;16;626461445;1060;157;1689;1689;9.65;0.59;186.04;3.57;629;16;573.00;0
1062;16;626461457;1062;162;1689;1689;9.72;0.59;186.05;3.57;627;16;574.00;0
1065;16;626461469;1065;166;1689;1689;9.82;0.60;186.24;3.57;624;16;575.00;0
1066;16;626461479;1066;198;1770;1816;9.82;0.61;186.21;3.41;704;16;576.00;46
1069;16;626461500;1069;185;1773;1817;9.84;0.61;186.39;3.40;704;16;577.00;44
1072;16;626461510;1072;167;1780;1817;10.02;0.62;186.56;3.40;708;16;578.00;37
1075;16;626461522;1075;162;1785;1817;10.15;0.63;186.51;3.40;710;16;579.00;32
1077;16;626461532;1077;153;1790;1817;10.24;0.63;186.76;3.40;713;16;580.00;27
1082;16;626461544;1082;149;1794;1817;10.29;0.64;187.14;3.40;712;16;581.00;23
1085;16;626461561;1085;150;1799;1817;10.39;0.64;187.26;3.41;714;16;582.00;18
1089;16;626461577;1089;157;1802;1817;10.36;0.64;187.35;3.42;713;16;583.00;15
1090;16;626461588;1090;157;1806;1818;10.32;0.64;187.44;3.42;716;16;584.00;12
1093;16;626461599;1093;162;1808;1820;10.27;0.63;187.69;3.42;715;16;585.00;12
1093;16;626461610;1093;165;1811;1820;10.28;0.63;187.69;3.44;718;16;586.00;9
1094;16;626461620;1094;169;1813;1821;10.27;0.63;187.66;3.44;719;16;587.00;8
1096;16;626461631;1096;179;1815;1821;10.32;0.63;187.67;3.45;719;16;588.00;6
1098;16;626461642;1098;178;1816;1821;10.30;0.63;188.12;3.45;718;16;589.00;5
1099;16;626461653;1099;175;1818;1821;10.37;0.64;188.22;3.46;719;16;590.00;3
1102;16;626461663;1102;174;1820;1825;10.37;0.64;188.55;3.46;718;16;591.00;5
1106;16;626461674;1106;179;1823;1825;10.41;0.64;188.54;3.48;717;16;592.00;2
1107;16;626461687;1107;186;1823;1825;10.44;0.64;188.52;3.48;716;16;593.00;2
1112;16;626461697;1112;191;1826;1828;10.52;0.64;189.05;3.47;714;16;594.00;2
1115;16;626461709;1115;190;1826;1828;10.58;0.64;189.22;3.47;711;16;595.00;2
1116;16;626461719;1116;194;1827;1828;10.61;0.64;189.18;3.48;711;16;596.00;1
1117;16;626461729;1117;194;1831;1832;10.61;0.64;189.22;3.47;714;16;597.00;1
1119;17;626461740;1119;194;1833;1833;10.70;0.65;188.98;3.47;714;17;598.00;0
1121;17;626461764;1121;193;1833;1833;10.72;0.65;189.19;3.47;712;17;599.00;0
1124;17;626461777;1124;195;1844;1859;10.60;0.64;189.76;3.45;720;17;600.00;15
1126;17;626461797;1126;187;1845;1859;10.67;0.65;189.66;3.45;719;17;601.00;14
1128;17;626461808;1128;181;1846;1859;10.67;0.65;189.94;3.45;718;17;602.00;13
1129;17;626461819;1129;182;1847;1860;10.69;0.65;189.83;3.44;718;17;603.00;13
1132;17;626461830;1132;182;1848;1860;10.65;0.65;190.03;3.44;716;17;604.00;12
1136;17;626461841;1136;176;1851;1866;10.68;0.65;190.26;3.44;715;17;605.00;15
1139;17;626461852;1139;177;1853;1866;10.68;0.65;190.13;3.44;714;17;606.00;13
1143;18;626461862;1143;173;1853;1867;10.70;0.65;190.34;3.44;710;18;607.00;14
1148;18;626461886;1148;170;1856;1867;10.65;0.64;190.83;3.45;708;18;608.00;11
1149;18;626461901;1149;168;1856;1867;10.67;0.65;190.75;3.45;707;18;609.00;11
1151;18;626461912;1151;162;1856;1867;10.67;0.65;190.93;3.45;705;18;610.00;11
1153;18;626461924;1153;157;1856;1867;10.67;0.65;191.20;3.45;703;18;611.00;11
1154;19;626461934;1154;150;1865;1879;10.64;0.64;191.19;3.44;711;19;612.00;14
1157;19;626461957;1157;139;1867;1879;10.63;0.64;191.36;3.44;710;19;613.00;12
1161;19;626461967;1161;133;1868;1879;10.70;0.65;191.60;3.44;707;19;614.00;11
1167;19;626461985;1167;129;1870;1879;10.72;0.65;191.80;3.45;703;19;615.00;9
1171;19;626461997;1171;120;1870;1879;10.73;0.65;191.77;3.45;699;19;616.00;9
1173;19;626462007;1173;117;1871;1879;10.75;0.65;191.99;3.45;698;19;617.00;8
1178;20;626462017;1178;108;1874;1883;10.81;0.65;192.79;3.45;696;20;618.00;9
1181;20;626462036;1181;106;1874;1883;10.93;0.66;192.72;3.45;693;20;619.00;9
1184;20;626462046;1184;103;1877;1887;11.08;0.67;193.22;3.45;693;20;620.00;10
1190;20;626462067;1190;97;1879;1888;11.27;0.68;193.35;3.44;689;20;621.00;9
1191;20;626462082;1191;98;1879;1888;11.31;0.68;193.58;3.44;688;20;622.00;9
1194;20;626462092;1194;103;1880;1888;11.33;0.69;193.95;3.45;686;20;623.00;8
1197;20;626462102;1197;107;1888;1901;11.36;0.69;193.95;3.44;691;20;624.00;13
1199;20;626462113;1199;106;1888;1901;11.35;0.69;194.22;3.44;689;20;625.00;13
1202;20;626462123;1202;112;1888;1901;11.37;0.69;194.47;3.44;686;20;626.00;13
1207;21;626462133;1207;114;1889;1902;11.39;0.69;194.71;3.44;682;21;627.00;13
1209;21;626462150;1209;117;1889;1903;11.39;0.69;194.97;3.44;680;21;628.00;14
1212;21;626462163;1212;121;1891;1903;11.41;0.69;195.37;3.46;679;21;629.00;12
1213;21;626462176;1213;125;1895;1909;11.37;0.69;195.43;3.47;682;21;630.00;14
1216;21;626462187;1216;127;1897;1909;11.29;0.68;195.76;3.47;681;21;631.00;12
1219;21;626462197;1219;130;1898;1909;11.23;0.68;195.60;3.47;679;21;632.00;11
1220;21;626462208;1220;135;1898;1909;11.27;0.68;195.83;3.47;678;21;633.00;11
1223;21;626462218;1223;134;1902;1915;11.25;0.68;195.61;3.46;679;21;634.00;13
1225;21;626462231;1225;137;1902;1915;11.21;0.68;195.68;3.46;677;21;635.00;13
1226;21;626462241;1226;137;1904;1915;11.13;0.68;195.60;3.48;678;21;636.00;11
1226;21;626462253;1226;136;1904;1915;11.11;0.68;195.60;3.48;678;21;637.00;11
1230;21;626462264;1230;144;1908;1919;11.07;0.67;195.64;3.48;678;21;638.00;11
1231;21;626462275;1231;148;1909;1920;11.06;0.67;195.55;3.47;678;21;639.00;11
1234;21;626462285;1234;154;1911;1920;10.98;0.67;195.35;3.49;677;21;640.00;9
1238;21;626462295;1238;160;1912;1921;10.96;0.67;195.20;3.49;674;21;641.00;9
1241;21;626462305;1241;164;1914;1921;10.83;0.66;195.04;3.52;673;21;642.00;7
1243;21;626462314;1243;166;1915;1921;10.71;0.65;195.01;3.53;672;21;643.00;6
1244;21;626462324;1244;166;1915;1921;10.56;0.64;195.02;3.53;671;21;644.00;6
1245;21;626462334;1245;170;1916;1921;10.46;0.64;194.92;3.54;671;21;645.00;5
1249;21;626462342;1249;172;1916;1921;10.35;0.63;194.79;3.54;667;21;646.00;5
1250;21;626462351;1250;177;1916;1921;10.23;0.62;194.75;3.54;666;21;647.00;5
1252;21;626462360;1252;188;1956;1991;10.24;0.63;194.71;3.51;704;21;648.00;35
1253;21;626462375;1253;190;1958;1992;10.12;0.62;194.58;3.51;705;21;649.00;34
1255;21;626462383;1255;190;1971;1992;10.05;0.62;194.52;3.51;716;21;650.00;21
1255;21;626462393;1255;192;1975;1992;9.91;0.61;194.52;3.52;720;21;651.00;17
1256;21;626462401;1256;194;1980;1992;9.87;0.61;194.53;3.52;724;21;652.00;12
1256;21;626462410;1256;202;1983;1992;9.80;0.60;194.53;3.52;727;21;653.00;9
1256;21;626462419;1256;208;1986;1992;9.74;0.60;194.53;3.52;730;21;654.00;6
1258;21;626462427;1258;209;1988;1992;9.68;0.60;194.42;3.53;730;21;655.00;4
1259;21;626462436;1259;216;1991;1993;9.58;0.59;194.36;3.53;732;21;656.00;2
1263;21;626462445;1263;228;1993;1994;9.47;0.58;194.25;3.54;730;21;657.00;1
1263;21;626462454;1263;236;1994;1994;9.38;0.58;194.25;3.53;731;21;658.00;0
1264;21;626462462;1264;238;1998;1998;9.23;0.57;194.16;3.53;734;21;659.00;0
1266;21;626462474;1266;243;1998;1998;9.10;0.56;193.96;3.53;732;21;660.00;0
1267;21;626462482;1267;247;1998;1998;8.96;0.55;194.05;3.53;731;21;661.00;0
1269;21;626462491;1269;249;1998;1998;8.82;0.54;193.86;3.53;729;21;662.00;0
1270;21;626462499;1270;256;2003;2004;8.75;0.54;193.99;3.52;733;21;663.00;1
1271;21;626462514;1271;262;2003;2004;8.66;0.53;193.93;3.52;732;21;664.00;1
1272;21;626462523;1272;268;2004;2004;8.65;0.53;193.91;3.52;732;21;665.00;0
1275;21;626462531;1275;274;2006;2007;8.63;0.53;193.83;3.52;731;21;666.00;1
1278;21;626462545;1278;277;2006;2007;8.53;0.52;193.74;3.52;728;21;667.00;1
1280;21;626462554;1280;283;2007;2007;8.48;0.52;193.75;3.52;727;21;668.00;0
1281;21;626462562;1281;288;2008;2008;8.42;0.51;193.70;3.52;727;21;669.00;0
1282;21;626462571;1282;294;2009;2009;8.37;0.51;193.84;3.52;727;21;670.00;0
1284;21;626462579;1284;303;2009;2009;8.22;0.50;193.63;3.52;725;21;671.00;0
1287;21;626462586;1287;310;2022;2022;8.05;0.49;193.91;3.49;735;21;672.00;0
1290;21;626462595;1290;313;2022;2022;7.93;0.48;193.76;3.49;732;21;673.00;0
1294;21;626462603;1294;312;2022;2022;7.82;0.48;193.91;3.49;728;21;674.00;0
1298;21;626462611;1298;295;2024;2024;7.73;0.47;193.80;3.49;726;21;675.00;0
1302;21;626462619;1302;286;2024;2024;7.60;0.46;193.78;3.49;722;21;676.00;0
1303;21;626462627;1303;284;2027;2028;7.54;0.46;193.88;3.49;724;21;677.00;1
1305;21;626462635;1305;280;2028;2028;7.39;0.45;194.24;3.49;723;21;678.00;0
1307;21;626462643;1307;276;2032;2032;7.29;0.45;194.56;3.48;725;21;679.00;0
1312;21;626462650;1312;259;2032;2032;7.24;0.44;194.20;3.48;720;21;680.00;0
1314;21;626462659;1314;247;2032;2032;7.20;0.44;194.61;3.48;718;21;681.00;0
1318;21;626462667;1318;239;2032;2032;7.22;0.44;195.13;3.48;714;21;682.00;0
1319;21;626462680;1319;235;2032;2032;7.29;0.44;195.01;3.48;713;21;683.00;0
1322;21;626462689;1322;238;2043;2044;7.42;0.45;195.54;3.46;721;21;684.00;1
1324;21;626462699;1324;234;2043;2044;7.49;0.46;195.61;3.46;719;21;685.00;1
1326;21;626462707;1326;229;2044;2044;7.61;0.46;195.69;3.46;718;21;686.00;0
1329;21;626462716;1329;224;2044;2044;7.68;0.47;196.01;3.46;715;21;687.00;0
1331;21;626462724;1331;215;2044;2044;7.75;0.47;196.38;3.46;713;21;688.00;0
1332;21;626462733;1332;208;2044;2044;7.85;0.48;196.53;3.46;712;21;689.00;0
1334;21;626462743;1334;209;2045;2045;8.00;0.49;196.64;3.46;711;21;690.00;0
1336;21;626462751;1336;201;2045;2045;8.08;0.49;196.71;3.46;709;21;691.00;0
1339;21;626462760;1339;200;2050;2051;8.19;0.50;197.10;3.45;711;21;692.00;1
1339;21;626462770;1339;200;2052;2052;8.37;0.51;197.10;3.45;713;21;693.00;0
1340;21;626462779;1340;199;2052;2052;8.46;0.52;197.22;3.45;712;21;694.00;0
1341;21;626462788;1341;195;2052;2052;8.57;0.52;197.32;3.45;711;21;695.00;0
1345;21;626462797;1345;192;2056;2056;8.65;0.53;197.31;3.44;711;21;696.00;0
1347;21;626462806;1347;189;2056;2056;8.76;0.54;197.62;3.44;709;21;697.00;0
1354;21;626462815;1354;184;2056;2056;8.76;0.53;198.04;3.44;702;21;698.00;0
1360;21;626462824;1360;184;2057;2057;8.77;0.54;198.28;3.44;697;21;699.00;0
1363;21;626462834;1363;181;2061;2061;8.76;0.54;198.43;3.44;698;21;700.00;0
1367;21;626462847;1367;177;2061;2061;8.80;0.54;198.50;3.44;694;21;701.00;0
1370;21;626462857;1370;170;2063;2064;8.87;0.54;198.53;3.44;693;21;702.00;1
1377;21;626462866;1377;169;2063;2064;8.90;0.54;198.53;3.44;686;21;703.00;1
1378;21;626462876;1378;165;2064;2064;9.12;0.56;198.57;3.43;686;21;704.00;0
1385;21;626462885;1385;159;2064;2064;9.17;0.56;198.70;3.43;679;21;705.00;0
1389;21;626462895;1389;156;2067;2068;9.33;0.57;198.64;3.43;678;21;706.00;1
1395;21;626462905;1395;156;2067;2068;9.39;0.57;198.79;3.43;672;21;707.00;1
1400;21;626462915;1400;153;2068;2068;9.39;0.57;198.85;3.43;668;21;708.00;0
1404;21;626462925;1404;153;2068;2068;9.44;0.58;199.10;3.43;664;21;709.00;0
1410;21;626462935;1410;152;2069;2069;9.45;0.57;199.13;3.43;659;21;710.00;0
1414;21;626462945;1414;154;2070;2070;9.55;0.58;199.10;3.43;656;21;711.00;0
1416;21;626462955;1416;155;2070;2070;9.66;0.59;199.17;3.43;654;21;712.00;0
1419;21;626462970;1419;157;2071;2071;9.75;0.59;199.27;3.43;652;21;713.00;0
1422;21;626462980;1422;154;2071;2071;9.75;0.59;199.43;3.43;649;21;714.00;0
1426;21;626462990;1426;150;2071;2071;9.72;0.59;199.71;3.43;645;21;715.00;0
1430;21;626463005;1430;154;2071;2071;9.73;0.59;199.60;3.43;641;21;716.00;0
1434;21;626463022;1434;157;2071;2071;9.67;0.59;199.67;3.43;637;21;717.00;0
1438;21;626463037;1438;156;2071;2071;9.73;0.59;199.60;3.43;633;21;718.00;0
1440;21;626463054;1440;157;2071;2071;9.79;0.60;199.60;3.43;631;21;719.00;0
1445;21;626463070;1445;191;2192;2301;9.80;0.61;199.72;3.24;747;21;720.00;109
1447;21;626463111;1447;185;2204;2302;9.80;0.61;200.00;3.23;757;21;721.00;98
1450;21;626463123;1450;171;2216;2302;9.89;0.62;199.98;3.22;766;21;722.00;86
1454;22;626463135;1454;168;2226;2302;9.77;0.61;200.27;3.22;772;22;723.00;76
1456;22;626463166;1456;168;2232;2302;9.74;0.61;200.31;3.22;776;22;724.00;70
1459;22;626463178;1459;174;2239;2302;9.63;0.60;200.61;3.23;780;22;725.00;63
1464;22;626463190;1464;176;2244;2302;9.49;0.59;201.13;3.23;780;22;726.00;58
1468;22;626463201;1468;167;2248;2302;9.42;0.59;201.47;3.24;780;22;727.00;54
1470;22;626463215;1470;168;2254;2303;9.36;0.58;201.62;3.25;784;22;728.00;49
1473;22;626463226;1473;174;2255;2304;9.29;0.58;201.58;3.25;782;22;729.00;49
1477;22;626463239;1477;188;2262;2304;9.27;0.57;201.80;3.28;785;22;730.00;42
1479;22;626463252;1479;194;2263;2305;9.21;0.57;201.79;3.27;784;22;731.00;42
1482;22;626463265;1482;199;2268;2305;9.22;0.57;202.07;3.29;786;22;732.00;37
1485;22;626463284;1485;203;2268;2305;9.27;0.57;202.48;3.29;783;22;733.00;37
1487;22;626463296;1487;215;2270;2305;9.31;0.58;202.44;3.30;783;22;734.00;35
1491;22;626463307;1491;218;2279;2309;9.18;0.57;203.05;3.33;788;22;735.00;30
1493;22;626463332;1493;210;2281;2309;9.19;0.57;203.22;3.35;788;22;736.00;28
1497;22;626463345;1497;209;2281;2309;9.25;0.57;203.24;3.35;784;22;737.00;28
1498;22;626463357;1498;199;2287;2312;9.38;0.57;203.39;3.38;789;22;738.00;25
1503;22;626463369;1503;196;2288;2312;9.45;0.58;203.64;3.38;785;22;739.00;24
1504;22;626463382;1504;198;2288;2312;9.54;0.58;203.63;3.38;784;22;740.00;24
1505;22;626463403;1505;200;2293;2316;9.55;0.58;203.79;3.39;788;22;741.00;23
1506;22;626463416;1506;207;2295;2317;9.62;0.59;203.93;3.39;789;22;742.00;22
1510;22;626463430;1510;212;2297;2317;9.63;0.59;204.11;3.41;787;22;743.00;20
1515;22;626463444;1515;212;2300;2321;9.66;0.59;204.52;3.40;785;22;744.00;21
1519;22;626463457;1519;213;2301;2321;9.71;0.59;204.59;3.41;782;22;745.00;20
1521;22;626463470;1521;217;2303;2321;9.77;0.60;204.81;3.41;782;22;746.00;18
1523;22;626463484;1523;216;2305;2322;9.81;0.60;204.94;3.42;782;22;747.00;17
1526;22;626463505;1526;214;2306;2322;9.89;0.60;205.10;3.43;780;22;748.00;16
1528;22;626463525;1528;215;2310;2328;9.92;0.60;205.08;3.43;782;22;749.00;18
1531;22;626463545;1531;212;2310;2328;9.98;0.61;205.23;3.43;779;22;750.00;18
1532;22;626463563;1532;209;2313;2329;10.03;0.61;205.21;3.45;781;22;751.00;16
1534;22;626463586;1534;203;2313;2329;10.12;0.62;205.43;3.45;779;22;752.00;16
1537;22;626463610;1537;203;2313;2329;10.16;0.62;205.52;3.45;776;22;753.00;16
1541;22;626463632;1541;201;2314;2329;10.17;0.62;205.52;3.46;773;22;754.00;15
1543;22;626463650;1543;202;2315;2329;10.17;0.62;205.70;3.47;772;22;755.00;14
1545;22;626463667;1545;200;2327;2341;10.24;0.63;206.00;3.46;782;22;756.00;14
1547;22;626463685;1547;202;2328;2341;10.29;0.63;206.06;3.47;781;22;757.00;13
1549;22;626463700;1549;205;2328;2341;10.34;0.63;205.93;3.47;779;22;758.00;13
1550;22;626463715;1550;209;2328;2341;10.37;0.63;206.03;3.47;778;22;759.00;13
1555;22;626463731;1555;211;2329;2341;10.31;0.63;206.01;3.47;774;22;760.00;12
1558;22;626463748;1558;212;2330;2341;10.31;0.63;206.03;3.48;772;22;761.00;11
1559;22;626463768;1559;216;2334;2345;10.25;0.63;206.11;3.48;775;22;762.00;11
1564;22;626463779;1564;220;2334;2345;10.18;0.62;206.25;3.48;770;22;763.00;11
1568;22;626463791;1568;219;2337;2349;10.07;0.62;206.10;3.47;769;22;764.00;12
1570;22;626463802;1570;218;2339;2351;10.05;0.61;206.12;3.47;769;22;765.00;12
1572;22;626463813;1572;226;2340;2351;9.97;0.61;206.09;3.47;768;22;766.00;11
1573;22;626463830;1573;229;2340;2351;9.88;0.60;206.09;3.47;767;22;767.00;11
1576;23;626463847;1576;231;2349;2364;9.82;0.60;206.34;3.46;773;23;768.00;15
1578;23;626463868;1578;235;2349;2364;9.78;0.60;206.38;3.46;771;23;769.00;15
1580;23;626463879;1580;233;2349;2364;9.68;0.59;206.48;3.46;769;23;770.00;15
1583;23;626463889;1583;229;2350;2365;9.64;0.59;206.55;3.45;767;23;771.00;15
1586;23;626463899;1586;230;2350;2366;9.58;0.58;206.53;3.45;764;23;772.00;16
1588;23;626463909;1588;225;2350;2366;9.52;0.58;206.44;3.45;762;23;773.00;16
1592;23;626463919;1592;220;2352;2369;9.45;0.58;206.71;3.45;760;23;774.00;17
1592;23;626463931;1592;219;2352;2369;9.44;0.58;206.71;3.45;760;23;775.00;17
1595;23;626463941;1595;219;2353;2369;9.45;0.58;206.81;3.45;758;23;776.00;16
1597;23;626463951;1597;216;2353;2369;9.47;0.58;206.78;3.45;756;23;777.00;16
1602;23;626463961;1602;216;2358;2375;9.46;0.58;207.14;3.47;756;23;778.00;17
1606;23;626463972;1606;214;2358;2375;9.44;0.58;207.16;3.47;752;23;779.00;17
1608;23;626463984;1608;216;2359;2375;9.41;0.57;207.21;3.47;751;23;780.00;16
1611;23;626464002;1611;212;2359;2375;9.40;0.58;207.43;3.47;748;23;781.00;16
1615;23;626464012;1615;204;2362;2379;9.40;0.57;207.53;3.47;747;23;782.00;17
1618;23;626464023;1618;201;2363;2380;9.34;0.57;207.73;3.47;745;23;783.00;17
1621;23;626464033;1621;198;2363;2380;9.32;0.57;207.62;3.47;742;23;784.00;17
1623;23;626464043;1623;192;2364;2381;9.27;0.56;207.61;3.46;741;23;785.00;17
1627;23;626464059;1627;185;2366;2381;9.21;0.56;207.41;3.48;739;23;786.00;15
1628;23;626464069;1628;180;2366;2381;9.23;0.56;207.35;3.48;738;23;787.00;15
1630;23;626464079;1630;176;2366;2381;9.27;0.56;207.37;3.48;736;23;788.00;15
1636;23;626464088;1636;167;2366;2381;9.24;0.56;207.28;3.48;730;23;789.00;15
1638;23;626464098;1638;164;2366;2381;9.24;0.56;207.12;3.48;728;23;790.00;15
1641;23;626464112;1641;167;2366;2381;9.28;0.56;206.90;3.48;725;23;791.00;15
1641;23;626464121;1641;170;2398;2451;9.42;0.58;206.90;3.46;757;23;792.00;53
1642;23;626464136;1642;172;2398;2452;9.46;0.58;206.82;3.46;756;23;793.00;54
1644;23;626464146;1644;173;2406;2452;9.57;0.58;206.78;3.46;762;23;794.00;46
1646;23;626464156;1646;175;2409;2452;9.56;0.58;206.69;3.49;763;23;795.00;43
1648;23;626464165;1648;175;2413;2452;9.59;0.58;206.55;3.49;765;23;796.00;39
1648;23;626464175;1648;175;2418;2452;9.63;0.59;206.55;3.52;770;23;797.00;34
1648;23;626464185;1648;173;2424;2452;9.68;0.59;206.55;3.53;776;23;798.00;28
1649;23;626464195;1649;174;2424;2452;9.65;0.59;206.56;3.53;775;23;799.00;28
1651;23;626464205;1651;177;2429;2453;9.65;0.59;206.49;3.56;778;23;800.00;24
1656;23;626464219;1656;181;2432;2454;9.62;0.59;206.26;3.57;776;23;801.00;22
1657;23;626464229;1657;190;2433;2454;9.56;0.58;206.19;3.57;776;23;802.00;21
1659;23;626464239;1659;194;2439;2458;9.48;0.58;206.20;3.60;780;23;803.00;19
1660;23;626464250;1660;195;2439;2458;9.44;0.58;206.13;3.60;779;23;804.00;19
1664;23;626464260;1664;206;2441;2458;9.31;0.57;206.22;3.64;777;23;805.00;17
1666;23;626464270;1666;216;2442;2458;9.21;0.56;206.05;3.65;776;23;806.00;16
1669;23;626464283;1669;223;2446;2464;9.12;0.55;206.13;3.68;777;23;807.00;18
1671;23;626464293;1671;230;2448;2464;9.05;0.55;205.99;3.68;777;23;808.00;16
1673;23;626464304;1673;235;2449;2464;8.96;0.54;205.79;3.71;776;23;809.00;15
1675;23;626464316;1675;244;2453;2470;8.93;0.54;205.71;3.72;778;23;810.00;17
1678;23;626464326;1678;243;2454;2470;8.93;0.54;205.67;3.74;776;23;811.00;16
1679;23;626464336;1679;253;2458;2470;8.89;0.54;205.56;3.80;779;23;812.00;12
1683;23;626464346;1683;260;2459;2471;8.83;0.54;205.57;3.80;776;23;813.00;12
1683;23;626464356;1683;262;2464;2472;8.83;0.54;205.57;3.84;781;23;814.00;8
1686;23;626464365;1686;266;2464;2472;8.72;0.53;205.45;3.84;778;23;815.00;8
1688;23;626464375;1688;278;2475;2485;8.68;0.53;205.36;3.84;787;23;816.00;10
1689;23;626464387;1689;283;2476;2485;8.64;0.53;205.33;3.85;787;23;817.00;9
1690;23;626464396;1690;288;2479;2485;8.57;0.52;205.22;3.87;789;23;818.00;6
1693;23;626464406;1693;291;2480;2486;8.56;0.52;205.12;3.87;787;23;819.00;6
1694;23;626464416;1694;299;2483;2486;8.47;0.51;205.05;3.87;789;23;820.00;3
1695;23;626464425;1695;307;2487;2490;8.47;0.52;204.99;3.87;792;23;821.00;3
1697;23;626464435;1697;316;2488;2490;8.40;0.51;204.84;3.87;791;23;822.00;2
1699;23;626464444;1699;322;2493;2494;8.33;0.51;204.86;3.87;794;23;823.00;1
1700;23;626464454;1700;324;2493;2494;8.28;0.50;204.97;3.87;793;23;824.00;1
1700;23;626464463;1700;329;2493;2494;8.16;0.50;204.97;3.87;793;23;825.00;1
1703;23;626464473;1703;338;2493;2494;8.00;0.49;204.81;3.87;790;23;826.00;1
1703;23;626464483;1703;328;2494;2494;7.86;0.48;204.81;3.87;791;23;827.00;0
1705;23;626464492;1705;318;2504;2506;7.84;0.48;204.76;3.85;799;23;828.00;2
1706;23;626464502;1706;316;2505;2506;7.84;0.48;204.71;3.85;799;23;829.00;1
1707;23;626464512;1707;311;2506;2506;7.85;0.48;204.72;3.85;799;23;830.00;0
1709;23;626464521;1709;301;2506;2506;7.88;0.48;204.61;3.85;797;23;831.00;0
1709;23;626464531;1709;297;2506;2506;7.96;0.49;204.61;3.85;797;23;832.00;0
1709;23;626464540;1709;293;2506;2506;8.06;0.49;204.61;3.85;797;23;833.00;0
1710;23;626464555;1710;290;2507;2507;8.09;0.49;204.64;3.85;797;23;834.00;0
1710;23;626464564;1710;289;2507;2507;8.20;0.50;204.64;3.85;797;23;835.00;0
1711;23;626464574;1711;286;2512;2513;8.33;0.51;204.67;3.85;801;23;836.00;1
1712;23;626464585;1712;290;2513;2514;8.45;0.51;204.62;3.84;801;23;837.00;1
1713;23;626464595;1713;290;2514;2514;8.52;0.52;204.57;3.84;801;23;838.00;0
1713;23;626464604;1713;288;2514;2514;8.56;0.52;204.57;3.84;801;23;839.00;0
1715;23;626464615;1715;289;2519;2519;8.61;0.52;204.41;3.84;804;23;840.00;0
1715;23;626464625;1715;288;2519;2519;8.60;0.52;204.41;3.84;804;23;841.00;0
1717;23;626464635;1717;284;2519;2519;8.51;0.52;204.47;3.84;802;23;842.00;0
1719;23;626464644;1719;285;2520;2520;8.38;0.51;204.42;3.83;801;23;843.00;0
1722;23;626464654;1722;284;2524;2524;8.31;0.51;204.49;3.83;802;23;844.00;0
1725;23;626464664;1725;289;2524;2524;8.24;0.50;204.71;3.83;799;23;845.00;0
1727;23;626464673;1727;291;2526;2527;8.19;0.50;204.62;3.83;799;23;846.00;1
1731;23;626464682;1731;289;2527;2527;8.07;0.49;205.00;3.83;796;23;847.00;0
1735;23;626464691;1735;295;2527;2527;7.98;0.49;205.41;3.83;792;23;848.00;0
1738;23;626464700;1738;300;2527;2527;7.84;0.48;205.69;3.83;789;23;849.00;0
1742;23;626464709;1742;288;2530;2531;7.82;0.48;206.23;3.82;788;23;850.00;1
1746;23;626464719;1746;282;2530;2531;7.79;0.48;206.48;3.82;784;23;851.00;1
1749;23;626464727;1749;273;2531;2531;7.83;0.48;207.00;3.82;782;23;852.00;0
1752;23;626464736;1752;271;2531;2531;7.88;0.48;207.08;3.82;779;23;853.00;0
1758;23;626464745;1758;268;2532;2532;7.89;0.48;207.63;3.82;774;23;854.00;0
1761;23;626464754;1761;257;2534;2534;8.05;0.49;207.72;3.82;773;23;855.00;0
1768;23;626464764;1768;258;2534;2534;8.10;0.49;207.74;3.82;766;23;856.00;0
1773;23;626464773;1773;248;2535;2535;8.22;0.50;207.97;3.82;762;23;857.00;0
1777;23;626464783;1777;243;2535;2535;8.33;0.51;208.27;3.82;758;23;858.00;0
1779;23;626464792;1779;235;2535;2535;8.44;0.51;208.50;3.82;756;23;859.00;0
1782;23;626464802;1782;225;2535;2535;8.49;0.52;209.00;3.82;753;23;860.00;0
1783;23;626464812;1783;220;2535;2535;8.60;0.53;209.08;3.82;752;23;861.00;0
1789;23;626464821;1789;208;2535;2535;8.56;0.52;209.26;3.82;746;23;862.00;0
1794;23;626464831;1794;197;2535;2535;8.57;0.52;209.29;3.82;741;23;863.00;0
1799;23;626464840;1799;201;2614;2662;8.75;0.54;209.89;3.70;815;23;864.00;48
1802;23;626464860;1802;198;2618;2663;8.80;0.54;210.07;3.70;816;23;865.00;45
1808;23;626464871;1808;189;2624;2663;8.96;0.55;210.18;3.69;816;23;866.00;39
1810;23;626464882;1810;188;2631;2663;9.03;0.56;210.27;3.69;821;23;867.00;32
1815;23;626464892;1815;187;2636;2663;9.08;0.56;210.46;3.69;821;23;868.00;27
1819;23;626464903;1819;182;2640;2663;9.12;0.56;210.50;3.70;821;23;869.00;23
1827;23;626464915;1827;175;2644;2663;9.05;0.56;210.71;3.70;817;23;870.00;19
1832;23;626464928;1832;179;2647;2663;9.00;0.55;210.88;3.70;815;23;871.00;16
1836;23;626464942;1836;184;2649;2664;8.94;0.55;211.12;3.71;813;23;872.00;15
1839;23;626464960;1839;192;2651;2665;8.94;0.55;211.33;3.71;812;23;873.00;14
1841;23;626464976;1841;194;2653;2665;8.93;0.55;211.61;3.71;812;23;874.00;12
1851;23;626464988;1851;200;2655;2666;8.84;0.54;211.82;3.71;804;23;875.00;11
1854;23;626465004;1854;210;2657;2666;8.88;0.55;211.90;3.72;803;23;876.00;9
1861;23;626465023;1861;214;2657;2666;8.83;0.54;211.98;3.72;796;23;877.00;9
1866;23;626465041;1866;220;2660;2666;8.91;0.55;212.26;3.73;794;23;878.00;6
1868;23;626465062;1868;221;2662;2670;8.94;0.55;212.29;3.73;794;23;879.00;8
1872;23;626465081;1872;220;2664;2670;8.91;0.55;212.35;3.73;792;23;880.00;6
1876;23;626465097;1876;218;2665;2670;8.91;0.55;212.39;3.74;789;23;881.00;5
1881;23;626465122;1881;225;2668;2673;8.93;0.55;212.51;3.74;787;23;882.00;5
1885;23;626465136;1885;228;2669;2673;8.95;0.55;212.51;3.74;784;23;883.00;4
1888;23;626465149;1888;221;2670;2673;9.00;0.55;212.81;3.74;782;23;884.00;3
1891;23;626465168;1891;221;2674;2677;9.04;0.55;212.73;3.74;783;23;885.00;3
1896;23;626465181;1896;223;2676;2678;9.14;0.56;212.82;3.74;780;23;886.00;2
1901;23;626465194;1901;220;2677;2678;9.19;0.56;213.05;3.75;776;23;887.00;1
1903;23;626465206;1903;223;2681;2682;9.26;0.57;212.97;3.74;778;23;888.00;1
1907;23;626465219;1907;221;2681;2682;9.26;0.57;213.28;3.74;774;23;889.00;1
1913;23;626465232;1913;225;2681;2682;9.26;0.57;213.31;3.74;768;23;890.00;1
1917;23;626465244;1917;229;2682;2683;9.22;0.57;213.52;3.74;765;23;891.00;1
1919;23;626465258;1919;228;2682;2683;9.16;0.56;213.56;3.74;763;23;892.00;1
1923;23;626465270;1923;230;2687;2689;9.06;0.56;213.53;3.73;764;23;893.00;2
1927;23;626465283;1927;234;2687;2689;8.91;0.55;213.67;3.73;760;23;894.00;2
1930;23;626465296;1930;235;2689;2690;8.82;0.54;213.83;3.73;759;23;895.00;1
1935;23;626465307;1935;239;2689;2690;8.75;0.54;214.01;3.73;754;23;896.00;1
1937;23;626465319;1937;231;2689;2690;8.76;0.54;214.04;3.73;752;23;897.00;1
1939;23;626465338;1939;222;2689;2690;8.80;0.54;214.15;3.73;750;23;898.00;1
1946;23;626465350;1946;219;2689;2690;8.75;0.53;214.54;3.73;743;23;899.00;1
1948;23;626465365;1948;232;2716;2736;8.69;0.53;214.56;3.70;768;23;900.00;20
1950;23;626465387;1950;223;2716;2736;8.73;0.53;215.03;3.70;766;23;901.00;20
1954;23;626465399;1954;214;2718;2736;8.83;0.54;215.31;3.69;764;23;902.00;18
1959;23;626465411;1959;215;2718;2736;8.87;0.54;215.36;3.69;759;23;903.00;18
1963;23;626465423;1963;213;2720;2736;8.83;0.54;215.35;3.69;757;23;904.00;16
1965;23;626465435;1965;215;2720;2736;8.76;0.54;215.43;3.69;755;23;905.00;16
1967;23;626465447;1967;207;2727;2740;8.75;0.54;215.63;3.71;760;23;906.00;13
1970;23;626465458;1970;195;2728;2740;8.79;0.54;215.83;3.71;758;23;907.00;12
1971;23;626465471;1971;186;2731;2744;8.93;0.55;215.88;3.71;760;23;908.00;13
1973;23;626465483;1973;180;2732;2745;8.99;0.55;215.88;3.71;759;23;909.00;13
1975;23;626465495;1975;182;2734;2745;9.03;0.55;216.06;3.71;759;23;910.00;11
1977;23;626465507;1977;175;2734;2745;9.10;0.56;216.18;3.71;757;23;911.00;11
1982;23;626465520;1982;179;2743;2758;9.20;0.56;216.22;3.70;761;23;912.00;15
1985;23;626465532;1985;183;2743;2758;9.29;0.57;216.39;3.70;758;23;913.00;15
1989;23;626465545;1989;183;2743;2758;9.34;0.57;216.64;3.70;754;23;914.00;15
1990;23;626465555;1990;188;2746;2759;9.39;0.57;216.76;3.71;756;23;915.00;13
1995;23;626465566;1995;190;2747;2760;9.39;0.57;216.95;3.70;752;23;916.00;13
1998;23;626465578;1998;185;2747;2760;9.37;0.57;216.98;3.70;749;23;917.00;13
2001;23;626465597;2001;182;2749;2763;9.40;0.57;217.09;3.70;748;23;918.00;14
2002;23;626465611;2002;182;2749;2763;9.35;0.57;217.07;3.70;747;23;919.00;14
2007;23;626465622;2007;175;2749;2763;9.30;0.57;217.13;3.70;742;23;920.00;14
2009;23;626465633;2009;171;2751;2763;9.30;0.57;217.15;3.71;742;23;921.00;12
2011;23;626465645;2011;169;2755;2769;9.41;0.57;217.08;3.71;744;23;922.00;14
2013;23;626465656;2013;169;2755;2769;9.54;0.58;217.06;3.71;742;23;923.00;14
2015;23;626465667;2015;162;2755;2769;9.71;0.59;217.26;3.71;740;23;924.00;14
2018;23;626465678;2018;162;2755;2769;9.76;0.59;217.11;3.71;737;23;925.00;14
2022;23;626465688;2022;162;2762;2773;9.68;0.59;217.10;3.73;740;23;926.00;11
2026;23;626465699;2026;164;2763;2774;9.66;0.58;217.01;3.73;737;23;927.00;11
2027;23;626465710;2027;173;2763;2774;9.58;0.58;217.00;3.73;736;23;928.00;11
2028;23;626465727;2028;177;2766;2775;9.55;0.58;217.06;3.74;738;23;929.00;9
2029;23;626465745;2029;182;2767;2775;9.53;0.58;217.10;3.74;738;23;930.00;8
2031;23;626465756;2031;192;2768;2775;9.47;0.58;217.16;3.75;737;23;931.00;7
2032;23;626465775;2032;198;2769;2775;9.47;0.58;217.16;3.76;737;23;932.00;6
2034;23;626465785;2034;195;2769;2775;9.41;0.57;217.20;3.76;735;23;933.00;6
2035;23;626465796;2035;208;2770;2775;9.40;0.57;217.19;3.76;735;23;934.00;5
2037;23;626465806;2037;210;2771;2775;9.38;0.57;217.26;3.76;734;23;935.00;4
2041;23;626465816;2041;233;2808;2845;9.14;0.56;217.28;3.71;767;23;936.00;37
2044;23;626465832;2044;227;2809;2846;9.05;0.55;217.39;3.72;765;23;937.00;37
2047;23;626465844;2047;225;2816;2846;9.04;0.55;217.42;3.72;769;23;938.00;30
2048;23;626465854;2048;225;2821;2846;9.03;0.55;217.51;3.72;773;23;939.00;25
2049;23;626465864;2049;221;2825;2846;9.05;0.55;217.51;3.72;776;23;940.00;21
2052;23;626465874;2052;217;2827;2846;9.08;0.55;217.68;3.72;775;23;941.00;19
2053;23;626465884;2053;217;2832;2846;9.24;0.56;217.68;3.72;779;23;942.00;14
2053;23;626465894;2053;213;2834;2846;9.35;0.57;217.68;3.72;781;23;943.00;12
2055;23;626465904;2055;210;2837;2847;9.42;0.58;217.61;3.73;782;23;944.00;10
2058;23;626465915;2058;213;2839;2849;9.40;0.57;217.60;3.72;781;23;945.00;10
2060;23;626465926;2060;211;2840;2849;9.41;0.57;217.87;3.74;780;23;946.00;9
2064;23;626465936;2064;203;2843;2853;9.35;0.57;217.97;3.73;779;23;947.00;10
2068;23;626465947;2068;197;2843;2853;9.20;0.56;217.89;3.73;775;23;948.00;10
2071;23;626465957;2071;192;2843;2853;9.12;0.56;217.83;3.73;772;23;949.00;10
2074;23;626465967;2074;191;2844;2853;9.04;0.55;217.83;3.74;770;23;950.00;9
2076;23;626465977;2076;187;2847;2859;8.95;0.55;217.93;3.74;771;23;951.00;12
2080;23;626465989;2080;185;2847;2859;8.89;0.54;217.95;3.74;767;23;952.00;12
2085;23;626466003;2085;182;2849;2859;8.77;0.54;217.90;3.75;764;23;953.00;10
2087;23;626466015;2087;175;2851;2862;8.73;0.54;217.81;3.75;764;23;954.00;11
2090;23;626466031;2090;178;2854;2862;8.59;0.53;217.87;3.76;764;23;955.00;8
2093;23;626466042;2093;177;2854;2862;8.51;0.52;217.99;3.76;761;23;956.00;8
2095;23;626466052;2095;182;2854;2863;8.47;0.52;217.92;3.76;759;23;957.00;9
2101;23;626466061;2101;178;2855;2864;8.41;0.51;217.88;3.75;754;23;958.00;9
2104;23;626466071;2104;179;2855;2864;8.42;0.51;217.77;3.75;751;23;959.00;9
2108;23;626466081;2108;184;2871;2890;8.32;0.51;217.49;3.73;763;23;960.00;19
2110;23;626466092;2110;181;2871;2890;8.30;0.51;217.62;3.73;761;23;961.00;19
2114;23;626466101;2114;186;2873;2890;8.36;0.51;217.39;3.73;759;23;962.00;17
2115;23;626466111;2115;186;2875;2891;8.49;0.52;217.31;3.73;760;23;963.00;16
2116;23;626466120;2116;189;2875;2891;8.54;0.52;217.32;3.73;759;23;964.00;16
2121;23;626466129;2121;193;2877;2895;8.64;0.53;217.08;3.73;756;23;965.00;18
2123;23;626466138;2123;197;2879;2895;8.68;0.53;217.04;3.73;756;23;966.00;16
2124;23;626466147;2124;204;2882;2899;8.70;0.53;216.95;3.73;758;23;967.00;17
2124;23;626466156;2124;202;2882;2899;8.74;0.53;216.95;3.73;758;23;968.00;17
2126;23;626466165;2126;202;2882;2899;8.80;0.54;217.19;3.73;756;23;969.00;17
2129;23;626466174;2129;203;2884;2899;8.73;0.53;217.18;3.75;755;23;970.00;15
2133;23;626466183;2133;205;2885;2899;8.69;0.53;217.08;3.76;752;23;971.00;14
2134;23;626466192;2134;207;2897;2911;8.72;0.53;217.04;3.77;763;23;972.00;14
2135;23;626466202;2135;214;2898;2911;8.68;0.53;217.07;3.76;763;23;973.00;13
2137;23;626466212;2137;215;2898;2911;8.66;0.53;216.94;3.76;761;23;974.00;13
2137;23;626466221;2137;227;2900;2911;8.68;0.53;216.94;3.77;763;23;975.00;11
2138;23;626466230;2138;233;2900;2911;8.67;0.53;216.95;3.77;762;23;976.00;11
2138;23;626466240;2138;242;2900;2911;8.65;0.53;216.95;3.77;762;23;977.00;11
2139;23;626466249;2139;246;2900;2912;8.56;0.52;217.01;3.77;761;23;978.00;12
2141;23;626466258;2141;237;2901;2912;8.54;0.52;217.04;3.78;760;23;979.00;11
2144;23;626466269;2144;233;2907;2918;8.55;0.52;217.03;3.80;763;23;980.00;11
2144;23;626466279;2144;233;2910;2919;8.55;0.52;217.03;3.80;766;23;981.00;9
2147;23;626466288;2147;230;2911;2919;8.60;0.52;216.96;3.81;764;23;982.00;8
2148;23;626466298;2148;228;2912;2919;8.67;0.53;216.86;3.82;764;23;983.00;7
2150;23;626466308;2150;228;2916;2923;8.78;0.54;216.79;3.83;766;23;984.00;7
2152;24;626466318;2152;228;2916;2923;8.83;0.54;216.77;3.83;764;24;985.00;7
2155;24;626466344;2155;227;2917;2923;8.89;0.54;216.68;3.83;762;24;986.00;6
2157;25;626466355;2157;226;2919;2924;8.94;0.54;216.67;3.84;762;25;987.00;5
2159;25;626466380;2159;219;2922;2928;8.94;0.54;216.54;3.84;763;25;988.00;6
2160;25;626466390;2160;215;2924;2928;9.01;0.55;216.56;3.85;764;25;989.00;4
2162;25;626466402;2162;216;2927;2934;9.04;0.55;216.56;3.85;765;25;990.00;7
2163;25;626466417;2163;220;2929;2934;9.08;0.55;216.55;3.85;766;25;991.00;5
2164;25;626466426;2164;220;2929;2934;9.10;0.55;216.62;3.85;765;25;992.00;5
2165;25;626466441;2165;221;2931;2934;9.08;0.55;216.65;3.85;766;25;993.00;3
2165;25;626466450;2165;224;2935;2938;9.04;0.55;216.65;3.86;770;25;994.00;3
2167;25;626466460;2167;227;2935;2938;8.98;0.55;216.62;3.86;768;25;995.00;3
2167;25;626466470;2167;232;2937;2938;8.91;0.55;216.62;3.86;770;25;996.00;1
2167;25;626466479;2167;234;2937;2938;8.90;0.55;216.62;3.86;770;25;997.00;1
2170;25;626466489;2170;238;2939;2939;8.83;0.54;216.66;3.86;769;25;998.00;0
2170;25;626466499;2170;233;2940;2940;8.82;0.54;216.66;3.85;770;25;999.00;0
2173;25;626466508;2173;231;2940;2940;8.75;0.54;216.64;3.85;767;25;1000.00;0
2176;25;626466522;2176;236;2941;2941;8.70;0.53;216.78;3.85;765;25;1001.00;0
2177;25;626466531;2177;238;2941;2941;8.68;0.53;216.70;3.85;764;25;1002.00;0
2179;25;626466540;2179;236;2941;2941;8.63;0.53;216.77;3.85;762;25;1003.00;0
2184;25;626466549;2184;229;2941;2941;8.56;0.52;216.82;3.85;757;25;1004.00;0
2187;25;626466558;2187;230;2941;2941;8.52;0.52;216.93;3.85;754;25;1005.00;0
2189;25;626466568;2189;231;2941;2941;8.56;0.52;216.95;3.85;752;25;1006.00;0
2191;25;626466577;2191;230;2941;2941;8.62;0.53;217.11;3.85;750;25;1007.00;0
2193;25;626466586;2193;256;3019;3068;8.77;0.55;217.24;3.76;826;25;1008.00;49
2198;25;626466604;2198;246;3023;3069;8.74;0.54;217.47;3.75;825;25;1009.00;46
2199;25;626466614;2199;247;3030;3069;8.82;0.55;217.50;3.75;831;25;1010.00;39
2205;25;626466624;2205;246;3035;3069;8.74;0.54;217.74;3.75;830;25;1011.00;34
2210;25;626466633;2210;246;3040;3069;8.62;0.53;217.78;3.75;830;25;1012.00;29
2211;25;626466643;2211;247;3044;3069;8.60;0.53;217.89;3.75;833;25;1013.00;25
2215;25;626466652;2215;245;3048;3069;8.58;0.53;217.98;3.75;833;25;1014.00;21
2219;25;626466662;2219;251;3051;3069;8.61;0.53;218.09;3.75;832;25;1015.00;18
2224;25;626466672;2224;260;3055;3070;8.60;0.53;218.30;3.76;831;25;1016.00;15
2230;25;626466686;2230;260;3057;3071;8.51;0.52;218.30;3.76;827;25;1017.00;14
2234;25;626466697;2234;263;3061;3071;8.45;0.52;218.55;3.77;827;25;1018.00;10
2238;25;626466707;2238;266;3062;3072;8.35;0.51;218.44;3.77;824;25;1019.00;10
2242;25;626466718;2242;261;3064;3072;8.30;0.51;218.80;3.77;822;25;1020.00;8
2246;25;626466729;2246;254;3065;3072;8.25;0.51;219.05;3.78;819;25;1021.00;7
2248;25;626466739;2248;246;3066;3072;8.26;0.51;219.26;3.78;818;25;1022.00;6
2253;25;626466750;2253;238;3069;3076;8.20;0.50;219.75;3.78;816;25;1023.00;7
2257;25;626466761;2257;238;3071;3076;8.18;0.50;220.09;3.79;814;25;1024.00;5
2261;25;626466772;2261;243;3072;3076;8.17;0.50;220.18;3.79;811;25;1025.00;4
2263;25;626466783;2263;243;3074;3079;8.23;0.50;220.46;3.79;811;25;1026.00;5
2267;25;626466795;2267;234;3076;3079;8.27;0.51;220.83;3.80;809;25;1027.00;3
2273;25;626466806;2273;230;3077;3079;8.32;0.51;221.17;3.80;804;25;1028.00;2
2275;25;626466817;2275;226;3081;3083;8.40;0.51;221.39;3.80;806;25;1029.00;2
2280;25;626466829;2280;223;3083;3084;8.50;0.52;221.72;3.80;803;25;1030.00;1
2285;25;626466840;2285;224;3083;3084;8.54;0.52;221.74;3.80;798;25;1031.00;1
2287;25;626466851;2287;222;3088;3088;8.57;0.53;221.95;3.79;801;25;1032.00;0
2289;25;626466862;2289;210;3088;3088;8.61;0.53;222.25;3.79;799;25;1033.00;0
2293;25;626466873;2293;209;3088;3088;8.63;0.53;222.42;3.79;795;25;1034.00;0
2299;25;626466884;2299;209;3090;3090;8.65;0.53;222.47;3.79;791;25;1035.00;0
2301;25;626466896;2301;213;3090;3090;8.72;0.54;222.66;3.79;789;25;1036.00;0
2304;25;626466908;2304;215;3095;3096;8.86;0.54;222.66;3.79;791;25;1037.00;1
2307;25;626466919;2307;215;3095;3096;8.96;0.55;222.74;3.79;788;25;1038.00;1
2312;25;626466931;2312;214;3097;3097;9.01;0.55;222.97;3.78;785;25;1039.00;0
2316;25;626466942;2316;203;3097;3097;9.02;0.55;223.12;3.78;781;25;1040.00;0
2320;25;626466954;2320;201;3097;3097;9.02;0.55;223.11;3.78;777;25;1041.00;0
2327;25;626466972;2327;192;3097;3097;9.02;0.55;223.22;3.78;770;25;1042.00;0
2333;25;626466989;2333;190;3097;3097;9.06;0.55;223.44;3.78;764;25;1043.00;0
2336;25;626467006;2336;187;3108;3109;9.20;0.56;223.43;3.77;772;25;1044.00;1
2341;25;626467026;2341;183;3109;3109;9.21;0.56;223.60;3.77;768;25;1045.00;0
2347;25;626467044;2347;178;3109;3109;9.22;0.56;223.74;3.77;762;25;1046.00;0
2351;25;626467062;2351;177;3109;3109;9.26;0.56;223.67;3.77;758;25;1047.00;0
2358;25;626467079;2358;179;3109;3109;9.27;0.57;223.84;3.77;751;25;1048.00;0
2365;25;626467096;2365;181;3109;3109;9.26;0.56;224.02;3.77;744;25;1049.00;0
2368;25;626467115;2368;183;3115;3115;9.28;0.56;224.12;3.76;747;25;1050.00;0
2371;25;626467128;2371;181;3115;3115;9.30;0.57;224.10;3.76;744;25;1051.00;0
2375;25;626467141;2375;183;3118;3119;9.38;0.57;224.14;3.76;743;25;1052.00;1
2378;25;626467154;2378;187;3120;3120;9.48;0.58;224.37;3.76;742;25;1053.00;0
2382;25;626467167;2382;183;3120;3120;9.57;0.58;224.33;3.76;738;25;1054.00;0
2384;25;626467181;2384;179;3120;3120;9.64;0.59;224.34;3.76;736;25;1055.00;0
2387;25;626467193;2387;182;3133;3133;9.65;0.59;224.46;3.74;746;25;1056.00;0
2393;25;626467205;2393;182;3133;3133;9.66;0.59;224.52;3.74;740;25;1057.00;0
2397;25;626467217;2397;185;3133;3133;9.61;0.59;224.39;3.74;736;25;1058.00;0
2401;25;626467236;2401;180;3134;3134;9.60;0.59;224.46;3.74;733;25;1059.00;0
2404;25;626467249;2404;185;3135;3135;9.55;0.58;224.49;3.74;731;25;1060.00;0
2407;25;626467260;2407;189;3135;3135;9.54;0.58;224.64;3.74;728;25;1061.00;0
2412;25;626467272;2412;195;3137;3138;9.52;0.58;224.85;3.74;725;25;1062.00;1
2413;25;626467283;2413;196;3137;3138;9.52;0.58;224.90;3.74;724;25;1063.00;1
2415;25;626467295;2415;205;3138;3138;9.48;0.58;224.98;3.74;723;25;1064.00;0
2418;25;626467305;2418;209;3138;3138;9.43;0.57;225.12;3.74;720;25;1065.00;0
2423;25;626467316;2423;218;3143;3144;9.40;0.57;225.44;3.73;720;25;1066.00;1
2426;25;626467328;2426;210;3143;3144;9.39;0.57;225.53;3.73;717;25;1067.00;1
2432;25;626467340;2432;208;3144;3144;9.37;0.57;225.66;3.73;712;25;1068.00;0
2435;25;626467351;2435;211;3144;3144;9.34;0.57;225.65;3.73;709;25;1069.00;0
2435;25;626467368;2435;211;3148;3148;9.28;0.57;225.65;3.73;713;25;1070.00;0
2438;25;626467379;2438;205;3149;3149;9.24;0.56;225.98;3.73;711;25;1071.00;0
2441;25;626467390;2441;210;3149;3149;9.21;0.56;225.93;3.73;708;25;1072.00;0
2446;25;626467401;2446;211;3150;3150;9.15;0.56;226.11;3.73;704;25;1073.00;0
2449;25;626467411;2449;212;3150;3150;9.17;0.56;226.16;3.73;701;25;1074.00;0
2453;25;626467422;2453;217;3150;3150;9.16;0.56;225.96;3.73;697;25;1075.00;0
2455;25;626467432;2455;200;3150;3150;9.14;0.56;226.15;3.73;695;25;1076.00;0
2458;25;626467449;2458;195;3150;3150;9.14;0.56;226.15;3.73;692;25;1077.00;0
2461;25;626467460;2461;183;3150;3150;9.18;0.56;226.16;3.73;689;25;1078.00;0
2465;25;626467476;2465;184;3150;3150;9.19;0.56;226.17;3.73;685;25;1079.00;0
2467;25;626467489;2467;202;3230;3275;9.01;0.55;226.23;3.64;763;25;1080.00;45
2468;25;626467522;2468;193;3232;3276;9.04;0.55;226.23;3.63;764;25;1081.00;44
2471;25;626467535;2471;184;3238;3276;9.12;0.56;226.31;3.63;767;25;1082.00;38
2472;25;626467548;2472;180;3243;3276;9.24;0.57;226.33;3.63;771;25;1083.00;33
2474;25;626467561;2474;179;3247;3276;9.27;0.57;226.35;3.63;773;25;1084.00;29
2477;25;626467580;2477;181;3251;3276;9.28;0.57;226.34;3.63;774;25;1085.00;25
2479;25;626467592;2479;179;3254;3276;9.29;0.57;226.30;3.64;775;25;1086.00;22
2480;25;626467605;2480;177;3254;3276;9.27;0.57;226.30;3.64;774;25;1087.00;22
2483;25;626467618;2483;171;3257;3277;9.24;0.57;226.35;3.64;774;25;1088.00;20
2483;25;626467630;2483;174;3259;3278;9.19;0.56;226.35;3.64;776;25;1089.00;19
2485;25;626467651;2485;171;3261;3278;9.16;0.56;226.32;3.64;776;25;1090.00;17
2485;25;626467664;2485;177;3266;3282;9.06;0.56;226.32;3.64;781;25;1091.00;16
2486;25;626467677;2486;182;3268;3282;8.98;0.55;226.43;3.65;782;25;1092.00;14
2488;25;626467688;2488;184;3269;3282;8.88;0.54;226.43;3.65;781;25;1093.00;13
2491;25;626467704;2491;191;3269;3282;8.82;0.54;226.47;3.65;778;25;1094.00;13
2493;25;626467715;2493;196;3275;3288;8.79;0.54;226.40;3.65;782;25;1095.00;13
2497;25;626467726;2497;201;3275;3288;8.73;0.54;226.46;3.65;778;25;1096.00;13
2502;25;626467737;2502;207;3275;3288;8.76;0.54;226.38;3.65;773;25;1097.00;13
2504;25;626467747;2504;221;3278;3291;8.80;0.54;226.41;3.64;774;25;1098.00;13
2506;25;626467767;2506;219;3278;3291;8.84;0.54;226.40;3.64;772;25;1099.00;13
2506;25;626467782;2506;228;3278;3291;8.90;0.55;226.40;3.64;772;25;1100.00;13
2512;25;626467800;2512;230;3279;3292;8.83;0.54;226.29;3.64;767;25;1101.00;13
2512;25;626467811;2512;234;3280;3293;8.85;0.54;226.29;3.64;768;25;1102.00;13
2512;25;626467821;2512;229;3280;3293;8.83;0.54;226.29;3.64;768;25;1103.00;13
2513;25;626467831;2513;238;3290;3306;8.81;0.54;226.23;3.63;777;25;1104.00;16
2515;25;626467842;2515;238;3290;3306;8.80;0.54;226.11;3.63;775;25;1105.00;16
2517;25;626467853;2517;244;3290;3306;8.83;0.54;226.08;3.63;773;25;1106.00;16
2519;25;626467863;2519;250;3291;3307;8.86;0.54;225.96;3.63;772;25;1107.00;16
2521;25;626467873;2521;254;3291;3307;8.86;0.54;225.89;3.63;770;25;1108.00;16
2523;25;626467882;2523;255;3294;3311;8.87;0.54;225.85;3.63;771;25;1109.00;17
2527;25;626467895;2527;252;3294;3311;8.84;0.54;225.82;3.63;767;25;1110.00;17
2531;25;626467904;2531;252;3298;3315;8.83;0.54;225.76;3.63;767;25;1111.00;17
2532;25;626467921;2532;252;3299;3315;8.82;0.54;225.72;3.63;767;25;1112.00;16
2532;25;626467931;2532;247;3299;3315;8.89;0.54;225.72;3.63;767;25;1113.00;16
2535;25;626467941;2535;240;3299;3315;8.88;0.54;225.56;3.63;764;25;1114.00;16
2537;25;626467951;2537;236;3299;3315;8.79;0.54;225.66;3.63;762;25;1115.00;16
2541;25;626467961;2541;236;3309;3327;8.80;0.54;225.65;3.62;768;25;1116.00;18
2541;25;626467972;2541;239;3310;3327;8.78;0.54;225.65;3.63;769;25;1117.00;17
2542;25;626467982;2542;236;3311;3327;8.77;0.54;225.73;3.63;769;25;1118.00;16
2544;25;626467991;2544;235;3311;3327;8.74;0.54;225.78;3.63;767;25;1119.00;16
2547;25;626468001;2547;233;3311;3327;8.65;0.53;225.71;3.63;764;25;1120.00;16
2550;25;626468017;2550;230;3312;3327;8.58;0.53;225.72;3.64;762;25;1121.00;15
2557;25;626468027;2557;226;3312;3328;8.48;0.52;225.67;3.64;755;25;1122.00;16
2561;25;626468036;2561;226;3313;3328;8.46;0.52;225.85;3.66;752;25;1123.00;15
2565;25;626468046;2565;223;3317;3334;8.38;0.51;225.80;3.65;752;25;1124.00;17
2569;25;626468055;2569;220;3321;3336;8.26;0.50;225.93;3.67;752;25;1125.00;15
2571;25;626468065;2571;219;3323;3336;8.29;0.50;225.87;3.68;752;25;1126.00;13
2576;25;626468073;2576;224;3323;3336;8.27;0.50;225.84;3.68;747;25;1127.00;13
2578;25;626468082;2578;221;3325;3340;8.33;0.51;225.75;3.68;747;25;1128.00;15
2579;25;626468090;2579;224;3326;3340;8.38;0.51;225.69;3.69;747;25;1129.00;14
2581;25;626468099;2581;228;3326;3340;8.41;0.51;225.67;3.69;745;25;1130.00;14
2582;25;626468107;2582;213;3328;3341;8.50;0.52;225.60;3.71;746;25;1131.00;13
2584;25;626468116;2584;202;3331;3345;8.54;0.52;225.53;3.70;747;25;1132.00;14
2588;25;626468125;2588;193;3332;3345;8.60;0.52;225.74;3.72;744;25;1133.00;13
2589;25;626468135;2589;188;3334;3348;8.81;0.53;225.73;3.72;745;25;1134.00;14
2590;25;626468144;2590;179;3336;3348;8.98;0.54;225.80;3.73;746;25;1135.00;12
2593;25;626468153;2593;172;3336;3348;9.05;0.55;225.67;3.73;743;25;1136.00;12
2594;25;626468163;2594;166;3336;3348;9.15;0.55;225.66;3.73;742;25;1137.00;12
2594;25;626468172;2594;161;3340;3352;9.28;0.56;225.66;3.74;746;25;1138.00;12
2595;25;626468186;2595;155;3340;3352;9.40;0.57;225.59;3.74;745;25;1139.00;12
2595;25;626468197;2595;153;3342;3352;9.53;0.58;225.59;3.75;747;25;1140.00;10
2595;25;626468207;2595;143;3342;3352;9.68;0.59;225.59;3.75;747;25;1141.00;10
2596;25;626468216;2596;148;3342;3353;9.81;0.59;225.54;3.75;746;25;1142.00;11
2596;25;626468226;2596;148;3343;3354;9.91;0.60;225.54;3.75;747;25;1143.00;11
2597;25;626468236;2597;146;3344;3354;9.96;0.60;225.54;3.76;747;25;1144.00;10
2598;25;626468245;2598;145;3345;3355;9.98;0.61;225.55;3.76;747;25;1145.00;10
2599;25;626468256;2599;149;3345;3355;9.99;0.61;225.54;3.76;746;25;1146.00;10
2600;25;626468266;2600;152;3345;3355;9.98;0.61;225.50;3.76;745;25;1147.00;10
2600;25;626468275;2600;155;3345;3355;10.00;0.61;225.50;3.76;745;25;1148.00;10
2602;25;626468291;2602;156;3345;3355;9.95;0.60;225.41;3.76;743;25;1149.00;10
2606;25;626468301;2606;158;3347;3355;9.82;0.59;225.33;3.79;741;25;1150.00;8
2607;25;626468310;2607;161;3347;3355;9.78;0.59;225.40;3.79;740;25;1151.00;8
2609;25;626468320;2609;182;3416;3482;9.76;0.60;225.54;3.71;807;25;1152.00;66
2610;25;626468340;2610;172;3424;3483;9.74;0.60;225.59;3.73;814;25;1153.00;59
2612;25;626468351;2612;167;3432;3483;9.84;0.61;225.78;3.73;820;25;1154.00;51
2615;25;626468361;2615;166;3439;3483;9.89;0.61;225.90;3.75;824;25;1155.00;44
2619;25;626468371;2619;166;3446;3483;9.89;0.61;226.39;3.76;827;25;1156.00;37
2621;25;626468382;2621;168;3449;3483;9.95;0.61;226.30;3.77;828;25;1157.00;34
2626;25;626468393;2626;170;3455;3483;9.94;0.61;226.25;3.78;829;25;1158.00;28
2628;25;626468408;2628;168;3460;3483;9.89;0.61;226.40;3.78;832;25;1159.00;23
2632;25;626468424;2632;172;3464;3484;9.83;0.60;226.41;3.78;832;25;1160.00;20
2633;25;626468439;2633;179;3468;3485;9.78;0.60;226.33;3.79;835;25;1161.00;17
2637;25;626468450;2637;184;3469;3485;9.69;0.59;226.32;3.79;832;25;1162.00;16
2638;25;626468461;2638;193;3472;3486;9.60;0.59;226.41;3.80;834;25;1163.00;14
2641;25;626468472;2641;195;3474;3486;9.44;0.58;226.46;3.81;833;25;1164.00;12
2644;25;626468490;2644;209;3476;3486;9.28;0.57;226.48;3.81;832;25;1165.00;10
2646;25;626468500;2646;212;3478;3486;9.16;0.56;226.73;3.82;832;25;1166.00;8
2649;25;626468510;2649;222;3482;3490;9.07;0.56;226.78;3.82;833;25;1167.00;8
2654;25;626468520;2654;225;3484;3490;8.88;0.54;226.78;3.83;830;25;1168.00;6
2656;25;626468531;2656;229;3485;3490;8.71;0.53;226.85;3.83;829;25;1169.00;5
2659;25;626468543;2659;228;3489;3496;8.63;0.53;226.91;3.83;830;25;1170.00;7
2661;25;626468554;2661;230;3491;3496;8.53;0.52;227.11;3.84;830;25;1171.00;5
2664;25;626468564;2664;233;3492;3496;8.54;0.52;227.20;3.84;828;25;1172.00;4
2666;25;626468574;2666;244;3496;3500;8.47;0.52;227.32;3.83;830;25;1173.00;4
2669;25;626468584;2669;245;3498;3501;8.47;0.52;227.39;3.83;829;25;1174.00;3
2672;25;626468595;2672;247;3498;3501;8.48;0.52;227.66;3.83;826;25;1175.00;3
2673;25;626468605;2673;251;3503;3505;8.53;0.52;227.67;3.83;830;25;1176.00;2
2676;25;626468615;2676;254;3503;3505;8.57;0.52;227.75;3.83;827;25;1177.00;2
2678;25;626468626;2678;252;3504;3505;8.61;0.53;228.00;3.83;826;25;1178.00;1
2679;25;626468636;2679;252;3505;3506;8.63;0.53;228.00;3.83;826;25;1179.00;1
2681;25;626468653;2681;249;3506;3506;8.61;0.53;228.18;3.83;825;25;1180.00;0
2685;25;626468669;2685;251;3510;3512;8.57;0.52;228.19;3.83;825;25;1181.00;2
2688;25;626468680;2688;254;3511;3512;8.46;0.52;228.29;3.83;823;25;1182.00;1
2692;25;626468690;2692;254;3512;3513;8.36;0.51;228.51;3.83;820;25;1183.00;1
2696;25;626468700;2696;252;3513;3513;8.26;0.50;228.61;3.83;817;25;1184.00;0
2698;25;626468719;2698;251;3513;3513;8.25;0.51;228.63;3.83;815;25;1185.00;0
2703;25;626468738;2703;256;3513;3513;8.16;0.50;228.72;3.83;810;25;1186.00;0
2705;25;626468748;2705;259;3513;3513;8.13;0.50;228.76;3.83;808;25;1187.00;0
2711;25;626468764;2711;258;3524;3525;8.09;0.49;229.13;3.82;813;25;1188.00;1
2714;25;626468774;2714;261;3525;3525;8.03;0.49;229.37;3.81;811;25;1189.00;0
2716;25;626468784;2716;245;3525;3525;8.03;0.49;229.38;3.81;809;25;1190.00;0
2723;25;626468794;2723;240;3525;3525;7.90;0.48;229.66;3.81;802;25;1191.00;0
2728;25;626468803;2728;240;3525;3525;7.88;0.48;229.78;3.81;797;25;1192.00;0
2731;25;626468813;2731;239;3525;3525;7.95;0.49;229.92;3.81;794;25;1193.00;0
2735;25;626468823;2735;245;3529;3529;7.97;0.49;230.04;3.81;794;25;1194.00;0
2740;25;626468833;2740;245;3529;3529;7.99;0.49;230.15;3.81;789;25;1195.00;0
2743;25;626468844;2743;241;3532;3533;8.11;0.49;230.28;3.81;789;25;1196.00;1
2746;25;626468854;2746;238;3534;3534;8.20;0.50;230.41;3.81;788;25;1197.00;0
2750;25;626468865;2750;227;3534;3534;8.17;0.50;230.43;3.81;784;25;1198.00;0
2751;25;626468875;2751;216;3534;3534;8.24;0.50;230.52;3.81;783;25;1199.00;0
2757;25;626468887;2757;215;3556;3575;8.24;0.50;230.64;3.78;799;25;1200.00;19
2760;25;626468906;2760;214;3557;3575;8.28;0.51;230.66;3.78;797;25;1201.00;18
2763;25;626468916;2763;209;3560;3575;8.33;0.51;230.69;3.78;797;25;1202.00;15
2769;25;626468927;2769;203;3562;3576;8.49;0.52;230.83;3.78;793;25;1203.00;14
2769;25;626468938;2769;210;3566;3577;8.59;0.53;230.83;3.78;797;25;1204.00;11
2772;25;626468948;2772;202;3566;3577;8.69;0.53;230.99;3.78;794;25;1205.00;11
2778;25;626468958;2778;208;3570;3580;8.78;0.54;231.19;3.78;792;25;1206.00;10
2783;25;626468969;2783;210;3571;3580;8.83;0.54;231.12;3.78;788;25;1207.00;9
2787;25;626468979;2787;205;3572;3580;8.83;0.54;231.26;3.78;785;25;1208.00;8
2792;25;626468990;2792;201;3572;3580;8.83;0.54;231.32;3.78;780;25;1209.00;8
2796;25;626469003;2796;197;3576;3586;8.88;0.54;231.36;3.78;780;25;1210.00;10
2801;25;626469020;2801;197;3579;3586;8.91;0.55;231.31;3.78;778;25;1211.00;7
2807;25;626469039;2807;188;3580;3586;8.99;0.55;231.30;3.78;773;25;1212.00;6
2813;25;626469067;2813;186;3580;3586;9.03;0.55;231.17;3.78;767;25;1213.00;6
2820;25;626469083;2820;181;3584;3590;9.06;0.55;231.29;3.78;764;25;1214.00;6
2823;25;626469100;2823;179;3586;3592;9.14;0.56;231.23;3.77;763;25;1215.00;6
2825;25;626469116;2825;181;3587;3592;9.10;0.56;231.34;3.78;762;25;1216.00;5
2829;25;626469130;2829;185;3589;3593;9.12;0.56;231.34;3.78;760;25;1217.00;4
2833;25;626469143;2833;182;3589;3593;9.10;0.56;231.71;3.78;756;25;1218.00;4
2840;25;626469155;2840;183;3589;3593;9.10;0.56;232.09;3.78;749;25;1219.00;4
2846;25;626469169;2846;185;3589;3593;9.08;0.55;232.17;3.78;743;25;1220.00;4
2855;25;626469181;2855;191;3589;3593;9.05;0.55;232.22;3.78;734;25;1221.00;4
2862;25;626469194;2862;195;3589;3593;9.02;0.55;232.49;3.78;727;25;1222.00;4
2865;25;626469206;2865;202;3590;3593;8.92;0.54;232.54;3.79;725;25;1223.00;3
2871;25;626469217;2871;216;3630;3663;8.74;0.53;232.75;3.74;759;25;1224.00;33
2874;25;626469235;2874;220;3631;3664;8.76;0.53;232.81;3.74;757;25;1225.00;33
2879;25;626469246;2879;213;3634;3664;8.81;0.54;233.11;3.74;755;25;1226.00;30
2882;25;626469259;2882;213;3635;3664;8.82;0.54;233.11;3.74;753;25;1227.00;29
2887;25;626469277;2887;223;3639;3666;8.86;0.54;233.21;3.75;752;25;1228.00;27
2891;25;626469289;2891;230;3640;3666;8.87;0.54;233.47;3.76;749;25;1229.00;26
2893;25;626469301;2893;234;3646;3666;8.90;0.54;233.58;3.76;753;25;1230.00;20
2894;25;626469312;2894;236;3646;3666;8.85;0.54;233.64;3.76;752;25;1231.00;20
2897;25;626469323;2897;242;3650;3667;8.74;0.53;233.66;3.76;753;25;1232.00;17
2900;25;626469334;2900;251;3655;3668;8.68;0.53;233.69;3.77;755;25;1233.00;13
2903;25;626469345;2903;254;3658;3668;8.57;0.52;233.87;3.77;755;25;1234.00;10
2904;26;626469356;2904;270;3667;3672;8.41;0.52;233.82;3.79;763;26;1235.00;5
2905;26;626469380;2905;275;3670;3672;8.34;0.51;233.86;3.79;765;26;1236.00;2
2911;26;626469397;2911;267;3671;3672;8.33;0.51;233.98;3.79;760;26;1237.00;1
2915;26;626469409;2915;268;3671;3672;8.34;0.51;233.93;3.79;756;26;1238.00;1
2919;26;626469421;2919;262;3676;3678;8.34;0.51;233.87;3.79;757;26;1239.00;2
2921;26;626469433;2921;264;3676;3678;8.42;0.52;233.80;3.79;755;26;1240.00;2
2924;26;626469444;2924;260;3678;3678;8.45;0.52;233.79;3.79;754;26;1241.00;0
2926;26;626469455;2926;258;3680;3681;8.54;0.52;233.79;3.79;754;26;1242.00;1
2930;26;626469468;2930;260;3681;3681;8.61;0.53;233.75;3.79;751;26;1243.00;0
2931;26;626469481;2931;259;3681;3681;8.61;0.53;233.80;3.79;750;26;1244.00;0
2934;26;626469499;2934;260;3682;3682;8.62;0.53;233.77;3.79;748;26;1245.00;0
2937;26;626469510;2937;248;3683;3683;8.65;0.53;233.75;3.79;746;26;1246.00;0
2940;26;626469522;2940;236;3683;3683;8.69;0.53;233.67;3.79;743;26;1247.00;0
2941;26;626469533;2941;231;3695;3696;8.79;0.54;233.62;3.78;754;26;1248.00;1
2942;26;626469545;2942;224;3696;3696;8.81;0.54;233.59;3.78;754;26;1249.00;0
2946;26;626469563;2946;219;3696;3696;8.79;0.54;233.52;3.78;750;26;1250.00;0
2946;26;626469574;2946;219;3697;3697;8.78;0.54;233.52;3.77;751;26;1251.00;0
2949;26;626469586;2949;221;3697;3697;8.72;0.53;233.63;3.77;748;26;1252.00;0
2951;26;626469597;2951;222;3700;3701;8.70;0.53;233.73;3.77;749;26;1253.00;1
2952;26;626469608;2952;224;3700;3701;8.70;0.53;233.76;3.77;748;26;1254.00;1
2954;26;626469619;2954;227;3705;3705;8.67;0.53;233.67;3.77;751;26;1255.00;0
2956;26;626469630;2956;225;3705;3705;8.64;0.53;233.64;3.77;749;26;1256.00;0
2957;26;626469642;2957;220;3705;3705;8.65;0.53;233.67;3.77;748;26;1257.00;0
2962;26;626469653;2962;224;3705;3705;8.66;0.53;233.78;3.77;743;26;1258.00;0
2966;26;626469664;2966;227;3705;3705;8.69;0.53;233.81;3.77;739;26;1259.00;0
2969;26;626469676;2969;229;3728;3739;8.71;0.54;233.75;3.75;759;26;1260.00;11
2970;26;626469689;2970;226;3728;3739;8.70;0.53;233.73;3.75;758;26;1261.00;11
2974;26;626469699;2974;226;3730;3739;8.72;0.54;233.64;3.74;756;26;1262.00;9
2976;26;626469711;2976;232;3730;3739;8.69;0.53;233.57;3.74;754;26;1263.00;9
2976;26;626469722;2976;234;3732;3739;8.77;0.54;233.57;3.74;756;26;1264.00;7
2979;26;626469740;2979;237;3732;3739;8.81;0.54;233.55;3.74;753;26;1265.00;7
2980;26;626469750;2980;242;3733;3740;8.82;0.54;233.48;3.75;753;26;1266.00;7
2981;26;626469760;2981;243;3734;3740;8.79;0.54;233.44;3.75;753;26;1267.00;6
2985;26;626469769;2985;246;3738;3746;8.74;0.53;233.38;3.75;753;26;1268.00;8
2987;26;626469788;2987;252;3740;3747;8.73;0.53;233.42;3.74;753;26;1269.00;7
2990;26;626469798;2990;253;3741;3747;8.63;0.53;233.29;3.75;751;26;1270.00;6
2993;26;626469814;2993;260;3742;3747;8.53;0.52;233.18;3.75;749;26;1271.00;5
2995;26;626469824;2995;267;3744;3751;8.41;0.51;233.13;3.74;749;26;1272.00;7
2996;26;626469834;2996;271;3745;3751;8.25;0.50;233.14;3.74;749;26;1273.00;6
2999;26;626469850;2999;274;3745;3751;8.15;0.50;233.09;3.74;746;26;1274.00;6
3000;26;626469860;3000;283;3746;3752;8.07;0.49;233.01;3.74;746;26;1275.00;6
3002;26;626469870;3002;289;3749;3756;8.01;0.49;233.02;3.74;747;26;1276.00;7
3002;26;626469880;3002;294;3749;3756;7.98;0.49;233.02;3.74;747;26;1277.00;7
3004;26;626469895;3004;299;3751;3759;7.95;0.48;233.14;3.74;747;26;1278.00;8
3005;26;626469904;3005;304;3751;3759;7.94;0.48;233.09;3.74;746;26;1279.00;8
3007;26;626469914;3007;297;3752;3759;7.87;0.48;233.09;3.74;745;26;1280.00;7
3008;26;626469923;3008;295;3752;3759;7.82;0.47;233.07;3.74;744;26;1281.00;7
3010;26;626469933;3010;293;3755;3763;7.81;0.47;233.08;3.74;745;26;1282.00;8
3011;26;626469943;3011;277;3755;3763;7.80;0.47;233.14;3.74;744;26;1283.00;8
3013;26;626469960;3013;262;3756;3763;7.81;0.48;233.13;3.74;743;26;1284.00;7
3013;26;626469970;3013;250;3756;3763;7.82;0.48;233.13;3.74;743;26;1285.00;7
3016;26;626469979;3016;235;3756;3764;7.90;0.48;233.11;3.74;740;26;1286.00;8
3018;26;626469989;3018;227;3757;3765;7.92;0.48;233.13;3.73;739;26;1287.00;8
3019;26;626469999;3019;220;3757;3765;7.98;0.49;233.12;3.73;738;26;1288.00;8
3021;26;626470009;3021;210;3758;3766;8.12;0.49;233.18;3.73;737;26;1289.00;8
3021;26;626470020;3021;200;3758;3766;8.21;0.50;233.18;3.73;737;26;1290.00;8
3022;26;626470036;3022;196;3758;3766;8.27;0.50;233.18;3.73;736;26;1291.00;8
3023;26;626470045;3023;181;3758;3766;8.35;0.51;233.17;3.73;735;26;1292.00;8
3024;26;626470054;3024;173;3758;3766;8.48;0.52;233.21;3.73;734;26;1293.00;8
3025;26;626470064;3025;171;3759;3766;8.58;0.52;233.22;3.74;734;26;1294.00;7
3028;26;626470073;3028;160;3759;3766;8.70;0.53;233.34;3.74;731;26;1295.00;7
3033;26;626470082;3033;173;3823;3893;8.85;0.54;233.27;3.69;790;26;1296.00;70
3034;26;626470102;3034;164;3824;3894;8.97;0.55;233.26;3.69;790;26;1297.00;70
3039;26;626470112;3039;162;3832;3894;9.14;0.56;233.09;3.68;793;26;1298.00;62
3045;26;626470122;3045;152;3834;3894;9.20;0.57;233.01;3.68;789;26;1299.00;60
3047;26;626470133;3047;146;3838;3894;9.35;0.57;232.96;3.68;791;26;1300.00;56
3048;26;626470147;3048;145;3841;3894;9.48;0.58;232.93;3.68;793;26;1301.00;53
3048;26;626470156;3048;148;3845;3894;9.60;0.59;232.93;3.69;797;26;1302.00;49
3051;26;626470167;3051;143;3847;3894;9.72;0.60;232.95;3.69;796;26;1303.00;47
3052;26;626470177;3052;144;3851;3895;9.86;0.60;233.00;3.69;799;26;1304.00;44
3057;26;626470187;3057;143;3854;3897;9.94;0.61;232.99;3.69;797;26;1305.00;43
3058;26;626470198;3058;141;3858;3897;10.07;0.62;232.95;3.70;800;26;1306.00;39
3062;26;626470209;3062;143;3860;3898;10.07;0.61;233.00;3.71;798;26;1307.00;38
3066;26;626470220;3066;144;3867;3898;10.03;0.61;232.90;3.72;801;26;1308.00;31
3067;26;626470230;3067;141;3869;3898;10.00;0.61;232.96;3.72;802;26;1309.00;29
3071;26;626470240;3071;144;3873;3898;9.86;0.60;232.97;3.73;802;26;1310.00;25
3072;26;626470251;3072;147;3875;3902;9.80;0.60;232.94;3.74;803;26;1311.00;27
3074;26;626470262;3074;150;3877;3902;9.75;0.60;233.05;3.74;803;26;1312.00;25
3078;26;626470273;3078;148;3878;3902;9.70;0.59;233.10;3.74;800;26;1313.00;24
3082;26;626470283;3082;154;3881;3905;9.73;0.59;233.08;3.75;799;26;1314.00;24
3086;26;626470295;3086;159;3882;3905;9.66;0.59;233.13;3.76;796;26;1315.00;23
3087;26;626470306;3087;161;3886;3905;9.63;0.58;233.09;3.77;799;26;1316.00;19
3090;26;626470316;3090;167;3890;3909;9.60;0.58;233.13;3.77;800;26;1317.00;19
3093;26;626470327;3093;172;3892;3910;9.64;0.59;233.32;3.77;799;26;1318.00;18
3095;26;626470338;3095;177;3895;3910;9.60;0.58;233.23;3.80;800;26;1319.00;15
3097;26;626470351;3097;179;3900;3915;9.62;0.58;233.34;3.80;803;26;1320.00;15
3100;26;626470363;3100;180;3900;3915;9.60;0.58;233.38;3.80;800;26;1321.00;15
3103;26;626470374;3103;183;3903;3915;9.53;0.58;233.58;3.83;800;26;1322.00;12
3106;26;626470385;3106;185;3904;3916;9.49;0.57;233.81;3.83;798;26;1323.00;12
3108;26;626470396;3108;189;3905;3916;9.49;0.57;233.90;3.84;797;26;1324.00;11
3110;26;626470407;3110;194;3910;3922;9.47;0.57;234.01;3.84;800;26;1325.00;12
3111;26;626470445;3111;199;3910;3922;9.46;0.57;234.11;3.84;799;26;1326.00;12
3111;26;626470456;3111;199;3912;3923;9.48;0.58;234.11;3.85;801;26;1327.00;11
3113;26;626470467;3113;198;3912;3923;9.47;0.57;234.12;3.85;799;26;1328.00;11
3115;26;626470484;3115;200;3914;3923;9.46;0.58;234.22;3.86;799;26;1329.00;9
3118;26;626470495;3118;202;3915;3923;9.47;0.58;234.36;3.87;797;26;1330.00;8
3121;26;626470506;3121;207;3917;3923;9.44;0.57;234.44;3.88;796;26;1331.00;6
3125;26;626470517;3125;210;3927;3935;9.36;0.57;234.56;3.87;802;26;1332.00;8
3127;26;626470529;3127;209;3928;3935;9.35;0.57;234.49;3.88;801;26;1333.00;7
3129;26;626470539;3129;219;3929;3935;9.30;0.57;234.64;3.88;800;26;1334.00;6
3130;26;626470556;3130;220;3930;3935;9.23;0.56;234.67;3.88;800;26;1335.00;5
3133;26;626470566;3133;221;3931;3935;9.16;0.56;234.83;3.89;798;26;1336.00;4
3136;26;626470577;3136;225;3932;3935;9.09;0.56;234.81;3.89;796;26;1337.00;3
3137;26;626470587;3137;228;3936;3939;8.97;0.55;234.89;3.90;799;26;1338.00;3
3140;26;626470597;3140;226;3937;3939;8.97;0.55;234.95;3.90;797;26;1339.00;2
3141;26;626470607;3141;224;3940;3943;9.02;0.55;235.03;3.90;799;26;1340.00;3
3144;26;626470618;3144;219;3943;3944;8.97;0.55;235.06;3.90;799;26;1341.00;1
3146;27;626470628;3146;215;3944;3944;8.98;0.55;235.17;3.90;798;27;1342.00;0
3149;27;626470655;3149;222;3944;3944;8.92;0.55;235.07;3.90;795;27;1343.00;0
3153;27;626470666;3153;227;3957;3957;8.84;0.54;235.07;3.88;804;27;1344.00;0
3155;27;626470677;3155;227;3957;3957;8.89;0.54;235.09;3.88;802;27;1345.00;0
3158;27;626470687;3158;226;3957;3957;8.83;0.54;235.10;3.88;799;27;1346.00;0
3160;27;626470697;3160;228;3958;3958;8.82;0.54;235.20;3.88;798;27;1347.00;0
3161;27;626470707;3161;228;3959;3959;8.86;0.54;235.36;3.88;798;27;1348.00;0
3166;27;626470718;3166;225;3959;3959;8.82;0.54;235.43;3.88;793;27;1349.00;0
3171;27;626470730;3171;230;3962;3968;8.76;0.53;235.48;3.88;791;27;1350.00;6
3172;27;626470741;3172;237;3963;3968;8.75;0.53;235.61;3.88;791;27;1351.00;5
3176;27;626470751;3176;241;3964;3968;8.67;0.53;235.65;3.88;788;27;1352.00;4
3181;27;626470760;3181;242;3965;3968;8.58;0.52;235.82;3.88;784;27;1353.00;3
3186;27;626470770;3186;243;3970;3974;8.65;0.53;235.92;3.88;784;27;1354.00;4
3189;27;626470780;3189;245;3970;3974;8.55;0.52;236.01;3.88;781;27;1355.00;4
3196;27;626470790;3196;252;3972;3974;8.40;0.51;236.20;3.88;776;27;1356.00;2
3199;27;626470800;3199;251;3972;3974;8.34;0.51;236.43;3.88;773;27;1357.00;2
3204;27;626470809;3204;256;3977;3978;8.26;0.50;236.56;3.87;773;27;1358.00;1
3208;27;626470819;3208;254;3978;3979;8.18;0.50;236.75;3.87;770;27;1359.00;1
3214;27;626470828;3214;239;3978;3979;8.09;0.49;236.79;3.87;764;27;1360.00;1
3219;27;626470838;3219;237;3979;3980;8.05;0.49;237.06;3.87;760;27;1361.00;1
3224;27;626470848;3224;221;3979;3980;8.01;0.49;237.13;3.87;755;27;1362.00;1
3227;27;626470857;3227;219;3979;3980;8.03;0.49;237.28;3.87;752;27;1363.00;1
3231;27;626470867;3231;217;3979;3980;8.08;0.49;237.30;3.87;748;27;1364.00;1
3233;27;626470876;3233;218;3979;3980;8.20;0.50;237.40;3.87;746;27;1365.00;1
3237;27;626470886;3237;215;3979;3980;8.34;0.51;237.57;3.87;742;27;1366.00;1
3240;27;626470895;3240;204;3979;3980;8.49;0.52;237.64;3.87;739;27;1367.00;1
3245;27;626470904;3245;201;4020;4050;8.67;0.53;237.55;3.83;775;27;1368.00;30
3249;27;626470920;3249;194;4025;4051;8.80;0.54;237.61;3.83;776;27;1369.00;26
3253;27;626470931;3253;192;4032;4051;9.04;0.55;237.48;3.82;779;27;1370.00;19
3256;27;626470941;3256;188;4033;4051;9.15;0.56;237.45;3.82;777;27;1371.00;18
3260;27;626470951;3260;184;4037;4051;9.28;0.57;237.62;3.82;777;27;1372.00;14
3263;27;626470962;3263;185;4041;4051;9.39;0.57;237.66;3.83;778;27;1373.00;10
3266;27;626470972;3266;186;4045;4051;9.33;0.57;237.77;3.83;779;27;1374.00;6
3270;27;626470982;3270;185;4048;4051;9.32;0.57;237.72;3.83;778;27;1375.00;3
3276;27;626470993;3276;186;4049;4052;9.21;0.56;237.83;3.83;773;27;1376.00;3
3278;27;626471004;3278;189;4051;4053;9.21;0.56;237.76;3.83;773;27;1377.00;2
3282;27;626471019;3282;198;4051;4053;9.14;0.56;237.79;3.83;769;27;1378.00;2
3286;27;626471037;3286;206;4054;4057;9.04;0.55;237.66;3.83;768;27;1379.00;3
3290;27;626471056;3290;210;4054;4057;8.99;0.55;237.72;3.83;764;27;1380.00;3
3294;27;626471071;3294;208;4054;4057;8.99;0.55;237.83;3.83;760;27;1381.00;3
3300;27;626471087;3300;211;4054;4057;8.93;0.55;237.79;3.83;754;27;1382.00;3
3303;27;626471103;3303;216;4059;4063;8.93;0.55;237.93;3.82;756;27;1383.00;4
3308;27;626471119;3308;224;4060;4063;9.00;0.55;237.83;3.82;752;27;1384.00;3
3311;27;626471130;3311;223;4061;4063;9.02;0.55;237.79;3.82;750;27;1385.00;2
3316;27;626471142;3316;225;4063;4066;8.99;0.55;237.98;3.82;747;27;1386.00;3
3323;27;626471154;3323;224;4063;4066;8.86;0.54;238.04;3.82;740;27;1387.00;3
3327;27;626471167;3327;223;4064;4066;8.84;0.54;237.92;3.82;737;27;1388.00;2
3333;27;626471179;3333;226;4065;4067;8.71;0.53;238.14;3.82;732;27;1389.00;2
3339;27;626471190;3339;234;4068;4068;8.55;0.52;238.27;3.83;729;27;1390.00;0
3343;27;626471201;3343;238;4068;4068;8.43;0.51;238.28;3.83;725;27;1391.00;0
3348;27;626471212;3348;244;4081;4081;8.33;0.51;238.46;3.82;733;27;1392.00;0
3353;27;626471224;3353;248;4081;4081;8.21;0.50;238.60;3.82;728;27;1393.00;0
3354;27;626471235;3354;257;4081;4081;8.21;0.50;238.59;3.82;727;27;1394.00;0
3356;27;626471245;3356;252;4083;4083;8.12;0.50;238.67;3.82;727;27;1395.00;0
3360;27;626471256;3360;259;4083;4083;8.00;0.49;238.73;3.82;723;27;1396.00;0
3362;27;626471268;3362;265;4086;4087;8.00;0.49;238.92;3.82;724;27;1397.00;1
3365;27;626471279;3365;273;4086;4087;7.85;0.48;238.86;3.82;721;27;1398.00;1
3369;27;626471296;3369;285;4090;4091;7.77;0.47;238.88;3.82;721;27;1399.00;1
3372;27;626471307;3372;295;4091;4091;7.64;0.47;238.84;3.82;719;27;1400.00;0
3375;27;626471322;3375;300;4091;4091;7.51;0.46;238.86;3.82;716;27;1401.00;0
3378;27;626471332;3378;306;4091;4091;7.42;0.45;238.89;3.82;713;27;1402.00;0
3381;27;626471342;3381;310;4091;4091;7.34;0.45;238.88;3.82;710;27;1403.00;0
3383;27;626471351;3383;311;4102;4103;7.36;0.45;238.85;3.81;719;27;1404.00;1
3384;27;626471362;3384;318;4102;4103;7.32;0.45;238.92;3.81;718;27;1405.00;1
3390;27;626471372;3390;323;4103;4103;7.18;0.44;238.94;3.81;713;27;1406.00;0
3391;27;626471381;3391;315;4103;4103;7.21;0.44;238.97;3.81;712;27;1407.00;0
3392;27;626471391;3392;313;4103;4103;7.19;0.44;238.97;3.81;711;27;1408.00;0
3393;27;626471400;3393;312;4103;4103;7.18;0.44;238.93;3.81;710;27;1409.00;0
3396;27;626471411;3396;315;4104;4104;7.16;0.44;239.02;3.80;708;27;1410.00;0
3397;27;626471421;3397;318;4104;4104;7.24;0.44;239.05;3.80;707;27;1411.00;0
3403;27;626471430;3403;318;4109;4110;7.19;0.44;238.77;3.80;706;27;1412.00;1
3404;27;626471441;3404;323;4110;4111;7.24;0.44;238.71;3.80;706;27;1413.00;1
3405;27;626471450;3405;319;4111;4111;7.27;0.44;238.74;3.80;706;27;1414.00;0
3406;27;626471459;3406;319;4111;4111;7.29;0.45;238.74;3.80;705;27;1415.00;0
3407;27;626471469;3407;305;4115;4115;7.38;0.45;238.71;3.80;708;27;1416.00;0
3410;27;626471479;3410;298;4115;4115;7.41;0.45;238.66;3.80;705;27;1417.00;0
3412;27;626471490;3412;287;4115;4115;7.47;0.46;238.59;3.80;703;27;1418.00;0
3413;27;626471500;3413;281;4116;4116;7.54;0.46;238.58;3.80;703;27;1419.00;0
3418;27;626471509;3418;276;4120;4120;7.57;0.46;238.49;3.79;702;27;1420.00;0
3421;27;626471519;3421;276;4120;4120;7.67;0.47;238.39;3.79;699;27;1421.00;0
3421;27;626471529;3421;262;4122;4123;7.86;0.48;238.39;3.79;701;27;1422.00;1
3425;28;626471540;3425;263;4122;4123;7.89;0.48;238.37;3.79;697;28;1423.00;1
3426;28;626471562;3426;257;4123;4123;7.96;0.49;238.31;3.79;697;28;1424.00;0
3428;28;626471572;3428;257;4123;4123;8.02;0.49;238.32;3.79;695;28;1425.00;0
3429;28;626471582;3429;263;4126;4127;8.13;0.50;238.33;3.79;697;28;1426.00;1
3430;28;626471592;3430;260;4126;4127;8.12;0.50;238.32;3.79;696;28;1427.00;1
3433;28;626471603;3433;258;4127;4127;8.12;0.50;238.30;3.79;694;28;1428.00;0
3435;28;626471613;3435;253;4127;4127;8.11;0.50;238.25;3.79;692;28;1429.00;0
3437;28;626471624;3437;255;4128;4128;8.05;0.49;238.24;3.79;691;28;1430.00;0
3441;28;626471633;3441;254;4129;4129;8.04;0.49;238.16;3.79;688;28;1431.00;0
3442;28;626471643;3442;256;4129;4129;8.01;0.49;238.19;3.79;687;28;1432.00;0
3443;28;626471652;3443;263;4130;4130;8.00;0.49;238.19;3.79;687;28;1433.00;0
3443;28;626471661;3443;263;4130;4130;7.98;0.49;238.19;3.79;687;28;1434.00;0
3445;28;626471671;3445;257;4130;4130;8.00;0.49;238.14;3.79;685;28;1435.00;0
3448;28;626471687;3448;249;4130;4130;8.03;0.49;238.10;3.79;682;28;1436.00;0
3450;28;626471697;3450;242;4130;4130;8.08;0.49;238.07;3.79;680;28;1437.00;0
3451;28;626471710;3451;233;4130;4130;8.21;0.50;238.03;3.79;679;28;1438.00;0
3454;28;626471719;3454;227;4130;4130;8.27;0.50;237.99;3.79;676;28;1439.00;0
3455;28;626471736;3455;272;4247;4360;8.27;0.52;237.94;3.68;792;28;1440.00;113
3456;28;626471768;3456;256;4250;4361;8.38;0.53;237.95;3.68;794;28;1441.00;111
3458;28;626471779;3458;242;4259;4361;8.55;0.54;238.14;3.68;801;28;1442.00;102
3460;28;626471790;3460;231;4265;4361;8.65;0.54;238.16;3.68;805;28;1443.00;96
3463;28;626471801;3463;228;4273;4361;8.73;0.55;238.14;3.68;810;28;1444.00;88
3465;28;626471811;3465;229;4276;4361;8.81;0.55;238.13;3.68;811;28;1445.00;85
3466;28;626471821;3466;231;4281;4361;8.89;0.55;238.12;3.68;815;28;1446.00;80
3469;28;626471839;3469;231;4286;4361;8.89;0.55;238.00;3.68;817;28;1447.00;75
3469;28;626471849;3469;241;4290;4362;8.88;0.55;238.00;3.69;821;28;1448.00;72
3473;28;626471865;3473;242;4294;4363;8.89;0.55;237.98;3.69;821;28;1449.00;69
3474;28;626471876;3474;244;4299;4363;8.85;0.55;237.96;3.70;825;28;1450.00;64
3476;28;626471887;3476;239;4303;4364;8.76;0.54;237.95;3.71;827;28;1451.00;61
3477;28;626471898;3477;245;4307;4364;8.69;0.54;237.93;3.71;830;28;1452.00;57
3477;28;626471909;3477;246;4310;4364;8.67;0.53;237.93;3.72;833;28;1453.00;54
3479;28;626471920;3479;249;4313;4364;8.61;0.53;237.93;3.73;834;28;1454.00;51
3480;28;626471931;3480;245;4318;4368;8.62;0.53;237.89;3.74;838;28;1455.00;50
3483;28;626471942;3483;242;4322;4368;8.54;0.52;238.01;3.74;839;28;1456.00;46
3485;28;626471953;3485;253;4322;4368;8.55;0.52;237.94;3.74;837;28;1457.00;46
3490;28;626471963;3490;248;4323;4371;8.49;0.52;238.05;3.74;833;28;1458.00;48
3490;28;626471981;3490;242;4323;4371;8.55;0.52;238.05;3.74;833;28;1459.00;48
3494;28;626471992;3494;240;4324;4371;8.63;0.53;238.14;3.75;830;28;1460.00;47
3499;28;626472003;3499;234;4327;4375;8.64;0.53;238.22;3.75;828;28;1461.00;48
3503;28;626472019;3503;219;4330;4376;8.75;0.53;238.27;3.75;827;28;1462.00;46
3508;28;626472031;3508;209;4330;4376;8.78;0.54;238.41;3.75;822;28;1463.00;46
3509;28;626472042;3509;204;4334;4380;8.89;0.54;238.48;3.76;825;28;1464.00;46
3510;28;626472053;3510;203;4335;4380;9.00;0.55;238.57;3.77;825;28;1465.00;45
3514;28;626472063;3514;191;4335;4380;9.04;0.55;238.54;3.77;821;28;1466.00;45
3517;28;626472080;3517;190;4336;4381;9.18;0.56;238.68;3.77;819;28;1467.00;45
3520;28;626472091;3520;181;4339;4381;9.30;0.57;238.63;3.78;819;28;1468.00;42
3522;28;626472107;3522;177;4341;4387;9.38;0.57;238.67;3.78;819;28;1469.00;46
3526;28;626472125;3526;174;4342;4387;9.37;0.57;238.78;3.78;816;28;1470.00;45
3527;29;626472136;3527;166;4343;4388;9.44;0.57;238.74;3.79;816;29;1471.00;45
3532;29;626472152;3532;159;4344;4388;9.45;0.57;238.77;3.79;812;29;1472.00;44
3536;29;626472163;3536;156;4345;4388;9.49;0.57;238.88;3.79;809;29;1473.00;43
3538;29;626472178;3538;151;4346;4388;9.48;0.57;238.96;3.80;808;29;1474.00;42
3539;29;626472189;3539;150;4348;4388;9.51;0.58;239.07;3.80;809;29;1475.00;40
3540;29;626472200;3540;152;4359;4400;9.64;0.58;239.12;3.80;819;29;1476.00;41
3543;29;626472212;3543;152;4360;4400;9.66;0.59;239.23;3.80;817;29;1477.00;40
3545;29;626472223;3545;147;4362;4400;9.71;0.59;239.26;3.81;817;29;1478.00;38
3547;29;626472235;3547;147;4362;4400;9.85;0.60;239.24;3.81;815;29;1479.00;38
3549;29;626472246;3549;146;4365;4400;9.85;0.60;239.37;3.83;816;29;1480.00;35
3552;29;626472259;3552;144;4365;4400;9.90;0.60;239.40;3.83;813;29;1481.00;35
3553;29;626472271;3553;146;4368;4404;9.94;0.60;239.52;3.83;815;29;1482.00;36
3559;29;626472282;3559;149;4370;4404;9.92;0.60;239.51;3.85;811;29;1483.00;34
3560;29;626472294;3560;155;4373;4408;9.95;0.60;239.57;3.84;813;29;1484.00;35
3562;29;626472305;3562;156;4377;4410;9.97;0.61;239.64;3.85;815;29;1485.00;33
3566;29;626472317;3566;156;4377;4410;10.01;0.61;239.76;3.85;811;29;1486.00;33
3569;29;626472328;3569;165;4378;4410;10.02;0.61;239.75;3.86;809;29;1487.00;32
3571;29;626472339;3571;170;4386;4423;10.03;0.61;239.80;3.85;815;29;1488.00;37
3573;29;626472351;3573;170;4387;4423;10.04;0.61;239.79;3.86;814;29;1489.00;36
3575;29;626472363;3575;178;4389;4423;10.04;0.61;239.82;3.87;814;29;1490.00;34
3577;29;626472374;3577;181;4392;4424;10.01;0.61;239.90;3.90;815;29;1491.00;32
3578;30;626472386;3578;185;4392;4425;9.96;0.61;239.95;3.90;814;30;1492.00;33
3581;30;626472420;3581;194;4395;4425;9.90;0.60;240.04;3.93;814;30;1493.00;30
3583;30;626472431;3583;199;4397;4428;9.95;0.61;240.10;3.93;814;30;1494.00;31
3586;30;626472449;3586;205;4398;4428;9.90;0.60;240.05;3.94;812;30;1495.00;30
3589;30;626472461;3589;208;4401;4428;9.83;0.60;240.14;3.96;812;30;1496.00;27
3593;30;626472472;3593;211;4402;4428;9.78;0.60;240.14;3.97;809;30;1497.00;26
3595;30;626472484;3595;216;4409;4434;9.83;0.60;240.15;4.01;814;30;1498.00;25
3599;30;626472496;3599;217;4411;4434;9.75;0.59;240.20;4.03;812;30;1499.00;23
3602;30;626472510;3602;224;4417;4453;9.63;0.58;240.27;4.05;815;30;1500.00;36
3605;30;626472530;3605;227;4420;4453;9.56;0.58;240.17;4.08;815;30;1501.00;33
3608;30;626472542;3608;226;4424;4457;9.40;0.57;240.30;4.08;816;30;1502.00;33
3610;30;626472555;3610;229;4429;4458;9.30;0.56;240.23;4.13;819;30;1503.00;29
3611;30;626472567;3611;238;4430;4458;9.25;0.56;240.29;4.13;819;30;1504.00;28
3615;30;626472579;3615;247;4434;4459;9.17;0.56;240.44;4.14;819;30;1505.00;25
3615;30;626472591;3615;253;4437;4459;9.08;0.55;240.44;4.15;822;30;1506.00;22
3617;30;626472603;3617;253;4438;4459;8.97;0.55;240.38;4.15;821;30;1507.00;21
3619;30;626472615;3619;258;4439;4459;8.94;0.55;240.48;4.16;820;30;1508.00;20
3620;30;626472631;3620;259;4442;4459;8.96;0.55;240.46;4.17;822;30;1509.00;17
3623;30;626472642;3623;252;4443;4459;9.04;0.55;240.72;4.17;820;30;1510.00;16
3628;30;626472659;3628;251;4444;4459;9.11;0.56;240.64;4.17;816;30;1511.00;15
3629;30;626472671;3629;250;4473;4529;9.13;0.56;240.67;4.15;844;30;1512.00;56
3632;30;626472687;3632;249;4476;4530;9.19;0.56;240.65;4.15;844;30;1513.00;54
3637;30;626472698;3637;248;4485;4530;9.21;0.56;240.87;4.15;848;30;1514.00;45
3642;30;626472709;3642;247;4492;4530;9.21;0.56;240.83;4.15;850;30;1515.00;38
3645;30;626472721;3645;249;4500;4530;9.19;0.56;240.92;4.15;855;30;1516.00;30
3649;30;626472732;3649;255;4502;4530;9.22;0.56;240.97;4.15;853;30;1517.00;28
3650;30;626472744;3650;255;4504;4530;9.29;0.57;240.94;4.15;854;30;1518.00;26
3653;30;626472755;3653;255;4505;4530;9.35;0.57;241.01;4.15;852;30;1519.00;25
3660;30;626472766;3660;254;4507;4531;9.33;0.57;240.94;4.15;847;30;1520.00;24
3661;30;626472777;3661;255;4509;4532;9.25;0.56;240.92;4.15;848;30;1521.00;23
3665;30;626472788;3665;261;4511;4532;9.17;0.56;240.98;4.16;846;30;1522.00;21
3670;30;626472799;3670;266;4515;4536;9.04;0.55;241.15;4.16;845;30;1523.00;21
3673;30;626472811;3673;267;4515;4536;8.98;0.55;241.20;4.16;842;30;1524.00;21
3676;30;626472821;3676;276;4515;4536;8.86;0.54;241.37;4.16;839;30;1525.00;21
3679;30;626472832;3679;281;4515;4536;8.74;0.53;241.42;4.16;836;30;1526.00;21
3682;30;626472842;3682;287;4520;4542;8.62;0.53;241.53;4.16;838;30;1527.00;22
3686;30;626472852;3686;298;4520;4542;8.42;0.51;241.55;4.16;834;30;1528.00;22
3690;30;626472863;3690;300;4520;4542;8.22;0.50;241.57;4.16;830;30;1529.00;22
3694;30;626472874;3694;294;4523;4548;8.04;0.49;241.68;4.16;829;30;1530.00;25
3697;30;626472886;3697;289;4523;4548;7.96;0.49;241.75;4.16;826;30;1531.00;25
3700;30;626472896;3700;284;4524;4548;7.95;0.49;241.75;4.16;824;30;1532.00;24
3703;30;626472907;3703;278;4526;4549;7.93;0.49;241.78;4.17;823;30;1533.00;23
3707;30;626472917;3707;272;4527;4550;7.93;0.49;241.75;4.17;820;30;1534.00;23
3711;30;626472927;3711;267;4527;4550;7.91;0.49;241.79;4.17;816;30;1535.00;23
3714;30;626472937;3714;266;4540;4563;7.89;0.48;241.76;4.17;826;30;1536.00;23
3717;31;626472948;3717;256;4540;4563;7.94;0.49;241.81;4.17;823;31;1537.00;23
3723;31;626472975;3723;249;4542;4563;8.01;0.49;241.94;4.18;819;31;1538.00;21
3727;31;626472986;3727;254;4544;4564;7.99;0.49;242.06;4.18;817;31;1539.00;20
3728;31;626472996;3728;251;4546;4564;8.07;0.50;242.11;4.19;818;31;1540.00;18
3736;31;626473007;3736;246;4549;4568;8.04;0.49;242.27;4.19;813;31;1541.00;19
3740;31;626473024;3740;239;4549;4568;7.99;0.49;242.35;4.19;809;31;1542.00;19
3741;31;626473044;3741;235;4553;4572;7.98;0.49;242.41;4.19;812;31;1543.00;19
3746;31;626473062;3746;233;4553;4572;7.95;0.49;242.50;4.19;807;31;1544.00;19
3748;31;626473082;3748;242;4554;4572;7.96;0.49;242.48;4.20;806;31;1545.00;18
3751;31;626473098;3751;239;4554;4572;7.99;0.49;242.44;4.20;803;31;1546.00;18
3754;31;626473114;3754;242;4554;4572;7.94;0.49;242.45;4.20;800;31;1547.00;18
3757;31;626473131;3757;249;4567;4584;7.99;0.49;242.52;4.20;810;31;1548.00;17
3760;31;626473145;3760;254;4567;4584;7.98;0.49;242.51;4.20;807;31;1549.00;17
3767;31;626473158;3767;257;4568;4584;7.86;0.48;242.48;4.21;801;31;1550.00;16
3771;32;626473170;3771;263;4568;4584;7.74;0.48;242.49;4.21;797;32;1551.00;16
3773;32;626473204;3773;266;4568;4584;7.68;0.47;242.49;4.21;795;32;1552.00;16
3777;32;626473218;3777;272;4569;4584;7.61;0.47;242.50;4.22;792;32;1553.00;15
3781;32;626473231;3781;276;4571;4585;7.55;0.46;242.54;4.22;790;32;1554.00;14
3787;32;626473243;3787;275;4572;4587;7.40;0.45;242.49;4.22;785;32;1555.00;15
3791;32;626473257;3791;283;4576;4593;7.30;0.45;242.55;4.22;785;32;1556.00;17
3794;32;626473270;3794;292;4579;4594;7.24;0.44;242.45;4.23;785;32;1557.00;15
3796;32;626473282;3796;295;4580;4594;7.17;0.44;242.54;4.24;784;32;1558.00;14
3799;32;626473294;3799;298;4581;4594;7.03;0.43;242.57;4.25;782;32;1559.00;13
3803;32;626473307;3803;303;4587;4599;6.97;0.43;242.60;4.25;784;32;1560.00;12
3809;32;626473320;3809;311;4587;4599;6.89;0.42;242.50;4.25;778;32;1561.00;12
3817;32;626473332;3817;315;4588;4599;6.76;0.41;242.55;4.25;771;32;1562.00;11
3818;32;626473344;3818;313;4590;4600;6.78;0.42;242.54;4.26;772;32;1563.00;10
3822;32;626473355;3822;317;4594;4604;6.79;0.42;242.53;4.25;772;32;1564.00;10
3824;32;626473366;3824;324;4595;4604;6.79;0.41;242.52;4.26;771;32;1565.00;9
3827;32;626473377;3827;328;4598;4607;6.83;0.42;242.51;4.26;771;32;1566.00;9
3833;32;626473397;3833;337;4599;4607;6.73;0.41;242.41;4.27;766;32;1567.00;8
3834;32;626473409;3834;348;4599;4607;6.74;0.41;242.38;4.27;765;32;1568.00;8
3839;32;626473419;3839;351;4601;4607;6.66;0.41;242.19;4.27;762;32;1569.00;6
3841;32;626473429;3841;357;4603;4611;6.66;0.41;242.13;4.27;762;32;1570.00;8
3842;32;626473439;3842;363;4604;4611;6.69;0.41;242.08;4.27;762;32;1571.00;7
3845;32;626473449;3845;372;4604;4611;6.71;0.41;242.00;4.27;759;32;1572.00;7
3846;32;626473458;3846;379;4604;4611;6.67;0.41;242.06;4.27;758;32;1573.00;7
3851;32;626473468;3851;387;4606;4612;6.59;0.40;242.04;4.27;755;32;1574.00;6
3854;32;626473479;3854;393;4609;4614;6.55;0.40;241.96;4.27;755;32;1575.00;5
3856;32;626473496;3856;400;4609;4614;6.46;0.39;241.87;4.27;753;32;1576.00;5
3858;32;626473505;3858;389;4611;4615;6.46;0.39;242.03;4.27;753;32;1577.00;4
3859;32;626473514;3859;383;4611;4615;6.46;0.39;242.02;4.27;752;32;1578.00;4
3861;32;626473524;3861;379;4611;4615;6.48;0.39;242.12;4.27;750;32;1579.00;4
3861;32;626473534;3861;374;4611;4615;6.54;0.40;242.12;4.27;750;32;1580.00;4
3864;32;626473544;3864;373;4611;4615;6.60;0.40;242.20;4.27;747;32;1581.00;4
3865;32;626473561;3865;372;4611;4615;6.62;0.40;242.23;4.27;746;32;1582.00;4
3866;32;626473571;3866;367;4611;4615;6.64;0.40;242.22;4.27;745;32;1583.00;4
3867;32;626473580;3867;380;4680;4742;6.96;0.43;242.22;4.21;813;32;1584.00;62
3868;32;626473601;3868;372;4682;4743;6.98;0.43;242.20;4.21;814;32;1585.00;61
3870;32;626473613;3870;350;4692;4743;7.13;0.44;242.17;4.20;822;32;1586.00;51
3871;32;626473624;3871;322;4697;4743;7.24;0.45;242.15;4.20;826;32;1587.00;46
3874;32;626473635;3874;300;4701;4743;7.33;0.45;242.13;4.20;827;32;1588.00;42
3876;32;626473647;3876;289;4703;4743;7.45;0.46;242.14;4.20;827;32;1589.00;40
3879;32;626473660;3879;280;4710;4743;7.59;0.47;242.15;4.20;831;32;1590.00;33
3879;32;626473672;3879;264;4712;4743;7.83;0.48;242.15;4.20;833;32;1591.00;31
3881;32;626473684;3881;255;4715;4744;8.02;0.49;242.10;4.21;834;32;1592.00;29
3881;32;626473696;3881;241;4720;4745;8.20;0.50;242.10;4.21;839;32;1593.00;25
3882;32;626473717;3882;239;4724;4745;8.35;0.51;242.10;4.22;842;32;1594.00;21
3884;32;626473735;3884;238;4728;4746;8.46;0.52;242.07;4.22;844;32;1595.00;18
3884;32;626473748;3884;234;4730;4746;8.56;0.53;242.07;4.22;846;32;1596.00;16
3886;32;626473761;3886;230;4730;4746;8.66;0.53;242.05;4.22;844;32;1597.00;16
3889;32;626473773;3889;224;4730;4746;8.73;0.54;241.99;4.22;841;32;1598.00;16
3890;32;626473785;3890;221;4734;4750;8.85;0.54;242.00;4.22;844;32;1599.00;16
3892;32;626473799;3892;221;4735;4750;8.89;0.54;241.97;4.23;843;32;1600.00;15
3894;32;626473816;3894;217;4738;4750;8.91;0.54;241.93;4.23;844;32;1601.00;12
3896;32;626473829;3896;211;4740;4753;8.95;0.55;241.91;4.23;844;32;1602.00;13
3897;32;626473843;3897;205;4741;4753;8.98;0.55;241.87;4.26;844;32;1603.00;12
3897;32;626473855;3897;203;4742;4753;9.09;0.55;241.87;4.26;845;32;1604.00;11
3900;32;626473867;3900;203;4745;4757;9.13;0.56;241.87;4.26;845;32;1605.00;12
3902;33;626473891;3902;202;4746;4758;9.17;0.56;241.86;4.26;844;33;1606.00;12
3904;33;626473927;3904;200;4746;4758;9.23;0.56;241.90;4.26;842;33;1607.00;12
3905;34;626473940;3905;198;4749;4762;9.35;0.57;241.95;4.26;844;34;1608.00;13
3911;34;626473972;3911;199;4749;4762;9.36;0.57;241.88;4.26;838;34;1609.00;13
3912;34;626473985;3912;203;4749;4762;9.39;0.57;241.89;4.26;837;34;1610.00;13
3915;34;626473998;3915;205;4750;4763;9.42;0.57;241.93;4.25;835;34;1611.00;13
3916;34;626474021;3916;216;4750;4763;9.38;0.57;241.99;4.25;834;34;1612.00;13
3917;34;626474040;3917;220;4755;4769;9.33;0.57;241.97;4.25;838;34;1613.00;14
3920;34;626474061;3920;224;4755;4769;9.30;0.56;242.04;4.25;835;34;1614.00;14
3920;34;626474077;3920;226;4755;4770;9.34;0.57;242.04;4.25;835;34;1615.00;15
3925;34;626474088;3925;224;4755;4770;9.30;0.56;242.22;4.25;830;34;1616.00;15
3926;34;626474099;3926;227;4755;4770;9.29;0.56;242.28;4.25;829;34;1617.00;15
3931;34;626474110;3931;227;4755;4770;9.26;0.56;242.32;4.25;824;34;1618.00;15
3933;34;626474121;3933;227;4755;4770;9.24;0.56;242.33;4.25;822;34;1619.00;15
3936;34;626474134;3936;228;4776;4806;9.21;0.56;242.39;4.23;840;34;1620.00;30
3939;34;626474148;3939;221;4777;4806;9.22;0.56;242.44;4.23;838;34;1621.00;29
3942;34;626474159;3942;219;4778;4806;9.24;0.56;242.51;4.23;836;34;1622.00;28
3945;34;626474169;3945;213;4779;4806;9.30;0.57;242.53;4.23;834;34;1623.00;27
3949;34;626474180;3949;208;4781;4806;9.27;0.56;242.63;4.23;832;34;1624.00;25
3953;34;626474198;3953;199;4782;4806;9.29;0.57;242.82;4.23;829;34;1625.00;24
3957;34;626474210;3957;191;4786;4810;9.37;0.57;242.84;4.27;829;34;1626.00;24
3959;34;626474221;3959;185;4788;4810;9.45;0.58;242.92;4.27;829;34;1627.00;22
3964;34;626474232;3964;176;4791;4814;9.50;0.58;242.95;4.27;827;34;1628.00;23
3969;34;626474243;3969;168;4793;4815;9.52;0.58;242.94;4.27;824;34;1629.00;22
3976;34;626474254;3976;167;4794;4815;9.44;0.57;243.05;4.27;818;34;1630.00;21
3980;34;626474264;3980;163;4795;4815;9.44;0.57;243.06;4.27;815;34;1631.00;20
3984;34;626474275;3984;160;4804;4828;9.38;0.57;243.08;4.26;820;34;1632.00;24
3988;34;626474287;3988;151;4805;4828;9.32;0.57;243.13;4.26;817;34;1633.00;23
3989;34;626474297;3989;159;4805;4828;9.38;0.57;243.11;4.26;816;34;1634.00;23
3994;34;626474307;3994;161;4807;4829;9.45;0.57;243.17;4.27;813;34;1635.00;22
3994;34;626474318;3994;152;4807;4830;9.52;0.58;243.17;4.27;813;34;1636.00;23
3997;34;626474329;3997;153;4807;4830;9.67;0.59;243.22;4.27;810;34;1637.00;23
4000;34;626474339;4000;147;4809;4833;9.84;0.60;243.27;4.27;809;34;1638.00;24
4003;34;626474351;4003;138;4810;4833;9.96;0.61;243.32;4.27;807;34;1639.00;23
4005;34;626474361;4005;135;4811;4833;9.97;0.61;243.32;4.31;806;34;1640.00;22
4007;34;626474372;4007;132;4811;4833;10.06;0.61;243.32;4.31;804;34;1641.00;22
4011;34;626474382;4011;131;4815;4839;10.14;0.62;243.28;4.30;804;34;1642.00;24
4014;34;626474393;4014;127;4815;4839;10.15;0.62;243.37;4.30;801;34;1643.00;24
4018;34;626474404;4018;126;4816;4839;10.17;0.62;243.50;4.30;798;34;1644.00;23
4023;34;626474414;4023;127;4816;4839;10.18;0.62;243.49;4.30;793;34;1645.00;23
4025;34;626474425;4025;127;4819;4843;10.13;0.62;243.59;4.30;794;34;1646.00;24
4028;34;626474441;4028;131;4822;4844;10.23;0.62;243.71;4.33;794;34;1647.00;22
4030;34;626474452;4030;131;4822;4844;10.31;0.63;243.69;4.33;792;34;1648.00;22
4033;34;626474463;4033;130;4823;4845;10.42;0.63;243.75;4.33;790;34;1649.00;22
4036;34;626474475;4036;128;4823;4845;10.53;0.64;243.76;4.33;787;34;1650.00;22
4039;34;626474486;4039;131;4823;4845;10.61;0.64;243.76;4.33;784;34;1651.00;22
4041;34;626474497;4041;130;4823;4845;10.64;0.65;243.74;4.33;782;34;1652.00;22
4044;34;626474509;4044;138;4824;4845;10.70;0.65;243.83;4.34;780;34;1653.00;21
4045;34;626474519;4045;139;4824;4845;10.73;0.65;243.84;4.34;779;34;1654.00;21
4050;34;626474532;4050;143;4824;4845;10.70;0.65;243.87;4.34;774;34;1655.00;21
4056;34;626474542;4056;151;4861;4915;10.66;0.65;243.89;4.31;805;34;1656.00;54
4059;34;626474566;4059;153;4861;4916;10.68;0.65;243.93;4.31;802;34;1657.00;55
4061;34;626474577;4061;156;4868;4916;10.67;0.65;243.88;4.32;807;34;1658.00;48
4063;34;626474588;4063;160;4873;4916;10.56;0.64;243.98;4.31;810;34;1659.00;43
4064;34;626474599;4064;163;4879;4916;10.50;0.64;243.95;4.34;815;34;1660.00;37
4065;34;626474610;4065;166;4881;4916;10.41;0.63;243.95;4.34;816;34;1661.00;35
4067;34;626474621;4067;166;4885;4916;10.30;0.63;244.02;4.35;818;34;1662.00;31
4069;34;626474633;4069;175;4889;4916;10.29;0.63;244.04;4.36;820;34;1663.00;27
4072;34;626474644;4072;173;4891;4917;10.22;0.62;244.11;4.38;819;34;1664.00;26
4076;34;626474656;4076;175;4897;4919;10.18;0.62;244.11;4.39;821;34;1665.00;22
4079;34;626474667;4079;173;4898;4919;10.15;0.62;244.24;4.39;819;34;1666.00;21
4081;34;626474678;4081;177;4903;4923;10.04;0.61;244.31;4.40;822;34;1667.00;20
4084;34;626474690;4084;179;4904;4923;9.97;0.61;244.23;4.40;820;34;1668.00;19
4089;34;626474701;4089;179;4905;4923;9.96;0.61;244.30;4.42;816;34;1669.00;18
4090;34;626474712;4090;192;4905;4923;9.96;0.61;244.37;4.42;815;34;1670.00;18
4090;34;626474723;4090;189;4911;4929;9.98;0.61;244.37;4.42;821;34;1671.00;18
4092;34;626474734;4092;191;4912;4929;9.94;0.61;244.46;4.42;820;34;1672.00;17
4096;34;626474745;4096;196;4913;4929;9.93;0.61;244.49;4.44;817;34;1673.00;16
4099;34;626474756;4099;196;4916;4932;9.93;0.61;244.51;4.43;817;34;1674.00;16
4101;34;626474767;4101;205;4917;4932;9.87;0.61;244.44;4.44;816;34;1675.00;15
4105;34;626474777;4105;207;4918;4932;9.76;0.60;244.47;4.45;813;34;1676.00;14
4108;34;626474788;4108;213;4918;4933;9.60;0.59;244.45;4.45;810;34;1677.00;15
4112;34;626474798;4112;222;4922;4934;9.49;0.58;244.32;4.47;810;34;1678.00;12
4115;34;626474808;4115;224;4922;4934;9.34;0.57;244.28;4.47;807;34;1679.00;12
4119;34;626474820;4119;231;4940;4960;9.22;0.56;244.35;4.46;821;34;1680.00;20
4123;34;626474832;4123;234;4942;4960;9.13;0.56;244.27;4.46;819;34;1681.00;18
4127;35;626474842;4127;232;4945;4960;9.06;0.55;244.28;4.46;818;35;1682.00;15
4128;36;626474870;4128;234;4946;4961;9.04;0.55;244.28;4.46;818;36;1683.00;15
4132;36;626474886;4132;232;4946;4961;9.01;0.55;244.30;4.46;814;36;1684.00;15
4132;37;626474901;4132;238;4952;4965;9.05;0.55;244.30;4.47;820;37;1685.00;13
4138;37;626474922;4138;242;4952;4965;9.06;0.55;244.34;4.47;814;37;1686.00;13
4139;37;626474936;4139;244;4955;4969;9.03;0.55;244.33;4.47;816;37;1687.00;14
4142;37;626474947;4142;252;4957;4969;8.99;0.55;244.30;4.47;815;37;1688.00;12
4146;37;626474957;4146;250;4958;4969;8.94;0.55;244.37;4.48;812;37;1689.00;11
4148;37;626474967;4148;257;4959;4969;8.76;0.53;244.39;4.48;811;37;1690.00;10
4154;37;626474977;4154;267;4959;4969;8.56;0.52;244.36;4.48;805;37;1691.00;10
4158;37;626474988;4158;270;4971;4981;8.42;0.51;244.31;4.47;813;37;1692.00;10
4162;37;626474998;4162;273;4972;4981;8.22;0.50;244.33;4.47;810;37;1693.00;9
4167;37;626475007;4167;278;4974;4981;8.06;0.49;244.25;4.47;807;37;1694.00;7
4172;37;626475021;4172;292;4974;4981;7.88;0.48;244.20;4.47;802;37;1695.00;7
4175;37;626475038;4175;294;4974;4981;7.75;0.47;244.35;4.47;799;37;1696.00;7
4179;37;626475052;4179;301;4974;4981;7.59;0.46;244.33;4.47;795;37;1697.00;7
4183;37;626475071;4183;311;4975;4982;7.36;0.45;244.47;4.47;792;37;1698.00;7
4188;37;626475085;4188;314;4975;4982;7.11;0.44;244.50;4.47;787;37;1699.00;7
4190;37;626475102;4190;308;4980;4988;7.08;0.43;244.51;4.47;790;37;1700.00;8
4195;37;626475127;4195;315;4981;4989;6.97;0.43;244.55;4.47;786;37;1701.00;8
4198;37;626475138;4198;312;4982;4989;6.90;0.42;244.63;4.47;784;37;1702.00;7
4202;37;626475147;4202;308;4982;4989;6.87;0.42;244.68;4.47;780;37;1703.00;7
4204;37;626475157;4204;309;4986;4993;6.91;0.42;244.67;4.46;782;37;1704.00;7
4206;37;626475166;4206;312;4986;4993;6.88;0.42;244.66;4.46;780;37;1705.00;7
4208;37;626475176;4208;316;4986;4993;6.86;0.42;244.67;4.46;778;37;1706.00;7
4210;37;626475185;4210;314;4987;4994;6.91;0.42;244.69;4.46;777;37;1707.00;7
4213;37;626475195;4213;314;4991;4998;6.90;0.42;244.76;4.46;778;37;1708.00;7
4217;37;626475206;4217;316;4991;4998;6.96;0.43;244.79;4.46;774;37;1709.00;7
4220;37;626475219;4220;315;4994;5004;7.04;0.43;244.86;4.46;774;37;1710.00;10
4224;37;626475229;4224;318;4994;5004;7.05;0.43;244.82;4.46;770;37;1711.00;10
4227;37;626475239;4227;316;4995;5004;7.12;0.44;244.83;4.46;768;37;1712.00;9
4233;37;626475248;4233;310;4995;5004;7.14;0.44;244.89;4.46;762;37;1713.00;9
4235;37;626475257;4235;306;4998;5008;7.20;0.44;244.82;4.45;763;37;1714.00;10
4240;37;626475267;4240;305;4999;5008;7.15;0.44;244.85;4.46;759;37;1715.00;9
4244;37;626475276;4244;307;4999;5008;7.10;0.43;244.76;4.46;755;37;1716.00;9
4246;37;626475286;4246;309;5000;5008;7.12;0.44;244.69;4.46;754;37;1717.00;8
4250;37;626475295;4250;306;5001;5009;7.06;0.43;244.60;4.45;751;37;1718.00;8
4253;37;626475304;4253;302;5003;5010;7.06;0.43;244.58;4.45;750;37;1719.00;7
4256;37;626475313;4256;305;5003;5010;7.03;0.43;244.51;4.45;747;37;1720.00;7
4260;37;626475322;4260;306;5004;5011;7.02;0.43;244.47;4.45;744;37;1721.00;7
4263;37;626475334;4263;309;5004;5011;7.04;0.43;244.47;4.45;741;37;1722.00;7
4266;37;626475344;4266;308;5004;5011;7.07;0.43;244.48;4.45;738;37;1723.00;7
4271;37;626475353;4271;306;5004;5011;6.98;0.43;244.47;4.45;733;37;1724.00;7
4272;37;626475363;4272;301;5004;5011;7.01;0.43;244.43;4.45;732;37;1725.00;7
4274;37;626475372;4274;296;5004;5011;7.06;0.43;244.39;4.45;730;37;1726.00;7
4277;37;626475382;4277;304;5004;5011;7.11;0.44;244.44;4.45;727;37;1727.00;7
4282;37;626475392;4282;319;5076;5138;7.46;0.46;244.46;4.42;794;37;1728.00;62
4285;37;626475414;4285;320;5079;5139;7.41;0.46;244.51;4.42;794;37;1729.00;60
4287;37;626475424;4287;320;5089;5139;7.52;0.47;244.45;4.41;802;37;1730.00;50
4290;37;626475434;4290;321;5095;5139;7.50;0.47;244.56;4.41;805;37;1731.00;44
4293;37;626475444;4293;318;5101;5139;7.51;0.47;244.63;4.41;808;37;1732.00;38
4296;37;626475455;4296;325;5106;5139;7.52;0.47;244.60;4.41;810;37;1733.00;33
4297;37;626475465;4297;331;5112;5139;7.58;0.47;244.62;4.41;815;37;1734.00;27
4301;38;626475482;4301;334;5115;5139;7.60;0.47;244.50;4.41;814;38;1735.00;24
4303;38;626475508;4303;343;5118;5140;7.61;0.47;244.51;4.42;815;38;1736.00;22
4305;38;626475520;4305;346;5122;5141;7.56;0.47;244.43;4.42;817;38;1737.00;19
4307;38;626475531;4307;347;5123;5141;7.52;0.46;244.43;4.42;816;38;1738.00;18
4309;38;626475541;4309;339;5125;5142;7.52;0.46;244.39;4.42;816;38;1739.00;17
4310;38;626475554;4310;334;5127;5142;7.56;0.47;244.37;4.42;817;38;1740.00;15
4313;38;626475565;4313;332;5128;5142;7.57;0.47;244.43;4.42;815;38;1741.00;14
4315;38;626475575;4315;335;5129;5142;7.60;0.47;244.42;4.43;814;38;1742.00;13
4317;38;626475587;4317;335;5133;5146;7.65;0.47;244.38;4.43;816;38;1743.00;13
4319;38;626475599;4319;329;5134;5146;7.70;0.47;244.41;4.43;815;38;1744.00;12
4321;38;626475610;4321;329;5136;5146;7.73;0.47;244.36;4.46;815;38;1745.00;10
4324;38;626475622;4324;324;5139;5149;7.82;0.48;244.30;4.46;815;38;1746.00;10
4326;38;626475633;4326;310;5139;5149;7.80;0.48;244.27;4.46;813;38;1747.00;10
4328;38;626475645;4328;292;5140;5149;7.88;0.48;244.22;4.46;812;38;1748.00;9
4331;38;626475657;4331;283;5143;5153;8.01;0.49;244.25;4.46;812;38;1749.00;10
4334;38;626475670;4334;272;5145;5154;8.12;0.50;244.26;4.46;811;38;1750.00;9
4340;38;626475687;4340;264;5145;5154;8.18;0.50;244.24;4.46;805;38;1751.00;9
4342;38;626475699;4342;258;5149;5158;8.29;0.51;244.19;4.46;807;38;1752.00;9
4342;38;626475711;4342;254;5149;5158;8.38;0.51;244.19;4.46;807;38;1753.00;9
4345;38;626475724;4345;251;5149;5158;8.49;0.52;244.21;4.46;804;38;1754.00;9
4348;38;626475736;4348;253;5151;5160;8.54;0.52;244.24;4.46;803;38;1755.00;9
4351;38;626475762;4351;247;5151;5160;8.59;0.52;244.27;4.46;800;38;1756.00;9
4352;38;626475775;4352;236;5155;5166;8.67;0.53;244.27;4.46;803;38;1757.00;11
4354;38;626475790;4354;225;5155;5166;8.75;0.53;244.27;4.46;801;38;1758.00;11
4355;38;626475813;4355;217;5156;5167;8.84;0.54;244.22;4.45;801;38;1759.00;11
4357;38;626475825;4357;212;5156;5167;8.95;0.54;244.15;4.45;799;38;1760.00;11
4362;38;626475838;4362;216;5157;5167;9.04;0.55;244.15;4.48;795;38;1761.00;10
4363;38;626475852;4363;213;5157;5167;9.12;0.55;244.12;4.48;794;38;1762.00;10
4365;38;626475866;4365;219;5157;5167;9.15;0.55;244.20;4.48;792;38;1763.00;10
4367;38;626475882;4367;217;5167;5179;9.33;0.57;244.24;4.47;800;38;1764.00;12
4368;38;626475896;4368;218;5167;5179;9.35;0.57;244.26;4.47;799;38;1765.00;12
4370;38;626475908;4370;223;5168;5179;9.40;0.57;244.30;4.47;798;38;1766.00;11
4372;38;626475921;4372;219;5168;5179;9.47;0.58;244.40;4.47;796;38;1767.00;11
4375;38;626475934;4375;215;5168;5179;9.51;0.58;244.41;4.47;793;38;1768.00;11
4376;38;626475946;4376;214;5168;5179;9.58;0.58;244.40;4.47;792;38;1769.00;11
4378;38;626475960;4378;210;5171;5183;9.57;0.58;244.50;4.47;793;38;1770.00;12
4381;38;626475975;4381;208;5171;5183;9.65;0.59;244.51;4.47;790;38;1771.00;12
4384;38;626475987;4384;207;5174;5187;9.68;0.59;244.53;4.47;790;38;1772.00;13
4385;38;626475999;4385;214;5175;5188;9.77;0.60;244.55;4.47;790;38;1773.00;13
4388;38;626476013;4388;208;5176;5188;9.83;0.60;244.78;4.47;788;38;1774.00;12
4393;38;626476026;4393;213;5176;5188;9.79;0.60;244.90;4.47;783;38;1775.00;12
4397;38;626476037;4397;213;5187;5201;9.90;0.60;244.88;4.46;790;38;1776.00;14
4401;38;626476050;4401;217;5187;5201;9.94;0.60;245.08;4.46;786;38;1777.00;14
4405;38;626476065;4405;218;5187;5201;9.94;0.60;245.22;4.46;782;38;1778.00;14
4407;38;626476077;4407;213;5188;5202;9.91;0.60;245.25;4.46;781;38;1779.00;14
4410;38;626476088;4410;219;5188;5203;9.88;0.60;245.36;4.46;778;38;1780.00;15
4413;38;626476100;4413;221;5188;5203;9.83;0.60;245.43;4.46;775;38;1781.00;15
4414;38;626476110;4414;224;5191;5206;9.81;0.60;245.49;4.49;777;38;1782.00;15
4417;38;626476121;4417;229;5191;5206;9.76;0.59;245.62;4.49;774;38;1783.00;15
4423;38;626476132;4423;228;5192;5206;9.70;0.59;245.62;4.48;769;38;1784.00;14
4424;38;626476143;4424;231;5192;5206;9.70;0.59;245.69;4.48;768;38;1785.00;14
4428;38;626476153;4428;236;5196;5212;9.67;0.59;245.70;4.48;768;38;1786.00;16
4430;38;626476164;4430;235;5196;5212;9.61;0.59;245.74;4.48;766;38;1787.00;16
4431;38;626476175;4431;231;5197;5212;9.58;0.58;245.73;4.48;766;38;1788.00;15
4434;38;626476185;4434;223;5197;5212;9.58;0.58;245.68;4.48;763;38;1789.00;15
4438;38;626476196;4438;216;5200;5216;9.52;0.58;245.71;4.48;762;38;1790.00;16
4439;38;626476207;4439;206;5201;5217;9.60;0.58;245.73;4.48;762;38;1791.00;16
4442;38;626476217;4442;204;5201;5217;9.69;0.59;245.74;4.48;759;38;1792.00;16
4451;38;626476228;4451;197;5202;5218;9.66;0.59;246.01;4.48;751;38;1793.00;16
4452;38;626476239;4452;193;5202;5218;9.76;0.59;246.06;4.48;750;38;1794.00;16
4456;38;626476249;4456;185;5202;5218;9.81;0.60;246.03;4.48;746;38;1795.00;16
4457;38;626476259;4457;181;5202;5218;9.90;0.60;246.05;4.48;745;38;1796.00;16
4457;38;626476269;4457;174;5202;5218;9.93;0.61;246.05;4.48;745;38;1797.00;16
4459;38;626476279;4459;171;5202;5218;9.94;0.61;246.10;4.48;743;38;1798.00;16
4466;38;626476289;4466;165;5202;5218;9.84;0.60;246.20;4.48;736;38;1799.00;16
4472;38;626476302;4472;185;5264;5356;9.47;0.58;246.28;4.45;792;38;1800.00;92
4475;38;626476329;4475;167;5264;5357;9.43;0.58;246.32;4.45;789;38;1801.00;93
4478;38;626476340;4478;160;5275;5357;9.47;0.58;246.41;4.45;797;38;1802.00;82
4484;38;626476352;4484;151;5277;5357;9.43;0.58;246.63;4.45;793;38;1803.00;80
4488;38;626476362;4488;151;5281;5357;9.48;0.58;246.71;4.45;793;38;1804.00;76
4489;38;626476374;4489;149;5288;5357;9.55;0.59;246.74;4.47;799;38;1805.00;69
4494;38;626476386;4494;144;5293;5357;9.57;0.59;246.77;4.47;799;38;1806.00;64
4498;38;626476397;4498;143;5295;5357;9.62;0.59;246.82;4.47;797;38;1807.00;62
4502;38;626476409;4502;134;5301;5358;9.75;0.60;246.81;4.50;799;38;1808.00;57
4506;38;626476421;4506;134;5302;5359;9.78;0.60;246.90;4.50;796;38;1809.00;57
4508;38;626476433;4508;132;5305;5359;9.84;0.60;246.90;4.50;797;38;1810.00;54
4509;38;626476445;4509;137;5308;5363;9.88;0.61;246.91;4.50;799;38;1811.00;55
4513;38;626476457;4513;134;5310;5363;9.83;0.60;246.89;4.50;797;38;1812.00;53
4514;38;626476469;4514;134;5311;5363;9.77;0.60;246.94;4.52;797;38;1813.00;52
4519;38;626476481;4519;130;5312;5363;9.68;0.59;246.88;4.53;793;38;1814.00;51
4522;38;626476493;4522;129;5317;5369;9.66;0.59;247.00;4.54;795;38;1815.00;52
4526;38;626476511;4526;124;5319;5369;9.66;0.59;247.05;4.55;793;38;1816.00;50
4527;38;626476523;4527;130;5320;5369;9.75;0.60;247.03;4.55;793;38;1817.00;49
4531;38;626476535;4531;130;5323;5372;9.84;0.60;247.11;4.56;792;38;1818.00;49
4533;38;626476549;4533;129;5324;5372;9.95;0.61;247.19;4.57;791;38;1819.00;48
4535;38;626476563;4535;125;5324;5372;10.05;0.61;247.20;4.57;789;38;1820.00;48
4538;38;626476574;4538;130;5324;5373;10.17;0.62;247.26;4.57;786;38;1821.00;49
4540;38;626476585;4540;131;5330;5374;10.23;0.62;247.26;4.58;790;38;1822.00;44
4542;39;626476596;4542;131;5330;5374;10.32;0.63;247.32;4.58;788;39;1823.00;44
4545;39;626476616;4545;137;5338;5387;10.35;0.63;247.25;4.58;793;39;1824.00;49
4549;39;626476632;4549;135;5339;5387;10.45;0.64;247.47;4.58;790;39;1825.00;48
4553;39;626476643;4553;139;5340;5387;10.44;0.64;247.53;4.58;787;39;1826.00;47
4557;39;626476655;4557;143;5341;5388;10.44;0.64;247.52;4.58;784;39;1827.00;47
4559;39;626476672;4559;152;5344;5388;10.35;0.63;247.48;4.59;785;39;1828.00;44
4564;39;626476683;4564;153;5347;5392;10.33;0.63;247.49;4.59;783;39;1829.00;45
4567;39;626476696;4567;156;5348;5392;10.26;0.62;247.48;4.61;781;39;1830.00;44
4569;39;626476707;4569;166;5354;5396;10.15;0.62;247.55;4.62;785;39;1831.00;42
4571;39;626476718;4571;169;5354;5396;10.15;0.62;247.63;4.62;783;39;1832.00;42
4575;39;626476729;4575;174;5356;5396;10.09;0.61;247.71;4.64;781;39;1833.00;40
4579;39;626476739;4579;177;5358;5396;9.98;0.61;247.82;4.65;779;39;1834.00;38
4582;39;626476750;4582;186;5360;5396;9.92;0.60;247.76;4.67;778;39;1835.00;36
4583;39;626476761;4583;187;5369;5408;9.91;0.60;247.82;4.66;786;39;1836.00;39
4587;39;626476774;4587;195;5369;5408;9.89;0.60;247.91;4.66;782;39;1837.00;39
4589;39;626476784;4589;198;5373;5408;9.89;0.60;247.94;4.68;784;39;1838.00;35
4591;39;626476801;4591;203;5375;5408;9.81;0.60;248.03;4.69;784;39;1839.00;33
4594;39;626476811;4594;203;5379;5408;9.74;0.60;248.08;4.71;785;39;1840.00;29
4596;39;626476822;4596;205;5382;5408;9.73;0.60;248.11;4.73;786;39;1841.00;26
4599;39;626476832;4599;211;5382;5409;9.68;0.59;248.14;4.73;783;39;1842.00;27
4602;39;626476843;4602;211;5384;5409;9.58;0.59;248.09;4.74;782;39;1843.00;25
4605;39;626476853;4605;216;5390;5415;9.48;0.58;248.04;4.75;785;39;1844.00;25
4606;39;626476863;4606;225;5392;5417;9.39;0.58;248.00;4.75;786;39;1845.00;25
4609;40;626476874;4609;231;5395;5417;9.28;0.57;248.11;4.76;786;40;1846.00;22
4614;40;626476896;4614;236;5395;5417;9.16;0.56;247.95;4.76;781;40;1847.00;22
4616;40;626476906;4616;241;5400;5421;9.11;0.56;247.95;4.77;784;40;1848.00;21
4619;40;626476920;4619;243;5400;5421;9.05;0.55;247.94;4.77;781;40;1849.00;21
4622;40;626476930;4622;244;5401;5421;8.91;0.54;247.91;4.77;779;40;1850.00;20
4623;40;626476940;4623;244;5402;5422;8.90;0.54;247.90;4.77;779;40;1851.00;20
4624;40;626476950;4624;248;5406;5426;8.85;0.54;247.85;4.78;782;40;1852.00;20
4627;40;626476960;4627;247;5407;5426;8.81;0.54;247.88;4.78;780;40;1853.00;19
4629;40;626476970;4629;247;5413;5429;8.79;0.54;247.90;4.80;784;40;1854.00;16
4634;40;626476979;4634;250;5413;5429;8.77;0.53;247.95;4.80;779;40;1855.00;16
4635;40;626476989;4635;253;5416;5429;8.77;0.53;247.99;4.80;781;40;1856.00;13
4637;40;626476998;4637;257;5416;5429;8.79;0.54;247.92;4.80;779;40;1857.00;13
4641;40;626477007;4641;261;5420;5433;8.84;0.54;247.81;4.80;779;40;1858.00;13
4641;40;626477021;4641;262;5420;5433;8.83;0.54;247.81;4.80;779;40;1859.00;13
4643;40;626477037;4643;263;5421;5433;8.75;0.53;247.73;4.80;778;40;1860.00;12
4648;40;626477051;4648;259;5421;5433;8.54;0.52;247.75;4.80;773;40;1861.00;12
4651;40;626477067;4651;266;5422;5434;8.34;0.51;247.79;4.79;771;40;1862.00;12
4651;40;626477080;4651;273;5423;5435;8.19;0.50;247.79;4.79;772;40;1863.00;12
4654;40;626477095;4654;279;5423;5435;8.02;0.49;247.80;4.79;769;40;1864.00;12
4655;40;626477106;4655;287;5424;5436;7.95;0.49;247.80;4.79;769;40;1865.00;12
4660;40;626477122;4660;297;5424;5436;7.77;0.48;247.80;4.79;764;40;1866.00;12
4663;40;626477133;4663;300;5424;5436;7.56;0.46;247.82;4.79;761;40;1867.00;12
4667;40;626477143;4667;305;5424;5436;7.39;0.45;247.99;4.79;757;40;1868.00;12
4671;40;626477152;4671;316;5424;5436;7.20;0.44;247.87;4.79;753;40;1869.00;12
4675;40;626477162;4675;306;5424;5436;7.00;0.43;247.88;4.79;749;40;1870.00;12
4676;41;626477170;4676;308;5424;5436;6.87;0.42;247.92;4.79;748;41;1871.00;12
4681;41;626477205;4681;323;5494;5563;7.05;0.44;247.89;4.73;813;41;1872.00;69
4682;41;626477225;4682;317;5497;5564;7.03;0.44;247.87;4.73;815;41;1873.00;67
4685;41;626477235;4685;316;5507;5564;7.08;0.44;247.90;4.73;822;41;1874.00;57
4686;41;626477261;4686;316;5512;5564;7.08;0.44;247.94;4.72;826;41;1875.00;52
4690;41;626477271;4690;322;5520;5564;7.11;0.44;247.97;4.72;830;41;1876.00;44
4695;41;626477280;4695;316;5521;5564;7.03;0.44;248.03;4.72;826;41;1877.00;43
4699;41;626477291;4699;321;5526;5564;7.08;0.44;247.99;4.72;827;41;1878.00;38
4702;41;626477300;4702;328;5528;5564;7.01;0.44;248.01;4.72;826;41;1879.00;36
4703;41;626477310;4703;332;5532;5565;7.01;0.44;247.98;4.73;829;41;1880.00;33
4707;41;626477331;4707;340;5534;5566;6.95;0.43;247.99;4.73;827;41;1881.00;32
4710;41;626477342;4710;341;5538;5568;6.90;0.43;247.91;4.73;828;41;1882.00;30
4713;41;626477352;4713;342;5540;5569;6.81;0.42;248.07;4.73;827;41;1883.00;29
4717;41;626477363;4717;340;5545;5569;6.81;0.42;248.11;4.74;828;41;1884.00;24
4718;41;626477374;4718;342;5547;5569;6.75;0.42;248.10;4.74;829;41;1885.00;22
4721;41;626477385;4721;340;5551;5569;6.74;0.42;248.15;4.75;830;41;1886.00;18
4723;41;626477396;4723;344;5554;5573;6.73;0.42;248.10;4.75;831;41;1887.00;19
4725;41;626477407;4725;350;5556;5573;6.71;0.42;248.17;4.75;831;41;1888.00;17
4727;41;626477418;4727;348;5558;5573;6.67;0.41;248.20;4.75;831;41;1889.00;15
4730;41;626477431;4730;350;5561;5579;6.61;0.41;248.34;4.75;831;41;1890.00;18
4734;41;626477443;4734;337;5563;5579;6.57;0.41;248.27;4.75;829;41;1891.00;16
4738;41;626477454;4738;333;5563;5579;6.63;0.41;248.17;4.75;825;41;1892.00;16
4740;41;626477467;4740;322;5567;5583;6.77;0.42;248.17;4.74;827;41;1893.00;16
4741;41;626477479;4741;322;5569;5584;6.81;0.42;248.14;4.74;828;41;1894.00;15
4747;41;626477491;4747;317;5569;5584;6.87;0.42;248.08;4.74;822;41;1895.00;15
4749;41;626477504;4749;312;5572;5588;6.96;0.43;248.01;4.74;823;41;1896.00;16
4752;41;626477516;4752;314;5572;5588;7.05;0.43;248.05;4.74;820;41;1897.00;16
4754;41;626477528;4754;312;5572;5588;7.13;0.44;248.05;4.74;818;41;1898.00;16
4756;41;626477539;4756;311;5573;5589;7.25;0.45;248.04;4.74;817;41;1899.00;16
4759;41;626477553;4759;309;5574;5589;7.30;0.45;248.10;4.76;815;41;1900.00;15
4765;41;626477570;4765;314;5578;5595;7.29;0.45;247.98;4.75;813;41;1901.00;17
4770;41;626477585;4770;313;5578;5595;7.29;0.45;248.14;4.75;808;41;1902.00;17
4775;41;626477597;4775;319;5579;5596;7.37;0.45;248.23;4.75;804;41;1903.00;17
4783;41;626477610;4783;318;5579;5596;7.39;0.45;248.17;4.75;796;41;1904.00;17
4786;41;626477622;4786;319;5579;5596;7.50;0.46;248.21;4.75;793;41;1905.00;17
4788;41;626477634;4788;319;5579;5596;7.54;0.46;248.17;4.75;791;41;1906.00;17
4793;41;626477647;4793;319;5579;5596;7.56;0.46;248.18;4.75;786;41;1907.00;17
4795;41;626477659;4795;316;5588;5608;7.73;0.47;248.16;4.75;793;41;1908.00;20
4796;41;626477671;4796;318;5589;5608;7.81;0.47;248.19;4.75;793;41;1909.00;19
4797;41;626477682;4797;321;5590;5608;7.85;0.48;248.22;4.75;793;41;1910.00;18
4798;41;626477693;4798;321;5590;5608;7.86;0.48;248.21;4.75;792;41;1911.00;18
4799;41;626477710;4799;325;5590;5608;7.84;0.48;248.20;4.75;791;41;1912.00;18
4802;41;626477722;4802;333;5590;5608;7.80;0.47;248.15;4.75;788;41;1913.00;18
4805;41;626477733;4805;334;5593;5612;7.82;0.47;248.29;4.74;788;41;1914.00;19
4806;41;626477745;4806;339;5593;5612;7.80;0.47;248.28;4.74;787;41;1915.00;19
4809;41;626477756;4809;342;5596;5616;7.82;0.47;248.29;4.74;787;41;1916.00;20
4812;41;626477777;4812;331;5597;5617;7.76;0.47;248.37;4.74;785;41;1917.00;20
4815;41;626477789;4815;323;5598;5617;7.74;0.47;248.38;4.74;783;41;1918.00;19
4817;41;626477802;4817;318;5598;5617;7.74;0.47;248.39;4.74;781;41;1919.00;19
4817;41;626477815;4817;323;5619;5646;7.86;0.48;248.39;4.72;802;41;1920.00;27
4819;41;626477828;4819;325;5620;5646;7.87;0.48;248.41;4.72;801;41;1921.00;26
4820;41;626477840;4820;318;5621;5646;7.93;0.48;248.40;4.72;801;41;1922.00;25
4822;41;626477851;4822;318;5623;5647;7.94;0.48;248.48;4.72;801;41;1923.00;24
4823;41;626477862;4823;314;5624;5648;7.92;0.48;248.47;4.72;801;41;1924.00;24
4828;41;626477874;4828;315;5624;5648;7.90;0.48;248.49;4.72;796;41;1925.00;24
4830;41;626477885;4830;296;5627;5651;7.98;0.48;248.47;4.72;797;41;1926.00;24
4833;41;626477897;4833;279;5627;5651;8.01;0.49;248.47;4.72;794;41;1927.00;24
4834;41;626477908;4834;265;5627;5651;8.08;0.49;248.51;4.72;793;41;1928.00;24
4838;41;626477920;4838;261;5627;5651;8.11;0.49;248.45;4.72;789;41;1929.00;24
4840;41;626477931;4840;251;5631;5657;8.17;0.50;248.46;4.71;791;41;1930.00;26
4842;41;626477944;4842;255;5631;5657;8.22;0.50;248.46;4.71;789;41;1931.00;26
4845;42;626477955;4845;253;5632;5657;8.24;0.50;248.49;4.71;787;42;1932.00;25
4850;42;626477992;4850;251;5632;5657;8.27;0.50;248.51;4.71;782;42;1933.00;25
4851;42;626478005;4851;252;5635;5661;8.35;0.51;248.51;4.71;784;42;1934.00;26
4855;42;626478028;4855;254;5637;5663;8.44;0.52;248.55;4.71;782;42;1935.00;26
4858;42;626478042;4858;253;5637;5663;8.52;0.52;248.61;4.71;779;42;1936.00;26
4859;42;626478055;4859;248;5638;5664;8.59;0.52;248.62;4.71;779;42;1937.00;26
4864;42;626478068;4864;248;5638;5664;8.60;0.52;248.61;4.71;774;42;1938.00;26
4868;42;626478081;4868;243;5638;5664;8.58;0.52;248.68;4.71;770;42;1939.00;26
4869;42;626478093;4869;248;5638;5664;8.60;0.52;248.72;4.71;769;42;1940.00;26
4872;42;626478104;4872;241;5638;5664;8.61;0.52;248.78;4.71;766;42;1941.00;26
4875;42;626478116;4875;240;5638;5664;8.64;0.53;248.76;4.71;763;42;1942.00;26
4878;42;626478128;4878;238;5638;5664;8.70;0.53;248.83;4.71;760;42;1943.00;26
4883;42;626478139;4883;247;5680;5734;8.49;0.52;248.81;4.68;797;42;1944.00;54
4884;42;626478157;4884;238;5681;5735;8.48;0.52;248.82;4.70;797;42;1945.00;54
4888;42;626478168;4888;222;5686;5735;8.54;0.52;248.76;4.70;798;42;1946.00;49
4891;42;626478179;4891;216;5690;5735;8.68;0.53;248.73;4.70;799;42;1947.00;45
4892;42;626478189;4892;214;5695;5735;8.80;0.54;248.75;4.70;803;42;1948.00;40
4894;42;626478199;4894;214;5699;5735;8.84;0.54;248.75;4.70;805;42;1949.00;36
4895;42;626478211;4895;212;5702;5737;8.89;0.54;248.74;4.70;807;42;1950.00;35
4897;42;626478222;4897;217;5703;5737;8.93;0.54;248.75;4.70;806;42;1951.00;34
4898;42;626478237;4898;222;5706;5738;9.01;0.55;248.72;4.70;808;42;1952.00;32
4899;42;626478248;4899;226;5707;5739;9.08;0.55;248.76;4.70;808;42;1953.00;32
4901;42;626478259;4901;227;5708;5739;9.09;0.55;248.78;4.70;807;42;1954.00;31
4902;42;626478269;4902;232;5711;5743;9.03;0.55;248.80;4.69;809;42;1955.00;32
4902;42;626478280;4902;232;5712;5743;9.04;0.55;248.80;4.70;810;42;1956.00;31
4905;42;626478290;4905;239;5712;5743;9.04;0.55;248.90;4.70;807;42;1957.00;31
4905;42;626478300;4905;238;5712;5743;9.04;0.55;248.90;4.70;807;42;1958.00;31
4907;42;626478310;4907;240;5717;5749;9.02;0.55;248.88;4.69;810;42;1959.00;32
4908;42;626478321;4908;241;5717;5749;9.06;0.55;248.93;4.69;809;42;1960.00;32
4910;42;626478331;4910;236;5717;5749;9.09;0.55;248.95;4.69;807;42;1961.00;32
4913;42;626478342;4913;232;5720;5752;9.14;0.56;248.96;4.69;807;42;1962.00;32
4915;42;626478353;4915;230;5720;5752;9.18;0.56;248.95;4.69;805;42;1963.00;32
4916;42;626478363;4916;230;5720;5752;9.22;0.56;248.93;4.69;804;42;1964.00;32
4919;42;626478373;4919;222;5720;5753;9.19;0.56;248.99;4.69;801;42;1965.00;33
4922;42;626478383;4922;213;5721;5754;9.18;0.56;248.92;4.69;799;42;1966.00;33
4924;42;626478394;4924;208;5721;5754;9.15;0.56;248.95;4.69;797;42;1967.00;33
4931;42;626478405;4931;209;5730;5767;9.08;0.55;249.05;4.68;799;42;1968.00;37
4933;42;626478416;4933;204;5730;5767;9.05;0.55;249.06;4.68;797;42;1969.00;37
4935;42;626478426;4935;198;5730;5767;8.99;0.55;249.12;4.68;795;42;1970.00;37
4939;42;626478436;4939;197;5732;5768;8.93;0.54;249.18;4.71;793;42;1971.00;36
4945;42;626478446;4945;193;5732;5768;8.84;0.54;249.29;4.71;787;42;1972.00;36
4947;42;626478456;4947;177;5735;5772;8.85;0.54;249.32;4.71;788;42;1973.00;37
4950;42;626478467;4950;174;5737;5772;8.95;0.54;249.28;4.72;787;42;1974.00;35
4953;42;626478478;4953;164;5740;5776;8.97;0.54;249.34;4.72;787;42;1975.00;36
4956;42;626478489;4956;155;5741;5776;9.04;0.55;249.38;4.73;785;42;1976.00;35
4958;42;626478499;4958;155;5741;5776;9.18;0.56;249.44;4.73;783;42;1977.00;35
4962;42;626478509;4962;144;5741;5776;9.24;0.56;249.44;4.73;779;42;1978.00;35
4966;42;626478520;4966;138;5741;5776;9.28;0.56;249.52;4.73;775;42;1979.00;35
4969;42;626478532;4969;141;5761;5810;9.34;0.57;249.73;4.72;792;42;1980.00;49
4972;42;626478544;4972;131;5763;5810;9.35;0.57;249.70;4.75;791;42;1981.00;47
4974;42;626478554;4974;132;5764;5810;9.40;0.57;249.74;4.75;790;42;1982.00;46
4976;42;626478564;4976;126;5764;5810;9.33;0.57;249.79;4.75;788;42;1983.00;46
4978;42;626478573;4978;135;5765;5810;9.33;0.57;249.81;4.75;787;42;1984.00;45
4979;42;626478583;4979;131;5765;5810;9.40;0.57;249.85;4.75;786;42;1985.00;45
4982;42;626478593;4982;132;5766;5811;9.41;0.57;249.93;4.75;784;42;1986.00;45
4984;42;626478604;4984;131;5767;5811;9.46;0.58;249.96;4.75;783;42;1987.00;44
4987;42;626478614;4987;133;5770;5817;9.59;0.59;249.94;4.75;783;42;1988.00;47
4989;42;626478625;4989;132;5771;5818;9.67;0.59;249.93;4.75;782;42;1989.00;47
4993;42;626478635;4993;131;5773;5818;9.72;0.59;249.94;4.75;780;42;1990.00;45
4995;42;626478645;4995;137;5774;5818;9.66;0.59;249.98;4.75;779;42;1991.00;44
4997;42;626478655;4997;142;5776;5822;9.66;0.59;249.97;4.75;779;42;1992.00;46
5000;42;626478666;5000;153;5777;5822;9.63;0.59;250.00;4.75;777;42;1993.00;45
5003;42;626478676;5003;153;5777;5822;9.51;0.58;249.96;4.75;774;42;1994.00;45
5003;42;626478686;5003;161;5778;5823;9.53;0.58;249.96;4.75;775;42;1995.00;45
5009;43;626478696;5009;163;5783;5827;9.46;0.58;250.04;4.76;774;43;1996.00;44
5013;43;626478723;5013;165;5783;5827;9.50;0.58;250.06;4.76;770;43;1997.00;44
5015;43;626478733;5015;172;5786;5830;9.55;0.58;250.05;4.76;771;43;1998.00;44
5018;43;626478750;5018;179;5787;5830;9.58;0.58;250.11;4.76;769;43;1999.00;43
5020;43;626478761;5020;183;5789;5830;9.62;0.59;250.19;4.79;769;43;2000.00;41
5025;43;626478776;5025;190;5790;5830;9.64;0.59;250.30;4.79;765;43;2001.00;40
5027;43;626478786;5027;191;5794;5834;9.73;0.59;250.33;4.80;767;43;2002.00;40
5029;43;626478797;5029;194;5796;5834;9.73;0.59;250.37;4.82;767;43;2003.00;38
5032;43;626478807;5032;192;5798;5834;9.68;0.59;250.49;4.83;766;43;2004.00;36
5032;43;626478818;5032;195;5799;5834;9.67;0.59;250.49;4.85;767;43;2005.00;35
5033;43;626478829;5033;200;5801;5835;9.61;0.58;250.55;4.86;768;43;2006.00;34
5035;43;626478839;5035;206;5803;5836;9.61;0.58;250.53;4.87;768;43;2007.00;33
5037;43;626478850;5037;209;5805;5836;9.58;0.58;250.52;4.89;768;43;2008.00;31
5039;43;626478860;5039;212;5806;5837;9.58;0.58;250.54;4.89;767;43;2009.00;31
5042;43;626478872;5042;217;5807;5837;9.52;0.58;250.52;4.90;765;43;2010.00;30
5045;43;626478882;5045;223;5808;5837;9.45;0.57;250.57;4.91;763;43;2011.00;29
5047;43;626478892;5047;226;5808;5837;9.37;0.57;250.53;4.91;761;43;2012.00;29
5051;43;626478901;5051;231;5810;5837;9.24;0.56;250.56;4.92;759;43;2013.00;27
5052;43;626478911;5052;232;5810;5837;9.16;0.56;250.55;4.92;758;43;2014.00;27
5054;43;626478920;5054;234;5812;5837;9.06;0.55;250.51;4.94;758;43;2015.00;25
5057;43;626478929;5057;254;5877;5964;9.10;0.56;250.44;4.89;820;43;2016.00;87
5060;43;626478948;5060;254;5878;5965;8.96;0.55;250.39;4.89;818;43;2017.00;87
5063;43;626478958;5063;257;5890;5965;8.94;0.55;250.28;4.90;827;43;2018.00;75
5065;43;626478969;5065;254;5897;5965;8.84;0.55;250.22;4.91;832;43;2019.00;68
5068;43;626478978;5068;258;5904;5965;8.70;0.54;250.17;4.91;836;43;2020.00;61
5071;43;626478988;5071;253;5911;5965;8.54;0.53;250.15;4.91;840;43;2021.00;54
5071;43;626478997;5071;251;5918;5965;8.46;0.52;250.15;4.92;847;43;2022.00;47
5072;43;626479006;5072;255;5922;5965;8.37;0.52;250.13;4.92;850;43;2023.00;43
5075;43;626479019;5075;257;5926;5966;8.36;0.51;250.09;4.93;851;43;2024.00;40
5077;43;626479049;5077;260;5929;5968;8.33;0.51;250.16;4.93;852;43;2025.00;39
5080;43;626479065;5080;265;5931;5968;8.26;0.51;250.11;4.93;851;43;2026.00;37
5081;43;626479080;5081;272;5935;5969;8.22;0.50;250.08;4.95;854;43;2027.00;34
5083;43;626479097;5083;273;5937;5969;8.16;0.50;250.03;4.95;854;43;2028.00;32
5083;43;626479111;5083;285;5939;5969;8.12;0.50;250.03;4.96;856;43;2029.00;30
5083;43;626479126;5083;296;5941;5969;8.09;0.50;250.03;4.96;858;43;2030.00;28
5084;43;626479137;5084;304;5944;5973;8.02;0.49;250.03;4.96;860;43;2031.00;29
5087;43;626479149;5087;316;5946;5973;7.84;0.48;250.09;4.96;859;43;2032.00;27
5092;43;626479160;5092;322;5949;5973;7.60;0.47;250.06;4.97;857;43;2033.00;24
5094;43;626479170;5094;326;5953;5976;7.47;0.46;250.06;4.97;859;43;2034.00;23
5094;43;626479181;5094;334;5956;5976;7.32;0.45;250.06;4.97;862;43;2035.00;20
5097;43;626479192;5097;342;5957;5976;7.10;0.44;250.00;4.97;860;43;2036.00;19
5099;43;626479202;5099;347;5960;5980;6.99;0.43;249.99;4.97;861;43;2037.00;20
5102;43;626479213;5102;354;5963;5981;6.85;0.42;249.93;4.97;861;43;2038.00;18
5105;43;626479226;5105;359;5963;5981;6.65;0.41;249.89;4.97;858;43;2039.00;18
5107;43;626479238;5107;355;5969;5986;6.56;0.40;249.89;4.97;862;43;2040.00;17
5110;43;626479249;5110;350;5969;5986;6.47;0.40;249.86;4.97;859;43;2041.00;17
5113;43;626479259;5113;353;5969;5986;6.36;0.39;249.84;4.97;856;43;2042.00;17
5118;43;626479269;5118;340;5970;5987;6.28;0.39;249.83;4.97;852;43;2043.00;17
5121;43;626479279;5121;331;5970;5987;6.25;0.38;249.87;4.97;849;43;2044.00;17
5123;43;626479289;5123;335;5975;5993;6.34;0.39;249.87;4.96;852;43;2045.00;18
5126;43;626479301;5126;333;5976;5993;6.39;0.39;249.89;4.96;850;43;2046.00;17
5129;43;626479312;5129;322;5977;5994;6.47;0.40;249.93;4.96;848;43;2047.00;17
5131;43;626479322;5131;317;5977;5994;6.54;0.40;249.94;4.96;846;43;2048.00;17
5134;43;626479333;5134;308;5977;5994;6.63;0.40;249.98;4.96;843;43;2049.00;17
5135;43;626479343;5135;297;5977;5994;6.74;0.41;249.93;4.96;842;43;2050.00;17
5138;43;626479353;5138;297;5977;5994;6.79;0.42;250.00;4.96;839;43;2051.00;17
5141;43;626479364;5141;291;5987;6006;6.93;0.42;250.00;4.95;846;43;2052.00;19
5143;43;626479376;5143;293;5987;6006;7.00;0.43;249.99;4.95;844;43;2053.00;19
5145;43;626479394;5145;294;5989;6006;7.14;0.44;250.02;4.95;844;43;2054.00;17
5147;43;626479411;5147;294;5989;6006;7.24;0.44;250.01;4.95;842;43;2055.00;17
5150;43;626479422;5150;292;5989;6006;7.34;0.45;249.99;4.95;839;43;2056.00;17
5153;43;626479432;5153;290;5989;6006;7.41;0.45;250.01;4.95;836;43;2057.00;17
5155;43;626479444;5155;285;5993;6010;7.47;0.46;250.08;4.95;838;43;2058.00;17
5158;43;626479455;5158;286;5993;6010;7.45;0.45;250.07;4.95;835;43;2059.00;17
5160;43;626479467;5160;282;5996;6014;7.50;0.46;250.12;4.95;836;43;2060.00;18
5162;43;626479480;5162;284;5997;6015;7.57;0.46;250.07;4.95;835;43;2061.00;18
5166;43;626479491;5166;290;5998;6015;7.59;0.46;250.09;4.95;832;43;2062.00;17
5167;43;626479502;5167;291;5998;6015;7.61;0.46;250.15;4.95;831;43;2063.00;17
5172;43;626479513;5172;289;6010;6028;7.71;0.47;250.23;4.94;838;43;2064.00;18
5176;43;626479526;5176;288;6010;6028;7.73;0.47;250.21;4.94;834;43;2065.00;18
5179;43;626479538;5179;287;6011;6028;7.74;0.47;250.21;4.94;832;43;2066.00;17
5183;43;626479550;5183;283;6013;6029;7.78;0.47;250.22;4.98;830;43;2067.00;16
5186;43;626479562;5186;286;6013;6030;7.80;0.48;250.25;4.98;827;43;2068.00;17
5191;43;626479574;5191;286;6013;6030;7.76;0.47;250.24;4.98;822;43;2069.00;17
5197;43;626479587;5197;281;6016;6036;7.78;0.47;250.40;4.98;819;43;2070.00;20
5201;44;626479599;5201;285;6016;6036;7.74;0.47;250.47;4.98;815;44;2071.00;20
5205;44;626479628;5205;282;6017;6036;7.82;0.48;250.53;4.98;812;44;2072.00;19
5209;44;626479640;5209;283;6017;6036;7.88;0.48;250.63;4.98;808;44;2073.00;19
5212;44;626479658;5212;278;6021;6042;8.04;0.49;250.70;4.98;809;44;2074.00;21
5218;44;626479669;5218;280;6021;6042;8.08;0.49;250.63;4.98;803;44;2075.00;21
5223;44;626479681;5223;280;6022;6042;8.11;0.49;250.77;4.98;799;44;2076.00;20
5227;44;626479693;5227;277;6022;6042;8.14;0.50;250.86;4.98;795;44;2077.00;20
5233;44;626479704;5233;281;6026;6046;8.21;0.50;250.83;4.97;793;44;2078.00;20
5238;44;626479717;5238;278;6027;6047;8.27;0.50;250.83;4.97;789;44;2079.00;20
5244;44;626479728;5244;278;6028;6047;8.35;0.51;250.97;4.97;784;44;2080.00;19
5248;44;626479739;5248;276;6029;6048;8.31;0.51;251.06;4.97;781;44;2081.00;19
5251;44;626479751;5251;279;6030;6048;8.26;0.50;251.12;5.02;779;44;2082.00;18
5254;44;626479762;5254;282;6030;6048;8.18;0.50;251.12;5.02;776;44;2083.00;18
5257;44;626479774;5257;283;6030;6048;8.10;0.49;251.15;5.02;773;44;2084.00;18
5263;44;626479785;5263;287;6030;6048;7.96;0.48;251.20;5.02;767;44;2085.00;18
5266;44;626479797;5266;286;6031;6048;7.94;0.48;251.21;5.06;765;44;2086.00;17
5270;44;626479808;5270;282;6031;6048;7.87;0.48;251.24;5.06;761;44;2087.00;17
5273;44;626479821;5273;285;6073;6118;7.88;0.48;251.21;5.08;800;44;2088.00;45
5275;44;626479838;5275;277;6074;6119;7.93;0.48;251.26;5.08;799;44;2089.00;45
5278;44;626479851;5278;268;6081;6119;8.09;0.49;251.31;5.12;803;44;2090.00;38
5279;44;626479862;5279;267;6082;6119;8.25;0.50;251.30;5.12;803;44;2091.00;37
5282;44;626479874;5282;266;6087;6119;8.36;0.51;251.34;5.17;805;44;2092.00;32
5285;44;626479887;5285;269;6092;6119;8.46;0.51;251.50;5.17;807;44;2093.00;27
5288;44;626479899;5288;268;6096;6119;8.43;0.51;251.55;5.17;808;44;2094.00;23
5289;44;626479915;5289;271;6099;6119;8.44;0.51;251.54;5.22;810;44;2095.00;20
5289;44;626479927;5289;257;6101;6120;8.47;0.51;251.54;5.21;812;44;2096.00;19
5292;44;626479940;5292;245;6103;6121;8.47;0.52;251.67;5.21;811;44;2097.00;18
5296;44;626479952;5296;239;6104;6121;8.40;0.51;251.76;5.25;808;44;2098.00;17
5300;44;626479976;5300;234;6107;6125;8.41;0.51;251.74;5.25;807;44;2099.00;18
5302;44;626479993;5302;234;6111;6140;8.38;0.51;251.77;5.25;809;44;2100.00;29
5304;44;626480013;5304;239;6111;6140;8.44;0.51;251.77;5.25;807;44;2101.00;29
5307;44;626480027;5307;234;6111;6140;8.47;0.51;251.77;5.25;804;44;2102.00;29
5312;44;626480039;5312;228;6114;6146;8.52;0.52;251.79;5.24;802;44;2103.00;32
5315;44;626480052;5315;228;6115;6146;8.60;0.52;251.86;5.28;800;44;2104.00;31
5316;44;626480064;5316;223;6115;6146;8.71;0.53;251.88;5.28;799;44;2105.00;31
5320;45;626480081;5320;221;6119;6149;8.81;0.53;251.89;5.28;799;45;2106.00;30
5321;45;626480099;5321;212;6119;6149;8.91;0.54;251.90;5.28;798;45;2107.00;30
5323;45;626480111;5323;207;6119;6149;9.03;0.55;252.01;5.28;796;45;2108.00;30
5328;45;626480122;5328;194;6119;6150;9.09;0.55;251.97;5.28;791;45;2109.00;31
5331;45;626480135;5331;195;6120;6151;9.16;0.56;251.91;5.28;789;45;2110.00;31
5331;45;626480152;5331;194;6122;6151;9.20;0.56;251.91;5.28;791;45;2111.00;29
5335;45;626480165;5335;190;6131;6164;9.23;0.56;252.02;5.27;796;45;2112.00;33
5336;45;626480178;5336;182;6131;6164;9.31;0.56;252.02;5.27;795;45;2113.00;33
5337;45;626480196;5337;182;6131;6164;9.32;0.57;252.02;5.27;794;45;2114.00;33
5339;45;626480207;5339;185;6133;6166;9.32;0.57;252.04;5.27;794;45;2115.00;33
5339;46;626480219;5339;185;6133;6166;9.36;0.57;252.04;5.27;794;46;2116.00;33
5342;46;626480240;5342;190;6137;6170;9.29;0.57;252.01;5.27;795;46;2117.00;33
5342;46;626480252;5342;190;6137;6170;9.32;0.57;252.01;5.27;795;46;2118.00;33
5345;46;626480263;5345;199;6140;6174;9.41;0.57;252.09;5.27;795;46;2119.00;34
5346;46;626480275;5346;199;6140;6174;9.52;0.58;252.10;5.27;794;46;2120.00;34
5349;46;626480286;5349;201;6140;6174;9.61;0.59;252.12;5.27;791;46;2121.00;34
5351;46;626480297;5351;210;6141;6174;9.72;0.59;252.12;5.27;790;46;2122.00;33
5356;46;626480307;5356;204;6142;6174;9.67;0.59;252.15;5.28;786;46;2123.00;32
5359;46;626480318;5359;204;6151;6186;9.64;0.59;252.15;5.27;792;46;2124.00;35
5363;46;626480330;5363;211;6152;6186;9.63;0.59;252.14;5.27;789;46;2125.00;34
5364;46;626480341;5364;211;6153;6186;9.60;0.58;252.13;5.27;789;46;2126.00;33
5367;46;626480352;5367;218;6154;6186;9.55;0.58;252.13;5.28;787;46;2127.00;32
5369;46;626480369;5369;216;6155;6186;9.51;0.58;252.10;5.28;786;46;2128.00;31
5370;46;626480379;5370;218;6157;6186;9.57;0.58;252.07;5.28;787;46;2129.00;29
5371;46;626480391;5371;220;6158;6187;9.58;0.58;252.07;5.29;787;46;2130.00;29
5371;46;626480402;5371;215;6160;6187;9.61;0.59;252.07;5.29;789;46;2131.00;27
5372;46;626480412;5372;211;6163;6193;9.65;0.59;252.08;5.29;791;46;2132.00;30
5375;46;626480423;5375;203;6166;6194;9.68;0.59;252.07;5.32;791;46;2133.00;28
5378;46;626480434;5378;196;6166;6194;9.59;0.58;252.06;5.32;788;46;2134.00;28
5380;46;626480445;5380;196;6167;6194;9.51;0.58;252.12;5.32;787;46;2135.00;27
5385;46;626480456;5385;199;6170;6198;9.41;0.57;252.08;5.32;785;46;2136.00;28
5387;46;626480467;5387;192;6170;6198;9.37;0.57;252.16;5.32;783;46;2137.00;28
5389;46;626480478;5389;187;6171;6198;9.37;0.57;252.20;5.32;782;46;2138.00;27
5390;46;626480488;5390;182;6172;6199;9.42;0.57;252.21;5.32;782;46;2139.00;27
5393;46;626480498;5393;181;6175;6203;9.37;0.57;252.24;5.31;782;46;2140.00;28
5395;46;626480508;5395;176;6175;6203;9.38;0.57;252.30;5.31;780;46;2141.00;28
5399;46;626480518;5399;178;6178;6206;9.39;0.57;252.44;5.31;779;46;2142.00;28
5402;46;626480529;5402;171;6178;6206;9.32;0.57;252.52;5.31;776;46;2143.00;28
5406;46;626480538;5406;173;6178;6206;9.29;0.56;252.57;5.31;772;46;2144.00;28
5409;46;626480548;5409;164;6180;6206;9.32;0.57;252.58;5.33;771;46;2145.00;26
5414;47;626480559;5414;165;6183;6210;9.31;0.57;252.58;5.33;769;47;2146.00;27
5420;47;626480580;5420;174;6183;6210;9.28;0.56;252.55;5.33;763;47;2147.00;27
5424;47;626480590;5424;170;6184;6210;9.18;0.56;252.52;5.33;760;47;2148.00;26
5427;47;626480606;5427;165;6184;6210;9.19;0.56;252.49;5.33;757;47;2149.00;26
5431;47;626480615;5431;162;6185;6211;9.12;0.55;252.56;5.39;754;47;2150.00;26
5433;47;626480625;5433;162;6186;6212;9.07;0.55;252.52;5.39;753;47;2151.00;26
5434;47;626480635;5434;160;6187;6212;9.05;0.55;252.51;5.42;753;47;2152.00;25
5435;47;626480645;5435;165;6188;6213;9.03;0.55;252.47;5.42;753;47;2153.00;25
5435;47;626480655;5435;169;6188;6213;9.03;0.55;252.47;5.42;753;47;2154.00;25
5438;47;626480664;5438;172;6189;6213;8.98;0.55;252.42;5.45;751;47;2155.00;24
5439;47;626480674;5439;174;6189;6213;8.98;0.55;252.45;5.45;750;47;2156.00;24
5440;47;626480684;5440;176;6189;6213;8.92;0.54;252.47;5.45;749;47;2157.00;24
5443;47;626480693;5443;175;6189;6213;8.95;0.54;252.43;5.45;746;47;2158.00;24
5446;47;626480702;5446;179;6190;6213;8.97;0.54;252.35;5.48;744;47;2159.00;23
5451;47;626480714;5451;215;6288;6443;8.99;0.56;252.29;5.40;837;47;2160.00;155
5452;47;626480753;5452;212;6289;6444;8.96;0.56;252.29;5.40;837;47;2161.00;155
5453;47;626480764;5453;201;6298;6444;8.97;0.56;252.25;5.39;845;47;2162.00;146
5455;47;626480774;5455;200;6304;6444;8.89;0.55;252.27;5.39;849;47;2163.00;140
5456;47;626480784;5456;201;6313;6444;8.86;0.55;252.26;5.39;857;47;2164.00;131
5457;47;626480794;5457;200;6320;6444;8.83;0.55;252.28;5.39;863;47;2165.00;124
5459;47;626480804;5459;201;6327;6444;8.76;0.54;252.28;5.39;868;47;2166.00;117
5462;47;626480814;5462;207;6330;6444;8.81;0.55;252.26;5.39;868;47;2167.00;114
5465;47;626480830;5465;214;6337;6445;8.85;0.55;252.19;5.39;872;47;2168.00;108
5470;47;626480841;5470;220;6340;6446;8.81;0.55;252.11;5.41;870;47;2169.00;106
5471;47;626480857;5471;215;6344;6446;8.82;0.55;252.07;5.41;873;47;2170.00;102
5473;47;626480867;5473;226;6349;6447;8.78;0.54;252.05;5.43;876;47;2171.00;98
5473;47;626480878;5473;230;6357;6447;8.71;0.54;252.05;5.45;884;47;2172.00;90
5474;47;626480889;5474;231;6362;6447;8.69;0.54;252.05;5.46;888;47;2173.00;85
5477;47;626480899;5477;234;6367;6447;8.61;0.53;251.98;5.48;890;47;2174.00;80
5479;47;626480910;5479;243;6371;6451;8.52;0.53;251.95;5.48;892;47;2175.00;80
5484;47;626480922;5484;251;6374;6451;8.35;0.52;251.89;5.49;890;47;2176.00;77
5486;47;626480934;5486;250;6379;6451;8.33;0.51;251.88;5.51;893;47;2177.00;72
5487;47;626480945;5487;258;6382;6454;8.32;0.51;251.85;5.52;895;47;2178.00;72
5488;47;626480956;5488;267;6385;6454;8.27;0.51;251.84;5.53;897;47;2179.00;69
5489;47;626480966;5489;274;6389;6454;8.21;0.51;251.85;5.55;900;47;2180.00;65
5489;47;626480977;5489;284;6395;6458;8.17;0.50;251.85;5.55;906;47;2181.00;63
5491;47;626480987;5491;291;6397;6459;8.15;0.50;251.79;5.56;906;47;2182.00;62
5493;47;626480998;5493;292;6402;6459;8.09;0.50;251.73;5.58;909;47;2183.00;57
5497;47;626481009;5497;298;6406;6463;8.03;0.49;251.64;5.59;909;47;2184.00;57
5498;47;626481024;5498;305;6408;6463;7.91;0.49;251.63;5.59;910;47;2185.00;55
5500;47;626481039;5500;318;6414;6463;7.80;0.48;251.61;5.65;914;47;2186.00;49
5501;47;626481057;5501;324;6417;6464;7.67;0.47;251.58;5.65;916;47;2187.00;47
5503;47;626481075;5503;337;6418;6464;7.53;0.46;251.65;5.66;915;47;2188.00;46
5504;47;626481093;5504;337;6425;6470;7.42;0.46;251.66;5.67;921;47;2189.00;45
5506;47;626481119;5506;342;6426;6470;7.29;0.45;251.63;5.68;920;47;2190.00;44
5507;47;626481134;5507;344;6430;6471;7.18;0.44;251.62;5.69;923;47;2191.00;41
5509;47;626481147;5509;348;6431;6471;7.07;0.43;251.56;5.70;922;47;2192.00;40
5512;47;626481164;5512;353;6433;6471;7.02;0.43;251.54;5.70;921;47;2193.00;38
5515;47;626481176;5515;355;6436;6471;6.91;0.42;251.50;5.71;921;47;2194.00;35
5515;47;626481187;5515;354;6438;6471;6.92;0.42;251.50;5.72;923;47;2195.00;33
5517;47;626481201;5517;341;6448;6483;6.96;0.43;251.49;5.71;931;47;2196.00;35
5519;47;626481215;5519;343;6450;6483;6.97;0.43;251.44;5.72;931;47;2197.00;33
5521;47;626481227;5521;341;6452;6483;7.02;0.43;251.42;5.72;931;47;2198.00;31
5523;47;626481240;5523;343;6455;6483;7.06;0.43;251.42;5.73;932;47;2199.00;28
5524;47;626481252;5524;344;6456;6483;7.06;0.43;251.46;5.73;932;47;2200.00;27
5527;47;626481268;5527;336;6456;6483;7.05;0.43;251.41;5.73;929;47;2201.00;27
5528;47;626481286;5528;341;6460;6487;7.07;0.43;251.40;5.73;932;47;2202.00;27
5529;47;626481297;5529;338;6461;6487;7.12;0.43;251.41;5.74;932;47;2203.00;26
5533;47;626481308;5533;343;6465;6491;7.17;0.44;251.47;5.73;932;47;2204.00;26
5538;47;626481319;5538;336;6468;6493;7.12;0.43;251.41;5.74;930;47;2205.00;25
5540;47;626481331;5540;337;6468;6493;7.10;0.43;251.38;5.74;928;47;2206.00;25
5542;47;626481343;5542;341;6471;6493;7.05;0.43;251.41;5.75;929;47;2207.00;22
5546;47;626481359;5546;343;6481;6506;6.97;0.43;251.45;5.74;935;47;2208.00;25
5550;47;626481371;5550;342;6481;6506;6.86;0.42;251.45;5.74;931;47;2209.00;25
5550;47;626481382;5550;331;6485;6508;6.82;0.42;251.45;5.74;935;47;2210.00;23
5554;47;626481394;5554;320;6486;6509;6.73;0.41;251.50;5.73;932;47;2211.00;23
5555;47;626481405;5555;318;6487;6510;6.69;0.41;251.52;5.74;932;47;2212.00;23
5557;47;626481416;5557;326;6489;6510;6.66;0.41;251.52;5.74;932;47;2213.00;21
5559;47;626481427;5559;322;6491;6513;6.69;0.41;251.57;5.73;932;47;2214.00;22
5560;47;626481444;5560;316;6492;6513;6.70;0.41;251.59;5.73;932;47;2215.00;21
5564;47;626481462;5564;317;6492;6513;6.73;0.41;251.62;5.73;928;47;2216.00;21
5567;47;626481475;5567;308;6493;6513;6.75;0.41;251.67;5.73;926;47;2217.00;20
5570;47;626481486;5570;305;6497;6519;6.79;0.42;251.70;5.73;927;47;2218.00;22
5571;47;626481498;5571;303;6498;6519;6.88;0.42;251.74;5.73;927;47;2219.00;21
5576;47;626481511;5576;297;6498;6519;6.90;0.42;251.84;5.73;922;47;2220.00;21
5579;47;626481523;5579;294;6498;6519;6.98;0.43;251.86;5.73;919;47;2221.00;21
5582;47;626481534;5582;282;6502;6523;7.06;0.43;251.97;5.76;920;47;2222.00;21
5586;47;626481546;5586;274;6503;6524;7.12;0.43;251.98;5.76;917;47;2223.00;21
5589;47;626481558;5589;276;6503;6524;7.22;0.44;252.11;5.76;914;47;2224.00;21
5595;47;626481571;5595;268;6504;6525;7.27;0.44;252.06;5.76;909;47;2225.00;21
5598;47;626481584;5598;272;6504;6525;7.36;0.45;252.07;5.76;906;47;2226.00;21
5603;47;626481596;5603;267;6504;6525;7.44;0.45;252.18;5.76;901;47;2227.00;21
5609;47;626481608;5609;271;6504;6525;7.49;0.46;252.16;5.76;895;47;2228.00;21
5612;47;626481620;5612;274;6504;6525;7.59;0.46;252.27;5.76;892;47;2229.00;21
5615;47;626481631;5615;273;6504;6525;7.62;0.46;252.31;5.76;889;47;2230.00;21
5617;47;626481643;5617;270;6504;6525;7.70;0.47;252.34;5.76;887;47;2231.00;21
5622;47;626481656;5622;272;6543;6595;7.82;0.48;252.38;5.73;921;47;2232.00;52
5624;47;626481674;5624;270;6545;6596;7.85;0.48;252.31;5.73;921;47;2233.00;51
5627;47;626481686;5627;270;6553;6596;7.90;0.48;252.45;5.72;926;47;2234.00;43
5631;47;626481699;5631;264;6557;6596;7.93;0.49;252.53;5.72;926;47;2235.00;39
5634;47;626481712;5634;264;6561;6596;7.97;0.49;252.60;5.72;927;47;2236.00;35
5639;47;626481724;5639;266;6566;6596;7.98;0.49;252.75;5.72;927;47;2237.00;30
5643;47;626481737;5643;267;6567;6596;8.05;0.49;252.79;5.72;924;47;2238.00;29
5646;47;626481750;5646;270;6569;6596;8.15;0.50;252.81;5.72;923;47;2239.00;27
5651;47;626481763;5651;270;6570;6597;8.17;0.50;252.86;5.72;919;47;2240.00;27
5656;47;626481778;5656;269;6572;6598;8.21;0.50;252.98;5.72;916;47;2241.00;26
5658;47;626481791;5658;270;6572;6598;8.20;0.50;252.99;5.72;914;47;2242.00;26
5665;47;626481804;5665;273;6575;6602;8.16;0.50;253.27;5.72;910;47;2243.00;27
5670;47;626481818;5670;281;6575;6602;8.17;0.50;253.27;5.72;905;47;2244.00;27
5673;47;626481831;5673;282;6575;6602;8.20;0.50;253.36;5.72;902;47;2245.00;27
5679;47;626481845;5679;288;6575;6602;8.19;0.50;253.52;5.72;896;47;2246.00;27
5683;47;626481859;5683;293;6579;6608;8.21;0.50;253.53;5.71;896;47;2247.00;29
5687;47;626481873;5687;296;6579;6608;8.25;0.50;253.63;5.71;892;47;2248.00;29
5693;47;626481886;5693;295;6580;6608;8.22;0.50;253.69;5.71;887;47;2249.00;28
5697;47;626481900;5697;300;6583;6614;8.22;0.50;253.71;5.71;886;47;2250.00;31
5701;47;626481914;5701;301;6584;6614;8.14;0.50;253.84;5.71;883;47;2251.00;30
5706;47;626481927;5706;311;6584;6614;8.06;0.49;253.87;5.71;878;47;2252.00;30
5709;47;626481940;5709;312;6585;6615;8.01;0.49;253.88;5.71;876;47;2253.00;30
5711;47;626481953;5711;309;6587;6616;7.99;0.49;253.88;5.71;876;47;2254.00;29
5718;47;626481965;5718;312;6587;6616;7.85;0.48;253.95;5.71;869;47;2255.00;29
5721;47;626481978;5721;320;6598;6629;7.90;0.48;254.00;5.70;877;47;2256.00;31
5724;47;626481992;5724;310;6598;6629;7.88;0.48;253.99;5.70;874;47;2257.00;31
5728;47;626482005;5728;300;6598;6629;7.89;0.48;254.17;5.70;870;47;2258.00;31
5736;47;626482024;5736;297;6599;6630;7.90;0.48;254.29;5.70;863;47;2259.00;31
5740;47;626482039;5740;294;6599;6630;7.94;0.49;254.33;5.70;859;47;2260.00;31
5746;47;626482052;5746;294;6602;6634;7.97;0.49;254.29;5.70;856;47;2261.00;32
5748;47;626482074;5748;292;6602;6634;7.93;0.49;254.30;5.70;854;47;2262.00;32
5753;47;626482086;5753;288;6606;6638;7.99;0.49;254.29;5.69;853;47;2263.00;32
5756;48;626482100;5756;287;6606;6638;7.98;0.49;254.33;5.69;850;48;2264.00;32
5761;48;626482124;5761;289;6606;6638;8.01;0.49;254.32;5.69;845;48;2265.00;32
5762;48;626482141;5762;279;6606;6638;8.10;0.49;254.37;5.69;844;48;2266.00;32
5766;48;626482153;5766;266;6606;6638;8.17;0.50;254.37;5.69;840;48;2267.00;32
5771;48;626482165;5771;262;6616;6650;8.24;0.50;254.46;5.68;845;48;2268.00;34
5774;48;626482178;5774;253;6617;6650;8.32;0.51;254.44;5.68;843;48;2269.00;33
5775;48;626482196;5775;254;6617;6650;8.46;0.51;254.42;5.68;842;48;2270.00;33
5777;48;626482209;5777;246;6617;6650;8.50;0.52;254.46;5.68;840;48;2271.00;33
5781;48;626482227;5781;242;6617;6650;8.63;0.52;254.48;5.68;836;48;2272.00;33
5783;48;626482239;5783;237;6617;6650;8.71;0.53;254.54;5.68;834;48;2273.00;33
5785;48;626482252;5785;238;6618;6651;8.71;0.53;254.55;5.72;833;48;2274.00;33
5789;48;626482264;5789;236;6618;6651;8.72;0.53;254.59;5.72;829;48;2275.00;33
5792;48;626482277;5792;245;6622;6657;8.71;0.53;254.64;5.72;830;48;2276.00;35
5795;48;626482290;5795;234;6623;6658;8.65;0.53;254.60;5.72;828;48;2277.00;35
5796;48;626482302;5796;225;6624;6658;8.69;0.53;254.59;5.72;828;48;2278.00;34
5799;48;626482315;5799;220;6624;6658;8.68;0.53;254.68;5.72;825;48;2279.00;34
5800;48;626482328;5800;214;6628;6663;8.70;0.53;254.66;5.71;828;48;2280.00;35
5803;48;626482340;5803;208;6628;6663;8.74;0.53;254.73;5.71;825;48;2281.00;35
5805;48;626482352;5805;209;6628;6663;8.78;0.53;254.71;5.71;823;48;2282.00;35
5808;48;626482363;5808;204;6629;6664;8.84;0.54;254.73;5.71;821;48;2283.00;35
5810;48;626482374;5810;201;6632;6668;8.89;0.54;254.70;5.71;822;48;2284.00;36
5812;48;626482386;5812;198;6632;6668;8.91;0.54;254.74;5.71;820;48;2285.00;36
5814;48;626482398;5814;196;6634;6671;8.97;0.54;254.73;5.71;820;48;2286.00;37
5815;48;626482409;5815;191;6634;6671;8.92;0.54;254.73;5.71;819;48;2287.00;37
5818;48;626482426;5818;190;6635;6671;8.95;0.54;254.74;5.71;817;48;2288.00;36
5819;48;626482437;5819;185;6635;6671;8.93;0.54;254.72;5.71;816;48;2289.00;36
5821;48;626482448;5821;182;6638;6675;8.96;0.55;254.75;5.71;817;48;2290.00;37
5822;48;626482460;5822;185;6639;6675;8.93;0.54;254.74;5.75;817;48;2291.00;36
5823;48;626482471;5823;184;6640;6675;9.02;0.55;254.72;5.75;817;48;2292.00;35
5824;48;626482481;5824;185;6640;6675;9.11;0.56;254.69;5.75;816;48;2293.00;35
5826;48;626482493;5826;198;6640;6676;9.14;0.56;254.66;5.75;814;48;2294.00;36
5828;48;626482504;5828;199;6642;6678;9.13;0.56;254.62;5.74;814;48;2295.00;36
5829;48;626482514;5829;205;6642;6678;9.08;0.55;254.61;5.74;813;48;2296.00;36
5830;48;626482525;5830;204;6643;6679;9.01;0.55;254.60;5.74;813;48;2297.00;36
5831;48;626482536;5831;210;6643;6679;8.84;0.54;254.63;5.74;812;48;2298.00;36
5833;48;626482552;5833;212;6644;6679;8.66;0.53;254.62;5.78;811;48;2299.00;35
5838;48;626482563;5838;207;6644;6679;8.52;0.52;254.64;5.78;806;48;2300.00;35
5839;48;626482577;5839;210;6644;6679;8.47;0.52;254.65;5.78;805;48;2301.00;35
5840;48;626482587;5840;210;6645;6679;8.44;0.51;254.65;5.80;805;48;2302.00;34
5840;48;626482598;5840;209;6645;6679;8.47;0.52;254.65;5.80;805;48;2303.00;34
5843;48;626482613;5843;234;6718;6806;8.39;0.52;254.72;5.75;875;48;2304.00;88
5845;48;626482634;5845;223;6718;6807;8.41;0.52;254.81;5.75;873;48;2305.00;89
5847;48;626482645;5847;211;6726;6807;8.57;0.53;254.81;5.75;879;48;2306.00;81
5850;48;626482656;5850;206;6727;6807;8.60;0.53;254.89;5.75;877;48;2307.00;80
5855;48;626482667;5855;202;6735;6807;8.58;0.53;254.91;5.77;880;48;2308.00;72
5857;48;626482678;5857;199;6738;6807;8.58;0.53;254.92;5.77;881;48;2309.00;69
5860;48;626482691;5860;195;6744;6807;8.58;0.53;254.92;5.79;884;48;2310.00;63
5862;48;626482713;5862;191;6746;6807;8.60;0.53;254.91;5.79;884;48;2311.00;61
5864;48;626482724;5864;191;6749;6808;8.59;0.53;254.93;5.79;885;48;2312.00;59
5871;48;626482734;5871;192;6755;6809;8.57;0.53;255.00;5.82;884;48;2313.00;54
5877;48;626482745;5877;193;6759;6809;8.55;0.52;254.99;5.82;882;48;2314.00;50
5881;48;626482756;5881;198;6762;6810;8.51;0.52;254.96;5.83;881;48;2315.00;48
5886;48;626482768;5886;194;6765;6810;8.43;0.52;254.86;5.85;879;48;2316.00;45
5890;48;626482779;5890;197;6766;6810;8.29;0.51;254.81;5.85;876;48;2317.00;44
5895;48;626482790;5895;196;6769;6810;8.13;0.50;254.74;5.89;874;48;2318.00;41
5898;48;626482800;5898;201;6771;6814;8.01;0.49;254.68;5.90;873;48;2319.00;43
5899;48;626482811;5899;206;6773;6814;7.94;0.49;254.66;5.90;874;48;2320.00;41
5901;48;626482821;5901;210;6774;6814;7.86;0.48;254.63;5.90;873;48;2321.00;40
5902;48;626482831;5902;217;6777;6817;7.77;0.47;254.60;5.90;875;48;2322.00;40
5902;48;626482842;5902;218;6777;6817;7.72;0.47;254.60;5.90;875;48;2323.00;40
5903;48;626482852;5903;218;6779;6817;7.68;0.47;254.57;5.91;876;48;2324.00;38
5904;48;626482862;5904;224;6782;6821;7.69;0.47;254.55;5.91;878;48;2325.00;39
5908;48;626482873;5908;225;6784;6822;7.68;0.47;254.51;5.91;876;48;2326.00;38
5909;48;626482884;5909;230;6784;6822;7.72;0.47;254.56;5.91;875;48;2327.00;38
5911;48;626482894;5911;234;6787;6826;7.72;0.47;254.51;5.90;876;48;2328.00;39
5915;48;626482905;5915;240;6787;6826;7.66;0.47;254.45;5.90;872;48;2329.00;39
5918;48;626482915;5918;241;6788;6826;7.62;0.47;254.34;5.90;870;48;2330.00;38
5919;48;626482926;5919;251;6789;6827;7.56;0.46;254.32;5.90;870;48;2331.00;38
5921;48;626482937;5921;251;6789;6827;7.51;0.46;254.24;5.90;868;48;2332.00;38
5922;48;626482948;5922;257;6793;6833;7.52;0.46;254.24;5.90;871;48;2333.00;40
5925;48;626482959;5925;267;6793;6833;7.42;0.45;254.17;5.90;868;48;2334.00;40
5926;48;626482970;5926;277;6794;6834;7.42;0.45;254.17;5.90;868;48;2335.00;40
5931;48;626482981;5931;278;6794;6834;7.37;0.45;254.06;5.90;863;48;2336.00;40
5932;48;626482992;5932;279;6795;6834;7.33;0.44;254.07;5.91;863;48;2337.00;39
5933;48;626483002;5933;277;6795;6834;7.26;0.44;254.06;5.91;862;48;2338.00;39
5934;48;626483013;5934;288;6795;6834;7.16;0.43;254.02;5.91;861;48;2339.00;39
5936;48;626483028;5936;294;6818;6870;7.21;0.44;254.04;5.90;882;48;2340.00;52
5937;48;626483049;5937;295;6820;6870;7.14;0.44;254.02;5.92;883;48;2341.00;50
5940;48;626483065;5940;301;6824;6870;7.13;0.43;254.01;5.93;884;48;2342.00;46
5940;48;626483085;5940;306;6825;6870;7.11;0.43;254.01;5.94;885;48;2343.00;45
5940;48;626483102;5940;313;6827;6870;7.12;0.43;254.01;5.94;887;48;2344.00;43
5941;48;626483117;5941;314;6830;6870;7.12;0.43;253.97;5.96;889;48;2345.00;40
5942;48;626483133;5942;314;6833;6874;7.10;0.43;253.96;5.96;891;48;2346.00;41
5943;48;626483146;5943;301;6835;6874;7.12;0.43;253.97;5.97;892;48;2347.00;39
5943;48;626483158;5943;295;6838;6878;7.16;0.44;253.97;5.98;895;48;2348.00;40
5944;48;626483170;5944;288;6841;6879;7.20;0.44;253.94;5.98;897;48;2349.00;38
5944;48;626483182;5944;287;6844;6879;7.24;0.44;253.94;6.00;900;48;2350.00;35
5947;48;626483200;5947;282;6846;6879;7.26;0.44;253.92;6.00;899;48;2351.00;33
5948;48;626483213;5948;281;6857;6892;7.20;0.44;253.88;5.99;909;48;2352.00;35
5948;48;626483235;5948;277;6859;6892;7.18;0.44;253.88;6.00;911;48;2353.00;33
5949;48;626483260;5949;278;6859;6892;7.18;0.44;253.87;6.00;910;48;2354.00;33
5949;48;626483271;5949;280;6862;6893;7.20;0.44;253.87;6.02;913;48;2355.00;31
5952;48;626483282;5952;279;6862;6894;7.19;0.44;253.83;6.02;910;48;2356.00;32
5953;48;626483293;5953;285;6862;6894;7.18;0.44;253.82;6.02;909;48;2357.00;32
5954;48;626483308;5954;286;6865;6897;7.15;0.44;253.80;6.03;911;48;2358.00;32
5955;48;626483324;5955;283;6866;6897;7.09;0.43;253.79;6.04;911;48;2359.00;31
5955;48;626483335;5955;287;6868;6897;7.11;0.43;253.79;6.05;913;48;2360.00;29
5959;48;626483346;5959;285;6869;6897;7.06;0.43;253.76;6.06;910;48;2361.00;28
5960;48;626483357;5960;288;6874;6903;7.08;0.43;253.72;6.05;914;48;2362.00;29
5960;48;626483368;5960;291;6875;6903;7.08;0.43;253.72;6.06;915;48;2363.00;28
5961;48;626483380;5961;289;6876;6903;7.11;0.43;253.74;6.06;915;48;2364.00;27
5961;48;626483392;5961;284;6876;6903;7.12;0.43;253.74;6.06;915;48;2365.00;27
5963;48;626483403;5963;292;6882;6907;7.17;0.44;253.74;6.09;919;48;2366.00;25
5963;48;626483415;5963;287;6883;6908;7.22;0.44;253.74;6.08;920;48;2367.00;25
5965;48;626483426;5965;294;6884;6908;7.25;0.44;253.69;6.09;919;48;2368.00;24
5969;48;626483437;5969;290;6885;6909;7.27;0.44;253.67;6.09;916;48;2369.00;24
5971;48;626483449;5971;288;6886;6909;7.26;0.44;253.65;6.10;915;48;2370.00;23
5974;48;626483461;5974;283;6887;6909;7.20;0.44;253.62;6.11;913;48;2371.00;22
5977;48;626483472;5977;284;6887;6909;7.16;0.44;253.60;6.11;910;48;2372.00;22
5978;48;626483482;5978;283;6889;6909;7.14;0.43;253.59;6.12;911;48;2373.00;20
5982;48;626483493;5982;288;6889;6909;7.11;0.43;253.63;6.12;907;48;2374.00;20
5986;48;626483504;5986;289;6892;6909;7.06;0.43;253.68;6.13;906;48;2375.00;17
5989;48;626483516;5989;297;6930;6979;7.18;0.44;253.72;6.10;941;48;2376.00;49
5994;48;626483532;5994;302;6933;6980;7.10;0.44;253.78;6.10;939;48;2377.00;47
5997;48;626483543;5997;304;6942;6980;7.05;0.43;253.80;6.10;945;48;2378.00;38
6000;48;626483554;6000;304;6945;6980;6.96;0.43;253.88;6.09;945;48;2379.00;35
6005;48;626483565;6005;292;6952;6980;6.92;0.42;253.97;6.09;947;48;2380.00;28
6010;48;626483577;6010;288;6957;6980;6.85;0.42;253.97;6.09;947;48;2381.00;23
6013;48;626483588;6013;285;6961;6980;6.81;0.42;254.01;6.10;948;48;2382.00;19
6017;48;626483600;6017;288;6963;6980;6.78;0.42;254.15;6.10;946;48;2383.00;17
6020;48;626483611;6020;290;6964;6981;6.77;0.41;254.18;6.10;944;48;2384.00;17
6024;48;626483622;6024;302;6968;6983;6.76;0.41;254.29;6.09;944;48;2385.00;15
6025;48;626483634;6025;309;6968;6983;6.82;0.42;254.32;6.09;943;48;2386.00;15
6029;48;626483646;6029;302;6971;6987;6.88;0.42;254.43;6.09;942;48;2387.00;16
6032;48;626483659;6032;298;6972;6987;6.96;0.43;254.51;6.09;940;48;2388.00;15
6035;48;626483670;6035;295;6972;6987;7.03;0.43;254.55;6.09;937;48;2389.00;15
6040;48;626483682;6040;299;6972;6987;7.09;0.43;254.59;6.09;932;48;2390.00;15
6044;48;626483695;6044;300;6976;6993;7.16;0.44;254.65;6.09;932;48;2391.00;17
6046;48;626483707;6046;306;6977;6993;7.21;0.44;254.71;6.09;931;48;2392.00;16
6052;48;626483719;6052;294;6977;6993;7.26;0.45;254.84;6.09;925;48;2393.00;16
6053;48;626483732;6053;293;6980;6996;7.33;0.45;254.90;6.09;927;48;2394.00;16
6057;48;626483744;6057;286;6980;6996;7.35;0.45;254.95;6.09;923;48;2395.00;16
6063;48;626483757;6063;281;6981;6996;7.35;0.45;254.97;6.12;918;48;2396.00;15
6064;48;626483770;6064;278;6982;6997;7.44;0.46;255.02;6.12;918;48;2397.00;15
6070;49;626483782;6070;279;6983;6998;7.50;0.46;255.05;6.12;913;49;2398.00;15
6076;49;626483807;6076;284;6983;6998;7.50;0.46;255.15;6.12;907;49;2399.00;15
6082;49;626483823;6082;284;7006;7057;7.54;0.46;255.33;6.10;924;49;2400.00;51
6088;49;626483847;6088;274;7008;7057;7.55;0.46;255.45;6.10;920;49;2401.00;49
6092;49;626483867;6092;268;7011;7057;7.57;0.46;255.57;6.09;919;49;2402.00;46
6093;49;626483879;6093;267;7012;7058;7.64;0.47;255.58;6.09;919;49;2403.00;46
6099;49;626483892;6099;271;7014;7058;7.65;0.47;255.69;6.09;915;49;2404.00;44
6104;49;626483911;6104;273;7017;7062;7.69;0.47;255.64;6.09;913;49;2405.00;45
6108;49;626483926;6108;277;7018;7062;7.73;0.47;255.70;6.09;910;49;2406.00;44
6113;49;626483944;6113;277;7023;7066;7.72;0.47;255.84;6.09;910;49;2407.00;43
6118;49;626483958;6118;275;7023;7066;7.67;0.47;255.91;6.09;905;49;2408.00;43
6121;50;626483972;6121;276;7023;7066;7.68;0.47;256.00;6.09;902;50;2409.00;43
6124;50;626484010;6124;284;7024;7066;7.68;0.47;256.05;6.09;900;50;2410.00;42
6126;50;626484027;6126;287;7025;7066;7.62;0.46;256.16;6.09;899;50;2411.00;41
6131;50;626484040;6131;292;7033;7078;7.67;0.47;256.15;6.08;902;50;2412.00;45
6137;50;626484057;6137;295;7035;7078;7.63;0.46;256.18;6.08;898;50;2413.00;43
6139;50;626484073;6139;300;7035;7078;7.67;0.47;256.23;6.08;896;50;2414.00;43
6141;50;626484085;6141;299;7035;7078;7.66;0.47;256.24;6.08;894;50;2415.00;43
6145;50;626484098;6145;301;7036;7078;7.58;0.46;256.20;6.09;891;50;2416.00;42
6146;50;626484110;6146;299;7036;7078;7.53;0.46;256.22;6.09;890;50;2417.00;42
6148;50;626484122;6148;302;7036;7079;7.49;0.46;256.32;6.09;888;50;2418.00;43
6152;50;626484135;6152;303;7039;7079;7.45;0.46;256.41;6.09;887;50;2419.00;40
6155;50;626484147;6155;296;7042;7085;7.44;0.45;256.37;6.09;887;50;2420.00;43
6161;50;626484160;6161;306;7043;7086;7.44;0.45;256.44;6.09;882;50;2421.00;43
6165;50;626484172;6165;310;7044;7086;7.36;0.45;256.52;6.09;879;50;2422.00;42
6167;50;626484184;6167;307;7044;7086;7.32;0.45;256.62;6.09;877;50;2423.00;42
6171;50;626484195;6171;316;7046;7090;7.32;0.44;256.65;6.09;875;50;2424.00;44
6172;50;626484207;6172;312;7047;7090;7.31;0.45;256.67;6.09;875;50;2425.00;43
6175;50;626484219;6175;314;7047;7090;7.32;0.45;256.74;6.09;872;50;2426.00;43
6181;50;626484230;6181;308;7048;7091;7.28;0.44;256.92;6.09;867;50;2427.00;43
6183;50;626484242;6183;303;7054;7095;7.25;0.44;256.95;6.10;871;50;2428.00;41
6188;50;626484255;6188;295;7055;7095;7.23;0.44;257.05;6.10;867;50;2429.00;40
6191;50;626484269;6191;294;7058;7101;7.30;0.44;257.15;6.09;867;50;2430.00;43
6194;50;626484281;6194;292;7059;7101;7.33;0.45;257.28;6.10;865;50;2431.00;42
6198;50;626484293;6198;293;7059;7101;7.35;0.45;257.38;6.10;861;50;2432.00;42
6200;50;626484304;6200;296;7060;7101;7.44;0.45;257.39;6.10;860;50;2433.00;41
6205;50;626484316;6205;287;7065;7105;7.50;0.46;257.45;6.14;860;50;2434.00;40
6209;50;626484329;6209;292;7066;7105;7.55;0.46;257.53;6.14;857;50;2435.00;39
6213;50;626484341;6213;274;7066;7105;7.58;0.46;257.63;6.14;853;50;2436.00;39
6217;50;626484353;6217;264;7067;7105;7.67;0.46;257.65;6.14;850;50;2437.00;38
6218;51;626484365;6218;250;7067;7106;7.69;0.47;257.66;6.14;849;51;2438.00;39
6223;51;626484383;6223;246;7069;7107;7.68;0.47;257.70;6.14;846;51;2439.00;38
6224;51;626484395;6224;244;7070;7107;7.72;0.47;257.67;6.14;846;51;2440.00;37
6228;51;626484407;6228;236;7072;7108;7.83;0.48;257.72;6.14;844;51;2441.00;36
6231;51;626484419;6231;239;7072;7108;7.95;0.48;257.78;6.14;841;51;2442.00;36
6233;51;626484432;6233;237;7072;7108;8.07;0.49;257.75;6.14;839;51;2443.00;36
6237;51;626484444;6237;226;7072;7108;8.11;0.49;257.80;6.14;835;51;2444.00;36
6238;51;626484456;6238;220;7072;7108;8.25;0.50;257.80;6.14;834;51;2445.00;36
6240;51;626484468;6240;221;7073;7108;8.32;0.50;257.83;6.15;833;51;2446.00;35
6242;51;626484480;6242;211;7073;7108;8.39;0.51;257.92;6.15;831;51;2447.00;35
6242;51;626484492;6242;218;7134;7235;8.66;0.53;257.92;6.09;892;51;2448.00;101
6245;51;626484519;6245;208;7137;7236;8.71;0.54;258.02;6.09;892;51;2449.00;99
6249;51;626484532;6249;206;7144;7236;8.79;0.54;258.10;6.13;895;51;2450.00;92
6250;51;626484544;6250;205;7146;7236;8.85;0.54;258.10;6.13;896;51;2451.00;90
6252;51;626484561;6252;206;7154;7236;8.96;0.55;258.17;6.13;902;51;2452.00;82
6253;51;626484573;6253;204;7155;7236;9.05;0.56;258.21;6.13;902;51;2453.00;81
6256;51;626484585;6256;203;7159;7236;9.12;0.56;258.34;6.13;903;51;2454.00;77
6256;51;626484603;6256;203;7162;7236;9.19;0.57;258.34;6.13;906;51;2455.00;74
6262;51;626484615;6262;206;7167;7237;9.18;0.56;258.32;6.13;905;51;2456.00;70
6263;51;626484627;6263;213;7170;7238;9.11;0.56;258.38;6.13;907;51;2457.00;68
6265;51;626484640;6265;220;7175;7238;9.03;0.55;258.35;6.14;910;51;2458.00;63
6266;51;626484652;6266;226;7178;7239;8.91;0.55;258.39;6.19;912;51;2459.00;61
6269;51;626484671;6269;230;7180;7239;8.81;0.54;258.42;6.19;911;51;2460.00;59
6272;51;626484683;6272;243;7183;7239;8.71;0.53;258.56;6.19;911;51;2461.00;56
6276;51;626484695;6276;247;7187;7239;8.65;0.53;258.58;6.19;911;51;2462.00;52
6278;51;626484707;6278;249;7190;7243;8.52;0.52;258.61;6.19;912;51;2463.00;53
6280;51;626484725;6280;261;7193;7243;8.49;0.52;258.65;6.20;913;51;2464.00;50
6281;51;626484737;6281;261;7196;7243;8.47;0.52;258.62;6.21;915;51;2465.00;47
6285;51;626484748;6285;267;7199;7246;8.41;0.51;258.73;6.21;914;51;2466.00;47
6286;51;626484760;6286;271;7200;7246;8.33;0.51;258.74;6.21;914;51;2467.00;46
6289;51;626484771;6289;277;7200;7246;8.23;0.50;258.67;6.21;911;51;2468.00;46
6293;51;626484782;6293;281;7206;7250;8.11;0.50;258.72;6.22;913;51;2469.00;44
6294;51;626484794;6294;280;7207;7251;8.03;0.49;258.70;6.22;913;51;2470.00;44
6296;51;626484807;6296;280;7209;7251;7.93;0.49;258.69;6.26;913;51;2471.00;42
6298;51;626484819;6298;273;7211;7255;7.84;0.48;258.64;6.26;913;51;2472.00;44
6303;51;626484832;6303;273;7212;7255;7.77;0.47;258.64;6.27;909;51;2473.00;43
6307;51;626484843;6307;274;7213;7255;7.74;0.47;258.63;6.31;906;51;2474.00;42
6312;51;626484854;6312;271;7215;7257;7.67;0.47;258.58;6.31;903;51;2475.00;42
6313;51;626484865;6313;271;7215;7257;7.63;0.47;258.55;6.31;902;51;2476.00;42
6315;51;626484876;6315;265;7220;7263;7.58;0.46;258.50;6.35;905;51;2477.00;43
6319;51;626484887;6319;265;7220;7263;7.42;0.45;258.45;6.35;901;51;2478.00;43
6322;51;626484899;6322;265;7222;7264;7.27;0.44;258.45;6.39;900;51;2479.00;42
6324;51;626484909;6324;265;7222;7264;7.19;0.44;258.40;6.39;898;51;2480.00;42
6327;51;626484919;6327;261;7222;7264;7.07;0.43;258.42;6.39;895;51;2481.00;42
6329;51;626484930;6329;257;7223;7264;6.95;0.42;258.38;6.43;894;51;2482.00;41
6329;51;626484940;6329;248;7223;7264;6.94;0.42;258.38;6.43;894;51;2483.00;41
6330;51;626484949;6330;250;7234;7276;6.91;0.42;258.40;6.46;904;51;2484.00;42
6331;51;626484960;6331;248;7237;7276;6.86;0.42;258.38;6.48;906;51;2485.00;39
6336;51;626484972;6336;244;7237;7276;6.81;0.42;258.48;6.48;901;51;2486.00;39
6337;51;626484982;6337;248;7238;7276;6.80;0.42;258.49;6.51;901;51;2487.00;38
6341;51;626484991;6341;247;7238;7276;6.71;0.41;258.42;6.51;897;51;2488.00;38
6344;51;626485001;6344;246;7239;7276;6.71;0.41;258.44;6.53;895;51;2489.00;37
6345;51;626485012;6345;253;7242;7280;6.75;0.41;258.42;6.53;897;51;2490.00;38
6346;51;626485024;6346;244;7243;7280;6.75;0.41;258.45;6.55;897;51;2491.00;37
6348;51;626485038;6348;247;7246;7284;6.78;0.41;258.43;6.55;898;51;2492.00;38
6351;51;626485055;6351;251;7248;7285;6.85;0.42;258.39;6.54;897;51;2493.00;37
6352;51;626485073;6352;265;7249;7285;6.79;0.41;258.35;6.56;897;51;2494.00;36
6352;51;626485087;6352;259;7249;7285;6.86;0.42;258.35;6.56;897;51;2495.00;36
6353;51;626485101;6353;263;7258;7298;6.86;0.42;258.33;6.57;905;51;2496.00;40
6355;51;626485117;6355;264;7258;7298;6.86;0.42;258.31;6.57;903;51;2497.00;40
6358;51;626485133;6358;271;7259;7298;6.87;0.42;258.23;6.57;901;51;2498.00;39
6360;51;626485145;6360;259;7260;7299;6.89;0.42;258.17;6.57;900;51;2499.00;39
6361;51;626485158;6361;253;7260;7300;6.98;0.43;258.15;6.57;899;51;2500.00;40
6363;51;626485175;6363;247;7261;7300;7.00;0.43;258.10;6.58;898;51;2501.00;39
6365;51;626485187;6365;242;7263;7303;7.09;0.43;258.07;6.58;898;51;2502.00;40
6365;51;626485199;6365;241;7264;7303;7.16;0.44;258.07;6.58;899;51;2503.00;39
6367;51;626485211;6367;235;7264;7303;7.21;0.44;258.03;6.58;897;51;2504.00;39
6369;51;626485223;6369;229;7264;7303;7.24;0.44;258.02;6.58;895;51;2505.00;39
6372;51;626485234;6372;229;7270;7309;7.34;0.45;258.05;6.60;898;51;2506.00;39
6375;51;626485247;6375;225;7271;7309;7.39;0.45;258.05;6.60;896;51;2507.00;38
6376;51;626485260;6376;218;7272;7309;7.39;0.45;258.06;6.60;896;51;2508.00;37
6377;51;626485273;6377;216;7272;7309;7.45;0.45;258.05;6.60;895;51;2509.00;37
6380;51;626485284;6380;217;7278;7313;7.45;0.45;258.11;6.64;898;51;2510.00;35
6381;51;626485297;6381;210;7280;7314;7.50;0.45;258.14;6.64;899;51;2511.00;34
6382;51;626485308;6382;212;7281;7314;7.58;0.46;258.12;6.64;899;51;2512.00;33
6383;51;626485319;6383;212;7282;7315;7.62;0.46;258.13;6.64;899;51;2513.00;33
6385;51;626485332;6385;215;7284;7315;7.66;0.46;258.06;6.65;899;51;2514.00;31
6387;51;626485344;6387;216;7286;7315;7.65;0.46;258.03;6.68;899;51;2515.00;29
6387;51;626485355;6387;222;7286;7315;7.69;0.47;258.03;6.68;899;51;2516.00;29
6387;51;626485366;6387;220;7289;7315;7.75;0.47;258.03;6.71;902;51;2517.00;26
6388;51;626485377;6388;225;7289;7315;7.79;0.47;258.02;6.71;901;51;2518.00;26
6390;51;626485388;6390;225;7290;7315;7.82;0.48;258.03;6.73;900;51;2519.00;25
6392;51;626485408;6392;231;7347;7440;8.01;0.49;257.99;6.69;955;51;2520.00;93
6393;51;626485432;6393;225;7352;7441;8.03;0.49;257.99;6.70;959;51;2521.00;89
6394;51;626485444;6394;223;7361;7441;8.07;0.50;258.00;6.70;967;51;2522.00;80
6398;51;626485456;6398;227;7372;7441;8.11;0.50;258.01;6.71;974;51;2523.00;69
6403;51;626485468;6403;228;7379;7441;8.07;0.49;258.08;6.70;976;51;2524.00;62
6404;51;626485487;6404;233;7384;7441;8.03;0.49;258.10;6.71;980;51;2525.00;57
6407;51;626485500;6407;239;7390;7441;7.96;0.49;258.15;6.71;983;51;2526.00;51
6408;51;626485513;6408;243;7393;7441;7.84;0.48;258.19;6.72;985;51;2527.00;48
6412;51;626485525;6412;252;7399;7442;7.74;0.48;258.17;6.74;987;51;2528.00;43
6413;51;626485537;6413;250;7400;7443;7.72;0.47;258.20;6.74;987;51;2529.00;43
6416;51;626485556;6416;241;7404;7443;7.67;0.47;258.22;6.75;988;51;2530.00;39
6417;51;626485569;6417;240;7410;7447;7.62;0.47;258.23;6.75;993;51;2531.00;37
6420;51;626485581;6420;237;7411;7447;7.58;0.46;258.18;6.75;991;51;2532.00;36
6424;51;626485594;6424;240;7414;7447;7.52;0.46;258.24;6.76;990;51;2533.00;33
6424;51;626485606;6424;231;7414;7447;7.53;0.46;258.24;6.76;990;51;2534.00;33
6426;51;626485619;6426;236;7418;7453;7.61;0.47;258.24;6.75;992;51;2535.00;35
6431;51;626485632;6431;242;7420;7453;7.60;0.46;258.33;6.76;989;51;2536.00;33
6432;51;626485646;6432;247;7422;7455;7.63;0.47;258.34;6.76;990;51;2537.00;33
6435;51;626485665;6435;249;7424;7458;7.65;0.47;258.38;6.76;989;51;2538.00;34
6437;51;626485679;6437;256;7425;7458;7.66;0.47;258.48;6.77;988;51;2539.00;33
6437;51;626485692;6437;263;7426;7458;7.68;0.47;258.48;6.77;989;51;2540.00;32
6441;51;626485705;6441;265;7429;7459;7.58;0.46;258.47;6.78;988;51;2541.00;30
6444;51;626485718;6444;268;7431;7460;7.51;0.46;258.51;6.78;987;51;2542.00;29
6446;51;626485730;6446;274;7432;7460;7.42;0.45;258.53;6.78;986;51;2543.00;28
6449;51;626485743;6449;281;7442;7473;7.28;0.45;258.64;6.78;993;51;2544.00;31
6454;51;626485757;6454;289;7444;7473;7.20;0.44;258.78;6.78;990;51;2545.00;29
6455;51;626485770;6455;296;7446;7473;7.14;0.44;258.78;6.78;991;51;2546.00;27
6461;51;626485782;6461;295;7447;7474;7.05;0.43;258.82;6.78;986;51;2547.00;27
6468;51;626485795;6468;301;7447;7474;6.96;0.43;258.93;6.78;979;51;2548.00;27
6475;51;626485807;6475;306;7451;7478;6.90;0.42;258.94;6.79;976;51;2549.00;27
6478;51;626485822;6478;303;7454;7481;6.87;0.42;259.03;6.78;976;51;2550.00;27
6480;51;626485835;6480;297;7459;7485;6.79;0.42;259.05;6.79;979;51;2551.00;26
6486;51;626485848;6486;290;7461;7485;6.71;0.41;259.27;6.79;975;51;2552.00;24
6491;51;626485860;6491;283;7462;7485;6.67;0.41;259.29;6.80;971;51;2553.00;23
6499;51;626485872;6499;286;7462;7485;6.60;0.40;259.29;6.80;963;51;2554.00;23
6501;51;626485885;6501;283;7463;7485;6.64;0.41;259.36;6.80;962;51;2555.00;22
6506;51;626485897;6506;289;7475;7497;6.74;0.41;259.51;6.79;969;51;2556.00;22
6509;51;626485910;6509;283;7475;7497;6.81;0.42;259.57;6.79;966;51;2557.00;22
6514;51;626485922;6514;275;7476;7497;6.86;0.42;259.68;6.80;962;51;2558.00;21
6518;51;626485934;6518;274;7476;7497;6.91;0.43;259.78;6.80;958;51;2559.00;21
6521;51;626485946;6521;276;7476;7497;6.99;0.43;259.84;6.80;955;51;2560.00;21
6524;51;626485959;6524;272;7476;7497;7.06;0.44;259.93;6.80;952;51;2561.00;21
6529;51;626485971;6529;269;7476;7498;7.10;0.44;260.03;6.80;947;51;2562.00;22
6534;51;626485984;6534;268;7476;7498;7.15;0.44;260.10;6.80;942;51;2563.00;22
6539;51;626485997;6539;268;7480;7504;7.29;0.45;260.25;6.79;941;51;2564.00;24
6543;51;626486011;6543;271;7483;7506;7.37;0.45;260.29;6.79;940;51;2565.00;23
6548;51;626486024;6548;270;7483;7506;7.47;0.46;260.34;6.79;935;51;2566.00;23
6554;51;626486038;6554;265;7483;7506;7.52;0.46;260.42;6.79;929;51;2567.00;23
6562;51;626486050;6562;262;7486;7510;7.60;0.47;260.39;6.79;924;51;2568.00;24
6567;51;626486065;6567;263;7486;7510;7.66;0.47;260.49;6.79;919;51;2569.00;24
6570;51;626486078;6570;255;7486;7510;7.76;0.48;260.54;6.79;916;51;2570.00;24
6573;51;626486089;6573;254;7487;7511;7.84;0.48;260.52;6.79;914;51;2571.00;24
6580;51;626486107;6580;253;7490;7515;7.88;0.49;260.60;6.78;910;51;2572.00;25
6586;51;626486119;6586;246;7490;7515;7.97;0.49;260.62;6.78;904;51;2573.00;25
6591;51;626486132;6591;242;7492;7518;8.02;0.49;260.60;6.78;901;51;2574.00;26
6595;51;626486144;6595;233;7493;7518;8.06;0.49;260.65;6.78;898;51;2575.00;25
6601;51;626486156;6601;229;7493;7518;8.06;0.49;260.65;6.78;892;51;2576.00;25
6603;51;626486168;6603;229;7493;7518;8.02;0.49;260.65;6.78;890;51;2577.00;25
6609;51;626486180;6609;234;7496;7522;8.01;0.49;260.70;6.78;887;51;2578.00;26
6612;51;626486192;6612;234;7496;7522;7.97;0.49;260.80;6.78;884;51;2579.00;26
6616;51;626486206;6616;229;7497;7522;8.05;0.49;260.77;6.78;881;51;2580.00;25
6623;51;626486219;6623;229;7497;7522;8.13;0.50;260.90;6.78;874;51;2581.00;25
6629;51;626486231;6629;231;7497;7523;8.17;0.50;261.03;6.78;868;51;2582.00;26
6632;51;626486243;6632;226;7498;7524;8.19;0.50;261.00;6.78;866;51;2583.00;26
6636;51;626486255;6636;228;7498;7524;8.25;0.50;261.06;6.78;862;51;2584.00;26
6640;51;626486267;6640;226;7499;7525;8.29;0.51;261.16;6.78;859;51;2585.00;26
6645;51;626486279;6645;228;7499;7525;8.31;0.51;261.22;6.78;854;51;2586.00;26
6648;51;626486290;6648;229;7499;7525;8.34;0.51;261.16;6.78;851;51;2587.00;26
6652;51;626486302;6652;231;7500;7525;8.27;0.51;261.23;6.80;848;51;2588.00;25
6655;51;626486313;6655;234;7500;7525;8.19;0.50;261.29;6.80;845;51;2589.00;25
6658;51;626486324;6658;240;7500;7525;8.10;0.50;261.26;6.80;842;51;2590.00;25
6664;51;626486335;6664;247;7500;7525;7.96;0.49;261.18;6.80;836;51;2591.00;25
6668;51;626486347;6668;263;7565;7652;8.08;0.50;261.17;6.75;897;51;2592.00;87
6669;51;626486368;6669;258;7568;7653;8.00;0.50;261.19;6.74;899;51;2593.00;85
6672;51;626486379;6672;259;7576;7653;7.94;0.49;261.23;6.74;904;51;2594.00;77
6675;51;626486391;6675;281;7580;7653;7.85;0.49;261.34;6.76;905;51;2595.00;73
6678;51;626486402;6678;291;7585;7653;7.80;0.48;261.35;6.76;907;51;2596.00;68
6679;51;626486413;6679;282;7588;7653;7.80;0.48;261.40;6.76;909;51;2597.00;65
6685;51;626486425;6685;284;7592;7653;7.76;0.48;261.43;6.76;907;51;2598.00;61
6686;51;626486437;6686;281;7595;7653;7.71;0.47;261.46;6.76;909;51;2599.00;58
6688;51;626486449;6688;280;7600;7654;7.70;0.47;261.55;6.76;912;51;2600.00;54
6691;52;626486465;6691;277;7604;7655;7.69;0.47;261.67;6.76;913;52;2601.00;51
6697;52;626486489;6697;285;7607;7655;7.67;0.47;261.67;6.76;910;52;2602.00;48
6701;52;626486501;6701;286;7610;7656;7.64;0.47;261.78;6.76;909;52;2603.00;46
6703;52;626486520;6703;293;7614;7656;7.60;0.47;261.80;6.77;911;52;2604.00;42
6706;52;626486532;6706;295;7614;7656;7.48;0.46;261.82;6.77;908;52;2605.00;42
6707;52;626486543;6707;280;7616;7656;7.49;0.46;261.79;6.77;909;52;2606.00;40
6711;52;626486555;6711;274;7619;7660;7.44;0.46;261.81;6.77;908;52;2607.00;41
6714;52;626486576;6714;259;7621;7660;7.54;0.46;261.94;6.77;907;53;2608.00;39
6715;52;626486599;6715;250;7622;7660;7.61;0.47;261.98;6.77;907;53;2609.00;38
6719;52;626486618;6719;244;7625;7666;7.64;0.47;261.97;6.77;906;53;2610.00;41
6721;52;626486632;6721;236;7626;7666;7.68;0.47;261.92;6.77;905;53;2611.00;40
6726;52;626486644;6726;236;7627;7666;7.66;0.47;261.93;6.77;901;53;2612.00;39
6728;52;626486657;6728;235;7630;7670;7.71;0.47;261.93;6.77;902;53;2613.00;40
6731;52;626486670;6731;226;7632;7671;7.82;0.48;261.96;6.77;901;53;2614.00;39
6733;52;626486682;6733;231;7632;7671;7.90;0.48;261.95;6.77;899;53;2615.00;39
6735;52;626486694;6735;234;7636;7675;7.99;0.49;261.97;6.76;901;53;2616.00;39
6736;52;626486707;6736;230;7636;7675;8.07;0.49;261.98;6.76;900;53;2617.00;39
6737;52;626486720;6737;231;7637;7675;8.15;0.50;261.95;6.76;900;53;2618.00;38
6739;52;626486737;6739;233;7639;7676;8.18;0.50;261.93;6.76;900;53;2619.00;37
6743;52;626486750;6743;237;7639;7676;8.22;0.50;261.94;6.76;896;53;2620.00;37
6744;52;626486762;6744;242;7643;7682;8.33;0.51;261.93;6.76;899;53;2621.00;39
6745;52;626486775;6745;247;7643;7682;8.34;0.51;261.92;6.76;898;53;2622.00;39
6746;52;626486788;6746;246;7644;7683;8.36;0.51;261.92;6.76;898;53;2623.00;39
6747;52;626486800;6747;248;7644;7683;8.33;0.51;261.92;6.76;897;53;2624.00;39
6747;52;626486813;6747;248;7644;7683;8.32;0.51;261.92;6.76;897;53;2625.00;39
6749;52;626486824;6749;253;7644;7683;8.31;0.51;261.88;6.76;895;53;2626.00;39
6751;52;626486836;6751;261;7644;7683;8.27;0.50;261.84;6.76;893;53;2627.00;39
6753;52;626486848;6753;264;7653;7695;8.29;0.51;261.80;6.75;900;53;2628.00;42
6758;52;626486861;6758;266;7654;7695;8.27;0.50;261.75;6.75;896;53;2629.00;41
6759;52;626486872;6759;273;7655;7695;8.24;0.50;261.76;6.75;896;53;2630.00;40
6762;52;626486884;6762;276;7655;7695;8.17;0.50;261.72;6.75;893;53;2631.00;40
6767;52;626486895;6767;287;7655;7695;8.08;0.49;261.80;6.75;888;53;2632.00;40
6769;52;626486907;6769;293;7655;7695;7.96;0.48;261.82;6.75;886;53;2633.00;40
6769;52;626486918;6769;298;7658;7699;7.91;0.48;261.82;6.75;889;53;2634.00;41
6771;52;626486930;6771;298;7658;7699;7.80;0.47;261.80;6.75;887;53;2635.00;41
6772;52;626486941;6772;296;7661;7703;7.71;0.47;261.81;6.75;889;53;2636.00;42
6776;52;626486952;6776;303;7662;7704;7.66;0.47;261.74;6.74;886;53;2637.00;42
6778;52;626486963;6778;306;7663;7704;7.62;0.46;261.72;6.74;885;53;2638.00;41
6780;52;626486974;6780;306;7663;7704;7.51;0.46;261.65;6.74;883;53;2639.00;41
6781;52;626486986;6781;308;7683;7733;7.43;0.45;261.62;6.73;902;53;2640.00;50
6783;52;626486999;6783;297;7684;7733;7.37;0.45;261.60;6.73;901;53;2641.00;49
6784;52;626487010;6784;301;7687;7733;7.35;0.45;261.60;6.72;903;53;2642.00;46
6785;52;626487021;6785;299;7689;7734;7.26;0.44;261.62;6.72;904;53;2643.00;45
6786;52;626487038;6786;303;7689;7735;7.22;0.44;261.64;6.72;903;53;2644.00;46
6788;52;626487054;6788;305;7689;7735;7.18;0.44;261.62;6.72;901;53;2645.00;46
6790;52;626487071;6790;309;7692;7738;7.18;0.44;261.60;6.72;902;53;2646.00;46
6791;52;626487089;6791;311;7692;7738;7.16;0.44;261.63;6.72;901;53;2647.00;46
6793;52;626487104;6793;314;7692;7738;7.13;0.43;261.64;6.72;899;53;2648.00;46
6793;52;626487119;6793;316;7692;7738;7.13;0.43;261.64;6.72;899;53;2649.00;46
6794;52;626487135;6794;318;7696;7744;7.09;0.43;261.64;6.72;902;53;2650.00;48
6796;52;626487151;6796;301;7698;7744;7.01;0.43;261.65;6.75;902;53;2651.00;46
6797;52;626487167;6797;284;7698;7744;6.99;0.43;261.63;6.75;901;53;2652.00;46
6800;52;626487179;6800;271;7698;7744;6.95;0.42;261.62;6.75;898;53;2653.00;46
6803;53;626487190;6803;259;7702;7748;6.90;0.42;261.67;6.76;899;54;2654.00;46
6808;53;626487219;6808;252;7705;7750;6.92;0.42;261.78;6.77;897;54;2655.00;45
6810;53;626487231;6810;247;7705;7750;6.99;0.43;261.83;6.77;895;54;2656.00;45
6813;53;626487243;6813;241;7706;7751;7.01;0.43;261.88;6.77;893;54;2657.00;45
6818;53;626487263;6818;229;7706;7751;7.07;0.43;261.96;6.77;888;54;2658.00;45
6821;53;626487275;6821;215;7706;7751;7.09;0.43;261.96;6.77;885;54;2659.00;45
6823;53;626487288;6823;211;7706;7751;7.17;0.43;261.92;6.77;883;54;2660.00;45
6824;53;626487301;6824;208;7706;7751;7.19;0.44;261.88;6.77;882;54;2661.00;45
6828;53;626487321;6828;201;7706;7751;7.18;0.44;261.86;6.77;878;54;2662.00;45
6828;53;626487333;6828;194;7706;7751;7.29;0.44;261.86;6.77;878;54;2663.00;45
6831;53;626487343;6831;198;7741;7821;7.50;0.46;261.80;6.74;910;54;2664.00;80
6832;53;626487361;6832;194;7742;7822;7.48;0.46;261.76;6.74;910;54;2665.00;80
6833;53;626487373;6833;190;7748;7822;7.60;0.46;261.73;6.74;915;54;2666.00;74
6835;53;626487384;6835;194;7756;7822;7.66;0.47;261.67;6.73;921;54;2667.00;66
6836;53;626487396;6836;196;7760;7822;7.77;0.47;261.68;6.73;924;54;2668.00;62
6838;53;626487407;6838;200;7765;7822;7.85;0.48;261.67;6.73;927;54;2669.00;57
6841;53;626487421;6841;205;7769;7822;7.90;0.48;261.67;6.73;928;54;2670.00;53
6842;53;626487439;6842;197;7770;7822;7.92;0.48;261.65;6.73;928;54;2671.00;52
6844;53;626487451;6844;197;7772;7823;7.98;0.49;261.62;6.73;928;54;2672.00;51
6846;53;626487463;6846;201;7773;7824;8.08;0.49;261.64;6.73;927;54;2673.00;51
6848;53;626487477;6848;208;7774;7824;8.11;0.49;261.59;6.73;926;54;2674.00;50
6850;53;626487489;6850;199;7777;7828;8.07;0.49;261.54;6.73;927;54;2675.00;51
6853;53;626487503;6853;199;7778;7828;8.03;0.49;261.56;6.74;925;54;2676.00;50
6855;53;626487515;6855;200;7778;7828;8.06;0.49;261.53;6.74;923;54;2677.00;50
6859;53;626487527;6859;203;7778;7828;8.07;0.49;261.54;6.74;919;54;2678.00;50
6861;53;626487539;6861;200;7782;7834;8.17;0.50;261.49;6.74;921;54;2679.00;52
6862;53;626487552;6862;208;7785;7834;8.23;0.50;261.49;6.76;923;54;2680.00;49
6864;53;626487566;6864;209;7785;7834;8.23;0.50;261.58;6.76;921;54;2681.00;49
6865;53;626487579;6865;210;7787;7837;8.26;0.50;261.57;6.76;922;54;2682.00;50
6866;53;626487593;6866;212;7789;7837;8.28;0.50;261.63;6.78;923;54;2683.00;48
6871;53;626487606;6871;213;7790;7837;8.28;0.50;261.64;6.78;919;54;2684.00;47
6873;53;626487618;6873;220;7792;7838;8.21;0.50;261.65;6.81;919;54;2685.00;46
6875;53;626487638;6875;227;7793;7839;8.22;0.50;261.65;6.81;918;54;2686.00;46
6877;53;626487650;6877;224;7793;7839;8.22;0.50;261.63;6.81;916;54;2687.00;46
6881;53;626487663;6881;224;7805;7852;8.21;0.50;261.58;6.81;924;54;2688.00;47
6885;53;626487677;6885;232;7807;7852;8.17;0.50;261.61;6.83;922;54;2689.00;45
6888;53;626487688;6888;236;7808;7852;8.16;0.50;261.75;6.84;920;54;2690.00;44
6888;53;626487701;6888;242;7810;7853;8.16;0.50;261.75;6.85;922;54;2691.00;43
6892;53;626487712;6892;250;7811;7853;8.08;0.49;261.81;6.85;919;54;2692.00;42
6895;53;626487725;6895;253;7815;7857;8.07;0.49;261.84;6.86;920;54;2693.00;42
6895;53;626487737;6895;253;7816;7857;8.01;0.49;261.84;6.87;921;54;2694.00;41
6897;53;626487748;6897;251;7821;7861;7.92;0.48;261.89;6.88;924;54;2695.00;40
6899;53;626487760;6899;252;7821;7861;7.84;0.48;261.93;6.88;922;54;2696.00;40
6903;53;626487772;6903;258;7823;7861;7.74;0.47;261.97;6.89;920;54;2697.00;38
6905;53;626487784;6905;271;7824;7861;7.61;0.46;262.06;6.90;919;54;2698.00;37
6908;53;626487795;6908;264;7825;7861;7.52;0.46;262.16;6.90;917;54;2699.00;36
6911;53;626487811;6911;268;7848;7910;7.59;0.46;262.12;6.90;937;54;2700.00;62
6914;53;626487833;6914;262;7850;7910;7.60;0.47;262.20;6.90;936;54;2701.00;60
6917;53;626487846;6917;270;7852;7910;7.48;0.46;262.25;6.89;935;54;2702.00;58
6921;53;626487858;6921;267;7856;7910;7.44;0.45;262.24;6.90;935;54;2703.00;54
6925;53;626487870;6925;272;7858;7910;7.39;0.45;262.32;6.90;933;54;2704.00;52
6927;53;626487882;6927;267;7860;7910;7.41;0.45;262.35;6.91;933;54;2705.00;50
6929;53;626487894;6929;268;7862;7911;7.41;0.45;262.37;6.91;933;54;2706.00;49
6932;53;626487906;6932;268;7863;7911;7.41;0.45;262.49;6.91;931;54;2707.00;48
6933;53;626487927;6933;274;7870;7917;7.46;0.46;262.53;6.94;937;54;2708.00;47
6935;53;626487941;6935;275;7871;7918;7.48;0.46;262.53;6.94;936;54;2709.00;47
6940;53;626487955;6940;282;7873;7918;7.44;0.45;262.70;6.95;933;54;2710.00;45
6944;53;626487968;6944;285;7873;7918;7.40;0.45;262.72;6.95;929;54;2711.00;45
6949;53;626487981;6949;290;7877;7922;7.36;0.45;262.91;6.94;928;54;2712.00;45
6954;53;626487993;6954;290;7880;7922;7.28;0.44;262.98;6.95;926;54;2713.00;42
6959;53;626488006;6959;291;7880;7922;7.26;0.44;263.08;6.95;921;54;2714.00;42
6962;53;626488019;6962;294;7881;7923;7.26;0.44;263.23;6.95;919;54;2715.00;42
6968;53;626488034;6968;289;7887;7927;7.19;0.44;263.28;6.97;919;54;2716.00;40
6971;53;626488047;6971;287;7887;7927;7.23;0.44;263.39;6.97;916;54;2717.00;40
6980;53;626488059;6980;288;7890;7930;7.20;0.44;263.43;6.97;910;54;2718.00;40
6982;53;626488082;6982;290;7892;7930;7.16;0.44;263.48;6.98;910;54;2719.00;38
6985;53;626488093;6985;272;7892;7930;7.14;0.44;263.51;6.98;907;54;2720.00;38
6991;53;626488105;6991;260;7895;7930;7.08;0.43;263.55;6.99;904;54;2721.00;35
6993;53;626488117;6993;251;7897;7934;7.10;0.43;263.57;6.99;904;54;2722.00;37
6998;53;626488129;6998;250;7897;7934;7.06;0.43;263.56;6.99;899;54;2723.00;37
7000;53;626488140;7000;247;7899;7934;7.03;0.43;263.59;6.99;899;54;2724.00;35
7003;53;626488166;7003;251;7900;7934;6.99;0.43;263.66;6.99;897;54;2725.00;34
7007;53;626488177;7007;251;7900;7935;7.00;0.43;263.68;6.99;893;54;2726.00;35
7009;53;626488189;7009;243;7904;7936;7.09;0.43;263.69;7.00;895;54;2727.00;32
7012;53;626488200;7012;232;7904;7936;7.16;0.44;263.75;7.00;892;54;2728.00;32
7017;53;626488211;7017;220;7907;7937;7.23;0.44;263.85;7.00;890;54;2729.00;30
7020;53;626488224;7020;219;7907;7937;7.37;0.45;263.93;7.00;887;54;2730.00;30
7025;53;626488236;7025;217;7908;7937;7.51;0.46;263.99;7.00;883;54;2731.00;29
7027;53;626488248;7027;223;7909;7937;7.64;0.47;264.04;7.01;882;54;2732.00;28
7033;53;626488259;7033;227;7911;7937;7.68;0.47;264.17;7.01;878;54;2733.00;26
7037;53;626488271;7037;232;7911;7937;7.67;0.47;264.19;7.01;874;54;2734.00;26
7043;53;626488282;7043;239;7912;7937;7.67;0.47;264.27;7.01;869;54;2735.00;25
7046;53;626488294;7046;252;7979;8064;7.89;0.49;264.31;6.95;933;54;2736.00;85
7050;53;626488315;7050;248;7985;8065;7.91;0.49;264.43;6.95;935;54;2737.00;80
7054;53;626488327;7054;250;7990;8065;7.90;0.49;264.45;6.95;936;54;2738.00;75
7058;53;626488339;7058;260;7995;8065;7.87;0.49;264.57;6.95;937;54;2739.00;70
7062;53;626488351;7062;256;7999;8065;7.93;0.49;264.59;6.95;937;54;2740.00;66
7068;53;626488363;7068;257;8003;8065;7.88;0.49;264.65;6.95;935;54;2741.00;62
7072;53;626488382;7072;255;8005;8065;7.88;0.48;264.69;6.95;933;54;2742.00;60
7076;53;626488394;7076;250;8011;8065;7.82;0.48;264.69;6.95;935;54;2743.00;54
7080;53;626488406;7080;254;8013;8066;7.83;0.48;264.78;6.95;933;54;2744.00;53
7086;53;626488418;7086;249;8017;8068;7.79;0.48;264.85;6.95;931;54;2745.00;51
7090;53;626488431;7090;249;8020;8068;7.82;0.48;264.91;6.95;930;54;2746.00;48
7092;53;626488443;7092;244;8025;8069;7.75;0.48;264.96;6.95;933;54;2747.00;44
7099;53;626488454;7099;248;8027;8069;7.68;0.47;264.91;6.95;928;54;2748.00;42
7102;53;626488467;7102;251;8027;8069;7.61;0.47;264.96;6.95;925;54;2749.00;42
7105;53;626488479;7105;257;8028;8069;7.63;0.47;265.09;6.95;923;54;2750.00;41
7109;53;626488491;7109;265;8033;8073;7.63;0.47;265.11;6.95;924;54;2751.00;40
7113;53;626488504;7113;268;8034;8073;7.69;0.47;265.18;6.95;921;54;2752.00;39
7116;53;626488521;7116;269;8035;8073;7.71;0.47;265.20;6.95;919;54;2753.00;38
7121;53;626488534;7121;271;8040;8076;7.74;0.48;265.24;6.95;919;54;2754.00;36
7128;53;626488546;7128;274;8040;8076;7.69;0.47;265.21;6.95;912;54;2755.00;36
7132;53;626488558;7132;278;8042;8076;7.64;0.47;265.31;6.95;910;54;2756.00;34
7136;53;626488570;7136;283;8045;8080;7.61;0.47;265.28;6.95;909;54;2757.00;35
7139;53;626488581;7139;295;8046;8081;7.59;0.47;265.29;6.95;907;54;2758.00;35
7142;53;626488593;7142;298;8046;8081;7.49;0.46;265.34;6.95;904;54;2759.00;35
7145;53;626488607;7145;313;8050;8086;7.45;0.46;265.32;6.95;905;54;2760.00;36
7152;53;626488619;7152;322;8050;8086;7.28;0.45;265.27;6.95;898;54;2761.00;36
7154;53;626488630;7154;322;8050;8086;7.25;0.45;265.31;6.95;896;54;2762.00;36
7157;53;626488642;7157;335;8051;8087;7.20;0.44;265.23;6.95;894;54;2763.00;36
7160;53;626488653;7160;340;8051;8087;7.14;0.44;265.19;6.95;891;54;2764.00;36
7164;53;626488665;7164;345;8055;8093;7.07;0.43;265.25;6.94;891;54;2765.00;38
7169;53;626488678;7169;347;8056;8093;7.03;0.43;265.31;6.94;887;54;2766.00;37
7172;53;626488690;7172;337;8057;8094;7.00;0.43;265.33;6.98;885;54;2767.00;37
7174;53;626488704;7174;330;8057;8094;6.96;0.43;265.36;6.98;883;54;2768.00;37
7180;53;626488715;7180;325;8057;8094;6.95;0.42;265.25;6.98;877;54;2769.00;37
7183;53;626488727;7183;325;8057;8094;6.95;0.43;265.23;6.98;874;54;2770.00;37
7184;53;626488738;7184;331;8057;8094;6.96;0.43;265.22;6.98;873;54;2771.00;37
7186;53;626488755;7186;334;8067;8106;7.14;0.44;265.21;6.97;881;54;2772.00;39
7187;53;626488768;7187;331;8067;8106;7.20;0.44;265.23;6.97;880;54;2773.00;39
7191;53;626488785;7191;331;8068;8106;7.30;0.44;265.19;6.97;877;54;2774.00;38
7193;53;626488797;7193;329;8068;8106;7.34;0.45;265.21;6.97;875;54;2775.00;38
7196;53;626488808;7196;318;8068;8106;7.40;0.45;265.20;6.97;872;54;2776.00;38
7197;53;626488820;7197;298;8068;8106;7.46;0.45;265.20;6.97;871;54;2777.00;38
7200;53;626488832;7200;288;8071;8110;7.49;0.46;265.19;6.97;871;54;2778.00;39
7205;53;626488850;7205;279;8071;8110;7.50;0.46;265.20;6.97;866;54;2779.00;39
7206;53;626488862;7206;271;8074;8114;7.55;0.46;265.17;6.97;868;54;2780.00;40
7208;53;626488874;7208;258;8076;8115;7.61;0.46;265.19;6.97;868;54;2781.00;39
7211;53;626488886;7211;256;8077;8115;7.64;0.47;265.14;7.01;866;54;2782.00;38
7213;53;626488898;7213;259;8077;8115;7.68;0.47;265.25;7.01;864;54;2783.00;38
7213;53;626488910;7213;262;8088;8128;7.81;0.48;265.25;7.00;875;54;2784.00;40
7214;53;626488922;7214;267;8088;8128;7.84;0.48;265.23;7.00;874;54;2785.00;40
7215;53;626488933;7215;270;8088;8128;7.81;0.48;265.24;7.00;873;54;2786.00;40
7217;53;626488951;7217;274;8089;8129;7.86;0.48;265.26;7.00;872;54;2787.00;40
7219;53;626488964;7219;264;8089;8130;7.86;0.48;265.23;7.00;870;54;2788.00;41
7223;53;626488978;7223;271;8089;8130;7.82;0.48;265.23;7.00;866;54;2789.00;41
7225;53;626488992;7225;270;8092;8136;7.83;0.48;265.20;6.99;867;54;2790.00;44
7229;53;626489005;7229;270;8093;8136;7.79;0.47;265.14;6.99;864;54;2791.00;43
7230;53;626489018;7230;274;8093;8136;7.72;0.47;265.12;6.99;863;54;2792.00;43
7232;53;626489033;7232;280;8094;8136;7.66;0.47;265.12;6.99;862;54;2793.00;42
7234;53;626489050;7234;289;8097;8142;7.55;0.46;265.09;6.99;863;54;2794.00;45
7237;53;626489067;7237;290;8098;8142;7.46;0.45;265.07;6.99;861;54;2795.00;44
7238;53;626489083;7238;293;8098;8142;7.31;0.44;265.06;6.99;860;54;2796.00;44
7241;53;626489100;7241;302;8099;8142;7.27;0.44;265.05;6.99;858;54;2797.00;43
7241;53;626489116;7241;305;8103;8146;7.20;0.44;265.05;7.02;862;54;2798.00;43
7244;53;626489131;7244;307;8105;8147;7.10;0.43;264.98;7.02;861;54;2799.00;42
7244;53;626489149;7244;311;8105;8147;7.04;0.43;264.98;7.02;861;54;2800.00;42
7248;53;626489165;7248;318;8106;8148;7.02;0.43;265.05;7.02;858;54;2801.00;42
7249;53;626489177;7249;318;8106;8148;6.95;0.42;265.05;7.02;857;54;2802.00;42
7250;53;626489189;7250;314;8106;8148;6.96;0.42;265.03;7.02;856;54;2803.00;42
7250;53;626489202;7250;305;8106;8148;6.99;0.43;265.03;7.02;856;54;2804.00;42
7252;53;626489213;7252;296;8106;8148;7.02;0.43;265.09;7.02;854;54;2805.00;42
7253;53;626489225;7253;291;8106;8148;7.07;0.43;265.08;7.02;853;54;2806.00;42
7254;53;626489236;7254;288;8106;8148;7.13;0.43;265.06;7.02;852;54;2807.00;42
7255;53;626489248;7255;297;8149;8218;7.17;0.44;265.06;6.98;894;54;2808.00;69
7256;53;626489265;7256;284;8149;8219;7.22;0.44;265.06;6.98;893;54;2809.00;70
7259;53;626489283;7259;272;8155;8219;7.38;0.45;265.07;6.98;896;54;2810.00;64
7260;53;626489295;7260;255;8158;8219;7.42;0.45;265.06;6.98;898;54;2811.00;61
7261;53;626489306;7261;249;8162;8219;7.48;0.46;265.05;6.98;901;54;2812.00;57
7262;54;626489318;7262;247;8166;8219;7.58;0.46;265.06;6.97;904;55;2813.00;53
7263;54;626489343;7263;249;8169;8219;7.67;0.47;265.05;6.97;906;55;2814.00;50
7265;54;626489360;7265;253;8170;8219;7.70;0.47;265.03;6.97;905;55;2815.00;49
7266;54;626489377;7266;254;8172;8220;7.76;0.47;265.01;6.97;906;55;2816.00;48
7266;54;626489390;7266;260;8173;8221;7.79;0.47;265.01;6.97;907;55;2817.00;48
7269;54;626489402;7269;250;8175;8221;7.76;0.47;264.97;7.01;906;55;2818.00;46
7269;54;626489413;7269;251;8178;8225;7.73;0.47;264.97;7.01;909;55;2819.00;47
7271;54;626489427;7271;251;8178;8225;7.69;0.47;264.94;7.01;907;55;2820.00;47
7272;54;626489438;7272;253;8178;8225;7.64;0.47;264.94;7.01;906;55;2821.00;47
7274;54;626489449;7274;246;8178;8225;7.60;0.46;264.94;7.01;904;55;2822.00;47
7276;54;626489461;7276;242;8181;8231;7.59;0.46;264.94;7.00;905;55;2823.00;50
7281;54;626489474;7281;235;8182;8231;7.60;0.46;264.94;7.00;901;55;2824.00;49
7285;54;626489485;7285;231;8184;8231;7.62;0.46;265.00;7.03;899;55;2825.00;47
7285;54;626489498;7285;227;8186;8234;7.74;0.47;265.00;7.02;901;55;2826.00;48
7290;54;626489510;7290;222;8186;8234;7.79;0.47;265.00;7.02;896;55;2827.00;48
7296;54;626489527;7296;214;8187;8234;7.76;0.47;264.96;7.02;891;55;2828.00;47
7300;54;626489540;7300;208;8187;8235;7.75;0.47;264.87;7.02;887;55;2829.00;48
7302;54;626489551;7302;201;8188;8236;7.78;0.47;265.01;7.02;886;55;2830.00;48
7306;54;626489563;7306;193;8188;8236;7.80;0.47;265.03;7.02;882;55;2831.00;48
7309;54;626489575;7309;197;8198;8249;7.82;0.48;265.04;7.01;889;55;2832.00;51
7312;54;626489587;7312;200;8198;8249;7.91;0.48;264.96;7.01;886;55;2833.00;51
7316;54;626489599;7316;199;8199;8249;7.94;0.48;264.96;7.05;883;55;2834.00;50
7318;54;626489610;7318;202;8201;8251;8.03;0.49;265.00;7.05;883;55;2835.00;50
7321;54;626489621;7321;205;8201;8251;8.10;0.49;264.99;7.05;880;55;2836.00;50
7323;54;626489633;7323;206;8205;8255;8.19;0.50;265.03;7.09;882;55;2837.00;50
7326;54;626489645;7326;206;8207;8255;8.26;0.50;265.09;7.09;881;55;2838.00;48
7329;54;626489656;7329;203;8211;8259;8.23;0.50;265.11;7.08;882;55;2839.00;48
7333;54;626489668;7333;204;8211;8259;8.28;0.50;265.16;7.08;878;55;2840.00;48
7335;54;626489680;7335;206;8211;8259;8.34;0.51;265.22;7.08;876;55;2841.00;48
7336;54;626489692;7336;202;8212;8259;8.39;0.51;265.22;7.12;876;55;2842.00;47
7340;54;626489703;7340;204;8212;8259;8.40;0.51;265.30;7.12;872;55;2843.00;47
7342;54;626489716;7342;198;8222;8271;8.44;0.51;265.27;7.11;880;55;2844.00;49
7346;54;626489728;7346;205;8223;8271;8.42;0.51;265.34;7.11;877;55;2845.00;48
7350;54;626489741;7350;206;8223;8271;8.39;0.51;265.37;7.11;873;55;2846.00;48
7351;54;626489753;7351;214;8223;8271;8.40;0.51;265.41;7.11;872;55;2847.00;48
7352;54;626489766;7352;216;8223;8271;8.39;0.51;265.42;7.11;871;55;2848.00;48
7354;54;626489784;7354;215;8223;8271;8.39;0.51;265.44;7.11;869;55;2849.00;48
7356;54;626489798;7356;217;8227;8274;8.37;0.51;265.42;7.14;871;55;2850.00;47
7357;54;626489810;7357;220;8227;8274;8.42;0.51;265.43;7.14;870;55;2851.00;47
7360;54;626489822;7360;219;8232;8280;8.52;0.52;265.53;7.15;872;55;2852.00;48
7360;54;626489835;7360;219;8235;8281;8.55;0.52;265.53;7.16;875;55;2853.00;46
7366;54;626489847;7366;212;8236;8281;8.50;0.52;265.57;7.17;870;55;2854.00;45
7368;54;626489860;7368;210;8236;8281;8.52;0.52;265.59;7.17;868;55;2855.00;45
7370;54;626489872;7370;212;8240;8285;8.55;0.52;265.60;7.18;870;55;2856.00;45
7374;54;626489890;7374;209;8241;8285;8.57;0.52;265.72;7.19;867;55;2857.00;44
7377;54;626489902;7377;216;8242;8285;8.62;0.52;265.75;7.20;865;55;2858.00;43
7381;54;626489915;7381;206;8244;8286;8.67;0.53;265.78;7.21;863;55;2859.00;42
7384;54;626489927;7384;202;8247;8290;8.71;0.53;265.84;7.21;863;55;2860.00;43
7385;54;626489946;7385;207;8248;8290;8.79;0.53;265.89;7.22;863;55;2861.00;42
7386;54;626489958;7386;206;8251;8293;8.83;0.54;265.87;7.22;865;55;2862.00;42
7389;54;626489971;7389;208;8253;8293;8.85;0.54;265.96;7.24;864;55;2863.00;40
7391;54;626489983;7391;209;8254;8295;8.79;0.53;265.98;7.24;863;55;2864.00;41
7393;54;626489995;7393;208;8257;8295;8.71;0.53;266.01;7.25;864;55;2865.00;38
7396;54;626490010;7396;210;8260;8299;8.65;0.53;266.08;7.25;864;55;2866.00;39
7398;54;626490026;7398;209;8262;8299;8.55;0.52;266.12;7.26;864;55;2867.00;37
7401;54;626490039;7401;213;8263;8299;8.45;0.52;266.17;7.26;862;55;2868.00;36
7405;54;626490051;7405;211;8265;8299;8.32;0.51;266.24;7.28;860;55;2869.00;34
7407;54;626490062;7407;207;8266;8300;8.24;0.50;266.26;7.29;859;55;2870.00;34
7409;54;626490074;7409;211;8267;8301;8.22;0.50;266.29;7.29;858;55;2871.00;34
7413;54;626490086;7413;208;8267;8301;8.16;0.50;266.27;7.29;854;55;2872.00;34
7416;54;626490096;7416;212;8271;8302;8.08;0.49;266.31;7.32;855;55;2873.00;31
7420;54;626490107;7420;207;8271;8302;8.00;0.49;266.34;7.32;851;55;2874.00;31
7423;54;626490118;7423;212;8272;8302;7.96;0.48;266.41;7.32;849;55;2875.00;30
7426;54;626490128;7426;208;8272;8302;7.94;0.48;266.47;7.32;846;55;2876.00;30
7426;54;626490139;7426;211;8272;8302;7.96;0.49;266.47;7.32;846;55;2877.00;30
7431;54;626490149;7431;209;8275;8302;7.91;0.48;266.52;7.35;844;55;2878.00;27
7432;54;626490159;7432;207;8275;8302;7.92;0.48;266.55;7.35;843;55;2879.00;27
7434;54;626490170;7434;247;8377;8532;7.97;0.50;266.56;7.27;943;55;2880.00;155
7441;54;626490199;7441;243;8379;8533;7.94;0.50;266.56;7.27;938;55;2881.00;154
7443;54;626490211;7443;234;8389;8533;8.00;0.50;266.61;7.26;946;55;2882.00;144
7448;54;626490221;7448;233;8398;8533;8.02;0.50;266.66;7.27;950;55;2883.00;135
7454;54;626490232;7454;231;8405;8533;8.01;0.50;266.87;7.26;951;55;2884.00;128
7458;54;626490243;7458;227;8413;8533;7.96;0.49;266.86;7.26;955;55;2885.00;120
7461;54;626490255;7461;236;8419;8533;7.89;0.49;266.92;7.26;958;55;2886.00;114
7465;54;626490266;7465;234;8427;8533;7.81;0.49;267.06;7.27;962;55;2887.00;106
7471;54;626490276;7471;243;8435;8534;7.71;0.48;267.10;7.28;964;55;2888.00;99
7476;54;626490287;7476;254;8437;8535;7.62;0.47;267.07;7.28;961;55;2889.00;98
7480;54;626490298;7480;245;8444;8535;7.52;0.47;267.06;7.28;964;55;2890.00;91
7484;54;626490310;7484;241;8448;8536;7.47;0.46;267.12;7.28;964;55;2891.00;88
7488;54;626490321;7488;240;8450;8536;7.38;0.46;267.15;7.28;962;55;2892.00;86
7493;54;626490332;7493;242;8455;8536;7.25;0.45;267.31;7.29;962;55;2893.00;81
7500;54;626490343;7500;250;8458;8536;7.11;0.44;267.45;7.29;958;55;2894.00;78
7504;54;626490355;7504;258;8462;8540;6.97;0.43;267.54;7.29;958;55;2895.00;78
7508;54;626490367;7508;271;8467;8540;6.83;0.42;267.58;7.30;959;55;2896.00;73
7512;54;626490378;7512;268;8471;8540;6.75;0.42;267.65;7.30;959;55;2897.00;69
7514;55;626490390;7514;264;8473;8543;6.82;0.42;267.65;7.30;959;56;2898.00;70
7517;55;626490419;7517;267;8475;8543;6.85;0.42;267.64;7.30;958;56;2899.00;68
7519;55;626490432;7519;269;8477;8543;6.91;0.42;267.65;7.31;958;56;2900.00;66
7522;55;626490447;7522;272;8483;8547;6.92;0.43;267.71;7.31;961;56;2901.00;64
7526;55;626490459;7526;271;8489;8548;6.95;0.43;267.82;7.36;963;56;2902.00;59
7530;55;626490473;7530;271;8489;8548;6.99;0.43;267.78;7.36;959;56;2903.00;59
7535;55;626490489;7535;269;8491;8552;7.05;0.43;267.87;7.36;956;56;2904.00;61
7541;55;626490502;7541;274;8494;8552;7.04;0.43;267.84;7.36;953;56;2905.00;58
7543;55;626490514;7543;274;8496;8552;7.15;0.44;267.86;7.37;953;56;2906.00;56
7548;55;626490532;7548;275;8501;8553;7.13;0.44;267.91;7.37;953;56;2907.00;52
7550;55;626490549;7550;284;8504;8553;7.05;0.43;267.90;7.38;954;56;2908.00;49
7552;55;626490561;7552;283;8508;8559;7.02;0.43;267.91;7.37;956;56;2909.00;51
7556;55;626490575;7556;283;8511;8559;6.97;0.43;267.93;7.38;955;56;2910.00;48
7559;55;626490586;7559;290;8513;8560;6.99;0.43;267.92;7.38;954;56;2911.00;47
7562;55;626490598;7562;295;8514;8560;7.05;0.43;267.87;7.39;952;56;2912.00;46
7564;55;626490610;7564;296;8515;8560;7.05;0.43;267.93;7.39;951;56;2913.00;45
7565;55;626490622;7565;310;8516;8560;6.95;0.42;267.95;7.39;951;56;2914.00;44
7567;55;626490634;7567;316;8518;8560;6.85;0.42;267.96;7.40;951;56;2915.00;42
7570;55;626490647;7570;325;8527;8572;6.83;0.42;267.96;7.39;957;56;2916.00;45
7572;55;626490660;7572;328;8527;8572;6.78;0.42;268.03;7.39;955;56;2917.00;45
7577;55;626490672;7577;339;8529;8572;6.74;0.41;268.05;7.39;952;56;2918.00;43
7583;55;626490683;7583;338;8529;8572;6.70;0.41;268.07;7.39;946;56;2919.00;43
7584;55;626490695;7584;344;8529;8572;6.72;0.41;268.05;7.39;945;56;2920.00;43
7587;55;626490707;7587;346;8529;8572;6.68;0.41;268.04;7.39;942;56;2921.00;43
7592;55;626490718;7592;355;8532;8576;6.64;0.41;268.13;7.38;940;56;2922.00;44
7596;55;626490730;7596;364;8532;8576;6.60;0.40;268.11;7.38;936;56;2923.00;44
7598;55;626490742;7598;371;8535;8580;6.60;0.40;268.10;7.38;937;56;2924.00;45
7599;55;626490754;7599;376;8538;8582;6.61;0.41;268.08;7.38;939;56;2925.00;44
7601;55;626490766;7601;379;8538;8582;6.59;0.41;268.13;7.38;937;56;2926.00;44
7606;55;626490777;7606;381;8538;8582;6.56;0.40;268.09;7.38;932;56;2927.00;44
7607;55;626490788;7607;383;8548;8595;6.67;0.41;268.11;7.37;941;56;2928.00;47
7610;55;626490800;7610;384;8548;8595;6.64;0.41;268.08;7.37;938;56;2929.00;47
7616;55;626490811;7616;385;8548;8595;6.57;0.40;267.97;7.37;932;56;2930.00;47
7618;55;626490822;7618;391;8549;8596;6.54;0.40;267.98;7.37;931;56;2931.00;47
7623;55;626490834;7623;398;8549;8597;6.46;0.40;268.02;7.37;926;56;2932.00;48
7627;55;626490845;7627;406;8550;8597;6.42;0.39;267.99;7.42;923;56;2933.00;47
7631;55;626490855;7631;409;8552;8600;6.42;0.39;267.97;7.42;921;56;2934.00;48
7633;55;626490868;7633;415;8552;8600;6.37;0.39;267.94;7.42;919;56;2935.00;48
7635;55;626490878;7635;421;8553;8600;6.34;0.39;267.89;7.42;918;56;2936.00;47
7635;55;626490890;7635;406;8553;8600;6.36;0.39;267.89;7.42;918;56;2937.00;47
7638;55;626490900;7638;407;8557;8606;6.38;0.39;267.86;7.41;919;56;2938.00;49
7641;55;626490912;7641;410;8557;8606;6.39;0.39;267.92;7.41;916;56;2939.00;49
7645;55;626490925;7645;412;8558;8606;6.35;0.39;267.80;7.41;913;56;2940.00;48
7645;55;626490936;7645;407;8558;8606;6.36;0.39;267.80;7.41;913;56;2941.00;48
7646;55;626490948;7646;409;8561;8610;6.39;0.39;267.79;7.41;915;56;2942.00;49
7647;55;626490959;7647;402;8562;8611;6.43;0.39;267.76;7.41;915;56;2943.00;49
7650;55;626490971;7650;402;8562;8611;6.46;0.39;267.75;7.41;912;56;2944.00;49
7650;55;626490981;7650;404;8563;8612;6.54;0.40;267.75;7.41;913;56;2945.00;49
7654;55;626490998;7654;388;8563;8612;6.58;0.40;267.72;7.41;909;56;2946.00;49
7655;55;626491010;7655;380;8563;8612;6.65;0.40;267.71;7.41;908;56;2947.00;49
7657;55;626491021;7657;373;8564;8612;6.74;0.41;267.67;7.46;907;56;2948.00;48
7661;55;626491044;7661;360;8564;8612;6.81;0.41;267.68;7.46;903;56;2949.00;48
7662;55;626491065;7662;355;8564;8612;6.84;0.41;267.71;7.46;902;56;2950.00;48
7663;55;626491085;7663;354;8564;8612;6.93;0.42;267.70;7.46;901;56;2951.00;48
7663;55;626491102;7663;363;8601;8682;7.18;0.44;267.70;7.42;938;56;2952.00;81
7665;55;626491127;7665;356;8601;8683;7.25;0.44;267.68;7.42;936;56;2953.00;82
7666;55;626491145;7666;350;8608;8683;7.41;0.45;267.69;7.42;942;56;2954.00;75
7669;55;626491158;7669;332;8613;8683;7.49;0.45;267.69;7.42;944;56;2955.00;70
7670;55;626491172;7670;323;8618;8683;7.56;0.46;267.69;7.42;948;56;2956.00;65
7673;55;626491186;7673;318;8620;8683;7.65;0.46;267.65;7.42;947;56;2957.00;63
7673;55;626491203;7673;311;8622;8683;7.73;0.47;267.65;7.41;949;56;2958.00;61
7673;55;626491237;7673;308;8623;8683;7.80;0.47;267.65;7.41;950;56;2959.00;60
7674;55;626491256;7674;306;8625;8684;7.88;0.48;267.65;7.41;951;56;2960.00;59
7675;55;626491271;7675;293;8626;8685;7.93;0.48;267.65;7.41;951;56;2961.00;59
7677;55;626491291;7677;292;8627;8685;7.95;0.48;267.63;7.41;950;56;2962.00;58
7678;55;626491306;7678;285;8630;8689;7.97;0.48;267.62;7.41;952;56;2963.00;59
7680;55;626491320;7680;282;8630;8689;8.00;0.48;267.69;7.41;950;56;2964.00;59
7682;55;626491334;7682;283;8630;8689;7.97;0.48;267.67;7.41;948;56;2965.00;59
7683;55;626491346;7683;279;8630;8689;7.94;0.48;267.65;7.41;947;56;2966.00;59
7683;55;626491359;7683;280;8634;8695;7.93;0.48;267.65;7.46;951;56;2967.00;61
7684;55;626491379;7684;283;8634;8695;7.92;0.48;267.63;7.46;950;56;2968.00;61
7685;55;626491393;7685;288;8635;8695;7.92;0.48;267.60;7.46;950;56;2969.00;60
7686;55;626491415;7686;297;8638;8701;7.93;0.48;267.60;7.46;952;56;2970.00;63
7686;55;626491428;7686;303;8639;8701;7.86;0.48;267.60;7.46;953;56;2971.00;62
7688;55;626491442;7688;309;8639;8701;7.77;0.47;267.63;7.46;951;56;2972.00;62
7691;55;626491456;7691;310;8640;8702;7.74;0.47;267.62;7.46;949;56;2973.00;62
7695;55;626491470;7695;319;8641;8703;7.69;0.47;267.63;7.45;946;56;2974.00;62
7695;55;626491483;7695;321;8642;8703;7.75;0.47;267.63;7.45;947;56;2975.00;61
7697;55;626491502;7697;316;8650;8716;7.77;0.47;267.61;7.45;953;56;2976.00;66
7699;55;626491516;7699;316;8651;8716;7.80;0.47;267.57;7.45;952;56;2977.00;65
7702;55;626491530;7702;314;8651;8716;7.78;0.47;267.60;7.45;949;56;2978.00;65
7704;55;626491543;7704;317;8652;8717;7.77;0.47;267.62;7.45;948;56;2979.00;65
7706;55;626491555;7706;313;8652;8717;7.73;0.47;267.62;7.45;946;56;2980.00;65
7706;55;626491575;7706;305;8654;8721;7.79;0.48;267.62;7.44;948;56;2981.00;67
7708;55;626491588;7708;302;8654;8721;7.82;0.48;267.62;7.44;946;56;2982.00;67
7709;55;626491601;7709;302;8658;8725;7.86;0.48;267.64;7.44;949;56;2983.00;67
7714;55;626491614;7714;295;8659;8725;7.81;0.48;267.64;7.49;945;56;2984.00;66
7718;55;626491627;7718;296;8659;8725;7.80;0.48;267.64;7.49;941;56;2985.00;66
7722;55;626491639;7722;285;8659;8725;7.80;0.48;267.68;7.49;937;56;2986.00;66
7726;55;626491652;7726;279;8659;8725;7.74;0.47;267.76;7.49;933;56;2987.00;66
7730;55;626491669;7730;276;8669;8737;7.76;0.47;267.78;7.49;939;56;2988.00;68
7734;55;626491683;7734;276;8670;8737;7.75;0.47;267.75;7.49;936;56;2989.00;67
7738;55;626491695;7738;274;8672;8737;7.79;0.47;267.79;7.54;934;56;2990.00;65
7744;55;626491708;7744;274;8672;8737;7.80;0.47;267.86;7.54;928;56;2991.00;65
7748;55;626491720;7748;270;8672;8737;7.83;0.48;267.92;7.54;924;56;2992.00;65
7751;55;626491732;7751;270;8672;8737;7.92;0.48;267.92;7.54;921;56;2993.00;65
7757;55;626491744;7757;261;8674;8738;7.97;0.48;268.00;7.55;917;56;2994.00;64
7759;55;626491756;7759;254;8676;8738;8.01;0.49;267.98;7.57;917;56;2995.00;62
7762;55;626491769;7762;254;8680;8744;8.09;0.49;267.97;7.63;918;56;2996.00;64
7767;55;626491781;7767;255;8682;8745;8.18;0.50;267.96;7.62;915;56;2997.00;63
7769;55;626491794;7769;253;8682;8745;8.24;0.50;267.99;7.62;913;56;2998.00;63
7772;55;626491805;7772;250;8682;8745;8.25;0.50;268.09;7.62;910;56;2999.00;63
7776;55;626491820;7776;248;8687;8765;8.25;0.50;268.13;7.62;911;56;3000.00;78
7777;55;626491838;7777;239;8687;8765;8.29;0.50;268.19;7.62;910;56;3001.00;78
7781;55;626491851;7781;234;8687;8765;8.33;0.51;268.18;7.62;906;56;3002.00;78
7787;55;626491870;7787;225;8688;8766;8.38;0.51;268.24;7.62;901;56;3003.00;78
7790;55;626491882;7790;216;8692;8770;8.40;0.51;268.21;7.67;902;56;3004.00;78
7793;55;626491894;7793;211;8692;8770;8.42;0.51;268.27;7.67;899;56;3005.00;78
7795;55;626491906;7795;209;8696;8773;8.46;0.51;268.34;7.67;901;56;3006.00;77
7797;55;626491919;7797;207;8696;8773;8.51;0.52;268.40;7.67;899;56;3007.00;77
7800;55;626491931;7800;211;8697;8773;8.59;0.52;268.42;7.68;897;56;3008.00;76
7804;55;626491944;7804;208;8699;8773;8.67;0.53;268.48;7.69;895;56;3009.00;74
7804;55;626491956;7804;212;8702;8777;8.73;0.53;268.48;7.70;898;56;3010.00;75
7809;55;626491969;7809;209;8703;8777;8.80;0.53;268.48;7.70;894;56;3011.00;74
7813;55;626491982;7813;211;8707;8777;8.81;0.53;268.50;7.70;894;56;3012.00;70
7816;55;626491995;7816;207;8708;8777;8.87;0.54;268.49;7.70;892;56;3013.00;69
7819;55;626492007;7819;202;8708;8778;8.92;0.54;268.54;7.70;889;56;3014.00;70
7821;55;626492021;7821;203;8713;8780;8.91;0.54;268.54;7.70;892;56;3015.00;67
7823;55;626492037;7823;204;8714;8780;8.94;0.54;268.56;7.70;891;56;3016.00;66
7826;55;626492049;7826;206;8716;8781;9.01;0.55;268.61;7.70;890;56;3017.00;65
7830;55;626492063;7830;208;8717;8781;9.03;0.55;268.71;7.70;887;56;3018.00;64
7831;55;626492076;7831;210;8717;8781;9.12;0.55;268.69;7.70;886;56;3019.00;64
7832;55;626492088;7832;214;8720;8781;9.14;0.55;268.73;7.73;888;56;3020.00;61
7835;55;626492100;7835;213;8720;8781;9.15;0.55;268.81;7.73;885;56;3021.00;61
7840;55;626492113;7840;216;8720;8781;9.15;0.55;268.85;7.73;880;56;3022.00;61
7843;55;626492125;7843;214;8723;8781;9.10;0.55;268.92;7.77;880;56;3023.00;58
7844;55;626492137;7844;231;8788;8908;9.03;0.55;268.92;7.71;944;56;3024.00;120
7848;55;626492165;7848;225;8792;8909;8.96;0.55;269.01;7.72;944;56;3025.00;117
7850;55;626492178;7850;216;8799;8909;8.99;0.55;268.99;7.73;949;56;3026.00;110
7855;55;626492192;7855;217;8803;8909;9.01;0.55;269.02;7.74;948;56;3027.00;106
7859;55;626492206;7859;220;8810;8909;9.04;0.56;269.07;7.75;951;56;3028.00;99
7860;55;626492220;7860;222;8816;8909;9.14;0.56;269.09;7.76;956;56;3029.00;93
7864;55;626492236;7864;226;8821;8909;9.17;0.56;269.13;7.78;957;56;3030.00;88
7865;55;626492250;7865;228;8826;8909;9.24;0.57;269.16;7.78;961;56;3031.00;83
7868;55;626492266;7868;231;8831;8910;9.29;0.57;269.17;7.80;963;56;3032.00;79
7869;55;626492280;7869;231;8834;8911;9.29;0.57;269.19;7.81;965;56;3033.00;77
7873;55;626492298;7873;237;8839;8911;9.26;0.57;269.20;7.81;966;56;3034.00;72
7875;55;626492311;7875;241;8844;8912;9.19;0.57;269.21;7.83;969;56;3035.00;68
7878;55;626492323;7878;240;8848;8912;9.05;0.56;269.22;7.84;970;56;3036.00;64
7881;55;626492337;7881;244;8850;8912;8.89;0.55;269.26;7.85;969;56;3037.00;62
7886;55;626492349;7886;259;8854;8912;8.79;0.54;269.27;7.86;968;56;3038.00;58
7888;55;626492362;7888;255;8857;8916;8.71;0.54;269.30;7.86;969;56;3039.00;59
7890;55;626492375;7890;264;8860;8916;8.58;0.53;269.32;7.87;970;56;3040.00;56
7896;55;626492388;7896;267;8861;8916;8.49;0.52;269.37;7.88;965;56;3041.00;55
7899;55;626492400;7899;268;8864;8919;8.42;0.52;269.45;7.88;965;56;3042.00;55
7901;55;626492413;7901;272;8868;8919;8.35;0.51;269.42;7.90;967;56;3043.00;51
7903;55;626492425;7903;276;8869;8919;8.30;0.51;269.47;7.90;966;56;3044.00;50
7903;55;626492438;7903;277;8873;8923;8.29;0.51;269.47;7.90;970;56;3045.00;50
7906;55;626492450;7906;278;8876;8924;8.22;0.50;269.66;7.91;970;56;3046.00;48
7909;55;626492462;7909;287;8877;8924;8.08;0.49;269.65;7.91;968;56;3047.00;47
7912;55;626492475;7912;288;8881;8928;7.96;0.49;269.63;7.91;969;56;3048.00;47
7914;55;626492487;7914;293;8883;8928;7.87;0.48;269.66;7.92;969;56;3049.00;45
7918;55;626492499;7918;287;8883;8928;7.72;0.47;269.66;7.92;965;56;3050.00;45
7922;55;626492511;7922;288;8884;8929;7.58;0.46;269.66;7.92;962;56;3051.00;45
7929;55;626492522;7929;287;8884;8929;7.46;0.46;269.79;7.92;955;56;3052.00;45
7933;55;626492534;7933;295;8890;8935;7.42;0.45;269.77;7.92;957;56;3053.00;45
7936;55;626492545;7936;292;8890;8935;7.36;0.45;269.78;7.92;954;56;3054.00;45
7942;55;626492556;7942;292;8894;8936;7.28;0.44;269.82;7.93;952;56;3055.00;42
7948;55;626492568;7948;297;8894;8936;7.15;0.44;269.80;7.93;946;56;3056.00;42
7951;55;626492578;7951;305;8896;8936;7.04;0.43;269.78;7.93;945;56;3057.00;40
7952;55;626492589;7952;309;8897;8936;6.91;0.42;269.77;7.94;945;56;3058.00;39
7957;55;626492599;7957;319;8897;8936;6.72;0.41;269.83;7.94;940;56;3059.00;39
7961;55;626492616;7961;317;8921;8972;6.69;0.41;269.86;7.92;960;56;3060.00;51
7961;55;626492630;7961;313;8923;8972;6.64;0.41;269.86;7.92;962;56;3061.00;49
7966;55;626492641;7966;313;8926;8972;6.56;0.41;269.97;7.92;960;56;3062.00;46
7972;55;626492652;7972;304;8928;8972;6.49;0.40;270.04;7.92;956;56;3063.00;44
7972;55;626492662;7972;314;8929;8972;6.50;0.40;270.04;7.92;957;56;3064.00;43
7976;55;626492672;7976;319;8930;8972;6.45;0.40;270.15;7.93;954;56;3065.00;42
7980;55;626492689;7980;324;8934;8976;6.44;0.40;270.26;7.92;954;56;3066.00;42
7983;55;626492700;7983;330;8934;8976;6.43;0.39;270.25;7.92;951;56;3067.00;42
7989;55;626492710;7989;332;8938;8980;6.39;0.39;270.27;7.93;949;56;3068.00;42
7992;55;626492722;7992;333;8939;8981;6.41;0.39;270.29;7.93;947;56;3069.00;42
7996;55;626492733;7996;331;8940;8981;6.35;0.39;270.48;7.93;944;56;3070.00;41
8001;55;626492743;8001;328;8941;8981;6.28;0.38;270.56;7.92;940;56;3071.00;40
8005;55;626492754;8005;326;8951;8994;6.26;0.38;270.61;7.92;946;56;3072.00;43
8006;55;626492766;8006;320;8953;8994;6.24;0.38;270.63;7.92;947;56;3073.00;41
8010;55;626492776;8010;320;8953;8994;6.21;0.38;270.74;7.92;943;56;3074.00;41
8015;55;626492787;8015;324;8954;8995;6.20;0.38;270.69;7.91;939;56;3075.00;41
8016;55;626492798;8016;328;8954;8996;6.26;0.38;270.70;7.91;938;56;3076.00;42
8020;55;626492808;8020;330;8954;8996;6.27;0.39;270.66;7.91;934;56;3077.00;42
8023;55;626492819;8023;328;8957;8999;6.33;0.39;270.61;7.91;934;56;3078.00;42
8026;55;626492830;8026;332;8957;8999;6.34;0.39;270.60;7.91;931;56;3079.00;42
8031;55;626492840;8031;335;8957;8999;6.30;0.39;270.61;7.91;926;56;3080.00;42
8033;55;626492851;8033;340;8957;8999;6.26;0.38;270.57;7.91;924;56;3081.00;42
8036;55;626492862;8036;345;8961;9005;6.20;0.38;270.58;7.91;925;56;3082.00;44
8039;55;626492873;8039;344;8963;9005;6.14;0.38;270.52;7.96;924;56;3083.00;42
8043;55;626492884;8043;342;8963;9005;6.17;0.38;270.48;7.96;920;56;3084.00;42
8049;55;626492895;8049;340;8963;9005;6.15;0.38;270.48;7.96;914;56;3085.00;42
8053;55;626492905;8053;348;8966;9009;6.18;0.38;270.42;7.96;913;56;3086.00;43
8057;55;626492916;8057;354;8967;9010;6.15;0.38;270.36;7.96;910;56;3087.00;43
8061;55;626492928;8061;352;8967;9010;6.13;0.38;270.44;7.96;906;56;3088.00;43
8066;55;626492938;8066;359;8968;9011;6.12;0.37;270.48;7.96;902;56;3089.00;43
8073;55;626492957;8073;368;8968;9011;6.06;0.37;270.38;7.96;895;56;3090.00;43
8074;55;626492968;8074;374;8968;9011;6.08;0.37;270.40;7.96;894;56;3091.00;43
8079;55;626492978;8079;378;8968;9011;6.05;0.37;270.35;7.96;889;56;3092.00;43
8081;55;626492989;8081;379;8968;9011;6.12;0.37;270.38;7.96;887;56;3093.00;43
8085;55;626492999;8085;381;8968;9011;6.11;0.37;270.43;7.96;883;56;3094.00;43
8088;55;626493010;8088;381;8968;9011;6.10;0.37;270.37;7.96;880;56;3095.00;43
8092;55;626493020;8092;383;9006;9081;6.30;0.38;270.39;7.92;914;56;3096.00;75
8094;55;626493041;8094;385;9007;9082;6.34;0.39;270.36;7.92;913;56;3097.00;75
8096;55;626493059;8096;379;9016;9082;6.48;0.40;270.34;7.92;920;56;3098.00;66
8099;55;626493077;8099;383;9020;9082;6.53;0.40;270.43;7.92;921;56;3099.00;62
8102;55;626493098;8102;383;9024;9082;6.58;0.40;270.46;7.91;922;56;3100.00;58
8103;55;626493119;8103;385;9028;9082;6.65;0.41;270.43;7.91;925;56;3101.00;54
8108;55;626493140;8108;389;9032;9082;6.65;0.41;270.51;7.91;924;56;3102.00;50
8108;55;626493153;8108;388;9032;9082;6.61;0.40;270.51;7.91;924;56;3103.00;50
8112;55;626493165;8112;386;9034;9083;6.57;0.40;270.55;7.91;922;56;3104.00;49
8113;55;626493177;8113;396;9036;9085;6.53;0.40;270.53;7.91;923;56;3105.00;49
8115;55;626493189;8115;407;9038;9085;6.40;0.39;270.57;7.97;923;56;3106.00;47
8116;55;626493203;8116;385;9041;9089;6.36;0.39;270.54;7.96;925;56;3107.00;48
8120;55;626493217;8120;370;9041;9089;6.34;0.39;270.48;7.96;921;56;3108.00;48
8122;55;626493230;8122;365;9041;9089;6.46;0.39;270.50;7.96;919;56;3109.00;48
8123;55;626493243;8123;357;9041;9089;6.58;0.40;270.49;7.96;918;56;3110.00;48
8126;55;626493257;8126;354;9045;9095;6.75;0.41;270.55;7.96;919;56;3111.00;50
8128;55;626493271;8128;347;9045;9095;6.88;0.42;270.51;7.96;917;56;3112.00;50
8130;55;626493284;8130;344;9046;9095;6.97;0.43;270.53;7.96;916;56;3113.00;49
8132;55;626493303;8132;337;9048;9098;7.06;0.43;270.51;7.96;916;56;3114.00;50
8132;55;626493316;8132;338;9049;9098;7.20;0.44;270.51;7.96;917;56;3115.00;49
8133;55;626493336;8133;318;9049;9098;7.31;0.45;270.51;7.96;916;56;3116.00;49
8135;55;626493356;8135;298;9049;9099;7.39;0.45;270.46;7.96;914;56;3117.00;50
8138;55;626493369;8138;288;9050;9100;7.48;0.46;270.43;7.96;912;56;3118.00;50
8140;55;626493382;8140;284;9050;9100;7.56;0.46;270.41;7.96;910;56;3119.00;50
8140;55;626493399;8140;287;9070;9126;7.79;0.48;270.41;7.94;930;56;3120.00;56
8143;55;626493415;8143;280;9071;9126;7.90;0.48;270.40;7.94;928;56;3121.00;55
8144;55;626493429;8144;270;9072;9126;8.00;0.49;270.40;7.94;928;56;3122.00;54
8145;55;626493442;8145;269;9073;9127;8.13;0.50;270.37;7.94;928;56;3123.00;54
8147;55;626493457;8147;265;9073;9127;8.23;0.50;270.37;7.94;926;56;3124.00;54
8152;55;626493472;8152;265;9076;9131;8.32;0.51;270.31;7.93;924;56;3125.00;55
8154;55;626493487;8154;262;9076;9131;8.40;0.51;270.32;7.93;922;56;3126.00;55
8156;55;626493501;8156;254;9080;9135;8.38;0.51;270.38;7.93;924;56;3127.00;55
8158;55;626493516;8158;249;9080;9135;8.39;0.51;270.36;7.93;922;56;3128.00;55
8158;55;626493529;8158;250;9080;9135;8.38;0.51;270.36;7.93;922;56;3129.00;55
8162;55;626493542;8162;244;9080;9135;8.36;0.51;270.34;7.93;918;56;3130.00;55
8164;55;626493557;8164;245;9080;9135;8.43;0.51;270.34;7.93;916;56;3131.00;55
8165;55;626493572;8165;244;9089;9147;8.46;0.52;270.33;7.92;924;56;3132.00;58
8170;55;626493587;8170;248;9089;9147;8.50;0.52;270.43;7.92;919;56;3133.00;58
8171;55;626493601;8171;246;9091;9147;8.60;0.52;270.46;7.92;920;56;3134.00;56
8175;55;626493615;8175;239;9091;9147;8.60;0.52;270.54;7.92;916;56;3135.00;56
8176;55;626493629;8176;240;9091;9147;8.66;0.53;270.55;7.92;915;56;3136.00;56
8182;55;626493645;8182;239;9091;9147;8.65;0.53;270.59;7.92;909;56;3137.00;56
8184;55;626493658;8184;241;9091;9148;8.67;0.53;270.68;7.92;907;56;3138.00;57
8188;55;626493671;8188;244;9091;9148;8.62;0.53;270.70;7.92;903;56;3139.00;57
8192;55;626493684;8192;243;9095;9154;8.58;0.52;270.73;7.92;903;56;3140.00;59
8196;55;626493697;8196;244;9096;9155;8.54;0.52;270.74;7.92;900;56;3141.00;59
8198;55;626493710;8198;244;9097;9155;8.50;0.52;270.72;7.92;899;56;3142.00;58
8201;55;626493723;8201;251;9097;9155;8.51;0.52;270.79;7.92;896;56;3143.00;58
8205;55;626493735;8205;260;9101;9159;8.46;0.51;270.80;7.97;896;56;3144.00;58
8207;55;626493748;8207;261;9101;9159;8.38;0.51;270.82;7.97;894;56;3145.00;58
8210;55;626493760;8210;274;9101;9159;8.36;0.51;270.90;7.97;891;56;3146.00;58
8212;55;626493773;8212;276;9102;9160;8.30;0.51;270.92;7.97;890;56;3147.00;58
8214;55;626493785;8214;281;9105;9164;8.22;0.50;270.92;7.97;891;56;3148.00;59
8218;55;626493799;8218;284;9105;9164;8.19;0.50;270.91;7.97;887;56;3149.00;59
8223;55;626493814;8223;288;9108;9170;8.19;0.50;270.95;7.96;885;56;3150.00;62
8227;55;626493827;8227;290;9108;9170;8.11;0.49;270.98;7.96;881;56;3151.00;62
8229;55;626493840;8229;281;9109;9170;8.07;0.49;271.00;7.96;880;56;3152.00;61
8230;55;626493852;8230;281;9109;9170;8.01;0.49;271.00;7.96;879;56;3153.00;61
8231;55;626493864;8231;273;9112;9174;8.05;0.49;271.01;7.96;881;56;3154.00;62
8236;55;626493876;8236;265;9112;9174;8.01;0.49;271.02;7.96;876;56;3155.00;62
8240;55;626493888;8240;264;9113;9174;8.05;0.49;271.15;7.96;873;56;3156.00;61
8244;55;626493900;8244;255;9113;9174;8.07;0.49;271.16;7.96;869;56;3157.00;61
8247;55;626493912;8247;255;9114;9175;8.08;0.49;271.15;7.96;867;56;3158.00;61
8250;55;626493924;8250;246;9115;9176;8.02;0.49;271.26;7.96;865;56;3159.00;61
8255;55;626493936;8255;241;9116;9176;8.00;0.49;271.24;7.96;861;56;3160.00;60
8263;55;626493948;8263;241;9117;9177;7.95;0.48;271.29;7.96;854;56;3161.00;60
8267;55;626493959;8267;236;9117;9177;7.94;0.48;271.32;7.96;850;56;3162.00;60
8275;55;626493971;8275;234;9117;9177;7.89;0.48;271.37;7.96;842;56;3163.00;60
8278;55;626493983;8278;232;9118;9177;7.87;0.48;271.35;7.97;840;56;3164.00;59
8281;55;626493996;8281;227;9118;9177;7.87;0.48;271.41;7.97;837;56;3165.00;59
8283;55;626494007;8283;221;9119;9177;7.87;0.48;271.46;7.98;836;56;3166.00;58
8286;55;626494019;8286;219;9119;9177;7.90;0.48;271.51;7.98;833;56;3167.00;58
8288;55;626494030;8288;236;9189;9304;7.90;0.48;271.55;7.92;901;56;3168.00;115
8288;55;626494053;8288;220;9190;9305;7.98;0.49;271.55;7.92;902;56;3169.00;115
8295;55;626494065;8295;206;9196;9305;8.11;0.50;271.55;7.92;901;56;3170.00;109
8297;55;626494078;8297;206;9200;9305;8.25;0.50;271.59;7.92;903;56;3171.00;105
8301;55;626494090;8301;204;9203;9305;8.39;0.51;271.62;7.91;902;56;3172.00;102
8303;55;626494102;8303;198;9207;9305;8.55;0.52;271.64;7.91;904;56;3173.00;98
8306;55;626494113;8306;193;9213;9305;8.64;0.53;271.60;7.91;907;56;3174.00;92
8310;55;626494130;8310;187;9215;9305;8.69;0.53;271.64;7.91;905;56;3175.00;90
8312;55;626494143;8312;187;9218;9306;8.75;0.53;271.69;7.91;906;56;3176.00;88
8314;55;626494155;8314;185;9224;9307;8.84;0.54;271.69;7.91;910;56;3177.00;83
8319;55;626494167;8319;191;9227;9307;8.91;0.54;271.81;7.91;908;56;3178.00;80
8320;55;626494179;8320;193;9228;9308;8.95;0.54;271.84;7.91;908;56;3179.00;80
8321;55;626494193;8321;194;9230;9308;8.97;0.55;271.84;7.91;909;56;3180.00;78
8324;55;626494206;8324;193;9232;9308;8.99;0.55;271.87;7.91;908;56;3181.00;76
8327;55;626494218;8327;196;9234;9308;8.95;0.54;271.90;7.92;907;56;3182.00;74
8329;55;626494230;8329;196;9238;9312;8.97;0.54;271.89;7.92;909;56;3183.00;74
8331;55;626494243;8331;203;9239;9312;9.00;0.55;271.92;7.92;908;56;3184.00;73
8333;55;626494261;8333;203;9240;9312;9.02;0.55;271.97;7.92;907;56;3185.00;72
8334;55;626494274;8334;208;9244;9315;9.01;0.55;271.98;7.93;910;56;3186.00;71
8336;55;626494287;8336;208;9245;9315;9.02;0.55;271.97;7.94;909;56;3187.00;70
8339;55;626494300;8339;210;9246;9315;9.05;0.55;271.98;7.94;907;56;3188.00;69
8342;55;626494318;8342;217;9250;9319;9.12;0.55;271.97;7.94;908;56;3189.00;69
8345;55;626494331;8345;220;9253;9320;9.14;0.55;272.03;7.96;908;56;3190.00;67
8345;55;626494344;8345;220;9254;9322;9.19;0.56;272.03;7.96;909;56;3191.00;68
8348;55;626494357;8348;228;9260;9326;9.17;0.56;272.01;7.97;912;56;3192.00;66
8349;55;626494371;8349;223;9260;9326;9.17;0.56;272.03;7.97;911;56;3193.00;66
8351;55;626494383;8351;221;9261;9326;9.17;0.56;272.09;7.99;910;56;3194.00;65
8354;55;626494396;8354;226;9264;9328;9.14;0.56;272.07;7.99;910;56;3195.00;64
8356;55;626494409;8356;233;9265;9328;9.19;0.56;272.12;8.01;909;56;3196.00;63
8361;55;626494421;8361;236;9269;9334;9.13;0.56;272.16;8.00;908;56;3197.00;65
8363;55;626494434;8363;239;9272;9334;9.06;0.55;272.17;8.02;909;56;3198.00;62
8366;55;626494453;8366;243;9273;9335;8.96;0.55;272.20;8.04;907;56;3199.00;62
8370;55;626494466;8370;248;9273;9335;8.84;0.54;272.31;8.04;903;56;3200.00;62
8371;55;626494482;8371;255;9274;9335;8.77;0.54;272.31;8.05;903;56;3201.00;61
8375;55;626494494;8375;259;9275;9335;8.73;0.53;272.33;8.06;900;56;3202.00;60
8377;55;626494505;8377;261;9276;9335;8.73;0.53;272.37;8.07;899;56;3203.00;59
8379;55;626494516;8379;264;9286;9347;8.76;0.54;272.41;8.07;907;56;3204.00;61
8382;55;626494529;8382;261;9287;9347;8.71;0.53;272.41;8.08;905;56;3205.00;60
8385;55;626494541;8385;261;9291;9347;8.64;0.53;272.47;8.09;906;56;3206.00;56
8388;55;626494552;8388;262;9291;9347;8.58;0.52;272.48;8.09;903;56;3207.00;56
8391;55;626494563;8391;263;9292;9347;8.45;0.52;272.49;8.10;901;56;3208.00;55
8394;55;626494575;8394;263;9293;9347;8.38;0.51;272.52;8.10;899;56;3209.00;54
8396;55;626494587;8396;261;9297;9351;8.29;0.51;272.54;8.11;901;56;3210.00;54
8399;55;626494598;8399;265;9298;9351;8.25;0.50;272.54;8.11;899;56;3211.00;53
8400;55;626494609;8400;268;9302;9355;8.26;0.51;272.56;8.12;902;56;3212.00;53
8402;55;626494625;8402;275;9304;9356;8.25;0.50;272.65;8.12;902;56;3213.00;52
8406;55;626494636;8406;279;9306;9356;8.21;0.50;272.62;8.13;900;56;3214.00;50
8409;55;626494646;8409;286;9306;9356;8.16;0.50;272.69;8.13;897;56;3215.00;50
8411;55;626494657;8411;291;9318;9369;8.13;0.50;272.70;8.12;907;56;3216.00;51
8414;55;626494669;8414;290;9319;9369;8.10;0.50;272.73;8.13;905;56;3217.00;50
8415;55;626494680;8415;295;9319;9369;8.09;0.49;272.71;8.13;904;56;3218.00;50
8417;55;626494690;8417;300;9322;9370;8.10;0.50;272.73;8.14;905;56;3219.00;48
8417;55;626494701;8417;305;9322;9371;8.12;0.50;272.73;8.14;905;56;3220.00;49
8420;55;626494712;8420;307;9324;9371;8.10;0.49;272.73;8.15;904;56;3221.00;47
8426;55;626494722;8426;310;9327;9374;8.03;0.49;272.82;8.16;901;56;3222.00;47
8433;55;626494733;8433;308;9328;9374;7.92;0.48;272.80;8.16;895;56;3223.00;46
8436;55;626494743;8436;309;9329;9374;7.80;0.47;272.86;8.16;893;56;3224.00;45
8437;55;626494753;8437;308;9329;9374;7.68;0.47;272.86;8.16;892;56;3225.00;45
8444;55;626494763;8444;310;9336;9380;7.51;0.46;272.88;8.17;892;56;3226.00;44
8446;55;626494774;8446;310;9336;9380;7.32;0.45;272.86;8.17;890;56;3227.00;44
8450;55;626494783;8450;319;9338;9380;7.07;0.43;272.87;8.17;888;56;3228.00;42
8453;55;626494793;8453;329;9339;9380;6.88;0.42;272.85;8.18;886;56;3229.00;41
8455;55;626494802;8455;324;9343;9384;6.67;0.41;272.85;8.18;888;56;3230.00;41
8457;55;626494812;8457;326;9344;9385;6.52;0.40;272.85;8.18;887;56;3231.00;41
8461;55;626494822;8461;321;9346;9385;6.34;0.39;272.80;8.18;885;56;3232.00;39
8463;55;626494832;8463;322;9347;9386;6.24;0.38;272.84;8.18;884;56;3233.00;39
8465;55;626494841;8465;319;9349;9386;6.22;0.38;272.83;8.19;884;56;3234.00;37
8467;55;626494851;8467;320;9349;9386;6.21;0.38;272.83;8.19;882;56;3235.00;37
8469;55;626494860;8469;318;9349;9386;6.15;0.38;272.84;8.19;880;56;3236.00;37
8474;55;626494869;8474;324;9351;9386;6.18;0.38;272.89;8.19;877;56;3237.00;35
8480;55;626494879;8480;324;9351;9386;6.19;0.38;272.81;8.19;871;56;3238.00;35
8483;55;626494889;8483;324;9351;9386;6.21;0.38;272.78;8.19;868;56;3239.00;35
8486;55;626494900;8486;323;9406;9511;6.60;0.41;272.75;8.14;920;56;3240.00;105
8491;55;626494919;8491;330;9410;9512;6.58;0.40;272.79;8.14;919;56;3241.00;102
8491;55;626494930;8491;332;9421;9512;6.73;0.41;272.79;8.13;930;56;3242.00;91
8493;55;626494939;8493;334;9429;9512;6.73;0.41;272.79;8.13;936;56;3243.00;83
8494;55;626494950;8494;340;9433;9512;6.71;0.41;272.77;8.13;939;56;3244.00;79
8495;55;626494961;8495;348;9437;9512;6.68;0.41;272.78;8.12;942;56;3245.00;75
8498;55;626494972;8498;351;9441;9512;6.60;0.41;272.77;8.12;943;56;3246.00;71
8501;55;626494982;8501;349;9443;9512;6.58;0.41;272.72;8.12;942;56;3247.00;69
8504;55;626494992;8504;346;9447;9513;6.59;0.41;272.71;8.12;943;56;3248.00;66
8507;55;626495002;8507;348;9449;9514;6.53;0.40;272.72;8.12;942;56;3249.00;65
8510;55;626495013;8510;350;9451;9514;6.49;0.40;272.71;8.12;941;56;3250.00;63
8513;55;626495023;8513;359;9456;9518;6.45;0.40;272.70;8.12;943;56;3251.00;62
8515;55;626495035;8515;352;9457;9518;6.38;0.39;272.69;8.12;942;56;3252.00;61
8519;55;626495054;8519;355;9458;9518;6.30;0.39;272.72;8.12;939;56;3253.00;60
8520;55;626495069;8520;356;9459;9518;6.20;0.38;272.73;8.12;939;56;3254.00;59
8524;55;626495087;8524;359;9464;9524;6.12;0.38;272.73;8.12;940;56;3255.00;60
8527;55;626495104;8527;358;9465;9524;6.08;0.38;272.74;8.12;938;56;3256.00;59
8529;55;626495120;8529;366;9465;9524;6.08;0.38;272.71;8.12;936;56;3257.00;59
8534;55;626495134;8534;364;9468;9527;6.08;0.38;272.66;8.12;934;56;3258.00;59
8538;55;626495149;8538;347;9468;9527;6.07;0.37;272.66;8.12;930;56;3259.00;59
8542;55;626495160;8542;343;9469;9527;6.06;0.37;272.77;8.12;927;56;3260.00;58
8546;55;626495172;8546;336;9470;9528;6.07;0.37;272.82;8.18;924;56;3261.00;58
8547;55;626495184;8547;331;9471;9529;6.16;0.38;272.83;8.18;924;56;3262.00;58
8554;55;626495196;8554;329;9471;9529;6.23;0.38;272.83;8.18;917;56;3263.00;58
8557;55;626495208;8557;334;9482;9542;6.35;0.39;272.82;8.17;925;56;3264.00;60
8562;55;626495222;8562;334;9482;9542;6.40;0.39;272.77;8.17;920;56;3265.00;60
8565;55;626495241;8565;332;9482;9542;6.47;0.40;272.79;8.17;917;56;3266.00;60
8568;55;626495254;8568;332;9483;9543;6.56;0.40;272.75;8.17;915;56;3267.00;60
8568;55;626495267;8568;333;9483;9543;6.69;0.41;272.75;8.17;915;56;3268.00;60
8570;55;626495279;8570;333;9486;9547;6.76;0.41;272.79;8.17;916;56;3269.00;61
8573;55;626495294;8573;336;9487;9547;6.79;0.42;272.84;8.23;914;56;3270.00;60
8574;55;626495306;8574;338;9491;9551;6.89;0.42;272.86;8.23;917;56;3271.00;60
8576;55;626495319;8576;333;9491;9551;6.88;0.42;272.86;8.23;915;56;3272.00;60
8580;55;626495331;8580;338;9492;9551;6.87;0.42;272.81;8.29;912;56;3273.00;59
8581;55;626495344;8581;342;9492;9551;6.85;0.42;272.81;8.29;911;56;3274.00;59
8583;55;626495355;8583;342;9492;9551;6.81;0.42;272.80;8.29;909;56;3275.00;59
8585;55;626495367;8585;344;9502;9563;6.90;0.42;272.78;8.28;917;56;3276.00;61
8589;55;626495381;8589;334;9503;9563;6.96;0.43;272.77;8.34;914;56;3277.00;60
8590;55;626495394;8590;335;9504;9563;7.08;0.44;272.75;8.34;914;56;3278.00;59
8593;55;626495406;8593;327;9504;9563;7.18;0.44;272.74;8.34;911;56;3279.00;59
8596;55;626495418;8596;329;9504;9563;7.27;0.45;272.77;8.34;908;56;3280.00;59
8601;55;626495431;8601;326;9504;9563;7.35;0.45;272.77;8.34;903;56;3281.00;59
8603;55;626495444;8603;318;9504;9564;7.42;0.45;272.81;8.34;901;56;3282.00;60
8605;55;626495457;8605;319;9505;9564;7.40;0.45;272.83;8.40;900;56;3283.00;59
8610;55;626495477;8610;318;9509;9570;7.45;0.45;272.88;8.39;899;56;3284.00;61
8611;55;626495497;8611;326;9511;9572;7.46;0.46;272.87;8.39;900;56;3285.00;61
8614;55;626495514;8614;315;9512;9572;7.49;0.46;272.93;8.39;898;56;3286.00;60
8618;55;626495528;8618;305;9512;9572;7.48;0.46;272.94;8.39;894;56;3287.00;60
8623;55;626495541;8623;293;9515;9576;7.47;0.45;272.95;8.39;892;56;3288.00;61
8624;55;626495559;8624;283;9515;9576;7.54;0.46;272.97;8.39;891;56;3289.00;61
8626;55;626495573;8626;283;9515;9576;7.60;0.46;273.02;8.39;889;56;3290.00;61
8629;55;626495586;8629;279;9516;9577;7.66;0.47;273.04;8.39;887;56;3291.00;61
8632;55;626495599;8632;282;9520;9581;7.70;0.47;273.02;8.44;888;56;3292.00;61
8635;55;626495613;8635;284;9520;9581;7.71;0.47;273.08;8.44;885;56;3293.00;61
8636;55;626495626;8636;282;9523;9584;7.75;0.47;273.10;8.49;887;56;3294.00;61
8637;55;626495640;8637;285;9523;9584;7.82;0.48;273.09;8.49;886;56;3295.00;61
8639;55;626495654;8639;296;9524;9584;7.85;0.48;273.17;8.49;885;56;3296.00;60
8643;55;626495668;8643;295;9524;9584;7.87;0.48;273.26;8.49;881;56;3297.00;60
8645;55;626495680;8645;287;9528;9588;7.90;0.48;273.24;8.53;883;56;3298.00;60
8649;55;626495694;8649;288;9528;9588;7.88;0.48;273.28;8.53;879;56;3299.00;60
8653;55;626495710;8653;290;9532;9607;7.88;0.48;273.29;8.53;879;56;3300.00;75
8658;55;626495729;8658;289;9533;9607;7.89;0.48;273.37;8.53;875;56;3301.00;74
8662;55;626495741;8662;283;9534;9608;7.91;0.48;273.47;8.57;872;56;3302.00;74
8663;55;626495754;8663;288;9535;9609;7.87;0.48;273.48;8.57;872;56;3303.00;74
8665;55;626495773;8665;281;9535;9609;7.86;0.48;273.48;8.57;870;56;3304.00;74
8669;55;626495785;8669;284;9536;9610;7.85;0.48;273.45;8.57;867;56;3305.00;74
8671;55;626495804;8671;288;9537;9610;7.87;0.48;273.44;8.57;866;56;3306.00;73
8675;55;626495816;8675;289;9538;9610;7.92;0.48;273.51;8.57;863;56;3307.00;72
8678;55;626495828;8678;285;9538;9610;7.90;0.48;273.52;8.57;860;56;3308.00;72
8679;55;626495840;8679;283;9538;9610;7.90;0.48;273.52;8.57;859;56;3309.00;72
8680;55;626495852;8680;289;9538;9610;7.95;0.48;273.52;8.57;858;56;3310.00;72
8683;55;626495863;8683;289;9538;9610;7.89;0.48;273.54;8.57;855;56;3311.00;72
8685;55;626495875;8685;322;9606;9737;7.89;0.49;273.52;8.51;921;56;3312.00;131
8686;55;626495898;8686;316;9611;9738;7.85;0.48;273.58;8.51;925;56;3313.00;127
8690;55;626495910;8690;313;9616;9738;7.89;0.49;273.61;8.55;926;56;3314.00;122
8691;55;626495924;8691;311;9617;9738;7.95;0.49;273.64;8.55;926;56;3315.00;121
8696;55;626495936;8696;315;9619;9738;7.99;0.49;273.67;8.55;923;56;3316.00;119
8697;55;626495948;8697;311;9621;9738;8.01;0.49;273.66;8.55;924;56;3317.00;117
8699;55;626495959;8699;315;9625;9738;8.04;0.49;273.66;8.55;926;56;3318.00;113
8701;55;626495972;8701;314;9627;9738;8.01;0.49;273.65;8.55;926;56;3319.00;111
8705;55;626495984;8705;311;9629;9739;7.98;0.49;273.66;8.55;924;56;3320.00;110
8708;55;626496003;8708;310;9631;9740;8.01;0.49;273.68;8.55;923;56;3321.00;109
8711;55;626496015;8711;309;9632;9740;8.00;0.49;273.65;8.55;921;56;3322.00;108
8712;55;626496029;8712;309;9634;9741;8.00;0.49;273.65;8.55;922;56;3323.00;107
8715;55;626496044;8715;311;9638;9741;8.03;0.49;273.79;8.55;923;56;3324.00;103
8717;55;626496056;8717;307;9640;9741;8.07;0.49;273.80;8.55;923;56;3325.00;101
8720;55;626496069;8720;310;9642;9741;8.12;0.50;273.83;8.55;922;56;3326.00;99
8723;55;626496081;8723;313;9644;9745;8.11;0.50;273.82;8.55;921;56;3327.00;101
8724;55;626496093;8724;311;9646;9745;8.08;0.49;273.85;8.56;922;56;3328.00;99
8726;55;626496105;8726;308;9649;9745;7.99;0.49;273.89;8.56;923;56;3329.00;96
8729;55;626496117;8729;300;9654;9751;7.94;0.48;273.90;8.56;925;56;3330.00;97
8730;55;626496129;8730;296;9657;9751;7.90;0.48;273.89;8.61;927;56;3331.00;94
8732;55;626496141;8732;293;9659;9751;7.81;0.48;273.93;8.61;927;56;3332.00;92
8737;55;626496152;8737;284;9664;9755;7.74;0.47;273.97;8.61;927;56;3333.00;91
8741;55;626496164;8741;277;9665;9756;7.72;0.47;273.95;8.61;924;56;3334.00;91
8745;55;626496177;8745;273;9669;9756;7.67;0.47;273.92;8.67;924;56;3335.00;87
8746;55;626496190;8746;271;9672;9760;7.72;0.47;273.93;8.67;926;56;3336.00;88
8749;55;626496202;8749;267;9673;9760;7.71;0.47;273.98;8.68;924;56;3337.00;87
8751;55;626496214;8751;263;9675;9760;7.73;0.47;273.98;8.72;924;56;3338.00;85
8756;55;626496226;8756;262;9676;9761;7.73;0.47;273.98;8.72;920;56;3339.00;85
8759;55;626496238;8759;259;9678;9761;7.79;0.47;273.95;8.77;919;56;3340.00;83
8760;55;626496250;8760;253;9680;9767;7.94;0.48;273.94;8.77;920;56;3341.00;87
8762;55;626496262;8762;254;9685;9767;8.01;0.48;273.99;8.83;923;56;3342.00;82
8763;55;626496275;8763;247;9687;9768;8.04;0.49;273.97;8.83;924;56;3343.00;81
8766;55;626496288;8766;246;9689;9768;8.04;0.49;274.02;8.83;923;56;3344.00;79
8768;55;626496300;8768;245;9691;9768;8.04;0.49;274.06;8.88;923;56;3345.00;77
8770;55;626496315;8770;240;9692;9768;8.06;0.49;274.03;8.88;922;56;3346.00;76
8772;55;626496328;8772;243;9692;9768;8.06;0.49;274.06;8.88;920;56;3347.00;76
8775;55;626496340;8775;245;9701;9780;8.10;0.49;274.17;8.92;926;56;3348.00;79
8780;55;626496354;8780;243;9707;9780;8.03;0.49;274.22;8.93;927;56;3349.00;73
8782;55;626496368;8782;245;9708;9780;8.07;0.49;274.23;8.93;926;56;3350.00;72
8786;55;626496380;8786;244;9712;9780;8.02;0.48;274.21;8.93;926;56;3351.00;68
8787;55;626496392;8787;244;9712;9780;8.04;0.49;274.20;8.93;925;56;3352.00;68
8792;55;626496403;8792;247;9712;9780;8.06;0.49;274.23;8.93;920;56;3353.00;68
8794;55;626496415;8794;252;9716;9784;8.06;0.49;274.23;8.93;922;56;3354.00;68
8796;55;626496428;8796;255;9716;9784;8.09;0.49;274.29;8.93;920;56;3355.00;68
8799;55;626496445;8799;254;9719;9788;8.13;0.49;274.33;8.93;920;56;3356.00;69
8801;55;626496463;8801;256;9721;9789;8.18;0.50;274.33;8.93;920;56;3357.00;68
8804;55;626496475;8804;255;9721;9789;8.19;0.50;274.33;8.93;917;56;3358.00;68
8810;55;626496486;8810;267;9721;9789;8.16;0.49;274.39;8.93;911;56;3359.00;68
8812;55;626496500;8812;277;9742;9818;8.10;0.49;274.42;8.93;930;56;3360.00;76
8815;55;626496515;8815;285;9743;9818;8.09;0.49;274.40;8.93;928;56;3361.00;75
8816;55;626496527;8816;289;9746;9818;8.08;0.49;274.44;8.93;930;56;3362.00;72
8819;55;626496539;8819;292;9750;9819;8.05;0.49;274.51;8.94;931;56;3363.00;69
8822;55;626496550;8822;297;9751;9820;7.96;0.48;274.49;8.95;929;56;3364.00;69
8824;55;626496562;8824;307;9751;9820;7.88;0.48;274.54;8.95;927;56;3365.00;69
8824;55;626496574;8824;308;9756;9823;7.85;0.48;274.54;8.97;932;56;3366.00;67
8825;55;626496585;8825;319;9757;9823;7.80;0.47;274.55;8.98;932;56;3367.00;66
8826;55;626496596;8826;327;9758;9823;7.79;0.47;274.54;8.99;932;56;3368.00;65
8828;55;626496607;8828;329;9759;9823;7.79;0.47;274.55;9.00;931;56;3369.00;64
8829;55;626496618;8829;329;9764;9829;7.74;0.47;274.57;9.01;935;56;3370.00;65
8831;55;626496630;8831;330;9765;9829;7.70;0.47;274.70;9.01;934;56;3371.00;64
8834;55;626496647;8834;333;9767;9829;7.61;0.47;274.66;9.03;933;56;3372.00;62
8835;55;626496658;8835;334;9768;9829;7.51;0.46;274.73;9.04;933;56;3373.00;61
8838;55;626496669;8838;344;9772;9833;7.40;0.45;274.77;9.05;934;56;3374.00;61
8841;55;626496680;8841;344;9774;9835;7.33;0.45;274.74;9.05;933;56;3375.00;61
8843;55;626496692;8843;352;9776;9835;7.25;0.45;274.69;9.07;933;56;3376.00;59
8843;55;626496704;8843;356;9777;9836;7.15;0.44;274.69;9.06;934;56;3377.00;59
8843;55;626496714;8843;365;9778;9836;7.09;0.44;274.69;9.07;935;56;3378.00;58
8846;55;626496725;8846;366;9779;9836;6.98;0.43;274.63;9.08;933;56;3379.00;57
8847;55;626496740;8847;364;9780;9836;6.98;0.43;274.62;9.09;933;56;3380.00;56
8849;55;626496751;8849;359;9780;9836;6.97;0.43;274.57;9.09;931;56;3381.00;56
8852;55;626496762;8852;358;9781;9836;6.95;0.43;274.53;9.10;929;56;3382.00;55
8856;55;626496772;8856;362;9781;9836;6.90;0.42;274.45;9.10;925;56;3383.00;55
8857;55;626496783;8857;370;9818;9906;7.04;0.43;274.43;9.07;961;56;3384.00;88
8860;55;626496804;8860;373;9826;9907;6.96;0.43;274.38;9.09;966;56;3385.00;81
8861;55;626496816;8861;373;9834;9907;6.98;0.43;274.39;9.09;973;56;3386.00;73
8865;55;626496826;8865;379;9842;9907;6.94;0.43;274.32;9.09;977;56;3387.00;65
8866;55;626496837;8866;387;9846;9907;6.92;0.43;274.30;9.09;980;56;3388.00;61
8867;55;626496848;8867;394;9852;9907;6.87;0.42;274.27;9.10;985;56;3389.00;55
8870;55;626496861;8870;394;9858;9907;6.75;0.41;274.24;9.11;988;56;3390.00;49
8870;55;626496871;8870;400;9858;9907;6.66;0.41;274.24;9.11;988;56;3391.00;49
8874;55;626496882;8874;402;9861;9908;6.55;0.40;274.20;9.11;987;56;3392.00;47
8878;55;626496893;8878;413;9862;9909;6.38;0.39;274.28;9.11;984;56;3393.00;47
8882;55;626496903;8882;415;9862;9909;6.21;0.38;274.23;9.11;980;56;3394.00;47
8885;55;626496914;8885;421;9866;9913;6.08;0.38;274.19;9.11;981;56;3395.00;47
8887;55;626496925;8887;424;9866;9913;5.98;0.37;274.21;9.11;979;56;3396.00;47
8891;55;626496935;8891;433;9867;9913;5.85;0.36;274.18;9.12;976;56;3397.00;46
8897;55;626496945;8897;445;9867;9913;5.68;0.35;274.20;9.12;970;56;3398.00;46
8903;55;626496955;8903;453;9872;9919;5.56;0.34;274.19;9.12;969;56;3399.00;47
8904;55;626496967;8904;443;9873;9919;5.47;0.34;274.18;9.12;969;56;3400.00;46
8909;55;626496981;8909;443;9874;9919;5.34;0.33;274.22;9.12;965;56;3401.00;45
8912;55;626496992;8912;441;9878;9922;5.26;0.32;274.24;9.13;966;56;3402.00;44
8912;55;626497002;8912;441;9878;9922;5.19;0.32;274.24;9.13;966;56;3403.00;44
8915;55;626497012;8915;440;9878;9922;5.11;0.31;274.25;9.13;963;56;3404.00;44
8917;55;626497022;8917;453;9878;9923;5.12;0.32;274.29;9.13;961;56;3405.00;45
8919;55;626497032;8919;455;9880;9924;5.17;0.32;274.25;9.13;961;56;3406.00;44
8924;55;626497050;8924;455;9880;9924;5.26;0.32;274.24;9.13;956;56;3407.00;44
8927;55;626497068;8927;451;9890;9937;5.35;0.33;274.24;9.12;963;56;3408.00;47
8928;55;626497086;8928;443;9891;9937;5.44;0.33;274.21;9.12;963;56;3409.00;46
8932;55;626497102;8932;438;9891;9937;5.49;0.34;274.19;9.12;959;56;3410.00;46
8936;55;626497117;8936;416;9892;9938;5.54;0.34;274.22;9.12;956;56;3411.00;46
8937;55;626497132;8937;413;9892;9938;5.64;0.35;274.20;9.12;955;56;3412.00;46
8939;55;626497147;8939;392;9896;9942;5.74;0.35;274.25;9.11;957;56;3413.00;46
8939;55;626497159;8939;384;9896;9942;5.83;0.36;274.25;9.11;957;56;3414.00;46
8941;55;626497172;8941;375;9899;9946;5.93;0.36;274.25;9.11;958;56;3415.00;47
8948;55;626497185;8948;364;9899;9946;5.96;0.36;274.20;9.11;951;56;3416.00;47
8952;56;626497198;8952;353;9899;9946;6.05;0.37;274.28;9.11;947;57;3417.00;47
8955;56;626497222;8955;349;9899;9946;6.10;0.37;274.27;9.11;944;57;3418.00;47
8958;56;626497234;8958;342;9899;9946;6.14;0.37;274.25;9.11;941;57;3419.00;47
8960;56;626497249;8960;339;9923;9980;6.41;0.39;274.25;9.09;963;57;3420.00;57
8961;56;626497276;8961;337;9923;9980;6.53;0.40;274.25;9.09;962;57;3421.00;57
8963;56;626497287;8963;340;9925;9980;6.62;0.41;274.25;9.09;962;57;3422.00;55
8965;56;626497299;8965;341;9926;9980;6.68;0.41;274.27;9.09;961;57;3423.00;54
8968;56;626497314;8968;333;9926;9980;6.70;0.41;274.26;9.09;958;57;3424.00;54
8969;56;626497326;8969;338;9927;9980;6.72;0.41;274.24;9.09;958;57;3425.00;53
8973;56;626497338;8973;345;9927;9981;6.77;0.41;274.25;9.09;954;57;3426.00;54
8978;56;626497351;8978;344;9928;9981;6.85;0.42;274.23;9.09;950;57;3427.00;53
8980;56;626497362;8980;340;9931;9987;6.91;0.42;274.25;9.08;951;57;3428.00;56
8983;56;626497375;8983;341;9933;9988;6.98;0.43;274.34;9.08;950;57;3429.00;55
8987;56;626497387;8987;334;9933;9988;6.98;0.43;274.38;9.08;946;57;3430.00;55
8993;56;626497399;8993;339;9934;9988;6.98;0.43;274.35;9.08;941;57;3431.00;54
8996;56;626497418;8996;345;9937;9992;6.97;0.42;274.31;9.08;941;57;3432.00;55
9001;56;626497430;9001;339;9937;9992;6.99;0.43;274.35;9.08;936;57;3433.00;55
9004;56;626497443;9004;328;9937;9992;6.98;0.42;274.39;9.08;933;57;3434.00;55
9009;56;626497456;9009;333;9938;9993;6.95;0.42;274.45;9.08;929;57;3435.00;55
9011;56;626497469;9011;327;9941;9997;7.04;0.43;274.50;9.08;930;57;3436.00;56
9014;56;626497482;9014;329;9941;9997;7.05;0.43;274.56;9.08;927;57;3437.00;56
9015;56;626497494;9015;329;9943;10000;7.12;0.44;274.58;9.07;928;57;3438.00;57
9018;56;626497507;9018;324;9945;10000;7.17;0.44;274.56;9.13;927;57;3439.00;55
9021;56;626497521;9021;323;9945;10000;7.19;0.44;274.63;9.13;924;57;3440.00;55
9024;56;626497533;9024;323;9945;10000;7.19;0.44;274.59;9.13;921;57;3441.00;55
9027;56;626497544;9027;328;9948;10004;7.24;0.44;274.63;9.13;921;57;3442.00;56
9032;56;626497557;9032;330;9948;10004;7.21;0.44;274.65;9.13;916;57;3443.00;56
9038;56;626497570;9038;334;9949;10004;7.21;0.44;274.67;9.13;911;57;3444.00;55
9041;56;626497583;9041;337;9949;10004;7.14;0.43;274.72;9.13;908;57;3445.00;55
9043;56;626497595;9043;343;9949;10005;7.08;0.43;274.70;9.13;906;57;3446.00;56
9047;56;626497607;9047;330;9950;10006;7.04;0.43;274.72;9.12;903;57;3447.00;56
9049;56;626497619;9049;323;9950;10006;7.01;0.42;274.79;9.12;901;57;3448.00;56
9051;56;626497631;9051;317;9951;10007;7.07;0.43;274.80;9.12;900;57;3449.00;56
9052;56;626497645;9052;314;9951;10007;7.12;0.43;274.83;9.12;899;57;3450.00;56
9054;56;626497657;9054;313;9951;10007;7.11;0.43;274.87;9.12;897;57;3451.00;56
9057;56;626497670;9057;314;9951;10007;7.13;0.43;274.86;9.12;894;57;3452.00;56
9061;56;626497682;9061;309;9951;10007;7.14;0.43;274.97;9.12;890;57;3453.00;56
9064;56;626497694;9064;306;9951;10007;7.11;0.43;275.00;9.12;887;57;3454.00;56
9066;56;626497706;9066;306;9951;10007;7.12;0.43;274.99;9.12;885;57;3455.00;56
9070;56;626497724;9070;319;10025;10134;7.27;0.45;275.12;9.06;955;57;3456.00;109
9072;56;626497747;9072;297;10027;10135;7.32;0.45;275.18;9.06;955;57;3457.00;108
9073;56;626497766;9073;282;10034;10135;7.49;0.46;275.17;9.05;961;57;3458.00;101
9077;56;626497778;9077;275;10039;10135;7.61;0.47;275.22;9.05;962;57;3459.00;96
9080;56;626497792;9080;268;10043;10135;7.75;0.48;275.27;9.05;963;57;3460.00;92
9083;56;626497805;9083;261;10047;10135;7.86;0.48;275.33;9.04;964;57;3461.00;88
9086;56;626497818;9086;258;10052;10135;7.94;0.49;275.37;9.04;966;57;3462.00;83
9089;56;626497838;9089;261;10055;10135;8.02;0.49;275.40;9.04;966;57;3463.00;80
9091;56;626497858;9091;266;10058;10136;8.06;0.49;275.41;9.04;967;57;3464.00;78
9094;56;626497871;9094;269;10060;10138;8.07;0.49;275.47;9.04;966;57;3465.00;78
9097;56;626497885;9097;273;10062;10138;8.04;0.49;275.50;9.04;965;57;3466.00;76
9099;56;626497899;9099;273;10063;10139;8.02;0.49;275.58;9.04;964;57;3467.00;76
9102;56;626497912;9102;269;10064;10139;8.03;0.49;275.59;9.04;962;57;3468.00;75
9104;56;626497926;9104;266;10065;10139;7.99;0.49;275.65;9.04;961;57;3469.00;74
9106;56;626497939;9106;264;10066;10139;7.95;0.49;275.67;9.04;960;57;3470.00;73
9108;56;626497952;9108;272;10070;10143;7.94;0.49;275.77;9.04;962;57;3471.00;73
9109;56;626497973;9109;275;10071;10143;7.91;0.49;275.76;9.04;962;57;3472.00;72
9111;56;626497986;9111;269;10073;10143;7.88;0.48;275.77;9.04;962;57;3473.00;70
9115;56;626497999;9115;264;10075;10146;7.87;0.48;275.81;9.04;960;57;3474.00;71
9117;57;626498013;9117;261;10077;10146;7.93;0.48;275.81;9.04;960;58;3475.00;69
9121;57;626498055;9121;263;10077;10146;7.92;0.48;275.91;9.04;956;58;3476.00;69
9125;57;626498069;9125;257;10081;10150;7.95;0.49;275.88;9.04;956;58;3477.00;69
9130;57;626498089;9130;256;10082;10151;7.96;0.48;275.85;9.04;952;58;3478.00;69
9132;57;626498103;9132;264;10083;10151;7.92;0.48;275.89;9.04;951;58;3479.00;68
9135;57;626498116;9135;263;10087;10156;7.85;0.48;275.87;9.03;952;58;3480.00;69
9138;57;626498129;9138;261;10087;10156;7.79;0.47;275.86;9.03;949;58;3481.00;69
9139;57;626498142;9139;266;10087;10156;7.77;0.47;275.90;9.03;948;58;3482.00;69
9140;57;626498154;9140;269;10088;10157;7.77;0.47;275.88;9.03;948;58;3483.00;69
9143;57;626498166;9143;280;10088;10157;7.76;0.47;275.83;9.03;945;58;3484.00;69
9145;58;626498179;9145;282;10092;10163;7.71;0.47;275.85;9.03;947;59;3485.00;71
9147;58;626498205;9147;289;10092;10163;7.70;0.47;275.84;9.03;945;59;3486.00;71
9148;58;626498222;9148;292;10093;10164;7.70;0.47;275.90;9.03;945;59;3487.00;71
9150;58;626498234;9150;285;10093;10164;7.70;0.47;275.89;9.03;943;59;3488.00;71
9153;58;626498246;9153;285;10093;10164;7.68;0.47;275.85;9.03;940;59;3489.00;71
9153;58;626498258;9153;281;10093;10164;7.67;0.47;275.85;9.03;940;59;3490.00;71
9155;58;626498270;9155;273;10094;10164;7.65;0.46;275.84;9.09;939;59;3491.00;70
9158;58;626498282;9158;262;10104;10176;7.70;0.47;275.84;9.08;946;59;3492.00;72
9160;58;626498296;9160;262;10104;10176;7.69;0.47;275.87;9.08;944;59;3493.00;72
9164;58;626498308;9164;256;10105;10176;7.68;0.47;275.94;9.08;941;59;3494.00;71
9169;58;626498320;9169;254;10105;10176;7.68;0.47;275.88;9.08;936;59;3495.00;71
9171;58;626498332;9171;245;10105;10176;7.67;0.46;275.87;9.08;934;59;3496.00;71
9175;58;626498344;9175;242;10105;10176;7.62;0.46;275.92;9.08;930;59;3497.00;71
9176;58;626498355;9176;238;10108;10180;7.58;0.46;275.91;9.08;932;59;3498.00;72
9178;58;626498367;9178;236;10108;10180;7.59;0.46;275.93;9.08;930;59;3499.00;72
9181;59;626498378;9181;231;10111;10184;7.58;0.46;275.98;9.07;930;60;3500.00;73
9182;59;626498407;9182;225;10113;10185;7.58;0.46;275.99;9.07;931;60;3501.00;72
9186;59;626498422;9186;218;10113;10185;7.50;0.46;276.03;9.07;927;60;3502.00;72
9187;59;626498433;9187;221;10113;10185;7.44;0.45;276.04;9.07;926;60;3503.00;72
9192;59;626498444;9192;222;10124;10198;7.38;0.45;276.02;9.09;932;60;3504.00;74
9196;59;626498457;9196;219;10124;10198;7.37;0.45;276.09;9.09;928;60;3505.00;74
9200;59;626498470;9200;211;10126;10198;7.38;0.45;276.11;9.15;926;60;3506.00;72
9204;59;626498482;9204;214;10128;10199;7.36;0.45;276.13;9.15;924;60;3507.00;71
9207;59;626498493;9207;217;10128;10200;7.35;0.45;276.13;9.15;921;60;3508.00;72
9210;59;626498504;9210;206;10129;10200;7.33;0.45;276.12;9.21;919;60;3509.00;71
9213;59;626498517;9213;211;10132;10206;7.34;0.45;276.10;9.21;919;60;3510.00;74
9216;59;626498528;9216;217;10133;10206;7.36;0.45;276.07;9.21;917;60;3511.00;73
9218;59;626498540;9218;213;10133;10206;7.37;0.45;276.05;9.21;915;60;3512.00;73
9219;59;626498551;9219;215;10134;10206;7.49;0.46;276.05;9.21;915;60;3513.00;72
9222;59;626498562;9222;214;10138;10212;7.53;0.46;276.09;9.20;916;60;3514.00;74
9226;59;626498574;9226;210;10139;10212;7.50;0.45;276.18;9.27;913;60;3515.00;73
9230;59;626498585;9230;208;10140;10212;7.55;0.46;276.27;9.27;910;60;3516.00;72
9230;59;626498597;9230;205;10140;10212;7.57;0.46;276.27;9.27;910;60;3517.00;72
9232;59;626498607;9232;203;10144;10216;7.57;0.46;276.31;9.26;912;60;3518.00;72
9234;59;626498620;9234;207;10146;10219;7.59;0.46;276.35;9.26;912;60;3519.00;73
9235;59;626498631;9235;210;10148;10219;7.56;0.46;276.35;9.27;913;60;3520.00;71
9235;59;626498643;9235;211;10149;10220;7.51;0.46;276.35;9.27;914;60;3521.00;71
9237;59;626498654;9237;217;10149;10220;7.46;0.45;276.43;9.27;912;60;3522.00;71
9238;59;626498665;9238;222;10149;10220;7.46;0.45;276.43;9.27;911;60;3523.00;71
9238;59;626498677;9238;219;10150;10220;7.46;0.45;276.43;9.29;912;60;3524.00;70
9241;59;626498688;9241;230;10151;10220;7.46;0.45;276.50;9.30;910;60;3525.00;69
9242;59;626498700;9242;226;10151;10220;7.43;0.45;276.53;9.30;909;60;3526.00;69
9244;59;626498711;9244;228;10151;10220;7.40;0.45;276.53;9.30;907;60;3527.00;69
9247;59;626498722;9247;235;10188;10290;7.56;0.46;276.48;9.28;941;60;3528.00;102
9249;59;626498739;9249;237;10189;10291;7.56;0.46;276.45;9.29;940;60;3529.00;102
9250;59;626498751;9250;238;10197;10291;7.64;0.47;276.45;9.30;947;60;3530.00;94
9252;59;626498762;9252;237;10202;10291;7.66;0.47;276.44;9.30;950;60;3531.00;89
9255;59;626498774;9255;241;10208;10291;7.62;0.46;276.41;9.32;953;60;3532.00;83
9257;59;626498785;9257;248;10211;10291;7.60;0.46;276.37;9.32;954;60;3533.00;80
9260;59;626498797;9260;251;10213;10291;7.57;0.46;276.33;9.32;953;60;3534.00;78
9261;59;626498809;9261;258;10219;10291;7.55;0.46;276.33;9.34;958;60;3535.00;72
9264;59;626498821;9264;257;10220;10292;7.43;0.45;276.26;9.34;956;60;3536.00;72
9267;59;626498833;9267;263;10226;10293;7.40;0.45;276.31;9.36;959;60;3537.00;67
9270;59;626498845;9270;266;10227;10293;7.31;0.45;276.25;9.36;957;60;3538.00;66
9271;59;626498857;9271;271;10232;10297;7.27;0.44;276.24;9.37;961;60;3539.00;65
9272;59;626498870;9272;276;10233;10297;7.20;0.44;276.23;9.37;961;60;3540.00;64
9272;59;626498881;9272;285;10234;10297;7.13;0.44;276.23;9.38;962;60;3541.00;63
9274;59;626498892;9274;294;10234;10297;7.02;0.43;276.20;9.38;960;60;3542.00;63
9275;59;626498904;9275;301;10240;10303;7.01;0.43;276.20;9.40;965;60;3543.00;63
9279;59;626498915;9279;306;10240;10303;6.90;0.42;276.17;9.40;961;60;3544.00;63
9281;59;626498926;9281;316;10243;10303;6.82;0.42;276.15;9.42;962;60;3545.00;60
9283;59;626498937;9283;326;10245;10306;6.70;0.41;276.12;9.42;962;60;3546.00;61
9283;59;626498948;9283;331;10248;10306;6.60;0.40;276.12;9.43;965;60;3547.00;58
9285;59;626498959;9285;338;10249;10306;6.46;0.40;276.10;9.44;964;60;3548.00;57
9287;59;626498969;9287;345;10250;10307;6.30;0.39;276.07;9.45;963;60;3549.00;57
9289;59;626498979;9289;347;10251;10308;6.21;0.38;276.03;9.45;962;60;3550.00;57
9289;59;626498995;9289;350;10251;10308;6.21;0.38;276.03;9.45;962;60;3551.00;57
9290;59;626499005;9290;351;10264;10321;6.20;0.38;276.02;9.46;974;60;3552.00;57
9292;59;626499016;9292;353;10265;10321;6.12;0.38;276.01;9.46;973;60;3553.00;56
9293;59;626499026;9293;356;10266;10321;6.10;0.37;275.98;9.47;973;60;3554.00;55
9294;59;626499039;9294;360;10268;10323;6.08;0.37;275.96;9.47;974;60;3555.00;55
9296;59;626499073;9296;359;10270;10323;6.02;0.37;275.93;9.48;974;60;3556.00;53
9298;59;626499091;9298;360;10273;10327;6.00;0.37;275.89;9.48;975;60;3557.00;54
9299;59;626499107;9299;363;10273;10327;5.99;0.37;275.90;9.48;974;60;3558.00;54
9303;59;626499122;9303;372;10279;10331;5.92;0.36;275.83;9.49;976;60;3559.00;52
9306;59;626499138;9306;373;10279;10331;5.85;0.36;275.93;9.49;973;60;3560.00;52
9307;59;626499152;9307;374;10281;10331;5.73;0.35;275.92;9.50;974;60;3561.00;50
9310;59;626499164;9310;381;10282;10331;5.62;0.34;275.88;9.51;972;60;3562.00;49
9312;59;626499176;9312;375;10283;10331;5.53;0.34;275.87;9.51;971;60;3563.00;48
9315;59;626499188;9315;367;10293;10343;5.56;0.34;275.87;9.50;978;60;3564.00;50
9319;59;626499201;9319;360;10294;10343;5.52;0.33;275.89;9.51;975;60;3565.00;49
9320;59;626499212;9320;359;10296;10343;5.52;0.34;275.91;9.51;976;60;3566.00;47
9323;59;626499232;9323;352;10296;10343;5.48;0.33;275.85;9.51;973;60;3567.00;47
9325;59;626499245;9325;355;10298;10343;5.39;0.33;275.85;9.52;973;60;3568.00;45
9328;59;626499257;9328;358;10298;10343;5.31;0.32;275.81;9.52;970;60;3569.00;45
9328;59;626499280;9328;339;10299;10344;5.31;0.32;275.81;9.52;971;60;3570.00;45
9331;59;626499291;9331;336;10300;10344;5.26;0.32;275.84;9.52;969;60;3571.00;44
9333;59;626499302;9333;338;10304;10350;5.28;0.32;275.88;9.52;971;60;3572.00;46
9333;59;626499313;9333;342;10308;10351;5.36;0.33;275.88;9.52;975;60;3573.00;43
9337;59;626499324;9337;338;10308;10351;5.39;0.33;275.86;9.52;971;60;3574.00;43
9338;59;626499335;9338;338;10308;10351;5.49;0.33;275.89;9.52;970;60;3575.00;43
9340;59;626499346;9340;333;10313;10355;5.59;0.34;275.84;9.53;973;60;3576.00;42
9343;59;626499357;9343;324;10313;10355;5.66;0.34;275.86;9.53;970;60;3577.00;42
9343;59;626499369;9343;328;10313;10355;5.74;0.35;275.86;9.53;970;60;3578.00;42
9344;59;626499379;9344;330;10314;10356;5.83;0.35;275.85;9.52;970;60;3579.00;42
9346;59;626499391;9346;334;10317;10360;5.89;0.36;275.84;9.52;971;60;3580.00;43
9348;59;626499403;9348;328;10318;10360;5.92;0.36;275.85;9.59;970;60;3581.00;42
9351;59;626499415;9351;327;10320;10363;5.98;0.36;275.85;9.59;969;60;3582.00;43
9351;59;626499434;9351;320;10321;10363;6.09;0.37;275.85;9.59;970;60;3583.00;42
9357;59;626499446;9357;317;10321;10363;6.13;0.37;275.86;9.59;964;60;3584.00;42
9360;59;626499458;9360;308;10321;10363;6.19;0.38;275.88;9.59;961;60;3585.00;42
9361;59;626499472;9361;305;10324;10367;6.36;0.39;275.89;9.58;963;60;3586.00;43
9366;59;626499485;9366;302;10324;10367;6.43;0.39;275.95;9.58;958;60;3587.00;43
9368;59;626499498;9368;298;10325;10367;6.50;0.40;275.99;9.58;957;60;3588.00;42
9371;59;626499510;9371;291;10325;10367;6.58;0.40;275.99;9.58;954;60;3589.00;42
9375;59;626499523;9375;291;10325;10368;6.65;0.41;276.01;9.58;950;60;3590.00;43
9380;59;626499535;9380;284;10326;10369;6.76;0.41;276.03;9.58;946;60;3591.00;43
9381;59;626499548;9381;284;10326;10369;6.86;0.42;276.09;9.58;945;60;3592.00;43
9388;59;626499560;9388;279;10327;10370;6.93;0.42;276.19;9.58;939;60;3593.00;43
9395;59;626499572;9395;272;10327;10370;6.94;0.42;276.24;9.58;932;60;3594.00;43
9398;59;626499586;9398;267;10327;10370;7.01;0.43;276.26;9.58;929;60;3595.00;43
9405;59;626499598;9405;268;10328;10370;7.03;0.43;276.31;9.64;923;60;3596.00;42
9407;59;626499610;9407;271;10328;10370;7.07;0.43;276.35;9.64;921;60;3597.00;42
9412;59;626499631;9412;272;10328;10370;7.08;0.43;276.46;9.64;916;60;3598.00;42
9420;59;626499644;9420;271;10328;10370;7.07;0.43;276.53;9.64;908;60;3599.00;42
9423;59;626499661;9423;304;10443;10623;7.40;0.46;276.56;9.54;1020;60;3600.00;180
9429;59;626499701;9429;304;10450;10624;7.42;0.46;276.52;9.53;1021;60;3601.00;174
9434;59;626499717;9434;300;10461;10624;7.44;0.47;276.57;9.52;1027;60;3602.00;163
9438;59;626499731;9438;293;10469;10624;7.47;0.47;276.70;9.52;1031;60;3603.00;155
9444;59;626499746;9444;298;10476;10624;7.49;0.47;276.67;9.51;1032;60;3604.00;148
9450;59;626499760;9450;291;10483;10624;7.48;0.47;276.72;9.51;1033;60;3605.00;141
9453;59;626499775;9453;294;10490;10624;7.49;0.47;276.76;9.51;1037;60;3606.00;134
9459;59;626499789;9459;295;10494;10624;7.53;0.47;276.81;9.51;1035;60;3607.00;130
9461;59;626499804;9461;305;10497;10625;7.58;0.47;276.82;9.51;1036;60;3608.00;128
9464;59;626499819;9464;311;10500;10626;7.60;0.47;276.89;9.51;1036;60;3609.00;126
9471;59;626499834;9471;312;10505;10626;7.56;0.47;276.99;9.51;1034;60;3610.00;121
9475;59;626499849;9475;321;10507;10627;7.50;0.47;277.09;9.51;1032;60;3611.00;120
9479;59;626499863;9479;324;10511;10627;7.42;0.46;277.17;9.51;1032;60;3612.00;116
9481;59;626499877;9481;336;10513;10627;7.37;0.46;277.24;9.51;1032;60;3613.00;114
9486;59;626499892;9486;342;10517;10627;7.35;0.46;277.32;9.51;1031;60;3614.00;110
9487;59;626499906;9487;349;10521;10631;7.31;0.45;277.32;9.51;1034;60;3615.00;110
9493;59;626499920;9493;350;10523;10631;7.20;0.45;277.38;9.51;1030;60;3616.00;108
9498;59;626499935;9498;343;10525;10631;7.15;0.44;277.52;9.57;1027;60;3617.00;106
9501;59;626499950;9501;340;10528;10634;7.15;0.44;277.50;9.57;1027;60;3618.00;106
9506;59;626499966;9506;338;10528;10634;7.12;0.44;277.58;9.57;1022;60;3619.00;106
9510;60;626499981;9510;343;10530;10634;7.09;0.44;277.63;9.57;1020;61;3620.00;104
9512;60;626500009;9512;339;10535;10638;7.12;0.44;277.64;9.57;1023;61;3621.00;103
9517;60;626500025;9517;343;10539;10639;7.17;0.44;277.66;9.57;1022;61;3622.00;100
9521;60;626500042;9521;341;10540;10639;7.25;0.44;277.68;9.57;1019;61;3623.00;99
9523;60;626500057;9523;339;10543;10643;7.31;0.45;277.71;9.58;1020;61;3624.00;100
9526;60;626500072;9526;342;10547;10643;7.37;0.45;277.73;9.58;1021;61;3625.00;96
9529;60;626500087;9529;333;10548;10643;7.45;0.45;277.78;9.58;1019;61;3626.00;95
9530;60;626500101;9530;321;10551;10644;7.51;0.46;277.80;9.58;1021;61;3627.00;93
9534;60;626500115;9534;316;10552;10644;7.51;0.46;277.82;9.58;1018;61;3628.00;92
9536;60;626500129;9536;305;10557;10650;7.54;0.46;277.80;9.58;1021;61;3629.00;93
9540;60;626500153;9540;299;10557;10650;7.54;0.46;277.84;9.58;1017;61;3630.00;93
9543;60;626500172;9543;298;10559;10651;7.58;0.46;277.92;9.58;1016;61;3631.00;92
9547;60;626500186;9547;295;10559;10651;7.60;0.46;277.89;9.58;1012;61;3632.00;92
9548;61;626500207;9548;291;10560;10651;7.59;0.46;277.92;9.58;1012;62;3633.00;91
9551;61;626500233;9551;295;10560;10651;7.56;0.46;278.00;9.58;1009;62;3634.00;91
9553;62;626500246;9553;299;10561;10651;7.54;0.46;277.97;9.58;1008;63;3635.00;90
9556;62;626500270;9556;301;10570;10663;7.50;0.46;277.98;9.58;1014;63;3636.00;93
9557;62;626500285;9557;302;10572;10663;7.49;0.46;277.99;9.58;1015;63;3637.00;91
9562;62;626500304;9562;302;10573;10663;7.50;0.46;277.99;9.58;1011;63;3638.00;90
9562;62;626500318;9562;301;10573;10663;7.55;0.46;277.99;9.58;1011;63;3639.00;90
9564;62;626500331;9564;288;10573;10663;7.61;0.46;278.01;9.58;1009;63;3640.00;90
9566;62;626500345;9566;287;10573;10663;7.65;0.47;278.00;9.58;1007;63;3641.00;90
9569;62;626500358;9569;288;10577;10667;7.67;0.47;277.98;9.58;1008;63;3642.00;90
9575;62;626500372;9575;284;10577;10667;7.68;0.47;278.06;9.58;1002;63;3643.00;90
9576;62;626500386;9576;283;10580;10671;7.76;0.47;278.05;9.58;1004;63;3644.00;91
9579;62;626500401;9579;285;10583;10673;7.72;0.47;278.12;9.63;1004;63;3645.00;90
9581;62;626500419;9581;288;10585;10673;7.66;0.47;278.12;9.69;1004;63;3646.00;88
9582;62;626500434;9582;288;10585;10673;7.59;0.46;278.11;9.69;1003;63;3647.00;88
9583;62;626500448;9583;288;10595;10686;7.55;0.46;278.15;9.69;1012;63;3648.00;91
9586;62;626500462;9586;287;10595;10686;7.50;0.46;278.13;9.69;1009;63;3649.00;91
9587;62;626500478;9587;296;10596;10686;7.47;0.46;278.12;9.69;1009;63;3650.00;90
9589;62;626500490;9589;301;10597;10687;7.48;0.46;278.18;9.69;1008;63;3651.00;90
9590;62;626500503;9590;305;10598;10688;7.47;0.46;278.20;9.74;1008;63;3652.00;90
9592;62;626500516;9592;303;10598;10688;7.48;0.46;278.19;9.74;1006;63;3653.00;90
9595;62;626500528;9595;300;10600;10691;7.44;0.45;278.15;9.74;1005;63;3654.00;91
9595;62;626500541;9595;305;10600;10691;7.43;0.45;278.15;9.74;1005;63;3655.00;91
9599;62;626500552;9599;310;10601;10691;7.35;0.45;278.20;9.74;1002;63;3656.00;90
9600;62;626500565;9600;317;10601;10691;7.31;0.45;278.19;9.74;1001;63;3657.00;90
9601;62;626500577;9601;316;10605;10697;7.24;0.44;278.17;9.73;1004;63;3658.00;92
9603;62;626500590;9603;317;10605;10697;7.14;0.44;278.15;9.73;1002;63;3659.00;92
9603;62;626500604;9603;310;10607;10697;7.10;0.44;278.15;9.79;1004;63;3660.00;90
9606;62;626500616;9606;312;10607;10697;7.08;0.43;278.16;9.79;1001;63;3661.00;90
9607;62;626500627;9607;313;10610;10701;7.04;0.43;278.15;9.79;1003;63;3662.00;91
9611;62;626500640;9611;304;10611;10702;7.02;0.43;278.11;9.79;1000;63;3663.00;91
9613;62;626500652;9613;300;10611;10702;6.97;0.43;278.11;9.79;998;63;3664.00;91
9619;62;626500664;9619;293;10612;10703;6.94;0.42;278.09;9.79;993;63;3665.00;91
9621;62;626500676;9621;290;10612;10703;6.92;0.42;278.11;9.79;991;63;3666.00;91
9625;62;626500688;9625;293;10612;10703;6.90;0.42;278.22;9.79;987;63;3667.00;91
9627;62;626500700;9627;300;10614;10703;6.88;0.42;278.27;9.84;987;63;3668.00;89
9630;62;626500711;9630;295;10614;10703;6.85;0.42;278.23;9.84;984;63;3669.00;89
9631;62;626500723;9631;292;10614;10703;6.79;0.41;278.26;9.84;983;63;3670.00;89
9633;62;626500735;9633;286;10614;10703;6.72;0.41;278.28;9.84;981;63;3671.00;89
9637;62;626500746;9637;288;10644;10773;6.77;0.41;278.28;9.82;1007;63;3672.00;129
9640;62;626500763;9640;279;10644;10774;6.74;0.41;278.32;9.82;1004;63;3673.00;130
9644;62;626500775;9644;277;10653;10774;6.82;0.42;278.32;9.82;1009;63;3674.00;121
9646;62;626500786;9646;276;10656;10774;6.78;0.41;278.33;9.89;1010;63;3675.00;118
9649;62;626500800;9649;272;10662;10774;6.80;0.41;278.35;9.89;1013;63;3676.00;112
9650;62;626500813;9650;267;10664;10774;6.81;0.42;278.34;9.88;1014;63;3677.00;110
9656;62;626500825;9656;258;10669;10774;6.80;0.41;278.28;9.93;1013;63;3678.00;105
9659;63;626500837;9659;250;10671;10774;6.82;0.41;278.26;9.93;1012;64;3679.00;103
9662;63;626500856;9662;247;10675;10775;6.87;0.42;278.29;9.98;1013;64;3680.00;100
9664;63;626500868;9664;237;10677;10776;6.92;0.42;278.26;9.98;1013;64;3681.00;99
9665;63;626500884;9665;234;10678;10776;6.90;0.42;278.24;9.98;1013;64;3682.00;98
9666;63;626500897;9666;227;10681;10780;6.84;0.41;278.22;9.98;1015;64;3683.00;99
9666;63;626500909;9666;226;10681;10780;6.79;0.41;278.22;9.98;1015;64;3684.00;99
9668;63;626500921;9668;224;10682;10780;6.76;0.41;278.22;10.02;1014;64;3685.00;98
9669;63;626500934;9669;235;10682;10780;6.72;0.41;278.20;10.02;1013;64;3686.00;98
9671;63;626500947;9671;242;10686;10786;6.72;0.41;278.17;10.03;1015;64;3687.00;100
9675;63;626500960;9675;258;10687;10786;6.65;0.40;278.09;10.03;1012;64;3688.00;99
9676;63;626500973;9676;261;10687;10786;6.63;0.40;278.07;10.03;1011;64;3689.00;99
9678;63;626500986;9678;274;10691;10792;6.61;0.40;278.03;10.03;1013;64;3690.00;101
9679;63;626500999;9679;283;10693;10792;6.57;0.40;278.01;10.03;1014;64;3691.00;99
9681;63;626501010;9681;287;10695;10792;6.54;0.40;277.96;10.04;1014;64;3692.00;97
9683;63;626501023;9683;296;10697;10793;6.50;0.40;277.93;10.04;1014;64;3693.00;96
9684;63;626501035;9684;294;10701;10794;6.42;0.39;277.91;10.09;1017;64;3694.00;93
9684;63;626501052;9684;293;10703;10794;6.36;0.39;277.91;10.09;1019;64;3695.00;91
9687;63;626501073;9687;300;10711;10807;6.30;0.38;277.93;10.08;1024;64;3696.00;96
9688;63;626501095;9688;307;10714;10807;6.26;0.38;277.93;10.09;1026;64;3697.00;93
9690;63;626501111;9690;316;10714;10807;6.21;0.38;277.92;10.09;1024;64;3698.00;93
9692;63;626501129;9692;316;10718;10808;6.22;0.38;277.90;10.10;1026;64;3699.00;90
9694;63;626501148;9694;323;10719;10808;6.16;0.37;277.85;10.12;1025;64;3700.00;89
9697;63;626501171;9697;325;10722;10812;6.14;0.37;277.83;10.12;1025;64;3701.00;90
9700;63;626501185;9700;331;10725;10812;6.12;0.37;277.92;10.13;1025;64;3702.00;87
9701;63;626501198;9701;340;10731;10816;6.13;0.37;277.90;10.15;1030;64;3703.00;85
9705;63;626501211;9705;348;10731;10816;6.07;0.37;277.81;10.15;1026;64;3704.00;85
9706;63;626501224;9706;354;10731;10816;6.05;0.37;277.79;10.15;1025;64;3705.00;85
9708;63;626501236;9708;349;10732;10816;6.05;0.37;277.75;10.16;1024;64;3706.00;84
9708;63;626501249;9708;348;10734;10816;6.06;0.37;277.75;10.18;1026;64;3707.00;82
9710;63;626501264;9710;355;10745;10828;6.09;0.37;277.72;10.18;1035;64;3708.00;83
9712;63;626501278;9712;355;10746;10828;6.11;0.37;277.70;10.18;1034;64;3709.00;82
9714;63;626501290;9714;361;10747;10828;6.03;0.37;277.69;10.19;1033;64;3710.00;81
9715;63;626501302;9715;365;10749;10828;5.98;0.37;277.70;10.21;1034;64;3711.00;79
9716;63;626501315;9716;371;10751;10828;5.99;0.37;277.72;10.22;1035;64;3712.00;77
9716;63;626501326;9716;378;10752;10828;6.02;0.37;277.72;10.23;1036;64;3713.00;76
9718;63;626501339;9718;383;10754;10829;5.97;0.37;277.74;10.24;1036;64;3714.00;75
9721;63;626501351;9721;369;10756;10829;5.92;0.36;277.73;10.26;1035;64;3715.00;73
9721;63;626501363;9721;372;10760;10835;5.96;0.37;277.73;10.25;1039;64;3716.00;75
9723;63;626501376;9723;366;10764;10836;5.94;0.36;277.71;10.26;1041;64;3717.00;72
9724;63;626501389;9724;366;10765;10836;5.91;0.36;277.71;10.26;1041;64;3718.00;71
9727;63;626501401;9727;354;10767;10836;5.88;0.36;277.75;10.28;1040;64;3719.00;69
9728;63;626501416;9728;343;10771;10841;5.92;0.36;277.74;10.28;1043;64;3720.00;70
9729;63;626501429;9729;335;10772;10841;5.92;0.36;277.74;10.29;1043;64;3721.00;69
9731;63;626501441;9731;339;10772;10841;5.92;0.36;277.72;10.29;1041;64;3722.00;69
9734;63;626501454;9734;340;10775;10842;5.94;0.36;277.73;10.31;1041;64;3723.00;67
9736;63;626501468;9736;337;10778;10846;6.02;0.37;277.71;10.31;1042;64;3724.00;68
9737;63;626501481;9737;332;10778;10846;6.15;0.38;277.69;10.31;1041;64;3725.00;68
9740;63;626501494;9740;336;10780;10849;6.25;0.38;277.77;10.31;1040;64;3726.00;69
9741;63;626501514;9741;331;10784;10849;6.33;0.39;277.76;10.34;1043;64;3727.00;65
9742;63;626501527;9742;335;10785;10849;6.40;0.39;277.75;10.34;1043;64;3728.00;64
9742;63;626501540;9742;340;10787;10849;6.48;0.40;277.75;10.36;1045;64;3729.00;62
9743;64;626501552;9743;343;10790;10853;6.53;0.40;277.74;10.36;1047;65;3730.00;63
9744;64;626501578;9744;351;10794;10853;6.51;0.40;277.72;10.37;1050;65;3731.00;59
9746;64;626501591;9746;351;10795;10853;6.47;0.39;277.76;10.37;1049;65;3732.00;58
9748;64;626501602;9748;353;10796;10853;6.37;0.39;277.73;10.38;1048;65;3733.00;57
9751;64;626501615;9751;349;10796;10854;6.24;0.38;277.71;10.38;1045;65;3734.00;58
9754;64;626501634;9754;351;10799;10856;6.17;0.38;277.69;10.38;1045;65;3735.00;57
9758;64;626501656;9758;353;10799;10856;6.08;0.37;277.65;10.38;1041;65;3736.00;57
9759;64;626501672;9759;352;10801;10857;6.00;0.37;277.68;10.39;1042;65;3737.00;56
9760;64;626501685;9760;355;10801;10857;5.96;0.37;277.69;10.39;1041;65;3738.00;56
9765;64;626501697;9765;361;10802;10857;5.84;0.36;277.68;10.40;1037;65;3739.00;55
9767;64;626501709;9767;347;10802;10857;5.76;0.35;277.69;10.40;1035;65;3740.00;55
9770;64;626501722;9770;348;10803;10857;5.70;0.35;277.75;10.41;1033;65;3741.00;54
9774;64;626501733;9774;347;10803;10857;5.65;0.35;277.83;10.41;1029;65;3742.00;54
9776;64;626501745;9776;342;10803;10857;5.65;0.35;277.85;10.41;1027;65;3743.00;54
9780;64;626501757;9780;362;10871;10984;5.89;0.37;277.91;10.37;1091;65;3744.00;113
9784;64;626501784;9784;350;10876;10985;5.87;0.36;277.93;10.37;1092;65;3745.00;109
9788;64;626501797;9788;336;10885;10985;5.97;0.37;277.97;10.36;1097;65;3746.00;100
9793;64;626501809;9793;329;10888;10985;6.02;0.37;277.98;10.36;1095;65;3747.00;97
9797;64;626501822;9797;325;10894;10985;6.09;0.38;278.09;10.36;1097;65;3748.00;91
9801;64;626501835;9801;321;10898;10985;6.13;0.38;278.26;10.36;1097;65;3749.00;87
9806;64;626501850;9806;318;10903;10990;6.12;0.38;278.32;10.35;1097;65;3750.00;87
9810;64;626501863;9810;323;10905;10990;6.09;0.38;278.40;10.35;1095;65;3751.00;85
9811;64;626501877;9811;321;10912;10991;6.18;0.38;278.41;10.40;1101;65;3752.00;79
9815;64;626501891;9815;317;10916;10992;6.24;0.38;278.47;10.40;1101;65;3753.00;76
9820;64;626501907;9820;320;10920;10992;6.32;0.39;278.54;10.40;1100;65;3754.00;72
9826;64;626501925;9826;318;10921;10993;6.39;0.39;278.57;10.40;1095;65;3755.00;72
9829;64;626501946;9829;310;10923;10993;6.49;0.40;278.63;10.40;1094;65;3756.00;70
9831;64;626501960;9831;320;10925;10993;6.60;0.41;278.67;10.40;1094;65;3757.00;68
9834;64;626501975;9834;314;10927;10993;6.65;0.41;278.69;10.40;1093;65;3758.00;66
9841;64;626501989;9841;309;10930;10997;6.65;0.41;278.82;10.39;1089;65;3759.00;67
9842;64;626502004;9842;308;10931;10997;6.68;0.41;278.84;10.39;1089;65;3760.00;66
9846;64;626502020;9846;302;10931;10997;6.65;0.41;278.90;10.39;1085;65;3761.00;66
9849;64;626502034;9849;298;10935;11000;6.66;0.41;278.90;10.39;1086;65;3762.00;65
9851;64;626502049;9851;299;10935;11000;6.65;0.41;278.91;10.39;1084;65;3763.00;65
9853;64;626502064;9853;291;10936;11000;6.69;0.41;278.96;10.39;1083;65;3764.00;64
9859;64;626502078;9859;295;10939;11004;6.67;0.41;279.01;10.39;1080;65;3765.00;65
9864;64;626502099;9864;297;10940;11005;6.67;0.41;278.97;10.39;1076;65;3766.00;65
9869;64;626502122;9869;305;10940;11005;6.65;0.41;279.01;10.39;1071;65;3767.00;65
9873;64;626502145;9873;311;10942;11009;6.63;0.40;279.02;10.39;1069;65;3768.00;67
9876;64;626502160;9876;315;10942;11009;6.66;0.41;278.99;10.39;1066;65;3769.00;67
9881;64;626502173;9881;318;10944;11009;6.69;0.41;279.02;10.39;1063;65;3770.00;65
9883;64;626502188;9883;318;10945;11010;6.77;0.41;279.02;10.39;1062;65;3771.00;65
9887;65;626502203;9887;321;10946;11010;6.83;0.42;279.10;10.39;1059;66;3772.00;64
9895;65;626502230;9895;320;10950;11016;6.83;0.42;279.20;10.39;1055;66;3773.00;66
9901;65;626502250;9901;325;10950;11016;6.91;0.42;279.28;10.39;1049;66;3774.00;66
9904;65;626502270;9904;324;10951;11017;6.97;0.42;279.35;10.39;1047;66;3775.00;66
9908;65;626502292;9908;330;10951;11017;7.00;0.43;279.41;10.39;1043;66;3776.00;66
9914;65;626502307;9914;329;10952;11017;7.05;0.43;279.47;10.39;1038;66;3777.00;65
9918;65;626502321;9918;331;10953;11017;7.01;0.43;279.50;10.39;1035;66;3778.00;64
9921;65;626502337;9921;329;10953;11017;7.02;0.43;279.50;10.39;1032;66;3779.00;64
9927;65;626502353;9927;328;10978;11053;7.07;0.43;279.49;10.36;1051;66;3780.00;75
9930;65;626502370;9930;325;10981;11053;7.03;0.43;279.51;10.41;1051;66;3781.00;72
9934;65;626502385;9934;318;10983;11053;6.97;0.43;279.58;10.41;1049;66;3782.00;70
9937;65;626502402;9937;321;10984;11053;6.93;0.42;279.60;10.41;1047;66;3783.00;69
9940;65;626502417;9940;316;10984;11053;6.84;0.42;279.63;10.41;1044;66;3784.00;69
9942;65;626502431;9942;320;10985;11053;6.81;0.41;279.65;10.41;1043;66;3785.00;68
9946;65;626502446;9946;325;10988;11057;6.75;0.41;279.76;10.40;1042;66;3786.00;69
9948;65;626502460;9948;319;10988;11057;6.77;0.41;279.79;10.40;1040;66;3787.00;69
9951;65;626502474;9951;319;10992;11061;6.78;0.41;279.81;10.40;1041;66;3788.00;69
9953;65;626502488;9953;319;10993;11062;6.80;0.42;279.87;10.40;1040;66;3789.00;69
9955;65;626502502;9955;317;10993;11062;6.80;0.42;279.93;10.40;1038;66;3790.00;69
9958;65;626502519;9958;318;10993;11062;6.77;0.42;279.96;10.40;1035;66;3791.00;69
9962;65;626502539;9962;324;11003;11075;6.85;0.42;280.01;10.39;1041;66;3792.00;72
9966;65;626502563;9966;326;11003;11075;6.83;0.42;280.05;10.39;1037;66;3793.00;72
9967;65;626502579;9967;326;11004;11075;6.87;0.42;280.04;10.39;1037;66;3794.00;71
9971;65;626502595;9971;330;11005;11076;6.87;0.42;280.10;10.39;1034;66;3795.00;71
9976;65;626502610;9976;320;11005;11077;6.90;0.42;280.23;10.39;1029;66;3796.00;72
9978;65;626502627;9978;317;11005;11077;6.98;0.43;280.19;10.39;1027;66;3797.00;72
9982;65;626502642;9982;305;11009;11080;7.02;0.43;280.25;10.49;1027;66;3798.00;71
9986;65;626502658;9986;291;11010;11080;7.07;0.43;280.24;10.48;1024;66;3799.00;70
9990;65;626502677;9990;280;11010;11080;7.13;0.44;280.36;10.48;1020;66;3800.00;70
9996;65;626502696;9996;272;11010;11080;7.19;0.44;280.44;10.48;1014;66;3801.00;70
9998;65;626502713;9998;272;11014;11086;7.26;0.44;280.45;10.48;1016;66;3802.00;72
10004;65;626502729;10004;270;11014;11086;7.28;0.44;280.41;10.48;1010;66;3803.00;72
10008;65;626502744;10008;267;11015;11086;7.29;0.44;280.45;10.48;1007;66;3804.00;71
10010;65;626502760;10010;266;11015;11086;7.27;0.44;280.48;10.48;1005;66;3805.00;71
10014;65;626502775;10014;269;11018;11090;7.19;0.44;280.56;10.48;1004;66;3806.00;72
10018;65;626502795;10018;268;11019;11091;7.21;0.44;280.61;10.48;1001;66;3807.00;72
10019;65;626502810;10019;264;11019;11091;7.21;0.44;280.64;10.48;1000;66;3808.00;72
10022;65;626502824;10022;259;11020;11092;7.19;0.44;280.69;10.48;998;66;3809.00;72
10024;65;626502840;10024;255;11020;11092;7.20;0.44;280.66;10.48;996;66;3810.00;72
10025;65;626502854;10025;253;11020;11092;7.24;0.44;280.66;10.48;995;66;3811.00;72
10027;65;626502868;10027;243;11020;11092;7.30;0.44;280.66;10.48;993;66;3812.00;72
10030;65;626502882;10030;244;11020;11092;7.34;0.45;280.69;10.48;990;66;3813.00;72
10032;65;626502896;10032;240;11020;11092;7.36;0.45;280.74;10.48;988;66;3814.00;72
10034;65;626502909;10034;239;11020;11092;7.33;0.45;280.76;10.48;986;66;3815.00;72
10040;65;626502923;10040;257;11058;11162;7.28;0.44;280.76;10.44;1018;66;3816.00;104
10045;65;626502942;10045;252;11060;11163;7.22;0.44;280.78;10.44;1015;66;3817.00;103
10048;65;626502956;10048;245;11064;11163;7.24;0.44;280.81;10.43;1016;66;3818.00;99
10051;65;626502978;10051;254;11069;11163;7.26;0.44;280.86;10.43;1018;66;3819.00;94
10052;65;626502992;10052;257;11074;11163;7.28;0.44;280.84;10.43;1022;66;3820.00;89
10054;65;626503010;10054;258;11079;11163;7.31;0.45;280.92;10.43;1025;66;3821.00;84
10056;65;626503030;10056;263;11081;11163;7.34;0.45;280.90;10.43;1025;66;3822.00;82
10057;65;626503046;10057;274;11082;11163;7.28;0.44;280.90;10.43;1025;66;3823.00;81
10057;65;626503072;10057;278;11084;11164;7.26;0.44;280.90;10.42;1027;66;3824.00;80
10059;65;626503096;10059;288;11086;11166;7.20;0.44;281.05;10.42;1027;66;3825.00;80
10059;65;626503115;10059;291;11087;11166;7.11;0.43;281.05;10.42;1028;66;3826.00;79
10060;65;626503136;10060;291;11090;11170;6.95;0.43;281.04;10.42;1030;66;3827.00;80
10062;65;626503156;10062;298;11090;11170;6.86;0.42;281.03;10.42;1028;66;3828.00;80
10065;65;626503173;10065;305;11090;11170;6.77;0.41;280.99;10.42;1025;66;3829.00;80
10066;65;626503187;10066;309;11090;11170;6.69;0.41;280.99;10.42;1024;66;3830.00;80
10070;65;626503201;10070;308;11093;11176;6.68;0.41;280.98;10.42;1023;66;3831.00;83
10071;65;626503216;10071;312;11093;11176;6.68;0.41;280.96;10.42;1022;66;3832.00;83
10074;65;626503229;10074;319;11094;11176;6.72;0.41;280.94;10.42;1020;66;3833.00;82
10075;65;626503244;10075;315;11096;11179;6.74;0.41;280.94;10.41;1021;66;3834.00;83
10079;65;626503258;10079;310;11096;11179;6.71;0.41;280.89;10.41;1017;66;3835.00;83
10082;65;626503271;10082;308;11097;11179;6.69;0.41;280.90;10.41;1015;66;3836.00;82
10085;65;626503283;10085;312;11097;11180;6.59;0.40;280.85;10.41;1012;66;3837.00;83
10089;65;626503296;10089;316;11098;11181;6.51;0.40;280.86;10.41;1009;66;3838.00;83
10091;65;626503309;10091;319;11098;11181;6.43;0.39;280.84;10.41;1007;66;3839.00;83
10093;65;626503324;10093;325;11113;11207;6.33;0.38;280.82;10.40;1020;66;3840.00;94
10099;65;626503338;10099;329;11113;11207;6.15;0.37;280.77;10.40;1014;66;3841.00;94
10102;65;626503350;10102;322;11115;11207;6.15;0.37;280.81;10.40;1013;66;3842.00;92
10105;65;626503361;10105;326;11118;11208;6.12;0.37;280.81;10.40;1013;66;3843.00;90
10106;65;626503374;10106;319;11118;11208;6.12;0.37;280.79;10.40;1012;66;3844.00;90
10110;65;626503386;10110;316;11121;11212;6.11;0.37;280.76;10.41;1011;66;3845.00;91
10112;65;626503401;10112;313;11122;11214;6.09;0.37;280.74;10.41;1010;66;3846.00;92
10116;65;626503413;10116;310;11126;11218;6.03;0.37;280.74;10.41;1010;66;3847.00;92
10122;65;626503426;10122;301;11126;11218;5.95;0.36;280.76;10.41;1004;66;3848.00;92
10125;65;626503438;10125;303;11127;11218;5.89;0.36;280.72;10.41;1002;66;3849.00;91
10129;65;626503450;10129;301;11127;11218;5.75;0.35;280.72;10.41;998;66;3850.00;91
10129;65;626503463;10129;301;11127;11218;5.72;0.35;280.72;10.41;998;66;3851.00;91
10133;65;626503475;10133;302;11137;11230;5.70;0.35;280.69;10.40;1004;66;3852.00;93
10134;65;626503488;10134;296;11137;11230;5.70;0.35;280.69;10.40;1003;66;3853.00;93
10139;65;626503500;10139;297;11138;11230;5.69;0.35;280.62;10.40;999;66;3854.00;92
10141;65;626503512;10141;298;11138;11230;5.70;0.35;280.61;10.40;997;66;3855.00;92
10144;65;626503524;10144;301;11138;11230;5.74;0.35;280.61;10.40;994;66;3856.00;92
10147;65;626503536;10147;309;11139;11230;5.77;0.35;280.58;10.40;992;66;3857.00;91
10147;65;626503547;10147;311;11139;11231;5.79;0.35;280.58;10.40;992;66;3858.00;92
10147;65;626503559;10147;316;11139;11231;5.82;0.35;280.58;10.40;992;66;3859.00;92
10147;65;626503570;10147;319;11145;11237;5.88;0.36;280.58;10.40;998;66;3860.00;92
10148;65;626503583;10148;319;11147;11238;5.81;0.35;280.59;10.45;999;66;3861.00;91
10151;65;626503601;10151;325;11149;11238;5.78;0.35;280.57;10.45;998;66;3862.00;89
10151;65;626503612;10151;327;11149;11238;5.77;0.35;280.57;10.45;998;66;3863.00;89
10154;65;626503623;10154;326;11151;11242;5.75;0.35;280.51;10.45;997;66;3864.00;91
10156;65;626503635;10156;326;11153;11242;5.71;0.35;280.53;10.51;997;66;3865.00;89
10159;65;626503647;10159;325;11154;11242;5.64;0.34;280.57;10.52;995;66;3866.00;88
10160;65;626503659;10160;319;11156;11243;5.65;0.34;280.58;10.52;996;66;3867.00;87
10162;65;626503670;10162;316;11160;11247;5.70;0.34;280.54;10.58;998;66;3868.00;87
10163;65;626503683;10163;310;11162;11247;5.73;0.35;280.55;10.59;999;66;3869.00;85
10163;65;626503697;10163;307;11166;11253;5.84;0.35;280.55;10.60;1003;66;3870.00;87
10166;65;626503709;10166;298;11168;11253;5.95;0.36;280.65;10.60;1002;66;3871.00;85
10166;65;626503722;10166;293;11170;11253;6.03;0.36;280.65;10.61;1004;66;3872.00;83
10168;65;626503734;10168;287;11171;11253;6.10;0.37;280.66;10.62;1003;66;3873.00;82
10168;65;626503747;10168;286;11174;11257;6.21;0.37;280.66;10.62;1006;66;3874.00;83
10169;65;626503759;10169;287;11175;11257;6.28;0.38;280.64;10.63;1006;66;3875.00;82
10169;65;626503772;10169;286;11177;11257;6.35;0.38;280.64;10.65;1008;66;3876.00;80
10170;65;626503785;10170;287;11178;11257;6.40;0.39;280.62;10.66;1008;66;3877.00;79
10171;65;626503798;10171;283;11180;11258;6.47;0.39;280.61;10.67;1009;66;3878.00;78
10172;65;626503811;10172;279;11181;11259;6.55;0.40;280.62;10.67;1009;66;3879.00;78
10172;65;626503823;10172;289;11182;11259;6.57;0.40;280.62;10.68;1010;66;3880.00;77
10172;65;626503836;10172;297;11183;11260;6.62;0.40;280.62;10.68;1011;66;3881.00;77
10173;65;626503849;10173;301;11185;11260;6.56;0.40;280.62;10.70;1012;66;3882.00;75
10173;65;626503868;10173;302;11186;11260;6.55;0.40;280.62;10.71;1013;66;3883.00;74
10174;65;626503881;10174;311;11188;11260;6.55;0.40;280.61;10.73;1014;66;3884.00;72
10174;65;626503893;10174;311;11188;11260;6.55;0.40;280.61;10.73;1014;66;3885.00;72
10176;65;626503906;10176;316;11190;11260;6.56;0.40;280.60;10.75;1014;66;3886.00;70
10176;65;626503919;10176;322;11191;11260;6.58;0.40;280.60;10.77;1015;66;3887.00;69
10176;65;626503931;10176;339;11258;11387;6.83;0.42;280.60;10.71;1082;66;3888.00;129
10178;65;626503954;10178;325;11260;11388;6.81;0.42;280.58;10.72;1082;66;3889.00;128
10179;65;626503968;10179;311;11268;11388;6.89;0.43;280.62;10.72;1089;66;3890.00;120
10181;65;626503982;10181;310;11275;11388;6.90;0.43;280.66;10.73;1094;66;3891.00;113
10184;65;626503996;10184;305;11283;11388;6.94;0.43;280.64;10.72;1099;66;3892.00;105
10185;65;626504009;10185;298;11289;11388;6.97;0.43;280.64;10.75;1104;66;3893.00;99
10189;65;626504023;10189;302;11293;11388;7.04;0.43;280.76;10.74;1104;66;3894.00;95
10190;65;626504037;10190;302;11296;11388;7.11;0.44;280.82;10.74;1106;66;3895.00;92
10192;65;626504053;10192;303;11301;11389;7.13;0.44;280.81;10.77;1109;66;3896.00;88
10196;65;626504067;10196;307;11305;11390;7.16;0.44;280.88;10.77;1109;66;3897.00;85
10198;65;626504081;10198;320;11310;11390;7.17;0.44;280.91;10.79;1112;66;3898.00;80
10200;65;626504095;10200;328;11312;11391;7.15;0.44;280.93;10.79;1112;66;3899.00;79
10202;65;626504115;10202;342;11317;11406;7.07;0.43;280.91;10.78;1115;66;3900.00;89
10203;65;626504134;10203;338;11320;11406;6.93;0.42;280.94;10.80;1117;66;3901.00;86
10211;65;626504147;10211;341;11322;11406;6.75;0.41;280.99;10.80;1111;66;3902.00;84
10213;65;626504161;10213;352;11327;11410;6.67;0.41;281.00;10.82;1114;66;3903.00;83
10215;65;626504174;10215;352;11328;11410;6.57;0.40;281.09;10.82;1113;66;3904.00;82
10218;66;626504187;10218;359;11330;11410;6.45;0.40;281.12;10.83;1112;67;3905.00;80
10221;66;626504214;10221;369;11334;11413;6.38;0.39;281.15;10.84;1113;67;3906.00;79
10229;66;626504227;10229;372;11335;11413;6.20;0.38;281.15;10.84;1106;67;3907.00;78
10233;66;626504240;10233;383;11339;11413;6.08;0.37;281.14;10.85;1106;67;3908.00;74
10236;66;626504253;10236;385;11342;11417;6.02;0.37;281.16;10.85;1106;67;3909.00;75
10240;66;626504265;10240;373;11343;11418;6.00;0.37;281.20;10.85;1103;67;3910.00;75
10247;66;626504279;10247;371;11345;11418;5.94;0.36;281.28;10.86;1098;67;3911.00;73
10249;66;626504292;10249;370;11349;11422;5.98;0.37;281.30;10.86;1100;67;3912.00;73
10253;66;626504304;10253;370;11349;11422;5.99;0.37;281.38;10.86;1096;67;3913.00;73
10257;66;626504321;10257;363;11352;11422;6.04;0.37;281.52;10.87;1095;67;3914.00;70
10262;66;626504334;10262;361;11354;11424;6.06;0.37;281.56;10.87;1092;67;3915.00;70
10263;66;626504348;10263;360;11354;11424;6.12;0.38;281.61;10.87;1091;67;3916.00;70
10268;66;626504360;10268;361;11360;11430;6.16;0.38;281.76;10.88;1092;67;3917.00;70
10272;67;626504374;10272;358;11360;11430;6.25;0.38;281.79;10.88;1088;68;3918.00;70
10275;67;626504399;10275;353;11360;11431;6.35;0.39;281.79;10.88;1085;68;3919.00;71
10281;67;626504412;10281;344;11363;11431;6.35;0.39;281.88;10.89;1082;68;3920.00;68
10281;67;626504425;10281;348;11363;11431;6.46;0.40;281.88;10.89;1082;68;3921.00;68
10289;67;626504443;10289;348;11363;11431;6.47;0.40;281.92;10.89;1074;68;3922.00;68
10291;67;626504456;10291;344;11364;11431;6.55;0.40;281.96;10.89;1073;68;3923.00;67
10294;67;626504469;10294;332;11372;11443;6.68;0.41;282.02;10.88;1078;68;3924.00;71
10300;67;626504490;10300;326;11372;11443;6.70;0.41;282.11;10.88;1072;68;3925.00;71
10302;67;626504523;10302;326;11374;11443;6.73;0.41;282.13;10.88;1072;68;3926.00;69
10306;67;626504537;10306;328;11374;11443;6.75;0.41;282.29;10.88;1068;68;3927.00;69
10311;67;626504550;10311;332;11374;11443;6.78;0.41;282.33;10.88;1063;68;3928.00;69
10314;67;626504565;10314;324;11376;11443;6.83;0.42;282.39;10.88;1062;68;3929.00;67
10321;67;626504586;10321;323;11379;11447;6.84;0.42;282.50;10.88;1058;68;3930.00;68
10326;67;626504600;10326;321;11380;11447;6.87;0.42;282.50;10.88;1054;68;3931.00;67
10331;67;626504614;10331;326;11382;11451;6.89;0.42;282.54;10.88;1051;68;3932.00;69
10334;67;626504633;10334;325;11383;11452;6.94;0.42;282.55;10.88;1049;68;3933.00;69
10337;67;626504648;10337;334;11385;11452;6.92;0.42;282.57;10.88;1048;68;3934.00;67
10343;67;626504661;10343;337;11385;11452;6.88;0.42;282.68;10.88;1042;68;3935.00;67
10350;67;626504674;10350;342;11395;11465;6.82;0.42;282.69;10.87;1045;68;3936.00;70
10353;67;626504689;10353;343;11396;11465;6.76;0.41;282.70;10.87;1043;68;3937.00;69
10356;67;626504702;10356;344;11396;11465;6.77;0.41;282.73;10.87;1040;68;3938.00;69
10358;67;626504716;10358;350;11398;11466;6.86;0.42;282.76;10.88;1040;68;3939.00;68
10365;67;626504729;10365;354;11399;11467;6.84;0.42;282.77;10.88;1034;68;3940.00;68
10371;67;626504742;10371;352;11399;11467;6.84;0.42;282.76;10.88;1028;68;3941.00;68
10377;67;626504756;10377;349;11403;11470;6.86;0.42;282.93;10.87;1026;68;3942.00;67
10379;67;626504775;10379;346;11405;11470;6.87;0.42;282.94;10.87;1026;68;3943.00;65
10385;67;626504789;10385;346;11405;11470;6.85;0.42;282.97;10.87;1020;68;3944.00;65
10386;67;626504804;10386;347;11406;11470;6.90;0.42;282.97;10.87;1020;68;3945.00;64
10390;67;626504817;10390;346;11410;11476;6.91;0.42;283.06;10.87;1020;68;3946.00;66
10395;67;626504831;10395;348;11410;11476;6.91;0.42;283.12;10.87;1015;68;3947.00;66
10399;67;626504845;10399;356;11411;11476;6.91;0.42;283.14;10.87;1012;68;3948.00;65
10404;67;626504858;10404;356;11411;11476;6.93;0.42;283.21;10.87;1007;68;3949.00;65
10410;67;626504872;10410;357;11414;11480;6.94;0.42;283.24;10.87;1004;68;3950.00;66
10414;67;626504886;10414;353;11415;11481;6.94;0.42;283.25;10.87;1001;68;3951.00;66
10418;67;626504900;10418;354;11415;11481;6.92;0.42;283.29;10.87;997;68;3952.00;66
10424;67;626504913;10424;355;11416;11482;6.86;0.42;283.32;10.87;992;68;3953.00;66
10426;67;626504926;10426;361;11416;11482;6.84;0.42;283.34;10.87;990;68;3954.00;66
10430;67;626504940;10430;357;11416;11482;6.78;0.41;283.36;10.87;986;68;3955.00;66
10433;67;626504953;10433;363;11416;11482;6.73;0.41;283.39;10.87;983;68;3956.00;66
10435;67;626504966;10435;353;11416;11482;6.67;0.41;283.41;10.87;981;68;3957.00;66
10438;67;626504985;10438;352;11416;11482;6.60;0.40;283.46;10.87;978;68;3958.00;66
10442;67;626504998;10442;349;11416;11482;6.55;0.40;283.48;10.87;974;68;3959.00;66
10444;67;626505013;10444;369;11485;11607;6.61;0.41;283.62;10.80;1041;68;3960.00;122
10447;67;626505035;10447;354;11487;11608;6.62;0.41;283.67;10.80;1040;68;3961.00;121
10453;67;626505060;10453;349;11491;11608;6.68;0.41;283.81;10.80;1038;68;3962.00;117
10457;67;626505083;10457;344;11494;11608;6.70;0.41;283.80;10.79;1037;68;3963.00;114
10459;67;626505106;10459;347;11498;11608;6.81;0.42;283.84;10.79;1039;68;3964.00;110
10465;67;626505135;10465;348;11501;11608;6.79;0.42;283.92;10.79;1036;68;3965.00;107
10469;67;626505157;10469;340;11506;11608;6.85;0.42;283.92;10.79;1037;68;3966.00;102
10473;67;626505175;10473;331;11508;11608;6.88;0.42;284.01;10.79;1035;68;3967.00;100
10477;67;626505191;10477;331;11512;11609;6.87;0.42;284.06;10.79;1035;68;3968.00;97
10478;67;626505206;10478;323;11516;11610;6.94;0.43;284.10;10.78;1038;68;3969.00;94
10481;67;626505221;10481;320;11519;11610;6.96;0.43;284.13;10.85;1038;68;3970.00;91
10482;67;626505244;10482;322;11523;11614;6.95;0.43;284.17;10.84;1041;68;3971.00;91
10485;67;626505259;10485;323;11526;11614;6.94;0.43;284.15;10.84;1041;68;3972.00;88
10488;67;626505274;10488;320;11526;11614;6.95;0.43;284.20;10.84;1038;68;3973.00;88
10490;67;626505289;10490;316;11527;11614;6.98;0.43;284.19;10.84;1037;68;3974.00;87
10492;67;626505303;10492;319;11530;11620;7.01;0.43;284.22;10.84;1038;68;3975.00;90
10496;67;626505319;10496;329;11530;11620;7.01;0.43;284.23;10.84;1034;68;3976.00;90
10498;67;626505333;10498;325;11531;11620;7.04;0.43;284.22;10.84;1033;68;3977.00;89
10498;67;626505347;10498;318;11533;11623;7.11;0.43;284.22;10.84;1035;68;3978.00;90
10501;67;626505362;10501;316;11534;11623;7.12;0.43;284.20;10.84;1033;68;3979.00;89
10505;67;626505376;10505;315;11535;11623;7.11;0.43;284.22;10.84;1030;68;3980.00;88
10506;67;626505391;10506;311;11535;11624;7.12;0.43;284.21;10.84;1029;68;3981.00;89
10507;67;626505412;10507;301;11536;11625;7.14;0.43;284.25;10.84;1029;68;3982.00;89
10512;67;626505426;10512;299;11536;11625;7.13;0.43;284.21;10.84;1024;68;3983.00;89
10516;67;626505440;10516;300;11547;11638;7.14;0.43;284.22;10.89;1031;68;3984.00;91
10517;67;626505455;10517;296;11547;11638;7.13;0.43;284.20;10.89;1030;68;3985.00;91
10521;67;626505469;10521;299;11547;11638;7.13;0.43;284.31;10.89;1026;68;3986.00;91
10521;67;626505483;10521;303;11548;11639;7.08;0.43;284.31;10.89;1027;68;3987.00;91
10523;67;626505497;10523;307;11548;11639;7.06;0.43;284.28;10.89;1025;68;3988.00;91
10525;67;626505512;10525;309;11552;11643;7.01;0.43;284.36;10.95;1027;68;3989.00;91
10528;67;626505528;10528;313;11552;11643;6.95;0.42;284.33;10.95;1024;68;3990.00;91
10531;67;626505541;10531;314;11556;11647;6.89;0.42;284.32;10.95;1025;68;3991.00;91
10532;67;626505556;10532;313;11556;11647;6.85;0.42;284.30;10.95;1024;68;3992.00;91
10533;67;626505569;10533;317;11556;11647;6.83;0.42;284.30;10.95;1023;68;3993.00;91
10535;67;626505583;10535;325;11556;11647;6.77;0.42;284.28;10.95;1021;68;3994.00;91
10538;67;626505596;10538;319;11556;11647;6.72;0.41;284.36;10.95;1018;68;3995.00;91
10543;67;626505609;10543;326;11566;11659;6.63;0.41;284.46;10.94;1023;68;3996.00;93
10546;67;626505624;10546;324;11567;11659;6.56;0.40;284.41;10.94;1021;68;3997.00;92
10547;67;626505638;10547;332;11567;11659;6.49;0.40;284.39;10.94;1020;68;3998.00;92
10549;67;626505650;10549;334;11567;11659;6.40;0.39;284.34;10.94;1018;68;3999.00;92
10550;67;626505663;10550;330;11567;11659;6.33;0.39;284.32;10.94;1017;68;4000.00;92
10551;67;626505679;10551;328;11567;11659;6.29;0.39;284.30;10.94;1016;68;4001.00;92
10553;67;626505691;10553;323;11568;11660;6.25;0.39;284.28;11.00;1015;68;4002.00;92
10555;67;626505704;10555;327;11568;11660;6.27;0.39;284.27;11.00;1013;68;4003.00;92
10559;67;626505716;10559;321;11572;11666;6.26;0.39;284.25;11.00;1013;68;4004.00;94
10561;67;626505729;10561;321;11576;11668;6.24;0.38;284.25;11.06;1015;68;4005.00;92
10563;67;626505741;10563;313;11576;11668;6.23;0.38;284.24;11.06;1013;68;4006.00;92
10568;67;626505753;10568;317;11577;11668;6.18;0.38;284.24;11.12;1009;68;4007.00;91
10571;67;626505764;10571;322;11580;11672;6.13;0.38;284.23;11.12;1009;68;4008.00;92
10577;67;626505775;10577;321;11580;11672;6.05;0.37;284.34;11.12;1003;68;4009.00;92
10578;67;626505787;10578;326;11581;11672;5.97;0.37;284.35;11.18;1003;68;4010.00;91
10580;67;626505798;10580;326;11582;11673;5.88;0.36;284.33;11.18;1002;68;4011.00;91
10584;67;626505809;10584;319;11586;11677;5.77;0.35;284.31;11.23;1002;68;4012.00;91
10584;67;626505821;10584;312;11586;11677;5.70;0.35;284.31;11.23;1002;68;4013.00;91
10585;67;626505832;10585;311;11589;11680;5.69;0.35;284.31;11.28;1004;68;4014.00;91
10587;67;626505843;10587;308;11592;11680;5.70;0.35;284.30;11.31;1005;68;4015.00;88
10589;67;626505855;10589;305;11592;11680;5.69;0.35;284.30;11.31;1003;68;4016.00;88
10592;67;626505869;10592;299;11593;11680;5.67;0.35;284.34;11.36;1001;68;4017.00;87
10594;67;626505879;10594;297;11596;11684;5.73;0.35;284.34;11.36;1002;68;4018.00;88
10599;67;626505892;10599;284;11597;11684;5.77;0.35;284.35;11.41;998;68;4019.00;87
10600;67;626505905;10600;275;11598;11684;5.82;0.36;284.32;11.41;998;68;4020.00;86
10600;67;626505917;10600;261;11598;11684;5.88;0.36;284.32;11.41;998;68;4021.00;86
10602;67;626505928;10602;258;11599;11685;5.89;0.36;284.29;11.46;997;68;4022.00;86
10607;67;626505940;10607;248;11600;11686;5.92;0.36;284.25;11.46;993;68;4023.00;86
10609;67;626505952;10609;244;11601;11686;5.98;0.37;284.29;11.50;992;68;4024.00;85
10611;67;626505964;10611;237;11602;11687;6.10;0.37;284.26;11.50;991;68;4025.00;85
10614;67;626505983;10614;237;11602;11687;6.19;0.38;284.23;11.50;988;68;4026.00;85
10618;67;626505994;10618;233;11604;11687;6.24;0.38;284.23;11.55;986;68;4027.00;83
10619;67;626506006;10619;225;11604;11687;6.33;0.39;284.21;11.55;985;68;4028.00;83
10620;67;626506024;10620;225;11604;11687;6.41;0.39;284.20;11.55;984;68;4029.00;83
10621;67;626506036;10621;220;11604;11687;6.51;0.40;284.20;11.55;983;68;4030.00;83
10624;67;626506049;10624;218;11604;11687;6.54;0.40;284.29;11.55;980;68;4031.00;83
10625;67;626506062;10625;246;11667;11814;6.80;0.42;284.29;11.49;1042;68;4032.00;147
10627;67;626506085;10627;236;11670;11815;6.83;0.42;284.28;11.49;1043;68;4033.00;145
10628;67;626506099;10628;229;11677;11815;6.94;0.43;284.29;11.48;1049;68;4034.00;138
10629;67;626506111;10629;230;11682;11815;7.01;0.43;284.30;11.48;1053;68;4035.00;133
10629;67;626506123;10629;225;11690;11815;7.08;0.43;284.30;11.48;1061;68;4036.00;125
10630;67;626506135;10630;215;11692;11815;7.10;0.44;284.29;11.47;1062;68;4037.00;123
10632;67;626506147;10632;215;11697;11815;7.14;0.44;284.30;11.47;1065;68;4038.00;118
10632;67;626506160;10632;224;11699;11815;7.20;0.44;284.30;11.49;1067;68;4039.00;116
10635;67;626506172;10635;224;11704;11816;7.29;0.45;284.26;11.48;1069;68;4040.00;112
10637;67;626506185;10637;223;11709;11817;7.39;0.45;284.25;11.50;1072;68;4041.00;108
10640;67;626506198;10640;228;11715;11817;7.45;0.46;284.35;11.51;1075;68;4042.00;102
10643;67;626506212;10643;225;11719;11818;7.46;0.46;284.31;11.51;1076;68;4043.00;99
10646;67;626506225;10646;232;11722;11818;7.47;0.46;284.36;11.52;1076;68;4044.00;96
10648;67;626506238;10648;233;11724;11818;7.46;0.46;284.39;11.53;1076;68;4045.00;94
10649;67;626506251;10649;243;11726;11818;7.45;0.46;284.40;11.53;1077;68;4046.00;92
10652;67;626506265;10652;245;11729;11822;7.38;0.45;284.47;11.53;1077;68;4047.00;93
10653;67;626506278;10653;254;11732;11822;7.37;0.45;284.53;11.56;1079;68;4048.00;90
10654;67;626506292;10654;256;11734;11822;7.35;0.45;284.56;11.58;1080;68;4049.00;88
10659;67;626506312;10659;264;11738;11828;7.28;0.44;284.58;11.58;1079;68;4050.00;90
10660;67;626506326;10660;271;11740;11828;7.23;0.44;284.58;11.60;1080;68;4051.00;88
10663;67;626506339;10663;275;11741;11828;7.11;0.43;284.65;11.60;1078;68;4052.00;87
10665;67;626506352;10665;277;11745;11832;7.06;0.43;284.66;11.61;1080;68;4053.00;87
10666;67;626506365;10666;281;11747;11833;7.03;0.43;284.70;11.61;1081;68;4054.00;86
10671;67;626506378;10671;289;11747;11833;6.96;0.42;284.76;11.61;1076;68;4055.00;86
10675;67;626506391;10675;297;11754;11837;6.95;0.42;284.76;11.64;1079;68;4056.00;83
10675;67;626506403;10675;302;11755;11837;6.92;0.42;284.76;11.65;1080;68;4057.00;82
10676;67;626506416;10676;308;11759;11837;6.87;0.42;284.79;11.68;1083;68;4058.00;78
10678;67;626506428;10678;313;11760;11838;6.84;0.42;284.86;11.68;1082;68;4059.00;78
10678;67;626506441;10678;312;11762;11838;6.83;0.42;284.86;11.69;1084;68;4060.00;76
10680;67;626506454;10680;315;11766;11844;6.88;0.42;284.94;11.69;1086;68;4061.00;78
10682;67;626506468;10682;314;11768;11844;6.84;0.42;285.02;11.70;1086;68;4062.00;76
10684;67;626506481;10684;315;11769;11845;6.82;0.42;285.01;11.71;1085;68;4063.00;76
10687;67;626506494;10687;311;11772;11845;6.76;0.41;285.08;11.73;1085;68;4064.00;73
10691;67;626506512;10691;310;11773;11845;6.72;0.41;285.06;11.74;1082;68;4065.00;72
10692;67;626506525;10692;310;11773;11845;6.69;0.41;285.09;11.74;1081;68;4066.00;72
10692;67;626506538;10692;308;11774;11845;6.68;0.41;285.09;11.74;1082;68;4067.00;71
10696;67;626506550;10696;307;11785;11857;6.74;0.41;285.15;11.74;1089;68;4068.00;72
10699;67;626506564;10699;310;11786;11857;6.75;0.41;285.26;11.75;1087;68;4069.00;71
10702;67;626506577;10702;301;11787;11857;6.71;0.41;285.27;11.75;1085;68;4070.00;70
10705;67;626506589;10705;302;11789;11857;6.66;0.41;285.39;11.76;1084;68;4071.00;68
10710;67;626506602;10710;307;11789;11857;6.56;0.40;285.42;11.76;1079;68;4072.00;68
10712;67;626506620;10712;316;11789;11857;6.48;0.39;285.46;11.76;1077;68;4073.00;68
10717;67;626506632;10717;314;11794;11861;6.37;0.39;285.60;11.78;1077;68;4074.00;67
10724;67;626506645;10724;318;11794;11861;6.26;0.38;285.64;11.78;1070;68;4075.00;67
10727;67;626506657;10727;316;11799;11865;6.22;0.38;285.71;11.78;1072;68;4076.00;66
10733;67;626506670;10733;321;11800;11866;6.10;0.37;285.76;11.78;1067;68;4077.00;66
10736;67;626506682;10736;334;11801;11866;6.01;0.37;285.77;11.78;1065;68;4078.00;65
10739;67;626506693;10739;338;11803;11866;5.92;0.36;285.78;11.80;1064;68;4079.00;63
10743;67;626506707;10743;334;11822;11895;5.84;0.36;285.76;11.78;1079;68;4080.00;73
10747;67;626506721;10747;331;11826;11895;5.82;0.36;285.79;11.79;1079;68;4081.00;69
10753;67;626506732;10753;324;11829;11895;5.76;0.35;285.78;11.80;1076;68;4082.00;66
10756;67;626506744;10756;331;11831;11896;5.75;0.35;285.86;11.79;1075;68;4083.00;65
10759;67;626506756;10759;333;11834;11897;5.82;0.36;285.84;11.80;1075;68;4084.00;63
10761;67;626506768;10761;333;11834;11897;5.87;0.36;285.88;11.80;1073;68;4085.00;63
10769;67;626506780;10769;344;11837;11900;5.89;0.36;285.91;11.80;1068;68;4086.00;63
10774;67;626506792;10774;335;11837;11900;5.93;0.36;285.93;11.80;1063;68;4087.00;63
10778;67;626506805;10778;333;11837;11900;6.01;0.37;285.91;11.80;1059;68;4088.00;63
10781;67;626506818;10781;332;11837;11900;6.09;0.37;285.96;11.80;1056;68;4089.00;63
10785;67;626506830;10785;326;11841;11906;6.22;0.38;286.03;11.80;1056;68;4090.00;65
10790;67;626506843;10790;321;11842;11906;6.29;0.39;286.12;11.80;1052;68;4091.00;64
10793;67;626506856;10793;318;11842;11906;6.36;0.39;286.16;11.80;1049;68;4092.00;64
10798;67;626506867;10798;312;11842;11906;6.42;0.39;286.24;11.80;1044;68;4093.00;64
10801;67;626506885;10801;302;11845;11910;6.47;0.40;286.25;11.79;1044;68;4094.00;65
10805;67;626506898;10805;306;11847;11912;6.57;0.40;286.26;11.79;1042;68;4095.00;65
10812;67;626506911;10812;304;11847;11912;6.59;0.40;286.35;11.79;1035;68;4096.00;65
10814;67;626506923;10814;307;11848;11913;6.70;0.41;286.35;11.79;1034;68;4097.00;65
10820;67;626506935;10820;298;11848;11913;6.72;0.41;286.43;11.79;1028;68;4098.00;65
10822;67;626506948;10822;300;11848;11913;6.80;0.42;286.46;11.79;1026;68;4099.00;65
10828;67;626506961;10828;298;11848;11913;6.89;0.42;286.47;11.79;1020;68;4100.00;65
10831;67;626506978;10831;305;11848;11913;6.95;0.43;286.49;11.79;1017;68;4101.00;65
10838;67;626506996;10838;297;11848;11913;6.92;0.43;286.60;11.79;1010;68;4102.00;65
10843;67;626507009;10843;302;11848;11913;6.87;0.42;286.61;11.79;1005;68;4103.00;65
10847;67;626507022;10847;310;11889;11983;6.88;0.42;286.71;11.75;1042;68;4104.00;94
10851;67;626507041;10851;306;11889;11984;6.94;0.43;286.67;11.75;1038;68;4105.00;95
10857;67;626507058;10857;307;11895;11984;7.01;0.43;286.75;11.74;1038;68;4106.00;89
10862;67;626507080;10862;309;11899;11984;7.14;0.44;286.76;11.74;1037;68;4107.00;85
10863;67;626507101;10863;317;11904;11984;7.24;0.44;286.83;11.74;1041;68;4108.00;80
10869;67;626507121;10869;324;11907;11984;7.23;0.44;286.86;11.74;1038;68;4109.00;77
10873;67;626507143;10873;322;11908;11984;7.21;0.44;286.93;11.74;1035;68;4110.00;76
10878;67;626507161;10878;330;11910;11984;7.20;0.44;286.96;11.73;1032;68;4111.00;74
10885;67;626507176;10885;337;11911;11985;7.20;0.44;286.98;11.73;1026;68;4112.00;74
10891;67;626507192;10891;342;11913;11986;7.18;0.44;286.99;11.73;1022;68;4113.00;73
10895;67;626507207;10895;346;11913;11986;7.15;0.44;287.06;11.73;1018;68;4114.00;73
10903;67;626507222;10903;354;11915;11990;7.12;0.44;287.20;11.73;1012;68;4115.00;75
10909;67;626507239;10909;363;11915;11990;7.08;0.43;287.17;11.73;1006;68;4116.00;75
10912;67;626507254;10912;373;11915;11990;7.09;0.43;287.21;11.73;1003;68;4117.00;75
10915;67;626507269;10915;377;11915;11990;7.10;0.43;287.20;11.73;1000;68;4118.00;75
10919;67;626507283;10919;380;11920;11996;7.07;0.43;287.23;11.78;1001;68;4119.00;76
10924;67;626507297;10924;383;11922;11996;7.06;0.43;287.24;11.78;998;68;4120.00;74
10926;67;626507311;10926;386;11923;11996;7.05;0.43;287.28;11.78;997;68;4121.00;73
10932;67;626507324;10932;392;11926;11999;6.96;0.43;287.27;11.77;994;68;4122.00;73
10933;67;626507345;10933;398;11927;11999;6.87;0.42;287.29;11.77;994;68;4123.00;72
10936;67;626507364;10936;404;11928;11999;6.75;0.41;287.34;11.77;992;68;4124.00;71
10940;67;626507378;10940;409;11928;12000;6.62;0.40;287.39;11.77;988;68;4125.00;72
10940;67;626507391;10940;413;11929;12001;6.57;0.40;287.39;11.77;989;68;4126.00;72
10941;67;626507404;10941;404;11929;12001;6.52;0.40;287.41;11.77;988;68;4127.00;72
10947;67;626507417;10947;406;11940;12014;6.51;0.40;287.49;11.76;993;68;4128.00;74
10950;67;626507432;10950;408;11940;12014;6.46;0.39;287.46;11.76;990;68;4129.00;74
10953;67;626507454;10953;403;11940;12014;6.44;0.39;287.45;11.76;987;68;4130.00;74
10954;67;626507469;10954;403;11941;12015;6.47;0.39;287.44;11.76;987;68;4131.00;74
10958;67;626507484;10958;402;11941;12015;6.44;0.39;287.43;11.76;983;68;4132.00;74
10959;67;626507498;10959;405;11944;12019;6.50;0.40;287.46;11.76;985;68;4133.00;75
10961;67;626507514;10961;407;11944;12019;6.53;0.40;287.48;11.76;983;68;4134.00;75
10965;68;626507527;10965;415;11948;12023;6.54;0.40;287.55;11.75;983;69;4135.00;75
10967;68;626507549;10967;406;11948;12023;6.55;0.40;287.52;11.75;981;69;4136.00;75
10970;68;626507564;10970;394;11948;12023;6.57;0.40;287.51;11.75;978;69;4137.00;75
10973;68;626507577;10973;392;11948;12023;6.58;0.40;287.54;11.75;975;69;4138.00;75
10973;68;626507592;10973;388;11948;12023;6.60;0.40;287.54;11.75;975;69;4139.00;75
10975;68;626507608;10975;386;11971;12057;6.67;0.41;287.52;11.73;996;69;4140.00;86
10978;68;626507626;10978;388;11973;12057;6.68;0.41;287.50;11.73;995;69;4141.00;84
10981;68;626507640;10981;377;11974;12057;6.71;0.41;287.49;11.73;993;69;4142.00;83
10983;68;626507660;10983;374;11974;12057;6.76;0.41;287.45;11.73;991;69;4143.00;83
10987;68;626507674;10987;371;11975;12057;6.81;0.42;287.50;11.73;988;69;4144.00;82
10988;68;626507688;10988;379;11975;12057;6.83;0.42;287.49;11.73;987;69;4145.00;82
10989;68;626507708;10989;380;11976;12058;6.88;0.42;287.50;11.73;987;69;4146.00;82
10993;68;626507721;10993;367;11977;12058;6.86;0.42;287.49;11.77;984;69;4147.00;81
10994;68;626507735;10994;357;11981;12064;6.92;0.42;287.47;11.77;987;69;4148.00;83
10996;68;626507748;10996;351;11982;12065;6.91;0.42;287.44;11.77;986;69;4149.00;83
11001;68;626507761;11001;348;11983;12065;6.86;0.42;287.37;11.77;982;69;4150.00;82
11002;68;626507775;11002;344;11983;12065;6.84;0.42;287.35;11.77;981;69;4151.00;82
11006;68;626507788;11006;340;11987;12069;6.85;0.42;287.31;11.76;981;69;4152.00;82
11008;68;626507802;11008;340;11987;12069;6.82;0.42;287.27;11.76;979;69;4153.00;82
11009;68;626507815;11009;343;11987;12069;6.79;0.41;287.25;11.76;978;69;4154.00;82
11013;68;626507836;11013;336;11988;12070;6.68;0.41;287.22;11.76;975;69;4155.00;82
11014;68;626507850;11014;346;11991;12074;6.61;0.40;287.21;11.76;977;69;4156.00;83
11017;68;626507864;11017;342;11991;12074;6.55;0.40;287.28;11.76;974;69;4157.00;83
11017;68;626507877;11017;345;11993;12077;6.57;0.40;287.28;11.76;976;69;4158.00;84
11020;68;626507890;11020;350;11993;12077;6.51;0.40;287.26;11.76;973;69;4159.00;84
11021;68;626507903;11021;348;11994;12077;6.45;0.39;287.24;11.76;973;69;4160.00;83
11022;68;626507916;11022;354;11994;12077;6.39;0.39;287.22;11.76;972;69;4161.00;83
11025;68;626507928;11025;359;11997;12081;6.33;0.39;287.25;11.76;972;69;4162.00;84
11025;68;626507942;11025;359;11998;12081;6.26;0.38;287.25;11.80;973;69;4163.00;83
11027;68;626507955;11027;371;11999;12081;6.25;0.38;287.24;11.80;972;69;4164.00;82
11028;68;626507967;11028;376;11999;12081;6.23;0.38;287.24;11.80;971;69;4165.00;82
11028;68;626507981;11028;381;12000;12082;6.18;0.38;287.24;11.85;972;69;4166.00;82
11029;68;626507992;11029;376;12001;12083;6.09;0.37;287.23;11.85;972;69;4167.00;82
11030;68;626508005;11030;381;12002;12083;6.00;0.37;287.23;11.89;972;69;4168.00;81
11030;68;626508018;11030;385;12003;12084;5.94;0.36;287.23;11.89;973;69;4169.00;81
11030;68;626508032;11030;382;12003;12084;5.84;0.36;287.23;11.89;973;69;4170.00;81
11032;68;626508051;11032;366;12004;12084;5.73;0.35;287.21;11.94;972;69;4171.00;80
11032;68;626508063;11032;355;12004;12084;5.66;0.35;287.21;11.94;972;69;4172.00;80
11036;68;626508075;11036;344;12007;12086;5.60;0.34;287.21;11.98;971;69;4173.00;79
11038;68;626508087;11038;335;12007;12086;5.64;0.35;287.18;11.98;969;69;4174.00;79
11041;68;626508100;11041;326;12007;12086;5.68;0.35;287.16;11.98;966;69;4175.00;79
11042;68;626508111;11042;337;12076;12213;5.93;0.37;287.15;11.91;1034;69;4176.00;137
11044;68;626508132;11044;318;12077;12214;6.01;0.37;287.13;11.91;1033;69;4177.00;137
11046;68;626508149;11046;300;12085;12214;6.11;0.38;287.14;11.95;1039;69;4178.00;129
11048;68;626508167;11048;288;12086;12214;6.16;0.38;287.15;11.95;1038;69;4179.00;128
11051;68;626508179;11051;283;12090;12214;6.23;0.39;287.23;12.00;1039;69;4180.00;124
11055;68;626508198;11055;275;12096;12214;6.28;0.39;287.26;12.00;1041;69;4181.00;118
11056;68;626508210;11056;262;12099;12214;6.37;0.39;287.25;11.99;1043;69;4182.00;115
11058;68;626508228;11058;265;12102;12214;6.45;0.40;287.27;12.04;1044;69;4183.00;112
11062;69;626508245;11062;269;12103;12215;6.51;0.40;287.29;12.04;1041;70;4184.00;112
11063;69;626508265;11063;268;12110;12217;6.57;0.40;287.29;12.05;1047;70;4185.00;107
11066;69;626508279;11066;269;12113;12217;6.69;0.41;287.25;12.10;1047;70;4186.00;104
11069;69;626508294;11069;262;12117;12218;6.81;0.42;287.29;12.10;1048;70;4187.00;101
11071;69;626508307;11071;259;12120;12218;6.87;0.42;287.27;12.10;1049;70;4188.00;98
11072;69;626508319;11072;252;12123;12218;6.93;0.43;287.28;12.10;1051;70;4189.00;95
11076;69;626508331;11076;250;12126;12218;6.94;0.42;287.32;12.10;1050;70;4190.00;92
11078;69;626508344;11078;243;12130;12222;6.88;0.42;287.37;12.14;1052;70;4191.00;92
11080;69;626508363;11080;251;12130;12222;6.84;0.42;287.38;12.14;1050;70;4192.00;92
11081;69;626508376;11081;247;12131;12222;6.84;0.42;287.36;12.14;1050;70;4193.00;91
11082;69;626508388;11082;242;12133;12225;6.97;0.43;287.37;12.14;1051;70;4194.00;92
11084;69;626508402;11084;239;12133;12225;7.02;0.43;287.36;12.14;1049;70;4195.00;92
11089;69;626508415;11089;245;12134;12225;7.02;0.43;287.37;12.14;1045;70;4196.00;91
11094;69;626508427;11094;250;12139;12229;7.00;0.43;287.43;12.15;1045;70;4197.00;90
11098;69;626508440;11098;244;12140;12230;7.06;0.43;287.45;12.15;1042;70;4198.00;90
11101;69;626508453;11101;242;12140;12230;7.10;0.43;287.41;12.15;1039;70;4199.00;90
11104;69;626508468;11104;249;12150;12264;7.08;0.43;287.36;12.14;1046;70;4200.00;114
11105;69;626508489;11105;245;12153;12264;7.08;0.43;287.40;12.14;1048;70;4201.00;111
11107;69;626508502;11107;238;12153;12264;7.09;0.43;287.46;12.14;1046;70;4202.00;111
11111;69;626508515;11111;241;12155;12265;7.13;0.43;287.58;12.14;1044;70;4203.00;110
11113;69;626508527;11113;232;12157;12265;7.20;0.44;287.64;12.14;1044;70;4204.00;108
11117;69;626508539;11117;236;12160;12271;7.23;0.44;287.65;12.14;1043;70;4205.00;111
11118;69;626508554;11118;235;12163;12271;7.28;0.44;287.65;12.15;1045;70;4206.00;108
11124;69;626508567;11124;236;12165;12272;7.29;0.44;287.65;12.15;1041;70;4207.00;107
11127;69;626508580;11127;236;12166;12272;7.33;0.44;287.70;12.15;1039;70;4208.00;106
11129;69;626508594;11129;231;12166;12272;7.39;0.45;287.71;12.15;1037;70;4209.00;106
11131;69;626508617;11131;228;12168;12272;7.41;0.45;287.75;12.18;1037;70;4210.00;104
11133;69;626508631;11133;234;12168;12272;7.46;0.45;287.78;12.18;1035;70;4211.00;104
11136;69;626508645;11136;237;12179;12284;7.51;0.46;287.79;12.18;1043;70;4212.00;105
11139;69;626508668;11139;238;12183;12284;7.55;0.46;287.88;12.19;1044;70;4213.00;101
11141;69;626508682;11141;233;12183;12284;7.66;0.46;287.84;12.19;1042;70;4214.00;101
11145;69;626508696;11145;231;12183;12284;7.68;0.47;287.88;12.19;1038;70;4215.00;101
11146;69;626508710;11146;232;12185;12284;7.74;0.47;287.91;12.21;1039;70;4216.00;99
11147;69;626508724;11147;231;12185;12284;7.81;0.47;287.89;12.21;1038;70;4217.00;99
11150;69;626508737;11150;232;12192;12288;7.77;0.47;287.94;12.23;1042;70;4218.00;96
11152;69;626508751;11152;226;12194;12288;7.78;0.47;287.98;12.25;1042;70;4219.00;94
11152;69;626508765;11152;231;12197;12292;7.84;0.48;287.98;12.25;1045;70;4220.00;95
11156;69;626508779;11156;227;12198;12293;7.80;0.47;288.03;12.25;1042;70;4221.00;95
11162;69;626508793;11162;228;12200;12293;7.75;0.47;288.06;12.27;1038;70;4222.00;93
11164;69;626508807;11164;230;12201;12293;7.75;0.47;288.03;12.27;1037;70;4223.00;92
11166;69;626508821;11166;232;12212;12306;7.73;0.47;288.05;12.30;1046;70;4224.00;94
11169;69;626508837;11169;232;12212;12306;7.68;0.47;288.08;12.30;1043;70;4225.00;94
11171;69;626508856;11171;238;12214;12306;7.60;0.46;288.14;12.32;1043;70;4226.00;92
11173;69;626508869;11173;240;12215;12307;7.56;0.46;288.17;12.32;1042;70;4227.00;92
11175;69;626508882;11175;249;12216;12308;7.53;0.46;288.27;12.33;1041;70;4228.00;92
11178;69;626508896;11178;241;12220;12308;7.49;0.46;288.33;12.34;1042;70;4229.00;88
11181;69;626508911;11181;234;12224;12314;7.48;0.46;288.36;12.35;1043;70;4230.00;90
11182;69;626508925;11182;235;12225;12314;7.49;0.46;288.41;12.35;1043;70;4231.00;89
11188;69;626508944;11188;239;12227;12314;7.47;0.46;288.47;12.37;1039;70;4232.00;87
11191;69;626508957;11191;238;12227;12314;7.45;0.46;288.50;12.37;1036;70;4233.00;87
11194;69;626508970;11194;237;12230;12320;7.48;0.46;288.55;12.37;1036;70;4234.00;90
11195;69;626508984;11195;244;12231;12320;7.47;0.46;288.58;12.37;1036;70;4235.00;89
11199;69;626508996;11199;251;12231;12320;7.45;0.46;288.65;12.37;1032;70;4236.00;89
11202;69;626509008;11202;253;12231;12320;7.49;0.46;288.66;12.37;1029;70;4237.00;89
11206;69;626509021;11206;257;12238;12324;7.47;0.46;288.68;12.41;1032;70;4238.00;86
11210;69;626509033;11210;258;12239;12325;7.39;0.45;288.73;12.41;1029;70;4239.00;86
11212;69;626509055;11212;258;12241;12325;7.36;0.45;288.77;12.43;1029;70;4240.00;84
11215;69;626509074;11215;262;12244;12326;7.26;0.44;288.82;12.44;1029;70;4241.00;82
11220;69;626509093;11220;264;12244;12326;7.11;0.43;288.86;12.44;1024;70;4242.00;82
11223;69;626509114;11223;279;12246;12326;7.02;0.43;288.84;12.45;1023;70;4243.00;80
11229;69;626509133;11229;285;12247;12326;6.93;0.42;288.90;12.46;1018;70;4244.00;79
11232;69;626509152;11232;284;12248;12326;6.88;0.42;288.95;12.47;1016;70;4245.00;78
11236;69;626509169;11236;293;12250;12326;6.86;0.42;288.91;12.47;1014;70;4246.00;76
11244;69;626509183;11244;296;12251;12326;6.72;0.41;288.88;12.48;1007;70;4247.00;75
11248;69;626509197;11248;315;12286;12396;6.68;0.41;288.89;12.45;1038;70;4248.00;110
11251;69;626509216;11251;319;12291;12397;6.54;0.40;288.92;12.46;1040;70;4249.00;106
11253;69;626509229;11253;308;12296;12397;6.49;0.40;288.95;12.45;1043;70;4250.00;101
11259;69;626509242;11259;302;12300;12397;6.41;0.39;288.96;12.47;1041;70;4251.00;97
11262;69;626509255;11262;309;12305;12397;6.38;0.39;289.01;12.47;1043;70;4252.00;92
11266;69;626509268;11266;304;12307;12397;6.35;0.39;289.08;12.47;1041;70;4253.00;90
11270;69;626509281;11270;304;12313;12397;6.31;0.39;289.18;12.48;1043;70;4254.00;84
11273;69;626509294;11273;309;12316;12397;6.31;0.39;289.18;12.49;1043;70;4255.00;81
11277;69;626509307;11277;315;12317;12398;6.30;0.39;289.16;12.49;1040;70;4256.00;81
11281;69;626509320;11281;315;12322;12399;6.32;0.39;289.21;12.50;1041;70;4257.00;77
11284;69;626509333;11284;320;12324;12399;6.39;0.39;289.19;12.50;1040;70;4258.00;75
11288;69;626509346;11288;318;12329;12403;6.37;0.39;289.24;12.50;1041;70;4259.00;74
11292;69;626509361;11292;324;12330;12403;6.39;0.39;289.38;12.50;1038;70;4260.00;73
11295;69;626509374;11295;324;12331;12403;6.35;0.39;289.42;12.50;1036;70;4261.00;72
11300;69;626509386;11300;329;12332;12403;6.33;0.39;289.50;12.50;1032;70;4262.00;71
11303;69;626509399;11303;333;12335;12409;6.34;0.39;289.53;12.50;1032;70;4263.00;74
11306;69;626509413;11306;343;12336;12409;6.34;0.39;289.58;12.50;1030;70;4264.00;73
11308;69;626509425;11308;329;12337;12409;6.38;0.39;289.58;12.50;1029;70;4265.00;72
11314;69;626509438;11314;323;12339;12412;6.38;0.39;289.59;12.50;1025;70;4266.00;73
11318;69;626509451;11318;325;12340;12412;6.35;0.39;289.63;12.50;1022;70;4267.00;72
11321;69;626509463;11321;323;12341;12412;6.37;0.39;289.61;12.51;1020;70;4268.00;71
11325;69;626509477;11325;325;12341;12413;6.32;0.39;289.62;12.51;1016;70;4269.00;72
11330;69;626509490;11330;323;12343;12414;6.26;0.38;289.67;12.51;1013;70;4270.00;71
11335;69;626509502;11335;325;12343;12414;6.22;0.38;289.65;12.51;1008;70;4271.00;71
11341;69;626509520;11341;332;12356;12427;6.24;0.38;289.68;12.50;1015;70;4272.00;71
11345;69;626509533;11345;333;12356;12427;6.23;0.38;289.65;12.50;1011;70;4273.00;71
11346;69;626509546;11346;331;12357;12427;6.28;0.38;289.66;12.50;1011;70;4274.00;70
11354;69;626509558;11354;332;12361;12429;6.25;0.38;289.70;12.50;1007;70;4275.00;68
11356;69;626509572;11356;337;12361;12429;6.24;0.38;289.71;12.50;1005;70;4276.00;68
11362;70;626509584;11362;338;12364;12433;6.20;0.38;289.74;12.50;1002;71;4277.00;69
11366;70;626509618;11366;340;12365;12433;6.20;0.38;289.77;12.50;999;71;4278.00;68
11368;70;626509632;11368;345;12368;12437;6.26;0.38;289.79;12.50;1000;71;4279.00;69
11371;70;626509645;11371;351;12369;12437;6.29;0.38;289.84;12.50;998;71;4280.00;68
11376;70;626509664;11376;358;12370;12437;6.33;0.39;290.00;12.50;994;71;4281.00;67
11379;70;626509676;11379;366;12370;12437;6.35;0.39;290.02;12.50;991;71;4282.00;67
11384;70;626509694;11384;365;12371;12437;6.34;0.39;290.08;12.50;987;71;4283.00;66
11387;70;626509707;11387;374;12381;12449;6.39;0.39;290.09;12.49;994;71;4284.00;68
11391;70;626509720;11391;380;12382;12449;6.38;0.39;290.10;12.49;991;71;4285.00;67
11396;70;626509733;11396;389;12383;12449;6.33;0.39;290.18;12.49;987;71;4286.00;66
11399;70;626509745;11399;393;12383;12449;6.26;0.38;290.24;12.49;984;71;4287.00;66
11402;70;626509770;11402;406;12384;12449;6.25;0.38;290.30;12.48;982;71;4288.00;65
11403;70;626509783;11403;408;12384;12449;6.25;0.38;290.29;12.48;981;71;4289.00;65
11407;70;626509796;11407;406;12384;12450;6.18;0.38;290.28;12.48;977;71;4290.00;66
11410;70;626509809;11410;412;12384;12450;6.15;0.37;290.25;12.48;974;71;4291.00;66
11412;70;626509822;11412;421;12388;12456;6.12;0.37;290.24;12.48;976;71;4292.00;68
11415;70;626509834;11415;430;12390;12457;6.10;0.37;290.21;12.48;975;71;4293.00;67
11419;70;626509848;11419;432;12390;12457;6.00;0.36;290.18;12.48;971;71;4294.00;67
11420;70;626509861;11420;436;12390;12457;5.92;0.36;290.16;12.48;970;71;4295.00;67
11422;70;626509875;11422;445;12393;12461;5.85;0.36;290.13;12.48;971;71;4296.00;68
11423;70;626509889;11423;438;12393;12461;5.80;0.35;290.14;12.48;970;71;4297.00;68
11425;70;626509902;11425;429;12393;12461;5.71;0.35;290.15;12.48;968;71;4298.00;68
11427;70;626509915;11427;432;12394;12462;5.70;0.35;290.13;12.48;967;71;4299.00;68
11431;70;626509930;11431;428;12397;12466;5.73;0.35;290.09;12.47;966;71;4300.00;69
11432;70;626509949;11432;433;12397;12466;5.71;0.35;290.14;12.47;965;71;4301.00;69
11436;70;626509962;11436;436;12399;12469;5.75;0.35;290.11;12.47;963;71;4302.00;70
11439;70;626509975;11439;437;12399;12469;5.75;0.35;290.09;12.47;960;71;4303.00;70
11441;70;626509987;11441;436;12401;12469;5.80;0.35;290.05;12.53;960;71;4304.00;68
11445;70;626510001;11445;435;12401;12469;5.78;0.35;289.99;12.53;956;71;4305.00;68
11447;70;626510012;11447;419;12404;12473;5.83;0.36;289.96;12.52;957;71;4306.00;69
11449;70;626510032;11449;404;12404;12473;5.89;0.36;289.93;12.52;955;71;4307.00;69
11452;70;626510045;11452;389;12405;12473;5.94;0.36;289.94;12.52;953;71;4308.00;68
11453;70;626510058;11453;375;12405;12473;5.98;0.36;289.93;12.52;952;71;4309.00;68
11453;70;626510071;11453;365;12405;12474;6.07;0.37;289.93;12.52;952;71;4310.00;69
11456;70;626510083;11456;355;12406;12475;6.14;0.37;289.96;12.52;950;71;4311.00;69
11456;70;626510096;11456;344;12406;12475;6.19;0.38;289.96;12.52;950;71;4312.00;69
11457;70;626510109;11457;339;12407;12476;6.23;0.38;289.94;12.52;950;71;4313.00;69
11459;71;626510123;11459;338;12407;12476;6.19;0.38;289.92;12.52;948;72;4314.00;69
11460;71;626510152;11460;338;12407;12476;6.24;0.38;289.91;12.52;947;72;4315.00;69
11461;71;626510164;11461;337;12407;12476;6.33;0.38;289.93;12.52;946;72;4316.00;69
11463;71;626510175;11463;327;12407;12476;6.35;0.38;289.90;12.52;944;72;4317.00;69
11463;71;626510187;11463;330;12407;12476;6.33;0.38;289.90;12.52;944;72;4318.00;69
11466;71;626510198;11466;325;12407;12476;6.29;0.38;289.90;12.52;941;72;4319.00;69
11466;71;626510212;11466;372;12517;12706;6.52;0.41;289.90;12.41;1051;72;4320.00;189
11466;71;626510241;11466;363;12520;12707;6.57;0.41;289.90;12.41;1054;72;4321.00;187
11468;71;626510254;11468;350;12529;12707;6.65;0.41;289.90;12.40;1061;72;4322.00;178
11469;71;626510266;11469;336;12534;12707;6.69;0.42;289.91;12.40;1065;72;4323.00;173
11471;71;626510278;11471;332;12542;12707;6.69;0.42;289.89;12.39;1071;72;4324.00;165
11473;71;626510291;11473;326;12545;12707;6.58;0.41;289.95;12.39;1072;72;4325.00;162
11474;71;626510303;11474;320;12549;12707;6.57;0.41;289.97;12.39;1075;72;4326.00;158
11474;71;626510316;11474;309;12552;12707;6.55;0.41;289.97;12.39;1078;72;4327.00;155
11476;71;626510328;11476;313;12555;12708;6.53;0.41;289.95;12.38;1079;72;4328.00;153
11477;71;626510341;11477;313;12559;12709;6.51;0.40;289.94;12.38;1082;72;4329.00;150
11478;71;626510353;11478;310;12563;12709;6.49;0.40;289.94;12.38;1085;72;4330.00;146
11479;71;626510366;11479;311;12568;12710;6.44;0.40;289.95;12.38;1089;72;4331.00;142
11480;71;626510384;11480;310;12571;12710;6.41;0.40;289.95;12.38;1091;72;4332.00;139
11481;71;626510397;11481;316;12574;12710;6.34;0.39;289.95;12.38;1093;72;4333.00;136
11482;71;626510410;11482;316;12577;12710;6.32;0.39;289.94;12.38;1095;72;4334.00;133
11484;71;626510423;11484;317;12581;12714;6.29;0.39;289.93;12.38;1097;72;4335.00;133
11485;71;626510437;11485;322;12583;12714;6.27;0.39;289.92;12.38;1098;72;4336.00;131
11487;71;626510455;11487;331;12586;12714;6.28;0.39;289.94;12.38;1099;72;4337.00;128
11488;71;626510469;11488;333;12587;12717;6.28;0.39;289.93;12.38;1099;72;4338.00;130
11488;71;626510483;11488;342;12591;12717;6.30;0.39;289.93;12.38;1103;72;4339.00;126
11490;71;626510495;11490;341;12594;12717;6.28;0.39;289.93;12.39;1104;72;4340.00;123
11490;71;626510509;11490;350;12597;12721;6.22;0.38;289.93;12.38;1107;72;4341.00;124
11493;71;626510522;11493;349;12599;12722;6.16;0.38;289.93;12.44;1106;72;4342.00;123
11495;71;626510536;11495;353;12601;12722;6.18;0.38;289.93;12.44;1106;72;4343.00;121
11498;71;626510548;11498;347;12603;12726;6.21;0.38;289.96;12.44;1105;72;4344.00;123
11503;71;626510562;11503;347;12604;12726;6.18;0.38;289.97;12.44;1101;72;4345.00;122
11504;71;626510574;11504;341;12604;12726;6.18;0.38;289.94;12.44;1100;72;4346.00;122
11507;71;626510587;11507;346;12606;12727;6.17;0.38;289.95;12.44;1099;72;4347.00;121
11509;71;626510605;11509;346;12606;12727;6.18;0.38;289.97;12.44;1097;72;4348.00;121
11514;71;626510618;11514;336;12609;12733;6.13;0.37;290.02;12.44;1095;72;4349.00;124
11517;71;626510632;11517;328;12610;12733;6.09;0.37;290.09;12.50;1093;72;4350.00;123
11520;71;626510646;11520;316;12611;12734;6.03;0.37;290.09;12.50;1091;72;4351.00;123
11523;71;626510658;11523;303;12611;12734;6.02;0.37;290.07;12.50;1088;72;4352.00;123
11525;71;626510670;11525;301;12614;12734;5.99;0.36;290.11;12.50;1089;72;4353.00;120
11526;71;626510682;11526;291;12614;12734;5.95;0.36;290.14;12.50;1088;72;4354.00;120
11530;71;626510695;11530;293;12616;12734;5.92;0.36;290.17;12.51;1086;72;4355.00;118
11533;71;626510709;11533;286;12626;12746;6.01;0.37;290.18;12.52;1093;72;4356.00;120
11538;71;626510722;11538;277;12627;12746;6.04;0.37;290.19;12.52;1089;72;4357.00;119
11540;71;626510734;11540;270;12629;12746;6.11;0.37;290.17;12.51;1089;72;4358.00;117
11543;71;626510748;11543;264;12630;12746;6.17;0.37;290.21;12.57;1087;72;4359.00;116
11545;71;626510762;11545;256;12630;12746;6.26;0.38;290.19;12.57;1085;72;4360.00;116
11545;71;626510784;11545;254;12630;12746;6.34;0.39;290.19;12.57;1085;72;4361.00;116
11546;71;626510798;11546;251;12635;12750;6.39;0.39;290.17;12.63;1089;72;4362.00;115
11549;71;626510812;11549;253;12635;12750;6.47;0.39;290.19;12.63;1086;72;4363.00;115
11550;71;626510825;11550;247;12637;12754;6.59;0.40;290.22;12.63;1087;72;4364.00;117
11554;71;626510839;11554;251;12642;12756;6.64;0.40;290.21;12.68;1088;72;4365.00;114
11557;71;626510852;11557;251;12642;12756;6.66;0.41;290.24;12.68;1085;72;4366.00;114
11561;71;626510866;11561;249;12643;12756;6.66;0.41;290.26;12.68;1082;72;4367.00;113
11566;71;626510880;11566;246;12652;12769;6.67;0.40;290.32;12.67;1086;72;4368.00;117
11569;71;626510897;11569;248;12653;12769;6.72;0.41;290.31;12.72;1084;72;4369.00;116
11571;71;626510913;11571;245;12654;12769;6.82;0.41;290.37;12.72;1083;72;4370.00;115
11574;71;626510928;11574;242;12655;12770;6.94;0.42;290.45;12.72;1081;72;4371.00;115
11577;71;626510943;11577;249;12655;12771;7.02;0.43;290.46;12.72;1078;72;4372.00;116
11579;71;626510957;11579;250;12656;12771;7.09;0.43;290.49;12.73;1077;72;4373.00;115
11583;71;626510972;11583;259;12658;12774;7.14;0.43;290.56;12.72;1075;72;4374.00;116
11586;71;626510987;11586;252;12658;12774;7.23;0.44;290.60;12.72;1072;72;4375.00;116
11588;71;626511001;11588;258;12660;12774;7.28;0.44;290.64;12.73;1072;72;4376.00;114
11592;71;626511016;11592;260;12660;12774;7.32;0.44;290.69;12.73;1068;72;4377.00;114
11596;71;626511030;11596;264;12664;12780;7.40;0.45;290.69;12.72;1068;72;4378.00;116
11599;71;626511046;11599;264;12665;12780;7.39;0.45;290.72;12.73;1066;72;4379.00;115
11602;71;626511066;11602;254;12667;12780;7.44;0.45;290.79;12.74;1065;72;4380.00;113
11603;71;626511094;11603;248;12669;12780;7.45;0.45;290.82;12.76;1066;72;4381.00;111
11606;71;626511118;11606;253;12672;12784;7.44;0.45;290.88;12.75;1066;72;4382.00;112
11608;71;626511143;11608;244;12675;12785;7.43;0.45;290.87;12.77;1067;72;4383.00;110
11611;71;626511163;11611;247;12675;12785;7.42;0.45;290.88;12.77;1064;72;4384.00;110
11613;71;626511180;11613;247;12679;12786;7.44;0.45;290.92;12.80;1066;72;4385.00;107
11618;71;626511196;11618;249;12679;12786;7.43;0.45;291.06;12.80;1061;72;4386.00;107
11619;71;626511212;11619;248;12681;12786;7.56;0.46;291.04;12.83;1062;72;4387.00;105
11624;71;626511227;11624;249;12683;12786;7.56;0.46;291.10;12.84;1059;72;4388.00;103
11626;71;626511244;11626;247;12684;12786;7.57;0.46;291.16;12.85;1058;72;4389.00;102
11630;71;626511264;11630;248;12686;12786;7.56;0.46;291.20;12.87;1056;72;4390.00;100
11633;71;626511292;11633;257;12689;12786;7.49;0.46;291.21;12.89;1056;72;4391.00;97
11637;71;626511308;11637;266;12724;12856;7.56;0.46;291.27;12.87;1087;72;4392.00;132
11637;71;626511331;11637;266;12728;12857;7.50;0.46;291.27;12.88;1091;72;4393.00;129
11639;71;626511346;11639;262;12738;12857;7.46;0.46;291.34;12.88;1099;72;4394.00;119
11641;71;626511360;11641;263;12739;12857;7.39;0.45;291.35;12.90;1098;72;4395.00;118
11645;71;626511374;11645;262;12747;12857;7.31;0.45;291.43;12.91;1102;72;4396.00;110
11647;71;626511389;11647;268;12750;12857;7.26;0.44;291.47;12.92;1103;72;4397.00;107
11652;71;626511404;11652;277;12755;12857;7.21;0.44;291.52;12.93;1103;72;4398.00;102
11654;71;626511419;11654;277;12758;12857;7.22;0.44;291.57;12.94;1104;72;4399.00;99
11656;71;626511437;11656;281;12762;12858;7.27;0.44;291.56;12.95;1106;72;4400.00;96
11659;71;626511459;11659;278;12768;12859;7.21;0.44;291.62;12.96;1109;72;4401.00;91
11661;71;626511475;11661;276;12769;12859;7.15;0.44;291.61;12.96;1108;72;4402.00;90
11663;71;626511490;11663;278;12772;12863;7.08;0.43;291.62;12.96;1109;72;4403.00;91
11665;71;626511514;11665;285;12773;12863;7.04;0.43;291.64;12.98;1108;72;4404.00;90
11669;71;626511531;11669;292;12776;12863;6.98;0.42;291.67;12.98;1107;72;4405.00;87
11670;71;626511547;11670;296;12777;12863;7.02;0.43;291.67;12.99;1107;72;4406.00;86
11672;71;626511563;11672;303;12783;12869;7.07;0.43;291.72;12.99;1111;72;4407.00;86
11674;71;626511582;11674;299;12783;12869;7.06;0.43;291.72;12.99;1109;72;4408.00;86
11677;71;626511600;11677;298;12785;12869;7.05;0.43;291.75;13.01;1108;72;4409.00;84
11680;71;626511618;11680;306;12790;12875;7.03;0.43;291.80;13.00;1110;72;4410.00;85
11685;71;626511635;11685;305;12792;12875;6.96;0.42;291.79;13.01;1107;72;4411.00;83
11687;71;626511652;11687;311;12795;12875;6.89;0.42;291.87;13.03;1108;72;4412.00;80
11691;71;626511668;11691;316;12796;12876;6.74;0.41;291.90;13.04;1105;72;4413.00;80
11694;71;626511685;11694;316;12797;12877;6.61;0.40;291.94;13.04;1103;72;4414.00;80
11698;71;626511700;11698;323;12798;12877;6.48;0.40;291.92;13.04;1100;72;4415.00;79
11704;71;626511716;11704;333;12810;12890;6.32;0.39;292.01;13.04;1106;72;4416.00;80
11709;71;626511732;11709;330;12811;12890;6.15;0.37;292.02;13.04;1102;72;4417.00;79
11714;71;626511746;11714;334;12812;12890;5.99;0.36;292.08;13.04;1098;72;4418.00;78
11720;71;626511760;11720;335;12813;12891;5.84;0.35;292.11;13.04;1093;72;4419.00;78
11722;71;626511774;11722;334;12814;12891;5.80;0.35;292.10;13.05;1092;72;4420.00;77
11725;71;626511789;11725;330;12818;12895;5.74;0.35;292.15;13.04;1093;72;4421.00;77
11730;71;626511805;11730;331;12819;12895;5.71;0.35;292.17;13.05;1089;72;4422.00;76
11732;71;626511821;11732;333;12822;12899;5.77;0.35;292.19;13.05;1090;72;4423.00;77
11735;71;626511837;11735;340;12823;12899;5.84;0.36;292.17;13.05;1088;72;4424.00;76
11738;71;626511853;11738;349;12825;12899;5.84;0.36;292.21;13.06;1087;72;4425.00;74
11741;71;626511868;11741;352;12825;12899;5.86;0.36;292.27;13.06;1084;72;4426.00;74
11742;71;626511882;11742;349;12826;12899;5.90;0.36;292.28;13.06;1084;72;4427.00;73
11746;71;626511897;11746;347;12839;12911;5.95;0.36;292.39;13.05;1093;72;4428.00;72
11748;71;626511912;11748;340;12839;12911;6.00;0.37;292.40;13.05;1091;72;4429.00;72
11750;71;626511927;11750;338;12839;12911;6.00;0.37;292.45;13.05;1089;72;4430.00;72
11755;71;626511940;11755;339;12839;12911;5.99;0.37;292.48;13.05;1084;72;4431.00;72
11757;71;626511955;11757;338;12839;12911;6.10;0.38;292.49;13.05;1082;72;4432.00;72
11758;71;626511970;11758;332;12839;12911;6.22;0.38;292.48;13.05;1081;72;4433.00;72
11761;71;626511984;11761;335;12839;12912;6.26;0.39;292.48;13.05;1078;72;4434.00;73
11766;71;626511998;11766;334;12839;12912;6.29;0.39;292.47;13.05;1073;72;4435.00;73
11770;71;626512012;11770;337;12843;12918;6.31;0.39;292.48;13.05;1073;72;4436.00;75
11774;71;626512028;11774;342;12844;12919;6.30;0.39;292.53;13.05;1070;72;4437.00;75
11778;71;626512053;11778;350;12845;12919;6.32;0.39;292.56;13.05;1067;72;4438.00;74
11782;71;626512069;11782;347;12845;12919;6.30;0.39;292.61;13.05;1063;72;4439.00;74
11787;71;626512087;11787;346;12849;12924;6.30;0.39;292.66;13.04;1062;72;4440.00;75
11793;71;626512105;11793;359;12849;12924;6.24;0.38;292.62;13.04;1056;72;4441.00;75
11800;71;626512119;11800;367;12849;12924;6.20;0.38;292.61;13.04;1049;72;4442.00;75
11800;71;626512133;11800;366;12850;12925;6.23;0.38;292.61;13.04;1050;72;4443.00;75
11805;71;626512146;11805;364;12853;12929;6.25;0.38;292.58;13.04;1048;72;4444.00;76
11808;71;626512161;11808;359;12853;12929;6.27;0.38;292.57;13.04;1045;72;4445.00;76
11811;71;626512176;11811;365;12855;12932;6.28;0.39;292.55;13.04;1044;72;4446.00;77
11815;71;626512190;11815;371;12855;12932;6.22;0.38;292.52;13.04;1040;72;4447.00;77
11817;71;626512211;11817;380;12856;12932;6.19;0.38;292.54;13.03;1039;72;4448.00;76
11822;71;626512225;11822;387;12856;12932;6.09;0.37;292.48;13.03;1034;72;4449.00;76
11830;71;626512241;11830;388;12859;12936;6.01;0.37;292.41;13.03;1029;72;4450.00;77
11831;71;626512257;11831;390;12859;12936;6.02;0.37;292.45;13.03;1028;72;4451.00;77
11838;71;626512270;11838;387;12860;12936;5.99;0.37;292.36;13.03;1022;72;4452.00;76
11843;71;626512286;11843;398;12860;12936;5.96;0.36;292.37;13.03;1017;72;4453.00;76
11849;71;626512299;11849;394;12861;12937;5.90;0.36;292.33;13.09;1012;72;4454.00;76
11854;71;626512314;11854;402;12863;12939;5.93;0.36;292.29;13.08;1009;72;4455.00;76
11858;71;626512327;11858;402;12863;12939;5.86;0.36;292.29;13.08;1005;72;4456.00;76
11861;71;626512340;11861;405;12864;12940;5.84;0.36;292.25;13.08;1003;72;4457.00;76
11867;71;626512354;11867;413;12864;12940;5.77;0.35;292.21;13.08;997;72;4458.00;76
11870;71;626512366;11870;417;12864;12940;5.68;0.35;292.17;13.08;994;72;4459.00;76
11870;71;626512379;11870;419;12864;12940;5.70;0.35;292.17;13.08;994;72;4460.00;76
11873;71;626512394;11873;424;12864;12940;5.70;0.35;292.21;13.08;991;72;4461.00;76
11874;71;626512407;11874;433;12864;12940;5.70;0.35;292.19;13.08;990;72;4462.00;76
11877;71;626512420;11877;436;12864;12940;5.65;0.35;292.17;13.08;987;72;4463.00;76
11879;71;626512432;11879;449;12929;13067;6.06;0.38;292.24;13.02;1050;72;4464.00;138
11883;71;626512455;11883;446;12932;13068;6.00;0.37;292.19;13.01;1049;72;4465.00;136
11884;71;626512469;11884;453;12941;13068;6.04;0.37;292.19;13.01;1057;72;4466.00;127
11886;71;626512481;11886;450;12944;13068;6.00;0.37;292.17;13.00;1058;72;4467.00;124
11887;71;626512495;11887;440;12950;13068;6.00;0.37;292.14;13.00;1063;72;4468.00;118
11888;71;626512509;11888;433;12952;13068;5.97;0.37;292.14;13.00;1064;72;4469.00;116
11889;71;626512524;11889;435;12958;13068;5.97;0.37;292.14;13.00;1069;72;4470.00;110
11889;71;626512538;11889;432;12958;13068;5.89;0.36;292.14;13.00;1069;72;4471.00;110
11890;71;626512552;11890;437;12964;13069;5.92;0.37;292.14;12.99;1074;72;4472.00;105
11892;71;626512566;11892;437;12967;13070;5.90;0.36;292.12;12.99;1075;72;4473.00;103
11893;71;626512580;11893;443;12972;13070;5.92;0.37;292.12;12.99;1079;72;4474.00;98
11894;71;626512603;11894;440;12974;13071;5.90;0.36;292.11;12.99;1080;72;4475.00;97
11895;71;626512618;11895;416;12977;13071;5.93;0.37;292.12;12.99;1082;72;4476.00;94
11896;71;626512633;11896;414;12979;13071;5.97;0.37;292.13;13.04;1083;72;4477.00;92
11896;71;626512649;11896;393;12980;13071;6.17;0.38;292.13;13.04;1084;72;4478.00;91
11898;71;626512665;11898;378;12984;13075;6.34;0.39;292.10;13.04;1086;72;4479.00;91
11900;71;626512684;11900;366;12985;13075;6.42;0.40;292.10;13.04;1085;72;4480.00;90
11903;71;626512701;11903;354;12986;13075;6.53;0.40;292.08;13.04;1083;72;4481.00;89
11905;71;626512722;11905;339;12989;13078;6.64;0.41;292.07;13.04;1084;72;4482.00;89
11905;71;626512740;11905;342;12989;13078;6.76;0.41;292.07;13.04;1084;72;4483.00;89
11907;71;626512758;11907;333;12990;13078;6.87;0.42;292.07;13.04;1083;72;4484.00;88
11909;71;626512777;11909;332;12993;13082;6.93;0.42;292.05;13.04;1084;72;4485.00;89
11911;71;626512795;11911;327;12995;13083;7.00;0.43;292.02;13.03;1084;72;4486.00;88
11914;71;626512819;11914;314;12995;13083;7.05;0.43;291.98;13.03;1081;72;4487.00;88
11915;71;626512835;11915;307;12999;13087;7.15;0.44;291.98;13.03;1084;72;4488.00;88
11917;71;626512851;11917;305;12999;13087;7.18;0.44;291.96;13.03;1082;72;4489.00;88
11919;71;626512867;11919;303;12999;13087;7.14;0.43;291.93;13.03;1080;72;4490.00;88
11921;71;626512882;11921;296;13000;13088;7.19;0.44;291.92;13.03;1079;72;4491.00;88
11922;71;626512897;11922;287;13000;13088;7.22;0.44;291.92;13.03;1078;72;4492.00;88
11925;71;626512912;11925;286;13004;13094;7.25;0.44;291.89;13.03;1079;72;4493.00;90
11928;71;626512928;11928;287;13004;13094;7.27;0.44;291.85;13.03;1076;72;4494.00;90
11931;71;626512948;11931;284;13005;13095;7.32;0.44;291.87;13.03;1074;72;4495.00;90
11931;71;626512964;11931;286;13005;13095;7.39;0.45;291.87;13.03;1074;72;4496.00;90
11935;71;626512979;11935;285;13005;13095;7.44;0.45;292.00;13.03;1070;72;4497.00;90
11937;71;626512994;11937;285;13005;13095;7.42;0.45;292.00;13.03;1068;72;4498.00;90
11939;71;626513008;11939;286;13005;13095;7.40;0.45;292.03;13.03;1066;72;4499.00;90
11942;71;626513026;11942;289;13026;13145;7.42;0.45;292.06;13.00;1084;72;4500.00;119
11945;71;626513053;11945;292;13026;13147;7.41;0.45;292.15;13.00;1081;72;4501.00;121
11947;71;626513085;11947;299;13028;13147;7.40;0.45;292.16;13.00;1081;72;4502.00;119
11951;71;626513110;11951;301;13029;13147;7.36;0.45;292.27;13.00;1078;72;4503.00;118
11954;71;626513135;11954;299;13032;13147;7.33;0.45;292.31;13.00;1078;72;4504.00;115
11957;71;626513155;11957;305;13032;13147;7.31;0.45;292.39;13.00;1075;72;4505.00;115
11958;71;626513176;11958;298;13037;13151;7.33;0.45;292.41;13.00;1079;72;4506.00;114
11961;71;626513194;11961;300;13037;13151;7.34;0.45;292.45;13.00;1076;72;4507.00;114
11963;71;626513212;11963;300;13041;13155;7.33;0.45;292.47;12.99;1078;72;4508.00;114
11969;71;626513230;11969;301;13043;13156;7.24;0.44;292.52;12.99;1074;72;4509.00;113
11972;71;626513250;11972;294;13044;13156;7.12;0.43;292.55;12.99;1072;72;4510.00;112
11976;71;626513269;11976;291;13045;13156;7.06;0.43;292.58;12.99;1069;72;4511.00;111
11978;71;626513287;11978;285;13052;13169;6.97;0.43;292.63;12.98;1074;72;4512.00;117
11980;71;626513308;11980;285;13053;13169;6.93;0.42;292.64;13.04;1073;72;4513.00;116
11982;71;626513333;11982;285;13053;13169;6.92;0.42;292.71;13.04;1071;72;4514.00;116
11984;71;626513350;11984;286;13055;13170;6.91;0.42;292.76;13.04;1071;72;4515.00;115
11986;71;626513366;11986;286;13056;13171;6.91;0.42;292.77;13.04;1070;72;4516.00;115
11993;71;626513380;11993;279;13056;13171;6.89;0.42;292.84;13.04;1063;72;4517.00;115
11996;71;626513397;11996;280;13058;13174;6.91;0.42;292.85;13.04;1062;72;4518.00;116
12001;71;626513413;12001;272;13058;13174;6.86;0.42;292.92;13.04;1057;72;4519.00;116
12003;71;626513434;12003;266;13058;13174;6.87;0.42;292.92;13.04;1055;72;4520.00;116
12007;71;626513449;12007;257;13060;13174;6.84;0.42;292.99;13.04;1053;72;4521.00;114
12010;71;626513465;12010;248;13063;13180;6.85;0.42;292.96;13.04;1053;72;4522.00;117
12015;71;626513481;12015;250;13063;13180;6.80;0.41;293.04;13.04;1048;72;4523.00;117
12017;71;626513497;12017;244;13064;13180;6.81;0.41;293.10;13.09;1047;72;4524.00;116
12019;71;626513512;12019;240;13065;13180;6.82;0.42;293.13;13.10;1046;72;4525.00;115
12022;71;626513529;12022;237;13068;13184;6.74;0.41;293.16;13.10;1046;72;4526.00;116
12025;71;626513544;12025;238;13071;13185;6.70;0.41;293.16;13.10;1046;72;4527.00;114
12028;71;626513560;12028;234;13071;13185;6.70;0.41;293.16;13.10;1043;72;4528.00;114
12032;71;626513576;12032;229;13072;13186;6.76;0.41;293.15;13.10;1040;72;4529.00;114
12034;71;626513594;12034;228;13073;13186;6.82;0.41;293.20;13.11;1039;72;4530.00;113
12037;71;626513610;12037;228;13073;13186;6.82;0.42;293.17;13.11;1036;72;4531.00;113
12039;72;626513626;12039;225;13074;13186;6.82;0.42;293.14;13.11;1035;73;4532.00;112
12042;72;626513648;12042;223;13075;13186;6.90;0.42;293.11;13.11;1033;73;4533.00;111
12046;72;626513668;12046;221;13075;13186;6.97;0.42;293.13;13.11;1029;73;4534.00;111
12047;72;626513685;12047;226;13075;13186;7.07;0.43;293.11;13.11;1028;73;4535.00;111
12051;72;626513701;12051;228;13113;13256;7.19;0.44;293.11;13.13;1062;73;4536.00;143
12055;72;626513724;12055;221;13115;13257;7.19;0.44;293.12;13.13;1060;73;4537.00;142
12056;72;626513741;12056;224;13119;13257;7.21;0.44;293.15;13.13;1063;73;4538.00;138
12060;72;626513756;12060;227;13123;13257;7.16;0.44;293.19;13.13;1063;73;4539.00;134
12062;72;626513772;12062;227;13129;13257;7.20;0.44;293.16;13.13;1067;73;4540.00;128
12067;72;626513788;12067;228;13133;13257;7.25;0.44;293.22;13.13;1066;73;4541.00;124
12071;72;626513813;12071;226;13135;13257;7.28;0.44;293.27;13.13;1064;73;4542.00;122
12072;72;626513829;12072;228;13138;13257;7.33;0.45;293.27;13.13;1066;73;4543.00;119
12077;72;626513847;12077;234;13142;13258;7.36;0.45;293.28;13.13;1065;73;4544.00;116
12079;72;626513865;12079;231;13147;13260;7.47;0.45;293.27;13.13;1068;73;4545.00;113
12080;72;626513881;12080;240;13150;13260;7.50;0.46;293.31;13.14;1070;73;4546.00;110
12082;72;626513902;12082;243;13155;13264;7.50;0.45;293.29;13.13;1073;73;4547.00;109
12086;72;626513920;12086;241;13155;13264;7.47;0.45;293.33;13.13;1069;73;4548.00;109
12090;72;626513938;12090;243;13156;13264;7.40;0.45;293.39;13.14;1066;73;4549.00;108
12091;72;626513956;12091;247;13157;13264;7.34;0.45;293.41;13.15;1066;73;4550.00;107
12094;72;626513975;12094;249;13162;13270;7.44;0.45;293.41;13.16;1068;73;4551.00;108
12096;72;626513994;12096;250;13165;13270;7.46;0.45;293.42;13.18;1069;73;4552.00;105
12098;72;626514012;12098;251;13166;13270;7.45;0.45;293.47;13.18;1068;73;4553.00;104
12101;72;626514030;12101;252;13171;13273;7.42;0.45;293.50;13.20;1070;73;4554.00;102
12102;72;626514067;12102;250;13173;13273;7.41;0.45;293.53;13.20;1071;73;4555.00;100
12104;72;626514085;12104;260;13174;13273;7.39;0.45;293.59;13.20;1070;73;4556.00;99
12106;72;626514104;12106;260;13177;13274;7.37;0.45;293.64;13.22;1071;73;4557.00;97
12110;72;626514122;12110;266;13179;13275;7.38;0.45;293.66;13.22;1069;73;4558.00;96
12113;72;626514140;12113;269;13179;13275;7.37;0.45;293.69;13.22;1066;73;4559.00;96
12115;72;626514159;12115;276;13199;13301;7.34;0.45;293.70;13.20;1084;73;4560.00;102
12118;72;626514178;12118;279;13200;13301;7.35;0.45;293.72;13.22;1082;73;4561.00;101
12120;72;626514195;12120;279;13201;13301;7.39;0.45;293.77;13.22;1081;73;4562.00;100
12127;72;626514211;12127;289;13205;13302;7.35;0.45;293.77;13.24;1078;73;4563.00;97
12130;72;626514229;12130;294;13206;13302;7.26;0.44;293.74;13.25;1076;73;4564.00;96
12134;72;626514245;12134;300;13210;13306;7.15;0.44;293.79;13.25;1076;73;4565.00;96
12139;72;626514262;12139;313;13210;13306;7.05;0.43;293.82;13.25;1071;73;4566.00;96
12139;72;626514278;12139;320;13215;13310;6.95;0.42;293.82;13.28;1076;73;4567.00;95
12143;72;626514296;12143;332;13215;13310;6.85;0.42;293.86;13.28;1072;73;4568.00;95
12147;72;626514316;12147;334;13217;13310;6.76;0.41;293.87;13.30;1070;73;4569.00;93
12149;72;626514335;12149;336;13217;13310;6.72;0.41;293.90;13.30;1068;73;4570.00;93
12152;72;626514352;12152;337;13219;13310;6.63;0.40;293.93;13.33;1067;73;4571.00;91
12156;72;626514373;12156;339;13229;13322;6.65;0.40;293.97;13.32;1073;73;4572.00;93
12156;72;626514394;12156;346;13229;13322;6.60;0.40;293.97;13.32;1073;73;4573.00;93
12158;72;626514409;12158;334;13232;13322;6.56;0.40;293.97;13.35;1074;73;4574.00;90
12159;72;626514422;12159;321;13232;13322;6.52;0.40;294.01;13.35;1073;73;4575.00;90
12160;72;626514434;12160;323;13232;13322;6.52;0.40;294.03;13.35;1072;73;4576.00;90
12161;72;626514452;12161;324;13235;13322;6.53;0.40;294.04;13.37;1074;73;4577.00;87
12163;72;626514471;12163;326;13235;13323;6.52;0.40;294.03;13.37;1072;73;4578.00;88
12165;72;626514488;12165;333;13235;13323;6.50;0.40;294.02;13.37;1070;73;4579.00;88
12168;72;626514501;12168;334;13241;13329;6.49;0.39;294.05;13.39;1073;73;4580.00;88
12174;72;626514514;12174;337;13242;13330;6.38;0.39;294.09;13.39;1068;73;4581.00;88
12177;72;626514527;12177;343;13245;13330;6.26;0.38;294.10;13.41;1068;73;4582.00;85
12180;72;626514538;12180;349;13246;13330;6.19;0.38;294.21;13.42;1066;73;4583.00;84
12183;72;626514550;12183;349;13249;13334;6.13;0.38;294.20;13.42;1066;73;4584.00;85
12186;72;626514563;12186;357;13250;13334;6.03;0.37;294.20;13.43;1064;73;4585.00;84
12191;72;626514579;12191;369;13250;13334;5.88;0.36;294.25;13.43;1059;73;4586.00;84
12193;72;626514590;12193;378;13253;13335;5.71;0.35;294.24;13.45;1060;73;4587.00;82
12195;72;626514601;12195;392;13257;13339;5.57;0.34;294.21;13.45;1062;73;4588.00;82
12199;72;626514612;12199;406;13258;13339;5.38;0.33;294.18;13.46;1059;73;4589.00;81
12205;72;626514624;12205;401;13261;13345;5.31;0.33;294.12;13.46;1056;73;4590.00;84
12207;72;626514636;12207;400;13263;13345;5.23;0.32;294.10;13.47;1056;73;4591.00;82
12210;72;626514647;12210;406;13264;13345;5.16;0.32;294.07;13.47;1054;73;4592.00;81
12211;72;626514657;12211;408;13264;13345;5.19;0.32;294.07;13.47;1053;73;4593.00;81
12214;72;626514667;12214;416;13269;13349;5.21;0.32;294.07;13.49;1055;73;4594.00;80
12218;72;626514680;12218;421;13269;13349;5.20;0.32;294.05;13.49;1051;73;4595.00;80
12221;72;626514692;12221;431;13272;13349;5.17;0.32;294.08;13.50;1051;73;4596.00;77
12224;72;626514705;12224;428;13272;13349;5.13;0.31;294.06;13.50;1048;73;4597.00;77
12227;72;626514716;12227;423;13273;13350;5.14;0.31;294.06;13.50;1046;73;4598.00;77
12229;72;626514728;12229;419;13276;13351;5.17;0.32;294.06;13.51;1047;73;4599.00;75
12230;72;626514741;12230;421;13277;13351;5.21;0.32;294.07;13.51;1047;73;4600.00;74
12235;72;626514757;12235;424;13278;13352;5.22;0.32;294.03;13.51;1043;73;4601.00;74
12238;72;626514769;12238;426;13278;13352;5.22;0.32;294.01;13.51;1040;73;4602.00;74
12242;72;626514780;12242;421;13278;13352;5.19;0.32;294.01;13.51;1036;73;4603.00;74
12244;72;626514793;12244;427;13278;13352;5.20;0.32;294.02;13.51;1034;73;4604.00;74
12248;72;626514805;12248;429;13278;13352;5.15;0.32;294.00;13.51;1030;73;4605.00;74
12251;72;626514819;12251;435;13278;13352;5.15;0.32;294.03;13.51;1027;73;4606.00;74
12256;72;626514832;12256;432;13278;13352;5.11;0.31;294.00;13.51;1022;73;4607.00;74
12259;72;626514846;12259;434;13342;13479;5.55;0.35;294.08;13.45;1083;73;4608.00;137
12262;72;626514873;12262;427;13346;13480;5.59;0.35;294.08;13.44;1084;73;4609.00;134
12270;72;626514886;12270;435;13352;13480;5.65;0.35;294.05;13.44;1082;73;4610.00;128
12271;72;626514902;12271;435;13360;13480;5.74;0.36;294.06;13.43;1089;73;4611.00;120
12274;72;626514925;12274;433;13365;13480;5.79;0.36;294.07;13.43;1091;73;4612.00;115
12278;72;626514941;12278;436;13371;13480;5.81;0.36;294.08;13.43;1093;73;4613.00;109
12281;72;626514958;12281;439;13376;13480;5.84;0.36;294.06;13.42;1095;73;4614.00;104
12286;72;626514971;12286;437;13380;13480;5.82;0.36;294.06;13.42;1094;73;4615.00;100
12288;72;626514985;12288;447;13384;13481;5.83;0.36;294.05;13.42;1096;73;4616.00;97
12291;72;626514998;12291;452;13386;13482;5.87;0.36;294.05;13.42;1095;73;4617.00;96
12292;72;626515011;12292;463;13387;13482;5.91;0.37;294.06;13.42;1095;73;4618.00;95
12296;72;626515026;12296;471;13389;13483;5.89;0.37;294.03;13.42;1093;73;4619.00;94
12302;72;626515043;12302;480;13390;13483;5.80;0.36;293.98;13.42;1088;73;4620.00;93
12305;72;626515058;12305;494;13392;13483;5.74;0.36;293.99;13.42;1087;73;4621.00;91
12308;72;626515077;12308;497;13393;13483;5.68;0.35;293.98;13.42;1085;73;4622.00;90
12311;72;626515099;12311;494;13396;13487;5.60;0.35;294.03;13.42;1085;73;4623.00;91
12315;72;626515122;12315;501;13398;13487;5.58;0.35;294.00;13.42;1083;73;4624.00;89
12319;72;626515140;12319;499;13398;13487;5.54;0.34;293.99;13.42;1079;73;4625.00;89
12321;72;626515162;12321;499;13401;13490;5.53;0.34;293.98;13.41;1080;73;4626.00;89
12323;72;626515183;12323;490;13402;13490;5.54;0.34;293.97;13.41;1079;73;4627.00;88
12324;72;626515204;12324;478;13403;13490;5.57;0.34;293.97;13.41;1079;73;4628.00;87
12326;72;626515228;12326;477;13408;13494;5.65;0.35;293.96;13.47;1082;73;4629.00;86
12330;72;626515246;12330;471;13409;13495;5.71;0.35;294.08;13.47;1079;73;4630.00;86
12333;72;626515264;12333;469;13410;13495;5.79;0.36;294.05;13.47;1077;73;4631.00;85
12339;72;626515281;12339;468;13413;13499;5.81;0.36;294.04;13.46;1074;73;4632.00;86
12341;72;626515300;12341;466;13413;13499;5.88;0.36;294.05;13.46;1072;73;4633.00;86
12347;72;626515318;12347;458;13413;13499;5.95;0.36;293.99;13.46;1066;73;4634.00;86
12348;72;626515335;12348;452;13415;13501;6.01;0.37;294.00;13.46;1067;73;4635.00;86
12350;72;626515361;12350;449;13415;13501;6.03;0.37;293.96;13.46;1065;73;4636.00;86
12350;72;626515385;12350;435;13419;13507;6.10;0.37;293.96;13.46;1069;73;4637.00;88
12352;72;626515402;12352;421;13420;13507;6.12;0.37;293.93;13.46;1068;73;4638.00;87
12355;72;626515427;12355;415;13420;13508;6.13;0.37;293.95;13.46;1065;73;4639.00;88
12357;72;626515445;12357;412;13420;13508;6.14;0.38;293.92;13.46;1063;73;4640.00;88
12359;72;626515460;12359;406;13420;13508;6.25;0.38;293.92;13.46;1061;73;4641.00;88
12361;72;626515476;12361;394;13420;13508;6.34;0.39;293.90;13.46;1059;73;4642.00;88
12363;72;626515491;12363;385;13420;13508;6.42;0.39;293.90;13.46;1057;74;4643.00;88
12364;72;626515527;12364;382;13430;13520;6.54;0.40;293.89;13.45;1066;74;4644.00;90
12365;72;626515546;12365;377;13431;13520;6.57;0.40;293.88;13.50;1066;74;4645.00;89
12368;72;626515564;12368;371;13432;13520;6.63;0.40;293.91;13.50;1064;74;4646.00;88
12370;72;626515582;12370;366;13432;13520;6.65;0.40;293.90;13.50;1062;74;4647.00;88
12373;72;626515600;12373;365;13432;13520;6.68;0.41;293.96;13.50;1059;74;4648.00;88
12376;72;626515616;12376;358;13432;13520;6.79;0.41;293.98;13.50;1056;74;4649.00;88
12379;72;626515635;12379;352;13437;13526;6.88;0.42;294.01;13.50;1058;74;4650.00;89
12380;72;626515658;12380;346;13437;13526;6.98;0.42;294.04;13.50;1057;74;4651.00;89
12386;72;626515675;12386;339;13440;13530;7.04;0.43;294.02;13.49;1054;74;4652.00;90
12390;72;626515692;12390;340;13442;13531;7.09;0.43;294.11;13.49;1052;74;4653.00;89
12392;72;626515710;12392;342;13442;13531;7.11;0.43;294.14;13.49;1050;74;4654.00;89
12396;72;626515728;12396;339;13442;13531;7.09;0.43;294.20;13.49;1046;74;4655.00;89
12398;72;626515754;12398;346;13453;13544;7.13;0.43;294.22;13.48;1055;74;4656.00;91
12401;72;626515777;12401;353;13453;13544;7.13;0.43;294.30;13.48;1052;74;4657.00;91
12402;72;626515799;12402;346;13453;13544;7.12;0.43;294.29;13.48;1051;74;4658.00;91
12403;72;626515822;12403;346;13454;13545;7.08;0.43;294.33;13.48;1051;74;4659.00;91
12407;72;626515841;12407;342;13454;13546;7.05;0.43;294.39;13.48;1047;74;4660.00;92
12409;72;626515859;12409;338;13454;13546;7.05;0.43;294.46;13.48;1045;74;4661.00;92
12412;72;626515877;12412;341;13456;13549;7.09;0.43;294.49;13.48;1044;74;4662.00;93
12414;72;626515893;12414;343;13457;13549;7.10;0.43;294.48;13.48;1043;74;4663.00;92
12417;72;626515908;12417;349;13457;13549;7.05;0.43;294.51;13.48;1040;74;4664.00;92
12420;72;626515924;12420;353;13457;13549;7.03;0.43;294.52;13.48;1037;74;4665.00;92
12423;72;626515938;12423;359;13461;13555;7.04;0.43;294.50;13.47;1038;74;4666.00;94
12426;72;626515955;12426;362;13461;13555;7.05;0.43;294.55;13.47;1035;74;4667.00;94
12428;72;626515973;12428;367;13462;13555;7.04;0.43;294.53;13.47;1034;74;4668.00;93
12434;72;626515989;12434;365;13462;13555;6.99;0.42;294.60;13.47;1028;74;4669.00;93
12436;72;626516005;12436;372;13465;13559;6.93;0.42;294.63;13.47;1029;74;4670.00;94
12441;72;626516021;12441;370;13466;13560;6.87;0.42;294.63;13.47;1025;74;4671.00;94
12443;72;626516040;12443;371;13466;13560;6.82;0.41;294.64;13.47;1023;74;4672.00;94
12447;72;626516060;12447;373;13467;13561;6.76;0.41;294.67;13.47;1020;74;4673.00;94
12450;72;626516078;12450;367;13467;13561;6.72;0.41;294.70;13.47;1017;74;4674.00;94
12452;72;626516094;12452;369;13467;13561;6.64;0.40;294.75;13.47;1015;74;4675.00;94
12454;72;626516109;12454;364;13468;13561;6.59;0.40;294.74;13.52;1014;74;4676.00;93
12457;72;626516123;12457;368;13468;13561;6.56;0.40;294.78;13.52;1011;74;4677.00;93
12459;72;626516136;12459;370;13468;13561;6.54;0.40;294.80;13.52;1009;74;4678.00;93
12460;72;626516149;12460;369;13468;13561;6.55;0.40;294.84;13.52;1008;74;4679.00;93
12461;72;626516163;12461;378;13531;13686;6.54;0.40;294.87;13.46;1070;74;4680.00;155
12462;72;626516187;12462;367;13531;13687;6.58;0.41;294.94;13.46;1069;74;4681.00;156
12465;72;626516200;12465;347;13540;13687;6.68;0.41;295.00;13.45;1075;74;4682.00;147
12467;72;626516214;12467;341;13542;13687;6.73;0.41;295.04;13.45;1075;74;4683.00;145
12471;72;626516229;12471;332;13547;13687;6.80;0.42;295.02;13.45;1076;74;4684.00;140
12472;72;626516245;12472;334;13551;13687;6.89;0.42;295.02;13.45;1079;74;4685.00;136
12476;72;626516262;12476;331;13557;13687;6.92;0.42;295.02;13.44;1081;74;4686.00;130
12480;72;626516278;12480;327;13559;13687;6.87;0.42;295.02;13.44;1079;74;4687.00;128
12483;72;626516296;12483;327;13563;13688;6.86;0.42;295.04;13.44;1080;74;4688.00;125
12485;72;626516314;12485;324;13565;13689;6.84;0.42;295.06;13.44;1080;74;4689.00;124
12487;72;626516331;12487;325;13567;13689;6.83;0.42;295.05;13.49;1080;74;4690.00;122
12489;72;626516347;12489;323;13571;13693;6.79;0.42;295.08;13.49;1082;74;4691.00;122
12493;72;626516362;12493;307;13572;13693;6.70;0.41;295.17;13.49;1079;74;4692.00;121
12496;72;626516376;12496;298;13572;13693;6.62;0.41;295.20;13.49;1076;74;4693.00;121
12501;72;626516397;12501;300;13573;13693;6.54;0.40;295.25;13.49;1072;74;4694.00;120
12503;72;626516419;12503;301;13577;13699;6.49;0.40;295.25;13.51;1074;74;4695.00;122
12509;72;626516436;12509;298;13579;13699;6.46;0.40;295.34;13.57;1070;74;4696.00;120
12513;72;626516452;12513;294;13581;13699;6.38;0.39;295.35;13.62;1068;74;4697.00;118
12515;72;626516466;12515;289;13583;13702;6.40;0.39;295.40;13.62;1068;74;4698.00;119
12521;72;626516482;12521;285;13585;13702;6.40;0.39;295.48;13.67;1064;74;4699.00;117
12523;72;626516499;12523;285;13586;13702;6.44;0.39;295.50;13.67;1063;74;4700.00;116
12528;72;626516517;12528;280;13586;13703;6.46;0.39;295.52;13.67;1058;74;4701.00;117
12530;72;626516533;12530;275;13588;13704;6.53;0.40;295.53;13.72;1058;74;4702.00;116
12532;72;626516547;12532;269;13588;13704;6.60;0.40;295.59;13.72;1056;74;4703.00;116
12533;72;626516561;12533;272;13597;13717;6.67;0.41;295.59;13.71;1064;74;4704.00;120
12537;72;626516577;12537;270;13598;13717;6.73;0.41;295.61;13.77;1061;74;4705.00;119
12540;72;626516592;12540;273;13598;13717;6.86;0.42;295.70;13.77;1058;74;4706.00;119
12542;72;626516609;12542;272;13601;13718;6.96;0.42;295.72;13.82;1059;74;4707.00;117
12546;72;626516625;12546;266;13601;13718;7.01;0.42;295.76;13.82;1055;74;4708.00;117
12547;72;626516641;12547;264;13606;13722;7.09;0.43;295.79;13.87;1059;74;4709.00;116
12549;72;626516658;12549;267;13607;13722;7.12;0.43;295.80;13.87;1058;74;4710.00;115
12552;72;626516674;12552;271;13611;13726;7.10;0.43;295.80;13.87;1059;74;4711.00;115
12555;72;626516693;12555;274;13612;13726;7.15;0.43;295.81;13.87;1057;74;4712.00;114
12558;72;626516710;12558;282;13613;13726;7.15;0.43;295.85;13.92;1055;74;4713.00;113
12560;72;626516726;12560;282;13613;13726;7.18;0.44;295.85;13.92;1053;74;4714.00;113
12561;72;626516741;12561;288;13614;13726;7.23;0.44;295.89;13.93;1053;74;4715.00;112
12566;72;626516756;12566;289;13623;13738;7.28;0.44;295.98;13.92;1057;74;4716.00;115
12569;72;626516774;12569;300;13625;13738;7.31;0.44;296.02;13.92;1056;74;4717.00;113
12573;72;626516790;12573;306;13627;13738;7.29;0.44;296.10;13.92;1054;74;4718.00;111
12573;72;626516806;12573;310;13627;13738;7.30;0.44;296.10;13.92;1054;74;4719.00;111
12576;72;626516822;12576;320;13627;13738;7.26;0.44;296.15;13.92;1051;74;4720.00;111
12580;72;626516838;12580;324;13628;13738;7.24;0.44;296.21;13.92;1048;74;4721.00;110
12580;72;626516853;12580;328;13629;13739;7.25;0.44;296.21;13.93;1049;74;4722.00;110
12582;72;626516869;12582;324;13631;13739;7.18;0.44;296.26;13.96;1049;74;4723.00;108
12584;72;626516886;12584;323;13635;13745;7.23;0.44;296.31;13.96;1051;74;4724.00;110
12587;72;626516902;12587;317;13641;13747;7.27;0.44;296.36;13.99;1054;74;4725.00;106
12592;72;626516917;12592;314;13642;13747;7.24;0.44;296.39;14.01;1050;74;4726.00;105
12594;72;626516932;12594;317;13643;13747;7.26;0.44;296.36;14.02;1049;74;4727.00;104
12596;72;626516949;12596;320;13647;13751;7.25;0.44;296.42;14.03;1051;74;4728.00;104
12599;72;626516965;12599;330;13648;13751;7.23;0.44;296.49;14.04;1049;74;4729.00;103
12601;72;626516981;12601;329;13649;13751;7.22;0.44;296.52;14.05;1048;74;4730.00;102
12603;72;626516998;12603;337;13652;13752;7.22;0.44;296.57;14.07;1049;74;4731.00;100
12606;72;626517014;12606;335;13655;13756;7.21;0.44;296.60;14.07;1049;74;4732.00;101
12608;72;626517030;12608;340;13655;13756;7.19;0.44;296.68;14.07;1047;74;4733.00;101
12610;72;626517044;12610;345;13660;13759;7.18;0.44;296.72;14.10;1050;74;4734.00;99
12611;72;626517059;12611;344;13661;13759;7.13;0.44;296.73;14.11;1050;74;4735.00;98
12613;72;626517087;12613;352;13663;13759;7.08;0.43;296.75;14.12;1050;74;4736.00;96
12615;72;626517107;12615;355;13664;13759;7.08;0.43;296.78;14.13;1049;74;4737.00;95
12616;72;626517131;12616;360;13668;13763;7.10;0.43;296.77;14.14;1052;74;4738.00;95
12621;72;626517150;12621;354;13669;13763;7.03;0.43;296.83;14.14;1048;74;4739.00;94
12626;72;626517182;12626;359;13671;13763;6.94;0.42;296.83;14.15;1045;74;4740.00;92
12626;72;626517200;12626;358;13671;13763;6.88;0.42;296.83;14.15;1045;74;4741.00;92
12627;72;626517218;12627;357;13671;13764;6.83;0.42;296.87;14.15;1044;74;4742.00;93
12631;72;626517236;12631;353;13675;13765;6.78;0.41;296.87;14.17;1044;74;4743.00;90
12631;72;626517258;12631;351;13676;13765;6.73;0.41;296.87;14.18;1045;74;4744.00;89
12634;72;626517272;12634;361;13679;13766;6.68;0.41;296.82;14.19;1045;74;4745.00;87
12638;72;626517286;12638;359;13679;13766;6.63;0.40;296.86;14.19;1041;74;4746.00;87
12639;72;626517301;12639;359;13680;13766;6.55;0.40;296.85;14.19;1041;74;4747.00;86
12642;72;626517323;12642;362;13681;13766;6.48;0.40;296.90;14.20;1039;74;4748.00;85
12644;72;626517337;12644;366;13681;13766;6.43;0.39;296.89;14.20;1037;74;4749.00;85
12646;72;626517351;12646;368;13683;13766;6.36;0.39;296.91;14.22;1037;74;4750.00;83
12649;72;626517365;12649;374;13683;13766;6.30;0.38;296.90;14.22;1034;74;4751.00;83
12653;72;626517378;12653;392;13750;13893;6.48;0.40;296.86;14.16;1097;74;4752.00;143
12657;72;626517404;12657;394;13751;13894;6.44;0.40;296.84;14.16;1094;74;4753.00;143
12660;72;626517418;12660;396;13761;13894;6.44;0.40;296.86;14.16;1101;74;4754.00;133
12666;72;626517432;12666;396;13767;13894;6.31;0.39;296.88;14.16;1101;74;4755.00;127
12668;72;626517449;12668;400;13773;13894;6.25;0.39;296.87;14.16;1105;74;4756.00;121
12670;72;626517464;12670;405;13780;13894;6.17;0.38;296.88;14.17;1110;74;4757.00;114
12674;72;626517477;12674;408;13785;13894;6.09;0.38;296.84;14.16;1111;74;4758.00;109
12676;72;626517489;12676;418;13789;13894;5.94;0.37;296.81;14.17;1113;74;4759.00;105
12680;72;626517502;12680;416;13793;13895;5.85;0.36;296.79;14.17;1113;74;4760.00;102
12683;72;626517523;12683;418;13798;13896;5.76;0.36;296.74;14.18;1115;74;4761.00;98
12687;72;626517542;12687;423;13801;13896;5.70;0.35;296.76;14.18;1114;74;4762.00;95
12689;72;626517557;12689;437;13804;13897;5.62;0.35;296.76;14.19;1115;74;4763.00;93
12690;72;626517575;12690;450;13805;13897;5.53;0.34;296.76;14.19;1115;74;4764.00;92
12695;72;626517594;12695;462;13806;13897;5.45;0.34;296.74;14.19;1111;74;4765.00;91
12695;72;626517609;12695;474;13809;13897;5.45;0.34;296.74;14.20;1114;74;4766.00;88
12698;72;626517623;12698;485;13811;13901;5.38;0.33;296.75;14.20;1113;74;4767.00;90
12700;72;626517638;12700;487;13813;13901;5.34;0.33;296.75;14.20;1113;74;4768.00;88
12702;72;626517652;12702;487;13814;13901;5.32;0.33;296.76;14.20;1112;74;4769.00;87
12704;72;626517668;12704;490;13818;13907;5.32;0.33;296.77;14.19;1114;74;4770.00;89
12706;72;626517683;12706;487;13819;13907;5.31;0.33;296.76;14.19;1113;74;4771.00;88
12709;72;626517698;12709;481;13821;13907;5.30;0.33;296.77;14.19;1112;74;4772.00;86
12711;72;626517712;12711;489;13824;13911;5.31;0.33;296.79;14.19;1113;74;4773.00;87
12716;72;626517727;12716;485;13826;13912;5.27;0.32;296.74;14.19;1110;74;4774.00;86
12720;72;626517742;12720;487;13826;13912;5.24;0.32;296.69;14.19;1106;74;4775.00;86
12722;72;626517756;12722;494;13830;13916;5.23;0.32;296.71;14.19;1108;74;4776.00;86
12726;72;626517771;12726;499;13830;13916;5.17;0.32;296.69;14.19;1104;74;4777.00;86
12730;72;626517785;12730;506;13831;13916;5.14;0.32;296.68;14.18;1101;74;4778.00;85
12732;72;626517799;12732;493;13832;13917;5.14;0.32;296.67;14.18;1100;74;4779.00;85
12734;72;626517814;12734;487;13833;13917;5.20;0.32;296.68;14.18;1099;74;4780.00;84
12739;72;626517829;12739;488;13836;13923;5.22;0.32;296.63;14.18;1097;74;4781.00;87
12740;72;626517845;12740;487;13837;13923;5.29;0.33;296.61;14.18;1097;74;4782.00;86
12741;72;626517859;12741;486;13837;13924;5.32;0.33;296.62;14.18;1096;74;4783.00;87
12743;72;626517874;12743;471;13838;13924;5.41;0.33;296.60;14.18;1095;74;4784.00;86
12744;72;626517889;12744;466;13838;13924;5.49;0.34;296.58;14.18;1094;74;4785.00;86
12751;72;626517905;12751;473;13838;13924;5.54;0.34;296.51;14.18;1087;74;4786.00;86
12753;72;626517922;12753;475;13838;13924;5.63;0.35;296.56;14.18;1085;74;4787.00;86
12758;72;626517936;12758;476;13848;13936;5.74;0.35;296.51;14.17;1090;74;4788.00;88
12765;72;626517961;12765;468;13848;13936;5.75;0.35;296.47;14.17;1083;74;4789.00;88
12769;72;626517984;12769;467;13849;13936;5.76;0.35;296.49;14.17;1080;74;4790.00;87
12772;72;626518001;12772;472;13849;13936;5.78;0.35;296.49;14.17;1077;74;4791.00;87
12775;72;626518016;12775;466;13849;13936;5.79;0.35;296.47;14.17;1074;74;4792.00;87
12778;72;626518031;12778;466;13849;13936;5.84;0.36;296.44;14.17;1071;74;4793.00;87
12780;72;626518048;12780;466;13852;13940;5.90;0.36;296.47;14.17;1072;74;4794.00;88
12781;72;626518065;12781;468;13852;13940;5.94;0.36;296.48;14.17;1071;74;4795.00;88
12783;72;626518081;12783;466;13855;13944;5.91;0.36;296.52;14.16;1072;74;4796.00;89
12784;72;626518098;12784;466;13856;13945;5.89;0.36;296.50;14.16;1072;74;4797.00;89
12786;72;626518113;12786;466;13857;13945;5.90;0.36;296.49;14.16;1071;74;4798.00;88
12789;72;626518127;12789;468;13857;13945;5.90;0.36;296.48;14.16;1068;74;4799.00;88
12793;72;626518145;12793;483;13878;13986;5.97;0.36;296.52;14.14;1085;74;4800.00;108
12796;72;626518167;12796;485;13880;13986;5.92;0.36;296.58;14.14;1084;74;4801.00;106
12797;72;626518182;12797;477;13881;13986;5.94;0.36;296.58;14.14;1084;74;4802.00;105
12802;72;626518196;12802;477;13882;13987;5.90;0.36;296.63;14.14;1080;74;4803.00;105
12803;72;626518210;12803;472;13883;13988;5.86;0.36;296.63;14.13;1080;74;4804.00;105
12809;72;626518224;12809;472;13884;13988;5.84;0.35;296.67;14.13;1075;74;4805.00;104
12812;72;626518239;12812;478;13888;13991;5.87;0.36;296.65;14.13;1076;74;4806.00;103
12814;72;626518253;12814;466;13891;13991;5.83;0.35;296.71;14.19;1077;74;4807.00;100
12816;72;626518269;12816;444;13892;13991;5.82;0.35;296.77;14.19;1076;74;4808.00;99
12818;72;626518283;12818;437;13892;13991;5.74;0.35;296.80;14.19;1074;74;4809.00;99
12818;72;626518298;12818;446;13897;13997;5.79;0.35;296.80;14.18;1079;74;4810.00;100
12822;72;626518313;12822;440;13898;13997;5.75;0.35;296.81;14.18;1076;74;4811.00;99
12826;72;626518327;12826;441;13898;13997;5.79;0.35;296.84;14.18;1072;74;4812.00;99
12828;72;626518341;12828;441;13899;13997;5.80;0.35;296.87;14.18;1071;74;4813.00;98
12830;72;626518355;12830;438;13902;14001;5.85;0.35;296.93;14.18;1072;74;4814.00;99
12834;72;626518370;12834;438;13904;14003;5.85;0.35;296.92;14.18;1070;74;4815.00;99
12835;72;626518384;12835;425;13904;14003;5.93;0.36;296.95;14.18;1069;74;4816.00;99
12837;72;626518399;12837;412;13905;14004;6.00;0.36;296.97;14.18;1068;74;4817.00;99
12839;72;626518414;12839;400;13905;14004;6.06;0.37;297.02;14.18;1066;74;4818.00;99
12842;72;626518428;12842;392;13906;14004;6.12;0.37;297.00;14.18;1064;74;4819.00;98
12845;72;626518442;12845;386;13906;14004;6.18;0.37;296.97;14.18;1061;74;4820.00;98
12847;72;626518457;12847;382;13906;14004;6.22;0.38;297.02;14.18;1059;74;4821.00;98
12850;72;626518472;12850;371;13906;14004;6.26;0.38;297.04;14.18;1056;74;4822.00;98
12853;72;626518493;12853;366;13906;14004;6.24;0.38;297.10;14.18;1053;74;4823.00;98
12853;72;626518507;12853;382;13950;14074;6.22;0.38;297.10;14.14;1097;74;4824.00;124
12855;72;626518528;12855;373;13950;14075;6.21;0.38;297.12;14.14;1095;74;4825.00;125
12857;72;626518542;12857;364;13954;14075;6.27;0.38;297.18;14.13;1097;74;4826.00;121
12860;72;626518557;12860;354;13955;14075;6.33;0.38;297.23;14.13;1095;74;4827.00;120
12863;72;626518572;12863;349;13958;14077;6.35;0.39;297.31;14.13;1095;74;4828.00;119
12867;72;626518588;12867;343;13961;14077;6.37;0.39;297.34;14.13;1094;74;4829.00;116
12867;72;626518605;12867;345;13965;14077;6.46;0.39;297.34;14.13;1098;74;4830.00;112
12871;72;626518619;12871;348;13966;14077;6.47;0.39;297.38;14.13;1095;74;4831.00;111
12874;72;626518634;12874;343;13968;14078;6.49;0.39;297.42;14.12;1094;74;4832.00;110
12877;72;626518649;12877;341;13970;14079;6.51;0.39;297.50;14.12;1093;74;4833.00;109
12878;72;626518664;12878;335;13974;14079;6.57;0.40;297.50;14.12;1096;74;4834.00;105
12881;72;626518679;12881;332;13979;14083;6.60;0.40;297.46;14.12;1098;74;4835.00;104
12884;72;626518694;12884;334;13980;14083;6.59;0.40;297.46;14.12;1096;74;4836.00;103
12888;72;626518709;12888;339;13981;14083;6.57;0.40;297.48;14.12;1093;74;4837.00;102
12891;72;626518723;12891;338;13981;14083;6.60;0.40;297.52;14.12;1090;74;4838.00;102
12892;72;626518737;12892;335;13987;14089;6.58;0.40;297.52;14.11;1095;74;4839.00;102
12897;72;626518751;12897;341;13987;14089;6.57;0.40;297.63;14.11;1090;74;4840.00;102
12897;72;626518767;12897;346;13987;14089;6.58;0.40;297.63;14.11;1090;74;4841.00;102
12898;72;626518781;12898;340;13990;14092;6.59;0.40;297.66;14.11;1092;74;4842.00;102
12900;72;626518795;12900;347;13990;14092;6.57;0.40;297.71;14.11;1090;74;4843.00;102
12900;72;626518812;12900;349;13990;14092;6.62;0.40;297.71;14.11;1090;74;4844.00;102
12900;72;626518826;12900;349;13990;14093;6.64;0.40;297.71;14.11;1090;74;4845.00;103
12901;72;626518841;12901;354;13991;14094;6.66;0.41;297.70;14.11;1090;74;4846.00;103
12903;72;626518855;12903;350;13992;14094;6.64;0.40;297.72;14.17;1089;74;4847.00;102
12905;72;626518869;12905;351;14003;14107;6.67;0.41;297.73;14.16;1098;74;4848.00;104
12905;72;626518885;12905;348;14003;14107;6.64;0.40;297.73;14.16;1098;74;4849.00;104
12906;72;626518899;12906;335;14003;14107;6.65;0.41;297.76;14.16;1097;74;4850.00;104
12908;72;626518913;12908;336;14004;14108;6.62;0.40;297.80;14.16;1096;74;4851.00;104
12913;72;626518927;12913;326;14004;14108;6.53;0.40;297.80;14.16;1091;74;4852.00;104
12916;72;626518943;12916;319;14007;14112;6.47;0.39;297.84;14.16;1091;74;4853.00;105
12920;72;626518959;12920;328;14007;14112;6.45;0.39;297.87;14.16;1087;74;4854.00;105
12923;72;626518975;12923;324;14011;14116;6.45;0.39;297.86;14.15;1088;74;4855.00;105
12925;72;626518990;12925;322;14011;14116;6.50;0.40;297.86;14.15;1086;74;4856.00;105
12927;72;626519005;12927;314;14011;14116;6.55;0.40;297.89;14.15;1084;74;4857.00;105
12929;72;626519019;12929;310;14011;14116;6.56;0.40;297.94;14.15;1082;74;4858.00;105
12931;72;626519034;12931;310;14011;14116;6.55;0.40;297.97;14.15;1080;74;4859.00;105
12935;72;626519051;12935;303;14031;14150;6.52;0.40;298.00;14.20;1096;74;4860.00;119
12940;72;626519072;12940;295;14032;14150;6.51;0.40;298.03;14.20;1092;74;4861.00;118
12942;72;626519092;12942;290;14035;14150;6.54;0.40;298.04;14.20;1093;74;4862.00;115
12948;72;626519112;12948;279;14036;14150;6.51;0.40;298.08;14.26;1088;74;4863.00;114
12950;72;626519132;12950;270;14037;14150;6.53;0.40;298.10;14.26;1087;74;4864.00;113
12954;72;626519152;12954;270;14038;14150;6.56;0.40;298.10;14.27;1084;74;4865.00;112
12961;72;626519174;12961;258;14039;14151;6.61;0.40;298.25;14.27;1078;74;4866.00;112
12966;72;626519192;12966;255;14039;14151;6.65;0.41;298.31;14.27;1073;74;4867.00;112
12972;72;626519209;12972;251;14044;14157;6.66;0.40;298.30;14.33;1072;74;4868.00;113
12974;72;626519226;12974;244;14045;14158;6.62;0.40;298.34;14.33;1071;74;4869.00;113
12975;72;626519243;12975;236;14046;14158;6.57;0.40;298.37;14.33;1071;74;4870.00;112
12977;72;626519261;12977;237;14046;14158;6.55;0.40;298.40;14.33;1069;74;4871.00;112
12980;72;626519294;12980;245;14049;14162;6.55;0.40;298.40;14.32;1069;74;4872.00;113
12985;72;626519328;12985;243;14050;14162;6.53;0.40;298.39;14.32;1065;74;4873.00;112
12987;72;626519355;12987;244;14050;14162;6.56;0.40;298.46;14.32;1063;74;4874.00;112
12990;72;626519377;12990;239;14051;14163;6.54;0.40;298.57;14.32;1061;74;4875.00;112
12995;72;626519394;12995;253;14055;14167;6.51;0.40;298.59;14.38;1060;74;4876.00;112
12999;72;626519413;12999;255;14056;14167;6.52;0.40;298.60;14.38;1057;74;4877.00;111
13001;72;626519431;13001;258;14059;14170;6.55;0.40;298.58;14.38;1058;74;4878.00;111
13005;72;626519447;13005;257;14060;14170;6.51;0.40;298.53;14.38;1055;74;4879.00;110
13008;72;626519466;13008;265;14061;14170;6.50;0.39;298.55;14.38;1053;74;4880.00;109
13015;72;626519485;13015;276;14061;14170;6.38;0.39;298.58;14.38;1046;74;4881.00;109
13015;72;626519520;13015;273;14064;14174;6.40;0.39;298.58;14.37;1049;74;4882.00;110
13019;72;626519544;13019;271;14065;14174;6.43;0.39;298.65;14.37;1046;74;4883.00;109
13021;72;626519563;13021;277;14065;14174;6.42;0.39;298.65;14.37;1044;74;4884.00;109
13025;72;626519580;13025;277;14065;14174;6.42;0.39;298.69;14.37;1040;74;4885.00;109
13027;72;626519598;13027;277;14066;14175;6.39;0.39;298.74;14.38;1039;74;4886.00;109
13031;72;626519616;13031;279;14067;14176;6.36;0.39;298.78;14.38;1036;74;4887.00;109
13032;72;626519634;13032;286;14067;14176;6.32;0.38;298.81;14.38;1035;74;4888.00;109
13035;72;626519653;13035;292;14068;14177;6.28;0.38;298.94;14.38;1033;74;4889.00;109
13037;72;626519674;13037;301;14070;14177;6.27;0.38;298.94;14.40;1033;74;4890.00;107
13038;72;626519690;13038;304;14070;14177;6.26;0.38;298.97;14.40;1032;74;4891.00;107
13039;72;626519706;13039;315;14071;14177;6.27;0.38;298.96;14.41;1032;74;4892.00;106
13039;72;626519723;13039;315;14072;14177;6.24;0.38;298.96;14.43;1033;74;4893.00;105
13043;72;626519741;13043;321;14073;14177;6.23;0.38;298.94;14.43;1030;74;4894.00;104
13043;72;626519759;13043;322;14074;14177;6.20;0.38;298.94;14.45;1031;74;4895.00;103
13046;72;626519775;13046;343;14139;14304;6.45;0.40;298.91;14.38;1093;74;4896.00;165
13050;72;626519805;13050;342;14144;14305;6.43;0.40;298.92;14.38;1094;74;4897.00;161
13051;72;626519823;13051;341;14154;14305;6.54;0.41;298.92;14.40;1103;74;4898.00;151
13055;72;626519839;13055;342;14157;14305;6.56;0.41;298.86;14.40;1102;74;4899.00;148
13059;72;626519857;13059;333;14164;14305;6.58;0.41;298.86;14.40;1105;74;4900.00;141
13059;72;626519883;13059;333;14171;14305;6.62;0.41;298.86;14.41;1112;74;4901.00;134
13060;72;626519901;13060;329;14179;14305;6.62;0.41;298.85;14.41;1119;74;4902.00;126
13062;72;626519920;13062;328;14183;14305;6.60;0.41;298.81;14.41;1121;74;4903.00;122
13065;72;626519945;13065;330;14188;14306;6.53;0.40;298.77;14.42;1123;74;4904.00;118
13067;72;626519975;13067;332;14192;14308;6.46;0.40;298.75;14.42;1125;74;4905.00;116
13067;72;626519996;13067;340;14194;14308;6.41;0.40;298.75;14.42;1127;74;4906.00;114
13071;72;626520017;13071;340;14196;14309;6.30;0.39;298.70;14.43;1125;74;4907.00;113
13074;72;626520044;13074;351;14201;14309;6.25;0.39;298.72;14.44;1127;74;4908.00;108
13077;72;626520063;13077;356;14202;14309;6.14;0.38;298.68;14.45;1125;74;4909.00;107
13081;72;626520081;13081;360;14204;14309;6.04;0.37;298.70;14.45;1123;74;4910.00;105
13081;72;626520099;13081;365;14209;14313;5.98;0.37;298.70;14.47;1128;74;4911.00;104
13083;72;626520117;13083;364;14211;14313;5.88;0.36;298.70;14.47;1128;74;4912.00;102
13084;72;626520133;13084;374;14213;14313;5.80;0.36;298.73;14.48;1129;74;4913.00;100
13085;72;626520147;13085;387;14216;14316;5.76;0.35;298.71;14.48;1131;74;4914.00;100
13087;72;626520170;13087;398;14218;14316;5.73;0.35;298.73;14.49;1131;74;4915.00;98
13087;72;626520197;13087;402;14219;14316;5.69;0.35;298.73;14.49;1132;74;4916.00;97
13088;72;626520213;13088;404;14223;14320;5.67;0.35;298.73;14.49;1135;74;4917.00;97
13089;72;626520229;13089;411;14226;14321;5.63;0.35;298.71;14.50;1137;74;4918.00;95
13093;72;626520243;13093;410;14226;14321;5.54;0.34;298.64;14.50;1133;74;4919.00;95
13093;72;626520260;13093;414;14232;14326;5.51;0.34;298.64;14.52;1139;74;4920.00;94
13094;72;626520281;13094;426;14233;14326;5.41;0.33;298.63;14.53;1139;74;4921.00;93
13098;72;626520300;13098;423;14233;14326;5.29;0.32;298.60;14.53;1135;74;4922.00;93
13100;72;626520320;13100;429;14234;14327;5.18;0.32;298.62;14.53;1134;74;4923.00;93
13105;72;626520335;13105;433;14235;14327;5.03;0.31;298.67;14.55;1130;74;4924.00;92
13107;72;626520356;13107;440;14241;14333;4.99;0.31;298.69;14.57;1134;74;4925.00;92
13109;72;626520370;13109;441;14242;14333;4.87;0.30;298.70;14.58;1133;74;4926.00;91
13112;72;626520384;13112;445;14244;14334;4.77;0.29;298.71;14.58;1132;74;4927.00;90
13115;72;626520401;13115;457;14244;14334;4.65;0.29;298.69;14.58;1129;74;4928.00;90
13117;72;626520419;13117;464;14245;14334;4.54;0.28;298.70;14.59;1128;74;4929.00;89
13120;72;626520435;13120;465;14245;14334;4.48;0.28;298.70;14.59;1125;74;4930.00;89
13122;72;626520452;13122;449;14246;14334;4.47;0.27;298.71;14.60;1124;74;4931.00;88
13125;72;626520465;13125;438;14258;14346;4.57;0.28;298.68;14.60;1133;74;4932.00;88
13126;72;626520481;13126;429;14258;14346;4.67;0.29;298.67;14.60;1132;74;4933.00;88
13129;72;626520498;13129;427;14259;14346;4.74;0.29;298.66;14.61;1130;74;4934.00;87
13131;72;626520519;13131;429;14260;14346;4.80;0.30;298.66;14.62;1129;74;4935.00;86
13136;72;626520534;13136;429;14260;14346;4.85;0.30;298.61;14.62;1124;74;4936.00;86
13138;72;626520550;13138;424;14261;14346;4.89;0.30;298.59;14.63;1123;74;4937.00;85
13140;72;626520573;13140;410;14264;14350;5.02;0.31;298.58;14.63;1124;74;4938.00;86
13141;72;626520589;13141;404;14264;14350;5.11;0.31;298.59;14.63;1123;74;4939.00;86
13145;72;626520610;13145;394;14267;14354;5.19;0.32;298.58;14.62;1122;74;4940.00;87
13149;72;626520631;13149;396;14269;14355;5.26;0.32;298.58;14.68;1120;74;4941.00;86
13150;73;626520650;13150;391;14270;14355;5.32;0.33;298.59;14.68;1120;75;4942.00;85
13153;73;626520674;13153;395;14270;14355;5.32;0.33;298.60;14.68;1117;75;4943.00;85
13154;73;626520688;13154;385;14280;14368;5.49;0.34;298.59;14.67;1126;75;4944.00;88
13159;73;626520707;13159;387;14280;14368;5.51;0.34;298.58;14.67;1121;75;4945.00;88
13162;73;626520721;13162;386;14281;14368;5.60;0.34;298.61;14.67;1119;75;4946.00;87
13165;73;626520734;13165;388;14282;14369;5.69;0.35;298.60;14.67;1117;75;4947.00;87
13168;73;626520748;13168;380;14282;14370;5.72;0.35;298.60;14.67;1114;75;4948.00;88
13168;73;626520762;13168;384;14282;14370;5.81;0.36;298.60;14.67;1114;75;4949.00;88
13171;73;626520777;13171;387;14286;14379;5.90;0.36;298.61;14.67;1115;75;4950.00;93
13174;73;626520793;13174;388;14286;14379;5.91;0.36;298.63;14.67;1112;75;4951.00;93
13179;73;626520808;13179;391;14288;14379;5.88;0.36;298.74;14.66;1109;75;4952.00;91
13183;73;626520823;13183;382;14288;14379;5.87;0.36;298.78;14.66;1105;75;4953.00;91
13189;73;626520839;13189;380;14292;14385;5.92;0.36;298.79;14.66;1103;75;4954.00;93
13191;73;626520855;13191;380;14292;14385;5.96;0.36;298.84;14.66;1101;75;4955.00;93
13198;73;626520872;13198;377;14293;14385;5.97;0.36;298.90;14.66;1095;75;4956.00;92
13201;73;626520887;13201;381;14293;14385;6.02;0.37;298.97;14.66;1092;75;4957.00;92
13206;73;626520903;13206;391;14297;14389;6.04;0.37;298.97;14.66;1091;75;4958.00;92
13211;73;626520921;13211;395;14299;14390;6.07;0.37;299.06;14.65;1088;75;4959.00;91
13213;73;626520939;13213;395;14301;14390;6.11;0.37;299.10;14.71;1088;75;4960.00;89
13217;73;626520954;13217;395;14302;14391;6.18;0.38;299.10;14.71;1085;75;4961.00;89
13222;73;626520972;13222;402;14302;14391;6.19;0.38;299.09;14.71;1080;75;4962.00;89
13227;73;626520987;13227;409;14302;14391;6.16;0.37;299.14;14.71;1075;75;4963.00;89
13231;73;626521001;13231;410;14302;14391;6.16;0.38;299.15;14.71;1071;75;4964.00;89
13235;73;626521016;13235;407;14302;14391;6.16;0.38;299.17;14.71;1067;75;4965.00;89
13238;73;626521031;13238;403;14302;14391;6.16;0.38;299.15;14.71;1064;75;4966.00;89
13242;73;626521047;13242;403;14302;14391;6.19;0.38;299.22;14.71;1060;75;4967.00;89
13245;73;626521061;13245;412;14346;14461;6.23;0.38;299.29;14.67;1101;75;4968.00;115
13247;73;626521094;13247;409;14346;14462;6.28;0.38;299.35;14.67;1099;75;4969.00;116
13249;73;626521118;13249;405;14352;14462;6.40;0.39;299.33;14.66;1103;75;4970.00;110
13255;73;626521140;13255;401;14353;14462;6.45;0.39;299.36;14.66;1098;75;4971.00;109
13257;73;626521160;13257;398;14357;14462;6.53;0.40;299.37;14.66;1100;75;4972.00;105
13261;73;626521180;13261;402;14358;14462;6.53;0.40;299.43;14.66;1097;75;4973.00;104
13266;73;626521199;13266;403;14362;14462;6.52;0.40;299.50;14.66;1096;75;4974.00;100
13268;73;626521219;13268;404;14364;14462;6.52;0.40;299.53;14.66;1096;75;4975.00;98
13271;73;626521236;13271;402;14366;14463;6.55;0.40;299.57;14.65;1095;75;4976.00;97
13273;73;626521254;13273;395;14371;14464;6.59;0.40;299.60;14.71;1098;75;4977.00;93
13277;73;626521273;13277;390;14371;14464;6.53;0.40;299.62;14.71;1094;75;4978.00;93
13279;73;626521290;13279;384;14374;14468;6.52;0.40;299.67;14.71;1095;75;4979.00;94
13281;73;626521308;13281;383;14374;14468;6.51;0.40;299.71;14.71;1093;75;4980.00;94
13285;73;626521323;13285;379;14374;14468;6.46;0.39;299.75;14.71;1089;75;4981.00;94
13288;73;626521339;13288;383;14374;14468;6.47;0.39;299.79;14.71;1086;75;4982.00;94
13290;73;626521354;13290;383;14378;14474;6.48;0.40;299.82;14.70;1088;75;4983.00;96
13292;73;626521370;13292;379;14378;14474;6.50;0.40;299.84;14.70;1086;75;4984.00;96
13295;73;626521385;13295;389;14379;14474;6.56;0.40;299.89;14.70;1084;75;4985.00;95
13297;73;626521400;13297;382;14381;14477;6.64;0.40;299.92;14.70;1084;75;4986.00;96
13301;73;626521416;13301;372;14381;14477;6.63;0.40;299.92;14.70;1080;75;4987.00;96
13306;73;626521431;13306;361;14382;14477;6.62;0.40;299.91;14.70;1076;75;4988.00;95
13309;73;626521447;13309;349;14382;14478;6.60;0.40;299.94;14.70;1073;75;4989.00;96
13312;73;626521463;13312;341;14383;14479;6.59;0.40;299.91;14.70;1071;75;4990.00;96
13313;73;626521480;13313;340;14383;14479;6.58;0.40;299.93;14.70;1070;75;4991.00;96
13317;73;626521495;13317;342;14394;14492;6.60;0.40;299.91;14.69;1077;75;4992.00;98
13320;74;626521513;13320;344;14395;14492;6.56;0.40;299.95;14.75;1075;76;4993.00;97
13322;74;626521548;13322;351;14395;14492;6.55;0.40;299.99;14.75;1073;76;4994.00;97
13324;74;626521566;13324;344;14397;14494;6.52;0.40;300.00;14.74;1073;76;4995.00;97
13327;74;626521581;13327;352;14397;14494;6.52;0.40;300.02;14.74;1070;76;4996.00;97
13331;74;626521597;13331;353;14400;14498;6.53;0.40;300.07;14.74;1069;76;4997.00;98
13333;74;626521627;13333;349;14400;14498;6.54;0.40;300.10;14.74;1067;76;4998.00;98
13337;74;626521642;13337;346;14404;14502;6.48;0.39;300.10;14.74;1067;76;4999.00;98
13341;74;626521659;13341;338;14404;14502;6.47;0.39;300.13;14.74;1063;76;5000.00;98
13343;74;626521679;13343;325;14404;14502;6.43;0.39;300.13;14.74;1061;76;5001.00;98
13344;74;626521696;13344;325;14404;14502;6.40;0.39;300.13;14.74;1060;76;5002.00;98
13346;74;626521711;13346;327;14404;14502;6.40;0.39;300.15;14.74;1058;76;5003.00;98
13348;74;626521725;13348;321;14414;14514;6.45;0.39;300.12;14.73;1066;76;5004.00;100
13351;74;626521742;13351;320;14414;14514;6.50;0.39;300.16;14.73;1063;76;5005.00;100
13352;74;626521756;13352;316;14415;14514;6.55;0.40;300.15;14.73;1063;76;5006.00;99
13354;74;626521773;13354;318;14415;14514;6.60;0.40;300.17;14.73;1061;76;5007.00;99
13360;74;626521788;13360;320;14415;14514;6.55;0.40;300.35;14.73;1055;76;5008.00;99
13360;74;626521804;13360;322;14415;14514;6.55;0.40;300.35;14.73;1055;76;5009.00;99
13364;74;626521821;13364;320;14415;14515;6.51;0.40;300.38;14.73;1051;76;5010.00;100
13366;74;626521837;13366;318;14415;14515;6.47;0.39;300.38;14.73;1049;76;5011.00;100
13367;74;626521852;13367;321;14419;14521;6.47;0.39;300.38;14.72;1052;76;5012.00;102
13368;74;626521867;13368;316;14420;14522;6.45;0.39;300.39;14.72;1052;76;5013.00;102
13368;74;626521881;13368;325;14421;14522;6.39;0.39;300.39;14.72;1053;76;5014.00;101
13370;74;626521895;13370;322;14421;14522;6.34;0.39;300.38;14.72;1051;76;5015.00;101
13372;74;626521911;13372;320;14424;14526;6.37;0.39;300.37;14.72;1052;76;5016.00;102
13372;74;626521927;13372;319;14424;14526;6.32;0.38;300.37;14.72;1052;76;5017.00;102
13377;74;626521943;13377;323;14424;14526;6.25;0.38;300.43;14.72;1047;76;5018.00;102
13377;74;626521957;13377;328;14425;14527;6.23;0.38;300.43;14.72;1048;76;5019.00;102
13379;74;626521973;13379;330;14428;14531;6.16;0.37;300.42;14.71;1049;76;5020.00;103
13380;74;626521987;13380;320;14428;14531;6.08;0.37;300.41;14.71;1048;76;5021.00;103
13383;74;626522003;13383;315;14430;14534;6.05;0.37;300.41;14.71;1047;76;5022.00;104
13386;74;626522020;13386;304;14431;14534;5.98;0.36;300.40;14.77;1045;76;5023.00;103
13388;74;626522037;13388;305;14432;14534;5.95;0.36;300.40;14.77;1044;76;5024.00;102
13390;74;626522054;13390;304;14432;14534;5.90;0.36;300.43;14.77;1042;76;5025.00;102
13393;74;626522070;13393;302;14435;14538;5.92;0.36;300.45;14.77;1042;76;5026.00;103
13395;74;626522086;13395;305;14435;14538;5.89;0.36;300.48;14.77;1040;76;5027.00;103
13396;74;626522103;13396;297;14436;14538;5.89;0.36;300.49;14.77;1040;76;5028.00;102
13397;74;626522118;13397;289;14436;14538;5.84;0.36;300.48;14.77;1039;76;5029.00;102
13400;74;626522132;13400;283;14436;14539;5.83;0.35;300.49;14.77;1036;76;5030.00;103
13406;74;626522145;13406;275;14437;14540;5.76;0.35;300.53;14.77;1031;76;5031.00;103
13409;74;626522159;13409;276;14437;14540;5.64;0.34;300.53;14.77;1028;76;5032.00;103
13411;74;626522172;13411;260;14438;14541;5.60;0.34;300.57;14.77;1027;76;5033.00;103
13414;74;626522185;13414;255;14439;14541;5.54;0.34;300.58;14.78;1025;76;5034.00;102
13418;74;626522203;13418;251;14439;14541;5.47;0.33;300.69;14.78;1021;76;5035.00;102
13422;74;626522224;13422;255;14440;14541;5.48;0.33;300.70;14.80;1018;76;5036.00;101
13426;74;626522236;13426;253;14440;14541;5.47;0.33;300.73;14.80;1014;76;5037.00;101
13428;74;626522248;13428;247;14440;14541;5.50;0.33;300.74;14.80;1012;76;5038.00;101
13434;74;626522261;13434;242;14440;14541;5.47;0.33;300.81;14.80;1006;76;5039.00;101
13438;74;626522276;13438;273;14539;14771;5.73;0.36;300.81;14.70;1101;76;5040.00;232
13440;74;626522308;13440;263;14543;14772;5.70;0.36;300.84;14.75;1103;76;5041.00;229
13442;74;626522329;13442;249;14552;14772;5.79;0.36;300.88;14.75;1110;76;5042.00;220
13445;74;626522343;13445;235;14556;14772;5.84;0.36;300.85;14.80;1111;76;5043.00;216
13446;74;626522356;13446;235;14563;14772;5.91;0.37;300.84;14.80;1117;76;5044.00;209
13449;74;626522370;13449;230;14571;14772;5.98;0.37;300.84;14.79;1122;76;5045.00;201
13449;74;626522383;13449;225;14577;14772;6.05;0.38;300.84;14.79;1128;76;5046.00;195
13451;74;626522397;13451;226;14582;14772;6.12;0.38;300.84;14.79;1131;76;5047.00;190
13451;74;626522411;13451;237;14588;14773;6.20;0.39;300.84;14.78;1137;76;5048.00;185
13453;74;626522425;13453;242;14591;14774;6.29;0.39;300.81;14.78;1138;76;5049.00;183
13456;74;626522439;13456;239;14596;14774;6.31;0.39;300.83;14.78;1140;76;5050.00;178
13459;74;626522453;13459;242;14598;14775;6.33;0.39;300.78;14.78;1139;76;5051.00;177
13460;74;626522468;13460;249;14604;14775;6.34;0.39;300.78;14.78;1144;76;5052.00;171
13463;74;626522482;13463;243;14608;14775;6.43;0.40;300.82;14.78;1145;76;5053.00;167
13464;74;626522498;13464;242;14614;14775;6.47;0.40;300.80;14.78;1150;76;5054.00;161
13467;74;626522513;13467;247;14617;14779;6.47;0.40;300.78;14.77;1150;76;5055.00;162
13471;74;626522528;13471;253;14621;14779;6.46;0.40;300.75;14.79;1150;76;5056.00;158
13471;74;626522543;13471;260;14624;14779;6.46;0.40;300.75;14.79;1153;76;5057.00;155
13473;74;626522558;13473;272;14626;14782;6.45;0.40;300.74;14.79;1153;76;5058.00;156
13474;74;626522579;13474;284;14628;14782;6.45;0.40;300.72;14.79;1154;76;5059.00;154
13478;74;626522594;13478;289;14632;14782;6.39;0.39;300.67;14.80;1154;76;5060.00;150
13479;74;626522609;13479;294;14638;14786;6.32;0.39;300.66;14.81;1159;76;5061.00;148
13482;74;626522624;13482;297;14641;14787;6.31;0.39;300.64;14.81;1159;76;5062.00;146
13485;74;626522639;13485;305;14644;14787;6.25;0.38;300.61;14.81;1159;76;5063.00;143
13489;74;626522660;13489;315;14651;14791;6.24;0.38;300.72;14.84;1162;76;5064.00;140
13491;74;626522682;13491;319;14653;14791;6.20;0.38;300.68;14.84;1162;76;5065.00;138
13494;74;626522697;13494;321;14656;14791;6.16;0.38;300.68;14.86;1162;76;5066.00;135
13496;74;626522711;13496;327;14658;14792;6.09;0.37;300.73;14.86;1162;76;5067.00;134
13500;74;626522725;13500;336;14661;14792;6.06;0.37;300.65;14.88;1161;76;5068.00;131
13501;74;626522738;13501;336;14664;14798;6.09;0.37;300.66;14.88;1163;76;5069.00;134
13503;74;626522754;13503;347;14667;14798;6.04;0.37;300.66;14.90;1164;76;5070.00;131
13504;74;626522767;13504;354;14671;14799;5.96;0.36;300.64;14.90;1167;76;5071.00;128
13507;74;626522781;13507;358;14673;14799;5.86;0.36;300.59;14.92;1166;76;5072.00;126
13509;74;626522794;13509;372;14674;14799;5.79;0.35;300.56;14.92;1165;76;5073.00;125
13510;74;626522806;13510;383;14677;14799;5.69;0.35;300.54;14.94;1167;76;5074.00;122
13511;74;626522819;13511;390;14677;14799;5.63;0.34;300.52;14.94;1166;76;5075.00;122
13513;74;626522832;13513;395;14689;14811;5.58;0.34;300.51;14.95;1176;76;5076.00;122
13515;74;626522846;13515;399;14690;14811;5.52;0.34;300.50;14.95;1175;76;5077.00;121
13517;74;626522858;13517;412;14694;14811;5.45;0.33;300.49;14.96;1177;76;5078.00;117
13519;74;626522870;13519;416;14695;14811;5.39;0.33;300.49;14.96;1176;76;5079.00;116
13519;74;626522883;13519;419;14697;14811;5.33;0.33;300.49;14.98;1178;76;5080.00;114
13523;74;626522895;13523;417;14697;14811;5.27;0.32;300.47;14.98;1174;76;5081.00;114
13526;74;626522908;13526;411;14702;14815;5.25;0.32;300.45;14.98;1176;76;5082.00;113
13528;74;626522921;13528;391;14703;14815;5.27;0.32;300.44;14.99;1175;76;5083.00;112
13529;74;626522933;13529;378;14707;14819;5.32;0.33;300.42;14.99;1178;76;5084.00;112
13531;74;626522946;13531;366;14710;14821;5.36;0.33;300.41;15.00;1179;76;5085.00;111
13531;74;626522959;13531;357;14712;14821;5.38;0.33;300.41;15.01;1181;76;5086.00;109
13533;74;626522972;13533;350;14713;14821;5.40;0.33;300.40;15.02;1180;76;5087.00;108
13535;74;626522985;13535;345;14725;14834;5.45;0.33;300.37;15.01;1190;76;5088.00;109
13535;74;626522999;13535;352;14726;14834;5.51;0.34;300.37;15.02;1191;76;5089.00;108
13536;74;626523013;13536;347;14727;14834;5.55;0.34;300.36;15.02;1191;76;5090.00;107
13538;74;626523026;13538;346;14728;14835;5.57;0.34;300.34;15.02;1190;76;5091.00;107
13541;74;626523039;13541;340;14730;14836;5.59;0.34;300.34;15.04;1189;76;5092.00;106
13543;75;626523052;13543;348;14730;14836;5.63;0.34;300.32;15.04;1187;77;5093.00;106
13544;75;626523081;13544;348;14733;14839;5.69;0.35;300.31;15.05;1189;77;5094.00;106
13548;75;626523106;13548;356;14734;14839;5.71;0.35;300.28;15.06;1186;77;5095.00;105
13551;75;626523133;13551;360;14735;14839;5.72;0.35;300.29;15.06;1184;77;5096.00;104
13553;76;626523153;13553;365;14738;14839;5.75;0.35;300.27;15.10;1185;78;5097.00;101
13557;76;626523186;13557;369;14742;14845;5.77;0.35;300.27;15.09;1185;78;5098.00;103
13559;76;626523202;13559;376;14744;14845;5.72;0.35;300.27;15.10;1185;78;5099.00;101
13562;76;626523225;13562;380;14749;14864;5.65;0.34;300.29;15.10;1187;78;5100.00;115
13563;76;626523246;13563;382;14749;14864;5.62;0.34;300.30;15.10;1186;78;5101.00;115
13565;76;626523260;13565;390;14754;14868;5.58;0.34;300.32;15.11;1189;78;5102.00;114
13568;76;626523274;13568;390;14755;14869;5.58;0.34;300.40;15.10;1187;78;5103.00;114
13571;76;626523288;13571;387;14756;14869;5.61;0.34;300.41;15.12;1185;78;5104.00;113
13573;76;626523302;13573;388;14758;14870;5.65;0.35;300.44;15.13;1185;78;5105.00;112
13576;76;626523316;13576;396;14760;14870;5.65;0.35;300.42;15.12;1184;78;5106.00;110
13579;76;626523331;13579;390;14763;14870;5.66;0.35;300.48;15.15;1184;78;5107.00;107
13583;76;626523345;13583;384;14763;14870;5.72;0.35;300.49;15.15;1180;78;5108.00;107
13587;76;626523359;13587;382;14763;14870;5.75;0.35;300.54;15.15;1176;78;5109.00;107
13590;76;626523373;13590;379;14763;14870;5.78;0.35;300.59;15.15;1173;78;5110.00;107
13595;76;626523387;13595;379;14763;14870;5.78;0.35;300.66;15.15;1168;78;5111.00;107
13599;76;626523403;13599;376;14797;14940;5.92;0.36;300.62;15.11;1198;78;5112.00;143
13604;76;626523423;13604;371;14800;14941;5.99;0.37;300.70;15.11;1196;78;5113.00;141
13608;76;626523439;13608;370;14807;14941;6.10;0.37;300.81;15.10;1199;78;5114.00;134
13611;76;626523453;13611;363;14808;14941;6.16;0.38;300.81;15.10;1197;78;5115.00;133
13616;76;626523472;13616;366;14811;14941;6.25;0.38;300.88;15.10;1195;78;5116.00;130
13622;76;626523487;13622;357;14813;14941;6.24;0.38;300.89;15.10;1191;78;5117.00;128
13625;76;626523502;13625;357;14817;14941;6.24;0.38;300.92;15.10;1192;78;5118.00;124
13628;76;626523517;13628;360;14821;14941;6.26;0.38;300.93;15.10;1193;78;5119.00;120
13633;76;626523532;13633;361;14823;14942;6.29;0.38;300.97;15.09;1190;78;5120.00;119
13638;76;626523547;13638;358;14826;14943;6.31;0.39;301.03;15.09;1188;78;5121.00;117
13645;76;626523564;13645;366;14828;14943;6.31;0.39;301.05;15.09;1183;78;5122.00;115
13649;76;626523580;13649;360;14832;14947;6.33;0.39;301.09;15.09;1183;78;5123.00;115
13652;76;626523597;13652;363;14833;14947;6.36;0.39;301.15;15.09;1181;78;5124.00;114
13659;76;626523613;13659;364;14833;14947;6.36;0.39;301.19;15.09;1174;78;5125.00;114
13662;76;626523628;13662;378;14833;14947;6.37;0.39;301.21;15.09;1171;78;5126.00;114
13666;76;626523644;13666;385;14836;14953;6.31;0.39;301.19;15.09;1170;78;5127.00;117
13672;76;626523660;13672;388;14837;14953;6.25;0.38;301.21;15.09;1165;78;5128.00;116
13676;76;626523676;13676;388;14837;14953;6.26;0.38;301.23;15.09;1161;78;5129.00;116
13683;76;626523692;13683;398;14841;14959;6.29;0.38;301.21;15.09;1158;78;5130.00;118
13686;76;626523709;13686;399;14841;14959;6.30;0.38;301.31;15.09;1155;78;5131.00;118
13692;76;626523724;13692;401;14843;14959;6.28;0.38;301.33;15.09;1151;78;5132.00;116
13694;76;626523739;13694;406;14843;14960;6.28;0.38;301.36;15.09;1149;78;5133.00;117
13697;76;626523756;13697;417;14846;14961;6.22;0.38;301.43;15.09;1149;78;5134.00;115
13701;76;626523777;13701;417;14847;14961;6.21;0.38;301.42;15.09;1146;78;5135.00;114
13704;76;626523793;13704;421;14856;14974;6.16;0.37;301.45;15.08;1152;78;5136.00;118
13709;76;626523810;13709;431;14857;14974;6.14;0.37;301.51;15.08;1148;78;5137.00;117
13712;76;626523826;13712;430;14857;14974;6.12;0.37;301.51;15.08;1145;78;5138.00;117
13717;76;626523842;13717;436;14860;14975;6.10;0.37;301.56;15.08;1143;78;5139.00;115
13718;76;626523858;13718;438;14862;14975;6.10;0.37;301.58;15.08;1144;78;5140.00;113
13722;76;626523872;13722;452;14867;14979;6.06;0.37;301.66;15.08;1145;78;5141.00;112
13725;76;626523889;13725;458;14867;14979;6.06;0.37;301.67;15.08;1142;78;5142.00;112
13729;76;626523905;13729;457;14872;14983;6.05;0.37;301.73;15.14;1143;78;5143.00;111
13732;76;626523922;13732;457;14873;14983;6.04;0.37;301.77;15.14;1141;78;5144.00;110
13736;76;626523936;13736;459;14874;14983;6.03;0.37;301.81;15.13;1138;78;5145.00;109
13737;76;626523957;13737;467;14874;14983;6.05;0.37;301.84;15.13;1137;78;5146.00;109
13742;76;626523974;13742;457;14876;14983;6.03;0.37;301.90;15.13;1134;78;5147.00;107
13748;76;626523996;13748;455;14886;14995;6.00;0.37;301.97;15.12;1138;78;5148.00;109
13752;76;626524020;13752;446;14887;14995;6.00;0.37;301.98;15.12;1135;78;5149.00;108
13757;76;626524045;13757;441;14887;14995;5.99;0.37;302.00;15.12;1130;78;5150.00;108
13761;76;626524068;13761;447;14887;14995;5.98;0.36;301.97;15.12;1126;78;5151.00;108
13768;76;626524091;13768;442;14887;14995;5.97;0.36;302.02;15.12;1119;78;5152.00;108
13771;76;626524113;13771;445;14887;14995;5.93;0.36;302.04;15.12;1116;78;5153.00;108
13774;76;626524132;13774;439;14887;14996;5.94;0.36;302.22;15.12;1113;78;5154.00;109
13778;76;626524153;13778;437;14889;14998;5.90;0.36;302.26;15.12;1111;78;5155.00;109
13781;76;626524190;13781;421;14893;15004;5.94;0.36;302.38;15.12;1112;78;5156.00;111
13783;76;626524220;13783;405;14895;15005;6.01;0.36;302.40;15.11;1112;78;5157.00;110
13786;76;626524243;13786;398;14895;15005;6.03;0.37;302.43;15.11;1109;78;5158.00;110
13789;76;626524263;13789;391;14896;15005;6.04;0.37;302.43;15.17;1107;78;5159.00;109
13794;76;626524281;13794;383;14900;15010;6.08;0.37;302.53;15.17;1106;78;5160.00;110
13797;76;626524300;13797;378;14900;15010;6.04;0.36;302.61;15.17;1103;78;5161.00;110
13799;76;626524318;13799;368;14900;15010;6.06;0.37;302.65;15.17;1101;78;5162.00;110
13801;76;626524336;13801;367;14901;15011;6.09;0.37;302.73;15.17;1100;78;5163.00;110
13802;76;626524365;13802;361;14904;15015;6.09;0.37;302.72;15.16;1102;78;5164.00;111
13806;76;626524385;13806;366;14904;15015;6.11;0.37;302.77;15.16;1098;78;5165.00;111
13807;76;626524404;13807;367;14906;15018;6.14;0.37;302.75;15.16;1099;78;5166.00;112
13808;76;626524424;13808;364;14906;15018;6.19;0.38;302.81;15.16;1098;78;5167.00;112
13811;76;626524443;13811;355;14907;15018;6.17;0.38;302.79;15.16;1096;78;5168.00;111
13812;76;626524459;13812;359;14907;15018;6.18;0.38;302.81;15.16;1095;78;5169.00;111
13813;76;626524478;13813;353;14910;15022;6.25;0.38;302.84;15.16;1097;78;5170.00;112
13816;76;626524497;13816;355;14910;15022;6.25;0.38;302.80;15.16;1094;78;5171.00;112
13817;76;626524515;13817;346;14911;15022;6.28;0.38;302.83;15.16;1094;78;5172.00;111
13823;76;626524531;13823;340;14911;15022;6.29;0.38;302.79;15.16;1088;78;5173.00;111
13824;76;626524547;13824;343;14911;15023;6.30;0.38;302.80;15.16;1087;78;5174.00;112
13827;76;626524565;13827;348;14913;15025;6.28;0.38;302.82;15.15;1086;78;5175.00;112
13830;76;626524584;13830;353;14913;15025;6.22;0.38;302.85;15.15;1083;78;5176.00;112
13831;76;626524602;13831;344;14914;15026;6.24;0.38;302.83;15.15;1083;78;5177.00;112
13833;77;626524620;13833;343;14914;15026;6.25;0.38;302.82;15.15;1081;79;5178.00;112
13836;77;626524656;13836;340;14914;15026;6.24;0.38;302.92;15.15;1078;79;5179.00;112
13836;77;626524671;13836;335;14914;15026;6.25;0.38;302.92;15.15;1078;79;5180.00;112
13837;77;626524685;13837;333;14914;15026;6.20;0.38;302.95;15.15;1077;79;5181.00;112
13838;77;626524699;13838;340;14914;15026;6.11;0.37;302.96;15.15;1076;79;5182.00;112
13838;77;626524713;13838;336;14914;15026;6.09;0.37;302.96;15.15;1076;79;5183.00;112
13841;77;626524726;13841;364;14985;15153;6.10;0.38;302.94;15.08;1144;79;5184.00;168
13843;77;626524750;13843;353;14985;15154;6.13;0.38;302.93;15.08;1142;79;5185.00;169
13845;77;626524765;13845;343;14991;15154;6.23;0.38;302.92;15.08;1146;79;5186.00;163
13848;77;626524784;13848;347;14996;15154;6.28;0.39;302.97;15.07;1148;79;5187.00;158
13851;77;626524798;13851;345;15001;15154;6.27;0.39;302.95;15.07;1150;79;5188.00;153
13853;77;626524813;13853;349;15005;15154;6.29;0.39;302.95;15.07;1152;79;5189.00;149
13854;77;626524830;13854;350;15010;15154;6.33;0.39;302.95;15.06;1156;79;5190.00;144
13854;77;626524847;13854;361;15013;15154;6.30;0.39;302.95;15.06;1159;79;5191.00;141
13857;77;626524867;13857;364;15017;15155;6.30;0.39;302.95;15.06;1160;79;5192.00;138
13859;77;626524882;13859;363;15020;15156;6.29;0.39;302.95;15.06;1161;79;5193.00;136
13859;77;626524896;13859;365;15022;15156;6.31;0.39;302.95;15.06;1163;79;5194.00;134
13862;77;626524911;13862;366;15022;15157;6.21;0.38;302.95;15.06;1160;79;5195.00;135
13863;77;626524931;13863;361;15024;15157;6.16;0.38;303.03;15.06;1161;79;5196.00;133
13865;77;626524947;13865;351;15025;15157;6.13;0.38;303.04;15.06;1160;79;5197.00;132
13869;77;626524961;13869;359;15027;15157;6.09;0.38;303.06;15.06;1158;79;5198.00;130
13871;77;626524979;13871;358;15028;15161;6.04;0.37;303.04;15.05;1157;79;5199.00;133
13874;77;626524994;13874;355;15029;15161;5.98;0.37;303.03;15.06;1155;79;5200.00;132
13878;77;626525016;13878;355;15032;15161;5.89;0.36;303.04;15.11;1154;79;5201.00;129
13881;77;626525039;13881;347;15034;15164;5.79;0.36;303.00;15.11;1153;79;5202.00;130
13881;77;626525054;13881;336;15036;15164;5.73;0.35;303.00;15.11;1155;79;5203.00;128
13887;77;626525069;13887;335;15036;15164;5.61;0.34;302.97;15.11;1149;79;5204.00;128
13888;77;626525098;13888;332;15042;15168;5.52;0.34;302.97;15.14;1154;79;5205.00;126
13892;77;626525123;13892;331;15043;15169;5.48;0.34;302.98;15.14;1151;79;5206.00;126
13896;77;626525145;13896;334;15044;15169;5.38;0.33;303.00;15.14;1148;79;5207.00;125
13900;77;626525168;13900;326;15046;15173;5.34;0.33;302.98;15.14;1146;79;5208.00;127
13904;77;626525190;13904;328;15047;15173;5.30;0.32;302.91;15.14;1143;79;5209.00;126
13906;77;626525207;13906;325;15047;15173;5.32;0.33;302.96;15.14;1141;79;5210.00;126
13909;77;626525222;13909;328;15048;15174;5.32;0.32;302.93;15.14;1139;79;5211.00;126
13911;77;626525236;13911;333;15049;15174;5.30;0.32;302.90;15.14;1138;79;5212.00;125
13913;77;626525251;13913;330;15052;15180;5.31;0.32;302.93;15.13;1139;79;5213.00;128
13914;77;626525265;13914;332;15053;15180;5.37;0.33;302.91;15.13;1139;79;5214.00;127
13917;77;626525280;13917;344;15054;15180;5.37;0.33;302.87;15.13;1137;79;5215.00;126
13919;77;626525293;13919;348;15055;15181;5.34;0.33;302.84;15.19;1136;79;5216.00;126
13921;77;626525306;13921;345;15056;15181;5.32;0.32;302.82;15.19;1135;79;5217.00;125
13923;77;626525319;13923;349;15056;15181;5.27;0.32;302.78;15.19;1133;79;5218.00;125
13926;77;626525333;13926;356;15058;15181;5.24;0.32;302.84;15.19;1132;79;5219.00;123
13927;77;626525348;13927;351;15078;15217;5.34;0.33;302.83;15.17;1151;79;5220.00;139
13927;77;626525364;13927;349;15078;15217;5.35;0.33;302.83;15.17;1151;79;5221.00;139
13931;77;626525383;13931;351;15082;15217;5.33;0.33;302.80;15.23;1151;79;5222.00;135
13931;77;626525397;13931;349;15082;15217;5.37;0.33;302.80;15.23;1151;79;5223.00;135
13933;77;626525410;13933;355;15083;15217;5.37;0.33;302.80;15.23;1150;79;5224.00;134
13933;77;626525430;13933;358;15085;15217;5.39;0.33;302.80;15.23;1152;79;5225.00;132
13933;77;626525443;13933;360;15088;15221;5.47;0.33;302.80;15.22;1155;79;5226.00;133
13935;77;626525457;13935;361;15089;15221;5.52;0.34;302.78;15.22;1154;79;5227.00;132
13936;77;626525471;13936;361;15092;15225;5.61;0.34;302.76;15.22;1156;79;5228.00;133
13937;77;626525485;13937;368;15095;15226;5.67;0.35;302.75;15.23;1158;79;5229.00;131
13939;77;626525499;13939;369;15097;15226;5.67;0.35;302.79;15.23;1158;79;5230.00;129
13939;77;626525513;13939;372;15098;15226;5.69;0.35;302.79;15.23;1159;79;5231.00;128
13942;77;626525527;13942;376;15110;15239;5.65;0.34;302.75;15.25;1168;79;5232.00;129
13942;77;626525543;13942;371;15110;15239;5.64;0.34;302.75;15.25;1168;79;5233.00;129
13945;77;626525557;13945;382;15113;15239;5.58;0.34;302.79;15.27;1168;79;5234.00;126
13947;77;626525570;13947;373;15115;15240;5.57;0.34;302.77;15.28;1168;79;5235.00;125
13947;77;626525590;13947;363;15116;15241;5.64;0.34;302.77;15.29;1169;79;5236.00;125
13949;77;626525605;13949;364;15118;15241;5.66;0.34;302.80;15.30;1169;79;5237.00;123
13950;77;626525619;13950;358;15122;15244;5.72;0.35;302.79;15.31;1172;79;5238.00;122
13952;77;626525634;13952;349;15123;15244;5.74;0.35;302.77;15.32;1171;79;5239.00;121
13952;77;626525648;13952;355;15124;15244;5.76;0.35;302.77;15.32;1172;79;5240.00;120
13953;77;626525662;13953;351;15125;15244;5.79;0.35;302.77;15.33;1172;79;5241.00;119
13953;77;626525676;13953;341;15129;15250;5.85;0.36;302.77;15.33;1176;79;5242.00;121
13954;77;626525690;13954;349;15130;15250;5.82;0.35;302.75;15.33;1176;79;5243.00;120
13955;77;626525710;13955;352;15132;15250;5.78;0.35;302.76;15.35;1177;79;5244.00;118
13955;77;626525723;13955;353;15133;15250;5.75;0.35;302.76;15.35;1178;79;5245.00;117
13957;77;626525737;13957;358;15137;15254;5.64;0.35;302.72;15.36;1180;79;5246.00;117
13959;77;626525751;13959;360;15139;15255;5.59;0.34;302.69;15.36;1180;79;5247.00;116
13960;77;626525765;13960;370;15139;15255;5.52;0.34;302.69;15.36;1179;79;5248.00;116
13961;77;626525778;13961;364;15142;15256;5.51;0.34;302.68;15.38;1181;79;5249.00;114
13962;77;626525794;13962;371;15142;15256;5.50;0.34;302.69;15.38;1180;79;5250.00;114
13962;77;626525807;13962;369;15144;15256;5.49;0.34;302.69;15.39;1182;79;5251.00;112
13964;77;626525821;13964;370;15144;15256;5.49;0.33;302.68;15.39;1180;79;5252.00;112
13964;77;626525834;13964;371;15145;15256;5.48;0.33;302.68;15.40;1181;79;5253.00;111
13966;77;626525848;13966;372;15146;15256;5.53;0.34;302.67;15.41;1180;79;5254.00;110
13967;77;626525861;13967;372;15146;15256;5.58;0.34;302.66;15.41;1179;79;5255.00;110
13969;77;626525875;13969;379;15187;15326;5.82;0.36;302.66;15.38;1218;79;5256.00;139
13970;77;626525894;13970;380;15190;15327;5.86;0.36;302.64;15.38;1220;79;5257.00;137
13972;77;626525909;13972;375;15199;15327;5.90;0.36;302.62;15.37;1227;79;5258.00;128
13974;77;626525923;13974;376;15205;15327;5.89;0.36;302.60;15.38;1231;79;5259.00;122
13975;77;626525937;13975;377;15210;15327;5.90;0.36;302.63;15.38;1235;79;5260.00;117
13975;77;626525951;13975;377;15214;15327;5.88;0.36;302.63;15.39;1239;79;5261.00;113
13983;77;626525965;13983;390;15217;15327;5.77;0.35;302.69;15.40;1234;79;5262.00;110
13985;77;626525980;13985;387;15217;15327;5.75;0.35;302.69;15.40;1232;79;5263.00;110
13991;77;626525994;13991;385;15220;15328;5.68;0.35;302.71;15.42;1229;79;5264.00;108
13994;77;626526008;13994;391;15224;15330;5.64;0.34;302.70;15.44;1230;79;5265.00;106
13996;77;626526024;13996;393;15224;15330;5.59;0.34;302.72;15.44;1228;79;5266.00;106
14003;77;626526038;14003;394;15229;15334;5.50;0.34;302.74;15.46;1226;79;5267.00;105
14009;77;626526053;14009;393;15230;15334;5.36;0.33;302.73;15.48;1221;79;5268.00;104
14011;77;626526067;14011;395;15230;15334;5.25;0.32;302.74;15.48;1219;79;5269.00;104
14015;77;626526081;14015;387;15231;15334;5.14;0.31;302.78;15.49;1216;79;5270.00;103
14018;77;626526096;14018;389;15235;15340;5.17;0.32;302.77;15.49;1217;79;5271.00;105
14021;77;626526111;14021;383;15237;15340;5.15;0.31;302.82;15.51;1216;79;5272.00;103
14024;77;626526125;14024;385;15239;15340;5.15;0.32;302.87;15.52;1215;79;5273.00;101
14028;77;626526140;14028;386;15241;15343;5.19;0.32;302.90;15.52;1213;79;5274.00;102
14030;77;626526155;14030;394;15242;15343;5.22;0.32;302.95;15.52;1212;79;5275.00;101
14033;77;626526169;14033;401;15243;15343;5.28;0.32;302.93;15.53;1210;79;5276.00;100
14036;77;626526184;14036;394;15244;15344;5.34;0.33;302.98;15.53;1208;79;5277.00;100
14040;77;626526199;14040;395;15245;15345;5.41;0.33;303.07;15.53;1205;79;5278.00;100
14042;77;626526214;14042;399;15246;15345;5.51;0.34;303.09;15.54;1204;79;5279.00;99
14048;77;626526232;14048;400;15266;15371;5.54;0.34;303.14;15.52;1218;79;5280.00;105
14050;77;626526251;14050;392;15267;15371;5.63;0.34;303.13;15.52;1217;79;5281.00;104
14053;77;626526267;14053;395;15268;15371;5.73;0.35;303.19;15.51;1215;79;5282.00;103
14058;77;626526282;14058;383;15269;15372;5.83;0.36;303.27;15.51;1211;79;5283.00;103
14060;77;626526298;14060;387;15269;15372;5.95;0.36;303.30;15.51;1209;79;5284.00;103
14064;77;626526315;14064;373;15273;15376;6.06;0.37;303.36;15.51;1209;79;5285.00;103
14072;77;626526331;14072;373;15273;15376;6.12;0.37;303.49;15.51;1201;79;5286.00;103
14073;77;626526348;14073;366;15276;15379;6.20;0.38;303.47;15.51;1203;79;5287.00;103
14080;77;626526363;14080;367;15276;15380;6.22;0.38;303.57;15.51;1196;79;5288.00;104
14086;77;626526379;14086;364;15276;15380;6.23;0.38;303.58;15.51;1190;79;5289.00;104
14088;77;626526394;14088;360;15276;15380;6.26;0.38;303.58;15.51;1188;79;5290.00;104
14092;77;626526416;14092;357;15276;15380;6.26;0.38;303.61;15.51;1184;79;5291.00;104
14097;77;626526432;14097;354;15285;15392;6.30;0.38;303.70;15.50;1188;79;5292.00;107
14102;77;626526448;14102;360;15286;15392;6.30;0.38;303.71;15.50;1184;79;5293.00;106
14108;77;626526464;14108;354;15287;15392;6.33;0.38;303.85;15.50;1179;79;5294.00;105
14109;77;626526481;14109;353;15287;15392;6.38;0.39;303.88;15.50;1178;79;5295.00;105
14113;77;626526497;14113;361;15287;15392;6.40;0.39;303.95;15.50;1174;79;5296.00;105
14116;77;626526513;14116;363;15287;15392;6.43;0.39;303.98;15.50;1171;79;5297.00;105
14118;77;626526528;14118;359;15287;15393;6.50;0.40;304.04;15.50;1169;79;5298.00;106
14126;77;626526544;14126;364;15287;15393;6.46;0.39;304.19;15.50;1161;79;5299.00;106
14131;77;626526560;14131;365;15291;15399;6.52;0.40;304.17;15.49;1160;79;5300.00;108
14136;77;626526579;14136;369;15293;15400;6.56;0.40;304.21;15.49;1157;79;5301.00;107
14139;77;626526594;14139;374;15293;15400;6.59;0.40;304.25;15.49;1154;79;5302.00;107
14149;77;626526609;14149;382;15293;15400;6.54;0.40;304.29;15.49;1144;79;5303.00;107
14153;77;626526624;14153;379;15296;15404;6.55;0.40;304.31;15.49;1143;79;5304.00;108
14158;77;626526639;14158;384;15296;15404;6.53;0.40;304.37;15.49;1138;79;5305.00;108
14160;77;626526655;14160;381;15297;15404;6.49;0.39;304.39;15.55;1137;79;5306.00;107
14168;77;626526670;14168;380;15298;15405;6.42;0.39;304.51;15.55;1130;79;5307.00;107
14172;77;626526685;14172;370;15301;15409;6.43;0.39;304.54;15.55;1129;79;5308.00;108
14176;77;626526700;14176;377;15301;15409;6.41;0.39;304.56;15.55;1125;79;5309.00;108
14180;77;626526716;14180;384;15304;15415;6.44;0.39;304.60;15.54;1124;79;5310.00;111
14184;77;626526731;14184;384;15305;15415;6.36;0.39;304.69;15.54;1121;79;5311.00;110
14188;77;626526746;14188;393;15305;15415;6.29;0.38;304.77;15.54;1117;79;5312.00;110
14193;77;626526760;14193;389;15306;15415;6.28;0.38;304.83;15.54;1113;79;5313.00;109
14196;77;626526774;14196;404;15308;15419;6.25;0.38;304.85;15.54;1112;79;5314.00;111
14198;77;626526790;14198;404;15309;15419;6.26;0.38;304.89;15.54;1111;79;5315.00;110
14200;77;626526803;14200;409;15309;15419;6.18;0.38;304.94;15.54;1109;79;5316.00;110
14205;77;626526822;14205;399;15310;15419;6.12;0.37;304.96;15.54;1105;79;5317.00;109
14209;77;626526836;14209;398;15310;15420;6.03;0.37;304.96;15.54;1101;79;5318.00;110
14212;77;626526850;14212;399;15312;15421;6.02;0.37;305.04;15.54;1100;79;5319.00;109
14216;77;626526865;14216;398;15312;15421;5.98;0.36;305.11;15.54;1096;79;5320.00;109
14220;77;626526878;14220;398;15313;15422;5.96;0.36;305.12;15.54;1093;79;5321.00;109
14224;77;626526893;14224;397;15313;15422;5.95;0.36;305.16;15.54;1089;79;5322.00;109
14228;77;626526913;14228;401;15313;15422;5.97;0.36;305.17;15.54;1085;79;5323.00;109
14231;77;626526927;14231;405;15313;15422;5.97;0.36;305.16;15.54;1082;79;5324.00;109
14234;77;626526941;14234;400;15313;15422;5.96;0.36;305.22;15.54;1079;79;5325.00;109
14237;77;626526960;14237;390;15313;15422;5.94;0.36;305.25;15.54;1076;79;5326.00;109
14240;77;626526975;14240;384;15313;15422;5.91;0.36;305.28;15.54;1073;79;5327.00;109
14240;77;626526988;14240;402;15380;15549;6.02;0.37;305.28;15.47;1140;79;5328.00;169
14244;77;626527012;14244;381;15382;15550;6.04;0.37;305.35;15.47;1138;79;5329.00;168
14245;78;626527026;14245;373;15391;15550;6.14;0.38;305.36;15.52;1146;80;5330.00;159
14246;78;626527048;14246;368;15394;15550;6.26;0.38;305.36;15.52;1148;80;5331.00;156
14248;78;626527062;14248;360;15398;15550;6.34;0.39;305.42;15.52;1150;80;5332.00;152
14249;78;626527080;14249;358;15401;15550;6.44;0.40;305.41;15.52;1152;80;5333.00;149
14253;78;626527103;14253;353;15405;15550;6.48;0.40;305.47;15.51;1152;80;5334.00;145
14256;78;626527126;14256;354;15410;15550;6.60;0.41;305.50;15.51;1154;80;5335.00;140
14257;78;626527147;14257;356;15416;15551;6.70;0.41;305.49;15.51;1159;80;5336.00;135
14262;78;626527169;14262;346;15419;15552;6.70;0.41;305.55;15.51;1157;80;5337.00;133
14263;78;626527195;14263;345;15420;15552;6.71;0.41;305.54;15.51;1157;80;5338.00;132
14266;78;626527211;14266;341;15421;15553;6.68;0.41;305.53;15.51;1155;80;5339.00;132
14268;78;626527229;14268;339;15424;15553;6.67;0.41;305.55;15.51;1156;80;5340.00;129
14272;78;626527245;14272;341;15425;15553;6.67;0.41;305.56;15.51;1153;80;5341.00;128
14275;78;626527262;14275;337;15427;15553;6.66;0.41;305.65;15.51;1152;80;5342.00;126
14277;78;626527278;14277;336;15430;15557;6.64;0.41;305.68;15.50;1153;80;5343.00;127
14280;78;626527294;14280;342;15432;15557;6.60;0.41;305.65;15.50;1152;80;5344.00;125
14280;78;626527309;14280;355;15432;15557;6.58;0.40;305.65;15.50;1152;80;5345.00;125
14283;78;626527324;14283;358;15435;15560;6.54;0.40;305.65;15.50;1152;80;5346.00;125
14285;78;626527345;14285;356;15436;15560;6.48;0.40;305.62;15.50;1151;80;5347.00;124
14289;78;626527359;14289;367;15438;15560;6.38;0.39;305.67;15.50;1149;80;5348.00;122
14290;78;626527373;14290;370;15442;15564;6.29;0.39;305.66;15.57;1152;80;5349.00;122
14292;78;626527389;14292;375;15444;15565;6.24;0.38;305.66;15.57;1152;80;5350.00;121
14293;78;626527403;14293;384;15445;15565;6.17;0.38;305.65;15.64;1152;80;5351.00;120
14293;78;626527417;14293;390;15449;15569;6.14;0.38;305.65;15.63;1156;80;5352.00;120
14293;78;626527431;14293;398;15449;15569;6.10;0.37;305.65;15.63;1156;80;5353.00;120
14297;78;626527446;14297;400;15450;15569;6.01;0.37;305.65;15.70;1153;80;5354.00;119
14300;78;626527460;14300;411;15452;15571;5.93;0.36;305.64;15.70;1152;80;5355.00;119
14301;78;626527476;14301;418;15452;15571;5.85;0.36;305.65;15.70;1151;80;5356.00;119
14303;78;626527490;14303;425;15457;15577;5.80;0.35;305.64;15.76;1154;80;5357.00;120
14306;78;626527504;14306;436;15457;15577;5.73;0.35;305.67;15.76;1151;80;5358.00;120
14307;78;626527518;14307;442;15458;15577;5.69;0.35;305.66;15.76;1151;80;5359.00;119
14314;78;626527531;14314;435;15458;15578;5.59;0.34;305.61;15.76;1144;80;5360.00;120
14314;78;626527544;14314;439;15458;15578;5.52;0.34;305.61;15.76;1144;80;5361.00;120
14316;78;626527557;14316;440;15458;15578;5.43;0.33;305.58;15.76;1142;80;5362.00;120
14317;78;626527570;14317;440;15458;15578;5.36;0.33;305.60;15.76;1141;80;5363.00;120
14320;78;626527582;14320;447;15466;15590;5.32;0.33;305.72;15.75;1146;80;5364.00;124
14323;78;626527597;14323;443;15466;15590;5.26;0.32;305.69;15.75;1143;80;5365.00;124
14325;78;626527610;14325;445;15469;15590;5.27;0.32;305.68;15.81;1144;80;5366.00;121
14326;78;626527624;14326;441;15469;15590;5.24;0.32;305.66;15.81;1143;80;5367.00;121
14328;78;626527635;14328;445;15469;15590;5.19;0.32;305.63;15.81;1141;80;5368.00;121
14332;78;626527648;14332;444;15469;15590;5.14;0.32;305.63;15.81;1137;80;5369.00;121
14336;78;626527663;14336;437;15472;15594;5.10;0.31;305.59;15.81;1136;80;5370.00;122
14343;78;626527676;14343;430;15472;15594;5.04;0.31;305.61;15.81;1129;80;5371.00;122
14349;78;626527689;14349;424;15475;15598;5.01;0.31;305.56;15.81;1126;80;5372.00;123
14350;78;626527702;14350;419;15476;15599;5.05;0.31;305.56;15.81;1126;80;5373.00;123
14351;78;626527713;14351;409;15478;15599;5.08;0.31;305.54;15.82;1127;80;5374.00;121
14354;78;626527727;14354;403;15479;15599;5.07;0.31;305.54;15.84;1125;80;5375.00;120
14356;78;626527739;14356;397;15490;15612;5.08;0.31;305.53;15.83;1134;80;5376.00;122
14360;78;626527753;14360;393;15490;15612;5.04;0.31;305.50;15.83;1130;80;5377.00;122
14363;78;626527765;14363;394;15492;15612;5.00;0.31;305.51;15.90;1129;80;5378.00;120
14365;78;626527776;14365;400;15493;15613;5.00;0.31;305.51;15.90;1128;80;5379.00;120
14369;78;626527789;14369;396;15493;15614;4.98;0.30;305.48;15.90;1124;80;5380.00;121
14370;78;626527801;14370;395;15494;15614;5.03;0.31;305.46;15.96;1124;80;5381.00;120
14372;78;626527814;14372;394;15496;15617;5.07;0.31;305.46;15.96;1124;80;5382.00;121
14374;78;626527826;14374;396;15497;15617;5.11;0.31;305.46;15.96;1123;80;5383.00;120
14377;78;626527838;14377;396;15498;15617;5.08;0.31;305.46;16.03;1121;80;5384.00;119
14379;78;626527851;14379;403;15498;15617;5.08;0.31;305.48;16.03;1119;80;5385.00;119
14380;78;626527863;14380;393;15502;15623;5.13;0.31;305.46;16.02;1122;80;5386.00;121
14382;78;626527875;14382;387;15502;15623;5.16;0.31;305.45;16.02;1120;80;5387.00;121
14384;78;626527889;14384;371;15503;15623;5.20;0.32;305.52;16.02;1119;80;5388.00;120
14385;78;626527901;14385;367;15503;15623;5.23;0.32;305.52;16.02;1118;80;5389.00;120
14388;78;626527913;14388;371;15507;15627;5.25;0.32;305.55;16.02;1119;80;5390.00;120
14389;78;626527927;14389;369;15508;15628;5.30;0.32;305.54;16.02;1119;80;5391.00;120
14391;78;626527939;14391;353;15508;15628;5.36;0.32;305.52;16.02;1117;80;5392.00;120
14394;78;626527953;14394;351;15509;15629;5.42;0.33;305.48;16.02;1115;80;5393.00;120
14394;78;626527972;14394;340;15509;15629;5.52;0.33;305.48;16.02;1115;80;5394.00;120
14395;78;626527985;14395;331;15509;15629;5.60;0.34;305.52;16.02;1114;80;5395.00;120
14397;78;626527998;14397;328;15509;15629;5.69;0.34;305.52;16.02;1112;80;5396.00;120
14398;78;626528011;14398;321;15509;15629;5.73;0.35;305.51;16.02;1111;80;5397.00;120
14399;78;626528031;14399;325;15509;15629;5.77;0.35;305.51;16.02;1110;80;5398.00;120
14399;78;626528045;14399;323;15509;15629;5.85;0.35;305.51;16.02;1110;80;5399.00;120
