step_arrived;step_collisions;step_duration;step_ended;step_halting;step_inserted;step_loaded;step_meanSpeed;step_meanSpeedRelative;step_meanTravelTime;step_meanWaitingTime;step_running;step_teleports;step_time;step_waiting
0;0;626381440;0;1;87;245;16.46;1.16;-1.00;0.00;87;0;0.00;158
0;0;626381470;0;0;98;245;15.75;1.09;-1.00;0.11;98;0;1.00;147
0;0;626381472;0;1;117;245;14.94;1.02;-1.00;0.42;117;0;2.00;128
0;0;626381473;0;1;135;245;13.69;0.92;-1.00;0.76;135;0;3.00;110
0;0;626381475;0;1;147;245;12.70;0.85;-1.00;1.03;147;0;4.00;98
0;0;626381478;0;5;156;245;11.90;0.80;-1.00;1.26;156;0;5.00;89
0;0;626381479;0;5;166;245;11.14;0.74;-1.00;1.54;166;0;6.00;79
0;0;626381481;0;10;172;245;10.54;0.70;-1.00;1.73;172;0;7.00;73
0;0;626381483;0;17;178;246;10.08;0.67;-1.00;1.94;178;0;8.00;68
0;0;626381485;0;18;184;247;9.73;0.65;-1.00;2.17;184;0;9.00;63
0;0;626381487;0;16;189;247;9.50;0.63;-1.00;2.38;189;0;10.00;58
0;0;626381490;0;23;194;248;9.34;0.62;-1.00;2.52;194;0;11.00;54
0;0;626381492;0;25;198;248;9.29;0.61;-1.00;2.71;198;0;12.00;50
1;0;626381495;1;31;204;248;9.09;0.59;13.00;3.01;203;0;13.00;44
1;0;626381499;1;33;206;248;9.12;0.59;13.00;3.12;205;0;14.00;42
1;0;626381502;1;36;213;252;9.08;0.59;13.00;3.38;212;0;15.00;39
1;1;626381505;1;42;215;252;9.10;0.59;13.00;3.49;214;1;16.00;37
1;1;626381525;1;45;218;252;9.15;0.58;13.00;3.68;217;1;17.00;34
1;1;626381528;1;48;222;255;9.22;0.58;13.00;3.86;221;1;18.00;33
2;1;626381541;2;52;224;255;9.30;0.59;16.00;3.99;222;1;19.00;31
2;1;626381544;2;57;226;255;9.47;0.60;16.00;4.13;224;1;20.00;29
3;1;626381547;3;59;233;259;9.55;0.60;17.67;4.24;230;1;21.00;26
3;1;626381550;3;64;240;260;9.55;0.60;17.67;4.67;237;1;22.00;20
3;1;626381553;3;67;242;260;9.46;0.59;17.67;4.78;239;1;23.00;18
4;1;626381557;4;72;246;264;9.31;0.58;19.25;4.84;242;1;24.00;18
4;1;626381568;4;76;249;264;9.15;0.57;19.25;5.01;245;1;25.00;15
6;1;626381572;6;79;251;264;9.05;0.56;21.17;5.08;245;1;26.00;13
7;1;626381575;7;84;254;265;8.97;0.56;22.00;5.17;247;1;27.00;11
7;1;626381578;7;86;255;265;9.00;0.56;22.00;5.25;248;1;28.00;10
7;1;626381581;7;90;262;271;8.87;0.55;22.00;5.35;255;1;29.00;9
7;1;626381587;7;91;262;271;8.87;0.55;22.00;5.35;255;1;30.00;9
8;1;626381590;8;94;266;272;8.79;0.54;22.75;5.52;258;1;31.00;6
8;1;626381594;8;97;266;272;8.94;0.55;22.75;5.52;258;1;32.00;6
9;1;626381596;9;102;267;272;8.91;0.55;23.89;5.54;258;1;33.00;5
9;1;626381600;9;105;267;272;8.89;0.55;23.89;5.54;258;1;34.00;5
11;1;626381603;11;113;268;272;8.78;0.54;25.00;5.65;257;1;35.00;4
11;1;626381606;11;115;279;284;9.01;0.56;25.00;5.42;268;1;36.00;5
11;1;626381610;11;117;280;284;8.97;0.56;25.00;5.41;269;1;37.00;4
11;1;626381613;11;118;280;284;8.85;0.55;25.00;5.41;269;1;38.00;4
11;1;626381617;11;119;280;284;8.75;0.54;25.00;5.41;269;1;39.00;4
13;1;626381620;13;121;280;284;8.47;0.53;26.69;5.41;267;1;40.00;4
13;1;626381623;13;125;280;284;8.33;0.52;26.69;5.41;267;1;41.00;4
13;1;626381626;13;128;284;288;8.26;0.51;26.69;5.35;271;1;42.00;4
14;1;626381631;14;131;284;288;8.10;0.50;27.71;5.35;270;1;43.00;4
15;1;626381635;15;133;287;292;8.04;0.50;27.40;5.30;272;1;44.00;5
15;1;626381638;15;137;289;294;7.99;0.50;27.40;5.26;274;1;45.00;5
16;1;626381643;16;141;290;294;7.88;0.49;28.00;5.26;274;1;46.00;4
16;1;626381646;16;140;290;294;7.84;0.49;28.00;5.26;274;1;47.00;4
16;1;626381649;16;142;301;307;8.07;0.50;28.00;5.06;285;1;48.00;6
16;1;626381653;16;146;301;307;7.92;0.49;28.00;5.06;285;1;49.00;6
19;1;626381656;19;145;301;307;7.74;0.48;31.05;5.06;282;1;50.00;6
19;1;626381659;19;148;302;308;7.61;0.47;31.05;5.05;283;1;51.00;6
19;1;626381662;19;152;303;309;7.47;0.46;31.05;5.04;284;1;52.00;6
19;1;626381665;19;156;303;309;7.41;0.46;31.05;5.04;284;1;53.00;6
19;1;626381668;19;156;305;312;7.39;0.46;31.05;5.00;286;1;54.00;7
19;1;626381671;19;156;305;312;7.28;0.45;31.05;5.00;286;1;55.00;7
22;1;626381674;22;145;306;312;7.14;0.44;31.82;4.99;284;1;56.00;6
23;1;626381677;23;140;306;312;7.13;0.44;32.83;4.99;283;1;57.00;6
23;1;626381679;23;141;310;318;7.28;0.45;32.83;4.94;287;1;58.00;8
23;1;626381683;23;144;310;318;7.36;0.45;32.83;4.94;287;1;59.00;8
24;1;626381687;24;143;312;318;7.36;0.45;33.96;4.93;288;1;60.00;6
24;1;626381691;24;145;312;318;7.36;0.45;33.96;4.93;288;1;61.00;6
26;1;626381695;26;150;316;322;7.38;0.45;36.12;4.88;290;1;62.00;6
27;1;626381702;27;150;317;323;7.48;0.46;37.00;4.86;290;1;63.00;6
27;1;626381706;27;150;317;323;7.62;0.47;37.00;4.86;290;1;64.00;6
27;1;626381709;27;150;318;324;7.76;0.48;37.00;4.85;291;1;65.00;6
28;1;626381713;28;152;318;324;7.78;0.48;36.54;4.85;290;1;66.00;6
29;1;626381716;29;145;318;324;7.86;0.48;36.38;4.85;289;1;67.00;6
30;1;626381719;30;142;318;324;7.92;0.48;37.37;4.85;288;1;68.00;6
30;1;626381722;30;137;318;324;7.99;0.49;37.37;4.85;288;1;69.00;6
31;1;626381725;31;131;318;324;8.10;0.49;38.42;4.85;287;1;70.00;6
31;1;626381728;31;128;318;324;8.26;0.50;38.42;4.85;287;1;71.00;6
31;1;626381731;31;135;353;394;8.34;0.51;38.42;4.37;322;1;72.00;41
32;1;626381741;32;128;354;395;8.43;0.52;39.34;4.36;322;1;73.00;41
32;1;626381753;32;123;361;395;8.81;0.54;39.34;4.32;329;1;74.00;34
33;1;626381756;33;120;365;395;9.06;0.55;40.42;4.30;332;1;75.00;30
34;1;626381760;34;117;371;395;9.41;0.57;41.47;4.30;337;1;76.00;24
35;1;626381764;35;115;374;395;9.52;0.58;42.29;4.30;339;1;77.00;21
35;1;626381775;35;114;377;395;9.62;0.59;42.29;4.32;342;1;78.00;18
35;1;626381790;35;114;378;395;9.63;0.58;42.29;4.32;343;1;79.00;17
35;1;626381794;35;116;380;396;9.70;0.59;42.29;4.32;345;1;80.00;16
35;1;626381800;35;119;381;397;9.66;0.59;42.29;4.31;346;1;81.00;16
35;1;626381804;35;119;382;397;9.63;0.59;42.29;4.33;347;1;82.00;15
35;1;626381808;35;123;386;401;9.45;0.58;42.29;4.29;351;1;83.00;15
37;1;626381813;37;124;386;401;9.31;0.57;44.08;4.29;349;1;84.00;15
38;1;626381818;38;128;386;401;9.17;0.56;45.16;4.29;348;1;85.00;15
40;1;626381822;40;129;386;401;9.04;0.55;47.20;4.29;346;1;86.00;15
41;1;626381827;41;130;390;407;8.93;0.54;48.10;4.26;349;1;87.00;17
42;1;626381831;42;133;390;407;8.79;0.53;49.05;4.26;348;1;88.00;17
43;1;626381835;43;138;391;407;8.72;0.53;49.98;4.26;348;1;89.00;16
43;1;626381840;43;139;394;413;8.61;0.52;49.98;4.22;351;1;90.00;19
43;1;626381851;43;140;395;413;8.54;0.52;49.98;4.22;352;1;91.00;18
44;1;626381854;44;140;395;413;8.51;0.52;50.93;4.22;351;1;92.00;18
46;1;626381858;46;140;397;414;8.36;0.51;52.57;4.20;351;1;93.00;17
51;1;626381862;51;138;398;415;8.30;0.51;55.22;4.20;347;1;94.00;17
51;1;626381866;51;138;399;415;8.36;0.51;55.22;4.20;348;1;95.00;16
54;1;626381870;54;140;409;428;8.29;0.50;57.39;4.10;355;1;96.00;19
55;1;626381875;55;141;410;428;8.37;0.51;58.11;4.09;355;1;97.00;18
55;1;626381879;55;142;410;428;8.43;0.51;58.11;4.09;355;1;98.00;18
58;1;626381883;58;137;411;429;8.54;0.52;60.22;4.08;353;1;99.00;18
58;1;626381889;58;136;411;429;8.60;0.52;60.22;4.08;353;1;100.00;18
60;1;626381898;60;131;413;433;8.69;0.53;61.53;4.06;353;1;101.00;20
61;1;626381903;61;124;413;433;8.74;0.53;62.10;4.06;352;1;102.00;20
62;1;626381908;62;119;418;437;8.79;0.53;62.76;4.03;356;1;103.00;19
63;1;626381912;63;115;418;437;8.89;0.54;63.41;4.03;355;1;104.00;19
63;1;626381917;63;110;418;437;9.09;0.55;63.41;4.03;355;1;105.00;19
64;1;626381922;64;103;418;437;9.28;0.57;64.05;4.03;354;1;106.00;19
64;1;626381927;64;98;418;437;9.45;0.58;64.05;4.03;354;1;107.00;19
65;1;626381932;65;90;429;449;9.63;0.59;64.71;3.93;364;1;108.00;20
66;1;626381937;66;81;430;449;9.68;0.59;65.38;3.92;364;1;109.00;19
66;1;626381942;66;81;430;449;9.73;0.59;65.38;3.92;364;1;110.00;19
66;1;626381946;66;78;430;449;9.85;0.60;65.38;3.92;364;1;111.00;19
66;1;626381951;66;75;430;449;10.03;0.61;65.38;3.92;364;1;112.00;19
66;1;626381957;66;70;430;449;10.26;0.63;65.38;3.92;364;1;113.00;19
66;1;626381962;66;72;431;450;10.50;0.64;65.38;3.91;365;1;114.00;19
66;1;626381967;66;74;431;450;10.62;0.65;65.38;3.91;365;1;115.00;19
68;1;626381972;68;72;435;456;10.81;0.66;66.53;3.89;367;1;116.00;21
68;1;626381978;68;71;438;457;10.95;0.67;66.53;4.13;370;1;117.00;19
69;1;626381984;69;72;438;457;11.08;0.68;67.28;4.13;369;1;118.00;19
70;1;626381990;70;71;438;457;11.26;0.69;68.00;4.13;368;1;119.00;19
76;1;626381998;76;74;444;462;11.42;0.70;71.36;4.45;368;1;120.00;18
76;1;626382004;76;73;445;462;11.57;0.71;71.36;4.56;369;1;121.00;17
78;1;626382010;78;74;448;462;11.55;0.70;71.72;5.02;370;1;122.00;14
79;1;626382016;79;76;449;463;11.58;0.70;72.33;5.01;370;1;123.00;14
79;1;626382022;79;79;454;467;11.49;0.70;72.33;5.24;375;1;124.00;13
79;1;626382028;79;80;456;467;11.59;0.71;72.33;5.45;377;1;125.00;11
82;1;626382033;82;83;458;470;11.69;0.71;73.56;5.42;376;1;126.00;12
82;1;626382040;82;87;462;470;11.77;0.72;73.56;5.76;380;1;127.00;8
83;1;626382046;83;88;462;470;11.86;0.72;74.07;5.76;379;1;128.00;8
85;1;626382052;85;89;463;470;11.84;0.72;75.33;5.81;378;1;129.00;7
86;1;626382058;86;93;467;474;11.87;0.72;75.84;5.97;381;1;130.00;7
86;1;626382065;86;92;467;474;11.95;0.73;75.84;5.97;381;1;131.00;7
87;1;626382071;87;89;470;474;12.09;0.74;76.28;6.07;383;1;132.00;4
90;1;626382077;90;88;471;474;12.09;0.74;77.92;6.19;381;1;133.00;3
91;1;626382083;91;89;472;475;12.14;0.74;78.52;6.18;381;1;134.00;3
92;1;626382089;92;92;475;477;12.12;0.74;77.96;6.22;383;1;135.00;2
92;1;626382096;92;94;475;477;12.22;0.75;77.96;6.22;383;1;136.00;2
93;1;626382102;93;96;476;478;12.33;0.76;78.59;6.21;383;1;137.00;2
95;1;626382108;95;99;477;478;12.40;0.76;79.36;6.29;382;1;138.00;1
97;1;626382115;97;99;477;478;12.42;0.76;79.85;6.29;380;1;139.00;1
101;1;626382121;101;100;478;478;12.27;0.75;81.92;6.31;377;1;140.00;0
101;1;626382127;101;100;478;478;12.09;0.74;81.92;6.31;377;1;141.00;0
103;1;626382133;103;100;478;478;11.85;0.73;82.72;6.31;375;1;142.00;0
105;1;626382140;105;103;478;478;11.63;0.71;82.93;6.31;373;1;143.00;0
108;1;626382146;108;125;549;605;11.14;0.70;83.32;5.50;441;1;144.00;56
108;1;626382163;108;119;555;606;11.11;0.70;83.32;5.45;447;1;145.00;51
110;1;626382175;110;118;563;606;11.05;0.69;83.60;5.40;453;1;146.00;43
112;1;626382181;112;123;566;606;10.94;0.69;84.73;5.39;454;1;147.00;40
113;1;626382189;113;120;570;606;10.92;0.69;85.29;5.38;457;1;148.00;36
114;1;626382197;114;118;573;606;10.92;0.69;85.22;5.38;459;1;149.00;33
116;1;626382207;116;122;575;611;10.85;0.68;85.98;5.37;459;1;150.00;36
117;2;626382218;117;122;577;611;10.85;0.68;86.54;5.38;460;2;151.00;34
119;2;626382249;119;122;580;612;10.92;0.68;87.48;5.39;461;2;152.00;32
121;2;626382257;121;122;581;613;10.90;0.68;87.37;5.40;460;2;153.00;32
124;2;626382265;124;124;584;613;10.94;0.68;88.85;5.42;460;2;154.00;29
125;2;626382273;125;126;586;614;10.82;0.67;89.26;5.42;461;2;155.00;28
126;2;626382280;126;130;591;614;10.79;0.67;88.64;5.47;465;2;156.00;23
128;2;626382286;128;133;592;614;10.69;0.67;89.56;5.48;464;2;157.00;22
129;2;626382293;129;140;596;614;10.76;0.67;90.09;5.54;467;2;158.00;18
131;2;626382301;131;144;600;618;10.72;0.67;91.05;5.58;469;2;159.00;18
133;2;626382307;133;149;604;618;10.61;0.66;91.92;5.65;471;2;160.00;14
135;2;626382314;135;152;605;618;10.43;0.65;92.06;5.67;470;2;161.00;13
136;2;626382320;136;152;608;621;10.25;0.63;92.49;5.71;472;2;162.00;13
138;2;626382326;138;155;611;621;10.13;0.63;93.49;5.74;473;2;163.00;10
142;2;626382333;142;154;613;621;9.94;0.61;94.76;5.75;471;2;164.00;8
142;3;626382352;142;158;617;625;9.82;0.61;94.76;5.72;475;3;165.00;8
144;3;626382377;144;152;618;626;9.78;0.60;95.58;5.72;474;3;166.00;8
145;3;626382384;145;150;618;626;9.71;0.60;95.94;5.72;473;3;167.00;8
148;3;626382391;148;150;623;630;9.61;0.59;96.52;5.71;475;3;168.00;7
151;3;626382397;151;151;624;630;9.41;0.58;97.27;5.71;473;3;169.00;6
153;3;626382410;153;144;625;630;9.36;0.58;97.14;5.73;472;3;170.00;5
154;3;626382417;154;134;627;631;9.38;0.58;97.45;5.75;473;3;171.00;4
155;3;626382430;155;127;627;631;9.39;0.58;97.89;5.75;472;3;172.00;4
155;3;626382443;155;128;633;637;9.43;0.58;97.89;5.75;478;3;173.00;4
155;3;626382450;155;126;634;637;9.44;0.58;97.89;5.76;479;3;174.00;3
157;3;626382457;157;129;635;638;9.48;0.58;98.30;5.76;478;3;175.00;3
158;3;626382464;158;129;636;638;9.58;0.59;98.77;5.75;478;3;176.00;2
158;3;626382470;158;129;637;638;9.63;0.59;98.77;5.79;479;3;177.00;1
159;3;626382477;159;124;638;638;9.68;0.60;98.52;5.79;479;3;178.00;0
160;3;626382483;160;117;638;638;9.75;0.60;98.87;5.79;478;3;179.00;0
162;3;626382491;162;113;669;672;9.72;0.60;99.40;5.52;507;3;180.00;3
162;3;626382499;162;112;670;672;9.78;0.60;99.40;5.51;508;3;181.00;2
164;3;626382506;164;113;671;672;9.76;0.60;100.39;5.51;507;3;182.00;1
165;3;626382512;165;121;672;672;9.83;0.61;100.12;5.50;507;3;183.00;0
167;3;626382519;167;127;672;672;9.87;0.61;100.25;5.50;505;3;184.00;0
168;3;626382526;168;136;672;672;9.87;0.61;100.47;5.50;504;3;185.00;0
170;3;626382532;170;141;676;676;9.88;0.61;100.95;5.48;506;3;186.00;0
170;3;626382539;170;146;676;676;9.85;0.61;100.95;5.48;506;3;187.00;0
171;3;626382545;171;148;679;680;9.79;0.60;101.10;5.46;508;3;188.00;1
173;3;626382551;173;155;680;681;9.67;0.60;101.14;5.45;507;3;189.00;1
175;3;626382558;175;160;681;681;9.57;0.59;101.34;5.44;506;3;190.00;0
179;3;626382565;179;162;681;681;9.44;0.58;102.10;5.44;502;3;191.00;0
181;3;626382571;181;173;694;694;9.43;0.58;102.24;5.34;513;3;192.00;0
184;3;626382579;184;173;694;694;9.23;0.57;102.64;5.34;510;3;193.00;0
186;3;626382586;186;179;694;694;9.15;0.57;102.42;5.34;508;3;194.00;0
189;3;626382593;189;182;695;695;9.17;0.57;102.36;5.34;506;3;195.00;0
194;4;626382600;194;186;696;696;9.09;0.56;101.92;5.33;502;4;196.00;0
196;4;626382625;196;190;696;696;9.01;0.56;101.39;5.33;500;4;197.00;0
200;4;626382633;200;190;698;699;8.94;0.55;101.15;5.32;498;4;198.00;1
202;4;626382647;202;196;699;699;8.79;0.54;101.22;5.31;497;4;199.00;0
203;4;626382656;203;199;699;699;8.65;0.53;101.69;5.31;496;4;200.00;0
205;4;626382669;205;204;699;699;8.56;0.53;101.67;5.31;494;4;201.00;0
207;5;626382676;207;205;704;705;8.43;0.52;101.70;5.28;497;5;202.00;1
208;5;626382701;208;211;704;705;8.25;0.51;102.18;5.28;496;5;203.00;1
209;5;626382708;209;220;705;705;8.14;0.50;101.85;5.28;496;5;204.00;0
211;5;626382720;211;224;705;705;8.03;0.49;101.29;5.28;494;5;205.00;0
212;5;626382726;212;227;709;709;8.01;0.49;101.42;5.25;497;5;206.00;0
215;5;626382732;215;227;710;710;7.89;0.48;101.58;5.24;495;5;207.00;0
218;5;626382739;218;233;710;710;7.72;0.47;102.23;5.24;492;5;208.00;0
220;5;626382745;220;236;711;711;7.58;0.46;103.19;5.24;491;5;209.00;0
222;5;626382753;222;241;711;711;7.47;0.46;103.23;5.24;489;5;210.00;0
222;5;626382759;222;247;711;711;7.45;0.46;103.23;5.24;489;5;211.00;0
223;5;626382765;223;254;711;711;7.43;0.46;102.88;5.24;488;5;212.00;0
223;5;626382771;223;261;711;711;7.38;0.46;102.88;5.24;488;5;213.00;0
225;5;626382776;225;259;711;711;7.31;0.45;102.80;5.24;486;5;214.00;0
226;5;626382782;226;258;711;711;7.31;0.45;103.23;5.24;485;5;215.00;0
227;5;626382788;227;269;754;781;7.51;0.47;103.54;4.94;527;5;216.00;27
227;5;626382800;227;255;756;782;7.58;0.47;103.54;4.93;529;5;217.00;26
228;5;626382807;228;247;762;782;7.66;0.47;104.04;4.91;534;5;218.00;20
229;5;626382814;229;231;766;782;7.81;0.48;103.90;4.90;537;5;219.00;16
230;5;626382821;230;217;769;782;8.04;0.50;104.41;4.89;539;5;220.00;13
232;5;626382827;232;205;773;782;8.24;0.51;104.79;4.89;541;5;221.00;9
232;5;626382834;232;198;778;782;8.48;0.52;104.79;4.90;546;5;222.00;4
233;5;626382841;233;194;780;782;8.68;0.53;105.03;4.91;547;5;223.00;2
236;5;626382849;236;193;782;783;8.79;0.54;105.77;4.90;546;5;224.00;1
238;5;626382857;238;188;784;785;8.89;0.55;106.75;4.89;546;5;225.00;1
240;5;626382865;240;171;785;785;9.01;0.55;107.73;4.90;545;5;226.00;0
241;5;626382872;241;161;789;789;9.09;0.56;107.80;4.88;548;5;227.00;0
244;6;626382881;244;144;789;789;9.26;0.57;108.54;4.88;545;6;228.00;0
244;6;626382904;244;138;789;789;9.43;0.58;108.54;4.88;545;6;229.00;0
247;6;626382917;247;126;789;789;9.54;0.58;109.98;4.88;542;6;230.00;0
248;6;626382937;248;117;794;795;9.62;0.59;109.64;4.85;546;6;231.00;1
250;6;626382952;250;113;794;795;9.65;0.59;110.02;4.85;544;6;232.00;1
251;6;626382974;251;107;795;795;9.72;0.59;110.45;4.85;544;6;233.00;0
253;6;626382999;253;106;797;798;9.81;0.60;110.16;4.84;544;6;234.00;1
256;6;626383026;256;109;798;798;9.93;0.61;111.56;4.83;542;6;235.00;0
257;6;626383036;257;110;798;798;9.96;0.61;111.40;4.83;541;6;236.00;0
258;6;626383050;258;106;799;799;9.99;0.61;111.05;4.83;541;6;237.00;0
259;6;626383059;259;102;800;800;10.07;0.61;111.53;4.83;541;6;238.00;0
259;6;626383069;259;102;800;800;10.14;0.62;111.53;4.83;541;6;239.00;0
263;6;626383080;263;106;823;826;10.01;0.61;112.11;4.69;560;6;240.00;3
263;6;626383091;263;102;823;826;10.07;0.62;112.11;4.69;560;6;241.00;3
267;6;626383100;267;97;824;826;10.05;0.62;113.18;4.69;557;6;242.00;2
269;6;626383108;269;99;826;827;10.10;0.62;113.62;4.68;557;6;243.00;1
274;6;626383116;274;106;827;827;10.12;0.62;114.16;4.68;553;6;244.00;0
276;6;626383125;276;108;830;831;10.13;0.62;114.81;4.67;554;6;245.00;1
280;6;626383133;280;114;830;831;10.01;0.61;115.76;4.67;550;6;246.00;1
281;6;626383142;281;120;835;835;9.96;0.61;116.15;4.65;554;6;247.00;0
281;7;626383150;281;122;835;835;10.08;0.61;116.15;4.65;554;7;248.00;0
285;7;626383175;285;128;835;835;10.15;0.62;116.94;4.65;550;7;249.00;0
287;7;626383184;287;129;835;835;10.17;0.62;117.03;4.65;548;7;250.00;0
287;7;626383199;287;136;835;835;10.22;0.62;117.03;4.65;548;7;251.00;0
287;7;626383207;287;137;846;847;10.27;0.63;117.03;4.59;559;7;252.00;1
288;7;626383216;288;145;846;847;10.23;0.62;117.00;4.59;558;7;253.00;1
293;7;626383224;293;147;847;847;10.17;0.62;118.45;4.58;554;7;254.00;0
295;7;626383233;295;151;847;847;10.15;0.62;118.87;4.58;552;7;255.00;0
296;8;626383242;296;154;847;847;10.15;0.62;118.69;4.58;551;8;256.00;0
297;8;626383264;297;157;847;847;10.12;0.62;118.81;4.58;550;8;257.00;0
298;8;626383276;298;158;848;848;10.10;0.61;119.26;4.58;550;8;258.00;0
298;8;626383289;298;161;848;848;10.10;0.61;119.26;4.58;550;8;259.00;0
299;8;626383303;299;155;853;854;10.04;0.61;119.31;4.56;554;8;260.00;1
300;8;626383311;300;150;854;855;10.11;0.61;119.31;4.55;554;8;261.00;1
302;8;626383319;302;145;855;855;10.06;0.61;119.18;4.55;553;8;262.00;0
304;8;626383327;304;146;855;855;10.05;0.61;119.65;4.55;551;8;263.00;0
306;8;626383336;306;142;859;859;10.00;0.60;119.89;4.53;553;8;264.00;0
307;8;626383344;307;141;859;859;10.04;0.61;120.01;4.53;552;8;265.00;0
310;8;626383351;310;136;859;859;10.12;0.61;120.61;4.53;549;8;266.00;0
311;8;626383359;311;133;860;860;10.24;0.62;120.61;4.52;549;8;267.00;0
315;8;626383367;315;135;864;864;10.30;0.63;121.08;4.51;549;8;268.00;0
318;8;626383375;318;132;864;864;10.36;0.63;121.18;4.51;546;8;269.00;0
323;8;626383385;323;128;867;870;10.44;0.63;121.85;4.49;544;8;270.00;3
323;8;626383395;323;123;867;870;10.52;0.64;121.85;4.49;544;8;271.00;3
328;8;626383402;328;113;868;870;10.62;0.64;122.80;4.49;540;8;272.00;2
330;8;626383411;330;106;868;870;10.79;0.65;122.84;4.49;538;8;273.00;2
333;8;626383419;333;102;871;874;10.95;0.66;123.53;4.48;538;8;274.00;3
335;9;626383427;335;101;871;874;11.06;0.67;123.72;4.48;536;9;275.00;3
337;9;626383443;337;95;872;874;11.19;0.68;123.64;4.48;535;9;276.00;2
339;9;626383452;339;93;872;874;11.34;0.69;123.94;4.48;533;9;277.00;2
340;9;626383460;340;89;874;875;11.45;0.69;123.86;4.48;534;9;278.00;1
342;9;626383470;342;87;875;876;11.54;0.70;123.91;4.47;533;9;279.00;1
343;9;626383479;343;83;876;876;11.59;0.70;123.84;4.48;533;9;280.00;0
346;9;626383491;346;81;877;877;11.66;0.70;123.95;4.47;531;9;281.00;0
347;9;626383500;347;81;877;877;11.73;0.71;124.15;4.47;530;9;282.00;0
348;9;626383509;348;80;877;877;11.75;0.71;123.99;4.47;529;9;283.00;0
350;9;626383519;350;80;877;877;11.79;0.71;123.77;4.47;527;9;284.00;0
351;9;626383528;351;79;877;877;11.86;0.72;124.13;4.47;526;9;285.00;0
353;9;626383536;353;79;877;877;11.92;0.72;124.50;4.47;524;9;286.00;0
353;9;626383544;353;80;877;877;11.96;0.73;124.50;4.47;524;9;287.00;0
354;9;626383553;354;99;947;1004;11.58;0.71;124.95;4.15;593;9;288.00;57
355;9;626383575;355;86;950;1005;11.62;0.72;125.26;4.14;595;9;289.00;55
355;9;626383585;355;75;958;1005;11.68;0.72;125.26;4.12;603;9;290.00;47
357;9;626383593;357;75;962;1005;11.67;0.72;125.28;4.11;605;9;291.00;43
358;9;626383603;358;81;966;1005;11.72;0.72;125.68;4.11;608;9;292.00;39
358;9;626383611;358;84;969;1005;11.83;0.73;125.68;4.12;611;9;293.00;36
360;9;626383620;360;85;972;1005;11.96;0.74;126.19;4.12;612;9;294.00;33
363;9;626383628;363;84;975;1005;12.11;0.74;126.31;4.13;612;9;295.00;30
368;9;626383637;368;82;978;1006;12.28;0.75;125.96;4.14;610;9;296.00;28
370;9;626383656;370;82;981;1007;12.42;0.76;126.55;4.16;611;9;297.00;26
372;9;626383666;372;84;984;1007;12.45;0.76;126.25;4.17;612;9;298.00;23
373;9;626383675;373;85;987;1008;12.38;0.76;126.38;4.20;614;9;299.00;21
375;9;626383689;375;88;992;1014;12.23;0.75;127.10;4.23;617;9;300.00;22
376;9;626383706;376;91;994;1014;12.12;0.74;127.56;4.25;618;9;301.00;20
376;9;626383717;376;97;998;1014;12.02;0.74;127.56;4.28;622;9;302.00;16
379;9;626383733;379;107;1003;1018;11.95;0.74;128.40;4.31;624;9;303.00;15
380;10;626383744;380;112;1006;1018;11.93;0.73;128.47;4.32;626;10;304.00;12
383;10;626383778;383;119;1007;1018;11.82;0.73;128.91;4.33;624;10;305.00;11
385;10;626383788;385;127;1010;1021;11.79;0.72;129.03;4.33;625;10;306.00;11
388;10;626383805;388;132;1010;1021;11.76;0.72;129.46;4.33;622;10;307.00;11
388;10;626383814;388;139;1011;1021;11.74;0.72;129.46;4.34;623;10;308.00;10
388;10;626383824;388;144;1015;1025;11.62;0.71;129.46;4.33;627;10;309.00;10
389;10;626383834;389;148;1016;1026;11.53;0.71;129.92;4.33;627;10;310.00;10
390;10;626383852;390;153;1016;1026;11.35;0.70;129.92;4.33;626;10;311.00;10
393;10;626383861;393;152;1020;1030;11.26;0.69;129.66;4.31;627;10;312.00;10
394;10;626383871;394;154;1020;1030;11.11;0.68;129.58;4.31;626;10;313.00;10
396;10;626383880;396;156;1021;1030;10.93;0.67;130.38;4.32;625;10;314.00;9
399;10;626383890;399;164;1024;1032;10.78;0.66;130.72;4.32;625;10;315.00;8
401;10;626383900;401;168;1024;1032;10.60;0.65;130.95;4.32;623;10;316.00;8
408;10;626383908;408;171;1028;1038;10.39;0.64;131.78;4.31;620;10;317.00;10
409;10;626383917;409;178;1028;1038;10.24;0.63;132.23;4.31;619;10;318.00;10
411;10;626383926;411;178;1029;1039;10.09;0.62;132.73;4.31;618;10;319.00;10
414;10;626383934;414;176;1031;1039;9.97;0.61;133.27;4.35;617;10;320.00;8
417;10;626383943;417;181;1032;1039;9.92;0.61;133.40;4.36;615;10;321.00;7
419;10;626383950;419;184;1034;1039;9.85;0.60;133.84;4.39;615;10;322.00;5
422;10;626383958;422;192;1035;1039;9.85;0.60;134.30;4.40;613;10;323.00;4
425;10;626383968;425;194;1046;1051;9.87;0.60;134.57;4.39;621;10;324.00;5
430;10;626383978;430;194;1047;1051;9.83;0.60;136.01;4.39;617;10;325.00;4
434;10;626383993;434;193;1050;1051;9.79;0.60;136.33;4.43;616;10;326.00;1
435;10;626384006;435;195;1050;1051;9.79;0.60;136.44;4.43;615;10;327.00;1
439;10;626384015;439;193;1051;1051;9.72;0.59;137.29;4.43;612;10;328.00;0
440;10;626384029;440;193;1051;1051;9.75;0.59;137.23;4.43;611;10;329.00;0
440;10;626384039;440;197;1055;1055;9.73;0.59;137.23;4.41;615;10;330.00;0
441;10;626384048;441;199;1055;1055;9.70;0.59;137.67;4.41;614;10;331.00;0
443;10;626384056;443;204;1058;1059;9.65;0.59;137.89;4.40;615;10;332.00;1
446;10;626384064;446;209;1060;1060;9.58;0.58;138.47;4.40;614;10;333.00;0
451;10;626384072;451;210;1060;1060;9.46;0.58;139.83;4.40;609;10;334.00;0
452;10;626384080;452;212;1060;1060;9.31;0.57;140.26;4.40;608;10;335.00;0
454;10;626384088;454;216;1072;1073;9.16;0.56;140.32;4.35;618;10;336.00;1
458;10;626384098;458;221;1072;1073;8.92;0.55;140.86;4.35;614;10;337.00;1
461;10;626384105;461;226;1073;1073;8.69;0.53;141.26;4.34;612;10;338.00;0
464;10;626384111;464;232;1074;1074;8.42;0.52;142.04;4.34;610;10;339.00;0
471;10;626384119;471;228;1075;1075;8.15;0.50;142.46;4.34;604;10;340.00;0
475;10;626384126;475;227;1075;1075;8.04;0.49;143.33;4.34;600;10;341.00;0
477;10;626384133;477;225;1077;1078;7.98;0.49;143.52;4.33;600;10;342.00;1
480;10;626384140;480;224;1078;1078;7.91;0.48;144.19;4.33;598;10;343.00;0
482;10;626384147;482;226;1078;1078;7.85;0.48;144.06;4.33;596;10;344.00;0
484;10;626384154;484;231;1078;1078;7.77;0.48;144.40;4.33;594;10;345.00;0
486;10;626384161;486;230;1083;1084;7.72;0.48;144.77;4.31;597;10;346.00;1
487;10;626384170;487;227;1083;1084;7.68;0.47;145.18;4.31;596;10;347.00;1
491;10;626384177;491;224;1084;1084;7.63;0.47;145.87;4.31;593;10;348.00;0
492;10;626384185;492;224;1084;1084;7.69;0.48;146.27;4.31;592;10;349.00;0
494;10;626384192;494;220;1088;1088;7.72;0.48;146.12;4.30;594;10;350.00;0
498;10;626384199;498;218;1089;1089;7.73;0.48;146.12;4.29;591;10;351.00;0
501;10;626384206;501;222;1089;1089;7.72;0.48;145.65;4.29;588;10;352.00;0
505;10;626384213;505;222;1090;1090;7.75;0.48;145.03;4.29;585;10;353.00;0
507;10;626384226;507;226;1090;1090;7.75;0.48;145.08;4.29;583;10;354.00;0
513;10;626384232;513;228;1090;1090;7.71;0.48;145.75;4.29;577;10;355.00;0
517;10;626384239;517;230;1090;1090;7.61;0.47;145.56;4.29;573;10;356.00;0
518;10;626384246;518;229;1090;1090;7.61;0.47;145.55;4.29;572;10;357.00;0
522;10;626384252;522;227;1090;1090;7.54;0.46;146.20;4.29;568;10;358.00;0
526;10;626384259;526;229;1090;1090;7.42;0.46;146.76;4.29;564;10;359.00;0
527;10;626384268;527;244;1157;1215;7.67;0.48;146.69;4.04;630;10;360.00;58
531;10;626384284;531;242;1165;1216;7.61;0.48;147.09;4.02;634;10;361.00;51
535;10;626384292;535;239;1178;1216;7.75;0.48;147.87;4.00;643;10;362.00;38
538;10;626384299;538;245;1184;1216;7.76;0.48;148.25;3.99;646;10;363.00;32
541;10;626384307;541;249;1190;1216;7.77;0.48;148.26;3.99;649;10;364.00;26
544;10;626384315;544;255;1194;1216;7.60;0.47;148.44;4.00;650;10;365.00;22
546;10;626384327;546;251;1200;1216;7.54;0.47;148.64;4.01;654;10;366.00;16
546;10;626384335;546;257;1201;1216;7.48;0.46;148.64;4.01;655;10;367.00;15
547;10;626384343;547;262;1205;1217;7.45;0.46;148.52;4.02;658;10;368.00;12
549;10;626384351;549;267;1206;1218;7.35;0.46;149.05;4.02;657;10;369.00;12
552;10;626384359;552;273;1208;1218;7.26;0.45;149.02;4.03;656;10;370.00;10
552;10;626384367;552;267;1215;1222;7.25;0.45;149.02;4.03;663;10;371.00;7
555;10;626384375;555;261;1216;1222;7.24;0.45;148.67;4.04;661;10;372.00;6
556;10;626384383;556;260;1218;1222;7.26;0.45;148.77;4.05;662;10;373.00;4
558;10;626384392;558;258;1219;1222;7.36;0.45;148.95;4.06;661;10;374.00;3
560;10;626384400;560;249;1225;1228;7.45;0.46;148.93;4.06;665;10;375.00;3
560;10;626384409;560;247;1225;1228;7.62;0.47;148.93;4.06;665;10;376.00;3
562;10;626384418;562;241;1226;1228;7.75;0.48;148.72;4.06;664;10;377.00;2
564;10;626384434;564;240;1228;1231;7.86;0.48;148.62;4.05;664;10;378.00;3
565;10;626384443;565;238;1229;1231;7.94;0.48;148.77;4.06;664;10;379.00;2
565;10;626384452;565;239;1230;1231;8.03;0.49;148.77;4.06;665;10;380.00;1
567;10;626384461;567;236;1232;1232;8.06;0.49;149.26;4.07;665;10;381.00;0
569;11;626384469;569;235;1233;1233;8.13;0.50;148.82;4.07;664;11;382.00;0
573;11;626384489;573;234;1233;1233;8.14;0.49;148.92;4.07;660;11;383.00;0
573;11;626384498;573;233;1246;1246;8.24;0.50;148.92;4.03;673;11;384.00;0
573;11;626384512;573;232;1246;1246;8.29;0.50;148.92;4.03;673;11;385.00;0
573;11;626384521;573;238;1246;1246;8.28;0.50;148.92;4.03;673;11;386.00;0
575;11;626384529;575;230;1247;1247;8.30;0.51;148.74;4.02;672;11;387.00;0
576;11;626384539;576;229;1247;1247;8.37;0.51;148.85;4.02;671;11;388.00;0
578;11;626384554;578;227;1251;1251;8.35;0.51;148.78;4.01;673;11;389.00;0
578;11;626384566;578;225;1251;1251;8.41;0.51;148.78;4.01;673;11;390.00;0
580;11;626384575;580;221;1255;1255;8.43;0.51;148.77;4.00;675;11;391.00;0
582;11;626384585;582;222;1255;1255;8.55;0.52;149.09;4.00;673;11;392.00;0
583;11;626384595;583;217;1255;1255;8.67;0.53;149.26;4.00;672;11;393.00;0
585;11;626384604;585;213;1255;1255;8.72;0.53;149.83;4.00;670;11;394.00;0
586;11;626384614;586;214;1255;1255;8.76;0.53;150.11;4.00;669;11;395.00;0
590;11;626384628;590;199;1267;1267;8.87;0.54;151.02;3.97;677;11;396.00;0
592;11;626384640;592;191;1267;1267;8.99;0.55;151.26;3.97;675;11;397.00;0
596;11;626384649;596;181;1267;1267;9.08;0.55;151.74;3.97;671;11;398.00;0
598;11;626384658;598;175;1267;1267;9.12;0.56;152.20;3.97;669;11;399.00;0
601;11;626384669;601;171;1267;1267;9.18;0.56;152.16;3.97;666;11;400.00;0
602;11;626384685;602;162;1267;1267;9.20;0.56;152.20;3.97;665;11;401.00;0
605;11;626384695;605;157;1268;1268;9.25;0.57;152.14;3.96;663;11;402.00;0
608;11;626384705;608;159;1268;1268;9.35;0.57;152.40;3.96;660;11;403.00;0
608;11;626384714;608;163;1273;1274;9.43;0.58;152.40;3.95;665;11;404.00;1
612;11;626384724;612;167;1276;1276;9.52;0.58;153.23;3.95;664;11;405.00;0
616;11;626384734;616;173;1276;1276;9.59;0.59;153.37;3.95;660;11;406.00;0
618;11;626384744;618;169;1276;1276;9.63;0.59;153.92;3.95;658;11;407.00;0
623;11;626384753;623;167;1280;1280;9.62;0.59;154.72;3.93;657;11;408.00;0
626;11;626384762;626;165;1280;1280;9.68;0.59;154.91;3.93;654;11;409.00;0
628;11;626384771;628;163;1280;1280;9.70;0.59;155.52;3.93;652;11;410.00;0
632;11;626384780;632;165;1281;1281;9.82;0.60;156.24;3.93;649;11;411.00;0
636;11;626384789;636;160;1285;1285;9.86;0.60;157.08;3.92;649;11;412.00;0
637;12;626384799;637;165;1285;1285;9.88;0.60;157.39;3.92;648;12;413.00;0
640;12;626384824;640;161;1287;1288;10.05;0.61;157.83;3.92;647;12;414.00;1
643;12;626384833;643;159;1287;1288;10.15;0.62;158.70;3.92;644;12;415.00;1
646;12;626384842;646;160;1288;1288;10.34;0.63;158.91;3.91;642;12;416.00;0
648;12;626384851;648;157;1288;1288;10.40;0.63;159.19;3.91;640;12;417.00;0
649;12;626384865;649;159;1291;1292;10.40;0.64;159.57;3.91;642;12;418.00;1
652;12;626384874;652;162;1291;1292;10.47;0.64;160.32;3.91;639;12;419.00;1
654;12;626384885;654;161;1292;1292;10.55;0.65;160.77;3.91;638;12;420.00;0
658;13;626384899;658;162;1292;1292;10.62;0.65;161.36;3.91;634;13;421.00;0
661;14;626384946;661;159;1293;1293;10.63;0.65;161.97;3.90;632;14;422.00;0
664;14;626384972;664;158;1294;1294;10.80;0.66;162.55;3.90;630;14;423.00;0
668;14;626384986;668;162;1294;1294;10.83;0.66;163.02;3.90;626;14;424.00;0
670;14;626385007;670;166;1295;1295;10.87;0.66;163.14;3.90;625;14;425.00;0
673;15;626385019;673;165;1295;1295;10.86;0.66;163.79;3.90;622;15;426.00;0
674;15;626385044;674;169;1295;1295;10.82;0.66;163.78;3.90;621;15;427.00;0
676;15;626385058;676;168;1295;1295;10.73;0.65;163.84;3.90;619;15;428.00;0
679;15;626385069;679;169;1295;1295;10.67;0.65;163.77;3.90;616;15;429.00;0
680;15;626385079;680;163;1295;1295;10.61;0.65;163.74;3.90;615;15;430.00;0
686;15;626385089;686;156;1295;1295;10.59;0.64;164.88;3.90;609;15;431.00;0
687;15;626385100;687;188;1375;1422;9.97;0.62;164.94;3.67;688;15;432.00;47
691;15;626385122;691;171;1376;1423;10.00;0.62;165.59;3.67;685;15;433.00;47
696;15;626385132;696;150;1383;1423;10.16;0.63;166.03;3.66;687;15;434.00;40
696;15;626385142;696;149;1384;1423;10.22;0.63;166.03;3.66;688;15;435.00;39
699;15;626385152;699;143;1389;1423;10.28;0.63;166.41;3.66;690;15;436.00;34
701;15;626385163;701;139;1392;1423;10.36;0.64;166.70;3.67;691;15;437.00;31
702;15;626385172;702;140;1397;1423;10.46;0.64;166.64;3.68;695;15;438.00;26
706;15;626385181;706;142;1398;1423;10.54;0.65;167.23;3.68;692;15;439.00;25
708;15;626385192;708;143;1403;1424;10.63;0.65;167.38;3.69;695;15;440.00;21
712;15;626385202;712;143;1404;1425;10.63;0.65;167.59;3.70;692;15;441.00;21
715;15;626385213;715;142;1408;1425;10.68;0.65;167.60;3.72;693;15;442.00;17
720;15;626385224;720;138;1412;1426;10.63;0.65;167.83;3.73;692;15;443.00;14
724;15;626385234;724;135;1413;1426;10.59;0.65;168.22;3.74;689;15;444.00;13
727;15;626385245;727;130;1416;1426;10.50;0.64;168.03;3.75;689;15;445.00;10
728;15;626385256;728;123;1418;1426;10.47;0.64;167.93;3.76;690;15;446.00;8
731;15;626385267;731;121;1420;1430;10.37;0.63;168.62;3.76;689;15;447.00;10
733;15;626385278;733;119;1421;1430;10.31;0.63;169.06;3.77;688;15;448.00;9
736;15;626385289;736;116;1421;1430;10.35;0.63;169.03;3.77;685;15;449.00;9
739;15;626385302;739;119;1425;1436;10.37;0.63;169.04;3.77;686;15;450.00;11
741;15;626385313;741;114;1425;1436;10.37;0.63;169.08;3.77;684;15;451.00;11
744;15;626385324;744;114;1426;1436;10.44;0.63;169.41;3.79;682;15;452.00;10
746;15;626385336;746;115;1430;1440;10.43;0.63;169.50;3.78;684;15;453.00;10
747;15;626385346;747;118;1431;1441;10.47;0.64;169.68;3.78;684;15;454.00;10
747;15;626385356;747;116;1432;1441;10.53;0.64;169.68;3.78;685;15;455.00;9
751;15;626385366;751;117;1435;1445;10.60;0.65;169.89;3.78;684;15;456.00;10
753;15;626385376;753;122;1437;1445;10.69;0.65;169.78;3.80;684;15;457.00;8
755;15;626385386;755;125;1437;1445;10.79;0.66;169.96;3.80;682;15;458.00;8
755;15;626385396;755;123;1441;1446;10.82;0.66;169.96;3.82;686;15;459.00;5
757;15;626385406;757;120;1441;1446;10.82;0.66;169.77;3.82;684;15;460.00;5
760;15;626385416;760;122;1446;1452;10.77;0.66;169.55;3.83;686;15;461.00;6
762;15;626385427;762;124;1447;1452;10.82;0.66;169.64;3.83;685;15;462.00;5
768;15;626385438;768;124;1447;1453;10.75;0.66;169.66;3.83;679;15;463.00;6
769;15;626385449;769;127;1448;1453;10.73;0.65;169.73;3.85;679;15;464.00;5
772;15;626385459;772;131;1448;1453;10.67;0.65;170.07;3.85;676;15;465.00;5
773;15;626385469;773;132;1449;1453;10.67;0.65;170.17;3.85;676;15;466.00;4
775;15;626385480;775;132;1449;1453;10.67;0.65;170.16;3.85;674;15;467.00;4
778;15;626385497;778;136;1458;1465;10.69;0.65;170.18;3.83;680;15;468.00;7
778;15;626385510;778;137;1459;1465;10.71;0.65;170.18;3.83;681;15;469.00;6
782;15;626385521;782;139;1462;1465;10.81;0.66;170.24;3.84;680;15;470.00;3
784;15;626385533;784;141;1462;1465;10.90;0.66;170.28;3.84;678;15;471.00;3
786;15;626385545;786;142;1462;1465;10.96;0.67;170.22;3.84;676;15;472.00;3
789;15;626385557;789;148;1463;1465;11.05;0.67;170.15;3.85;674;15;473.00;2
792;15;626385570;792;150;1466;1469;11.04;0.67;170.12;3.84;674;15;474.00;3
794;15;626385585;794;156;1467;1469;11.12;0.68;170.19;3.85;673;15;475.00;2
797;16;626385598;797;158;1471;1473;11.16;0.68;170.43;3.85;674;16;476.00;2
800;16;626385626;800;164;1473;1474;11.26;0.68;170.66;3.84;673;16;477.00;1
800;16;626385648;800;165;1474;1474;11.22;0.68;170.66;3.84;674;16;478.00;0
803;16;626385672;803;171;1474;1474;11.13;0.68;170.77;3.84;671;16;479.00;0
806;16;626385685;806;177;1494;1500;10.90;0.66;170.77;3.79;688;16;480.00;6
810;16;626385698;810;178;1494;1500;10.67;0.65;170.90;3.79;684;16;481.00;6
812;16;626385710;812;183;1497;1500;10.59;0.65;170.86;3.79;685;16;482.00;3
812;16;626385721;812;188;1500;1501;10.53;0.65;170.86;3.78;688;16;483.00;1
812;16;626385731;812;192;1502;1502;10.50;0.64;170.86;3.78;690;16;484.00;0
814;16;626385742;814;193;1502;1502;10.37;0.63;170.74;3.78;688;16;485.00;0
815;16;626385752;815;200;1504;1505;10.29;0.63;170.68;3.78;689;16;486.00;1
816;16;626385763;816;208;1504;1505;10.18;0.62;170.63;3.78;688;16;487.00;1
817;16;626385773;817;218;1505;1505;10.08;0.62;170.56;3.78;688;16;488.00;0
819;16;626385783;819;218;1505;1505;10.02;0.61;170.31;3.78;686;16;489.00;0
821;16;626385793;821;217;1510;1511;10.03;0.61;170.60;3.77;689;16;490.00;1
823;16;626385804;823;219;1510;1511;9.94;0.61;170.57;3.77;687;16;491.00;1
825;16;626385815;825;217;1511;1511;9.88;0.60;170.56;3.77;686;16;492.00;0
826;16;626385825;826;219;1511;1511;9.82;0.60;170.51;3.77;685;16;493.00;0
827;16;626385835;827;219;1515;1515;9.71;0.59;170.38;3.76;688;16;494.00;0
830;16;626385845;830;224;1517;1517;9.62;0.59;170.07;3.75;687;16;495.00;0
833;16;626385855;833;226;1517;1517;9.50;0.58;169.84;3.75;684;16;496.00;0
834;16;626385866;834;230;1518;1518;9.47;0.58;170.04;3.75;684;16;497.00;0
835;16;626385877;835;236;1518;1518;9.39;0.57;169.92;3.75;683;16;498.00;0
836;16;626385891;836;238;1518;1518;9.38;0.58;169.88;3.75;682;16;499.00;0
840;16;626385906;840;245;1518;1518;9.29;0.57;169.51;3.75;678;16;500.00;0
845;16;626385920;845;241;1518;1518;9.20;0.56;169.54;3.75;673;16;501.00;0
848;16;626385930;848;245;1518;1518;9.05;0.55;169.83;3.75;670;16;502.00;0
849;16;626385939;849;246;1518;1518;9.00;0.55;170.12;3.75;669;16;503.00;0
852;16;626385947;852;255;1559;1588;9.13;0.56;170.15;3.65;707;16;504.00;29
858;16;626385962;858;256;1563;1589;9.01;0.55;170.63;3.65;705;16;505.00;26
864;16;626385972;864;255;1571;1589;8.83;0.54;170.39;3.64;707;16;506.00;18
867;16;626385980;867;257;1577;1589;8.74;0.53;170.98;3.64;710;16;507.00;12
868;16;626385989;868;263;1579;1589;8.59;0.53;171.27;3.64;711;16;508.00;10
870;16;626385997;870;267;1582;1589;8.44;0.52;171.89;3.64;712;16;509.00;7
873;16;626386007;873;257;1585;1589;8.36;0.51;172.40;3.64;712;16;510.00;4
874;16;626386017;874;254;1586;1589;8.29;0.51;172.26;3.65;712;16;511.00;3
875;16;626386025;875;252;1589;1590;8.20;0.50;172.56;3.65;714;16;512.00;1
877;16;626386034;877;251;1589;1591;8.10;0.50;172.60;3.65;712;16;513.00;2
881;16;626386043;881;246;1591;1591;8.00;0.49;173.39;3.65;710;16;514.00;0
883;16;626386051;883;246;1595;1595;7.93;0.48;173.27;3.65;712;16;515.00;0
885;16;626386061;885;253;1595;1595;7.89;0.48;173.53;3.65;710;16;516.00;0
888;16;626386070;888;252;1595;1595;7.95;0.49;173.86;3.65;707;16;517.00;0
891;16;626386079;891;249;1595;1595;8.01;0.49;174.20;3.65;704;16;518.00;0
895;16;626386088;895;253;1600;1601;8.09;0.49;174.85;3.64;705;16;519.00;1
896;16;626386098;896;253;1601;1601;8.13;0.50;174.83;3.64;705;16;520.00;0
900;16;626386107;900;255;1601;1601;8.14;0.50;175.15;3.64;701;16;521.00;0
901;16;626386116;901;259;1603;1604;8.14;0.50;175.21;3.63;702;16;522.00;1
903;16;626386126;903;242;1603;1604;8.16;0.50;175.40;3.63;700;16;523.00;1
906;16;626386135;906;231;1604;1604;8.19;0.50;175.58;3.63;698;16;524.00;0
908;16;626386145;908;228;1605;1605;8.23;0.50;175.98;3.63;697;16;525.00;0
914;16;626386155;914;222;1606;1606;8.32;0.51;176.10;3.63;692;16;526.00;0
918;16;626386165;918;217;1606;1606;8.44;0.52;176.11;3.63;688;16;527.00;0
922;16;626386175;922;215;1618;1619;8.58;0.52;175.91;3.60;696;16;528.00;1
927;16;626386186;927;209;1618;1619;8.64;0.53;176.46;3.60;691;16;529.00;1
930;16;626386202;930;204;1619;1619;8.76;0.53;176.26;3.60;689;16;530.00;0
931;16;626386218;931;203;1620;1620;8.89;0.54;176.44;3.60;689;16;531.00;0
934;16;626386229;934;197;1620;1620;8.99;0.55;176.90;3.60;686;16;532.00;0
935;16;626386239;935;201;1623;1624;9.09;0.55;177.09;3.59;688;16;533.00;1
939;16;626386251;939;195;1623;1624;9.11;0.55;177.22;3.59;684;16;534.00;1
943;16;626386262;943;196;1627;1628;9.12;0.56;177.27;3.59;684;16;535.00;1
946;16;626386273;946;192;1627;1628;8.98;0.55;177.36;3.59;681;16;536.00;1
950;16;626386284;950;191;1627;1628;8.85;0.54;177.47;3.59;677;16;537.00;1
952;16;626386294;952;193;1628;1628;8.75;0.53;177.75;3.59;676;16;538.00;0
956;16;626386311;956;197;1628;1628;8.69;0.53;178.23;3.59;672;16;539.00;0
957;16;626386323;957;210;1657;1662;8.80;0.54;178.35;3.53;700;16;540.00;5
961;16;626386338;961;204;1657;1662;8.79;0.54;178.71;3.53;696;16;541.00;5
962;16;626386348;962;199;1659;1662;8.92;0.55;178.88;3.52;697;16;542.00;3
966;16;626386358;966;197;1659;1662;8.96;0.55;179.14;3.52;693;16;543.00;3
971;16;626386368;971;197;1660;1662;8.98;0.55;179.04;3.52;689;16;544.00;2
976;16;626386379;976;200;1660;1662;9.00;0.55;179.15;3.52;684;16;545.00;2
978;16;626386391;978;208;1662;1663;9.11;0.56;179.43;3.52;684;16;546.00;1
984;16;626386401;984;207;1662;1663;9.15;0.56;179.48;3.52;678;16;547.00;1
986;16;626386412;986;206;1667;1669;9.15;0.56;179.49;3.52;681;16;548.00;2
991;16;626386423;991;206;1668;1670;9.18;0.56;179.43;3.52;677;16;549.00;2
994;16;626386433;994;210;1669;1670;9.22;0.56;179.41;3.52;675;16;550.00;1
997;16;626386444;997;207;1669;1670;9.24;0.57;179.70;3.52;672;16;551.00;1
998;16;626386455;998;210;1674;1674;9.28;0.57;179.64;3.51;676;16;552.00;0
1002;16;626386467;1002;212;1674;1674;9.23;0.57;179.99;3.51;672;16;553.00;0
1007;16;626386478;1007;214;1674;1674;9.16;0.56;180.14;3.51;667;16;554.00;0
1007;16;626386488;1007;220;1675;1675;9.10;0.56;180.14;3.51;668;16;555.00;0
1012;16;626386500;1012;226;1679;1679;9.03;0.55;179.99;3.50;667;16;556.00;0
1014;16;626386511;1014;217;1679;1679;8.99;0.55;180.31;3.50;665;16;557.00;0
1017;16;626386522;1017;212;1681;1682;8.95;0.55;180.44;3.50;664;16;558.00;1
1020;16;626386532;1020;207;1681;1682;8.94;0.55;180.94;3.50;661;16;559.00;1
1024;16;626386542;1024;206;1682;1682;9.08;0.55;181.38;3.50;658;16;560.00;0
1027;16;626386552;1027;201;1682;1682;9.16;0.56;181.57;3.50;655;16;561.00;0
1030;16;626386564;1030;205;1685;1686;9.26;0.56;182.00;3.49;655;16;562.00;1
1035;16;626386576;1035;209;1685;1686;9.34;0.57;182.70;3.49;650;16;563.00;1
1036;16;626386587;1036;209;1686;1686;9.45;0.58;182.79;3.49;650;16;564.00;0
1039;16;626386598;1039;208;1686;1686;9.43;0.57;183.28;3.49;647;16;565.00;0
1042;16;626386614;1042;192;1687;1687;9.48;0.58;183.77;3.49;645;16;566.00;0
1044;16;626386631;1044;178;1688;1688;9.51;0.58;184.11;3.49;644;16;567.00;0
1049;16;626386642;1049;170;1688;1688;9.50;0.58;184.65;3.49;639;16;568.00;0
1050;16;626386654;1050;167;1689;1689;9.59;0.58;184.61;3.49;639;16;569.00;0
1053;16;626386666;1053;164;1689;1689;9.63;0.59;185.26;3.49;636;16;570.00;0
1056;16;626386678;1056;161;1689;1689;9.73;0.59;185.70;3.49;633;16;571.00;0
1058;16;626386690;1058;162;1689;1689;9.83;0.60;185.85;3.49;631;16;572.00;0
1061;16;626386700;1061;155;1689;1689;9.92;0.60;186.21;3.49;628;16;573.00;0
1065;16;626386712;1065;154;1689;1689;9.95;0.60;186.75;3.49;624;16;574.00;0
1065;16;626386723;1065;154;1689;1689;10.05;0.61;186.75;3.49;624;16;575.00;0
1067;16;626386733;1067;185;1769;1816;9.88;0.61;187.28;3.33;702;16;576.00;47
1070;16;626386757;1070;172;1772;1817;9.94;0.61;187.75;3.33;702;16;577.00;45
1073;16;626386769;1073;157;1778;1817;10.10;0.62;187.78;3.32;705;16;578.00;39
1075;16;626386780;1075;151;1784;1817;10.15;0.63;187.97;3.32;709;16;579.00;33
1078;16;626386790;1078;145;1788;1817;10.27;0.63;187.91;3.32;710;16;580.00;29
1082;16;626386802;1082;141;1793;1817;10.25;0.63;188.37;3.33;711;16;581.00;24
1084;16;626386818;1084;143;1797;1817;10.24;0.63;188.35;3.33;713;16;582.00;20
1086;16;626386829;1086;146;1801;1817;10.27;0.63;188.44;3.34;715;16;583.00;16
1090;16;626386840;1090;150;1804;1818;10.31;0.63;188.65;3.35;714;16;584.00;14
1092;16;626386852;1092;151;1808;1820;10.31;0.63;188.61;3.35;716;16;585.00;12
1094;16;626386863;1094;152;1810;1820;10.24;0.63;188.63;3.36;716;16;586.00;10
1097;16;626386874;1097;157;1812;1821;10.24;0.63;188.65;3.36;715;16;587.00;9
1099;16;626386885;1099;165;1814;1821;10.29;0.63;188.80;3.37;715;16;588.00;7
1103;16;626386911;1103;172;1815;1821;10.33;0.63;189.11;3.38;712;16;589.00;6
1106;16;626386931;1106;173;1817;1821;10.30;0.63;189.09;3.39;711;16;590.00;4
1108;17;626386950;1108;175;1819;1825;10.31;0.63;189.39;3.39;711;17;591.00;6
1109;17;626386984;1109;176;1821;1825;10.37;0.63;189.49;3.40;712;17;592.00;4
1111;17;626387001;1111;183;1822;1825;10.39;0.63;189.76;3.41;711;17;593.00;3
1114;17;626387016;1114;185;1825;1828;10.44;0.64;189.82;3.41;711;17;594.00;3
1115;17;626387027;1115;183;1825;1828;10.43;0.64;189.79;3.41;710;17;595.00;3
1116;17;626387040;1116;185;1826;1828;10.42;0.64;189.77;3.41;710;17;596.00;2
1118;17;626387051;1118;189;1830;1832;10.36;0.63;190.10;3.40;712;17;597.00;2
1120;17;626387063;1120;192;1832;1833;10.38;0.63;189.99;3.41;712;17;598.00;1
1124;17;626387075;1124;193;1832;1833;10.38;0.63;189.84;3.41;708;17;599.00;1
1124;17;626387090;1124;197;1844;1859;10.32;0.63;189.84;3.39;720;17;600.00;15
1126;17;626387117;1126;190;1845;1859;10.39;0.63;189.83;3.39;719;17;601.00;14
1131;17;626387129;1131;191;1846;1859;10.37;0.63;190.15;3.39;715;17;602.00;13
1132;17;626387140;1132;189;1847;1860;10.42;0.63;190.07;3.38;715;17;603.00;13
1134;17;626387152;1134;186;1848;1860;10.46;0.64;189.95;3.38;714;17;604.00;12
1137;17;626387164;1137;187;1852;1866;10.44;0.64;190.28;3.38;715;17;605.00;14
1141;17;626387181;1141;182;1853;1866;10.44;0.63;190.33;3.38;712;17;606.00;13
1145;17;626387193;1145;177;1856;1867;10.41;0.63;190.65;3.38;711;17;607.00;11
1149;17;626387204;1149;177;1856;1867;10.42;0.63;190.71;3.38;707;17;608.00;11
1150;17;626387216;1150;174;1856;1867;10.38;0.63;190.91;3.38;706;17;609.00;11
1153;17;626387226;1153;167;1858;1867;10.36;0.63;191.45;3.39;705;17;610.00;9
1158;17;626387237;1158;164;1858;1867;10.37;0.63;191.82;3.39;700;17;611.00;9
1160;17;626387248;1160;156;1867;1879;10.43;0.63;191.74;3.38;707;17;612.00;12
1162;17;626387261;1162;146;1870;1879;10.47;0.63;191.79;3.38;708;17;613.00;9
1166;18;626387279;1166;137;1870;1879;10.55;0.64;192.23;3.38;704;18;614.00;9
1169;18;626387302;1169;124;1870;1879;10.57;0.64;192.21;3.38;701;18;615.00;9
1172;18;626387319;1172;118;1871;1879;10.62;0.64;192.43;3.38;699;18;616.00;8
1176;18;626387330;1176;112;1871;1879;10.74;0.65;192.51;3.38;695;18;617.00;8
1177;18;626387342;1177;105;1876;1883;10.80;0.65;192.45;3.38;699;18;618.00;7
1180;18;626387353;1180;100;1876;1883;10.86;0.66;192.95;3.38;696;18;619.00;7
1183;18;626387364;1183;95;1879;1887;10.97;0.66;193.06;3.38;696;18;620.00;8
1186;18;626387376;1186;94;1880;1888;11.11;0.67;193.28;3.38;694;18;621.00;8
1191;18;626387387;1191;92;1881;1888;11.23;0.68;193.73;3.38;690;18;622.00;7
1194;18;626387399;1194;92;1881;1888;11.31;0.68;194.13;3.38;687;18;623.00;7
1197;18;626387410;1197;97;1890;1901;11.38;0.69;194.07;3.37;693;18;624.00;11
1201;18;626387422;1201;97;1890;1901;11.46;0.69;194.36;3.37;689;18;625.00;11
1205;19;626387434;1205;96;1890;1901;11.50;0.70;194.50;3.37;685;19;626.00;11
1207;19;626387457;1207;102;1891;1902;11.54;0.70;194.43;3.37;684;19;627.00;11
1211;19;626387469;1211;108;1891;1903;11.50;0.70;194.66;3.37;680;19;628.00;12
1213;19;626387485;1213;114;1894;1903;11.48;0.69;194.95;3.40;681;19;629.00;9
1215;19;626387498;1215;114;1897;1909;11.48;0.69;194.97;3.40;682;19;630.00;12
1216;19;626387510;1216;120;1899;1909;11.44;0.69;195.13;3.40;683;19;631.00;10
1218;19;626387522;1218;122;1900;1909;11.37;0.69;195.06;3.40;682;19;632.00;9
1219;19;626387533;1219;124;1900;1909;11.30;0.69;194.92;3.40;681;19;633.00;9
1221;19;626387543;1221;129;1904;1915;11.34;0.69;194.92;3.40;683;19;634.00;11
1223;19;626387555;1223;131;1905;1915;11.19;0.68;194.80;3.41;682;19;635.00;10
1226;19;626387566;1226;134;1906;1915;11.18;0.68;195.05;3.41;680;19;636.00;9
1228;19;626387577;1228;136;1907;1915;11.14;0.68;195.07;3.41;679;19;637.00;8
1232;19;626387588;1232;140;1910;1919;11.12;0.67;194.91;3.41;678;19;638.00;9
1235;19;626387601;1235;146;1911;1920;11.07;0.67;194.87;3.41;676;19;639.00;9
1236;19;626387611;1236;152;1912;1920;11.01;0.67;194.99;3.41;676;19;640.00;8
1238;19;626387622;1238;159;1914;1921;10.95;0.66;194.97;3.43;676;19;641.00;7
1238;19;626387633;1238;160;1914;1921;10.84;0.66;194.97;3.43;676;19;642.00;7
1239;20;626387644;1239;164;1916;1921;10.70;0.65;194.87;3.45;677;20;643.00;5
1239;20;626387661;1239;170;1917;1921;10.64;0.65;194.87;3.45;678;20;644.00;4
1242;20;626387681;1242;172;1917;1921;10.54;0.64;194.77;3.45;675;20;645.00;4
1245;20;626387692;1245;177;1920;1921;10.44;0.64;194.53;3.49;675;20;646.00;1
1246;20;626387702;1246;180;1920;1921;10.30;0.63;194.57;3.49;674;20;647.00;1
1249;20;626387712;1249;192;1956;1991;10.28;0.63;194.24;3.43;707;20;648.00;35
1252;20;626387729;1252;190;1957;1992;10.19;0.62;194.12;3.43;705;20;649.00;35
1253;20;626387740;1253;197;1965;1992;10.23;0.63;194.02;3.43;712;20;650.00;27
1255;20;626387750;1255;198;1969;1992;10.11;0.62;194.00;3.43;714;20;651.00;23
1256;20;626387760;1256;203;1978;1992;10.03;0.61;193.94;3.43;722;20;652.00;14
1256;20;626387770;1256;211;1980;1992;9.93;0.61;193.94;3.43;724;20;653.00;12
1257;20;626387780;1257;215;1982;1992;9.84;0.60;193.89;3.43;725;20;654.00;10
1258;20;626387790;1258;219;1985;1992;9.74;0.60;193.82;3.44;727;20;655.00;7
1260;20;626387800;1260;220;1986;1993;9.65;0.59;193.68;3.44;726;20;656.00;7
1261;20;626387810;1261;227;1990;1994;9.52;0.58;193.53;3.45;729;20;657.00;4
1263;20;626387820;1263;235;1994;1994;9.32;0.57;193.53;3.46;731;20;658.00;0
1265;20;626387830;1265;238;1998;1998;9.16;0.56;193.33;3.45;733;20;659.00;0
1266;20;626387841;1266;241;1998;1998;8.99;0.55;193.42;3.45;732;20;660.00;0
1267;20;626387857;1267;253;1998;1998;8.84;0.54;193.55;3.45;731;20;661.00;0
1269;20;626387867;1269;251;1998;1998;8.69;0.53;193.40;3.45;729;20;662.00;0
1271;20;626387877;1271;259;2003;2004;8.67;0.53;193.33;3.45;732;20;663.00;1
1272;20;626387888;1272;265;2003;2004;8.56;0.52;193.24;3.45;731;20;664.00;1
1274;20;626387899;1274;272;2004;2004;8.51;0.52;193.25;3.45;730;20;665.00;0
1275;20;626387908;1275;277;2006;2007;8.51;0.52;193.20;3.44;731;20;666.00;1
1275;20;626387918;1275;281;2006;2007;8.53;0.52;193.20;3.44;731;20;667.00;1
1275;20;626387929;1275;283;2007;2007;8.52;0.52;193.20;3.44;732;20;668.00;0
1277;20;626387938;1277;292;2008;2008;8.48;0.52;193.09;3.44;731;20;669.00;0
1280;20;626387947;1280;295;2009;2009;8.35;0.51;192.90;3.44;729;20;670.00;0
1283;20;626387957;1283;299;2009;2009;8.22;0.50;193.00;3.44;726;20;671.00;0
1283;20;626387966;1283;308;2021;2022;8.08;0.49;193.00;3.42;738;20;672.00;1
1287;20;626387976;1287;313;2021;2022;7.90;0.48;193.08;3.42;734;20;673.00;1
1290;20;626387985;1290;318;2022;2022;7.74;0.47;193.30;3.42;732;20;674.00;0
1292;20;626387993;1292;306;2024;2024;7.59;0.46;193.43;3.41;732;20;675.00;0
1295;20;626388003;1295;295;2024;2024;7.43;0.45;193.50;3.41;729;20;676.00;0
1302;20;626388011;1302;296;2027;2028;7.30;0.44;193.42;3.41;725;20;677.00;1
1304;20;626388024;1304;290;2027;2028;7.18;0.44;193.22;3.41;723;20;678.00;1
1307;20;626388032;1307;292;2032;2032;7.08;0.43;193.81;3.41;725;20;679.00;0
1312;20;626388040;1312;271;2032;2032;6.99;0.43;194.16;3.41;720;20;680.00;0
1312;20;626388050;1312;262;2032;2032;7.03;0.43;194.16;3.41;720;20;681.00;0
1317;20;626388064;1317;252;2032;2032;7.00;0.43;194.47;3.41;715;20;682.00;0
1318;20;626388072;1318;243;2032;2032;7.05;0.43;194.62;3.41;714;20;683.00;0
1322;20;626388081;1322;241;2042;2044;7.15;0.44;194.88;3.39;720;20;684.00;2
1324;20;626388091;1324;246;2043;2044;7.27;0.45;195.24;3.39;719;20;685.00;1
1328;20;626388100;1328;239;2044;2044;7.38;0.45;195.60;3.39;716;20;686.00;0
1328;20;626388109;1328;235;2044;2044;7.50;0.46;195.60;3.39;716;20;687.00;0
1331;20;626388119;1331;229;2044;2044;7.65;0.47;196.10;3.39;713;20;688.00;0
1332;20;626388128;1332;216;2044;2044;7.81;0.48;196.25;3.39;712;20;689.00;0
1334;20;626388139;1334;210;2045;2045;7.89;0.48;196.31;3.39;711;20;690.00;0
1336;20;626388149;1336;210;2045;2045;7.98;0.49;196.62;3.39;709;20;691.00;0
1339;20;626388159;1339;204;2050;2051;8.13;0.50;196.76;3.38;711;20;692.00;1
1340;20;626388170;1340;200;2051;2052;8.22;0.50;196.97;3.38;711;20;693.00;1
1341;20;626388180;1341;202;2052;2052;8.35;0.51;196.85;3.38;711;20;694.00;0
1345;20;626388191;1345;196;2052;2052;8.44;0.51;196.91;3.38;707;20;695.00;0
1347;20;626388201;1347;198;2056;2056;8.54;0.52;197.05;3.37;709;20;696.00;0
1349;20;626388212;1349;191;2056;2056;8.61;0.53;196.89;3.37;707;20;697.00;0
1355;20;626388222;1355;189;2056;2056;8.65;0.53;197.10;3.37;701;20;698.00;0
1357;20;626388232;1357;186;2057;2057;8.76;0.53;197.38;3.37;700;20;699.00;0
1359;20;626388242;1359;186;2061;2061;8.90;0.54;197.35;3.37;702;20;700.00;0
1363;20;626388263;1363;181;2061;2061;8.99;0.55;197.34;3.37;698;20;701.00;0
1367;20;626388273;1367;179;2063;2064;9.06;0.55;197.50;3.36;696;20;702.00;1
1370;20;626388283;1370;175;2063;2064;9.10;0.56;197.46;3.36;693;20;703.00;1
1378;20;626388292;1378;168;2064;2064;9.10;0.55;197.61;3.36;686;20;704.00;0
1381;20;626388303;1381;167;2064;2064;9.16;0.56;197.87;3.36;683;20;705.00;0
1382;20;626388312;1382;165;2067;2068;9.32;0.57;198.01;3.36;685;20;706.00;1
1388;20;626388322;1388;164;2067;2068;9.35;0.57;198.03;3.36;679;20;707.00;1
1391;20;626388334;1391;166;2068;2068;9.39;0.57;198.12;3.36;677;20;708.00;0
1401;20;626388344;1401;164;2068;2068;9.41;0.57;198.27;3.36;667;20;709.00;0
1407;20;626388354;1407;166;2069;2069;9.46;0.58;198.41;3.36;662;20;710.00;0
1412;20;626388365;1412;163;2070;2070;9.57;0.58;198.65;3.36;658;20;711.00;0
1418;20;626388375;1418;161;2070;2070;9.61;0.58;198.75;3.36;652;20;712.00;0
1421;20;626388386;1421;156;2071;2071;9.68;0.59;199.03;3.35;650;20;713.00;0
1428;20;626388397;1428;157;2071;2071;9.65;0.58;199.34;3.35;643;20;714.00;0
1430;20;626388408;1430;156;2071;2071;9.71;0.59;199.47;3.35;641;20;715.00;0
1433;20;626388419;1433;155;2071;2071;9.76;0.59;199.36;3.35;638;20;716.00;0
1435;20;626388430;1435;161;2071;2071;9.82;0.60;199.50;3.35;636;20;717.00;0
1437;20;626388446;1437;156;2071;2071;9.93;0.60;199.67;3.35;634;20;718.00;0
1441;20;626388457;1441;153;2071;2071;10.01;0.61;199.70;3.35;630;20;719.00;0
1444;20;626388471;1444;197;2194;2301;9.91;0.62;199.96;3.17;750;20;720.00;107
1448;20;626388504;1448;189;2203;2302;9.91;0.62;200.28;3.16;755;20;721.00;99
1450;20;626388517;1450;170;2214;2302;9.97;0.62;200.71;3.15;764;20;722.00;88
1452;20;626388528;1452;163;2220;2302;9.95;0.62;200.94;3.15;768;20;723.00;82
1456;20;626388540;1456;166;2228;2302;9.89;0.62;201.23;3.16;772;20;724.00;74
1458;20;626388552;1458;166;2231;2302;9.85;0.61;201.40;3.16;773;20;725.00;71
1461;20;626388563;1461;169;2239;2302;9.73;0.61;201.72;3.17;778;20;726.00;63
1464;20;626388575;1464;165;2243;2302;9.67;0.60;201.80;3.18;779;20;727.00;59
1467;20;626388592;1467;169;2248;2303;9.60;0.60;201.91;3.19;781;20;728.00;55
1470;20;626388605;1470;168;2252;2304;9.56;0.59;202.18;3.20;782;20;729.00;52
1475;20;626388619;1475;173;2255;2304;9.48;0.59;202.42;3.21;780;20;730.00;49
1480;20;626388632;1480;185;2261;2305;9.41;0.58;202.65;3.22;781;20;731.00;44
1483;20;626388645;1483;187;2266;2305;9.34;0.58;202.59;3.24;783;20;732.00;39
1486;20;626388663;1486;192;2268;2305;9.35;0.58;202.69;3.25;782;20;733.00;37
1487;20;626388676;1487;201;2273;2305;9.43;0.58;202.74;3.27;786;20;734.00;32
1490;20;626388689;1490;208;2277;2309;9.41;0.58;202.87;3.28;787;20;735.00;32
1491;20;626388709;1491;199;2281;2309;9.49;0.59;202.80;3.30;790;20;736.00;28
1495;20;626388721;1495;196;2282;2309;9.55;0.59;203.07;3.31;787;20;737.00;27
1499;20;626388734;1499;190;2284;2312;9.58;0.59;203.16;3.31;785;20;738.00;28
1500;20;626388748;1500;181;2285;2312;9.68;0.60;203.27;3.32;785;20;739.00;27
1506;20;626388762;1506;185;2285;2312;9.71;0.60;203.41;3.32;779;20;740.00;27
1508;20;626388776;1508;183;2292;2316;9.75;0.60;203.55;3.34;784;20;741.00;24
1509;20;626388790;1509;190;2293;2317;9.86;0.61;203.66;3.34;784;20;742.00;24
1510;20;626388803;1510;193;2294;2317;9.92;0.61;203.73;3.34;784;20;743.00;23
1514;20;626388817;1514;191;2299;2321;9.88;0.61;203.91;3.34;785;20;744.00;22
1517;20;626388831;1517;195;2299;2321;9.88;0.61;203.71;3.34;782;20;745.00;22
1520;20;626388851;1520;201;2300;2321;9.85;0.60;204.01;3.35;780;20;746.00;21
1522;20;626388863;1522;200;2302;2322;9.88;0.61;203.97;3.36;780;20;747.00;20
1522;20;626388876;1522;204;2302;2322;9.93;0.61;203.97;3.36;780;20;748.00;20
1524;20;626388889;1524;204;2306;2328;10.00;0.61;204.03;3.35;782;20;749.00;22
1530;20;626388913;1530;203;2307;2328;10.00;0.61;203.93;3.36;777;20;750.00;21
1535;20;626388936;1535;209;2309;2329;10.00;0.61;204.23;3.37;774;20;751.00;20
1538;20;626388954;1538;205;2309;2329;10.02;0.61;204.29;3.37;771;20;752.00;20
1540;20;626388970;1540;203;2310;2329;9.98;0.61;204.30;3.38;770;20;753.00;19
1542;20;626388987;1542;204;2311;2329;9.99;0.61;204.35;3.39;769;20;754.00;18
1546;20;626389005;1546;202;2313;2329;9.95;0.61;204.73;3.40;767;20;755.00;16
1547;20;626389019;1547;201;2325;2341;10.01;0.61;204.78;3.38;778;20;756.00;16
1551;20;626389032;1551;205;2325;2341;10.06;0.61;204.94;3.38;774;20;757.00;16
1554;20;626389044;1554;211;2326;2341;10.06;0.61;204.76;3.38;772;20;758.00;15
1557;21;626389056;1557;212;2326;2341;10.14;0.62;204.94;3.38;769;21;759.00;15
1561;21;626389090;1561;212;2326;2341;10.14;0.62;205.07;3.38;765;21;760.00;15
1563;21;626389103;1563;219;2326;2341;10.11;0.61;205.02;3.38;763;21;761.00;15
1564;21;626389114;1564;223;2330;2345;10.08;0.61;204.97;3.38;766;21;762.00;15
1564;21;626389126;1564;224;2330;2345;10.10;0.61;204.97;3.38;766;21;763.00;15
1567;21;626389144;1567;227;2333;2349;10.06;0.61;205.34;3.37;766;21;764.00;16
1569;21;626389155;1569;233;2335;2351;10.10;0.61;205.42;3.37;766;21;765.00;16
1570;21;626389167;1570;236;2336;2351;10.12;0.61;205.50;3.37;766;21;766.00;15
1573;21;626389178;1573;238;2336;2351;10.13;0.62;205.44;3.37;763;21;767.00;15
1574;21;626389188;1574;236;2346;2364;10.04;0.61;205.43;3.36;772;21;768.00;18
1575;21;626389200;1575;241;2346;2364;9.95;0.60;205.65;3.36;771;21;769.00;18
1577;21;626389211;1577;237;2347;2364;9.81;0.60;205.90;3.36;770;21;770.00;17
1578;21;626389222;1578;233;2348;2365;9.79;0.60;205.94;3.35;770;21;771.00;17
1581;21;626389232;1581;231;2348;2366;9.72;0.59;205.99;3.35;767;21;772.00;18
1582;21;626389242;1582;228;2348;2366;9.76;0.59;205.93;3.35;766;21;773.00;18
1584;21;626389254;1584;221;2350;2369;9.80;0.60;206.01;3.35;766;21;774.00;19
1587;21;626389265;1587;215;2350;2369;9.76;0.59;206.21;3.35;763;21;775.00;19
1591;21;626389280;1591;211;2351;2369;9.73;0.59;206.28;3.35;760;21;776.00;18
1592;21;626389290;1592;207;2351;2369;9.69;0.59;206.19;3.35;759;21;777.00;18
1596;21;626389300;1596;200;2355;2375;9.68;0.59;206.42;3.35;759;21;778.00;20
1599;21;626389310;1599;197;2355;2375;9.64;0.59;206.55;3.35;756;21;779.00;20
1605;21;626389321;1605;195;2356;2375;9.58;0.58;206.96;3.35;751;21;780.00;19
1609;21;626389331;1609;197;2356;2375;9.45;0.58;207.28;3.35;747;21;781.00;19
1613;21;626389340;1613;187;2359;2379;9.33;0.57;207.69;3.34;746;21;782.00;20
1616;21;626389350;1616;187;2360;2380;9.25;0.57;207.90;3.34;744;21;783.00;20
1621;21;626389359;1621;181;2360;2380;9.15;0.56;207.91;3.34;739;21;784.00;20
1623;21;626389375;1623;179;2361;2381;9.14;0.56;208.11;3.34;738;21;785.00;20
1626;21;626389387;1626;169;2362;2381;9.11;0.56;208.15;3.35;736;21;786.00;19
1629;21;626389397;1629;171;2362;2381;9.13;0.56;208.08;3.35;733;21;787.00;19
1631;21;626389406;1631;168;2362;2381;9.16;0.56;208.09;3.35;731;21;788.00;19
1635;21;626389415;1635;162;2362;2381;9.17;0.56;207.90;3.35;727;21;789.00;19
1636;21;626389424;1636;159;2362;2381;9.25;0.56;207.82;3.35;726;21;790.00;19
1640;21;626389434;1640;162;2362;2381;9.35;0.57;207.64;3.35;722;21;791.00;19
1641;21;626389444;1641;167;2395;2451;9.49;0.58;207.68;3.33;754;21;792.00;56
1643;21;626389459;1643;165;2397;2452;9.56;0.59;207.54;3.33;754;21;793.00;55
1644;21;626389469;1644;163;2405;2452;9.74;0.60;207.48;3.32;761;21;794.00;47
1648;21;626389480;1648;161;2407;2452;9.72;0.59;207.25;3.35;759;21;795.00;45
1649;21;626389489;1649;167;2413;2452;9.80;0.60;207.25;3.36;764;21;796.00;39
1651;21;626389499;1651;174;2418;2452;9.82;0.60;207.12;3.39;767;21;797.00;34
1653;21;626389510;1653;171;2424;2452;9.77;0.60;207.13;3.39;771;21;798.00;28
1657;21;626389520;1657;176;2428;2452;9.73;0.59;206.90;3.40;771;21;799.00;24
1659;21;626389530;1659;176;2431;2453;9.73;0.59;206.83;3.43;772;21;800.00;22
1660;21;626389545;1660;175;2432;2454;9.69;0.59;206.83;3.43;772;21;801.00;22
1664;21;626389556;1664;182;2434;2454;9.65;0.59;206.65;3.47;770;21;802.00;20
1667;21;626389567;1667;191;2437;2458;9.56;0.58;206.63;3.46;770;21;803.00;21
1669;21;626389579;1669;196;2438;2458;9.46;0.58;206.53;3.50;769;21;804.00;20
1672;21;626389591;1672;197;2438;2458;9.38;0.57;206.43;3.50;766;21;805.00;20
1673;21;626389604;1673;209;2439;2458;9.31;0.57;206.36;3.53;766;21;806.00;19
1674;21;626389615;1674;213;2444;2464;9.31;0.57;206.35;3.56;770;21;807.00;20
1677;21;626389627;1677;223;2446;2464;9.29;0.57;206.19;3.59;769;21;808.00;18
1679;21;626389640;1679;234;2447;2464;9.26;0.56;206.30;3.63;768;21;809.00;17
1680;21;626389654;1680;238;2453;2470;9.20;0.56;206.21;3.68;773;21;810.00;17
1682;21;626389667;1682;244;2454;2470;9.13;0.56;206.07;3.72;772;21;811.00;16
1683;21;626389682;1683;246;2456;2470;9.10;0.55;205.96;3.75;773;21;812.00;14
1688;21;626389694;1688;252;2459;2471;8.97;0.54;205.69;3.77;771;21;813.00;12
1690;21;626389706;1690;252;2460;2472;8.87;0.54;205.51;3.77;770;21;814.00;12
1691;21;626389718;1691;259;2463;2472;8.79;0.53;205.52;3.81;772;21;815.00;9
1692;21;626389730;1692;266;2473;2485;8.71;0.53;205.50;3.80;781;21;816.00;12
1694;21;626389743;1694;269;2474;2485;8.69;0.53;205.36;3.84;780;21;817.00;11
1695;21;626389754;1695;273;2477;2485;8.61;0.52;205.26;3.86;782;21;818.00;8
1696;22;626389765;1696;278;2478;2486;8.59;0.52;205.28;3.86;782;22;819.00;8
1699;22;626389788;1699;288;2480;2486;8.55;0.52;205.19;3.89;781;22;820.00;6
1699;22;626389799;1699;287;2483;2490;8.56;0.52;205.19;3.88;784;22;821.00;7
1701;22;626389811;1701;290;2485;2490;8.49;0.52;205.07;3.90;784;22;822.00;5
1704;22;626389821;1704;296;2490;2494;8.39;0.51;204.85;3.89;786;22;823.00;4
1706;22;626389832;1706;305;2492;2494;8.27;0.50;204.72;3.91;786;22;824.00;2
1707;22;626389844;1707;309;2493;2494;8.19;0.50;204.77;3.91;786;22;825.00;1
1707;22;626389854;1707;314;2493;2494;8.06;0.49;204.77;3.91;786;22;826.00;1
1708;22;626389863;1708;306;2494;2494;7.94;0.48;204.77;3.91;786;22;827.00;0
1709;22;626389873;1709;303;2504;2506;7.93;0.48;204.72;3.89;795;22;828.00;2
1709;22;626389884;1709;300;2505;2506;7.91;0.48;204.72;3.89;796;22;829.00;1
1709;22;626389895;1709;297;2506;2506;7.93;0.49;204.72;3.89;797;22;830.00;0
1712;22;626389906;1712;295;2506;2506;8.01;0.49;204.88;3.89;794;22;831.00;0
1712;22;626389917;1712;289;2506;2506;8.07;0.49;204.88;3.89;794;22;832.00;0
1714;22;626389928;1714;281;2506;2506;8.08;0.49;204.90;3.89;792;22;833.00;0
1715;22;626389945;1715;279;2507;2507;8.10;0.49;204.85;3.89;792;22;834.00;0
1716;22;626389956;1716;276;2507;2507;8.12;0.49;204.82;3.89;791;22;835.00;0
1716;22;626389967;1716;275;2512;2513;8.30;0.50;204.82;3.89;796;22;836.00;1
1716;22;626389979;1716;274;2513;2514;8.41;0.51;204.82;3.88;797;22;837.00;1
1716;22;626389989;1716;274;2514;2514;8.50;0.52;204.82;3.88;798;22;838.00;0
1717;22;626390001;1717;275;2514;2514;8.56;0.52;204.77;3.88;797;22;839.00;0
1720;22;626390014;1720;275;2519;2519;8.63;0.53;204.92;3.88;799;22;840.00;0
1722;22;626390026;1722;275;2519;2519;8.60;0.52;205.08;3.88;797;22;841.00;0
1722;22;626390036;1722;276;2519;2519;8.52;0.52;205.08;3.88;797;22;842.00;0
1724;22;626390047;1724;283;2520;2520;8.34;0.51;205.36;3.88;796;22;843.00;0
1726;22;626390057;1726;283;2524;2524;8.24;0.50;205.51;3.87;798;22;844.00;0
1729;22;626390068;1729;284;2524;2524;8.13;0.50;205.76;3.87;795;22;845.00;0
1734;22;626390078;1734;291;2526;2527;7.99;0.49;205.69;3.87;792;22;846.00;1
1737;22;626390089;1737;292;2527;2527;7.82;0.48;206.06;3.87;790;22;847.00;0
1741;22;626390099;1741;290;2527;2527;7.68;0.47;206.08;3.87;786;22;848.00;0
1743;22;626390109;1743;296;2527;2527;7.65;0.47;206.34;3.87;784;22;849.00;0
1747;22;626390118;1747;291;2530;2531;7.70;0.47;206.33;3.86;783;22;850.00;1
1753;22;626390128;1753;284;2530;2531;7.68;0.47;206.58;3.86;777;22;851.00;1
1756;22;626390138;1756;275;2531;2531;7.77;0.48;206.83;3.86;775;22;852.00;0
1762;22;626390148;1762;273;2531;2531;7.79;0.48;207.17;3.86;769;22;853.00;0
1764;22;626390158;1764;272;2531;2532;7.85;0.48;207.14;3.86;767;22;854.00;1
1767;22;626390168;1767;268;2534;2534;7.85;0.48;207.32;3.86;767;22;855.00;0
1772;22;626390178;1772;264;2534;2534;7.85;0.48;207.82;3.86;762;22;856.00;0
1774;22;626390187;1774;263;2535;2535;7.96;0.49;208.13;3.86;761;22;857.00;0
1779;22;626390198;1779;252;2535;2535;8.00;0.49;208.24;3.86;756;22;858.00;0
1782;22;626390208;1782;248;2535;2535;8.02;0.49;208.64;3.86;753;22;859.00;0
1784;22;626390217;1784;235;2535;2535;8.10;0.49;208.96;3.86;751;22;860.00;0
1787;22;626390227;1787;227;2535;2535;8.16;0.50;209.40;3.86;748;22;861.00;0
1791;22;626390237;1791;219;2535;2535;8.20;0.50;209.52;3.86;744;22;862.00;0
1797;22;626390248;1797;212;2535;2535;8.26;0.50;209.85;3.86;738;22;863.00;0
1800;22;626390258;1800;217;2614;2662;8.56;0.53;209.99;3.74;814;22;864.00;48
1807;22;626390282;1807;208;2616;2663;8.63;0.53;210.21;3.74;809;22;865.00;47
1808;22;626390295;1808;199;2622;2663;8.82;0.54;210.33;3.74;814;22;866.00;41
1811;22;626390307;1811;194;2629;2663;8.98;0.55;210.28;3.73;818;22;867.00;34
1815;22;626390317;1815;197;2635;2663;9.06;0.56;210.59;3.73;820;22;868.00;28
1819;22;626390330;1819;195;2640;2663;9.05;0.56;210.85;3.74;821;22;869.00;23
1822;22;626390343;1822;193;2645;2663;9.06;0.56;211.00;3.74;823;22;870.00;18
1825;22;626390355;1825;195;2647;2663;9.06;0.56;210.80;3.74;822;22;871.00;16
1828;22;626390368;1828;205;2651;2664;8.96;0.55;210.91;3.75;823;22;872.00;13
1832;22;626390381;1832;211;2652;2665;8.90;0.55;210.96;3.75;820;22;873.00;13
1834;22;626390393;1834;213;2653;2665;8.86;0.55;211.10;3.75;819;22;874.00;12
1842;22;626390406;1842;225;2655;2666;8.86;0.55;211.26;3.75;813;22;875.00;11
1845;22;626390419;1845;230;2657;2666;8.82;0.54;211.64;3.76;812;22;876.00;9
1847;22;626390431;1847;233;2658;2666;8.87;0.55;211.71;3.76;811;22;877.00;8
1850;22;626390445;1850;239;2660;2666;8.91;0.55;211.88;3.77;810;22;878.00;6
1857;22;626390457;1857;242;2663;2670;8.87;0.55;211.95;3.77;806;22;879.00;7
1859;22;626390472;1859;240;2665;2670;8.87;0.55;212.10;3.78;806;22;880.00;5
1865;22;626390485;1865;239;2666;2670;8.89;0.55;212.28;3.78;801;22;881.00;4
1872;22;626390498;1872;242;2669;2673;8.93;0.55;212.30;3.78;797;22;882.00;4
1879;22;626390511;1879;244;2669;2673;9.01;0.55;212.45;3.78;790;22;883.00;4
1880;22;626390524;1880;241;2670;2673;9.08;0.56;212.61;3.78;790;22;884.00;3
1881;22;626390538;1881;240;2674;2677;9.14;0.56;212.70;3.78;793;22;885.00;3
1887;22;626390550;1887;237;2676;2678;9.17;0.56;213.00;3.78;789;22;886.00;2
1890;22;626390562;1890;236;2676;2678;9.17;0.56;213.03;3.78;786;22;887.00;2
1895;22;626390575;1895;238;2680;2682;9.18;0.56;213.15;3.77;785;22;888.00;2
1899;22;626390590;1899;237;2680;2682;9.23;0.57;213.24;3.77;781;22;889.00;2
1901;22;626390603;1901;233;2680;2682;9.23;0.57;213.37;3.77;779;22;890.00;2
1906;22;626390615;1906;235;2681;2683;9.25;0.57;213.28;3.77;775;22;891.00;2
1910;22;626390633;1910;234;2682;2683;9.20;0.56;213.37;3.78;772;22;892.00;1
1913;22;626390648;1913;235;2687;2689;9.17;0.56;213.55;3.77;774;22;893.00;2
1914;22;626390661;1914;240;2687;2689;9.16;0.56;213.64;3.77;773;22;894.00;2
1917;22;626390674;1917;243;2689;2690;9.11;0.56;213.74;3.77;772;22;895.00;1
1925;22;626390687;1925;249;2689;2690;9.04;0.55;214.15;3.77;764;22;896.00;1
1929;22;626390700;1929;237;2689;2690;9.02;0.55;214.21;3.77;760;22;897.00;1
1931;22;626390714;1931;229;2689;2690;8.98;0.55;214.23;3.77;758;22;898.00;1
1938;22;626390727;1938;227;2689;2690;8.93;0.55;214.80;3.77;751;22;899.00;1
1943;22;626390747;1943;229;2717;2736;8.88;0.54;214.84;3.73;774;22;900.00;19
1949;22;626390769;1949;225;2717;2736;8.92;0.55;215.12;3.73;768;22;901.00;19
1952;22;626390783;1952;216;2719;2736;8.94;0.55;215.27;3.73;767;22;902.00;17
1955;22;626390796;1955;213;2719;2736;9.01;0.55;215.59;3.73;764;22;903.00;17
1956;22;626390808;1956;214;2720;2736;9.09;0.56;215.52;3.73;764;22;904.00;16
1960;22;626390821;1960;213;2720;2736;9.07;0.56;215.69;3.73;760;22;905.00;16
1964;22;626390833;1964;203;2726;2740;9.00;0.55;215.74;3.73;762;22;906.00;14
1968;22;626390845;1968;187;2727;2740;8.98;0.55;215.74;3.73;759;22;907.00;13
1973;22;626390857;1973;181;2732;2744;9.02;0.55;215.87;3.75;759;22;908.00;12
1976;22;626390875;1976;180;2734;2745;9.03;0.55;215.96;3.75;758;22;909.00;11
1977;22;626390887;1977;177;2734;2745;9.04;0.55;216.02;3.75;757;22;910.00;11
1979;22;626390904;1979;173;2734;2745;9.06;0.55;216.03;3.75;755;22;911.00;11
1981;22;626390921;1981;180;2743;2758;9.11;0.56;216.04;3.74;762;22;912.00;15
1984;22;626390940;1984;182;2744;2758;9.15;0.56;216.25;3.74;760;22;913.00;14
1988;22;626390958;1988;182;2744;2758;9.20;0.56;216.41;3.74;756;22;914.00;14
1990;22;626390978;1990;183;2746;2759;9.27;0.57;216.45;3.74;756;22;915.00;13
1992;22;626390994;1992;182;2747;2760;9.28;0.57;216.62;3.74;755;22;916.00;13
1995;22;626391010;1995;184;2747;2760;9.31;0.57;216.77;3.74;752;22;917.00;13
1998;22;626391024;1998;180;2749;2763;9.37;0.57;217.01;3.74;751;22;918.00;14
2000;22;626391037;2000;177;2751;2763;9.33;0.57;216.99;3.75;751;22;919.00;12
2005;22;626391050;2005;171;2751;2763;9.29;0.57;217.19;3.75;746;22;920.00;12
2008;22;626391063;2008;165;2752;2763;9.24;0.56;217.19;3.76;744;22;921.00;11
2011;22;626391083;2011;159;2755;2769;9.30;0.57;217.13;3.75;744;22;922.00;14
2014;22;626391097;2014;155;2755;2769;9.36;0.57;217.16;3.75;741;22;923.00;14
2015;22;626391109;2015;154;2755;2769;9.35;0.57;217.22;3.75;740;22;924.00;14
2017;22;626391122;2017;156;2758;2769;9.32;0.57;217.21;3.76;741;22;925.00;11
2020;22;626391134;2020;156;2762;2773;9.23;0.56;217.13;3.76;742;22;926.00;11
2024;22;626391146;2024;159;2764;2774;9.29;0.56;216.89;3.77;740;22;927.00;10
2025;22;626391158;2025;159;2764;2774;9.33;0.57;216.88;3.77;739;22;928.00;10
2027;22;626391170;2027;167;2768;2775;9.36;0.57;216.88;3.79;741;22;929.00;7
2028;22;626391190;2028;173;2768;2775;9.34;0.57;216.87;3.79;740;22;930.00;7
2030;22;626391201;2030;176;2769;2775;9.26;0.56;216.97;3.79;739;22;931.00;6
2031;22;626391219;2031;178;2770;2775;9.21;0.56;217.03;3.80;739;22;932.00;5
2032;22;626391231;2032;185;2771;2775;9.16;0.56;216.99;3.80;739;22;933.00;4
2034;22;626391242;2034;195;2771;2775;9.08;0.55;217.02;3.80;737;22;934.00;4
2036;22;626391254;2036;201;2772;2775;9.09;0.55;216.93;3.80;736;22;935.00;3
2038;22;626391265;2038;223;2813;2845;8.89;0.54;216.92;3.75;775;22;936.00;32
2038;22;626391283;2038;222;2814;2846;8.87;0.54;216.92;3.76;776;22;937.00;32
2042;22;626391294;2042;223;2821;2846;8.91;0.54;216.79;3.75;779;22;938.00;25
2043;22;626391305;2043;233;2825;2846;8.93;0.54;216.83;3.75;782;22;939.00;21
2043;22;626391316;2043;229;2830;2846;8.94;0.55;216.83;3.75;787;22;940.00;16
2045;22;626391326;2045;229;2833;2846;8.92;0.54;216.85;3.75;788;22;941.00;13
2046;22;626391337;2046;238;2836;2846;8.94;0.55;216.90;3.75;790;22;942.00;10
2048;22;626391349;2048;239;2840;2846;8.95;0.55;216.88;3.76;792;22;943.00;6
2049;22;626391361;2049;234;2841;2847;8.94;0.55;216.83;3.76;792;22;944.00;6
2052;22;626391373;2052;232;2844;2849;8.96;0.55;216.83;3.76;792;22;945.00;5
2053;22;626391384;2053;227;2844;2849;8.98;0.55;216.77;3.76;791;22;946.00;5
2054;22;626391395;2054;226;2847;2853;8.96;0.55;216.74;3.75;793;22;947.00;6
2057;22;626391406;2057;224;2847;2853;8.94;0.55;216.64;3.75;790;22;948.00;6
2061;22;626391416;2061;227;2847;2853;8.89;0.54;216.68;3.75;786;22;949.00;6
2066;22;626391427;2066;216;2847;2853;8.78;0.54;216.80;3.75;781;22;950.00;6
2069;22;626391439;2069;211;2850;2859;8.71;0.53;216.96;3.75;781;22;951.00;9
2073;22;626391450;2073;206;2850;2859;8.64;0.53;216.86;3.75;777;22;952.00;9
2076;22;626391462;2076;200;2852;2859;8.58;0.53;217.04;3.76;776;22;953.00;7
2083;22;626391474;2083;196;2854;2862;8.50;0.52;217.06;3.76;771;22;954.00;8
2089;22;626391485;2089;194;2857;2862;8.42;0.51;217.26;3.77;768;22;955.00;5
2092;22;626391496;2092;193;2857;2862;8.36;0.51;217.29;3.77;765;22;956.00;5
2095;22;626391507;2095;195;2857;2863;8.27;0.50;217.31;3.77;762;22;957.00;6
2098;22;626391519;2098;191;2858;2864;8.23;0.50;217.24;3.77;760;22;958.00;6
2100;22;626391530;2100;196;2858;2864;8.16;0.50;217.19;3.77;758;22;959.00;6
2104;22;626391541;2104;200;2874;2890;8.10;0.49;217.09;3.75;770;22;960.00;16
2108;22;626391555;2108;198;2875;2890;8.13;0.50;216.81;3.75;767;22;961.00;15
2112;22;626391565;2112;199;2877;2890;8.20;0.50;216.95;3.74;765;22;962.00;13
2114;22;626391576;2114;200;2879;2891;8.29;0.50;217.03;3.74;765;22;963.00;12
2116;22;626391587;2116;204;2879;2891;8.38;0.51;216.97;3.74;763;22;964.00;12
2118;22;626391597;2118;206;2881;2895;8.51;0.52;216.86;3.74;763;22;965.00;14
2120;22;626391609;2120;207;2881;2895;8.53;0.52;216.68;3.74;761;22;966.00;14
2121;22;626391619;2121;212;2885;2899;8.53;0.52;216.66;3.74;764;22;967.00;14
2122;22;626391637;2122;213;2885;2899;8.61;0.52;216.58;3.74;763;22;968.00;14
2123;22;626391648;2123;218;2885;2899;8.60;0.52;216.54;3.74;762;22;969.00;14
2126;22;626391658;2126;224;2888;2899;8.56;0.52;216.36;3.77;762;22;970.00;11
2128;22;626391669;2128;219;2888;2899;8.53;0.52;216.28;3.77;760;22;971.00;11
2128;22;626391678;2128;223;2900;2911;8.56;0.52;216.28;3.78;772;22;972.00;11
2128;22;626391689;2128;226;2901;2911;8.57;0.52;216.28;3.77;773;22;973.00;10
2131;22;626391700;2131;230;2901;2911;8.54;0.52;216.32;3.77;770;22;974.00;10
2132;22;626391711;2132;238;2902;2911;8.50;0.52;216.31;3.78;770;22;975.00;9
2133;22;626391721;2133;240;2903;2911;8.43;0.51;216.33;3.78;770;22;976.00;8
2135;22;626391731;2135;244;2903;2911;8.39;0.51;216.36;3.78;768;22;977.00;8
2136;22;626391742;2136;251;2904;2912;8.32;0.51;216.38;3.79;768;22;978.00;8
2136;22;626391752;2136;243;2905;2912;8.39;0.51;216.38;3.79;769;22;979.00;7
2138;22;626391763;2138;237;2910;2918;8.45;0.52;216.46;3.80;772;22;980.00;8
2139;22;626391774;2139;234;2913;2919;8.54;0.52;216.47;3.80;774;22;981.00;6
2144;22;626391785;2144;234;2913;2919;8.59;0.52;216.41;3.80;769;22;982.00;6
2146;22;626391796;2146;236;2914;2919;8.59;0.52;216.32;3.81;768;22;983.00;5
2146;22;626391807;2146;233;2918;2923;8.61;0.52;216.32;3.81;772;22;984.00;5
2149;22;626391820;2149;231;2918;2923;8.68;0.53;216.52;3.81;769;22;985.00;5
2150;22;626391831;2150;228;2920;2923;8.76;0.53;216.48;3.82;770;22;986.00;3
2151;24;626391842;2151;228;2921;2924;8.83;0.54;216.39;3.82;770;24;987.00;3
2152;24;626391878;2152;228;2924;2928;8.91;0.54;216.33;3.82;772;24;988.00;4
2153;24;626391892;2153;227;2924;2928;8.93;0.54;216.32;3.82;771;24;989.00;4
2156;24;626391915;2156;229;2930;2934;8.94;0.54;216.14;3.82;774;24;990.00;4
2160;24;626391926;2160;229;2932;2934;8.93;0.54;216.02;3.82;772;24;991.00;2
2162;24;626391936;2162;229;2932;2934;8.94;0.54;216.07;3.82;770;24;992.00;2
2163;24;626391946;2163;229;2933;2934;8.97;0.55;216.06;3.82;770;24;993.00;1
2163;24;626391956;2163;229;2935;2938;9.00;0.55;216.06;3.82;772;24;994.00;3
2164;24;626391971;2164;234;2936;2938;8.93;0.55;216.09;3.82;772;24;995.00;2
2164;24;626391981;2164;240;2937;2938;8.84;0.54;216.09;3.82;773;24;996.00;1
2167;24;626391990;2167;248;2937;2938;8.72;0.53;216.13;3.82;770;24;997.00;1
2168;24;626391999;2168;246;2939;2939;8.62;0.53;216.16;3.82;771;24;998.00;0
2172;24;626392009;2172;245;2940;2940;8.47;0.52;216.16;3.82;768;24;999.00;0
2173;24;626392020;2173;245;2940;2940;8.39;0.51;216.14;3.82;767;24;1000.00;0
2173;24;626392033;2173;240;2941;2941;8.40;0.51;216.14;3.82;768;24;1001.00;0
2176;24;626392048;2176;245;2941;2941;8.38;0.51;216.14;3.82;765;24;1002.00;0
2178;24;626392057;2178;244;2941;2941;8.38;0.51;216.32;3.82;763;24;1003.00;0
2181;24;626392066;2181;239;2941;2941;8.37;0.51;216.46;3.82;760;24;1004.00;0
2183;24;626392075;2183;235;2941;2941;8.40;0.51;216.53;3.82;758;24;1005.00;0
2185;24;626392085;2185;240;2941;2941;8.42;0.51;216.45;3.82;756;24;1006.00;0
2188;24;626392094;2188;239;2941;2941;8.43;0.51;216.58;3.82;753;24;1007.00;0
2191;24;626392103;2191;261;3012;3068;8.56;0.53;216.75;3.73;821;24;1008.00;56
2193;24;626392122;2193;254;3014;3069;8.52;0.53;216.89;3.72;821;24;1009.00;55
2195;24;626392131;2195;246;3025;3069;8.62;0.53;217.14;3.72;830;24;1010.00;44
2198;24;626392141;2198;253;3030;3069;8.66;0.53;217.26;3.72;832;24;1011.00;39
2200;24;626392150;2200;254;3036;3069;8.65;0.53;217.22;3.72;836;24;1012.00;33
2204;24;626392160;2204;252;3041;3069;8.58;0.53;217.41;3.72;837;24;1013.00;28
2208;24;626392169;2208;252;3046;3069;8.49;0.52;217.42;3.72;838;24;1014.00;23
2212;24;626392179;2212;251;3049;3069;8.47;0.52;217.48;3.73;837;24;1015.00;20
2216;24;626392194;2216;257;3052;3070;8.41;0.52;217.65;3.73;836;24;1016.00;18
2222;24;626392204;2222;263;3055;3071;8.43;0.52;217.60;3.74;833;24;1017.00;16
2229;24;626392215;2229;271;3058;3071;8.28;0.51;218.06;3.74;829;24;1018.00;13
2234;24;626392224;2234;269;3062;3072;8.14;0.50;218.26;3.75;828;24;1019.00;10
2238;24;626392236;2238;266;3063;3072;8.01;0.49;218.69;3.75;825;24;1020.00;9
2241;24;626392246;2241;257;3064;3072;7.94;0.49;218.85;3.75;823;24;1021.00;8
2246;24;626392256;2246;253;3066;3072;7.91;0.49;219.12;3.76;820;24;1022.00;6
2247;24;626392267;2247;255;3070;3076;7.94;0.49;219.07;3.76;823;24;1023.00;6
2252;24;626392277;2252;253;3071;3076;7.94;0.49;219.62;3.76;819;24;1024.00;5
2255;24;626392288;2255;253;3074;3076;7.94;0.49;219.78;3.77;819;24;1025.00;2
2258;24;626392299;2258;252;3075;3079;7.96;0.49;220.02;3.77;817;24;1026.00;4
2261;24;626392309;2261;247;3078;3079;8.00;0.49;220.10;3.78;817;24;1027.00;1
2265;24;626392321;2265;241;3078;3079;8.06;0.49;220.33;3.78;813;24;1028.00;1
2266;24;626392331;2266;239;3083;3083;8.12;0.50;220.41;3.77;817;24;1029.00;0
2271;24;626392342;2271;228;3084;3084;8.22;0.50;220.68;3.77;813;24;1030.00;0
2276;24;626392353;2276;232;3084;3084;8.28;0.50;220.90;3.77;808;24;1031.00;0
2281;24;626392364;2281;229;3088;3088;8.34;0.51;220.96;3.77;807;24;1032.00;0
2283;24;626392375;2283;218;3088;3088;8.42;0.51;221.22;3.77;805;24;1033.00;0
2289;24;626392386;2289;219;3088;3088;8.50;0.52;221.42;3.77;799;24;1034.00;0
2295;24;626392398;2295;213;3090;3090;8.59;0.52;221.76;3.76;795;24;1035.00;0
2297;24;626392409;2297;211;3090;3090;8.73;0.53;221.67;3.76;793;24;1036.00;0
2302;24;626392420;2302;216;3095;3096;8.83;0.54;222.05;3.76;793;24;1037.00;1
2307;24;626392432;2307;219;3095;3096;8.85;0.54;222.29;3.76;788;24;1038.00;1
2311;24;626392443;2311;220;3097;3097;8.83;0.54;222.61;3.76;786;24;1039.00;0
2316;25;626392454;2316;217;3097;3097;8.86;0.54;222.90;3.76;781;25;1040.00;0
2318;25;626392476;2318;211;3097;3097;8.99;0.55;223.04;3.76;779;25;1041.00;0
2321;25;626392487;2321;208;3097;3097;9.03;0.55;223.09;3.76;776;25;1042.00;0
2325;25;626392504;2325;198;3097;3097;9.15;0.56;223.37;3.76;772;25;1043.00;0
2329;25;626392517;2329;187;3108;3109;9.27;0.57;223.54;3.75;779;25;1044.00;1
2331;25;626392531;2331;182;3108;3109;9.30;0.57;223.58;3.75;777;25;1045.00;1
2336;25;626392543;2336;181;3109;3109;9.28;0.57;223.71;3.74;773;25;1046.00;0
2344;25;626392555;2344;181;3109;3109;9.30;0.57;223.99;3.74;765;25;1047.00;0
2347;25;626392568;2347;184;3109;3109;9.36;0.57;223.89;3.74;762;25;1048.00;0
2351;25;626392581;2351;186;3109;3109;9.42;0.58;224.25;3.74;758;25;1049.00;0
2356;25;626392595;2356;188;3115;3115;9.49;0.58;224.34;3.74;759;25;1050.00;0
2361;25;626392611;2361;187;3115;3115;9.52;0.58;224.46;3.74;754;25;1051.00;0
2363;25;626392626;2363;188;3118;3119;9.59;0.59;224.55;3.74;755;25;1052.00;1
2367;25;626392642;2367;192;3120;3120;9.58;0.58;224.70;3.73;753;25;1053.00;0
2370;25;626392658;2370;185;3120;3120;9.60;0.59;224.76;3.73;750;25;1054.00;0
2373;25;626392669;2373;184;3120;3120;9.62;0.59;224.79;3.73;747;25;1055.00;0
2377;25;626392681;2377;191;3133;3133;9.65;0.59;224.80;3.72;756;25;1056.00;0
2382;25;626392699;2382;188;3133;3133;9.72;0.59;224.64;3.72;751;25;1057.00;0
2387;25;626392715;2387;188;3133;3133;9.69;0.59;224.92;3.72;746;25;1058.00;0
2394;25;626392731;2394;189;3134;3134;9.68;0.59;224.89;3.72;740;25;1059.00;0
2398;25;626392751;2398;187;3135;3135;9.66;0.59;224.84;3.72;737;25;1060.00;0
2403;25;626392771;2403;196;3135;3135;9.56;0.58;224.95;3.72;732;25;1061.00;0
2404;25;626392786;2404;195;3137;3138;9.59;0.58;225.01;3.72;733;25;1062.00;1
2408;25;626392799;2408;196;3137;3138;9.54;0.58;225.02;3.72;729;25;1063.00;1
2411;25;626392811;2411;202;3138;3138;9.49;0.58;225.21;3.71;727;25;1064.00;0
2412;25;626392823;2412;212;3138;3138;9.48;0.58;225.26;3.71;726;25;1065.00;0
2413;25;626392836;2413;216;3143;3144;9.40;0.57;225.27;3.71;730;25;1066.00;1
2416;25;626392849;2416;209;3143;3144;9.30;0.57;225.27;3.71;727;25;1067.00;1
2419;25;626392861;2419;207;3144;3144;9.26;0.57;225.23;3.71;725;25;1068.00;0
2422;25;626392872;2422;207;3144;3144;9.25;0.57;225.27;3.71;722;25;1069.00;0
2426;25;626392884;2426;205;3148;3148;9.29;0.57;225.57;3.71;722;25;1070.00;0
2431;25;626392897;2431;202;3149;3149;9.38;0.57;225.72;3.71;718;25;1071.00;0
2437;25;626392913;2437;205;3149;3149;9.35;0.57;225.84;3.71;712;25;1072.00;0
2441;25;626392941;2441;197;3150;3150;9.30;0.57;225.84;3.70;709;25;1073.00;0
2444;25;626392971;2444;198;3150;3150;9.30;0.57;225.93;3.70;706;25;1074.00;0
2446;25;626392986;2446;204;3150;3150;9.34;0.57;226.12;3.70;704;25;1075.00;0
2448;25;626393004;2448;201;3150;3150;9.37;0.57;226.14;3.70;702;25;1076.00;0
2451;25;626393023;2451;189;3150;3150;9.38;0.57;226.27;3.70;699;25;1077.00;0
2456;25;626393045;2456;184;3150;3150;9.44;0.57;226.36;3.70;694;25;1078.00;0
2456;25;626393063;2456;179;3150;3150;9.49;0.58;226.36;3.70;694;25;1079.00;0
2460;25;626393083;2460;202;3226;3275;9.30;0.57;226.46;3.62;766;25;1080.00;49
2464;25;626393110;2464;189;3231;3276;9.28;0.57;226.55;3.61;767;25;1081.00;45
2467;25;626393122;2467;167;3237;3276;9.37;0.58;226.76;3.61;770;25;1082.00;39
2470;25;626393135;2470;169;3241;3276;9.41;0.58;226.96;3.61;771;25;1083.00;35
2472;25;626393147;2472;164;3244;3276;9.49;0.58;227.04;3.61;772;25;1084.00;32
2476;25;626393159;2476;159;3250;3276;9.53;0.59;227.07;3.61;774;25;1085.00;26
2479;25;626393171;2479;163;3254;3276;9.56;0.59;227.19;3.62;775;25;1086.00;22
2481;25;626393184;2481;161;3256;3276;9.50;0.58;227.24;3.62;775;25;1087.00;20
2482;25;626393199;2482;160;3259;3277;9.51;0.58;227.30;3.62;777;25;1088.00;18
2484;25;626393214;2484;158;3262;3278;9.44;0.58;227.31;3.62;778;25;1089.00;16
2486;25;626393227;2486;165;3263;3278;9.32;0.57;227.40;3.62;777;25;1090.00;15
2489;25;626393240;2489;170;3268;3282;9.16;0.56;227.34;3.62;779;25;1091.00;14
2491;25;626393254;2491;174;3269;3282;9.06;0.56;227.39;3.62;778;25;1092.00;13
2492;25;626393268;2492;181;3269;3282;9.04;0.55;227.33;3.62;777;25;1093.00;13
2493;25;626393287;2493;189;3270;3282;9.00;0.55;227.31;3.63;777;25;1094.00;12
2495;25;626393299;2495;208;3274;3288;9.00;0.55;227.26;3.63;779;25;1095.00;14
2497;25;626393312;2497;209;3275;3288;8.97;0.55;227.30;3.63;778;25;1096.00;13
2498;25;626393325;2498;215;3275;3288;8.92;0.55;227.23;3.63;777;25;1097.00;13
2501;25;626393344;2501;219;3278;3291;8.89;0.54;227.11;3.63;777;25;1098.00;13
2502;25;626393356;2502;220;3279;3291;8.81;0.54;227.08;3.63;777;25;1099.00;12
2503;25;626393383;2503;227;3280;3291;8.75;0.54;227.08;3.63;777;25;1100.00;11
2505;25;626393402;2505;227;3281;3292;8.69;0.53;227.08;3.63;776;25;1101.00;11
2507;25;626393415;2507;228;3282;3293;8.69;0.53;226.96;3.63;775;25;1102.00;11
2508;25;626393427;2508;232;3282;3293;8.69;0.53;226.95;3.63;774;25;1103.00;11
2510;25;626393441;2510;238;3293;3306;8.61;0.53;226.90;3.62;783;25;1104.00;13
2511;25;626393457;2511;240;3293;3306;8.60;0.53;226.82;3.62;782;25;1105.00;13
2513;25;626393471;2513;252;3293;3306;8.54;0.52;226.91;3.62;780;25;1106.00;13
2516;25;626393483;2516;260;3294;3307;8.51;0.52;226.93;3.62;778;25;1107.00;13
2518;25;626393495;2518;266;3294;3307;8.52;0.52;226.90;3.62;776;25;1108.00;13
2521;25;626393506;2521;268;3297;3311;8.57;0.53;226.89;3.62;776;25;1109.00;14
2524;25;626393522;2524;265;3297;3311;8.53;0.52;226.75;3.62;773;25;1110.00;14
2525;25;626393534;2525;263;3301;3315;8.53;0.52;226.67;3.62;776;25;1111.00;14
2527;25;626393546;2527;257;3301;3315;8.54;0.52;226.58;3.62;774;25;1112.00;14
2531;25;626393558;2531;248;3301;3315;8.56;0.53;226.44;3.62;770;25;1113.00;14
2535;25;626393571;2535;243;3301;3315;8.51;0.52;226.44;3.62;766;25;1114.00;14
2537;25;626393583;2537;238;3301;3315;8.51;0.52;226.38;3.62;764;25;1115.00;14
2540;25;626393594;2540;234;3310;3327;8.56;0.52;226.25;3.61;770;25;1116.00;17
2546;25;626393607;2546;237;3310;3327;8.45;0.52;226.36;3.61;764;25;1117.00;17
2549;25;626393620;2549;234;3312;3327;8.41;0.51;226.28;3.61;763;25;1118.00;15
2550;25;626393632;2550;232;3312;3327;8.40;0.51;226.29;3.61;762;25;1119.00;15
2552;25;626393644;2552;232;3313;3327;8.35;0.51;226.31;3.62;761;25;1120.00;14
2556;25;626393655;2556;233;3313;3327;8.28;0.51;226.24;3.62;757;25;1121.00;14
2560;25;626393667;2560;226;3313;3328;8.25;0.50;226.20;3.62;753;25;1122.00;15
2564;25;626393679;2564;222;3313;3328;8.20;0.50;226.21;3.62;749;25;1123.00;15
2564;25;626393698;2564;224;3317;3334;8.20;0.50;226.21;3.62;753;25;1124.00;17
2565;25;626393710;2565;229;3322;3336;8.17;0.50;226.22;3.64;757;25;1125.00;14
2565;25;626393721;2565;225;3323;3336;8.18;0.50;226.22;3.64;758;25;1126.00;13
2567;25;626393732;2567;231;3324;3336;8.22;0.50;226.18;3.65;757;25;1127.00;12
2571;25;626393743;2571;227;3326;3340;8.30;0.50;226.20;3.65;755;25;1128.00;14
2573;25;626393756;2573;227;3326;3340;8.32;0.51;226.45;3.65;753;25;1129.00;14
2573;25;626393767;2573;223;3327;3340;8.37;0.51;226.45;3.66;754;25;1130.00;13
2575;25;626393781;2575;211;3328;3341;8.45;0.51;226.33;3.66;753;25;1131.00;13
2575;25;626393792;2575;202;3332;3345;8.55;0.52;226.33;3.67;757;25;1132.00;13
2577;25;626393804;2577;194;3332;3345;8.64;0.52;226.25;3.67;755;25;1133.00;13
2578;25;626393817;2578;190;3334;3348;8.75;0.53;226.24;3.67;756;25;1134.00;14
2579;25;626393833;2579;180;3336;3348;8.86;0.54;226.18;3.69;757;25;1135.00;12
2580;25;626393849;2580;173;3336;3348;8.98;0.54;226.12;3.69;756;25;1136.00;12
2585;25;626393861;2585;169;3338;3348;9.01;0.54;225.98;3.72;753;25;1137.00;10
2587;25;626393875;2587;164;3341;3352;9.13;0.55;225.84;3.72;754;25;1138.00;11
2588;26;626393892;2588;161;3342;3352;9.23;0.56;225.88;3.73;754;26;1139.00;10
2588;26;626393935;2588;159;3344;3352;9.39;0.57;225.88;3.74;756;26;1140.00;8
2588;26;626393951;2588;159;3344;3352;9.45;0.57;225.88;3.74;756;26;1141.00;8
2588;26;626393971;2588;160;3345;3353;9.52;0.58;225.88;3.75;757;26;1142.00;8
2589;27;626393982;2589;160;3346;3354;9.59;0.58;225.84;3.74;757;27;1143.00;8
2590;27;626394005;2590;159;3346;3354;9.64;0.59;225.82;3.74;756;27;1144.00;8
2592;27;626394016;2592;157;3347;3355;9.72;0.59;225.80;3.74;755;27;1145.00;8
2594;27;626394033;2594;160;3347;3355;9.76;0.59;225.75;3.74;753;27;1146.00;8
2595;27;626394050;2595;163;3347;3355;9.86;0.60;225.75;3.74;752;27;1147.00;8
2597;27;626394064;2597;161;3347;3355;9.89;0.60;225.73;3.74;750;27;1148.00;8
2598;27;626394074;2598;165;3348;3355;9.91;0.60;225.74;3.76;750;27;1149.00;7
2600;27;626394085;2600;167;3349;3355;9.91;0.60;225.76;3.77;749;27;1150.00;6
2602;27;626394095;2602;178;3349;3355;9.97;0.61;225.73;3.77;747;27;1151.00;6
2604;27;626394106;2604;196;3417;3482;9.95;0.61;225.86;3.70;813;27;1152.00;65
2606;27;626394128;2606;192;3419;3483;9.91;0.61;225.87;3.71;813;27;1153.00;64
2607;27;626394141;2607;186;3426;3483;9.97;0.61;225.84;3.71;819;27;1154.00;57
2610;27;626394155;2610;185;3432;3483;9.91;0.61;225.81;3.71;822;27;1155.00;51
2612;27;626394167;2612;182;3439;3483;9.91;0.61;225.86;3.72;827;27;1156.00;44
2615;27;626394178;2615;185;3441;3483;9.91;0.61;225.81;3.72;826;27;1157.00;42
2617;27;626394189;2617;179;3449;3483;9.96;0.61;225.92;3.73;832;27;1158.00;34
2618;27;626394199;2618;180;3449;3483;9.99;0.61;225.91;3.73;831;27;1159.00;34
2620;27;626394210;2620;185;3457;3484;10.06;0.62;226.09;3.74;837;27;1160.00;27
2625;27;626394221;2625;184;3460;3485;10.12;0.62;225.99;3.75;835;27;1161.00;25
2629;27;626394232;2629;193;3467;3485;10.14;0.62;226.20;3.76;838;27;1162.00;18
2632;27;626394250;2632;195;3470;3486;9.98;0.61;226.39;3.77;838;27;1163.00;16
2635;27;626394261;2635;197;3472;3486;9.83;0.60;226.58;3.77;837;27;1164.00;14
2639;27;626394278;2639;203;3474;3486;9.58;0.59;226.62;3.78;835;27;1165.00;12
2640;27;626394289;2640;206;3476;3486;9.42;0.58;226.78;3.78;836;27;1166.00;10
2642;27;626394307;2642;218;3480;3490;9.28;0.57;226.83;3.79;838;27;1167.00;10
2645;27;626394320;2645;232;3484;3490;9.10;0.56;227.02;3.80;839;27;1168.00;6
2649;27;626394333;2649;234;3485;3490;8.98;0.55;227.19;3.81;836;27;1169.00;5
2650;27;626394346;2650;241;3490;3496;8.86;0.54;227.27;3.81;840;27;1170.00;6
2653;27;626394359;2653;247;3491;3496;8.78;0.54;227.29;3.81;838;27;1171.00;5
2655;27;626394376;2655;250;3492;3496;8.71;0.53;227.38;3.81;837;27;1172.00;4
2659;27;626394388;2659;245;3496;3500;8.62;0.53;227.43;3.80;837;27;1173.00;4
2660;27;626394401;2660;247;3498;3501;8.62;0.53;227.35;3.80;838;27;1174.00;3
2661;27;626394412;2661;248;3499;3501;8.61;0.53;227.43;3.80;838;27;1175.00;2
2663;27;626394424;2663;253;3503;3505;8.65;0.53;227.65;3.80;840;27;1176.00;2
2665;27;626394436;2665;257;3504;3505;8.63;0.53;227.72;3.80;839;27;1177.00;1
2666;27;626394448;2666;251;3504;3505;8.58;0.52;227.83;3.80;838;27;1178.00;1
2669;27;626394466;2669;253;3505;3506;8.55;0.52;228.01;3.80;836;27;1179.00;1
2671;27;626394477;2671;254;3505;3506;8.50;0.52;228.07;3.80;834;27;1180.00;1
2676;27;626394494;2676;255;3510;3512;8.47;0.52;228.23;3.80;834;27;1181.00;2
2678;27;626394508;2678;260;3510;3512;8.40;0.51;228.28;3.80;832;27;1182.00;2
2680;27;626394520;2680;261;3512;3513;8.34;0.51;228.41;3.79;832;27;1183.00;1
2685;27;626394537;2685;263;3512;3513;8.28;0.51;228.45;3.79;827;27;1184.00;1
2691;27;626394563;2691;267;3512;3513;8.21;0.50;228.40;3.79;821;27;1185.00;1
2696;27;626394591;2696;263;3512;3513;8.13;0.50;228.48;3.79;816;27;1186.00;1
2699;27;626394618;2699;266;3512;3513;8.07;0.49;228.73;3.79;813;27;1187.00;1
2700;27;626394631;2700;268;3523;3525;8.07;0.49;228.72;3.78;823;27;1188.00;2
2703;27;626394647;2703;272;3523;3525;8.02;0.49;228.77;3.78;820;27;1189.00;2
2707;27;626394660;2707;261;3524;3525;7.97;0.49;228.83;3.78;817;27;1190.00;1
2709;27;626394672;2709;264;3524;3525;7.95;0.49;228.85;3.78;815;27;1191.00;1
2714;27;626394684;2714;256;3524;3525;7.89;0.48;229.00;3.78;810;27;1192.00;1
2717;28;626394701;2717;253;3524;3525;7.87;0.48;229.09;3.78;807;28;1193.00;1
2722;28;626394726;2722;252;3528;3529;7.87;0.48;229.37;3.78;806;28;1194.00;1
2725;28;626394741;2725;245;3528;3529;7.92;0.48;229.53;3.78;803;28;1195.00;1
2728;28;626394755;2728;248;3531;3533;8.01;0.49;229.73;3.78;803;28;1196.00;2
2735;28;626394771;2735;236;3532;3534;8.09;0.50;230.09;3.78;797;28;1197.00;2
2737;28;626394794;2737;229;3533;3534;8.23;0.50;230.17;3.78;796;28;1198.00;1
2743;28;626394808;2743;217;3533;3534;8.33;0.51;230.37;3.78;790;28;1199.00;1
2749;28;626394836;2749;220;3556;3575;8.29;0.51;230.59;3.75;807;28;1200.00;19
2753;28;626394860;2753;207;3557;3575;8.36;0.51;230.57;3.75;804;28;1201.00;18
2756;28;626394881;2756;208;3559;3575;8.37;0.51;230.73;3.75;803;28;1202.00;16
2760;28;626394893;2760;200;3562;3576;8.38;0.51;230.89;3.75;802;28;1203.00;14
2761;28;626394910;2761;199;3565;3577;8.39;0.51;230.95;3.75;804;28;1204.00;12
2766;28;626394930;2766;197;3567;3577;8.36;0.51;231.08;3.75;801;28;1205.00;10
2771;28;626394950;2771;192;3569;3580;8.38;0.51;231.09;3.75;798;28;1206.00;11
2773;28;626394969;2773;193;3569;3580;8.38;0.51;231.07;3.75;796;28;1207.00;11
2778;28;626394987;2778;198;3571;3580;8.33;0.51;230.99;3.75;793;28;1208.00;9
2783;28;626395004;2783;195;3571;3580;8.35;0.51;231.16;3.75;788;28;1209.00;9
2786;28;626395021;2786;199;3577;3586;8.42;0.52;231.15;3.74;791;28;1210.00;9
2789;28;626395037;2789;201;3578;3586;8.42;0.51;231.15;3.75;789;28;1211.00;8
2796;28;626395052;2796;203;3579;3586;8.47;0.51;231.18;3.75;783;28;1212.00;7
2800;28;626395077;2800;194;3579;3586;8.54;0.52;231.27;3.75;779;28;1213.00;7
2803;28;626395091;2803;191;3583;3590;8.58;0.52;231.31;3.74;780;28;1214.00;7
2806;28;626395106;2806;187;3585;3592;8.65;0.53;231.36;3.74;779;28;1215.00;7
2808;28;626395121;2808;188;3585;3592;8.70;0.53;231.39;3.74;777;28;1216.00;7
2816;28;626395141;2816;192;3587;3593;8.69;0.53;231.88;3.74;771;28;1217.00;6
2820;28;626395161;2820;191;3587;3593;8.72;0.53;231.85;3.74;767;28;1218.00;6
2826;28;626395192;2826;192;3587;3593;8.80;0.54;231.83;3.74;761;28;1219.00;6
2832;28;626395209;2832;190;3587;3593;8.84;0.54;232.25;3.74;755;28;1220.00;6
2837;28;626395226;2837;189;3587;3593;8.76;0.54;232.20;3.74;750;28;1221.00;6
2843;28;626395246;2843;189;3588;3593;8.66;0.53;231.99;3.76;745;28;1222.00;5
2847;28;626395264;2847;196;3589;3593;8.59;0.52;232.08;3.77;742;28;1223.00;4
2851;28;626395278;2851;209;3629;3663;8.50;0.52;232.27;3.73;778;28;1224.00;34
2857;28;626395301;2857;207;3631;3664;8.55;0.52;232.47;3.73;774;28;1225.00;33
2861;28;626395320;2861;204;3636;3664;8.70;0.53;232.73;3.72;775;28;1226.00;28
2867;28;626395336;2867;211;3636;3664;8.70;0.53;232.90;3.72;769;28;1227.00;28
2873;28;626395357;2873;215;3642;3666;8.78;0.54;233.12;3.72;769;28;1228.00;24
2877;28;626395385;2877;225;3644;3666;8.79;0.54;233.16;3.73;767;28;1229.00;22
2879;28;626395404;2879;227;3648;3666;8.81;0.54;233.22;3.73;769;28;1230.00;18
2887;28;626395420;2887;232;3649;3666;8.72;0.54;233.34;3.73;762;28;1231.00;17
2890;28;626395435;2890;241;3653;3667;8.70;0.54;233.44;3.74;763;28;1232.00;14
2895;28;626395450;2895;245;3655;3668;8.66;0.53;233.61;3.74;760;28;1233.00;13
2899;28;626395468;2899;248;3657;3668;8.60;0.53;233.69;3.74;758;28;1234.00;11
2901;28;626395484;2901;263;3665;3672;8.49;0.52;233.88;3.75;764;28;1235.00;7
2904;29;626395511;2904;268;3667;3672;8.38;0.51;234.02;3.76;763;29;1236.00;5
2905;29;626395545;2905;266;3668;3672;8.36;0.51;234.09;3.76;763;29;1237.00;4
2910;29;626395564;2910;267;3668;3672;8.32;0.51;234.08;3.76;758;29;1238.00;4
2913;29;626395579;2913;264;3675;3678;8.28;0.51;234.23;3.76;762;29;1239.00;3
2916;29;626395594;2916;260;3675;3678;8.27;0.51;234.32;3.76;759;29;1240.00;3
2916;29;626395607;2916;258;3676;3678;8.25;0.51;234.32;3.77;760;29;1241.00;2
2918;29;626395626;2918;260;3679;3681;8.28;0.51;234.36;3.76;761;29;1242.00;2
2925;29;626395638;2925;261;3679;3681;8.27;0.51;234.31;3.76;754;29;1243.00;2
2925;29;626395651;2925;264;3679;3681;8.28;0.51;234.31;3.76;754;29;1244.00;2
2926;29;626395664;2926;270;3680;3682;8.27;0.51;234.31;3.76;754;29;1245.00;2
2929;29;626395678;2929;261;3682;3683;8.31;0.51;234.35;3.77;753;29;1246.00;1
2933;29;626395692;2933;252;3682;3683;8.30;0.51;234.39;3.77;749;29;1247.00;1
2936;29;626395714;2936;240;3695;3696;8.37;0.51;234.37;3.76;759;29;1248.00;1
2938;29;626395740;2938;230;3695;3696;8.41;0.51;234.43;3.76;757;29;1249.00;1
2940;29;626395753;2940;228;3695;3696;8.42;0.51;234.56;3.76;755;29;1250.00;1
2946;29;626395768;2946;228;3696;3697;8.48;0.52;234.59;3.76;750;29;1251.00;1
2948;29;626395783;2948;228;3696;3697;8.56;0.52;234.55;3.76;748;29;1252.00;1
2952;29;626395796;2952;229;3699;3701;8.62;0.53;234.77;3.76;747;29;1253.00;2
2956;29;626395811;2956;230;3699;3701;8.70;0.53;234.65;3.76;743;29;1254.00;2
2960;29;626395824;2960;232;3704;3705;8.74;0.53;234.51;3.75;744;29;1255.00;1
2961;29;626395837;2961;227;3704;3705;8.75;0.53;234.51;3.75;743;29;1256.00;1
2966;29;626395854;2966;221;3705;3705;8.73;0.53;234.46;3.76;739;29;1257.00;0
2971;29;626395876;2971;222;3705;3705;8.64;0.52;234.34;3.76;734;29;1258.00;0
2972;29;626395890;2972;221;3705;3705;8.56;0.52;234.29;3.76;733;29;1259.00;0
2974;29;626395907;2974;222;3727;3739;8.49;0.52;234.18;3.74;753;29;1260.00;12
2976;29;626395923;2976;226;3727;3739;8.44;0.52;234.20;3.74;751;29;1261.00;12
2977;29;626395936;2977;224;3728;3739;8.44;0.52;234.21;3.74;751;29;1262.00;11
2979;29;626395950;2979;230;3728;3739;8.41;0.52;234.07;3.74;749;29;1263.00;11
2979;29;626395962;2979;230;3730;3739;8.43;0.52;234.07;3.74;751;29;1264.00;9
2979;29;626395974;2979;229;3730;3739;8.48;0.52;234.07;3.74;751;29;1265.00;9
2980;29;626395984;2980;233;3731;3740;8.42;0.52;234.08;3.74;751;29;1266.00;9
2981;29;626395996;2981;234;3732;3740;8.41;0.52;234.04;3.74;751;29;1267.00;8
2984;29;626396023;2984;236;3736;3746;8.32;0.51;233.95;3.74;752;29;1268.00;10
2987;29;626396043;2987;236;3738;3747;8.27;0.51;233.98;3.74;751;29;1269.00;9
2988;29;626396061;2988;234;3739;3747;8.26;0.51;233.99;3.74;751;29;1270.00;8
2988;29;626396071;2988;248;3740;3747;8.23;0.50;233.99;3.74;752;29;1271.00;7
2991;29;626396083;2991;252;3742;3751;8.20;0.50;233.90;3.74;751;29;1272.00;9
2992;29;626396101;2992;253;3744;3751;8.15;0.50;233.89;3.74;752;29;1273.00;7
2993;29;626396112;2993;263;3744;3751;8.08;0.49;233.85;3.74;751;29;1274.00;7
2995;29;626396127;2995;269;3745;3752;8.02;0.49;233.80;3.74;750;29;1275.00;7
2998;29;626396138;2998;277;3749;3756;7.93;0.48;233.80;3.74;751;29;1276.00;7
2999;29;626396149;2999;283;3749;3756;7.90;0.48;233.81;3.74;750;29;1277.00;7
3000;29;626396162;3000;291;3751;3759;7.89;0.48;233.79;3.74;751;29;1278.00;8
3002;29;626396174;3002;292;3751;3759;7.77;0.47;233.86;3.74;749;29;1279.00;8
3004;29;626396184;3004;291;3752;3759;7.71;0.47;233.85;3.74;748;29;1280.00;7
3006;29;626396195;3006;294;3752;3759;7.60;0.46;233.85;3.74;746;29;1281.00;7
3007;29;626396206;3007;293;3755;3763;7.59;0.46;233.84;3.73;748;29;1282.00;8
3009;29;626396217;3009;278;3755;3763;7.56;0.46;233.80;3.73;746;29;1283.00;8
3010;29;626396229;3010;261;3756;3763;7.57;0.46;233.80;3.73;746;29;1284.00;7
3013;29;626396240;3013;248;3756;3763;7.58;0.46;233.85;3.73;743;29;1285.00;7
3015;29;626396251;3015;237;3756;3764;7.62;0.46;233.80;3.73;741;29;1286.00;8
3016;29;626396262;3016;230;3757;3765;7.74;0.47;233.79;3.73;741;29;1287.00;8
3017;29;626396276;3017;223;3757;3765;7.76;0.47;233.78;3.73;740;29;1288.00;8
3022;29;626396295;3022;210;3758;3766;7.80;0.47;233.76;3.73;736;29;1289.00;8
3024;29;626396306;3024;198;3758;3766;7.83;0.47;233.75;3.73;734;29;1290.00;8
3026;29;626396316;3026;192;3758;3766;7.90;0.48;233.78;3.73;732;29;1291.00;8
3026;29;626396325;3026;179;3758;3766;7.92;0.48;233.78;3.73;732;29;1292.00;8
3026;29;626396342;3026;170;3758;3766;8.07;0.49;233.78;3.73;732;29;1293.00;8
3029;29;626396352;3029;167;3759;3766;8.18;0.50;233.71;3.74;730;29;1294.00;7
3030;29;626396371;3030;155;3759;3766;8.29;0.50;233.71;3.74;729;29;1295.00;7
3033;29;626396382;3033;168;3823;3893;8.45;0.52;233.58;3.69;790;29;1296.00;70
3035;29;626396404;3035;152;3823;3894;8.56;0.53;233.52;3.69;788;29;1297.00;71
3036;29;626396415;3036;144;3830;3894;8.76;0.54;233.49;3.68;794;29;1298.00;64
3040;29;626396426;3040;135;3835;3894;8.84;0.54;233.40;3.68;795;29;1299.00;59
3040;29;626396441;3040;132;3841;3894;8.99;0.55;233.40;3.68;801;29;1300.00;53
3041;29;626396459;3041;124;3846;3894;9.03;0.55;233.38;3.69;805;29;1301.00;48
3041;29;626396471;3041;120;3849;3894;9.14;0.56;233.38;3.69;808;29;1302.00;45
3041;29;626396481;3041;122;3851;3894;9.26;0.57;233.38;3.69;810;29;1303.00;43
3043;29;626396492;3043;121;3856;3895;9.32;0.57;233.43;3.69;813;29;1304.00;39
3046;29;626396506;3046;121;3858;3897;9.38;0.58;233.33;3.69;812;29;1305.00;39
3049;29;626396519;3049;121;3861;3897;9.46;0.58;233.43;3.70;812;29;1306.00;36
3053;29;626396531;3053;119;3862;3898;9.53;0.58;233.39;3.70;809;29;1307.00;36
3056;29;626396545;3056;124;3864;3898;9.58;0.59;233.34;3.70;808;29;1308.00;34
3057;29;626396557;3057;126;3868;3898;9.51;0.58;233.31;3.71;811;29;1309.00;30
3061;29;626396570;3061;129;3870;3898;9.43;0.58;233.26;3.72;809;29;1310.00;28
3066;29;626396582;3066;131;3872;3902;9.36;0.57;233.17;3.72;806;29;1311.00;30
3069;29;626396595;3069;138;3875;3902;9.38;0.57;233.24;3.73;806;29;1312.00;27
3072;29;626396606;3072;143;3880;3902;9.33;0.57;233.40;3.76;808;29;1313.00;22
3076;29;626396619;3076;152;3884;3905;9.37;0.57;233.43;3.76;808;29;1314.00;21
3078;29;626396631;3078;147;3885;3905;9.36;0.57;233.52;3.76;807;29;1315.00;20
3080;29;626396642;3080;156;3888;3905;9.34;0.57;233.54;3.77;808;29;1316.00;17
3081;29;626396659;3081;162;3893;3909;9.29;0.56;233.58;3.79;812;29;1317.00;16
3085;29;626396674;3085;168;3896;3910;9.30;0.56;233.73;3.80;811;29;1318.00;14
3089;29;626396688;3089;174;3897;3910;9.29;0.56;233.89;3.80;808;29;1319.00;13
3091;29;626396707;3091;172;3902;3915;9.31;0.56;233.95;3.81;811;29;1320.00;13
3095;29;626396722;3095;176;3903;3915;9.21;0.56;234.06;3.81;808;29;1321.00;12
3095;29;626396737;3095;176;3903;3915;9.25;0.56;234.06;3.81;808;29;1322.00;12
3099;29;626396750;3099;180;3905;3916;9.27;0.56;234.08;3.82;806;29;1323.00;11
3104;29;626396765;3104;190;3906;3916;9.32;0.57;234.25;3.83;802;29;1324.00;10
3105;29;626396779;3105;187;3910;3922;9.36;0.57;234.30;3.82;805;29;1325.00;12
3108;29;626396798;3108;186;3913;3922;9.32;0.57;234.41;3.84;805;29;1326.00;9
3110;29;626396824;3110;188;3913;3923;9.30;0.56;234.50;3.84;803;29;1327.00;10
3112;29;626396837;3112;189;3914;3923;9.23;0.56;234.68;3.84;802;29;1328.00;9
3113;29;626396850;3113;188;3915;3923;9.22;0.56;234.78;3.85;802;29;1329.00;8
3115;29;626396862;3115;186;3915;3923;9.13;0.56;234.91;3.85;800;29;1330.00;8
3119;29;626396882;3119;189;3916;3923;9.07;0.55;235.03;3.86;797;29;1331.00;7
3119;29;626396895;3119;186;3926;3935;9.08;0.55;235.03;3.85;807;29;1332.00;9
3122;29;626396912;3122;188;3927;3935;9.00;0.55;235.05;3.85;805;29;1333.00;8
3126;29;626396937;3126;192;3931;3935;8.96;0.55;235.10;3.88;805;29;1334.00;4
3129;29;626396954;3129;200;3931;3935;8.91;0.54;234.98;3.88;802;29;1335.00;4
3131;29;626396974;3131;204;3931;3935;8.78;0.54;235.08;3.88;800;29;1336.00;4
3136;29;626396993;3136;206;3932;3935;8.65;0.53;235.28;3.88;796;29;1337.00;3
3137;29;626397013;3137;214;3935;3939;8.57;0.52;235.35;3.88;798;29;1338.00;4
3139;29;626397030;3139;210;3938;3939;8.54;0.52;235.42;3.89;799;29;1339.00;1
3141;29;626397044;3141;210;3942;3943;8.59;0.52;235.49;3.88;801;29;1340.00;1
3143;29;626397063;3143;216;3943;3944;8.63;0.53;235.55;3.88;800;29;1341.00;1
3148;29;626397078;3148;220;3944;3944;8.61;0.52;235.77;3.88;796;29;1342.00;0
3150;29;626397091;3150;219;3944;3944;8.59;0.52;235.67;3.88;794;29;1343.00;0
3153;29;626397106;3153;220;3956;3957;8.59;0.52;235.74;3.87;803;29;1344.00;1
3156;29;626397124;3156;216;3956;3957;8.63;0.53;235.82;3.87;800;29;1345.00;1
3157;29;626397138;3157;215;3957;3957;8.70;0.53;235.78;3.87;800;29;1346.00;0
3160;29;626397154;3160;214;3958;3958;8.70;0.53;235.86;3.87;798;29;1347.00;0
3163;29;626397169;3163;218;3959;3959;8.62;0.52;236.10;3.87;796;29;1348.00;0
3163;29;626397183;3163;226;3959;3959;8.62;0.53;236.10;3.87;796;29;1349.00;0
3164;29;626397201;3164;222;3962;3968;8.54;0.52;236.20;3.87;798;29;1350.00;6
3164;29;626397217;3164;225;3964;3968;8.55;0.52;236.20;3.87;800;29;1351.00;4
3167;29;626397234;3167;225;3964;3968;8.50;0.52;236.21;3.87;797;29;1352.00;4
3171;29;626397247;3171;227;3965;3968;8.40;0.51;236.32;3.86;794;29;1353.00;3
3174;29;626397260;3174;230;3969;3974;8.34;0.51;236.39;3.86;795;29;1354.00;5
3178;29;626397273;3178;237;3970;3974;8.21;0.50;236.50;3.86;792;29;1355.00;4
3183;29;626397285;3183;237;3970;3974;8.09;0.49;236.63;3.86;787;29;1356.00;4
3187;29;626397297;3187;245;3971;3974;7.95;0.49;236.73;3.86;784;29;1357.00;3
3192;29;626397310;3192;246;3975;3978;7.78;0.48;236.79;3.86;783;29;1358.00;3
3194;29;626397323;3194;255;3978;3979;7.66;0.47;236.90;3.86;784;29;1359.00;1
3195;29;626397340;3195;247;3978;3979;7.64;0.47;236.89;3.86;783;29;1360.00;1
3201;29;626397352;3201;237;3979;3980;7.55;0.46;236.83;3.86;778;29;1361.00;1
3207;29;626397365;3207;233;3979;3980;7.55;0.46;236.95;3.86;772;29;1362.00;1
3210;29;626397376;3210;236;3979;3980;7.57;0.46;236.87;3.86;769;29;1363.00;1
3215;29;626397388;3215;225;3979;3980;7.55;0.46;237.21;3.86;764;29;1364.00;1
3219;29;626397401;3219;224;3979;3980;7.54;0.46;237.26;3.86;760;29;1365.00;1
3223;29;626397413;3223;222;3979;3980;7.58;0.46;237.39;3.86;756;29;1366.00;1
3225;29;626397426;3225;218;3979;3980;7.66;0.47;237.50;3.86;754;29;1367.00;1
3231;29;626397440;3231;218;4022;4050;7.88;0.48;237.62;3.82;791;29;1368.00;28
3233;29;626397462;3233;213;4027;4051;8.02;0.49;237.71;3.81;794;29;1369.00;24
3236;29;626397481;3236;202;4032;4051;8.18;0.50;237.94;3.81;796;29;1370.00;19
3239;29;626397495;3239;201;4037;4051;8.38;0.51;238.09;3.81;798;29;1371.00;14
3245;29;626397512;3245;204;4041;4051;8.45;0.52;238.23;3.81;796;29;1372.00;10
3249;29;626397525;3249;204;4045;4051;8.63;0.53;238.45;3.81;796;29;1373.00;6
3251;29;626397540;3251;199;4046;4051;8.65;0.53;238.44;3.81;795;29;1374.00;5
3258;29;626397557;3258;199;4047;4051;8.64;0.53;238.40;3.81;789;29;1375.00;4
3259;29;626397572;3259;200;4049;4052;8.64;0.53;238.52;3.81;790;29;1376.00;3
3263;29;626397585;3263;198;4050;4053;8.70;0.53;238.59;3.81;787;29;1377.00;3
3266;29;626397602;3266;201;4051;4053;8.72;0.54;238.69;3.82;785;29;1378.00;2
3272;29;626397616;3272;203;4054;4057;8.69;0.53;238.64;3.81;782;29;1379.00;3
3279;29;626397631;3279;203;4054;4057;8.68;0.53;238.67;3.81;775;29;1380.00;3
3282;29;626397646;3282;203;4054;4057;8.65;0.53;238.70;3.81;772;29;1381.00;3
3285;29;626397661;3285;203;4054;4057;8.70;0.53;238.76;3.81;769;29;1382.00;3
3290;29;626397675;3290;208;4058;4063;8.67;0.53;238.71;3.81;768;29;1383.00;5
3295;30;626397695;3295;213;4059;4063;8.67;0.53;239.06;3.81;764;30;1384.00;4
3298;30;626397726;3298;216;4060;4063;8.73;0.53;239.01;3.81;762;30;1385.00;3
3304;30;626397742;3304;222;4063;4066;8.73;0.53;239.25;3.81;759;30;1386.00;3
3311;30;626397759;3311;228;4065;4066;8.73;0.53;239.39;3.82;754;30;1387.00;1
3314;30;626397775;3314;231;4065;4066;8.74;0.54;239.58;3.82;751;30;1388.00;1
3323;30;626397791;3323;227;4067;4067;8.65;0.53;239.64;3.82;744;30;1389.00;0
3328;30;626397807;3328;231;4068;4068;8.52;0.52;239.56;3.82;740;30;1390.00;0
3332;30;626397824;3332;236;4068;4068;8.39;0.51;239.56;3.82;736;30;1391.00;0
3335;30;626397842;3335;237;4081;4081;8.37;0.51;239.54;3.81;746;30;1392.00;0
3338;30;626397859;3338;240;4081;4081;8.29;0.51;239.56;3.81;743;30;1393.00;0
3341;30;626397872;3341;244;4081;4081;8.20;0.50;239.49;3.81;740;30;1394.00;0
3346;30;626397900;3346;250;4083;4083;8.15;0.50;239.67;3.81;737;30;1395.00;0
3348;30;626397919;3348;262;4083;4083;8.11;0.49;239.66;3.81;735;30;1396.00;0
3351;30;626397933;3351;264;4086;4087;8.08;0.49;239.73;3.80;735;30;1397.00;1
3355;30;626397947;3355;274;4086;4087;7.97;0.49;239.67;3.80;731;30;1398.00;1
3357;30;626397959;3357;277;4091;4091;8.00;0.49;239.64;3.80;734;30;1399.00;0
3358;30;626397977;3358;288;4091;4091;7.93;0.48;239.62;3.80;733;30;1400.00;0
3362;30;626397995;3362;293;4091;4091;7.87;0.48;239.64;3.80;729;30;1401.00;0
3364;30;626398009;3364;302;4091;4091;7.75;0.47;239.65;3.80;727;30;1402.00;0
3367;30;626398028;3367;313;4091;4091;7.66;0.47;239.69;3.80;724;30;1403.00;0
3370;30;626398041;3370;313;4102;4103;7.68;0.47;239.61;3.79;732;30;1404.00;1
3372;30;626398055;3372;315;4102;4103;7.54;0.46;239.60;3.79;730;30;1405.00;1
3373;30;626398066;3373;322;4103;4103;7.48;0.45;239.58;3.79;730;30;1406.00;0
3376;30;626398082;3376;316;4103;4103;7.43;0.45;239.57;3.79;727;30;1407.00;0
3380;30;626398095;3380;313;4103;4103;7.35;0.45;239.58;3.79;723;30;1408.00;0
3381;30;626398109;3381;313;4103;4103;7.34;0.45;239.54;3.79;722;30;1409.00;0
3384;30;626398125;3384;317;4104;4104;7.35;0.45;239.72;3.79;720;30;1410.00;0
3388;30;626398139;3388;313;4104;4104;7.36;0.45;239.51;3.79;716;30;1411.00;0
3389;30;626398151;3389;314;4109;4110;7.45;0.45;239.49;3.79;720;30;1412.00;1
3392;30;626398163;3392;314;4110;4111;7.45;0.45;239.37;3.78;718;30;1413.00;1
3392;30;626398176;3392;319;4111;4111;7.45;0.45;239.37;3.78;719;30;1414.00;0
3392;30;626398190;3392;322;4111;4111;7.47;0.45;239.37;3.78;719;30;1415.00;0
3392;30;626398203;3392;305;4115;4115;7.52;0.46;239.37;3.78;723;30;1416.00;0
3394;30;626398216;3394;288;4115;4115;7.58;0.46;239.28;3.78;721;30;1417.00;0
3395;30;626398232;3395;276;4115;4115;7.67;0.47;239.23;3.78;720;30;1418.00;0
3396;30;626398245;3396;270;4116;4116;7.74;0.47;239.20;3.78;720;30;1419.00;0
3399;30;626398262;3399;265;4120;4120;7.77;0.47;239.14;3.78;721;30;1420.00;0
3401;30;626398274;3401;264;4120;4120;7.80;0.47;239.18;3.78;719;30;1421.00;0
3401;30;626398286;3401;259;4122;4123;7.86;0.48;239.18;3.78;721;30;1422.00;1
3403;30;626398298;3403;254;4122;4123;7.90;0.48;239.13;3.78;719;30;1423.00;1
3403;30;626398313;3403;252;4123;4123;7.96;0.48;239.13;3.77;720;30;1424.00;0
3405;30;626398324;3405;249;4123;4123;8.00;0.49;239.08;3.77;718;30;1425.00;0
3406;30;626398335;3406;251;4126;4127;8.06;0.49;239.02;3.77;720;30;1426.00;1
3406;30;626398346;3406;254;4126;4127;8.08;0.49;239.02;3.77;720;30;1427.00;1
3409;30;626398357;3409;255;4127;4127;8.07;0.49;238.99;3.77;718;30;1428.00;0
3410;30;626398368;3410;256;4127;4127;8.02;0.49;239.00;3.77;717;30;1429.00;0
3413;30;626398378;3413;261;4128;4128;7.96;0.48;239.00;3.77;715;30;1430.00;0
3413;30;626398389;3413;264;4129;4129;8.00;0.49;239.00;3.77;716;30;1431.00;0
3416;31;626398399;3416;266;4129;4129;7.96;0.49;238.98;3.77;713;31;1432.00;0
3417;31;626398420;3417;268;4130;4130;7.93;0.48;238.95;3.77;713;31;1433.00;0
3419;31;626398430;3419;271;4130;4130;7.83;0.48;238.91;3.77;711;31;1434.00;0
3422;32;626398439;3422;259;4130;4130;7.84;0.48;238.85;3.77;708;32;1435.00;0
3422;32;626398465;3422;253;4130;4130;7.86;0.48;238.85;3.77;708;32;1436.00;0
3424;32;626398475;3424;248;4130;4130;7.94;0.48;238.81;3.77;706;32;1437.00;0
3424;32;626398485;3424;249;4130;4130;7.98;0.49;238.81;3.77;706;32;1438.00;0
3427;32;626398495;3427;239;4130;4130;7.99;0.49;238.75;3.77;703;32;1439.00;0
3429;32;626398512;3429;283;4247;4360;8.06;0.50;238.75;3.67;818;32;1440.00;113
3433;32;626398541;3433;271;4250;4361;8.08;0.50;238.67;3.67;817;32;1441.00;111
3435;32;626398557;3435;249;4259;4361;8.16;0.51;238.67;3.66;824;32;1442.00;102
3436;33;626398568;3436;247;4264;4361;8.22;0.51;238.68;3.66;828;33;1443.00;97
3439;33;626398590;3439;244;4269;4361;8.33;0.52;238.60;3.66;830;33;1444.00;92
3439;34;626398606;3439;238;4273;4361;8.40;0.52;238.60;3.66;834;34;1445.00;88
3440;34;626398627;3440;240;4278;4361;8.44;0.52;238.58;3.67;838;34;1446.00;83
3441;34;626398644;3441;239;4284;4361;8.44;0.52;238.55;3.67;843;34;1447.00;77
3442;34;626398659;3442;250;4289;4362;8.42;0.52;238.52;3.68;847;34;1448.00;73
3444;34;626398671;3444;249;4293;4363;8.41;0.52;238.54;3.68;849;34;1449.00;70
3445;34;626398688;3445;250;4298;4363;8.42;0.52;238.55;3.69;853;34;1450.00;65
3445;34;626398700;3445;249;4300;4364;8.45;0.52;238.55;3.69;855;34;1451.00;64
3446;34;626398712;3446;256;4302;4364;8.52;0.53;238.59;3.69;856;34;1452.00;62
3449;34;626398724;3449;255;4305;4364;8.56;0.53;238.57;3.70;856;34;1453.00;59
3451;34;626398735;3451;260;4308;4364;8.64;0.54;238.55;3.71;857;34;1454.00;56
3454;34;626398746;3454;251;4314;4368;8.65;0.53;238.54;3.72;860;34;1455.00;54
3457;34;626398759;3457;251;4318;4368;8.68;0.53;238.58;3.73;861;34;1456.00;50
3459;34;626398772;3459;246;4319;4368;8.81;0.54;238.52;3.73;860;34;1457.00;49
3465;34;626398784;3465;246;4323;4371;8.86;0.54;238.60;3.74;858;34;1458.00;48
3467;34;626398798;3467;247;4324;4371;8.93;0.55;238.61;3.74;857;34;1459.00;47
3470;34;626398810;3470;241;4324;4371;8.99;0.55;238.74;3.74;854;34;1460.00;47
3476;34;626398827;3476;237;4329;4375;9.01;0.55;238.92;3.74;853;34;1461.00;46
3480;34;626398839;3480;226;4331;4376;9.14;0.56;238.88;3.75;851;34;1462.00;45
3483;34;626398851;3483;225;4332;4376;9.22;0.56;238.98;3.75;849;34;1463.00;44
3487;34;626398862;3487;223;4336;4380;9.26;0.57;239.12;3.76;849;34;1464.00;44
3487;34;626398874;3487;210;4339;4380;9.31;0.57;239.12;3.77;852;34;1465.00;41
3490;34;626398885;3490;206;4341;4380;9.30;0.57;239.20;3.78;851;34;1466.00;39
3495;34;626398895;3495;199;4344;4381;9.22;0.56;239.29;3.79;849;34;1467.00;37
3497;34;626398909;3497;194;4344;4381;9.22;0.56;239.29;3.79;847;34;1468.00;37
3500;34;626398926;3500;183;4349;4387;9.21;0.56;239.36;3.79;849;34;1469.00;38
3502;34;626398947;3502;173;4349;4387;9.23;0.56;239.39;3.79;847;34;1470.00;38
3504;34;626398967;3504;171;4350;4388;9.25;0.56;239.40;3.79;846;34;1471.00;38
3507;34;626398986;3507;167;4351;4388;9.28;0.56;239.43;3.80;844;34;1472.00;37
3509;34;626399005;3509;169;4351;4388;9.34;0.57;239.49;3.80;842;34;1473.00;37
3511;34;626399021;3511;172;4353;4388;9.38;0.57;239.58;3.81;842;34;1474.00;35
3513;35;626399036;3513;171;4353;4388;9.45;0.57;239.67;3.81;840;35;1475.00;35
3514;35;626399060;3514;177;4364;4400;9.61;0.58;239.69;3.80;850;35;1476.00;36
3517;35;626399078;3517;181;4366;4400;9.64;0.59;239.72;3.82;849;35;1477.00;34
3520;35;626399092;3520;184;4366;4400;9.69;0.59;239.78;3.82;846;35;1478.00;34
3524;35;626399106;3524;183;4366;4400;9.75;0.59;239.78;3.82;842;35;1479.00;34
3527;35;626399119;3527;186;4369;4400;9.77;0.59;239.85;3.84;842;35;1480.00;31
3530;35;626399133;3530;185;4369;4400;9.81;0.59;240.00;3.84;839;35;1481.00;31
3531;35;626399147;3531;184;4373;4404;9.85;0.60;239.98;3.84;842;35;1482.00;31
3534;35;626399161;3534;186;4373;4404;9.90;0.60;240.18;3.84;839;35;1483.00;31
3536;35;626399176;3536;190;4377;4408;9.96;0.60;240.24;3.85;841;35;1484.00;31
3538;35;626399190;3538;189;4379;4410;10.03;0.61;240.31;3.85;841;35;1485.00;31
3540;35;626399210;3540;189;4381;4410;10.05;0.61;240.43;3.86;841;35;1486.00;29
3543;35;626399223;3543;195;4381;4410;10.05;0.61;240.45;3.86;838;35;1487.00;29
3547;35;626399236;3547;197;4390;4423;10.03;0.61;240.46;3.86;843;35;1488.00;33
3548;35;626399252;3548;197;4391;4423;9.99;0.61;240.51;3.87;843;35;1489.00;32
3550;35;626399265;3550;200;4392;4423;9.92;0.60;240.61;3.87;842;35;1490.00;31
3552;35;626399279;3552;202;4396;4424;9.92;0.60;240.55;3.90;844;35;1491.00;28
3556;35;626399292;3556;210;4396;4425;9.85;0.60;240.52;3.90;840;35;1492.00;29
3558;35;626399306;3558;210;4397;4425;9.84;0.60;240.58;3.91;839;35;1493.00;28
3560;35;626399319;3560;215;4401;4428;9.81;0.60;240.61;3.93;841;35;1494.00;27
3562;35;626399340;3562;217;4401;4428;9.75;0.59;240.73;3.93;839;35;1495.00;27
3565;35;626399354;3565;223;4403;4428;9.74;0.59;240.67;3.95;838;35;1496.00;25
3569;35;626399366;3569;223;4405;4428;9.70;0.59;240.78;3.97;836;35;1497.00;23
3573;35;626399380;3573;226;4410;4434;9.71;0.59;240.87;3.98;837;35;1498.00;24
3575;35;626399393;3575;227;4411;4434;9.70;0.59;240.82;3.98;836;35;1499.00;23
3579;35;626399414;3579;231;4417;4453;9.66;0.59;240.81;4.01;838;35;1500.00;36
3584;35;626399442;3584;233;4420;4453;9.57;0.58;240.88;4.03;836;35;1501.00;33
3585;35;626399458;3585;237;4425;4457;9.49;0.58;240.93;4.05;840;35;1502.00;32
3588;35;626399472;3588;239;4427;4458;9.42;0.57;240.99;4.06;839;35;1503.00;31
3588;35;626399485;3588;242;4430;4458;9.38;0.57;240.99;4.09;842;35;1504.00;28
3594;35;626399498;3594;249;4434;4459;9.27;0.57;241.12;4.11;840;35;1505.00;25
3594;35;626399511;3594;251;4435;4459;9.21;0.56;241.12;4.12;841;35;1506.00;24
3601;35;626399524;3601;253;4438;4459;9.07;0.55;241.31;4.12;837;35;1507.00;21
3604;35;626399539;3604;258;4440;4459;8.92;0.54;241.34;4.14;836;35;1508.00;19
3607;35;626399552;3607;258;4441;4459;8.84;0.54;241.41;4.15;834;35;1509.00;18
3609;35;626399564;3609;258;4443;4459;8.85;0.54;241.41;4.15;834;35;1510.00;16
3610;35;626399575;3610;259;4446;4459;8.81;0.54;241.50;4.16;836;35;1511.00;13
3612;35;626399588;3612;264;4475;4529;8.78;0.54;241.58;4.14;863;35;1512.00;54
3614;35;626399609;3614;259;4479;4530;8.76;0.54;241.65;4.14;865;35;1513.00;51
3618;35;626399621;3618;264;4488;4530;8.74;0.53;241.58;4.14;870;35;1514.00;42
3621;35;626399633;3621;260;4489;4530;8.78;0.54;241.58;4.14;868;35;1515.00;41
3624;35;626399646;3624;260;4494;4530;8.85;0.54;241.58;4.14;870;35;1516.00;36
3625;35;626399658;3625;261;4494;4530;8.90;0.54;241.66;4.14;869;35;1517.00;36
3629;35;626399670;3629;259;4497;4530;8.98;0.55;241.66;4.14;868;35;1518.00;33
3631;35;626399683;3631;267;4501;4530;8.98;0.55;241.66;4.14;870;35;1519.00;29
3634;35;626399696;3634;270;4501;4531;8.93;0.54;241.59;4.14;867;35;1520.00;30
3635;35;626399708;3635;275;4505;4532;8.90;0.54;241.66;4.15;870;35;1521.00;27
3638;35;626399721;3638;277;4506;4532;8.75;0.53;241.72;4.15;868;35;1522.00;26
3644;35;626399733;3644;279;4511;4536;8.63;0.53;241.84;4.15;867;35;1523.00;25
3649;35;626399746;3649;285;4513;4536;8.59;0.52;241.92;4.16;864;35;1524.00;23
3653;36;626399758;3653;285;4515;4536;8.50;0.52;241.91;4.16;862;36;1525.00;21
3655;36;626399782;3655;288;4517;4536;8.43;0.51;241.90;4.16;862;36;1526.00;19
3659;36;626399795;3659;287;4521;4542;8.33;0.51;242.03;4.16;862;36;1527.00;21
3662;36;626399808;3662;294;4522;4542;8.16;0.50;242.09;4.16;860;36;1528.00;20
3666;36;626399820;3666;297;4522;4542;8.02;0.49;242.22;4.16;856;36;1529.00;20
3672;36;626399834;3672;287;4525;4548;7.90;0.48;242.48;4.16;853;36;1530.00;23
3674;36;626399846;3674;282;4525;4548;7.82;0.48;242.55;4.16;851;36;1531.00;23
3676;36;626399858;3676;281;4526;4548;7.78;0.48;242.58;4.17;850;36;1532.00;22
3682;36;626399870;3682;278;4528;4549;7.69;0.47;242.64;4.17;846;36;1533.00;21
3685;36;626399881;3685;274;4529;4550;7.76;0.48;242.76;4.17;844;36;1534.00;21
3691;36;626399895;3691;279;4529;4550;7.80;0.48;242.80;4.17;838;36;1535.00;21
3696;36;626399911;3696;277;4542;4563;7.78;0.48;242.85;4.17;846;36;1536.00;21
3700;36;626399926;3700;275;4543;4563;7.87;0.48;243.01;4.18;843;36;1537.00;20
3707;36;626399938;3707;263;4543;4563;7.95;0.49;243.10;4.18;836;36;1538.00;20
3712;36;626399952;3712;261;4546;4564;8.08;0.49;243.25;4.19;834;36;1539.00;18
3715;36;626399964;3715;255;4547;4564;8.10;0.49;243.31;4.20;832;36;1540.00;17
3718;36;626399976;3718;248;4551;4568;8.10;0.49;243.42;4.20;833;36;1541.00;17
3723;36;626399992;3723;249;4551;4568;8.07;0.49;243.46;4.20;828;36;1542.00;17
3727;36;626400008;3727;242;4556;4572;8.05;0.49;243.52;4.20;829;36;1543.00;16
3731;36;626400026;3731;246;4556;4572;8.06;0.49;243.57;4.20;825;36;1544.00;16
3735;36;626400044;3735;245;4556;4572;8.06;0.49;243.52;4.20;821;36;1545.00;16
3741;36;626400056;3741;247;4558;4572;8.08;0.49;243.59;4.22;817;36;1546.00;14
3747;36;626400068;3747;252;4558;4572;8.02;0.49;243.73;4.22;811;36;1547.00;14
3749;36;626400080;3749;254;4570;4584;8.01;0.49;243.78;4.21;821;36;1548.00;14
3754;36;626400095;3754;259;4570;4584;7.94;0.48;243.85;4.21;816;36;1549.00;14
3756;36;626400106;3756;264;4570;4584;7.89;0.48;243.94;4.21;814;36;1550.00;14
3761;36;626400119;3761;269;4571;4584;7.80;0.48;243.84;4.22;810;36;1551.00;13
3764;36;626400130;3764;268;4571;4584;7.68;0.47;243.86;4.22;807;36;1552.00;13
3766;36;626400148;3766;274;4572;4584;7.68;0.47;243.93;4.23;806;36;1553.00;12
3768;36;626400159;3768;273;4574;4585;7.61;0.46;243.93;4.24;806;36;1554.00;11
3773;36;626400170;3773;281;4575;4587;7.51;0.46;243.98;4.24;802;36;1555.00;12
3776;36;626400181;3776;281;4579;4593;7.47;0.46;243.87;4.23;803;36;1556.00;14
3778;36;626400192;3778;285;4582;4594;7.44;0.45;243.99;4.24;804;36;1557.00;12
3780;36;626400202;3780;281;4583;4594;7.35;0.45;244.07;4.25;803;36;1558.00;11
3783;36;626400213;3783;285;4583;4594;7.26;0.44;244.06;4.25;800;36;1559.00;11
3788;36;626400224;3788;296;4589;4599;7.16;0.44;243.92;4.25;801;36;1560.00;10
3794;36;626400235;3794;302;4589;4599;7.08;0.43;243.91;4.25;795;36;1561.00;10
3798;36;626400246;3798;310;4590;4599;6.98;0.43;243.85;4.26;792;36;1562.00;9
3800;36;626400261;3800;314;4591;4600;6.95;0.43;243.89;4.26;791;36;1563.00;9
3804;36;626400271;3804;313;4596;4604;6.91;0.42;243.82;4.26;792;36;1564.00;8
3808;36;626400281;3808;319;4596;4604;6.87;0.42;243.67;4.26;788;36;1565.00;8
3810;36;626400292;3810;323;4599;4607;6.93;0.43;243.64;4.26;789;36;1566.00;8
3814;36;626400301;3814;329;4600;4607;6.91;0.42;243.51;4.27;786;36;1567.00;7
3816;36;626400311;3816;332;4600;4607;6.87;0.42;243.53;4.27;784;36;1568.00;7
3821;36;626400321;3821;341;4601;4607;6.78;0.42;243.43;4.27;780;36;1569.00;6
3824;36;626400330;3824;349;4603;4611;6.71;0.41;243.49;4.27;779;36;1570.00;8
3826;36;626400340;3826;356;4604;4611;6.63;0.41;243.46;4.27;778;36;1571.00;7
3830;36;626400350;3830;359;4605;4611;6.52;0.40;243.45;4.27;775;36;1572.00;6
3833;36;626400359;3833;368;4606;4611;6.42;0.39;243.48;4.28;773;36;1573.00;5
3835;36;626400368;3835;377;4608;4612;6.33;0.39;243.48;4.28;773;36;1574.00;4
3837;36;626400378;3837;380;4610;4614;6.27;0.38;243.43;4.27;773;36;1575.00;4
3840;36;626400387;3840;387;4611;4614;6.15;0.38;243.34;4.28;771;36;1576.00;3
3841;36;626400397;3841;380;4613;4615;6.21;0.38;243.31;4.28;772;36;1577.00;2
3841;36;626400406;3841;369;4613;4615;6.19;0.38;243.31;4.28;772;36;1578.00;2
3843;36;626400415;3843;368;4613;4615;6.22;0.38;243.34;4.28;770;36;1579.00;2
3845;36;626400425;3845;364;4613;4615;6.25;0.38;243.47;4.28;768;36;1580.00;2
3845;36;626400434;3845;364;4613;4615;6.34;0.39;243.47;4.28;768;36;1581.00;2
3845;36;626400444;3845;361;4613;4615;6.38;0.39;243.47;4.28;768;36;1582.00;2
3847;36;626400453;3847;356;4613;4615;6.50;0.40;243.49;4.28;766;36;1583.00;2
3849;36;626400463;3849;367;4685;4742;6.88;0.43;243.50;4.21;836;36;1584.00;57
3854;36;626400488;3854;366;4687;4743;6.96;0.43;243.49;4.21;833;36;1585.00;56
3857;36;626400499;3857;349;4696;4743;7.10;0.44;243.50;4.20;839;36;1586.00;47
3857;36;626400509;3857;322;4703;4743;7.25;0.45;243.50;4.20;846;36;1587.00;40
3858;36;626400519;3858;305;4709;4743;7.39;0.46;243.49;4.20;851;36;1588.00;34
3859;36;626400530;3859;287;4714;4743;7.50;0.46;243.44;4.20;855;36;1589.00;29
3859;36;626400542;3859;279;4719;4743;7.65;0.47;243.44;4.21;860;36;1590.00;24
3862;36;626400553;3862;271;4722;4743;7.77;0.48;243.43;4.21;860;36;1591.00;21
3864;36;626400565;3864;259;4725;4744;7.90;0.49;243.39;4.21;861;36;1592.00;19
3870;36;626400576;3870;249;4726;4745;8.00;0.49;243.31;4.21;856;36;1593.00;19
3871;36;626400594;3871;242;4727;4745;8.10;0.50;243.31;4.21;856;36;1594.00;18
3872;36;626400612;3872;239;4728;4746;8.15;0.50;243.29;4.21;856;36;1595.00;18
3875;36;626400624;3875;241;4728;4746;8.22;0.50;243.25;4.21;853;36;1596.00;18
3877;36;626400643;3877;242;4730;4746;8.34;0.51;243.25;4.22;853;36;1597.00;16
3877;36;626400655;3877;241;4732;4746;8.46;0.52;243.25;4.22;855;36;1598.00;14
3877;36;626400667;3877;240;4736;4750;8.55;0.52;243.25;4.22;859;36;1599.00;14
3880;36;626400680;3880;239;4737;4750;8.54;0.52;243.22;4.22;857;36;1600.00;13
3883;36;626400696;3883;232;4739;4750;8.56;0.52;243.20;4.22;856;36;1601.00;11
3884;36;626400708;3884;224;4741;4753;8.66;0.53;243.17;4.22;857;36;1602.00;12
3885;36;626400721;3885;228;4742;4753;8.70;0.53;243.14;4.22;857;36;1603.00;11
3886;36;626400733;3886;229;4744;4753;8.74;0.53;243.13;4.26;858;36;1604.00;9
3887;36;626400745;3887;230;4747;4757;8.72;0.53;243.09;4.26;860;36;1605.00;10
3888;36;626400756;3888;225;4748;4758;8.75;0.53;243.11;4.25;860;36;1606.00;10
3889;36;626400769;3889;225;4748;4758;8.76;0.53;243.13;4.25;859;36;1607.00;10
3891;36;626400780;3891;232;4751;4762;8.78;0.53;243.09;4.25;860;36;1608.00;11
3894;36;626400792;3894;227;4751;4762;8.83;0.54;243.11;4.25;857;36;1609.00;11
3895;36;626400803;3895;228;4751;4762;8.84;0.54;243.13;4.25;856;36;1610.00;11
3897;36;626400815;3897;229;4752;4763;8.86;0.54;243.10;4.25;855;36;1611.00;11
3899;36;626400826;3899;232;4752;4763;8.88;0.54;243.16;4.25;853;36;1612.00;11
3901;36;626400838;3901;235;4756;4769;8.92;0.54;243.18;4.25;855;36;1613.00;13
3905;36;626400850;3905;240;4756;4769;8.94;0.54;243.12;4.25;851;36;1614.00;13
3907;36;626400861;3907;243;4757;4770;8.94;0.54;243.25;4.25;850;36;1615.00;13
3908;36;626400872;3908;241;4757;4770;8.93;0.54;243.23;4.25;849;36;1616.00;13
3912;36;626400883;3912;237;4757;4770;8.91;0.54;243.29;4.25;845;36;1617.00;13
3918;36;626400894;3918;243;4757;4770;8.87;0.54;243.44;4.25;839;36;1618.00;13
3920;36;626400932;3920;242;4757;4770;8.83;0.54;243.47;4.25;837;36;1619.00;13
3925;36;626400950;3925;236;4779;4806;8.89;0.54;243.51;4.23;854;36;1620.00;27
3931;36;626400973;3931;229;4779;4806;8.91;0.54;243.64;4.23;848;36;1621.00;27
3935;36;626400990;3935;225;4781;4806;8.94;0.54;243.76;4.23;846;36;1622.00;25
3937;36;626401007;3937;220;4782;4806;8.98;0.55;243.80;4.23;845;36;1623.00;24
3941;36;626401022;3941;213;4783;4806;8.99;0.55;243.88;4.23;842;36;1624.00;23
3943;36;626401035;3943;214;4784;4806;9.03;0.55;243.87;4.23;841;36;1625.00;22
3946;36;626401050;3946;208;4787;4810;9.02;0.55;244.03;4.23;841;36;1626.00;23
3948;36;626401064;3948;199;4789;4810;9.09;0.55;244.10;4.23;841;36;1627.00;21
3952;36;626401076;3952;202;4792;4814;9.10;0.56;244.17;4.23;840;36;1628.00;22
3955;36;626401090;3955;193;4794;4815;9.17;0.56;244.21;4.22;839;36;1629.00;21
3960;36;626401103;3960;185;4796;4815;9.17;0.56;244.29;4.23;836;36;1630.00;19
3962;36;626401117;3962;180;4796;4815;9.19;0.56;244.33;4.23;834;36;1631.00;19
3964;36;626401128;3964;173;4805;4828;9.18;0.56;244.37;4.22;841;36;1632.00;23
3967;36;626401141;3967;170;4806;4828;9.20;0.56;244.47;4.22;839;36;1633.00;22
3969;36;626401153;3969;166;4806;4828;9.29;0.57;244.41;4.22;837;36;1634.00;22
3973;36;626401164;3973;166;4808;4829;9.33;0.57;244.38;4.23;835;36;1635.00;21
3978;36;626401177;3978;158;4808;4830;9.37;0.57;244.38;4.23;830;36;1636.00;22
3986;36;626401188;3986;152;4808;4830;9.39;0.57;244.45;4.23;822;36;1637.00;22
3989;36;626401200;3989;144;4810;4833;9.41;0.57;244.50;4.22;821;36;1638.00;23
3993;36;626401213;3993;138;4811;4833;9.51;0.58;244.46;4.22;818;36;1639.00;22
3996;36;626401224;3996;137;4811;4833;9.57;0.58;244.50;4.22;815;36;1640.00;22
4000;36;626401235;4000;131;4811;4833;9.64;0.59;244.63;4.22;811;36;1641.00;22
4002;36;626401247;4002;129;4815;4839;9.75;0.59;244.64;4.22;813;36;1642.00;24
4007;36;626401259;4007;129;4815;4839;9.76;0.59;244.61;4.22;808;36;1643.00;24
4012;36;626401272;4012;123;4816;4839;9.80;0.60;244.74;4.22;804;36;1644.00;23
4016;36;626401284;4016;119;4816;4839;9.86;0.60;244.76;4.22;800;36;1645.00;23
4019;36;626401301;4019;120;4819;4843;9.89;0.60;244.70;4.22;800;36;1646.00;24
4022;36;626401313;4022;117;4821;4844;9.97;0.61;244.72;4.22;799;36;1647.00;23
4025;36;626401325;4025;118;4822;4844;10.07;0.61;244.85;4.23;797;36;1648.00;22
4026;36;626401337;4026;121;4823;4845;10.14;0.62;244.86;4.23;797;36;1649.00;22
4031;36;626401351;4031;123;4823;4845;10.18;0.62;244.94;4.23;792;36;1650.00;22
4033;36;626401362;4033;123;4823;4845;10.29;0.62;244.95;4.23;790;36;1651.00;22
4034;36;626401374;4034;122;4824;4845;10.39;0.63;245.00;4.24;790;36;1652.00;21
4037;36;626401386;4037;125;4824;4845;10.36;0.63;244.98;4.24;787;36;1653.00;21
4040;36;626401398;4040;124;4824;4845;10.37;0.63;245.10;4.24;784;36;1654.00;21
4041;36;626401410;4041;125;4824;4845;10.37;0.63;245.11;4.24;783;36;1655.00;21
4044;36;626401422;4044;138;4862;4915;10.40;0.63;245.27;4.21;818;36;1656.00;53
4045;36;626401439;4045;136;4862;4916;10.45;0.64;245.27;4.21;817;36;1657.00;54
4048;36;626401451;4048;135;4869;4916;10.51;0.64;245.32;4.21;821;36;1658.00;47
4050;36;626401464;4050;141;4874;4916;10.56;0.64;245.28;4.21;824;36;1659.00;42
4053;36;626401476;4053;144;4881;4916;10.56;0.65;245.35;4.23;828;36;1660.00;35
4055;36;626401488;4055;150;4885;4916;10.57;0.65;245.33;4.23;830;36;1661.00;31
4059;36;626401500;4059;154;4890;4916;10.54;0.64;245.41;4.25;831;36;1662.00;26
4062;36;626401511;4062;150;4892;4916;10.50;0.64;245.44;4.25;830;36;1663.00;24
4065;36;626401529;4065;152;4894;4917;10.49;0.64;245.49;4.25;829;36;1664.00;23
4070;36;626401553;4070;155;4899;4919;10.49;0.64;245.57;4.27;829;36;1665.00;20
4073;36;626401567;4073;160;4900;4919;10.46;0.64;245.56;4.27;827;36;1666.00;19
4078;36;626401579;4078;162;4902;4923;10.42;0.64;245.61;4.27;824;36;1667.00;21
4083;36;626401591;4083;164;4903;4923;10.36;0.63;245.53;4.29;820;36;1668.00;20
4083;36;626401603;4083;169;4903;4923;10.30;0.63;245.53;4.29;820;36;1669.00;20
4087;36;626401615;4087;179;4906;4923;10.17;0.62;245.54;4.32;819;36;1670.00;17
4089;36;626401626;4089;178;4911;4929;10.13;0.62;245.53;4.32;822;36;1671.00;18
4092;36;626401639;4092;181;4911;4929;10.04;0.62;245.48;4.32;819;36;1672.00;18
4097;36;626401650;4097;190;4913;4929;9.96;0.61;245.46;4.33;816;36;1673.00;16
4099;36;626401662;4099;201;4915;4932;9.90;0.61;245.52;4.33;816;36;1674.00;17
4100;36;626401673;4100;202;4917;4932;9.84;0.60;245.52;4.34;817;36;1675.00;15
4102;36;626401684;4102;205;4917;4932;9.71;0.60;245.59;4.34;815;36;1676.00;15
4107;36;626401694;4107;216;4918;4933;9.48;0.58;245.59;4.34;811;36;1677.00;15
4109;36;626401705;4109;217;4920;4934;9.33;0.57;245.68;4.35;811;36;1678.00;14
4115;36;626401715;4115;217;4921;4934;9.16;0.56;245.61;4.36;806;36;1679.00;13
4121;36;626401727;4121;228;4936;4960;8.96;0.55;245.41;4.34;815;36;1680.00;24
4125;36;626401740;4125;232;4937;4960;8.84;0.54;245.49;4.35;812;36;1681.00;23
4129;36;626401750;4129;233;4939;4960;8.78;0.54;245.50;4.35;810;36;1682.00;21
4131;36;626401761;4131;230;4943;4961;8.78;0.54;245.49;4.35;812;36;1683.00;18
4133;36;626401771;4133;234;4946;4961;8.76;0.53;245.56;4.35;813;36;1684.00;15
4135;36;626401782;4135;239;4949;4965;8.78;0.54;245.63;4.35;814;36;1685.00;16
4137;36;626401793;4137;242;4952;4965;8.72;0.53;245.77;4.36;815;36;1686.00;13
4140;36;626401803;4140;242;4954;4969;8.69;0.53;245.71;4.35;814;36;1687.00;15
4143;36;626401820;4143;242;4958;4969;8.65;0.53;245.80;4.36;815;36;1688.00;11
4148;36;626401830;4148;243;4958;4969;8.56;0.52;245.98;4.36;810;36;1689.00;11
4149;36;626401840;4149;248;4958;4969;8.50;0.52;245.99;4.36;809;36;1690.00;11
4152;36;626401856;4152;256;4958;4969;8.43;0.51;246.07;4.36;806;36;1691.00;11
4156;36;626401866;4156;255;4970;4981;8.34;0.51;246.00;4.36;814;36;1692.00;11
4162;36;626401877;4162;262;4970;4981;8.16;0.50;245.93;4.36;808;36;1693.00;11
4165;36;626401887;4165;270;4973;4981;8.13;0.50;245.96;4.36;808;36;1694.00;8
4170;36;626401898;4170;279;4973;4981;8.01;0.49;245.91;4.36;803;36;1695.00;8
4171;36;626401912;4171;283;4973;4981;7.88;0.48;245.97;4.36;802;36;1696.00;8
4173;36;626401924;4173;288;4973;4981;7.81;0.48;246.07;4.36;800;36;1697.00;8
4177;36;626401934;4177;303;4974;4982;7.62;0.47;246.08;4.36;797;36;1698.00;8
4179;36;626401944;4179;305;4974;4982;7.45;0.46;246.13;4.36;795;36;1699.00;8
4182;36;626401955;4182;298;4979;4988;7.35;0.45;246.16;4.35;797;36;1700.00;9
4183;36;626401971;4183;294;4980;4989;7.33;0.45;246.12;4.35;797;36;1701.00;9
4186;36;626401980;4186;288;4981;4989;7.26;0.44;246.23;4.35;795;36;1702.00;8
4189;36;626401989;4189;279;4981;4989;7.20;0.44;246.27;4.35;792;36;1703.00;8
4191;36;626401998;4191;274;4985;4993;7.18;0.44;246.37;4.35;794;36;1704.00;8
4197;36;626402008;4197;277;4985;4993;7.10;0.43;246.44;4.35;788;36;1705.00;8
4199;36;626402019;4199;279;4985;4993;7.08;0.43;246.38;4.35;786;36;1706.00;8
4204;36;626402028;4204;272;4986;4994;7.04;0.43;246.37;4.35;782;36;1707.00;8
4207;36;626402038;4207;274;4990;4998;7.03;0.43;246.27;4.35;783;36;1708.00;8
4210;36;626402048;4210;274;4990;4998;7.06;0.43;246.44;4.35;780;36;1709.00;8
4211;36;626402059;4211;281;4993;5004;7.17;0.44;246.39;4.34;782;36;1710.00;11
4214;36;626402069;4214;277;4994;5004;7.21;0.44;246.46;4.34;780;36;1711.00;10
4217;36;626402078;4217;279;4995;5004;7.16;0.44;246.42;4.34;778;36;1712.00;9
4219;36;626402087;4219;284;4995;5004;7.13;0.44;246.40;4.34;776;36;1713.00;9
4223;36;626402096;4223;286;4998;5008;7.17;0.44;246.37;4.34;775;36;1714.00;10
4224;36;626402106;4224;284;4999;5008;7.17;0.44;246.34;4.34;775;36;1715.00;9
4226;36;626402115;4226;286;4999;5008;7.07;0.43;246.28;4.34;773;36;1716.00;9
4230;36;626402124;4230;292;5000;5008;7.01;0.43;246.34;4.34;770;36;1717.00;8
4235;36;626402133;4235;291;5001;5009;6.93;0.43;246.24;4.34;766;36;1718.00;8
4236;36;626402143;4236;288;5002;5010;6.93;0.43;246.27;4.34;766;36;1719.00;8
4240;36;626402151;4240;294;5002;5010;6.91;0.42;246.24;4.34;762;36;1720.00;8
4245;36;626402161;4245;295;5003;5011;6.93;0.42;246.34;4.34;758;36;1721.00;8
4250;36;626402170;4250;299;5003;5011;6.86;0.42;246.21;4.34;753;36;1722.00;8
4252;36;626402179;4252;301;5003;5011;6.87;0.42;246.26;4.34;751;36;1723.00;8
4253;36;626402189;4253;299;5003;5011;6.86;0.42;246.23;4.34;750;36;1724.00;8
4255;36;626402198;4255;296;5003;5011;6.86;0.42;246.29;4.34;748;36;1725.00;8
4257;36;626402207;4257;297;5003;5011;6.85;0.42;246.34;4.34;746;36;1726.00;8
4262;36;626402215;4262;304;5003;5011;6.83;0.42;246.31;4.34;741;36;1727.00;8
4266;36;626402224;4266;320;5075;5138;7.13;0.44;246.29;4.28;809;36;1728.00;63
4267;36;626402244;4267;312;5078;5139;7.14;0.44;246.28;4.28;811;36;1729.00;61
4272;36;626402255;4272;312;5086;5139;7.16;0.44;246.27;4.27;814;36;1730.00;53
4274;36;626402265;4274;317;5091;5139;7.19;0.45;246.24;4.27;817;36;1731.00;48
4278;36;626402275;4278;317;5095;5139;7.23;0.45;246.16;4.27;817;36;1732.00;44
4279;36;626402284;4279;327;5098;5139;7.25;0.45;246.15;4.27;819;36;1733.00;41
4285;36;626402294;4285;332;5103;5139;7.24;0.45;246.14;4.27;818;36;1734.00;36
4286;36;626402304;4286;339;5105;5139;7.33;0.45;246.09;4.27;819;36;1735.00;34
4288;36;626402314;4288;345;5109;5140;7.37;0.46;246.10;4.28;821;36;1736.00;31
4293;36;626402325;4293;356;5111;5141;7.30;0.45;246.08;4.28;818;36;1737.00;30
4295;36;626402336;4295;368;5115;5141;7.23;0.45;246.12;4.28;820;36;1738.00;26
4297;36;626402346;4297;363;5118;5142;7.24;0.45;246.09;4.28;821;36;1739.00;24
4301;36;626402358;4301;354;5122;5142;7.28;0.45;246.17;4.29;821;36;1740.00;20
4301;36;626402368;4301;352;5124;5142;7.39;0.46;246.17;4.29;823;36;1741.00;18
4304;36;626402378;4304;353;5128;5142;7.50;0.46;246.19;4.30;824;36;1742.00;14
4306;36;626402389;4306;355;5131;5146;7.56;0.47;246.23;4.30;825;36;1743.00;15
4310;37;626402400;4310;354;5133;5146;7.56;0.46;246.24;4.31;823;37;1744.00;13
4312;37;626402423;4312;356;5134;5146;7.61;0.47;246.27;4.31;822;37;1745.00;12
4313;37;626402434;4313;355;5137;5149;7.62;0.47;246.25;4.30;824;37;1746.00;12
4314;37;626402455;4314;337;5137;5149;7.60;0.46;246.19;4.30;823;37;1747.00;12
4314;37;626402467;4314;335;5138;5149;7.64;0.47;246.19;4.31;824;37;1748.00;11
4316;37;626402478;4316;327;5142;5153;7.69;0.47;246.32;4.30;826;37;1749.00;11
4320;37;626402490;4320;315;5144;5154;7.74;0.47;246.23;4.30;824;37;1750.00;10
4323;37;626402501;4323;311;5144;5154;7.81;0.48;246.25;4.30;821;37;1751.00;10
4325;37;626402512;4325;307;5147;5158;7.86;0.48;246.21;4.30;822;37;1752.00;11
4326;37;626402524;4326;299;5147;5158;7.95;0.49;246.19;4.30;821;37;1753.00;11
4329;37;626402536;4329;300;5147;5158;8.05;0.49;246.15;4.30;818;37;1754.00;11
4332;37;626402547;4332;292;5149;5160;8.13;0.50;246.09;4.30;817;37;1755.00;11
4334;37;626402558;4334;277;5149;5160;8.20;0.50;246.07;4.30;815;37;1756.00;11
4336;37;626402570;4336;270;5153;5166;8.27;0.50;246.14;4.30;817;37;1757.00;13
4337;37;626402582;4337;260;5154;5166;8.36;0.51;246.12;4.29;817;37;1758.00;12
4339;37;626402593;4339;248;5154;5167;8.43;0.51;246.05;4.29;815;37;1759.00;13
4342;37;626402605;4342;247;5154;5167;8.50;0.52;246.14;4.29;812;37;1760.00;13
4344;37;626402617;4344;245;5154;5167;8.60;0.52;246.12;4.29;810;37;1761.00;13
4345;37;626402628;4345;241;5154;5167;8.67;0.53;246.09;4.29;809;37;1762.00;13
4346;37;626402640;4346;242;5155;5167;8.71;0.53;246.10;4.34;809;37;1763.00;12
4349;37;626402652;4349;239;5165;5179;8.85;0.54;246.16;4.33;816;37;1764.00;14
4349;37;626402664;4349;241;5166;5179;8.91;0.54;246.16;4.33;817;37;1765.00;13
4350;37;626402675;4350;244;5166;5179;8.98;0.55;246.17;4.33;816;37;1766.00;13
4352;37;626402686;4352;239;5166;5179;9.05;0.55;246.16;4.33;814;37;1767.00;13
4356;37;626402698;4356;248;5166;5179;9.09;0.55;246.19;4.33;810;37;1768.00;13
4362;37;626402709;4362;241;5166;5179;9.07;0.55;246.17;4.33;804;37;1769.00;13
4367;38;626402723;4367;236;5169;5183;9.03;0.55;246.17;4.33;802;38;1770.00;14
4368;38;626402741;4368;236;5169;5183;9.02;0.55;246.20;4.33;801;38;1771.00;14
4370;38;626402756;4370;234;5172;5187;8.98;0.55;246.23;4.33;802;38;1772.00;15
4372;38;626402767;4372;240;5174;5188;8.98;0.55;246.22;4.33;802;38;1773.00;14
4375;38;626402778;4375;236;5174;5188;9.02;0.55;246.28;4.33;799;38;1774.00;14
4379;38;626402788;4379;240;5174;5188;8.99;0.55;246.28;4.33;795;38;1775.00;14
4381;38;626402799;4381;243;5185;5201;9.07;0.55;246.29;4.32;804;38;1776.00;16
4386;38;626402811;4386;247;5185;5201;9.04;0.55;246.42;4.32;799;38;1777.00;16
4389;39;626402822;4389;250;5185;5201;9.02;0.55;246.54;4.32;796;39;1778.00;16
4391;39;626402849;4391;255;5186;5202;9.09;0.55;246.60;4.32;795;39;1779.00;16
4394;39;626402860;4394;254;5186;5203;9.09;0.55;246.74;4.32;792;39;1780.00;17
4397;39;626402876;4397;255;5186;5203;9.09;0.55;246.80;4.32;789;39;1781.00;17
4398;39;626402886;4398;252;5188;5206;9.13;0.56;246.80;4.32;790;39;1782.00;18
4402;39;626402897;4402;254;5188;5206;9.14;0.56;246.87;4.32;786;39;1783.00;18
4406;39;626402908;4406;255;5189;5206;9.11;0.56;246.92;4.32;783;39;1784.00;17
4410;39;626402923;4410;249;5189;5206;9.11;0.56;246.99;4.32;779;39;1785.00;17
4414;39;626402942;4414;247;5193;5212;9.08;0.55;246.92;4.31;779;39;1786.00;19
4418;39;626402959;4418;246;5193;5212;9.07;0.55;247.00;4.31;775;39;1787.00;19
4422;39;626402976;4422;245;5194;5212;9.10;0.55;247.05;4.31;772;39;1788.00;18
4424;39;626402993;4424;242;5194;5212;9.14;0.56;247.05;4.31;770;39;1789.00;18
4427;39;626403007;4427;238;5197;5216;9.14;0.55;247.08;4.31;770;39;1790.00;19
4428;39;626403025;4428;231;5198;5217;9.19;0.56;247.10;4.31;770;39;1791.00;19
4428;39;626403040;4428;225;5198;5217;9.24;0.56;247.10;4.31;770;39;1792.00;19
4431;39;626403051;4431;225;5199;5218;9.32;0.57;247.15;4.31;768;39;1793.00;19
4432;39;626403062;4432;223;5199;5218;9.41;0.57;247.14;4.31;767;39;1794.00;19
4433;39;626403073;4433;213;5200;5218;9.41;0.57;247.12;4.35;767;39;1795.00;18
4436;39;626403085;4436;212;5200;5218;9.43;0.57;247.16;4.35;764;39;1796.00;18
4437;39;626403096;4437;208;5200;5218;9.38;0.57;247.17;4.35;763;39;1797.00;18
4442;39;626403107;4442;198;5200;5218;9.33;0.57;247.20;4.35;758;39;1798.00;18
4446;39;626403118;4446;195;5200;5218;9.30;0.56;247.25;4.35;754;39;1799.00;18
4450;39;626403132;4450;212;5264;5356;9.13;0.56;247.35;4.30;814;39;1800.00;92
4451;39;626403160;4451;199;5264;5357;9.14;0.56;247.40;4.30;813;39;1801.00;93
4451;39;626403172;4451;185;5274;5357;9.24;0.57;247.40;4.29;823;39;1802.00;83
4454;39;626403183;4454;176;5278;5357;9.27;0.57;247.49;4.29;824;39;1803.00;79
4457;39;626403194;4457;170;5282;5357;9.31;0.57;247.66;4.29;825;39;1804.00;75
4459;39;626403207;4459;165;5288;5357;9.34;0.57;247.68;4.31;829;39;1805.00;69
4463;39;626403219;4463;159;5293;5357;9.41;0.58;247.72;4.31;830;39;1806.00;64
4469;39;626403231;4469;159;5297;5357;9.32;0.57;247.87;4.31;828;39;1807.00;60
4472;39;626403252;4472;158;5301;5358;9.32;0.57;247.94;4.31;829;39;1808.00;57
4478;39;626403271;4478;150;5302;5359;9.33;0.57;247.99;4.32;824;39;1809.00;57
4480;39;626403283;4480;144;5305;5359;9.38;0.57;248.01;4.36;825;39;1810.00;54
4484;39;626403295;4484;137;5309;5363;9.43;0.58;248.06;4.36;825;39;1811.00;54
4488;39;626403308;4488;132;5311;5363;9.40;0.57;248.12;4.36;823;39;1812.00;52
4490;39;626403320;4490;131;5312;5363;9.36;0.57;248.19;4.40;822;39;1813.00;51
4492;39;626403333;4492;129;5312;5363;9.33;0.57;248.13;4.40;820;39;1814.00;51
4494;39;626403351;4494;129;5314;5369;9.28;0.57;248.22;4.39;820;39;1815.00;55
4497;39;626403363;4497;132;5316;5369;9.25;0.57;248.17;4.43;819;39;1816.00;53
4500;39;626403382;4500;136;5318;5369;9.34;0.57;248.15;4.44;818;39;1817.00;51
4503;39;626403403;4503;139;5321;5372;9.45;0.58;248.17;4.46;818;39;1818.00;51
4504;39;626403415;4504;139;5321;5372;9.58;0.58;248.22;4.46;817;39;1819.00;51
4506;39;626403426;4506;143;5322;5372;9.66;0.59;248.34;4.47;816;39;1820.00;50
4509;39;626403438;4509;146;5325;5373;9.68;0.59;248.45;4.50;816;39;1821.00;48
4510;39;626403450;4510;143;5327;5374;9.70;0.59;248.48;4.50;817;39;1822.00;47
4512;39;626403470;4512;148;5328;5374;9.65;0.59;248.60;4.50;816;39;1823.00;46
4515;39;626403482;4515;149;5335;5387;9.67;0.59;248.69;4.50;820;39;1824.00;52
4519;39;626403494;4519;146;5337;5387;9.73;0.60;248.70;4.50;818;39;1825.00;50
4522;39;626403506;4522;146;5337;5387;9.80;0.60;248.77;4.50;815;39;1826.00;50
4525;39;626403524;4525;150;5338;5388;9.86;0.60;248.78;4.50;813;39;1827.00;50
4529;39;626403542;4529;154;5338;5388;9.90;0.60;248.83;4.50;809;39;1828.00;50
4531;39;626403555;4531;159;5341;5392;9.92;0.61;248.87;4.50;810;39;1829.00;51
4534;39;626403570;4534;162;5342;5392;9.87;0.60;248.93;4.51;808;39;1830.00;50
4536;39;626403581;4536;166;5348;5396;9.83;0.60;248.98;4.54;812;39;1831.00;48
4539;39;626403594;4539;178;5348;5396;9.72;0.59;249.03;4.54;809;39;1832.00;48
4541;39;626403606;4541;176;5352;5396;9.67;0.59;249.05;4.56;811;39;1833.00;44
4547;39;626403618;4547;181;5354;5396;9.69;0.59;249.10;4.57;807;39;1834.00;42
4547;39;626403648;4547;184;5354;5396;9.69;0.59;249.10;4.57;807;39;1835.00;42
4554;39;626403660;4554;193;5366;5408;9.69;0.59;249.16;4.58;812;39;1836.00;42
4556;39;626403673;4556;196;5367;5408;9.69;0.59;249.26;4.59;811;39;1837.00;41
4557;39;626403684;4557;200;5369;5408;9.70;0.59;249.25;4.59;812;39;1838.00;39
4560;39;626403696;4560;204;5371;5408;9.68;0.59;249.22;4.61;811;39;1839.00;37
4562;39;626403707;4562;212;5374;5408;9.67;0.59;249.20;4.62;812;39;1840.00;34
4563;39;626403718;4563;216;5374;5408;9.66;0.59;249.26;4.62;811;39;1841.00;34
4567;39;626403729;4567;223;5377;5409;9.67;0.59;249.35;4.63;810;39;1842.00;32
4571;39;626403740;4571;228;5377;5409;9.62;0.59;249.30;4.63;806;39;1843.00;32
4573;39;626403751;4573;232;5384;5415;9.59;0.59;249.28;4.65;811;39;1844.00;31
4578;39;626403763;4578;236;5387;5417;9.48;0.58;249.31;4.64;809;39;1845.00;30
4579;39;626403775;4579;239;5387;5417;9.40;0.57;249.26;4.64;808;39;1846.00;30
4581;39;626403787;4581;244;5390;5417;9.36;0.57;249.32;4.66;809;39;1847.00;27
4581;39;626403797;4581;244;5394;5421;9.21;0.56;249.32;4.67;813;39;1848.00;27
4585;39;626403808;4585;248;5394;5421;9.10;0.56;249.48;4.67;809;39;1849.00;27
4588;39;626403820;4588;252;5396;5421;8.96;0.55;249.43;4.68;808;39;1850.00;25
4590;39;626403838;4590;254;5397;5422;8.82;0.54;249.44;4.68;807;39;1851.00;25
4594;39;626403849;4594;258;5400;5426;8.71;0.53;249.42;4.68;806;39;1852.00;26
4595;39;626403860;4595;257;5400;5426;8.59;0.52;249.46;4.68;805;39;1853.00;26
4596;39;626403870;4596;259;5402;5429;8.48;0.52;249.45;4.68;806;39;1854.00;27
4599;39;626403881;4599;259;5403;5429;8.42;0.51;249.47;4.67;804;39;1855.00;26
4601;39;626403892;4601;259;5403;5429;8.35;0.51;249.42;4.67;802;39;1856.00;26
4603;39;626403903;4603;255;5408;5429;8.27;0.50;249.34;4.70;805;39;1857.00;21
4606;39;626403917;4606;257;5412;5433;8.25;0.50;249.27;4.70;806;39;1858.00;21
4609;39;626403935;4609;256;5414;5433;8.20;0.50;249.26;4.71;805;39;1859.00;19
4609;39;626403947;4609;261;5415;5433;8.18;0.50;249.26;4.71;806;39;1860.00;18
4610;39;626403957;4610;266;5416;5433;8.05;0.49;249.23;4.71;806;39;1861.00;17
4616;39;626403966;4616;273;5416;5434;7.86;0.48;249.45;4.71;800;39;1862.00;18
4617;39;626403976;4617;281;5417;5435;7.76;0.47;249.42;4.71;800;39;1863.00;18
4620;39;626403985;4620;279;5418;5435;7.62;0.47;249.55;4.71;798;39;1864.00;17
4625;39;626403994;4625;285;5419;5436;7.47;0.46;249.62;4.71;794;39;1865.00;17
4627;39;626404003;4627;291;5419;5436;7.36;0.45;249.63;4.71;792;39;1866.00;17
4631;39;626404012;4631;294;5419;5436;7.19;0.44;249.54;4.71;788;39;1867.00;17
4633;39;626404020;4633;301;5419;5436;6.98;0.43;249.54;4.71;786;39;1868.00;17
4638;39;626404028;4638;305;5419;5436;6.76;0.42;249.42;4.71;781;39;1869.00;17
4639;39;626404036;4639;296;5419;5436;6.70;0.41;249.41;4.71;780;39;1870.00;17
4642;39;626404044;4642;293;5419;5436;6.62;0.41;249.33;4.71;777;39;1871.00;17
4644;39;626404052;4644;310;5489;5563;6.88;0.43;249.28;4.65;845;39;1872.00;74
4649;39;626404070;4649;302;5494;5564;6.89;0.43;249.44;4.64;845;39;1873.00;70
4650;39;626404080;4650;300;5503;5564;7.02;0.44;249.39;4.64;853;39;1874.00;61
4653;39;626404089;4653;299;5506;5564;6.96;0.44;249.39;4.64;853;39;1875.00;58
4657;39;626404097;4657;302;5512;5564;7.03;0.44;249.32;4.64;855;39;1876.00;52
4659;39;626404107;4659;304;5517;5564;7.11;0.44;249.32;4.64;858;39;1877.00;47
4664;39;626404116;4664;310;5524;5564;7.13;0.44;249.46;4.64;860;39;1878.00;40
4666;39;626404126;4666;308;5526;5564;7.12;0.44;249.44;4.64;860;39;1879.00;38
4668;39;626404135;4668;309;5530;5565;7.13;0.44;249.44;4.64;862;39;1880.00;35
4670;39;626404145;4670;316;5534;5566;7.17;0.45;249.51;4.65;864;39;1881.00;32
4674;39;626404155;4674;316;5537;5568;7.15;0.44;249.45;4.65;863;39;1882.00;31
4677;39;626404166;4677;322;5539;5569;7.09;0.44;249.49;4.65;862;39;1883.00;30
4681;39;626404176;4681;332;5541;5569;7.02;0.44;249.45;4.65;860;39;1884.00;28
4683;39;626404187;4683;341;5543;5569;6.98;0.43;249.40;4.65;860;39;1885.00;26
4687;39;626404196;4687;335;5545;5569;6.96;0.43;249.44;4.66;858;39;1886.00;24
4688;39;626404206;4688;340;5548;5573;6.93;0.43;249.46;4.66;860;39;1887.00;25
4690;39;626404216;4690;339;5550;5573;6.88;0.43;249.49;4.66;860;39;1888.00;23
4695;39;626404226;4695;342;5552;5573;6.81;0.42;249.52;4.66;857;39;1889.00;21
4695;39;626404238;4695;349;5555;5579;6.80;0.42;249.52;4.66;860;39;1890.00;24
4699;39;626404248;4699;341;5557;5579;6.75;0.42;249.59;4.66;858;39;1891.00;22
4703;39;626404258;4703;336;5558;5579;6.72;0.41;249.55;4.66;855;39;1892.00;21
4707;39;626404269;4707;333;5563;5583;6.79;0.42;249.56;4.66;856;39;1893.00;20
4710;39;626404280;4710;325;5565;5584;6.85;0.42;249.56;4.65;855;39;1894.00;19
4718;39;626404291;4718;325;5565;5584;6.78;0.41;249.41;4.65;847;39;1895.00;19
4720;39;626404302;4720;319;5569;5588;6.83;0.42;249.59;4.65;849;39;1896.00;19
4724;39;626404313;4724;325;5569;5588;6.83;0.42;249.66;4.65;845;39;1897.00;19
4727;39;626404323;4727;322;5569;5588;6.88;0.42;249.60;4.65;842;39;1898.00;19
4731;39;626404334;4731;321;5570;5589;6.97;0.42;249.65;4.65;839;39;1899.00;19
4736;39;626404346;4736;318;5570;5589;6.98;0.43;249.61;4.65;834;39;1900.00;19
4739;39;626404361;4739;322;5574;5595;7.08;0.43;249.78;4.65;835;39;1901.00;21
4743;39;626404372;4743;328;5574;5595;7.04;0.43;249.73;4.65;831;39;1902.00;21
4746;39;626404389;4746;327;5576;5596;7.04;0.43;249.67;4.65;830;39;1903.00;20
4747;39;626404411;4747;322;5576;5596;7.08;0.43;249.70;4.65;829;39;1904.00;20
4750;39;626404422;4750;325;5576;5596;7.15;0.43;249.68;4.65;826;39;1905.00;20
4752;39;626404433;4752;327;5576;5596;7.21;0.44;249.58;4.65;824;39;1906.00;20
4754;39;626404445;4754;326;5576;5596;7.27;0.44;249.60;4.65;822;39;1907.00;20
4755;39;626404456;4755;322;5587;5608;7.46;0.45;249.61;4.68;832;39;1908.00;21
4758;39;626404468;4758;322;5587;5608;7.50;0.46;249.59;4.68;829;39;1909.00;21
4760;39;626404479;4760;322;5588;5608;7.52;0.46;249.55;4.68;828;39;1910.00;20
4762;39;626404490;4762;326;5588;5608;7.49;0.45;249.61;4.68;826;39;1911.00;20
4764;39;626404506;4764;329;5588;5608;7.47;0.45;249.61;4.68;824;39;1912.00;20
4766;39;626404517;4766;335;5588;5608;7.49;0.45;249.67;4.68;822;39;1913.00;20
4767;39;626404529;4767;337;5591;5612;7.52;0.46;249.67;4.68;824;39;1914.00;21
4769;39;626404540;4769;343;5591;5612;7.46;0.45;249.67;4.68;822;39;1915.00;21
4772;39;626404551;4772;350;5594;5616;7.42;0.45;249.77;4.67;822;39;1916.00;22
4775;39;626404563;4775;340;5595;5617;7.49;0.46;249.73;4.67;820;39;1917.00;22
4778;39;626404574;4778;333;5596;5617;7.50;0.46;249.78;4.67;818;39;1918.00;21
4781;39;626404585;4781;328;5596;5617;7.50;0.46;249.94;4.67;815;39;1919.00;21
4783;39;626404599;4783;325;5617;5646;7.58;0.46;250.04;4.66;834;39;1920.00;29
4786;39;626404613;4786;319;5617;5646;7.60;0.47;250.00;4.66;831;39;1921.00;29
4791;39;626404624;4791;318;5619;5646;7.61;0.47;250.03;4.65;828;39;1922.00;27
4795;39;626404635;4795;318;5621;5647;7.61;0.47;250.20;4.65;826;39;1923.00;26
4797;39;626404647;4797;319;5622;5648;7.67;0.47;250.20;4.65;825;39;1924.00;26
4803;39;626404658;4803;324;5622;5648;7.65;0.47;250.29;4.65;819;39;1925.00;26
4809;39;626404670;4809;308;5625;5651;7.68;0.47;250.25;4.65;816;39;1926.00;26
4810;39;626404687;4810;301;5625;5651;7.73;0.47;250.31;4.65;815;39;1927.00;26
4815;39;626404698;4815;286;5625;5651;7.70;0.47;250.40;4.65;810;39;1928.00;26
4819;39;626404710;4819;281;5625;5651;7.68;0.47;250.43;4.65;806;39;1929.00;26
4822;39;626404721;4822;275;5629;5657;7.76;0.47;250.48;4.65;807;39;1930.00;28
4826;39;626404733;4826;269;5629;5657;7.81;0.47;250.46;4.65;803;39;1931.00;28
4831;39;626404745;4831;266;5630;5657;7.84;0.48;250.53;4.65;799;39;1932.00;27
4834;39;626404758;4834;267;5630;5657;7.93;0.48;250.50;4.65;796;39;1933.00;27
4838;39;626404776;4838;268;5633;5661;7.99;0.48;250.43;4.65;795;39;1934.00;28
4843;39;626404787;4843;274;5635;5663;8.04;0.49;250.53;4.64;792;39;1935.00;28
4845;39;626404799;4845;273;5635;5663;8.07;0.49;250.53;4.64;790;39;1936.00;28
4847;39;626404811;4847;269;5636;5664;8.13;0.49;250.55;4.64;789;39;1937.00;28
4848;39;626404822;4848;262;5636;5664;8.22;0.50;250.55;4.64;788;39;1938.00;28
4852;39;626404833;4852;257;5636;5664;8.30;0.50;250.62;4.64;784;39;1939.00;28
4853;39;626404845;4853;251;5636;5664;8.32;0.51;250.64;4.64;783;39;1940.00;28
4854;39;626404856;4854;249;5636;5664;8.32;0.50;250.64;4.64;782;39;1941.00;28
4856;39;626404866;4856;242;5636;5664;8.30;0.50;250.65;4.64;780;39;1942.00;28
4857;39;626404877;4857;242;5636;5664;8.35;0.51;250.66;4.64;779;39;1943.00;28
4859;39;626404889;4859;262;5678;5734;8.20;0.50;250.65;4.61;819;39;1944.00;56
4861;39;626404904;4861;248;5678;5735;8.26;0.50;250.68;4.61;817;39;1945.00;57
4863;39;626404920;4863;235;5683;5735;8.45;0.51;250.74;4.61;820;39;1946.00;52
4866;39;626404935;4866;235;5687;5735;8.56;0.52;250.76;4.61;821;39;1947.00;48
4868;39;626404952;4868;234;5691;5735;8.65;0.53;250.74;4.61;823;39;1948.00;44
4870;39;626404972;4870;231;5693;5735;8.72;0.53;250.77;4.61;823;39;1949.00;42
4873;39;626405004;4873;231;5696;5737;8.82;0.54;250.77;4.61;823;39;1950.00;41
4875;39;626405022;4875;237;5699;5737;8.89;0.54;250.86;4.61;824;39;1951.00;38
4877;39;626405044;4877;238;5702;5738;8.96;0.54;250.82;4.61;825;39;1952.00;36
4877;39;626405056;4877;239;5704;5739;8.98;0.55;250.82;4.61;827;39;1953.00;35
4878;39;626405068;4878;245;5705;5739;9.00;0.55;250.83;4.61;827;39;1954.00;34
4878;39;626405080;4878;244;5709;5743;8.99;0.55;250.83;4.61;831;39;1955.00;34
4880;39;626405093;4880;243;5709;5743;9.02;0.55;250.87;4.61;829;39;1956.00;34
4882;39;626405105;4882;244;5709;5743;9.02;0.55;250.86;4.61;827;39;1957.00;34
4885;39;626405117;4885;243;5709;5743;9.00;0.55;250.91;4.61;824;39;1958.00;34
4888;39;626405129;4888;246;5714;5749;8.95;0.55;251.01;4.60;826;39;1959.00;35
4892;39;626405142;4892;240;5714;5749;8.90;0.54;251.06;4.60;822;39;1960.00;35
4895;39;626405153;4895;247;5714;5749;8.87;0.54;251.07;4.60;819;39;1961.00;35
4896;39;626405165;4896;248;5717;5752;8.87;0.54;251.05;4.60;821;39;1962.00;35
4896;39;626405177;4896;245;5717;5752;8.88;0.54;251.05;4.60;821;39;1963.00;35
4901;39;626405188;4901;240;5717;5752;8.91;0.54;251.10;4.60;816;39;1964.00;35
4904;39;626405200;4904;235;5717;5753;8.92;0.54;251.15;4.60;813;39;1965.00;36
4906;39;626405212;4906;231;5718;5754;9.05;0.55;251.15;4.60;812;39;1966.00;36
4911;39;626405223;4911;229;5718;5754;9.01;0.55;251.20;4.60;807;39;1967.00;36
4913;39;626405234;4913;224;5727;5767;9.01;0.55;251.16;4.59;814;39;1968.00;40
4917;39;626405246;4917;216;5727;5767;8.98;0.55;251.27;4.59;810;39;1969.00;40
4921;39;626405258;4921;213;5728;5767;8.91;0.54;251.39;4.63;807;39;1970.00;39
4925;39;626405270;4925;205;5729;5768;8.93;0.54;251.47;4.63;804;39;1971.00;39
4932;39;626405280;4932;203;5729;5768;8.94;0.54;251.46;4.63;797;39;1972.00;39
4937;39;626405292;4937;198;5732;5772;9.00;0.55;251.52;4.63;795;39;1973.00;40
4943;39;626405305;4943;191;5733;5772;9.01;0.54;251.63;4.64;790;39;1974.00;39
4946;39;626405317;4946;184;5738;5776;9.07;0.55;251.58;4.65;792;39;1975.00;38
4949;39;626405329;4949;175;5738;5776;9.09;0.55;251.79;4.65;789;39;1976.00;38
4952;39;626405341;4952;165;5738;5776;9.15;0.55;251.76;4.65;786;39;1977.00;38
4955;39;626405352;4955;155;5738;5776;9.25;0.56;251.86;4.65;783;39;1978.00;38
4962;39;626405363;4962;152;5738;5776;9.27;0.56;251.91;4.65;776;39;1979.00;38
4962;39;626405376;4962;150;5758;5810;9.38;0.57;251.91;4.64;796;39;1980.00;52
4964;39;626405390;4964;148;5759;5810;9.40;0.57;252.00;4.64;795;39;1981.00;51
4967;39;626405401;4967;144;5760;5810;9.39;0.57;252.02;4.64;793;39;1982.00;50
4968;39;626405412;4968;139;5760;5810;9.43;0.57;252.06;4.64;792;39;1983.00;50
4969;39;626405423;4969;138;5761;5810;9.49;0.58;252.06;4.64;792;39;1984.00;49
4972;39;626405434;4972;142;5761;5810;9.52;0.58;252.12;4.64;789;39;1985.00;49
4974;39;626405446;4974;144;5763;5811;9.58;0.58;252.16;4.68;789;39;1986.00;48
4975;39;626405459;4975;146;5764;5811;9.61;0.58;252.21;4.68;789;39;1987.00;47
4977;39;626405469;4977;148;5767;5817;9.70;0.59;252.22;4.68;790;39;1988.00;50
4980;39;626405481;4980;151;5772;5818;9.76;0.59;252.20;4.71;792;39;1989.00;46
4983;39;626405492;4983;151;5773;5818;9.76;0.59;252.24;4.72;790;39;1990.00;45
4987;39;626405503;4987;155;5773;5818;9.82;0.59;252.22;4.72;786;39;1991.00;45
4989;39;626405515;4989;161;5777;5822;9.82;0.59;252.23;4.76;788;39;1992.00;45
4992;39;626405527;4992;162;5777;5822;9.71;0.59;252.32;4.76;785;39;1993.00;45
4993;39;626405539;4993;170;5778;5822;9.62;0.58;252.29;4.76;785;39;1994.00;44
4996;39;626405549;4996;175;5780;5823;9.54;0.58;252.33;4.76;784;39;1995.00;43
4999;39;626405561;4999;175;5784;5827;9.45;0.57;252.34;4.77;785;39;1996.00;43
5002;39;626405572;5002;180;5785;5827;9.33;0.57;252.35;4.77;783;39;1997.00;42
5003;39;626405589;5003;181;5787;5830;9.29;0.56;252.38;4.77;784;39;1998.00;43
5004;39;626405608;5004;186;5790;5830;9.16;0.56;252.45;4.78;786;39;1999.00;40
5005;39;626405619;5005;186;5790;5830;9.11;0.55;252.45;4.78;785;39;2000.00;40
5007;39;626405636;5007;188;5792;5830;9.06;0.55;252.52;4.79;785;39;2001.00;38
5008;39;626405648;5008;194;5795;5834;9.18;0.56;252.52;4.79;787;39;2002.00;39
5009;39;626405660;5009;198;5797;5834;9.21;0.56;252.50;4.81;788;39;2003.00;37
5011;39;626405671;5011;203;5798;5834;9.23;0.56;252.56;4.81;787;39;2004.00;36
5014;39;626405690;5014;202;5800;5834;9.20;0.56;252.61;4.83;786;39;2005.00;34
5016;39;626405701;5016;208;5800;5835;9.19;0.56;252.71;4.83;784;39;2006.00;35
5017;39;626405713;5017;212;5801;5836;9.19;0.56;252.73;4.83;784;39;2007.00;35
5018;39;626405724;5018;217;5803;5836;9.17;0.56;252.79;4.85;785;39;2008.00;33
5020;39;626405734;5020;218;5804;5837;9.13;0.56;252.76;4.85;784;39;2009.00;33
5022;39;626405748;5022;222;5805;5837;9.07;0.55;252.72;4.86;783;39;2010.00;32
5023;39;626405759;5023;223;5806;5837;8.93;0.55;252.68;4.86;783;39;2011.00;31
5025;39;626405769;5025;222;5806;5837;8.83;0.54;252.63;4.86;781;39;2012.00;31
5028;39;626405780;5028;224;5806;5837;8.72;0.53;252.55;4.86;778;39;2013.00;31
5029;39;626405790;5029;226;5808;5837;8.62;0.53;252.53;4.88;779;39;2014.00;29
5032;39;626405800;5032;232;5808;5837;8.54;0.52;252.46;4.88;776;39;2015.00;29
5035;39;626405810;5035;253;5871;5964;8.59;0.53;252.42;4.84;836;39;2016.00;93
5036;39;626405832;5036;259;5873;5965;8.45;0.53;252.44;4.84;837;39;2017.00;92
5037;39;626405843;5037;258;5886;5965;8.51;0.53;252.44;4.84;849;39;2018.00;79
5039;39;626405853;5039;258;5891;5965;8.45;0.53;252.43;4.84;852;39;2019.00;74
5041;39;626405864;5041;256;5898;5965;8.41;0.52;252.46;4.85;857;39;2020.00;67
5047;39;626405874;5047;255;5901;5965;8.29;0.51;252.42;4.85;854;39;2021.00;64
5051;39;626405885;5051;253;5909;5965;8.23;0.51;252.33;4.86;858;39;2022.00;56
5053;39;626405896;5053;253;5911;5965;8.16;0.50;252.27;4.86;858;39;2023.00;54
5057;39;626405906;5057;257;5918;5966;8.12;0.50;252.24;4.88;861;39;2024.00;48
5063;39;626405918;5063;261;5924;5968;8.13;0.50;252.06;4.88;861;39;2025.00;44
5067;39;626405930;5067;266;5927;5968;8.14;0.50;252.00;4.88;860;39;2026.00;41
5067;39;626405941;5067;271;5931;5969;8.14;0.50;252.00;4.89;864;39;2027.00;38
5067;39;626405952;5067;281;5933;5969;8.12;0.50;252.00;4.89;866;39;2028.00;36
5071;39;626405963;5071;292;5938;5969;8.03;0.49;252.13;4.91;867;39;2029.00;31
5075;39;626405974;5075;296;5938;5969;7.88;0.48;252.07;4.91;863;39;2030.00;31
5075;39;626405984;5075;301;5943;5973;7.79;0.48;252.07;4.91;868;39;2031.00;30
5077;39;626405995;5077;313;5944;5973;7.67;0.47;252.03;4.91;867;39;2032.00;29
5079;39;626406010;5079;319;5946;5973;7.51;0.46;252.08;4.91;867;39;2033.00;27
5082;39;626406021;5082;329;5949;5976;7.40;0.45;252.14;4.91;867;39;2034.00;27
5082;39;626406031;5082;336;5950;5976;7.34;0.45;252.14;4.92;868;39;2035.00;26
5085;39;626406042;5085;345;5952;5976;7.18;0.44;252.21;4.92;867;39;2036.00;24
5089;39;626406051;5089;348;5956;5980;7.07;0.43;252.12;4.92;867;39;2037.00;24
5092;39;626406063;5092;352;5957;5981;6.96;0.43;252.14;4.92;865;39;2038.00;24
5095;39;626406073;5095;363;5959;5981;6.75;0.41;252.06;4.92;864;39;2039.00;22
5097;39;626406090;5097;353;5965;5986;6.70;0.41;252.12;4.91;868;39;2040.00;21
5101;39;626406100;5101;351;5965;5986;6.61;0.41;252.12;4.91;864;39;2041.00;21
5102;39;626406110;5102;353;5965;5986;6.54;0.40;252.12;4.91;863;39;2042.00;21
5105;39;626406120;5105;340;5966;5987;6.54;0.40;252.16;4.91;861;39;2043.00;21
5108;39;626406130;5108;330;5966;5987;6.54;0.40;252.15;4.91;858;39;2044.00;21
5108;39;626406140;5108;329;5970;5993;6.63;0.41;252.15;4.91;862;39;2045.00;23
5113;39;626406150;5113;327;5971;5993;6.64;0.41;252.13;4.91;858;39;2046.00;22
5115;39;626406160;5115;313;5973;5994;6.72;0.41;252.14;4.91;858;39;2047.00;21
5121;39;626406171;5121;308;5973;5994;6.71;0.41;252.07;4.91;852;39;2048.00;21
5123;40;626406187;5123;291;5973;5994;6.74;0.41;252.06;4.91;850;40;2049.00;21
5126;40;626406209;5126;284;5973;5994;6.82;0.42;252.17;4.91;847;40;2050.00;21
5128;40;626406219;5128;279;5973;5994;6.86;0.42;252.26;4.91;845;40;2051.00;21
5131;40;626406229;5131;274;5983;6006;6.99;0.43;252.31;4.90;852;40;2052.00;23
5135;40;626406246;5135;268;5983;6006;7.02;0.43;252.26;4.90;848;40;2053.00;23
5137;40;626406258;5137;264;5985;6006;7.13;0.43;252.23;4.90;848;40;2054.00;21
5140;40;626406269;5140;264;5985;6006;7.17;0.44;252.26;4.90;845;40;2055.00;21
5143;40;626406280;5143;258;5985;6006;7.27;0.44;252.22;4.90;842;40;2056.00;21
5145;40;626406297;5145;254;5985;6006;7.38;0.45;252.16;4.90;840;40;2057.00;21
5145;40;626406308;5145;254;5989;6010;7.55;0.46;252.16;4.90;844;40;2058.00;21
5146;40;626406319;5146;259;5989;6010;7.61;0.46;252.18;4.90;843;40;2059.00;21
5149;40;626406330;5149;248;5992;6014;7.69;0.47;252.15;4.90;843;40;2060.00;22
5150;40;626406342;5150;255;5993;6015;7.76;0.47;252.17;4.89;843;40;2061.00;22
5153;40;626406354;5153;255;5994;6015;7.80;0.47;252.18;4.89;841;40;2062.00;21
5155;40;626406365;5155;251;5994;6015;7.85;0.48;252.18;4.89;839;40;2063.00;21
5159;40;626406376;5159;255;6007;6028;7.93;0.48;252.22;4.88;848;40;2064.00;21
5163;40;626406389;5163;256;6007;6028;7.93;0.48;252.31;4.88;844;40;2065.00;21
5167;40;626406400;5167;254;6007;6028;7.95;0.49;252.19;4.88;840;40;2066.00;21
5171;40;626406412;5171;255;6008;6029;7.99;0.49;252.26;4.88;837;40;2067.00;21
5176;40;626406423;5176;257;6009;6030;8.01;0.49;252.41;4.88;833;40;2068.00;21
5179;40;626406435;5179;256;6009;6030;8.04;0.49;252.57;4.88;830;40;2069.00;21
5186;40;626406448;5186;263;6012;6036;8.04;0.49;252.60;4.88;826;40;2070.00;24
5191;40;626406460;5191;263;6012;6036;8.03;0.49;252.73;4.88;821;40;2071.00;24
5195;40;626406471;5195;265;6013;6036;8.08;0.49;252.82;4.88;818;40;2072.00;23
5199;40;626406482;5199;264;6013;6036;8.04;0.49;252.91;4.88;814;40;2073.00;23
5205;40;626406494;5205;269;6017;6042;8.02;0.49;252.93;4.88;812;40;2074.00;25
5209;40;626406505;5209;273;6017;6042;7.96;0.48;253.14;4.88;808;40;2075.00;25
5212;40;626406517;5212;273;6018;6042;7.96;0.48;253.12;4.88;806;40;2076.00;24
5215;40;626406529;5215;275;6018;6042;7.95;0.48;253.26;4.88;803;40;2077.00;24
5219;40;626406539;5219;280;6024;6046;7.92;0.48;253.28;4.92;805;40;2078.00;22
5226;40;626406551;5226;277;6025;6047;7.82;0.48;253.35;4.92;799;40;2079.00;22
5229;41;626406569;5229;283;6026;6047;7.76;0.47;253.47;4.92;797;41;2080.00;21
5235;41;626406586;5235;285;6027;6048;7.73;0.47;253.54;4.92;792;41;2081.00;21
5237;41;626406597;5237;282;6027;6048;7.65;0.47;253.58;4.92;790;41;2082.00;21
5240;41;626406608;5240;283;6027;6048;7.65;0.47;253.63;4.92;787;41;2083.00;21
5246;41;626406619;5246;285;6027;6048;7.60;0.46;253.60;4.92;781;41;2084.00;21
5248;41;626406630;5248;289;6027;6048;7.62;0.46;253.63;4.92;779;41;2085.00;21
5250;41;626406640;5250;296;6027;6048;7.62;0.46;253.67;4.92;777;41;2086.00;21
5254;41;626406651;5254;288;6027;6048;7.60;0.46;253.82;4.92;773;41;2087.00;21
5255;41;626406667;5255;295;6070;6118;7.71;0.47;253.82;4.88;815;41;2088.00;48
5259;41;626406684;5259;286;6071;6119;7.75;0.47;253.93;4.88;812;41;2089.00;48
5263;41;626406695;5263;274;6077;6119;7.89;0.48;254.05;4.88;814;41;2090.00;42
5264;41;626406707;5264;273;6078;6119;8.08;0.49;254.12;4.88;814;41;2091.00;41
5267;41;626406718;5267;269;6082;6119;8.23;0.50;254.23;4.88;815;41;2092.00;37
5270;41;626406741;5270;267;6084;6119;8.33;0.51;254.31;4.88;814;41;2093.00;35
5272;41;626406752;5272;271;6088;6119;8.41;0.51;254.29;4.88;816;41;2094.00;31
5274;41;626406764;5274;270;6089;6119;8.46;0.52;254.32;4.88;815;41;2095.00;30
5277;41;626406775;5277;255;6092;6120;8.55;0.52;254.31;4.88;815;41;2096.00;28
5279;41;626406786;5279;245;6094;6121;8.56;0.52;254.29;4.88;815;41;2097.00;27
5280;41;626406798;5280;244;6095;6121;8.51;0.52;254.29;4.88;815;41;2098.00;26
5282;41;626406809;5282;244;6099;6125;8.45;0.51;254.28;4.93;817;41;2099.00;26
5286;41;626406824;5286;247;6103;6140;8.37;0.51;254.21;4.92;817;41;2100.00;37
5289;41;626406843;5289;247;6103;6140;8.41;0.51;254.18;4.92;814;41;2101.00;37
5292;41;626406856;5292;244;6103;6140;8.53;0.52;254.18;4.92;811;41;2102.00;37
5295;41;626406868;5295;241;6106;6146;8.63;0.52;254.24;4.92;811;41;2103.00;40
5296;42;626406880;5296;239;6106;6146;8.68;0.53;254.23;4.92;810;42;2104.00;40
5297;42;626406908;5297;241;6107;6146;8.73;0.53;254.24;4.92;810;42;2105.00;39
5299;42;626406926;5299;243;6110;6149;8.73;0.53;254.25;4.92;811;42;2106.00;39
5300;42;626406945;5300;233;6110;6149;8.69;0.53;254.27;4.92;810;42;2107.00;39
5303;42;626406963;5303;220;6110;6149;8.68;0.53;254.28;4.92;807;42;2108.00;39
5306;42;626406983;5306;224;6110;6150;8.72;0.53;254.33;4.92;804;42;2109.00;40
5308;42;626406999;5308;217;6111;6151;8.81;0.53;254.32;4.92;803;42;2110.00;40
5311;42;626407017;5311;213;6113;6151;8.85;0.54;254.30;4.97;802;42;2111.00;38
5313;42;626407033;5313;205;6123;6164;8.90;0.54;254.34;4.97;810;42;2112.00;41
5316;42;626407048;5316;201;6123;6164;8.96;0.54;254.34;4.97;807;42;2113.00;41
5318;42;626407063;5318;196;6123;6164;9.04;0.55;254.35;4.97;805;42;2114.00;41
5320;42;626407076;5320;191;6125;6166;9.19;0.56;254.33;4.96;805;42;2115.00;41
5322;42;626407089;5322;196;6125;6166;9.31;0.57;254.35;4.96;803;42;2116.00;41
5324;43;626407102;5324;194;6128;6170;9.31;0.57;254.32;4.96;804;43;2117.00;42
5325;43;626407128;5325;191;6129;6170;9.34;0.57;254.31;4.97;804;43;2118.00;41
5329;44;626407140;5329;189;6132;6174;9.27;0.56;254.30;4.97;803;44;2119.00;42
5332;44;626407170;5332;192;6132;6174;9.26;0.56;254.36;4.97;800;44;2120.00;42
5335;44;626407182;5335;195;6132;6174;9.27;0.56;254.38;4.97;797;44;2121.00;42
5337;44;626407200;5337;199;6132;6174;9.24;0.56;254.50;4.97;795;44;2122.00;42
5340;44;626407212;5340;199;6134;6174;9.23;0.56;254.53;4.97;794;44;2123.00;40
5340;44;626407224;5340;198;6142;6186;9.33;0.57;254.53;4.96;802;44;2124.00;44
5340;44;626407236;5340;202;6142;6186;9.35;0.57;254.53;4.96;802;44;2125.00;44
5340;44;626407247;5340;207;6145;6186;9.38;0.57;254.53;4.97;805;44;2126.00;41
5340;44;626407260;5340;213;6147;6186;9.37;0.57;254.53;5.03;807;44;2127.00;39
5341;44;626407271;5341;219;6149;6186;9.33;0.57;254.55;5.03;808;44;2128.00;37
5345;44;626407283;5345;219;6150;6186;9.24;0.56;254.46;5.03;805;44;2129.00;36
5346;44;626407297;5346;212;6151;6187;9.26;0.57;254.46;5.03;805;44;2130.00;36
5348;44;626407309;5348;214;6151;6187;9.29;0.57;254.45;5.03;803;44;2131.00;36
5350;44;626407320;5350;209;6156;6193;9.32;0.57;254.45;5.03;806;44;2132.00;37
5352;44;626407333;5352;206;6157;6194;9.27;0.57;254.46;5.03;805;44;2133.00;37
5353;44;626407345;5353;199;6159;6194;9.27;0.57;254.43;5.03;806;44;2134.00;35
5355;44;626407356;5355;200;6159;6194;9.24;0.56;254.43;5.03;804;44;2135.00;35
5358;44;626407368;5358;201;6162;6198;9.20;0.56;254.45;5.03;804;44;2136.00;36
5361;44;626407380;5361;197;6163;6198;9.16;0.56;254.44;5.03;802;44;2137.00;35
5365;44;626407391;5365;191;6163;6198;9.13;0.56;254.39;5.03;798;44;2138.00;35
5367;44;626407404;5367;186;6164;6199;9.15;0.56;254.37;5.03;797;44;2139.00;35
5374;44;626407415;5374;177;6167;6203;9.01;0.55;254.38;5.03;793;44;2140.00;36
5375;44;626407428;5375;178;6168;6203;8.95;0.54;254.37;5.08;793;44;2141.00;35
5379;44;626407438;5379;165;6170;6206;8.92;0.54;254.37;5.08;791;44;2142.00;36
5383;44;626407449;5383;169;6170;6206;8.87;0.54;254.33;5.08;787;44;2143.00;36
5385;44;626407461;5385;165;6171;6206;8.84;0.54;254.28;5.08;786;44;2144.00;35
5389;44;626407473;5389;170;6173;6206;8.79;0.53;254.35;5.10;784;44;2145.00;33
5395;44;626407484;5395;169;6176;6210;8.84;0.54;254.48;5.10;781;44;2146.00;34
5398;44;626407495;5398;173;6177;6210;8.91;0.54;254.43;5.10;779;44;2147.00;33
5401;44;626407506;5401;168;6177;6210;8.94;0.54;254.54;5.10;776;44;2148.00;33
5404;44;626407518;5404;165;6177;6210;8.82;0.53;254.57;5.10;773;44;2149.00;33
5408;44;626407528;5408;164;6177;6211;8.66;0.53;254.55;5.10;769;44;2150.00;34
5411;44;626407539;5411;164;6179;6212;8.58;0.52;254.67;5.15;768;44;2151.00;33
5413;44;626407550;5413;165;6179;6212;8.55;0.52;254.63;5.15;766;44;2152.00;33
5417;44;626407560;5417;165;6180;6213;8.50;0.52;254.64;5.15;763;44;2153.00;33
5419;44;626407570;5419;164;6180;6213;8.40;0.51;254.65;5.15;761;44;2154.00;33
5422;44;626407581;5422;171;6180;6213;8.30;0.50;254.69;5.15;758;44;2155.00;33
5423;44;626407592;5423;175;6180;6213;8.29;0.50;254.68;5.15;757;44;2156.00;33
5425;44;626407602;5425;173;6180;6213;8.32;0.51;254.64;5.15;755;44;2157.00;33
5428;44;626407612;5428;176;6181;6213;8.40;0.51;254.55;5.21;753;44;2158.00;32
5430;44;626407623;5430;177;6181;6213;8.51;0.52;254.54;5.21;751;44;2159.00;32
5430;44;626407634;5430;209;6280;6443;8.65;0.54;254.54;5.19;850;44;2160.00;163
5434;44;626407666;5434;205;6281;6444;8.60;0.54;254.56;5.18;847;44;2161.00;163
5435;44;626407677;5435;198;6291;6444;8.71;0.54;254.58;5.18;856;44;2162.00;153
5438;44;626407688;5438;197;6297;6444;8.64;0.54;254.53;5.23;859;44;2163.00;147
5439;44;626407699;5439;205;6306;6444;8.71;0.54;254.51;5.23;867;44;2164.00;138
5442;44;626407710;5442;203;6313;6444;8.76;0.54;254.44;5.23;871;44;2165.00;131
5443;44;626407722;5443;203;6320;6444;8.85;0.55;254.41;5.23;877;44;2166.00;124
5446;44;626407733;5446;205;6326;6444;8.92;0.55;254.38;5.24;880;44;2167.00;118
5449;44;626407745;5449;215;6334;6445;8.91;0.55;254.27;5.30;885;44;2168.00;111
5452;44;626407763;5452;222;6337;6446;8.90;0.55;254.25;5.30;885;44;2169.00;109
5452;44;626407775;5452;228;6341;6446;8.86;0.55;254.25;5.31;889;44;2170.00;105
5455;44;626407787;5455;231;6347;6447;8.75;0.54;254.20;5.33;892;44;2171.00;100
5455;44;626407799;5455;239;6351;6447;8.63;0.53;254.20;5.33;896;44;2172.00;96
5457;44;626407817;5457;244;6356;6447;8.52;0.53;254.18;5.36;899;44;2173.00;91
5457;44;626407829;5457;250;6359;6447;8.38;0.52;254.18;5.36;902;44;2174.00;88
5458;44;626407841;5458;253;6365;6451;8.30;0.51;254.15;5.37;907;44;2175.00;86
5461;44;626407853;5461;259;6372;6451;8.22;0.51;254.15;5.40;911;44;2176.00;79
5462;44;626407865;5462;264;6372;6451;8.13;0.50;254.14;5.40;910;44;2177.00;79
5463;45;626407877;5463;272;6377;6454;8.07;0.50;254.13;5.41;914;45;2178.00;77
5464;45;626407906;5464;285;6378;6454;8.01;0.49;254.11;5.41;914;45;2179.00;76
5465;45;626407918;5465;292;6381;6454;7.93;0.49;254.12;5.43;916;45;2180.00;73
5466;45;626407937;5466;299;6386;6458;7.84;0.48;254.08;5.43;920;45;2181.00;72
5466;45;626407949;5466;312;6392;6459;7.76;0.48;254.08;5.47;926;45;2182.00;67
5471;45;626407973;5471;319;6396;6459;7.61;0.47;254.05;5.49;925;45;2183.00;63
5472;45;626407990;5472;331;6403;6463;7.49;0.46;254.01;5.51;931;45;2184.00;60
5472;45;626408001;5472;339;6406;6463;7.38;0.46;254.01;5.52;934;45;2185.00;57
5477;45;626408011;5477;346;6408;6463;7.27;0.45;253.94;5.52;931;45;2186.00;55
5479;45;626408023;5479;350;6410;6464;7.17;0.44;253.94;5.53;931;45;2187.00;54
5482;45;626408033;5482;352;6414;6464;7.02;0.43;253.93;5.54;932;45;2188.00;50
5484;45;626408044;5484;355;6418;6470;6.95;0.43;253.88;5.55;934;45;2189.00;52
5484;45;626408061;5484;352;6423;6470;6.93;0.43;253.88;5.57;939;45;2190.00;47
5486;45;626408072;5486;359;6426;6471;6.88;0.42;253.82;5.57;940;45;2191.00;45
5487;45;626408083;5487;359;6426;6471;6.87;0.42;253.78;5.57;939;45;2192.00;45
5488;45;626408094;5488;365;6431;6471;6.91;0.42;253.74;5.59;943;45;2193.00;40
5489;45;626408104;5489;367;6434;6471;6.87;0.42;253.87;5.59;945;45;2194.00;37
5491;45;626408115;5491;363;6436;6471;6.90;0.42;253.86;5.60;945;45;2195.00;35
5493;45;626408126;5493;360;6447;6483;6.99;0.43;253.83;5.59;954;45;2196.00;36
5493;45;626408138;5493;359;6448;6483;7.03;0.43;253.83;5.59;955;45;2197.00;35
5494;45;626408148;5494;353;6449;6483;7.01;0.43;253.79;5.60;955;45;2198.00;34
5495;45;626408159;5495;354;6449;6483;7.03;0.43;253.77;5.60;954;45;2199.00;34
5496;46;626408171;5496;353;6449;6483;7.02;0.43;253.72;5.60;953;46;2200.00;34
5499;46;626408196;5499;345;6450;6483;7.01;0.43;253.68;5.60;951;46;2201.00;33
5500;46;626408208;5500;343;6453;6487;7.01;0.43;253.66;5.60;953;46;2202.00;34
5503;47;626408219;5503;345;6454;6487;7.00;0.43;253.67;5.60;951;47;2203.00;33
5505;47;626408240;5505;348;6458;6491;6.97;0.43;253.68;5.60;953;47;2204.00;33
5508;48;626408252;5508;342;6461;6493;6.88;0.42;253.72;5.60;953;48;2205.00;32
5514;48;626408278;5514;345;6461;6493;6.81;0.42;253.77;5.60;947;48;2206.00;32
5515;48;626408289;5515;346;6463;6493;6.73;0.41;253.80;5.61;948;48;2207.00;30
5519;48;626408300;5519;352;6476;6506;6.66;0.41;253.81;5.60;957;48;2208.00;30
5520;48;626408312;5520;352;6476;6506;6.59;0.40;253.76;5.60;956;48;2209.00;30
5522;48;626408322;5522;341;6478;6508;6.53;0.40;253.84;5.60;956;48;2210.00;30
5524;48;626408333;5524;336;6479;6509;6.54;0.40;253.88;5.60;955;48;2211.00;30
5526;48;626408349;5526;336;6479;6510;6.48;0.40;253.90;5.60;953;48;2212.00;31
5530;48;626408360;5530;329;6480;6510;6.44;0.39;253.98;5.60;950;48;2213.00;30
5534;49;626408372;5534;332;6482;6513;6.46;0.39;253.87;5.59;948;49;2214.00;31
5540;49;626408400;5540;327;6483;6513;6.38;0.39;254.05;5.59;943;49;2215.00;30
5540;50;626408412;5540;329;6483;6513;6.44;0.39;254.05;5.59;943;50;2216.00;30
5542;50;626408438;5542;322;6483;6513;6.47;0.40;254.08;5.59;941;50;2217.00;30
5547;50;626408449;5547;326;6487;6519;6.54;0.40;254.17;5.59;940;50;2218.00;32
5550;50;626408462;5550;313;6488;6519;6.65;0.41;254.25;5.59;938;50;2219.00;31
5554;50;626408482;5554;309;6489;6519;6.74;0.41;254.26;5.59;935;50;2220.00;30
5558;50;626408494;5558;299;6491;6519;6.80;0.42;254.33;5.66;933;50;2221.00;28
5559;50;626408507;5559;290;6495;6523;6.97;0.43;254.39;5.65;936;50;2222.00;28
5564;50;626408520;5564;278;6496;6524;7.06;0.43;254.47;5.65;932;50;2223.00;28
5569;50;626408533;5569;279;6496;6524;7.14;0.44;254.59;5.65;927;50;2224.00;28
5572;50;626408547;5572;277;6497;6525;7.24;0.44;254.67;5.65;925;50;2225.00;28
5579;50;626408560;5579;274;6497;6525;7.20;0.44;254.80;5.65;918;50;2226.00;28
5583;50;626408573;5583;275;6497;6525;7.27;0.45;254.89;5.65;914;50;2227.00;28
5588;50;626408585;5588;277;6497;6525;7.30;0.45;254.87;5.65;909;50;2228.00;28
5594;50;626408599;5594;280;6497;6525;7.31;0.45;254.89;5.65;903;50;2229.00;28
5598;50;626408610;5598;282;6497;6525;7.36;0.45;254.89;5.65;899;50;2230.00;28
5600;50;626408622;5600;279;6497;6525;7.46;0.46;254.83;5.65;897;50;2231.00;28
5605;50;626408634;5605;292;6535;6595;7.61;0.47;254.95;5.62;930;50;2232.00;60
5607;50;626408652;5607;278;6536;6596;7.67;0.47;254.92;5.62;929;50;2233.00;60
5612;50;626408664;5612;276;6544;6596;7.81;0.48;255.12;5.61;932;50;2234.00;52
5614;50;626408676;5614;268;6549;6596;7.90;0.48;255.22;5.61;935;50;2235.00;47
5616;50;626408690;5616;260;6555;6596;7.97;0.49;255.21;5.61;939;50;2236.00;41
5620;50;626408702;5620;263;6559;6596;8.02;0.49;255.32;5.61;939;50;2237.00;37
5623;50;626408715;5623;265;6560;6596;8.06;0.49;255.39;5.61;937;50;2238.00;36
5629;50;626408728;5629;268;6561;6596;8.07;0.49;255.41;5.61;932;50;2239.00;35
5634;50;626408741;5634;271;6563;6597;8.14;0.50;255.51;5.61;929;50;2240.00;34
5641;50;626408759;5641;276;6564;6598;8.14;0.49;255.59;5.61;923;50;2241.00;34
5642;50;626408773;5642;284;6565;6598;8.14;0.49;255.61;5.61;923;50;2242.00;33
5648;50;626408787;5648;288;6568;6602;8.10;0.49;255.68;5.61;920;50;2243.00;34
5652;50;626408804;5652;287;6568;6602;8.06;0.49;255.71;5.61;916;50;2244.00;34
5656;50;626408819;5656;292;6568;6602;8.04;0.49;255.72;5.61;912;50;2245.00;34
5662;50;626408832;5662;297;6568;6602;8.01;0.49;255.82;5.61;906;50;2246.00;34
5667;50;626408846;5667;301;6572;6608;8.01;0.49;255.86;5.60;905;50;2247.00;36
5668;50;626408859;5668;301;6572;6608;8.03;0.49;255.88;5.60;904;50;2248.00;36
5674;50;626408877;5674;304;6573;6608;8.06;0.49;255.91;5.60;899;50;2249.00;35
5678;50;626408892;5678;299;6576;6614;8.02;0.49;255.90;5.60;898;50;2250.00;38
5679;50;626408905;5679;299;6577;6614;8.01;0.49;255.91;5.60;898;50;2251.00;37
5685;50;626408918;5685;303;6577;6614;7.89;0.48;255.95;5.60;892;50;2252.00;37
5688;50;626408936;5688;304;6578;6615;7.82;0.48;256.00;5.60;890;50;2253.00;37
5690;50;626408957;5690;312;6579;6616;7.77;0.47;256.11;5.60;889;50;2254.00;37
5695;50;626408979;5695;316;6580;6616;7.65;0.47;256.15;5.60;885;50;2255.00;36
5699;50;626408998;5699;330;6590;6629;7.68;0.47;256.25;5.59;891;50;2256.00;39
5699;50;626409018;5699;315;6591;6629;7.67;0.47;256.25;5.59;892;50;2257.00;38
5703;50;626409035;5703;309;6591;6629;7.65;0.47;256.32;5.59;888;50;2258.00;38
5708;50;626409050;5708;306;6592;6630;7.62;0.47;256.45;5.59;884;50;2259.00;38
5710;50;626409064;5710;306;6592;6630;7.68;0.47;256.53;5.59;882;50;2260.00;38
5714;50;626409079;5714;304;6595;6634;7.68;0.47;256.59;5.59;881;50;2261.00;39
5718;50;626409095;5718;298;6596;6634;7.69;0.47;256.67;5.59;878;50;2262.00;38
5721;50;626409108;5721;294;6600;6638;7.71;0.47;256.65;5.64;879;50;2263.00;38
5726;50;626409122;5726;294;6600;6638;7.67;0.47;256.63;5.64;874;50;2264.00;38
5728;50;626409150;5728;297;6600;6638;7.61;0.46;256.66;5.64;872;50;2265.00;38
5731;50;626409162;5731;287;6600;6638;7.60;0.46;256.64;5.64;869;50;2266.00;38
5735;50;626409176;5735;271;6600;6638;7.62;0.46;256.61;5.64;865;50;2267.00;38
5736;50;626409189;5736;260;6609;6650;7.79;0.47;256.63;5.64;873;50;2268.00;41
5739;50;626409203;5739;250;6610;6650;7.92;0.48;256.63;5.63;871;50;2269.00;40
5744;50;626409217;5744;249;6611;6650;8.05;0.49;256.68;5.63;867;50;2270.00;39
5745;50;626409230;5745;249;6611;6650;8.16;0.50;256.67;5.63;866;50;2271.00;39
5748;50;626409244;5748;250;6611;6650;8.24;0.50;256.71;5.63;863;50;2272.00;39
5752;50;626409266;5752;253;6611;6650;8.24;0.50;256.76;5.63;859;50;2273.00;39
5755;50;626409279;5755;251;6611;6651;8.26;0.50;256.73;5.63;856;50;2274.00;40
5758;50;626409292;5758;252;6611;6651;8.29;0.50;256.76;5.63;853;50;2275.00;40
5760;50;626409305;5760;256;6615;6657;8.34;0.51;256.84;5.63;855;50;2276.00;42
5766;50;626409320;5766;251;6616;6658;8.40;0.51;256.89;5.63;850;50;2277.00;42
5769;50;626409333;5769;250;6617;6658;8.42;0.51;256.90;5.63;848;50;2278.00;41
5773;50;626409353;5773;237;6617;6658;8.43;0.51;256.99;5.63;844;50;2279.00;41
5776;50;626409368;5776;233;6621;6663;8.48;0.52;256.97;5.63;845;50;2280.00;42
5778;50;626409382;5778;227;6621;6663;8.53;0.52;256.93;5.63;843;50;2281.00;42
5781;50;626409395;5781;220;6621;6663;8.57;0.52;256.93;5.63;840;50;2282.00;42
5784;50;626409407;5784;220;6622;6664;8.67;0.53;257.07;5.63;838;50;2283.00;42
5788;50;626409420;5788;217;6625;6668;8.65;0.52;257.09;5.62;837;50;2284.00;43
5789;50;626409433;5789;211;6625;6668;8.70;0.53;257.10;5.62;836;50;2285.00;43
5790;50;626409446;5790;210;6627;6671;8.75;0.53;257.10;5.62;837;50;2286.00;44
5792;50;626409459;5792;204;6627;6671;8.75;0.53;257.16;5.62;835;50;2287.00;44
5795;50;626409474;5795;206;6628;6671;8.72;0.53;257.17;5.62;833;50;2288.00;43
5796;50;626409492;5796;198;6628;6671;8.76;0.53;257.16;5.62;832;50;2289.00;43
5799;50;626409510;5799;206;6631;6675;8.83;0.54;257.31;5.62;832;50;2290.00;44
5802;50;626409523;5802;207;6631;6675;8.78;0.53;257.46;5.62;829;50;2291.00;44
5803;50;626409535;5803;199;6632;6675;8.73;0.53;257.46;5.62;829;50;2292.00;43
5806;50;626409546;5806;194;6632;6675;8.71;0.53;257.47;5.62;826;50;2293.00;43
5806;50;626409557;5806;198;6632;6676;8.68;0.53;257.47;5.62;826;50;2294.00;44
5807;50;626409569;5807;200;6634;6678;8.70;0.53;257.46;5.62;827;50;2295.00;44
5808;50;626409580;5808;202;6635;6678;8.67;0.53;257.43;5.68;827;50;2296.00;43
5809;50;626409592;5809;207;6636;6679;8.68;0.53;257.45;5.68;827;50;2297.00;43
5811;50;626409604;5811;207;6636;6679;8.60;0.52;257.44;5.68;825;50;2298.00;43
5813;50;626409615;5813;213;6636;6679;8.47;0.52;257.43;5.68;823;50;2299.00;43
5817;50;626409634;5817;204;6636;6679;8.36;0.51;257.38;5.68;819;50;2300.00;43
5821;50;626409656;5821;208;6636;6679;8.31;0.50;257.37;5.68;815;50;2301.00;43
5822;50;626409668;5822;199;6636;6679;8.33;0.51;257.37;5.68;814;50;2302.00;43
5824;50;626409679;5824;202;6636;6679;8.30;0.50;257.39;5.68;812;50;2303.00;43
5826;50;626409690;5826;221;6709;6806;8.22;0.51;257.40;5.62;883;50;2304.00;97
5827;50;626409713;5827;213;6709;6807;8.19;0.50;257.38;5.62;882;50;2305.00;98
5829;50;626409724;5829;204;6717;6807;8.26;0.51;257.42;5.61;888;50;2306.00;90
5830;50;626409735;5830;198;6721;6807;8.28;0.51;257.51;5.61;891;50;2307.00;86
5832;50;626409746;5832;197;6725;6807;8.29;0.51;257.55;5.61;893;50;2308.00;82
5837;50;626409757;5837;193;6729;6807;8.30;0.51;257.53;5.61;892;50;2309.00;78
5838;50;626409770;5838;195;6733;6807;8.30;0.51;257.56;5.61;895;50;2310.00;74
5842;50;626409780;5842;197;6736;6807;8.27;0.51;257.59;5.61;894;50;2311.00;71
5842;50;626409798;5842;194;6740;6808;8.25;0.51;257.59;5.61;898;50;2312.00;68
5846;50;626409809;5846;197;6744;6809;8.16;0.50;257.53;5.61;898;50;2313.00;65
5850;50;626409820;5850;197;6746;6809;8.09;0.50;257.53;5.63;896;50;2314.00;63
5855;50;626409839;5855;202;6748;6810;8.06;0.49;257.57;5.64;893;50;2315.00;62
5858;50;626409851;5858;205;6751;6810;7.98;0.49;257.56;5.72;893;50;2316.00;59
5861;50;626409861;5861;209;6752;6810;7.87;0.48;257.53;5.72;891;50;2317.00;58
5865;50;626409873;5865;212;6753;6810;7.80;0.48;257.55;5.72;888;50;2318.00;57
5868;50;626409884;5868;210;6756;6814;7.70;0.47;257.58;5.72;888;50;2319.00;58
5870;50;626409896;5870;208;6758;6814;7.68;0.47;257.63;5.72;888;50;2320.00;56
5874;50;626409908;5874;211;6759;6814;7.68;0.47;257.58;5.73;885;50;2321.00;55
5876;50;626409920;5876;215;6762;6817;7.67;0.47;257.53;5.73;886;50;2322.00;55
5877;50;626409932;5877;211;6763;6817;7.70;0.47;257.53;5.73;886;50;2323.00;54
5877;50;626409943;5877;210;6764;6817;7.73;0.48;257.53;5.73;887;50;2324.00;53
5878;50;626409955;5878;216;6767;6821;7.68;0.47;257.50;5.72;889;50;2325.00;54
5879;50;626409966;5879;221;6769;6822;7.72;0.48;257.46;5.72;890;50;2326.00;53
5881;50;626409979;5881;230;6769;6822;7.68;0.47;257.43;5.72;888;50;2327.00;53
5885;50;626409989;5885;230;6773;6826;7.63;0.47;257.41;5.72;888;50;2328.00;53
5889;50;626410000;5889;232;6773;6826;7.56;0.46;257.33;5.72;884;50;2329.00;53
5894;50;626410011;5894;238;6773;6826;7.47;0.46;257.26;5.72;879;50;2330.00;53
5894;50;626410023;5894;245;6774;6827;7.45;0.46;257.26;5.72;880;50;2331.00;53
5896;50;626410033;5896;251;6774;6827;7.39;0.45;257.21;5.72;878;50;2332.00;53
5898;50;626410044;5898;257;6778;6833;7.39;0.45;257.19;5.72;880;50;2333.00;55
5899;50;626410056;5899;266;6778;6833;7.40;0.45;257.18;5.72;879;50;2334.00;55
5901;50;626410067;5901;271;6779;6834;7.40;0.45;257.12;5.72;878;50;2335.00;55
5902;50;626410078;5902;273;6780;6834;7.40;0.45;257.08;5.73;878;50;2336.00;54
5905;50;626410088;5905;274;6780;6834;7.33;0.45;257.05;5.73;875;50;2337.00;54
5906;50;626410100;5906;276;6780;6834;7.30;0.44;257.03;5.73;874;50;2338.00;54
5908;50;626410111;5908;279;6780;6834;7.26;0.44;257.03;5.73;872;50;2339.00;54
5908;50;626410124;5908;296;6804;6870;7.34;0.45;257.03;5.74;896;50;2340.00;66
5909;50;626410138;5909;288;6806;6870;7.36;0.45;257.02;5.74;897;50;2341.00;64
5911;50;626410149;5911;298;6810;6870;7.34;0.45;256.99;5.77;899;50;2342.00;60
5912;50;626410163;5912;301;6812;6870;7.33;0.45;257.00;5.76;900;50;2343.00;58
5913;50;626410173;5913;305;6814;6870;7.30;0.45;256.97;5.77;901;50;2344.00;56
5914;50;626410191;5914;305;6816;6870;7.27;0.44;256.96;5.79;902;50;2345.00;54
5914;50;626410203;5914;307;6820;6874;7.28;0.45;256.96;5.79;906;50;2346.00;54
5915;50;626410215;5915;300;6821;6874;7.25;0.44;256.96;5.80;906;50;2347.00;53
5916;50;626410226;5916;298;6825;6878;7.23;0.44;256.92;5.81;909;50;2348.00;53
5920;50;626410238;5920;286;6827;6879;7.24;0.44;256.91;5.81;907;50;2349.00;52
5922;50;626410249;5922;282;6829;6879;7.23;0.44;256.93;5.83;907;50;2350.00;50
5923;50;626410260;5923;281;6831;6879;7.21;0.44;256.91;5.84;908;50;2351.00;48
5926;50;626410276;5926;278;6841;6892;7.17;0.44;256.85;5.83;915;50;2352.00;51
5928;50;626410288;5928;275;6842;6892;7.11;0.44;256.83;5.84;914;50;2353.00;50
5930;50;626410304;5930;277;6844;6892;7.11;0.44;256.87;5.85;914;50;2354.00;48
5931;50;626410315;5931;279;6846;6893;7.09;0.43;256.86;5.85;915;50;2355.00;47
5931;50;626410324;5931;282;6847;6894;7.11;0.44;256.86;5.86;916;50;2356.00;47
5932;50;626410341;5932;293;6848;6894;7.12;0.44;256.88;5.87;916;50;2357.00;46
5936;50;626410352;5936;304;6852;6897;7.13;0.44;256.79;5.88;916;50;2358.00;45
5938;50;626410369;5938;299;6853;6897;7.16;0.44;256.81;5.88;915;50;2359.00;44
5939;50;626410380;5939;296;6854;6897;7.18;0.44;256.80;5.89;915;50;2360.00;43
5940;50;626410390;5940;293;6854;6897;7.20;0.44;256.76;5.89;914;50;2361.00;43
5941;50;626410401;5941;290;6858;6903;7.21;0.44;256.75;5.89;917;50;2362.00;45
5943;50;626410412;5943;294;6858;6903;7.20;0.44;256.74;5.89;915;50;2363.00;45
5945;50;626410423;5945;289;6859;6903;7.22;0.44;256.70;5.89;914;50;2364.00;44
5946;50;626410433;5946;283;6863;6903;7.24;0.44;256.66;5.92;917;50;2365.00;40
5948;50;626410445;5948;288;6866;6907;7.26;0.44;256.64;5.92;918;50;2366.00;41
5948;50;626410456;5948;291;6869;6908;7.35;0.45;256.64;5.93;921;50;2367.00;39
5948;50;626410467;5948;292;6869;6908;7.41;0.45;256.64;5.93;921;50;2368.00;39
5949;50;626410478;5949;292;6871;6909;7.43;0.45;256.62;5.93;922;50;2369.00;38
5951;50;626410491;5951;296;6873;6909;7.41;0.45;256.63;5.94;922;50;2370.00;36
5954;50;626410502;5954;294;6873;6909;7.35;0.45;256.63;5.94;919;50;2371.00;36
5956;50;626410512;5956;297;6874;6909;7.31;0.45;256.67;5.94;918;50;2372.00;35
5961;50;626410523;5961;295;6875;6909;7.23;0.44;256.62;5.95;914;50;2373.00;34
5963;50;626410533;5963;292;6875;6909;7.21;0.44;256.67;5.95;912;50;2374.00;34
5967;50;626410544;5967;290;6877;6909;7.16;0.44;256.67;5.95;910;50;2375.00;32
5971;50;626410554;5971;302;6915;6979;7.29;0.45;256.65;5.92;944;50;2376.00;64
5979;50;626410571;5979;300;6916;6980;7.20;0.44;256.88;5.92;937;50;2377.00;64
5985;50;626410583;5985;299;6925;6980;7.16;0.44;256.90;5.91;940;50;2378.00;55
5988;50;626410593;5988;306;6929;6980;7.06;0.43;256.88;5.92;941;50;2379.00;51
5992;50;626410604;5992;297;6935;6980;7.10;0.43;256.90;5.91;943;50;2380.00;45
5997;50;626410614;5997;292;6939;6980;7.08;0.43;256.88;5.92;942;50;2381.00;41
6000;50;626410625;6000;288;6945;6980;7.09;0.43;256.95;5.92;945;50;2382.00;35
6003;50;626410636;6003;282;6946;6980;7.08;0.43;257.04;5.92;943;50;2383.00;34
6005;50;626410648;6005;283;6950;6981;7.08;0.43;257.04;5.92;945;50;2384.00;31
6010;50;626410659;6010;286;6953;6983;7.04;0.43;257.07;5.91;943;50;2385.00;30
6011;50;626410671;6011;296;6953;6983;7.06;0.43;257.10;5.91;942;50;2386.00;30
6016;50;626410683;6016;297;6957;6987;7.07;0.43;257.13;5.91;941;50;2387.00;30
6021;50;626410695;6021;295;6957;6987;7.15;0.44;257.24;5.91;936;50;2388.00;30
6023;50;626410707;6023;295;6957;6987;7.25;0.44;257.31;5.91;934;50;2389.00;30
6026;50;626410718;6026;295;6957;6987;7.26;0.44;257.46;5.91;931;50;2390.00;30
6030;50;626410730;6030;295;6961;6993;7.32;0.45;257.58;5.91;931;50;2391.00;32
6033;50;626410742;6033;293;6962;6993;7.37;0.45;257.72;5.91;929;50;2392.00;31
6036;50;626410754;6036;295;6962;6993;7.46;0.46;257.69;5.91;926;50;2393.00;31
6040;50;626410766;6040;294;6964;6996;7.56;0.46;257.74;5.91;924;50;2394.00;32
6047;50;626410779;6047;297;6965;6996;7.58;0.46;257.71;5.91;918;50;2395.00;31
6053;50;626410791;6053;298;6965;6996;7.59;0.46;257.77;5.91;912;50;2396.00;31
6057;50;626410803;6057;290;6966;6997;7.59;0.46;257.88;5.91;909;50;2397.00;31
6062;50;626410816;6062;282;6968;6998;7.59;0.46;257.96;5.97;906;50;2398.00;30
6066;50;626410828;6066;280;6968;6998;7.58;0.46;258.08;5.97;902;50;2399.00;30
6071;50;626410842;6071;282;6991;7057;7.65;0.47;258.10;5.95;920;50;2400.00;66
6075;50;626410864;6075;278;6993;7057;7.67;0.47;258.26;5.95;918;50;2401.00;64
6081;50;626410876;6081;274;6996;7057;7.72;0.47;258.34;5.95;915;50;2402.00;61
6084;51;626410889;6084;260;6997;7058;7.75;0.47;258.42;5.95;913;51;2403.00;61
6094;51;626410913;6094;255;6999;7058;7.73;0.47;258.41;5.95;905;51;2404.00;59
6097;51;626410929;6097;253;7001;7062;7.79;0.48;258.45;5.95;904;51;2405.00;61
6102;51;626410950;6102;250;7003;7062;7.79;0.48;258.60;5.95;901;51;2406.00;59
6106;51;626410970;6106;253;7007;7066;7.84;0.48;258.61;5.94;901;51;2407.00;59
6111;51;626410991;6111;257;7008;7066;7.79;0.47;258.75;5.95;897;51;2408.00;58
6116;51;626411010;6116;259;7008;7066;7.79;0.47;258.77;5.95;892;51;2409.00;58
6121;51;626411029;6121;256;7009;7066;7.76;0.47;258.78;5.95;888;51;2410.00;57
6124;51;626411046;6124;267;7009;7066;7.75;0.47;258.85;5.95;885;51;2411.00;57
6129;51;626411060;6129;270;7017;7078;7.76;0.47;259.02;5.94;888;51;2412.00;61
6133;51;626411075;6133;275;7019;7078;7.74;0.47;259.10;5.94;886;51;2413.00;59
6137;51;626411089;6137;278;7020;7078;7.78;0.47;259.23;5.94;883;51;2414.00;58
6138;51;626411103;6138;277;7020;7078;7.82;0.48;259.24;5.94;882;51;2415.00;58
6141;51;626411117;6141;280;7021;7078;7.82;0.48;259.29;5.94;880;51;2416.00;57
6143;51;626411131;6143;277;7021;7078;7.77;0.47;259.39;5.94;878;51;2417.00;57
6147;51;626411144;6147;283;7021;7079;7.74;0.47;259.63;5.94;874;51;2418.00;58
6154;51;626411157;6154;289;7024;7079;7.68;0.47;259.71;5.95;870;51;2419.00;55
6158;51;626411174;6158;284;7027;7085;7.66;0.47;259.70;5.95;869;51;2420.00;58
6162;51;626411188;6162;291;7028;7086;7.66;0.47;259.77;5.94;866;51;2421.00;58
6165;51;626411200;6165;292;7029;7086;7.66;0.47;259.85;5.95;864;51;2422.00;57
6168;51;626411213;6168;288;7029;7086;7.62;0.46;259.92;5.95;861;51;2423.00;57
6172;51;626411226;6172;292;7031;7090;7.56;0.46;260.02;5.95;859;51;2424.00;59
6174;51;626411238;6174;296;7032;7090;7.51;0.46;260.07;5.95;858;51;2425.00;58
6178;51;626411251;6178;300;7032;7090;7.50;0.46;260.09;5.95;854;51;2426.00;58
6183;51;626411264;6183;286;7033;7091;7.47;0.46;260.17;5.95;850;51;2427.00;58
6184;51;626411277;6184;287;7039;7095;7.45;0.45;260.17;5.95;855;51;2428.00;56
6188;51;626411291;6188;281;7040;7095;7.46;0.45;260.25;5.95;852;51;2429.00;55
6191;51;626411304;6191;281;7043;7101;7.53;0.46;260.34;5.95;852;51;2430.00;58
6194;51;626411318;6194;279;7044;7101;7.59;0.46;260.40;5.95;850;51;2431.00;57
6197;51;626411330;6197;276;7044;7101;7.69;0.47;260.46;5.95;847;51;2432.00;57
6201;51;626411343;6201;280;7045;7101;7.71;0.47;260.54;5.95;844;51;2433.00;56
6204;51;626411356;6204;278;7049;7105;7.70;0.47;260.62;5.96;845;51;2434.00;56
6209;51;626411370;6209;278;7051;7105;7.67;0.47;260.78;5.96;842;51;2435.00;54
6211;51;626411382;6211;266;7052;7105;7.74;0.47;260.83;5.96;841;51;2436.00;53
6213;51;626411394;6213;255;7053;7105;7.78;0.47;260.88;5.96;840;51;2437.00;52
6216;51;626411414;6216;252;7054;7106;7.81;0.48;260.97;6.03;838;51;2438.00;52
6219;51;626411426;6219;239;7055;7107;7.92;0.48;260.98;6.03;836;51;2439.00;52
6221;51;626411440;6221;236;7056;7107;8.01;0.49;261.00;6.03;835;51;2440.00;51
6226;51;626411452;6226;225;7057;7108;8.04;0.49;260.97;6.03;831;51;2441.00;51
6228;51;626411467;6228;215;7057;7108;8.14;0.49;260.97;6.03;829;51;2442.00;51
6230;51;626411480;6230;218;7057;7108;8.24;0.50;260.96;6.03;827;51;2443.00;51
6234;51;626411492;6234;206;7057;7108;8.31;0.50;260.99;6.03;823;51;2444.00;51
6240;51;626411510;6240;207;7057;7108;8.31;0.50;261.08;6.03;817;51;2445.00;51
6243;51;626411523;6243;208;7058;7108;8.34;0.51;261.17;6.04;815;51;2446.00;50
6248;51;626411542;6248;203;7058;7108;8.32;0.50;261.28;6.04;810;51;2447.00;50
6250;51;626411561;6250;218;7119;7235;8.49;0.52;261.24;5.99;869;51;2448.00;116
6251;51;626411585;6251;208;7121;7236;8.54;0.52;261.22;5.98;870;51;2449.00;115
6252;51;626411598;6252;189;7129;7236;8.67;0.53;261.25;5.98;877;51;2450.00;107
6253;51;626411611;6253;185;7130;7236;8.73;0.54;261.29;5.98;877;51;2451.00;106
6255;51;626411623;6255;188;7137;7236;8.85;0.54;261.33;5.98;882;51;2452.00;99
6258;51;626411636;6258;193;7137;7236;8.88;0.55;261.41;5.98;879;51;2453.00;99
6259;51;626411649;6259;194;7141;7236;8.95;0.55;261.45;5.98;882;51;2454.00;95
6263;51;626411662;6263;197;7142;7236;8.96;0.55;261.57;5.98;879;51;2455.00;94
6265;51;626411675;6265;204;7148;7237;8.97;0.55;261.65;5.99;883;51;2456.00;89
6266;51;626411688;6266;205;7150;7238;8.83;0.54;261.68;5.99;884;51;2457.00;88
6271;51;626411701;6271;209;7154;7238;8.74;0.54;261.89;6.00;883;51;2458.00;84
6273;51;626411713;6273;217;7157;7239;8.69;0.53;261.89;6.00;884;51;2459.00;82
6275;51;626411727;6275;228;7161;7239;8.62;0.53;261.95;6.00;886;51;2460.00;78
6277;51;626411740;6277;227;7164;7239;8.61;0.53;261.92;6.00;887;51;2461.00;75
6280;51;626411752;6280;242;7170;7239;8.58;0.53;261.93;6.09;890;51;2462.00;69
6284;51;626411764;6284;242;7174;7243;8.51;0.52;261.88;6.09;890;51;2463.00;69
6286;51;626411776;6286;253;7176;7243;8.43;0.52;261.88;6.09;890;51;2464.00;67
6286;51;626411790;6286;252;7180;7243;8.31;0.51;261.88;6.10;894;51;2465.00;63
6289;51;626411802;6289;261;7183;7246;8.24;0.50;261.82;6.10;894;51;2466.00;63
6291;51;626411822;6291;262;7184;7246;8.16;0.50;261.78;6.10;893;51;2467.00;62
6293;51;626411834;6293;260;7186;7246;8.06;0.49;261.80;6.11;893;51;2468.00;60
6294;51;626411847;6294;267;7190;7250;8.01;0.49;261.76;6.11;896;51;2469.00;60
6295;51;626411859;6295;265;7192;7251;7.99;0.49;261.74;6.11;897;51;2470.00;59
6297;51;626411871;6297;261;7193;7251;7.96;0.49;261.74;6.11;896;51;2471.00;58
6298;51;626411883;6298;267;7195;7255;7.94;0.49;261.71;6.11;897;51;2472.00;60
6299;51;626411896;6299;260;7195;7255;7.86;0.48;261.67;6.11;896;51;2473.00;60
6301;51;626411907;6301;260;7195;7255;7.78;0.48;261.64;6.11;894;51;2474.00;60
6302;51;626411919;6302;260;7198;7257;7.70;0.47;261.65;6.18;896;51;2475.00;59
6309;51;626411930;6309;260;7198;7257;7.55;0.46;261.61;6.18;889;51;2476.00;59
6312;51;626411943;6312;257;7202;7263;7.49;0.46;261.59;6.18;890;51;2477.00;61
6316;51;626411955;6316;261;7203;7263;7.43;0.45;261.61;6.24;887;51;2478.00;60
6318;51;626411968;6318;264;7204;7264;7.38;0.45;261.60;6.24;886;51;2479.00;60
6318;51;626411979;6318;254;7204;7264;7.36;0.45;261.60;6.24;886;51;2480.00;60
6320;51;626411989;6320;256;7205;7264;7.28;0.44;261.61;6.31;885;51;2481.00;59
6323;51;626411999;6323;241;7205;7264;7.21;0.44;261.58;6.31;882;51;2482.00;59
6327;51;626412009;6327;231;7206;7264;7.12;0.43;261.66;6.37;879;51;2483.00;58
6331;51;626412019;6331;221;7216;7276;7.08;0.43;261.60;6.36;885;51;2484.00;60
6333;51;626412031;6333;219;7219;7276;7.06;0.43;261.60;6.38;886;51;2485.00;57
6336;51;626412042;6336;224;7220;7276;7.06;0.43;261.57;6.44;884;51;2486.00;56
6340;51;626412052;6340;229;7220;7276;7.10;0.43;261.54;6.44;880;51;2487.00;56
6343;51;626412062;6343;229;7220;7276;7.16;0.44;261.60;6.44;877;51;2488.00;56
6346;51;626412071;6346;232;7221;7276;7.15;0.43;261.56;6.48;875;51;2489.00;55
6348;51;626412083;6348;230;7224;7280;7.11;0.43;261.53;6.48;876;51;2490.00;56
6350;51;626412101;6350;228;7224;7280;7.08;0.43;261.50;6.48;874;51;2491.00;56
6351;51;626412111;6351;231;7228;7284;7.08;0.43;261.48;6.52;877;51;2492.00;56
6352;51;626412122;6352;235;7230;7285;7.11;0.43;261.44;6.52;878;51;2493.00;55
6355;51;626412132;6355;239;7230;7285;7.07;0.43;261.37;6.52;875;51;2494.00;55
6357;51;626412142;6357;236;7230;7285;7.11;0.43;261.32;6.52;873;51;2495.00;55
6362;51;626412152;6362;244;7239;7298;7.12;0.43;261.24;6.53;877;51;2496.00;59
6363;51;626412163;6363;237;7239;7298;7.16;0.43;261.22;6.53;876;51;2497.00;59
6368;51;626412173;6368;243;7240;7298;7.15;0.43;261.17;6.53;872;51;2498.00;58
6370;51;626412183;6370;228;7241;7299;7.16;0.43;261.30;6.52;871;51;2499.00;58
6371;51;626412195;6371;218;7241;7300;7.20;0.44;261.26;6.52;870;51;2500.00;59
6375;51;626412209;6375;219;7242;7300;7.20;0.43;261.22;6.54;867;51;2501.00;58
6375;51;626412221;6375;213;7244;7303;7.32;0.44;261.22;6.54;869;51;2502.00;59
6377;51;626412233;6377;205;7245;7303;7.38;0.45;261.20;6.54;868;51;2503.00;58
6378;51;626412244;6378;202;7245;7303;7.45;0.45;261.22;6.54;867;51;2504.00;58
6379;51;626412256;6379;197;7245;7303;7.54;0.45;261.23;6.54;866;51;2505.00;58
6380;51;626412269;6380;190;7249;7309;7.72;0.46;261.22;6.53;869;51;2506.00;60
6381;51;626412281;6381;188;7251;7309;7.71;0.46;261.21;6.55;870;51;2507.00;58
6381;51;626412299;6381;182;7252;7309;7.72;0.47;261.21;6.55;871;51;2508.00;57
6383;51;626412310;6383;182;7253;7309;7.71;0.46;261.24;6.56;870;51;2509.00;56
6384;51;626412322;6384;179;7258;7313;7.64;0.46;261.24;6.58;874;51;2510.00;55
6386;51;626412334;6386;182;7260;7314;7.68;0.46;261.23;6.59;874;51;2511.00;54
6387;51;626412347;6387;187;7262;7314;7.74;0.47;261.21;6.61;875;51;2512.00;52
6389;51;626412358;6389;188;7264;7315;7.76;0.47;261.18;6.61;875;51;2513.00;51
6389;51;626412370;6389;185;7264;7315;7.79;0.47;261.18;6.61;875;51;2514.00;51
6389;51;626412382;6389;190;7267;7315;7.80;0.47;261.18;6.64;878;51;2515.00;48
6389;51;626412394;6389;193;7267;7315;7.88;0.48;261.18;6.64;878;51;2516.00;48
6389;51;626412406;6389;189;7268;7315;7.95;0.48;261.18;6.65;879;51;2517.00;47
6389;51;626412418;6389;193;7271;7315;8.00;0.49;261.18;6.69;882;51;2518.00;44
6390;51;626412429;6390;194;7271;7315;8.01;0.49;261.17;6.69;881;51;2519.00;44
6392;51;626412443;6392;202;7324;7440;8.15;0.50;261.12;6.65;932;51;2520.00;116
6393;51;626412466;6393;195;7328;7441;8.08;0.50;261.19;6.67;935;51;2521.00;113
6394;51;626412479;6394;195;7339;7441;8.10;0.50;261.25;6.66;945;51;2522.00;102
6396;51;626412491;6396;202;7351;7441;8.11;0.50;261.20;6.67;955;51;2523.00;90
6398;51;626412503;6398;198;7359;7441;8.10;0.50;261.21;6.67;961;51;2524.00;82
6398;51;626412515;6398;205;7364;7441;8.09;0.50;261.21;6.68;966;51;2525.00;77
6399;51;626412526;6399;205;7370;7441;8.05;0.49;261.21;6.68;971;51;2526.00;71
6401;51;626412539;6401;213;7374;7441;8.01;0.49;261.31;6.69;973;51;2527.00;67
6405;51;626412551;6405;225;7379;7442;7.96;0.49;261.29;6.69;974;51;2528.00;63
6406;51;626412569;6406;225;7381;7443;7.92;0.49;261.31;6.70;975;51;2529.00;62
6409;51;626412581;6409;218;7385;7443;7.90;0.49;261.34;6.70;976;51;2530.00;58
6413;51;626412594;6413;225;7388;7447;7.83;0.48;261.32;6.70;975;51;2531.00;59
6416;51;626412608;6416;234;7392;7447;7.77;0.48;261.39;6.73;976;51;2532.00;55
6419;51;626412620;6419;234;7393;7447;7.74;0.47;261.32;6.73;974;51;2533.00;54
6423;51;626412633;6423;238;7394;7447;7.72;0.47;261.37;6.73;971;51;2534.00;53
6426;51;626412652;6426;239;7401;7453;7.69;0.47;261.52;6.74;975;51;2535.00;52
6428;51;626412671;6428;241;7402;7453;7.66;0.47;261.53;6.75;974;51;2536.00;51
6430;51;626412683;6430;251;7404;7455;7.63;0.47;261.56;6.75;974;51;2537.00;51
6435;51;626412700;6435;256;7407;7458;7.54;0.46;261.61;6.75;972;51;2538.00;51
6435;51;626412712;6435;259;7407;7458;7.47;0.46;261.61;6.75;972;51;2539.00;51
6438;51;626412724;6438;257;7409;7458;7.39;0.45;261.63;6.76;971;51;2540.00;49
6441;51;626412735;6441;263;7410;7459;7.32;0.45;261.61;6.76;969;51;2541.00;49
6443;51;626412747;6443;267;7411;7460;7.27;0.44;261.62;6.76;968;51;2542.00;49
6447;51;626412758;6447;262;7412;7460;7.18;0.44;261.60;6.76;965;51;2543.00;48
6452;51;626412770;6452;265;7422;7473;7.15;0.44;261.61;6.75;970;51;2544.00;51
6454;51;626412782;6454;275;7425;7473;7.10;0.43;261.63;6.76;971;51;2545.00;48
6458;51;626412793;6458;279;7426;7473;7.02;0.43;261.64;6.76;968;51;2546.00;47
6462;51;626412805;6462;283;7427;7474;6.95;0.43;261.65;6.76;965;51;2547.00;47
6466;51;626412816;6466;288;7429;7474;6.79;0.42;261.77;6.76;963;51;2548.00;45
6471;51;626412827;6471;290;7432;7478;6.74;0.41;261.79;6.76;961;51;2549.00;46
6474;51;626412840;6474;279;7436;7481;6.68;0.41;261.90;6.76;962;51;2550.00;45
6477;51;626412852;6477;277;7442;7485;6.64;0.41;261.99;6.76;965;51;2551.00;43
6481;51;626412864;6481;265;7442;7485;6.64;0.41;261.98;6.76;961;51;2552.00;43
6486;51;626412875;6486;256;7443;7485;6.64;0.41;262.08;6.77;957;51;2553.00;42
6489;51;626412887;6489;256;7443;7485;6.67;0.41;262.12;6.77;954;51;2554.00;42
6493;51;626412899;6493;253;7447;7485;6.68;0.41;262.23;6.77;954;51;2555.00;38
6495;51;626412910;6495;256;7458;7497;6.80;0.42;262.26;6.76;963;51;2556.00;39
6498;51;626412923;6498;253;7458;7497;6.85;0.42;262.35;6.76;960;51;2557.00;39
6500;51;626412942;6500;250;7458;7497;6.87;0.42;262.42;6.76;958;51;2558.00;39
6503;51;626412961;6503;244;7458;7497;6.94;0.43;262.49;6.76;955;51;2559.00;39
6507;51;626412979;6507;244;7458;7497;6.96;0.43;262.61;6.76;951;51;2560.00;39
6510;51;626412998;6510;237;7458;7497;7.02;0.43;262.69;6.76;948;51;2561.00;39
6514;51;626413016;6514;233;7458;7498;7.12;0.44;262.72;6.76;944;51;2562.00;40
6518;51;626413044;6518;231;7458;7498;7.17;0.44;262.81;6.76;940;51;2563.00;40
6520;51;626413058;6520;234;7462;7504;7.31;0.45;262.79;6.75;942;51;2564.00;42
6526;51;626413072;6526;228;7465;7506;7.41;0.46;262.89;6.75;939;51;2565.00;41
6528;51;626413086;6528;222;7465;7506;7.49;0.46;262.91;6.75;937;51;2566.00;41
6534;51;626413101;6534;224;7465;7506;7.54;0.47;262.91;6.75;931;51;2567.00;41
6538;51;626413114;6538;220;7468;7510;7.63;0.47;262.92;6.75;930;51;2568.00;42
6544;51;626413129;6544;227;7468;7510;7.67;0.47;262.88;6.75;924;51;2569.00;42
6545;51;626413142;6545;228;7468;7510;7.73;0.48;262.90;6.75;923;51;2570.00;42
6550;51;626413156;6550;229;7469;7511;7.80;0.48;262.87;6.75;919;51;2571.00;42
6554;51;626413170;6554;226;7472;7515;7.79;0.48;262.93;6.75;918;51;2572.00;43
6558;51;626413185;6558;224;7472;7515;7.83;0.48;262.92;6.75;914;51;2573.00;43
6566;51;626413199;6566;226;7474;7518;7.82;0.48;262.88;6.74;908;51;2574.00;44
6574;51;626413213;6574;221;7475;7518;7.86;0.48;262.97;6.74;901;51;2575.00;43
6576;51;626413226;6576;225;7475;7518;7.97;0.49;262.96;6.74;899;51;2576.00;43
6579;51;626413240;6579;224;7475;7518;8.03;0.49;263.03;6.74;896;51;2577.00;43
6582;51;626413254;6582;229;7478;7522;8.09;0.49;263.11;6.74;896;51;2578.00;44
6587;51;626413269;6587;229;7478;7522;8.09;0.49;263.20;6.74;891;51;2579.00;44
6594;51;626413284;6594;228;7479;7522;8.10;0.49;263.34;6.74;885;51;2580.00;43
6599;51;626413297;6599;228;7479;7522;8.08;0.49;263.36;6.74;880;51;2581.00;43
6602;51;626413311;6602;231;7479;7523;8.02;0.49;263.35;6.74;877;51;2582.00;44
6605;51;626413330;6605;228;7480;7524;8.03;0.49;263.34;6.74;875;51;2583.00;44
6611;51;626413344;6611;229;7480;7524;8.00;0.49;263.44;6.74;869;51;2584.00;44
6613;51;626413356;6613;234;7481;7525;8.03;0.49;263.51;6.74;868;51;2585.00;44
6615;51;626413369;6615;233;7481;7525;8.03;0.49;263.58;6.74;866;51;2586.00;44
6622;51;626413381;6622;231;7481;7525;7.99;0.49;263.59;6.74;859;51;2587.00;44
6624;51;626413396;6624;234;7481;7525;7.99;0.49;263.58;6.74;857;51;2588.00;44
6629;51;626413408;6629;240;7481;7525;7.95;0.49;263.58;6.74;852;51;2589.00;44
6631;51;626413421;6631;235;7481;7525;7.87;0.48;263.65;6.74;850;51;2590.00;44
6633;51;626413433;6633;239;7482;7525;7.79;0.48;263.69;6.80;849;51;2591.00;43
6638;51;626413446;6638;255;7543;7652;7.98;0.49;263.75;6.74;905;51;2592.00;109
6640;51;626413470;6640;252;7548;7653;7.91;0.49;263.77;6.74;908;51;2593.00;105
6647;51;626413483;6647;259;7559;7653;7.88;0.49;263.78;6.73;912;51;2594.00;94
6651;51;626413497;6651;262;7564;7653;7.77;0.48;263.87;6.73;913;51;2595.00;89
6652;51;626413509;6652;268;7567;7653;7.67;0.47;263.87;6.73;915;51;2596.00;86
6654;51;626413523;6654;257;7572;7653;7.62;0.47;263.89;6.73;918;51;2597.00;81
6657;51;626413536;6657;262;7575;7653;7.61;0.47;263.91;6.73;918;51;2598.00;78
6657;51;626413550;6657;262;7577;7653;7.63;0.47;263.91;6.73;920;51;2599.00;76
6660;51;626413563;6660;259;7584;7654;7.66;0.47;263.93;6.73;924;51;2600.00;70
6665;51;626413580;6665;253;7588;7655;7.64;0.47;263.94;6.73;923;51;2601.00;67
6666;51;626413594;6666;255;7591;7655;7.69;0.47;263.91;6.73;925;51;2602.00;64
6669;51;626413608;6669;254;7591;7656;7.63;0.47;264.08;6.73;922;51;2603.00;65
6672;51;626413621;6672;261;7594;7656;7.60;0.47;264.10;6.73;922;51;2604.00;62
6675;51;626413635;6675;265;7596;7656;7.56;0.46;264.14;6.79;921;51;2605.00;60
6679;51;626413648;6679;256;7598;7656;7.59;0.47;264.17;6.79;919;51;2606.00;58
6681;51;626413662;6681;248;7601;7660;7.64;0.47;264.20;6.79;920;51;2607.00;59
6686;51;626413675;6686;246;7602;7660;7.62;0.47;264.27;6.79;916;51;2608.00;58
6687;51;626413690;6687;239;7604;7660;7.72;0.47;264.32;6.79;917;51;2609.00;56
6689;51;626413704;6689;233;7607;7666;7.81;0.48;264.47;6.79;918;51;2610.00;59
6693;51;626413719;6693;235;7608;7666;7.85;0.48;264.47;6.79;915;51;2611.00;58
6693;51;626413733;6693;238;7609;7666;7.92;0.48;264.47;6.79;916;51;2612.00;57
6697;51;626413746;6697;242;7612;7670;7.90;0.48;264.55;6.79;915;51;2613.00;58
6698;51;626413766;6698;245;7614;7671;7.95;0.48;264.55;6.79;916;51;2614.00;57
6702;51;626413787;6702;240;7614;7671;7.93;0.48;264.52;6.79;912;51;2615.00;57
6704;51;626413800;6704;245;7618;7675;7.98;0.49;264.51;6.79;914;51;2616.00;57
6707;51;626413814;6707;241;7618;7675;8.00;0.49;264.48;6.79;911;51;2617.00;57
6709;51;626413828;6709;243;7619;7675;8.07;0.49;264.52;6.79;910;51;2618.00;56
6710;51;626413842;6710;242;7621;7676;8.19;0.50;264.52;6.85;911;51;2619.00;55
6713;51;626413856;6713;247;7622;7676;8.27;0.50;264.49;6.85;909;51;2620.00;54
6715;51;626413870;6715;245;7625;7682;8.31;0.50;264.50;6.84;910;51;2621.00;57
6715;51;626413884;6715;245;7626;7682;8.36;0.51;264.50;6.84;911;51;2622.00;56
6716;51;626413897;6716;245;7627;7683;8.40;0.51;264.47;6.84;911;51;2623.00;56
6718;51;626413910;6718;244;7627;7683;8.30;0.51;264.42;6.84;909;51;2624.00;56
6721;51;626413923;6721;245;7627;7683;8.21;0.50;264.38;6.84;906;51;2625.00;56
6726;51;626413937;6726;244;7627;7683;8.15;0.50;264.37;6.84;901;51;2626.00;56
6728;51;626413949;6728;245;7627;7683;8.11;0.49;264.35;6.84;899;51;2627.00;56
6728;51;626413962;6728;251;7637;7695;8.13;0.49;264.35;6.83;909;51;2628.00;58
6733;51;626413977;6733;247;7638;7695;8.08;0.49;264.28;6.83;905;51;2629.00;57
6736;51;626413989;6736;251;7638;7695;8.01;0.49;264.22;6.83;902;51;2630.00;57
6738;51;626414000;6738;252;7638;7695;7.96;0.48;264.23;6.83;900;51;2631.00;57
6738;51;626414012;6738;259;7638;7695;7.96;0.48;264.23;6.83;900;51;2632.00;57
6742;51;626414023;6742;266;7638;7695;7.90;0.48;264.32;6.83;896;51;2633.00;57
6743;51;626414034;6743;271;7641;7699;7.84;0.48;264.31;6.83;898;51;2634.00;58
6745;51;626414045;6745;274;7641;7699;7.72;0.47;264.29;6.83;896;51;2635.00;58
6746;51;626414056;6746;278;7644;7703;7.70;0.47;264.29;6.83;898;51;2636.00;59
6748;51;626414068;6748;285;7645;7704;7.61;0.46;264.27;6.83;897;51;2637.00;59
6750;51;626414080;6750;296;7646;7704;7.49;0.46;264.23;6.83;896;51;2638.00;58
6752;51;626414090;6752;302;7646;7704;7.40;0.45;264.21;6.83;894;51;2639.00;58
6753;51;626414103;6753;306;7666;7733;7.32;0.45;264.23;6.81;913;51;2640.00;67
6754;51;626414116;6754;300;7666;7733;7.25;0.44;264.22;6.81;912;51;2641.00;67
6756;51;626414127;6756;294;7669;7733;7.22;0.44;264.17;6.81;913;51;2642.00;64
6758;51;626414138;6758;302;7671;7734;7.14;0.43;264.20;6.81;913;51;2643.00;63
6762;51;626414149;6762;306;7672;7735;7.07;0.43;264.21;6.81;910;51;2644.00;63
6762;51;626414160;6762;311;7672;7735;6.98;0.42;264.21;6.81;910;51;2645.00;63
6764;51;626414170;6764;308;7675;7738;6.94;0.42;264.20;6.80;911;51;2646.00;63
6765;51;626414181;6765;309;7675;7738;6.85;0.42;264.22;6.80;910;51;2647.00;63
6766;51;626414192;6766;314;7675;7738;6.78;0.41;264.24;6.80;909;51;2648.00;63
6767;51;626414202;6767;318;7675;7738;6.69;0.41;264.25;6.80;908;51;2649.00;63
6769;51;626414212;6769;316;7679;7744;6.59;0.40;264.25;6.80;910;51;2650.00;65
6771;51;626414224;6771;305;7679;7744;6.53;0.40;264.25;6.80;908;51;2651.00;65
6772;51;626414234;6772;291;7680;7744;6.47;0.39;264.23;6.80;908;51;2652.00;64
6774;51;626414245;6774;274;7680;7744;6.47;0.39;264.28;6.80;906;51;2653.00;64
6775;51;626414257;6775;264;7685;7748;6.50;0.40;264.26;6.87;910;51;2654.00;63
6778;51;626414272;6778;251;7688;7750;6.54;0.40;264.32;6.88;910;51;2655.00;62
6783;51;626414283;6783;246;7688;7750;6.55;0.40;264.26;6.88;905;51;2656.00;62
6784;51;626414295;6784;240;7689;7751;6.68;0.41;264.26;6.88;905;51;2657.00;62
6785;51;626414305;6785;235;7689;7751;6.78;0.41;264.25;6.88;904;51;2658.00;62
6791;51;626414317;6791;228;7689;7751;6.83;0.41;264.23;6.88;898;51;2659.00;62
6791;51;626414328;6791;217;7689;7751;6.97;0.42;264.23;6.88;898;51;2660.00;62
6792;51;626414339;6792;210;7689;7751;7.08;0.43;264.20;6.88;897;51;2661.00;62
6794;51;626414350;6794;206;7689;7751;7.18;0.44;264.21;6.88;895;51;2662.00;62
6795;51;626414360;6795;203;7689;7751;7.27;0.44;264.20;6.88;894;51;2663.00;62
6796;51;626414371;6796;200;7728;7821;7.48;0.46;264.17;6.85;932;51;2664.00;93
6799;51;626414389;6799;190;7728;7822;7.54;0.46;264.14;6.85;929;51;2665.00;94
6801;51;626414400;6801;191;7735;7822;7.59;0.46;264.09;6.84;934;51;2666.00;87
6802;51;626414417;6802;193;7743;7822;7.61;0.46;264.08;6.84;941;51;2667.00;79
6804;51;626414428;6804;194;7747;7822;7.69;0.47;264.03;6.84;943;51;2668.00;75
6806;51;626414439;6806;190;7751;7822;7.76;0.47;264.00;6.84;945;51;2669.00;71
6806;51;626414453;6806;191;7752;7822;7.84;0.48;264.00;6.84;946;51;2670.00;70
6807;51;626414464;6807;194;7753;7822;7.95;0.48;263.98;6.84;946;51;2671.00;69
6809;51;626414477;6809;194;7755;7823;8.06;0.49;264.02;6.84;946;51;2672.00;68
6812;51;626414489;6812;194;7757;7824;8.17;0.50;264.03;6.84;945;51;2673.00;67
6814;51;626414501;6814;194;7757;7824;8.18;0.50;264.13;6.84;943;51;2674.00;67
6819;51;626414513;6819;197;7760;7828;8.06;0.49;264.08;6.83;941;51;2675.00;68
6823;51;626414526;6823;190;7760;7828;8.04;0.49;263.97;6.83;937;51;2676.00;68
6826;51;626414557;6826;187;7761;7828;8.02;0.49;264.06;6.85;935;51;2677.00;67
6831;51;626414569;6831;199;7761;7828;7.97;0.48;264.06;6.85;930;51;2678.00;67
6834;51;626414581;6834;197;7765;7834;8.02;0.49;264.10;6.85;931;51;2679.00;69
6837;51;626414594;6837;202;7768;7834;8.00;0.49;264.17;6.87;931;51;2680.00;66
6838;51;626414606;6838;199;7768;7834;8.02;0.49;264.19;6.87;930;51;2681.00;66
6840;51;626414619;6840;200;7772;7837;8.04;0.49;264.21;6.88;932;51;2682.00;65
6843;51;626414631;6843;214;7773;7837;8.06;0.49;264.24;6.89;930;51;2683.00;64
6845;51;626414643;6845;212;7773;7837;8.06;0.49;264.26;6.89;928;51;2684.00;64
6847;51;626414655;6847;216;7775;7838;8.00;0.49;264.29;6.92;928;51;2685.00;63
6850;51;626414667;6850;212;7776;7839;8.01;0.49;264.30;6.92;926;51;2686.00;63
6851;51;626414680;6851;214;7777;7839;8.00;0.49;264.31;6.93;926;51;2687.00;62
6854;51;626414692;6854;227;7788;7852;8.03;0.49;264.29;6.92;934;51;2688.00;64
6857;51;626414704;6857;226;7790;7852;8.04;0.49;264.25;6.94;933;51;2689.00;62
6859;51;626414717;6859;226;7791;7852;8.02;0.49;264.26;6.95;932;51;2690.00;61
6864;51;626414728;6864;232;7793;7853;7.97;0.48;264.38;6.95;929;51;2691.00;60
6865;51;626414740;6865;234;7794;7853;7.94;0.48;264.36;6.97;929;51;2692.00;59
6868;51;626414751;6868;238;7798;7857;7.89;0.48;264.38;6.97;930;51;2693.00;59
6871;51;626414764;6871;240;7800;7857;7.84;0.48;264.40;6.98;929;51;2694.00;57
6874;51;626414775;6874;246;7804;7861;7.79;0.47;264.39;6.98;930;51;2695.00;57
6877;51;626414787;6877;252;7805;7861;7.72;0.47;264.46;6.99;928;51;2696.00;56
6879;51;626414798;6879;254;7806;7861;7.68;0.47;264.57;6.99;927;51;2697.00;55
6880;51;626414810;6880;250;7807;7861;7.60;0.46;264.56;7.01;927;51;2698.00;54
6884;51;626414821;6884;244;7808;7861;7.51;0.46;264.62;7.01;924;51;2699.00;53
6886;51;626414835;6886;248;7830;7910;7.60;0.46;264.72;6.99;944;51;2700.00;80
6886;51;626414855;6886;242;7833;7910;7.56;0.46;264.72;6.98;947;51;2701.00;77
6889;51;626414866;6889;238;7837;7910;7.52;0.46;264.84;7.00;948;51;2702.00;73
6891;51;626414878;6891;239;7839;7910;7.51;0.46;264.90;7.00;948;51;2703.00;71
6894;51;626414889;6894;239;7843;7910;7.47;0.46;264.89;7.01;949;51;2704.00;67
6896;51;626414901;6896;236;7843;7910;7.51;0.46;264.94;7.01;947;51;2705.00;67
6898;51;626414912;6898;232;7844;7911;7.53;0.46;265.00;7.01;946;51;2706.00;67
6902;51;626414923;6902;242;7848;7911;7.53;0.46;264.99;7.02;946;51;2707.00;63
6903;51;626414940;6903;244;7852;7917;7.59;0.46;265.03;7.02;949;51;2708.00;65
6905;51;626414960;6905;245;7854;7918;7.62;0.47;265.09;7.03;949;51;2709.00;64
6906;51;626414981;6906;249;7854;7918;7.55;0.46;265.07;7.03;948;51;2710.00;64
6913;51;626414998;6913;251;7856;7918;7.43;0.45;265.12;7.04;943;51;2711.00;62
6917;51;626415016;6917;254;7858;7922;7.38;0.45;265.14;7.04;941;51;2712.00;64
6920;51;626415033;6920;263;7863;7922;7.31;0.45;265.16;7.05;943;51;2713.00;59
6928;51;626415048;6928;264;7864;7922;7.25;0.44;265.32;7.05;936;51;2714.00;58
6931;51;626415062;6931;266;7865;7923;7.22;0.44;265.39;7.05;934;51;2715.00;58
6936;51;626415074;6936;273;7870;7927;7.14;0.43;265.45;7.06;934;51;2716.00;57
6940;51;626415087;6940;272;7870;7927;7.11;0.43;265.58;7.06;930;51;2717.00;57
6944;51;626415105;6944;272;7873;7930;7.07;0.43;265.71;7.06;929;51;2718.00;57
6948;51;626415117;6948;274;7876;7930;6.97;0.43;265.77;7.07;928;51;2719.00;54
6952;51;626415129;6952;262;7876;7930;6.89;0.42;265.81;7.07;924;51;2720.00;54
6956;51;626415141;6956;251;7878;7930;6.85;0.42;265.89;7.08;922;51;2721.00;52
6961;51;626415159;6961;244;7880;7934;6.85;0.42;265.96;7.08;919;51;2722.00;54
6966;51;626415172;6966;238;7880;7934;6.84;0.42;266.11;7.08;914;51;2723.00;54
6968;51;626415184;6968;239;7883;7934;6.88;0.42;266.18;7.08;915;51;2724.00;51
6971;51;626415195;6971;242;7884;7934;6.90;0.42;266.27;7.08;913;51;2725.00;50
6974;51;626415206;6974;249;7884;7935;6.92;0.42;266.32;7.08;910;51;2726.00;51
6977;51;626415218;6977;242;7887;7936;6.94;0.42;266.38;7.08;910;51;2727.00;49
6981;51;626415230;6981;239;7887;7936;6.89;0.42;266.39;7.08;906;51;2728.00;49
6984;51;626415242;6984;239;7890;7937;6.91;0.42;266.47;7.09;906;51;2729.00;47
6988;51;626415256;6988;240;7891;7937;6.98;0.43;266.51;7.09;903;51;2730.00;46
6990;51;626415270;6990;236;7891;7937;7.01;0.43;266.52;7.09;901;51;2731.00;46
6994;51;626415282;6994;238;7891;7937;7.02;0.43;266.70;7.09;897;51;2732.00;46
6995;51;626415294;6995;238;7893;7937;7.08;0.43;266.71;7.09;898;51;2733.00;44
6998;51;626415305;6998;241;7893;7937;7.10;0.44;266.77;7.09;895;51;2734.00;44
7003;51;626415317;7003;244;7895;7937;7.12;0.44;266.78;7.10;892;51;2735.00;42
7007;51;626415328;7007;258;7965;8064;7.42;0.46;266.79;7.04;958;51;2736.00;99
7013;51;626415351;7013;261;7969;8065;7.48;0.46;266.81;7.04;956;51;2737.00;96
7016;51;626415363;7016;264;7974;8065;7.59;0.47;266.84;7.03;958;51;2738.00;91
7024;51;626415376;7024;257;7977;8065;7.55;0.47;266.85;7.03;953;51;2739.00;88
7029;51;626415389;7029;254;7980;8065;7.60;0.47;266.92;7.03;951;51;2740.00;85
7034;51;626415401;7034;260;7983;8065;7.61;0.47;267.02;7.03;949;51;2741.00;82
7041;51;626415413;7041;262;7986;8065;7.52;0.46;267.12;7.03;945;51;2742.00;79
7045;51;626415425;7045;260;7988;8065;7.46;0.46;267.13;7.03;943;51;2743.00;77
7048;51;626415438;7048;256;7994;8066;7.43;0.46;267.16;7.03;946;51;2744.00;72
7053;51;626415451;7053;256;8000;8068;7.43;0.46;267.11;7.03;947;51;2745.00;68
7059;51;626415464;7059;255;8003;8068;7.40;0.46;267.29;7.03;944;51;2746.00;65
7062;51;626415477;7062;255;8006;8069;7.39;0.46;267.35;7.03;944;51;2747.00;63
7066;51;626415490;7066;253;8010;8069;7.40;0.46;267.45;7.11;944;51;2748.00;59
7070;51;626415503;7070;259;8012;8069;7.44;0.46;267.41;7.11;942;51;2749.00;57
7074;51;626415517;7074;259;8013;8069;7.42;0.46;267.50;7.11;939;51;2750.00;56
7077;51;626415529;7077;254;8017;8073;7.42;0.46;267.52;7.11;940;51;2751.00;56
7079;51;626415542;7079;255;8019;8073;7.43;0.46;267.60;7.11;940;51;2752.00;54
7083;51;626415560;7083;265;8021;8073;7.44;0.46;267.75;7.11;938;51;2753.00;52
7090;51;626415578;7090;282;8024;8076;7.41;0.46;267.70;7.11;934;51;2754.00;52
7099;51;626415591;7099;282;8024;8076;7.31;0.45;267.67;7.11;925;51;2755.00;52
7103;52;626415604;7103;293;8026;8076;7.28;0.45;267.70;7.11;923;52;2756.00;50
7107;52;626415633;7107;297;8029;8080;7.29;0.45;267.78;7.11;922;52;2757.00;51
7112;52;626415645;7112;308;8031;8081;7.26;0.45;267.83;7.11;919;52;2758.00;50
7118;52;626415658;7118;310;8031;8081;7.22;0.44;267.73;7.11;913;52;2759.00;50
7122;52;626415673;7122;312;8035;8086;7.17;0.44;267.72;7.11;913;52;2760.00;51
7126;52;626415685;7126;318;8035;8086;7.14;0.44;267.71;7.11;909;52;2761.00;51
7131;52;626415699;7131;329;8035;8086;6.99;0.43;267.80;7.11;904;52;2762.00;51
7135;52;626415712;7135;335;8036;8087;6.93;0.42;267.86;7.11;901;52;2763.00;51
7137;52;626415724;7137;344;8036;8087;6.86;0.42;267.91;7.11;899;52;2764.00;51
7139;52;626415737;7139;352;8040;8093;6.76;0.41;267.99;7.10;901;52;2765.00;53
7140;52;626415750;7140;362;8040;8093;6.72;0.41;267.98;7.10;900;52;2766.00;53
7143;52;626415763;7143;357;8041;8094;6.65;0.41;267.99;7.10;898;52;2767.00;53
7146;52;626415775;7146;349;8042;8094;6.59;0.40;268.04;7.18;896;52;2768.00;52
7148;52;626415788;7148;342;8042;8094;6.63;0.41;268.06;7.18;894;53;2769.00;52
7150;52;626415808;7150;346;8042;8094;6.67;0.41;268.08;7.18;892;53;2770.00;52
7154;52;626415822;7154;342;8042;8094;6.75;0.41;268.09;7.18;888;53;2771.00;52
7157;52;626415834;7157;338;8052;8106;6.94;0.43;268.13;7.17;895;53;2772.00;54
7161;52;626415853;7161;340;8053;8106;7.08;0.43;268.11;7.17;892;53;2773.00;53
7164;52;626415866;7164;339;8053;8106;7.11;0.43;268.15;7.17;889;53;2774.00;53
7167;52;626415878;7167;334;8053;8106;7.16;0.44;268.09;7.17;886;53;2775.00;53
7167;52;626415891;7167;318;8053;8106;7.25;0.44;268.09;7.17;886;53;2776.00;53
7173;52;626415904;7173;304;8053;8106;7.31;0.45;268.21;7.17;880;53;2777.00;53
7177;52;626415918;7177;286;8056;8110;7.36;0.45;268.20;7.16;879;53;2778.00;54
7179;52;626415933;7179;277;8056;8110;7.45;0.45;268.18;7.16;877;53;2779.00;54
7183;52;626415945;7183;275;8059;8114;7.53;0.46;268.13;7.16;876;53;2780.00;55
7185;52;626415960;7185;272;8061;8115;7.54;0.46;268.13;7.16;876;53;2781.00;54
7188;52;626415976;7188;274;8061;8115;7.64;0.46;268.12;7.16;873;53;2782.00;54
7193;52;626415988;7193;270;8062;8115;7.67;0.47;268.08;7.24;869;53;2783.00;53
7194;52;626416006;7194;274;8073;8128;7.81;0.47;268.21;7.23;879;53;2784.00;55
7195;52;626416021;7195;274;8073;8128;7.88;0.48;268.22;7.23;878;53;2785.00;55
7198;52;626416034;7198;277;8073;8128;7.90;0.48;268.24;7.23;875;53;2786.00;55
7199;52;626416051;7199;279;8074;8129;7.89;0.48;268.24;7.23;875;53;2787.00;55
7201;52;626416064;7201;279;8075;8130;7.91;0.48;268.18;7.30;874;53;2788.00;55
7203;52;626416076;7203;286;8075;8130;7.93;0.48;268.16;7.30;872;53;2789.00;55
7204;52;626416089;7204;283;8078;8136;7.94;0.48;268.13;7.30;874;53;2790.00;58
7206;52;626416102;7206;281;8079;8136;7.91;0.48;268.08;7.30;873;53;2791.00;57
7207;52;626416113;7207;275;8079;8136;7.84;0.48;268.07;7.30;872;53;2792.00;57
7208;52;626416130;7208;276;8080;8136;7.78;0.47;268.07;7.30;872;53;2793.00;56
7209;52;626416141;7209;279;8083;8142;7.76;0.47;268.06;7.30;874;53;2794.00;59
7212;52;626416158;7212;278;8085;8142;7.71;0.47;268.04;7.37;873;53;2795.00;57
7213;52;626416170;7213;280;8085;8142;7.66;0.47;268.02;7.37;872;53;2796.00;57
7213;52;626416181;7213;283;8086;8142;7.61;0.46;268.02;7.37;873;53;2797.00;56
7215;52;626416192;7215;290;8089;8146;7.55;0.46;267.96;7.37;874;53;2798.00;57
7217;53;626416209;7217;291;8091;8147;7.56;0.46;267.95;7.37;874;54;2799.00;56
7220;53;626416228;7220;296;8091;8147;7.52;0.46;268.00;7.37;871;54;2800.00;56
7220;53;626416242;7220;296;8092;8148;7.46;0.45;268.00;7.37;872;54;2801.00;56
7222;53;626416254;7222;299;8092;8148;7.33;0.45;267.96;7.37;870;54;2802.00;56
7223;53;626416264;7223;293;8092;8148;7.24;0.44;267.95;7.37;869;54;2803.00;56
7224;53;626416276;7224;289;8092;8148;7.18;0.44;267.96;7.37;868;54;2804.00;56
7225;53;626416286;7225;277;8092;8148;7.15;0.44;267.94;7.37;867;54;2805.00;56
7227;53;626416297;7227;277;8092;8148;7.14;0.43;267.93;7.37;865;54;2806.00;56
7228;53;626416313;7228;274;8092;8148;7.13;0.43;267.93;7.37;864;54;2807.00;56
7229;53;626416324;7229;281;8133;8218;7.11;0.43;267.93;7.33;904;54;2808.00;85
7231;53;626416341;7231;268;8135;8219;7.17;0.44;267.91;7.33;904;54;2809.00;84
7233;53;626416353;7233;257;8140;8219;7.25;0.44;267.94;7.33;907;54;2810.00;79
7234;53;626416364;7234;249;8142;8219;7.31;0.45;267.94;7.33;908;54;2811.00;77
7234;53;626416376;7234;247;8146;8219;7.43;0.45;267.94;7.32;912;54;2812.00;73
7236;53;626416387;7236;240;8148;8219;7.52;0.46;267.94;7.32;912;54;2813.00;71
7238;53;626416399;7238;236;8150;8219;7.67;0.47;267.93;7.32;912;54;2814.00;69
7240;53;626416416;7240;233;8153;8219;7.77;0.47;267.94;7.32;913;54;2815.00;66
7242;53;626416427;7242;231;8158;8220;7.88;0.48;267.92;7.32;916;54;2816.00;62
7246;53;626416439;7246;234;8160;8221;7.88;0.48;267.87;7.40;914;54;2817.00;61
7248;53;626416450;7248;227;8161;8221;7.88;0.48;267.85;7.40;913;54;2818.00;60
7248;53;626416461;7248;217;8165;8225;7.85;0.48;267.85;7.48;917;54;2819.00;60
7248;53;626416475;7248;212;8165;8225;7.86;0.48;267.85;7.48;917;54;2820.00;60
7249;53;626416486;7249;210;8165;8225;7.81;0.48;267.85;7.48;916;54;2821.00;60
7249;53;626416496;7249;202;8165;8225;7.82;0.48;267.85;7.48;916;54;2822.00;60
7250;53;626416507;7250;197;8169;8231;7.74;0.47;267.86;7.56;919;54;2823.00;62
7255;53;626416519;7255;201;8170;8231;7.66;0.47;267.84;7.56;915;54;2824.00;61
7260;53;626416530;7260;199;8173;8231;7.66;0.47;267.84;7.66;913;54;2825.00;58
7264;53;626416543;7264;195;8175;8234;7.69;0.47;267.90;7.66;911;54;2826.00;59
7267;53;626416555;7267;194;8175;8234;7.71;0.47;267.84;7.66;908;54;2827.00;59
7270;53;626416566;7270;196;8177;8234;7.76;0.47;267.80;7.74;907;54;2828.00;57
7274;53;626416577;7274;189;8178;8235;7.78;0.47;267.72;7.81;904;54;2829.00;57
7277;53;626416589;7277;180;8179;8236;7.81;0.47;267.73;7.81;902;54;2830.00;57
7278;53;626416600;7278;184;8180;8236;7.85;0.48;267.75;7.87;902;54;2831.00;56
7282;53;626416611;7282;179;8190;8249;7.93;0.48;267.69;7.86;908;54;2832.00;59
7284;53;626416623;7284;180;8190;8249;8.01;0.49;267.69;7.86;906;54;2833.00;59
7285;53;626416635;7285;176;8191;8249;8.09;0.49;267.66;7.93;906;54;2834.00;58
7289;53;626416646;7289;182;8193;8251;8.13;0.49;267.63;7.92;904;54;2835.00;58
7291;53;626416658;7291;173;8194;8251;8.21;0.50;267.69;7.98;903;54;2836.00;57
7295;53;626416670;7295;178;8197;8255;8.27;0.50;267.71;7.98;902;54;2837.00;58
7297;53;626416682;7297;180;8197;8255;8.31;0.50;267.72;7.98;900;54;2838.00;58
7299;53;626416693;7299;179;8201;8259;8.33;0.51;267.80;7.98;902;54;2839.00;58
7302;53;626416705;7302;181;8204;8259;8.33;0.50;267.84;8.04;902;54;2840.00;55
7304;53;626416717;7304;180;8204;8259;8.32;0.50;267.82;8.04;900;54;2841.00;55
7305;53;626416728;7305;182;8205;8259;8.28;0.50;267.83;8.09;900;54;2842.00;54
7308;53;626416739;7308;181;8205;8259;8.22;0.50;267.82;8.09;897;54;2843.00;54
7311;53;626416751;7311;186;8215;8271;8.26;0.50;267.96;8.08;904;54;2844.00;56
7314;53;626416763;7314;186;8216;8271;8.23;0.50;267.95;8.08;902;54;2845.00;55
7318;53;626416775;7318;185;8216;8271;8.24;0.50;267.97;8.08;898;54;2846.00;55
7320;53;626416786;7320;184;8216;8271;8.29;0.50;267.98;8.08;896;54;2847.00;55
7322;53;626416798;7322;187;8216;8271;8.35;0.51;268.01;8.08;894;54;2848.00;55
7324;53;626416810;7324;183;8216;8271;8.39;0.51;268.06;8.08;892;54;2849.00;55
7325;53;626416824;7325;186;8220;8274;8.43;0.51;268.09;8.11;895;54;2850.00;54
7329;53;626416836;7329;184;8220;8274;8.42;0.51;268.17;8.11;891;54;2851.00;54
7332;53;626416848;7332;192;8226;8280;8.46;0.51;268.27;8.13;894;54;2852.00;54
7333;53;626416861;7333;193;8228;8281;8.53;0.52;268.29;8.13;895;54;2853.00;53
7336;53;626416873;7336;192;8228;8281;8.52;0.52;268.28;8.13;892;54;2854.00;53
7340;53;626416884;7340;196;8228;8281;8.47;0.52;268.39;8.13;888;54;2855.00;53
7342;53;626416897;7342;192;8234;8285;8.45;0.51;268.35;8.16;892;54;2856.00;51
7343;53;626416909;7343;196;8235;8285;8.42;0.51;268.39;8.17;892;54;2857.00;50
7344;53;626416921;7344;199;8236;8285;8.40;0.51;268.41;8.18;892;54;2858.00;49
7345;53;626416937;7345;207;8237;8286;8.40;0.51;268.44;8.18;892;54;2859.00;49
7348;53;626416957;7348;211;8242;8290;8.33;0.51;268.41;8.19;894;54;2860.00;48
7351;53;626416976;7351;207;8244;8290;8.33;0.51;268.50;8.21;893;54;2861.00;46
7354;53;626416995;7354;203;8247;8293;8.32;0.51;268.57;8.22;893;54;2862.00;46
7355;53;626417014;7355;208;8247;8293;8.34;0.51;268.67;8.22;892;54;2863.00;46
7360;53;626417032;7360;211;8250;8295;8.29;0.50;268.76;8.22;890;54;2864.00;45
7362;53;626417048;7362;214;8252;8295;8.22;0.50;268.76;8.23;890;54;2865.00;43
7365;53;626417061;7365;211;8255;8299;8.16;0.50;268.78;8.23;890;54;2866.00;44
7368;53;626417074;7368;212;8257;8299;8.08;0.49;268.87;8.24;889;54;2867.00;42
7370;53;626417087;7370;219;8259;8299;7.96;0.49;268.97;8.24;889;54;2868.00;40
7371;53;626417099;7371;221;8260;8299;7.85;0.48;268.99;8.25;889;54;2869.00;39
7374;53;626417112;7374;223;8260;8300;7.74;0.47;269.01;8.25;886;54;2870.00;40
7378;53;626417123;7378;219;8262;8301;7.68;0.47;269.01;8.26;884;54;2871.00;39
7381;53;626417135;7381;218;8262;8301;7.65;0.47;269.02;8.26;881;54;2872.00;39
7384;53;626417147;7384;224;8266;8302;7.58;0.46;269.00;8.28;882;54;2873.00;36
7387;53;626417159;7387;225;8266;8302;7.56;0.46;269.03;8.28;879;54;2874.00;36
7388;53;626417171;7388;232;8266;8302;7.64;0.46;269.04;8.28;878;54;2875.00;36
7391;53;626417182;7391;233;8267;8302;7.62;0.46;269.07;8.28;876;54;2876.00;35
7393;53;626417193;7393;228;8267;8302;7.64;0.46;269.12;8.28;874;54;2877.00;35
7395;53;626417204;7395;229;8267;8302;7.70;0.47;269.15;8.28;872;54;2878.00;35
7398;53;626417215;7398;233;8270;8302;7.76;0.47;269.19;8.30;872;54;2879.00;32
7401;53;626417228;7401;272;8368;8532;7.79;0.49;269.25;8.20;967;54;2880.00;164
7408;53;626417261;7408;268;8375;8533;7.73;0.48;269.37;8.20;967;54;2881.00;158
7412;53;626417274;7412;255;8383;8533;7.73;0.48;269.36;8.19;971;54;2882.00;150
7415;53;626417285;7415;250;8388;8533;7.70;0.48;269.37;8.19;973;54;2883.00;145
7422;53;626417297;7422;253;8398;8533;7.63;0.47;269.42;8.19;976;54;2884.00;135
7426;53;626417309;7426;250;8400;8533;7.55;0.47;269.54;8.19;974;54;2885.00;133
7429;53;626417321;7429;253;8408;8533;7.54;0.47;269.59;8.19;979;54;2886.00;125
7436;53;626417334;7436;256;8413;8533;7.49;0.47;269.71;8.19;977;54;2887.00;120
7440;53;626417346;7440;269;8419;8534;7.45;0.46;269.65;8.19;979;54;2888.00;115
7446;53;626417357;7446;271;8426;8535;7.37;0.46;269.76;8.19;980;54;2889.00;109
7449;53;626417370;7449;271;8429;8535;7.34;0.45;269.75;8.19;980;54;2890.00;106
7453;53;626417387;7453;277;8436;8536;7.25;0.45;269.88;8.19;983;54;2891.00;100
7456;53;626417400;7456;274;8439;8536;7.12;0.44;269.94;8.19;983;54;2892.00;97
7462;53;626417412;7462;287;8445;8536;7.03;0.43;270.03;8.20;983;54;2893.00;91
7466;53;626417424;7466;287;8450;8536;6.98;0.43;270.18;8.20;984;54;2894.00;86
7469;53;626417436;7469;297;8457;8540;6.84;0.42;270.24;8.20;988;54;2895.00;83
7472;53;626417449;7472;304;8459;8540;6.72;0.42;270.32;8.20;987;54;2896.00;81
7475;53;626417462;7475;308;8459;8540;6.71;0.41;270.44;8.20;984;54;2897.00;81
7477;53;626417476;7477;307;8464;8543;6.71;0.42;270.47;8.21;987;54;2898.00;79
7480;53;626417495;7480;306;8466;8543;6.72;0.42;270.58;8.21;986;54;2899.00;77
7486;53;626417509;7486;307;8468;8543;6.72;0.42;270.59;8.21;982;54;2900.00;75
7488;53;626417525;7488;301;8472;8547;6.78;0.42;270.63;8.22;984;54;2901.00;75
7493;53;626417538;7493;294;8473;8548;6.78;0.42;270.76;8.21;980;54;2902.00;75
7495;53;626417551;7495;299;8477;8548;6.78;0.42;270.79;8.22;982;54;2903.00;71
7502;53;626417564;7502;301;8479;8552;6.78;0.42;270.83;8.22;977;54;2904.00;73
7507;53;626417578;7507;299;8483;8552;6.80;0.42;270.86;8.22;976;54;2905.00;69
7512;53;626417591;7512;297;8484;8552;6.85;0.42;270.88;8.22;972;54;2906.00;68
7514;53;626417609;7514;308;8488;8553;6.91;0.42;270.86;8.23;974;54;2907.00;65
7519;53;626417622;7519;314;8489;8553;6.96;0.43;270.82;8.23;970;54;2908.00;64
7524;53;626417634;7524;310;8495;8559;6.95;0.43;270.87;8.24;971;54;2909.00;64
7525;53;626417650;7525;311;8495;8559;7.02;0.43;270.86;8.24;970;54;2910.00;64
7532;53;626417663;7532;301;8498;8560;7.00;0.43;270.99;8.24;966;54;2911.00;62
7536;53;626417677;7536;308;8501;8560;6.95;0.43;271.06;8.25;965;54;2912.00;59
7540;53;626417691;7540;304;8502;8560;6.87;0.42;271.10;8.25;962;54;2913.00;58
7541;53;626417703;7541;307;8503;8560;6.81;0.42;271.11;8.25;962;54;2914.00;57
7546;53;626417715;7546;314;8504;8560;6.63;0.41;271.11;8.25;958;54;2915.00;56
7548;53;626417734;7548;317;8515;8572;6.61;0.41;271.15;8.24;967;54;2916.00;57
7551;53;626417747;7551;324;8517;8572;6.55;0.40;271.17;8.25;966;54;2917.00;55
7556;53;626417759;7556;333;8518;8572;6.47;0.40;271.18;8.31;962;54;2918.00;54
7558;53;626417772;7558;335;8519;8572;6.47;0.40;271.22;8.31;961;54;2919.00;53
7560;53;626417785;7560;348;8519;8572;6.51;0.40;271.28;8.31;959;54;2920.00;53
7560;53;626417797;7560;355;8520;8572;6.49;0.40;271.28;8.31;960;54;2921.00;52
7563;53;626417809;7563;362;8523;8576;6.47;0.40;271.27;8.31;960;54;2922.00;53
7567;53;626417822;7567;364;8525;8576;6.34;0.39;271.29;8.32;958;54;2923.00;51
7570;53;626417842;7570;364;8528;8580;6.34;0.39;271.26;8.31;958;54;2924.00;52
7571;53;626417855;7571;375;8530;8582;6.36;0.39;271.24;8.31;959;54;2925.00;52
7574;53;626417873;7574;377;8531;8582;6.33;0.39;271.24;8.31;957;54;2926.00;51
7575;53;626417886;7575;382;8532;8582;6.36;0.39;271.24;8.37;957;54;2927.00;50
7577;53;626417898;7577;387;8542;8595;6.45;0.40;271.24;8.36;965;54;2928.00;53
7581;53;626417911;7581;388;8542;8595;6.42;0.40;271.20;8.36;961;54;2929.00;53
7581;53;626417925;7581;399;8542;8595;6.42;0.40;271.20;8.36;961;54;2930.00;53
7584;53;626417942;7584;406;8543;8596;6.41;0.39;271.18;8.36;959;54;2931.00;53
7585;53;626417955;7585;424;8543;8597;6.41;0.39;271.17;8.36;958;54;2932.00;54
7590;53;626417967;7590;434;8543;8597;6.25;0.38;271.08;8.36;953;54;2933.00;54
7593;53;626417980;7593;434;8545;8600;6.21;0.38;271.04;8.36;952;54;2934.00;55
7597;53;626417992;7597;431;8546;8600;6.15;0.38;270.97;8.36;949;54;2935.00;54
7600;53;626418004;7600;436;8546;8600;6.09;0.37;270.89;8.36;946;54;2936.00;54
7604;53;626418015;7604;429;8546;8600;6.02;0.37;270.85;8.36;942;54;2937.00;54
7608;53;626418027;7608;430;8551;8606;6.05;0.37;270.82;8.41;943;54;2938.00;55
7611;53;626418039;7611;425;8551;8606;6.03;0.37;270.81;8.41;940;54;2939.00;55
7614;53;626418052;7614;420;8552;8606;6.09;0.37;270.79;8.41;938;54;2940.00;54
7615;53;626418064;7615;411;8552;8606;6.11;0.37;270.77;8.41;937;54;2941.00;54
7616;53;626418075;7616;407;8556;8610;6.20;0.38;270.76;8.46;940;54;2942.00;54
7619;53;626418087;7619;407;8557;8611;6.23;0.38;270.72;8.46;938;54;2943.00;54
7619;53;626418099;7619;412;8557;8611;6.26;0.38;270.72;8.46;938;54;2944.00;54
7621;53;626418110;7621;408;8558;8612;6.33;0.39;270.67;8.46;937;54;2945.00;54
7624;53;626418121;7624;396;8558;8612;6.40;0.39;270.59;8.46;934;54;2946.00;54
7628;53;626418140;7628;383;8558;8612;6.44;0.39;270.67;8.46;930;54;2947.00;54
7629;53;626418153;7629;370;8558;8612;6.52;0.40;270.64;8.46;929;54;2948.00;54
7632;53;626418166;7632;355;8558;8612;6.58;0.40;270.59;8.46;926;54;2949.00;54
7633;53;626418180;7633;348;8558;8612;6.66;0.40;270.60;8.46;925;54;2950.00;54
7634;53;626418198;7634;348;8559;8612;6.77;0.41;270.59;8.51;925;54;2951.00;53
7634;53;626418210;7634;350;8593;8682;7.03;0.43;270.59;8.48;959;54;2952.00;89
7634;53;626418232;7634;347;8594;8683;7.11;0.43;270.59;8.48;960;54;2953.00;89
7635;53;626418244;7635;339;8603;8683;7.26;0.44;270.58;8.47;968;54;2954.00;80
7636;53;626418257;7636;328;8605;8683;7.31;0.44;270.58;8.52;969;54;2955.00;78
7638;53;626418270;7638;321;8609;8683;7.37;0.45;270.57;8.52;971;54;2956.00;74
7638;53;626418282;7638;315;8611;8683;7.43;0.45;270.57;8.52;973;54;2957.00;72
7638;53;626418295;7638;310;8613;8683;7.50;0.46;270.57;8.52;975;54;2958.00;70
7638;53;626418307;7638;304;8616;8683;7.54;0.46;270.57;8.52;978;54;2959.00;67
7640;53;626418320;7640;297;8617;8684;7.57;0.46;270.57;8.52;977;54;2960.00;67
7641;53;626418334;7641;285;8621;8685;7.62;0.46;270.58;8.51;980;54;2961.00;64
7642;53;626418348;7642;282;8623;8685;7.68;0.47;270.60;8.51;981;54;2962.00;62
7646;54;626418363;7646;276;8626;8689;7.69;0.47;270.56;8.51;980;55;2963.00;63
7648;54;626418391;7648;268;8627;8689;7.79;0.47;270.63;8.56;979;55;2964.00;62
7648;55;626418405;7648;275;8627;8689;7.84;0.48;270.63;8.56;979;56;2965.00;62
7650;55;626418433;7650;265;8627;8689;7.88;0.48;270.61;8.56;977;56;2966.00;62
7651;56;626418447;7651;263;8631;8695;7.90;0.48;270.60;8.61;980;57;2967.00;64
7653;56;626418470;7653;256;8631;8695;7.92;0.48;270.58;8.61;978;57;2968.00;64
7656;56;626418483;7656;259;8632;8695;7.94;0.48;270.61;8.61;976;57;2969.00;63
7658;56;626418503;7658;255;8635;8701;7.96;0.48;270.59;8.61;977;57;2970.00;66
7659;56;626418517;7659;258;8636;8701;7.98;0.49;270.59;8.61;977;57;2971.00;65
7661;56;626418536;7661;260;8636;8701;7.98;0.49;270.60;8.61;975;57;2972.00;65
7662;56;626418549;7662;261;8638;8702;7.96;0.48;270.59;8.66;976;57;2973.00;64
7667;56;626418561;7667;266;8639;8703;7.90;0.48;270.55;8.66;972;57;2974.00;64
7667;56;626418575;7667;267;8641;8703;7.91;0.48;270.55;8.71;974;57;2975.00;62
7667;56;626418587;7667;270;8649;8716;7.96;0.49;270.55;8.70;982;57;2976.00;67
7668;56;626418600;7668;276;8651;8716;7.97;0.49;270.56;8.75;983;57;2977.00;65
7672;56;626418613;7672;278;8651;8716;7.96;0.49;270.57;8.75;979;57;2978.00;65
7674;56;626418626;7674;284;8653;8717;7.97;0.49;270.55;8.80;979;57;2979.00;64
7678;56;626418640;7678;282;8653;8717;7.98;0.49;270.55;8.80;975;57;2980.00;64
7681;56;626418659;7681;289;8655;8721;8.05;0.49;270.55;8.80;974;57;2981.00;66
7686;56;626418673;7686;290;8655;8721;8.01;0.49;270.56;8.80;969;57;2982.00;66
7688;56;626418686;7688;281;8660;8725;8.02;0.49;270.58;8.85;972;57;2983.00;65
7691;56;626418700;7691;275;8660;8725;8.05;0.49;270.65;8.85;969;57;2984.00;65
7694;56;626418712;7694;276;8661;8725;8.05;0.49;270.63;8.90;967;57;2985.00;64
7700;56;626418725;7700;274;8661;8725;8.04;0.49;270.59;8.90;961;57;2986.00;64
7701;56;626418738;7701;271;8661;8725;8.05;0.49;270.61;8.90;960;57;2987.00;64
7704;56;626418750;7704;269;8671;8737;8.10;0.49;270.66;8.94;967;57;2988.00;66
7709;56;626418768;7709;265;8672;8737;8.04;0.49;270.72;8.95;963;57;2989.00;65
7714;56;626418781;7714;259;8675;8737;8.01;0.49;270.78;9.00;961;57;2990.00;62
7716;56;626418793;7716;258;8675;8737;7.98;0.49;270.80;9.00;959;57;2991.00;62
7719;56;626418805;7719;248;8675;8737;7.91;0.48;270.86;9.00;956;57;2992.00;62
7722;56;626418817;7722;243;8676;8737;7.88;0.48;270.83;9.05;954;57;2993.00;61
7723;56;626418828;7723;239;8678;8738;7.88;0.48;270.89;9.06;955;57;2994.00;60
7728;56;626418841;7728;233;8681;8738;7.80;0.47;270.95;9.13;953;57;2995.00;57
7732;56;626418860;7732;222;8684;8744;7.81;0.47;270.99;9.13;952;57;2996.00;60
7734;56;626418873;7734;224;8686;8745;7.80;0.47;271.00;9.13;952;57;2997.00;59
7739;56;626418885;7739;220;8686;8745;7.79;0.47;270.99;9.13;947;57;2998.00;59
7741;56;626418897;7741;221;8687;8745;7.80;0.47;271.00;9.17;946;57;2999.00;58
7744;56;626418912;7744;222;8691;8765;7.82;0.47;270.98;9.17;947;57;3000.00;74
7746;56;626418931;7746;219;8691;8765;7.86;0.48;271.02;9.17;945;57;3001.00;74
7749;56;626418949;7749;212;8692;8765;7.88;0.48;271.03;9.17;943;57;3002.00;73
7753;56;626418971;7753;213;8694;8766;7.95;0.48;271.10;9.21;941;57;3003.00;72
7756;56;626418991;7756;214;8697;8770;7.98;0.48;271.17;9.20;941;57;3004.00;73
7757;56;626419014;7757;213;8697;8770;8.07;0.49;271.16;9.20;940;57;3005.00;73
7765;56;626419031;7765;219;8700;8773;8.14;0.49;271.20;9.20;935;57;3006.00;73
7767;56;626419051;7767;216;8701;8773;8.18;0.50;271.27;9.21;934;57;3007.00;72
7767;56;626419066;7767;219;8702;8773;8.27;0.50;271.27;9.21;935;57;3008.00;71
7772;56;626419079;7772;214;8703;8773;8.32;0.50;271.29;9.21;931;57;3009.00;70
7773;56;626419093;7773;212;8707;8777;8.41;0.51;271.29;9.23;934;57;3010.00;70
7777;56;626419107;7777;204;8708;8777;8.45;0.51;271.33;9.23;931;57;3011.00;69
7781;56;626419121;7781;202;8711;8777;8.51;0.52;271.48;9.23;930;57;3012.00;66
7783;56;626419135;7783;198;8712;8777;8.57;0.52;271.51;9.23;929;57;3013.00;65
7787;56;626419148;7787;194;8713;8778;8.58;0.52;271.50;9.23;926;57;3014.00;65
7791;56;626419162;7791;189;8718;8780;8.56;0.52;271.49;9.23;927;57;3015.00;62
7794;56;626419176;7794;186;8718;8780;8.54;0.52;271.50;9.23;924;57;3016.00;62
7796;56;626419190;7796;191;8721;8781;8.64;0.52;271.55;9.23;925;57;3017.00;60
7798;56;626419203;7798;190;8721;8781;8.72;0.53;271.57;9.23;923;57;3018.00;60
7801;56;626419219;7801;185;8721;8781;8.82;0.53;271.66;9.23;920;57;3019.00;60
7804;56;626419233;7804;194;8724;8781;8.82;0.53;271.72;9.24;920;57;3020.00;57
7807;56;626419246;7807;186;8725;8781;8.84;0.53;271.77;9.26;918;57;3021.00;56
7809;56;626419260;7809;188;8725;8781;8.86;0.54;271.84;9.26;916;57;3022.00;56
7810;56;626419274;7810;194;8726;8781;8.92;0.54;271.85;9.27;916;57;3023.00;55
7815;56;626419288;7815;212;8790;8908;8.91;0.55;272.03;9.22;975;57;3024.00;118
7816;56;626419313;7816;209;8795;8909;8.96;0.55;272.06;9.22;979;57;3025.00;114
7818;56;626419335;7818;211;8805;8909;8.99;0.55;272.09;9.23;987;57;3026.00;104
7822;56;626419349;7822;213;8807;8909;9.01;0.55;272.21;9.24;985;57;3027.00;102
7824;56;626419365;7824;219;8813;8909;9.05;0.56;272.20;9.23;989;57;3028.00;96
7827;56;626419379;7827;218;8815;8909;9.04;0.56;272.24;9.25;988;57;3029.00;94
7828;56;626419396;7828;218;8819;8909;9.09;0.56;272.22;9.26;991;57;3030.00;90
7832;56;626419409;7832;219;8821;8909;9.08;0.56;272.26;9.26;989;57;3031.00;88
7836;56;626419423;7836;214;8828;8910;9.06;0.56;272.32;9.29;992;57;3032.00;82
7839;56;626419438;7839;216;8830;8911;9.04;0.55;272.29;9.29;991;57;3033.00;81
7841;56;626419452;7841;218;8833;8911;8.96;0.55;272.26;9.30;992;57;3034.00;78
7844;56;626419467;7844;225;8836;8912;8.95;0.55;272.30;9.30;992;57;3035.00;76
7847;56;626419483;7847;229;8839;8912;8.86;0.54;272.36;9.32;992;57;3036.00;73
7849;56;626419506;7849;233;8845;8912;8.75;0.54;272.31;9.34;996;57;3037.00;67
7851;56;626419520;7851;245;8850;8912;8.65;0.53;272.40;9.34;999;57;3038.00;62
7852;56;626419534;7852;246;8856;8916;8.54;0.53;272.44;9.36;1004;57;3039.00;60
7857;56;626419548;7857;244;8860;8916;8.40;0.52;272.45;9.36;1003;57;3040.00;56
7860;56;626419563;7860;261;8863;8916;8.26;0.51;272.44;9.36;1003;57;3041.00;53
7862;56;626419584;7862;266;8868;8919;8.13;0.50;272.45;9.37;1006;57;3042.00;51
7866;56;626419598;7866;269;8869;8919;8.00;0.49;272.52;9.37;1003;57;3043.00;50
7870;56;626419617;7870;269;8870;8919;7.94;0.49;272.52;9.37;1000;57;3044.00;49
7871;56;626419631;7871;275;8876;8923;7.86;0.48;272.54;9.38;1005;57;3045.00;47
7877;56;626419645;7877;272;8878;8924;7.79;0.48;272.53;9.38;1001;57;3046.00;46
7882;56;626419658;7882;275;8880;8924;7.68;0.47;272.53;9.39;998;57;3047.00;44
7885;56;626419678;7885;281;8883;8928;7.67;0.47;272.59;9.39;998;57;3048.00;45
7888;56;626419693;7888;279;8886;8928;7.63;0.47;272.63;9.40;998;57;3049.00;42
7889;56;626419708;7889;276;8886;8928;7.55;0.46;272.63;9.40;997;57;3050.00;42
7893;56;626419722;7893;290;8887;8929;7.46;0.46;272.64;9.39;994;57;3051.00;42
7896;56;626419735;7896;297;8887;8929;7.35;0.45;272.68;9.39;991;57;3052.00;42
7899;56;626419749;7899;309;8891;8935;7.33;0.45;272.68;9.39;992;57;3053.00;44
7901;56;626419763;7901;312;8894;8935;7.20;0.44;272.65;9.40;993;57;3054.00;41
7907;56;626419775;7907;315;8895;8936;7.11;0.44;272.78;9.40;988;57;3055.00;41
7911;56;626419788;7911;315;8899;8936;6.97;0.43;272.78;9.41;988;57;3056.00;37
7914;56;626419800;7914;320;8899;8936;6.90;0.42;272.79;9.41;985;57;3057.00;37
7919;56;626419819;7919;324;8899;8936;6.74;0.41;272.87;9.41;980;57;3058.00;37
7923;56;626419837;7923;337;8901;8936;6.56;0.40;272.86;9.42;978;57;3059.00;35
7930;56;626419850;7930;334;8924;8972;6.51;0.40;272.99;9.40;994;57;3060.00;48
7934;56;626419865;7934;325;8926;8972;6.42;0.40;273.03;9.40;992;57;3061.00;46
7935;56;626419877;7935;330;8930;8972;6.34;0.39;273.03;9.40;995;57;3062.00;42
7941;56;626419888;7941;326;8932;8972;6.26;0.39;273.07;9.39;991;57;3063.00;40
7945;56;626419900;7945;333;8934;8972;6.23;0.38;273.26;9.40;989;57;3064.00;38
7948;56;626419912;7948;343;8934;8972;6.19;0.38;273.34;9.40;986;57;3065.00;38
7954;56;626419923;7954;346;8939;8976;6.19;0.38;273.43;9.40;985;57;3066.00;37
7958;56;626419936;7958;340;8939;8976;6.24;0.38;273.44;9.40;981;57;3067.00;37
7962;56;626419948;7962;337;8942;8980;6.26;0.38;273.46;9.39;980;57;3068.00;38
7966;56;626419960;7966;338;8944;8981;6.26;0.38;273.56;9.40;978;57;3069.00;37
7968;56;626419973;7968;341;8945;8981;6.26;0.38;273.60;9.40;977;57;3070.00;36
7969;56;626419988;7969;341;8946;8981;6.25;0.38;273.63;9.39;977;57;3071.00;35
7972;56;626420000;7972;343;8957;8994;6.22;0.38;273.70;9.38;985;57;3072.00;37
7973;56;626420012;7973;344;8958;8994;6.21;0.38;273.72;9.38;985;57;3073.00;36
7977;56;626420022;7977;352;8958;8994;6.16;0.38;273.71;9.38;981;57;3074.00;36
7979;56;626420034;7979;354;8959;8995;6.14;0.38;273.73;9.38;980;57;3075.00;36
7985;56;626420045;7985;362;8959;8996;6.11;0.38;273.67;9.38;974;57;3076.00;37
7990;56;626420056;7990;367;8959;8996;6.09;0.38;273.63;9.38;969;57;3077.00;37
7992;56;626420067;7992;369;8961;8999;6.16;0.38;273.70;9.38;969;57;3078.00;38
7999;56;626420078;7999;361;8961;8999;6.13;0.38;273.66;9.38;962;57;3079.00;38
8002;56;626420089;8002;361;8962;8999;6.07;0.37;273.67;9.38;960;57;3080.00;37
8004;56;626420100;8004;358;8962;8999;6.04;0.37;273.68;9.38;958;57;3081.00;37
8011;56;626420110;8011;362;8966;9005;6.04;0.37;273.69;9.38;955;57;3082.00;39
8014;56;626420122;8014;367;8966;9005;6.04;0.37;273.70;9.38;952;57;3083.00;39
8018;56;626420132;8018;377;8967;9005;6.01;0.37;273.66;9.37;949;57;3084.00;38
8022;56;626420145;8022;378;8967;9005;6.02;0.37;273.60;9.37;945;57;3085.00;38
8024;56;626420158;8024;382;8970;9009;6.07;0.37;273.60;9.37;946;57;3086.00;39
8030;56;626420169;8030;388;8971;9010;5.99;0.37;273.68;9.37;941;57;3087.00;39
8036;56;626420181;8036;387;8971;9010;5.93;0.36;273.60;9.37;935;57;3088.00;39
8039;56;626420200;8039;388;8972;9011;5.92;0.36;273.59;9.37;933;57;3089.00;39
8041;56;626420214;8041;390;8972;9011;5.90;0.36;273.58;9.37;931;57;3090.00;39
8044;56;626420226;8044;390;8972;9011;5.93;0.36;273.56;9.37;928;57;3091.00;39
8050;56;626420236;8050;390;8972;9011;5.88;0.36;273.59;9.37;922;57;3092.00;39
8054;56;626420248;8054;392;8972;9011;5.79;0.36;273.64;9.37;918;57;3093.00;39
8057;56;626420258;8057;397;8972;9011;5.77;0.36;273.62;9.37;915;57;3094.00;39
8062;56;626420270;8062;408;8972;9011;5.77;0.35;273.57;9.37;910;57;3095.00;39
8065;56;626420280;8065;415;9014;9081;5.92;0.36;273.53;9.33;949;57;3096.00;67
8068;56;626420297;8068;418;9015;9082;5.92;0.36;273.50;9.33;947;57;3097.00;67
8070;56;626420308;8070;417;9022;9082;6.03;0.37;273.44;9.32;952;57;3098.00;60
8075;56;626420319;8075;426;9027;9082;6.12;0.37;273.46;9.32;952;57;3099.00;55
8076;56;626420331;8076;428;9032;9082;6.19;0.38;273.45;9.31;956;57;3100.00;50
8078;56;626420346;8078;436;9034;9082;6.20;0.38;273.49;9.31;956;57;3101.00;48
8081;56;626420357;8081;435;9035;9082;6.19;0.38;273.47;9.31;954;57;3102.00;47
8082;56;626420369;8082;440;9036;9082;6.16;0.38;273.45;9.31;954;57;3103.00;46
8085;56;626420380;8085;443;9038;9083;6.11;0.37;273.45;9.31;953;57;3104.00;45
8090;56;626420392;8090;450;9040;9085;6.03;0.37;273.52;9.31;950;57;3105.00;45
8091;57;626420403;8091;454;9041;9085;5.96;0.36;273.52;9.31;950;58;3106.00;44
8091;57;626420425;8091;437;9044;9089;5.95;0.36;273.52;9.31;953;58;3107.00;45
8092;57;626420438;8092;417;9044;9089;5.99;0.37;273.49;9.31;952;58;3108.00;45
8096;57;626420450;8096;404;9044;9089;6.03;0.37;273.50;9.31;948;58;3109.00;45
8100;57;626420462;8100;394;9044;9089;6.11;0.37;273.48;9.31;944;58;3110.00;45
8101;57;626420475;8101;387;9048;9095;6.25;0.38;273.46;9.30;947;58;3111.00;47
8101;58;626420487;8101;377;9049;9095;6.40;0.39;273.46;9.30;948;59;3112.00;46
8101;58;626420510;8101;369;9049;9095;6.48;0.40;273.46;9.30;948;59;3113.00;46
8103;58;626420533;8103;361;9052;9098;6.66;0.41;273.44;9.30;949;59;3114.00;46
8105;58;626420551;8105;353;9052;9098;6.78;0.41;273.42;9.30;947;59;3115.00;46
8108;58;626420564;8108;328;9052;9098;6.92;0.42;273.51;9.30;944;59;3116.00;46
8110;58;626420577;8110;316;9052;9099;7.11;0.43;273.50;9.30;942;59;3117.00;47
8111;58;626420590;8111;304;9053;9100;7.25;0.44;273.47;9.30;942;59;3118.00;47
8115;58;626420608;8115;288;9053;9100;7.34;0.45;273.45;9.30;938;59;3119.00;47
8115;58;626420623;8115;290;9073;9126;7.48;0.46;273.45;9.28;958;59;3120.00;53
8118;58;626420639;8118;282;9074;9126;7.53;0.46;273.40;9.28;956;59;3121.00;52
8120;58;626420659;8120;281;9075;9126;7.59;0.46;273.37;9.27;955;59;3122.00;51
8121;58;626420672;8121;277;9076;9127;7.70;0.47;273.36;9.27;955;59;3123.00;51
8122;58;626420685;8122;277;9076;9127;7.79;0.47;273.36;9.27;954;59;3124.00;51
8124;59;626420699;8124;273;9079;9131;7.89;0.48;273.38;9.27;955;60;3125.00;52
8125;59;626420730;8125;269;9079;9131;7.99;0.48;273.38;9.27;954;60;3126.00;52
8125;59;626420744;8125;262;9083;9135;8.08;0.49;273.38;9.27;958;60;3127.00;52
8129;59;626420757;8129;260;9083;9135;8.10;0.49;273.38;9.27;954;60;3128.00;52
8132;59;626420770;8132;250;9083;9135;8.13;0.49;273.39;9.27;951;60;3129.00;52
8134;59;626420783;8134;245;9083;9135;8.16;0.49;273.38;9.27;949;60;3130.00;52
8136;59;626420797;8136;244;9083;9135;8.21;0.50;273.47;9.27;947;60;3131.00;52
8137;59;626420810;8137;241;9093;9147;8.29;0.50;273.46;9.26;956;60;3132.00;54
8140;59;626420824;8140;242;9093;9147;8.33;0.51;273.49;9.26;953;60;3133.00;54
8143;59;626420837;8143;239;9094;9147;8.38;0.51;273.50;9.26;951;60;3134.00;53
8150;59;626420850;8150;245;9094;9147;8.38;0.51;273.53;9.26;944;60;3135.00;53
8153;59;626420864;8153;246;9094;9147;8.42;0.51;273.57;9.26;941;60;3136.00;53
8156;59;626420876;8156;247;9094;9147;8.43;0.51;273.60;9.26;938;60;3137.00;53
8158;59;626420889;8158;247;9094;9148;8.36;0.51;273.62;9.26;936;60;3138.00;54
8162;59;626420901;8162;250;9094;9148;8.37;0.51;273.72;9.26;932;60;3139.00;54
8165;59;626420913;8165;249;9098;9154;8.34;0.51;273.81;9.25;933;60;3140.00;56
8169;59;626420932;8169;251;9099;9155;8.24;0.50;273.86;9.25;930;60;3141.00;56
8172;59;626420951;8172;254;9100;9155;8.24;0.50;273.93;9.25;928;60;3142.00;55
8175;59;626420973;8175;260;9100;9155;8.22;0.50;273.93;9.25;925;60;3143.00;55
8179;59;626420994;8179;266;9103;9159;8.19;0.50;273.92;9.25;924;60;3144.00;56
8183;59;626421014;8183;267;9103;9159;8.09;0.49;273.94;9.25;920;60;3145.00;56
8186;59;626421033;8186;274;9103;9159;8.06;0.49;273.92;9.25;917;60;3146.00;56
8191;59;626421050;8191;273;9104;9160;8.08;0.49;273.95;9.25;913;60;3147.00;56
8194;59;626421066;8194;276;9107;9164;8.02;0.49;273.98;9.24;913;60;3148.00;57
8195;59;626421080;8195;282;9107;9164;7.97;0.48;274.03;9.24;912;60;3149.00;57
8198;59;626421103;8198;286;9110;9170;7.99;0.48;274.02;9.24;912;60;3150.00;60
8202;59;626421124;8202;279;9110;9170;7.91;0.48;274.06;9.24;908;60;3151.00;60
8206;59;626421139;8206;268;9111;9170;7.90;0.48;274.21;9.24;905;60;3152.00;59
8211;59;626421156;8211;269;9111;9170;7.91;0.48;274.29;9.24;900;60;3153.00;59
8212;59;626421172;8212;266;9114;9174;7.99;0.48;274.32;9.24;902;60;3154.00;60
8213;59;626421185;8213;262;9114;9174;8.03;0.49;274.32;9.24;901;60;3155.00;60
8215;59;626421198;8215;258;9115;9174;8.12;0.49;274.35;9.24;900;60;3156.00;59
8215;59;626421211;8215;248;9115;9174;8.25;0.50;274.35;9.24;900;60;3157.00;59
8216;59;626421223;8216;241;9116;9175;8.31;0.51;274.40;9.24;900;60;3158.00;59
8219;59;626421235;8219;240;9117;9176;8.34;0.51;274.42;9.24;898;60;3159.00;59
8222;59;626421248;8222;238;9118;9176;8.33;0.51;274.39;9.24;896;60;3160.00;58
8225;59;626421260;8225;230;9119;9177;8.33;0.51;274.38;9.24;894;60;3161.00;58
8231;59;626421273;8231;224;9120;9177;8.24;0.50;274.56;9.29;889;60;3162.00;57
8236;59;626421287;8236;214;9120;9177;8.20;0.50;274.59;9.29;884;60;3163.00;57
8237;59;626421299;8237;212;9121;9177;8.19;0.50;274.59;9.30;884;60;3164.00;56
8242;59;626421312;8242;213;9122;9177;8.15;0.50;274.57;9.31;880;60;3165.00;55
8248;59;626421324;8248;207;9122;9177;8.12;0.49;274.55;9.31;874;60;3166.00;55
8250;59;626421337;8250;205;9122;9177;8.14;0.49;274.54;9.31;872;60;3167.00;55
8256;59;626421348;8256;222;9188;9304;8.09;0.50;274.52;9.25;932;60;3168.00;116
8259;59;626421372;8259;208;9189;9305;8.08;0.50;274.50;9.25;930;60;3169.00;116
8263;59;626421386;8263;196;9195;9305;8.14;0.50;274.47;9.24;932;60;3170.00;110
8266;59;626421399;8266;191;9197;9305;8.19;0.50;274.49;9.24;931;60;3171.00;108
8270;59;626421411;8270;187;9200;9305;8.28;0.51;274.54;9.24;930;60;3172.00;105
8274;59;626421424;8274;181;9201;9305;8.33;0.51;274.57;9.24;927;60;3173.00;104
8276;59;626421437;8276;184;9204;9305;8.47;0.52;274.59;9.24;928;60;3174.00;101
8278;60;626421449;8278;186;9208;9305;8.56;0.52;274.61;9.24;930;61;3175.00;97
8281;60;626421469;8281;190;9211;9306;8.71;0.53;274.61;9.24;930;61;3176.00;95
8285;60;626421483;8285;185;9217;9307;8.85;0.54;274.60;9.24;932;61;3177.00;90
8286;60;626421496;8286;189;9220;9307;8.97;0.55;274.57;9.24;934;61;3178.00;87
8291;60;626421515;8291;196;9223;9308;9.09;0.55;274.66;9.24;932;61;3179.00;85
8295;60;626421530;8295;197;9229;9308;9.08;0.55;274.70;9.24;934;61;3180.00;79
8299;60;626421544;8299;193;9233;9308;9.07;0.55;274.68;9.24;934;61;3181.00;75
8302;60;626421557;8302;195;9235;9308;9.01;0.55;274.74;9.24;933;61;3182.00;73
8303;60;626421570;8303;194;9238;9312;9.01;0.55;274.79;9.24;935;61;3183.00;74
8307;60;626421584;8307;200;9241;9312;9.02;0.55;274.83;9.24;934;61;3184.00;71
8309;60;626421598;8309;202;9242;9312;9.02;0.55;274.89;9.24;933;61;3185.00;70
8313;61;626421611;8313;209;9245;9315;8.99;0.55;275.03;9.26;932;62;3186.00;70
8315;61;626421643;8315;211;9248;9315;8.99;0.55;275.06;9.27;933;62;3187.00;67
8322;61;626421662;8322;221;9249;9315;8.97;0.54;275.13;9.27;927;62;3188.00;66
8323;61;626421676;8323;217;9252;9319;8.93;0.54;275.16;9.26;929;62;3189.00;67
8324;61;626421690;8324;217;9255;9320;8.98;0.55;275.21;9.27;931;62;3190.00;65
8327;61;626421703;8327;219;9257;9322;8.89;0.54;275.28;9.29;930;62;3191.00;65
8331;61;626421718;8331;223;9262;9326;8.95;0.55;275.27;9.29;931;62;3192.00;64
8333;61;626421732;8333;230;9263;9326;9.01;0.55;275.31;9.29;930;62;3193.00;63
8335;61;626421745;8335;233;9264;9326;9.05;0.55;275.31;9.31;929;62;3194.00;62
8338;61;626421758;8338;234;9267;9328;9.13;0.56;275.34;9.31;929;62;3195.00;61
8340;61;626421772;8340;236;9268;9328;9.14;0.56;275.38;9.33;928;62;3196.00;60
8342;61;626421785;8342;239;9273;9334;9.14;0.56;275.41;9.32;931;62;3197.00;61
8348;61;626421799;8348;236;9275;9334;9.04;0.55;275.43;9.34;927;62;3198.00;59
8349;61;626421812;8349;241;9275;9335;8.96;0.55;275.45;9.34;926;62;3199.00;60
8351;61;626421826;8351;249;9277;9335;8.84;0.54;275.52;9.36;926;62;3200.00;58
8353;61;626421845;8353;251;9277;9335;8.75;0.54;275.52;9.36;924;62;3201.00;58
8355;61;626421858;8355;257;9279;9335;8.70;0.53;275.53;9.37;924;62;3202.00;56
8360;61;626421871;8360;264;9280;9335;8.64;0.53;275.63;9.39;920;62;3203.00;55
8364;61;626421883;8364;268;9291;9347;8.62;0.53;275.62;9.38;927;62;3204.00;56
8366;61;626421897;8366;270;9292;9347;8.52;0.52;275.65;9.38;926;62;3205.00;55
8366;61;626421909;8366;273;9294;9347;8.46;0.52;275.65;9.39;928;62;3206.00;53
8371;61;626421921;8371;276;9296;9347;8.42;0.52;275.65;9.40;925;62;3207.00;51
8373;61;626421934;8373;285;9297;9347;8.37;0.51;275.70;9.41;924;62;3208.00;50
8377;61;626421947;8377;289;9298;9347;8.27;0.51;275.78;9.41;921;62;3209.00;49
8380;61;626421961;8380;292;9302;9351;8.20;0.50;275.86;9.42;922;62;3210.00;49
8383;61;626421974;8383;284;9302;9351;8.16;0.50;275.88;9.42;919;62;3211.00;49
8385;61;626421986;8385;287;9306;9355;8.12;0.50;275.95;9.42;921;62;3212.00;49
8387;61;626421998;8387;293;9307;9356;8.07;0.49;275.97;9.42;920;62;3213.00;49
8390;61;626422009;8390;293;9311;9356;8.01;0.49;276.04;9.44;921;62;3214.00;45
8392;61;626422020;8392;301;9311;9356;7.94;0.49;276.07;9.44;919;62;3215.00;45
8396;61;626422031;8396;299;9322;9369;7.88;0.48;276.12;9.43;926;62;3216.00;47
8398;61;626422043;8398;300;9324;9369;7.80;0.48;276.09;9.43;926;62;3217.00;45
8400;61;626422054;8400;309;9324;9369;7.74;0.47;276.15;9.43;924;62;3218.00;45
8404;61;626422066;8404;304;9325;9370;7.68;0.47;276.13;9.43;921;62;3219.00;45
8406;61;626422077;8406;303;9326;9371;7.59;0.46;276.09;9.44;920;62;3220.00;45
8410;61;626422088;8410;311;9326;9371;7.50;0.46;276.11;9.44;916;62;3221.00;45
8412;61;626422099;8412;321;9331;9374;7.45;0.46;276.10;9.45;919;62;3222.00;43
8413;61;626422109;8413;324;9332;9374;7.42;0.45;276.08;9.45;919;62;3223.00;42
8415;61;626422119;8415;326;9332;9374;7.32;0.45;276.11;9.45;917;62;3224.00;42
8419;61;626422129;8419;329;9333;9374;7.23;0.44;276.08;9.45;914;62;3225.00;41
8423;61;626422139;8423;334;9338;9380;7.18;0.44;276.05;9.45;915;62;3226.00;42
8426;61;626422150;8426;338;9338;9380;7.02;0.43;276.08;9.45;912;62;3227.00;42
8430;61;626422161;8430;339;9339;9380;6.84;0.42;276.06;9.45;909;62;3228.00;41
8433;61;626422170;8433;345;9342;9380;6.63;0.41;276.08;9.46;909;62;3229.00;38
8436;61;626422179;8436;340;9345;9384;6.46;0.40;276.11;9.46;909;62;3230.00;39
8441;61;626422189;8441;342;9346;9385;6.32;0.39;276.13;9.45;905;62;3231.00;39
8441;61;626422199;8441;339;9346;9385;6.22;0.38;276.13;9.45;905;62;3232.00;39
8447;61;626422209;8447;333;9351;9386;6.11;0.37;276.19;9.46;904;62;3233.00;35
8450;61;626422219;8450;335;9351;9386;6.08;0.37;276.17;9.46;901;62;3234.00;35
8453;61;626422228;8453;344;9351;9386;6.11;0.37;276.15;9.46;898;62;3235.00;35
8458;61;626422238;8458;340;9353;9386;6.09;0.37;276.11;9.46;895;62;3236.00;33
8460;61;626422247;8460;335;9353;9386;6.10;0.37;276.07;9.46;893;62;3237.00;33
8465;61;626422258;8465;330;9353;9386;6.11;0.37;276.03;9.46;888;62;3238.00;33
8469;61;626422268;8469;328;9353;9386;6.12;0.37;276.04;9.46;884;62;3239.00;33
8471;61;626422279;8471;325;9405;9511;6.47;0.40;276.05;9.41;934;62;3240.00;106
8475;61;626422298;8475;328;9408;9512;6.48;0.40;276.02;9.47;933;62;3241.00;104
8479;61;626422309;8479;323;9419;9512;6.62;0.41;276.17;9.46;940;62;3242.00;93
8482;61;626422320;8482;321;9428;9512;6.66;0.41;276.13;9.45;946;62;3243.00;84
8485;61;626422331;8485;324;9434;9512;6.67;0.41;276.13;9.45;949;62;3244.00;78
8491;61;626422341;8491;321;9439;9512;6.60;0.41;276.10;9.45;948;62;3245.00;73
8491;61;626422358;8491;323;9444;9512;6.58;0.41;276.10;9.44;953;62;3246.00;68
8494;61;626422368;8494;333;9446;9512;6.52;0.40;276.14;9.44;952;62;3247.00;66
8496;61;626422379;8496;344;9451;9513;6.54;0.40;276.14;9.44;955;62;3248.00;62
8502;61;626422391;8502;353;9453;9514;6.46;0.40;276.12;9.44;951;62;3249.00;61
8506;61;626422402;8506;349;9454;9514;6.42;0.40;276.13;9.44;948;62;3250.00;60
8511;61;626422413;8511;355;9459;9518;6.38;0.39;276.04;9.44;948;62;3251.00;59
8513;61;626422425;8513;360;9460;9518;6.33;0.39;276.11;9.44;947;62;3252.00;58
8515;61;626422436;8515;353;9461;9518;6.26;0.39;276.12;9.44;946;62;3253.00;57
8518;61;626422448;8518;353;9463;9518;6.19;0.38;276.10;9.44;945;62;3254.00;55
8522;61;626422461;8522;354;9466;9524;6.21;0.38;276.07;9.44;944;62;3255.00;58
8528;61;626422474;8528;348;9468;9524;6.12;0.38;276.08;9.44;940;62;3256.00;56
8532;61;626422486;8532;352;9468;9524;6.04;0.37;276.13;9.44;936;62;3257.00;56
8534;61;626422504;8534;351;9473;9527;6.04;0.37;276.11;9.49;939;62;3258.00;54
8535;61;626422517;8535;349;9473;9527;6.05;0.37;276.10;9.49;938;62;3259.00;54
8539;61;626422529;8539;338;9473;9527;5.99;0.37;276.08;9.49;934;62;3260.00;54
8539;61;626422540;8539;335;9473;9528;6.01;0.37;276.08;9.49;934;62;3261.00;55
8543;61;626422551;8543;330;9474;9529;6.03;0.37;276.07;9.49;931;62;3262.00;55
8546;61;626422563;8546;331;9474;9529;6.02;0.37;276.09;9.49;928;62;3263.00;55
8549;61;626422576;8549;328;9485;9542;6.17;0.38;276.02;9.48;936;62;3264.00;57
8552;61;626422589;8552;334;9485;9542;6.23;0.38;276.00;9.48;933;62;3265.00;57
8557;61;626422606;8557;329;9485;9542;6.29;0.38;276.04;9.48;928;62;3266.00;57
8557;61;626422618;8557;327;9486;9543;6.41;0.39;276.04;9.48;929;62;3267.00;57
8558;61;626422630;8558;323;9486;9543;6.46;0.40;276.07;9.48;928;62;3268.00;57
8559;61;626422642;8559;321;9490;9547;6.56;0.40;276.10;9.54;931;62;3269.00;57
8563;61;626422661;8563;316;9490;9547;6.59;0.40;276.10;9.54;927;62;3270.00;57
8566;61;626422673;8566;316;9494;9551;6.69;0.41;276.06;9.53;928;62;3271.00;57
8568;61;626422685;8568;318;9494;9551;6.73;0.41;276.03;9.53;926;62;3272.00;57
8571;61;626422697;8571;314;9494;9551;6.69;0.41;276.02;9.53;923;62;3273.00;57
8573;61;626422710;8573;318;9495;9551;6.68;0.41;276.01;9.59;922;62;3274.00;56
8573;61;626422721;8573;320;9495;9551;6.75;0.41;276.01;9.59;922;62;3275.00;56
8577;61;626422733;8577;327;9505;9563;6.92;0.42;275.97;9.58;928;62;3276.00;58
8580;61;626422746;8580;318;9505;9563;6.99;0.43;276.01;9.58;925;62;3277.00;58
8582;61;626422758;8582;320;9506;9563;7.06;0.43;276.00;9.58;924;62;3278.00;57
8582;61;626422771;8582;311;9506;9563;7.17;0.44;276.00;9.58;924;62;3279.00;57
8587;61;626422783;8587;314;9507;9563;7.20;0.44;276.04;9.63;920;62;3280.00;56
8587;61;626422795;8587;311;9507;9563;7.32;0.45;276.04;9.63;920;62;3281.00;56
8592;61;626422808;8592;307;9507;9564;7.33;0.45;276.16;9.63;915;62;3282.00;57
8594;61;626422820;8594;312;9507;9564;7.42;0.45;276.12;9.63;913;62;3283.00;57
8597;61;626422833;8597;312;9511;9570;7.46;0.45;276.14;9.63;914;62;3284.00;59
8600;61;626422846;8600;312;9513;9572;7.43;0.45;276.15;9.63;913;62;3285.00;59
8602;61;626422858;8602;302;9514;9572;7.51;0.46;276.15;9.63;912;62;3286.00;58
8606;61;626422871;8606;293;9514;9572;7.57;0.46;276.19;9.63;908;62;3287.00;58
8610;61;626422884;8610;287;9517;9576;7.61;0.46;276.28;9.62;907;62;3288.00;59
8610;61;626422903;8610;291;9517;9576;7.67;0.47;276.28;9.62;907;62;3289.00;59
8614;61;626422920;8614;283;9517;9576;7.71;0.47;276.36;9.62;903;62;3290.00;59
8616;61;626422933;8616;281;9518;9577;7.76;0.47;276.38;9.62;902;62;3291.00;59
8620;61;626422952;8620;272;9521;9581;7.83;0.48;276.45;9.62;901;62;3292.00;60
8622;61;626422972;8622;281;9521;9581;7.87;0.48;276.51;9.62;899;62;3293.00;60
8625;61;626422992;8625;284;9523;9584;7.90;0.48;276.55;9.62;898;62;3294.00;61
8626;61;626423011;8626;287;9523;9584;7.96;0.48;276.54;9.62;897;62;3295.00;61
8630;61;626423028;8630;295;9524;9584;7.96;0.48;276.62;9.62;894;62;3296.00;60
8633;61;626423047;8633;292;9524;9584;7.91;0.48;276.63;9.62;891;62;3297.00;60
8636;61;626423064;8636;285;9527;9588;7.90;0.48;276.63;9.62;891;62;3298.00;61
8639;61;626423079;8639;279;9527;9588;7.88;0.48;276.70;9.62;888;62;3299.00;61
8642;61;626423097;8642;275;9531;9607;7.85;0.48;276.74;9.61;889;62;3300.00;76
8644;61;626423117;8644;271;9532;9607;7.85;0.48;276.75;9.61;888;62;3301.00;75
8646;61;626423131;8646;265;9532;9608;7.91;0.48;276.73;9.61;886;62;3302.00;76
8649;61;626423144;8649;266;9533;9609;7.91;0.48;276.75;9.61;884;62;3303.00;76
8651;61;626423157;8651;262;9533;9609;7.93;0.48;276.76;9.61;882;62;3304.00;76
8655;61;626423170;8655;259;9534;9610;7.95;0.49;276.75;9.61;879;62;3305.00;76
8661;61;626423190;8661;259;9535;9610;7.91;0.48;276.71;9.61;874;62;3306.00;75
8662;61;626423203;8662;261;9536;9610;7.89;0.48;276.75;9.61;874;62;3307.00;74
8667;61;626423215;8667;266;9536;9610;7.86;0.48;276.73;9.61;869;62;3308.00;74
8670;61;626423227;8670;263;9536;9610;7.82;0.48;276.75;9.61;866;62;3309.00;74
8673;61;626423239;8673;265;9536;9610;7.79;0.48;276.77;9.61;863;62;3310.00;74
8677;61;626423252;8677;266;9537;9610;7.73;0.47;276.77;9.61;860;62;3311.00;73
8678;61;626423265;8678;293;9605;9737;7.76;0.48;276.79;9.54;927;62;3312.00;132
8684;61;626423287;8684;292;9609;9738;7.74;0.48;276.84;9.54;925;62;3313.00;129
8686;61;626423302;8686;282;9613;9738;7.86;0.48;276.83;9.53;927;62;3314.00;125
8688;61;626423320;8688;278;9615;9738;7.88;0.49;276.88;9.53;927;62;3315.00;123
8692;61;626423338;8692;283;9617;9738;7.84;0.48;276.90;9.53;925;62;3316.00;121
8693;61;626423352;8693;278;9620;9738;7.84;0.48;276.90;9.53;927;62;3317.00;118
8696;61;626423364;8696;275;9624;9738;7.88;0.49;276.96;9.58;928;62;3318.00;114
8698;61;626423377;8698;283;9627;9738;7.90;0.49;276.95;9.58;929;62;3319.00;111
8704;61;626423390;8704;277;9629;9739;7.87;0.48;277.02;9.58;925;62;3320.00;110
8705;61;626423403;8705;278;9631;9740;7.84;0.48;277.02;9.58;926;62;3321.00;109
8707;61;626423416;8707;273;9634;9740;7.84;0.48;277.02;9.58;927;62;3322.00;106
8707;61;626423429;8707;277;9637;9741;7.85;0.48;277.02;9.59;930;62;3323.00;104
8708;61;626423441;8708;273;9639;9741;7.84;0.48;277.03;9.59;931;62;3324.00;102
8709;61;626423455;8709;271;9642;9741;7.85;0.48;277.01;9.59;933;62;3325.00;99
8711;61;626423473;8711;275;9644;9741;7.83;0.48;277.00;9.59;933;62;3326.00;97
8713;61;626423490;8713;281;9646;9745;7.83;0.48;276.97;9.59;933;62;3327.00;99
8715;61;626423503;8715;278;9650;9745;7.77;0.48;277.00;9.59;935;62;3328.00;95
8716;62;626423515;8716;269;9652;9745;7.76;0.47;277.02;9.59;936;63;3329.00;93
8719;62;626423540;8719;274;9655;9751;7.78;0.47;276.99;9.59;936;63;3330.00;96
8723;62;626423553;8723;274;9656;9751;7.67;0.47;276.97;9.59;933;63;3331.00;95
8727;62;626423566;8727;264;9657;9751;7.56;0.46;277.02;9.59;930;63;3332.00;94
8731;62;626423584;8731;253;9662;9755;7.46;0.45;277.00;9.59;931;63;3333.00;93
8736;63;626423604;8736;252;9664;9756;7.42;0.45;276.98;9.59;928;64;3334.00;92
8737;63;626423628;8737;249;9666;9756;7.45;0.45;276.97;9.65;929;64;3335.00;90
8739;63;626423643;8739;237;9669;9760;7.47;0.45;276.97;9.70;930;64;3336.00;91
8743;63;626423656;8743;237;9670;9760;7.41;0.45;276.94;9.70;927;64;3337.00;90
8746;63;626423668;8746;227;9673;9760;7.44;0.45;276.93;9.75;927;64;3338.00;87
8748;63;626423680;8748;225;9675;9761;7.48;0.45;276.91;9.75;927;64;3339.00;86
8749;63;626423693;8749;229;9678;9761;7.49;0.45;276.92;9.76;929;64;3340.00;83
8750;63;626423706;8750;226;9682;9767;7.52;0.46;276.93;9.81;932;64;3341.00;85
8752;63;626423719;8752;225;9684;9767;7.58;0.46;276.92;9.81;932;64;3342.00;83
8756;63;626423732;8756;221;9686;9768;7.59;0.46;276.91;9.86;930;64;3343.00;82
8756;63;626423745;8756;217;9686;9768;7.66;0.46;276.91;9.86;930;64;3344.00;82
8761;63;626423763;8761;214;9688;9768;7.66;0.46;276.99;9.86;927;64;3345.00;80
8762;63;626423776;8762;219;9689;9768;7.71;0.47;276.97;9.90;927;64;3346.00;79
8767;63;626423795;8767;218;9690;9768;7.73;0.47;276.94;9.91;923;64;3347.00;78
8769;63;626423808;8769;218;9699;9780;7.79;0.47;276.96;9.90;930;64;3348.00;81
8770;63;626423822;8770;222;9705;9780;7.78;0.47;276.93;9.95;935;64;3349.00;75
8773;63;626423835;8773;220;9706;9780;7.73;0.47;276.91;9.95;933;64;3350.00;74
8776;63;626423849;8776;224;9711;9780;7.68;0.46;276.91;10.00;935;64;3351.00;69
8777;63;626423861;8777;225;9711;9780;7.65;0.46;276.92;10.00;934;64;3352.00;69
8778;63;626423873;8778;229;9711;9780;7.66;0.46;276.96;10.00;933;64;3353.00;69
8779;63;626423886;8779;226;9715;9784;7.65;0.46;276.98;10.00;936;64;3354.00;69
8782;63;626423899;8782;229;9715;9784;7.69;0.46;276.96;10.00;933;64;3355.00;69
8783;63;626423911;8783;234;9718;9788;7.76;0.47;276.97;10.00;935;64;3356.00;70
8786;63;626423932;8786;235;9719;9789;7.77;0.47;277.00;10.00;933;64;3357.00;70
8789;63;626423945;8789;241;9720;9789;7.80;0.47;277.05;10.00;931;64;3358.00;69
8791;63;626423958;8791;248;9721;9789;7.84;0.47;277.06;10.01;930;64;3359.00;68
8794;63;626423973;8794;260;9741;9818;7.77;0.47;277.05;10.00;947;64;3360.00;77
8799;63;626423987;8799;259;9743;9818;7.69;0.46;277.11;10.00;944;64;3361.00;75
8799;63;626424001;8799;268;9747;9818;7.70;0.47;277.11;10.01;948;64;3362.00;71
8802;63;626424013;8802;275;9750;9819;7.67;0.46;277.17;10.02;948;64;3363.00;69
8804;63;626424025;8804;277;9751;9820;7.63;0.46;277.24;10.03;947;64;3364.00;69
8805;63;626424042;8805;281;9751;9820;7.67;0.47;277.25;10.03;946;64;3365.00;69
8807;63;626424054;8807;285;9755;9823;7.66;0.46;277.33;10.04;948;64;3366.00;68
8807;63;626424067;8807;289;9756;9823;7.65;0.47;277.33;10.05;949;64;3367.00;67
8809;63;626424085;8809;297;9756;9823;7.65;0.47;277.31;10.05;947;64;3368.00;67
8810;63;626424097;8810;301;9757;9823;7.63;0.47;277.42;10.06;947;64;3369.00;66
8813;63;626424108;8813;307;9762;9829;7.63;0.47;277.45;10.06;949;64;3370.00;67
8817;63;626424121;8817;308;9764;9829;7.56;0.46;277.43;10.07;947;64;3371.00;65
8818;63;626424132;8818;311;9764;9829;7.44;0.46;277.47;10.07;946;64;3372.00;65
8818;63;626424144;8818;315;9766;9829;7.34;0.45;277.47;10.09;948;64;3373.00;63
8822;63;626424155;8822;313;9770;9833;7.20;0.44;277.45;10.10;948;64;3374.00;63
8823;63;626424167;8823;318;9773;9835;7.12;0.44;277.43;10.11;950;64;3375.00;62
8825;63;626424178;8825;322;9774;9835;7.02;0.43;277.39;10.12;949;64;3376.00;61
8825;63;626424189;8825;326;9776;9836;6.99;0.43;277.39;10.12;951;64;3377.00;60
8826;63;626424200;8826;330;9777;9836;6.92;0.43;277.37;10.13;951;64;3378.00;59
8826;63;626424211;8826;330;9777;9836;6.94;0.43;277.37;10.13;951;64;3379.00;59
8830;63;626424221;8830;331;9779;9836;6.87;0.42;277.31;10.14;949;64;3380.00;57
8832;63;626424233;8832;326;9779;9836;6.85;0.42;277.28;10.14;947;64;3381.00;57
8834;63;626424244;8834;327;9780;9836;6.83;0.42;277.23;10.15;946;64;3382.00;56
8837;63;626424255;8837;330;9780;9836;6.76;0.42;277.16;10.15;943;64;3383.00;56
8841;63;626424265;8841;343;9817;9906;6.94;0.43;277.10;10.12;976;64;3384.00;89
8843;63;626424282;8843;343;9817;9907;6.87;0.42;277.05;10.12;974;64;3385.00;90
8844;63;626424294;8844;348;9831;9907;6.94;0.43;277.05;10.14;987;64;3386.00;76
8845;63;626424304;8845;347;9837;9907;6.92;0.43;277.02;10.14;992;64;3387.00;70
8846;63;626424316;8846;347;9842;9907;6.95;0.43;277.04;10.14;996;64;3388.00;65
8848;63;626424327;8848;350;9849;9907;6.94;0.43;277.00;10.15;1001;64;3389.00;58
8850;63;626424340;8850;359;9853;9907;6.92;0.42;277.00;10.15;1003;64;3390.00;54
8855;63;626424351;8855;366;9854;9907;6.76;0.41;276.94;10.15;999;64;3391.00;53
8857;63;626424363;8857;373;9858;9908;6.62;0.41;276.92;10.15;1001;64;3392.00;50
8860;63;626424374;8860;373;9859;9909;6.51;0.40;276.99;10.15;999;64;3393.00;50
8866;63;626424385;8866;376;9861;9909;6.31;0.39;276.87;10.16;995;64;3394.00;48
8868;63;626424403;8868;389;9864;9913;6.19;0.38;276.88;10.16;996;64;3395.00;49
8872;63;626424415;8872;397;9864;9913;6.03;0.37;276.86;10.16;992;64;3396.00;49
8873;63;626424425;8873;401;9865;9913;5.96;0.36;276.83;10.16;992;64;3397.00;48
8877;63;626424436;8877;414;9865;9913;5.76;0.35;276.85;10.16;988;64;3398.00;48
8879;63;626424446;8879;423;9871;9919;5.62;0.34;276.85;10.16;992;64;3399.00;48
8881;63;626424458;8881;414;9872;9919;5.49;0.34;276.90;10.16;991;64;3400.00;47
8883;63;626424474;8883;408;9872;9919;5.39;0.33;276.92;10.16;989;64;3401.00;47
8888;63;626424484;8888;406;9876;9922;5.29;0.32;276.91;10.16;988;64;3402.00;46
8890;63;626424496;8890;408;9876;9922;5.27;0.32;276.93;10.16;986;64;3403.00;46
8892;63;626424506;8892;415;9876;9922;5.21;0.32;276.92;10.16;984;64;3404.00;46
8897;63;626424516;8897;421;9877;9923;5.14;0.31;276.90;10.17;980;64;3405.00;46
8898;63;626424527;8898;425;9879;9924;5.16;0.31;276.90;10.17;981;64;3406.00;45
8902;63;626424537;8902;424;9880;9924;5.15;0.31;276.89;10.18;978;64;3407.00;44
8905;63;626424547;8905;418;9892;9937;5.19;0.32;276.91;10.16;987;64;3408.00;45
8906;63;626424559;8906;411;9892;9937;5.25;0.32;276.89;10.16;986;64;3409.00;45
8909;63;626424570;8909;411;9892;9937;5.25;0.32;276.90;10.16;983;64;3410.00;45
8911;63;626424581;8911;399;9893;9938;5.28;0.32;276.89;10.16;982;64;3411.00;45
8913;63;626424593;8913;386;9893;9938;5.37;0.33;276.85;10.16;980;64;3412.00;45
8915;63;626424603;8915;374;9896;9942;5.47;0.33;276.89;10.16;981;64;3413.00;46
8916;63;626424615;8916;362;9897;9942;5.55;0.34;276.90;10.16;981;64;3414.00;45
8919;63;626424626;8919;369;9900;9946;5.62;0.34;276.85;10.16;981;64;3415.00;46
8924;63;626424638;8924;373;9900;9946;5.68;0.35;276.90;10.16;976;64;3416.00;46
8925;64;626424650;8925;365;9900;9946;5.76;0.35;276.88;10.16;975;65;3417.00;46
8928;64;626424673;8928;363;9900;9946;5.82;0.36;276.87;10.16;972;65;3418.00;46
8930;64;626424685;8930;355;9900;9946;5.90;0.36;276.87;10.16;970;65;3419.00;46
8931;64;626424698;8931;358;9925;9980;6.20;0.38;276.86;10.13;994;65;3420.00;55
8932;64;626424713;8932;350;9925;9980;6.27;0.39;276.88;10.13;993;65;3421.00;55
8935;64;626424726;8935;346;9926;9980;6.35;0.39;276.84;10.13;991;65;3422.00;54
8938;64;626424738;8938;346;9926;9980;6.39;0.39;276.84;10.13;988;65;3423.00;54
8940;64;626424750;8940;346;9927;9980;6.48;0.40;276.82;10.13;987;65;3424.00;53
8943;64;626424762;8943;344;9927;9980;6.56;0.40;276.77;10.13;984;65;3425.00;53
8945;64;626424774;8945;347;9928;9981;6.61;0.41;276.80;10.13;983;65;3426.00;53
8949;64;626424786;8949;347;9928;9981;6.63;0.41;276.86;10.13;979;65;3427.00;53
8952;64;626424799;8952;340;9932;9987;6.64;0.41;276.84;10.13;980;65;3428.00;55
8956;64;626424812;8956;341;9934;9988;6.67;0.41;276.86;10.18;978;65;3429.00;54
8959;64;626424824;8959;342;9935;9988;6.69;0.41;276.88;10.18;976;65;3430.00;53
8961;64;626424837;8961;349;9936;9988;6.71;0.41;276.92;10.18;975;65;3431.00;52
8967;64;626424850;8967;350;9939;9992;6.72;0.41;276.98;10.17;972;65;3432.00;53
8970;64;626424863;8970;347;9939;9992;6.70;0.41;276.98;10.17;969;65;3433.00;53
8974;64;626424875;8974;348;9939;9992;6.74;0.41;276.94;10.17;965;65;3434.00;53
8978;64;626424887;8978;346;9940;9993;6.80;0.41;276.92;10.17;962;65;3435.00;53
8981;64;626424900;8981;342;9943;9997;6.88;0.42;276.99;10.17;962;65;3436.00;54
8983;64;626424913;8983;347;9944;9997;6.93;0.42;277.02;10.23;961;65;3437.00;53
8985;64;626424925;8985;348;9946;10000;7.06;0.43;277.00;10.22;961;65;3438.00;54
8987;64;626424946;8987;349;9947;10000;7.11;0.43;277.05;10.22;960;65;3439.00;53
8992;64;626424965;8992;348;9947;10000;7.12;0.43;277.08;10.22;955;65;3440.00;53
8996;64;626424997;8996;351;9947;10000;7.07;0.43;277.20;10.22;951;65;3441.00;53
8999;64;626425018;8999;352;9950;10004;6.99;0.43;277.25;10.22;951;65;3442.00;54
9005;64;626425037;9005;357;9950;10004;6.89;0.42;277.21;10.22;945;65;3443.00;54
9006;64;626425055;9006;363;9951;10004;6.87;0.42;277.20;10.22;945;65;3444.00;53
9011;64;626425070;9011;370;9951;10004;6.78;0.41;277.17;10.22;940;65;3445.00;53
9013;64;626425084;9013;372;9951;10005;6.71;0.41;277.24;10.22;938;65;3446.00;54
9016;64;626425099;9016;364;9952;10006;6.61;0.40;277.29;10.22;936;65;3447.00;54
9018;64;626425114;9018;365;9952;10006;6.57;0.40;277.32;10.22;934;65;3448.00;54
9021;64;626425127;9021;357;9953;10007;6.59;0.40;277.44;10.22;932;65;3449.00;54
9022;64;626425143;9022;353;9953;10007;6.64;0.40;277.49;10.22;931;65;3450.00;54
9025;64;626425156;9025;355;9953;10007;6.64;0.40;277.57;10.22;928;65;3451.00;54
9027;64;626425170;9027;350;9953;10007;6.70;0.41;277.59;10.22;926;65;3452.00;54
9031;64;626425184;9031;350;9953;10007;6.74;0.41;277.68;10.22;922;65;3453.00;54
9033;64;626425197;9033;348;9953;10007;6.76;0.41;277.69;10.22;920;65;3454.00;54
9036;64;626425217;9036;348;9954;10007;6.73;0.41;277.79;10.27;918;65;3455.00;53
9039;64;626425230;9039;350;10025;10134;6.95;0.43;277.89;10.20;986;65;3456.00;109
9042;64;626425254;9042;325;10027;10135;7.01;0.43;277.92;10.20;985;65;3457.00;108
9045;64;626425269;9045;303;10035;10135;7.17;0.44;277.96;10.19;990;65;3458.00;100
9049;64;626425282;9049;290;10036;10135;7.24;0.45;277.97;10.19;987;65;3459.00;99
9052;64;626425296;9052;286;10042;10135;7.37;0.45;278.03;10.19;990;65;3460.00;93
9057;64;626425317;9057;283;10045;10135;7.42;0.46;278.08;10.19;988;65;3461.00;90
9060;64;626425333;9060;289;10050;10135;7.51;0.46;278.13;10.19;990;65;3462.00;85
9064;64;626425347;9064;295;10054;10135;7.53;0.46;278.19;10.18;990;65;3463.00;81
9066;64;626425361;9066;288;10059;10136;7.56;0.46;278.19;10.18;993;65;3464.00;77
9070;64;626425375;9070;297;10062;10138;7.53;0.46;278.24;10.18;992;65;3465.00;76
9073;64;626425390;9073;299;10065;10138;7.51;0.46;278.29;10.18;992;65;3466.00;73
9076;64;626425404;9076;302;10067;10139;7.48;0.46;278.30;10.18;991;65;3467.00;72
9080;64;626425418;9080;302;10069;10139;7.50;0.46;278.33;10.18;989;65;3468.00;70
9084;64;626425433;9084;302;10070;10139;7.50;0.46;278.40;10.18;986;65;3469.00;69
9084;64;626425449;9084;302;10072;10139;7.57;0.46;278.40;10.18;988;65;3470.00;67
9085;64;626425463;9085;302;10075;10143;7.60;0.47;278.40;10.18;990;65;3471.00;68
9087;64;626425486;9087;309;10077;10143;7.61;0.47;278.41;10.18;990;65;3472.00;66
9091;64;626425507;9091;308;10078;10143;7.61;0.47;278.48;10.18;987;65;3473.00;65
9094;64;626425522;9094;299;10081;10146;7.65;0.47;278.62;10.18;987;65;3474.00;65
9095;64;626425536;9095;292;10081;10146;7.67;0.47;278.65;10.18;986;65;3475.00;65
9103;64;626425550;9103;288;10082;10146;7.63;0.47;278.66;10.18;979;65;3476.00;64
9103;64;626425565;9103;284;10085;10150;7.63;0.47;278.66;10.17;982;65;3477.00;65
9107;64;626425585;9107;285;10086;10151;7.60;0.46;278.69;10.17;979;65;3478.00;65
9108;64;626425600;9108;292;10086;10151;7.60;0.46;278.73;10.17;978;65;3479.00;65
9110;64;626425615;9110;290;10090;10156;7.65;0.47;278.72;10.17;980;65;3480.00;66
9113;64;626425630;9113;291;10091;10156;7.63;0.47;278.79;10.23;978;65;3481.00;65
9113;64;626425645;9113;293;10091;10156;7.61;0.46;278.79;10.23;978;65;3482.00;65
9115;64;626425659;9115;298;10092;10157;7.54;0.46;278.78;10.23;977;65;3483.00;65
9118;64;626425672;9118;295;10092;10157;7.52;0.46;278.86;10.23;974;65;3484.00;65
9121;64;626425685;9121;301;10096;10163;7.48;0.46;278.84;10.22;975;65;3485.00;67
9123;64;626425699;9123;302;10097;10163;7.51;0.46;278.84;10.22;974;65;3486.00;66
9127;64;626425713;9127;308;10097;10164;7.53;0.46;278.85;10.22;970;65;3487.00;67
9129;64;626425726;9129;305;10097;10164;7.52;0.46;278.94;10.22;968;65;3488.00;67
9130;64;626425740;9130;307;10097;10164;7.51;0.46;278.94;10.22;967;65;3489.00;67
9130;64;626425753;9130;298;10097;10164;7.54;0.46;278.94;10.22;967;65;3490.00;67
9132;64;626425766;9132;299;10097;10164;7.57;0.46;278.91;10.22;965;65;3491.00;67
9132;64;626425779;9132;286;10106;10176;7.60;0.46;278.91;10.21;974;65;3492.00;70
9132;64;626425793;9132;279;10106;10176;7.63;0.46;278.91;10.21;974;65;3493.00;70
9134;64;626425806;9134;269;10108;10176;7.68;0.47;278.87;10.21;974;65;3494.00;68
9136;64;626425819;9136;267;10108;10176;7.64;0.46;278.90;10.21;972;65;3495.00;68
9138;64;626425832;9138;268;10108;10176;7.65;0.47;279.02;10.21;970;65;3496.00;68
9142;64;626425847;9142;272;10108;10176;7.65;0.47;279.05;10.21;966;65;3497.00;68
9144;64;626425860;9144;276;10111;10180;7.66;0.47;279.07;10.21;967;65;3498.00;69
9146;64;626425874;9146;276;10111;10180;7.63;0.46;279.09;10.21;965;65;3499.00;69
9149;64;626425888;9149;267;10114;10184;7.61;0.46;279.11;10.21;965;65;3500.00;70
9154;64;626425911;9154;263;10116;10185;7.53;0.46;279.31;10.21;962;65;3501.00;69
9156;64;626425925;9156;258;10116;10185;7.44;0.45;279.30;10.21;960;65;3502.00;69
9159;64;626425937;9159;252;10117;10185;7.34;0.44;279.34;10.27;958;65;3503.00;68
9164;64;626425951;9164;247;10127;10198;7.27;0.44;279.44;10.26;963;65;3504.00;71
9167;64;626425965;9167;243;10128;10198;7.22;0.44;279.48;10.27;961;65;3505.00;70
9171;64;626425980;9171;231;10128;10198;7.21;0.43;279.52;10.27;957;65;3506.00;70
9173;64;626425992;9173;236;10129;10199;7.25;0.44;279.54;10.27;956;65;3507.00;70
9174;64;626426004;9174;235;10129;10200;7.27;0.44;279.55;10.27;955;65;3508.00;71
9177;64;626426016;9177;234;10129;10200;7.25;0.44;279.62;10.27;952;65;3509.00;71
9181;64;626426029;9181;233;10132;10206;7.21;0.44;279.60;10.26;951;65;3510.00;74
9183;64;626426041;9183;235;10133;10206;7.24;0.44;279.63;10.26;950;65;3511.00;73
9184;64;626426053;9184;231;10134;10206;7.31;0.44;279.65;10.26;950;65;3512.00;72
9188;64;626426064;9188;228;10134;10206;7.30;0.44;279.66;10.26;946;65;3513.00;72
9190;64;626426076;9190;221;10138;10212;7.39;0.45;279.72;10.26;948;65;3514.00;74
9192;64;626426088;9192;214;10138;10212;7.35;0.45;279.68;10.26;946;65;3515.00;74
9197;64;626426100;9197;213;10140;10212;7.32;0.44;279.74;10.26;943;65;3516.00;72
9197;64;626426118;9197;215;10141;10212;7.30;0.44;279.74;10.26;944;65;3517.00;71
9197;64;626426129;9197;220;10144;10216;7.33;0.44;279.74;10.26;947;65;3518.00;72
9199;64;626426141;9199;222;10148;10219;7.30;0.44;279.79;10.31;949;65;3519.00;71
9199;64;626426153;9199;219;10149;10219;7.29;0.44;279.79;10.32;950;65;3520.00;70
9201;64;626426164;9201;221;10150;10220;7.27;0.44;279.79;10.32;949;65;3521.00;70
9206;64;626426176;9206;228;10150;10220;7.21;0.44;279.82;10.32;944;65;3522.00;70
9208;64;626426188;9208;235;10150;10220;7.15;0.43;279.82;10.32;942;65;3523.00;70
9210;64;626426199;9210;240;10151;10220;7.15;0.43;279.91;10.38;941;65;3524.00;69
9212;64;626426211;9212;247;10151;10220;7.14;0.43;279.92;10.38;939;65;3525.00;69
9216;64;626426222;9216;258;10151;10220;7.07;0.43;280.00;10.38;935;65;3526.00;69
9217;64;626426234;9217;261;10152;10220;7.05;0.43;280.06;10.39;935;65;3527.00;68
9218;64;626426246;9218;276;10188;10290;7.20;0.44;280.05;10.36;970;65;3528.00;102
9219;64;626426263;9219;273;10191;10291;7.10;0.43;280.03;10.36;972;65;3529.00;100
9221;64;626426275;9221;272;10199;10291;7.10;0.43;280.01;10.35;978;65;3530.00;92
9224;64;626426287;9224;283;10203;10291;7.04;0.43;279.96;10.37;979;65;3531.00;88
9226;64;626426299;9226;282;10209;10291;7.05;0.43;279.91;10.37;983;65;3532.00;82
9228;64;626426311;9228;285;10211;10291;7.05;0.43;279.88;10.37;983;65;3533.00;80
9231;64;626426323;9231;292;10214;10291;6.96;0.42;279.83;10.39;983;65;3534.00;77
9232;64;626426335;9232;294;10218;10291;6.98;0.43;279.81;10.39;986;65;3535.00;73
9233;64;626426347;9233;303;10219;10292;6.91;0.42;279.78;10.39;986;65;3536.00;73
9234;64;626426365;9234;309;10225;10293;6.92;0.42;279.76;10.41;991;65;3537.00;68
9234;64;626426377;9234;311;10226;10293;6.92;0.42;279.76;10.41;992;65;3538.00;67
9238;64;626426389;9238;318;10232;10297;6.87;0.42;279.75;10.43;994;65;3539.00;65
9239;64;626426403;9239;320;10233;10297;6.76;0.41;279.77;10.44;994;65;3540.00;64
9241;64;626426415;9241;329;10233;10297;6.67;0.41;279.75;10.44;992;65;3541.00;64
9241;64;626426427;9241;335;10234;10297;6.60;0.41;279.75;10.44;993;65;3542.00;63
9242;64;626426439;9242;344;10239;10303;6.60;0.41;279.75;10.45;997;65;3543.00;64
9243;64;626426450;9243;348;10241;10303;6.47;0.40;279.73;10.45;998;65;3544.00;62
9248;64;626426462;9248;360;10242;10303;6.33;0.39;279.81;10.46;994;65;3545.00;61
9250;64;626426474;9250;366;10246;10306;6.26;0.38;279.77;10.46;996;65;3546.00;60
9252;64;626426492;9252;371;10247;10306;6.14;0.38;279.74;10.47;995;65;3547.00;59
9253;64;626426503;9253;378;10248;10306;6.03;0.37;279.72;10.47;995;65;3548.00;58
9255;64;626426515;9255;378;10249;10307;5.92;0.36;279.71;10.48;994;65;3549.00;58
9255;64;626426527;9255;385;10250;10308;5.87;0.36;279.71;10.48;995;65;3550.00;58
9258;64;626426538;9258;381;10251;10308;5.81;0.36;279.67;10.50;993;65;3551.00;57
9258;64;626426549;9258;383;10263;10321;5.79;0.36;279.67;10.48;1005;65;3552.00;58
9258;64;626426563;9258;382;10264;10321;5.75;0.35;279.67;10.49;1006;65;3553.00;57
9261;64;626426574;9261;380;10264;10321;5.70;0.35;279.65;10.49;1003;65;3554.00;57
9263;64;626426586;9263;391;10267;10323;5.68;0.35;279.60;10.50;1004;65;3555.00;56
9266;64;626426597;9266;389;10267;10323;5.64;0.35;279.56;10.50;1001;65;3556.00;56
9269;64;626426608;9269;401;10270;10327;5.63;0.34;279.54;10.50;1001;65;3557.00;57
9270;64;626426622;9270;406;10273;10327;5.61;0.34;279.57;10.53;1003;65;3558.00;54
9270;64;626426632;9270;404;10277;10331;5.65;0.35;279.57;10.52;1007;65;3559.00;54
9273;64;626426643;9273;403;10278;10331;5.61;0.34;279.52;10.53;1005;65;3560.00;53
9278;64;626426654;9278;406;10278;10331;5.48;0.33;279.46;10.53;1000;65;3561.00;53
9279;64;626426665;9279;409;10279;10331;5.36;0.33;279.46;10.54;1000;65;3562.00;52
9281;64;626426675;9281;399;10280;10331;5.25;0.32;279.47;10.55;999;65;3563.00;51
9284;64;626426686;9284;389;10290;10343;5.27;0.32;279.49;10.54;1006;65;3564.00;53
9287;64;626426697;9287;381;10294;10343;5.22;0.32;279.46;10.56;1007;65;3565.00;49
9291;64;626426708;9291;378;10294;10343;5.13;0.31;279.48;10.56;1003;65;3566.00;49
9292;64;626426719;9292;370;10294;10343;5.08;0.31;279.48;10.56;1002;65;3567.00;49
9295;64;626426729;9295;379;10295;10343;4.98;0.30;279.47;10.57;1000;65;3568.00;48
9299;64;626426739;9299;384;10295;10343;4.86;0.30;279.49;10.57;996;65;3569.00;48
9301;64;626426757;9301;371;10298;10344;4.88;0.30;279.60;10.59;997;65;3570.00;46
9305;64;626426768;9305;358;10298;10344;4.92;0.30;279.58;10.59;993;65;3571.00;46
9309;64;626426779;9309;352;10302;10350;5.06;0.31;279.58;10.59;993;65;3572.00;48
9312;64;626426790;9312;352;10306;10351;5.13;0.31;279.55;10.59;994;65;3573.00;45
9316;64;626426801;9316;342;10306;10351;5.18;0.32;279.50;10.59;990;65;3574.00;45
9318;64;626426812;9318;349;10307;10351;5.23;0.32;279.49;10.59;989;65;3575.00;44
9319;64;626426823;9319;346;10310;10355;5.39;0.33;279.48;10.59;991;65;3576.00;45
9322;64;626426834;9322;340;10312;10355;5.46;0.33;279.48;10.60;990;65;3577.00;43
9323;64;626426845;9323;337;10312;10355;5.55;0.34;279.50;10.60;989;65;3578.00;43
9324;64;626426856;9324;334;10313;10356;5.71;0.35;279.51;10.60;989;65;3579.00;43
9326;64;626426868;9326;332;10316;10360;5.80;0.35;279.53;10.59;990;65;3580.00;44
9327;64;626426880;9327;321;10316;10360;5.89;0.36;279.55;10.59;989;65;3581.00;44
9330;64;626426891;9330;331;10318;10363;5.96;0.36;279.57;10.59;988;65;3582.00;45
9332;64;626426903;9332;321;10319;10363;6.00;0.37;279.56;10.59;987;65;3583.00;44
9336;64;626426914;9336;314;10319;10363;6.06;0.37;279.56;10.59;983;65;3584.00;44
9340;64;626426926;9340;318;10319;10363;6.18;0.38;279.55;10.59;979;65;3585.00;44
9342;64;626426938;9342;307;10322;10367;6.29;0.38;279.62;10.59;980;65;3586.00;45
9347;64;626426955;9347;304;10322;10367;6.37;0.39;279.68;10.59;975;65;3587.00;45
9349;64;626426974;9349;308;10323;10367;6.47;0.40;279.65;10.59;974;65;3588.00;44
9355;64;626426992;9355;304;10323;10367;6.46;0.39;279.71;10.59;968;65;3589.00;44
9358;64;626427018;9358;302;10323;10368;6.49;0.40;279.70;10.59;965;65;3590.00;45
9364;64;626427036;9364;299;10324;10369;6.48;0.40;279.82;10.59;960;65;3591.00;45
9370;64;626427057;9370;298;10324;10369;6.53;0.40;279.85;10.59;954;65;3592.00;45
9372;64;626427072;9372;290;10325;10370;6.62;0.40;279.90;10.58;953;65;3593.00;45
9377;64;626427085;9377;281;10325;10370;6.62;0.40;279.91;10.58;948;65;3594.00;45
9382;64;626427099;9382;277;10325;10370;6.61;0.41;280.00;10.58;943;65;3595.00;45
9386;64;626427112;9386;272;10325;10370;6.68;0.41;279.99;10.58;939;65;3596.00;45
9391;64;626427126;9391;269;10326;10370;6.74;0.41;280.05;10.65;935;65;3597.00;44
9392;64;626427138;9392;268;10326;10370;6.91;0.42;280.04;10.65;934;65;3598.00;44
9398;64;626427151;9398;265;10326;10370;6.97;0.43;280.13;10.65;928;65;3599.00;44
9403;64;626427166;9403;298;10439;10623;7.27;0.46;280.07;10.54;1036;65;3600.00;184
9406;64;626427205;9406;296;10445;10624;7.31;0.46;280.18;10.53;1039;65;3601.00;179
9414;64;626427221;9414;291;10458;10624;7.36;0.46;280.25;10.52;1044;65;3602.00;166
9416;64;626427240;9416;285;10465;10624;7.42;0.47;280.28;10.52;1049;65;3603.00;159
9420;64;626427255;9420;291;10470;10624;7.45;0.47;280.30;10.51;1050;65;3604.00;154
9427;64;626427269;9427;292;10474;10624;7.44;0.47;280.39;10.51;1047;65;3605.00;150
9430;64;626427283;9430;297;10484;10624;7.44;0.47;280.35;10.51;1054;65;3606.00;140
9436;64;626427304;9436;303;10491;10624;7.41;0.46;280.41;10.57;1055;65;3607.00;133
9440;64;626427319;9440;307;10494;10625;7.37;0.46;280.45;10.57;1054;65;3608.00;131
9445;64;626427334;9445;311;10498;10626;7.36;0.46;280.49;10.57;1053;65;3609.00;128
9451;64;626427349;9451;314;10501;10626;7.26;0.45;280.52;10.57;1050;65;3610.00;125
9456;64;626427364;9456;325;10506;10627;7.20;0.45;280.52;10.57;1050;65;3611.00;121
9462;64;626427378;9462;325;10511;10627;7.15;0.44;280.55;10.57;1049;65;3612.00;116
9463;64;626427399;9463;338;10514;10627;7.15;0.44;280.54;10.57;1051;65;3613.00;113
9465;64;626427414;9465;348;10517;10627;7.11;0.44;280.60;10.57;1052;65;3614.00;110
9466;64;626427428;9466;351;10522;10631;7.09;0.44;280.65;10.57;1056;65;3615.00;109
9471;64;626427444;9471;354;10524;10631;7.00;0.43;280.78;10.57;1053;65;3616.00;107
9477;65;626427459;9477;343;10526;10631;6.96;0.43;280.84;10.57;1049;66;3617.00;105
9480;65;626427496;9480;336;10528;10634;6.96;0.43;280.84;10.57;1048;66;3618.00;106
9482;65;626427512;9482;331;10529;10634;6.99;0.43;280.86;10.57;1047;66;3619.00;105
9485;65;626427527;9485;328;10529;10634;7.08;0.43;280.94;10.57;1044;66;3620.00;105
9489;65;626427543;9489;321;10534;10638;7.17;0.44;280.97;10.57;1045;66;3621.00;104
9492;66;626427560;9492;317;10538;10639;7.28;0.45;281.00;10.57;1046;67;3622.00;101
9498;66;626427588;9498;318;10539;10639;7.34;0.45;281.05;10.57;1041;67;3623.00;100
9498;66;626427604;9498;321;10543;10643;7.40;0.45;281.05;10.57;1045;67;3624.00;100
9502;66;626427634;9502;320;10543;10643;7.43;0.45;281.07;10.57;1041;67;3625.00;100
9504;66;626427650;9504;310;10546;10643;7.49;0.46;281.10;10.58;1042;67;3626.00;97
9508;66;626427671;9508;302;10549;10644;7.49;0.46;281.17;10.57;1041;67;3627.00;95
9510;66;626427687;9510;292;10549;10644;7.58;0.46;281.24;10.57;1039;67;3628.00;95
9512;66;626427702;9512;289;10553;10650;7.61;0.46;281.27;10.57;1041;67;3629.00;97
9515;66;626427720;9515;286;10554;10650;7.61;0.46;281.32;10.58;1039;67;3630.00;96
9517;66;626427736;9517;280;10554;10651;7.65;0.47;281.32;10.58;1037;67;3631.00;97
9520;66;626427752;9520;289;10555;10651;7.64;0.47;281.30;10.58;1035;67;3632.00;96
9525;66;626427768;9525;290;10556;10651;7.58;0.46;281.31;10.58;1031;67;3633.00;95
9527;66;626427783;9527;294;10559;10651;7.52;0.46;281.34;10.64;1032;67;3634.00;92
9530;66;626427798;9530;299;10559;10651;7.45;0.45;281.43;10.64;1029;67;3635.00;92
9537;66;626427813;9537;302;10571;10663;7.40;0.45;281.49;10.69;1034;67;3636.00;92
9539;66;626427831;9539;296;10571;10663;7.37;0.45;281.55;10.69;1032;67;3637.00;92
9543;66;626427847;9543;290;10571;10663;7.36;0.45;281.57;10.69;1028;67;3638.00;92
9544;66;626427865;9544;285;10571;10663;7.37;0.45;281.58;10.69;1027;67;3639.00;92
9548;66;626427882;9548;289;10573;10663;7.33;0.45;281.64;10.69;1025;67;3640.00;90
9552;66;626427899;9552;292;10573;10663;7.34;0.45;281.61;10.69;1021;67;3641.00;90
9554;66;626427916;9554;283;10577;10667;7.27;0.44;281.57;10.69;1023;67;3642.00;90
9556;66;626427932;9556;282;10577;10667;7.25;0.44;281.54;10.69;1021;67;3643.00;90
9558;66;626427947;9558;287;10580;10671;7.22;0.44;281.52;10.69;1022;67;3644.00;91
9558;66;626427962;9558;290;10582;10673;7.25;0.44;281.52;10.68;1024;67;3645.00;91
9560;66;626427977;9560;298;10583;10673;7.23;0.44;281.49;10.68;1023;67;3646.00;90
9562;66;626427990;9562;298;10583;10673;7.19;0.44;281.53;10.68;1021;67;3647.00;90
9565;66;626428003;9565;303;10593;10686;7.25;0.44;281.54;10.68;1028;67;3648.00;93
9566;66;626428018;9566;307;10594;10686;7.31;0.44;281.53;10.68;1028;67;3649.00;92
9569;66;626428031;9569;303;10594;10686;7.31;0.44;281.51;10.68;1025;67;3650.00;92
9571;66;626428044;9571;303;10595;10687;7.32;0.45;281.52;10.68;1024;67;3651.00;92
9573;66;626428057;9573;308;10595;10688;7.30;0.44;281.63;10.68;1022;67;3652.00;93
9574;66;626428069;9574;305;10595;10688;7.26;0.44;281.66;10.68;1021;67;3653.00;93
9575;66;626428082;9575;307;10598;10691;7.25;0.44;281.66;10.73;1023;67;3654.00;93
9578;66;626428095;9578;312;10598;10691;7.20;0.44;281.62;10.73;1020;67;3655.00;93
9580;66;626428108;9580;305;10599;10691;7.12;0.44;281.67;10.73;1019;67;3656.00;92
9581;66;626428121;9581;311;10599;10691;7.08;0.43;281.66;10.73;1018;67;3657.00;92
9583;66;626428133;9583;307;10603;10697;7.09;0.43;281.77;10.73;1020;67;3658.00;94
9585;66;626428146;9585;304;10603;10697;7.00;0.43;281.83;10.73;1018;67;3659.00;94
9588;66;626428161;9588;297;10604;10697;6.94;0.43;281.82;10.73;1016;67;3660.00;93
9588;66;626428174;9588;293;10604;10697;6.91;0.42;281.82;10.73;1016;67;3661.00;93
9591;66;626428187;9591;286;10607;10701;6.85;0.42;281.77;10.72;1016;67;3662.00;94
9595;66;626428199;9595;285;10608;10702;6.81;0.42;281.77;10.72;1013;67;3663.00;94
9597;66;626428212;9597;276;10608;10702;6.81;0.42;281.79;10.72;1011;67;3664.00;94
9599;66;626428224;9599;272;10609;10703;6.80;0.42;281.79;10.72;1010;67;3665.00;94
9601;66;626428236;9601;273;10609;10703;6.76;0.41;281.77;10.72;1008;67;3666.00;94
9603;66;626428248;9603;272;10609;10703;6.72;0.41;281.78;10.72;1006;67;3667.00;94
9608;66;626428260;9608;276;10610;10703;6.65;0.41;281.89;10.73;1002;67;3668.00;93
9611;66;626428272;9611;273;10611;10703;6.63;0.41;281.91;10.78;1000;67;3669.00;92
9613;66;626428290;9613;269;10611;10703;6.59;0.40;281.93;10.78;998;67;3670.00;92
9616;66;626428302;9616;270;10611;10703;6.48;0.40;281.94;10.78;995;67;3671.00;92
9617;66;626428313;9617;279;10642;10773;6.56;0.40;281.93;10.75;1025;67;3672.00;131
9621;66;626428330;9621;270;10643;10774;6.53;0.40;281.90;10.81;1022;67;3673.00;131
9626;66;626428342;9626;274;10651;10774;6.56;0.40;281.92;10.81;1025;67;3674.00;123
9627;66;626428354;9627;268;10657;10774;6.57;0.40;281.99;10.89;1030;67;3675.00;117
9630;66;626428368;9630;259;10663;10774;6.53;0.40;281.98;10.88;1033;67;3676.00;111
9632;66;626428379;9632;262;10668;10774;6.55;0.40;281.97;10.93;1036;67;3677.00;106
9635;66;626428392;9635;260;10670;10774;6.55;0.40;281.98;10.93;1035;67;3678.00;104
9639;66;626428404;9639;260;10671;10774;6.57;0.40;281.92;10.93;1032;67;3679.00;103
9640;66;626428416;9640;253;10674;10775;6.61;0.40;281.90;10.98;1034;67;3680.00;101
9644;66;626428428;9644;253;10675;10776;6.63;0.40;281.88;10.98;1031;67;3681.00;101
9644;66;626428441;9644;250;10677;10776;6.63;0.40;281.88;11.03;1033;67;3682.00;99
9645;66;626428452;9645;258;10680;10780;6.67;0.41;281.86;11.02;1035;67;3683.00;100
9647;66;626428465;9647;251;10681;10780;6.64;0.40;281.84;11.07;1034;67;3684.00;99
9649;66;626428477;9649;253;10681;10780;6.57;0.40;281.81;11.07;1032;67;3685.00;99
9649;66;626428490;9649;259;10681;10780;6.53;0.40;281.81;11.07;1032;67;3686.00;99
9651;66;626428502;9651;259;10686;10786;6.55;0.40;281.77;11.12;1035;67;3687.00;100
9652;66;626428515;9652;261;10687;10786;6.51;0.40;281.74;11.11;1035;67;3688.00;99
9654;66;626428527;9654;266;10687;10786;6.45;0.39;281.72;11.11;1033;67;3689.00;99
9658;66;626428541;9658;272;10691;10792;6.42;0.39;281.65;11.12;1033;67;3690.00;101
9660;66;626428553;9660;268;10692;10792;6.39;0.39;281.63;11.12;1032;67;3691.00;100
9662;66;626428566;9662;275;10694;10792;6.40;0.39;281.60;11.12;1032;67;3692.00;98
9664;66;626428578;9664;284;10696;10793;6.37;0.39;281.56;11.13;1032;67;3693.00;97
9666;66;626428590;9666;296;10699;10794;6.40;0.39;281.59;11.13;1033;67;3694.00;95
9668;66;626428603;9668;292;10701;10794;6.34;0.39;281.55;11.14;1033;67;3695.00;93
9670;66;626428615;9670;299;10710;10807;6.35;0.39;281.50;11.13;1040;67;3696.00;97
9671;66;626428629;9671;300;10713;10807;6.32;0.38;281.51;11.14;1042;67;3697.00;94
9672;66;626428641;9672;314;10715;10807;6.29;0.38;281.48;11.15;1043;67;3698.00;92
9676;66;626428653;9676;313;10717;10808;6.22;0.38;281.45;11.15;1041;67;3699.00;91
9676;66;626428666;9676;314;10720;10808;6.18;0.38;281.45;11.17;1044;67;3700.00;88
9681;66;626428683;9681;326;10724;10812;6.13;0.37;281.40;11.17;1043;67;3701.00;88
9683;66;626428698;9683;322;10725;10812;6.11;0.37;281.37;11.17;1042;67;3702.00;87
9686;66;626428711;9686;336;10730;10816;6.09;0.37;281.31;11.19;1044;67;3703.00;86
9690;66;626428725;9690;337;10730;10816;6.09;0.37;281.33;11.19;1040;67;3704.00;86
9691;66;626428737;9691;343;10732;10816;6.09;0.37;281.32;11.21;1041;67;3705.00;84
9692;66;626428750;9692;351;10733;10816;6.06;0.37;281.29;11.22;1041;67;3706.00;83
9694;66;626428761;9694;357;10734;10816;6.05;0.37;281.38;11.24;1040;67;3707.00;82
9695;66;626428773;9695;364;10743;10828;6.12;0.37;281.42;11.23;1048;67;3708.00;85
9699;66;626428786;9699;369;10746;10828;6.13;0.37;281.38;11.25;1047;67;3709.00;82
9700;66;626428798;9700;376;10748;10828;6.08;0.37;281.39;11.26;1048;67;3710.00;80
9700;66;626428810;9700;383;10753;10828;6.00;0.37;281.39;11.29;1053;67;3711.00;75
9701;66;626428822;9701;386;10755;10828;5.92;0.36;281.38;11.31;1054;67;3712.00;73
9702;66;626428834;9702;391;10756;10828;5.88;0.36;281.37;11.31;1054;67;3713.00;72
9704;66;626428846;9704;398;10758;10829;5.85;0.36;281.37;11.33;1054;67;3714.00;71
9704;66;626428858;9704;393;10759;10829;5.84;0.36;281.37;11.33;1055;67;3715.00;70
9706;66;626428870;9706;386;10766;10835;5.84;0.36;281.37;11.35;1060;67;3716.00;69
9706;66;626428883;9706;380;10770;10836;5.86;0.36;281.37;11.36;1064;67;3717.00;66
9707;66;626428895;9707;386;10770;10836;5.87;0.36;281.38;11.36;1063;67;3718.00;66
9709;66;626428906;9709;371;10772;10836;5.87;0.36;281.33;11.38;1063;67;3719.00;64
9712;66;626428920;9712;362;10776;10841;5.89;0.36;281.29;11.37;1064;67;3720.00;65
9712;66;626428933;9712;360;10777;10841;5.90;0.36;281.29;11.38;1065;67;3721.00;64
9713;66;626428957;9713;356;10778;10841;5.93;0.36;281.27;11.39;1065;67;3722.00;63
9714;66;626428978;9714;352;10780;10842;5.99;0.36;281.29;11.40;1066;67;3723.00;62
9715;66;626429002;9715;343;10784;10846;6.03;0.37;281.27;11.41;1069;67;3724.00;62
9715;66;626429023;9715;337;10784;10846;6.12;0.37;281.27;11.41;1069;67;3725.00;62
9716;66;626429040;9716;335;10786;10849;6.26;0.38;281.25;11.40;1070;67;3726.00;63
9717;66;626429058;9717;328;10787;10849;6.35;0.39;281.24;11.40;1070;67;3727.00;62
9719;66;626429074;9719;328;10791;10849;6.39;0.39;281.33;11.44;1072;67;3728.00;58
9719;66;626429088;9719;338;10791;10849;6.46;0.39;281.33;11.44;1072;67;3729.00;58
9720;66;626429102;9720;343;10796;10853;6.49;0.40;281.31;11.45;1076;67;3730.00;57
9722;66;626429125;9722;348;10798;10853;6.46;0.39;281.27;11.45;1076;67;3731.00;55
9726;66;626429139;9726;347;10799;10853;6.35;0.39;281.26;11.46;1073;67;3732.00;54
9727;66;626429152;9727;347;10800;10853;6.26;0.38;281.28;11.46;1073;67;3733.00;53
9729;66;626429165;9729;347;10800;10854;6.17;0.38;281.28;11.46;1071;67;3734.00;54
9735;66;626429186;9735;357;10803;10856;6.02;0.37;281.29;11.46;1068;67;3735.00;53
9736;66;626429210;9736;356;10805;10856;5.91;0.36;281.28;11.47;1069;67;3736.00;51
9740;66;626429223;9740;361;10806;10857;5.81;0.35;281.34;11.47;1066;67;3737.00;51
9745;66;626429235;9745;368;10807;10857;5.77;0.35;281.31;11.48;1062;67;3738.00;50
9746;66;626429247;9746;371;10808;10857;5.75;0.35;281.30;11.48;1062;67;3739.00;49
9751;66;626429258;9751;364;10808;10857;5.67;0.35;281.29;11.48;1057;67;3740.00;49
9754;66;626429271;9754;352;10809;10857;5.66;0.35;281.34;11.48;1055;67;3741.00;48
9756;66;626429283;9756;358;10809;10857;5.65;0.35;281.38;11.48;1053;67;3742.00;48
9760;66;626429295;9760;356;10809;10857;5.59;0.34;281.49;11.48;1049;67;3743.00;48
9765;66;626429307;9765;376;10875;10984;5.86;0.36;281.59;11.42;1110;67;3744.00;109
9767;66;626429330;9767;370;10877;10985;5.90;0.37;281.58;11.42;1110;67;3745.00;108
9770;66;626429344;9770;363;10886;10985;6.01;0.37;281.62;11.41;1116;67;3746.00;99
9775;66;626429357;9775;364;10893;10985;6.05;0.38;281.77;11.40;1118;67;3747.00;92
9777;66;626429371;9777;358;10900;10985;6.15;0.38;281.81;11.40;1123;67;3748.00;85
9781;66;626429385;9781;353;10903;10985;6.17;0.38;281.87;11.40;1122;67;3749.00;82
9782;66;626429400;9782;350;10908;10990;6.24;0.39;281.87;11.39;1126;67;3750.00;82
9786;66;626429414;9786;351;10912;10990;6.24;0.39;281.93;11.39;1126;67;3751.00;78
9789;66;626429437;9789;342;10918;10991;6.33;0.39;281.94;11.39;1129;67;3752.00;73
9793;66;626429451;9793;341;10920;10992;6.35;0.39;282.02;11.39;1127;67;3753.00;72
9797;66;626429466;9797;339;10923;10992;6.46;0.40;282.13;11.39;1126;67;3754.00;69
9801;66;626429481;9801;340;10924;10993;6.54;0.40;282.20;11.39;1123;67;3755.00;69
9806;66;626429497;9806;339;10925;10993;6.63;0.41;282.24;11.39;1119;67;3756.00;68
9810;66;626429512;9810;344;10926;10993;6.63;0.41;282.38;11.39;1116;67;3757.00;67
9814;66;626429527;9814;343;10929;10993;6.70;0.41;282.45;11.39;1115;67;3758.00;64
9818;66;626429542;9818;342;10932;10997;6.72;0.41;282.51;11.39;1114;67;3759.00;65
9824;66;626429557;9824;341;10934;10997;6.67;0.41;282.59;11.39;1110;67;3760.00;63
9827;66;626429573;9827;333;10934;10997;6.69;0.41;282.63;11.39;1107;67;3761.00;63
9831;66;626429588;9831;329;10937;11000;6.75;0.41;282.73;11.39;1106;67;3762.00;63
9836;66;626429604;9836;323;10938;11000;6.75;0.42;282.86;11.39;1102;67;3763.00;62
9841;66;626429620;9841;325;10939;11000;6.77;0.42;282.89;11.39;1098;67;3764.00;61
9847;66;626429635;9847;326;10942;11004;6.78;0.42;282.91;11.38;1095;67;3765.00;62
9851;66;626429651;9851;328;10943;11005;6.81;0.42;282.92;11.38;1092;67;3766.00;62
9854;66;626429666;9854;332;10943;11005;6.80;0.42;282.88;11.38;1089;67;3767.00;62
9858;66;626429681;9858;337;10946;11009;6.85;0.42;282.93;11.38;1088;67;3768.00;63
9862;66;626429696;9862;339;10946;11009;6.84;0.42;282.93;11.38;1084;67;3769.00;63
9868;66;626429712;9868;336;10947;11009;6.83;0.42;282.94;11.38;1079;67;3770.00;62
9871;66;626429727;9871;338;10948;11010;6.84;0.42;282.97;11.38;1077;67;3771.00;62
9874;66;626429742;9874;341;10948;11010;6.87;0.42;283.02;11.38;1074;67;3772.00;62
9878;66;626429756;9878;342;10953;11016;6.87;0.42;283.02;11.38;1075;67;3773.00;63
9882;67;626429772;9882;350;10953;11016;6.90;0.42;282.98;11.38;1071;68;3774.00;63
9889;67;626429801;9889;348;10954;11017;6.86;0.42;283.01;11.38;1065;68;3775.00;63
9894;67;626429817;9894;345;10955;11017;6.79;0.41;283.05;11.38;1061;68;3776.00;62
9899;67;626429833;9899;351;10955;11017;6.77;0.41;283.10;11.38;1056;68;3777.00;62
9903;67;626429847;9903;346;10956;11017;6.76;0.41;283.16;11.38;1053;68;3778.00;61
9908;67;626429868;9908;345;10956;11017;6.75;0.41;283.27;11.38;1048;68;3779.00;61
9915;67;626429885;9915;354;10980;11053;6.82;0.42;283.28;11.35;1065;68;3780.00;73
9921;67;626429903;9921;351;10982;11053;6.76;0.41;283.35;11.35;1061;68;3781.00;71
9923;67;626429925;9923;350;10984;11053;6.73;0.41;283.37;11.35;1061;68;3782.00;69
9924;67;626429942;9924;350;10984;11053;6.79;0.42;283.37;11.35;1060;68;3783.00;69
9925;67;626429957;9925;355;10985;11053;6.78;0.41;283.36;11.35;1060;68;3784.00;68
9930;67;626429973;9930;360;10985;11053;6.78;0.41;283.38;11.35;1055;68;3785.00;68
9935;67;626429987;9935;368;10989;11057;6.74;0.41;283.44;11.34;1054;68;3786.00;68
9937;67;626430003;9937;368;10989;11057;6.71;0.41;283.50;11.34;1052;68;3787.00;68
9938;67;626430019;9938;366;10991;11061;6.68;0.41;283.52;11.34;1053;68;3788.00;70
9942;67;626430041;9942;364;10993;11062;6.64;0.41;283.58;11.34;1051;68;3789.00;69
9944;67;626430056;9944;363;10993;11062;6.67;0.41;283.58;11.34;1049;68;3790.00;69
9945;67;626430070;9945;367;10995;11062;6.66;0.41;283.60;11.34;1050;68;3791.00;67
9948;67;626430084;9948;375;11005;11075;6.70;0.41;283.65;11.33;1057;68;3792.00;70
9950;67;626430099;9950;377;11005;11075;6.74;0.41;283.67;11.33;1055;68;3793.00;70
9951;67;626430120;9951;378;11006;11075;6.75;0.41;283.67;11.33;1055;68;3794.00;69
9954;67;626430135;9954;379;11007;11076;6.76;0.41;283.72;11.33;1053;68;3795.00;69
9958;67;626430150;9958;370;11007;11077;6.77;0.41;283.76;11.33;1049;68;3796.00;70
9962;67;626430166;9962;355;11007;11077;6.80;0.41;283.82;11.33;1045;68;3797.00;70
9962;67;626430181;9962;345;11010;11080;6.89;0.42;283.82;11.32;1048;68;3798.00;70
9965;67;626430197;9965;331;11010;11080;6.94;0.42;283.90;11.32;1045;68;3799.00;70
9967;67;626430214;9967;319;11010;11080;6.98;0.43;283.98;11.32;1043;68;3800.00;70
9972;67;626430232;9972;313;11010;11080;7.01;0.43;284.05;11.32;1038;68;3801.00;70
9973;67;626430249;9973;307;11014;11086;7.08;0.43;284.03;11.32;1041;68;3802.00;72
9977;67;626430265;9977;304;11014;11086;7.12;0.43;284.01;11.32;1037;68;3803.00;72
9981;67;626430281;9981;298;11015;11086;7.15;0.44;284.13;11.32;1034;68;3804.00;71
9983;67;626430295;9983;294;11015;11086;7.16;0.44;284.15;11.32;1032;68;3805.00;71
9985;67;626430311;9985;292;11018;11090;7.14;0.44;284.17;11.32;1033;68;3806.00;72
9989;67;626430326;9989;285;11019;11091;7.13;0.43;284.17;11.32;1030;68;3807.00;72
9990;67;626430341;9990;284;11019;11091;7.09;0.43;284.16;11.32;1029;68;3808.00;72
9995;67;626430361;9995;281;11020;11092;7.07;0.43;284.19;11.31;1025;68;3809.00;72
9998;67;626430379;9998;274;11020;11092;7.09;0.43;284.16;11.31;1022;68;3810.00;72
10002;67;626430394;10002;263;11020;11092;7.03;0.43;284.31;11.31;1018;68;3811.00;72
10008;67;626430414;10008;248;11020;11092;7.02;0.43;284.31;11.31;1012;68;3812.00;72
10009;67;626430427;10009;240;11020;11092;7.06;0.43;284.29;11.31;1011;68;3813.00;72
10011;67;626430440;10011;239;11020;11092;7.08;0.43;284.30;11.31;1009;68;3814.00;72
10016;67;626430452;10016;238;11020;11092;7.09;0.43;284.33;11.31;1004;68;3815.00;72
10018;67;626430476;10018;251;11056;11162;7.16;0.44;284.33;11.28;1038;68;3816.00;106
10019;67;626430494;10019;250;11057;11163;7.18;0.44;284.41;11.28;1038;68;3817.00;106
10022;67;626430507;10022;250;11065;11163;7.22;0.44;284.37;11.27;1043;68;3818.00;98
10023;67;626430520;10023;254;11066;11163;7.19;0.44;284.36;11.27;1043;68;3819.00;97
10025;67;626430533;10025;261;11070;11163;7.16;0.44;284.38;11.27;1045;68;3820.00;93
10027;67;626430546;10027;259;11073;11163;7.20;0.44;284.39;11.26;1046;68;3821.00;90
10028;67;626430559;10028;269;11076;11163;7.24;0.44;284.38;11.26;1048;68;3822.00;87
10032;67;626430571;10032;271;11079;11163;7.19;0.44;284.45;11.26;1047;68;3823.00;84
10034;67;626430585;10034;275;11081;11164;7.15;0.44;284.43;11.26;1047;68;3824.00;83
10034;67;626430598;10034;281;11085;11166;7.11;0.43;284.43;11.26;1051;68;3825.00;81
10036;67;626430610;10036;290;11087;11166;7.07;0.43;284.42;11.26;1051;68;3826.00;79
10043;67;626430623;10043;289;11090;11170;6.98;0.43;284.51;11.26;1047;68;3827.00;80
10046;67;626430637;10046;299;11090;11170;6.85;0.42;284.52;11.26;1044;68;3828.00;80
10049;67;626430651;10049;300;11090;11170;6.78;0.41;284.52;11.26;1041;68;3829.00;80
10052;67;626430666;10052;301;11090;11170;6.65;0.41;284.56;11.26;1038;68;3830.00;80
10052;67;626430682;10052;298;11093;11176;6.59;0.40;284.56;11.25;1041;68;3831.00;83
10053;67;626430697;10053;296;11094;11176;6.56;0.40;284.56;11.25;1041;68;3832.00;82
10059;67;626430712;10059;296;11094;11176;6.52;0.40;284.54;11.25;1035;68;3833.00;82
10060;67;626430726;10060;295;11097;11179;6.51;0.40;284.52;11.25;1037;68;3834.00;82
10064;67;626430739;10064;294;11097;11179;6.43;0.39;284.58;11.25;1033;68;3835.00;82
10066;67;626430752;10066;297;11097;11179;6.42;0.39;284.55;11.25;1031;68;3836.00;82
10070;67;626430764;10070;298;11097;11180;6.37;0.39;284.55;11.25;1027;68;3837.00;83
10072;67;626430776;10072;297;11098;11181;6.35;0.39;284.54;11.25;1026;68;3838.00;83
10074;67;626430788;10074;289;11098;11181;6.32;0.38;284.64;11.25;1024;68;3839.00;83
10077;67;626430802;10077;297;11113;11207;6.23;0.38;284.60;11.23;1036;68;3840.00;94
10080;67;626430815;10080;289;11114;11207;6.17;0.37;284.58;11.23;1034;68;3841.00;93
10083;67;626430827;10083;290;11116;11207;6.13;0.37;284.58;11.23;1033;68;3842.00;91
10088;67;626430838;10088;283;11118;11208;6.07;0.37;284.53;11.23;1030;68;3843.00;90
10092;67;626430850;10092;279;11118;11208;6.04;0.37;284.46;11.23;1026;68;3844.00;90
10095;67;626430863;10095;281;11121;11212;6.06;0.37;284.46;11.24;1026;68;3845.00;91
10099;67;626430876;10099;276;11123;11214;6.01;0.36;284.44;11.24;1024;68;3846.00;91
10102;67;626430889;10102;272;11126;11218;5.98;0.36;284.41;11.24;1024;68;3847.00;92
10105;67;626430905;10105;261;11127;11218;5.93;0.36;284.41;11.24;1022;68;3848.00;91
10108;67;626430916;10108;261;11127;11218;5.94;0.36;284.35;11.24;1019;68;3849.00;91
10109;67;626430928;10109;257;11127;11218;5.95;0.36;284.34;11.24;1018;68;3850.00;91
10110;67;626430940;10110;252;11127;11218;5.92;0.36;284.34;11.24;1017;68;3851.00;91
10115;67;626430953;10115;260;11138;11230;5.96;0.36;284.38;11.22;1023;68;3852.00;92
10117;67;626430974;10117;263;11138;11230;5.92;0.36;284.36;11.22;1021;68;3853.00;92
10121;67;626431003;10121;254;11138;11230;5.93;0.36;284.32;11.22;1017;68;3854.00;92
10122;67;626431022;10122;259;11138;11230;5.97;0.36;284.30;11.22;1016;68;3855.00;92
10126;67;626431041;10126;260;11139;11230;5.97;0.36;284.26;11.28;1013;68;3856.00;91
10128;67;626431058;10128;270;11140;11230;5.98;0.36;284.24;11.28;1012;68;3857.00;90
10129;67;626431074;10129;279;11140;11231;5.99;0.36;284.22;11.28;1011;68;3858.00;91
10130;67;626431087;10130;280;11140;11231;5.96;0.36;284.22;11.28;1010;68;3859.00;91
10131;67;626431101;10131;281;11146;11237;5.96;0.36;284.21;11.28;1015;68;3860.00;91
10131;67;626431114;10131;283;11149;11238;5.95;0.36;284.21;11.33;1018;68;3861.00;89
10134;67;626431127;10134;294;11150;11238;5.92;0.36;284.22;11.33;1016;68;3862.00;88
10138;67;626431140;10138;301;11151;11238;5.92;0.36;284.20;11.34;1013;68;3863.00;87
10139;67;626431154;10139;294;11153;11242;5.94;0.36;284.18;11.33;1014;68;3864.00;89
10141;67;626431167;10141;297;11153;11242;5.94;0.36;284.17;11.33;1012;68;3865.00;89
10142;67;626431179;10142;305;11155;11242;5.92;0.36;284.17;11.35;1013;68;3866.00;87
10142;67;626431191;10142;296;11157;11243;6.01;0.36;284.17;11.36;1015;68;3867.00;86
10144;67;626431204;10144;298;11160;11247;6.08;0.37;284.14;11.36;1016;68;3868.00;87
10145;67;626431217;10145;290;11162;11247;6.16;0.37;284.15;11.37;1017;68;3869.00;85
10147;67;626431231;10147;286;11166;11253;6.28;0.38;284.13;11.38;1019;68;3870.00;87
10147;67;626431245;10147;281;11166;11253;6.38;0.39;284.13;11.38;1019;68;3871.00;87
10147;67;626431259;10147;281;11169;11253;6.47;0.39;284.13;11.39;1022;68;3872.00;84
10149;67;626431273;10149;278;11171;11253;6.55;0.40;284.23;11.40;1022;68;3873.00;82
10150;67;626431286;10150;272;11174;11257;6.66;0.40;284.23;11.40;1024;68;3874.00;83
10151;68;626431300;10151;266;11176;11257;6.70;0.41;284.22;11.42;1025;69;3875.00;81
10154;68;626431327;10154;274;11177;11257;6.71;0.41;284.17;11.42;1023;69;3876.00;80
10154;68;626431340;10154;274;11177;11257;6.76;0.41;284.17;11.42;1023;69;3877.00;80
10154;68;626431353;10154;269;11180;11258;6.72;0.41;284.17;11.44;1026;69;3878.00;78
10154;68;626431367;10154;271;11182;11259;6.66;0.40;284.17;11.45;1028;69;3879.00;77
10154;68;626431379;10154;273;11184;11259;6.60;0.40;284.17;11.47;1030;69;3880.00;75
10157;68;626431393;10157;282;11185;11260;6.57;0.40;284.16;11.47;1028;69;3881.00;75
10157;68;626431406;10157;274;11186;11260;6.60;0.40;284.16;11.47;1029;69;3882.00;74
10158;68;626431418;10158;287;11187;11260;6.61;0.40;284.15;11.49;1029;69;3883.00;73
10158;68;626431430;10158;283;11189;11260;6.63;0.40;284.15;11.50;1031;69;3884.00;71
10160;68;626431443;10160;279;11189;11260;6.61;0.40;284.14;11.50;1029;69;3885.00;71
10160;68;626431457;10160;288;11190;11260;6.58;0.40;284.14;11.51;1030;69;3886.00;70
10162;68;626431471;10162;288;11191;11260;6.53;0.40;284.12;11.51;1029;69;3887.00;69
10164;68;626431484;10164;312;11259;11387;6.73;0.42;284.09;11.44;1095;69;3888.00;128
10165;68;626431508;10165;307;11262;11388;6.65;0.41;284.09;11.46;1097;69;3889.00;126
10165;68;626431523;10165;286;11268;11388;6.70;0.41;284.09;11.45;1103;69;3890.00;120
10168;68;626431540;10168;288;11278;11388;6.73;0.41;284.16;11.46;1110;69;3891.00;110
10170;68;626431554;10170;285;11286;11388;6.77;0.42;284.18;11.46;1116;69;3892.00;102
10171;68;626431567;10171;281;11292;11388;6.73;0.41;284.21;11.46;1121;69;3893.00;96
10173;68;626431583;10173;281;11298;11388;6.73;0.41;284.26;11.46;1125;69;3894.00;90
10173;68;626431600;10173;277;11301;11388;6.77;0.41;284.26;11.47;1128;69;3895.00;87
10177;68;626431617;10177;283;11304;11389;6.80;0.42;284.27;11.47;1127;69;3896.00;85
10181;68;626431638;10181;292;11307;11390;6.87;0.42;284.40;11.47;1126;69;3897.00;83
10183;68;626431656;10183;295;11309;11390;6.95;0.42;284.39;11.48;1126;69;3898.00;81
10185;68;626431673;10185;304;11311;11391;6.93;0.42;284.45;11.48;1126;69;3899.00;80
10187;68;626431694;10187;314;11317;11406;6.80;0.42;284.52;11.48;1130;69;3900.00;89
10189;68;626431715;10189;312;11318;11406;6.65;0.41;284.51;11.49;1129;69;3901.00;88
10192;68;626431730;10192;323;11322;11406;6.56;0.40;284.57;11.49;1130;69;3902.00;84
10194;68;626431744;10194;326;11325;11410;6.46;0.40;284.62;11.49;1131;69;3903.00;85
10199;68;626431758;10199;337;11327;11410;6.33;0.39;284.65;11.50;1128;69;3904.00;83
10205;68;626431773;10205;347;11329;11410;6.21;0.38;284.68;11.50;1124;69;3905.00;81
10206;68;626431787;10206;363;11333;11413;6.15;0.38;284.71;11.51;1127;69;3906.00;80
10212;68;626431801;10212;369;11334;11413;6.04;0.37;284.78;11.51;1122;69;3907.00;79
10214;68;626431816;10214;376;11335;11413;5.93;0.36;284.82;11.51;1121;69;3908.00;78
10217;68;626431829;10217;385;11340;11417;5.86;0.36;284.84;11.52;1123;69;3909.00;77
10222;68;626431844;10222;387;11343;11418;5.84;0.36;284.97;11.53;1121;69;3910.00;75
10225;68;626431858;10225;385;11345;11418;5.80;0.36;284.98;11.54;1120;69;3911.00;73
10230;68;626431872;10230;378;11348;11422;5.77;0.36;284.99;11.54;1118;69;3912.00;74
10236;68;626431889;10236;375;11349;11422;5.70;0.35;285.04;11.54;1113;69;3913.00;73
10239;68;626431907;10239;376;11351;11422;5.71;0.35;285.14;11.55;1112;69;3914.00;71
10242;68;626431921;10242;369;11354;11424;5.75;0.35;285.22;11.55;1112;69;3915.00;70
10248;68;626431937;10248;358;11354;11424;5.77;0.35;285.33;11.55;1106;69;3916.00;70
10249;68;626431951;10249;357;11358;11430;5.89;0.36;285.37;11.55;1109;69;3917.00;72
10254;68;626431974;10254;356;11358;11430;5.94;0.37;285.44;11.55;1104;69;3918.00;72
10260;68;626431993;10260;347;11358;11431;5.96;0.37;285.60;11.55;1098;69;3919.00;73
10262;68;626432020;10262;342;11359;11431;6.06;0.37;285.59;11.55;1097;69;3920.00;72
10267;68;626432051;10267;335;11360;11431;6.15;0.38;285.68;11.61;1093;69;3921.00;71
10274;68;626432082;10274;329;11360;11431;6.17;0.38;285.73;11.61;1086;69;3922.00;71
10275;68;626432109;10275;327;11361;11431;6.22;0.38;285.76;11.61;1086;69;3923.00;70
10283;68;626432141;10283;328;11369;11443;6.30;0.39;285.85;11.60;1086;69;3924.00;74
10290;68;626432170;10290;330;11369;11443;6.30;0.39;285.91;11.60;1079;69;3925.00;74
10293;68;626432193;10293;325;11371;11443;6.37;0.39;285.93;11.61;1078;69;3926.00;72
10296;68;626432212;10296;327;11371;11443;6.38;0.39;285.98;11.61;1075;69;3927.00;72
10302;68;626432229;10302;319;11371;11443;6.38;0.39;286.07;11.61;1069;69;3928.00;72
10309;68;626432247;10309;320;11373;11443;6.34;0.39;286.10;11.61;1064;69;3929.00;70
10313;68;626432264;10313;321;11376;11447;6.36;0.39;286.13;11.60;1063;69;3930.00;71
10315;68;626432284;10315;324;11376;11447;6.37;0.39;286.17;11.60;1061;69;3931.00;71
10317;68;626432300;10317;330;11379;11451;6.44;0.39;286.20;11.60;1062;69;3932.00;72
10321;68;626432315;10321;331;11380;11452;6.48;0.39;286.25;11.60;1059;69;3933.00;72
10322;68;626432329;10322;339;11380;11452;6.51;0.40;286.27;11.60;1058;69;3934.00;72
10325;68;626432342;10325;345;11382;11452;6.52;0.40;286.25;11.61;1057;69;3935.00;70
10326;68;626432355;10326;353;11392;11465;6.56;0.40;286.27;11.60;1066;69;3936.00;73
10331;68;626432370;10331;355;11393;11465;6.56;0.40;286.26;11.60;1062;69;3937.00;72
10333;68;626432384;10333;350;11394;11465;6.58;0.40;286.23;11.60;1061;69;3938.00;71
10338;68;626432397;10338;351;11395;11466;6.56;0.40;286.28;11.60;1057;69;3939.00;71
10347;68;626432412;10347;347;11396;11467;6.48;0.39;286.45;11.66;1049;69;3940.00;71
10348;68;626432426;10348;346;11397;11467;6.48;0.40;286.43;11.66;1049;69;3941.00;70
10351;68;626432440;10351;346;11399;11470;6.52;0.40;286.44;11.66;1048;69;3942.00;71
10357;68;626432454;10357;344;11400;11470;6.51;0.40;286.57;11.66;1043;69;3943.00;70
10360;68;626432469;10360;342;11400;11470;6.54;0.40;286.56;11.66;1040;69;3944.00;70
10364;68;626432483;10364;336;11401;11470;6.58;0.40;286.56;11.66;1037;69;3945.00;69
10367;68;626432497;10367;339;11405;11476;6.64;0.41;286.58;11.66;1038;69;3946.00;71
10372;68;626432511;10372;337;11406;11476;6.69;0.41;286.76;11.66;1034;69;3947.00;70
10376;68;626432525;10376;330;11407;11476;6.73;0.41;286.79;11.65;1031;69;3948.00;69
10382;68;626432539;10382;330;11408;11476;6.77;0.41;286.88;11.65;1026;69;3949.00;68
10387;68;626432564;10387;329;11412;11480;6.76;0.41;286.97;11.65;1025;69;3950.00;68
10390;68;626432578;10390;328;11413;11481;6.81;0.42;287.04;11.65;1023;69;3951.00;68
10395;68;626432592;10395;329;11413;11481;6.82;0.42;287.11;11.65;1018;69;3952.00;68
10400;68;626432606;10400;337;11414;11482;6.83;0.42;287.17;11.65;1014;69;3953.00;68
10402;68;626432620;10402;333;11414;11482;6.82;0.42;287.23;11.65;1012;69;3954.00;68
10405;68;626432633;10405;343;11415;11482;6.77;0.42;287.24;11.71;1010;69;3955.00;67
10408;68;626432648;10408;351;11415;11482;6.74;0.41;287.27;11.71;1007;69;3956.00;67
10412;68;626432662;10412;343;11415;11482;6.69;0.41;287.37;11.71;1003;69;3957.00;67
10415;68;626432676;10415;336;11415;11482;6.66;0.41;287.38;11.71;1000;69;3958.00;67
10419;68;626432690;10419;345;11415;11482;6.65;0.41;287.40;11.71;996;69;3959.00;67
10425;68;626432705;10425;360;11484;11607;6.68;0.41;287.42;11.64;1059;69;3960.00;123
10427;68;626432729;10427;357;11486;11608;6.68;0.41;287.44;11.64;1059;69;3961.00;122
10432;68;626432743;10432;344;11493;11608;6.74;0.42;287.42;11.70;1061;69;3962.00;115
10436;68;626432763;10436;347;11495;11608;6.84;0.42;287.52;11.69;1059;69;3963.00;113
10440;68;626432777;10440;340;11499;11608;6.91;0.43;287.50;11.69;1059;69;3964.00;109
10444;68;626432790;10444;337;11503;11608;6.97;0.43;287.58;11.75;1059;69;3965.00;105
10450;68;626432804;10450;329;11508;11608;7.04;0.43;287.56;11.75;1058;69;3966.00;100
10454;68;626432819;10454;323;11509;11608;7.06;0.43;287.63;11.75;1055;69;3967.00;99
10457;68;626432833;10457;312;11515;11609;7.10;0.43;287.65;11.75;1058;69;3968.00;94
10461;68;626432847;10461;311;11516;11610;7.12;0.43;287.67;11.75;1055;69;3969.00;94
10463;68;626432862;10463;312;11517;11610;7.05;0.43;287.70;11.75;1054;69;3970.00;93
10468;68;626432877;10468;318;11522;11614;6.99;0.43;287.75;11.74;1054;69;3971.00;92
10469;68;626432892;10469;310;11525;11614;6.96;0.42;287.77;11.80;1056;69;3972.00;89
10470;68;626432906;10470;310;11526;11614;6.91;0.42;287.79;11.80;1056;69;3973.00;88
10471;68;626432920;10471;312;11527;11614;6.92;0.42;287.77;11.80;1056;69;3974.00;87
10476;68;626432934;10476;310;11531;11620;6.92;0.42;287.83;11.80;1055;69;3975.00;89
10478;68;626432949;10478;315;11531;11620;6.89;0.42;287.85;11.80;1053;69;3976.00;89
10479;68;626432977;10479;297;11532;11620;6.88;0.42;287.83;11.80;1053;69;3977.00;88
10481;68;626433000;10481;298;11535;11623;6.92;0.42;287.82;11.80;1054;69;3978.00;88
10483;68;626433022;10483;301;11535;11623;6.96;0.42;287.80;11.80;1052;69;3979.00;88
10484;68;626433046;10484;297;11537;11623;7.01;0.43;287.79;11.86;1053;69;3980.00;86
10486;68;626433069;10486;298;11537;11624;7.05;0.43;287.92;11.86;1051;69;3981.00;87
10488;68;626433088;10488;300;11538;11625;7.06;0.43;287.91;11.86;1050;69;3982.00;87
10488;68;626433105;10488;300;11538;11625;7.05;0.43;287.91;11.86;1050;69;3983.00;87
10491;68;626433121;10491;303;11548;11638;7.00;0.43;287.88;11.85;1057;69;3984.00;90
10495;68;626433140;10495;302;11549;11638;6.99;0.42;287.85;11.91;1054;69;3985.00;89
10497;68;626433156;10497;309;11549;11638;7.01;0.43;287.84;11.91;1052;69;3986.00;89
10499;68;626433173;10499;308;11550;11639;7.01;0.43;287.87;11.91;1051;69;3987.00;89
10502;68;626433189;10502;312;11550;11639;6.96;0.42;287.84;11.91;1048;69;3988.00;89
10506;68;626433205;10506;319;11553;11643;6.92;0.42;287.80;11.91;1047;69;3989.00;90
10507;68;626433223;10507;318;11553;11643;6.87;0.42;287.79;11.91;1046;69;3990.00;90
10510;68;626433238;10510;323;11558;11647;6.79;0.41;287.78;11.97;1048;69;3991.00;89
10510;68;626433254;10510;330;11558;11647;6.70;0.41;287.78;11.97;1048;69;3992.00;89
10511;68;626433269;10511;334;11558;11647;6.58;0.40;287.79;11.97;1047;69;3993.00;89
10512;68;626433284;10512;337;11558;11647;6.49;0.40;287.79;11.97;1046;69;3994.00;89
10513;68;626433298;10513;345;11559;11647;6.38;0.39;287.77;12.03;1046;69;3995.00;88
10513;68;626433312;10513;347;11569;11659;6.35;0.39;287.77;12.02;1056;69;3996.00;90
10517;68;626433328;10517;352;11569;11659;6.28;0.38;287.72;12.02;1052;69;3997.00;90
10519;68;626433343;10519;356;11570;11659;6.19;0.38;287.68;12.02;1051;69;3998.00;89
10521;68;626433357;10521;352;11570;11659;6.10;0.37;287.65;12.02;1049;69;3999.00;89
10523;68;626433373;10523;343;11570;11659;6.03;0.37;287.63;12.02;1047;69;4000.00;89
10526;68;626433394;10526;349;11570;11659;5.97;0.37;287.57;12.02;1044;69;4001.00;89
10529;68;626433407;10529;343;11570;11660;5.91;0.36;287.54;12.02;1041;69;4002.00;90
10530;68;626433421;10530;342;11570;11660;5.90;0.36;287.55;12.02;1040;69;4003.00;90
10534;68;626433434;10534;344;11574;11666;5.91;0.36;287.62;12.02;1040;69;4004.00;92
10535;68;626433447;10535;343;11577;11668;5.96;0.37;287.63;12.02;1042;69;4005.00;91
10539;68;626433460;10539;340;11577;11668;5.89;0.36;287.63;12.02;1038;69;4006.00;91
10540;68;626433473;10540;343;11578;11668;5.89;0.36;287.64;12.07;1038;69;4007.00;90
10541;68;626433486;10541;338;11581;11672;5.90;0.36;287.66;12.07;1040;69;4008.00;91
10543;68;626433501;10543;328;11581;11672;5.87;0.36;287.64;12.07;1038;69;4009.00;91
10544;68;626433516;10544;326;11581;11672;5.84;0.36;287.65;12.07;1037;69;4010.00;91
10549;68;626433530;10549;329;11583;11673;5.79;0.36;287.65;12.13;1034;69;4011.00;90
10551;68;626433546;10551;326;11586;11677;5.71;0.35;287.63;12.13;1035;69;4012.00;91
10553;68;626433561;10553;323;11587;11677;5.65;0.35;287.59;12.18;1034;69;4013.00;90
10555;68;626433575;10555;324;11590;11680;5.63;0.35;287.58;12.19;1035;69;4014.00;90
10557;68;626433592;10557;323;11592;11680;5.60;0.34;287.59;12.21;1035;69;4015.00;88
10560;68;626433607;10560;321;11593;11680;5.53;0.34;287.58;12.26;1033;69;4016.00;87
10565;68;626433621;10565;317;11593;11680;5.49;0.34;287.57;12.26;1028;69;4017.00;87
10568;68;626433635;10568;315;11596;11684;5.48;0.33;287.57;12.26;1028;69;4018.00;88
10569;68;626433648;10569;299;11597;11684;5.46;0.33;287.58;12.31;1028;69;4019.00;87
10570;68;626433661;10570;293;11598;11684;5.48;0.34;287.57;12.31;1028;69;4020.00;86
10572;68;626433673;10572;279;11599;11684;5.51;0.34;287.54;12.36;1027;69;4021.00;85
10575;68;626433684;10575;266;11599;11685;5.56;0.34;287.51;12.36;1024;69;4022.00;86
10577;68;626433697;10577;266;11600;11686;5.66;0.35;287.48;12.36;1023;69;4023.00;86
10578;68;626433709;10578;263;11601;11686;5.72;0.35;287.49;12.41;1023;69;4024.00;85
10581;68;626433722;10581;263;11602;11687;5.84;0.36;287.51;12.41;1021;69;4025.00;85
10583;68;626433734;10583;259;11602;11687;6.02;0.37;287.59;12.41;1019;69;4026.00;85
10585;68;626433746;10585;253;11604;11687;6.08;0.37;287.58;12.46;1019;69;4027.00;83
10589;68;626433767;10589;253;11604;11687;6.14;0.37;287.59;12.46;1015;69;4028.00;83
10590;68;626433779;10590;250;11604;11687;6.20;0.38;287.59;12.46;1014;69;4029.00;83
10592;68;626433798;10592;255;11605;11687;6.27;0.38;287.57;12.51;1013;69;4030.00;82
10594;68;626433812;10594;252;11605;11687;6.31;0.38;287.59;12.51;1011;69;4031.00;82
10594;68;626433825;10594;272;11668;11814;6.60;0.41;287.59;12.44;1074;69;4032.00;146
10596;68;626433849;10596;269;11672;11815;6.66;0.41;287.61;12.44;1076;69;4033.00;143
10596;68;626433864;10596;258;11680;11815;6.79;0.42;287.61;12.43;1084;69;4034.00;135
10599;68;626433878;10599;251;11685;11815;6.85;0.42;287.60;12.43;1086;69;4035.00;130
10600;68;626433894;10600;243;11690;11815;6.92;0.42;287.59;12.43;1090;69;4036.00;125
10601;68;626433907;10601;248;11695;11815;6.99;0.43;287.59;12.43;1094;69;4037.00;120
10603;68;626433921;10603;245;11698;11815;7.02;0.43;287.61;12.43;1095;69;4038.00;117
10604;68;626433934;10604;252;11702;11815;7.04;0.43;287.59;12.44;1098;69;4039.00;113
10606;68;626433951;10606;258;11707;11816;7.06;0.43;287.60;12.46;1101;69;4040.00;109
10609;68;626433972;10609;255;11710;11817;7.08;0.43;287.56;12.46;1101;69;4041.00;107
10611;68;626433986;10611;250;11713;11817;7.09;0.44;287.57;12.46;1102;69;4042.00;104
10614;68;626434000;10614;256;11718;11818;7.04;0.43;287.64;12.48;1104;69;4043.00;100
10615;68;626434015;10615;257;11721;11818;7.03;0.43;287.67;12.48;1106;69;4044.00;97
10618;68;626434029;10618;254;11725;11818;7.03;0.43;287.72;12.49;1107;69;4045.00;93
10622;68;626434044;10622;259;11729;11818;6.95;0.43;287.79;12.50;1107;69;4046.00;89
10623;68;626434057;10623;265;11733;11822;6.95;0.43;287.77;12.51;1110;69;4047.00;89
10627;68;626434072;10627;264;11736;11822;6.91;0.43;287.84;12.51;1109;69;4048.00;86
10632;68;626434086;10632;265;11738;11822;6.81;0.42;287.88;12.53;1106;69;4049.00;84
10634;68;626434101;10634;267;11742;11828;6.81;0.42;287.92;12.53;1108;69;4050.00;86
10637;68;626434116;10637;276;11745;11828;6.81;0.42;287.95;12.54;1108;69;4051.00;83
10639;68;626434129;10639;285;11746;11828;6.78;0.42;287.98;12.54;1107;69;4052.00;82
10640;68;626434142;10640;295;11750;11832;6.76;0.41;288.02;12.55;1110;69;4053.00;82
10642;68;626434155;10642;295;11752;11833;6.82;0.42;288.03;12.55;1110;69;4054.00;81
10645;68;626434169;10645;299;11755;11833;6.79;0.42;288.03;12.58;1110;69;4055.00;78
10649;68;626434182;10649;306;11758;11837;6.73;0.41;288.04;12.57;1109;69;4056.00;79
10650;68;626434196;10650;308;11760;11837;6.70;0.41;288.08;12.60;1110;69;4057.00;77
10652;68;626434209;10652;310;11760;11837;6.60;0.40;288.11;12.60;1108;69;4058.00;77
10654;68;626434222;10654;310;11763;11838;6.53;0.40;288.17;12.62;1109;69;4059.00;75
10654;68;626434241;10654;304;11764;11838;6.48;0.40;288.17;12.63;1110;69;4060.00;74
10657;68;626434255;10657;306;11769;11844;6.50;0.40;288.24;12.64;1112;69;4061.00;75
10659;68;626434269;10659;302;11769;11844;6.48;0.40;288.33;12.64;1110;69;4062.00;75
10662;68;626434282;10662;303;11772;11845;6.46;0.40;288.36;12.66;1110;69;4063.00;73
10665;68;626434295;10665;307;11772;11845;6.40;0.39;288.41;12.66;1107;69;4064.00;73
10668;68;626434315;10668;309;11774;11845;6.39;0.39;288.43;12.68;1106;69;4065.00;71
10670;68;626434328;10670;305;11774;11845;6.40;0.39;288.48;12.68;1104;69;4066.00;71
10676;68;626434342;10676;303;11774;11845;6.42;0.39;288.49;12.68;1098;69;4067.00;71
10676;68;626434355;10676;298;11785;11857;6.49;0.40;288.49;12.68;1109;69;4068.00;72
10679;68;626434369;10679;295;11785;11857;6.46;0.40;288.57;12.68;1106;69;4069.00;72
10680;68;626434382;10680;302;11787;11857;6.50;0.40;288.60;12.68;1107;69;4070.00;70
10684;68;626434395;10684;304;11789;11857;6.41;0.39;288.69;12.70;1105;69;4071.00;68
10689;68;626434408;10689;298;11789;11857;6.35;0.39;288.73;12.70;1100;69;4072.00;68
10695;68;626434421;10695;295;11791;11857;6.29;0.38;288.80;12.71;1096;69;4073.00;66
10699;68;626434433;10699;293;11794;11861;6.26;0.38;288.79;12.71;1095;69;4074.00;67
10705;68;626434447;10705;297;11795;11861;6.22;0.38;288.91;12.72;1090;69;4075.00;66
10709;68;626434460;10709;295;11799;11865;6.19;0.38;288.89;12.72;1090;69;4076.00;66
10716;68;626434474;10716;300;11800;11866;6.09;0.37;288.96;12.72;1084;69;4077.00;66
10719;68;626434488;10719;307;11803;11866;6.03;0.37;288.97;12.73;1084;69;4078.00;63
10725;68;626434499;10725;317;11803;11866;5.92;0.36;288.97;12.73;1078;69;4079.00;63
10732;68;626434513;10732;316;11823;11895;5.86;0.36;289.15;12.72;1091;69;4080.00;72
10736;68;626434529;10736;314;11826;11895;5.84;0.36;289.14;12.72;1090;69;4081.00;69
10740;68;626434541;10740;324;11829;11895;5.82;0.35;289.17;12.72;1089;69;4082.00;66
10743;68;626434554;10743;320;11833;11896;5.82;0.35;289.24;12.73;1090;69;4083.00;63
10746;68;626434567;10746;321;11833;11897;5.84;0.36;289.33;12.73;1087;69;4084.00;64
10749;68;626434579;10749;330;11833;11897;5.88;0.36;289.39;12.73;1084;69;4085.00;64
10754;68;626434592;10754;328;11836;11900;5.90;0.36;289.51;12.73;1082;69;4086.00;64
10761;68;626434604;10761;320;11838;11900;5.91;0.36;289.51;12.74;1077;69;4087.00;62
10764;68;626434617;10764;316;11838;11900;6.00;0.37;289.61;12.74;1074;69;4088.00;62
10767;68;626434630;10767;313;11840;11900;6.10;0.37;289.66;12.74;1073;69;4089.00;60
10771;68;626434643;10771;310;11844;11906;6.19;0.38;289.67;12.74;1073;69;4090.00;62
10779;68;626434656;10779;301;11845;11906;6.15;0.38;289.69;12.74;1066;69;4091.00;61
10783;68;626434670;10783;303;11845;11906;6.15;0.38;289.71;12.74;1062;69;4092.00;61
10785;68;626434682;10785;305;11845;11906;6.20;0.38;289.74;12.74;1060;69;4093.00;61
10789;68;626434695;10789;298;11848;11910;6.23;0.38;289.80;12.73;1059;69;4094.00;62
10793;68;626434708;10793;297;11850;11912;6.25;0.38;289.87;12.73;1057;69;4095.00;62
10796;68;626434722;10796;297;11850;11912;6.31;0.39;289.86;12.73;1054;69;4096.00;62
10799;68;626434736;10799;295;11851;11913;6.37;0.39;289.93;12.73;1052;69;4097.00;62
10806;68;626434749;10806;289;11851;11913;6.41;0.39;290.02;12.73;1045;69;4098.00;62
10810;68;626434766;10810;283;11851;11913;6.46;0.40;290.07;12.73;1041;69;4099.00;62
10817;68;626434782;10817;282;11851;11913;6.46;0.39;290.05;12.73;1034;69;4100.00;62
10820;68;626434800;10820;279;11851;11913;6.53;0.40;290.08;12.73;1031;69;4101.00;62
10823;68;626434814;10823;280;11851;11913;6.55;0.40;290.08;12.73;1028;69;4102.00;62
10828;68;626434829;10828;281;11851;11913;6.64;0.41;290.07;12.73;1023;69;4103.00;62
10832;68;626434843;10832;292;11893;11983;6.77;0.41;290.13;12.69;1061;69;4104.00;90
10836;68;626434863;10836;285;11893;11984;6.84;0.42;290.14;12.69;1057;69;4105.00;91
10841;68;626434877;10841;285;11898;11984;6.95;0.42;290.16;12.68;1057;69;4106.00;86
10846;68;626434891;10846;289;11902;11984;7.04;0.43;290.16;12.68;1056;69;4107.00;82
10849;68;626434905;10849;295;11907;11984;7.14;0.44;290.18;12.68;1058;69;4108.00;77
10852;68;626434918;10852;297;11910;11984;7.13;0.43;290.14;12.67;1058;69;4109.00;74
10855;68;626434933;10855;305;11912;11984;7.20;0.44;290.15;12.67;1057;69;4110.00;72
10859;68;626434947;10859;307;11912;11984;7.17;0.44;290.17;12.67;1053;69;4111.00;72
10864;68;626434967;10864;317;11914;11985;7.07;0.43;290.21;12.67;1050;69;4112.00;71
10866;68;626434991;10866;322;11915;11986;7.02;0.43;290.27;12.67;1049;69;4113.00;71
10868;68;626435012;10868;326;11917;11986;6.99;0.43;290.31;12.72;1049;69;4114.00;69
10870;68;626435044;10870;335;11919;11990;7.00;0.43;290.32;12.72;1049;69;4115.00;71
10875;68;626435074;10875;341;11919;11990;6.92;0.42;290.35;12.72;1044;69;4116.00;71
10879;68;626435092;10879;352;11919;11990;6.87;0.42;290.29;12.72;1040;69;4117.00;71
10882;68;626435107;10882;354;11919;11990;6.82;0.42;290.34;12.72;1037;69;4118.00;71
10884;68;626435121;10884;356;11923;11996;6.82;0.42;290.35;12.71;1039;69;4119.00;73
10888;68;626435137;10888;360;11923;11996;6.76;0.41;290.29;12.71;1035;69;4120.00;73
10895;68;626435152;10895;360;11925;11996;6.71;0.41;290.37;12.71;1030;69;4121.00;71
10897;69;626435167;10897;365;11927;11999;6.68;0.41;290.38;12.71;1030;70;4122.00;72
10900;69;626435192;10900;368;11929;11999;6.67;0.41;290.46;12.71;1029;70;4123.00;70
10903;69;626435211;10903;376;11930;11999;6.56;0.40;290.50;12.71;1027;70;4124.00;69
10905;69;626435225;10905;383;11930;12000;6.42;0.39;290.51;12.71;1025;70;4125.00;70
10910;69;626435239;10910;389;11931;12001;6.32;0.39;290.66;12.71;1021;70;4126.00;70
10914;69;626435253;10914;383;11932;12001;6.23;0.38;290.66;12.71;1018;70;4127.00;69
10916;69;626435267;10916;382;11943;12014;6.28;0.38;290.67;12.70;1027;70;4128.00;71
10920;69;626435282;10920;384;11943;12014;6.24;0.38;290.71;12.70;1023;70;4129.00;71
10923;69;626435298;10923;382;11944;12014;6.21;0.38;290.69;12.74;1021;70;4130.00;70
10927;69;626435315;10927;385;11945;12015;6.22;0.38;290.68;12.74;1018;70;4131.00;70
10931;69;626435336;10931;388;11945;12015;6.23;0.38;290.73;12.74;1014;70;4132.00;70
10931;69;626435353;10931;389;11948;12019;6.31;0.39;290.73;12.74;1017;70;4133.00;71
10934;69;626435369;10934;390;11948;12019;6.28;0.38;290.81;12.74;1014;70;4134.00;71
10937;69;626435384;10937;392;11952;12023;6.25;0.38;290.91;12.73;1015;70;4135.00;71
10937;70;626435398;10937;383;11952;12023;6.22;0.38;290.91;12.73;1015;71;4136.00;71
10940;70;626435427;10940;381;11952;12023;6.19;0.38;290.97;12.73;1012;71;4137.00;71
10942;70;626435441;10942;374;11952;12023;6.20;0.38;290.97;12.73;1010;71;4138.00;71
10946;70;626435454;10946;361;11953;12023;6.24;0.38;290.95;12.78;1007;71;4139.00;70
10951;70;626435469;10951;367;11977;12057;6.31;0.39;290.96;12.75;1026;71;4140.00;80
10955;70;626435486;10955;360;11978;12057;6.28;0.38;290.98;12.75;1023;71;4141.00;79
10958;70;626435500;10958;349;11979;12057;6.29;0.38;291.00;12.75;1021;71;4142.00;78
10960;70;626435514;10960;347;11979;12057;6.32;0.39;290.97;12.75;1019;71;4143.00;78
10962;70;626435527;10962;339;11980;12057;6.33;0.39;290.93;12.75;1018;71;4144.00;77
10965;70;626435539;10965;346;11980;12057;6.42;0.39;290.94;12.75;1015;71;4145.00;77
10967;70;626435552;10967;339;11981;12058;6.49;0.40;290.92;12.75;1014;71;4146.00;77
10967;71;626435566;10967;341;11981;12058;6.49;0.40;290.92;12.75;1014;72;4147.00;77
10968;71;626435588;10968;333;11985;12064;6.54;0.40;290.92;12.74;1017;72;4148.00;79
10971;71;626435607;10971;340;11986;12065;6.50;0.40;290.94;12.74;1015;72;4149.00;79
10975;71;626435620;10975;333;11988;12065;6.47;0.40;290.96;12.79;1013;72;4150.00;77
10977;71;626435634;10977;328;11988;12065;6.43;0.39;290.94;12.79;1011;72;4151.00;77
10979;71;626435654;10979;323;11992;12069;6.44;0.39;290.92;12.78;1013;72;4152.00;77
10984;71;626435668;10984;321;11992;12069;6.38;0.39;290.92;12.78;1008;72;4153.00;77
10987;71;626435682;10987;316;11992;12069;6.33;0.39;290.88;12.78;1005;72;4154.00;77
10989;71;626435695;10989;316;11993;12070;6.30;0.39;290.86;12.78;1004;72;4155.00;77
10993;71;626435714;10993;323;11996;12074;6.25;0.38;290.83;12.78;1003;72;4156.00;78
10994;71;626435728;10994;325;11996;12074;6.21;0.38;290.81;12.78;1002;72;4157.00;78
10998;71;626435740;10998;328;11998;12077;6.18;0.38;290.82;12.78;1000;72;4158.00;79
10999;71;626435753;10999;335;11998;12077;6.11;0.37;290.82;12.78;999;72;4159.00;79
11000;71;626435766;11000;336;12000;12077;6.05;0.37;290.80;12.82;1000;72;4160.00;77
11002;71;626435779;11002;337;12000;12077;5.98;0.36;290.76;12.82;998;72;4161.00;77
11002;71;626435792;11002;342;12003;12081;5.93;0.36;290.76;12.82;1001;72;4162.00;78
11004;71;626435804;11004;351;12004;12081;5.87;0.36;290.75;12.86;1000;72;4163.00;77
11005;71;626435816;11005;353;12005;12081;5.85;0.36;290.73;12.86;1000;72;4164.00;76
11006;71;626435834;11006;362;12006;12081;5.80;0.35;290.77;12.91;1000;72;4165.00;75
11006;71;626435845;11006;367;12006;12082;5.71;0.35;290.77;12.91;1000;72;4166.00;76
11008;71;626435856;11008;370;12008;12083;5.63;0.34;290.77;12.96;1000;72;4167.00;75
11009;71;626435869;11009;374;12008;12083;5.56;0.34;290.77;12.96;999;72;4168.00;75
11009;71;626435886;11009;374;12009;12084;5.49;0.33;290.77;12.95;1000;72;4169.00;75
11009;71;626435900;11009;372;12010;12084;5.41;0.33;290.77;13.00;1001;72;4170.00;74
11010;71;626435911;11010;358;12010;12084;5.36;0.33;290.77;13.00;1000;72;4171.00;74
11010;71;626435923;11010;353;12010;12084;5.39;0.33;290.77;13.00;1000;72;4172.00;74
11014;71;626435934;11014;347;12013;12086;5.37;0.33;290.84;13.05;999;72;4173.00;73
11015;71;626435947;11015;327;12013;12086;5.44;0.33;290.82;13.05;998;72;4174.00;73
11016;71;626435960;11016;318;12014;12086;5.50;0.33;290.83;13.09;998;72;4175.00;72
11017;71;626435973;11017;330;12081;12213;5.68;0.35;290.83;13.02;1064;72;4176.00;132
11019;71;626435996;11019;312;12082;12214;5.75;0.36;290.83;13.02;1063;72;4177.00;132
11019;71;626436015;11019;284;12088;12214;5.92;0.37;290.83;13.06;1069;72;4178.00;126
11021;71;626436027;11021;276;12090;12214;6.04;0.37;290.82;13.06;1069;72;4179.00;124
11024;71;626436046;11024;271;12094;12214;6.14;0.38;290.86;13.10;1070;72;4180.00;120
11025;71;626436064;11025;261;12100;12214;6.21;0.38;290.85;13.10;1075;72;4181.00;114
11028;71;626436083;11028;245;12102;12214;6.23;0.38;290.86;13.10;1074;72;4182.00;112
11029;71;626436101;11029;241;12105;12214;6.28;0.39;290.88;13.10;1076;72;4183.00;109
11032;71;626436113;11032;250;12108;12215;6.34;0.39;290.89;13.14;1076;72;4184.00;107
11034;71;626436126;11034;247;12113;12217;6.37;0.39;290.89;13.16;1079;72;4185.00;104
11036;71;626436140;11036;244;12116;12217;6.46;0.40;290.87;13.16;1080;72;4186.00;101
11038;71;626436153;11038;238;12119;12218;6.54;0.40;290.85;13.16;1081;72;4187.00;99
11040;71;626436166;11040;232;12121;12218;6.60;0.40;290.86;13.21;1081;72;4188.00;97
11041;71;626436180;11041;235;12126;12218;6.63;0.41;290.85;13.21;1085;72;4189.00;92
11042;71;626436192;11042;230;12127;12218;6.61;0.40;290.84;13.21;1085;72;4190.00;91
11042;71;626436206;11042;234;12132;12222;6.66;0.41;290.84;13.21;1090;72;4191.00;90
11044;71;626436219;11044;233;12135;12222;6.73;0.41;290.86;13.21;1091;72;4192.00;87
11048;71;626436232;11048;232;12137;12222;6.78;0.41;290.85;13.21;1089;72;4193.00;85
11049;71;626436245;11049;240;12139;12225;6.82;0.42;290.89;13.21;1090;72;4194.00;86
11052;71;626436265;11052;237;12140;12225;6.82;0.42;290.90;13.21;1088;72;4195.00;85
11054;71;626436284;11054;239;12140;12225;6.85;0.42;290.93;13.21;1086;72;4196.00;85
11055;71;626436297;11055;240;12144;12229;6.89;0.42;290.91;13.20;1089;72;4197.00;85
11061;71;626436311;11061;239;12146;12230;6.91;0.42;290.94;13.20;1085;72;4198.00;84
11066;71;626436325;11066;237;12146;12230;6.94;0.42;290.95;13.20;1080;72;4199.00;84
11068;71;626436341;11068;246;12157;12264;6.96;0.42;290.96;13.19;1089;72;4200.00;107
11072;71;626436362;11072;241;12159;12264;6.94;0.42;291.00;13.19;1087;72;4201.00;105
11074;71;626436376;11074;241;12162;12264;6.96;0.42;291.04;13.19;1088;72;4202.00;102
11076;71;626436390;11076;241;12164;12265;6.98;0.42;291.05;13.19;1088;72;4203.00;101
11079;71;626436403;11079;234;12164;12265;6.99;0.42;291.17;13.19;1085;72;4204.00;101
11081;71;626436417;11081;237;12169;12271;6.98;0.42;291.16;13.19;1088;72;4205.00;102
11085;71;626436431;11085;241;12170;12271;6.96;0.42;291.21;13.19;1085;72;4206.00;101
11088;71;626436445;11088;233;12171;12272;6.98;0.42;291.23;13.19;1083;72;4207.00;101
11091;71;626436459;11091;234;12171;12272;7.01;0.42;291.27;13.19;1080;72;4208.00;101
11094;71;626436474;11094;233;12171;12272;7.02;0.42;291.31;13.19;1077;72;4209.00;101
11096;71;626436488;11096;229;12174;12272;7.04;0.43;291.31;13.22;1078;72;4210.00;98
11098;71;626436502;11098;227;12175;12272;7.04;0.43;291.36;13.22;1077;72;4211.00;97
11099;71;626436516;11099;229;12187;12284;7.15;0.43;291.37;13.22;1088;72;4212.00;97
11102;71;626436531;11102;227;12188;12284;7.15;0.43;291.43;13.23;1086;72;4213.00;96
11104;71;626436545;11104;230;12189;12284;7.22;0.44;291.45;13.24;1085;72;4214.00;95
11106;71;626436559;11106;225;12190;12284;7.25;0.44;291.43;13.26;1084;72;4215.00;94
11109;71;626436579;11109;229;12192;12284;7.28;0.44;291.45;13.26;1083;72;4216.00;92
11111;71;626436593;11111;225;12194;12284;7.33;0.45;291.43;13.28;1083;72;4217.00;90
11113;71;626436607;11113;226;12198;12288;7.37;0.45;291.46;13.28;1085;72;4218.00;90
11114;71;626436622;11114;225;12200;12288;7.39;0.45;291.45;13.30;1086;72;4219.00;88
11115;71;626436637;11115;237;12203;12292;7.41;0.45;291.44;13.31;1088;72;4220.00;89
11118;71;626436652;11118;239;12206;12293;7.37;0.45;291.44;13.32;1088;72;4221.00;87
11120;71;626436668;11120;250;12209;12293;7.34;0.45;291.50;13.34;1089;72;4222.00;84
11122;71;626436682;11122;255;12209;12293;7.37;0.45;291.53;13.34;1087;72;4223.00;84
11125;71;626436696;11125;259;12218;12306;7.32;0.45;291.57;13.34;1093;72;4224.00;88
11129;71;626436712;11129;257;12219;12306;7.26;0.44;291.60;13.36;1090;72;4225.00;87
11131;71;626436726;11131;260;12220;12306;7.20;0.44;291.59;13.36;1089;72;4226.00;86
11135;71;626436740;11135;268;12223;12307;7.16;0.44;291.65;13.36;1088;72;4227.00;84
11137;71;626436754;11137;266;12225;12308;7.07;0.43;291.76;13.38;1088;72;4228.00;83
11139;71;626436767;11139;258;12226;12308;7.05;0.43;291.78;13.38;1087;72;4229.00;82
11142;71;626436783;11142;258;12230;12314;7.00;0.43;291.85;13.38;1088;72;4230.00;84
11144;71;626436797;11144;249;12232;12314;6.98;0.43;291.87;13.39;1088;72;4231.00;82
11149;71;626436811;11149;252;12232;12314;6.92;0.42;291.86;13.39;1083;72;4232.00;82
11152;71;626436824;11152;255;12233;12314;6.87;0.42;291.96;13.40;1081;72;4233.00;81
11153;71;626436838;11153;256;12238;12320;6.91;0.42;291.99;13.41;1085;72;4234.00;82
11157;71;626436851;11157;254;12240;12320;6.88;0.42;292.00;13.42;1083;72;4235.00;80
11161;71;626436865;11161;258;12241;12320;6.80;0.41;292.10;13.43;1080;72;4236.00;79
11163;71;626436878;11163;259;12241;12320;6.77;0.41;292.14;13.43;1078;72;4237.00;79
11163;71;626436892;11163;266;12245;12324;6.78;0.41;292.14;13.43;1082;72;4238.00;79
11167;71;626436905;11167;266;12246;12325;6.78;0.41;292.20;13.43;1079;72;4239.00;79
11169;71;626436918;11169;266;12248;12325;6.77;0.41;292.21;13.44;1079;72;4240.00;77
11172;71;626436931;11172;268;12251;12326;6.76;0.41;292.22;13.45;1079;72;4241.00;75
11174;71;626436951;11174;271;12252;12326;6.71;0.41;292.24;13.46;1078;72;4242.00;74
11177;71;626436970;11177;270;12252;12326;6.64;0.41;292.29;13.46;1075;72;4243.00;74
11178;71;626436989;11178;278;12253;12326;6.59;0.40;292.29;13.46;1075;72;4244.00;73
11185;71;626437009;11185;283;12254;12326;6.45;0.39;292.37;13.47;1069;72;4245.00;72
11188;71;626437029;11188;286;12256;12326;6.34;0.39;292.40;13.47;1068;72;4246.00;70
11194;71;626437059;11194;299;12257;12326;6.19;0.38;292.40;13.47;1063;72;4247.00;69
11202;71;626437077;11202;305;12292;12396;6.11;0.37;292.44;13.44;1090;72;4248.00;104
11203;71;626437097;11203;308;12292;12397;6.04;0.37;292.42;13.44;1089;72;4249.00;105
11210;71;626437118;11210;294;12299;12397;6.02;0.37;292.41;13.45;1089;72;4250.00;98
11213;71;626437132;11213;288;12302;12397;5.98;0.37;292.45;13.44;1089;72;4251.00;95
11216;71;626437146;11216;286;12307;12397;5.99;0.37;292.44;13.45;1091;72;4252.00;90
11221;71;626437161;11221;289;12310;12397;5.91;0.36;292.55;13.46;1089;72;4253.00;87
11223;71;626437175;11223;298;12313;12397;5.91;0.36;292.54;13.46;1090;72;4254.00;84
11226;71;626437190;11226;305;12316;12397;5.90;0.36;292.56;13.47;1090;72;4255.00;81
11231;71;626437204;11231;312;12318;12398;5.87;0.36;292.70;13.47;1087;72;4256.00;80
11233;71;626437218;11233;318;12321;12399;5.94;0.36;292.77;13.47;1088;72;4257.00;78
11237;71;626437232;11237;322;12327;12399;5.93;0.36;292.86;13.48;1090;72;4258.00;72
11240;71;626437246;11240;322;12331;12403;5.95;0.36;292.83;13.47;1091;72;4259.00;72
11245;71;626437263;11245;318;12334;12403;5.96;0.37;292.95;13.48;1089;72;4260.00;69
11250;71;626437277;11250;324;12336;12403;5.97;0.37;292.98;13.48;1086;72;4261.00;67
11251;71;626437291;11251;334;12337;12403;6.04;0.37;292.99;13.48;1086;72;4262.00;66
11255;71;626437304;11255;336;12340;12409;6.05;0.37;292.97;13.47;1085;72;4263.00;69
11262;71;626437319;11262;341;12341;12409;6.00;0.37;292.95;13.48;1079;72;4264.00;68
11266;71;626437333;11266;341;12342;12409;6.03;0.37;293.00;13.48;1076;72;4265.00;67
11267;71;626437346;11267;344;12344;12412;6.11;0.37;293.00;13.47;1077;72;4266.00;68
11272;71;626437360;11272;340;12344;12412;6.12;0.38;293.04;13.47;1072;72;4267.00;68
11275;71;626437374;11275;336;12346;12412;6.17;0.38;293.00;13.48;1071;72;4268.00;66
11283;71;626437386;11283;334;12346;12413;6.10;0.37;292.99;13.48;1063;72;4269.00;67
11288;71;626437401;11288;328;12348;12414;6.09;0.37;293.00;13.48;1060;72;4270.00;66
11292;71;626437414;11292;324;12348;12414;6.09;0.37;293.03;13.48;1056;72;4271.00;66
11298;71;626437428;11298;330;12359;12427;6.10;0.37;293.06;13.47;1061;72;4272.00;68
11307;71;626437442;11307;330;12362;12427;6.01;0.36;293.06;13.52;1055;72;4273.00;65
11308;71;626437457;11308;336;12363;12427;6.07;0.37;293.05;13.52;1055;72;4274.00;64
11313;71;626437471;11313;340;12366;12429;6.11;0.37;293.06;13.52;1053;72;4275.00;63
11317;71;626437485;11317;346;12367;12429;6.14;0.37;293.12;13.52;1050;72;4276.00;62
11319;71;626437500;11319;339;12369;12433;6.17;0.38;293.14;13.52;1050;72;4277.00;64
11324;71;626437514;11324;338;12370;12433;6.13;0.37;293.20;13.52;1046;72;4278.00;63
11327;71;626437528;11327;341;12373;12437;6.16;0.38;293.23;13.52;1046;72;4279.00;64
11331;71;626437542;11331;349;12374;12437;6.13;0.37;293.25;13.52;1043;72;4280.00;63
11335;71;626437556;11335;355;12374;12437;6.11;0.37;293.30;13.52;1039;72;4281.00;63
11338;71;626437570;11338;363;12375;12437;6.15;0.38;293.39;13.52;1037;72;4282.00;62
11338;71;626437584;11338;370;12375;12437;6.17;0.38;293.39;13.52;1037;72;4283.00;62
11338;71;626437597;11338;379;12386;12449;6.27;0.38;293.39;13.51;1048;72;4284.00;63
11342;71;626437612;11342;387;12386;12449;6.22;0.38;293.42;13.51;1044;72;4285.00;63
11344;71;626437626;11344;392;12387;12449;6.21;0.38;293.44;13.51;1043;72;4286.00;62
11349;71;626437640;11349;402;12387;12449;6.16;0.38;293.57;13.51;1038;72;4287.00;62
11353;71;626437654;11353;413;12388;12449;6.11;0.37;293.63;13.51;1035;72;4288.00;61
11356;71;626437673;11356;417;12389;12449;6.07;0.37;293.68;13.51;1033;72;4289.00;60
11358;71;626437689;11358;425;12389;12450;6.06;0.37;293.70;13.51;1031;72;4290.00;61
11360;71;626437703;11360;436;12390;12450;6.01;0.37;293.71;13.51;1030;72;4291.00;60
11365;71;626437716;11365;446;12393;12456;5.93;0.36;293.71;13.51;1028;72;4292.00;63
11371;71;626437730;11371;461;12395;12457;5.89;0.36;293.71;13.50;1024;72;4293.00;62
11373;71;626437743;11373;469;12396;12457;5.82;0.36;293.67;13.50;1023;72;4294.00;61
11377;71;626437756;11377;480;12396;12457;5.71;0.35;293.64;13.50;1019;72;4295.00;61
11378;71;626437769;11378;486;12399;12461;5.67;0.35;293.64;13.50;1021;72;4296.00;62
11383;71;626437781;11383;479;12400;12461;5.61;0.34;293.65;13.56;1017;72;4297.00;61
11385;71;626437795;11385;477;12400;12461;5.59;0.34;293.67;13.56;1015;72;4298.00;61
11387;71;626437808;11387;478;12401;12462;5.58;0.34;293.63;13.55;1014;72;4299.00;61
11392;71;626437821;11392;473;12404;12466;5.55;0.34;293.59;13.55;1012;72;4300.00;62
11396;71;626437840;11396;472;12404;12466;5.54;0.34;293.55;13.55;1008;72;4301.00;62
11397;71;626437854;11397;464;12406;12469;5.59;0.34;293.53;13.55;1009;72;4302.00;63
11398;71;626437867;11398;461;12407;12469;5.64;0.34;293.52;13.55;1009;72;4303.00;62
11401;71;626437879;11401;462;12407;12469;5.63;0.34;293.58;13.55;1006;72;4304.00;62
11403;71;626437893;11403;455;12407;12469;5.60;0.34;293.65;13.55;1004;72;4305.00;62
11405;71;626437907;11405;443;12410;12473;5.64;0.35;293.63;13.55;1005;72;4306.00;63
11408;71;626437920;11408;424;12411;12473;5.64;0.35;293.58;13.54;1003;72;4307.00;62
11410;71;626437940;11410;416;12411;12473;5.68;0.35;293.54;13.54;1001;72;4308.00;62
11413;71;626437954;11413;404;12411;12473;5.71;0.35;293.52;13.54;998;72;4309.00;62
11415;71;626437970;11415;406;12411;12474;5.72;0.35;293.52;13.54;996;72;4310.00;63
11417;71;626437989;11417;399;12412;12475;5.74;0.35;293.51;13.54;995;72;4311.00;63
11420;71;626438003;11420;390;12412;12475;5.79;0.35;293.48;13.54;992;72;4312.00;63
11422;71;626438017;11422;391;12413;12476;5.86;0.36;293.50;13.54;991;72;4313.00;63
11426;71;626438029;11426;389;12413;12476;5.90;0.36;293.47;13.54;987;72;4314.00;63
11426;71;626438042;11426;391;12413;12476;5.96;0.36;293.47;13.54;987;72;4315.00;63
11428;71;626438063;11428;389;12413;12476;5.99;0.36;293.45;13.54;985;72;4316.00;63
11430;71;626438076;11430;389;12413;12476;6.00;0.36;293.45;13.54;983;72;4317.00;63
11431;71;626438090;11431;393;12413;12476;6.00;0.36;293.43;13.54;982;72;4318.00;63
11432;71;626438103;11432;396;12413;12476;6.04;0.37;293.42;13.54;981;72;4319.00;63
11432;71;626438117;11432;439;12523;12706;6.30;0.39;293.42;13.42;1091;72;4320.00;183
11433;71;626438152;11433;426;12526;12707;6.30;0.39;293.41;13.42;1093;72;4321.00;181
11435;71;626438166;11435;418;12535;12707;6.36;0.40;293.43;13.41;1100;72;4322.00;172
11436;71;626438181;11436;404;12540;12707;6.36;0.40;293.40;13.41;1104;72;4323.00;167
11441;71;626438194;11441;397;12548;12707;6.36;0.40;293.44;13.40;1107;72;4324.00;159
11441;71;626438208;11441;393;12551;12707;6.37;0.40;293.44;13.40;1110;72;4325.00;156
11442;71;626438222;11442;387;12557;12707;6.43;0.40;293.43;13.40;1115;72;4326.00;150
11443;71;626438237;11443;389;12561;12707;6.37;0.40;293.42;13.39;1118;72;4327.00;146
11444;71;626438257;11444;382;12565;12708;6.34;0.39;293.49;13.39;1121;72;4328.00;143
11446;71;626438270;11446;385;12571;12709;6.31;0.39;293.57;13.39;1125;72;4329.00;138
11446;71;626438284;11446;378;12573;12709;6.29;0.39;293.57;13.39;1127;72;4330.00;136
11448;72;626438302;11448;380;12576;12710;6.22;0.39;293.55;13.39;1128;73;4331.00;134
11448;72;626438328;11448;388;12579;12710;6.21;0.39;293.55;13.39;1131;73;4332.00;131
11450;72;626438341;11450;386;12585;12710;6.16;0.38;293.54;13.44;1135;73;4333.00;125
11450;72;626438356;11450;383;12588;12710;6.17;0.38;293.54;13.44;1138;73;4334.00;122
11453;72;626438368;11453;386;12591;12714;6.15;0.38;293.53;13.44;1138;73;4335.00;123
11455;72;626438382;11455;389;12593;12714;6.12;0.38;293.52;13.44;1138;73;4336.00;121
11457;72;626438396;11457;391;12597;12714;6.07;0.38;293.52;13.44;1140;73;4337.00;117
11458;72;626438415;11458;398;12599;12717;6.08;0.38;293.52;13.44;1141;73;4338.00;118
11459;72;626438428;11459;399;12601;12717;6.06;0.37;293.52;13.44;1142;73;4339.00;116
11459;72;626438442;11459;396;12601;12717;6.09;0.38;293.52;13.44;1142;73;4340.00;116
11460;72;626438456;11460;400;12605;12721;6.07;0.37;293.51;13.44;1145;73;4341.00;116
11460;72;626438470;11460;396;12607;12722;6.05;0.37;293.51;13.44;1147;73;4342.00;115
11464;72;626438483;11464;395;12610;12722;6.00;0.37;293.53;13.44;1146;73;4343.00;112
11466;72;626438497;11466;388;12613;12726;6.02;0.37;293.55;13.44;1147;73;4344.00;113
11468;72;626438511;11468;384;12614;12726;6.02;0.37;293.57;13.43;1146;73;4345.00;112
11476;72;626438524;11476;387;12615;12726;5.99;0.37;293.66;13.43;1139;73;4346.00;111
11476;72;626438538;11476;384;12616;12727;6.01;0.37;293.66;13.43;1140;73;4347.00;111
11479;72;626438550;11479;381;12616;12727;6.02;0.37;293.74;13.43;1137;73;4348.00;111
11487;72;626438563;11487;378;12620;12733;5.97;0.36;293.80;13.48;1133;73;4349.00;113
11488;72;626438578;11488;376;12621;12733;5.95;0.36;293.80;13.48;1133;73;4350.00;112
11493;72;626438591;11493;375;12622;12734;5.89;0.36;293.88;13.52;1129;73;4351.00;112
11497;72;626438604;11497;366;12622;12734;5.81;0.35;293.95;13.52;1125;73;4352.00;112
11503;72;626438617;11503;356;12623;12734;5.74;0.35;293.99;13.57;1120;73;4353.00;111
11504;72;626438630;11504;348;12626;12734;5.74;0.35;294.03;13.58;1122;73;4354.00;108
11507;72;626438650;11507;339;12627;12734;5.74;0.35;294.02;13.59;1120;73;4355.00;107
11510;72;626438664;11510;334;12638;12746;5.77;0.35;294.08;13.63;1128;73;4356.00;108
11512;72;626438678;11512;329;12638;12746;5.87;0.36;294.06;13.63;1126;73;4357.00;108
11514;72;626438691;11514;319;12639;12746;5.95;0.36;294.06;13.63;1125;73;4358.00;107
11520;72;626438704;11520;315;12640;12746;5.98;0.36;294.13;13.67;1120;73;4359.00;106
11522;72;626438717;11522;304;12640;12746;6.07;0.37;294.15;13.67;1118;73;4360.00;106
11524;72;626438730;11524;303;12641;12746;6.16;0.37;294.17;13.71;1117;73;4361.00;105
11527;72;626438743;11527;302;12644;12750;6.26;0.38;294.20;13.71;1117;73;4362.00;106
11530;72;626438757;11530;289;12644;12750;6.35;0.39;294.29;13.71;1114;73;4363.00;106
11532;72;626438776;11532;293;12647;12754;6.46;0.39;294.28;13.75;1115;73;4364.00;107
11536;72;626438790;11536;288;12649;12756;6.53;0.40;294.37;13.74;1113;73;4365.00;107
11540;72;626438804;11540;291;12650;12756;6.59;0.40;294.42;13.74;1110;73;4366.00;106
11543;72;626438818;11543;289;12652;12756;6.67;0.40;294.43;13.74;1109;73;4367.00;104
11545;72;626438832;11545;298;12661;12769;6.74;0.41;294.42;13.73;1116;73;4368.00;108
11549;72;626438848;11549;292;12661;12769;6.81;0.41;294.47;13.73;1112;73;4369.00;108
11552;72;626438863;11552;294;12662;12769;6.85;0.42;294.49;13.74;1110;73;4370.00;107
11554;72;626438878;11554;300;12663;12770;6.93;0.42;294.53;13.74;1109;73;4371.00;107
11555;72;626438893;11555;296;12663;12771;7.01;0.43;294.57;13.74;1108;73;4372.00;108
11558;72;626438907;11558;292;12664;12771;7.08;0.43;294.60;13.74;1106;73;4373.00;107
11564;72;626438922;11564;284;12666;12774;7.18;0.44;294.72;13.74;1102;73;4374.00;108
11567;72;626438938;11567;285;12668;12774;7.27;0.44;294.69;13.74;1101;73;4375.00;106
11568;72;626438953;11568;282;12670;12774;7.33;0.45;294.72;13.75;1102;73;4376.00;104
11571;72;626438972;11571;281;12670;12774;7.37;0.45;294.73;13.75;1099;73;4377.00;104
11573;72;626438997;11573;287;12675;12780;7.44;0.45;294.76;13.75;1102;73;4378.00;105
11576;72;626439021;11576;292;12675;12780;7.47;0.45;294.76;13.75;1099;73;4379.00;105
11578;72;626439044;11578;300;12677;12780;7.53;0.46;294.81;13.77;1099;73;4380.00;103
11578;72;626439068;11578;295;12678;12780;7.59;0.46;294.81;13.77;1100;73;4381.00;102
11582;72;626439086;11582;308;12682;12784;7.57;0.46;294.85;13.78;1100;73;4382.00;102
11585;72;626439103;11585;301;12684;12785;7.56;0.46;294.85;13.79;1099;73;4383.00;101
11588;72;626439120;11588;303;12686;12785;7.58;0.46;294.86;13.80;1098;73;4384.00;99
11590;72;626439136;11590;305;12688;12786;7.55;0.46;294.87;13.81;1098;73;4385.00;98
11592;72;626439151;11592;311;12690;12786;7.52;0.46;294.83;13.82;1098;73;4386.00;96
11597;72;626439167;11597;317;12690;12786;7.49;0.46;294.87;13.82;1093;73;4387.00;96
11602;72;626439183;11602;320;12693;12786;7.47;0.45;294.88;13.84;1091;73;4388.00;93
11607;72;626439198;11607;314;12694;12786;7.46;0.45;294.93;13.85;1087;73;4389.00;92
11609;72;626439213;11609;319;12695;12786;7.38;0.45;294.94;13.85;1086;73;4390.00;91
11611;72;626439228;11611;323;12697;12786;7.31;0.44;295.02;13.87;1086;73;4391.00;89
11611;72;626439243;11611;325;12733;12856;7.41;0.45;295.02;13.83;1122;73;4392.00;123
11615;72;626439264;11615;332;12736;12857;7.37;0.45;295.05;13.86;1121;73;4393.00;121
11621;72;626439279;11621;329;12744;12857;7.34;0.45;295.10;13.86;1123;73;4394.00;113
11623;72;626439294;11623;330;12750;12857;7.32;0.45;295.11;13.87;1127;73;4395.00;107
11625;72;626439309;11625;336;12756;12857;7.30;0.44;295.13;13.89;1131;73;4396.00;101
11626;72;626439324;11626;336;12761;12857;7.22;0.44;295.14;13.89;1135;73;4397.00;96
11629;72;626439339;11629;338;12765;12857;7.15;0.44;295.22;13.90;1136;73;4398.00;92
11632;72;626439354;11632;338;12766;12857;7.16;0.44;295.34;13.91;1134;73;4399.00;91
11634;72;626439370;11634;333;12771;12858;7.17;0.44;295.30;13.92;1137;73;4400.00;87
11637;72;626439390;11637;332;12773;12859;7.20;0.44;295.35;13.93;1136;73;4401.00;86
11640;72;626439407;11640;327;12775;12859;7.20;0.44;295.33;13.93;1135;73;4402.00;84
11642;72;626439423;11642;329;12779;12863;7.15;0.44;295.35;13.94;1137;73;4403.00;84
11643;72;626439438;11643;323;12781;12863;7.10;0.43;295.40;13.95;1138;73;4404.00;82
11648;72;626439454;11648;325;12783;12863;7.06;0.43;295.39;13.96;1135;73;4405.00;80
11649;72;626439471;11649;332;12784;12863;7.10;0.43;295.43;13.96;1135;73;4406.00;79
11651;72;626439486;11651;331;12789;12869;7.17;0.44;295.44;13.96;1138;73;4407.00;80
11653;72;626439503;11653;330;12791;12869;7.18;0.44;295.45;13.97;1138;73;4408.00;78
11655;72;626439518;11655;330;12793;12869;7.16;0.44;295.52;13.97;1138;73;4409.00;76
11657;72;626439536;11657;338;12800;12875;7.13;0.44;295.54;13.97;1143;73;4410.00;75
11660;72;626439558;11660;339;12801;12875;7.08;0.43;295.55;13.97;1141;73;4411.00;74
11667;72;626439573;11667;340;12801;12875;6.96;0.43;295.66;13.97;1134;73;4412.00;74
11671;72;626439589;11671;343;12802;12876;6.83;0.42;295.70;13.98;1131;73;4413.00;74
11674;72;626439605;11674;342;12803;12877;6.73;0.41;295.71;13.98;1129;73;4414.00;74
11676;72;626439619;11676;346;12806;12877;6.59;0.40;295.72;14.01;1130;73;4415.00;71
11683;72;626439634;11683;357;12817;12890;6.42;0.39;295.78;14.00;1134;73;4416.00;73
11686;72;626439651;11686;360;12818;12890;6.28;0.38;295.85;14.00;1132;73;4417.00;72
11691;72;626439666;11691;373;12819;12890;6.17;0.38;295.86;14.01;1128;73;4418.00;71
11695;72;626439680;11695;387;12820;12891;6.07;0.37;295.85;14.01;1125;73;4419.00;71
11697;72;626439694;11697;376;12820;12891;6.00;0.37;295.90;14.01;1123;73;4420.00;71
11700;72;626439707;11700;376;12825;12895;5.93;0.36;295.92;14.01;1125;73;4421.00;70
11704;72;626439722;11704;370;12825;12895;5.90;0.36;295.98;14.01;1121;73;4422.00;70
11709;72;626439735;11709;376;12830;12899;5.86;0.36;295.96;14.04;1121;73;4423.00;69
11711;72;626439749;11711;381;12832;12899;5.87;0.36;296.01;14.04;1121;73;4424.00;67
11712;72;626439764;11712;383;12833;12899;5.93;0.36;296.02;14.05;1121;73;4425.00;66
11718;72;626439778;11718;390;12833;12899;5.92;0.36;296.06;14.05;1115;73;4426.00;66
11721;72;626439794;11721;382;12835;12899;5.92;0.36;296.11;14.05;1114;73;4427.00;64
11725;72;626439808;11725;376;12846;12911;6.01;0.37;296.17;14.05;1121;73;4428.00;65
11728;72;626439823;11728;364;12848;12911;6.06;0.37;296.16;14.05;1120;73;4429.00;63
11732;72;626439837;11732;355;12849;12911;6.08;0.37;296.18;14.05;1117;73;4430.00;62
11736;72;626439851;11736;348;12849;12911;6.07;0.37;296.20;14.05;1113;73;4431.00;62
11740;72;626439873;11740;338;12849;12911;6.04;0.37;296.24;14.05;1109;73;4432.00;62
11744;72;626439887;11744;339;12849;12911;6.04;0.37;296.29;14.05;1105;73;4433.00;62
11748;72;626439908;11748;338;12849;12912;6.07;0.37;296.43;14.05;1101;73;4434.00;63
11751;72;626439922;11751;334;12849;12912;6.09;0.37;296.41;14.05;1098;73;4435.00;63
11755;72;626439936;11755;338;12853;12918;6.20;0.38;296.38;14.05;1098;73;4436.00;65
11761;72;626439951;11761;341;12854;12919;6.19;0.38;296.37;14.05;1093;73;4437.00;65
11764;72;626439967;11764;349;12855;12919;6.17;0.38;296.40;14.05;1091;73;4438.00;64
11769;72;626439982;11769;359;12855;12919;6.14;0.37;296.51;14.05;1086;73;4439.00;64
11773;72;626439997;11773;360;12859;12924;6.12;0.37;296.56;14.04;1086;73;4440.00;65
11775;72;626440014;11775;371;12859;12924;6.10;0.37;296.57;14.04;1084;73;4441.00;65
11779;72;626440026;11779;365;12860;12924;6.10;0.37;296.54;14.08;1081;73;4442.00;64
11783;72;626440040;11783;373;12861;12925;6.10;0.37;296.58;14.08;1078;73;4443.00;64
11790;72;626440053;11790;368;12864;12929;6.03;0.37;296.60;14.08;1074;73;4444.00;65
11790;72;626440067;11790;370;12864;12929;5.97;0.36;296.60;14.08;1074;73;4445.00;65
11795;72;626440080;11795;370;12866;12932;5.97;0.37;296.63;14.08;1071;73;4446.00;66
11798;72;626440094;11798;373;12866;12932;5.98;0.37;296.62;14.08;1068;73;4447.00;66
11800;72;626440106;11800;375;12867;12932;5.99;0.37;296.62;14.08;1067;73;4448.00;65
11807;72;626440119;11807;376;12867;12932;5.94;0.36;296.58;14.08;1060;73;4449.00;65
11813;72;626440133;11813;383;12870;12936;5.99;0.37;296.55;14.07;1057;73;4450.00;66
11815;72;626440146;11815;386;12870;12936;5.98;0.37;296.55;14.07;1055;73;4451.00;66
11820;72;626440159;11820;386;12871;12936;5.94;0.36;296.47;14.07;1051;73;4452.00;65
11828;72;626440171;11828;391;12871;12936;5.87;0.36;296.48;14.07;1043;73;4453.00;65
11832;72;626440184;11832;391;12871;12937;5.79;0.35;296.44;14.07;1039;73;4454.00;66
11834;72;626440197;11834;390;12873;12939;5.80;0.36;296.43;14.07;1039;73;4455.00;66
11837;72;626440210;11837;400;12873;12939;5.79;0.36;296.40;14.07;1036;73;4456.00;66
11842;72;626440223;11842;413;12874;12940;5.74;0.35;296.35;14.07;1032;73;4457.00;66
11845;72;626440235;11845;418;12874;12940;5.76;0.35;296.31;14.07;1029;73;4458.00;66
11847;72;626440250;11847;426;12874;12940;5.74;0.35;296.28;14.07;1027;73;4459.00;66
11849;72;626440262;11849;428;12874;12940;5.76;0.35;296.29;14.07;1025;73;4460.00;66
11852;72;626440275;11852;427;12874;12940;5.71;0.35;296.28;14.07;1022;73;4461.00;66
11856;72;626440286;11856;436;12874;12940;5.64;0.35;296.30;14.07;1018;73;4462.00;66
11862;72;626440299;11862;442;12874;12940;5.57;0.34;296.25;14.07;1012;73;4463.00;66
11864;72;626440311;11864;458;12942;13067;5.99;0.37;296.23;14.00;1078;73;4464.00;125
11865;72;626440333;11865;465;12944;13068;5.97;0.37;296.23;13.99;1079;73;4465.00;124
11870;72;626440346;11870;463;12950;13068;5.93;0.37;296.24;13.99;1080;73;4466.00;118
11871;72;626440359;11871;457;12954;13068;5.91;0.37;296.23;13.98;1083;73;4467.00;114
11873;72;626440371;11873;451;12959;13068;5.90;0.37;296.19;13.98;1086;73;4468.00;109
11875;72;626440384;11875;454;12961;13068;5.94;0.37;296.22;13.98;1086;73;4469.00;107
11878;72;626440398;11878;455;12967;13068;5.99;0.37;296.25;13.98;1089;73;4470.00;101
11879;72;626440412;11879;451;12968;13068;6.06;0.38;296.23;13.98;1089;73;4471.00;100
11883;72;626440425;11883;449;12972;13069;6.10;0.38;296.19;13.97;1089;73;4472.00;97
11884;72;626440439;11884;450;12974;13070;6.08;0.38;296.19;13.97;1090;73;4473.00;96
11888;72;626440453;11888;461;12978;13070;6.00;0.37;296.19;13.97;1090;73;4474.00;92
11890;72;626440466;11890;453;12983;13071;6.02;0.37;296.19;13.97;1093;73;4475.00;88
11892;73;626440481;11892;441;12986;13071;6.07;0.37;296.16;13.97;1094;74;4476.00;85
11893;73;626440512;11893;425;12988;13071;6.19;0.38;296.17;13.97;1095;74;4477.00;83
11894;73;626440526;11894;413;12989;13071;6.29;0.39;296.16;13.97;1095;74;4478.00;82
11896;73;626440541;11896;403;12993;13075;6.42;0.39;296.15;13.97;1097;74;4479.00;82
11898;73;626440562;11898;387;12994;13075;6.56;0.40;296.14;13.97;1096;74;4480.00;81
11898;73;626440583;11898;373;12994;13075;6.65;0.41;296.14;13.97;1096;74;4481.00;81
11900;73;626440604;11900;362;12997;13078;6.82;0.42;296.12;13.96;1097;74;4482.00;81
11900;73;626440619;11900;345;12997;13078;6.87;0.42;296.12;13.96;1097;74;4483.00;81
11901;73;626440634;11901;342;12998;13078;6.89;0.42;296.11;13.97;1097;74;4484.00;80
11904;73;626440649;11904;334;13001;13082;6.87;0.42;296.06;13.96;1097;74;4485.00;81
11905;73;626440664;11905;333;13003;13083;6.95;0.42;296.04;13.96;1098;74;4486.00;80
11906;73;626440685;11906;329;13004;13083;6.99;0.43;296.03;13.96;1098;74;4487.00;79
11908;73;626440705;11908;327;13007;13087;7.03;0.43;295.99;13.96;1099;74;4488.00;80
11910;73;626440726;11910;326;13008;13087;7.05;0.43;296.02;13.96;1098;74;4489.00;79
11913;73;626440741;11913;324;13008;13087;7.03;0.43;296.00;13.96;1095;74;4490.00;79
11914;73;626440756;11914;317;13009;13088;7.09;0.43;295.99;13.96;1095;74;4491.00;79
11916;73;626440771;11916;313;13009;13088;7.12;0.43;296.01;13.96;1093;74;4492.00;79
11917;73;626440786;11917;313;13013;13094;7.14;0.43;296.00;13.95;1096;74;4493.00;81
11918;73;626440801;11918;314;13013;13094;7.12;0.43;296.00;13.95;1095;74;4494.00;81
11919;73;626440816;11919;317;13014;13095;7.13;0.43;296.00;13.95;1095;74;4495.00;81
11922;73;626440830;11922;320;13014;13095;7.12;0.43;296.05;13.95;1092;74;4496.00;81
11926;73;626440850;11926;324;13014;13095;7.10;0.43;296.07;13.95;1088;74;4497.00;81
11927;73;626440865;11927;323;13014;13095;7.08;0.43;296.13;13.95;1087;74;4498.00;81
11931;73;626440879;11931;323;13014;13095;7.01;0.42;296.17;13.95;1083;74;4499.00;81
11932;73;626440896;11932;334;13036;13145;6.96;0.42;296.16;13.93;1104;74;4500.00;109
11935;73;626440919;11935;334;13037;13147;6.95;0.42;296.14;13.93;1102;74;4501.00;110
11939;73;626440935;11939;339;13039;13147;6.95;0.42;296.19;13.92;1100;74;4502.00;108
11939;73;626440949;11939;343;13039;13147;6.92;0.42;296.19;13.92;1100;74;4503.00;108
11943;73;626440964;11943;347;13041;13147;6.89;0.42;296.23;13.92;1098;74;4504.00;106
11946;73;626440985;11946;352;13041;13147;6.89;0.42;296.36;13.92;1095;74;4505.00;106
11947;73;626441006;11947;353;13047;13151;6.89;0.42;296.40;13.92;1100;74;4506.00;104
11950;73;626441028;11950;356;13048;13151;6.85;0.42;296.48;13.92;1098;74;4507.00;103
11952;73;626441048;11952;353;13051;13155;6.85;0.42;296.48;13.92;1099;74;4508.00;104
11953;73;626441069;11953;351;13053;13156;6.82;0.42;296.49;13.91;1100;74;4509.00;103
11958;73;626441087;11958;342;13054;13156;6.76;0.41;296.55;13.91;1096;74;4510.00;102
11960;73;626441104;11960;335;13054;13156;6.71;0.41;296.59;13.91;1094;74;4511.00;102
11966;73;626441118;11966;329;13061;13169;6.66;0.41;296.71;13.91;1095;74;4512.00;108
11968;73;626441135;11968;328;13061;13169;6.66;0.41;296.69;13.91;1093;74;4513.00;108
11973;73;626441150;11973;328;13062;13169;6.63;0.40;296.76;13.91;1089;74;4514.00;107
11977;73;626441165;11977;329;13064;13170;6.61;0.40;296.88;13.91;1087;74;4515.00;106
11979;73;626441179;11979;333;13064;13171;6.60;0.40;296.90;13.91;1085;74;4516.00;107
11982;73;626441200;11982;327;13064;13171;6.61;0.40;296.93;13.91;1082;74;4517.00;107
11986;73;626441215;11986;323;13066;13174;6.64;0.40;296.93;13.90;1080;74;4518.00;108
11989;73;626441230;11989;318;13067;13174;6.60;0.40;296.99;13.90;1078;74;4519.00;107
11990;73;626441243;11990;320;13067;13174;6.66;0.41;297.02;13.90;1077;74;4520.00;107
11997;73;626441257;11997;320;13069;13174;6.60;0.40;297.04;13.95;1072;74;4521.00;105
12002;73;626441272;12002;304;13072;13180;6.55;0.40;297.09;13.95;1070;74;4522.00;108
12004;73;626441287;12004;305;13072;13180;6.49;0.40;297.11;13.95;1068;74;4523.00;108
12006;73;626441301;12006;297;13072;13180;6.54;0.40;297.11;13.95;1066;74;4524.00;108
12009;73;626441314;12009;289;13075;13180;6.46;0.39;297.18;13.98;1066;74;4525.00;105
12012;73;626441329;12012;284;13078;13184;6.42;0.39;297.17;13.98;1066;74;4526.00;106
12014;73;626441344;12014;277;13080;13185;6.43;0.39;297.20;13.98;1066;74;4527.00;105
12019;73;626441358;12019;269;13080;13185;6.41;0.39;297.23;13.98;1061;74;4528.00;105
12022;73;626441372;12022;269;13081;13186;6.45;0.39;297.21;13.97;1059;74;4529.00;105
12024;73;626441388;12024;266;13082;13186;6.50;0.40;297.23;13.98;1058;74;4530.00;104
12028;73;626441402;12028;265;13082;13186;6.50;0.40;297.22;13.98;1054;74;4531.00;104
12031;73;626441416;12031;264;13082;13186;6.57;0.40;297.26;13.98;1051;74;4532.00;104
12034;73;626441429;12034;260;13083;13186;6.60;0.40;297.30;13.98;1049;74;4533.00;103
12036;73;626441444;12036;264;13084;13186;6.65;0.41;297.32;13.98;1048;74;4534.00;102
12038;73;626441457;12038;254;13084;13186;6.75;0.41;297.34;13.98;1046;74;4535.00;102
12040;73;626441472;12040;250;13123;13256;6.84;0.42;297.38;13.94;1083;74;4536.00;133
12042;73;626441492;12042;243;13126;13257;6.91;0.42;297.40;13.98;1084;74;4537.00;131
12047;73;626441508;12047;239;13131;13257;6.99;0.43;297.40;13.98;1084;74;4538.00;126
12051;73;626441523;12051;236;13132;13257;7.00;0.43;297.43;13.98;1081;74;4539.00;125
12057;73;626441538;12057;226;13136;13257;7.05;0.43;297.41;14.02;1079;74;4540.00;121
12060;73;626441553;12060;220;13139;13257;7.08;0.43;297.43;14.02;1079;74;4541.00;118
12062;73;626441567;12062;223;13146;13257;7.15;0.43;297.40;14.03;1084;74;4542.00;111
12062;73;626441583;12062;224;13147;13257;7.22;0.44;297.40;14.03;1085;74;4543.00;110
12067;73;626441597;12067;223;13151;13258;7.26;0.44;297.45;14.03;1084;74;4544.00;107
12070;73;626441612;12070;219;13155;13260;7.32;0.44;297.44;14.02;1085;74;4545.00;105
12072;73;626441628;12072;215;13158;13260;7.33;0.44;297.42;14.02;1086;74;4546.00;102
12074;73;626441642;12074;215;13163;13264;7.34;0.45;297.44;14.02;1089;74;4547.00;101
12077;73;626441659;12077;222;13165;13264;7.35;0.45;297.45;14.02;1088;74;4548.00;99
12079;73;626441674;12079;225;13165;13264;7.31;0.44;297.44;14.02;1086;74;4549.00;99
12084;73;626441689;12084;229;13167;13264;7.29;0.44;297.55;14.04;1083;74;4550.00;97
12086;73;626441705;12086;233;13171;13270;7.30;0.44;297.55;14.04;1085;74;4551.00;99
12089;73;626441721;12089;241;13171;13270;7.32;0.44;297.69;14.04;1082;74;4552.00;99
12091;73;626441735;12091;243;13173;13270;7.37;0.45;297.71;14.06;1082;74;4553.00;97
12093;73;626441751;12093;251;13178;13273;7.38;0.45;297.78;14.06;1085;74;4554.00;95
12097;73;626441766;12097;247;13178;13273;7.34;0.45;297.82;14.06;1081;74;4555.00;95
12099;73;626441781;12099;247;13181;13273;7.29;0.44;297.86;14.08;1082;74;4556.00;92
12104;73;626441799;12104;252;13182;13274;7.24;0.44;297.91;14.08;1078;74;4557.00;92
12106;73;626441816;12106;252;13186;13275;7.23;0.44;297.95;14.10;1080;74;4558.00;89
12111;73;626441830;12111;258;13187;13275;7.21;0.44;297.95;14.10;1076;74;4559.00;88
12114;73;626441846;12114;258;13205;13301;7.26;0.44;298.03;14.10;1091;74;4560.00;96
12117;73;626441864;12117;262;13206;13301;7.30;0.44;298.06;14.10;1089;74;4561.00;95
12120;73;626441878;12120;260;13210;13301;7.31;0.44;298.08;14.12;1090;74;4562.00;91
12122;73;626441893;12122;262;13214;13302;7.34;0.45;298.13;14.13;1092;74;4563.00;88
12124;73;626441907;12124;272;13215;13302;7.27;0.44;298.15;14.13;1091;74;4564.00;87
12129;73;626441921;12129;272;13220;13306;7.20;0.44;298.21;14.15;1091;74;4565.00;86
12129;73;626441936;12129;277;13221;13306;7.14;0.43;298.21;14.15;1092;74;4566.00;85
12133;73;626441950;12133;286;13224;13310;7.03;0.43;298.23;14.15;1091;74;4567.00;86
12136;73;626441965;12136;285;13226;13310;6.90;0.42;298.26;14.17;1090;74;4568.00;84
12137;73;626441980;12137;282;13227;13310;6.83;0.42;298.26;14.19;1090;74;4569.00;83
12139;73;626441993;12139;282;13228;13310;6.73;0.41;298.27;14.20;1089;74;4570.00;82
12143;73;626442007;12143;281;13230;13310;6.66;0.41;298.25;14.22;1087;74;4571.00;80
12144;73;626442021;12144;286;13240;13322;6.68;0.41;298.30;14.21;1096;74;4572.00;82
12148;73;626442034;12148;287;13242;13322;6.61;0.40;298.30;14.23;1094;74;4573.00;80
12152;73;626442052;12152;292;13243;13322;6.58;0.40;298.31;14.23;1091;74;4574.00;79
12153;73;626442065;12153;294;13243;13322;6.63;0.40;298.35;14.23;1090;74;4575.00;79
12154;73;626442077;12154;298;13245;13322;6.64;0.41;298.40;14.25;1091;74;4576.00;77
12155;73;626442090;12155;302;13246;13322;6.70;0.41;298.43;14.25;1091;74;4577.00;76
12157;73;626442103;12157;307;13246;13323;6.72;0.41;298.44;14.25;1089;74;4578.00;77
12158;73;626442115;12158;315;13248;13323;6.71;0.41;298.49;14.27;1090;74;4579.00;75
12159;73;626442127;12159;328;13252;13329;6.75;0.41;298.50;14.26;1093;74;4580.00;77
12163;73;626442141;12163;334;13255;13330;6.67;0.41;298.53;14.28;1092;74;4581.00;75
12169;73;626442153;12169;330;13256;13330;6.55;0.40;298.58;14.28;1087;74;4582.00;74
12173;73;626442166;12173;338;13256;13330;6.41;0.39;298.54;14.28;1083;74;4583.00;74
12176;73;626442179;12176;346;13261;13334;6.31;0.39;298.49;14.29;1085;74;4584.00;73
12177;73;626442192;12177;354;13262;13334;6.20;0.38;298.49;14.30;1085;74;4585.00;72
12179;73;626442203;12179;364;13263;13334;6.08;0.37;298.48;14.30;1084;74;4586.00;71
12183;73;626442215;12183;374;13264;13335;5.97;0.37;298.54;14.30;1081;74;4587.00;71
12187;73;626442227;12187;384;13267;13339;5.83;0.36;298.58;14.30;1080;74;4588.00;72
12191;73;626442238;12191;390;13269;13339;5.72;0.35;298.62;14.31;1078;74;4589.00;70
12198;73;626442251;12198;380;13272;13345;5.60;0.34;298.65;14.31;1074;74;4590.00;73
12200;73;626442265;12200;377;13274;13345;5.53;0.34;298.70;14.32;1074;74;4591.00;71
12205;73;626442276;12205;367;13275;13345;5.46;0.34;298.71;14.32;1070;74;4592.00;70
12212;73;626442291;12212;367;13276;13345;5.42;0.33;298.70;14.32;1064;74;4593.00;69
12214;73;626442304;12214;374;13280;13349;5.47;0.34;298.70;14.33;1066;74;4594.00;69
12219;73;626442318;12219;383;13281;13349;5.48;0.34;298.67;14.33;1062;74;4595.00;68
12224;73;626442330;12224;392;13282;13349;5.45;0.33;298.61;14.33;1058;74;4596.00;67
12225;73;626442343;12225;387;13284;13349;5.45;0.33;298.63;14.34;1059;74;4597.00;65
12227;73;626442354;12227;381;13284;13350;5.44;0.33;298.65;14.34;1057;74;4598.00;66
12231;73;626442365;12231;376;13286;13351;5.46;0.33;298.65;14.34;1055;74;4599.00;65
12232;73;626442377;12232;378;13286;13351;5.48;0.34;298.63;14.34;1054;74;4600.00;65
12238;73;626442392;12238;386;13287;13352;5.44;0.33;298.62;14.33;1049;74;4601.00;65
12244;73;626442404;12244;383;13287;13352;5.40;0.33;298.57;14.33;1043;74;4602.00;65
12248;73;626442415;12248;377;13287;13352;5.40;0.33;298.54;14.33;1039;74;4603.00;65
12251;73;626442427;12251;380;13287;13352;5.35;0.33;298.51;14.33;1036;74;4604.00;65
12257;73;626442438;12257;380;13287;13352;5.30;0.32;298.49;14.33;1030;74;4605.00;65
12257;73;626442449;12257;381;13287;13352;5.33;0.33;298.49;14.33;1030;74;4606.00;65
12260;73;626442460;12260;383;13287;13352;5.34;0.33;298.50;14.33;1027;74;4607.00;65
12263;73;626442471;12263;390;13350;13479;5.82;0.36;298.47;14.27;1087;74;4608.00;129
12267;73;626442492;12267;395;13352;13480;5.81;0.36;298.46;14.27;1085;74;4609.00;128
12271;73;626442505;12271;393;13361;13480;5.91;0.37;298.46;14.26;1090;74;4610.00;119
12276;73;626442516;12276;403;13366;13480;5.95;0.37;298.42;14.25;1090;74;4611.00;114
12276;73;626442529;12276;407;13372;13480;5.97;0.37;298.42;14.25;1096;74;4612.00;108
12281;73;626442541;12281;411;13378;13480;5.94;0.37;298.35;14.24;1097;74;4613.00;102
12285;73;626442559;12285;412;13383;13480;5.91;0.37;298.37;14.24;1098;74;4614.00;97
12291;73;626442571;12291;417;13385;13480;5.86;0.36;298.41;14.24;1094;74;4615.00;95
12295;73;626442584;12295;420;13389;13481;5.85;0.36;298.38;14.24;1094;74;4616.00;92
12298;73;626442602;12298;423;13391;13482;5.81;0.36;298.36;14.24;1093;74;4617.00;91
12301;73;626442615;12301;431;13395;13482;5.74;0.35;298.36;14.24;1094;74;4618.00;87
12303;73;626442628;12303;431;13397;13483;5.68;0.35;298.35;14.23;1094;74;4619.00;86
12308;73;626442643;12308;445;13399;13483;5.61;0.35;298.34;14.23;1091;74;4620.00;84
12309;73;626442655;12309;449;13400;13483;5.57;0.34;298.34;14.23;1091;74;4621.00;83
12314;73;626442668;12314;459;13402;13483;5.58;0.34;298.39;14.23;1088;74;4622.00;81
12315;73;626442681;12315;468;13405;13487;5.61;0.35;298.43;14.23;1090;74;4623.00;82
12317;73;626442694;12317;476;13406;13487;5.60;0.35;298.44;14.23;1089;74;4624.00;81
12318;73;626442708;12318;477;13407;13487;5.61;0.35;298.41;14.23;1089;74;4625.00;80
12320;73;626442720;12320;473;13411;13490;5.62;0.35;298.42;14.28;1091;74;4626.00;79
12320;73;626442733;12320;466;13412;13490;5.64;0.35;298.42;14.28;1092;74;4627.00;78
12323;73;626442751;12323;456;13413;13490;5.63;0.35;298.39;14.28;1090;74;4628.00;77
12324;73;626442765;12324;453;13417;13494;5.69;0.35;298.36;14.28;1093;74;4629.00;77
12327;73;626442784;12327;458;13419;13495;5.73;0.35;298.40;14.27;1092;74;4630.00;76
12329;73;626442797;12329;452;13419;13495;5.75;0.35;298.38;14.27;1090;74;4631.00;76
12331;73;626442811;12331;457;13422;13499;5.81;0.36;298.36;14.27;1091;74;4632.00;77
12333;73;626442824;12333;456;13422;13499;5.83;0.36;298.37;14.27;1089;74;4633.00;77
12336;73;626442849;12336;455;13422;13499;5.84;0.36;298.37;14.27;1086;74;4634.00;77
12338;73;626442862;12338;454;13424;13501;5.90;0.36;298.35;14.27;1086;74;4635.00;77
12343;73;626442876;12343;450;13424;13501;5.90;0.36;298.37;14.27;1081;74;4636.00;77
12345;73;626442889;12345;436;13428;13507;5.91;0.36;298.36;14.26;1083;74;4637.00;79
12345;73;626442903;12345;426;13429;13507;5.99;0.37;298.36;14.26;1084;74;4638.00;78
12346;73;626442917;12346;418;13429;13508;6.00;0.37;298.35;14.26;1083;74;4639.00;79
12350;73;626442931;12350;408;13429;13508;6.03;0.37;298.30;14.26;1079;74;4640.00;79
12353;73;626442945;12353;401;13429;13508;6.07;0.37;298.31;14.26;1076;74;4641.00;79
12355;73;626442960;12355;402;13429;13508;6.09;0.37;298.32;14.26;1074;74;4642.00;79
12357;73;626442989;12357;400;13429;13508;6.12;0.37;298.29;14.26;1072;74;4643.00;79
12358;73;626443011;12358;401;13439;13520;6.27;0.38;298.28;14.25;1081;75;4644.00;81
12360;73;626443049;12360;399;13439;13520;6.32;0.39;298.26;14.25;1079;75;4645.00;81
12362;73;626443069;12362;393;13440;13520;6.41;0.39;298.25;14.25;1078;75;4646.00;80
12366;73;626443088;12366;378;13440;13520;6.46;0.39;298.26;14.25;1074;75;4647.00;80
12367;73;626443111;12367;370;13440;13520;6.56;0.40;298.26;14.25;1073;75;4648.00;80
12370;73;626443127;12370;361;13440;13520;6.60;0.40;298.30;14.25;1070;75;4649.00;80
12372;73;626443145;12372;362;13445;13526;6.64;0.40;298.29;14.25;1073;75;4650.00;81
12374;73;626443172;12374;357;13445;13526;6.62;0.40;298.36;14.25;1071;75;4651.00;81
12377;73;626443188;12377;354;13448;13530;6.65;0.40;298.41;14.24;1071;75;4652.00;82
12382;73;626443203;12382;354;13450;13531;6.64;0.40;298.47;14.24;1068;75;4653.00;81
12384;73;626443218;12384;352;13450;13531;6.63;0.40;298.53;14.24;1066;75;4654.00;81
12386;73;626443233;12386;360;13450;13531;6.66;0.40;298.55;14.24;1064;75;4655.00;81
12391;73;626443248;12391;366;13461;13544;6.66;0.40;298.66;14.23;1070;75;4656.00;83
12395;73;626443266;12395;365;13461;13544;6.68;0.40;298.67;14.23;1066;75;4657.00;83
12397;73;626443281;12397;368;13462;13544;6.69;0.41;298.69;14.28;1065;75;4658.00;82
12402;73;626443295;12402;375;13463;13545;6.66;0.40;298.72;14.28;1061;75;4659.00;82
12405;73;626443310;12405;369;13463;13546;6.66;0.40;298.74;14.28;1058;75;4660.00;83
12410;73;626443325;12410;365;13463;13546;6.65;0.40;298.73;14.28;1053;75;4661.00;83
12412;73;626443341;12412;360;13465;13549;6.68;0.40;298.74;14.28;1053;75;4662.00;84
12414;73;626443356;12414;367;13465;13549;6.67;0.40;298.79;14.28;1051;75;4663.00;84
12415;73;626443370;12415;367;13466;13549;6.69;0.40;298.79;14.28;1051;75;4664.00;83
12418;73;626443384;12418;365;13466;13549;6.69;0.40;298.83;14.28;1048;75;4665.00;83
12422;73;626443399;12422;363;13470;13555;6.71;0.41;298.94;14.27;1048;75;4666.00;85
12424;73;626443414;12424;365;13470;13555;6.80;0.41;298.95;14.27;1046;75;4667.00;85
12428;73;626443428;12428;366;13471;13555;6.80;0.41;299.05;14.27;1043;75;4668.00;84
12432;73;626443442;12432;361;13471;13555;6.82;0.41;299.11;14.27;1039;75;4669.00;84
12434;73;626443456;12434;361;13474;13559;6.78;0.41;299.20;14.27;1040;75;4670.00;85
12435;73;626443471;12435;359;13475;13560;6.79;0.41;299.24;14.27;1040;75;4671.00;85
12438;73;626443485;12438;360;13475;13560;6.80;0.41;299.26;14.27;1037;75;4672.00;85
12440;73;626443498;12440;363;13476;13561;6.81;0.41;299.31;14.27;1036;75;4673.00;85
12443;73;626443512;12443;359;13476;13561;6.82;0.41;299.34;14.27;1033;75;4674.00;85
12443;73;626443526;12443;360;13476;13561;6.80;0.41;299.34;14.27;1033;75;4675.00;85
12445;73;626443539;12445;365;13476;13561;6.73;0.41;299.33;14.27;1031;75;4676.00;85
12448;73;626443552;12448;367;13476;13561;6.63;0.40;299.41;14.27;1028;75;4677.00;85
12450;73;626443565;12450;364;13476;13561;6.54;0.40;299.48;14.27;1026;75;4678.00;85
12451;73;626443579;12451;365;13476;13561;6.49;0.40;299.46;14.27;1025;75;4679.00;85
12452;73;626443600;12452;372;13538;13686;6.49;0.40;299.46;14.20;1086;75;4680.00;148
12452;73;626443623;12452;359;13538;13687;6.53;0.40;299.46;14.20;1086;75;4681.00;149
12458;73;626443636;12458;340;13546;13687;6.57;0.40;299.48;14.19;1088;75;4682.00;141
12460;73;626443650;12460;329;13549;13687;6.63;0.41;299.49;14.19;1089;75;4683.00;138
12467;73;626443663;12467;327;13553;13687;6.62;0.41;299.57;14.19;1086;75;4684.00;134
12468;73;626443679;12468;324;13556;13687;6.73;0.41;299.60;14.19;1088;75;4685.00;131
12470;73;626443693;12470;320;13562;13687;6.75;0.41;299.59;14.18;1092;75;4686.00;125
12472;73;626443706;12472;319;13564;13687;6.76;0.41;299.61;14.18;1092;75;4687.00;123
12475;73;626443720;12475;321;13568;13688;6.77;0.41;299.64;14.18;1093;75;4688.00;120
12480;73;626443734;12480;324;13570;13689;6.67;0.41;299.70;14.18;1090;75;4689.00;119
12482;73;626443748;12482;312;13572;13689;6.63;0.41;299.75;14.18;1090;75;4690.00;117
12484;73;626443761;12484;313;13577;13693;6.57;0.40;299.76;14.18;1093;75;4691.00;116
12488;73;626443775;12488;303;13579;13693;6.56;0.40;299.79;14.17;1091;75;4692.00;114
12492;73;626443789;12492;302;13579;13693;6.50;0.40;299.83;14.17;1087;75;4693.00;114
12496;73;626443802;12496;292;13581;13693;6.43;0.39;299.87;14.17;1085;75;4694.00;112
12501;73;626443817;12501;292;13586;13699;6.31;0.39;299.96;14.19;1085;75;4695.00;113
12504;73;626443833;12504;293;13587;13699;6.28;0.38;299.93;14.25;1083;75;4696.00;112
12507;73;626443848;12507;292;13589;13699;6.27;0.38;299.94;14.25;1082;75;4697.00;110
12511;73;626443862;12511;284;13591;13702;6.29;0.38;299.94;14.24;1080;75;4698.00;111
12513;73;626443876;12513;275;13592;13702;6.32;0.39;299.93;14.24;1079;75;4699.00;110
12519;73;626443891;12519;271;13593;13702;6.39;0.39;299.95;14.30;1074;75;4700.00;109
12521;73;626443910;12521;279;13593;13703;6.45;0.39;300.02;14.30;1072;75;4701.00;110
12523;73;626443924;12523;269;13595;13704;6.50;0.40;300.04;14.35;1072;75;4702.00;109
12525;73;626443939;12525;270;13595;13704;6.55;0.40;300.04;14.35;1070;75;4703.00;109
12528;73;626443953;12528;275;13604;13717;6.60;0.40;300.02;14.34;1076;75;4704.00;113
12531;73;626443968;12531;275;13604;13717;6.68;0.41;300.04;14.34;1073;75;4705.00;113
12531;73;626443985;12531;276;13605;13717;6.83;0.41;300.04;14.39;1074;75;4706.00;112
12534;73;626443999;12534;273;13607;13718;6.92;0.42;300.08;14.39;1073;75;4707.00;111
12539;73;626444014;12539;266;13607;13718;6.99;0.42;300.06;14.39;1068;75;4708.00;111
12544;73;626444027;12544;258;13611;13722;7.06;0.43;300.14;14.44;1067;75;4709.00;111
12545;73;626444045;12545;253;13612;13722;7.08;0.43;300.17;14.45;1067;75;4710.00;110
12548;73;626444061;12548;258;13616;13726;7.16;0.43;300.24;14.44;1068;75;4711.00;110
12549;73;626444079;12549;251;13617;13726;7.22;0.44;300.24;14.44;1068;75;4712.00;109
12552;73;626444093;12552;258;13617;13726;7.21;0.44;300.26;14.44;1065;75;4713.00;109
12553;73;626444107;12553;256;13618;13726;7.19;0.44;300.27;14.44;1065;75;4714.00;108
12554;73;626444125;12554;260;13618;13726;7.19;0.44;300.29;14.44;1064;75;4715.00;108
12556;73;626444142;12556;265;13629;13738;7.24;0.44;300.27;14.43;1073;75;4716.00;109
12558;73;626444157;12558;266;13630;13738;7.25;0.44;300.34;14.43;1072;75;4717.00;108
12559;73;626444171;12559;270;13631;13738;7.22;0.44;300.34;14.43;1072;75;4718.00;107
12562;73;626444186;12562;282;13631;13738;7.24;0.44;300.42;14.43;1069;75;4719.00;107
12567;73;626444200;12567;283;13632;13738;7.26;0.44;300.49;14.45;1065;75;4720.00;106
12571;73;626444214;12571;282;13633;13738;7.25;0.44;300.54;14.45;1062;75;4721.00;105
12571;73;626444231;12571;285;13635;13739;7.29;0.44;300.54;14.47;1064;75;4722.00;104
12573;73;626444246;12573;289;13635;13739;7.29;0.44;300.60;14.47;1062;75;4723.00;104
12575;73;626444262;12575;293;13642;13745;7.28;0.44;300.64;14.51;1067;75;4724.00;103
12578;73;626444288;12578;296;13645;13747;7.27;0.44;300.66;14.50;1067;75;4725.00;102
12581;73;626444313;12581;289;13646;13747;7.24;0.44;300.71;14.52;1065;75;4726.00;101
12585;73;626444337;12585;285;13648;13747;7.26;0.44;300.71;14.54;1063;75;4727.00;99
12587;73;626444356;12587;295;13652;13751;7.28;0.44;300.70;14.55;1065;75;4728.00;99
12588;73;626444378;12588;293;13652;13751;7.25;0.44;300.72;14.55;1064;75;4729.00;99
12590;73;626444394;12590;296;13654;13751;7.21;0.44;300.75;14.57;1064;75;4730.00;97
12593;73;626444409;12593;304;13657;13752;7.18;0.44;300.79;14.58;1064;75;4731.00;95
12595;73;626444425;12595;307;13660;13756;7.14;0.44;300.81;14.58;1065;75;4732.00;96
12597;73;626444441;12597;307;13661;13756;7.10;0.43;300.85;14.59;1064;75;4733.00;95
12599;73;626444455;12599;315;13664;13759;7.10;0.43;300.95;14.60;1065;75;4734.00;95
12601;73;626444470;12601;315;13665;13759;7.02;0.43;300.99;14.60;1064;75;4735.00;94
12602;73;626444483;12602;322;13667;13759;6.99;0.43;301.02;14.62;1065;75;4736.00;92
12604;73;626444498;12604;318;13668;13759;6.92;0.42;301.01;14.63;1064;75;4737.00;91
12607;73;626444516;12607;321;13672;13763;6.92;0.42;301.03;14.63;1065;75;4738.00;91
12609;73;626444545;12609;321;13674;13763;6.83;0.42;301.06;14.65;1065;75;4739.00;89
12611;73;626444562;12611;316;13675;13763;6.79;0.41;301.11;14.65;1064;75;4740.00;88
12616;73;626444575;12616;316;13677;13763;6.71;0.41;301.10;14.66;1061;75;4741.00;86
12616;73;626444589;12616;316;13677;13764;6.67;0.41;301.10;14.66;1061;75;4742.00;87
12618;73;626444601;12618;321;13681;13765;6.66;0.41;301.17;14.69;1063;75;4743.00;84
12621;73;626444615;12621;323;13681;13765;6.62;0.40;301.14;14.69;1060;75;4744.00;84
12624;73;626444627;12624;325;13683;13766;6.60;0.40;301.11;14.69;1059;75;4745.00;83
12624;73;626444641;12624;328;13683;13766;6.61;0.40;301.11;14.69;1059;75;4746.00;83
12626;73;626444653;12626;333;13683;13766;6.60;0.40;301.14;14.69;1057;75;4747.00;83
12628;73;626444666;12628;334;13686;13766;6.60;0.40;301.19;14.72;1058;75;4748.00;80
12628;73;626444679;12628;328;13686;13766;6.67;0.41;301.19;14.72;1058;75;4749.00;80
12629;73;626444691;12629;332;13686;13766;6.69;0.41;301.17;14.72;1057;75;4750.00;80
12631;73;626444703;12631;333;13687;13766;6.66;0.41;301.14;14.72;1056;75;4751.00;79
12634;73;626444715;12634;361;13752;13893;6.85;0.42;301.16;14.65;1118;75;4752.00;141
12636;73;626444738;12636;356;13756;13894;6.75;0.42;301.14;14.66;1120;75;4753.00;138
12642;73;626444751;12642;349;13765;13894;6.71;0.41;301.13;14.66;1123;75;4754.00;129
12645;73;626444763;12645;349;13774;13894;6.64;0.41;301.12;14.65;1129;75;4755.00;120
12650;73;626444776;12650;355;13781;13894;6.53;0.40;301.18;14.65;1131;75;4756.00;113
12654;73;626444790;12654;359;13786;13894;6.42;0.40;301.13;14.65;1132;75;4757.00;108
12660;73;626444803;12660;361;13793;13894;6.28;0.39;301.10;14.65;1133;75;4758.00;101
12665;73;626444815;12665;369;13797;13894;6.13;0.38;301.05;14.66;1132;75;4759.00;97
12666;73;626444828;12666;368;13800;13895;6.09;0.38;301.04;14.65;1134;75;4760.00;95
12670;73;626444840;12670;372;13800;13896;6.05;0.37;301.00;14.65;1130;75;4761.00;96
12673;73;626444853;12673;381;13805;13896;6.03;0.37;300.98;14.67;1132;75;4762.00;91
12676;73;626444865;12676;386;13806;13897;5.97;0.37;300.97;14.67;1130;75;4763.00;91
12679;73;626444877;12679;393;13807;13897;5.92;0.37;300.94;14.67;1128;75;4764.00;90
12682;73;626444890;12682;398;13809;13897;5.89;0.36;300.92;14.67;1127;75;4765.00;88
12684;73;626444903;12684;406;13811;13897;5.85;0.36;300.95;14.67;1127;75;4766.00;86
12687;73;626444915;12687;414;13815;13901;5.83;0.36;300.93;14.67;1128;75;4767.00;86
12690;73;626444929;12690;421;13818;13901;5.80;0.36;300.90;14.68;1128;75;4768.00;83
12693;73;626444942;12693;427;13820;13901;5.81;0.36;300.92;14.68;1127;75;4769.00;81
12696;73;626444956;12696;431;13823;13907;5.79;0.36;300.94;14.68;1127;75;4770.00;84
12700;73;626444975;12700;429;13824;13907;5.71;0.35;300.92;14.68;1124;75;4771.00;83
12705;73;626444994;12705;433;13825;13907;5.67;0.35;300.94;14.68;1120;75;4772.00;82
12707;73;626445015;12707;440;13828;13911;5.62;0.35;300.94;14.67;1121;75;4773.00;83
12711;73;626445034;12711;453;13830;13912;5.60;0.34;300.91;14.67;1119;75;4774.00;82
12717;73;626445055;12717;458;13830;13912;5.53;0.34;300.85;14.67;1113;75;4775.00;82
12720;73;626445076;12720;468;13834;13916;5.50;0.34;300.84;14.67;1114;75;4776.00;82
12721;73;626445093;12721;474;13834;13916;5.46;0.34;300.84;14.67;1113;75;4777.00;82
12726;73;626445106;12726;473;13835;13916;5.38;0.33;300.92;14.67;1109;75;4778.00;81
12727;73;626445119;12727;471;13836;13917;5.42;0.33;300.93;14.67;1109;75;4779.00;81
12728;73;626445133;12728;463;13837;13917;5.47;0.34;300.91;14.67;1109;75;4780.00;80
12737;73;626445146;12737;454;13840;13923;5.39;0.33;300.86;14.66;1103;75;4781.00;83
12738;73;626445160;12738;449;13841;13923;5.46;0.33;300.87;14.66;1103;75;4782.00;82
12744;73;626445174;12744;443;13841;13924;5.45;0.33;300.81;14.66;1097;75;4783.00;83
12747;73;626445189;12747;438;13842;13924;5.50;0.34;300.83;14.66;1095;75;4784.00;82
12750;73;626445203;12750;432;13842;13924;5.56;0.34;300.84;14.66;1092;75;4785.00;82
12754;73;626445226;12754;431;13842;13924;5.62;0.34;300.82;14.66;1088;75;4786.00;82
12758;73;626445241;12758;424;13842;13924;5.70;0.35;300.79;14.66;1084;75;4787.00;82
12762;73;626445257;12762;427;13852;13936;5.83;0.36;300.79;14.65;1090;75;4788.00;84
12765;73;626445272;12765;433;13852;13936;5.91;0.36;300.78;14.65;1087;75;4789.00;84
12767;73;626445293;12767;421;13853;13936;5.92;0.36;300.77;14.65;1086;75;4790.00;83
12771;73;626445308;12771;419;13853;13936;5.92;0.36;300.75;14.65;1082;75;4791.00;83
12772;73;626445323;12772;423;13853;13936;5.96;0.36;300.76;14.65;1081;75;4792.00;83
12773;73;626445337;12773;423;13853;13936;6.01;0.37;300.76;14.65;1080;75;4793.00;83
12777;73;626445351;12777;414;13856;13940;6.03;0.37;300.77;14.65;1079;75;4794.00;84
12781;73;626445365;12781;411;13856;13940;6.03;0.37;300.79;14.65;1075;75;4795.00;84
12781;73;626445379;12781;413;13859;13944;6.05;0.37;300.79;14.64;1078;75;4796.00;85
12784;73;626445393;12784;421;13860;13945;6.00;0.37;300.77;14.64;1076;75;4797.00;85
12786;73;626445408;12786;426;13861;13945;5.96;0.36;300.75;14.64;1075;75;4798.00;84
12790;73;626445421;12790;435;13861;13945;5.91;0.36;300.73;14.64;1071;75;4799.00;84
12791;73;626445438;12791;442;13883;13986;5.99;0.37;300.74;14.62;1092;75;4800.00;103
12793;73;626445460;12793;436;13884;13986;5.93;0.36;300.80;14.62;1091;75;4801.00;102
12796;73;626445475;12796;442;13886;13986;5.90;0.36;300.80;14.62;1090;75;4802.00;100
12797;73;626445488;12797;447;13888;13987;5.94;0.36;300.80;14.61;1091;75;4803.00;99
12802;73;626445502;12802;455;13888;13988;5.87;0.36;300.80;14.61;1086;75;4804.00;100
12806;73;626445517;12806;462;13889;13988;5.84;0.36;300.81;14.61;1083;75;4805.00;99
12807;73;626445530;12807;469;13893;13991;5.80;0.36;300.79;14.61;1086;75;4806.00;98
12810;73;626445544;12810;458;13893;13991;5.68;0.35;300.79;14.61;1083;75;4807.00;98
12812;73;626445559;12812;454;13895;13991;5.63;0.35;300.87;14.67;1083;75;4808.00;96
12814;73;626445575;12814;450;13895;13991;5.64;0.35;300.88;14.67;1081;75;4809.00;96
12814;73;626445589;12814;452;13899;13997;5.66;0.35;300.88;14.67;1085;75;4810.00;98
12822;73;626445603;12822;452;13902;13997;5.62;0.34;300.84;14.66;1080;75;4811.00;95
12825;73;626445618;12825;445;13902;13997;5.66;0.34;300.86;14.66;1077;75;4812.00;95
12829;73;626445634;12829;448;13903;13997;5.70;0.35;300.85;14.66;1074;75;4813.00;94
12832;73;626445649;12832;443;13906;14001;5.74;0.35;300.89;14.66;1074;75;4814.00;95
12834;73;626445663;12834;449;13908;14003;5.80;0.35;300.94;14.66;1074;75;4815.00;95
12840;73;626445679;12840;439;13908;14003;5.83;0.35;300.89;14.66;1068;75;4816.00;95
12844;73;626445697;12844;430;13910;14004;5.88;0.36;300.98;14.66;1066;75;4817.00;94
12847;73;626445712;12847;419;13910;14004;5.92;0.36;300.95;14.66;1063;75;4818.00;94
12850;73;626445727;12850;414;13910;14004;5.94;0.36;301.04;14.66;1060;75;4819.00;94
12851;73;626445741;12851;409;13910;14004;5.94;0.36;301.10;14.66;1059;75;4820.00;94
12852;73;626445756;12852;398;13910;14004;5.99;0.36;301.11;14.66;1058;75;4821.00;94
12853;73;626445771;12853;393;13910;14004;5.97;0.36;301.12;14.66;1057;75;4822.00;94
12856;73;626445785;12856;387;13911;14004;5.96;0.36;301.18;14.66;1055;75;4823.00;93
12859;73;626445799;12859;399;13952;14074;6.00;0.36;301.18;14.61;1093;75;4824.00;122
12863;73;626445820;12863;390;13952;14075;5.98;0.36;301.22;14.61;1089;75;4825.00;123
12865;73;626445842;12865;381;13956;14075;6.07;0.37;301.28;14.61;1091;75;4826.00;119
12867;73;626445856;12867;380;13957;14075;6.14;0.37;301.31;14.61;1090;75;4827.00;118
12871;73;626445869;12871;369;13960;14077;6.20;0.38;301.32;14.61;1089;75;4828.00;117
12871;73;626445885;12871;369;13962;14077;6.24;0.38;301.32;14.61;1091;75;4829.00;115
12873;73;626445910;12873;365;13965;14077;6.25;0.38;301.38;14.61;1092;75;4830.00;112
12877;73;626445925;12877;364;13965;14077;6.28;0.38;301.43;14.61;1088;75;4831.00;112
12880;73;626445940;12880;360;13967;14078;6.29;0.38;301.50;14.61;1087;75;4832.00;111
12883;73;626445954;12883;361;13969;14079;6.33;0.38;301.53;14.60;1086;75;4833.00;110
12885;73;626445971;12885;361;13970;14079;6.31;0.38;301.56;14.60;1085;75;4834.00;109
12888;73;626445985;12888;362;13976;14083;6.27;0.38;301.53;14.60;1088;75;4835.00;107
12892;73;626446000;12892;366;13978;14083;6.27;0.38;301.59;14.60;1086;75;4836.00;105
12895;73;626446014;12895;369;13978;14083;6.26;0.38;301.71;14.60;1083;75;4837.00;105
12896;73;626446028;12896;369;13980;14083;6.30;0.38;301.72;14.60;1084;75;4838.00;103
12899;73;626446041;12899;365;13984;14089;6.24;0.38;301.80;14.60;1085;75;4839.00;105
12900;73;626446055;12900;364;13986;14089;6.28;0.38;301.81;14.60;1086;75;4840.00;103
12904;73;626446068;12904;369;13987;14089;6.24;0.38;301.95;14.60;1083;75;4841.00;102
12905;73;626446082;12905;368;13991;14092;6.29;0.38;301.95;14.60;1086;75;4842.00;101
12907;73;626446095;12907;379;13992;14092;6.29;0.38;302.00;14.60;1085;75;4843.00;100
12907;73;626446108;12907;385;13993;14092;6.32;0.38;302.00;14.60;1086;75;4844.00;99
12907;73;626446121;12907;379;13994;14093;6.35;0.39;302.00;14.59;1087;75;4845.00;99
12908;73;626446134;12908;379;13995;14094;6.34;0.39;302.00;14.59;1087;75;4846.00;99
12908;73;626446148;12908;382;13995;14094;6.33;0.38;302.00;14.59;1087;75;4847.00;99
12910;73;626446160;12910;386;14006;14107;6.34;0.39;302.04;14.58;1096;75;4848.00;101
12912;73;626446174;12912;387;14006;14107;6.33;0.38;302.04;14.58;1094;75;4849.00;101
12913;73;626446188;12913;388;14006;14107;6.30;0.38;302.02;14.58;1093;75;4850.00;101
12914;73;626446200;12914;380;14007;14108;6.23;0.38;302.01;14.58;1093;75;4851.00;101
12916;73;626446213;12916;375;14007;14108;6.16;0.37;302.00;14.58;1091;75;4852.00;101
12919;73;626446226;12919;375;14010;14112;6.17;0.37;302.01;14.58;1091;75;4853.00;102
12921;73;626446239;12921;365;14010;14112;6.16;0.37;302.01;14.58;1089;75;4854.00;102
12924;73;626446253;12924;351;14014;14116;6.12;0.37;302.05;14.57;1090;75;4855.00;102
12928;73;626446267;12928;345;14014;14116;6.14;0.37;302.08;14.57;1086;75;4856.00;102
12930;73;626446280;12930;328;14014;14116;6.17;0.37;302.10;14.57;1084;75;4857.00;102
12934;73;626446292;12934;329;14014;14116;6.14;0.37;302.10;14.57;1080;75;4858.00;102
12935;73;626446305;12935;322;14014;14116;6.16;0.37;302.11;14.57;1079;75;4859.00;102
12938;73;626446318;12938;311;14033;14150;6.22;0.38;302.16;14.55;1095;75;4860.00;117
12939;73;626446334;12939;304;14033;14150;6.24;0.38;302.15;14.55;1094;75;4861.00;117
12942;73;626446347;12942;287;14035;14150;6.26;0.38;302.19;14.55;1093;75;4862.00;115
12945;73;626446360;12945;281;14035;14150;6.28;0.38;302.23;14.55;1090;75;4863.00;115
12947;73;626446374;12947;267;14036;14150;6.31;0.39;302.26;14.55;1089;75;4864.00;114
12952;73;626446387;12952;262;14037;14150;6.35;0.39;302.37;14.56;1085;75;4865.00;113
12955;73;626446406;12955;262;14038;14151;6.40;0.39;302.42;14.56;1083;75;4866.00;113
12961;73;626446419;12961;258;14038;14151;6.43;0.39;302.50;14.56;1077;75;4867.00;113
12964;73;626446432;12964;261;14042;14157;6.52;0.40;302.52;14.56;1078;75;4868.00;115
12967;73;626446446;12967;251;14043;14158;6.56;0.40;302.53;14.56;1076;75;4869.00;115
12972;73;626446459;12972;248;14044;14158;6.56;0.40;302.65;14.56;1072;75;4870.00;114
12973;73;626446472;12973;250;14044;14158;6.53;0.40;302.67;14.56;1071;75;4871.00;114
12979;73;626446484;12979;246;14048;14162;6.42;0.39;302.70;14.62;1069;75;4872.00;114
12982;73;626446498;12982;249;14050;14162;6.38;0.39;302.71;14.62;1068;75;4873.00;112
12982;73;626446510;12982;251;14050;14162;6.39;0.39;302.71;14.62;1068;75;4874.00;112
12984;73;626446523;12984;251;14051;14163;6.46;0.39;302.72;14.62;1067;75;4875.00;112
12988;73;626446535;12988;257;14055;14167;6.46;0.39;302.73;14.68;1067;75;4876.00;112
12990;73;626446549;12990;253;14056;14167;6.48;0.39;302.73;14.68;1066;75;4877.00;111
12993;73;626446562;12993;250;14058;14170;6.54;0.40;302.74;14.68;1065;75;4878.00;112
12996;73;626446575;12996;257;14060;14170;6.56;0.40;302.74;14.68;1064;75;4879.00;110
12998;73;626446589;12998;263;14060;14170;6.59;0.40;302.72;14.68;1062;75;4880.00;110
13001;73;626446603;13001;261;14060;14170;6.62;0.40;302.75;14.68;1059;75;4881.00;110
13003;73;626446615;13003;258;14065;14174;6.66;0.40;302.73;14.67;1062;75;4882.00;109
13007;73;626446629;13007;261;14065;14174;6.66;0.40;302.74;14.67;1058;75;4883.00;109
13011;73;626446642;13011;260;14066;14174;6.62;0.40;302.69;14.67;1055;75;4884.00;108
13015;73;626446661;13015;263;14067;14174;6.64;0.40;302.74;14.69;1052;75;4885.00;107
13017;73;626446675;13017;260;14067;14175;6.67;0.40;302.82;14.69;1050;75;4886.00;108
13021;73;626446688;13021;264;14068;14176;6.67;0.40;302.86;14.69;1047;75;4887.00;108
13023;73;626446702;13023;266;14068;14176;6.66;0.40;302.88;14.69;1045;75;4888.00;108
13027;73;626446715;13027;267;14069;14177;6.66;0.40;303.02;14.68;1042;75;4889.00;108
13031;73;626446730;13031;274;14070;14177;6.64;0.40;303.10;14.70;1039;75;4890.00;107
13033;73;626446743;13033;276;14071;14177;6.60;0.40;303.14;14.71;1038;75;4891.00;106
13035;73;626446756;13035;283;14071;14177;6.53;0.40;303.18;14.71;1036;75;4892.00;106
13039;73;626446769;13039;291;14073;14177;6.46;0.39;303.20;14.74;1034;75;4893.00;104
13042;73;626446782;13042;297;14073;14177;6.39;0.39;303.25;14.74;1031;75;4894.00;104
13045;73;626446795;13045;302;14075;14177;6.35;0.39;303.30;14.76;1030;75;4895.00;102
13046;73;626446807;13046;320;14138;14304;6.55;0.40;303.30;14.69;1092;75;4896.00;166
13050;73;626446830;13050;326;14144;14305;6.54;0.40;303.39;14.71;1094;75;4897.00;161
13052;73;626446843;13052;325;14153;14305;6.59;0.41;303.36;14.70;1101;75;4898.00;152
13053;73;626446855;13053;323;14156;14305;6.59;0.41;303.35;14.70;1103;75;4899.00;149
13057;73;626446869;13057;326;14165;14305;6.55;0.40;303.33;14.72;1108;75;4900.00;140
13060;73;626446885;13060;320;14169;14305;6.55;0.40;303.35;14.71;1109;75;4901.00;136
13062;73;626446897;13062;322;14173;14305;6.57;0.41;303.34;14.72;1111;75;4902.00;132
13062;73;626446914;13062;331;14178;14305;6.54;0.40;303.34;14.73;1116;75;4903.00;127
13064;73;626446927;13064;325;14182;14306;6.54;0.40;303.32;14.74;1118;75;4904.00;124
13067;73;626446945;13067;332;14185;14308;6.51;0.40;303.26;14.74;1118;75;4905.00;123
13070;73;626446958;13070;332;14192;14308;6.50;0.40;303.22;14.76;1122;75;4906.00;116
13073;73;626446974;13073;344;14194;14309;6.44;0.40;303.18;14.76;1121;75;4907.00;115
13076;73;626446994;13076;352;14200;14309;6.36;0.39;303.13;14.77;1124;75;4908.00;109
13080;73;626447015;13080;357;14201;14309;6.24;0.38;303.09;14.77;1121;75;4909.00;108
13084;73;626447036;13084;359;14204;14309;6.14;0.38;303.06;14.79;1120;75;4910.00;105
13084;73;626447055;13084;354;14207;14313;6.07;0.37;303.06;14.79;1123;75;4911.00;106
13084;73;626447074;13084;362;14211;14313;5.98;0.37;303.06;14.81;1127;75;4912.00;102
13085;73;626447101;13085;362;14211;14313;5.90;0.36;303.05;14.81;1126;75;4913.00;102
13086;73;626447116;13086;373;14214;14316;5.87;0.36;303.05;14.81;1128;75;4914.00;102
13088;73;626447131;13088;381;14217;14316;5.83;0.36;303.02;14.83;1129;75;4915.00;99
13089;73;626447154;13089;386;14219;14316;5.85;0.36;303.00;14.83;1130;75;4916.00;97
13090;73;626447170;13090;393;14223;14320;5.84;0.36;302.99;14.84;1133;75;4917.00;97
13090;73;626447185;13090;390;14226;14321;5.86;0.36;302.99;14.84;1136;75;4918.00;95
13091;73;626447199;13091;401;14228;14321;5.82;0.36;302.97;14.85;1137;75;4919.00;93
13093;73;626447215;13093;407;14232;14326;5.80;0.35;302.96;14.85;1139;75;4920.00;94
13095;73;626447230;13095;413;14234;14326;5.70;0.35;302.93;14.86;1139;75;4921.00;92
13099;73;626447243;13099;427;14234;14326;5.59;0.34;302.95;14.86;1135;75;4922.00;92
13099;73;626447258;13099;426;14235;14327;5.50;0.34;302.95;14.86;1136;75;4923.00;92
13102;73;626447271;13102;432;14235;14327;5.44;0.33;302.96;14.86;1133;75;4924.00;92
13105;73;626447284;13105;437;14239;14333;5.38;0.33;302.93;14.86;1134;75;4925.00;94
13110;73;626447299;13110;447;14242;14333;5.27;0.32;302.93;14.88;1132;75;4926.00;91
13111;73;626447312;13111;454;14243;14334;5.17;0.32;302.93;14.88;1132;75;4927.00;91
13113;73;626447324;13113;467;14245;14334;5.03;0.31;302.90;14.89;1132;75;4928.00;89
13115;73;626447337;13115;479;14246;14334;4.90;0.30;302.89;14.90;1131;75;4929.00;88
13117;73;626447349;13117;475;14246;14334;4.78;0.29;302.88;14.90;1129;75;4930.00;88
13119;73;626447360;13119;460;14248;14334;4.71;0.29;302.89;14.91;1129;75;4931.00;86
13121;73;626447373;13121;453;14258;14346;4.75;0.29;302.88;14.90;1137;75;4932.00;88
13124;73;626447387;13124;449;14259;14346;4.71;0.29;302.88;14.90;1135;75;4933.00;87
13126;73;626447399;13126;447;14261;14346;4.71;0.29;302.88;14.91;1135;75;4934.00;85
13128;73;626447412;13128;449;14261;14346;4.75;0.29;302.87;14.91;1133;75;4935.00;85
13131;73;626447424;13131;449;14262;14346;4.77;0.29;302.89;14.91;1131;75;4936.00;84
13132;73;626447438;13132;442;14262;14346;4.88;0.30;302.91;14.91;1130;75;4937.00;84
13134;73;626447457;13134;434;14265;14350;4.99;0.31;302.92;14.91;1131;75;4938.00;85
13137;73;626447471;13137;419;14265;14350;5.09;0.31;302.92;14.91;1128;75;4939.00;85
13140;73;626447485;13140;415;14268;14354;5.23;0.32;302.89;14.91;1128;75;4940.00;86
13141;73;626447499;13141;424;14269;14355;5.33;0.33;302.90;14.91;1128;75;4941.00;86
13146;73;626447514;13146;426;14270;14355;5.39;0.33;302.86;14.91;1124;75;4942.00;85
13148;73;626447527;13148;421;14270;14355;5.48;0.34;302.86;14.91;1122;75;4943.00;85
13150;73;626447541;13150;425;14281;14368;5.66;0.35;302.87;14.90;1131;75;4944.00;87
13154;73;626447556;13154;416;14281;14368;5.73;0.35;302.84;14.90;1127;75;4945.00;87
13158;73;626447570;13158;413;14281;14368;5.77;0.35;302.84;14.90;1123;75;4946.00;87
13161;73;626447584;13161;416;14282;14369;5.84;0.36;302.84;14.89;1121;75;4947.00;87
13162;73;626447598;13162;415;14282;14370;5.88;0.36;302.84;14.89;1120;75;4948.00;88
13164;73;626447612;13164;405;14282;14370;5.89;0.36;302.83;14.89;1118;75;4949.00;88
13166;73;626447627;13166;405;14286;14379;5.95;0.36;302.83;14.89;1120;75;4950.00;93
13170;73;626447642;13170;402;14287;14379;5.95;0.36;302.85;14.89;1117;75;4951.00;92
13174;73;626447656;13174;399;14288;14379;5.98;0.37;302.86;14.89;1114;75;4952.00;91
13179;73;626447670;13179;397;14289;14379;5.96;0.36;302.89;14.96;1110;75;4953.00;90
13184;73;626447685;13184;385;14293;14385;6.01;0.37;302.90;14.95;1109;75;4954.00;92
13192;73;626447706;13192;385;14293;14385;6.03;0.37;302.98;14.95;1101;75;4955.00;92
13194;73;626447721;13194;395;14294;14385;6.06;0.37;302.99;14.95;1100;75;4956.00;91
13198;73;626447741;13198;396;14295;14385;6.05;0.37;303.01;14.95;1097;75;4957.00;90
13202;73;626447761;13202;399;14299;14389;6.08;0.37;303.08;14.95;1097;75;4958.00;90
13206;73;626447776;13206;398;14300;14390;6.13;0.37;303.10;14.95;1094;75;4959.00;90
13208;73;626447790;13208;398;14301;14390;6.16;0.38;303.12;14.95;1093;75;4960.00;89
13212;73;626447804;13212;404;14302;14391;6.16;0.38;303.13;14.95;1090;75;4961.00;89
13216;73;626447818;13216;414;14302;14391;6.15;0.38;303.11;14.95;1086;75;4962.00;89
13222;73;626447833;13222;408;14302;14391;6.12;0.37;303.19;14.95;1080;75;4963.00;89
13225;73;626447848;13225;414;14302;14391;6.12;0.37;303.22;14.95;1077;75;4964.00;89
13229;73;626447862;13229;416;14302;14391;6.13;0.37;303.22;14.95;1073;75;4965.00;89
13232;73;626447877;13232;418;14302;14391;6.12;0.37;303.22;14.95;1070;75;4966.00;89
13233;73;626447891;13233;419;14302;14391;6.20;0.38;303.20;14.95;1069;75;4967.00;89
13236;73;626447905;13236;436;14347;14461;6.27;0.38;303.27;14.90;1111;75;4968.00;114
13239;73;626447925;13239;435;14347;14462;6.31;0.39;303.31;14.90;1108;75;4969.00;115
13244;73;626447941;13244;431;14352;14462;6.39;0.39;303.33;14.89;1108;75;4970.00;110
13249;73;626447956;13249;429;14356;14462;6.47;0.39;303.35;14.89;1107;75;4971.00;106
13254;73;626447976;13254;427;14360;14462;6.51;0.40;303.34;14.89;1106;75;4972.00;102
13257;73;626447991;13257;427;14363;14462;6.53;0.40;303.42;14.89;1106;75;4973.00;99
13260;73;626448007;13260;428;14366;14462;6.52;0.40;303.48;14.88;1106;75;4974.00;96
13262;73;626448022;13262;433;14366;14462;6.48;0.40;303.48;14.88;1104;75;4975.00;96
13266;73;626448036;13266;435;14368;14463;6.44;0.39;303.54;14.88;1102;75;4976.00;95
13268;73;626448050;13268;426;14369;14464;6.39;0.39;303.59;14.88;1101;75;4977.00;95
13270;73;626448064;13270;422;14370;14464;6.35;0.39;303.61;14.88;1100;75;4978.00;94
13273;73;626448079;13273;426;14373;14468;6.33;0.39;303.67;14.88;1100;75;4979.00;95
13277;73;626448095;13277;428;14373;14468;6.32;0.39;303.81;14.88;1096;75;4980.00;95
13287;73;626448109;13287;424;14373;14468;6.35;0.39;303.89;14.88;1086;75;4981.00;95
13292;73;626448124;13292;429;14373;14468;6.35;0.39;303.94;14.88;1081;75;4982.00;95
13293;73;626448138;13293;433;14377;14474;6.39;0.39;303.94;14.87;1084;75;4983.00;97
13297;73;626448152;13297;438;14377;14474;6.40;0.39;303.95;14.87;1080;75;4984.00;97
13301;73;626448166;13301;438;14378;14474;6.41;0.39;304.03;14.87;1077;75;4985.00;96
13304;73;626448187;13304;428;14380;14477;6.44;0.39;304.05;14.87;1076;75;4986.00;97
13308;73;626448208;13308;416;14381;14477;6.48;0.40;304.07;14.87;1073;75;4987.00;96
13312;73;626448223;13312;414;14381;14477;6.51;0.40;304.12;14.87;1069;75;4988.00;96
13314;73;626448237;13314;399;14381;14478;6.54;0.40;304.14;14.87;1067;75;4989.00;97
13316;73;626448252;13316;392;14382;14479;6.54;0.40;304.14;14.87;1066;75;4990.00;97
13317;73;626448272;13317;380;14382;14479;6.53;0.40;304.16;14.87;1065;75;4991.00;97
13320;73;626448292;13320;380;14393;14492;6.54;0.40;304.18;14.86;1073;75;4992.00;99
13324;73;626448307;13324;376;14393;14492;6.51;0.39;304.18;14.86;1069;75;4993.00;99
13326;73;626448322;13326;376;14393;14492;6.45;0.39;304.20;14.86;1067;75;4994.00;99
13328;73;626448336;13328;388;14395;14494;6.44;0.39;304.28;14.86;1067;75;4995.00;99
13330;73;626448350;13330;391;14395;14494;6.43;0.39;304.28;14.86;1065;75;4996.00;99
13335;73;626448364;13335;375;14398;14498;6.44;0.39;304.32;14.85;1063;75;4997.00;100
13342;73;626448378;13342;377;14398;14498;6.39;0.39;304.33;14.85;1056;75;4998.00;100
13343;73;626448393;13343;378;14402;14502;6.38;0.39;304.38;14.85;1059;75;4999.00;100
13345;73;626448408;13345;364;14402;14502;6.36;0.38;304.41;14.85;1057;75;5000.00;100
13349;73;626448426;13349;361;14402;14502;6.34;0.38;304.40;14.85;1053;75;5001.00;100
13352;73;626448439;13352;351;14402;14502;6.30;0.38;304.37;14.85;1050;75;5002.00;100
13354;73;626448453;13354;347;14402;14502;6.26;0.38;304.44;14.85;1048;75;5003.00;100
13357;73;626448465;13357;345;14411;14514;6.33;0.38;304.50;14.84;1054;75;5004.00;103
13358;73;626448480;13358;345;14411;14514;6.37;0.39;304.50;14.84;1053;75;5005.00;103
13362;73;626448493;13362;344;14413;14514;6.34;0.38;304.69;14.84;1051;75;5006.00;101
13364;73;626448506;13364;336;14413;14514;6.33;0.38;304.68;14.84;1049;75;5007.00;101
13366;73;626448519;13366;327;14413;14514;6.33;0.38;304.66;14.84;1047;75;5008.00;101
13369;73;626448532;13369;324;14413;14514;6.30;0.38;304.68;14.84;1044;75;5009.00;101
13371;73;626448546;13371;322;14413;14515;6.30;0.38;304.71;14.84;1042;75;5010.00;102
13373;73;626448559;13373;322;14413;14515;6.34;0.39;304.78;14.84;1040;75;5011.00;102
13374;73;626448572;13374;325;14417;14521;6.33;0.38;304.78;14.83;1043;75;5012.00;104
13375;73;626448585;13375;328;14418;14522;6.33;0.38;304.76;14.83;1043;75;5013.00;104
13377;73;626448598;13377;332;14419;14522;6.36;0.39;304.81;14.83;1042;75;5014.00;103
13380;73;626448610;13380;332;14419;14522;6.32;0.38;304.86;14.83;1039;75;5015.00;103
13381;73;626448623;13381;342;14422;14526;6.34;0.39;304.86;14.83;1041;75;5016.00;104
13381;73;626448637;13381;343;14422;14526;6.39;0.39;304.86;14.83;1041;75;5017.00;104
13383;73;626448650;13383;344;14422;14526;6.39;0.39;304.83;14.83;1039;75;5018.00;104
13383;73;626448662;13383;340;14423;14527;6.35;0.39;304.83;14.83;1040;75;5019.00;104
13385;73;626448675;13385;340;14426;14531;6.29;0.38;304.84;14.83;1041;75;5020.00;105
13387;73;626448688;13387;335;14426;14531;6.23;0.38;304.84;14.83;1039;75;5021.00;105
13388;73;626448701;13388;316;14428;14534;6.18;0.38;304.83;14.82;1040;75;5022.00;106
13391;73;626448713;13391;311;14428;14534;6.12;0.37;304.83;14.82;1037;75;5023.00;106
13391;73;626448726;13391;305;14429;14534;6.12;0.37;304.83;14.82;1038;75;5024.00;105
13394;73;626448738;13394;293;14430;14534;6.08;0.37;304.89;14.89;1036;75;5025.00;104
13394;73;626448752;13394;288;14433;14538;6.12;0.37;304.89;14.89;1039;75;5026.00;105
13398;73;626448764;13398;275;14433;14538;6.12;0.37;304.89;14.89;1035;75;5027.00;105
13402;73;626448776;13402;274;14434;14538;6.10;0.37;304.91;14.89;1032;75;5028.00;104
13405;73;626448788;13405;260;14434;14538;6.02;0.37;304.94;14.89;1029;75;5029.00;104
13409;73;626448800;13409;251;14434;14539;5.92;0.36;305.01;14.89;1025;75;5030.00;105
13409;73;626448813;13409;250;14435;14540;5.90;0.36;305.01;14.89;1026;75;5031.00;105
13415;73;626448825;13415;240;14435;14540;5.77;0.35;305.05;14.89;1020;75;5032.00;105
13418;73;626448837;13418;235;14436;14541;5.72;0.35;305.09;14.88;1018;75;5033.00;105
13422;73;626448849;13422;237;14436;14541;5.69;0.35;305.11;14.88;1014;75;5034.00;105
13427;73;626448860;13427;233;14437;14541;5.68;0.35;305.14;14.90;1010;75;5035.00;104
13431;73;626448874;13431;230;14437;14541;5.65;0.34;305.17;14.90;1006;75;5036.00;104
13435;73;626448885;13435;233;14437;14541;5.67;0.35;305.20;14.90;1002;75;5037.00;104
13441;73;626448896;13441;228;14437;14541;5.61;0.34;305.22;14.90;996;75;5038.00;104
13444;73;626448913;13444;224;14437;14541;5.60;0.34;305.20;14.90;993;75;5039.00;104
13449;73;626448926;13449;251;14536;14771;5.83;0.36;305.24;14.86;1087;75;5040.00;235
13449;73;626448962;13449;243;14539;14772;5.83;0.36;305.24;14.86;1090;75;5041.00;233
13450;73;626448980;13450;234;14546;14772;5.92;0.37;305.22;14.86;1096;75;5042.00;226
13451;73;626448999;13451;225;14551;14772;5.98;0.37;305.31;14.92;1100;75;5043.00;221
13452;73;626449018;13452;230;14558;14772;6.01;0.37;305.34;14.91;1106;75;5044.00;214
13454;73;626449045;13454;222;14566;14772;6.04;0.38;305.32;14.97;1112;75;5045.00;206
13456;73;626449064;13456;225;14573;14772;6.11;0.38;305.29;14.97;1117;75;5046.00;199
13458;73;626449085;13458;221;14578;14772;6.17;0.38;305.29;14.97;1120;75;5047.00;194
13462;73;626449103;13462;225;14585;14773;6.18;0.38;305.21;14.96;1123;75;5048.00;188
13466;73;626449123;13466;220;14587;14774;6.22;0.38;305.24;14.96;1121;75;5049.00;187
13467;73;626449137;13467;215;14591;14774;6.24;0.39;305.23;14.96;1124;75;5050.00;183
13469;73;626449152;13469;221;14596;14775;6.24;0.38;305.20;14.96;1127;75;5051.00;179
13469;73;626449166;13469;236;14601;14775;6.24;0.38;305.20;14.96;1132;75;5052.00;174
13470;73;626449182;13470;240;14605;14775;6.24;0.38;305.19;14.96;1135;75;5053.00;170
13470;73;626449196;13470;247;14608;14775;6.28;0.39;305.19;14.96;1138;75;5054.00;167
13473;73;626449211;13473;255;14613;14779;6.23;0.38;305.15;14.97;1140;75;5055.00;166
13475;73;626449225;13475;255;14616;14779;6.21;0.38;305.12;14.97;1141;75;5056.00;163
13477;73;626449240;13477;263;14620;14779;6.15;0.38;305.11;14.97;1143;75;5057.00;159
13478;73;626449255;13478;268;14624;14782;6.16;0.38;305.09;14.97;1146;75;5058.00;158
13479;73;626449271;13479;270;14625;14782;6.17;0.38;305.08;14.97;1146;75;5059.00;157
13479;73;626449285;13479;279;14630;14782;6.20;0.38;305.08;14.99;1151;75;5060.00;152
13482;73;626449300;13482;286;14634;14786;6.21;0.38;305.05;14.99;1152;75;5061.00;152
13484;74;626449315;13484;291;14640;14787;6.24;0.38;305.03;15.01;1156;76;5062.00;147
13486;74;626449350;13486;293;14642;14787;6.22;0.38;305.00;15.02;1156;76;5063.00;145
13487;74;626449364;13487;302;14644;14791;6.24;0.38;304.99;15.02;1157;76;5064.00;147
13487;74;626449379;13487;314;14648;14791;6.22;0.38;304.99;15.04;1161;76;5065.00;143
13489;74;626449394;13489;314;14650;14791;6.19;0.38;304.97;15.04;1161;76;5066.00;141
13491;74;626449408;13491;324;14655;14792;6.22;0.38;304.94;15.05;1164;76;5067.00;137
13494;74;626449422;13494;325;14657;14792;6.24;0.38;304.89;15.07;1163;76;5068.00;135
13496;74;626449437;13496;326;14662;14798;6.23;0.38;304.87;15.08;1166;76;5069.00;136
13498;74;626449460;13498;331;14664;14798;6.16;0.38;304.87;15.09;1166;76;5070.00;134
13500;74;626449474;13500;342;14668;14799;6.06;0.37;304.86;15.10;1168;76;5071.00;131
13504;74;626449490;13504;341;14671;14799;5.93;0.36;304.83;15.12;1167;76;5072.00;128
13506;74;626449504;13506;344;14673;14799;5.84;0.36;304.78;15.13;1167;76;5073.00;126
13507;74;626449519;13507;359;14675;14799;5.80;0.36;304.78;15.14;1168;76;5074.00;124
13508;74;626449532;13508;371;14678;14799;5.70;0.35;304.79;15.15;1170;76;5075.00;121
13509;74;626449547;13509;383;14688;14811;5.70;0.35;304.78;15.14;1179;76;5076.00;123
13512;74;626449561;13512;388;14689;14811;5.61;0.34;304.75;15.16;1177;76;5077.00;122
13514;74;626449574;13514;392;14692;14811;5.54;0.34;304.72;15.17;1178;76;5078.00;119
13514;74;626449588;13514;395;14693;14811;5.49;0.34;304.72;15.17;1179;76;5079.00;118
13514;74;626449602;13514;400;14695;14811;5.46;0.33;304.72;15.19;1181;76;5080.00;116
13519;74;626449616;13519;395;14696;14811;5.38;0.33;304.67;15.19;1177;76;5081.00;115
13521;74;626449630;13521;403;14702;14815;5.34;0.33;304.65;15.21;1181;76;5082.00;113
13523;74;626449644;13523;392;14702;14815;5.38;0.33;304.62;15.21;1179;76;5083.00;113
13523;74;626449658;13523;382;14705;14819;5.41;0.33;304.62;15.20;1182;76;5084.00;114
13523;74;626449672;13523;370;14710;14821;5.42;0.33;304.62;15.22;1187;76;5085.00;111
13527;74;626449687;13527;363;14710;14821;5.41;0.33;304.60;15.22;1183;76;5086.00;111
13529;74;626449701;13529;369;14712;14821;5.45;0.33;304.58;15.24;1183;76;5087.00;109
13530;74;626449717;13530;363;14723;14834;5.56;0.34;304.57;15.22;1193;76;5088.00;111
13531;74;626449732;13531;360;14723;14834;5.63;0.34;304.56;15.22;1192;76;5089.00;111
13531;74;626449747;13531;353;14725;14834;5.66;0.35;304.56;15.24;1194;76;5090.00;109
13533;74;626449762;13533;350;14726;14835;5.68;0.35;304.56;15.24;1193;76;5091.00;109
13534;74;626449777;13534;346;14728;14836;5.68;0.35;304.55;15.26;1194;76;5092.00;108
13534;74;626449793;13534;349;14728;14836;5.73;0.35;304.55;15.26;1194;76;5093.00;108
13539;74;626449808;13539;347;14730;14839;5.73;0.35;304.55;15.25;1191;76;5094.00;109
13539;74;626449833;13539;348;14733;14839;5.78;0.35;304.55;15.27;1194;76;5095.00;106
13544;74;626449848;13544;354;14733;14839;5.73;0.35;304.54;15.27;1189;76;5096.00;106
13546;74;626449862;13546;364;14733;14839;5.73;0.35;304.53;15.27;1187;76;5097.00;106
13549;74;626449876;13549;376;14739;14845;5.72;0.35;304.52;15.28;1190;76;5098.00;106
13552;74;626449891;13552;379;14740;14845;5.67;0.35;304.54;15.28;1188;76;5099.00;105
13554;74;626449908;13554;378;14746;14864;5.63;0.35;304.52;15.29;1192;76;5100.00;118
13555;74;626449929;13555;371;14747;14864;5.63;0.35;304.53;15.29;1192;76;5101.00;117
13558;74;626449944;13558;377;14752;14868;5.63;0.35;304.55;15.29;1194;76;5102.00;116
13561;74;626449958;13561;379;14753;14869;5.65;0.35;304.59;15.29;1192;76;5103.00;116
13564;74;626449977;13564;383;14753;14869;5.62;0.35;304.71;15.29;1189;76;5104.00;116
13567;74;626449994;13567;391;14757;14870;5.62;0.35;304.77;15.30;1190;76;5105.00;113
13571;74;626450008;13571;394;14758;14870;5.63;0.35;304.80;15.30;1187;76;5106.00;112
13574;74;626450022;13574;394;14760;14870;5.64;0.35;304.83;15.31;1186;76;5107.00;110
13577;74;626450037;13577;393;14761;14870;5.72;0.35;304.87;15.31;1184;76;5108.00;109
13580;74;626450050;13580;380;14761;14870;5.74;0.35;304.83;15.31;1181;76;5109.00;109
13584;74;626450064;13584;378;14761;14870;5.74;0.35;304.94;15.31;1177;76;5110.00;109
13585;74;626450078;13585;371;14761;14870;5.78;0.36;304.94;15.31;1176;76;5111.00;109
13591;74;626450091;13591;372;14794;14940;5.89;0.36;304.93;15.28;1203;76;5112.00;146
13597;74;626450111;13597;361;14798;14941;5.90;0.36;304.94;15.28;1201;76;5113.00;143
13600;74;626450125;13600;367;14806;14941;6.04;0.37;305.02;15.27;1206;76;5114.00;135
13605;74;626450140;13605;357;14807;14941;6.04;0.37;305.04;15.27;1202;76;5115.00;134
13608;74;626450154;13608;360;14812;14941;6.12;0.37;305.06;15.26;1204;76;5116.00;129
13614;74;626450168;13614;360;14812;14941;6.07;0.37;305.05;15.26;1198;76;5117.00;129
13617;74;626450183;13617;353;14816;14941;6.09;0.37;305.13;15.26;1199;76;5118.00;125
13622;74;626450197;13622;351;14819;14941;6.08;0.37;305.13;15.26;1197;76;5119.00;122
13628;74;626450212;13628;354;14821;14942;6.07;0.37;305.21;15.26;1193;76;5120.00;121
13635;74;626450226;13635;363;14824;14943;6.08;0.37;305.15;15.26;1189;76;5121.00;119
13637;74;626450241;13637;364;14826;14943;6.08;0.37;305.15;15.26;1189;76;5122.00;117
13640;74;626450255;13640;366;14829;14947;6.10;0.37;305.19;15.25;1189;76;5123.00;118
13645;74;626450270;13645;372;14830;14947;6.10;0.37;305.20;15.25;1185;76;5124.00;117
13649;74;626450285;13649;372;14831;14947;6.14;0.37;305.24;15.26;1182;76;5125.00;116
13655;74;626450299;13655;378;14831;14947;6.15;0.38;305.30;15.26;1176;76;5126.00;116
13660;74;626450314;13660;384;14834;14953;6.17;0.38;305.35;15.25;1174;76;5127.00;119
13666;74;626450329;13666;388;14834;14953;6.14;0.37;305.34;15.25;1168;76;5128.00;119
13669;74;626450350;13669;389;14834;14953;6.12;0.37;305.41;15.25;1165;76;5129.00;119
13672;74;626450366;13672;395;14838;14959;6.18;0.38;305.45;15.25;1166;76;5130.00;121
13675;74;626450382;13675;401;14839;14959;6.20;0.38;305.52;15.25;1164;76;5131.00;120
13681;74;626450396;13681;404;14839;14959;6.17;0.38;305.59;15.25;1158;76;5132.00;120
13681;74;626450411;13681;400;14841;14960;6.15;0.38;305.59;15.25;1160;76;5133.00;119
13685;74;626450426;13685;408;14842;14961;6.16;0.38;305.66;15.25;1157;76;5134.00;119
13688;74;626450440;13688;412;14843;14961;6.12;0.38;305.73;15.25;1155;76;5135.00;118
13692;74;626450455;13692;419;14853;14974;6.14;0.38;305.76;15.24;1161;76;5136.00;121
13696;74;626450471;13696;423;14854;14974;6.12;0.37;305.80;15.24;1158;76;5137.00;120
13699;74;626450486;13699;424;14854;14974;6.12;0.38;305.81;15.24;1155;76;5138.00;120
13704;74;626450500;13704;425;14856;14975;6.12;0.37;305.81;15.24;1152;76;5139.00;119
13709;74;626450515;13709;430;14856;14975;6.05;0.37;305.91;15.24;1147;76;5140.00;119
13711;74;626450530;13711;432;14860;14979;6.02;0.37;305.94;15.25;1149;76;5141.00;119
13717;74;626450544;13717;436;14861;14979;5.99;0.37;306.03;15.25;1144;76;5142.00;118
13721;74;626450559;13721;441;14866;14983;5.98;0.37;306.02;15.24;1145;76;5143.00;117
13725;74;626450573;13725;446;14867;14983;5.99;0.37;306.09;15.24;1142;76;5144.00;116
13727;74;626450588;13727;445;14868;14983;6.00;0.37;306.12;15.24;1141;76;5145.00;115
13734;74;626450602;13734;452;14869;14983;5.95;0.36;306.16;15.24;1135;76;5146.00;114
13737;74;626450616;13737;445;14869;14983;5.94;0.36;306.21;15.24;1132;76;5147.00;114
13739;74;626450630;13739;444;14878;14995;6.01;0.37;306.20;15.24;1139;76;5148.00;117
13746;74;626450647;13746;436;14880;14995;5.99;0.37;306.30;15.23;1134;76;5149.00;115
13749;74;626450663;13749;435;14882;14995;6.02;0.37;306.32;15.23;1133;76;5150.00;113
13754;74;626450677;13754;437;14883;14995;6.03;0.37;306.37;15.23;1129;76;5151.00;112
13758;74;626450692;13758;436;14884;14995;6.01;0.37;306.50;15.23;1126;76;5152.00;111
13760;74;626450707;13760;434;14884;14995;6.06;0.37;306.49;15.23;1124;76;5153.00;111
13765;74;626450722;13765;437;14884;14996;6.05;0.37;306.54;15.23;1119;76;5154.00;112
13768;74;626450736;13768;441;14886;14998;6.03;0.37;306.61;15.23;1118;76;5155.00;112
13769;74;626450752;13769;429;14890;15004;6.06;0.37;306.59;15.23;1121;76;5156.00;114
13773;74;626450766;13773;422;14892;15005;6.05;0.37;306.67;15.22;1119;76;5157.00;113
13775;74;626450781;13775;413;14892;15005;6.07;0.37;306.70;15.22;1117;76;5158.00;113
13776;74;626450796;13776;410;14892;15005;6.10;0.37;306.75;15.22;1116;76;5159.00;113
13780;74;626450811;13780;405;14896;15010;6.14;0.37;306.79;15.22;1116;76;5160.00;114
13782;74;626450827;13782;401;14896;15010;6.16;0.37;306.85;15.22;1114;76;5161.00;114
13789;74;626450842;13789;402;14896;15010;6.14;0.37;306.88;15.22;1107;76;5162.00;114
13791;74;626450856;13791;399;14898;15011;6.21;0.38;306.94;15.29;1107;76;5163.00;113
13793;74;626450872;13793;398;14901;15015;6.25;0.38;306.94;15.29;1108;76;5164.00;114
13795;74;626450886;13795;395;14901;15015;6.26;0.38;307.00;15.29;1106;76;5165.00;114
13798;74;626450900;13798;392;14903;15018;6.31;0.38;307.03;15.28;1105;76;5166.00;115
13800;74;626450915;13800;383;14904;15018;6.36;0.38;307.01;15.28;1104;76;5167.00;114
13802;74;626450930;13802;373;14904;15018;6.32;0.38;307.13;15.28;1102;76;5168.00;114
13804;74;626450945;13804;371;14904;15018;6.32;0.38;307.15;15.28;1100;76;5169.00;114
13808;74;626450959;13808;369;14907;15022;6.31;0.38;307.16;15.28;1099;76;5170.00;115
13808;74;626450975;13808;363;14908;15022;6.31;0.38;307.16;15.28;1100;76;5171.00;114
13813;74;626450998;13813;359;14908;15022;6.26;0.38;307.16;15.28;1095;76;5172.00;114
13814;74;626451029;13814;354;14908;15022;6.29;0.38;307.17;15.28;1094;76;5173.00;114
13816;74;626451059;13816;350;14908;15023;6.25;0.38;307.22;15.28;1092;76;5174.00;115
13820;74;626451081;13820;351;14910;15025;6.20;0.38;307.27;15.28;1090;76;5175.00;115
13822;74;626451100;13822;355;14910;15025;6.20;0.38;307.26;15.28;1088;76;5176.00;115
13825;74;626451118;13825;353;14911;15026;6.19;0.38;307.24;15.28;1086;76;5177.00;115
13828;74;626451132;13828;356;14911;15026;6.17;0.37;307.28;15.28;1083;76;5178.00;115
13828;74;626451153;13828;345;14911;15026;6.20;0.38;307.28;15.28;1083;76;5179.00;115
13831;74;626451169;13831;346;14911;15026;6.15;0.37;307.24;15.28;1080;76;5180.00;115
13831;74;626451185;13831;346;14911;15026;6.12;0.37;307.24;15.28;1080;76;5181.00;115
13832;74;626451203;13832;345;14911;15026;6.10;0.37;307.28;15.28;1079;76;5182.00;115
13832;74;626451219;13832;346;14911;15026;6.05;0.37;307.28;15.28;1079;76;5183.00;115
13834;74;626451233;13834;381;14982;15153;6.09;0.38;307.31;15.20;1148;76;5184.00;171
13834;74;626451262;13834;374;14984;15154;6.05;0.37;307.31;15.20;1150;76;5185.00;170
13837;74;626451277;13837;364;14988;15154;6.08;0.37;307.34;15.20;1151;76;5186.00;166
13838;74;626451292;13838;365;14990;15154;6.09;0.38;307.33;15.20;1152;76;5187.00;164
13839;74;626451306;13839;366;14995;15154;6.14;0.38;307.32;15.19;1156;76;5188.00;159
13840;74;626451320;13840;367;14997;15154;6.08;0.37;307.31;15.19;1157;76;5189.00;157
13842;74;626451337;13842;367;15001;15154;6.05;0.37;307.30;15.19;1159;76;5190.00;153
13845;74;626451351;13845;372;15002;15154;6.03;0.37;307.36;15.19;1157;76;5191.00;152
13850;74;626451366;13850;368;15006;15155;5.98;0.37;307.33;15.19;1156;76;5192.00;149
13852;74;626451388;13852;367;15010;15156;6.00;0.37;307.31;15.19;1158;76;5193.00;146
13852;74;626451402;13852;367;15015;15156;6.04;0.37;307.31;15.18;1163;76;5194.00;141
13852;74;626451416;13852;362;15019;15157;6.01;0.37;307.31;15.18;1167;76;5195.00;138
13852;74;626451430;13852;365;15021;15157;6.01;0.37;307.31;15.18;1169;76;5196.00;136
13854;74;626451444;13854;358;15022;15157;5.97;0.37;307.31;15.18;1168;76;5197.00;135
13857;74;626451458;13857;367;15024;15157;5.90;0.36;307.28;15.18;1167;76;5198.00;133
13861;74;626451473;13861;367;15027;15161;5.84;0.36;307.27;15.25;1166;76;5199.00;134
13864;74;626451489;13864;362;15028;15161;5.73;0.35;307.36;15.25;1164;76;5200.00;133
13868;74;626451507;13868;357;15029;15161;5.64;0.35;307.33;15.25;1161;76;5201.00;132
13870;74;626451525;13870;359;15031;15164;5.61;0.35;307.37;15.25;1161;76;5202.00;133
13876;74;626451542;13876;349;15033;15164;5.51;0.34;307.39;15.25;1157;76;5203.00;131
13878;74;626451564;13878;356;15034;15164;5.45;0.34;307.41;15.25;1156;76;5204.00;130
13881;74;626451578;13881;349;15039;15168;5.38;0.33;307.37;15.27;1158;76;5205.00;129
13884;74;626451595;13884;347;15041;15169;5.33;0.33;307.36;15.27;1157;76;5206.00;128
13888;74;626451608;13888;355;15041;15169;5.24;0.32;307.34;15.27;1153;76;5207.00;128
13892;74;626451622;13892;354;15044;15173;5.18;0.32;307.31;15.26;1152;76;5208.00;129
13896;74;626451636;13896;354;15044;15173;5.13;0.31;307.25;15.26;1148;76;5209.00;129
13899;74;626451651;13899;357;15044;15173;5.14;0.31;307.21;15.26;1145;76;5210.00;129
13899;74;626451665;13899;353;15045;15174;5.22;0.32;307.21;15.26;1146;76;5211.00;129
13902;74;626451679;13902;347;15046;15174;5.22;0.32;307.19;15.26;1144;76;5212.00;128
13903;74;626451693;13903;356;15049;15180;5.31;0.32;307.18;15.26;1146;76;5213.00;131
13905;74;626451707;13905;349;15049;15180;5.34;0.32;307.16;15.26;1144;76;5214.00;131
13907;74;626451722;13907;351;15052;15180;5.36;0.33;307.15;15.33;1145;76;5215.00;128
13910;74;626451735;13910;353;15052;15181;5.30;0.32;307.11;15.33;1142;76;5216.00;129
13911;74;626451750;13911;357;15054;15181;5.29;0.32;307.09;15.33;1143;76;5217.00;127
13915;74;626451763;13915;363;15054;15181;5.28;0.32;307.04;15.33;1139;76;5218.00;127
13917;74;626451777;13917;365;15055;15181;5.27;0.32;307.01;15.40;1138;76;5219.00;126
13918;74;626451791;13918;373;15075;15217;5.36;0.33;306.99;15.38;1157;76;5220.00;142
13921;74;626451809;13921;371;15076;15217;5.34;0.32;306.99;15.38;1155;76;5221.00;141
13924;74;626451823;13924;371;15078;15217;5.36;0.33;306.96;15.38;1154;76;5222.00;139
13924;74;626451836;13924;375;15080;15217;5.41;0.33;306.96;15.37;1156;76;5223.00;137
13925;74;626451849;13925;375;15081;15217;5.41;0.33;306.94;15.37;1156;76;5224.00;136
13925;74;626451863;13925;370;15082;15217;5.41;0.33;306.94;15.37;1157;76;5225.00;135
13927;74;626451876;13927;374;15086;15221;5.44;0.33;306.92;15.37;1159;76;5226.00;135
13928;74;626451891;13928;377;15087;15221;5.47;0.33;306.92;15.37;1159;76;5227.00;134
13931;74;626451904;13931;377;15092;15225;5.56;0.34;306.91;15.36;1161;76;5228.00;133
13932;74;626451919;13932;376;15093;15226;5.61;0.34;306.91;15.36;1161;76;5229.00;133
13933;74;626451934;13933;369;15097;15226;5.60;0.34;306.91;15.39;1164;76;5230.00;129
13933;74;626451948;13933;374;15097;15226;5.55;0.34;306.91;15.39;1164;76;5231.00;129
13934;74;626451961;13934;374;15107;15239;5.48;0.33;306.91;15.39;1173;76;5232.00;132
13936;74;626451982;13936;372;15109;15239;5.40;0.33;306.88;15.40;1173;76;5233.00;130
13937;74;626452003;13937;385;15109;15239;5.39;0.33;306.87;15.40;1172;76;5234.00;130
13938;74;626452017;13938;372;15112;15240;5.37;0.33;306.86;15.41;1174;76;5235.00;128
13938;74;626452035;13938;367;15113;15241;5.38;0.33;306.86;15.42;1175;76;5236.00;128
13938;74;626452049;13938;367;15113;15241;5.38;0.33;306.86;15.42;1175;76;5237.00;128
13939;74;626452063;13939;370;15117;15244;5.40;0.33;306.86;15.44;1178;76;5238.00;127
13940;75;626452076;13940;365;15117;15244;5.38;0.33;306.85;15.44;1177;77;5239.00;127
13941;75;626452103;13941;372;15120;15244;5.43;0.33;306.84;15.47;1179;77;5240.00;124
13941;75;626452121;13941;365;15121;15244;5.49;0.34;306.84;15.48;1180;77;5241.00;123
13944;75;626452134;13944;367;15126;15250;5.56;0.34;306.81;15.49;1182;77;5242.00;124
13944;76;626452150;13944;370;15129;15250;5.60;0.34;306.81;15.51;1185;78;5243.00;121
13947;76;626452176;13947;368;15129;15250;5.58;0.34;306.79;15.51;1182;78;5244.00;121
13947;77;626452196;13947;368;15129;15250;5.57;0.34;306.79;15.51;1182;79;5245.00;121
13948;77;626452220;13948;362;15134;15254;5.58;0.34;306.79;15.53;1186;79;5246.00;120
13950;77;626452234;13950;369;15135;15255;5.54;0.34;306.76;15.53;1185;79;5247.00;120
13953;77;626452253;13953;369;15137;15255;5.52;0.34;306.71;15.55;1184;79;5248.00;118
13953;77;626452267;13953;367;15138;15256;5.50;0.33;306.71;15.55;1185;79;5249.00;118
13955;77;626452282;13955;365;15138;15256;5.50;0.33;306.69;15.55;1183;79;5250.00;118
13956;77;626452295;13956;364;15140;15256;5.52;0.34;306.67;15.57;1184;79;5251.00;116
13956;77;626452308;13956;357;15140;15256;5.59;0.34;306.67;15.57;1184;79;5252.00;116
13956;77;626452321;13956;355;15142;15256;5.65;0.34;306.67;15.59;1186;79;5253.00;114
13956;78;626452334;13956;352;15142;15256;5.71;0.35;306.67;15.59;1186;80;5254.00;114
13959;78;626452359;13959;353;15144;15256;5.76;0.35;306.65;15.61;1185;80;5255.00;112
13959;78;626452372;13959;360;15183;15326;6.03;0.37;306.65;15.57;1224;80;5256.00;143
13962;78;626452397;13962;357;15186;15327;6.08;0.37;306.68;15.56;1224;80;5257.00;141
13967;78;626452411;13967;353;15194;15327;6.09;0.37;306.71;15.56;1227;80;5258.00;133
13968;78;626452425;13968;348;15199;15327;6.11;0.37;306.71;15.55;1231;80;5259.00;128
13970;78;626452444;13970;360;15206;15327;6.08;0.37;306.76;15.57;1236;80;5260.00;121
13975;78;626452464;13975;358;15210;15327;6.00;0.37;306.76;15.57;1235;80;5261.00;117
13977;78;626452479;13977;361;15215;15327;5.96;0.36;306.80;15.60;1238;80;5262.00;112
13981;78;626452493;13981;366;15216;15327;5.84;0.36;306.79;15.60;1235;80;5263.00;111
13987;78;626452506;13987;368;15218;15328;5.75;0.35;306.81;15.60;1231;80;5264.00;110
13990;78;626452520;13990;381;15221;15330;5.65;0.34;306.78;15.61;1231;80;5265.00;109
13996;78;626452534;13996;384;15223;15330;5.53;0.34;306.82;15.62;1227;80;5266.00;107
14002;78;626452548;14002;386;15226;15334;5.42;0.33;306.80;15.62;1224;80;5267.00;108
14006;78;626452563;14006;391;15228;15334;5.35;0.32;306.82;15.63;1222;80;5268.00;106
14010;78;626452576;14010;400;15228;15334;5.31;0.32;306.86;15.63;1218;80;5269.00;106
14010;78;626452590;14010;390;15229;15334;5.33;0.32;306.86;15.64;1219;80;5270.00;105
14016;78;626452604;14016;386;15234;15340;5.30;0.32;306.96;15.64;1218;80;5271.00;106
14018;78;626452619;14018;384;15234;15340;5.29;0.32;307.00;15.64;1216;80;5272.00;106
14020;78;626452632;14020;386;15236;15340;5.36;0.33;307.02;15.65;1216;80;5273.00;104
14025;78;626452646;14025;389;15239;15343;5.36;0.33;307.15;15.65;1214;80;5274.00;104
14027;78;626452660;14027;390;15239;15343;5.39;0.33;307.19;15.65;1212;80;5275.00;104
14031;78;626452674;14031;397;15241;15343;5.39;0.33;307.19;15.65;1210;80;5276.00;102
14033;78;626452689;14033;391;15241;15344;5.42;0.33;307.22;15.65;1208;80;5277.00;103
14035;78;626452704;14035;393;15242;15345;5.48;0.33;307.28;15.65;1207;80;5278.00;103
14040;78;626452718;14040;392;15242;15345;5.59;0.34;307.29;15.65;1202;80;5279.00;103
14042;78;626452735;14042;395;15262;15371;5.69;0.35;307.33;15.63;1220;80;5280.00;109
14046;78;626452751;14046;389;15264;15371;5.74;0.35;307.38;15.70;1218;80;5281.00;107
14051;78;626452767;14051;379;15265;15371;5.83;0.36;307.41;15.70;1214;80;5282.00;106
14055;78;626452782;14055;382;15266;15372;5.85;0.36;307.52;15.70;1211;80;5283.00;106
14058;78;626452796;14058;379;15266;15372;5.91;0.36;307.55;15.70;1208;80;5284.00;106
14064;78;626452811;14064;380;15270;15376;5.95;0.36;307.56;15.70;1206;80;5285.00;106
14066;78;626452827;14066;376;15270;15376;5.99;0.37;307.60;15.70;1204;80;5286.00;106
14072;78;626452842;14072;369;15273;15379;6.02;0.37;307.62;15.69;1201;80;5287.00;106
14077;78;626452857;14077;358;15273;15380;6.03;0.37;307.72;15.69;1196;80;5288.00;107
14082;78;626452871;14082;353;15273;15380;6.07;0.37;307.75;15.69;1191;80;5289.00;107
14086;78;626452886;14086;357;15273;15380;6.08;0.37;307.81;15.69;1187;80;5290.00;107
14093;78;626452901;14093;360;15273;15380;6.03;0.37;307.85;15.69;1180;80;5291.00;107
14094;78;626452917;14094;364;15283;15392;6.15;0.37;307.88;15.68;1189;80;5292.00;109
14098;78;626452938;14098;363;15284;15392;6.21;0.38;307.98;15.68;1186;80;5293.00;108
14103;78;626452953;14103;365;15284;15392;6.29;0.38;307.98;15.68;1181;80;5294.00;108
14106;78;626452969;14106;370;15284;15392;6.34;0.38;308.04;15.68;1178;80;5295.00;108
14111;78;626452989;14111;364;15284;15392;6.34;0.39;308.13;15.68;1173;80;5296.00;108
14117;78;626453014;14117;373;15284;15392;6.35;0.39;308.14;15.68;1167;80;5297.00;108
14121;78;626453038;14121;371;15284;15393;6.39;0.39;308.22;15.68;1163;80;5298.00;109
14127;78;626453060;14127;374;15284;15393;6.40;0.39;308.21;15.68;1157;80;5299.00;109
14133;78;626453084;14133;376;15288;15399;6.40;0.39;308.24;15.68;1155;80;5300.00;111
14134;78;626453118;14134;378;15289;15400;6.42;0.39;308.24;15.68;1155;80;5301.00;111
14141;78;626453134;14141;374;15290;15400;6.41;0.39;308.25;15.68;1149;80;5302.00;110
14144;78;626453151;14144;379;15290;15400;6.38;0.39;308.27;15.68;1146;80;5303.00;110
14150;79;626453169;14150;374;15293;15404;6.39;0.39;308.28;15.67;1143;81;5304.00;111
14152;79;626453198;14152;377;15293;15404;6.46;0.39;308.35;15.67;1141;81;5305.00;111
14157;79;626453214;14157;377;15293;15404;6.42;0.39;308.44;15.67;1136;81;5306.00;111
14158;79;626453230;14158;367;15295;15405;6.45;0.39;308.43;15.74;1137;81;5307.00;110
14162;79;626453246;14162;366;15298;15409;6.44;0.39;308.43;15.74;1136;81;5308.00;111
14166;79;626453263;14166;359;15298;15409;6.39;0.39;308.50;15.74;1132;81;5309.00;111
14170;79;626453280;14170;357;15301;15415;6.42;0.39;308.55;15.73;1131;81;5310.00;114
14173;79;626453298;14173;361;15302;15415;6.40;0.39;308.63;15.73;1129;81;5311.00;113
14175;79;626453314;14175;367;15302;15415;6.40;0.39;308.67;15.73;1127;81;5312.00;113
14178;79;626453330;14178;368;15303;15415;6.42;0.39;308.78;15.73;1125;81;5313.00;112
14180;79;626453346;14180;378;15305;15419;6.38;0.39;308.77;15.73;1125;81;5314.00;114
14184;79;626453362;14184;383;15306;15419;6.35;0.39;308.81;15.73;1122;81;5315.00;113
14188;79;626453377;14188;397;15306;15419;6.27;0.38;308.87;15.73;1118;81;5316.00;113
14190;79;626453395;14190;394;15307;15419;6.21;0.38;308.90;15.73;1117;81;5317.00;112
14195;79;626453410;14195;393;15307;15420;6.10;0.37;309.01;15.73;1112;81;5318.00;113
14197;79;626453426;14197;396;15309;15421;6.10;0.37;309.04;15.73;1112;81;5319.00;112
14201;79;626453441;14201;398;15309;15421;6.07;0.37;309.01;15.73;1108;81;5320.00;112
14205;79;626453457;14205;400;15310;15422;6.10;0.37;309.07;15.73;1105;81;5321.00;112
14211;79;626453473;14211;397;15310;15422;6.12;0.37;309.18;15.73;1099;81;5322.00;112
14213;79;626453488;14213;404;15310;15422;6.16;0.38;309.16;15.73;1097;82;5323.00;112
14216;79;626453513;14216;396;15310;15422;6.14;0.38;309.20;15.73;1094;82;5324.00;112
14221;79;626453529;14221;403;15310;15422;6.09;0.37;309.23;15.73;1089;82;5325.00;112
14225;79;626453550;14225;399;15310;15422;6.07;0.37;309.30;15.73;1085;82;5326.00;112
14229;79;626453566;14229;392;15310;15422;6.04;0.37;309.36;15.73;1081;82;5327.00;112
14230;79;626453587;14230;423;15381;15549;6.09;0.38;309.35;15.65;1151;82;5328.00;168
14233;79;626453613;14233;393;15381;15550;6.11;0.38;309.40;15.65;1148;82;5329.00;169
14235;79;626453629;14235;387;15384;15550;6.20;0.38;309.42;15.65;1149;82;5330.00;166
14237;79;626453645;14237;375;15388;15550;6.28;0.39;309.44;15.65;1151;82;5331.00;162
14238;79;626453662;14238;363;15390;15550;6.33;0.39;309.44;15.65;1152;82;5332.00;160
14239;79;626453677;14239;363;15392;15550;6.39;0.40;309.48;15.64;1153;82;5333.00;158
14244;79;626453693;14244;360;15396;15550;6.45;0.40;309.46;15.64;1152;82;5334.00;154
14245;79;626453721;14245;357;15398;15550;6.53;0.40;309.51;15.71;1153;82;5335.00;152
14249;79;626453736;14249;355;15404;15551;6.59;0.41;309.52;15.70;1155;82;5336.00;147
14252;79;626453752;14252;355;15406;15552;6.67;0.41;309.54;15.70;1154;82;5337.00;146
14255;79;626453769;14255;353;15410;15552;6.72;0.41;309.58;15.70;1155;82;5338.00;142
14259;79;626453785;14259;349;15413;15553;6.68;0.41;309.70;15.70;1154;82;5339.00;140
14261;79;626453802;14261;350;15417;15553;6.68;0.41;309.68;15.70;1156;82;5340.00;136
14263;79;626453818;14263;352;15422;15553;6.70;0.41;309.75;15.70;1159;82;5341.00;131
14267;79;626453842;14267;345;15425;15553;6.65;0.41;309.83;15.70;1158;82;5342.00;128
14271;79;626453858;14271;352;15429;15557;6.63;0.41;309.92;15.70;1158;82;5343.00;128
14275;79;626453875;14275;349;15430;15557;6.60;0.40;309.94;15.70;1155;82;5344.00;127
14277;79;626453897;14277;351;15432;15557;6.56;0.40;309.92;15.70;1155;82;5345.00;125
14283;79;626453919;14283;351;15434;15560;6.49;0.40;309.95;15.69;1151;82;5346.00;126
14284;79;626453936;14284;348;15435;15560;6.44;0.39;309.99;15.69;1151;82;5347.00;125
14289;79;626453950;14289;354;15435;15560;6.35;0.39;309.98;15.69;1146;82;5348.00;125
14293;79;626453966;14293;364;15439;15564;6.28;0.38;310.02;15.69;1146;82;5349.00;125
14295;79;626453982;14295;373;15440;15565;6.22;0.38;310.02;15.69;1145;82;5350.00;125
14297;79;626453998;14297;372;15441;15565;6.16;0.38;310.06;15.69;1144;82;5351.00;124
14297;79;626454014;14297;380;15444;15569;6.11;0.37;310.06;15.68;1147;82;5352.00;125
14299;79;626454030;14299;382;15445;15569;6.00;0.37;310.02;15.69;1146;82;5353.00;124
14300;79;626454044;14300;382;15445;15569;5.89;0.36;310.01;15.69;1145;82;5354.00;124
14300;79;626454057;14300;388;15447;15571;5.80;0.35;310.01;15.68;1147;82;5355.00;124
14303;79;626454072;14303;397;15447;15571;5.69;0.35;309.99;15.68;1144;82;5356.00;124
14303;79;626454085;14303;405;15451;15577;5.64;0.35;309.99;15.68;1148;82;5357.00;126
14306;79;626454099;14306;408;15451;15577;5.56;0.34;310.01;15.68;1145;82;5358.00;126
14309;79;626454112;14309;420;15452;15577;5.48;0.33;309.98;15.68;1143;82;5359.00;125
14313;79;626454125;14313;420;15452;15578;5.40;0.33;309.95;15.68;1139;82;5360.00;126
14315;79;626454138;14315;424;15452;15578;5.35;0.33;309.95;15.68;1137;82;5361.00;126
14321;79;626454151;14321;418;15453;15578;5.26;0.32;309.87;15.74;1132;82;5362.00;125
14322;79;626454164;14322;418;15453;15578;5.23;0.32;309.85;15.74;1131;82;5363.00;125
14324;79;626454177;14324;416;15461;15590;5.19;0.32;309.82;15.74;1137;82;5364.00;129
14326;79;626454190;14326;419;15461;15590;5.11;0.31;309.81;15.74;1135;82;5365.00;129
14329;79;626454203;14329;409;15463;15590;5.05;0.31;309.79;15.73;1134;82;5366.00;127
14331;79;626454215;14331;407;15463;15590;4.99;0.30;309.78;15.73;1132;82;5367.00;127
14334;79;626454228;14334;402;15464;15590;4.97;0.30;309.77;15.73;1130;82;5368.00;126
14335;79;626454240;14335;406;15464;15590;4.92;0.30;309.81;15.73;1129;82;5369.00;126
14338;79;626454254;14338;396;15467;15594;4.91;0.30;309.78;15.73;1129;82;5370.00;127
14341;79;626454267;14341;391;15467;15594;4.91;0.30;309.76;15.73;1126;82;5371.00;127
14345;79;626454278;14345;391;15470;15598;4.87;0.30;309.84;15.73;1125;82;5372.00;128
14348;79;626454291;14348;389;15471;15599;4.86;0.30;309.83;15.73;1123;82;5373.00;128
14350;79;626454303;14350;377;15472;15599;4.85;0.30;309.84;15.73;1122;82;5374.00;127
14351;79;626454315;14351;370;15473;15599;4.87;0.30;309.83;15.74;1122;82;5375.00;126
14352;79;626454328;14352;365;15482;15612;4.92;0.30;309.86;15.73;1130;82;5376.00;130
14355;79;626454341;14355;365;15482;15612;4.93;0.30;309.84;15.73;1127;82;5377.00;130
14357;79;626454353;14357;364;15483;15612;4.99;0.30;309.82;15.73;1126;82;5378.00;129
14362;79;626454367;14362;366;15485;15613;5.00;0.31;309.79;15.73;1123;82;5379.00;128
14364;79;626454379;14364;368;15485;15614;5.00;0.31;309.78;15.73;1121;82;5380.00;129
14366;79;626454391;14366;365;15485;15614;5.04;0.31;309.74;15.73;1119;82;5381.00;129
14369;79;626454403;14369;370;15488;15617;5.11;0.31;309.75;15.80;1119;82;5382.00;129
14370;79;626454416;14370;368;15489;15617;5.15;0.31;309.74;15.80;1119;82;5383.00;128
14372;79;626454428;14372;365;15489;15617;5.16;0.31;309.73;15.80;1117;82;5384.00;128
14372;79;626454440;14372;372;15490;15617;5.18;0.32;309.73;15.87;1118;82;5385.00;127
14377;79;626454452;14377;382;15494;15623;5.19;0.32;309.69;15.86;1117;82;5386.00;129
14377;79;626454465;14377;372;15494;15623;5.19;0.32;309.69;15.86;1117;82;5387.00;129
14379;79;626454477;14379;360;15495;15623;5.23;0.32;309.67;15.86;1116;82;5388.00;128
14379;79;626454490;14379;343;15495;15623;5.28;0.32;309.67;15.86;1116;82;5389.00;128
14380;79;626454502;14380;341;15498;15627;5.30;0.32;309.66;15.86;1118;82;5390.00;129
14382;79;626454515;14382;331;15499;15628;5.33;0.32;309.63;15.86;1117;82;5391.00;129
14384;79;626454528;14384;328;15499;15628;5.35;0.32;309.63;15.86;1115;82;5392.00;129
14386;79;626454541;14386;318;15500;15629;5.41;0.33;309.67;15.86;1114;82;5393.00;129
14390;79;626454554;14390;315;15500;15629;5.46;0.33;309.70;15.86;1110;82;5394.00;129
14390;79;626454568;14390;319;15500;15629;5.59;0.34;309.70;15.86;1110;82;5395.00;129
14391;79;626454580;14391;308;15500;15629;5.66;0.34;309.69;15.86;1109;82;5396.00;129
14392;79;626454606;14392;305;15501;15629;5.70;0.35;309.67;15.87;1109;82;5397.00;128
14393;79;626454618;14393;303;15501;15629;5.72;0.35;309.67;15.87;1108;82;5398.00;128
14393;79;626454631;14393;298;15501;15629;5.71;0.35;309.67;15.87;1108;82;5399.00;128
