step_arrived;step_collisions;step_duration;step_ended;step_halting;step_inserted;step_loaded;step_meanSpeed;step_meanSpeedRelative;step_meanTravelTime;step_meanWaitingTime;step_running;step_teleports;step_time;step_waiting
0;0;626089466;0;2;85;245;16.46;1.16;-1.00;0.00;85;0;0.00;160
0;0;626089498;0;1;99;245;15.39;1.07;-1.00;0.14;99;0;1.00;146
0;0;626089499;0;3;118;245;14.77;1.01;-1.00;0.44;118;0;2.00;127
0;0;626089500;0;3;132;245;13.70;0.93;-1.00;0.71;132;0;3.00;113
0;0;626089502;0;2;144;245;12.79;0.86;-1.00;0.99;144;0;4.00;101
0;0;626089503;0;4;153;245;12.04;0.81;-1.00;1.22;153;0;5.00;92
0;0;626089505;0;6;162;245;11.28;0.76;-1.00;1.49;162;0;6.00;83
0;0;626089507;0;9;169;245;10.74;0.71;-1.00;1.72;169;0;7.00;76
0;0;626089509;0;10;177;246;10.25;0.68;-1.00;2.00;177;0;8.00;69
0;0;626089512;0;13;181;247;9.82;0.65;-1.00;2.15;181;0;9.00;66
0;0;626089515;0;16;186;247;9.65;0.64;-1.00;2.37;186;0;10.00;61
0;0;626089517;0;23;195;248;9.22;0.61;-1.00;2.71;195;0;11.00;53
1;0;626089520;1;23;199;248;9.28;0.61;12.00;2.90;198;0;12.00;49
1;0;626089523;1;30;206;248;9.17;0.60;12.00;3.21;205;0;13.00;42
1;0;626089526;1;34;208;248;9.16;0.60;12.00;3.31;207;0;14.00;40
1;0;626089529;1;37;212;252;9.10;0.59;12.00;3.40;211;0;15.00;40
1;0;626089532;1;42;216;252;9.00;0.58;12.00;3.63;215;0;16.00;36
1;0;626089535;1;44;219;252;8.90;0.57;12.00;3.82;218;0;17.00;33
2;0;626089539;2;52;223;255;9.00;0.57;15.00;3.99;221;0;18.00;32
2;0;626089543;2;56;225;255;8.98;0.57;15.00;4.12;223;0;19.00;30
3;0;626089546;3;58;227;255;9.10;0.57;16.67;4.26;224;0;20.00;28
3;0;626089550;3;65;232;259;9.26;0.58;16.67;4.28;229;0;21.00;27
4;0;626089553;4;68;239;260;9.20;0.58;18.00;4.71;235;0;22.00;21
5;0;626089557;5;72;242;260;9.09;0.57;19.00;4.94;237;0;23.00;18
5;0;626089560;5;75;248;264;9.06;0.57;19.00;5.11;243;0;24.00;16
5;0;626089564;5;79;249;264;9.08;0.57;19.00;5.19;244;0;25.00;15
5;0;626089567;5;80;251;264;9.08;0.57;19.00;5.32;246;0;26.00;13
5;0;626089571;5;85;252;265;9.09;0.57;19.00;5.40;247;0;27.00;13
6;0;626089575;6;88;255;265;9.01;0.56;19.83;5.49;249;0;28.00;10
6;0;626089579;6;90;259;271;8.96;0.56;19.83;5.42;253;0;29.00;12
6;0;626089585;6;93;262;271;8.80;0.55;19.83;5.65;256;0;30.00;9
6;0;626089589;6;95;263;272;8.77;0.54;19.83;5.63;257;0;31.00;9
8;0;626089594;8;95;264;272;8.71;0.54;22.50;5.68;256;0;32.00;8
9;0;626089598;9;102;265;272;8.70;0.54;23.67;5.78;256;0;33.00;7
9;0;626089602;9;105;265;272;8.76;0.54;23.67;5.78;256;0;34.00;7
9;0;626089606;9;108;266;272;8.78;0.54;23.67;5.83;257;0;35.00;6
12;1;626089609;12;112;279;284;8.87;0.55;25.58;5.63;267;1;36.00;5
12;1;626089628;12;115;279;284;8.75;0.54;25.58;5.63;267;1;37.00;5
12;1;626089631;12;118;280;284;8.61;0.53;25.58;5.64;268;1;38.00;4
12;1;626089635;12;121;280;284;8.60;0.53;25.58;5.64;268;1;39.00;4
14;1;626089638;14;124;281;284;8.54;0.53;27.14;5.64;267;1;40.00;3
14;1;626089643;14;126;281;284;8.42;0.52;27.14;5.64;267;1;41.00;3
15;1;626089647;15;128;285;288;8.30;0.51;27.60;5.57;270;1;42.00;3
15;1;626089650;15;132;285;288;8.11;0.50;27.60;5.57;270;1;43.00;3
18;1;626089655;18;135;288;292;7.93;0.49;28.83;5.52;270;1;44.00;4
18;1;626089659;18;141;290;294;7.83;0.48;28.83;5.49;272;1;45.00;4
18;1;626089663;18;143;291;294;7.78;0.48;28.83;5.48;273;1;46.00;3
18;1;626089666;18;142;291;294;7.67;0.47;28.83;5.48;273;1;47.00;3
18;1;626089670;18;143;302;307;7.89;0.49;28.83;5.28;284;1;48.00;5
19;1;626089675;19;147;302;307;7.72;0.47;29.84;5.28;283;1;49.00;5
19;1;626089680;19;150;302;307;7.63;0.47;29.84;5.28;283;1;50.00;5
19;1;626089684;19;151;303;308;7.59;0.47;29.84;5.26;284;1;51.00;5
19;1;626089689;19;153;304;309;7.50;0.46;29.84;5.25;285;1;52.00;5
19;1;626089694;19;156;304;309;7.44;0.46;29.84;5.25;285;1;53.00;5
20;1;626089697;20;157;306;312;7.45;0.46;31.05;5.22;286;1;54.00;6
20;1;626089700;20;158;306;312;7.35;0.45;31.05;5.22;286;1;55.00;6
24;1;626089704;24;149;307;312;7.29;0.45;32.67;5.21;283;1;56.00;5
25;1;626089708;25;144;307;312;7.17;0.44;33.64;5.21;282;1;57.00;5
26;1;626089712;26;146;312;318;7.12;0.44;34.58;5.14;286;1;58.00;6
26;1;626089716;26;144;312;318;7.15;0.44;34.58;5.14;286;1;59.00;6
26;1;626089722;26;146;313;318;7.20;0.44;34.58;5.13;287;1;60.00;5
26;1;626089725;26;147;313;318;7.27;0.45;34.58;5.13;287;1;61.00;5
29;1;626089729;29;148;317;322;7.30;0.45;36.10;5.08;288;1;62.00;5
29;1;626089733;29;149;318;323;7.52;0.46;36.10;5.06;289;1;63.00;5
29;1;626089737;29;150;318;323;7.58;0.47;36.10;5.06;289;1;64.00;5
30;1;626089741;30;151;319;324;7.72;0.47;37.07;5.05;289;1;65.00;5
30;1;626089744;30;153;319;324;7.77;0.48;37.07;5.05;289;1;66.00;5
30;1;626089748;30;145;319;324;7.84;0.48;37.07;5.05;289;1;67.00;5
31;1;626089752;31;138;319;324;7.96;0.49;36.71;5.05;288;1;68.00;5
31;1;626089756;31;134;319;324;8.14;0.50;36.71;5.05;288;1;69.00;5
31;1;626089759;31;131;319;324;8.26;0.51;36.71;5.05;288;1;70.00;5
31;1;626089763;31;128;319;324;8.39;0.51;36.71;5.05;288;1;71.00;5
31;1;626089767;31;133;354;394;8.54;0.53;36.71;4.55;323;1;72.00;40
31;1;626089777;31;123;355;395;8.66;0.53;36.71;4.54;324;1;73.00;40
33;1;626089782;33;119;362;395;9.03;0.55;38.82;4.49;329;1;74.00;33
34;1;626089786;34;115;364;395;9.17;0.56;39.65;4.48;330;1;75.00;31
35;1;626089791;35;113;368;395;9.37;0.57;40.69;4.48;333;1;76.00;27
35;1;626089803;35;113;369;395;9.44;0.58;40.69;4.48;334;1;77.00;26
36;2;626089815;36;113;372;395;9.64;0.59;41.28;4.49;336;2;78.00;23
36;2;626089838;36;113;374;395;9.74;0.60;41.28;4.51;338;2;79.00;21
38;2;626089843;38;114;376;396;9.76;0.59;43.32;4.52;338;2;80.00;20
38;2;626089848;38;114;379;397;9.88;0.60;43.32;4.54;341;2;81.00;18
38;2;626089853;38;119;381;397;9.97;0.61;43.32;4.56;343;2;82.00;16
38;2;626089857;38;124;386;401;9.94;0.60;43.32;4.53;348;2;83.00;15
39;2;626089862;39;124;386;401;9.85;0.60;44.36;4.53;347;2;84.00;15
40;2;626089866;40;124;386;401;9.81;0.59;45.38;4.53;346;2;85.00;15
40;2;626089871;40;125;386;401;9.74;0.59;45.38;4.53;346;2;86.00;15
40;2;626089876;40;127;390;407;9.63;0.58;45.38;4.49;350;2;87.00;17
42;2;626089882;42;131;390;407;9.38;0.57;47.17;4.49;348;2;88.00;17
43;2;626089887;43;136;391;407;9.25;0.56;48.02;4.49;348;2;89.00;16
43;2;626089895;43;132;394;413;9.15;0.56;48.02;4.45;351;2;90.00;19
45;2;626089907;45;131;395;413;8.99;0.55;49.93;4.44;350;2;91.00;18
46;2;626089912;46;133;395;413;8.83;0.54;50.85;4.44;349;2;92.00;18
48;2;626089918;48;131;397;414;8.78;0.53;51.10;4.43;349;2;93.00;17
49;2;626089923;49;132;398;415;8.78;0.53;51.98;4.42;349;2;94.00;17
51;2;626089929;51;132;399;415;8.82;0.54;53.67;4.42;348;2;95.00;16
52;2;626089936;52;134;409;428;8.65;0.53;54.48;4.32;357;2;96.00;19
54;2;626089944;54;132;410;428;8.57;0.52;56.06;4.31;356;2;97.00;18
57;2;626089952;57;132;410;428;8.52;0.52;58.12;4.31;353;2;98.00;18
57;2;626089958;57;129;411;429;8.68;0.53;58.12;4.30;354;2;99.00;18
59;2;626089966;59;127;411;429;8.74;0.53;59.54;4.30;352;2;100.00;18
60;2;626089979;60;125;413;433;8.82;0.54;60.22;4.28;353;2;101.00;20
60;2;626089986;60;121;413;433;8.92;0.54;60.22;4.28;353;2;102.00;20
61;2;626089993;61;118;418;437;8.98;0.55;60.87;4.25;357;2;103.00;19
61;2;626090001;61;110;420;437;9.00;0.55;60.87;4.38;359;2;104.00;17
62;2;626090008;62;104;420;437;9.06;0.55;61.56;4.38;358;2;105.00;17
64;2;626090015;64;102;420;437;9.16;0.56;62.77;4.38;356;2;106.00;17
64;2;626090021;64;98;420;437;9.27;0.56;62.77;4.38;356;2;107.00;17
64;2;626090027;64;94;431;449;9.52;0.58;62.77;4.27;367;2;108.00;18
67;2;626090035;67;86;432;449;9.69;0.59;64.79;4.26;365;2;109.00;17
67;2;626090046;67;78;432;449;9.92;0.61;64.79;4.26;365;2;110.00;17
67;2;626090053;67;78;432;449;10.16;0.62;64.79;4.26;365;2;111.00;17
68;2;626090062;68;76;432;449;10.41;0.64;65.46;4.26;364;2;112.00;17
68;2;626090071;68;74;432;449;10.67;0.65;65.46;4.26;364;2;113.00;17
68;2;626090079;68;71;433;450;10.83;0.66;65.46;4.25;365;2;114.00;17
68;2;626090088;68;72;433;450;10.97;0.67;65.46;4.25;365;2;115.00;17
69;2;626090097;69;70;437;456;11.15;0.68;65.88;4.22;368;2;116.00;19
70;2;626090108;70;69;439;457;11.30;0.69;66.60;4.21;369;2;117.00;18
72;2;626090117;72;68;440;457;11.42;0.70;67.36;4.47;368;2;118.00;17
72;2;626090129;72;67;441;457;11.49;0.70;67.36;4.56;369;2;119.00;16
76;2;626090142;76;70;445;462;11.63;0.71;69.28;4.52;369;2;120.00;17
78;2;626090159;78;70;447;462;11.71;0.71;70.59;4.88;369;2;121.00;15
80;2;626090169;80;71;449;462;11.74;0.71;71.84;5.08;369;2;122.00;13
80;2;626090181;80;72;451;463;11.81;0.72;71.84;5.33;371;2;123.00;12
81;2;626090191;81;74;457;467;11.73;0.71;72.48;5.50;376;2;124.00;10
81;2;626090203;81;75;458;467;11.81;0.72;72.48;5.66;377;2;125.00;9
81;2;626090214;81;77;462;470;11.84;0.72;72.48;5.75;381;2;126.00;8
81;2;626090225;81;82;464;470;11.83;0.72;72.48;5.92;383;2;127.00;6
82;2;626090240;82;84;465;470;11.95;0.73;73.13;5.91;383;2;128.00;5
82;2;626090249;82;87;466;470;12.01;0.73;73.13;6.02;384;2;129.00;4
85;2;626090262;85;89;469;474;12.07;0.73;74.15;5.99;384;2;130.00;5
86;2;626090280;86;90;471;474;12.13;0.74;74.66;6.10;385;2;131.00;3
89;2;626090288;89;90;471;474;12.17;0.74;76.39;6.10;382;2;132.00;3
91;2;626090298;91;90;472;474;12.22;0.75;77.30;6.16;381;2;133.00;2
92;2;626090308;92;90;473;475;12.19;0.74;77.89;6.15;381;2;134.00;2
96;2;626090318;96;89;476;477;12.06;0.74;79.11;6.19;380;2;135.00;1
96;2;626090328;96;91;476;477;12.08;0.74;79.11;6.19;380;2;136.00;1
98;2;626090337;98;94;478;478;12.05;0.74;79.83;6.21;380;2;137.00;0
98;2;626090346;98;95;478;478;12.10;0.74;79.83;6.21;380;2;138.00;0
100;2;626090355;100;96;478;478;12.10;0.75;80.23;6.21;378;2;139.00;0
101;2;626090364;101;99;478;478;12.06;0.74;80.80;6.21;377;2;140.00;0
104;2;626090373;104;101;478;478;11.91;0.73;82.07;6.21;374;2;141.00;0
106;2;626090382;106;102;478;478;11.81;0.73;83.03;6.21;372;2;142.00;0
108;2;626090391;108;104;478;478;11.74;0.72;82.58;6.21;370;2;143.00;0
112;2;626090400;112;123;550;605;11.31;0.71;84.23;5.40;438;2;144.00;55
114;2;626090422;114;114;555;606;11.24;0.71;84.16;5.36;441;2;145.00;51
115;2;626090431;115;111;563;606;11.28;0.71;84.70;5.31;448;2;146.00;43
115;2;626090441;115;113;568;606;11.18;0.70;84.70;5.29;453;2;147.00;38
115;2;626090449;115;115;574;606;11.18;0.70;84.70;5.28;459;2;148.00;32
119;2;626090458;119;117;578;606;11.04;0.69;86.45;5.28;459;2;149.00;28
121;2;626090471;121;116;583;611;10.90;0.68;87.45;5.28;462;2;150.00;28
123;2;626090483;123;116;585;611;10.85;0.68;88.38;5.29;462;2;151.00;26
127;2;626090498;127;117;590;612;10.84;0.67;88.91;5.31;463;2;152.00;22
129;2;626090509;129;119;592;613;10.81;0.67;89.33;5.32;463;2;153.00;21
132;2;626090519;132;121;595;613;10.77;0.67;90.10;5.35;463;2;154.00;18
132;2;626090529;132;126;598;614;10.79;0.67;90.10;5.35;466;2;155.00;16
134;2;626090538;134;128;601;614;10.70;0.67;89.99;5.37;467;2;156.00;13
135;2;626090550;135;130;602;614;10.67;0.66;89.93;5.38;467;2;157.00;12
135;2;626090558;135;136;604;614;10.70;0.66;89.93;5.41;469;2;158.00;10
136;2;626090567;136;140;607;618;10.70;0.66;90.43;5.41;471;2;159.00;11
136;2;626090578;136;145;609;618;10.62;0.66;90.43;5.43;473;2;160.00;9
137;2;626090586;137;148;610;618;10.47;0.65;90.88;5.44;473;2;161.00;8
138;2;626090603;138;151;613;621;10.35;0.64;91.39;5.44;475;2;162.00;8
142;2;626090610;142;149;613;621;10.17;0.63;91.43;5.44;471;2;163.00;8
144;2;626090618;144;146;614;621;10.03;0.62;92.21;5.46;470;2;164.00;7
146;2;626090626;146;147;617;625;9.90;0.61;93.18;5.44;471;2;165.00;8
147;2;626090635;147;147;618;626;9.87;0.61;93.67;5.43;471;2;166.00;8
149;2;626090645;149;147;618;626;9.81;0.60;94.04;5.43;469;2;167.00;8
150;2;626090655;150;147;623;630;9.68;0.60;94.39;5.42;473;2;168.00;7
151;2;626090663;151;150;624;630;9.39;0.58;94.72;5.42;473;2;169.00;6
152;2;626090683;152;143;625;630;9.22;0.57;95.11;5.45;473;2;170.00;5
152;2;626090694;152;136;627;631;9.06;0.56;95.11;5.47;475;2;171.00;4
154;2;626090701;154;134;629;631;8.94;0.55;95.98;5.50;475;2;172.00;2
158;2;626090708;158;130;633;637;8.90;0.55;97.22;5.47;475;2;173.00;4
160;2;626090717;160;131;633;637;8.95;0.55;97.96;5.47;473;2;174.00;4
161;2;626090725;161;130;635;638;8.98;0.55;98.14;5.48;474;2;175.00;3
162;2;626090732;162;131;637;638;8.99;0.55;97.98;5.51;475;2;176.00;1
162;2;626090740;162;132;637;638;9.11;0.56;97.98;5.51;475;2;177.00;1
164;2;626090749;164;124;638;638;9.20;0.57;98.30;5.51;474;2;178.00;0
165;2;626090759;165;123;638;638;9.38;0.58;98.03;5.51;473;2;179.00;0
166;2;626090771;166;122;669;672;9.54;0.59;98.52;5.25;503;2;180.00;3
166;2;626090784;166;118;670;672;9.60;0.59;98.52;5.24;504;2;181.00;2
167;2;626090794;167;123;670;672;9.73;0.60;99.01;5.24;503;2;182.00;2
167;2;626090803;167;126;670;672;9.82;0.61;99.01;5.24;503;2;183.00;2
169;2;626090812;169;132;671;672;9.93;0.61;99.28;5.24;502;2;184.00;1
169;2;626090820;169;134;672;672;10.02;0.62;99.28;5.24;503;2;185.00;0
169;2;626090839;169;136;676;676;10.11;0.63;99.28;5.22;507;2;186.00;0
171;2;626090848;171;139;676;676;10.15;0.63;99.94;5.22;505;2;187.00;0
172;2;626090856;172;144;680;680;10.08;0.62;99.69;5.19;508;2;188.00;0
176;2;626090865;176;153;681;681;9.94;0.62;100.33;5.19;505;2;189.00;0
179;2;626090873;179;161;681;681;9.83;0.61;100.48;5.19;502;2;190.00;0
182;2;626090881;182;164;681;681;9.77;0.61;101.55;5.19;499;2;191.00;0
185;2;626090898;185;178;694;694;9.70;0.60;101.88;5.09;509;2;192.00;0
188;2;626090919;188;174;694;694;9.66;0.60;102.53;5.09;506;2;193.00;0
191;2;626090930;191;176;694;694;9.53;0.59;102.38;5.09;503;2;194.00;0
194;2;626090940;194;184;695;695;9.43;0.58;102.33;5.08;501;2;195.00;0
201;2;626090950;201;187;696;696;9.24;0.57;103.18;5.08;495;2;196.00;0
204;2;626090965;204;195;696;696;9.13;0.56;102.91;5.08;492;2;197.00;0
208;2;626090974;208;195;698;699;9.03;0.55;102.42;5.06;490;2;198.00;1
209;2;626090987;209;197;699;699;8.95;0.55;102.86;5.06;490;2;199.00;0
210;2;626091000;210;200;699;699;8.80;0.54;102.63;5.06;489;2;200.00;0
212;2;626091020;212;203;699;699;8.58;0.53;102.79;5.06;487;2;201.00;0
214;2;626091031;214;209;704;705;8.44;0.52;103.60;5.03;490;2;202.00;1
215;2;626091044;215;212;704;705;8.23;0.50;103.80;5.03;489;2;203.00;1
215;3;626091053;215;211;705;705;8.16;0.50;103.80;5.02;490;3;204.00;0
216;3;626091089;216;215;705;705;8.00;0.49;103.50;5.02;489;3;205.00;0
217;3;626091099;217;221;709;709;7.97;0.49;103.18;5.00;492;3;206.00;0
218;3;626091108;218;225;710;710;7.87;0.48;103.00;4.99;492;3;207.00;0
219;3;626091118;219;231;710;710;7.71;0.47;102.65;4.99;491;3;208.00;0
219;3;626091127;219;235;711;711;7.64;0.47;102.65;4.99;492;3;209.00;0
224;3;626091137;224;238;711;711;7.51;0.46;102.26;4.99;487;3;210.00;0
224;3;626091148;224;245;711;711;7.47;0.46;102.26;4.99;487;3;211.00;0
224;3;626091156;224;246;711;711;7.45;0.46;102.26;4.99;487;3;212.00;0
224;3;626091164;224;251;711;711;7.47;0.46;102.26;4.99;487;3;213.00;0
225;3;626091172;225;256;711;711;7.41;0.46;102.41;4.99;486;3;214.00;0
227;3;626091181;227;259;711;711;7.31;0.45;102.74;4.99;484;3;215.00;0
229;3;626091190;229;269;754;781;7.48;0.46;103.00;4.70;525;3;216.00;27
231;3;626091208;231;256;756;782;7.40;0.46;103.35;4.69;525;3;217.00;26
232;3;626091218;232;248;762;782;7.53;0.47;103.84;4.67;530;3;218.00;20
232;3;626091229;232;228;764;782;7.71;0.48;103.84;4.67;532;3;219.00;18
234;3;626091237;234;213;769;782;7.87;0.49;104.63;4.66;535;3;220.00;13
236;3;626091257;236;206;770;782;8.02;0.49;105.61;4.66;534;3;221.00;12
237;3;626091266;237;201;773;782;8.29;0.51;106.08;4.67;536;3;222.00;9
238;3;626091275;238;194;776;782;8.50;0.52;106.32;4.68;538;3;223.00;6
240;3;626091294;240;188;777;783;8.62;0.53;106.67;4.68;537;3;224.00;6
240;3;626091304;240;185;782;785;8.82;0.54;106.67;4.69;542;3;225.00;3
243;3;626091313;243;166;785;785;9.01;0.55;107.40;4.70;542;3;226.00;0
244;4;626091322;244;157;789;789;9.18;0.56;107.87;4.68;545;4;227.00;0
246;4;626091352;246;142;789;789;9.40;0.58;108.07;4.68;543;4;228.00;0
247;4;626091364;247;135;789;789;9.50;0.58;108.36;4.68;542;4;229.00;0
249;4;626091396;249;131;789;789;9.60;0.59;108.91;4.68;540;4;230.00;0
250;4;626091417;250;124;794;795;9.67;0.59;108.57;4.66;544;4;231.00;1
252;4;626091427;252;117;794;795;9.78;0.60;109.49;4.66;542;4;232.00;1
253;4;626091442;253;116;795;795;9.99;0.61;109.97;4.66;542;4;233.00;0
254;4;626091451;254;114;797;798;10.08;0.61;110.46;4.64;543;4;234.00;1
255;4;626091468;255;112;798;798;10.15;0.62;110.46;4.64;543;4;235.00;0
257;4;626091478;257;109;798;798;10.19;0.62;110.70;4.64;541;4;236.00;0
260;4;626091486;260;105;799;799;10.19;0.62;111.19;4.63;539;4;237.00;0
262;4;626091496;262;101;800;800;10.24;0.62;111.31;4.63;538;4;238.00;0
263;4;626091504;263;99;800;800;10.29;0.63;111.16;4.63;537;4;239.00;0
264;4;626091515;264;107;824;826;10.20;0.62;111.38;4.50;560;4;240.00;2
265;4;626091526;265;102;825;826;10.25;0.63;111.32;4.49;560;4;241.00;1
268;4;626091541;268;98;826;826;10.34;0.63;112.31;4.49;558;4;242.00;0
269;4;626091551;269;100;827;827;10.46;0.64;112.26;4.48;558;4;243.00;0
272;4;626091559;272;104;827;827;10.54;0.64;113.39;4.48;555;4;244.00;0
277;4;626091568;277;106;830;831;10.57;0.64;113.51;4.47;553;4;245.00;1
280;4;626091585;280;108;830;831;10.60;0.64;114.10;4.47;550;4;246.00;1
283;4;626091593;283;112;835;835;10.62;0.65;115.39;4.45;552;4;247.00;0
284;4;626091602;284;116;835;835;10.66;0.65;115.86;4.45;551;4;248.00;0
287;5;626091610;287;119;835;835;10.65;0.65;116.10;4.45;548;5;249.00;0
289;5;626091629;289;120;835;835;10.69;0.65;116.57;4.45;546;5;250.00;0
290;5;626091637;290;123;835;835;10.67;0.65;116.67;4.45;545;5;251.00;0
291;5;626091646;291;129;846;847;10.64;0.65;116.82;4.39;555;5;252.00;1
293;5;626091655;293;129;846;847;10.58;0.64;116.80;4.39;553;5;253.00;1
295;6;626091663;295;132;847;847;10.58;0.64;117.03;4.39;552;6;254.00;0
296;6;626091682;296;138;847;847;10.54;0.64;117.22;4.39;551;6;255.00;0
296;6;626091691;296;144;847;847;10.48;0.64;117.22;4.39;551;6;256.00;0
297;6;626091698;297;149;847;847;10.46;0.63;117.27;4.39;550;6;257.00;0
298;6;626091706;298;153;848;848;10.35;0.63;117.10;4.39;550;6;258.00;0
298;6;626091719;298;160;848;848;10.28;0.62;117.10;4.39;550;6;259.00;0
299;6;626091727;299;151;853;854;10.17;0.62;117.25;4.37;554;6;260.00;1
300;6;626091736;300;147;854;855;10.16;0.62;117.44;4.36;554;6;261.00;1
303;6;626091749;303;145;855;855;10.15;0.62;117.78;4.36;552;6;262.00;0
305;6;626091757;305;142;855;855;10.16;0.61;117.94;4.36;550;6;263.00;0
305;6;626091765;305;138;859;859;10.21;0.62;117.94;4.34;554;6;264.00;0
307;6;626091773;307;137;859;859;10.20;0.62;118.34;4.34;552;6;265.00;0
310;6;626091781;310;133;859;859;10.20;0.62;119.52;4.34;549;6;266.00;0
311;6;626091788;311;131;860;860;10.32;0.62;119.42;4.34;549;6;267.00;0
314;6;626091795;314;131;864;864;10.31;0.62;120.26;4.32;550;6;268.00;0
314;6;626091805;314;130;864;864;10.33;0.63;120.26;4.32;550;6;269.00;0
315;6;626091815;315;126;867;870;10.47;0.63;120.51;4.31;552;6;270.00;3
318;6;626091823;318;124;867;870;10.53;0.64;120.61;4.31;549;6;271.00;3
322;6;626091831;322;116;868;870;10.59;0.64;121.73;4.30;546;6;272.00;2
324;6;626091839;324;110;868;870;10.73;0.65;121.64;4.30;544;6;273.00;2
326;6;626091847;326;104;871;874;10.90;0.66;122.22;4.30;545;6;274.00;3
330;6;626091856;330;103;871;874;10.99;0.67;122.55;4.30;541;6;275.00;3
333;6;626091865;333;99;872;874;11.17;0.68;122.83;4.30;539;6;276.00;2
337;6;626091873;337;91;872;874;11.26;0.68;123.26;4.30;535;6;277.00;2
340;6;626091881;340;89;874;875;11.30;0.68;123.26;4.29;534;6;278.00;1
341;6;626091891;341;81;875;876;11.44;0.69;123.19;4.29;534;6;279.00;1
342;6;626091899;342;80;876;876;11.51;0.70;123.01;4.29;534;6;280.00;0
345;6;626091907;345;76;877;877;11.55;0.70;123.03;4.29;532;6;281.00;0
346;6;626091916;346;76;877;877;11.63;0.71;122.87;4.29;531;6;282.00;0
348;6;626091926;348;74;877;877;11.75;0.71;123.24;4.29;529;6;283.00;0
352;6;626091934;352;75;877;877;11.81;0.72;123.32;4.29;525;6;284.00;0
354;6;626091943;354;76;877;877;11.80;0.71;123.99;4.29;523;6;285.00;0
354;6;626091954;354;75;877;877;11.85;0.72;123.99;4.29;523;6;286.00;0
354;6;626091963;354;75;877;877;11.84;0.72;123.99;4.29;523;6;287.00;0
356;6;626091972;356;93;948;1004;11.42;0.71;124.51;3.97;592;6;288.00;56
357;6;626091993;357;84;949;1005;11.45;0.71;124.96;3.97;592;6;289.00;56
358;6;626092003;358;81;957;1005;11.48;0.71;125.20;3.95;599;6;290.00;48
361;6;626092012;361;77;960;1005;11.56;0.71;126.15;3.95;599;6;291.00;45
361;6;626092024;361;76;964;1005;11.68;0.72;126.15;3.95;603;6;292.00;41
363;6;626092033;363;80;969;1005;11.76;0.72;126.66;3.95;606;6;293.00;36
364;6;626092043;364;82;974;1005;11.84;0.73;126.63;3.96;610;6;294.00;31
369;6;626092053;369;82;977;1005;11.91;0.73;126.98;3.97;608;6;295.00;28
371;6;626092063;371;81;981;1006;12.01;0.74;126.53;3.99;610;6;296.00;25
374;6;626092073;374;80;984;1007;12.12;0.74;127.36;4.01;610;6;297.00;23
376;6;626092089;376;82;988;1007;12.15;0.75;127.11;4.03;612;6;298.00;19
379;6;626092104;379;85;991;1008;12.11;0.74;127.00;4.04;612;6;299.00;17
379;6;626092123;379;89;995;1014;12.05;0.74;127.00;4.08;616;6;300.00;19
379;6;626092138;379;94;997;1014;11.92;0.73;127.00;4.08;618;6;301.00;17
380;6;626092153;380;97;998;1014;11.86;0.73;127.22;4.09;618;6;302.00;16
383;6;626092164;383;106;1002;1018;11.79;0.73;127.16;4.11;619;6;303.00;16
385;6;626092175;385;113;1004;1018;11.70;0.72;127.70;4.13;619;6;304.00;14
386;6;626092185;386;118;1006;1018;11.66;0.72;128.09;4.16;620;6;305.00;12
388;6;626092196;388;124;1009;1021;11.60;0.71;128.86;4.16;621;6;306.00;12
390;6;626092206;390;131;1011;1021;11.50;0.71;129.49;4.16;621;6;307.00;10
392;6;626092216;392;136;1012;1021;11.41;0.70;129.67;4.16;620;6;308.00;9
397;6;626092225;397;141;1015;1025;11.23;0.69;130.50;4.15;618;6;309.00;10
399;6;626092241;399;149;1016;1026;11.21;0.69;130.55;4.15;617;6;310.00;10
401;6;626092251;401;154;1016;1026;11.06;0.68;131.09;4.15;615;6;311.00;10
402;6;626092266;402;156;1021;1030;11.00;0.68;131.52;4.14;619;6;312.00;9
404;6;626092276;404;157;1022;1030;10.89;0.67;131.70;4.15;618;6;313.00;8
407;6;626092286;407;159;1022;1030;10.78;0.66;132.39;4.15;615;6;314.00;8
409;6;626092295;409;164;1024;1032;10.69;0.66;132.59;4.14;615;6;315.00;8
412;6;626092303;412;164;1024;1032;10.54;0.65;132.62;4.14;612;6;316.00;8
412;6;626092311;412;171;1029;1038;10.50;0.65;132.62;4.14;617;6;317.00;9
414;6;626092319;414;174;1029;1038;10.32;0.64;132.97;4.14;615;6;318.00;9
416;6;626092332;416;168;1030;1039;10.22;0.63;133.47;4.14;614;6;319.00;9
421;6;626092347;421;171;1032;1039;10.07;0.62;133.87;4.18;611;6;320.00;7
424;6;626092355;424;182;1034;1039;10.02;0.62;134.17;4.20;610;6;321.00;5
429;6;626092364;429;183;1035;1039;9.95;0.61;134.82;4.22;606;6;322.00;4
432;6;626092373;432;183;1037;1039;9.89;0.60;135.69;4.25;605;6;323.00;2
434;6;626092382;434;186;1048;1051;9.87;0.60;135.58;4.20;614;6;324.00;3
436;6;626092391;436;188;1049;1051;9.81;0.60;136.43;4.21;613;6;325.00;2
438;6;626092400;438;190;1050;1051;9.83;0.60;136.83;4.24;612;6;326.00;1
438;6;626092409;438;194;1051;1051;9.87;0.60;136.83;4.24;613;6;327.00;0
440;6;626092417;440;197;1051;1051;9.91;0.61;137.25;4.24;611;6;328.00;0
443;6;626092425;443;201;1051;1051;9.88;0.60;137.51;4.24;608;6;329.00;0
444;6;626092435;444;201;1055;1055;9.82;0.60;137.45;4.23;611;6;330.00;0
447;6;626092443;447;203;1055;1055;9.77;0.59;137.76;4.23;608;6;331.00;0
447;6;626092451;447;205;1058;1059;9.76;0.59;137.76;4.22;611;6;332.00;1
451;6;626092460;451;208;1059;1060;9.64;0.59;138.26;4.21;608;6;333.00;1
452;6;626092468;452;209;1060;1060;9.54;0.58;138.21;4.21;608;6;334.00;0
457;6;626092477;457;213;1060;1060;9.37;0.57;139.51;4.21;603;6;335.00;0
461;6;626092484;461;223;1072;1073;9.14;0.56;139.88;4.17;611;6;336.00;1
463;6;626092493;463;227;1072;1073;9.01;0.55;140.27;4.17;609;6;337.00;1
467;6;626092500;467;232;1073;1073;8.76;0.54;140.98;4.16;606;6;338.00;0
470;6;626092507;470;236;1074;1074;8.62;0.53;141.77;4.16;604;6;339.00;0
472;6;626092513;472;222;1075;1075;8.45;0.52;142.10;4.16;603;6;340.00;0
476;6;626092521;476;222;1075;1075;8.28;0.51;142.96;4.16;599;6;341.00;0
479;6;626092528;479;218;1077;1078;8.20;0.51;143.14;4.15;598;6;342.00;1
482;6;626092535;482;214;1077;1078;8.17;0.50;143.73;4.15;595;6;343.00;1
486;6;626092541;486;215;1078;1078;8.19;0.51;144.34;4.15;592;6;344.00;0
492;6;626092548;492;222;1078;1078;8.12;0.50;145.81;4.15;586;6;345.00;0
494;6;626092556;494;225;1083;1084;8.16;0.50;146.54;4.13;589;6;346.00;1
496;6;626092564;496;219;1083;1084;8.09;0.50;146.89;4.13;587;6;347.00;1
496;6;626092571;496;217;1084;1084;8.09;0.50;146.89;4.13;588;6;348.00;0
500;6;626092578;500;217;1084;1084;7.98;0.49;147.50;4.13;584;6;349.00;0
502;6;626092585;502;218;1088;1088;7.94;0.49;147.10;4.12;586;6;350.00;0
506;6;626092593;506;218;1089;1089;7.84;0.48;147.28;4.12;583;6;351.00;0
509;6;626092601;509;219;1089;1089;7.76;0.48;147.07;4.12;580;6;352.00;0
512;6;626092608;512;221;1090;1090;7.68;0.47;146.95;4.11;578;6;353.00;0
518;6;626092615;518;226;1090;1090;7.55;0.46;147.04;4.11;572;6;354.00;0
523;6;626092624;523;228;1090;1090;7.53;0.46;147.17;4.11;567;6;355.00;0
526;6;626092631;526;223;1090;1090;7.59;0.46;147.16;4.11;564;6;356.00;0
526;6;626092639;526;227;1090;1090;7.69;0.47;147.16;4.11;564;6;357.00;0
528;6;626092646;528;223;1090;1090;7.70;0.47;147.01;4.11;562;6;358.00;0
530;6;626092654;530;226;1090;1090;7.69;0.47;147.29;4.11;560;6;359.00;0
531;6;626092663;531;237;1151;1215;8.15;0.51;147.22;3.90;620;6;360.00;64
532;6;626092682;532;242;1166;1216;8.02;0.50;147.60;3.86;634;6;361.00;50
533;6;626092691;533;240;1178;1216;8.03;0.50;147.76;3.84;645;6;362.00;38
536;6;626092705;536;240;1186;1216;8.07;0.50;147.44;3.83;650;6;363.00;30
537;6;626092713;537;241;1193;1216;8.05;0.50;147.31;3.83;656;6;364.00;23
538;6;626092721;538;239;1196;1216;7.99;0.50;147.09;3.84;658;6;365.00;20
541;6;626092730;541;239;1201;1216;7.92;0.49;147.14;3.85;660;6;366.00;15
543;6;626092738;543;245;1201;1216;7.84;0.49;147.68;3.85;658;6;367.00;15
546;6;626092747;546;251;1205;1217;7.73;0.48;147.58;3.85;659;6;368.00;12
546;6;626092756;546;262;1205;1218;7.66;0.47;147.58;3.85;659;6;369.00;13
548;6;626092765;548;264;1208;1218;7.55;0.47;147.80;3.87;660;6;370.00;10
550;6;626092773;550;259;1215;1222;7.49;0.46;147.81;3.87;665;6;371.00;7
552;6;626092783;552;251;1217;1222;7.41;0.46;147.70;3.88;665;6;372.00;5
555;6;626092792;555;247;1217;1222;7.36;0.45;147.68;3.88;662;6;373.00;5
555;6;626092802;555;244;1218;1222;7.43;0.46;147.68;3.89;663;6;374.00;4
557;6;626092812;557;238;1224;1228;7.52;0.46;147.71;3.90;667;6;375.00;4
558;6;626092822;558;235;1224;1228;7.66;0.47;148.05;3.90;666;6;376.00;4
561;6;626092832;561;233;1226;1228;7.79;0.48;148.39;3.91;665;6;377.00;2
561;6;626092853;561;231;1229;1231;7.97;0.49;148.39;3.90;668;6;378.00;2
564;6;626092862;564;229;1229;1231;8.05;0.49;148.31;3.90;665;6;379.00;2
566;6;626092872;566;231;1230;1231;8.05;0.49;148.57;3.90;664;6;380.00;1
569;6;626092882;569;232;1232;1232;8.07;0.49;148.85;3.91;663;6;381.00;0
570;6;626092892;570;233;1233;1233;8.23;0.50;148.62;3.91;663;6;382.00;0
572;6;626092902;572;235;1233;1233;8.33;0.51;148.51;3.91;661;6;383.00;0
573;6;626092911;573;235;1246;1246;8.46;0.52;148.64;3.87;673;6;384.00;0
574;6;626092923;574;229;1246;1246;8.48;0.52;148.42;3.87;672;6;385.00;0
574;6;626092933;574;233;1246;1246;8.49;0.52;148.42;3.87;672;6;386.00;0
576;6;626092943;576;231;1247;1247;8.51;0.52;148.49;3.87;671;6;387.00;0
580;6;626092954;580;224;1247;1247;8.57;0.52;148.96;3.87;667;6;388.00;0
580;6;626092983;580;217;1250;1251;8.63;0.52;148.96;3.86;670;6;389.00;1
581;6;626093002;581;216;1250;1251;8.65;0.53;148.76;3.86;669;6;390.00;1
582;6;626093020;582;213;1255;1255;8.71;0.53;148.92;3.85;673;6;391.00;0
583;6;626093038;583;214;1255;1255;8.73;0.53;148.94;3.85;672;6;392.00;0
585;6;626093053;585;219;1255;1255;8.75;0.53;148.85;3.85;670;6;393.00;0
586;6;626093069;586;223;1255;1255;8.85;0.54;149.02;3.85;669;6;394.00;0
587;6;626093084;587;224;1255;1255;8.89;0.54;149.19;3.85;668;6;395.00;0
590;6;626093101;590;206;1265;1267;9.03;0.55;149.57;3.82;675;6;396.00;2
593;6;626093120;593;198;1265;1267;9.03;0.55;150.19;3.82;672;6;397.00;2
595;6;626093133;595;183;1267;1267;9.13;0.56;150.77;3.82;672;6;398.00;0
601;6;626093144;601;174;1267;1267;9.21;0.56;151.53;3.82;666;6;399.00;0
602;7;626093157;602;167;1267;1267;9.30;0.57;151.93;3.82;665;7;400.00;0
604;7;626093181;604;161;1267;1267;9.42;0.58;152.22;3.82;663;7;401.00;0
607;7;626093197;607;157;1268;1268;9.53;0.58;152.51;3.82;661;7;402.00;0
610;7;626093208;610;162;1268;1268;9.60;0.59;153.12;3.82;658;7;403.00;0
614;8;626093220;614;163;1273;1274;9.59;0.59;153.45;3.81;659;8;404.00;1
618;8;626093239;618;166;1276;1276;9.63;0.59;153.66;3.80;658;8;405.00;0
620;8;626093251;620;170;1276;1276;9.71;0.59;154.39;3.80;656;8;406.00;0
625;8;626093261;625;172;1276;1276;9.73;0.60;154.88;3.80;651;8;407.00;0
628;8;626093273;628;171;1280;1280;9.84;0.60;155.14;3.79;652;8;408.00;0
633;8;626093285;633;171;1280;1280;9.79;0.60;155.82;3.79;647;8;409.00;0
634;8;626093296;634;166;1280;1280;9.85;0.60;156.15;3.79;646;8;410.00;0
636;8;626093306;636;163;1281;1281;9.95;0.61;156.39;3.78;645;8;411.00;0
638;8;626093317;638;158;1285;1285;9.93;0.61;156.92;3.78;647;8;412.00;0
641;8;626093333;641;159;1285;1285;9.99;0.61;157.29;3.78;644;8;413.00;0
643;8;626093344;643;156;1287;1288;10.07;0.61;157.91;3.77;644;8;414.00;1
645;8;626093355;645;153;1287;1288;10.19;0.62;158.17;3.77;642;8;415.00;1
649;8;626093363;649;153;1288;1288;10.29;0.63;158.74;3.77;639;8;416.00;0
652;8;626093374;652;150;1288;1288;10.32;0.63;159.57;3.77;636;8;417.00;0
653;9;626093384;653;151;1291;1292;10.45;0.64;159.69;3.76;638;9;418.00;1
656;9;626093404;656;153;1291;1292;10.49;0.64;159.99;3.76;635;9;419.00;1
660;9;626093420;660;153;1292;1292;10.54;0.64;160.75;3.76;632;9;420.00;0
663;9;626093431;663;156;1292;1292;10.56;0.65;161.31;3.76;629;9;421.00;0
665;9;626093447;665;158;1293;1293;10.62;0.65;161.35;3.76;628;9;422.00;0
669;9;626093458;669;160;1294;1294;10.55;0.64;161.52;3.76;625;9;423.00;0
670;9;626093468;670;161;1294;1294;10.51;0.64;161.41;3.76;624;9;424.00;0
671;9;626093478;671;164;1295;1295;10.51;0.64;161.54;3.75;624;9;425.00;0
675;10;626093490;675;163;1295;1295;10.51;0.64;162.85;3.75;620;10;426.00;0
682;10;626093510;682;167;1295;1295;10.43;0.63;163.37;3.75;613;10;427.00;0
684;10;626093520;684;163;1295;1295;10.36;0.63;163.64;3.75;611;10;428.00;0
686;10;626093529;686;163;1295;1295;10.26;0.62;163.85;3.75;609;10;429.00;0
687;10;626093538;687;157;1295;1295;10.23;0.62;163.82;3.75;608;10;430.00;0
691;10;626093548;691;154;1295;1295;10.16;0.62;164.46;3.75;604;10;431.00;0
691;10;626093557;691;182;1375;1422;9.65;0.60;164.46;3.54;684;10;432.00;47
694;10;626093580;694;163;1375;1423;9.64;0.60;164.67;3.54;681;10;433.00;48
695;10;626093591;695;147;1381;1423;9.76;0.60;164.77;3.53;686;10;434.00;42
696;10;626093601;696;140;1382;1423;9.80;0.61;164.74;3.53;686;10;435.00;41
700;10;626093610;700;138;1387;1423;9.88;0.61;165.27;3.53;687;10;436.00;36
701;10;626093620;701;141;1391;1423;9.96;0.62;165.45;3.54;690;10;437.00;32
703;10;626093629;703;142;1396;1423;10.07;0.62;165.48;3.55;693;10;438.00;27
707;10;626093639;707;144;1400;1423;10.08;0.62;165.98;3.56;693;10;439.00;23
710;10;626093661;710;148;1405;1424;10.13;0.62;165.95;3.57;695;10;440.00;19
712;10;626093677;712;146;1407;1425;10.14;0.62;165.98;3.57;695;10;441.00;18
715;10;626093687;715;139;1409;1425;10.19;0.62;166.22;3.58;694;10;442.00;16
718;10;626093697;718;134;1411;1426;10.19;0.62;166.14;3.59;693;10;443.00;15
722;10;626093707;722;131;1413;1426;10.18;0.62;166.24;3.61;691;10;444.00;13
722;10;626093717;722;126;1414;1426;10.14;0.62;166.24;3.61;692;10;445.00;12
726;10;626093727;726;123;1418;1426;10.07;0.62;167.12;3.64;692;10;446.00;8
728;10;626093738;728;120;1419;1430;10.05;0.61;167.48;3.64;691;10;447.00;11
734;10;626093755;734;121;1421;1430;10.01;0.61;167.46;3.65;687;10;448.00;9
737;10;626093772;737;123;1422;1430;10.00;0.61;167.68;3.66;685;10;449.00;8
738;10;626093784;738;126;1426;1436;10.05;0.61;167.77;3.65;688;10;450.00;10
740;10;626093795;740;121;1427;1436;10.12;0.62;168.01;3.65;687;10;451.00;9
742;10;626093806;742;119;1428;1436;10.15;0.62;168.05;3.65;686;10;452.00;8
745;10;626093818;745;124;1431;1440;10.11;0.62;167.75;3.65;686;10;453.00;9
746;10;626093831;746;122;1433;1441;10.20;0.62;167.65;3.64;687;10;454.00;8
746;10;626093841;746;121;1433;1441;10.35;0.63;167.65;3.64;687;10;455.00;8
749;10;626093852;749;124;1436;1445;10.44;0.64;167.83;3.64;687;10;456.00;9
752;10;626093864;752;128;1437;1445;10.46;0.64;168.29;3.66;685;10;457.00;8
754;10;626093875;754;126;1437;1445;10.55;0.64;168.23;3.66;683;10;458.00;8
757;10;626093886;757;127;1438;1446;10.62;0.65;168.19;3.65;681;10;459.00;8
758;10;626093903;758;128;1441;1446;10.69;0.65;168.28;3.69;683;10;460.00;5
761;10;626093914;761;128;1444;1452;10.81;0.66;168.29;3.69;683;10;461.00;8
763;10;626093926;763;132;1446;1452;10.85;0.66;168.58;3.69;683;10;462.00;6
765;10;626093938;765;132;1447;1453;10.84;0.66;168.55;3.71;682;10;463.00;6
769;10;626093949;769;133;1447;1453;10.85;0.66;168.66;3.71;678;10;464.00;6
769;10;626093962;769;132;1447;1453;10.87;0.66;168.66;3.71;678;10;465.00;6
772;10;626093974;772;134;1448;1453;10.87;0.66;168.62;3.71;676;10;466.00;5
772;10;626093985;772;134;1448;1453;10.88;0.66;168.62;3.71;676;10;467.00;5
773;10;626094002;773;135;1457;1465;10.97;0.67;168.64;3.69;684;10;468.00;8
774;10;626094015;774;139;1457;1465;11.03;0.67;168.59;3.69;683;10;469.00;8
778;10;626094025;778;139;1461;1465;11.15;0.68;168.93;3.71;683;10;470.00;4
781;10;626094037;781;143;1461;1465;11.19;0.68;168.80;3.71;680;10;471.00;4
783;10;626094053;783;145;1461;1465;11.22;0.68;169.02;3.71;678;10;472.00;4
789;10;626094065;789;149;1462;1465;11.17;0.68;169.40;3.72;673;10;473.00;3
790;11;626094077;790;154;1465;1469;11.15;0.68;169.33;3.71;675;11;474.00;4
790;11;626094095;790;156;1465;1469;11.14;0.68;169.33;3.71;675;11;475.00;4
793;11;626094110;793;160;1470;1473;11.13;0.68;169.27;3.72;677;11;476.00;3
793;11;626094126;793;163;1472;1474;11.10;0.68;169.27;3.72;679;11;477.00;2
799;11;626094137;799;165;1474;1474;11.05;0.67;169.19;3.73;675;11;478.00;0
800;11;626094149;800;168;1474;1474;10.95;0.67;169.12;3.73;674;11;479.00;0
800;11;626094161;800;176;1495;1500;10.81;0.66;169.12;3.67;695;11;480.00;5
801;11;626094179;801;179;1496;1500;10.76;0.66;169.06;3.67;695;11;481.00;4
803;11;626094189;803;186;1499;1500;10.75;0.66;169.27;3.67;696;11;482.00;1
804;11;626094216;804;190;1501;1501;10.71;0.65;169.12;3.67;697;11;483.00;0
806;11;626094227;806;194;1502;1502;10.64;0.65;169.28;3.66;696;11;484.00;0
806;11;626094239;806;202;1502;1502;10.54;0.65;169.28;3.66;696;11;485.00;0
807;11;626094249;807;203;1504;1505;10.43;0.64;169.48;3.66;697;11;486.00;1
809;11;626094260;809;208;1504;1505;10.29;0.63;169.46;3.66;695;11;487.00;1
809;11;626094271;809;209;1505;1505;10.24;0.63;169.46;3.66;696;11;488.00;0
812;11;626094282;812;208;1505;1505;10.15;0.62;169.44;3.66;693;11;489.00;0
816;11;626094293;816;211;1510;1511;10.14;0.62;169.09;3.65;694;11;490.00;1
816;11;626094310;816;214;1510;1511;10.05;0.62;169.09;3.65;694;11;491.00;1
817;11;626094320;817;215;1511;1511;10.00;0.62;169.15;3.65;694;11;492.00;0
823;11;626094329;823;215;1511;1511;9.98;0.61;169.17;3.65;688;11;493.00;0
824;11;626094339;824;220;1515;1515;9.91;0.61;169.12;3.64;691;11;494.00;0
827;11;626094350;827;222;1517;1517;9.81;0.60;169.21;3.64;690;11;495.00;0
831;11;626094359;831;226;1517;1517;9.67;0.59;168.90;3.64;686;11;496.00;0
833;11;626094369;833;228;1518;1518;9.63;0.59;168.66;3.64;685;11;497.00;0
836;11;626094378;836;232;1518;1518;9.61;0.59;168.43;3.64;682;11;498.00;0
839;11;626094388;839;229;1518;1518;9.55;0.58;168.24;3.64;679;11;499.00;0
840;11;626094397;840;233;1518;1518;9.46;0.58;168.12;3.64;678;11;500.00;0
843;11;626094410;843;238;1518;1518;9.33;0.57;168.05;3.64;675;11;501.00;0
849;11;626094419;849;241;1518;1518;9.17;0.56;167.70;3.64;669;11;502.00;0
852;11;626094428;852;246;1518;1518;9.06;0.55;167.86;3.64;666;11;503.00;0
855;11;626094436;855;252;1557;1588;9.08;0.55;168.14;3.54;702;11;504.00;31
858;11;626094453;858;258;1558;1589;8.92;0.54;168.77;3.54;700;11;505.00;31
860;11;626094462;860;260;1569;1589;8.86;0.54;168.88;3.53;709;11;506.00;20
865;11;626094472;865;262;1573;1589;8.68;0.53;168.75;3.53;708;11;507.00;16
867;11;626094481;867;264;1578;1589;8.45;0.51;169.33;3.53;711;11;508.00;11
871;11;626094489;871;273;1579;1589;8.26;0.50;169.68;3.53;708;11;509.00;10
874;11;626094499;874;269;1583;1589;8.18;0.50;170.34;3.54;709;11;510.00;6
878;11;626094508;878;267;1584;1589;8.11;0.49;171.00;3.54;706;11;511.00;5
881;11;626094517;881;261;1587;1590;8.05;0.49;171.60;3.55;706;11;512.00;3
882;11;626094526;882;263;1590;1591;8.07;0.49;171.55;3.55;708;11;513.00;1
884;11;626094534;884;263;1591;1591;8.03;0.49;171.93;3.55;707;11;514.00;0
887;11;626094542;887;262;1595;1595;7.94;0.49;172.32;3.55;708;11;515.00;0
891;11;626094552;891;262;1595;1595;7.87;0.48;172.98;3.55;704;11;516.00;0
892;11;626094561;892;267;1595;1595;7.85;0.48;173.33;3.55;703;11;517.00;0
895;11;626094570;895;267;1595;1595;7.81;0.48;173.48;3.55;700;11;518.00;0
900;11;626094579;900;264;1600;1601;7.75;0.47;173.85;3.54;700;11;519.00;1
900;11;626094589;900;269;1601;1601;7.79;0.48;173.85;3.54;701;11;520.00;0
901;11;626094599;901;272;1601;1601;7.80;0.48;174.11;3.54;700;11;521.00;0
902;11;626094607;902;275;1603;1604;7.88;0.48;174.34;3.53;701;11;522.00;1
905;11;626094617;905;254;1603;1604;7.93;0.49;174.61;3.53;698;11;523.00;1
906;11;626094626;906;237;1604;1604;8.00;0.49;174.85;3.53;698;11;524.00;0
912;11;626094637;912;228;1605;1605;8.04;0.49;175.21;3.53;693;11;525.00;0
914;11;626094647;914;226;1606;1606;8.07;0.49;175.55;3.53;692;11;526.00;0
918;11;626094656;918;228;1606;1606;8.10;0.50;176.09;3.53;688;11;527.00;0
922;11;626094667;922;222;1618;1619;8.18;0.50;176.02;3.50;696;11;528.00;1
926;11;626094678;926;214;1618;1619;8.16;0.50;176.43;3.50;692;11;529.00;1
930;11;626094694;930;206;1619;1619;8.22;0.50;176.19;3.50;689;11;530.00;0
930;11;626094707;930;207;1620;1620;8.37;0.51;176.19;3.50;690;11;531.00;0
937;11;626094722;937;204;1620;1620;8.37;0.51;176.28;3.50;683;11;532.00;0
941;11;626094732;941;205;1623;1624;8.42;0.52;176.99;3.50;682;11;533.00;1
943;11;626094743;943;202;1623;1624;8.42;0.52;176.80;3.50;680;11;534.00;1
947;11;626094753;947;197;1628;1628;8.44;0.52;176.92;3.49;681;11;535.00;0
954;11;626094764;954;192;1628;1628;8.39;0.51;177.08;3.49;674;11;536.00;0
956;11;626094774;956;196;1628;1628;8.41;0.52;177.40;3.49;672;11;537.00;0
959;11;626094784;959;196;1628;1628;8.41;0.52;177.53;3.49;669;11;538.00;0
961;11;626094794;961;198;1628;1628;8.44;0.52;177.54;3.49;667;11;539.00;0
964;11;626094807;964;202;1657;1662;8.55;0.53;177.80;3.43;693;11;540.00;5
965;11;626094821;965;196;1657;1662;8.67;0.53;177.79;3.43;692;11;541.00;5
969;11;626094831;969;200;1659;1662;8.83;0.54;177.78;3.43;690;11;542.00;3
971;11;626094842;971;204;1659;1662;8.90;0.55;178.07;3.43;688;11;543.00;3
975;11;626094852;975;205;1660;1662;8.95;0.55;178.39;3.43;685;11;544.00;2
977;11;626094863;977;203;1660;1662;9.00;0.55;178.55;3.43;683;11;545.00;2
979;11;626094874;979;205;1662;1663;9.12;0.56;178.79;3.43;683;11;546.00;1
984;11;626094884;984;206;1662;1663;9.14;0.56;179.20;3.43;678;11;547.00;1
987;11;626094895;987;207;1667;1669;9.13;0.56;179.14;3.42;680;11;548.00;2
990;11;626094906;990;210;1668;1670;9.15;0.56;179.29;3.42;678;11;549.00;2
994;11;626094917;994;211;1669;1670;9.12;0.56;179.49;3.42;675;11;550.00;1
996;11;626094928;996;207;1669;1670;9.11;0.56;180.02;3.42;673;11;551.00;1
998;11;626094939;998;214;1674;1674;9.11;0.56;180.04;3.42;676;11;552.00;0
1002;11;626094949;1002;214;1674;1674;8.98;0.55;180.53;3.42;672;11;553.00;0
1005;11;626094965;1005;215;1674;1674;8.88;0.54;180.84;3.42;669;11;554.00;0
1007;11;626094981;1007;220;1675;1675;8.83;0.54;181.22;3.41;668;11;555.00;0
1010;11;626094998;1010;223;1679;1679;8.76;0.54;181.71;3.41;669;11;556.00;0
1011;11;626095016;1011;217;1679;1679;8.77;0.54;181.96;3.41;668;11;557.00;0
1016;11;626095032;1016;211;1681;1682;8.84;0.54;182.13;3.40;665;11;558.00;1
1019;11;626095047;1019;208;1681;1682;8.84;0.54;182.43;3.40;662;11;559.00;1
1027;11;626095066;1027;205;1682;1682;8.84;0.54;182.80;3.40;655;11;560.00;0
1031;11;626095081;1031;207;1682;1682;8.97;0.54;182.86;3.40;651;11;561.00;0
1033;11;626095094;1033;215;1685;1686;9.10;0.55;182.78;3.40;652;11;562.00;1
1037;11;626095107;1037;218;1685;1686;9.19;0.56;183.35;3.40;648;11;563.00;1
1039;11;626095119;1039;215;1686;1686;9.23;0.56;183.56;3.40;647;11;564.00;0
1040;11;626095131;1040;213;1686;1686;9.16;0.56;183.82;3.40;646;11;565.00;0
1044;11;626095144;1044;204;1687;1687;9.11;0.55;184.10;3.40;643;11;566.00;0
1045;11;626095156;1045;193;1688;1688;9.17;0.56;184.41;3.40;643;11;567.00;0
1046;11;626095168;1046;182;1688;1688;9.20;0.56;184.57;3.40;642;11;568.00;0
1047;11;626095187;1047;179;1689;1689;9.24;0.56;184.60;3.39;642;11;569.00;0
1049;11;626095201;1049;168;1689;1689;9.31;0.57;184.70;3.39;640;11;570.00;0
1051;11;626095212;1051;161;1689;1689;9.34;0.57;184.94;3.39;638;11;571.00;0
1052;11;626095227;1052;162;1689;1689;9.40;0.57;185.15;3.39;637;11;572.00;0
1054;11;626095239;1054;161;1689;1689;9.49;0.58;185.46;3.39;635;11;573.00;0
1057;11;626095250;1057;166;1689;1689;9.60;0.59;185.72;3.39;632;11;574.00;0
1060;11;626095260;1060;166;1689;1689;9.71;0.59;185.98;3.39;629;11;575.00;0
1065;11;626095272;1065;193;1769;1816;9.73;0.60;186.08;3.24;704;11;576.00;47
1068;11;626095295;1068;183;1772;1817;9.84;0.61;186.49;3.24;704;11;577.00;45
1073;11;626095308;1073;165;1779;1817;10.00;0.62;187.12;3.23;706;11;578.00;38
1075;11;626095319;1075;151;1782;1817;10.09;0.62;187.12;3.23;707;11;579.00;35
1078;11;626095331;1078;146;1787;1817;10.21;0.63;187.33;3.24;709;11;580.00;30
1080;12;626095343;1080;149;1790;1817;10.22;0.63;187.46;3.24;710;12;581.00;27
1083;12;626095377;1083;147;1795;1817;10.26;0.63;187.49;3.25;712;12;582.00;22
1086;12;626095396;1086;150;1797;1817;10.26;0.63;187.70;3.25;711;12;583.00;20
1089;12;626095413;1089;154;1800;1818;10.25;0.63;187.85;3.26;711;12;584.00;18
1094;12;626095424;1094;155;1804;1820;10.23;0.63;187.78;3.27;710;12;585.00;16
1097;12;626095436;1097;157;1808;1820;10.24;0.63;187.70;3.28;711;12;586.00;12
1098;12;626095447;1098;163;1812;1821;10.27;0.63;187.79;3.29;714;12;587.00;9
1100;12;626095459;1100;176;1814;1821;10.32;0.63;187.99;3.30;714;12;588.00;7
1101;12;626095471;1101;176;1815;1821;10.39;0.64;188.09;3.30;714;12;589.00;6
1103;12;626095482;1103;176;1817;1821;10.46;0.64;188.33;3.31;714;12;590.00;4
1107;12;626095494;1107;177;1820;1825;10.45;0.64;188.49;3.31;713;12;591.00;5
1108;12;626095513;1108;176;1821;1825;10.48;0.64;188.56;3.32;713;12;592.00;4
1112;12;626095524;1112;177;1821;1825;10.50;0.64;188.70;3.32;709;12;593.00;4
1113;12;626095535;1113;181;1824;1828;10.55;0.64;188.63;3.33;711;12;594.00;4
1114;13;626095546;1114;180;1824;1828;10.56;0.65;188.61;3.33;710;13;595.00;4
1114;13;626095565;1114;179;1825;1828;10.65;0.65;188.61;3.33;711;13;596.00;3
1115;13;626095577;1115;190;1829;1832;10.61;0.65;188.53;3.33;714;13;597.00;3
1118;13;626095589;1118;182;1831;1833;10.68;0.65;188.32;3.33;713;13;598.00;2
1119;13;626095601;1119;181;1831;1833;10.74;0.66;188.55;3.33;712;13;599.00;2
1122;13;626095619;1122;185;1843;1859;10.66;0.65;188.75;3.31;721;13;600.00;16
1123;13;626095639;1123;173;1843;1859;10.72;0.65;188.75;3.31;720;13;601.00;16
1126;13;626095654;1126;176;1844;1859;10.78;0.66;189.07;3.32;718;13;602.00;15
1130;13;626095672;1130;176;1846;1860;10.85;0.66;189.26;3.31;716;13;603.00;14
1135;13;626095685;1135;176;1848;1860;10.85;0.66;189.53;3.32;713;13;604.00;12
1139;13;626095696;1139;171;1851;1866;10.89;0.66;190.01;3.31;712;13;605.00;15
1142;13;626095715;1142;170;1852;1866;10.90;0.66;190.13;3.31;710;13;606.00;14
1145;13;626095726;1145;169;1853;1867;10.91;0.66;190.13;3.31;708;13;607.00;14
1148;13;626095737;1148;165;1853;1867;10.92;0.66;190.13;3.31;705;13;608.00;14
1150;13;626095755;1150;159;1854;1867;10.92;0.66;190.24;3.31;704;13;609.00;13
1150;13;626095767;1150;156;1855;1867;10.92;0.66;190.24;3.32;705;13;610.00;12
1154;13;626095777;1154;155;1855;1867;10.92;0.66;190.98;3.32;701;13;611.00;12
1155;13;626095787;1155;148;1864;1879;10.97;0.67;190.99;3.31;709;13;612.00;15
1161;13;626095798;1161;138;1866;1879;10.92;0.66;191.55;3.32;705;13;613.00;13
1165;13;626095817;1165;128;1867;1879;10.88;0.66;191.98;3.31;702;13;614.00;12
1173;13;626095827;1173;124;1870;1879;10.80;0.65;191.82;3.32;697;13;615.00;9
1176;13;626095837;1176;116;1871;1879;10.86;0.66;191.85;3.32;695;13;616.00;8
1182;13;626095847;1182;115;1871;1879;10.89;0.66;192.88;3.32;689;13;617.00;8
1184;13;626095856;1184;109;1875;1883;10.89;0.66;192.92;3.33;691;13;618.00;8
1188;13;626095866;1188;101;1875;1883;10.96;0.66;193.06;3.33;687;13;619.00;8
1190;13;626095876;1190;97;1878;1887;11.03;0.67;193.05;3.33;688;13;620.00;9
1194;13;626095886;1194;96;1879;1888;11.15;0.67;193.22;3.32;685;13;621.00;9
1197;13;626095897;1197;96;1880;1888;11.24;0.68;193.32;3.32;683;13;622.00;8
1202;13;626095906;1202;97;1880;1888;11.26;0.68;193.66;3.32;678;13;623.00;8
1206;13;626095916;1206;99;1889;1901;11.22;0.68;193.93;3.32;683;13;624.00;12
1208;13;626095928;1208;99;1889;1901;11.27;0.68;194.32;3.32;681;13;625.00;12
1210;13;626095937;1210;101;1889;1901;11.31;0.68;194.36;3.32;679;13;626.00;12
1212;13;626095960;1212;109;1890;1902;11.38;0.69;194.24;3.32;678;13;627.00;12
1215;13;626095971;1215;112;1890;1903;11.37;0.69;194.71;3.32;675;13;628.00;13
1216;13;626095983;1216;116;1893;1903;11.33;0.69;194.90;3.35;677;13;629.00;10
1219;13;626095995;1219;117;1896;1909;11.33;0.69;195.28;3.35;677;13;630.00;13
1222;13;626096007;1222;117;1898;1909;11.31;0.69;195.32;3.35;676;13;631.00;11
1223;13;626096016;1223;122;1899;1909;11.39;0.69;195.32;3.35;676;13;632.00;10
1226;13;626096026;1226;127;1899;1909;11.39;0.69;195.32;3.35;673;13;633.00;10
1227;14;626096041;1227;132;1903;1915;11.49;0.70;195.38;3.34;676;14;634.00;12
1229;14;626096058;1229;132;1904;1915;11.47;0.70;195.19;3.36;675;14;635.00;11
1230;14;626096067;1230;135;1905;1915;11.53;0.70;195.14;3.36;675;14;636.00;10
1231;14;626096081;1231;136;1905;1915;11.46;0.70;195.21;3.36;674;14;637.00;10
1235;14;626096091;1235;139;1909;1919;11.27;0.68;195.03;3.36;674;14;638.00;10
1235;14;626096101;1235;144;1911;1920;11.14;0.68;195.03;3.37;676;14;639.00;9
1238;14;626096110;1238;147;1912;1920;10.92;0.67;194.98;3.37;674;14;640.00;8
1240;14;626096120;1240;157;1914;1921;10.84;0.66;194.89;3.39;674;14;641.00;7
1240;14;626096129;1240;163;1914;1921;10.85;0.66;194.89;3.39;674;14;642.00;7
1242;14;626096138;1242;166;1916;1921;10.73;0.66;194.91;3.40;674;14;643.00;5
1245;14;626096148;1245;170;1916;1921;10.64;0.65;195.00;3.40;671;14;644.00;5
1246;14;626096157;1246;173;1917;1921;10.50;0.64;195.01;3.41;671;14;645.00;4
1247;14;626096166;1247;178;1917;1921;10.36;0.63;194.91;3.41;670;14;646.00;4
1249;14;626096175;1249;188;1920;1921;10.22;0.62;194.71;3.45;671;14;647.00;1
1251;14;626096187;1251;199;1958;1991;10.23;0.63;194.64;3.38;707;14;648.00;33
1254;14;626096201;1254;200;1961;1992;10.11;0.62;194.49;3.39;707;14;649.00;31
1256;14;626096211;1256;204;1973;1992;9.99;0.61;194.26;3.38;717;14;650.00;19
1259;14;626096219;1259;206;1977;1992;9.91;0.61;194.27;3.38;718;14;651.00;15
1262;14;626096228;1262;212;1984;1992;9.84;0.60;194.02;3.38;722;14;652.00;8
1264;14;626096237;1264;218;1988;1992;9.71;0.59;193.95;3.38;724;14;653.00;4
1266;14;626096246;1266;226;1990;1992;9.57;0.58;193.88;3.39;724;14;654.00;2
1267;14;626096254;1267;228;1990;1992;9.38;0.57;194.01;3.39;723;14;655.00;2
1267;14;626096262;1267;231;1992;1993;9.24;0.56;194.01;3.39;725;14;656.00;1
1270;14;626096271;1270;237;1993;1994;9.08;0.55;193.63;3.39;723;14;657.00;1
1272;14;626096280;1272;244;1994;1994;9.01;0.55;193.67;3.39;722;14;658.00;0
1272;14;626096288;1272;251;1998;1998;8.87;0.54;193.67;3.39;726;14;659.00;0
1273;14;626096298;1273;252;1998;1998;8.78;0.54;193.61;3.39;725;14;660.00;0
1276;14;626096312;1276;260;1998;1998;8.65;0.53;193.46;3.39;722;14;661.00;0
1276;14;626096321;1276;263;1998;1998;8.55;0.52;193.46;3.39;722;14;662.00;0
1276;14;626096330;1276;271;2003;2004;8.51;0.52;193.46;3.38;727;14;663.00;1
1278;14;626096340;1278;275;2004;2004;8.45;0.52;193.60;3.38;726;14;664.00;0
1279;14;626096349;1279;279;2004;2004;8.41;0.52;193.68;3.38;725;14;665.00;0
1282;14;626096359;1282;280;2007;2007;8.38;0.51;193.53;3.37;725;14;666.00;0
1282;14;626096368;1282;287;2007;2007;8.30;0.51;193.53;3.37;725;14;667.00;0
1285;14;626096377;1285;295;2007;2007;8.22;0.50;193.43;3.37;722;14;668.00;0
1286;14;626096386;1286;297;2008;2008;8.18;0.50;193.38;3.37;722;14;669.00;0
1286;14;626096395;1286;303;2009;2009;8.14;0.50;193.38;3.37;723;14;670.00;0
1290;14;626096403;1290;310;2009;2009;8.00;0.49;193.34;3.37;719;14;671.00;0
1290;14;626096412;1290;315;2022;2022;7.93;0.48;193.34;3.35;732;14;672.00;0
1292;14;626096422;1292;323;2022;2022;7.87;0.48;193.36;3.35;730;14;673.00;0
1296;14;626096431;1296;325;2022;2022;7.82;0.48;193.41;3.35;726;14;674.00;0
1300;14;626096439;1300;308;2024;2024;7.78;0.47;193.57;3.35;724;14;675.00;0
1304;14;626096449;1304;298;2024;2024;7.70;0.47;193.51;3.35;720;14;676.00;0
1305;14;626096458;1305;286;2027;2028;7.73;0.47;193.68;3.34;722;14;677.00;1
1308;14;626096466;1308;282;2027;2028;7.65;0.47;193.85;3.34;719;14;678.00;1
1311;14;626096474;1311;282;2032;2032;7.59;0.46;193.80;3.34;721;14;679.00;0
1313;15;626096483;1313;260;2032;2032;7.58;0.46;193.83;3.34;719;15;680.00;0
1318;15;626096502;1318;248;2032;2032;7.51;0.46;194.18;3.34;714;15;681.00;0
1320;15;626096517;1320;235;2032;2032;7.53;0.46;194.53;3.34;712;15;682.00;0
1325;15;626096525;1325;226;2032;2032;7.58;0.46;194.62;3.34;707;15;683.00;0
1327;15;626096534;1327;225;2042;2044;7.77;0.47;194.78;3.32;715;15;684.00;2
1329;15;626096549;1329;227;2043;2044;7.87;0.48;195.10;3.32;714;15;685.00;1
1333;15;626096559;1333;220;2044;2044;8.00;0.49;195.42;3.32;711;15;686.00;0
1334;15;626096569;1334;212;2044;2044;8.14;0.50;195.52;3.32;710;15;687.00;0
1336;15;626096578;1336;206;2044;2044;8.24;0.50;195.83;3.32;708;15;688.00;0
1338;15;626096588;1338;203;2044;2044;8.33;0.51;195.92;3.32;706;15;689.00;0
1339;15;626096601;1339;195;2044;2045;8.40;0.51;196.09;3.32;705;15;690.00;1
1343;15;626096610;1343;196;2045;2045;8.40;0.52;196.49;3.32;702;15;691.00;0
1343;15;626096619;1343;188;2050;2051;8.55;0.53;196.49;3.31;707;15;692.00;1
1347;15;626096629;1347;186;2052;2052;8.63;0.53;196.65;3.31;705;15;693.00;0
1349;15;626096638;1349;180;2052;2052;8.62;0.53;196.75;3.31;703;15;694.00;0
1352;15;626096649;1352;181;2052;2052;8.62;0.53;197.10;3.31;700;15;695.00;0
1353;15;626096660;1353;177;2056;2056;8.74;0.54;197.15;3.30;703;15;696.00;0
1354;15;626096670;1354;175;2056;2056;8.83;0.54;197.30;3.30;702;15;697.00;0
1359;15;626096680;1359;167;2056;2056;8.81;0.54;197.46;3.30;697;15;698.00;0
1363;15;626096691;1363;161;2057;2057;8.88;0.54;197.40;3.30;694;15;699.00;0
1367;15;626096702;1367;167;2061;2061;8.97;0.55;197.53;3.30;694;15;700.00;0
1370;15;626096717;1370;165;2061;2061;9.05;0.55;198.05;3.30;691;15;701.00;0
1373;15;626096727;1373;160;2063;2064;9.17;0.56;197.99;3.30;690;15;702.00;1
1378;15;626096738;1378;156;2064;2064;9.31;0.57;197.99;3.30;686;15;703.00;0
1384;15;626096749;1384;155;2064;2064;9.40;0.58;198.03;3.30;680;15;704.00;0
1389;15;626096761;1389;155;2064;2064;9.53;0.58;198.05;3.30;675;15;705.00;0
1396;15;626096772;1396;151;2067;2068;9.60;0.59;198.43;3.29;671;15;706.00;1
1401;15;626096784;1401;149;2067;2068;9.78;0.60;198.36;3.29;666;15;707.00;1
1405;15;626096795;1405;148;2068;2068;9.91;0.60;198.63;3.29;663;15;708.00;0
1411;15;626096805;1411;144;2068;2068;9.91;0.60;198.62;3.29;657;15;709.00;0
1417;15;626096817;1417;141;2069;2069;9.91;0.60;198.84;3.29;652;15;710.00;0
1422;15;626096828;1422;143;2070;2070;9.91;0.60;198.92;3.29;648;15;711.00;0
1427;15;626096839;1427;143;2070;2070;9.89;0.60;199.33;3.29;643;15;712.00;0
1430;15;626096851;1430;143;2071;2071;9.98;0.61;199.40;3.29;641;15;713.00;0
1437;15;626096863;1437;140;2071;2071;10.01;0.61;199.69;3.29;634;15;714.00;0
1440;15;626096872;1440;139;2071;2071;10.06;0.61;199.72;3.29;631;15;715.00;0
1441;15;626096882;1441;140;2071;2071;10.10;0.61;199.78;3.29;630;15;716.00;0
1445;15;626096892;1445;141;2071;2071;10.12;0.61;199.80;3.29;626;15;717.00;0
1448;15;626096901;1448;142;2071;2071;10.12;0.62;199.93;3.29;623;15;718.00;0
1450;15;626096910;1450;140;2071;2071;10.15;0.62;199.71;3.29;621;15;719.00;0
1454;15;626096922;1454;192;2197;2301;9.95;0.62;200.01;3.10;743;15;720.00;104
1461;15;626096951;1461;176;2206;2302;9.90;0.62;200.46;3.09;745;15;721.00;96
1463;15;626096965;1463;166;2218;2302;9.99;0.62;200.51;3.09;755;15;722.00;84
1467;15;626096982;1467;162;2226;2302;9.88;0.62;200.87;3.09;759;15;723.00;76
1469;15;626097002;1469;161;2231;2302;9.89;0.62;201.09;3.09;762;15;724.00;71
1470;15;626097021;1470;163;2238;2302;9.85;0.61;201.09;3.09;768;15;725.00;64
1476;15;626097040;1476;171;2244;2302;9.74;0.61;201.44;3.10;768;15;726.00;58
1482;15;626097059;1482;169;2250;2302;9.59;0.59;201.97;3.11;768;15;727.00;52
1484;15;626097078;1484;170;2255;2303;9.53;0.59;201.99;3.12;771;15;728.00;48
1487;15;626097093;1487;173;2259;2304;9.46;0.59;202.09;3.13;772;15;729.00;45
1491;15;626097107;1491;175;2263;2304;9.45;0.58;202.32;3.14;772;15;730.00;41
1492;15;626097121;1492;189;2267;2305;9.44;0.58;202.47;3.15;775;15;731.00;38
1495;15;626097134;1495;189;2270;2305;9.44;0.58;202.75;3.16;775;15;732.00;35
1498;15;626097149;1498;203;2273;2305;9.40;0.58;203.19;3.18;775;15;733.00;32
1501;15;626097162;1501;209;2273;2305;9.38;0.58;203.19;3.18;772;15;734.00;32
1503;15;626097175;1503;213;2277;2309;9.37;0.58;203.33;3.18;774;15;735.00;32
1507;15;626097189;1507;215;2279;2309;9.33;0.57;203.46;3.20;772;15;736.00;30
1509;15;626097201;1509;214;2282;2309;9.38;0.58;203.58;3.21;773;15;737.00;27
1512;15;626097215;1512;214;2284;2312;9.43;0.58;203.90;3.22;772;15;738.00;28
1517;15;626097235;1517;204;2286;2312;9.43;0.58;204.21;3.23;769;15;739.00;26
1520;15;626097255;1520;201;2289;2312;9.51;0.58;203.96;3.25;769;15;740.00;23
1522;15;626097269;1522;197;2295;2316;9.56;0.59;204.02;3.26;773;15;741.00;21
1524;15;626097283;1524;198;2298;2317;9.67;0.59;204.23;3.28;774;15;742.00;19
1527;15;626097296;1527;203;2299;2317;9.71;0.60;204.26;3.28;772;15;743.00;18
1529;15;626097311;1529;207;2306;2321;9.75;0.60;204.35;3.30;777;15;744.00;15
1532;15;626097330;1532;210;2306;2321;9.80;0.60;204.39;3.30;774;15;745.00;15
1536;15;626097344;1536;214;2307;2321;9.79;0.60;204.45;3.30;771;15;746.00;14
1537;15;626097357;1537;210;2310;2322;9.81;0.60;204.45;3.31;773;15;747.00;12
1538;15;626097371;1538;212;2310;2322;9.88;0.60;204.48;3.31;772;15;748.00;12
1539;15;626097383;1539;210;2314;2328;9.93;0.61;204.53;3.31;775;15;749.00;14
1539;15;626097400;1539;210;2315;2328;10.00;0.61;204.53;3.30;776;15;750.00;13
1542;15;626097413;1542;210;2317;2329;10.00;0.61;204.67;3.30;775;15;751.00;12
1543;15;626097428;1543;210;2317;2329;9.99;0.61;204.62;3.30;774;15;752.00;12
1547;15;626097442;1547;206;2317;2329;10.04;0.61;204.86;3.30;770;15;753.00;12
1552;15;626097456;1552;211;2317;2329;10.09;0.61;204.99;3.30;765;15;754.00;12
1554;15;626097470;1554;213;2317;2329;10.14;0.62;205.03;3.30;763;15;755.00;12
1556;15;626097482;1556;210;2329;2341;10.22;0.62;205.00;3.29;773;15;756.00;12
1560;15;626097496;1560;215;2329;2341;10.19;0.62;205.27;3.29;769;15;757.00;12
1563;15;626097510;1563;211;2329;2341;10.22;0.62;205.26;3.29;766;15;758.00;12
1565;15;626097522;1565;209;2329;2341;10.24;0.63;205.29;3.29;764;15;759.00;12
1567;15;626097535;1567;212;2329;2341;10.23;0.62;205.53;3.29;762;15;760.00;12
1568;15;626097547;1568;219;2329;2341;10.20;0.62;205.56;3.29;761;15;761.00;12
1571;15;626097559;1571;218;2333;2345;10.14;0.62;205.60;3.28;762;15;762.00;12
1572;15;626097577;1572;220;2333;2345;10.20;0.62;205.62;3.28;761;15;763.00;12
1575;15;626097591;1575;223;2336;2349;10.19;0.62;205.76;3.28;761;15;764.00;13
1576;15;626097604;1576;222;2338;2351;10.14;0.62;205.70;3.28;762;15;765.00;13
1576;15;626097615;1576;227;2339;2351;10.10;0.61;205.70;3.28;763;15;766.00;12
1577;15;626097633;1577;230;2339;2351;10.09;0.62;205.82;3.28;762;15;767.00;12
1579;15;626097645;1579;234;2349;2364;10.03;0.61;205.81;3.26;770;15;768.00;15
1582;15;626097658;1582;238;2349;2364;9.90;0.60;206.00;3.26;767;15;769.00;15
1583;15;626097670;1583;237;2349;2364;9.85;0.60;205.99;3.26;766;15;770.00;15
1585;15;626097681;1585;235;2350;2365;9.78;0.60;206.02;3.26;765;15;771.00;15
1589;15;626097693;1589;233;2350;2366;9.64;0.59;206.10;3.26;761;15;772.00;16
1592;15;626097704;1592;230;2350;2366;9.53;0.58;206.04;3.26;758;15;773.00;16
1593;15;626097716;1593;227;2352;2369;9.54;0.58;206.05;3.26;759;15;774.00;17
1596;15;626097726;1596;224;2352;2369;9.45;0.58;206.20;3.26;756;15;775.00;17
1598;15;626097737;1598;223;2353;2369;9.41;0.58;206.39;3.26;755;15;776.00;16
1600;15;626097748;1600;222;2354;2369;9.38;0.57;206.65;3.28;754;15;777.00;15
1604;15;626097760;1604;225;2358;2375;9.36;0.57;206.97;3.28;754;15;778.00;17
1607;15;626097772;1607;227;2358;2375;9.29;0.57;207.15;3.28;751;15;779.00;17
1611;15;626097790;1611;224;2359;2375;9.21;0.56;207.39;3.28;748;15;780.00;16
1616;15;626097801;1616;219;2359;2375;9.12;0.56;207.43;3.28;743;15;781.00;16
1620;15;626097812;1620;214;2362;2379;9.01;0.55;207.18;3.27;742;15;782.00;17
1621;15;626097823;1621;216;2363;2380;9.03;0.55;207.12;3.27;742;15;783.00;17
1622;15;626097834;1622;207;2363;2380;9.09;0.55;207.06;3.27;741;15;784.00;17
1622;15;626097844;1622;202;2366;2381;9.04;0.55;207.06;3.28;744;15;785.00;15
1624;15;626097855;1624;194;2366;2381;9.07;0.55;206.96;3.28;742;15;786.00;15
1626;15;626097866;1626;186;2366;2381;9.14;0.56;206.97;3.28;740;15;787.00;15
1629;15;626097876;1629;186;2366;2381;9.11;0.55;206.93;3.28;737;15;788.00;15
1631;15;626097887;1631;178;2366;2381;9.12;0.55;206.78;3.28;735;15;789.00;15
1632;15;626097898;1632;175;2367;2381;9.12;0.56;206.69;3.29;735;15;790.00;14
1635;15;626097909;1635;175;2367;2381;9.15;0.56;206.61;3.29;732;15;791.00;14
1635;15;626097919;1635;176;2397;2451;9.24;0.57;206.61;3.25;762;15;792.00;54
1636;15;626097937;1636;178;2398;2452;9.21;0.57;206.55;3.28;762;15;793.00;54
1638;15;626097950;1638;172;2405;2452;9.34;0.57;206.43;3.27;767;15;794.00;47
1639;15;626097967;1639;172;2409;2452;9.39;0.58;206.35;3.27;770;15;795.00;43
1643;15;626097980;1643;175;2417;2452;9.46;0.58;206.27;3.33;774;15;796.00;35
1644;15;626097994;1644;181;2421;2452;9.53;0.58;206.28;3.34;777;15;797.00;31
1645;15;626098005;1645;182;2426;2452;9.58;0.59;206.20;3.37;781;15;798.00;26
1648;16;626098017;1648;182;2429;2452;9.62;0.59;206.12;3.41;781;16;799.00;23
1650;16;626098039;1650;185;2431;2453;9.66;0.59;206.00;3.41;781;16;800.00;22
1652;16;626098055;1652;186;2435;2454;9.62;0.59;205.91;3.44;783;16;801.00;19
1656;16;626098067;1656;192;2436;2454;9.59;0.58;205.64;3.44;780;16;802.00;18
1660;16;626098079;1660;195;2441;2458;9.56;0.58;205.52;3.45;781;16;803.00;17
1663;16;626098091;1663;199;2443;2458;9.47;0.58;205.47;3.48;780;16;804.00;15
1666;16;626098102;1666;201;2443;2458;9.37;0.57;205.33;3.48;777;16;805.00;15
1668;16;626098115;1668;211;2443;2458;9.27;0.56;205.18;3.48;775;16;806.00;15
1670;16;626098126;1670;221;2448;2464;9.21;0.56;205.13;3.51;778;16;807.00;16
1672;16;626098137;1672;226;2449;2464;9.16;0.56;205.04;3.51;777;16;808.00;15
1674;16;626098150;1674;228;2450;2464;9.09;0.55;205.03;3.55;776;16;809.00;14
1677;16;626098162;1677;236;2455;2470;9.06;0.55;204.76;3.58;778;16;810.00;15
1678;16;626098180;1678;246;2457;2470;8.98;0.55;204.65;3.60;779;16;811.00;13
1681;16;626098191;1681;252;2459;2470;8.93;0.54;204.53;3.63;778;16;812.00;11
1682;16;626098203;1682;257;2461;2471;8.86;0.54;204.50;3.66;779;16;813.00;10
1685;16;626098213;1685;263;2464;2472;8.78;0.53;204.46;3.66;779;16;814.00;8
1686;16;626098224;1686;269;2466;2472;8.73;0.53;204.36;3.68;780;16;815.00;6
1686;16;626098234;1686;277;2477;2485;8.69;0.53;204.36;3.67;791;16;816.00;8
1688;16;626098246;1688;286;2478;2485;8.67;0.53;204.27;3.68;790;16;817.00;7
1688;16;626098257;1688;292;2479;2485;8.64;0.53;204.27;3.68;791;16;818.00;6
1688;16;626098267;1688;297;2481;2486;8.61;0.53;204.27;3.69;793;16;819.00;5
1690;16;626098278;1690;307;2481;2486;8.57;0.52;204.15;3.69;791;16;820.00;5
1692;16;626098289;1692;310;2485;2490;8.51;0.52;204.19;3.69;793;16;821.00;5
1694;16;626098301;1694;318;2485;2490;8.42;0.51;204.07;3.69;791;16;822.00;5
1694;16;626098312;1694;327;2492;2494;8.36;0.51;204.07;3.69;798;16;823.00;2
1699;16;626098325;1699;330;2493;2494;8.25;0.50;203.93;3.69;794;16;824.00;1
1700;16;626098336;1700;335;2493;2494;8.18;0.50;203.83;3.69;793;16;825.00;1
1701;16;626098347;1701;343;2493;2494;8.06;0.49;203.77;3.69;792;16;826.00;1
1704;16;626098357;1704;333;2493;2494;7.93;0.48;203.80;3.69;789;16;827.00;1
1705;16;626098368;1705;328;2504;2506;7.94;0.49;203.83;3.68;799;16;828.00;2
1706;16;626098381;1706;319;2505;2506;7.94;0.49;203.79;3.68;799;16;829.00;1
1707;16;626098393;1707;312;2505;2506;7.96;0.49;203.73;3.68;798;16;830.00;1
1707;16;626098403;1707;304;2505;2506;8.03;0.49;203.73;3.68;798;16;831.00;1
1708;16;626098413;1708;300;2505;2506;8.09;0.50;203.76;3.68;797;16;832.00;1
1708;16;626098424;1708;294;2505;2506;8.19;0.50;203.76;3.68;797;16;833.00;1
1709;16;626098434;1709;293;2506;2507;8.30;0.51;203.70;3.67;797;16;834.00;1
1710;16;626098445;1710;289;2506;2507;8.39;0.51;203.70;3.67;796;16;835.00;1
1714;16;626098457;1714;285;2511;2513;8.50;0.52;203.68;3.67;797;16;836.00;2
1715;16;626098475;1715;288;2512;2514;8.57;0.52;203.80;3.67;797;16;837.00;2
1715;17;626098486;1715;290;2513;2514;8.68;0.53;203.80;3.67;798;17;838.00;1
1717;17;626098516;1717;290;2513;2514;8.71;0.53;203.71;3.67;796;17;839.00;1
1717;17;626098529;1717;290;2518;2519;8.77;0.53;203.71;3.66;801;17;840.00;1
1717;17;626098540;1717;291;2518;2519;8.65;0.53;203.71;3.66;801;17;841.00;1
1717;17;626098551;1717;290;2518;2519;8.57;0.52;203.71;3.66;801;17;842.00;1
1719;17;626098561;1719;291;2519;2520;8.47;0.52;203.78;3.66;800;17;843.00;1
1719;17;626098572;1719;288;2523;2524;8.34;0.51;203.78;3.65;804;17;844.00;1
1724;17;626098583;1724;294;2523;2524;8.20;0.50;203.84;3.65;799;17;845.00;1
1726;17;626098594;1726;295;2525;2527;8.12;0.49;203.90;3.65;799;17;846.00;2
1728;17;626098605;1728;297;2526;2527;8.01;0.49;204.05;3.65;798;17;847.00;1
1732;17;626098614;1732;305;2526;2527;7.92;0.48;204.48;3.65;794;17;848.00;1
1735;17;626098624;1735;304;2526;2527;7.85;0.48;204.44;3.65;791;17;849.00;1
1739;17;626098634;1739;289;2529;2531;7.87;0.48;204.84;3.65;790;17;850.00;2
1745;17;626098645;1745;285;2529;2531;7.83;0.48;205.51;3.65;784;17;851.00;2
1747;17;626098655;1747;277;2530;2531;7.85;0.48;205.63;3.65;783;17;852.00;1
1752;17;626098664;1752;272;2530;2531;7.87;0.48;205.89;3.65;778;17;853.00;1
1757;17;626098674;1757;271;2531;2532;7.84;0.48;206.42;3.65;774;17;854.00;1
1761;17;626098685;1761;267;2533;2534;7.93;0.48;206.43;3.64;772;17;855.00;1
1766;17;626098695;1766;264;2533;2534;7.98;0.49;206.48;3.64;767;17;856.00;1
1770;17;626098706;1770;260;2534;2535;8.10;0.49;206.66;3.64;764;17;857.00;1
1774;17;626098721;1774;251;2534;2535;8.23;0.50;207.07;3.64;760;17;858.00;1
1778;17;626098732;1778;244;2534;2535;8.32;0.51;207.03;3.64;756;17;859.00;1
1783;17;626098742;1783;238;2534;2535;8.39;0.51;207.57;3.64;751;17;860.00;1
1785;17;626098753;1785;236;2534;2535;8.54;0.52;207.70;3.64;749;17;861.00;1
1787;17;626098763;1787;227;2534;2535;8.59;0.52;207.85;3.64;747;17;862.00;1
1790;17;626098775;1790;217;2534;2535;8.63;0.52;208.19;3.64;744;17;863.00;1
1792;17;626098785;1792;226;2614;2662;8.91;0.55;208.34;3.53;822;17;864.00;48
1798;17;626098810;1798;217;2618;2663;8.89;0.55;208.65;3.53;820;17;865.00;45
1800;17;626098822;1800;210;2627;2663;9.07;0.56;208.67;3.52;827;17;866.00;36
1806;17;626098835;1806;212;2629;2663;9.11;0.56;209.19;3.52;823;17;867.00;34
1812;17;626098847;1812;206;2633;2663;9.20;0.57;209.37;3.52;821;17;868.00;30
1813;17;626098859;1813;198;2637;2663;9.30;0.58;209.41;3.53;824;17;869.00;26
1820;17;626098873;1820;193;2642;2663;9.30;0.57;209.73;3.53;822;17;870.00;21
1826;17;626098886;1826;193;2646;2663;9.23;0.57;210.13;3.54;820;17;871.00;17
1827;17;626098899;1827;191;2649;2664;9.22;0.57;210.10;3.54;822;17;872.00;15
1832;17;626098917;1832;198;2650;2665;9.19;0.57;210.47;3.54;818;17;873.00;15
1837;17;626098930;1837;202;2652;2665;9.18;0.56;210.49;3.54;815;17;874.00;13
1841;17;626098943;1841;206;2654;2666;9.15;0.56;210.54;3.55;813;17;875.00;12
1844;17;626098956;1844;212;2656;2666;9.17;0.56;210.76;3.55;812;17;876.00;10
1848;17;626098974;1848;218;2658;2666;9.13;0.56;210.61;3.59;810;17;877.00;8
1853;17;626098992;1853;217;2660;2666;9.15;0.56;211.11;3.59;807;17;878.00;6
1858;17;626099012;1858;220;2663;2670;9.17;0.56;211.35;3.60;805;17;879.00;7
1862;17;626099040;1862;231;2664;2670;9.18;0.56;211.33;3.60;802;17;880.00;6
1868;17;626099058;1868;228;2665;2670;9.22;0.56;211.58;3.60;797;17;881.00;5
1871;17;626099089;1871;228;2668;2673;9.32;0.57;211.63;3.61;797;17;882.00;5
1878;17;626099111;1878;226;2668;2673;9.34;0.57;212.01;3.61;790;17;883.00;5
1883;17;626099124;1883;222;2669;2673;9.46;0.58;211.90;3.61;786;17;884.00;4
1889;17;626099136;1889;222;2673;2677;9.52;0.58;212.21;3.60;784;17;885.00;4
1893;17;626099150;1893;217;2675;2678;9.60;0.59;212.24;3.60;782;17;886.00;3
1899;17;626099162;1899;215;2675;2678;9.64;0.59;212.18;3.60;776;17;887.00;3
1903;17;626099175;1903;216;2680;2682;9.69;0.59;212.18;3.60;777;17;888.00;2
1907;17;626099188;1907;216;2680;2682;9.70;0.59;212.35;3.60;773;17;889.00;2
1911;17;626099200;1911;218;2680;2682;9.58;0.59;212.71;3.60;769;17;890.00;2
1915;17;626099221;1915;224;2681;2683;9.54;0.58;212.81;3.60;766;17;891.00;2
1918;17;626099235;1918;227;2681;2683;9.48;0.58;212.86;3.60;763;17;892.00;2
1923;17;626099248;1923;227;2686;2689;9.43;0.58;212.96;3.59;763;17;893.00;3
1927;17;626099261;1927;231;2686;2689;9.32;0.57;213.00;3.59;759;17;894.00;3
1933;17;626099274;1933;232;2688;2690;9.23;0.57;213.17;3.59;755;17;895.00;2
1937;17;626099285;1937;235;2688;2690;9.12;0.56;213.36;3.59;751;17;896.00;2
1941;17;626099297;1941;227;2689;2690;8.99;0.55;213.62;3.60;748;17;897.00;1
1944;17;626099317;1944;226;2689;2690;8.95;0.55;213.83;3.60;745;17;898.00;1
1948;17;626099331;1948;222;2690;2690;8.90;0.55;214.24;3.61;742;17;899.00;0
1952;17;626099347;1952;232;2718;2736;8.85;0.55;214.41;3.58;766;17;900.00;18
1955;17;626099370;1955;228;2718;2736;8.97;0.55;214.85;3.58;763;17;901.00;18
1958;17;626099382;1958;221;2720;2736;9.05;0.56;214.95;3.58;762;17;902.00;16
1960;17;626099393;1960;225;2720;2736;9.12;0.56;215.03;3.58;760;17;903.00;16
1963;17;626099405;1963;224;2721;2736;9.17;0.56;215.12;3.58;758;17;904.00;15
1969;17;626099416;1969;225;2722;2736;9.14;0.56;215.17;3.58;753;17;905.00;14
1970;17;626099434;1970;210;2727;2740;9.14;0.56;215.33;3.57;757;17;906.00;13
1972;17;626099446;1972;207;2728;2740;9.11;0.56;215.37;3.58;756;17;907.00;12
1976;17;626099467;1976;202;2732;2744;9.13;0.56;215.56;3.58;756;17;908.00;12
1980;17;626099478;1980;192;2733;2745;9.16;0.56;215.58;3.58;753;17;909.00;12
1984;17;626099490;1984;187;2734;2745;9.21;0.56;215.91;3.58;750;17;910.00;11
1986;17;626099502;1986;178;2734;2745;9.27;0.57;215.88;3.58;748;17;911.00;11
1991;17;626099513;1991;179;2743;2758;9.39;0.58;215.95;3.57;752;17;912.00;15
1994;17;626099525;1994;185;2743;2758;9.41;0.58;216.05;3.57;749;17;913.00;15
2000;17;626099537;2000;184;2744;2758;9.40;0.57;216.14;3.57;744;17;914.00;14
2001;17;626099548;2001;181;2745;2759;9.44;0.58;216.13;3.57;744;17;915.00;14
2003;17;626099559;2003;187;2747;2760;9.45;0.58;216.21;3.57;744;17;916.00;13
2006;17;626099571;2006;190;2747;2760;9.43;0.58;216.29;3.57;741;17;917.00;13
2006;17;626099582;2006;185;2749;2763;9.41;0.58;216.29;3.57;743;17;918.00;14
2008;17;626099593;2008;185;2749;2763;9.40;0.58;216.30;3.57;741;17;919.00;14
2010;17;626099604;2010;181;2750;2763;9.40;0.58;216.42;3.58;740;17;920.00;13
2014;17;626099627;2014;175;2750;2763;9.43;0.58;216.42;3.58;736;17;921.00;13
2016;17;626099638;2016;170;2755;2769;9.49;0.58;216.40;3.58;739;17;922.00;14
2021;17;626099652;2021;162;2755;2769;9.50;0.58;216.51;3.58;734;17;923.00;14
2022;17;626099662;2022;162;2755;2769;9.64;0.59;216.45;3.58;733;17;924.00;14
2023;17;626099672;2023;158;2756;2769;9.71;0.59;216.52;3.59;733;17;925.00;13
2028;17;626099682;2028;158;2762;2773;9.69;0.59;216.52;3.59;734;17;926.00;11
2029;17;626099693;2029;161;2764;2774;9.74;0.59;216.51;3.60;735;17;927.00;10
2033;17;626099703;2033;168;2764;2774;9.73;0.59;216.51;3.60;731;17;928.00;10
2036;17;626099720;2036;169;2765;2775;9.74;0.59;216.48;3.60;729;17;929.00;10
2038;17;626099740;2038;174;2766;2775;9.69;0.59;216.40;3.61;728;17;930.00;9
2038;17;626099750;2038;177;2767;2775;9.73;0.59;216.40;3.62;729;17;931.00;8
2040;17;626099760;2040;182;2768;2775;9.62;0.59;216.40;3.62;728;17;932.00;7
2040;17;626099771;2040;181;2769;2775;9.61;0.59;216.40;3.63;729;17;933.00;6
2042;17;626099781;2042;189;2769;2775;9.55;0.58;216.43;3.63;727;17;934.00;6
2044;17;626099791;2044;194;2770;2775;9.49;0.58;216.39;3.63;726;17;935.00;5
2044;17;626099801;2044;211;2807;2845;9.30;0.57;216.39;3.59;763;17;936.00;38
2047;17;626099816;2047;215;2812;2846;9.21;0.56;216.59;3.60;765;17;937.00;34
2049;17;626099827;2049;212;2820;2846;9.25;0.57;216.63;3.59;771;17;938.00;26
2052;17;626099836;2052;213;2824;2846;9.19;0.56;216.50;3.59;772;17;939.00;22
2054;17;626099847;2054;213;2828;2846;9.15;0.56;216.52;3.59;774;17;940.00;18
2055;17;626099856;2055;218;2831;2846;9.16;0.56;216.50;3.61;776;17;941.00;15
2056;17;626099867;2056;216;2835;2846;9.19;0.56;216.53;3.61;779;17;942.00;11
2059;17;626099876;2059;212;2836;2846;9.18;0.56;216.64;3.61;777;17;943.00;10
2063;17;626099886;2063;215;2839;2847;9.11;0.56;216.71;3.62;776;17;944.00;8
2067;17;626099896;2067;215;2842;2849;9.08;0.56;216.86;3.61;775;17;945.00;7
2070;17;626099906;2070;215;2843;2849;9.09;0.55;216.86;3.62;773;17;946.00;6
2074;17;626099915;2074;217;2846;2853;9.02;0.55;216.69;3.61;772;17;947.00;7
2075;17;626099926;2075;217;2846;2853;8.97;0.55;216.78;3.61;771;17;948.00;7
2079;17;626099936;2079;212;2846;2853;8.90;0.54;216.66;3.61;767;17;949.00;7
2080;17;626099945;2080;206;2846;2853;8.81;0.54;216.79;3.61;766;17;950.00;7
2085;17;626099955;2085;207;2849;2859;8.70;0.53;216.53;3.61;764;17;951.00;10
2088;17;626099965;2088;200;2850;2859;8.54;0.52;216.47;3.61;762;17;952.00;9
2092;17;626099974;2092;201;2851;2859;8.42;0.51;216.47;3.62;759;17;953.00;8
2096;17;626099984;2096;198;2854;2862;8.31;0.51;216.56;3.62;758;17;954.00;8
2101;17;626099993;2101;197;2857;2862;8.21;0.50;216.54;3.63;756;17;955.00;5
2104;17;626100007;2104;195;2857;2862;8.17;0.50;216.56;3.63;753;17;956.00;5
2108;17;626100025;2108;199;2857;2863;8.18;0.50;216.61;3.63;749;17;957.00;6
2113;17;626100037;2113;200;2858;2864;8.17;0.50;216.76;3.63;745;17;958.00;6
2117;17;626100048;2117;197;2858;2864;8.29;0.50;216.70;3.63;741;17;959.00;6
2118;17;626100062;2118;204;2875;2890;8.38;0.51;216.69;3.61;757;17;960.00;15
2120;17;626100075;2120;197;2875;2890;8.43;0.51;216.68;3.61;755;17;961.00;15
2122;17;626100085;2122;200;2877;2890;8.56;0.52;216.60;3.60;755;17;962.00;13
2123;17;626100096;2123;198;2879;2891;8.65;0.53;216.52;3.60;756;17;963.00;12
2126;17;626100107;2126;201;2879;2891;8.67;0.53;216.31;3.60;753;17;964.00;12
2128;17;626100117;2128;206;2881;2895;8.75;0.53;216.19;3.60;753;17;965.00;14
2133;17;626100127;2133;205;2882;2895;8.76;0.53;215.91;3.60;749;17;966.00;13
2133;17;626100138;2133;208;2885;2899;8.77;0.53;215.91;3.60;752;17;967.00;14
2133;17;626100149;2133;213;2885;2899;8.78;0.53;215.91;3.60;752;17;968.00;14
2133;17;626100159;2133;215;2888;2899;8.82;0.54;215.91;3.63;755;17;969.00;11
2135;17;626100169;2135;219;2888;2899;8.77;0.53;216.13;3.63;753;17;970.00;11
2137;17;626100179;2137;223;2889;2899;8.68;0.53;216.12;3.64;752;17;971.00;10
2139;17;626100189;2139;226;2900;2911;8.64;0.52;216.05;3.63;761;17;972.00;11
2139;17;626100201;2139;229;2901;2911;8.60;0.52;216.05;3.63;762;17;973.00;10
2139;17;626100211;2139;233;2902;2911;8.61;0.52;216.05;3.63;763;17;974.00;9
2140;17;626100222;2140;239;2902;2911;8.57;0.52;216.01;3.63;762;17;975.00;9
2140;17;626100232;2140;247;2903;2911;8.56;0.52;216.01;3.63;763;17;976.00;8
2141;17;626100242;2141;260;2904;2911;8.59;0.52;215.96;3.64;763;17;977.00;7
2142;17;626100253;2142;264;2904;2912;8.60;0.52;216.04;3.64;762;17;978.00;8
2144;17;626100263;2144;253;2905;2912;8.64;0.53;216.08;3.65;761;17;979.00;7
2146;17;626100274;2146;249;2910;2918;8.69;0.53;216.10;3.65;764;17;980.00;8
2149;17;626100286;2149;242;2913;2919;8.75;0.53;216.15;3.66;764;17;981.00;6
2149;17;626100296;2149;240;2913;2919;8.83;0.54;216.15;3.66;764;17;982.00;6
2153;17;626100307;2153;235;2914;2919;8.86;0.54;216.05;3.67;761;17;983.00;5
2156;17;626100318;2156;232;2917;2923;8.95;0.54;215.86;3.66;761;17;984.00;6
2157;17;626100330;2157;222;2920;2923;9.01;0.55;215.91;3.68;763;17;985.00;3
2158;17;626100346;2158;221;2920;2923;9.02;0.55;215.90;3.68;762;17;986.00;3
2159;17;626100358;2159;220;2922;2924;9.07;0.55;215.81;3.68;763;17;987.00;2
2162;17;626100374;2162;220;2926;2928;9.06;0.55;215.72;3.68;764;17;988.00;2
2162;17;626100386;2162;220;2927;2928;9.12;0.56;215.72;3.68;765;17;989.00;1
2164;17;626100399;2164;219;2931;2934;9.22;0.56;215.69;3.68;767;17;990.00;3
2165;17;626100410;2165;221;2931;2934;9.24;0.56;215.68;3.68;766;17;991.00;3
2166;17;626100421;2166;222;2932;2934;9.25;0.56;215.72;3.67;766;17;992.00;2
2166;18;626100433;2166;226;2932;2934;9.22;0.56;215.72;3.67;766;18;993.00;2
2167;18;626100454;2167;230;2935;2938;9.16;0.56;215.69;3.67;768;18;994.00;3
2171;18;626100465;2171;231;2936;2938;9.03;0.55;215.75;3.67;765;18;995.00;2
2171;18;626100482;2171;233;2936;2938;8.90;0.54;215.75;3.67;765;18;996.00;2
2173;18;626100492;2173;236;2937;2938;8.85;0.54;215.74;3.67;764;18;997.00;1
2173;18;626100503;2173;239;2939;2939;8.79;0.54;215.74;3.67;766;18;998.00;0
2176;18;626100513;2176;237;2940;2940;8.75;0.53;215.84;3.67;764;18;999.00;0
2177;18;626100525;2177;236;2940;2940;8.69;0.53;215.83;3.67;763;18;1000.00;0
2181;18;626100538;2181;231;2941;2941;8.66;0.53;215.72;3.67;760;18;1001.00;0
2182;18;626100549;2182;231;2941;2941;8.65;0.53;215.65;3.67;759;18;1002.00;0
2184;18;626100558;2184;229;2941;2941;8.65;0.53;215.75;3.67;757;18;1003.00;0
2188;18;626100569;2188;229;2941;2941;8.63;0.52;215.91;3.67;753;18;1004.00;0
2190;18;626100579;2190;228;2941;2941;8.66;0.53;216.24;3.67;751;18;1005.00;0
2194;18;626100589;2194;231;2941;2941;8.69;0.53;216.30;3.67;747;18;1006.00;0
2195;18;626100599;2195;230;2941;2941;8.69;0.53;216.41;3.67;746;18;1007.00;0
2198;18;626100610;2198;253;3013;3068;8.69;0.54;216.65;3.58;815;18;1008.00;55
2199;18;626100636;2199;247;3016;3069;8.68;0.54;216.76;3.58;817;18;1009.00;53
2200;18;626100647;2200;237;3026;3069;8.78;0.54;216.87;3.58;826;18;1010.00;43
2205;18;626100657;2205;235;3032;3069;8.77;0.54;217.12;3.58;827;18;1011.00;37
2207;18;626100667;2207;232;3039;3069;8.75;0.54;217.19;3.58;832;18;1012.00;30
2211;18;626100678;2211;237;3043;3069;8.68;0.53;217.59;3.58;832;18;1013.00;26
2217;18;626100688;2217;241;3047;3069;8.56;0.53;217.64;3.58;830;18;1014.00;22
2222;18;626100698;2222;244;3049;3069;8.42;0.52;217.49;3.58;827;18;1015.00;20
2226;18;626100709;2226;251;3053;3070;8.37;0.51;217.44;3.59;827;18;1016.00;17
2230;18;626100720;2230;257;3056;3071;8.34;0.51;217.49;3.59;826;18;1017.00;15
2234;18;626100731;2234;255;3060;3071;8.26;0.51;217.42;3.60;826;18;1018.00;11
2236;18;626100747;2236;260;3062;3072;8.19;0.50;217.37;3.60;826;18;1019.00;10
2239;18;626100759;2239;251;3063;3072;8.13;0.50;217.59;3.60;824;18;1020.00;9
2244;18;626100770;2244;239;3064;3072;8.04;0.49;217.63;3.61;820;18;1021.00;8
2246;18;626100782;2246;233;3065;3072;8.00;0.49;217.70;3.61;819;18;1022.00;7
2249;18;626100793;2249;227;3068;3076;7.99;0.49;217.84;3.61;819;18;1023.00;8
2253;18;626100806;2253;231;3070;3076;7.96;0.49;218.08;3.62;817;18;1024.00;6
2255;18;626100818;2255;232;3072;3076;8.03;0.49;218.19;3.63;817;18;1025.00;4
2261;18;626100835;2261;231;3075;3079;8.08;0.49;218.44;3.63;814;18;1026.00;4
2265;18;626100847;2265;226;3076;3079;8.14;0.50;218.69;3.63;811;18;1027.00;3
2267;18;626100858;2267;212;3078;3079;8.23;0.50;218.95;3.64;811;18;1028.00;1
2271;18;626100870;2271;212;3083;3083;8.32;0.51;219.40;3.63;812;18;1029.00;0
2273;18;626100883;2273;208;3084;3084;8.48;0.52;219.56;3.63;811;18;1030.00;0
2275;18;626100895;2275;206;3084;3084;8.60;0.53;219.68;3.63;809;18;1031.00;0
2279;18;626100908;2279;205;3088;3088;8.64;0.53;219.95;3.63;809;18;1032.00;0
2284;18;626100919;2284;205;3088;3088;8.75;0.53;220.10;3.63;804;18;1033.00;0
2289;18;626100933;2289;201;3088;3088;8.80;0.54;220.25;3.63;799;18;1034.00;0
2294;18;626100951;2294;198;3090;3090;8.94;0.55;220.48;3.62;796;18;1035.00;0
2297;18;626100965;2297;193;3090;3090;9.07;0.55;220.53;3.62;793;18;1036.00;0
2302;18;626100983;2302;198;3095;3096;9.18;0.56;220.94;3.62;793;18;1037.00;1
2307;18;626101015;2307;192;3095;3096;9.21;0.56;221.15;3.62;788;18;1038.00;1
2312;18;626101043;2312;188;3097;3097;9.26;0.56;221.32;3.62;785;18;1039.00;0
2319;18;626101061;2319;185;3097;3097;9.18;0.56;221.51;3.62;778;18;1040.00;0
2325;18;626101078;2325;186;3097;3097;9.13;0.56;221.89;3.62;772;18;1041.00;0
2326;18;626101092;2326;185;3097;3097;9.11;0.55;221.84;3.62;771;18;1042.00;0
2332;18;626101104;2332;188;3097;3097;9.15;0.56;222.08;3.62;765;18;1043.00;0
2338;18;626101127;2338;183;3108;3109;9.23;0.56;222.43;3.61;770;18;1044.00;1
2339;18;626101150;2339;185;3109;3109;9.30;0.57;222.42;3.61;770;18;1045.00;0
2346;18;626101163;2346;179;3109;3109;9.35;0.57;222.58;3.61;763;18;1046.00;0
2350;18;626101176;2350;176;3109;3109;9.44;0.57;222.75;3.61;759;18;1047.00;0
2355;18;626101188;2355;177;3109;3109;9.52;0.58;222.77;3.61;754;18;1048.00;0
2360;18;626101200;2360;175;3109;3109;9.59;0.58;222.92;3.61;749;18;1049.00;0
2361;18;626101212;2361;179;3115;3115;9.61;0.59;222.97;3.60;754;18;1050.00;0
2366;18;626101226;2366;175;3115;3115;9.69;0.59;223.14;3.60;749;18;1051.00;0
2369;18;626101237;2369;171;3118;3119;9.75;0.60;223.21;3.60;749;18;1052.00;1
2372;18;626101251;2372;168;3120;3120;9.77;0.60;223.57;3.60;748;18;1053.00;0
2377;18;626101262;2377;170;3120;3120;9.80;0.60;223.78;3.60;743;18;1054.00;0
2387;18;626101274;2387;170;3120;3120;9.79;0.60;224.13;3.60;733;18;1055.00;0
2388;18;626101286;2388;178;3133;3133;9.87;0.60;224.11;3.58;745;18;1056.00;0
2391;18;626101299;2391;177;3133;3133;9.94;0.61;224.26;3.58;742;18;1057.00;0
2396;18;626101310;2396;177;3133;3133;9.95;0.61;224.44;3.58;737;18;1058.00;0
2399;18;626101322;2399;176;3134;3134;9.97;0.61;224.41;3.58;735;18;1059.00;0
2405;18;626101333;2405;180;3135;3135;9.91;0.60;224.50;3.58;730;18;1060.00;0
2408;18;626101345;2408;178;3135;3135;9.99;0.61;224.68;3.58;727;18;1061.00;0
2415;18;626101356;2415;186;3137;3138;9.94;0.61;224.85;3.58;722;18;1062.00;1
2420;18;626101368;2420;190;3137;3138;9.87;0.60;225.04;3.58;717;18;1063.00;1
2422;18;626101379;2422;193;3138;3138;9.85;0.60;225.17;3.58;716;18;1064.00;0
2424;18;626101390;2424;199;3138;3138;9.75;0.59;225.40;3.58;714;18;1065.00;0
2428;18;626101401;2428;203;3143;3144;9.63;0.59;225.49;3.57;715;18;1066.00;1
2433;18;626101412;2433;199;3143;3144;9.51;0.58;225.57;3.57;710;18;1067.00;1
2434;18;626101424;2434;193;3144;3144;9.45;0.58;225.49;3.57;710;18;1068.00;0
2436;18;626101443;2436;197;3144;3144;9.45;0.58;225.64;3.57;708;18;1069.00;0
2440;18;626101455;2440;194;3148;3148;9.39;0.57;225.72;3.57;708;18;1070.00;0
2442;18;626101466;2442;198;3149;3149;9.37;0.57;225.74;3.57;707;18;1071.00;0
2443;18;626101478;2443;202;3149;3149;9.25;0.57;225.81;3.57;706;18;1072.00;0
2446;18;626101489;2446;194;3150;3150;9.25;0.57;225.82;3.57;704;18;1073.00;0
2450;18;626101500;2450;198;3150;3150;9.21;0.56;226.04;3.57;700;18;1074.00;0
2453;18;626101511;2453;203;3150;3150;9.14;0.56;226.08;3.57;697;18;1075.00;0
2458;18;626101522;2458;188;3150;3150;9.14;0.56;226.05;3.57;692;18;1076.00;0
2462;18;626101533;2462;183;3150;3150;9.19;0.56;225.86;3.57;688;18;1077.00;0
2465;18;626101542;2465;183;3150;3150;9.29;0.57;225.89;3.57;685;18;1078.00;0
2468;18;626101553;2468;177;3150;3150;9.34;0.57;225.94;3.57;682;18;1079.00;0
2469;18;626101566;2469;206;3230;3275;9.14;0.57;225.95;3.48;761;18;1080.00;45
2472;18;626101586;2472;191;3233;3276;9.08;0.56;225.98;3.48;761;18;1081.00;43
2478;18;626101600;2478;180;3243;3276;9.06;0.56;226.42;3.47;765;18;1082.00;33
2484;18;626101611;2484;180;3248;3276;9.12;0.56;226.59;3.47;764;18;1083.00;28
2484;18;626101622;2484;179;3251;3276;9.18;0.57;226.59;3.47;767;18;1084.00;25
2488;18;626101640;2488;179;3254;3276;9.19;0.57;226.75;3.47;766;18;1085.00;22
2489;18;626101652;2489;184;3259;3276;9.22;0.57;226.71;3.48;770;18;1086.00;17
2492;18;626101663;2492;181;3259;3276;9.27;0.57;226.97;3.48;767;18;1087.00;17
2496;18;626101675;2496;178;3262;3277;9.29;0.57;227.10;3.48;766;18;1088.00;15
2497;18;626101687;2497;181;3263;3278;9.30;0.57;227.08;3.48;766;18;1089.00;15
2502;18;626101698;2502;180;3265;3278;9.23;0.56;227.05;3.48;763;18;1090.00;13
2502;18;626101709;2502;191;3271;3282;9.19;0.56;227.05;3.48;769;18;1091.00;11
2506;18;626101720;2506;187;3272;3282;9.06;0.56;227.10;3.49;766;18;1092.00;10
2507;18;626101730;2507;189;3272;3282;8.96;0.55;227.08;3.49;765;18;1093.00;10
2509;18;626101742;2509;187;3273;3282;8.90;0.54;227.02;3.49;764;18;1094.00;9
2512;18;626101752;2512;189;3278;3288;8.85;0.54;227.05;3.49;766;18;1095.00;10
2513;18;626101771;2513;188;3278;3288;8.83;0.54;226.99;3.49;765;18;1096.00;10
2513;19;626101789;2513;189;3279;3288;8.79;0.54;226.99;3.49;766;19;1097.00;9
2514;19;626101817;2514;193;3281;3291;8.74;0.54;226.99;3.49;767;19;1098.00;10
2514;19;626101828;2514;202;3282;3291;8.81;0.54;226.99;3.49;768;19;1099.00;9
2514;19;626101839;2514;203;3282;3291;8.83;0.54;226.99;3.49;768;19;1100.00;9
2517;19;626101855;2517;212;3284;3292;8.72;0.54;226.98;3.49;767;19;1101.00;8
2518;19;626101865;2518;213;3285;3293;8.73;0.54;226.96;3.49;767;19;1102.00;8
2524;19;626101875;2524;218;3285;3293;8.67;0.53;226.72;3.49;761;19;1103.00;8
2524;19;626101885;2524;228;3295;3306;8.68;0.53;226.72;3.48;771;19;1104.00;11
2529;19;626101897;2529;234;3295;3306;8.63;0.53;226.75;3.48;766;19;1105.00;11
2532;19;626101908;2532;240;3295;3306;8.58;0.53;226.63;3.48;763;19;1106.00;11
2533;19;626101918;2533;247;3296;3307;8.59;0.53;226.57;3.47;763;19;1107.00;11
2536;19;626101934;2536;252;3296;3307;8.57;0.53;226.56;3.47;760;19;1108.00;11
2539;19;626101944;2539;258;3300;3311;8.55;0.52;226.60;3.47;761;19;1109.00;11
2542;19;626101957;2542;257;3300;3311;8.59;0.53;226.61;3.47;758;19;1110.00;11
2543;19;626101977;2543;250;3303;3315;8.68;0.53;226.57;3.47;760;19;1111.00;12
2545;19;626101987;2545;246;3303;3315;8.70;0.53;226.45;3.47;758;19;1112.00;12
2548;19;626101997;2548;242;3303;3315;8.78;0.54;226.42;3.47;755;19;1113.00;12
2549;19;626102007;2549;240;3303;3315;8.79;0.54;226.39;3.47;754;19;1114.00;12
2552;19;626102024;2552;233;3304;3315;8.76;0.54;226.35;3.48;752;19;1115.00;11
2554;19;626102034;2554;233;3314;3327;8.83;0.54;226.27;3.47;760;19;1116.00;13
2558;19;626102044;2558;235;3314;3327;8.79;0.54;226.18;3.47;756;19;1117.00;13
2561;19;626102053;2561;235;3315;3327;8.78;0.54;226.04;3.47;754;19;1118.00;12
2565;19;626102063;2565;234;3315;3327;8.75;0.53;225.99;3.47;750;19;1119.00;12
2571;19;626102072;2571;229;3316;3327;8.65;0.53;225.85;3.48;745;19;1120.00;11
2573;19;626102086;2573;229;3317;3327;8.54;0.52;225.94;3.49;744;19;1121.00;10
2576;19;626102095;2576;222;3317;3328;8.42;0.51;225.96;3.49;741;19;1122.00;11
2577;19;626102104;2577;219;3318;3328;8.32;0.51;225.97;3.49;741;19;1123.00;10
2581;19;626102112;2581;221;3323;3334;8.26;0.50;226.00;3.50;742;19;1124.00;11
2582;19;626102125;2582;220;3328;3336;8.25;0.50;225.96;3.51;746;19;1125.00;8
2585;19;626102136;2585;219;3329;3336;8.19;0.50;225.99;3.52;744;19;1126.00;7
2586;19;626102145;2586;222;3329;3336;8.19;0.50;225.99;3.52;743;19;1127.00;7
2588;19;626102154;2588;224;3332;3340;8.19;0.50;226.24;3.52;744;19;1128.00;8
2590;19;626102165;2590;227;3333;3340;8.20;0.50;226.23;3.54;743;19;1129.00;7
2591;19;626102174;2591;226;3333;3340;8.24;0.50;226.23;3.54;742;19;1130.00;7
2594;19;626102183;2594;214;3335;3341;8.25;0.50;226.13;3.55;741;19;1131.00;6
2594;19;626102193;2594;202;3338;3345;8.42;0.51;226.13;3.55;744;19;1132.00;7
2594;19;626102203;2594;196;3339;3345;8.58;0.52;226.13;3.56;745;19;1133.00;6
2594;19;626102212;2594;191;3341;3348;8.75;0.53;226.13;3.56;747;19;1134.00;7
2596;19;626102223;2596;184;3342;3348;8.87;0.54;226.04;3.56;746;19;1135.00;6
2597;20;626102232;2597;179;3342;3348;9.02;0.55;226.09;3.56;745;20;1136.00;6
2599;20;626102252;2599;175;3342;3348;9.09;0.55;225.96;3.56;743;20;1137.00;6
2599;20;626102263;2599;167;3345;3352;9.24;0.56;225.96;3.56;746;20;1138.00;7
2602;21;626102275;2602;165;3345;3352;9.41;0.57;225.82;3.56;743;21;1139.00;7
2602;21;626102298;2602;165;3346;3352;9.58;0.58;225.82;3.56;744;21;1140.00;6
2603;21;626102308;2603;159;3346;3352;9.70;0.59;225.81;3.56;743;21;1141.00;6
2605;21;626102319;2605;156;3346;3353;9.75;0.59;225.76;3.56;741;21;1142.00;7
2606;21;626102330;2606;157;3347;3354;9.86;0.60;225.74;3.55;741;21;1143.00;7
2606;21;626102341;2606;156;3347;3354;9.95;0.60;225.74;3.55;741;21;1144.00;7
2607;21;626102352;2607;159;3348;3355;10.02;0.61;225.77;3.55;741;21;1145.00;7
2607;21;626102363;2607;157;3348;3355;10.11;0.61;225.77;3.55;741;21;1146.00;7
2608;21;626102375;2608;159;3348;3355;10.17;0.62;225.74;3.55;740;21;1147.00;7
2611;21;626102387;2611;164;3348;3355;10.18;0.62;225.79;3.55;737;21;1148.00;7
2611;21;626102399;2611;161;3348;3355;10.22;0.62;225.79;3.55;737;21;1149.00;7
2613;21;626102410;2613;162;3350;3355;10.17;0.62;225.74;3.57;737;21;1150.00;5
2614;21;626102423;2614;159;3350;3355;10.19;0.62;225.73;3.57;736;21;1151.00;5
2617;21;626102434;2617;181;3420;3482;10.13;0.62;225.88;3.51;803;21;1152.00;62
2618;21;626102459;2618;177;3425;3483;10.10;0.62;226.01;3.51;807;21;1153.00;58
2620;21;626102472;2620;167;3432;3483;10.10;0.62;226.18;3.50;812;21;1154.00;51
2624;21;626102490;2624;172;3439;3483;10.13;0.62;226.13;3.51;815;21;1155.00;44
2627;21;626102501;2627;171;3447;3483;10.17;0.62;226.19;3.51;820;21;1156.00;36
2628;21;626102512;2628;174;3452;3483;10.12;0.62;226.25;3.52;824;21;1157.00;31
2631;21;626102523;2631;172;3455;3483;10.06;0.62;226.30;3.52;824;21;1158.00;28
2632;21;626102533;2632;182;3459;3483;10.05;0.62;226.27;3.53;827;21;1159.00;24
2637;21;626102544;2637;183;3464;3484;10.02;0.62;226.20;3.54;827;21;1160.00;20
2639;21;626102555;2639;187;3468;3485;9.94;0.61;226.34;3.55;829;21;1161.00;17
2643;21;626102565;2643;194;3470;3485;9.87;0.61;226.38;3.55;827;21;1162.00;15
2646;21;626102576;2646;199;3474;3486;9.71;0.60;226.38;3.56;828;21;1163.00;12
2648;21;626102587;2648;204;3477;3486;9.58;0.59;226.44;3.57;829;21;1164.00;9
2652;21;626102597;2652;209;3479;3486;9.41;0.58;226.51;3.57;827;21;1165.00;7
2655;21;626102607;2655;220;3481;3486;9.25;0.57;226.73;3.58;826;21;1166.00;5
2661;21;626102617;2661;228;3484;3490;9.07;0.56;226.76;3.58;823;21;1167.00;6
2665;21;626102628;2665;238;3486;3490;8.97;0.55;226.92;3.58;821;21;1168.00;4
2666;21;626102638;2666;233;3487;3490;8.93;0.55;226.97;3.59;821;21;1169.00;3
2670;21;626102650;2670;236;3490;3496;8.88;0.55;227.09;3.59;820;21;1170.00;6
2674;21;626102661;2674;236;3491;3496;8.74;0.54;227.44;3.59;817;21;1171.00;5
2676;21;626102678;2676;238;3492;3496;8.66;0.53;227.47;3.59;816;21;1172.00;4
2677;21;626102688;2677;239;3496;3500;8.61;0.53;227.55;3.59;819;21;1173.00;4
2680;21;626102699;2680;237;3498;3501;8.60;0.53;227.61;3.59;818;21;1174.00;3
2683;21;626102709;2683;237;3499;3501;8.58;0.53;227.44;3.59;816;21;1175.00;2
2685;21;626102720;2685;241;3503;3505;8.68;0.53;227.69;3.58;818;21;1176.00;2
2685;21;626102730;2685;245;3504;3505;8.71;0.53;227.69;3.58;819;21;1177.00;1
2690;21;626102740;2690;247;3504;3505;8.69;0.53;227.69;3.58;814;21;1178.00;1
2693;21;626102751;2693;250;3506;3506;8.77;0.54;227.77;3.58;813;21;1179.00;0
2694;21;626102760;2694;249;3506;3506;8.82;0.54;227.83;3.58;812;21;1180.00;0
2700;22;626102770;2700;247;3511;3512;8.79;0.54;227.87;3.58;811;22;1181.00;1
2705;22;626102791;2705;248;3511;3512;8.72;0.53;227.97;3.58;806;22;1182.00;1
2708;22;626102801;2708;249;3513;3513;8.59;0.53;227.96;3.58;805;22;1183.00;0
2714;22;626102816;2714;248;3513;3513;8.49;0.52;227.94;3.58;799;22;1184.00;0
2718;22;626102826;2718;252;3513;3513;8.41;0.51;228.15;3.58;795;22;1185.00;0
2720;22;626102841;2720;255;3513;3513;8.45;0.52;228.26;3.58;793;22;1186.00;0
2723;22;626102850;2723;254;3513;3513;8.41;0.51;228.37;3.58;790;22;1187.00;0
2727;22;626102860;2727;256;3524;3525;8.37;0.51;228.38;3.57;797;22;1188.00;1
2729;22;626102870;2729;250;3524;3525;8.26;0.50;228.41;3.57;795;22;1189.00;1
2732;22;626102885;2732;240;3525;3525;8.22;0.50;228.68;3.57;793;22;1190.00;0
2733;22;626102894;2733;236;3525;3525;8.14;0.50;228.74;3.57;792;22;1191.00;0
2737;22;626102904;2737;232;3525;3525;8.15;0.50;228.79;3.57;788;22;1192.00;0
2742;22;626102913;2742;224;3525;3525;8.15;0.50;228.92;3.57;783;22;1193.00;0
2745;22;626102923;2745;228;3529;3529;8.20;0.50;229.12;3.56;784;22;1194.00;0
2749;22;626102933;2749;230;3529;3529;8.31;0.51;229.13;3.56;780;22;1195.00;0
2751;22;626102943;2751;223;3532;3533;8.44;0.52;229.18;3.56;781;22;1196.00;1
2754;22;626102958;2754;221;3533;3534;8.50;0.52;229.27;3.56;779;22;1197.00;1
2755;22;626102974;2755;213;3534;3534;8.58;0.53;229.26;3.56;779;22;1198.00;0
2759;22;626102991;2759;204;3534;3534;8.61;0.53;229.46;3.56;775;22;1199.00;0
2764;22;626103015;2764;200;3557;3575;8.56;0.52;229.51;3.54;793;22;1200.00;18
2766;22;626103052;2766;198;3558;3575;8.59;0.53;229.57;3.54;792;22;1201.00;17
2770;22;626103071;2770;192;3561;3575;8.63;0.53;229.55;3.54;791;22;1202.00;14
2776;22;626103087;2776;188;3563;3576;8.67;0.53;229.78;3.54;787;22;1203.00;13
2780;22;626103101;2780;193;3566;3577;8.67;0.53;229.87;3.53;786;22;1204.00;11
2783;22;626103115;2783;189;3569;3577;8.69;0.53;229.90;3.54;786;22;1205.00;8
2789;22;626103128;2789;187;3571;3580;8.78;0.54;230.15;3.53;782;22;1206.00;9
2793;22;626103142;2793;183;3571;3580;8.80;0.54;230.19;3.53;778;22;1207.00;9
2799;22;626103154;2799;185;3572;3580;8.82;0.54;230.29;3.54;773;22;1208.00;8
2806;22;626103167;2806;182;3572;3580;8.83;0.54;230.50;3.54;766;22;1209.00;8
2811;22;626103180;2811;186;3577;3586;8.87;0.54;230.72;3.53;766;22;1210.00;9
2814;22;626103194;2814;189;3579;3586;8.87;0.54;230.91;3.53;765;22;1211.00;7
2819;22;626103206;2819;194;3580;3586;8.88;0.54;230.95;3.53;761;22;1212.00;6
2824;22;626103227;2824;189;3580;3586;8.88;0.54;231.10;3.53;756;22;1213.00;6
2827;22;626103245;2827;187;3584;3590;8.94;0.55;231.11;3.53;757;22;1214.00;6
2832;22;626103258;2832;186;3587;3592;9.00;0.55;231.29;3.53;755;22;1215.00;5
2837;22;626103272;2837;187;3587;3592;9.04;0.55;231.16;3.53;750;22;1216.00;5
2842;22;626103285;2842;186;3588;3593;9.10;0.56;231.50;3.53;746;22;1217.00;5
2846;22;626103296;2846;182;3588;3593;9.16;0.56;231.51;3.53;742;22;1218.00;5
2851;22;626103308;2851;184;3588;3593;9.25;0.56;231.56;3.53;737;22;1219.00;5
2856;22;626103319;2856;183;3589;3593;9.33;0.57;231.55;3.54;733;22;1220.00;4
2860;22;626103331;2860;189;3590;3593;9.29;0.57;231.60;3.54;730;22;1221.00;3
2866;22;626103343;2866;192;3590;3593;9.22;0.56;231.83;3.54;724;22;1222.00;3
2869;22;626103354;2869;197;3590;3593;9.13;0.56;231.76;3.54;721;22;1223.00;3
2875;22;626103365;2875;211;3631;3663;9.03;0.55;231.91;3.50;756;22;1224.00;32
2882;22;626103382;2882;211;3632;3664;8.96;0.55;232.03;3.50;750;22;1225.00;32
2888;22;626103395;2888;210;3636;3664;8.96;0.55;232.07;3.50;748;22;1226.00;28
2892;22;626103407;2892;215;3638;3664;8.96;0.55;232.10;3.51;746;22;1227.00;26
2896;22;626103418;2896;221;3642;3666;9.01;0.55;232.28;3.51;746;22;1228.00;24
2897;22;626103432;2897;226;3643;3666;9.11;0.56;232.22;3.51;746;22;1229.00;23
2901;22;626103445;2901;233;3647;3666;9.09;0.56;232.35;3.51;746;22;1230.00;19
2907;22;626103456;2907;239;3649;3666;9.00;0.55;232.45;3.51;742;22;1231.00;17
2910;22;626103467;2910;244;3653;3667;8.90;0.54;232.31;3.52;743;22;1232.00;14
2911;22;626103478;2911;253;3659;3668;8.76;0.54;232.39;3.53;748;22;1233.00;9
2915;23;626103488;2915;256;3663;3668;8.62;0.53;232.50;3.54;748;23;1234.00;5
2917;23;626103514;2917;270;3666;3672;8.44;0.52;232.60;3.54;749;23;1235.00;6
2921;24;626103527;2921;279;3668;3672;8.34;0.51;232.69;3.54;747;24;1236.00;4
2923;24;626103551;2923;276;3669;3672;8.26;0.51;232.81;3.54;746;24;1237.00;3
2927;24;626103564;2927;276;3670;3672;8.19;0.50;232.65;3.54;743;24;1238.00;2
2930;24;626103576;2930;275;3677;3678;8.13;0.50;232.81;3.54;747;24;1239.00;1
2933;24;626103590;2933;273;3677;3678;8.13;0.50;232.73;3.54;744;24;1240.00;1
2934;24;626103603;2934;272;3677;3678;8.18;0.50;232.68;3.54;743;24;1241.00;1
2936;24;626103614;2936;274;3680;3681;8.28;0.50;232.65;3.54;744;24;1242.00;1
2936;24;626103627;2936;270;3680;3681;8.29;0.51;232.65;3.54;744;24;1243.00;1
2940;24;626103639;2940;275;3680;3681;8.27;0.50;233.01;3.54;740;24;1244.00;1
2942;24;626103650;2942;278;3681;3682;8.26;0.50;232.92;3.54;739;24;1245.00;1
2944;25;626103662;2944;267;3682;3683;8.26;0.50;232.89;3.54;738;25;1246.00;1
2944;25;626103691;2944;257;3682;3683;8.32;0.51;232.89;3.54;738;25;1247.00;1
2948;25;626103703;2948;254;3695;3696;8.42;0.51;232.97;3.53;747;25;1248.00;1
2953;25;626103723;2953;245;3695;3696;8.41;0.51;233.23;3.53;742;25;1249.00;1
2955;25;626103734;2955;245;3695;3696;8.41;0.51;233.21;3.53;740;25;1250.00;1
2958;25;626103746;2958;231;3696;3697;8.43;0.51;233.31;3.53;738;25;1251.00;1
2962;25;626103759;2962;234;3696;3697;8.44;0.51;233.29;3.53;734;25;1252.00;1
2964;25;626103771;2964;232;3699;3701;8.46;0.52;233.32;3.52;735;25;1253.00;2
2968;25;626103783;2968;236;3699;3701;8.45;0.51;233.41;3.52;731;25;1254.00;2
2970;25;626103801;2970;238;3704;3705;8.43;0.51;233.32;3.52;734;25;1255.00;1
2973;25;626103815;2973;239;3704;3705;8.43;0.51;233.22;3.52;731;25;1256.00;1
2976;25;626103826;2976;235;3704;3705;8.44;0.51;233.26;3.52;728;25;1257.00;1
2981;25;626103839;2981;229;3704;3705;8.46;0.51;233.17;3.52;723;25;1258.00;1
2983;25;626103851;2983;232;3704;3705;8.51;0.52;233.07;3.52;721;25;1259.00;1
2984;25;626103863;2984;233;3729;3739;8.49;0.52;233.06;3.50;745;25;1260.00;10
2985;25;626103878;2985;226;3729;3739;8.58;0.52;233.03;3.50;744;25;1261.00;10
2986;25;626103890;2986;226;3730;3739;8.61;0.53;232.97;3.50;744;25;1262.00;9
2987;25;626103901;2987;226;3730;3739;8.62;0.53;232.98;3.50;743;25;1263.00;9
2988;25;626103912;2988;230;3732;3739;8.63;0.53;232.91;3.50;744;25;1264.00;7
2991;25;626103923;2991;235;3732;3739;8.56;0.52;232.82;3.50;741;25;1265.00;7
2992;25;626103935;2992;241;3733;3740;8.55;0.52;232.80;3.50;741;25;1266.00;7
2995;25;626103945;2995;240;3734;3740;8.46;0.52;232.69;3.50;739;25;1267.00;6
2996;25;626103956;2996;246;3739;3746;8.38;0.51;232.69;3.51;743;25;1268.00;7
2999;25;626103968;2999;253;3740;3747;8.34;0.51;232.63;3.51;741;25;1269.00;7
3001;25;626103979;3001;255;3742;3747;8.26;0.51;232.62;3.51;741;25;1270.00;5
3002;25;626103987;3002;261;3742;3747;8.18;0.50;232.61;3.51;740;25;1271.00;5
3003;25;626104003;3003;263;3745;3751;8.15;0.50;232.54;3.51;742;25;1272.00;6
3004;25;626104012;3004;269;3746;3751;8.00;0.49;232.53;3.51;742;25;1273.00;5
3005;25;626104022;3005;273;3746;3751;7.92;0.48;232.48;3.51;741;25;1274.00;5
3007;25;626104030;3007;281;3747;3752;7.78;0.48;232.37;3.51;740;25;1275.00;5
3008;25;626104044;3008;289;3750;3756;7.68;0.47;232.39;3.50;742;25;1276.00;6
3009;25;626104053;3009;292;3750;3756;7.63;0.47;232.40;3.50;741;25;1277.00;6
3011;25;626104069;3011;293;3752;3759;7.58;0.46;232.55;3.50;741;25;1278.00;7
3011;25;626104078;3011;295;3752;3759;7.47;0.46;232.55;3.50;741;25;1279.00;7
3012;25;626104086;3012;294;3753;3759;7.39;0.45;232.56;3.50;741;25;1280.00;6
3012;25;626104095;3012;290;3753;3759;7.34;0.45;232.56;3.50;741;25;1281.00;6
3013;25;626104103;3013;293;3756;3763;7.36;0.45;232.53;3.50;743;25;1282.00;7
3015;25;626104112;3015;275;3757;3763;7.35;0.45;232.50;3.51;742;25;1283.00;6
3018;25;626104121;3018;259;3758;3763;7.44;0.45;232.49;3.51;740;25;1284.00;5
3019;25;626104130;3019;252;3758;3763;7.52;0.46;232.50;3.51;739;25;1285.00;5
3020;25;626104138;3020;241;3758;3764;7.62;0.46;232.49;3.51;738;25;1286.00;6
3024;25;626104148;3024;237;3759;3765;7.74;0.47;232.42;3.50;735;25;1287.00;6
3026;25;626104157;3026;229;3760;3765;7.82;0.47;232.38;3.51;734;25;1288.00;5
3029;25;626104166;3029;217;3761;3766;7.94;0.48;232.34;3.51;732;25;1289.00;5
3031;25;626104178;3031;206;3761;3766;8.03;0.49;232.38;3.51;730;25;1290.00;5
3033;25;626104188;3033;203;3761;3766;8.13;0.49;232.37;3.51;728;25;1291.00;5
3033;25;626104197;3033;189;3761;3766;8.21;0.50;232.37;3.51;728;25;1292.00;5
3037;25;626104212;3037;181;3761;3766;8.26;0.50;232.47;3.51;724;25;1293.00;5
3039;25;626104222;3039;169;3762;3766;8.36;0.51;232.50;3.52;723;25;1294.00;4
3040;25;626104237;3040;160;3762;3766;8.53;0.52;232.47;3.52;722;25;1295.00;4
3041;25;626104247;3041;166;3824;3893;8.68;0.54;232.46;3.47;783;25;1296.00;69
3044;25;626104270;3044;161;3824;3894;8.78;0.54;232.40;3.47;780;25;1297.00;70
3045;25;626104281;3045;153;3831;3894;8.94;0.55;232.37;3.46;786;25;1298.00;63
3047;25;626104291;3047;156;3834;3894;9.02;0.56;232.34;3.46;787;25;1299.00;60
3048;25;626104302;3048;144;3838;3894;9.16;0.56;232.27;3.46;790;25;1300.00;56
3050;25;626104316;3050;141;3841;3894;9.25;0.57;232.22;3.47;791;25;1301.00;53
3050;25;626104326;3050;140;3844;3894;9.40;0.58;232.22;3.47;794;25;1302.00;50
3053;25;626104337;3053;137;3846;3894;9.56;0.59;232.17;3.47;793;25;1303.00;48
3054;25;626104348;3054;141;3850;3895;9.72;0.60;232.12;3.47;796;25;1304.00;45
3057;25;626104359;3057;143;3852;3897;9.78;0.60;232.12;3.47;795;25;1305.00;45
3060;25;626104371;3060;139;3857;3897;9.89;0.61;232.19;3.48;797;25;1306.00;40
3062;25;626104382;3062;145;3859;3898;9.88;0.61;232.10;3.49;797;25;1307.00;39
3064;25;626104398;3064;141;3864;3898;9.92;0.61;232.28;3.50;800;25;1308.00;34
3069;25;626104409;3069;142;3868;3898;9.85;0.60;232.17;3.51;799;25;1309.00;30
3072;25;626104421;3072;143;3873;3898;9.85;0.60;232.27;3.52;801;25;1310.00;25
3076;25;626104432;3076;154;3879;3902;9.79;0.60;232.30;3.53;803;25;1311.00;23
3079;25;626104445;3079;154;3882;3902;9.69;0.59;232.32;3.55;803;25;1312.00;20
3081;25;626104457;3081;158;3884;3902;9.63;0.59;232.45;3.56;803;25;1313.00;18
3087;25;626104469;3087;160;3888;3905;9.55;0.58;232.57;3.56;801;25;1314.00;17
3088;25;626104491;3088;165;3890;3905;9.49;0.58;232.62;3.57;802;25;1315.00;15
3091;25;626104503;3091;170;3893;3905;9.41;0.57;232.62;3.57;802;25;1316.00;12
3093;25;626104520;3093;175;3897;3909;9.27;0.56;232.64;3.58;804;25;1317.00;12
3095;25;626104533;3095;179;3899;3910;9.28;0.56;232.71;3.58;804;25;1318.00;11
3098;25;626104544;3098;180;3900;3910;9.27;0.56;232.86;3.58;802;25;1319.00;10
3100;25;626104558;3100;186;3906;3915;9.36;0.57;232.96;3.59;806;25;1320.00;9
3104;25;626104571;3104;188;3906;3915;9.34;0.57;233.10;3.59;802;25;1321.00;9
3108;25;626104583;3108;189;3906;3915;9.31;0.56;233.14;3.59;798;25;1322.00;9
3109;25;626104595;3109;191;3908;3916;9.28;0.56;233.22;3.60;799;25;1323.00;8
3112;25;626104607;3112;194;3908;3916;9.27;0.56;233.38;3.60;796;25;1324.00;8
3115;25;626104619;3115;199;3914;3922;9.27;0.56;233.45;3.60;799;25;1325.00;8
3119;25;626104631;3119;197;3914;3922;9.22;0.56;233.68;3.60;795;25;1326.00;8
3121;25;626104644;3121;201;3915;3923;9.22;0.56;233.81;3.60;794;25;1327.00;8
3123;25;626104656;3123;201;3916;3923;9.22;0.56;233.85;3.61;793;25;1328.00;7
3126;25;626104667;3126;200;3918;3923;9.23;0.56;234.01;3.62;792;25;1329.00;5
3128;25;626104679;3128;204;3919;3923;9.26;0.56;234.06;3.63;791;25;1330.00;4
3131;25;626104696;3131;201;3920;3923;9.27;0.56;234.07;3.64;789;25;1331.00;3
3135;25;626104708;3135;205;3930;3935;9.32;0.57;234.10;3.63;795;25;1332.00;5
3139;25;626104721;3139;209;3932;3935;9.32;0.57;234.12;3.63;793;25;1333.00;3
3141;25;626104733;3141;213;3934;3935;9.35;0.57;234.16;3.63;793;25;1334.00;1
3143;25;626104745;3143;216;3935;3935;9.36;0.57;234.17;3.63;792;25;1335.00;0
3145;25;626104756;3145;213;3935;3935;9.29;0.56;234.23;3.63;790;25;1336.00;0
3146;25;626104768;3146;212;3935;3935;9.25;0.56;234.24;3.63;789;25;1337.00;0
3148;25;626104780;3148;220;3939;3939;9.17;0.56;234.29;3.63;791;25;1338.00;0
3154;25;626104792;3154;219;3939;3939;9.10;0.55;234.56;3.63;785;25;1339.00;0
3155;25;626104804;3155;221;3942;3943;9.07;0.55;234.57;3.63;787;25;1340.00;1
3158;25;626104821;3158;219;3944;3944;9.05;0.55;234.53;3.63;786;25;1341.00;0
3160;25;626104832;3160;218;3944;3944;8.98;0.55;234.61;3.63;784;25;1342.00;0
3162;25;626104843;3162;213;3944;3944;8.89;0.54;234.59;3.63;782;25;1343.00;0
3166;25;626104854;3166;222;3956;3957;8.78;0.54;234.69;3.62;790;25;1344.00;1
3167;25;626104866;3167;220;3956;3957;8.84;0.54;234.62;3.62;789;25;1345.00;1
3171;25;626104877;3171;221;3957;3957;8.86;0.54;234.77;3.62;786;25;1346.00;0
3173;25;626104889;3173;217;3958;3958;8.96;0.55;234.74;3.62;785;25;1347.00;0
3176;25;626104900;3176;220;3959;3959;9.01;0.55;234.87;3.61;783;25;1348.00;0
3177;25;626104917;3177;226;3959;3959;9.09;0.56;234.88;3.61;782;25;1349.00;0
3180;25;626104930;3180;224;3962;3968;9.12;0.56;234.96;3.61;782;25;1350.00;6
3183;25;626104943;3183;227;3963;3968;9.06;0.55;234.98;3.61;780;25;1351.00;5
3186;25;626104954;3186;228;3964;3968;9.01;0.55;235.06;3.61;778;25;1352.00;4
3188;25;626104965;3188;227;3964;3968;8.96;0.55;235.11;3.61;776;25;1353.00;4
3190;25;626104983;3190;224;3969;3974;8.89;0.54;235.11;3.61;779;25;1354.00;5
3195;25;626105001;3195;226;3969;3974;8.78;0.54;235.21;3.61;774;25;1355.00;5
3197;25;626105018;3197;229;3970;3974;8.74;0.54;235.13;3.61;773;25;1356.00;4
3202;25;626105032;3202;233;3970;3974;8.64;0.53;235.18;3.61;768;25;1357.00;4
3206;25;626105048;3206;236;3975;3978;8.54;0.52;235.26;3.61;769;25;1358.00;3
3211;25;626105062;3211;237;3977;3979;8.47;0.52;235.36;3.61;766;25;1359.00;2
3218;25;626105078;3218;223;3978;3979;8.39;0.51;235.60;3.61;760;25;1360.00;1
3223;25;626105091;3223;219;3979;3980;8.34;0.51;235.58;3.61;756;25;1361.00;1
3226;25;626105102;3226;222;3979;3980;8.29;0.51;235.46;3.61;753;25;1362.00;1
3228;25;626105112;3228;205;3979;3980;8.31;0.51;235.53;3.61;751;25;1363.00;1
3232;25;626105122;3232;205;3979;3980;8.32;0.51;235.76;3.61;747;25;1364.00;1
3237;25;626105132;3237;203;3979;3980;8.37;0.51;235.92;3.61;742;25;1365.00;1
3240;25;626105142;3240;204;3979;3980;8.39;0.51;235.95;3.61;739;25;1366.00;1
3245;25;626105152;3245;197;3979;3980;8.46;0.52;236.00;3.61;734;25;1367.00;1
3248;25;626105163;3248;194;4022;4050;8.64;0.53;236.11;3.57;774;25;1368.00;28
3249;25;626105179;3249;188;4027;4051;8.76;0.54;236.10;3.57;778;25;1369.00;24
3254;25;626105190;3254;186;4033;4051;8.87;0.54;236.16;3.56;779;25;1370.00;18
3256;25;626105201;3256;191;4037;4051;9.00;0.55;236.15;3.56;781;25;1371.00;14
3262;25;626105211;3262;187;4042;4051;9.08;0.55;236.17;3.56;780;25;1372.00;9
3265;25;626105222;3265;186;4045;4051;9.10;0.56;236.18;3.56;780;25;1373.00;6
3273;25;626105233;3273;196;4046;4051;9.03;0.55;236.16;3.56;773;25;1374.00;5
3273;25;626105243;3273;198;4047;4051;9.04;0.55;236.16;3.57;774;25;1375.00;4
3279;25;626105254;3279;194;4049;4052;8.94;0.54;236.32;3.57;770;25;1376.00;3
3284;25;626105265;3284;191;4050;4053;8.96;0.55;236.52;3.57;766;25;1377.00;3
3289;25;626105276;3289;193;4051;4053;8.90;0.54;236.40;3.57;762;25;1378.00;2
3295;25;626105286;3295;204;4054;4057;8.82;0.54;236.65;3.56;759;25;1379.00;3
3299;25;626105299;3299;204;4054;4057;8.74;0.53;236.60;3.56;755;25;1380.00;3
3303;25;626105310;3303;211;4054;4057;8.72;0.53;236.66;3.56;751;25;1381.00;3
3306;25;626105320;3306;212;4054;4057;8.62;0.53;236.79;3.56;748;25;1382.00;3
3308;25;626105331;3308;214;4059;4063;8.61;0.53;236.81;3.56;751;25;1383.00;4
3314;25;626105341;3314;221;4060;4063;8.55;0.52;237.00;3.56;746;25;1384.00;3
3319;25;626105352;3319;227;4061;4063;8.53;0.52;236.92;3.56;742;25;1385.00;2
3322;25;626105363;3322;234;4063;4066;8.66;0.53;237.00;3.56;741;25;1386.00;3
3330;25;626105372;3330;234;4065;4066;8.57;0.52;237.18;3.57;735;25;1387.00;1
3336;25;626105383;3336;233;4066;4066;8.45;0.52;237.35;3.57;730;25;1388.00;0
3338;25;626105395;3338;234;4066;4067;8.43;0.51;237.29;3.57;728;25;1389.00;1
3346;25;626105405;3346;234;4068;4068;8.33;0.51;237.40;3.57;722;25;1390.00;0
3352;25;626105416;3352;241;4068;4068;8.25;0.50;237.42;3.57;716;25;1391.00;0
3354;25;626105434;3354;244;4081;4081;8.31;0.51;237.41;3.56;727;25;1392.00;0
3357;25;626105445;3357;248;4081;4081;8.28;0.51;237.39;3.56;724;25;1393.00;0
3360;25;626105458;3360;249;4081;4081;8.23;0.50;237.36;3.56;721;25;1394.00;0
3361;25;626105470;3361;254;4083;4083;8.27;0.51;237.36;3.56;722;25;1395.00;0
3365;25;626105481;3365;253;4083;4083;8.25;0.50;237.50;3.56;718;25;1396.00;0
3368;25;626105501;3368;260;4086;4087;8.18;0.50;237.50;3.56;718;25;1397.00;1
3371;25;626105514;3371;269;4086;4087;8.07;0.49;237.50;3.56;715;25;1398.00;1
3372;25;626105526;3372;274;4091;4091;8.03;0.49;237.52;3.55;719;25;1399.00;0
3375;25;626105546;3375;286;4091;4091;7.89;0.48;237.45;3.55;716;25;1400.00;0
3376;25;626105564;3376;292;4091;4091;7.81;0.48;237.39;3.55;715;25;1401.00;0
3378;25;626105575;3378;294;4091;4091;7.76;0.47;237.51;3.55;713;25;1402.00;0
3381;25;626105586;3381;301;4091;4091;7.71;0.47;237.63;3.55;710;25;1403.00;0
3384;25;626105597;3384;305;4102;4103;7.78;0.47;237.67;3.54;718;25;1404.00;1
3387;25;626105608;3387;313;4102;4103;7.64;0.47;237.75;3.54;715;25;1405.00;1
3391;25;626105619;3391;318;4103;4103;7.58;0.46;237.74;3.54;712;25;1406.00;0
3392;25;626105630;3392;312;4103;4103;7.55;0.46;237.78;3.54;711;25;1407.00;0
3395;25;626105641;3395;309;4103;4103;7.56;0.46;237.86;3.54;708;25;1408.00;0
3398;25;626105651;3398;306;4103;4103;7.59;0.46;237.92;3.54;705;25;1409.00;0
3403;25;626105664;3403;307;4104;4104;7.61;0.46;237.99;3.54;701;25;1410.00;0
3408;26;626105675;3408;300;4104;4104;7.62;0.46;237.99;3.54;696;26;1411.00;0
3410;26;626105698;3410;303;4109;4110;7.67;0.47;237.93;3.54;699;26;1412.00;1
3413;26;626105709;3413;299;4110;4111;7.68;0.47;237.80;3.54;697;26;1413.00;1
3414;26;626105721;3414;306;4111;4111;7.74;0.47;237.76;3.54;697;26;1414.00;0
3415;26;626105731;3415;310;4111;4111;7.74;0.47;237.73;3.54;696;26;1415.00;0
3417;26;626105742;3417;295;4115;4115;7.80;0.47;237.67;3.54;698;26;1416.00;0
3421;26;626105753;3421;285;4115;4115;7.80;0.47;237.52;3.54;694;26;1417.00;0
3421;26;626105764;3421;277;4115;4115;7.83;0.48;237.52;3.54;694;26;1418.00;0
3425;26;626105775;3425;269;4116;4116;7.85;0.48;237.51;3.53;691;26;1419.00;0
3426;26;626105786;3426;273;4120;4120;7.89;0.48;237.47;3.53;694;26;1420.00;0
3427;26;626105797;3427;264;4120;4120;7.95;0.48;237.50;3.53;693;26;1421.00;0
3427;26;626105809;3427;265;4122;4123;8.06;0.49;237.50;3.53;695;26;1422.00;1
3428;26;626105820;3428;254;4122;4123;8.11;0.49;237.48;3.53;694;26;1423.00;1
3430;26;626105831;3430;246;4123;4123;8.16;0.50;237.41;3.53;693;26;1424.00;0
3432;26;626105842;3432;242;4123;4123;8.23;0.50;237.36;3.53;691;26;1425.00;0
3433;26;626105852;3433;246;4126;4127;8.29;0.51;237.34;3.53;693;26;1426.00;1
3435;26;626105863;3435;244;4126;4127;8.27;0.50;237.33;3.53;691;26;1427.00;1
3437;26;626105874;3437;247;4127;4127;8.31;0.51;237.25;3.53;690;26;1428.00;0
3439;26;626105885;3439;246;4127;4127;8.34;0.51;237.23;3.53;688;26;1429.00;0
3441;26;626105895;3441;245;4128;4128;8.38;0.51;237.24;3.53;687;26;1430.00;0
3441;26;626105906;3441;245;4129;4129;8.40;0.51;237.24;3.53;688;26;1431.00;0
3442;26;626105916;3442;247;4129;4129;8.38;0.51;237.23;3.53;687;26;1432.00;0
3444;27;626105927;3444;246;4130;4130;8.36;0.51;237.21;3.53;686;27;1433.00;0
3445;27;626105944;3445;246;4130;4130;8.31;0.51;237.18;3.53;685;27;1434.00;0
3446;27;626105958;3446;235;4130;4130;8.31;0.51;237.19;3.53;684;27;1435.00;0
3447;27;626105970;3447;224;4130;4130;8.39;0.51;237.19;3.53;683;27;1436.00;0
3448;27;626105980;3448;218;4130;4130;8.41;0.51;237.15;3.53;682;27;1437.00;0
3449;27;626105990;3449;207;4130;4130;8.44;0.52;237.14;3.53;681;27;1438.00;0
3450;28;626106001;3450;206;4130;4130;8.52;0.52;237.10;3.53;680;28;1439.00;0
3452;28;626106036;3452;260;4258;4360;8.33;0.52;237.08;3.42;806;28;1440.00;102
3455;28;626106073;3455;241;4259;4361;8.49;0.53;237.08;3.42;804;28;1441.00;102
3456;28;626106091;3456;221;4267;4361;8.68;0.54;237.09;3.42;811;28;1442.00;94
3459;28;626106103;3459;215;4270;4361;8.72;0.54;236.97;3.42;811;28;1443.00;91
3459;28;626106113;3459;211;4276;4361;8.80;0.55;236.97;3.42;817;28;1444.00;85
3462;28;626106129;3462;203;4281;4361;8.78;0.55;236.94;3.42;819;28;1445.00;80
3463;28;626106145;3463;211;4284;4361;8.82;0.55;236.90;3.42;821;28;1446.00;77
3464;28;626106160;3464;215;4290;4361;8.89;0.55;236.89;3.43;826;28;1447.00;71
3466;28;626106171;3466;219;4293;4362;8.94;0.55;236.84;3.43;827;28;1448.00;69
3467;28;626106181;3467;218;4299;4363;9.04;0.56;236.86;3.44;832;28;1449.00;64
3467;28;626106192;3467;220;4304;4363;9.08;0.56;236.86;3.45;837;28;1450.00;59
3469;28;626106202;3469;221;4307;4364;9.05;0.56;236.78;3.45;838;28;1451.00;57
3472;28;626106212;3472;229;4315;4364;9.02;0.56;236.77;3.47;843;28;1452.00;49
3476;28;626106222;3476;227;4318;4364;8.92;0.55;236.89;3.47;842;28;1453.00;46
3478;28;626106233;3478;226;4319;4364;8.87;0.55;236.91;3.47;841;28;1454.00;45
3479;28;626106243;3479;227;4323;4368;8.90;0.55;236.90;3.48;844;28;1455.00;45
3480;28;626106259;3480;226;4324;4368;8.90;0.55;236.96;3.48;844;28;1456.00;44
3486;28;626106270;3486;229;4326;4368;8.86;0.54;236.95;3.49;840;28;1457.00;42
3489;28;626106281;3489;234;4329;4371;8.95;0.55;236.95;3.49;840;28;1458.00;42
3490;28;626106292;3490;227;4331;4371;9.04;0.55;236.90;3.50;841;28;1459.00;40
3493;28;626106302;3493;221;4331;4371;9.02;0.55;236.96;3.50;838;28;1460.00;40
3497;28;626106313;3497;216;4334;4375;9.04;0.55;236.98;3.50;837;28;1461.00;41
3501;28;626106323;3501;207;4337;4376;9.06;0.55;237.06;3.51;836;28;1462.00;39
3505;28;626106334;3505;200;4338;4376;9.05;0.55;237.05;3.51;833;28;1463.00;38
3507;28;626106344;3507;193;4340;4380;9.04;0.55;237.06;3.51;833;28;1464.00;40
3510;28;626106361;3510;193;4343;4380;9.07;0.55;237.20;3.52;833;28;1465.00;37
3514;28;626106372;3514;188;4343;4380;9.11;0.56;237.24;3.52;829;28;1466.00;37
3516;28;626106383;3516;180;4344;4381;9.14;0.56;237.26;3.52;828;28;1467.00;37
3517;28;626106393;3517;170;4346;4381;9.24;0.56;237.32;3.53;829;28;1468.00;35
3519;28;626106404;3519;167;4348;4387;9.31;0.57;237.34;3.53;829;28;1469.00;39
3524;28;626106416;3524;163;4348;4387;9.28;0.56;237.44;3.53;824;28;1470.00;39
3526;28;626106427;3526;159;4349;4388;9.33;0.57;237.54;3.53;823;28;1471.00;39
3529;28;626106439;3529;153;4350;4388;9.34;0.57;237.61;3.54;821;28;1472.00;38
3532;28;626106455;3532;149;4351;4388;9.34;0.57;237.61;3.55;819;28;1473.00;37
3533;28;626106472;3533;145;4353;4388;9.41;0.57;237.68;3.56;820;28;1474.00;35
3536;28;626106484;3536;147;4353;4388;9.47;0.57;237.81;3.56;817;28;1475.00;35
3539;28;626106495;3539;148;4365;4400;9.55;0.58;237.78;3.56;826;28;1476.00;35
3542;28;626106508;3542;148;4366;4400;9.63;0.58;237.96;3.57;824;28;1477.00;34
3544;28;626106519;3544;150;4367;4400;9.78;0.59;237.94;3.58;823;28;1478.00;33
3549;28;626106533;3549;153;4370;4400;9.86;0.60;238.10;3.58;821;28;1479.00;30
3552;28;626106546;3552;154;4371;4400;9.92;0.60;238.16;3.59;819;28;1480.00;29
3553;28;626106557;3553;150;4372;4400;10.01;0.61;238.18;3.59;819;28;1481.00;28
3554;28;626106570;3554;156;4377;4404;9.99;0.61;238.22;3.60;823;28;1482.00;27
3558;28;626106582;3558;159;4377;4404;9.97;0.60;238.26;3.60;819;28;1483.00;27
3559;28;626106601;3559;160;4381;4408;10.01;0.61;238.33;3.61;822;28;1484.00;27
3562;28;626106613;3562;167;4384;4410;9.99;0.61;238.43;3.61;822;28;1485.00;26
3564;29;626106625;3564;169;4384;4410;10.01;0.61;238.44;3.61;820;29;1486.00;26
3567;29;626106649;3567;168;4385;4410;9.98;0.61;238.50;3.62;818;29;1487.00;25
3568;29;626106660;3568;177;4395;4423;10.00;0.61;238.54;3.62;827;29;1488.00;28
3572;29;626106677;3572;174;4395;4423;9.99;0.61;238.56;3.62;823;29;1489.00;28
3574;29;626106694;3574;176;4397;4423;9.99;0.61;238.53;3.64;823;29;1490.00;26
3576;29;626106716;3576;175;4398;4424;10.00;0.61;238.60;3.64;822;29;1491.00;26
3581;29;626106727;3581;185;4398;4425;9.98;0.61;238.63;3.64;817;29;1492.00;27
3585;29;626106739;3585;188;4400;4425;9.94;0.60;238.62;3.66;815;29;1493.00;25
3587;29;626106750;3587;188;4403;4428;9.93;0.61;238.62;3.67;816;29;1494.00;25
3590;29;626106762;3590;192;4404;4428;9.92;0.60;238.64;3.68;814;29;1495.00;24
3594;29;626106773;3594;197;4408;4428;9.89;0.60;238.66;3.71;814;29;1496.00;20
3594;29;626106784;3594;199;4408;4428;9.93;0.61;238.66;3.71;814;29;1497.00;20
3601;29;626106796;3601;200;4414;4434;10.01;0.61;238.67;3.72;813;29;1498.00;20
3603;29;626106808;3603;205;4415;4434;9.96;0.61;238.74;3.74;812;29;1499.00;19
3604;29;626106821;3604;208;4420;4453;9.89;0.60;238.73;3.74;816;29;1500.00;33
3609;29;626106841;3609;208;4421;4453;9.79;0.59;238.82;3.75;812;29;1501.00;32
3611;29;626106852;3611;216;4427;4457;9.68;0.59;238.87;3.76;816;29;1502.00;30
3613;29;626106862;3613;220;4430;4458;9.60;0.58;238.84;3.77;817;29;1503.00;28
3615;29;626106873;3615;230;4431;4458;9.51;0.58;238.93;3.77;816;29;1504.00;27
3616;29;626106883;3616;234;4433;4459;9.38;0.57;238.99;3.77;817;29;1505.00;26
3617;29;626106893;3617;243;4435;4459;9.30;0.57;239.07;3.80;818;29;1506.00;24
3620;29;626106904;3620;256;4435;4459;9.23;0.56;239.20;3.80;815;29;1507.00;24
3623;29;626106914;3623;265;4438;4459;9.15;0.56;239.21;3.81;815;29;1508.00;21
3624;29;626106930;3624;261;4441;4459;9.14;0.56;239.29;3.85;817;29;1509.00;18
3628;29;626106941;3628;259;4441;4459;9.18;0.56;239.27;3.85;813;29;1510.00;18
3631;29;626106952;3631;258;4444;4459;9.13;0.55;239.33;3.87;813;29;1511.00;15
3633;29;626106963;3633;263;4481;4529;9.07;0.55;239.40;3.84;848;29;1512.00;48
3635;29;626106984;3635;259;4485;4530;9.04;0.55;239.36;3.85;850;29;1513.00;45
3637;29;626107011;3637;255;4492;4530;9.06;0.55;239.45;3.85;855;29;1514.00;38
3640;29;626107029;3640;256;4492;4530;9.07;0.55;239.40;3.85;852;29;1515.00;38
3642;29;626107044;3642;252;4497;4530;9.08;0.55;239.60;3.85;855;29;1516.00;33
3643;29;626107060;3643;257;4498;4530;9.11;0.56;239.59;3.85;855;29;1517.00;32
3646;29;626107076;3646;255;4501;4530;9.09;0.55;239.57;3.85;855;29;1518.00;29
3648;29;626107090;3648;258;4502;4530;9.10;0.56;239.65;3.85;854;29;1519.00;28
3651;29;626107103;3651;258;4503;4531;9.08;0.55;239.56;3.85;852;29;1520.00;28
3658;29;626107114;3658;262;4505;4532;9.03;0.55;239.49;3.85;847;29;1521.00;27
3659;29;626107126;3659;266;4507;4532;8.93;0.54;239.46;3.86;848;29;1522.00;25
3663;29;626107138;3663;266;4511;4536;8.84;0.54;239.42;3.86;848;29;1523.00;25
3666;29;626107150;3666;270;4514;4536;8.80;0.54;239.50;3.87;848;29;1524.00;22
3669;29;626107162;3669;278;4516;4536;8.68;0.53;239.45;3.87;847;29;1525.00;20
3674;29;626107172;3674;278;4517;4536;8.51;0.52;239.47;3.87;843;29;1526.00;19
3674;29;626107184;3674;284;4522;4542;8.44;0.52;239.47;3.87;848;29;1527.00;20
3679;29;626107195;3679;291;4522;4542;8.20;0.50;239.61;3.87;843;29;1528.00;20
3683;29;626107206;3683;296;4522;4542;7.97;0.49;239.83;3.87;839;29;1529.00;20
3684;29;626107225;3684;280;4525;4548;7.92;0.48;239.79;3.87;841;29;1530.00;23
3689;29;626107237;3689;279;4525;4548;7.85;0.48;239.82;3.87;836;29;1531.00;23
3693;29;626107248;3693;274;4525;4548;7.72;0.47;239.96;3.87;832;29;1532.00;23
3694;29;626107259;3694;270;4528;4549;7.70;0.47;240.01;3.88;834;29;1533.00;21
3698;29;626107270;3698;266;4529;4550;7.75;0.47;240.00;3.88;831;29;1534.00;21
3703;29;626107282;3703;266;4529;4550;7.75;0.47;240.16;3.88;826;29;1535.00;21
3708;29;626107292;3708;262;4541;4563;7.72;0.47;240.02;3.88;833;29;1536.00;22
3711;29;626107304;3711;252;4542;4563;7.82;0.48;240.11;3.88;831;29;1537.00;21
3715;29;626107315;3715;245;4543;4563;7.93;0.49;240.35;3.89;828;29;1538.00;20
3718;29;626107326;3718;246;4546;4564;8.09;0.50;240.60;3.90;828;29;1539.00;18
3721;29;626107337;3721;241;4548;4564;8.18;0.50;240.70;3.91;827;29;1540.00;16
3726;29;626107347;3726;238;4551;4568;8.26;0.51;240.66;3.91;825;29;1541.00;17
3732;29;626107358;3732;232;4551;4568;8.21;0.50;241.02;3.91;819;29;1542.00;17
3737;29;626107370;3737;229;4556;4572;8.22;0.50;240.99;3.92;819;29;1543.00;16
3741;29;626107381;3741;233;4556;4572;8.27;0.51;241.18;3.92;815;29;1544.00;16
3744;29;626107391;3744;234;4556;4572;8.28;0.51;241.28;3.92;812;29;1545.00;16
3747;29;626107402;3747;238;4558;4572;8.25;0.50;241.22;3.93;811;29;1546.00;14
3753;29;626107412;3753;241;4558;4572;8.17;0.50;241.20;3.93;805;29;1547.00;14
3756;29;626107423;3756;243;4568;4584;8.25;0.51;241.28;3.93;812;29;1548.00;16
3759;29;626107434;3759;242;4570;4584;8.21;0.50;241.43;3.94;811;29;1549.00;14
3767;29;626107445;3767;251;4571;4584;8.07;0.49;241.57;3.94;804;29;1550.00;13
3768;29;626107457;3768;252;4572;4584;8.03;0.49;241.64;3.94;804;29;1551.00;12
3775;29;626107468;3775;259;4573;4584;7.94;0.49;241.71;3.95;798;29;1552.00;11
3779;29;626107479;3779;264;4573;4584;7.88;0.48;241.69;3.95;794;29;1553.00;11
3781;29;626107490;3781;270;4575;4585;7.82;0.48;241.70;3.96;794;29;1554.00;10
3785;29;626107500;3785;271;4576;4587;7.71;0.47;241.77;3.95;791;29;1555.00;11
3788;29;626107512;3788;271;4580;4593;7.67;0.47;241.82;3.95;792;29;1556.00;13
3790;29;626107523;3790;274;4582;4594;7.65;0.47;241.77;3.96;792;29;1557.00;12
3793;29;626107536;3793;284;4582;4594;7.52;0.46;241.82;3.96;789;29;1558.00;12
3797;29;626107547;3797;287;4584;4594;7.47;0.46;241.83;3.97;787;29;1559.00;10
3803;29;626107559;3803;288;4590;4599;7.41;0.45;241.67;3.97;787;29;1560.00;9
3807;29;626107570;3807;298;4591;4599;7.36;0.45;241.65;3.97;784;29;1561.00;8
3814;29;626107580;3814;300;4591;4599;7.24;0.44;241.54;3.97;777;29;1562.00;8
3815;29;626107591;3815;304;4593;4600;7.19;0.44;241.57;3.98;778;29;1563.00;7
3817;29;626107601;3817;311;4598;4604;7.19;0.44;241.52;3.98;781;29;1564.00;6
3820;29;626107612;3820;319;4598;4604;7.10;0.44;241.36;3.98;778;29;1565.00;6
3825;29;626107623;3825;320;4601;4607;7.10;0.43;241.33;3.98;776;29;1566.00;6
3828;29;626107633;3828;328;4601;4607;7.07;0.43;241.29;3.98;773;29;1567.00;6
3831;29;626107644;3831;330;4601;4607;6.99;0.43;241.23;3.98;770;29;1568.00;6
3832;29;626107654;3832;342;4603;4607;6.91;0.42;241.18;3.99;771;29;1569.00;4
3836;29;626107669;3836;350;4605;4611;6.86;0.42;241.20;3.98;769;29;1570.00;6
3839;29;626107680;3839;357;4605;4611;6.82;0.42;241.14;3.98;766;29;1571.00;6
3839;29;626107690;3839;365;4606;4611;6.83;0.42;241.14;3.99;767;29;1572.00;5
3842;29;626107698;3842;376;4607;4611;6.84;0.42;241.11;3.99;765;29;1573.00;4
3844;29;626107708;3844;380;4608;4612;6.77;0.41;241.09;3.99;764;29;1574.00;4
3846;29;626107718;3846;391;4611;4614;6.79;0.41;240.98;3.99;765;29;1575.00;3
3849;29;626107727;3849;393;4612;4614;6.71;0.41;241.02;3.99;763;29;1576.00;2
3852;29;626107736;3852;385;4614;4615;6.69;0.41;240.97;4.01;762;29;1577.00;1
3855;29;626107747;3855;376;4614;4615;6.62;0.40;240.94;4.01;759;29;1578.00;1
3857;29;626107757;3857;373;4614;4615;6.57;0.40;241.06;4.01;757;29;1579.00;1
3859;29;626107766;3859;377;4614;4615;6.65;0.41;241.08;4.01;755;29;1580.00;1
3862;29;626107776;3862;381;4614;4615;6.66;0.41;241.12;4.01;752;29;1581.00;1
3862;29;626107786;3862;378;4614;4615;6.71;0.41;241.12;4.01;752;29;1582.00;1
3865;29;626107796;3865;378;4614;4615;6.72;0.41;241.05;4.01;749;29;1583.00;1
3867;29;626107805;3867;401;4688;4742;7.04;0.44;241.09;3.95;821;29;1584.00;54
3870;29;626107826;3870;385;4690;4743;7.09;0.44;241.11;3.95;820;29;1585.00;53
3872;29;626107845;3872;367;4701;4743;7.29;0.45;241.03;3.95;829;29;1586.00;42
3875;29;626107865;3875;338;4705;4743;7.39;0.46;241.09;3.94;830;29;1587.00;38
3878;29;626107876;3878;315;4709;4743;7.48;0.46;241.03;3.94;831;29;1588.00;34
3879;29;626107887;3879;289;4713;4743;7.66;0.47;241.01;3.95;834;29;1589.00;30
3879;29;626107900;3879;275;4717;4743;7.82;0.48;241.01;3.95;838;29;1590.00;26
3879;29;626107911;3879;265;4718;4743;7.98;0.49;241.01;3.95;839;29;1591.00;25
3880;29;626107923;3880;255;4722;4744;8.19;0.50;241.01;3.95;842;29;1592.00;22
3881;29;626107935;3881;245;4724;4745;8.35;0.51;241.01;3.95;843;29;1593.00;21
3883;29;626107955;3883;245;4727;4745;8.48;0.52;241.00;3.96;844;29;1594.00;18
3884;29;626107969;3884;236;4728;4746;8.58;0.53;241.00;3.96;844;29;1595.00;18
3886;29;626107982;3886;234;4731;4746;8.65;0.53;240.96;3.96;845;29;1596.00;15
3888;29;626107994;3888;235;4734;4746;8.73;0.53;240.94;3.97;846;29;1597.00;12
3889;29;626108007;3889;241;4736;4746;8.83;0.54;240.98;3.97;847;29;1598.00;10
3891;29;626108019;3891;235;4740;4750;8.89;0.54;240.95;3.97;849;29;1599.00;10
3891;29;626108032;3891;233;4742;4750;8.91;0.55;240.95;3.98;851;29;1600.00;8
3893;29;626108048;3893;229;4742;4750;8.93;0.55;240.92;3.98;849;29;1601.00;8
3895;29;626108060;3895;227;4745;4753;8.99;0.55;240.93;3.98;850;29;1602.00;8
3898;29;626108073;3898;228;4746;4753;8.97;0.55;240.91;3.98;848;29;1603.00;7
3901;29;626108092;3901;228;4747;4753;9.01;0.55;240.88;3.98;846;29;1604.00;6
3902;29;626108104;3902;224;4751;4757;9.02;0.55;240.83;3.98;849;29;1605.00;6
3904;29;626108116;3904;226;4752;4758;9.09;0.55;240.83;3.98;848;29;1606.00;6
3906;29;626108129;3906;221;4752;4758;9.08;0.55;240.80;3.98;846;29;1607.00;6
3908;29;626108140;3908;220;4755;4762;9.02;0.55;240.87;3.98;847;29;1608.00;7
3910;29;626108158;3910;218;4755;4762;9.09;0.55;240.87;3.98;845;29;1609.00;7
3910;29;626108169;3910;222;4755;4762;9.15;0.56;240.87;3.98;845;29;1610.00;7
3911;29;626108180;3911;220;4756;4763;9.17;0.56;240.92;3.97;845;29;1611.00;7
3913;29;626108191;3913;222;4756;4763;9.19;0.56;240.91;3.97;843;29;1612.00;7
3918;29;626108208;3918;228;4760;4769;9.20;0.56;240.94;3.97;842;29;1613.00;9
3918;29;626108219;3918;231;4760;4769;9.23;0.56;240.94;3.97;842;29;1614.00;9
3920;29;626108235;3920;235;4761;4770;9.24;0.56;240.98;3.97;841;29;1615.00;9
3921;29;626108246;3921;239;4761;4770;9.19;0.56;241.07;3.97;840;29;1616.00;9
3923;29;626108257;3923;230;4761;4770;9.12;0.56;241.13;3.97;838;29;1617.00;9
3926;29;626108267;3926;228;4761;4770;9.09;0.55;241.16;3.97;835;29;1618.00;9
3930;29;626108278;3930;229;4761;4770;9.09;0.55;241.29;3.97;831;29;1619.00;9
3934;29;626108291;3934;232;4782;4806;9.06;0.55;241.37;3.95;848;29;1620.00;24
3936;29;626108305;3936;222;4782;4806;9.15;0.56;241.45;3.95;846;29;1621.00;24
3938;29;626108315;3938;213;4784;4806;9.21;0.56;241.50;3.95;846;29;1622.00;22
3942;29;626108326;3942;212;4784;4806;9.22;0.56;241.62;3.95;842;29;1623.00;22
3946;29;626108337;3946;213;4786;4806;9.23;0.56;241.68;3.98;840;29;1624.00;20
3952;29;626108348;3952;205;4786;4806;9.26;0.56;241.74;3.98;834;29;1625.00;20
3955;29;626108358;3955;206;4790;4810;9.34;0.57;241.68;3.98;835;29;1626.00;20
3959;29;626108369;3959;201;4790;4810;9.37;0.57;241.77;3.98;831;29;1627.00;20
3963;29;626108380;3963;199;4793;4814;9.41;0.57;241.87;3.97;830;29;1628.00;21
3967;29;626108392;3967;188;4796;4815;9.43;0.57;241.83;3.97;829;29;1629.00;19
3972;29;626108408;3972;178;4796;4815;9.44;0.58;241.87;3.97;824;29;1630.00;19
3976;29;626108418;3976;175;4797;4815;9.42;0.57;241.83;3.97;821;29;1631.00;18
3980;29;626108429;3980;165;4806;4828;9.39;0.57;241.83;3.97;826;29;1632.00;22
3982;29;626108440;3982;160;4806;4828;9.37;0.57;241.94;3.97;824;29;1633.00;22
3982;29;626108450;3982;151;4806;4828;9.46;0.58;241.94;3.97;824;29;1634.00;22
3985;29;626108460;3985;150;4809;4829;9.58;0.58;242.04;3.99;824;29;1635.00;20
3990;29;626108472;3990;139;4809;4830;9.61;0.58;242.08;3.99;819;29;1636.00;21
3993;29;626108484;3993;139;4809;4830;9.64;0.59;242.15;3.99;816;29;1637.00;21
4002;29;626108495;4002;136;4811;4833;9.67;0.59;242.32;3.98;809;29;1638.00;22
4005;29;626108506;4005;132;4812;4833;9.79;0.60;242.35;3.98;807;29;1639.00;21
4007;29;626108517;4007;127;4812;4833;9.86;0.60;242.44;3.98;805;29;1640.00;21
4011;29;626108527;4011;125;4813;4833;9.96;0.61;242.55;3.99;802;29;1641.00;20
4015;29;626108538;4015;125;4817;4839;10.07;0.61;242.56;3.98;802;29;1642.00;22
4018;29;626108549;4018;124;4818;4839;10.16;0.62;242.53;3.98;800;29;1643.00;21
4020;29;626108560;4020;126;4818;4839;10.19;0.62;242.63;3.98;798;29;1644.00;21
4024;29;626108570;4024;123;4819;4839;10.20;0.62;242.66;4.00;795;29;1645.00;20
4027;29;626108581;4027;121;4822;4843;10.18;0.62;242.64;3.99;795;29;1646.00;21
4031;29;626108593;4031;120;4824;4844;10.14;0.62;242.71;4.00;793;29;1647.00;20
4033;29;626108604;4033;124;4824;4844;10.24;0.62;242.73;4.00;791;29;1648.00;20
4036;29;626108614;4036;133;4825;4845;10.35;0.63;242.71;4.00;789;29;1649.00;20
4041;29;626108626;4041;130;4826;4845;10.35;0.63;242.66;4.00;785;29;1650.00;19
4042;29;626108638;4042;130;4826;4845;10.37;0.63;242.72;4.00;784;29;1651.00;19
4044;29;626108648;4044;129;4827;4845;10.42;0.63;242.68;4.01;783;29;1652.00;18
4047;29;626108658;4047;131;4827;4845;10.44;0.63;242.78;4.01;780;29;1653.00;18
4049;29;626108669;4049;134;4828;4845;10.44;0.63;242.90;4.01;779;29;1654.00;17
4049;29;626108680;4049;138;4829;4845;10.50;0.64;242.90;4.02;780;29;1655.00;16
4052;29;626108690;4052;148;4868;4915;10.56;0.64;242.98;4.00;816;29;1656.00;47
4057;29;626108710;4057;146;4870;4916;10.58;0.64;243.01;4.00;813;29;1657.00;46
4062;29;626108727;4062;147;4877;4916;10.66;0.65;243.04;3.99;815;29;1658.00;39
4063;29;626108743;4063;152;4881;4916;10.71;0.65;243.09;3.99;818;29;1659.00;35
4067;29;626108756;4067;159;4890;4916;10.71;0.65;243.04;4.01;823;29;1660.00;26
4067;29;626108770;4067;158;4893;4916;10.75;0.65;243.04;4.01;826;29;1661.00;23
4071;29;626108782;4071;160;4896;4916;10.79;0.66;243.07;4.02;825;29;1662.00;20
4074;29;626108796;4074;164;4897;4916;10.78;0.66;243.12;4.03;823;29;1663.00;19
4077;29;626108809;4077;162;4900;4917;10.76;0.65;243.13;4.04;823;29;1664.00;17
4079;29;626108822;4079;166;4903;4919;10.67;0.65;243.16;4.05;824;29;1665.00;16
4083;29;626108837;4083;173;4905;4919;10.62;0.65;243.25;4.06;822;29;1666.00;14
4085;29;626108850;4085;173;4907;4923;10.44;0.64;243.18;4.06;822;29;1667.00;16
4088;29;626108863;4088;174;4909;4923;10.20;0.62;243.17;4.07;821;29;1668.00;14
4089;29;626108876;4089;176;4909;4923;10.09;0.62;243.19;4.07;820;29;1669.00;14
4094;29;626108889;4094;184;4911;4923;9.95;0.61;243.22;4.08;817;29;1670.00;12
4096;29;626108901;4096;190;4915;4929;9.97;0.61;243.21;4.08;819;29;1671.00;14
4097;29;626108914;4097;194;4916;4929;9.91;0.61;243.21;4.08;819;29;1672.00;13
4098;29;626108925;4098;200;4918;4929;9.89;0.61;243.24;4.09;820;29;1673.00;11
4101;29;626108937;4101;200;4921;4932;9.91;0.61;243.25;4.09;820;29;1674.00;11
4106;29;626108949;4106;204;4923;4932;9.84;0.60;243.26;4.09;817;29;1675.00;9
4109;29;626108963;4109;204;4923;4932;9.76;0.60;243.29;4.09;814;29;1676.00;9
4111;29;626108982;4111;211;4924;4933;9.69;0.59;243.30;4.10;813;29;1677.00;9
4114;29;626108999;4114;215;4925;4934;9.59;0.59;243.21;4.10;811;29;1678.00;9
4116;29;626109016;4116;216;4928;4934;9.46;0.58;243.22;4.10;812;29;1679.00;6
4119;29;626109038;4119;227;4944;4960;9.32;0.57;243.15;4.09;825;29;1680.00;16
4123;29;626109058;4123;220;4948;4960;9.23;0.57;243.27;4.09;825;29;1681.00;12
4127;29;626109076;4127;222;4950;4960;9.19;0.56;243.27;4.09;823;29;1682.00;10
4130;29;626109091;4130;217;4951;4961;9.20;0.57;243.29;4.09;821;29;1683.00;10
4136;29;626109105;4136;222;4952;4961;9.19;0.56;243.24;4.09;816;29;1684.00;9
4144;29;626109118;4144;223;4955;4965;9.15;0.56;243.28;4.09;811;29;1685.00;10
4148;29;626109130;4148;231;4955;4965;9.11;0.56;243.35;4.09;807;29;1686.00;10
4153;29;626109142;4153;236;4959;4969;9.00;0.55;243.28;4.08;806;29;1687.00;10
4157;29;626109156;4157;237;4961;4969;8.95;0.55;243.30;4.09;804;29;1688.00;8
4159;29;626109168;4159;249;4961;4969;8.90;0.54;243.22;4.09;802;29;1689.00;8
4166;29;626109179;4166;253;4961;4969;8.79;0.54;243.23;4.09;795;29;1690.00;8
4168;29;626109193;4168;257;4961;4969;8.73;0.53;243.20;4.09;793;29;1691.00;8
4171;29;626109204;4171;264;4974;4981;8.63;0.53;243.16;4.09;803;29;1692.00;7
4175;29;626109217;4175;271;4974;4981;8.44;0.51;243.14;4.09;799;29;1693.00;7
4180;29;626109227;4180;274;4976;4981;8.26;0.50;243.21;4.09;796;29;1694.00;5
4183;29;626109237;4183;282;4976;4981;8.06;0.49;243.31;4.09;793;29;1695.00;5
4185;29;626109247;4185;288;4976;4981;7.92;0.49;243.36;4.09;791;29;1696.00;5
4189;29;626109258;4189;293;4976;4981;7.76;0.48;243.51;4.09;787;29;1697.00;5
4195;29;626109268;4195;299;4977;4982;7.55;0.46;243.58;4.09;782;29;1698.00;5
4197;29;626109278;4197;309;4977;4982;7.39;0.46;243.65;4.09;780;29;1699.00;5
4200;29;626109287;4200;299;4982;4988;7.32;0.45;243.62;4.08;782;29;1700.00;6
4207;29;626109302;4207;295;4983;4989;7.12;0.44;243.81;4.08;776;29;1701.00;6
4207;29;626109312;4207;293;4984;4989;7.05;0.43;243.81;4.08;777;29;1702.00;5
4210;29;626109321;4210;293;4984;4989;6.92;0.43;243.87;4.08;774;29;1703.00;5
4211;29;626109331;4211;293;4988;4993;6.84;0.42;243.91;4.08;777;29;1704.00;5
4213;29;626109341;4213;291;4988;4993;6.85;0.42;243.90;4.08;775;29;1705.00;5
4219;29;626109351;4219;291;4988;4993;6.74;0.41;243.85;4.08;769;29;1706.00;5
4221;29;626109360;4221;290;4989;4994;6.80;0.42;243.77;4.08;768;29;1707.00;5
4228;29;626109370;4228;292;4993;4998;6.78;0.42;243.79;4.08;765;29;1708.00;5
4230;29;626109381;4230;293;4993;4998;6.81;0.42;243.81;4.08;763;29;1709.00;5
4234;29;626109393;4234;288;4996;5004;6.91;0.42;243.74;4.07;762;29;1710.00;8
4235;29;626109404;4235;293;4997;5004;7.04;0.43;243.78;4.07;762;29;1711.00;7
4240;29;626109414;4240;298;4997;5004;7.09;0.43;243.70;4.07;757;29;1712.00;7
4241;29;626109424;4241;295;4998;5004;7.17;0.44;243.67;4.07;757;29;1713.00;6
4244;29;626109434;4244;291;5000;5008;7.22;0.44;243.76;4.07;756;29;1714.00;8
4249;29;626109445;4249;285;5002;5008;7.17;0.44;243.70;4.09;753;29;1715.00;6
4251;29;626109455;4251;286;5002;5008;7.13;0.44;243.74;4.09;751;29;1716.00;6
4257;29;626109465;4257;293;5003;5008;7.09;0.43;243.67;4.09;746;29;1717.00;5
4261;29;626109478;4261;291;5004;5009;7.04;0.43;243.60;4.09;743;29;1718.00;5
4266;29;626109489;4266;291;5006;5010;7.04;0.43;243.47;4.09;740;29;1719.00;4
4268;29;626109499;4268;293;5006;5010;7.07;0.43;243.53;4.09;738;29;1720.00;4
4269;29;626109510;4269;298;5007;5011;7.10;0.43;243.51;4.09;738;29;1721.00;4
4272;29;626109521;4272;301;5007;5011;7.08;0.43;243.48;4.09;735;29;1722.00;4
4276;29;626109538;4276;304;5007;5011;7.02;0.43;243.51;4.09;731;29;1723.00;4
4277;29;626109549;4277;306;5007;5011;6.99;0.43;243.52;4.09;730;29;1724.00;4
4283;29;626109559;4283;303;5007;5011;6.90;0.42;243.46;4.09;724;29;1725.00;4
4287;29;626109570;4287;307;5007;5011;6.84;0.42;243.49;4.09;720;29;1726.00;4
4290;29;626109581;4290;310;5007;5011;6.84;0.42;243.45;4.09;717;29;1727.00;4
4297;29;626109590;4297;320;5079;5138;7.14;0.44;243.32;4.03;782;29;1728.00;59
4300;29;626109614;4300;315;5082;5139;7.14;0.44;243.34;4.03;782;29;1729.00;57
4301;29;626109625;4301;314;5091;5139;7.30;0.45;243.31;4.03;790;29;1730.00;48
4302;29;626109637;4302;309;5096;5139;7.40;0.46;243.37;4.02;794;29;1731.00;43
4305;29;626109648;4305;312;5100;5139;7.46;0.46;243.29;4.02;795;29;1732.00;39
4306;29;626109660;4306;318;5103;5139;7.52;0.46;243.30;4.03;797;29;1733.00;36
4310;29;626109671;4310;324;5107;5139;7.55;0.47;243.27;4.03;797;29;1734.00;32
4314;29;626109682;4314;328;5109;5139;7.57;0.47;243.24;4.03;795;29;1735.00;30
4314;29;626109693;4314;332;5113;5140;7.55;0.46;243.24;4.03;799;29;1736.00;27
4315;29;626109705;4315;337;5115;5141;7.52;0.46;243.24;4.03;800;29;1737.00;26
4317;29;626109716;4317;345;5118;5141;7.50;0.46;243.20;4.04;801;29;1738.00;23
4319;29;626109727;4319;336;5122;5142;7.50;0.46;243.15;4.04;803;29;1739.00;20
4321;29;626109740;4321;335;5124;5142;7.50;0.46;243.19;4.04;803;29;1740.00;18
4321;29;626109752;4321;338;5128;5142;7.61;0.47;243.19;4.05;807;29;1741.00;14
4324;29;626109764;4324;332;5129;5142;7.65;0.47;243.19;4.05;805;29;1742.00;13
4326;29;626109776;4326;334;5135;5146;7.76;0.48;243.31;4.06;809;29;1743.00;11
4327;29;626109790;4327;337;5136;5146;7.81;0.48;243.31;4.06;809;29;1744.00;10
4328;29;626109803;4328;331;5136;5146;7.86;0.48;243.32;4.06;808;29;1745.00;10
4331;29;626109815;4331;333;5139;5149;7.91;0.48;243.30;4.06;808;29;1746.00;10
4332;29;626109828;4332;315;5139;5149;7.99;0.49;243.29;4.06;807;29;1747.00;10
4333;29;626109849;4333;301;5140;5149;8.05;0.49;243.32;4.06;807;29;1748.00;9
4335;30;626109862;4335;290;5144;5153;8.13;0.50;243.25;4.06;809;30;1749.00;9
4336;30;626109886;4336;281;5146;5154;8.22;0.50;243.20;4.06;810;30;1750.00;8
4340;30;626109905;4340;274;5146;5154;8.23;0.50;243.25;4.06;806;30;1751.00;8
4341;30;626109918;4341;272;5151;5158;8.31;0.51;243.27;4.06;810;30;1752.00;7
4345;30;626109933;4345;272;5151;5158;8.39;0.51;243.26;4.06;806;30;1753.00;7
4348;30;626109946;4348;266;5152;5158;8.39;0.51;243.32;4.06;804;30;1754.00;6
4351;30;626109959;4351;264;5154;5160;8.40;0.51;243.29;4.06;803;30;1755.00;6
4353;30;626109982;4353;251;5154;5160;8.47;0.52;243.29;4.06;801;30;1756.00;6
4354;30;626109995;4354;238;5159;5166;8.59;0.52;243.24;4.06;805;30;1757.00;7
4355;30;626110016;4355;232;5159;5166;8.69;0.53;243.22;4.06;804;30;1758.00;7
4356;30;626110029;4356;228;5161;5167;8.73;0.53;243.22;4.05;805;30;1759.00;6
4359;30;626110042;4359;227;5161;5167;8.81;0.54;243.26;4.05;802;30;1760.00;6
4361;30;626110055;4361;232;5161;5167;8.90;0.54;243.20;4.05;800;30;1761.00;6
4364;30;626110068;4364;236;5161;5167;8.90;0.54;243.22;4.05;797;30;1762.00;6
4365;30;626110081;4365;235;5161;5167;9.00;0.55;243.24;4.05;796;30;1763.00;6
4367;30;626110094;4367;239;5171;5179;9.07;0.55;243.31;4.05;804;30;1764.00;8
4369;30;626110109;4369;236;5172;5179;9.21;0.56;243.37;4.05;803;30;1765.00;7
4372;30;626110122;4372;235;5172;5179;9.26;0.56;243.34;4.05;800;30;1766.00;7
4374;30;626110135;4374;231;5172;5179;9.32;0.56;243.33;4.05;798;30;1767.00;7
4376;30;626110148;4376;233;5172;5179;9.39;0.57;243.33;4.05;796;30;1768.00;7
4378;30;626110161;4378;227;5172;5179;9.41;0.57;243.32;4.05;794;30;1769.00;7
4382;31;626110176;4382;223;5175;5183;9.33;0.57;243.33;4.04;793;31;1770.00;8
4382;31;626110196;4382;226;5175;5183;9.36;0.57;243.33;4.04;793;31;1771.00;8
4383;31;626110209;4383;226;5178;5187;9.43;0.57;243.34;4.04;795;31;1772.00;9
4388;31;626110222;4388;231;5179;5188;9.42;0.57;243.64;4.04;791;31;1773.00;9
4389;31;626110235;4389;231;5180;5188;9.48;0.58;243.62;4.04;791;31;1774.00;8
4392;31;626110247;4392;234;5180;5188;9.50;0.58;243.74;4.04;788;31;1775.00;8
4395;31;626110260;4395;233;5191;5201;9.51;0.58;243.83;4.03;796;31;1776.00;10
4396;31;626110273;4396;233;5191;5201;9.54;0.58;243.83;4.03;795;31;1777.00;10
4400;31;626110290;4400;232;5191;5201;9.61;0.59;243.95;4.03;791;31;1778.00;10
4403;31;626110302;4403;230;5192;5202;9.67;0.59;243.99;4.03;789;31;1779.00;10
4406;31;626110314;4406;233;5192;5203;9.69;0.59;244.05;4.03;786;31;1780.00;11
4411;31;626110326;4411;231;5192;5203;9.64;0.59;244.18;4.03;781;31;1781.00;11
4412;31;626110348;4412;231;5194;5206;9.63;0.59;244.21;4.03;782;31;1782.00;12
4415;31;626110359;4415;229;5194;5206;9.64;0.59;244.34;4.03;779;31;1783.00;12
4420;31;626110371;4420;231;5195;5206;9.69;0.59;244.40;4.03;775;31;1784.00;11
4422;31;626110383;4422;234;5195;5206;9.72;0.59;244.41;4.03;773;31;1785.00;11
4425;31;626110394;4425;236;5199;5212;9.71;0.59;244.46;4.03;774;31;1786.00;13
4427;31;626110411;4427;235;5199;5212;9.66;0.59;244.58;4.03;772;31;1787.00;13
4429;31;626110428;4429;240;5200;5212;9.61;0.59;244.63;4.03;771;31;1788.00;12
4433;31;626110441;4433;237;5200;5212;9.56;0.58;244.74;4.03;767;31;1789.00;12
4437;31;626110452;4437;230;5203;5216;9.50;0.58;244.81;4.03;766;31;1790.00;13
4439;31;626110463;4439;222;5204;5217;9.59;0.59;244.83;4.03;765;31;1791.00;13
4444;31;626110473;4444;217;5204;5217;9.63;0.59;244.89;4.03;760;31;1792.00;13
4448;31;626110484;4448;210;5205;5218;9.70;0.59;244.92;4.02;757;31;1793.00;13
4452;31;626110496;4452;201;5205;5218;9.79;0.60;244.98;4.02;753;31;1794.00;13
4459;31;626110509;4459;203;5205;5218;9.83;0.60;245.06;4.02;746;31;1795.00;13
4461;31;626110520;4461;192;5205;5218;9.89;0.60;245.12;4.02;744;31;1796.00;13
4463;31;626110529;4463;190;5205;5218;9.94;0.61;245.21;4.02;742;31;1797.00;13
4465;31;626110539;4465;181;5205;5218;9.99;0.61;245.32;4.02;740;31;1798.00;13
4468;31;626110549;4468;171;5205;5218;9.98;0.61;245.36;4.02;737;31;1799.00;13
4472;31;626110562;4472;182;5269;5356;9.70;0.60;245.52;3.98;797;31;1800.00;87
4475;31;626110587;4475;169;5269;5357;9.68;0.60;245.51;3.98;794;31;1801.00;88
4482;31;626110598;4482;152;5278;5357;9.64;0.59;245.67;4.01;796;31;1802.00;79
4485;31;626110609;4485;153;5286;5357;9.69;0.60;245.78;4.00;801;31;1803.00;71
4491;31;626110620;4491;149;5292;5357;9.69;0.59;245.86;4.00;801;31;1804.00;65
4495;31;626110633;4495;142;5297;5357;9.65;0.59;245.94;4.02;802;31;1805.00;60
4497;31;626110652;4497;143;5301;5357;9.63;0.59;245.89;4.02;804;31;1806.00;56
4504;31;626110669;4504;141;5302;5357;9.58;0.59;246.03;4.02;798;31;1807.00;55
4508;31;626110680;4508;141;5305;5358;9.62;0.59;246.06;4.02;797;31;1808.00;53
4511;31;626110692;4511;135;5307;5359;9.60;0.59;246.10;4.07;796;31;1809.00;52
4512;31;626110704;4512;136;5310;5359;9.58;0.59;246.16;4.08;798;31;1810.00;49
4514;31;626110714;4514;134;5316;5363;9.64;0.59;246.17;4.10;802;31;1811.00;47
4515;31;626110725;4515;128;5317;5363;9.68;0.59;246.18;4.10;802;31;1812.00;46
4520;31;626110742;4520;120;5319;5363;9.71;0.59;246.21;4.10;799;31;1813.00;44
4526;31;626110753;4526;121;5320;5363;9.67;0.59;246.30;4.12;794;31;1814.00;43
4529;31;626110765;4529;121;5324;5369;9.66;0.59;246.32;4.12;795;31;1815.00;45
4530;31;626110776;4530;126;5324;5369;9.71;0.59;246.36;4.12;794;31;1816.00;45
4536;31;626110787;4536;132;5326;5369;9.79;0.60;246.33;4.14;790;31;1817.00;43
4538;31;626110798;4538;138;5328;5372;9.93;0.61;246.36;4.14;790;31;1818.00;44
4540;31;626110809;4540;139;5329;5372;10.04;0.61;246.41;4.14;789;31;1819.00;43
4542;31;626110819;4542;145;5331;5372;10.11;0.62;246.44;4.15;789;31;1820.00;41
4545;31;626110836;4545;151;5333;5373;10.12;0.62;246.45;4.15;788;31;1821.00;40
4550;31;626110848;4550;151;5335;5374;10.16;0.62;246.52;4.15;785;31;1822.00;39
4550;31;626110859;4550;150;5336;5374;10.25;0.63;246.52;4.16;786;31;1823.00;38
4557;31;626110870;4557;154;5344;5387;10.32;0.63;246.53;4.16;787;31;1824.00;43
4561;31;626110882;4561;155;5346;5387;10.39;0.63;246.50;4.16;785;31;1825.00;41
4562;31;626110894;4562;156;5347;5387;10.43;0.64;246.52;4.16;785;31;1826.00;40
4564;31;626110911;4564;161;5352;5388;10.44;0.64;246.49;4.17;788;31;1827.00;36
4567;31;626110930;4567;165;5352;5388;10.40;0.63;246.39;4.17;785;31;1828.00;36
4569;31;626110941;4569;168;5355;5392;10.38;0.63;246.39;4.17;786;31;1829.00;37
4569;31;626110954;4569;170;5358;5392;10.34;0.63;246.39;4.19;789;31;1830.00;34
4571;31;626110965;4571;174;5361;5396;10.29;0.63;246.50;4.19;790;31;1831.00;35
4575;31;626110980;4575;180;5365;5396;10.17;0.62;246.63;4.21;790;31;1832.00;31
4576;31;626110997;4576;177;5365;5396;10.14;0.62;246.61;4.21;789;31;1833.00;31
4579;31;626111020;4579;174;5366;5396;10.12;0.62;246.68;4.22;787;31;1834.00;30
4582;31;626111043;4582;177;5367;5396;10.08;0.62;246.72;4.22;785;31;1835.00;29
4587;31;626111063;4587;178;5378;5408;10.05;0.62;246.84;4.22;791;31;1836.00;30
4592;31;626111088;4592;183;5381;5408;9.97;0.61;246.89;4.23;789;31;1837.00;27
4595;32;626111103;4595;183;5382;5408;9.94;0.61;246.96;4.23;787;32;1838.00;26
4595;32;626111133;4595;186;5384;5408;9.95;0.61;246.96;4.24;789;32;1839.00;24
4600;32;626111144;4600;190;5385;5408;9.89;0.61;247.03;4.25;785;32;1840.00;23
4603;32;626111155;4603;191;5386;5408;9.82;0.60;247.13;4.25;783;32;1841.00;22
4603;32;626111167;4603;196;5388;5409;9.81;0.60;247.13;4.27;785;32;1842.00;21
4611;32;626111177;4611;205;5390;5409;9.75;0.60;247.09;4.28;779;32;1843.00;19
4613;32;626111188;4613;210;5394;5415;9.76;0.60;247.11;4.28;781;32;1844.00;21
4615;32;626111200;4615;216;5398;5417;9.70;0.59;247.04;4.28;783;32;1845.00;19
4617;32;626111210;4617;221;5398;5417;9.61;0.59;247.09;4.28;781;32;1846.00;19
4621;32;626111221;4621;228;5400;5417;9.50;0.58;247.06;4.29;779;32;1847.00;17
4622;32;626111240;4622;237;5404;5421;9.38;0.57;247.03;4.29;782;32;1848.00;17
4623;32;626111251;4623;236;5405;5421;9.33;0.57;247.01;4.29;782;32;1849.00;16
4627;32;626111262;4627;240;5406;5421;9.20;0.56;246.98;4.30;779;32;1850.00;15
4629;32;626111272;4629;236;5407;5422;9.09;0.55;247.10;4.30;778;32;1851.00;15
4631;32;626111282;4631;238;5411;5426;8.99;0.55;247.15;4.29;780;32;1852.00;15
4633;32;626111292;4633;245;5412;5426;8.94;0.54;247.22;4.30;779;32;1853.00;14
4635;32;626111302;4635;244;5414;5429;8.91;0.54;247.18;4.29;779;32;1854.00;15
4636;32;626111313;4636;240;5414;5429;8.83;0.54;247.15;4.29;778;32;1855.00;15
4637;32;626111322;4637;242;5416;5429;8.81;0.54;247.19;4.29;779;32;1856.00;13
4638;32;626111332;4638;239;5416;5429;8.77;0.54;247.15;4.29;778;32;1857.00;13
4640;32;626111343;4640;247;5420;5433;8.74;0.53;247.15;4.29;780;32;1858.00;13
4643;32;626111353;4643;254;5420;5433;8.68;0.53;247.24;4.29;777;32;1859.00;13
4645;32;626111365;4645;258;5421;5433;8.61;0.52;247.24;4.29;776;32;1860.00;12
4648;32;626111375;4648;258;5421;5433;8.47;0.52;247.20;4.29;773;32;1861.00;12
4651;32;626111384;4651;261;5422;5434;8.32;0.51;247.24;4.29;771;32;1862.00;12
4652;32;626111393;4652;270;5423;5435;8.18;0.50;247.20;4.29;771;32;1863.00;12
4657;32;626111401;4657;274;5423;5435;8.02;0.49;247.26;4.29;766;32;1864.00;12
4660;32;626111410;4660;282;5424;5436;7.86;0.48;247.21;4.29;764;32;1865.00;12
4663;32;626111419;4663;285;5424;5436;7.72;0.47;247.13;4.29;761;32;1866.00;12
4666;32;626111427;4666;287;5424;5436;7.52;0.46;247.05;4.29;758;32;1867.00;12
4668;32;626111436;4668;288;5424;5436;7.29;0.45;247.08;4.29;756;32;1868.00;12
4672;32;626111444;4672;293;5424;5436;6.97;0.43;247.08;4.29;752;32;1869.00;12
4674;32;626111452;4674;286;5424;5436;6.74;0.42;247.02;4.29;750;32;1870.00;12
4677;32;626111460;4677;284;5424;5436;6.56;0.40;247.03;4.29;747;32;1871.00;12
4680;32;626111478;4680;310;5495;5563;6.75;0.42;246.98;4.24;815;32;1872.00;68
4682;32;626111497;4682;302;5501;5564;6.69;0.42;247.01;4.23;819;32;1873.00;63
4684;32;626111505;4684;301;5508;5564;6.72;0.42;246.98;4.23;824;32;1874.00;56
4687;32;626111514;4687;305;5513;5564;6.73;0.42;247.05;4.23;826;32;1875.00;51
4688;32;626111524;4688;310;5518;5564;6.81;0.43;247.02;4.23;830;32;1876.00;46
4691;32;626111532;4691;309;5523;5564;6.87;0.43;247.02;4.23;832;32;1877.00;41
4693;32;626111541;4693;302;5529;5564;6.94;0.43;247.01;4.23;836;32;1878.00;35
4697;32;626111550;4697;299;5531;5564;6.96;0.43;247.09;4.23;834;32;1879.00;33
4700;32;626111560;4700;295;5535;5565;7.00;0.43;247.03;4.24;835;32;1880.00;30
4702;32;626111569;4702;308;5539;5566;6.97;0.43;247.03;4.24;837;32;1881.00;27
4704;32;626111585;4704;314;5542;5568;6.97;0.43;247.04;4.24;838;32;1882.00;26
4708;32;626111595;4708;315;5544;5569;6.91;0.43;247.20;4.24;836;32;1883.00;25
4710;32;626111605;4710;323;5546;5569;6.85;0.42;247.27;4.24;836;32;1884.00;23
4714;32;626111615;4714;326;5547;5569;6.77;0.42;247.26;4.24;833;32;1885.00;22
4716;32;626111624;4716;334;5549;5569;6.72;0.42;247.27;4.25;833;32;1886.00;20
4719;32;626111633;4719;340;5552;5573;6.65;0.41;247.30;4.25;833;32;1887.00;21
4720;32;626111643;4720;337;5554;5573;6.63;0.41;247.28;4.25;834;32;1888.00;19
4723;32;626111653;4723;338;5555;5573;6.60;0.41;247.35;4.25;832;32;1889.00;18
4725;32;626111664;4725;340;5559;5579;6.57;0.41;247.39;4.25;834;32;1890.00;20
4728;32;626111674;4728;327;5561;5579;6.64;0.41;247.26;4.25;833;32;1891.00;18
4731;32;626111685;4731;325;5561;5579;6.72;0.41;247.26;4.25;830;32;1892.00;18
4734;32;626111695;4734;317;5567;5583;6.80;0.42;247.27;4.25;833;32;1893.00;16
4738;32;626111706;4738;316;5568;5584;6.80;0.42;247.16;4.25;830;32;1894.00;16
4740;32;626111717;4740;314;5569;5584;6.82;0.42;247.24;4.25;829;32;1895.00;15
4744;32;626111727;4744;307;5574;5588;6.82;0.42;247.24;4.25;830;32;1896.00;14
4745;32;626111739;4745;301;5574;5588;6.91;0.42;247.28;4.25;829;32;1897.00;14
4749;32;626111759;4749;302;5574;5588;6.98;0.43;247.23;4.25;825;32;1898.00;14
4753;32;626111770;4753;298;5576;5589;7.02;0.43;247.19;4.27;823;32;1899.00;13
4757;32;626111783;4757;295;5576;5589;7.15;0.44;247.28;4.27;819;32;1900.00;13
4762;32;626111800;4762;298;5581;5595;7.19;0.44;247.32;4.26;819;32;1901.00;14
4764;32;626111813;4764;300;5581;5595;7.26;0.44;247.35;4.26;817;32;1902.00;14
4766;32;626111831;4766;303;5583;5596;7.33;0.45;247.53;4.26;817;32;1903.00;13
4771;32;626111843;4771;304;5583;5596;7.33;0.45;247.52;4.26;812;32;1904.00;13
4778;32;626111853;4778;306;5583;5596;7.31;0.44;247.49;4.26;805;32;1905.00;13
4780;32;626111864;4780;303;5583;5596;7.36;0.45;247.53;4.26;803;32;1906.00;13
4782;32;626111875;4782;300;5583;5596;7.40;0.45;247.51;4.26;801;32;1907.00;13
4784;32;626111885;4784;306;5594;5608;7.58;0.46;247.53;4.25;810;32;1908.00;14
4785;32;626111898;4785;308;5595;5608;7.67;0.47;247.48;4.25;810;32;1909.00;13
4788;32;626111908;4788;311;5595;5608;7.65;0.46;247.53;4.25;807;32;1910.00;13
4788;32;626111920;4788;317;5595;5608;7.65;0.46;247.53;4.25;807;32;1911.00;13
4791;32;626111931;4791;326;5595;5608;7.62;0.46;247.54;4.25;804;32;1912.00;13
4792;32;626111941;4792;330;5595;5608;7.63;0.46;247.55;4.25;803;32;1913.00;13
4795;32;626111952;4795;337;5599;5612;7.67;0.47;247.61;4.25;804;32;1914.00;13
4798;32;626111964;4798;341;5599;5612;7.63;0.46;247.62;4.25;801;32;1915.00;13
4800;32;626111977;4800;348;5602;5616;7.58;0.46;247.60;4.25;802;32;1916.00;14
4803;32;626111989;4803;336;5603;5617;7.54;0.46;247.61;4.25;800;32;1917.00;14
4805;32;626111999;4805;333;5604;5617;7.55;0.46;247.62;4.25;799;32;1918.00;13
4805;32;626112010;4805;330;5604;5617;7.58;0.46;247.62;4.25;799;32;1919.00;13
4811;32;626112023;4811;333;5625;5646;7.68;0.47;247.63;4.23;814;32;1920.00;21
4813;32;626112036;4813;326;5626;5646;7.71;0.47;247.63;4.23;813;32;1921.00;20
4817;32;626112047;4817;324;5627;5646;7.77;0.47;247.77;4.23;810;32;1922.00;19
4820;32;626112058;4820;321;5629;5647;7.88;0.48;247.81;4.23;809;32;1923.00;18
4824;32;626112069;4824;315;5630;5648;7.91;0.48;247.90;4.23;806;32;1924.00;18
4828;32;626112081;4828;316;5630;5648;7.88;0.48;248.00;4.23;802;32;1925.00;18
4829;32;626112097;4829;296;5633;5651;7.91;0.48;247.96;4.23;804;32;1926.00;18
4833;32;626112109;4833;282;5633;5651;7.87;0.48;247.90;4.23;800;32;1927.00;18
4837;32;626112121;4837;274;5633;5651;7.90;0.48;247.91;4.23;796;32;1928.00;18
4841;32;626112132;4841;271;5633;5651;7.92;0.48;247.86;4.23;792;32;1929.00;18
4844;32;626112143;4844;267;5637;5657;7.96;0.48;247.86;4.23;793;32;1930.00;20
4845;32;626112155;4845;263;5638;5657;8.01;0.49;247.83;4.22;793;32;1931.00;19
4847;32;626112166;4847;256;5639;5657;8.11;0.49;247.84;4.25;792;32;1932.00;18
4851;32;626112183;4851;254;5639;5657;8.20;0.50;247.82;4.25;788;32;1933.00;18
4853;32;626112194;4853;256;5642;5661;8.29;0.50;247.83;4.25;789;32;1934.00;19
4855;32;626112205;4855;263;5644;5663;8.33;0.51;247.86;4.24;789;32;1935.00;19
4859;32;626112217;4859;262;5644;5663;8.34;0.51;247.86;4.24;785;32;1936.00;19
4860;32;626112228;4860;253;5645;5664;8.39;0.51;247.85;4.24;785;32;1937.00;19
4864;32;626112238;4864;255;5645;5664;8.45;0.51;247.89;4.24;781;32;1938.00;19
4865;32;626112249;4865;245;5645;5664;8.47;0.51;247.91;4.24;780;32;1939.00;19
4867;32;626112260;4867;246;5645;5664;8.49;0.52;247.94;4.24;778;32;1940.00;19
4870;33;626112271;4870;243;5645;5664;8.52;0.52;247.94;4.24;775;33;1941.00;19
4873;33;626112297;4873;242;5645;5664;8.57;0.52;247.89;4.24;772;33;1942.00;19
4877;33;626112307;4877;240;5645;5664;8.50;0.52;247.85;4.24;768;33;1943.00;19
4882;33;626112318;4882;252;5687;5734;8.33;0.51;247.84;4.21;805;33;1944.00;47
4882;33;626112333;4882;247;5687;5735;8.40;0.51;247.84;4.21;805;33;1945.00;48
4884;33;626112344;4884;240;5691;5735;8.55;0.52;247.84;4.21;807;33;1946.00;44
4887;33;626112354;4887;237;5696;5735;8.69;0.53;247.85;4.21;809;33;1947.00;39
4887;33;626112364;4887;230;5700;5735;8.82;0.54;247.85;4.21;813;33;1948.00;35
4890;33;626112381;4890;227;5704;5735;8.94;0.55;247.83;4.21;814;33;1949.00;31
4895;33;626112393;4895;231;5708;5737;9.00;0.55;247.88;4.21;813;33;1950.00;29
4895;33;626112405;4895;229;5709;5737;9.10;0.55;247.88;4.21;814;33;1951.00;28
4897;33;626112415;4897;236;5712;5738;9.13;0.56;247.89;4.21;815;33;1952.00;26
4901;33;626112426;4901;242;5714;5739;9.12;0.56;247.89;4.21;813;33;1953.00;25
4904;33;626112436;4904;243;5714;5739;9.10;0.55;247.92;4.21;810;33;1954.00;25
4904;33;626112447;4904;246;5718;5743;9.05;0.55;247.92;4.21;814;33;1955.00;25
4906;33;626112458;4906;243;5718;5743;9.01;0.55;247.90;4.21;812;33;1956.00;25
4910;33;626112469;4910;247;5718;5743;8.99;0.55;247.83;4.21;808;33;1957.00;25
4913;33;626112479;4913;245;5718;5743;8.93;0.54;247.83;4.21;805;33;1958.00;25
4914;33;626112490;4914;246;5723;5749;8.92;0.54;247.83;4.21;809;33;1959.00;26
4916;33;626112500;4916;242;5723;5749;8.98;0.55;247.85;4.21;807;33;1960.00;26
4916;33;626112510;4916;235;5724;5749;8.98;0.55;247.85;4.23;808;33;1961.00;25
4917;33;626112521;4917;235;5727;5752;9.07;0.55;247.89;4.23;810;33;1962.00;25
4919;33;626112531;4919;233;5727;5752;9.12;0.56;247.95;4.23;808;33;1963.00;25
4922;33;626112541;4922;229;5727;5752;9.19;0.56;248.02;4.23;805;33;1964.00;25
4923;33;626112551;4923;224;5727;5753;9.24;0.56;248.03;4.23;804;33;1965.00;26
4927;33;626112561;4927;221;5728;5754;9.28;0.57;248.14;4.23;801;33;1966.00;26
4930;33;626112572;4930;214;5728;5754;9.35;0.57;248.08;4.23;798;33;1967.00;26
4933;33;626112582;4933;215;5737;5767;9.34;0.57;248.17;4.23;804;33;1968.00;30
4937;33;626112593;4937;211;5737;5767;9.32;0.57;248.35;4.23;800;33;1969.00;30
4941;33;626112609;4941;205;5737;5767;9.26;0.56;248.40;4.23;796;33;1970.00;30
4943;33;626112620;4943;201;5738;5768;9.25;0.56;248.47;4.22;795;33;1971.00;30
4950;33;626112630;4950;189;5738;5768;9.15;0.56;248.49;4.22;788;33;1972.00;30
4955;33;626112640;4955;182;5741;5772;9.18;0.56;248.53;4.22;786;33;1973.00;31
4958;33;626112651;4958;175;5742;5772;9.22;0.56;248.68;4.23;784;33;1974.00;30
4961;33;626112662;4961;173;5748;5776;9.20;0.56;248.72;4.27;787;33;1975.00;28
4965;33;626112672;4965;167;5748;5776;9.25;0.56;248.73;4.27;783;33;1976.00;28
4967;33;626112683;4967;156;5748;5776;9.32;0.57;248.81;4.27;781;33;1977.00;28
4970;33;626112693;4970;153;5749;5776;9.38;0.57;248.83;4.30;779;33;1978.00;27
4975;33;626112703;4975;151;5749;5776;9.40;0.57;248.78;4.30;774;33;1979.00;27
4977;33;626112715;4977;144;5769;5810;9.51;0.58;248.84;4.28;792;33;1980.00;41
4978;33;626112727;4978;142;5771;5810;9.53;0.58;248.89;4.31;793;33;1981.00;39
4979;33;626112737;4979;143;5772;5810;9.53;0.58;248.92;4.31;793;33;1982.00;38
4982;33;626112748;4982;143;5772;5810;9.47;0.58;248.92;4.31;790;33;1983.00;38
4985;33;626112758;4985;142;5773;5810;9.50;0.58;248.99;4.31;788;33;1984.00;37
4990;33;626112769;4990;143;5773;5810;9.55;0.58;249.12;4.31;783;33;1985.00;37
4990;33;626112779;4990;148;5774;5811;9.66;0.59;249.12;4.31;784;33;1986.00;37
4993;33;626112789;4993;151;5775;5811;9.64;0.59;249.21;4.32;782;33;1987.00;36
4995;33;626112804;4995;154;5778;5817;9.73;0.59;249.20;4.31;783;33;1988.00;39
4998;33;626112815;4998;152;5781;5818;9.73;0.59;249.19;4.32;783;33;1989.00;37
5001;33;626112825;5001;152;5782;5818;9.68;0.59;249.23;4.32;781;33;1990.00;36
5001;33;626112835;5001;160;5782;5818;9.68;0.59;249.23;4.32;781;33;1991.00;36
5006;33;626112845;5006;161;5785;5822;9.69;0.59;249.33;4.32;779;33;1992.00;37
5008;33;626112856;5008;169;5785;5822;9.63;0.59;249.33;4.32;777;33;1993.00;37
5012;33;626112866;5012;177;5786;5822;9.57;0.58;249.32;4.32;774;33;1994.00;36
5013;33;626112877;5013;174;5787;5823;9.56;0.58;249.31;4.32;774;33;1995.00;36
5015;34;626112887;5015;177;5792;5827;9.49;0.58;249.41;4.33;777;34;1996.00;35
5017;34;626112905;5017;178;5792;5827;9.49;0.58;249.48;4.33;775;34;1997.00;35
5018;34;626112918;5018;184;5794;5830;9.56;0.58;249.49;4.33;776;34;1998.00;36
5022;34;626112930;5022;186;5796;5830;9.58;0.58;249.55;4.33;774;34;1999.00;34
5023;34;626112943;5023;184;5798;5830;9.58;0.58;249.51;4.35;775;34;2000.00;32
5025;34;626112958;5025;184;5799;5830;9.55;0.58;249.52;4.35;774;34;2001.00;31
5026;34;626112974;5026;190;5803;5834;9.53;0.58;249.57;4.36;777;34;2002.00;31
5031;34;626112992;5031;191;5804;5834;9.55;0.58;249.68;4.37;773;34;2003.00;30
5031;34;626113018;5031;193;5806;5834;9.52;0.58;249.68;4.37;775;34;2004.00;28
5033;34;626113034;5033;195;5808;5834;9.46;0.58;249.73;4.39;775;34;2005.00;26
5035;34;626113058;5035;198;5808;5835;9.37;0.57;249.74;4.39;773;34;2006.00;27
5036;34;626113072;5036;201;5810;5836;9.31;0.57;249.72;4.39;774;34;2007.00;26
5038;34;626113090;5038;205;5810;5836;9.24;0.56;249.69;4.39;772;34;2008.00;26
5041;34;626113105;5041;209;5813;5837;9.24;0.56;249.67;4.41;772;34;2009.00;24
5046;34;626113119;5046;214;5813;5837;9.16;0.56;249.59;4.41;767;34;2010.00;24
5046;34;626113132;5046;218;5815;5837;9.12;0.56;249.59;4.42;769;34;2011.00;22
5049;34;626113144;5049;222;5815;5837;9.06;0.55;249.62;4.42;766;34;2012.00;22
5050;34;626113155;5050;225;5817;5837;8.99;0.55;249.62;4.43;767;34;2013.00;20
5053;34;626113167;5053;233;5818;5837;8.85;0.54;249.64;4.44;765;34;2014.00;19
5057;34;626113179;5057;239;5818;5837;8.72;0.53;249.57;4.44;761;34;2015.00;19
5063;34;626113190;5063;261;5880;5964;8.76;0.54;249.69;4.40;817;34;2016.00;84
5065;34;626113215;5065;264;5881;5965;8.66;0.54;249.61;4.40;816;34;2017.00;84
5067;34;626113226;5067;267;5892;5965;8.65;0.53;249.56;4.40;825;34;2018.00;73
5068;34;626113236;5068;264;5898;5965;8.62;0.53;249.52;4.40;830;34;2019.00;67
5070;34;626113246;5070;260;5907;5965;8.58;0.53;249.48;4.41;837;34;2020.00;58
5074;34;626113258;5074;259;5912;5965;8.56;0.53;249.40;4.41;838;34;2021.00;53
5074;34;626113270;5074;255;5919;5965;8.56;0.53;249.40;4.41;845;34;2022.00;46
5074;34;626113282;5074;256;5924;5965;8.43;0.52;249.40;4.42;850;34;2023.00;41
5078;34;626113299;5078;250;5928;5966;8.34;0.51;249.40;4.42;850;34;2024.00;38
5079;34;626113311;5079;255;5935;5968;8.26;0.51;249.35;4.43;856;34;2025.00;33
5083;34;626113323;5083;258;5939;5968;8.28;0.51;249.39;4.43;856;34;2026.00;29
5084;34;626113335;5084;272;5942;5969;8.24;0.51;249.37;4.43;858;34;2027.00;27
5087;34;626113346;5087;280;5945;5969;8.12;0.50;249.37;4.44;858;34;2028.00;24
5088;34;626113358;5088;288;5946;5969;8.08;0.50;249.37;4.44;858;34;2029.00;23
5089;34;626113369;5089;295;5950;5969;8.02;0.49;249.34;4.44;861;34;2030.00;19
5090;34;626113380;5090;304;5952;5973;7.91;0.49;249.35;4.44;862;34;2031.00;21
5092;34;626113394;5092;306;5954;5973;7.79;0.48;249.36;4.44;862;34;2032.00;19
5096;34;626113405;5096;314;5955;5973;7.62;0.47;249.31;4.44;859;34;2033.00;18
5098;34;626113416;5098;322;5958;5976;7.46;0.46;249.30;4.45;860;34;2034.00;18
5102;34;626113427;5102;324;5958;5976;7.27;0.45;249.27;4.45;856;34;2035.00;18
5103;34;626113444;5103;330;5960;5976;7.17;0.44;249.27;4.45;857;34;2036.00;16
5107;34;626113455;5107;343;5964;5980;7.01;0.43;249.24;4.44;857;34;2037.00;16
5111;34;626113468;5111;348;5966;5981;6.88;0.42;249.13;4.44;855;34;2038.00;15
5115;34;626113484;5115;355;5966;5981;6.74;0.41;249.07;4.44;851;34;2039.00;15
5118;34;626113496;5118;348;5971;5986;6.65;0.41;249.10;4.44;853;34;2040.00;15
5120;34;626113506;5120;348;5971;5986;6.54;0.40;249.10;4.44;851;34;2041.00;15
5123;34;626113516;5123;347;5971;5986;6.41;0.39;249.13;4.44;848;34;2042.00;15
5124;34;626113526;5124;330;5972;5987;6.40;0.39;249.11;4.44;848;34;2043.00;15
5128;34;626113536;5128;327;5972;5987;6.37;0.39;249.13;4.44;844;34;2044.00;15
5130;34;626113546;5130;320;5977;5993;6.43;0.39;249.19;4.44;847;34;2045.00;16
5131;34;626113558;5131;324;5977;5993;6.50;0.40;249.18;4.44;846;34;2046.00;16
5135;34;626113569;5135;311;5979;5994;6.51;0.40;249.14;4.44;844;34;2047.00;15
5136;34;626113583;5136;297;5979;5994;6.63;0.41;249.18;4.44;843;34;2048.00;15
5137;34;626113599;5137;296;5979;5994;6.74;0.41;249.22;4.44;842;34;2049.00;15
5140;34;626113626;5140;291;5979;5994;6.85;0.42;249.23;4.44;839;34;2050.00;15
5144;34;626113643;5144;285;5979;5994;6.91;0.42;249.18;4.44;835;34;2051.00;15
5145;34;626113656;5145;277;5990;6006;7.08;0.43;249.22;4.43;845;34;2052.00;16
5148;34;626113670;5148;276;5990;6006;7.19;0.44;249.21;4.43;842;34;2053.00;16
5151;34;626113681;5151;285;5991;6006;7.30;0.45;249.21;4.43;840;34;2054.00;15
5153;34;626113693;5153;280;5991;6006;7.40;0.45;249.20;4.43;838;34;2055.00;15
5156;34;626113705;5156;279;5991;6006;7.46;0.46;249.24;4.43;835;34;2056.00;15
5158;34;626113723;5158;276;5991;6006;7.54;0.46;249.23;4.43;833;34;2057.00;15
5161;34;626113734;5161;281;5995;6010;7.59;0.46;249.24;4.43;834;34;2058.00;15
5164;34;626113747;5164;283;5995;6010;7.69;0.47;249.25;4.43;831;34;2059.00;15
5165;34;626113759;5165;279;5998;6014;7.80;0.48;249.26;4.42;833;34;2060.00;16
5170;34;626113772;5170;269;5999;6015;7.87;0.48;249.24;4.42;829;34;2061.00;16
5172;34;626113785;5172;265;6000;6015;7.88;0.48;249.18;4.42;828;34;2062.00;15
5177;34;626113797;5177;264;6000;6015;7.79;0.47;249.32;4.42;823;34;2063.00;15
5180;34;626113811;5180;266;6013;6028;7.85;0.48;249.35;4.41;833;34;2064.00;15
5183;34;626113825;5183;266;6013;6028;7.85;0.48;249.39;4.41;830;34;2065.00;15
5188;34;626113840;5188;268;6013;6028;7.84;0.48;249.50;4.41;825;34;2066.00;15
5192;34;626113853;5192;263;6014;6029;7.85;0.48;249.57;4.41;822;34;2067.00;15
5197;34;626113867;5197;260;6015;6030;7.79;0.47;249.59;4.41;818;34;2068.00;15
5199;34;626113880;5199;256;6015;6030;7.74;0.47;249.70;4.41;816;34;2069.00;15
5202;34;626113893;5202;262;6018;6036;7.83;0.48;249.84;4.41;816;34;2070.00;18
5205;34;626113906;5205;262;6018;6036;7.79;0.47;249.96;4.41;813;34;2071.00;18
5211;34;626113924;5211;263;6019;6036;7.78;0.47;250.13;4.41;808;34;2072.00;17
5215;34;626113938;5215;259;6019;6036;7.74;0.47;250.18;4.41;804;34;2073.00;17
5219;34;626113950;5219;259;6024;6042;7.74;0.47;250.08;4.41;805;34;2074.00;18
5225;34;626113965;5225;260;6024;6042;7.75;0.47;250.22;4.41;799;34;2075.00;18
5234;34;626113982;5234;264;6026;6042;7.74;0.47;250.26;4.45;792;34;2076.00;16
5235;34;626113999;5235;267;6026;6042;7.81;0.48;250.30;4.45;791;34;2077.00;16
5240;34;626114018;5240;270;6031;6046;7.84;0.48;250.32;4.45;791;34;2078.00;15
5245;34;626114032;5245;272;6032;6047;7.86;0.48;250.42;4.45;787;34;2079.00;15
5248;34;626114045;5248;270;6033;6047;7.88;0.48;250.35;4.45;785;34;2080.00;14
5251;34;626114058;5251;268;6034;6048;7.89;0.48;250.53;4.45;783;34;2081.00;14
5252;34;626114069;5252;276;6034;6048;7.93;0.48;250.56;4.45;782;34;2082.00;14
5253;34;626114081;5253;281;6034;6048;7.92;0.48;250.53;4.45;781;34;2083.00;14
5256;34;626114093;5256;285;6034;6048;7.92;0.48;250.51;4.45;778;34;2084.00;14
5259;34;626114105;5259;286;6034;6048;7.84;0.48;250.58;4.45;775;34;2085.00;14
5261;34;626114117;5261;290;6034;6048;7.79;0.47;250.58;4.45;773;34;2086.00;14
5265;34;626114129;5265;281;6034;6048;7.73;0.47;250.67;4.45;769;34;2087.00;14
5265;34;626114140;5265;291;6077;6118;7.80;0.48;250.67;4.42;812;34;2088.00;41
5269;34;626114160;5269;286;6079;6119;7.83;0.48;250.65;4.46;810;34;2089.00;40
5275;34;626114172;5275;283;6084;6119;7.92;0.48;250.73;4.46;809;34;2090.00;35
5277;34;626114185;5277;281;6086;6119;8.04;0.49;250.72;4.46;809;34;2091.00;33
5278;34;626114198;5278;284;6090;6119;8.18;0.50;250.74;4.46;812;34;2092.00;29
5283;34;626114210;5283;286;6094;6119;8.29;0.50;250.75;4.46;811;34;2093.00;25
5284;34;626114224;5284;284;6099;6119;8.38;0.51;250.76;4.46;815;34;2094.00;20
5288;34;626114236;5288;285;6102;6119;8.37;0.51;250.74;4.46;814;34;2095.00;17
5290;34;626114249;5290;271;6103;6120;8.40;0.51;250.74;4.46;813;34;2096.00;17
5292;34;626114262;5292;266;6105;6121;8.42;0.51;250.69;4.46;813;34;2097.00;16
5294;34;626114280;5294;254;6105;6121;8.44;0.51;250.71;4.46;811;34;2098.00;16
5298;34;626114293;5298;251;6108;6125;8.41;0.51;250.68;4.46;810;34;2099.00;17
5302;34;626114309;5302;250;6112;6140;8.44;0.51;250.69;4.46;810;34;2100.00;28
5305;34;626114329;5305;242;6112;6140;8.54;0.52;250.65;4.46;807;34;2101.00;28
5306;34;626114343;5306;244;6112;6140;8.62;0.53;250.65;4.46;806;34;2102.00;28
5311;34;626114356;5311;241;6115;6146;8.64;0.53;250.68;4.46;804;34;2103.00;31
5313;34;626114371;5313;242;6115;6146;8.76;0.53;250.72;4.46;802;34;2104.00;31
5314;34;626114383;5314;242;6116;6146;8.82;0.54;250.73;4.46;802;34;2105.00;30
5315;34;626114396;5315;242;6119;6149;8.88;0.54;250.71;4.46;804;34;2106.00;30
5318;34;626114408;5318;234;6119;6149;8.87;0.54;250.73;4.46;801;34;2107.00;30
5321;34;626114421;5321;223;6119;6149;8.91;0.54;250.76;4.46;798;34;2108.00;30
5323;34;626114435;5323;216;6119;6150;8.96;0.55;250.73;4.46;796;34;2109.00;31
5326;34;626114447;5326;210;6120;6151;9.01;0.55;250.68;4.46;794;34;2110.00;31
5329;34;626114461;5329;206;6121;6151;9.06;0.55;250.78;4.46;792;34;2111.00;30
5332;34;626114475;5332;206;6131;6164;9.11;0.55;250.72;4.45;799;34;2112.00;33
5333;34;626114489;5333;196;6132;6164;9.13;0.56;250.74;4.50;799;34;2113.00;32
5335;34;626114502;5335;195;6132;6164;9.20;0.56;250.68;4.50;797;34;2114.00;32
5335;34;626114514;5335;200;6134;6166;9.28;0.56;250.68;4.50;799;34;2115.00;32
5336;34;626114526;5336;197;6134;6166;9.31;0.57;250.69;4.50;798;34;2116.00;32
5339;34;626114539;5339;201;6137;6170;9.33;0.57;250.66;4.50;798;34;2117.00;33
5342;34;626114552;5342;201;6138;6170;9.32;0.57;250.75;4.50;796;34;2118.00;32
5344;34;626114564;5344;202;6141;6174;9.29;0.56;250.72;4.50;797;34;2119.00;33
5346;34;626114576;5346;199;6141;6174;9.30;0.57;250.71;4.50;795;34;2120.00;33
5349;34;626114588;5349;204;6141;6174;9.36;0.57;250.69;4.50;792;34;2121.00;33
5350;34;626114606;5350;203;6142;6174;9.41;0.57;250.67;4.50;792;34;2122.00;32
5354;34;626114618;5354;203;6142;6174;9.45;0.57;250.83;4.50;788;34;2123.00;32
5356;34;626114631;5356;207;6151;6186;9.43;0.57;250.83;4.50;795;34;2124.00;35
5357;34;626114650;5357;212;6151;6186;9.43;0.57;250.83;4.50;794;34;2125.00;35
5359;34;626114662;5359;209;6154;6186;9.46;0.58;250.81;4.51;795;34;2126.00;32
5360;34;626114674;5360;208;6154;6186;9.51;0.58;250.79;4.51;794;34;2127.00;32
5361;34;626114687;5361;218;6158;6186;9.51;0.58;250.82;4.57;797;34;2128.00;28
5362;34;626114699;5362;221;6158;6186;9.53;0.58;250.81;4.57;796;34;2129.00;28
5362;34;626114714;5362;217;6160;6187;9.49;0.58;250.81;4.57;798;34;2130.00;27
5363;34;626114726;5363;213;6161;6187;9.44;0.57;250.79;4.57;798;34;2131.00;26
5366;34;626114739;5366;202;6165;6193;9.43;0.57;250.79;4.57;799;34;2132.00;28
5367;34;626114753;5367;199;6166;6194;9.35;0.57;250.80;4.57;799;34;2133.00;28
5370;34;626114766;5370;196;6167;6194;9.29;0.57;250.77;4.63;797;34;2134.00;27
5372;34;626114778;5372;195;6168;6194;9.21;0.56;250.77;4.63;796;34;2135.00;26
5376;34;626114792;5376;193;6171;6198;9.14;0.56;250.81;4.62;795;34;2136.00;27
5378;34;626114804;5378;186;6172;6198;9.08;0.55;250.80;4.62;794;34;2137.00;26
5383;34;626114816;5383;185;6172;6198;9.00;0.55;250.84;4.62;789;34;2138.00;26
5387;34;626114828;5387;184;6174;6199;9.01;0.55;250.86;4.62;787;34;2139.00;25
5388;34;626114839;5388;187;6177;6203;8.97;0.55;250.88;4.62;789;34;2140.00;26
5392;34;626114850;5392;175;6177;6203;8.99;0.55;250.89;4.62;785;34;2141.00;26
5396;34;626114861;5396;173;6180;6206;8.95;0.55;250.87;4.68;784;34;2142.00;26
5401;34;626114873;5401;171;6181;6206;8.87;0.54;250.84;4.72;780;34;2143.00;25
5404;34;626114884;5404;165;6182;6206;8.95;0.54;250.94;4.72;778;34;2144.00;24
5411;34;626114895;5411;164;6183;6206;8.95;0.54;250.93;4.73;772;34;2145.00;23
5415;34;626114907;5415;163;6187;6210;8.95;0.54;250.96;4.77;772;34;2146.00;23
5420;34;626114919;5420;160;6188;6210;8.89;0.54;251.04;4.80;768;34;2147.00;22
5421;34;626114930;5421;167;6189;6210;8.88;0.54;251.09;4.80;768;34;2148.00;21
5425;34;626114947;5425;170;6189;6210;8.90;0.54;251.21;4.80;764;34;2149.00;21
5427;34;626114959;5427;167;6190;6211;8.83;0.54;251.22;4.84;763;34;2150.00;21
5429;34;626114970;5429;167;6191;6212;8.81;0.54;251.17;4.84;762;34;2151.00;21
5430;34;626114985;5430;163;6192;6212;8.80;0.54;251.13;4.87;762;34;2152.00;20
5432;34;626115000;5432;167;6193;6213;8.84;0.54;251.15;4.87;761;34;2153.00;20
5435;34;626115018;5435;169;6193;6213;8.83;0.54;251.09;4.87;758;34;2154.00;20
5438;34;626115036;5438;173;6194;6213;8.86;0.54;251.08;4.90;756;34;2155.00;19
5439;34;626115054;5439;173;6194;6213;8.89;0.54;251.04;4.90;755;34;2156.00;19
5443;34;626115069;5443;183;6194;6213;8.90;0.54;251.04;4.90;751;34;2157.00;19
5444;34;626115087;5444;187;6194;6213;8.96;0.54;251.03;4.90;750;34;2158.00;19
5445;34;626115102;5445;191;6194;6213;8.98;0.55;251.05;4.90;749;34;2159.00;19
5447;34;626115116;5447;222;6287;6443;8.97;0.56;251.06;4.83;840;34;2160.00;156
5451;34;626115160;5451;215;6288;6444;8.87;0.55;251.13;4.83;837;34;2161.00;156
5452;34;626115173;5452;215;6298;6444;8.93;0.56;251.11;4.82;846;34;2162.00;146
5453;34;626115185;5453;212;6307;6444;8.88;0.55;251.09;4.82;854;34;2163.00;137
5454;34;626115198;5454;208;6314;6444;8.84;0.55;251.08;4.82;860;34;2164.00;130
5454;35;626115211;5454;206;6323;6444;8.74;0.54;251.08;4.82;869;35;2165.00;121
5457;35;626115241;5457;207;6330;6444;8.70;0.54;251.00;4.82;873;35;2166.00;114
5459;35;626115254;5459;214;6336;6444;8.65;0.54;250.98;4.82;877;35;2167.00;108
5461;35;626115273;5461;217;6341;6445;8.68;0.54;250.95;4.82;880;35;2168.00;104
5465;36;626115292;5465;224;6346;6446;8.64;0.54;250.83;4.83;881;36;2169.00;100
5469;36;626115322;5469;227;6351;6446;8.67;0.54;250.90;4.84;882;36;2170.00;95
5472;36;626115335;5472;239;6352;6447;8.65;0.53;250.87;4.84;880;36;2171.00;95
5473;36;626115355;5473;240;6358;6447;8.63;0.53;250.83;4.85;885;36;2172.00;89
5473;36;626115368;5473;248;6364;6447;8.58;0.53;250.83;4.88;891;36;2173.00;83
5476;36;626115380;5476;254;6368;6447;8.55;0.53;250.78;4.88;892;36;2174.00;79
5478;36;626115392;5478;256;6371;6451;8.60;0.53;250.74;4.88;893;36;2175.00;80
5481;36;626115406;5481;262;6378;6451;8.50;0.52;250.74;4.91;897;36;2176.00;73
5484;36;626115420;5484;262;6379;6451;8.38;0.52;250.77;4.91;895;36;2177.00;72
5486;36;626115433;5486;264;6384;6454;8.28;0.51;250.79;4.93;898;36;2178.00;70
5487;36;626115446;5487;276;6388;6454;8.15;0.50;250.76;4.93;901;36;2179.00;66
5491;36;626115458;5491;289;6391;6454;8.02;0.49;250.79;4.94;900;36;2180.00;63
5492;36;626115472;5492;302;6398;6458;7.87;0.48;250.75;4.97;906;36;2181.00;60
5493;36;626115491;5493;310;6403;6459;7.77;0.48;250.72;4.98;910;36;2182.00;56
5496;36;626115504;5496;320;6406;6459;7.65;0.47;250.64;5.00;910;36;2183.00;53
5496;36;626115517;5496;335;6411;6463;7.59;0.47;250.64;5.02;915;36;2184.00;52
5498;36;626115536;5498;342;6412;6463;7.52;0.46;250.61;5.02;914;36;2185.00;51
5499;36;626115549;5499;344;6417;6463;7.37;0.45;250.59;5.03;918;36;2186.00;46
5499;36;626115567;5499;349;6420;6464;7.27;0.45;250.59;5.04;921;36;2187.00;44
5500;36;626115580;5500;355;6421;6464;7.20;0.44;250.55;5.04;921;36;2188.00;43
5502;36;626115599;5502;354;6427;6470;7.22;0.44;250.50;5.05;925;36;2189.00;43
5503;36;626115615;5503;358;6429;6470;7.16;0.44;250.46;5.06;926;36;2190.00;41
5504;36;626115627;5504;360;6429;6471;7.11;0.44;250.45;5.06;925;36;2191.00;42
5508;36;626115646;5508;369;6433;6471;7.00;0.43;250.36;5.07;925;36;2192.00;38
5510;36;626115657;5510;370;6433;6471;6.95;0.43;250.42;5.07;923;36;2193.00;38
5510;36;626115669;5510;376;6434;6471;6.91;0.42;250.42;5.07;924;36;2194.00;37
5510;36;626115681;5510;367;6435;6471;6.90;0.42;250.42;5.08;925;36;2195.00;36
5511;36;626115693;5511;359;6448;6483;6.94;0.43;250.42;5.08;937;36;2196.00;35
5513;36;626115706;5513;352;6452;6483;6.99;0.43;250.37;5.10;939;36;2197.00;31
5514;36;626115719;5514;353;6454;6483;7.03;0.43;250.33;5.11;940;36;2198.00;29
5517;36;626115735;5517;355;6455;6483;7.08;0.43;250.35;5.11;938;36;2199.00;28
5517;36;626115749;5517;349;6456;6483;7.13;0.44;250.35;5.12;939;36;2200.00;27
5519;36;626115768;5519;349;6457;6483;7.13;0.44;250.32;5.12;938;36;2201.00;26
5521;36;626115789;5521;349;6461;6487;7.10;0.43;250.24;5.12;940;36;2202.00;26
5523;36;626115802;5523;348;6461;6487;7.10;0.43;250.26;5.12;938;36;2203.00;26
5525;36;626115815;5525;345;6466;6491;7.11;0.44;250.28;5.12;941;36;2204.00;25
5528;36;626115834;5528;345;6469;6493;7.04;0.43;250.26;5.12;941;36;2205.00;24
5531;36;626115848;5531;346;6469;6493;6.95;0.43;250.30;5.12;938;36;2206.00;24
5536;36;626115860;5536;340;6471;6493;6.83;0.42;250.34;5.13;935;36;2207.00;22
5537;36;626115872;5537;349;6483;6506;6.77;0.41;250.38;5.12;946;36;2208.00;23
5539;36;626115886;5539;350;6484;6506;6.65;0.41;250.36;5.12;945;36;2209.00;22
5540;36;626115897;5540;341;6486;6508;6.55;0.40;250.41;5.12;946;36;2210.00;22
5542;36;626115910;5542;340;6487;6509;6.54;0.40;250.46;5.12;945;36;2211.00;22
5544;36;626115922;5544;333;6487;6510;6.48;0.40;250.47;5.12;943;36;2212.00;23
5547;36;626115934;5547;334;6488;6510;6.46;0.40;250.47;5.12;941;36;2213.00;22
5553;36;626115946;5553;334;6490;6513;6.50;0.40;250.59;5.12;937;36;2214.00;23
5555;36;626115959;5555;331;6491;6513;6.61;0.41;250.53;5.12;936;36;2215.00;22
5560;36;626115972;5560;329;6491;6513;6.63;0.41;250.70;5.12;931;36;2216.00;22
5562;36;626115993;5562;324;6491;6513;6.70;0.41;250.72;5.12;929;36;2217.00;22
5565;36;626116006;5565;315;6496;6519;6.80;0.42;250.83;5.12;931;36;2218.00;23
5568;36;626116020;5568;304;6496;6519;6.86;0.42;250.84;5.12;928;36;2219.00;23
5571;36;626116036;5571;299;6496;6519;6.99;0.43;250.94;5.12;925;36;2220.00;23
5571;36;626116049;5571;301;6497;6519;7.12;0.44;250.94;5.12;926;36;2221.00;22
5575;36;626116060;5575;284;6503;6523;7.22;0.44;251.10;5.15;928;36;2222.00;20
5580;36;626116075;5580;279;6504;6524;7.35;0.45;251.19;5.15;924;36;2223.00;20
5586;36;626116088;5586;276;6505;6524;7.42;0.46;251.35;5.15;919;36;2224.00;19
5588;36;626116101;5588;276;6506;6525;7.51;0.46;251.39;5.15;918;36;2225.00;19
5595;36;626116114;5595;279;6506;6525;7.53;0.46;251.37;5.15;911;36;2226.00;19
5600;36;626116128;5600;274;6506;6525;7.64;0.47;251.55;5.15;906;36;2227.00;19
5606;36;626116141;5606;268;6506;6525;7.70;0.47;251.59;5.15;900;36;2228.00;19
5612;36;626116153;5612;259;6506;6525;7.71;0.47;251.59;5.15;894;36;2229.00;19
5615;36;626116167;5615;258;6506;6525;7.70;0.47;251.63;5.15;891;36;2230.00;19
5619;36;626116180;5619;257;6506;6525;7.73;0.47;251.61;5.15;887;36;2231.00;19
5623;36;626116193;5623;250;6544;6595;7.83;0.48;251.78;5.12;921;36;2232.00;51
5629;36;626116214;5629;252;6545;6596;7.84;0.48;251.83;5.12;916;36;2233.00;51
5634;36;626116228;5634;262;6552;6596;7.93;0.48;251.91;5.12;918;36;2234.00;44
5636;36;626116241;5636;263;6558;6596;7.95;0.49;251.98;5.11;922;36;2235.00;38
5640;36;626116254;5640;267;6562;6596;7.97;0.49;251.99;5.11;922;36;2236.00;34
5644;36;626116268;5644;267;6566;6596;8.01;0.49;251.99;5.11;922;36;2237.00;30
5649;36;626116282;5649;268;6569;6596;8.03;0.49;252.14;5.11;920;36;2238.00;27
5655;36;626116296;5655;277;6571;6596;7.99;0.49;252.14;5.11;916;36;2239.00;25
5659;36;626116309;5659;279;6574;6597;8.03;0.49;252.09;5.11;915;36;2240.00;23
5664;36;626116324;5664;277;6575;6598;8.04;0.49;252.26;5.11;911;36;2241.00;23
5668;36;626116338;5668;290;6576;6598;8.03;0.49;252.41;5.11;908;36;2242.00;22
5672;36;626116353;5672;291;6579;6602;8.07;0.49;252.56;5.11;907;36;2243.00;23
5675;36;626116367;5675;293;6579;6602;8.08;0.49;252.62;5.11;904;36;2244.00;23
5678;36;626116381;5678;292;6579;6602;8.16;0.50;252.67;5.11;901;36;2245.00;23
5682;36;626116395;5682;297;6579;6602;8.17;0.50;252.78;5.11;897;36;2246.00;23
5685;36;626116409;5685;301;6583;6608;8.24;0.50;252.81;5.11;898;36;2247.00;25
5689;36;626116423;5689;302;6584;6608;8.25;0.50;252.97;5.11;895;36;2248.00;24
5694;36;626116437;5694;304;6584;6608;8.28;0.51;253.08;5.11;890;36;2249.00;24
5699;36;626116458;5699;301;6587;6614;8.34;0.51;253.02;5.11;888;36;2250.00;27
5702;36;626116472;5702;306;6587;6614;8.30;0.51;252.95;5.11;885;36;2251.00;27
5707;36;626116486;5707;308;6588;6614;8.23;0.50;253.17;5.11;881;36;2252.00;26
5710;36;626116500;5710;313;6588;6615;8.22;0.50;253.20;5.11;878;36;2253.00;27
5715;37;626116513;5715;321;6590;6616;8.15;0.50;253.30;5.11;875;37;2254.00;26
5719;37;626116538;5719;324;6590;6616;8.05;0.49;253.42;5.11;871;37;2255.00;26
5724;37;626116555;5724;337;6601;6629;8.13;0.50;253.53;5.10;877;37;2256.00;28
5726;37;626116570;5726;326;6602;6629;8.07;0.49;253.58;5.10;876;37;2257.00;27
5731;37;626116583;5731;328;6602;6629;7.97;0.49;253.74;5.10;871;37;2258.00;27
5733;37;626116597;5733;325;6603;6630;7.98;0.49;253.71;5.10;870;37;2259.00;27
5736;37;626116611;5736;328;6603;6630;7.94;0.48;253.88;5.10;867;37;2260.00;27
5739;37;626116625;5739;327;6606;6634;7.90;0.48;253.94;5.09;867;37;2261.00;28
5741;37;626116639;5741;328;6606;6634;7.90;0.48;254.02;5.09;865;37;2262.00;28
5747;37;626116658;5747;324;6610;6638;7.88;0.48;254.03;5.09;863;37;2263.00;28
5753;37;626116678;5753;321;6610;6638;7.89;0.48;254.05;5.09;857;37;2264.00;28
5755;37;626116692;5755;316;6610;6638;7.93;0.48;254.07;5.09;855;37;2265.00;28
5762;37;626116704;5762;299;6610;6638;7.96;0.49;254.05;5.09;848;37;2266.00;28
5768;37;626116723;5768;282;6610;6638;7.98;0.49;254.11;5.09;842;37;2267.00;28
5771;37;626116736;5771;272;6620;6650;8.06;0.49;254.08;5.09;849;37;2268.00;30
5774;37;626116751;5774;258;6620;6650;8.13;0.50;254.18;5.09;846;37;2269.00;30
5778;37;626116770;5778;254;6621;6650;8.26;0.50;254.16;5.08;843;37;2270.00;29
5780;37;626116784;5780;249;6621;6650;8.31;0.51;254.22;5.08;841;37;2271.00;29
5783;37;626116798;5783;246;6621;6650;8.34;0.51;254.23;5.08;838;37;2272.00;29
5786;37;626116812;5786;241;6621;6650;8.36;0.51;254.21;5.08;835;37;2273.00;29
5789;37;626116825;5789;241;6621;6651;8.45;0.51;254.30;5.08;832;37;2274.00;30
5791;37;626116839;5791;237;6621;6651;8.52;0.52;254.31;5.08;830;37;2275.00;30
5797;37;626116852;5797;232;6625;6657;8.50;0.52;254.43;5.08;828;37;2276.00;32
5798;37;626116866;5798;223;6627;6658;8.54;0.52;254.43;5.08;829;37;2277.00;31
5799;37;626116879;5799;223;6627;6658;8.54;0.52;254.41;5.08;828;37;2278.00;31
5801;37;626116893;5801;217;6627;6658;8.59;0.52;254.43;5.08;826;37;2279.00;31
5805;37;626116908;5805;222;6631;6663;8.64;0.52;254.45;5.08;826;37;2280.00;32
5809;37;626116921;5809;217;6631;6663;8.61;0.52;254.41;5.08;822;37;2281.00;32
5810;37;626116935;5810;212;6631;6663;8.64;0.53;254.39;5.08;821;37;2282.00;32
5812;37;626116948;5812;208;6632;6664;8.71;0.53;254.37;5.08;820;37;2283.00;32
5813;37;626116960;5813;205;6635;6668;8.76;0.53;254.36;5.08;822;37;2284.00;33
5816;37;626116974;5816;197;6635;6668;8.74;0.53;254.33;5.08;819;37;2285.00;33
5818;37;626116991;5818;195;6637;6671;8.79;0.53;254.47;5.07;819;37;2286.00;34
5820;37;626117008;5820;188;6637;6671;8.79;0.53;254.49;5.07;817;37;2287.00;34
5822;37;626117023;5822;189;6638;6671;8.76;0.53;254.47;5.07;816;37;2288.00;33
5824;37;626117052;5824;187;6638;6671;8.74;0.53;254.45;5.07;814;37;2289.00;33
5826;37;626117069;5826;187;6641;6675;8.75;0.53;254.43;5.07;815;37;2290.00;34
5827;37;626117085;5827;194;6641;6675;8.79;0.53;254.41;5.07;814;37;2291.00;34
5830;37;626117112;5830;192;6642;6675;8.87;0.54;254.46;5.07;812;37;2292.00;33
5830;37;626117126;5830;190;6642;6675;8.89;0.54;254.46;5.07;812;37;2293.00;33
5833;37;626117138;5833;194;6642;6676;8.91;0.54;254.46;5.07;809;37;2294.00;34
5836;37;626117151;5836;191;6644;6678;8.87;0.54;254.48;5.07;808;37;2295.00;34
5841;37;626117165;5841;189;6644;6678;8.81;0.53;254.40;5.07;803;37;2296.00;34
5841;37;626117183;5841;191;6645;6679;8.78;0.53;254.40;5.07;804;37;2297.00;34
5843;37;626117195;5843;194;6645;6679;8.64;0.52;254.39;5.07;802;37;2298.00;34
5843;37;626117207;5843;197;6646;6679;8.59;0.52;254.39;5.11;803;37;2299.00;33
5845;37;626117220;5845;200;6646;6679;8.56;0.52;254.38;5.11;801;37;2300.00;33
5846;37;626117236;5846;195;6646;6679;8.50;0.52;254.35;5.11;800;37;2301.00;33
5847;37;626117247;5847;193;6646;6679;8.48;0.51;254.33;5.11;799;37;2302.00;33
5852;37;626117265;5852;197;6646;6679;8.41;0.51;254.36;5.11;794;37;2303.00;33
5853;37;626117280;5853;229;6719;6806;8.31;0.51;254.38;5.06;866;37;2304.00;87
5853;37;626117310;5853;215;6719;6807;8.23;0.51;254.38;5.06;866;37;2305.00;88
5856;37;626117326;5856;207;6726;6807;8.26;0.51;254.40;5.05;870;37;2306.00;81
5859;37;626117343;5859;200;6727;6807;8.26;0.51;254.43;5.05;868;37;2307.00;80
5859;37;626117361;5859;206;6732;6807;8.27;0.51;254.43;5.05;873;37;2308.00;75
5864;37;626117377;5864;207;6735;6807;8.29;0.51;254.44;5.05;871;37;2309.00;72
5865;37;626117396;5865;203;6739;6807;8.31;0.51;254.53;5.05;874;37;2310.00;68
5867;38;626117411;5867;198;6741;6807;8.25;0.51;254.53;5.05;874;38;2311.00;66
5869;38;626117442;5869;196;6745;6808;8.22;0.50;254.55;5.05;876;38;2312.00;63
5872;38;626117459;5872;197;6748;6809;8.22;0.50;254.58;5.06;876;38;2313.00;61
5874;38;626117476;5874;194;6752;6809;8.20;0.50;254.57;5.06;878;38;2314.00;57
5878;38;626117492;5878;190;6755;6810;8.12;0.50;254.47;5.07;877;38;2315.00;55
5879;38;626117518;5879;187;6759;6810;8.10;0.50;254.50;5.08;880;38;2316.00;51
5881;38;626117533;5881;189;6761;6810;8.03;0.49;254.44;5.08;880;38;2317.00;49
5886;38;626117548;5886;189;6763;6810;7.87;0.48;254.35;5.08;877;38;2318.00;47
5888;38;626117565;5888;183;6766;6814;7.79;0.48;254.36;5.08;878;38;2319.00;48
5891;38;626117580;5891;185;6768;6814;7.75;0.47;254.30;5.08;877;38;2320.00;46
5891;38;626117592;5891;194;6768;6814;7.69;0.47;254.30;5.08;877;38;2321.00;46
5895;38;626117604;5895;197;6771;6817;7.70;0.47;254.24;5.08;876;38;2322.00;46
5896;38;626117617;5896;195;6771;6817;7.69;0.47;254.25;5.08;875;38;2323.00;46
5900;38;626117629;5900;199;6772;6817;7.66;0.47;254.28;5.08;872;38;2324.00;45
5902;38;626117643;5902;204;6775;6821;7.65;0.47;254.25;5.08;873;38;2325.00;46
5902;38;626117655;5902;207;6777;6822;7.70;0.47;254.25;5.08;875;38;2326.00;45
5905;38;626117667;5905;219;6778;6822;7.71;0.47;254.25;5.08;873;38;2327.00;44
5907;38;626117679;5907;223;6781;6826;7.68;0.47;254.19;5.08;874;38;2328.00;45
5908;38;626117691;5908;225;6781;6826;7.63;0.46;254.15;5.08;873;38;2329.00;45
5910;38;626117703;5910;231;6781;6826;7.54;0.46;254.09;5.08;871;38;2330.00;45
5913;38;626117715;5913;233;6782;6827;7.50;0.46;254.13;5.08;869;38;2331.00;45
5915;38;626117726;5915;237;6782;6827;7.44;0.45;254.11;5.08;867;38;2332.00;45
5915;38;626117738;5915;248;6786;6833;7.47;0.45;254.11;5.08;871;38;2333.00;47
5917;38;626117750;5917;251;6787;6833;7.46;0.45;254.19;5.08;870;38;2334.00;46
5920;38;626117762;5920;253;6787;6834;7.42;0.45;254.11;5.08;867;38;2335.00;47
5921;38;626117775;5921;265;6788;6834;7.38;0.45;254.12;5.09;867;38;2336.00;46
5922;38;626117787;5922;267;6788;6834;7.34;0.45;254.13;5.09;866;38;2337.00;46
5922;38;626117798;5922;271;6788;6834;7.31;0.45;254.13;5.09;866;38;2338.00;46
5925;38;626117810;5925;279;6790;6834;7.22;0.44;254.12;5.11;865;38;2339.00;44
5928;38;626117824;5928;286;6811;6870;7.26;0.44;254.07;5.10;883;38;2340.00;59
5928;38;626117839;5928;292;6811;6870;7.24;0.44;254.07;5.10;883;38;2341.00;59
5929;38;626117851;5929;295;6815;6870;7.23;0.44;254.08;5.11;886;38;2342.00;55
5930;38;626117863;5930;301;6818;6870;7.20;0.44;254.09;5.12;888;38;2343.00;52
5933;38;626117874;5933;299;6821;6870;7.17;0.44;254.08;5.12;888;38;2344.00;49
5934;38;626117886;5934;302;6823;6870;7.14;0.43;254.08;5.14;889;38;2345.00;47
5935;38;626117898;5935;309;6827;6874;7.08;0.43;254.07;5.14;892;38;2346.00;47
5936;38;626117910;5936;296;6830;6874;7.06;0.43;254.08;5.16;894;38;2347.00;44
5938;38;626117922;5938;294;6834;6878;7.02;0.43;254.02;5.16;896;38;2348.00;44
5938;38;626117935;5938;289;6837;6879;6.97;0.42;254.02;5.17;899;38;2349.00;42
5939;38;626117946;5939;287;6838;6879;6.91;0.42;254.02;5.17;899;38;2350.00;41
5940;38;626117958;5940;282;6839;6879;6.91;0.42;254.03;5.18;899;38;2351.00;40
5942;38;626117970;5942;285;6851;6892;6.84;0.42;253.97;5.17;909;38;2352.00;41
5943;38;626117985;5943;276;6852;6892;6.84;0.42;253.98;5.19;909;38;2353.00;40
5943;38;626117997;5943;285;6853;6892;6.89;0.42;253.98;5.20;910;38;2354.00;39
5943;38;626118008;5943;283;6855;6893;6.94;0.43;253.98;5.20;912;38;2355.00;38
5943;38;626118025;5943;285;6856;6894;6.95;0.43;253.98;5.21;913;38;2356.00;38
5946;38;626118046;5946;290;6857;6894;6.94;0.43;253.93;5.21;911;38;2357.00;37
5947;38;626118067;5947;293;6860;6897;6.97;0.43;253.89;5.21;913;38;2358.00;37
5948;38;626118083;5948;292;6860;6897;7.02;0.43;253.87;5.21;912;38;2359.00;37
5950;38;626118096;5950;291;6862;6897;7.09;0.43;253.87;5.22;912;38;2360.00;35
5952;38;626118112;5952;295;6862;6897;7.15;0.44;253.82;5.22;910;38;2361.00;35
5953;38;626118124;5953;286;6867;6903;7.18;0.44;253.84;5.22;914;38;2362.00;36
5955;38;626118136;5955;285;6868;6903;7.16;0.44;253.83;5.23;913;38;2363.00;35
5955;38;626118148;5955;282;6869;6903;7.18;0.44;253.83;5.22;914;38;2364.00;34
5956;38;626118160;5956;280;6869;6903;7.19;0.44;253.84;5.22;913;38;2365.00;34
5957;38;626118172;5957;285;6875;6907;7.19;0.44;253.83;5.25;918;38;2366.00;32
5957;38;626118183;5957;288;6876;6908;7.23;0.44;253.83;5.25;919;38;2367.00;32
5960;38;626118194;5960;286;6876;6908;7.22;0.44;253.75;5.25;916;38;2368.00;32
5961;38;626118206;5961;288;6878;6909;7.21;0.44;253.73;5.25;917;38;2369.00;31
5964;38;626118219;5964;286;6878;6909;7.18;0.44;253.75;5.25;914;38;2370.00;31
5965;38;626118231;5965;291;6881;6909;7.15;0.44;253.73;5.27;916;38;2371.00;28
5972;38;626118242;5972;292;6881;6909;7.13;0.44;253.77;5.27;909;38;2372.00;28
5973;38;626118254;5973;289;6882;6909;7.10;0.43;253.78;5.27;909;38;2373.00;27
5977;38;626118265;5977;290;6882;6909;7.07;0.43;253.82;5.27;905;38;2374.00;27
5979;38;626118276;5979;292;6884;6909;7.02;0.43;253.84;5.28;905;38;2375.00;25
5983;38;626118287;5983;302;6923;6979;7.11;0.44;253.82;5.25;940;38;2376.00;56
5986;38;626118305;5986;296;6926;6980;7.07;0.43;253.76;5.25;940;38;2377.00;54
5990;38;626118317;5990;292;6932;6980;6.98;0.43;253.76;5.25;942;38;2378.00;48
5997;38;626118328;5997;300;6933;6980;6.80;0.42;253.83;5.25;936;38;2379.00;47
5998;38;626118339;5998;288;6940;6980;6.83;0.42;253.82;5.25;942;38;2380.00;40
6007;38;626118351;6007;286;6943;6980;6.67;0.41;253.77;5.25;936;38;2381.00;37
6011;38;626118363;6011;284;6948;6980;6.67;0.41;253.91;5.25;937;38;2382.00;32
6013;38;626118375;6013;290;6951;6980;6.70;0.41;253.91;5.25;938;38;2383.00;29
6019;38;626118386;6019;292;6956;6981;6.70;0.41;254.04;5.25;937;38;2384.00;25
6024;38;626118399;6024;302;6959;6983;6.75;0.41;254.20;5.25;935;38;2385.00;24
6027;38;626118412;6027;301;6959;6983;6.85;0.42;254.22;5.25;932;38;2386.00;24
6030;38;626118423;6030;304;6963;6987;6.90;0.42;254.30;5.25;933;38;2387.00;24
6033;38;626118436;6033;295;6963;6987;6.95;0.43;254.40;5.25;930;38;2388.00;24
6037;38;626118447;6037;291;6963;6987;7.03;0.43;254.46;5.25;926;38;2389.00;24
6041;38;626118458;6041;294;6963;6987;7.10;0.44;254.51;5.25;922;38;2390.00;24
6046;38;626118470;6046;294;6968;6993;7.13;0.44;254.64;5.24;922;38;2391.00;25
6050;38;626118483;6050;293;6969;6993;7.25;0.44;254.74;5.24;919;38;2392.00;24
6053;38;626118494;6053;296;6969;6993;7.27;0.44;254.78;5.24;916;38;2393.00;24
6058;38;626118506;6058;296;6971;6996;7.35;0.45;254.94;5.24;913;38;2394.00;25
6060;38;626118519;6060;295;6971;6996;7.41;0.45;254.99;5.24;911;38;2395.00;25
6063;38;626118530;6063;289;6972;6996;7.51;0.46;254.98;5.24;909;38;2396.00;24
6068;38;626118542;6068;285;6972;6997;7.59;0.46;255.06;5.24;904;38;2397.00;25
6075;38;626118553;6075;283;6974;6998;7.59;0.46;255.16;5.24;899;38;2398.00;24
6080;38;626118565;6080;281;6974;6998;7.57;0.46;255.12;5.24;894;38;2399.00;24
6084;38;626118580;6084;289;6999;7057;7.58;0.46;255.14;5.22;915;38;2400.00;58
6088;38;626118604;6088;274;7001;7057;7.57;0.46;255.21;5.22;913;38;2401.00;56
6097;38;626118617;6097;270;7003;7057;7.56;0.46;255.25;5.22;906;38;2402.00;54
6097;38;626118631;6097;271;7004;7058;7.62;0.47;255.25;5.22;907;38;2403.00;54
6105;38;626118644;6105;274;7006;7058;7.63;0.47;255.38;5.22;901;38;2404.00;52
6108;38;626118658;6108;270;7008;7062;7.65;0.47;255.41;5.22;900;38;2405.00;54
6112;39;626118672;6112;274;7011;7062;7.64;0.47;255.37;5.22;899;39;2406.00;51
6115;39;626118696;6115;271;7014;7066;7.75;0.47;255.42;5.22;899;39;2407.00;52
6118;39;626118711;6118;274;7015;7066;7.77;0.48;255.47;5.22;897;39;2408.00;51
6127;39;626118724;6127;277;7016;7066;7.74;0.47;255.66;5.22;889;39;2409.00;50
6131;39;626118738;6131;272;7016;7066;7.75;0.47;255.72;5.22;885;39;2410.00;50
6134;39;626118751;6134;278;7017;7066;7.69;0.47;255.70;5.22;883;39;2411.00;49
6139;39;626118765;6139;282;7025;7078;7.67;0.47;255.86;5.21;886;39;2412.00;53
6145;39;626118780;6145;287;7025;7078;7.62;0.47;255.94;5.21;880;39;2413.00;53
6147;39;626118793;6147;287;7027;7078;7.67;0.47;255.98;5.21;880;39;2414.00;51
6153;39;626118807;6153;289;7028;7078;7.64;0.47;256.07;5.22;875;39;2415.00;50
6156;39;626118820;6156;290;7028;7078;7.67;0.47;256.16;5.22;872;39;2416.00;50
6158;39;626118837;6158;287;7028;7078;7.71;0.47;256.15;5.22;870;39;2417.00;50
6160;39;626118850;6160;294;7029;7079;7.72;0.47;256.21;5.22;869;39;2418.00;50
6162;39;626118863;6162;289;7029;7079;7.67;0.47;256.21;5.22;867;39;2419.00;50
6165;39;626118877;6165;296;7035;7085;7.71;0.47;256.19;5.28;870;39;2420.00;50
6170;39;626118894;6170;299;7037;7086;7.75;0.47;256.27;5.28;867;39;2421.00;49
6174;39;626118907;6174;299;7037;7086;7.75;0.47;256.40;5.28;863;39;2422.00;49
6178;39;626118921;6178;302;7037;7086;7.74;0.47;256.41;5.28;859;39;2423.00;49
6180;39;626118934;6180;303;7040;7090;7.79;0.48;256.44;5.28;860;39;2424.00;50
6185;39;626118947;6185;305;7040;7090;7.74;0.47;256.59;5.28;855;39;2425.00;50
6187;39;626118961;6187;308;7042;7090;7.73;0.47;256.63;5.28;855;39;2426.00;48
6190;39;626118975;6190;290;7044;7091;7.69;0.47;256.66;5.28;854;39;2427.00;47
6194;39;626118993;6194;284;7049;7095;7.65;0.47;256.78;5.29;855;39;2428.00;46
6199;39;626119015;6199;282;7050;7095;7.59;0.46;256.76;5.29;851;39;2429.00;45
6202;39;626119035;6202;277;7054;7101;7.64;0.46;256.82;5.28;852;39;2430.00;47
6204;39;626119058;6204;272;7054;7101;7.68;0.47;256.85;5.28;850;39;2431.00;47
6206;39;626119078;6206;272;7054;7101;7.71;0.47;256.86;5.28;848;39;2432.00;47
6212;39;626119099;6212;272;7056;7101;7.71;0.47;257.06;5.29;844;39;2433.00;45
6214;39;626119116;6214;277;7058;7105;7.75;0.47;257.13;5.29;844;39;2434.00;47
6215;39;626119131;6215;281;7059;7105;7.75;0.47;257.11;5.29;844;39;2435.00;46
6219;39;626119146;6219;270;7059;7105;7.71;0.47;257.19;5.29;840;39;2436.00;46
6222;39;626119160;6222;263;7059;7105;7.82;0.48;257.25;5.29;837;39;2437.00;46
6224;39;626119175;6224;256;7060;7106;7.94;0.48;257.21;5.29;836;39;2438.00;46
6229;39;626119190;6229;251;7063;7107;8.05;0.49;257.43;5.29;834;39;2439.00;44
6232;39;626119205;6232;244;7063;7107;8.15;0.49;257.50;5.29;831;39;2440.00;44
6233;39;626119237;6233;237;7064;7108;8.25;0.50;257.56;5.29;831;39;2441.00;44
6236;39;626119252;6236;229;7064;7108;8.27;0.50;257.63;5.29;828;39;2442.00;44
6237;39;626119266;6237;225;7064;7108;8.37;0.51;257.63;5.29;827;39;2443.00;44
6240;39;626119279;6240;220;7064;7108;8.41;0.51;257.67;5.29;824;39;2444.00;44
6244;39;626119292;6244;224;7065;7108;8.44;0.51;257.67;5.29;821;39;2445.00;43
6246;39;626119305;6246;217;7065;7108;8.52;0.52;257.68;5.29;819;39;2446.00;43
6249;39;626119319;6249;212;7065;7108;8.60;0.52;257.81;5.29;816;39;2447.00;43
6253;39;626119333;6253;223;7126;7235;8.78;0.54;257.93;5.25;873;39;2448.00;109
6255;39;626119360;6255;213;7130;7236;8.89;0.55;257.98;5.25;875;39;2449.00;106
6259;39;626119374;6259;202;7137;7236;8.94;0.55;258.02;5.24;878;39;2450.00;99
6262;39;626119395;6262;204;7140;7236;8.96;0.55;258.09;5.25;878;39;2451.00;96
6264;39;626119409;6264;194;7145;7236;9.00;0.55;258.08;5.25;881;39;2452.00;91
6268;39;626119423;6268;189;7146;7236;9.01;0.55;258.16;5.25;878;39;2453.00;90
6271;39;626119437;6271;192;7151;7236;9.08;0.56;258.20;5.25;880;39;2454.00;85
6273;39;626119450;6273;199;7157;7236;9.13;0.56;258.29;5.25;884;39;2455.00;79
6276;39;626119464;6276;198;7161;7237;9.15;0.56;258.33;5.31;885;39;2456.00;76
6279;39;626119479;6279;200;7164;7238;9.14;0.56;258.43;5.31;885;39;2457.00;74
6280;39;626119493;6280;205;7169;7238;9.14;0.56;258.41;5.36;889;39;2458.00;69
6283;39;626119506;6283;202;7172;7239;9.10;0.56;258.54;5.36;889;39;2459.00;67
6284;39;626119522;6284;216;7175;7239;9.06;0.55;258.52;5.36;891;39;2460.00;64
6284;39;626119537;6284;222;7178;7239;9.00;0.55;258.52;5.37;894;39;2461.00;61
6287;39;626119550;6287;235;7182;7239;8.94;0.55;258.58;5.38;895;39;2462.00;57
6288;39;626119564;6288;237;7185;7243;8.88;0.54;258.57;5.38;897;39;2463.00;58
6290;39;626119578;6290;245;7186;7243;8.75;0.54;258.61;5.38;896;39;2464.00;57
6291;39;626119593;6291;254;7188;7243;8.65;0.53;258.58;5.38;897;39;2465.00;55
6292;39;626119606;6292;251;7190;7246;8.57;0.52;258.57;5.38;898;39;2466.00;56
6295;39;626119620;6295;255;7191;7246;8.41;0.51;258.56;5.38;896;39;2467.00;55
6298;39;626119639;6298;267;7193;7246;8.29;0.51;258.47;5.39;895;39;2468.00;53
6302;39;626119653;6302;269;7197;7250;8.14;0.50;258.39;5.39;895;39;2469.00;53
6304;39;626119667;6304;270;7200;7251;8.08;0.49;258.39;5.40;896;39;2470.00;51
6308;39;626119681;6308;265;7202;7251;7.97;0.49;258.33;5.44;894;39;2471.00;49
6310;39;626119694;6310;264;7204;7255;7.93;0.49;258.30;5.44;894;39;2472.00;51
6311;39;626119707;6311;259;7204;7255;7.88;0.48;258.33;5.44;893;39;2473.00;51
6314;39;626119719;6314;254;7204;7255;7.80;0.48;258.28;5.44;890;39;2474.00;51
6317;39;626119730;6317;260;7207;7257;7.74;0.47;258.23;5.48;890;39;2475.00;50
6319;39;626119743;6319;259;7207;7257;7.70;0.47;258.19;5.48;888;39;2476.00;50
6321;39;626119754;6321;252;7212;7263;7.66;0.47;258.13;5.52;891;39;2477.00;51
6326;39;626119766;6326;253;7213;7263;7.58;0.46;258.12;5.52;887;39;2478.00;50
6327;39;626119785;6327;248;7214;7264;7.53;0.46;258.11;5.56;887;39;2479.00;50
6332;39;626119798;6332;247;7214;7264;7.39;0.45;258.02;5.56;882;39;2480.00;50
6335;39;626119810;6335;248;7214;7264;7.29;0.44;258.04;5.56;879;39;2481.00;50
6338;39;626119822;6338;242;7215;7264;7.22;0.44;258.00;5.61;877;39;2482.00;49
6340;39;626119834;6340;234;7215;7264;7.15;0.44;258.01;5.61;875;39;2483.00;49
6344;39;626119846;6344;233;7225;7276;7.16;0.44;257.99;5.64;881;39;2484.00;51
6345;39;626119864;6345;228;7228;7276;7.07;0.43;257.95;5.66;883;39;2485.00;48
6347;39;626119877;6347;230;7229;7276;7.08;0.43;257.92;5.66;882;39;2486.00;47
6351;39;626119889;6351;232;7230;7276;7.02;0.43;257.93;5.71;879;39;2487.00;46
6352;39;626119900;6352;240;7230;7276;7.05;0.43;257.90;5.71;878;39;2488.00;46
6354;39;626119911;6354;240;7231;7276;7.05;0.43;257.95;5.75;877;39;2489.00;45
6355;39;626119924;6355;241;7234;7280;7.09;0.43;257.93;5.75;879;39;2490.00;46
6360;39;626119936;6360;241;7235;7280;7.09;0.43;258.04;5.80;875;39;2491.00;45
6360;39;626119949;6360;246;7238;7284;7.13;0.43;258.04;5.79;878;39;2492.00;46
6362;39;626119961;6362;244;7240;7285;7.16;0.43;258.04;5.79;878;39;2493.00;45
6363;39;626119973;6363;248;7240;7285;7.23;0.44;258.02;5.79;877;39;2494.00;45
6363;39;626119985;6363;250;7241;7285;7.29;0.44;258.02;5.84;878;39;2495.00;44
6365;39;626119999;6365;256;7250;7298;7.29;0.44;257.96;5.84;885;39;2496.00;48
6368;39;626120011;6368;252;7250;7298;7.30;0.44;257.94;5.84;882;39;2497.00;48
6370;39;626120026;6370;261;7251;7298;7.27;0.44;257.89;5.84;881;39;2498.00;47
6371;39;626120040;6371;248;7252;7299;7.35;0.45;257.87;5.84;881;39;2499.00;47
6373;39;626120053;6373;242;7252;7300;7.40;0.45;257.85;5.84;879;39;2500.00;48
6377;39;626120069;6377;232;7252;7300;7.44;0.45;257.83;5.84;875;39;2501.00;48
6377;39;626120081;6377;225;7255;7303;7.56;0.46;257.83;5.85;878;39;2502.00;48
6378;39;626120093;6378;216;7256;7303;7.70;0.47;257.80;5.85;878;39;2503.00;47
6380;40;626120105;6380;212;7256;7303;7.74;0.47;257.84;5.85;876;40;2504.00;47
6380;40;626120129;6380;205;7256;7303;7.86;0.48;257.84;5.85;876;40;2505.00;47
6381;40;626120141;6381;200;7260;7309;8.04;0.49;257.85;5.85;879;40;2506.00;49
6381;40;626120154;6381;197;7263;7309;8.14;0.49;257.85;5.87;882;40;2507.00;46
6382;40;626120166;6382;198;7263;7309;8.26;0.50;257.88;5.87;881;40;2508.00;46
6385;40;626120179;6385;195;7264;7309;8.22;0.50;257.85;5.88;879;40;2509.00;45
6385;40;626120191;6385;190;7270;7313;8.22;0.50;257.85;5.90;885;40;2510.00;43
6387;40;626120205;6387;194;7271;7314;8.22;0.50;257.80;5.90;884;40;2511.00;43
6388;40;626120218;6388;196;7273;7314;8.19;0.50;257.77;5.92;885;40;2512.00;41
6388;40;626120235;6388;198;7276;7315;8.16;0.49;257.77;5.93;888;40;2513.00;39
6389;40;626120247;6389;194;7278;7315;8.16;0.49;257.79;5.95;889;40;2514.00;37
6390;40;626120260;6390;197;7278;7315;8.14;0.49;257.77;5.95;888;40;2515.00;37
6390;40;626120272;6390;200;7279;7315;8.17;0.50;257.77;5.96;889;40;2516.00;36
6390;40;626120284;6390;197;7281;7315;8.17;0.50;257.77;5.98;891;40;2517.00;34
6392;40;626120296;6392;196;7281;7315;8.19;0.50;257.82;5.98;889;40;2518.00;34
6393;40;626120313;6393;193;7282;7315;8.21;0.50;257.79;5.99;889;40;2519.00;33
6394;40;626120327;6394;206;7341;7440;8.37;0.51;257.79;5.95;947;40;2520.00;99
6396;40;626120357;6396;199;7345;7441;8.35;0.51;257.80;5.95;949;40;2521.00;96
6398;40;626120370;6398;198;7357;7441;8.34;0.51;257.79;5.96;959;40;2522.00;84
6402;40;626120382;6402;199;7365;7441;8.32;0.51;257.83;5.95;963;40;2523.00;76
6405;40;626120395;6405;203;7369;7441;8.26;0.51;257.82;5.96;964;40;2524.00;72
6405;40;626120407;6405;206;7376;7441;8.25;0.51;257.82;5.96;971;40;2525.00;65
6406;40;626120420;6406;207;7380;7441;8.16;0.50;257.83;5.97;974;40;2526.00;61
6408;40;626120437;6408;215;7386;7441;8.07;0.50;257.91;5.98;978;40;2527.00;55
6410;40;626120449;6410;231;7390;7442;7.99;0.49;257.93;5.98;980;40;2528.00;52
6413;40;626120462;6413;231;7393;7443;7.86;0.48;257.90;5.98;980;40;2529.00;50
6415;40;626120475;6415;230;7396;7443;7.77;0.48;257.90;5.99;981;40;2530.00;47
6418;40;626120488;6418;232;7401;7447;7.65;0.47;257.92;5.99;983;40;2531.00;46
6424;40;626120501;6424;228;7403;7447;7.57;0.47;257.85;6.00;979;40;2532.00;44
6427;40;626120514;6427;230;7404;7447;7.54;0.46;257.87;6.01;977;40;2533.00;43
6429;40;626120528;6429;233;7406;7447;7.52;0.46;257.86;6.01;977;40;2534.00;41
6430;40;626120540;6430;232;7412;7453;7.57;0.47;257.85;6.01;982;40;2535.00;41
6431;40;626120555;6431;234;7413;7453;7.59;0.47;257.83;6.01;982;40;2536.00;40
6434;40;626120573;6434;239;7415;7455;7.60;0.47;257.85;6.02;981;40;2537.00;40
6438;40;626120586;6438;248;7417;7458;7.62;0.47;257.92;6.02;979;40;2538.00;41
6439;40;626120600;6439;255;7418;7458;7.60;0.47;257.90;6.02;979;40;2539.00;40
6443;40;626120614;6443;257;7419;7458;7.59;0.46;257.94;6.03;976;40;2540.00;39
6446;40;626120627;6446;264;7421;7459;7.52;0.46;257.99;6.04;975;40;2541.00;38
6452;40;626120640;6452;264;7424;7460;7.48;0.46;258.00;6.05;972;40;2542.00;36
6454;40;626120653;6454;270;7424;7460;7.41;0.45;257.99;6.05;970;40;2543.00;36
6458;40;626120665;6458;278;7435;7473;7.33;0.45;258.02;6.04;977;40;2544.00;38
6463;40;626120679;6463;284;7436;7473;7.29;0.45;258.09;6.04;973;40;2545.00;37
6466;40;626120692;6466;286;7438;7473;7.27;0.45;258.10;6.05;972;40;2546.00;35
6471;40;626120705;6471;292;7440;7474;7.18;0.44;258.31;6.05;969;40;2547.00;34
6476;40;626120717;6476;291;7440;7474;7.11;0.44;258.35;6.05;964;40;2548.00;34
6481;40;626120730;6481;305;7444;7478;7.02;0.43;258.34;6.05;963;40;2549.00;34
6487;40;626120750;6487;294;7447;7481;6.92;0.42;258.32;6.06;960;40;2550.00;34
6491;40;626120764;6491;285;7451;7485;6.87;0.42;258.41;6.05;960;40;2551.00;34
6493;40;626120777;6493;285;7453;7485;6.80;0.42;258.49;6.06;960;40;2552.00;32
6499;40;626120789;6499;279;7454;7485;6.72;0.41;258.55;6.06;955;40;2553.00;31
6500;40;626120802;6500;274;7454;7485;6.71;0.41;258.55;6.06;954;40;2554.00;31
6507;40;626120814;6507;269;7455;7485;6.63;0.41;258.66;6.06;948;40;2555.00;30
6511;40;626120827;6511;270;7467;7497;6.70;0.41;258.67;6.05;956;40;2556.00;30
6515;40;626120842;6515;267;7467;7497;6.76;0.42;258.76;6.05;952;40;2557.00;30
6518;40;626120855;6518;259;7468;7497;6.82;0.42;258.86;6.05;950;40;2558.00;29
6522;40;626120867;6522;267;7468;7497;6.87;0.42;258.93;6.05;946;40;2559.00;29
6525;40;626120879;6525;259;7468;7497;6.94;0.43;259.01;6.05;943;40;2560.00;29
6528;40;626120892;6528;260;7468;7497;6.96;0.43;259.08;6.05;940;40;2561.00;29
6531;40;626120905;6531;260;7468;7498;6.97;0.43;259.20;6.05;937;40;2562.00;30
6533;40;626120918;6533;255;7468;7498;7.03;0.43;259.28;6.05;935;40;2563.00;30
6537;40;626120932;6537;250;7472;7504;7.17;0.44;259.36;6.05;935;40;2564.00;32
6541;40;626120946;6541;244;7474;7506;7.27;0.45;259.47;6.05;933;40;2565.00;32
6548;40;626120962;6548;240;7475;7506;7.37;0.46;259.47;6.05;927;40;2566.00;31
6553;40;626120977;6553;245;7475;7506;7.47;0.46;259.47;6.05;922;40;2567.00;31
6556;40;626120996;6556;251;7478;7510;7.63;0.47;259.51;6.04;922;40;2568.00;32
6560;40;626121016;6560;249;7478;7510;7.72;0.48;259.56;6.04;918;40;2569.00;32
6562;40;626121036;6562;242;7478;7510;7.83;0.48;259.51;6.04;916;40;2570.00;32
6568;40;626121055;6568;241;7479;7511;7.87;0.48;259.46;6.04;911;40;2571.00;32
6572;40;626121073;6572;240;7482;7515;7.88;0.49;259.50;6.04;910;40;2572.00;33
6576;40;626121096;6576;231;7482;7515;7.94;0.49;259.49;6.04;906;40;2573.00;33
6581;40;626121114;6581;227;7484;7518;8.03;0.49;259.51;6.04;903;40;2574.00;34
6588;40;626121130;6588;222;7485;7518;8.05;0.49;259.53;6.04;897;40;2575.00;33
6591;40;626121145;6591;219;7485;7518;8.04;0.49;259.59;6.04;894;40;2576.00;33
6595;40;626121160;6595;218;7485;7518;8.04;0.49;259.54;6.04;890;40;2577.00;33
6598;40;626121176;6598;221;7488;7522;8.03;0.49;259.51;6.04;890;40;2578.00;34
6599;40;626121199;6599;219;7488;7522;8.03;0.49;259.50;6.04;889;40;2579.00;34
6605;40;626121215;6605;218;7490;7522;7.99;0.49;259.58;6.09;885;40;2580.00;32
6608;40;626121230;6608;216;7490;7522;8.02;0.49;259.55;6.09;882;40;2581.00;32
6613;40;626121244;6613;221;7490;7523;8.05;0.49;259.64;6.09;877;40;2582.00;33
6619;40;626121257;6619;227;7491;7524;8.00;0.49;259.78;6.09;872;40;2583.00;33
6624;40;626121272;6624;230;7491;7524;8.02;0.49;259.75;6.09;867;40;2584.00;33
6627;40;626121285;6627;233;7492;7525;8.02;0.49;259.76;6.09;865;40;2585.00;33
6632;40;626121298;6632;236;7492;7525;7.99;0.49;259.83;6.09;860;40;2586.00;33
6636;40;626121312;6636;235;7492;7525;8.00;0.49;259.87;6.09;856;40;2587.00;33
6643;40;626121332;6643;236;7492;7525;7.96;0.48;259.95;6.09;849;40;2588.00;33
6648;40;626121346;6648;234;7492;7525;7.92;0.48;259.99;6.09;844;40;2589.00;33
6651;41;626121359;6651;241;7492;7525;7.88;0.48;259.94;6.09;841;41;2590.00;33
6656;41;626121390;6656;245;7492;7525;7.75;0.47;259.97;6.09;836;41;2591.00;33
6659;41;626121403;6659;269;7561;7652;7.94;0.49;260.09;6.04;902;41;2592.00;91
6661;41;626121429;6661;264;7565;7653;7.82;0.48;260.15;6.03;904;41;2593.00;88
6663;41;626121443;6663;264;7572;7653;7.78;0.48;260.24;6.03;909;41;2594.00;81
6668;41;626121459;6668;270;7576;7653;7.68;0.47;260.46;6.03;908;41;2595.00;77
6669;41;626121473;6669;275;7582;7653;7.69;0.47;260.45;6.08;913;41;2596.00;71
6671;41;626121485;6671;273;7584;7653;7.63;0.47;260.49;6.08;913;41;2597.00;69
6672;41;626121497;6672;270;7588;7653;7.65;0.47;260.54;6.08;916;41;2598.00;65
6674;41;626121509;6674;272;7591;7653;7.70;0.48;260.48;6.08;917;41;2599.00;62
6677;41;626121525;6677;270;7595;7654;7.70;0.47;260.50;6.08;918;41;2600.00;59
6680;41;626121542;6680;271;7601;7655;7.77;0.48;260.57;6.08;921;41;2601.00;54
6681;41;626121556;6681;274;7602;7655;7.75;0.48;260.60;6.09;921;41;2602.00;53
6686;41;626121568;6686;274;7605;7656;7.72;0.48;260.73;6.14;919;41;2603.00;51
6690;41;626121581;6690;278;7607;7656;7.67;0.47;260.76;6.15;917;41;2604.00;49
6695;41;626121603;6695;281;7608;7656;7.60;0.47;260.82;6.15;913;41;2605.00;48
6698;41;626121623;6698;260;7610;7656;7.55;0.47;260.87;6.15;912;41;2606.00;46
6703;41;626121644;6703;256;7613;7660;7.55;0.46;260.84;6.15;910;41;2607.00;47
6705;41;626121657;6705;251;7614;7660;7.59;0.47;260.83;6.15;909;41;2608.00;46
6707;41;626121678;6707;243;7614;7660;7.62;0.47;260.79;6.15;907;41;2609.00;46
6710;41;626121692;6710;242;7618;7666;7.67;0.47;260.80;6.15;908;41;2610.00;48
6711;41;626121706;6711;237;7618;7666;7.67;0.47;260.80;6.15;907;41;2611.00;48
6713;41;626121719;6713;242;7619;7666;7.67;0.47;260.83;6.15;906;41;2612.00;47
6716;41;626121731;6716;246;7622;7670;7.66;0.47;260.89;6.15;906;41;2613.00;48
6717;41;626121745;6717;244;7624;7671;7.74;0.47;260.92;6.15;907;41;2614.00;47
6720;41;626121757;6720;253;7626;7671;7.80;0.48;260.91;6.21;906;41;2615.00;45
6723;41;626121770;6723;251;7629;7675;7.84;0.48;260.91;6.20;906;41;2616.00;46
6725;41;626121783;6725;247;7630;7675;7.87;0.48;260.90;6.20;905;41;2617.00;45
6730;41;626121795;6730;243;7631;7675;7.94;0.48;261.04;6.20;901;41;2618.00;44
6731;41;626121808;6731;246;7633;7676;7.98;0.49;261.07;6.20;902;41;2619.00;43
6732;41;626121821;6732;251;7633;7676;8.02;0.49;261.07;6.20;901;41;2620.00;43
6732;41;626121834;6732;252;7638;7682;8.12;0.49;261.07;6.26;906;41;2621.00;44
6735;41;626121847;6735;254;7639;7682;8.22;0.50;261.04;6.26;904;41;2622.00;43
6738;41;626121867;6738;254;7639;7683;8.26;0.50;261.06;6.26;901;41;2623.00;44
6740;41;626121880;6740;252;7639;7683;8.29;0.50;261.03;6.26;899;41;2624.00;44
6741;41;626121892;6741;249;7639;7683;8.25;0.50;261.04;6.26;898;41;2625.00;44
6741;41;626121905;6741;249;7639;7683;8.20;0.50;261.04;6.26;898;41;2626.00;44
6746;41;626121917;6746;255;7639;7683;8.18;0.50;261.17;6.26;893;41;2627.00;44
6749;41;626121929;6749;258;7649;7695;8.22;0.50;261.10;6.25;900;41;2628.00;46
6753;41;626121942;6753;262;7650;7695;8.21;0.50;261.03;6.25;897;41;2629.00;45
6754;41;626121954;6754;261;7650;7695;8.22;0.50;261.02;6.25;896;41;2630.00;45
6758;41;626121966;6758;260;7650;7695;8.22;0.50;260.95;6.25;892;41;2631.00;45
6759;41;626121978;6759;271;7650;7695;8.16;0.50;260.92;6.25;891;41;2632.00;45
6759;41;626121991;6759;274;7650;7695;8.12;0.49;260.92;6.25;891;41;2633.00;45
6760;41;626122003;6760;274;7653;7699;8.05;0.49;260.90;6.25;893;41;2634.00;46
6762;41;626122014;6762;279;7654;7699;7.98;0.49;260.87;6.30;892;41;2635.00;45
6763;41;626122026;6763;288;7657;7703;7.91;0.48;260.84;6.30;894;41;2636.00;46
6765;41;626122038;6765;291;7658;7704;7.87;0.48;260.86;6.30;893;41;2637.00;46
6766;41;626122049;6766;302;7660;7704;7.79;0.47;260.87;6.34;894;41;2638.00;44
6769;41;626122060;6769;307;7660;7704;7.62;0.46;260.87;6.34;891;41;2639.00;44
6770;41;626122073;6770;305;7679;7733;7.49;0.46;260.86;6.32;909;41;2640.00;54
6770;41;626122086;6770;306;7680;7733;7.39;0.45;260.86;6.32;910;41;2641.00;53
6771;41;626122097;6771;301;7683;7733;7.32;0.45;260.85;6.32;912;41;2642.00;50
6772;41;626122108;6772;299;7685;7734;7.30;0.45;260.98;6.32;913;41;2643.00;49
6775;41;626122119;6775;299;7686;7735;7.25;0.44;260.95;6.32;911;41;2644.00;49
6777;41;626122130;6777;301;7686;7735;7.26;0.44;260.97;6.32;909;41;2645.00;49
6779;41;626122141;6779;303;7689;7738;7.22;0.44;260.97;6.32;910;41;2646.00;49
6780;41;626122152;6780;305;7689;7738;7.18;0.44;260.97;6.32;909;41;2647.00;49
6783;41;626122162;6783;306;7689;7738;7.13;0.43;261.01;6.32;906;41;2648.00;49
6785;41;626122172;6785;306;7689;7738;7.03;0.43;261.03;6.32;904;41;2649.00;49
6787;41;626122183;6787;304;7693;7744;6.96;0.42;261.04;6.32;906;41;2650.00;51
6790;41;626122194;6790;290;7694;7744;6.97;0.42;261.03;6.32;904;41;2651.00;50
6792;41;626122205;6792;270;7695;7744;6.95;0.42;261.04;6.36;903;41;2652.00;49
6794;41;626122223;6794;264;7695;7744;6.91;0.42;261.04;6.36;901;41;2653.00;49
6796;41;626122233;6796;253;7699;7748;6.86;0.42;261.02;6.37;903;41;2654.00;49
6799;41;626122245;6799;243;7701;7750;6.86;0.42;261.07;6.37;902;41;2655.00;49
6805;42;626122256;6805;236;7702;7750;6.81;0.41;261.06;6.38;897;42;2656.00;48
6806;42;626122280;6806;225;7703;7751;6.86;0.42;261.05;6.38;897;42;2657.00;48
6807;42;626122291;6807;220;7703;7751;6.94;0.42;261.03;6.38;896;42;2658.00;48
6808;42;626122301;6808;213;7703;7751;7.04;0.43;261.01;6.38;895;42;2659.00;48
6811;42;626122312;6811;206;7703;7751;7.07;0.43;260.94;6.38;892;42;2660.00;48
6812;42;626122322;6812;199;7703;7751;7.18;0.44;260.94;6.38;891;42;2661.00;48
6813;42;626122332;6813;196;7703;7751;7.27;0.44;260.91;6.38;890;42;2662.00;48
6813;42;626122343;6813;196;7703;7751;7.37;0.45;260.91;6.38;890;42;2663.00;48
6815;42;626122353;6815;204;7741;7821;7.64;0.47;260.87;6.35;926;42;2664.00;80
6817;42;626122375;6817;199;7742;7822;7.68;0.47;260.83;6.35;925;42;2665.00;80
6820;42;626122391;6820;189;7748;7822;7.71;0.47;260.77;6.34;928;42;2666.00;74
6822;42;626122403;6822;191;7757;7822;7.77;0.47;260.76;6.34;935;42;2667.00;65
6825;42;626122413;6825;189;7760;7822;7.84;0.48;260.71;6.34;935;42;2668.00;62
6827;42;626122425;6827;189;7762;7822;7.89;0.48;260.66;6.34;935;42;2669.00;60
6829;42;626122437;6829;196;7766;7822;7.90;0.48;260.75;6.34;937;42;2670.00;56
6829;42;626122454;6829;194;7766;7822;7.90;0.48;260.75;6.34;937;42;2671.00;56
6836;42;626122465;6836;190;7769;7823;7.91;0.48;260.73;6.34;933;42;2672.00;54
6838;42;626122477;6838;195;7770;7824;7.92;0.48;260.73;6.34;932;42;2673.00;54
6839;42;626122489;6839;198;7771;7824;7.93;0.48;260.72;6.34;932;42;2674.00;53
6842;42;626122500;6842;202;7774;7828;7.87;0.48;260.65;6.34;932;42;2675.00;54
6842;42;626122512;6842;204;7774;7828;7.86;0.48;260.65;6.34;932;42;2676.00;54
6845;42;626122523;6845;199;7774;7828;7.81;0.47;260.66;6.34;929;42;2677.00;54
6847;42;626122534;6847;207;7774;7828;7.76;0.47;260.63;6.34;927;42;2678.00;54
6850;42;626122545;6850;214;7779;7834;7.80;0.47;260.63;6.35;929;42;2679.00;55
6854;42;626122557;6854;212;7780;7834;7.77;0.47;260.69;6.35;926;42;2680.00;54
6856;42;626122569;6856;219;7782;7834;7.80;0.47;260.79;6.37;926;42;2681.00;52
6859;42;626122582;6859;224;7785;7837;7.86;0.48;260.90;6.38;926;42;2682.00;52
6860;42;626122595;6860;232;7786;7837;7.90;0.48;260.90;6.39;926;42;2683.00;51
6865;42;626122606;6865;240;7787;7837;7.92;0.48;260.93;6.39;922;42;2684.00;50
6865;42;626122617;6865;239;7789;7838;8.00;0.49;260.93;6.42;924;42;2685.00;49
6867;42;626122629;6867;238;7790;7839;8.03;0.49;260.88;6.42;923;42;2686.00;49
6869;42;626122640;6869;236;7792;7839;7.98;0.48;260.90;6.43;923;42;2687.00;47
6870;42;626122652;6870;234;7803;7852;8.01;0.49;260.90;6.43;933;42;2688.00;49
6873;42;626122665;6873;237;7804;7852;7.99;0.49;260.91;6.44;931;42;2689.00;48
6875;42;626122676;6875;243;7805;7852;8.00;0.49;260.92;6.44;930;42;2690.00;47
6880;42;626122688;6880;245;7807;7853;8.00;0.49;261.05;6.45;927;42;2691.00;46
6881;42;626122699;6881;250;7808;7853;8.03;0.49;261.08;6.46;927;42;2692.00;45
6883;42;626122711;6883;255;7812;7857;8.01;0.49;261.22;6.47;929;42;2693.00;45
6887;42;626122723;6887;245;7814;7857;7.97;0.48;261.25;6.47;927;42;2694.00;43
6888;42;626122735;6888;250;7818;7861;7.89;0.48;261.28;6.48;930;42;2695.00;43
6891;42;626122747;6891;256;7820;7861;7.80;0.48;261.32;6.49;929;42;2696.00;41
6894;42;626122758;6894;261;7820;7861;7.71;0.47;261.40;6.49;926;42;2697.00;41
6895;42;626122770;6895;258;7821;7861;7.63;0.46;261.38;6.49;926;42;2698.00;40
6897;42;626122780;6897;257;7822;7861;7.57;0.46;261.40;6.50;925;42;2699.00;39
6901;42;626122794;6901;259;7846;7910;7.57;0.46;261.38;6.50;945;42;2700.00;64
6904;42;626122816;6904;252;7848;7910;7.51;0.46;261.39;6.50;944;42;2701.00;62
6907;42;626122833;6907;250;7852;7910;7.48;0.46;261.37;6.50;945;42;2702.00;58
6909;42;626122846;6909;246;7853;7910;7.47;0.46;261.42;6.50;944;42;2703.00;57
6913;42;626122857;6913;249;7857;7910;7.46;0.46;261.45;6.51;944;42;2704.00;53
6915;42;626122869;6915;244;7857;7910;7.47;0.46;261.47;6.51;942;42;2705.00;53
6918;42;626122880;6918;245;7861;7911;7.46;0.46;261.51;6.52;943;42;2706.00;50
6920;42;626122892;6920;244;7862;7911;7.44;0.46;261.52;6.52;942;42;2707.00;49
6924;42;626122903;6924;241;7868;7917;7.51;0.46;261.71;6.54;944;42;2708.00;49
6928;42;626122916;6928;243;7869;7918;7.49;0.46;261.80;6.54;941;42;2709.00;49
6930;42;626122928;6930;246;7869;7918;7.49;0.46;261.78;6.54;939;42;2710.00;49
6934;42;626122940;6934;247;7872;7918;7.41;0.45;261.88;6.55;938;42;2711.00;46
6942;42;626122951;6942;253;7875;7922;7.33;0.45;262.09;6.54;933;42;2712.00;47
6942;42;626122963;6942;254;7878;7922;7.28;0.44;262.09;6.55;936;42;2713.00;44
6948;42;626122975;6948;260;7879;7922;7.23;0.44;262.15;6.56;931;42;2714.00;43
6951;42;626122987;6951;258;7880;7923;7.23;0.44;262.15;6.55;929;42;2715.00;43
6954;42;626123004;6954;263;7883;7927;7.20;0.44;262.24;6.55;929;42;2716.00;44
6959;42;626123021;6959;271;7886;7927;7.15;0.44;262.33;6.56;927;42;2717.00;41
6965;42;626123038;6965;280;7888;7930;7.11;0.43;262.36;6.56;923;42;2718.00;42
6966;42;626123055;6966;276;7892;7930;7.06;0.43;262.35;6.56;926;42;2719.00;38
6969;42;626123074;6969;258;7892;7930;7.06;0.43;262.47;6.56;923;42;2720.00;38
6973;42;626123093;6973;256;7893;7930;6.99;0.43;262.50;6.57;920;42;2721.00;37
6977;42;626123109;6977;249;7895;7934;7.00;0.43;262.54;6.56;918;42;2722.00;39
6980;42;626123122;6980;244;7895;7934;6.94;0.42;262.61;6.56;915;42;2723.00;39
6984;42;626123136;6984;245;7897;7934;6.87;0.42;262.63;6.57;913;42;2724.00;37
6987;42;626123150;6987;253;7899;7934;6.77;0.41;262.68;6.57;912;42;2725.00;35
6989;42;626123163;6989;246;7899;7935;6.76;0.41;262.74;6.57;910;42;2726.00;36
6992;42;626123183;6992;248;7901;7936;6.76;0.41;262.75;6.57;909;42;2727.00;35
6995;42;626123196;6995;242;7901;7936;6.76;0.41;262.79;6.57;906;42;2728.00;35
6999;42;626123209;6999;237;7902;7937;6.82;0.42;262.84;6.57;903;42;2729.00;35
7001;42;626123224;7001;238;7902;7937;6.89;0.42;262.89;6.57;901;42;2730.00;35
7005;42;626123237;7005;239;7904;7937;6.95;0.43;262.93;6.57;899;42;2731.00;33
7009;42;626123251;7009;240;7904;7937;7.04;0.43;262.93;6.57;895;42;2732.00;33
7011;42;626123264;7011;238;7906;7937;7.06;0.43;262.99;6.58;895;42;2733.00;31
7014;42;626123277;7014;239;7906;7937;7.12;0.44;262.99;6.58;892;42;2734.00;31
7024;42;626123290;7024;235;7906;7937;7.15;0.44;263.03;6.58;882;42;2735.00;31
7027;42;626123310;7027;252;7974;8064;7.46;0.46;263.20;6.52;947;42;2736.00;90
7032;42;626123348;7032;254;7981;8065;7.48;0.46;263.27;6.57;949;42;2737.00;84
7037;42;626123363;7037;253;7987;8065;7.52;0.47;263.31;6.57;950;42;2738.00;78
7042;42;626123378;7042;248;7991;8065;7.51;0.46;263.45;6.57;949;42;2739.00;74
7048;42;626123401;7048;249;7995;8065;7.59;0.47;263.52;6.57;947;42;2740.00;70
7055;42;626123417;7055;253;7997;8065;7.57;0.47;263.54;6.57;942;42;2741.00;68
7059;42;626123431;7059;253;7999;8065;7.47;0.46;263.63;6.57;940;42;2742.00;66
7063;42;626123451;7063;255;8003;8065;7.48;0.46;263.65;6.57;940;42;2743.00;62
7067;42;626123465;7067;251;8008;8066;7.45;0.46;263.73;6.57;941;42;2744.00;58
7071;42;626123480;7071;243;8012;8068;7.49;0.46;263.74;6.57;941;42;2745.00;56
7072;42;626123494;7072;251;8015;8068;7.47;0.46;263.76;6.57;943;42;2746.00;53
7076;42;626123508;7076;246;8017;8069;7.44;0.46;263.83;6.58;941;42;2747.00;52
7080;42;626123522;7080;255;8019;8069;7.42;0.46;263.91;6.58;939;42;2748.00;50
7085;42;626123536;7085;260;8023;8069;7.38;0.45;263.90;6.58;938;42;2749.00;46
7090;42;626123550;7090;260;8024;8069;7.39;0.45;263.97;6.58;934;42;2750.00;45
7093;42;626123564;7093;261;8028;8073;7.39;0.46;263.97;6.58;935;42;2751.00;45
7096;42;626123578;7096;260;8030;8073;7.43;0.46;264.00;6.58;934;42;2752.00;43
7101;42;626123593;7101;272;8032;8073;7.36;0.45;264.11;6.59;931;42;2753.00;41
7107;42;626123612;7107;277;8036;8076;7.31;0.45;264.28;6.59;929;42;2754.00;40
7110;42;626123627;7110;286;8038;8076;7.31;0.45;264.23;6.59;928;42;2755.00;38
7116;42;626123641;7116;293;8039;8076;7.26;0.45;264.28;6.59;923;42;2756.00;37
7119;42;626123655;7119;301;8044;8080;7.28;0.45;264.27;6.59;925;42;2757.00;36
7122;42;626123670;7122;310;8045;8081;7.31;0.45;264.23;6.59;923;42;2758.00;36
7127;42;626123685;7127;316;8045;8081;7.24;0.44;264.20;6.59;918;42;2759.00;36
7132;42;626123699;7132;321;8050;8086;7.20;0.44;264.25;6.63;918;42;2760.00;36
7137;42;626123712;7137;325;8050;8086;7.13;0.44;264.35;6.63;913;42;2761.00;36
7138;42;626123725;7138;329;8050;8086;7.07;0.43;264.42;6.63;912;42;2762.00;36
7142;42;626123737;7142;337;8051;8087;7.04;0.43;264.53;6.63;909;42;2763.00;36
7149;42;626123749;7149;341;8051;8087;7.02;0.43;264.68;6.63;902;42;2764.00;36
7151;42;626123762;7151;347;8055;8093;6.94;0.43;264.69;6.63;904;42;2765.00;38
7157;42;626123775;7157;352;8055;8093;6.84;0.42;264.76;6.63;898;42;2766.00;38
7160;42;626123788;7160;338;8056;8094;6.83;0.42;264.88;6.63;896;42;2767.00;38
7164;42;626123800;7164;331;8056;8094;6.87;0.42;264.94;6.63;892;42;2768.00;38
7169;42;626123813;7169;329;8056;8094;6.90;0.42;264.98;6.63;887;42;2769.00;38
7172;42;626123825;7172;315;8056;8094;6.96;0.42;264.98;6.63;884;42;2770.00;38
7175;42;626123839;7175;311;8056;8094;6.99;0.43;265.08;6.63;881;42;2771.00;38
7178;42;626123851;7178;315;8066;8106;7.11;0.43;265.12;6.62;888;42;2772.00;40
7182;42;626123864;7182;316;8067;8106;7.15;0.44;265.12;6.62;885;42;2773.00;39
7187;42;626123875;7187;312;8067;8106;7.18;0.44;265.15;6.62;880;42;2774.00;39
7190;42;626123888;7190;307;8068;8106;7.18;0.44;265.15;6.67;878;42;2775.00;38
7190;42;626123914;7190;297;8068;8106;7.23;0.44;265.15;6.67;878;42;2776.00;38
7195;42;626123928;7195;284;8068;8106;7.24;0.44;265.20;6.67;873;42;2777.00;38
7197;42;626123943;7197;276;8071;8110;7.27;0.44;265.18;6.67;874;42;2778.00;39
7201;42;626123965;7201;275;8071;8110;7.30;0.44;265.20;6.67;870;42;2779.00;39
7205;42;626123980;7205;270;8075;8114;7.37;0.45;265.13;6.71;870;42;2780.00;39
7206;42;626124002;7206;264;8077;8115;7.43;0.45;265.11;6.71;871;43;2781.00;38
7206;42;626124026;7206;267;8077;8115;7.44;0.45;265.11;6.71;871;43;2782.00;38
7209;42;626124039;7209;272;8078;8115;7.49;0.46;265.04;6.76;869;43;2783.00;37
7211;42;626124053;7211;273;8088;8128;7.55;0.46;265.01;6.75;877;43;2784.00;40
7211;42;626124067;7211;264;8088;8128;7.59;0.46;265.01;6.75;877;43;2785.00;40
7213;42;626124080;7213;271;8089;8128;7.62;0.46;264.96;6.75;876;43;2786.00;39
7216;42;626124093;7216;267;8090;8129;7.66;0.46;264.89;6.75;874;43;2787.00;39
7219;42;626124106;7219;270;8091;8130;7.65;0.46;264.90;6.79;872;43;2788.00;39
7220;42;626124119;7220;260;8091;8130;7.66;0.46;264.89;6.79;871;43;2789.00;39
7222;42;626124134;7222;257;8094;8136;7.66;0.46;264.87;6.79;872;43;2790.00;42
7223;42;626124148;7223;258;8094;8136;7.66;0.46;264.87;6.79;871;43;2791.00;42
7224;42;626124160;7224;256;8096;8136;7.61;0.46;264.86;6.83;872;43;2792.00;40
7225;42;626124172;7225;251;8096;8136;7.57;0.46;264.85;6.83;871;43;2793.00;40
7227;42;626124204;7227;253;8100;8142;7.57;0.46;264.84;6.82;873;43;2794.00;42
7227;42;626124218;7227;259;8100;8142;7.57;0.46;264.84;6.82;873;43;2795.00;42
7229;42;626124229;7229;256;8101;8142;7.51;0.46;264.80;6.82;872;43;2796.00;41
7231;42;626124241;7231;265;8101;8142;7.44;0.45;264.77;6.82;870;43;2797.00;41
7231;42;626124253;7231;269;8105;8146;7.41;0.45;264.77;6.82;874;43;2798.00;41
7234;42;626124265;7234;277;8106;8147;7.39;0.45;264.85;6.82;872;43;2799.00;41
7235;42;626124278;7235;284;8107;8147;7.33;0.44;264.82;6.82;872;43;2800.00;40
7237;42;626124293;7237;288;8108;8148;7.25;0.44;264.81;6.82;871;43;2801.00;40
7237;42;626124305;7237;296;8108;8148;7.14;0.43;264.81;6.82;871;43;2802.00;40
7238;42;626124317;7238;294;8108;8148;7.16;0.44;264.80;6.82;870;43;2803.00;40
7240;42;626124329;7240;289;8108;8148;7.15;0.44;264.78;6.82;868;43;2804.00;40
7242;42;626124341;7242;286;8108;8148;7.14;0.43;264.77;6.82;866;43;2805.00;40
7244;42;626124352;7244;287;8108;8148;7.11;0.43;264.74;6.82;864;43;2806.00;40
7245;42;626124364;7245;279;8108;8148;7.15;0.44;264.74;6.82;863;43;2807.00;40
7245;43;626124376;7245;290;8151;8218;7.17;0.44;264.74;6.78;906;44;2808.00;67
7246;43;626124405;7246;281;8151;8219;7.18;0.44;264.73;6.78;905;44;2809.00;68
7248;43;626124418;7248;262;8158;8219;7.32;0.45;264.74;6.78;910;44;2810.00;61
7248;43;626124431;7248;253;8160;8219;7.43;0.45;264.74;6.78;912;44;2811.00;59
7248;43;626124443;7248;250;8164;8219;7.60;0.46;264.74;6.78;916;44;2812.00;55
7250;43;626124462;7250;244;8166;8219;7.68;0.47;264.73;6.78;916;44;2813.00;53
7251;43;626124474;7251;243;8170;8219;7.81;0.48;264.74;6.78;919;44;2814.00;49
7255;43;626124490;7255;239;8171;8219;7.82;0.48;264.75;6.78;916;44;2815.00;48
7257;43;626124508;7257;232;8173;8220;7.87;0.48;264.72;6.78;916;44;2816.00;47
7261;43;626124520;7261;229;8175;8221;7.85;0.48;264.71;6.78;914;44;2817.00;46
7262;43;626124531;7262;228;8177;8221;7.81;0.48;264.70;6.81;915;44;2818.00;44
7265;43;626124543;7265;225;8180;8225;7.76;0.47;264.67;6.81;915;44;2819.00;45
7266;43;626124556;7266;220;8180;8225;7.75;0.47;264.65;6.81;914;44;2820.00;45
7269;43;626124568;7269;219;8180;8225;7.70;0.47;264.66;6.81;911;44;2821.00;45
7273;43;626124579;7273;206;8181;8225;7.62;0.47;264.71;6.85;908;44;2822.00;44
7275;43;626124591;7275;203;8184;8231;7.67;0.47;264.70;6.84;909;44;2823.00;47
7277;43;626124604;7277;204;8185;8231;7.68;0.47;264.83;6.84;908;44;2824.00;46
7278;43;626124616;7278;195;8186;8231;7.70;0.47;264.81;6.85;908;44;2825.00;45
7282;43;626124639;7282;192;8188;8234;7.74;0.47;264.85;6.85;906;44;2826.00;46
7284;43;626124653;7284;197;8188;8234;7.78;0.48;264.84;6.85;904;44;2827.00;46
7289;43;626124666;7289;190;8190;8234;7.80;0.48;264.77;6.89;901;44;2828.00;44
7294;43;626124678;7294;190;8190;8235;7.80;0.48;264.72;6.89;896;44;2829.00;45
7298;43;626124692;7298;180;8192;8236;7.75;0.47;264.70;6.92;894;44;2830.00;44
7301;43;626124707;7301;183;8192;8236;7.75;0.47;264.70;6.92;891;44;2831.00;44
7305;44;626124718;7305;179;8203;8249;7.78;0.47;264.65;6.95;898;45;2832.00;46
7307;44;626124749;7307;181;8203;8249;7.77;0.47;264.61;6.95;896;45;2833.00;46
7310;44;626124762;7310;180;8204;8249;7.83;0.48;264.62;6.99;894;45;2834.00;45
7315;44;626124775;7315;178;8206;8251;7.91;0.48;264.55;6.99;891;45;2835.00;45
7319;44;626124788;7319;175;8206;8251;7.99;0.48;264.54;6.99;887;45;2836.00;45
7322;44;626124800;7322;170;8210;8255;8.07;0.49;264.60;7.03;888;45;2837.00;45
7324;44;626124813;7324;171;8212;8255;8.16;0.49;264.65;7.02;888;45;2838.00;43
7326;44;626124825;7326;178;8215;8259;8.15;0.49;264.68;7.02;889;45;2839.00;44
7327;44;626124838;7327;168;8217;8259;8.13;0.49;264.74;7.06;890;45;2840.00;42
7330;44;626124850;7330;164;8217;8259;8.11;0.49;264.77;7.06;887;45;2841.00;42
7333;44;626124862;7333;172;8217;8259;8.11;0.49;264.84;7.06;884;45;2842.00;42
7334;44;626124875;7334;167;8217;8259;8.10;0.49;264.89;7.06;883;45;2843.00;42
7335;44;626124887;7335;166;8227;8271;8.15;0.49;264.89;7.05;892;45;2844.00;44
7335;44;626124901;7335;167;8228;8271;8.16;0.50;264.89;7.05;893;45;2845.00;43
7337;44;626124913;7337;175;8228;8271;8.10;0.49;264.95;7.05;891;45;2846.00;43
7339;44;626124924;7339;180;8228;8271;8.10;0.49;264.92;7.05;889;45;2847.00;43
7342;44;626124937;7342;191;8228;8271;8.19;0.50;264.92;7.05;886;45;2848.00;43
7345;44;626124949;7345;188;8228;8271;8.25;0.50;264.94;7.05;883;45;2849.00;43
7347;44;626124964;7347;188;8232;8274;8.21;0.50;264.97;7.07;885;45;2850.00;42
7351;44;626124983;7351;185;8232;8274;8.24;0.50;265.01;7.07;881;45;2851.00;42
7356;44;626125002;7356;182;8236;8280;8.32;0.50;265.13;7.07;880;45;2852.00;44
7356;44;626125033;7356;184;8240;8281;8.38;0.51;265.13;7.10;884;45;2853.00;41
7357;44;626125052;7357;185;8240;8281;8.45;0.51;265.18;7.10;883;45;2854.00;41
7362;44;626125071;7362;185;8241;8281;8.47;0.51;265.17;7.11;879;45;2855.00;40
7364;44;626125093;7364;185;8245;8285;8.50;0.52;265.20;7.12;881;45;2856.00;40
7366;44;626125112;7366;183;8246;8285;8.47;0.52;265.20;7.13;880;45;2857.00;39
7367;44;626125126;7367;185;8246;8285;8.47;0.52;265.21;7.13;879;45;2858.00;39
7369;44;626125140;7369;189;8249;8286;8.45;0.51;265.27;7.15;880;45;2859.00;37
7372;44;626125154;7372;193;8252;8290;8.36;0.51;265.33;7.14;880;45;2860.00;38
7375;44;626125170;7375;198;8254;8290;8.33;0.51;265.37;7.16;879;45;2861.00;36
7378;44;626125184;7378;207;8256;8293;8.29;0.50;265.46;7.16;878;45;2862.00;37
7380;44;626125198;7380;207;8259;8293;8.26;0.50;265.55;7.17;879;45;2863.00;34
7383;44;626125212;7383;212;8261;8295;8.21;0.50;265.57;7.17;878;45;2864.00;34
7385;44;626125226;7385;215;8263;8295;8.20;0.50;265.58;7.19;878;45;2865.00;32
7391;44;626125238;7391;219;8266;8299;8.20;0.50;265.62;7.18;875;45;2866.00;33
7393;44;626125252;7393;223;8269;8299;8.15;0.50;265.76;7.20;876;45;2867.00;30
7395;44;626125265;7395;226;8269;8299;8.05;0.49;265.83;7.20;874;45;2868.00;30
7398;44;626125278;7398;220;8270;8299;7.97;0.49;265.88;7.21;872;45;2869.00;29
7401;44;626125290;7401;218;8270;8300;7.97;0.49;265.91;7.21;869;45;2870.00;30
7404;44;626125303;7404;219;8274;8301;8.01;0.49;265.89;7.23;870;45;2871.00;27
7409;44;626125316;7409;219;8274;8301;8.01;0.49;265.95;7.23;865;45;2872.00;27
7411;44;626125329;7411;216;8276;8302;7.96;0.48;265.97;7.24;865;45;2873.00;26
7415;44;626125343;7415;217;8276;8302;7.95;0.48;265.99;7.24;861;45;2874.00;26
7416;44;626125356;7416;223;8276;8302;7.94;0.48;266.01;7.24;860;45;2875.00;26
7419;44;626125367;7419;220;8279;8302;7.87;0.48;266.03;7.26;860;45;2876.00;23
7423;44;626125380;7423;222;8279;8302;7.84;0.48;266.09;7.26;856;45;2877.00;23
7424;44;626125392;7424;225;8280;8302;7.86;0.48;266.06;7.26;856;45;2878.00;22
7429;44;626125403;7429;214;8280;8302;7.84;0.48;266.17;7.26;851;45;2879.00;22
7431;44;626125417;7431;255;8383;8532;7.85;0.49;266.25;7.19;952;45;2880.00;149
7433;44;626125455;7433;249;8388;8533;7.80;0.49;266.28;7.19;955;45;2881.00;145
7440;44;626125468;7440;239;8397;8533;7.76;0.48;266.32;7.18;957;45;2882.00;136
7441;44;626125481;7441;241;8402;8533;7.78;0.48;266.35;7.18;961;45;2883.00;131
7444;44;626125493;7444;239;8409;8533;7.83;0.49;266.41;7.18;965;45;2884.00;124
7448;45;626125505;7448;238;8415;8533;7.78;0.48;266.44;7.18;967;46;2885.00;118
7451;45;626125538;7451;240;8418;8533;7.78;0.48;266.47;7.18;967;46;2886.00;115
7454;45;626125552;7454;244;8427;8533;7.73;0.48;266.48;7.18;973;46;2887.00;106
7457;45;626125565;7457;253;8431;8534;7.64;0.47;266.56;7.18;974;46;2888.00;103
7462;45;626125577;7462;254;8437;8535;7.52;0.47;266.58;7.18;975;46;2889.00;98
7467;45;626125590;7467;242;8444;8535;7.36;0.46;266.61;7.19;977;46;2890.00;91
7469;45;626125605;7469;238;8449;8536;7.30;0.45;266.65;7.19;980;46;2891.00;87
7473;45;626125618;7473;248;8454;8536;7.19;0.45;266.77;7.19;981;46;2892.00;82
7476;45;626125632;7476;255;8462;8536;7.08;0.44;266.80;7.20;986;46;2893.00;74
7479;45;626125651;7479;261;8464;8536;6.94;0.43;266.86;7.20;985;46;2894.00;72
7481;45;626125666;7481;275;8469;8540;6.89;0.43;266.86;7.20;988;46;2895.00;71
7483;45;626125679;7483;278;8471;8540;6.83;0.42;266.90;7.20;988;46;2896.00;69
7487;45;626125699;7487;286;8474;8540;6.70;0.41;266.98;7.21;987;46;2897.00;66
7491;45;626125715;7491;278;8476;8543;6.65;0.41;267.02;7.21;985;46;2898.00;67
7494;45;626125734;7494;272;8478;8543;6.62;0.41;267.10;7.21;984;46;2899.00;65
7498;45;626125750;7498;273;8480;8543;6.62;0.41;267.05;7.21;982;46;2900.00;63
7501;45;626125767;7501;275;8483;8547;6.68;0.41;267.06;7.21;982;46;2901.00;64
7505;45;626125781;7505;271;8487;8548;6.72;0.41;267.08;7.22;982;46;2902.00;61
7511;45;626125795;7511;275;8487;8548;6.73;0.41;267.20;7.22;976;46;2903.00;61
7515;46;626125809;7515;275;8492;8552;6.80;0.42;267.28;7.22;977;47;2904.00;60
7518;46;626125831;7518;276;8494;8552;6.82;0.42;267.33;7.22;976;47;2905.00;58
7525;46;626125846;7525;279;8495;8552;6.84;0.42;267.37;7.22;970;47;2906.00;57
7527;46;626125860;7527;287;8498;8553;6.88;0.42;267.42;7.23;971;47;2907.00;55
7531;46;626125878;7531;289;8500;8553;6.89;0.42;267.43;7.23;969;47;2908.00;53
7535;46;626125893;7535;292;8504;8559;6.94;0.42;267.46;7.23;969;47;2909.00;55
7537;46;626125909;7537;297;8505;8559;6.94;0.43;267.50;7.23;968;47;2910.00;54
7540;46;626125923;7540;299;8508;8560;6.92;0.42;267.53;7.24;968;47;2911.00;52
7542;46;626125937;7542;302;8509;8560;6.92;0.42;267.55;7.25;967;47;2912.00;51
7549;46;626125952;7549;303;8511;8560;6.79;0.42;267.63;7.25;962;47;2913.00;49
7550;46;626125973;7550;314;8511;8560;6.75;0.41;267.67;7.25;961;47;2914.00;49
7552;46;626125987;7552;318;8513;8560;6.67;0.41;267.65;7.26;961;47;2915.00;47
7558;46;626126002;7558;321;8523;8572;6.63;0.41;267.71;7.25;965;47;2916.00;49
7561;46;626126023;7561;329;8523;8572;6.53;0.40;267.80;7.25;962;47;2917.00;49
7567;46;626126038;7567;335;8526;8572;6.46;0.40;267.77;7.26;959;47;2918.00;46
7572;46;626126052;7572;346;8527;8572;6.34;0.39;267.84;7.26;955;47;2919.00;45
7576;46;626126065;7576;358;8527;8572;6.35;0.39;267.91;7.26;951;47;2920.00;45
7576;46;626126079;7576;359;8530;8572;6.36;0.39;267.91;7.26;954;47;2921.00;42
7581;46;626126092;7581;367;8533;8576;6.39;0.39;267.86;7.26;952;47;2922.00;43
7583;46;626126105;7583;373;8534;8576;6.40;0.39;267.91;7.26;951;47;2923.00;42
7587;46;626126118;7587;376;8536;8580;6.38;0.39;267.93;7.26;949;47;2924.00;44
7589;46;626126133;7589;373;8539;8582;6.37;0.39;267.91;7.26;950;47;2925.00;43
7590;46;626126146;7590;373;8539;8582;6.42;0.39;267.89;7.26;949;47;2926.00;43
7590;46;626126159;7590;371;8541;8582;6.40;0.39;267.89;7.31;951;47;2927.00;41
7593;46;626126173;7593;367;8550;8595;6.47;0.40;267.89;7.30;957;47;2928.00;45
7599;46;626126189;7599;363;8551;8595;6.45;0.40;267.86;7.30;952;47;2929.00;44
7603;46;626126201;7603;364;8552;8595;6.45;0.40;267.81;7.30;949;47;2930.00;43
7606;46;626126214;7606;364;8554;8596;6.44;0.39;267.78;7.30;948;47;2931.00;42
7606;46;626126226;7606;366;8554;8597;6.41;0.39;267.78;7.30;948;47;2932.00;43
7612;46;626126239;7612;375;8554;8597;6.32;0.39;267.70;7.30;942;47;2933.00;43
7615;46;626126253;7615;384;8557;8600;6.32;0.39;267.66;7.29;942;47;2934.00;43
7617;46;626126266;7617;392;8557;8600;6.33;0.39;267.62;7.29;940;47;2935.00;43
7618;46;626126278;7618;402;8557;8600;6.31;0.39;267.64;7.29;939;47;2936.00;43
7620;46;626126291;7620;389;8557;8600;6.29;0.38;267.61;7.29;937;47;2937.00;43
7623;46;626126304;7623;384;8561;8606;6.27;0.38;267.60;7.29;938;47;2938.00;45
7626;46;626126318;7626;379;8561;8606;6.29;0.38;267.53;7.29;935;47;2939.00;45
7630;46;626126332;7630;381;8562;8606;6.34;0.39;267.45;7.29;932;47;2940.00;44
7631;46;626126345;7631;380;8562;8606;6.38;0.39;267.43;7.29;931;47;2941.00;44
7634;46;626126358;7634;378;8566;8610;6.43;0.39;267.39;7.34;932;47;2942.00;44
7636;46;626126372;7636;379;8567;8611;6.47;0.39;267.36;7.34;931;47;2943.00;44
7637;46;626126390;7637;379;8567;8611;6.52;0.40;267.35;7.34;930;47;2944.00;44
7639;46;626126403;7639;378;8568;8612;6.51;0.40;267.29;7.34;929;47;2945.00;44
7640;46;626126416;7640;366;8568;8612;6.60;0.40;267.28;7.34;928;47;2946.00;44
7642;46;626126429;7642;353;8568;8612;6.68;0.41;267.22;7.34;926;47;2947.00;44
7644;46;626126442;7644;342;8568;8612;6.75;0.41;267.22;7.34;924;47;2948.00;44
7646;46;626126455;7646;334;8569;8612;6.77;0.41;267.22;7.38;923;47;2949.00;43
7648;46;626126468;7648;327;8569;8612;6.81;0.41;267.19;7.38;921;47;2950.00;43
7650;46;626126482;7650;324;8569;8612;6.86;0.42;267.19;7.38;919;47;2951.00;43
7651;46;626126494;7651;339;8602;8682;7.05;0.43;267.18;7.36;951;47;2952.00;80
7651;46;626126515;7651;340;8603;8683;7.13;0.43;267.18;7.36;952;47;2953.00;80
7651;46;626126529;7651;341;8612;8683;7.27;0.44;267.18;7.35;961;47;2954.00;71
7652;46;626126542;7652;331;8613;8683;7.32;0.45;267.17;7.35;961;47;2955.00;70
7653;46;626126557;7653;324;8619;8683;7.44;0.45;267.16;7.35;966;47;2956.00;64
7653;46;626126571;7653;315;8622;8683;7.51;0.46;267.16;7.35;969;47;2957.00;61
7655;46;626126584;7655;305;8626;8683;7.59;0.46;267.16;7.35;971;47;2958.00;57
7656;46;626126604;7656;297;8629;8683;7.60;0.46;267.15;7.40;973;47;2959.00;54
7658;46;626126618;7658;283;8631;8684;7.64;0.47;267.14;7.39;973;47;2960.00;53
7659;46;626126632;7659;286;8633;8685;7.70;0.47;267.12;7.39;974;47;2961.00;52
7660;46;626126646;7660;276;8633;8685;7.72;0.47;267.11;7.39;973;47;2962.00;52
7663;46;626126661;7663;277;8636;8689;7.71;0.47;267.15;7.39;973;47;2963.00;53
7664;47;626126675;7664;271;8636;8689;7.73;0.47;267.14;7.39;972;48;2964.00;53
7667;47;626126707;7667;264;8636;8689;7.71;0.47;267.18;7.39;969;48;2965.00;53
7670;47;626126721;7670;264;8636;8689;7.66;0.47;267.15;7.39;966;48;2966.00;53
7672;47;626126736;7672;266;8639;8695;7.67;0.47;267.15;7.39;967;48;2967.00;56
7675;47;626126750;7675;267;8639;8695;7.66;0.47;267.13;7.39;964;48;2968.00;56
7676;47;626126765;7676;265;8640;8695;7.70;0.47;267.12;7.39;964;48;2969.00;55
7677;47;626126780;7677;269;8643;8701;7.68;0.47;267.12;7.39;966;48;2970.00;58
7677;47;626126795;7677;274;8644;8701;7.67;0.47;267.12;7.39;967;48;2971.00;57
7677;47;626126809;7677;282;8644;8701;7.63;0.46;267.12;7.39;967;48;2972.00;57
7678;47;626126822;7678;286;8645;8702;7.64;0.47;267.12;7.39;967;48;2973.00;57
7680;47;626126836;7680;284;8646;8703;7.66;0.47;267.11;7.38;966;48;2974.00;57
7680;47;626126849;7680;285;8648;8703;7.70;0.47;267.11;7.44;968;48;2975.00;55
7683;47;626126863;7683;285;8656;8716;7.74;0.47;267.11;7.43;973;48;2976.00;60
7686;47;626126878;7686;286;8657;8716;7.74;0.47;267.20;7.43;971;48;2977.00;59
7689;47;626126892;7689;289;8657;8716;7.71;0.47;267.26;7.43;968;48;2978.00;59
7694;47;626126906;7694;294;8658;8717;7.71;0.47;267.31;7.43;964;48;2979.00;59
7696;47;626126920;7696;289;8658;8717;7.71;0.47;267.35;7.43;962;48;2980.00;59
7701;47;626126933;7701;281;8660;8721;7.68;0.47;267.42;7.43;959;48;2981.00;61
7702;47;626126947;7702;278;8660;8721;7.64;0.47;267.44;7.43;958;48;2982.00;61
7704;47;626126961;7704;279;8664;8725;7.60;0.46;267.45;7.42;960;48;2983.00;61
7709;47;626126975;7709;273;8664;8725;7.56;0.46;267.53;7.42;955;48;2984.00;61
7710;47;626126989;7710;271;8664;8725;7.52;0.46;267.56;7.42;954;48;2985.00;61
7716;47;626127006;7716;267;8664;8725;7.44;0.45;267.53;7.42;948;48;2986.00;61
7720;47;626127034;7720;266;8664;8725;7.39;0.45;267.55;7.42;944;48;2987.00;61
7723;47;626127053;7723;255;8674;8737;7.39;0.45;267.51;7.42;951;48;2988.00;63
7727;47;626127074;7727;250;8675;8737;7.32;0.45;267.66;7.42;948;48;2989.00;62
7730;47;626127092;7730;247;8676;8737;7.25;0.44;267.60;7.42;946;48;2990.00;61
7732;47;626127111;7732;245;8677;8737;7.22;0.44;267.58;7.46;945;48;2991.00;60
7734;47;626127128;7734;237;8677;8737;7.22;0.44;267.57;7.46;943;48;2992.00;60
7735;47;626127141;7735;236;8679;8737;7.29;0.44;267.59;7.47;944;48;2993.00;58
7738;47;626127153;7738;229;8680;8738;7.30;0.44;267.59;7.47;942;48;2994.00;58
7740;47;626127165;7740;229;8682;8738;7.36;0.45;267.60;7.50;942;48;2995.00;56
7744;48;626127178;7744;227;8686;8744;7.47;0.45;267.64;7.54;942;49;2996.00;58
7746;48;626127206;7746;214;8687;8745;7.58;0.46;267.65;7.54;941;49;2997.00;58
7750;48;626127218;7750;215;8688;8745;7.64;0.46;267.62;7.54;938;49;2998.00;57
7753;48;626127231;7753;212;8688;8745;7.67;0.46;267.59;7.54;935;49;2999.00;57
7757;48;626127246;7757;205;8692;8765;7.73;0.47;267.63;7.54;935;49;3000.00;73
7762;48;626127268;7762;201;8693;8765;7.76;0.47;267.67;7.58;931;49;3001.00;72
7765;48;626127281;7765;204;8694;8765;7.79;0.47;267.75;7.58;929;49;3002.00;71
7770;48;626127293;7770;202;8695;8766;7.88;0.48;267.84;7.58;925;49;3003.00;71
7771;48;626127306;7771;201;8699;8770;7.98;0.48;267.81;7.62;928;49;3004.00;71
7776;48;626127318;7776;199;8699;8770;8.02;0.49;267.85;7.62;923;49;3005.00;71
7778;48;626127331;7778;192;8702;8773;8.14;0.49;267.89;7.61;924;49;3006.00;71
7780;48;626127344;7780;187;8705;8773;8.23;0.50;267.87;7.62;925;49;3007.00;68
7785;48;626127356;7785;189;8708;8773;8.26;0.50;267.96;7.66;923;49;3008.00;65
7789;48;626127369;7789;185;8708;8773;8.34;0.50;268.01;7.66;919;49;3009.00;65
7790;48;626127381;7790;180;8710;8777;8.41;0.51;268.00;7.67;920;49;3010.00;67
7793;48;626127394;7793;183;8711;8777;8.48;0.51;267.99;7.67;918;49;3011.00;66
7794;48;626127406;7794;176;8714;8777;8.52;0.52;268.00;7.67;920;49;3012.00;63
7795;48;626127419;7795;177;8714;8777;8.54;0.52;267.98;7.67;919;49;3013.00;63
7800;48;626127431;7800;177;8715;8778;8.59;0.52;268.01;7.67;915;49;3014.00;63
7803;48;626127444;7803;175;8719;8780;8.56;0.52;268.09;7.67;916;49;3015.00;61
7804;48;626127457;7804;173;8720;8780;8.60;0.52;268.08;7.67;916;49;3016.00;60
7809;48;626127471;7809;176;8722;8781;8.68;0.53;268.14;7.67;913;49;3017.00;59
7813;48;626127485;7813;174;8722;8781;8.73;0.53;268.17;7.67;909;49;3018.00;59
7815;48;626127498;7815;182;8722;8781;8.78;0.53;268.18;7.67;907;49;3019.00;59
7817;48;626127511;7817;186;8725;8781;8.84;0.53;268.23;7.68;908;49;3020.00;56
7821;48;626127525;7821;178;8726;8781;8.90;0.54;268.29;7.70;905;49;3021.00;55
7821;48;626127538;7821;183;8726;8781;8.94;0.54;268.29;7.70;905;49;3022.00;55
7825;48;626127550;7825;180;8729;8781;8.95;0.54;268.35;7.76;904;49;3023.00;52
7829;48;626127564;7829;207;8792;8908;8.89;0.55;268.44;7.71;963;49;3024.00;116
7831;48;626127587;7831;194;8796;8909;8.91;0.55;268.47;7.71;965;49;3025.00;113
7834;48;626127600;7834;193;8806;8909;8.89;0.55;268.51;7.72;972;49;3026.00;103
7837;48;626127614;7837;190;8808;8909;8.88;0.54;268.55;7.73;971;49;3027.00;101
7839;48;626127628;7839;194;8815;8909;8.90;0.55;268.54;7.74;976;49;3028.00;94
7840;48;626127649;7840;196;8818;8909;8.87;0.55;268.57;7.75;978;49;3029.00;91
7842;49;626127665;7842;194;8820;8909;8.86;0.55;268.61;7.76;978;50;3030.00;89
7843;49;626127692;7843;200;8828;8909;8.87;0.55;268.57;7.80;985;50;3031.00;81
7844;49;626127706;7844;211;8829;8910;8.92;0.55;268.58;7.80;985;50;3032.00;81
7848;49;626127721;7848;214;8834;8911;8.98;0.55;268.61;7.80;986;50;3033.00;77
7851;49;626127737;7851;219;8839;8911;8.96;0.55;268.67;7.82;988;50;3034.00;72
7853;49;626127753;7853;227;8843;8912;8.98;0.55;268.75;7.82;990;50;3035.00;69
7855;49;626127770;7855;237;8849;8912;8.94;0.55;268.88;7.85;994;50;3036.00;63
7858;49;626127786;7858;242;8854;8912;8.83;0.54;268.84;7.85;996;50;3037.00;58
7861;49;626127802;7861;249;8856;8912;8.73;0.54;268.78;7.86;995;50;3038.00;56
7862;49;626127817;7862;256;8861;8916;8.65;0.53;268.80;7.87;999;50;3039.00;55
7867;49;626127833;7867;260;8865;8916;8.54;0.53;268.82;7.87;998;50;3040.00;51
7870;49;626127847;7870;265;8867;8916;8.46;0.52;268.88;7.87;997;50;3041.00;49
7873;49;626127866;7873;264;8871;8919;8.37;0.51;268.86;7.88;998;50;3042.00;48
7879;49;626127889;7879;268;8874;8919;8.26;0.51;268.88;7.88;995;50;3043.00;45
7882;49;626127903;7882;267;8875;8919;8.14;0.50;268.90;7.88;993;50;3044.00;44
7883;49;626127917;7883;270;8879;8923;8.06;0.49;268.92;7.89;996;50;3045.00;44
7888;49;626127931;7888;271;8882;8924;8.02;0.49;268.97;7.89;994;50;3046.00;42
7892;49;626127945;7892;272;8882;8924;7.93;0.48;268.97;7.89;990;50;3047.00;42
7894;49;626127958;7894;281;8887;8928;7.91;0.48;269.05;7.89;993;50;3048.00;41
7898;49;626127980;7898;287;8887;8928;7.80;0.48;269.10;7.89;989;50;3049.00;41
7900;49;626127993;7900;290;8889;8928;7.72;0.47;269.06;7.90;989;50;3050.00;39
7905;49;626128008;7905;288;8890;8929;7.60;0.46;269.13;7.90;985;50;3051.00;39
7908;49;626128021;7908;293;8890;8929;7.47;0.46;269.13;7.90;982;50;3052.00;39
7911;49;626128032;7911;299;8897;8935;7.36;0.45;269.24;7.90;986;50;3053.00;38
7914;49;626128045;7914;303;8898;8935;7.20;0.44;269.26;7.91;984;50;3054.00;37
7919;49;626128056;7919;308;8898;8936;7.04;0.43;269.31;7.91;979;50;3055.00;38
7924;49;626128068;7924;313;8899;8936;6.84;0.42;269.29;7.91;975;50;3056.00;37
7928;49;626128079;7928;324;8900;8936;6.69;0.41;269.39;7.92;972;50;3057.00;36
7934;49;626128089;7934;336;8900;8936;6.53;0.40;269.44;7.92;966;50;3058.00;36
7937;49;626128100;7937;346;8900;8936;6.35;0.39;269.50;7.92;963;50;3059.00;36
7943;49;626128111;7943;341;8927;8972;6.30;0.39;269.61;7.91;984;50;3060.00;45
7947;49;626128125;7947;346;8928;8972;6.28;0.39;269.71;7.92;981;50;3061.00;44
7951;49;626128135;7951;347;8932;8972;6.28;0.39;269.77;7.92;981;50;3062.00;40
7955;49;626128146;7955;344;8933;8972;6.19;0.38;269.85;7.92;978;50;3063.00;39
7958;49;626128157;7958;347;8936;8972;6.14;0.38;269.97;7.92;978;50;3064.00;36
7961;49;626128167;7961;337;8938;8972;6.13;0.38;270.04;7.92;977;50;3065.00;34
7964;49;626128178;7964;343;8941;8976;6.08;0.37;270.07;7.92;977;50;3066.00;35
7966;49;626128189;7966;345;8942;8976;6.09;0.37;270.09;7.92;976;50;3067.00;34
7970;49;626128200;7970;341;8944;8980;6.12;0.38;270.19;7.91;974;50;3068.00;36
7973;49;626128211;7973;338;8946;8981;6.15;0.38;270.18;7.91;973;50;3069.00;35
7977;49;626128222;7977;335;8947;8981;6.18;0.38;270.25;7.91;970;50;3070.00;34
7979;49;626128233;7979;333;8947;8981;6.22;0.38;270.29;7.91;968;50;3071.00;34
7980;49;626128243;7980;340;8959;8994;6.31;0.39;270.34;7.90;979;50;3072.00;35
7983;49;626128256;7983;338;8959;8994;6.32;0.39;270.46;7.90;976;50;3073.00;35
7987;49;626128268;7987;346;8959;8994;6.32;0.39;270.57;7.90;972;50;3074.00;35
7990;49;626128279;7990;334;8960;8995;6.31;0.39;270.55;7.90;970;50;3075.00;35
7991;49;626128289;7991;338;8960;8996;6.30;0.39;270.52;7.90;969;50;3076.00;36
7993;49;626128300;7993;337;8960;8996;6.26;0.38;270.47;7.90;967;50;3077.00;36
7996;49;626128311;7996;339;8962;8999;6.27;0.39;270.44;7.90;966;50;3078.00;37
8001;49;626128322;8001;339;8962;8999;6.24;0.38;270.47;7.90;961;50;3079.00;37
8005;49;626128333;8005;342;8963;8999;6.22;0.38;270.44;7.90;958;50;3080.00;36
8009;49;626128344;8009;341;8963;8999;6.20;0.38;270.40;7.90;954;50;3081.00;36
8013;49;626128361;8013;345;8967;9005;6.20;0.38;270.39;7.90;954;50;3082.00;38
8013;49;626128373;8013;352;8967;9005;6.16;0.38;270.39;7.90;954;50;3083.00;38
8017;49;626128384;8017;355;8968;9005;6.12;0.38;270.35;7.90;951;50;3084.00;37
8024;49;626128396;8024;367;8968;9005;6.00;0.37;270.26;7.90;944;50;3085.00;37
8028;49;626128407;8028;372;8971;9009;5.96;0.36;270.24;7.89;943;50;3086.00;38
8031;49;626128418;8031;380;8972;9010;5.92;0.36;270.29;7.89;941;50;3087.00;38
8037;49;626128429;8037;379;8972;9010;5.83;0.36;270.40;7.89;935;50;3088.00;38
8041;49;626128440;8041;383;8973;9011;5.77;0.35;270.39;7.89;932;50;3089.00;38
8043;49;626128453;8043;381;8973;9011;5.77;0.35;270.37;7.89;930;50;3090.00;38
8046;49;626128464;8046;390;8973;9011;5.71;0.35;270.35;7.89;927;50;3091.00;38
8049;49;626128475;8049;387;8973;9011;5.67;0.35;270.33;7.89;924;50;3092.00;38
8051;49;626128486;8051;387;8973;9011;5.63;0.34;270.35;7.89;922;50;3093.00;38
8056;49;626128497;8056;388;8973;9011;5.62;0.34;270.40;7.89;917;50;3094.00;38
8058;49;626128508;8058;391;8973;9011;5.63;0.34;270.36;7.89;915;50;3095.00;38
8060;49;626128518;8060;396;9013;9081;5.85;0.36;270.38;7.86;953;50;3096.00;68
8060;49;626128534;8060;390;9014;9082;5.86;0.36;270.38;7.86;954;50;3097.00;68
8064;49;626128545;8064;388;9022;9082;5.93;0.36;270.36;7.85;958;50;3098.00;60
8067;49;626128556;8067;392;9024;9082;5.99;0.37;270.39;7.85;957;50;3099.00;58
8068;49;626128568;8068;391;9028;9082;6.15;0.38;270.36;7.85;960;50;3100.00;54
8068;49;626128583;8068;394;9030;9082;6.21;0.38;270.36;7.85;962;50;3101.00;52
8070;49;626128594;8070;401;9033;9082;6.28;0.39;270.36;7.85;963;50;3102.00;49
8071;49;626128605;8071;406;9036;9082;6.33;0.39;270.36;7.85;965;50;3103.00;46
8074;49;626128616;8074;411;9038;9083;6.34;0.39;270.35;7.85;964;50;3104.00;45
8075;49;626128627;8075;417;9042;9085;6.35;0.39;270.34;7.84;967;50;3105.00;43
8076;49;626128639;8076;421;9042;9085;6.23;0.38;270.36;7.84;966;50;3106.00;43
8079;49;626128650;8079;403;9045;9089;6.16;0.38;270.35;7.84;966;50;3107.00;44
8082;49;626128662;8082;386;9046;9089;6.15;0.38;270.33;7.89;964;50;3108.00;43
8087;49;626128675;8087;380;9046;9089;6.17;0.38;270.30;7.89;959;50;3109.00;43
8090;49;626128687;8090;377;9046;9089;6.28;0.39;270.47;7.89;956;50;3110.00;43
8092;49;626128699;8092;367;9050;9095;6.40;0.40;270.51;7.88;958;50;3111.00;45
8095;50;626128711;8095;355;9051;9095;6.57;0.41;270.47;7.88;956;51;3112.00;44
8098;50;626128735;8098;342;9051;9095;6.68;0.41;270.48;7.88;953;51;3113.00;44
8104;50;626128753;8104;341;9053;9098;6.78;0.42;270.48;7.88;949;51;3114.00;45
8107;50;626128766;8107;333;9053;9098;6.89;0.42;270.48;7.88;946;51;3115.00;45
8110;50;626128784;8110;311;9054;9098;7.05;0.43;270.45;7.88;944;51;3116.00;44
8111;50;626128798;8111;293;9054;9099;7.15;0.44;270.42;7.88;943;51;3117.00;45
8112;50;626128812;8112;282;9055;9100;7.26;0.44;270.42;7.88;943;51;3118.00;45
8112;50;626128825;8112;272;9055;9100;7.38;0.45;270.42;7.88;943;51;3119.00;45
8116;50;626128841;8116;273;9075;9126;7.56;0.46;270.38;7.86;959;51;3120.00;51
8116;50;626128856;8116;266;9076;9126;7.69;0.47;270.38;7.86;960;51;3121.00;50
8119;50;626128870;8119;264;9078;9126;7.83;0.48;270.36;7.90;959;51;3122.00;48
8121;50;626128883;8121;259;9079;9127;7.93;0.48;270.32;7.90;958;51;3123.00;48
8121;50;626128897;8121;249;9079;9127;8.05;0.49;270.32;7.90;958;51;3124.00;48
8123;50;626128910;8123;258;9082;9131;8.13;0.49;270.28;7.90;959;51;3125.00;49
8125;50;626128924;8125;256;9082;9131;8.18;0.50;270.32;7.90;957;51;3126.00;49
8126;50;626128937;8126;255;9086;9135;8.23;0.50;270.32;7.90;960;51;3127.00;49
8128;50;626128951;8128;254;9086;9135;8.26;0.50;270.31;7.90;958;51;3128.00;49
8129;50;626128964;8129;253;9086;9135;8.32;0.51;270.29;7.90;957;51;3129.00;49
8132;50;626128978;8132;255;9086;9135;8.36;0.51;270.32;7.90;954;51;3130.00;49
8136;50;626128991;8136;255;9086;9135;8.34;0.51;270.34;7.90;950;51;3131.00;49
8137;50;626129010;8137;250;9096;9147;8.39;0.51;270.32;7.89;959;51;3132.00;51
8142;50;626129033;8142;248;9096;9147;8.40;0.51;270.44;7.89;954;51;3133.00;51
8147;50;626129061;8147;247;9097;9147;8.33;0.51;270.48;7.89;950;51;3134.00;50
8151;50;626129082;8151;251;9097;9147;8.33;0.51;270.55;7.89;946;51;3135.00;50
8155;50;626129102;8155;254;9097;9147;8.34;0.51;270.58;7.89;942;51;3136.00;50
8158;50;626129124;8158;251;9097;9147;8.35;0.51;270.61;7.89;939;51;3137.00;50
8164;50;626129141;8164;259;9097;9148;8.32;0.50;270.61;7.89;933;51;3138.00;51
8165;50;626129155;8165;261;9097;9148;8.32;0.50;270.63;7.89;932;51;3139.00;51
8168;50;626129171;8168;261;9101;9154;8.30;0.50;270.60;7.88;933;51;3140.00;53
8170;50;626129186;8170;256;9102;9155;8.33;0.51;270.63;7.88;932;51;3141.00;53
8171;50;626129201;8171;262;9103;9155;8.39;0.51;270.64;7.88;932;51;3142.00;52
8174;50;626129216;8174;263;9103;9155;8.37;0.51;270.71;7.88;929;51;3143.00;52
8175;50;626129231;8175;267;9106;9159;8.32;0.51;270.74;7.88;931;51;3144.00;53
8177;50;626129245;8177;271;9106;9159;8.27;0.50;270.80;7.88;929;51;3145.00;53
8181;50;626129260;8181;278;9106;9159;8.15;0.49;270.91;7.88;925;51;3146.00;53
8182;50;626129274;8182;286;9107;9160;8.12;0.49;270.92;7.88;925;51;3147.00;53
8185;50;626129288;8185;292;9110;9164;8.01;0.49;270.91;7.88;925;51;3148.00;54
8188;50;626129302;8188;299;9110;9164;7.96;0.48;271.01;7.88;922;51;3149.00;54
8191;50;626129318;8191;295;9113;9170;7.94;0.48;271.07;7.87;922;51;3150.00;57
8194;50;626129333;8194;290;9113;9170;7.91;0.48;271.14;7.87;919;51;3151.00;57
8196;50;626129347;8196;283;9114;9170;7.90;0.48;271.11;7.87;918;51;3152.00;56
8199;50;626129361;8199;283;9114;9170;7.91;0.48;271.15;7.87;915;51;3153.00;56
8204;50;626129375;8204;277;9117;9174;7.92;0.48;271.26;7.87;913;51;3154.00;57
8206;50;626129389;8206;270;9117;9174;7.90;0.48;271.24;7.87;911;51;3155.00;57
8210;50;626129402;8210;264;9118;9174;7.92;0.48;271.29;7.87;908;51;3156.00;56
8212;50;626129416;8212;259;9118;9174;7.98;0.49;271.32;7.87;906;51;3157.00;56
8216;50;626129428;8216;259;9119;9175;7.94;0.49;271.33;7.87;903;51;3158.00;56
8222;50;626129443;8222;248;9120;9176;7.90;0.48;271.40;7.87;898;51;3159.00;56
8225;50;626129456;8225;240;9121;9176;7.86;0.48;271.42;7.87;896;51;3160.00;55
8230;50;626129471;8230;234;9122;9177;7.77;0.48;271.44;7.87;892;51;3161.00;55
8235;50;626129484;8235;224;9122;9177;7.68;0.47;271.49;7.87;887;51;3162.00;55
8238;50;626129497;8238;209;9123;9177;7.64;0.47;271.49;7.92;885;51;3163.00;54
8241;50;626129509;8241;204;9124;9177;7.62;0.47;271.52;7.93;883;51;3164.00;53
8243;50;626129528;8243;198;9125;9177;7.61;0.47;271.51;7.94;882;51;3165.00;52
8249;51;626129542;8249;194;9125;9177;7.67;0.47;271.53;7.94;876;52;3166.00;52
8254;51;626129567;8254;189;9125;9177;7.77;0.47;271.62;7.94;871;52;3167.00;52
8259;51;626129580;8259;205;9192;9304;7.81;0.48;271.60;7.89;933;52;3168.00;112
8262;51;626129606;8262;190;9193;9305;7.89;0.49;271.59;7.89;931;52;3169.00;112
8268;51;626129620;8268;178;9201;9305;7.95;0.49;271.64;7.88;933;52;3170.00;104
8273;51;626129635;8273;176;9205;9305;8.06;0.50;271.62;7.88;932;52;3171.00;100
8277;51;626129649;8277;174;9209;9305;8.14;0.50;271.59;7.88;932;52;3172.00;96
8279;51;626129663;8279;169;9212;9305;8.19;0.50;271.66;7.88;933;52;3173.00;93
8285;51;626129682;8285;164;9218;9305;8.28;0.51;271.69;7.87;933;52;3174.00;87
8289;51;626129697;8289;162;9220;9305;8.43;0.52;271.74;7.87;931;52;3175.00;85
8292;51;626129711;8292;161;9223;9306;8.52;0.52;271.74;7.87;931;52;3176.00;83
8296;51;626129731;8296;158;9229;9307;8.63;0.53;271.81;7.91;933;52;3177.00;78
8301;51;626129745;8301;166;9232;9307;8.73;0.53;271.82;7.91;931;52;3178.00;75
8303;51;626129759;8303;166;9233;9308;8.79;0.54;271.87;7.91;930;52;3179.00;75
8309;51;626129775;8309;168;9237;9308;8.78;0.53;271.96;7.92;928;52;3180.00;71
8312;51;626129789;8312;169;9240;9308;8.69;0.53;271.91;7.95;928;52;3181.00;68
8314;51;626129806;8314;176;9243;9308;8.67;0.53;271.93;7.95;929;52;3182.00;65
8315;51;626129819;8315;183;9246;9312;8.67;0.53;271.97;7.95;931;52;3183.00;66
8317;51;626129834;8317;192;9248;9312;8.65;0.53;272.04;7.95;931;52;3184.00;64
8320;51;626129849;8320;194;9249;9312;8.68;0.53;272.06;7.95;929;52;3185.00;63
8322;51;626129864;8322;199;9252;9315;8.70;0.53;272.10;7.95;930;52;3186.00;63
8325;51;626129879;8325;213;9253;9315;8.67;0.53;272.21;7.96;928;52;3187.00;62
8326;51;626129893;8326;216;9254;9315;8.71;0.53;272.24;7.96;928;52;3188.00;61
8328;51;626129906;8328;227;9257;9319;8.69;0.53;272.27;7.96;929;52;3189.00;62
8331;51;626129921;8331;235;9260;9320;8.73;0.53;272.28;7.97;929;52;3190.00;60
8336;51;626129936;8336;233;9263;9322;8.75;0.53;272.31;7.99;927;52;3191.00;59
8339;51;626129951;8339;238;9267;9326;8.85;0.54;272.31;7.99;928;52;3192.00;59
8342;51;626129966;8342;246;9267;9326;8.91;0.54;272.33;7.99;925;52;3193.00;59
8346;51;626129981;8346;241;9268;9326;8.92;0.54;272.43;8.01;922;52;3194.00;58
8349;51;626129999;8349;243;9270;9328;8.88;0.54;272.49;8.01;921;52;3195.00;58
8350;51;626130027;8350;247;9273;9328;8.85;0.54;272.51;8.05;923;52;3196.00;55
8354;51;626130043;8354;247;9277;9334;8.79;0.53;272.56;8.04;923;52;3197.00;57
8356;51;626130065;8356;248;9278;9334;8.66;0.53;272.57;8.05;922;52;3198.00;56
8358;51;626130079;8358;249;9280;9335;8.57;0.52;272.58;8.07;922;52;3199.00;55
8360;51;626130094;8360;254;9281;9335;8.44;0.51;272.62;8.07;921;52;3200.00;54
8361;51;626130110;8361;249;9282;9335;8.35;0.51;272.63;8.09;921;52;3201.00;53
8365;51;626130123;8365;253;9283;9335;8.27;0.50;272.66;8.09;918;52;3202.00;52
8367;51;626130136;8367;252;9284;9335;8.27;0.50;272.64;8.10;917;52;3203.00;51
8371;51;626130149;8371;254;9294;9347;8.28;0.50;272.72;8.10;923;52;3204.00;53
8374;51;626130163;8374;251;9295;9347;8.27;0.50;272.78;8.11;921;52;3205.00;52
8376;51;626130175;8376;251;9297;9347;8.27;0.50;272.77;8.11;921;52;3206.00;50
8379;51;626130188;8379;254;9299;9347;8.17;0.50;272.82;8.13;920;52;3207.00;48
8382;51;626130201;8382;255;9299;9347;8.07;0.49;272.88;8.13;917;52;3208.00;48
8382;51;626130214;8382;255;9300;9347;8.02;0.49;272.88;8.14;918;52;3209.00;47
8386;51;626130228;8386;256;9304;9351;7.90;0.48;272.91;8.14;918;52;3210.00;47
8390;51;626130242;8390;259;9305;9351;7.80;0.48;273.01;8.15;915;52;3211.00;46
8392;51;626130255;8392;266;9308;9355;7.85;0.48;273.01;8.15;916;52;3212.00;47
8396;51;626130267;8396;265;9311;9356;7.85;0.48;273.05;8.16;915;52;3213.00;45
8397;51;626130279;8397;273;9312;9356;7.86;0.48;273.04;8.16;915;52;3214.00;44
8399;51;626130292;8399;272;9312;9356;7.84;0.48;273.01;8.16;913;52;3215.00;44
8401;51;626130303;8401;273;9325;9369;7.81;0.48;273.00;8.17;924;52;3216.00;44
8403;51;626130317;8403;276;9325;9369;7.79;0.48;272.99;8.17;922;52;3217.00;44
8403;51;626130328;8403;283;9327;9369;7.79;0.48;272.99;8.18;924;52;3218.00;42
8406;51;626130340;8406;283;9329;9370;7.74;0.47;272.95;8.19;923;52;3219.00;41
8407;51;626130352;8407;287;9329;9371;7.71;0.47;272.99;8.19;922;52;3220.00;42
8410;51;626130364;8410;291;9330;9371;7.63;0.47;272.99;8.19;920;52;3221.00;41
8414;51;626130376;8414;303;9333;9374;7.58;0.46;273.05;8.19;919;52;3222.00;41
8416;51;626130389;8416;306;9334;9374;7.48;0.46;273.01;8.20;918;52;3223.00;40
8422;51;626130399;8422;318;9335;9374;7.38;0.45;272.97;8.20;913;52;3224.00;39
8427;51;626130411;8427;320;9337;9374;7.29;0.45;272.90;8.21;910;52;3225.00;37
8429;51;626130422;8429;323;9341;9380;7.24;0.44;272.90;8.20;912;52;3226.00;39
8434;51;626130434;8434;334;9343;9380;7.11;0.44;272.89;8.20;909;52;3227.00;37
8436;51;626130445;8436;340;9344;9380;6.98;0.43;272.93;8.21;908;52;3228.00;36
8439;51;626130456;8439;340;9344;9380;6.79;0.42;272.94;8.21;905;52;3229.00;36
8441;51;626130467;8441;338;9349;9384;6.67;0.41;272.96;8.22;908;52;3230.00;35
8443;51;626130478;8443;331;9350;9385;6.60;0.41;272.97;8.22;907;52;3231.00;35
8447;51;626130489;8447;330;9351;9385;6.50;0.40;272.98;8.22;904;52;3232.00;34
8449;51;626130499;8449;338;9353;9386;6.44;0.39;273.02;8.22;904;52;3233.00;33
8452;51;626130510;8452;342;9353;9386;6.45;0.40;273.01;8.22;901;52;3234.00;33
8457;51;626130521;8457;338;9355;9386;6.41;0.39;273.09;8.23;898;52;3235.00;31
8457;51;626130532;8457;336;9355;9386;6.46;0.40;273.09;8.23;898;52;3236.00;31
8461;51;626130542;8461;335;9355;9386;6.45;0.40;273.07;8.23;894;52;3237.00;31
8463;51;626130552;8463;335;9355;9386;6.46;0.40;273.07;8.23;892;52;3238.00;31
8467;51;626130563;8467;330;9358;9386;6.42;0.39;273.04;8.23;891;52;3239.00;28
8470;51;626130576;8470;325;9412;9511;6.70;0.42;273.02;8.18;942;52;3240.00;99
8473;51;626130597;8473;328;9419;9512;6.70;0.42;273.06;8.18;946;52;3241.00;93
8479;51;626130609;8479;333;9430;9512;6.77;0.42;273.09;8.17;951;52;3242.00;82
8484;51;626130620;8484;323;9436;9512;6.76;0.42;273.07;8.17;952;52;3243.00;76
8487;51;626130632;8487;322;9440;9512;6.69;0.41;273.03;8.17;953;52;3244.00;72
8492;51;626130644;8492;329;9445;9512;6.59;0.41;273.06;8.17;953;52;3245.00;67
8492;51;626130656;8492;331;9449;9512;6.56;0.41;273.06;8.17;957;52;3246.00;63
8495;51;626130668;8495;342;9451;9512;6.48;0.40;273.06;8.17;956;52;3247.00;61
8497;51;626130680;8497;347;9455;9513;6.47;0.40;273.08;8.17;958;52;3248.00;58
8501;51;626130692;8501;347;9458;9514;6.44;0.40;273.04;8.17;957;52;3249.00;56
8504;51;626130704;8504;342;9460;9514;6.40;0.40;273.00;8.17;956;52;3250.00;54
8510;51;626130718;8510;345;9464;9518;6.38;0.39;273.01;8.16;954;52;3251.00;54
8514;51;626130736;8514;344;9468;9518;6.32;0.39;272.95;8.17;954;52;3252.00;50
8517;51;626130749;8517;351;9468;9518;6.24;0.39;272.97;8.17;951;52;3253.00;50
8520;51;626130766;8520;354;9468;9518;6.16;0.38;273.00;8.17;948;52;3254.00;50
8524;51;626130779;8524;368;9472;9524;6.10;0.38;273.00;8.16;948;52;3255.00;52
8527;51;626130792;8527;377;9474;9524;6.07;0.38;273.02;8.20;947;52;3256.00;50
8531;51;626130804;8531;384;9474;9524;5.98;0.37;272.99;8.20;943;52;3257.00;50
8538;51;626130816;8538;391;9476;9527;5.88;0.36;273.16;8.20;938;52;3258.00;51
8540;51;626130829;8540;373;9477;9527;5.87;0.36;273.15;8.20;937;52;3259.00;50
8542;51;626130842;8542;367;9477;9527;5.91;0.36;273.16;8.20;935;52;3260.00;50
8546;51;626130854;8546;364;9478;9528;5.93;0.36;273.11;8.20;932;52;3261.00;50
8549;51;626130867;8549;355;9479;9529;5.91;0.36;273.08;8.20;930;52;3262.00;50
8551;51;626130879;8551;348;9479;9529;5.95;0.37;273.06;8.20;928;52;3263.00;50
8552;51;626130892;8552;346;9490;9542;6.15;0.38;273.04;8.19;938;52;3264.00;52
8554;52;626130905;8554;345;9490;9542;6.23;0.38;273.05;8.19;936;53;3265.00;52
8558;52;626130934;8558;341;9490;9542;6.32;0.39;273.01;8.19;932;53;3266.00;52
8561;52;626130948;8561;340;9491;9543;6.42;0.39;272.98;8.19;930;53;3267.00;52
8562;52;626130966;8562;339;9491;9543;6.53;0.40;272.98;8.19;929;53;3268.00;52
8563;52;626130979;8563;340;9495;9547;6.56;0.40;272.99;8.23;932;53;3269.00;52
8565;52;626131000;8565;343;9495;9547;6.61;0.41;272.99;8.23;930;53;3270.00;52
8566;52;626131021;8566;340;9499;9551;6.66;0.41;273.01;8.22;933;53;3271.00;52
8570;52;626131044;8570;337;9500;9551;6.67;0.41;272.96;8.26;930;53;3272.00;51
8575;52;626131067;8575;336;9500;9551;6.66;0.41;272.91;8.26;925;53;3273.00;51
8579;52;626131085;8579;337;9500;9551;6.65;0.41;272.91;8.26;921;53;3274.00;51
8580;52;626131103;8580;351;9501;9551;6.67;0.41;272.90;8.30;921;53;3275.00;50
8581;52;626131120;8581;354;9510;9563;6.80;0.41;272.93;8.30;929;53;3276.00;53
8583;52;626131136;8583;346;9511;9563;6.81;0.42;272.98;8.34;928;53;3277.00;52
8583;52;626131151;8583;346;9513;9563;6.92;0.42;272.98;8.34;930;53;3278.00;50
8584;52;626131169;8584;341;9513;9563;7.01;0.43;272.96;8.34;929;53;3279.00;50
8586;52;626131183;8586;341;9513;9563;7.05;0.43;272.99;8.34;927;53;3280.00;50
8590;52;626131198;8590;336;9514;9563;7.07;0.43;272.99;8.38;924;53;3281.00;49
8593;52;626131214;8593;332;9514;9564;7.11;0.43;273.06;8.38;921;53;3282.00;50
8597;52;626131232;8597;330;9514;9564;7.15;0.44;273.12;8.38;917;53;3283.00;50
8599;52;626131247;8599;331;9518;9570;7.23;0.44;273.10;8.37;919;53;3284.00;52
8603;52;626131263;8603;336;9520;9572;7.24;0.44;273.14;8.37;917;53;3285.00;52
8607;52;626131277;8607;327;9521;9572;7.28;0.44;273.19;8.37;914;53;3286.00;51
8610;52;626131291;8610;319;9521;9572;7.38;0.45;273.19;8.37;911;53;3287.00;51
8612;52;626131306;8612;304;9524;9576;7.47;0.46;273.19;8.37;912;53;3288.00;52
8614;52;626131320;8614;295;9524;9576;7.52;0.46;273.21;8.37;910;53;3289.00;52
8618;52;626131334;8618;290;9524;9576;7.56;0.46;273.22;8.37;906;53;3290.00;52
8619;52;626131348;8619;288;9525;9577;7.60;0.46;273.22;8.37;906;53;3291.00;52
8624;52;626131362;8624;291;9528;9581;7.60;0.46;273.27;8.37;904;53;3292.00;53
8625;52;626131376;8625;291;9528;9581;7.65;0.46;273.30;8.37;903;53;3293.00;53
8627;52;626131390;8627;289;9530;9584;7.70;0.47;273.34;8.36;903;53;3294.00;54
8630;52;626131404;8630;288;9530;9584;7.68;0.47;273.38;8.36;900;53;3295.00;54
8630;52;626131418;8630;297;9531;9584;7.77;0.47;273.38;8.36;901;53;3296.00;53
8631;52;626131431;8631;289;9531;9584;7.87;0.48;273.42;8.36;900;53;3297.00;53
8634;53;626131445;8634;286;9534;9588;7.92;0.48;273.46;8.36;900;54;3298.00;54
8636;53;626131474;8636;285;9534;9588;7.96;0.48;273.46;8.36;898;54;3299.00;54
8640;53;626131491;8640;286;9538;9607;7.95;0.48;273.49;8.36;898;54;3300.00;69
8642;53;626131512;8642;273;9539;9607;7.94;0.48;273.50;8.36;897;54;3301.00;68
8645;53;626131526;8645;275;9539;9608;7.88;0.48;273.49;8.36;894;54;3302.00;69
8648;53;626131540;8648;269;9540;9609;7.83;0.48;273.54;8.36;892;54;3303.00;69
8652;53;626131561;8652;271;9540;9609;7.78;0.47;273.56;8.36;888;54;3304.00;69
8654;53;626131575;8654;269;9541;9610;7.75;0.47;273.60;8.36;887;54;3305.00;69
8658;53;626131590;8658;274;9543;9610;7.66;0.47;273.60;8.36;885;54;3306.00;67
8663;53;626131605;8663;263;9543;9610;7.63;0.47;273.66;8.36;880;54;3307.00;67
8667;53;626131618;8667;268;9543;9610;7.63;0.47;273.70;8.36;876;54;3308.00;67
8668;53;626131631;8668;266;9543;9610;7.64;0.47;273.70;8.36;875;54;3309.00;67
8671;53;626131644;8671;272;9543;9610;7.63;0.47;273.78;8.36;872;54;3310.00;67
8674;53;626131657;8674;272;9543;9610;7.61;0.46;273.84;8.36;869;54;3311.00;67
8675;53;626131670;8675;298;9611;9737;7.58;0.47;273.83;8.30;936;54;3312.00;126
8677;53;626131696;8677;288;9615;9738;7.59;0.47;273.81;8.30;938;54;3313.00;123
8680;53;626131710;8680;284;9619;9738;7.64;0.47;273.79;8.34;939;54;3314.00;119
8682;53;626131723;8682;288;9620;9738;7.70;0.48;273.80;8.34;938;54;3315.00;118
8683;53;626131736;8683;284;9623;9738;7.75;0.48;273.79;8.34;940;54;3316.00;115
8684;53;626131749;8684;286;9628;9738;7.81;0.48;273.78;8.34;944;54;3317.00;110
8688;53;626131763;8688;288;9631;9738;7.75;0.48;273.91;8.34;943;54;3318.00;107
8689;53;626131783;8689;288;9634;9738;7.77;0.48;273.89;8.34;945;54;3319.00;104
8692;53;626131796;8692;274;9637;9739;7.73;0.48;273.89;8.34;945;54;3320.00;102
8692;53;626131810;8692;273;9640;9740;7.72;0.47;273.89;8.34;948;54;3321.00;100
8699;53;626131823;8699;276;9642;9740;7.71;0.47;273.92;8.34;943;54;3322.00;98
8701;53;626131837;8701;280;9646;9741;7.69;0.47;273.96;8.34;945;54;3323.00;95
8702;53;626131851;8702;279;9646;9741;7.72;0.47;273.94;8.34;944;54;3324.00;95
8704;53;626131864;8704;279;9648;9741;7.79;0.48;274.06;8.34;944;54;3325.00;93
8708;53;626131884;8708;276;9650;9741;7.84;0.48;274.08;8.34;942;54;3326.00;91
8708;53;626131897;8708;277;9652;9745;7.84;0.48;274.08;8.34;944;54;3327.00;93
8710;53;626131911;8710;280;9655;9745;7.81;0.48;274.08;8.35;945;54;3328.00;90
8713;54;626131924;8713;285;9659;9745;7.68;0.47;274.11;8.39;946;55;3329.00;86
8719;54;626131956;8719;279;9662;9751;7.63;0.47;274.10;8.39;943;55;3330.00;89
8722;55;626131972;8722;282;9663;9751;7.59;0.46;274.10;8.39;941;56;3331.00;88
8723;55;626131999;8723;270;9665;9751;7.53;0.46;274.09;8.44;942;56;3332.00;86
8726;55;626132015;8726;267;9671;9755;7.51;0.46;274.12;8.44;945;56;3333.00;84
8730;55;626132032;8730;267;9673;9756;7.51;0.46;274.14;8.44;943;56;3334.00;83
8734;55;626132047;8734;272;9676;9756;7.52;0.46;274.10;8.51;942;56;3335.00;80
8739;55;626132067;8739;260;9677;9760;7.51;0.46;274.12;8.51;938;56;3336.00;83
8743;55;626132080;8743;253;9679;9760;7.56;0.46;274.12;8.51;936;56;3337.00;81
8747;55;626132093;8747;245;9681;9760;7.57;0.46;274.11;8.56;934;56;3338.00;79
8752;55;626132106;8752;242;9685;9761;7.58;0.46;274.13;8.56;933;56;3339.00;76
8753;55;626132120;8753;237;9686;9761;7.64;0.46;274.14;8.61;933;56;3340.00;75
8753;55;626132133;8753;227;9689;9767;7.76;0.47;274.14;8.61;936;56;3341.00;78
8755;55;626132148;8755;222;9691;9767;7.78;0.47;274.11;8.66;936;56;3342.00;76
8757;55;626132162;8757;214;9692;9768;7.81;0.47;274.14;8.66;935;56;3343.00;76
8759;55;626132180;8759;218;9693;9768;7.85;0.47;274.14;8.66;934;56;3344.00;75
8762;55;626132194;8762;213;9694;9768;7.85;0.47;274.20;8.66;932;56;3345.00;74
8763;55;626132213;8763;213;9696;9768;7.89;0.48;274.20;8.71;933;56;3346.00;72
8767;55;626132227;8767;215;9696;9768;7.93;0.48;274.23;8.71;929;56;3347.00;72
8769;55;626132240;8769;220;9708;9780;7.98;0.48;274.36;8.75;939;56;3348.00;72
8771;55;626132254;8771;221;9708;9780;7.98;0.48;274.35;8.75;937;56;3349.00;72
8773;55;626132268;8773;223;9712;9780;8.00;0.48;274.35;8.76;939;56;3350.00;68
8777;55;626132281;8777;218;9715;9780;7.97;0.48;274.32;8.80;938;56;3351.00;65
8779;55;626132294;8779;221;9718;9780;7.93;0.48;274.34;8.81;939;56;3352.00;62
8783;55;626132307;8783;215;9718;9780;7.86;0.48;274.41;8.81;935;56;3353.00;62
8783;55;626132320;8783;220;9723;9784;7.85;0.48;274.41;8.81;940;56;3354.00;61
8785;56;626132335;8785;222;9723;9784;7.88;0.48;274.43;8.81;938;57;3355.00;61
8788;56;626132358;8788;226;9727;9788;7.89;0.48;274.42;8.80;939;57;3356.00;61
8788;56;626132372;8788;233;9728;9789;7.95;0.48;274.42;8.80;940;57;3357.00;61
8791;56;626132384;8791;240;9728;9789;7.95;0.48;274.45;8.80;937;57;3358.00;61
8793;56;626132398;8793;246;9728;9789;7.91;0.48;274.46;8.80;935;57;3359.00;61
8797;56;626132413;8797;253;9750;9818;7.82;0.47;274.53;8.81;953;57;3360.00;68
8799;56;626132430;8799;257;9751;9818;7.83;0.48;274.56;8.81;952;57;3361.00;67
8803;56;626132444;8803;256;9755;9818;7.83;0.47;274.60;8.81;952;57;3362.00;63
8805;56;626132458;8805;263;9758;9819;7.83;0.48;274.59;8.82;953;57;3363.00;61
8809;56;626132478;8809;268;9758;9820;7.76;0.47;274.67;8.82;949;57;3364.00;62
8812;56;626132492;8812;274;9759;9820;7.68;0.47;274.71;8.84;947;57;3365.00;61
8815;56;626132505;8815;276;9764;9823;7.68;0.46;274.79;8.85;949;57;3366.00;59
8816;56;626132519;8816;285;9765;9823;7.64;0.46;274.76;8.87;949;57;3367.00;58
8816;56;626132533;8816;288;9766;9823;7.62;0.46;274.76;8.88;950;57;3368.00;57
8817;56;626132545;8817;295;9766;9823;7.60;0.46;274.77;8.88;949;57;3369.00;57
8817;56;626132558;8817;300;9772;9829;7.65;0.46;274.77;8.90;955;57;3370.00;57
8820;56;626132571;8820;316;9773;9829;7.58;0.46;274.86;8.89;953;57;3371.00;56
8820;56;626132584;8820;313;9775;9829;7.46;0.46;274.86;8.91;955;57;3372.00;54
8821;56;626132597;8821;321;9775;9829;7.35;0.45;274.84;8.91;954;57;3373.00;54
8824;56;626132610;8824;326;9780;9833;7.29;0.45;274.81;8.93;956;57;3374.00;53
8824;56;626132622;8824;330;9782;9835;7.20;0.44;274.81;8.93;958;57;3375.00;53
8826;56;626132635;8826;332;9784;9835;7.13;0.44;274.80;8.95;958;57;3376.00;51
8827;56;626132647;8827;340;9785;9836;7.07;0.43;274.78;8.95;958;57;3377.00;51
8828;56;626132660;8828;343;9786;9836;7.02;0.43;274.78;8.95;958;57;3378.00;50
8830;56;626132672;8830;343;9787;9836;6.93;0.43;274.84;8.96;957;57;3379.00;49
8833;56;626132685;8833;339;9788;9836;6.91;0.42;274.78;8.97;955;57;3380.00;48
8835;56;626132698;8835;343;9788;9836;6.85;0.42;274.75;8.97;953;57;3381.00;48
8838;56;626132711;8838;337;9789;9836;6.78;0.42;274.73;8.97;951;57;3382.00;47
8840;56;626132723;8840;334;9789;9836;6.70;0.41;274.69;8.97;949;57;3383.00;47
8843;56;626132734;8843;342;9829;9906;6.82;0.42;274.65;8.98;986;57;3384.00;77
8848;56;626132754;8848;343;9832;9907;6.73;0.41;274.60;8.97;984;57;3385.00;75
8848;56;626132766;8848;341;9841;9907;6.71;0.41;274.60;8.97;993;57;3386.00;66
8850;56;626132778;8850;343;9847;9907;6.63;0.41;274.56;8.97;997;57;3387.00;60
8852;56;626132789;8852;347;9852;9907;6.62;0.41;274.53;8.97;1000;57;3388.00;55
8854;56;626132801;8854;351;9856;9907;6.59;0.40;274.49;8.97;1002;57;3389.00;51
8855;56;626132815;8855;360;9859;9907;6.55;0.40;274.52;8.97;1004;57;3390.00;48
8856;56;626132826;8856;367;9864;9907;6.53;0.40;274.52;8.99;1008;57;3391.00;43
8861;56;626132838;8861;379;9867;9908;6.45;0.39;274.43;8.99;1006;57;3392.00;41
8864;56;626132851;8864;386;9869;9909;6.32;0.39;274.55;8.99;1005;57;3393.00;40
8869;56;626132862;8869;389;9870;9909;6.19;0.38;274.52;8.99;1001;57;3394.00;39
8875;56;626132874;8875;403;9874;9913;6.05;0.37;274.47;8.99;999;57;3395.00;39
8878;56;626132887;8878;408;9874;9913;5.85;0.36;274.43;8.99;996;57;3396.00;39
8882;56;626132898;8882;413;9875;9913;5.67;0.35;274.43;9.00;993;57;3397.00;38
8882;56;626132909;8882;426;9876;9913;5.57;0.34;274.43;9.00;994;57;3398.00;37
8886;56;626132920;8886;429;9881;9919;5.45;0.33;274.45;9.00;995;57;3399.00;38
8889;56;626132933;8889;421;9881;9919;5.38;0.33;274.45;9.00;992;57;3400.00;38
8892;56;626132949;8892;422;9883;9919;5.32;0.33;274.41;9.00;991;57;3401.00;36
8895;56;626132960;8895;422;9886;9922;5.28;0.32;274.42;9.01;991;57;3402.00;36
8896;56;626132972;8896;427;9887;9922;5.24;0.32;274.42;9.01;991;57;3403.00;35
8898;56;626132983;8898;429;9887;9922;5.17;0.32;274.45;9.01;989;57;3404.00;35
8902;56;626132994;8902;431;9887;9923;5.08;0.31;274.43;9.01;985;57;3405.00;36
8903;56;626133009;8903;436;9888;9924;5.09;0.31;274.45;9.01;985;57;3406.00;36
8908;56;626133027;8908;434;9889;9924;5.00;0.31;274.40;9.01;981;57;3407.00;35
8909;56;626133046;8909;434;9899;9937;5.11;0.31;274.38;9.00;990;57;3408.00;38
8911;56;626133067;8911;431;9899;9937;5.17;0.32;274.36;9.00;988;57;3409.00;38
8914;56;626133085;8914;432;9900;9937;5.21;0.32;274.36;9.00;986;57;3410.00;37
8916;56;626133102;8916;415;9901;9938;5.33;0.32;274.34;9.00;985;57;3411.00;37
8918;56;626133120;8918;400;9901;9938;5.39;0.33;274.37;9.00;983;57;3412.00;37
8918;56;626133133;8918;397;9904;9942;5.48;0.33;274.37;9.00;986;57;3413.00;38
8920;56;626133148;8920;385;9904;9942;5.60;0.34;274.35;9.00;984;57;3414.00;38
8923;56;626133161;8923;377;9907;9946;5.69;0.35;274.33;8.99;984;57;3415.00;39
8926;56;626133175;8926;370;9908;9946;5.74;0.35;274.28;8.99;982;57;3416.00;38
8929;56;626133188;8929;367;9908;9946;5.80;0.35;274.37;8.99;979;57;3417.00;38
8931;56;626133201;8931;356;9908;9946;5.85;0.36;274.33;8.99;977;57;3418.00;38
8933;56;626133215;8933;352;9908;9946;5.87;0.36;274.32;8.99;975;57;3419.00;38
8935;56;626133231;8935;354;9936;9980;6.16;0.38;274.32;8.97;1001;57;3420.00;44
8937;56;626133256;8937;355;9937;9980;6.23;0.38;274.32;8.97;1000;57;3421.00;43
8939;56;626133271;8939;346;9937;9980;6.32;0.39;274.31;8.97;998;57;3422.00;43
8943;56;626133285;8943;341;9937;9980;6.37;0.39;274.29;8.97;994;57;3423.00;43
8946;56;626133300;8946;338;9937;9980;6.41;0.39;274.27;8.97;991;57;3424.00;43
8950;56;626133315;8950;329;9937;9980;6.44;0.39;274.27;8.97;987;57;3425.00;43
8951;56;626133329;8951;324;9937;9981;6.53;0.40;274.26;8.97;986;57;3426.00;44
8953;56;626133343;8953;325;9937;9981;6.61;0.40;274.24;8.97;984;57;3427.00;44
8956;56;626133358;8956;328;9941;9987;6.73;0.41;274.32;8.96;985;57;3428.00;46
8960;56;626133374;8960;326;9943;9988;6.73;0.41;274.34;9.00;983;57;3429.00;45
8965;56;626133390;8965;320;9944;9988;6.73;0.41;274.34;9.00;979;57;3430.00;44
8965;56;626133404;8965;324;9944;9988;6.78;0.41;274.34;9.00;979;57;3431.00;44
8969;56;626133418;8969;330;9947;9992;6.84;0.42;274.40;9.00;978;57;3432.00;45
8973;56;626133439;8973;326;9947;9992;6.82;0.42;274.41;9.00;974;57;3433.00;45
8976;56;626133453;8976;323;9947;9992;6.89;0.42;274.46;9.00;971;57;3434.00;45
8980;56;626133468;8980;321;9948;9993;6.89;0.42;274.45;9.00;968;57;3435.00;45
8984;56;626133482;8984;315;9951;9997;6.87;0.42;274.50;9.00;967;57;3436.00;46
8987;56;626133496;8987;312;9951;9997;6.87;0.42;274.53;9.00;964;57;3437.00;46
8992;56;626133510;8992;311;9953;10000;6.89;0.42;274.57;8.99;961;57;3438.00;47
8994;56;626133525;8994;311;9954;10000;6.90;0.42;274.54;8.99;960;57;3439.00;46
8997;56;626133540;8997;314;9954;10000;6.88;0.42;274.61;8.99;957;57;3440.00;46
9001;56;626133554;9001;310;9954;10000;6.91;0.42;274.74;8.99;953;57;3441.00;46
9003;56;626133568;9003;313;9957;10004;6.89;0.42;274.75;8.99;954;57;3442.00;47
9007;56;626133582;9007;317;9957;10004;6.87;0.42;274.77;8.99;950;57;3443.00;47
9011;56;626133597;9011;315;9958;10004;6.84;0.42;274.79;8.99;947;57;3444.00;46
9014;56;626133612;9014;314;9959;10004;6.82;0.42;274.89;9.03;945;57;3445.00;45
9018;56;626133624;9018;319;9959;10005;6.79;0.41;274.90;9.03;941;57;3446.00;46
9019;56;626133639;9019;312;9960;10006;6.82;0.42;274.91;9.03;941;57;3447.00;46
9021;56;626133653;9021;300;9960;10006;6.84;0.42;274.92;9.03;939;57;3448.00;46
9023;56;626133667;9023;303;9961;10007;6.84;0.42;274.98;9.03;938;57;3449.00;46
9026;56;626133683;9026;303;9961;10007;6.80;0.42;274.95;9.03;935;57;3450.00;46
9029;56;626133696;9029;297;9961;10007;6.80;0.42;275.06;9.03;932;57;3451.00;46
9034;56;626133718;9034;299;9961;10007;6.85;0.42;275.14;9.03;927;57;3452.00;46
9038;56;626133731;9038;294;9961;10007;6.92;0.42;275.20;9.03;923;57;3453.00;46
9040;56;626133746;9040;297;9961;10007;6.97;0.43;275.20;9.03;921;57;3454.00;46
9042;56;626133766;9042;297;9961;10007;7.04;0.43;275.24;9.03;919;57;3455.00;46
9046;56;626133781;9046;307;10033;10134;7.26;0.45;275.29;8.97;987;57;3456.00;101
9049;56;626133810;9049;286;10035;10135;7.36;0.45;275.28;8.96;986;57;3457.00;100
9052;56;626133826;9052;263;10043;10135;7.49;0.46;275.32;8.96;991;57;3458.00;92
9054;56;626133850;9054;261;10046;10135;7.53;0.46;275.32;8.96;992;57;3459.00;89
9056;56;626133866;9056;249;10050;10135;7.65;0.47;275.33;8.95;994;57;3460.00;85
9058;56;626133881;9058;242;10054;10135;7.71;0.47;275.39;8.95;996;57;3461.00;81
9058;56;626133896;9058;249;10059;10135;7.77;0.48;275.39;8.95;1001;57;3462.00;76
9059;56;626133916;9059;253;10061;10135;7.79;0.48;275.42;8.95;1002;57;3463.00;74
9062;56;626133932;9062;258;10066;10136;7.83;0.48;275.51;9.00;1004;57;3464.00;70
9064;56;626133948;9064;263;10070;10138;7.83;0.48;275.51;8.99;1006;57;3465.00;68
9067;56;626133972;9067;276;10073;10138;7.78;0.48;275.57;9.00;1006;57;3466.00;65
9070;56;626133987;9070;276;10075;10139;7.81;0.48;275.62;8.99;1005;57;3467.00;64
9074;56;626134006;9074;270;10077;10139;7.79;0.48;275.65;9.00;1003;57;3468.00;62
9076;56;626134025;9076;268;10078;10139;7.80;0.48;275.66;9.00;1002;57;3469.00;61
9081;56;626134041;9081;276;10080;10139;7.79;0.48;275.66;9.00;999;57;3470.00;59
9084;56;626134057;9084;276;10083;10143;7.79;0.48;275.72;9.00;999;57;3471.00;60
9085;56;626134073;9085;277;10085;10143;7.81;0.48;275.76;9.00;1000;57;3472.00;58
9088;56;626134088;9088;275;10087;10143;7.80;0.48;275.89;9.04;999;57;3473.00;56
9092;56;626134108;9092;272;10089;10146;7.83;0.48;275.97;9.03;997;57;3474.00;57
9094;56;626134123;9094;265;10090;10146;7.90;0.48;275.96;9.03;996;57;3475.00;56
9097;56;626134138;9097;267;10090;10146;7.91;0.48;276.06;9.03;993;57;3476.00;56
9099;56;626134153;9099;270;10094;10150;7.94;0.49;276.04;9.03;995;57;3477.00;56
9102;56;626134167;9102;276;10095;10151;7.95;0.49;276.03;9.03;993;57;3478.00;56
9106;56;626134183;9106;274;10095;10151;7.91;0.48;276.03;9.03;989;57;3479.00;56
9110;56;626134198;9110;277;10099;10156;7.92;0.48;276.06;9.03;989;57;3480.00;57
9116;56;626134213;9116;278;10099;10156;7.85;0.48;276.12;9.03;983;57;3481.00;57
9120;56;626134228;9120;278;10099;10156;7.82;0.48;276.19;9.03;979;57;3482.00;57
9123;56;626134243;9123;284;10100;10157;7.80;0.48;276.23;9.03;977;57;3483.00;57
9124;56;626134257;9124;281;10100;10157;7.82;0.48;276.22;9.03;976;57;3484.00;57
9125;56;626134272;9125;286;10104;10163;7.82;0.48;276.22;9.02;979;57;3485.00;59
9128;56;626134287;9128;298;10105;10163;7.81;0.48;276.20;9.02;977;57;3486.00;58
9129;56;626134301;9129;297;10105;10164;7.80;0.48;276.19;9.02;976;57;3487.00;59
9131;56;626134315;9131;297;10105;10164;7.74;0.47;276.18;9.02;974;57;3488.00;59
9134;56;626134329;9134;298;10105;10164;7.67;0.47;276.14;9.02;971;57;3489.00;59
9137;56;626134343;9137;294;10106;10164;7.64;0.46;276.18;9.06;969;57;3490.00;58
9138;56;626134358;9138;283;10106;10164;7.65;0.47;276.18;9.06;968;57;3491.00;58
9139;57;626134373;9139;278;10116;10176;7.63;0.46;276.18;9.05;977;58;3492.00;60
9141;57;626134404;9141;265;10117;10176;7.62;0.46;276.15;9.05;976;58;3493.00;59
9142;57;626134424;9142;265;10117;10176;7.61;0.46;276.17;9.05;975;58;3494.00;59
9144;57;626134443;9144;258;10117;10176;7.59;0.46;276.22;9.05;973;58;3495.00;59
9149;57;626134457;9149;260;10117;10176;7.59;0.46;276.14;9.05;968;58;3496.00;59
9150;57;626134472;9150;248;10117;10176;7.65;0.46;276.16;9.05;967;58;3497.00;59
9153;57;626134485;9153;243;10120;10180;7.67;0.47;276.19;9.05;967;58;3498.00;60
9157;57;626134500;9157;246;10120;10180;7.68;0.47;276.19;9.05;963;58;3499.00;60
9160;57;626134514;9160;233;10123;10184;7.72;0.47;276.19;9.05;963;58;3500.00;61
9165;57;626134531;9165;233;10125;10185;7.71;0.47;276.26;9.05;960;58;3501.00;60
9166;57;626134545;9166;229;10125;10185;7.63;0.46;276.31;9.05;959;58;3502.00;60
9168;57;626134557;9168;230;10125;10185;7.56;0.46;276.36;9.05;957;58;3503.00;60
9173;57;626134570;9173;235;10136;10198;7.45;0.45;276.44;9.05;963;58;3504.00;62
9177;57;626134586;9177;227;10138;10198;7.39;0.45;276.55;9.10;961;58;3505.00;60
9182;57;626134599;9182;227;10138;10198;7.37;0.45;276.59;9.10;956;58;3506.00;60
9186;57;626134612;9186;231;10139;10199;7.37;0.45;276.62;9.10;953;58;3507.00;60
9187;57;626134624;9187;231;10140;10200;7.43;0.45;276.61;9.14;953;58;3508.00;60
9191;57;626134637;9191;232;10140;10200;7.48;0.45;276.65;9.14;949;58;3509.00;60
9196;57;626134652;9196;221;10143;10206;7.49;0.45;276.67;9.14;947;58;3510.00;63
9199;57;626134666;9199;222;10145;10206;7.53;0.46;276.66;9.17;946;58;3511.00;61
9200;57;626134679;9200;224;10146;10206;7.56;0.46;276.64;9.17;946;58;3512.00;60
9203;57;626134692;9203;220;10146;10206;7.54;0.46;276.74;9.17;943;58;3513.00;60
9207;57;626134705;9207;226;10150;10212;7.51;0.45;276.79;9.17;943;58;3514.00;62
9209;57;626134719;9209;224;10150;10212;7.52;0.46;276.76;9.17;941;58;3515.00;62
9212;57;626134732;9212;223;10153;10212;7.47;0.45;276.77;9.20;941;58;3516.00;59
9213;57;626134750;9213;220;10153;10212;7.47;0.45;276.76;9.20;940;58;3517.00;59
9215;57;626134763;9215;218;10157;10216;7.43;0.45;276.79;9.20;942;58;3518.00;59
9218;57;626134776;9218;226;10159;10219;7.43;0.45;276.90;9.20;941;58;3519.00;60
9219;57;626134790;9219;229;10159;10219;7.42;0.45;276.93;9.20;940;58;3520.00;60
9220;57;626134803;9220;234;10162;10220;7.36;0.45;277.01;9.21;942;58;3521.00;58
9221;57;626134816;9221;231;10162;10220;7.32;0.44;277.01;9.21;941;58;3522.00;58
9224;57;626134829;9224;233;10163;10220;7.27;0.44;277.02;9.24;939;58;3523.00;57
9226;57;626134843;9226;231;10163;10220;7.25;0.44;277.09;9.24;937;58;3524.00;57
9227;57;626134856;9227;236;10163;10220;7.27;0.44;277.11;9.24;936;58;3525.00;57
9230;57;626134869;9230;242;10163;10220;7.29;0.44;277.14;9.24;933;58;3526.00;57
9232;57;626134882;9232;244;10163;10220;7.31;0.44;277.17;9.24;931;58;3527.00;57
9233;57;626134894;9233;255;10196;10290;7.49;0.46;277.15;9.21;963;58;3528.00;94
9236;57;626134913;9236;256;10197;10291;7.42;0.45;277.12;9.22;961;58;3529.00;94
9237;57;626134927;9237;253;10208;10291;7.46;0.45;277.18;9.27;971;58;3530.00;83
9239;57;626134940;9239;256;10214;10291;7.50;0.46;277.15;9.26;975;58;3531.00;77
9242;57;626134953;9242;260;10219;10291;7.45;0.45;277.12;9.27;977;58;3532.00;72
9244;57;626134966;9244;263;10224;10291;7.44;0.45;277.13;9.29;980;58;3533.00;67
9247;57;626134980;9247;270;10227;10291;7.37;0.45;277.15;9.29;980;58;3534.00;64
9248;58;626134993;9248;273;10231;10291;7.34;0.45;277.19;9.31;983;59;3535.00;60
9248;58;626135023;9248;268;10234;10292;7.36;0.45;277.19;9.31;986;59;3536.00;58
9251;58;626135045;9251;272;10237;10293;7.31;0.45;277.14;9.31;986;59;3537.00;56
9255;58;626135071;9255;274;10240;10293;7.30;0.45;277.06;9.33;985;59;3538.00;53
9258;58;626135092;9258;279;10246;10297;7.28;0.45;277.01;9.34;988;59;3539.00;51
9262;58;626135115;9262;284;10247;10297;7.16;0.44;276.94;9.35;985;59;3540.00;50
9265;58;626135130;9265;289;10248;10297;7.06;0.43;276.90;9.36;983;59;3541.00;49
9266;58;626135145;9266;297;10248;10297;7.01;0.43;276.89;9.36;982;59;3542.00;49
9267;58;626135159;9267;309;10254;10303;6.99;0.43;276.93;9.37;987;59;3543.00;49
9268;58;626135174;9268;316;10254;10303;6.91;0.42;276.92;9.37;986;59;3544.00;49
9270;58;626135188;9270;328;10257;10303;6.80;0.42;276.99;9.39;987;59;3545.00;46
9271;58;626135202;9271;331;10259;10306;6.72;0.41;276.99;9.39;988;59;3546.00;47
9273;58;626135215;9273;339;10262;10306;6.60;0.40;276.99;9.41;989;59;3547.00;44
9274;58;626135230;9274;349;10262;10306;6.45;0.40;276.97;9.41;988;59;3548.00;44
9275;58;626135242;9275;349;10263;10307;6.33;0.39;276.95;9.41;988;59;3549.00;44
9278;58;626135255;9278;350;10265;10308;6.20;0.38;276.91;9.42;987;59;3550.00;43
9280;58;626135270;9280;348;10266;10308;6.13;0.38;276.89;9.42;986;59;3551.00;42
9282;58;626135281;9282;360;10277;10321;6.12;0.38;276.87;9.41;995;59;3552.00;44
9284;58;626135294;9284;365;10278;10321;6.05;0.37;276.85;9.42;994;59;3553.00;43
9286;58;626135305;9286;360;10279;10321;6.00;0.37;276.88;9.42;993;59;3554.00;42
9287;58;626135316;9287;360;10282;10323;5.98;0.37;276.87;9.43;995;59;3555.00;41
9291;58;626135333;9291;361;10283;10323;5.94;0.36;276.79;9.43;992;59;3556.00;40
9292;58;626135346;9292;366;10286;10327;5.96;0.36;276.79;9.43;994;59;3557.00;41
9294;58;626135357;9294;366;10288;10327;5.91;0.36;276.81;9.44;994;59;3558.00;39
9296;58;626135368;9296;378;10293;10331;5.89;0.36;276.82;9.44;997;59;3559.00;38
9298;58;626135380;9298;381;10293;10331;5.82;0.36;276.81;9.44;995;59;3560.00;38
9299;58;626135392;9299;379;10294;10331;5.71;0.35;276.81;9.45;995;59;3561.00;37
9302;58;626135403;9302;389;10295;10331;5.58;0.34;276.77;9.46;993;59;3562.00;36
9305;58;626135414;9305;381;10295;10331;5.44;0.33;276.73;9.46;990;59;3563.00;36
9307;58;626135425;9307;378;10306;10343;5.42;0.33;276.71;9.46;999;59;3564.00;37
9308;58;626135437;9308;369;10307;10343;5.44;0.33;276.70;9.46;999;59;3565.00;36
9312;58;626135447;9312;367;10308;10343;5.42;0.33;276.68;9.46;996;59;3566.00;35
9316;58;626135458;9316;369;10310;10343;5.33;0.32;276.69;9.47;994;59;3567.00;33
9317;59;626135469;9317;365;10310;10343;5.29;0.32;276.68;9.47;993;60;3568.00;33
9320;59;626135495;9320;367;10310;10343;5.22;0.32;276.79;9.47;990;60;3569.00;33
9323;59;626135516;9323;348;10312;10344;5.18;0.32;276.79;9.49;989;60;3570.00;32
9327;59;626135534;9327;345;10312;10344;5.15;0.31;276.74;9.49;985;60;3571.00;32
9328;59;626135545;9328;343;10317;10350;5.22;0.32;276.72;9.48;989;60;3572.00;33
9331;59;626135556;9331;339;10320;10351;5.27;0.32;276.73;9.48;989;60;3573.00;31
9333;59;626135568;9333;335;10320;10351;5.34;0.33;276.75;9.48;987;60;3574.00;31
9334;59;626135578;9334;339;10320;10351;5.41;0.33;276.77;9.48;986;60;3575.00;31
9336;59;626135589;9336;337;10323;10355;5.56;0.34;276.80;9.48;987;60;3576.00;32
9338;59;626135601;9338;330;10323;10355;5.65;0.34;276.82;9.48;985;60;3577.00;32
9343;59;626135612;9343;331;10327;10355;5.75;0.35;276.77;9.50;984;60;3578.00;28
9343;59;626135624;9343;329;10328;10356;5.91;0.36;276.77;9.50;985;60;3579.00;28
9344;59;626135635;9344;324;10331;10360;6.01;0.37;276.79;9.49;987;60;3580.00;29
9345;59;626135648;9345;317;10331;10360;6.08;0.37;276.81;9.49;986;60;3581.00;29
9348;59;626135659;9348;314;10334;10363;6.14;0.37;276.84;9.52;986;60;3582.00;29
9350;59;626135671;9350;311;10335;10363;6.18;0.38;276.85;9.52;985;60;3583.00;28
9355;59;626135682;9355;306;10335;10363;6.18;0.38;276.92;9.52;980;60;3584.00;28
9358;59;626135695;9358;303;10335;10363;6.22;0.38;276.94;9.52;977;60;3585.00;28
9359;59;626135707;9359;305;10338;10367;6.35;0.39;276.95;9.52;979;60;3586.00;29
9364;59;626135720;9364;303;10338;10367;6.44;0.39;277.08;9.52;974;60;3587.00;29
9370;59;626135732;9370;303;10339;10367;6.53;0.40;277.07;9.52;969;60;3588.00;28
9374;59;626135745;9374;300;10339;10367;6.61;0.40;277.07;9.52;965;60;3589.00;28
9379;59;626135757;9379;297;10339;10368;6.61;0.40;277.16;9.52;960;60;3590.00;29
9385;59;626135770;9385;297;10340;10369;6.65;0.41;277.22;9.52;955;60;3591.00;29
9387;59;626135782;9387;297;10340;10369;6.70;0.41;277.23;9.52;953;60;3592.00;29
9392;59;626135794;9392;287;10341;10370;6.72;0.41;277.22;9.52;949;60;3593.00;29
9394;59;626135807;9394;284;10341;10370;6.75;0.41;277.23;9.52;947;60;3594.00;29
9400;59;626135819;9400;289;10341;10370;6.79;0.41;277.21;9.52;941;60;3595.00;29
9403;59;626135832;9403;285;10341;10370;6.83;0.42;277.27;9.52;938;60;3596.00;29
9405;59;626135844;9405;287;10341;10370;6.91;0.42;277.28;9.52;936;60;3597.00;29
9408;59;626135856;9408;288;10341;10370;6.95;0.42;277.28;9.52;933;60;3598.00;29
9414;59;626135868;9414;285;10341;10370;6.95;0.42;277.31;9.52;927;60;3599.00;29
9417;59;626135884;9417;322;10456;10623;7.25;0.45;277.35;9.41;1039;60;3600.00;167
9423;59;626135922;9423;313;10462;10624;7.28;0.46;277.37;9.41;1039;60;3601.00;162
9427;59;626135937;9427;300;10476;10624;7.31;0.46;277.43;9.43;1049;60;3602.00;148
9433;59;626135952;9433;292;10483;10624;7.37;0.46;277.40;9.43;1050;60;3603.00;141
9438;59;626135967;9438;294;10492;10624;7.39;0.46;277.40;9.42;1054;60;3604.00;132
9442;59;626135981;9442;297;10496;10624;7.45;0.46;277.45;9.42;1054;60;3605.00;128
9446;60;626135995;9446;294;10504;10624;7.41;0.46;277.49;9.42;1058;61;3606.00;120
9449;60;626136039;9449;296;10508;10624;7.40;0.46;277.52;9.42;1059;61;3607.00;116
9454;60;626136054;9454;300;10513;10625;7.40;0.46;277.50;9.42;1059;61;3608.00;112
9458;60;626136074;9458;303;10516;10626;7.43;0.46;277.50;9.42;1058;61;3609.00;110
9463;60;626136088;9463;305;10519;10626;7.42;0.46;277.57;9.42;1056;61;3610.00;107
9466;60;626136101;9466;302;10519;10627;7.44;0.46;277.58;9.42;1053;61;3611.00;108
9472;60;626136114;9472;318;10527;10627;7.40;0.46;277.64;9.42;1055;61;3612.00;100
9476;60;626136129;9476;317;10529;10627;7.35;0.46;277.76;9.42;1053;61;3613.00;98
9479;60;626136143;9479;326;10531;10627;7.30;0.45;277.79;9.42;1052;61;3614.00;96
9481;60;626136157;9481;331;10534;10631;7.25;0.45;277.80;9.42;1053;61;3615.00;97
9487;60;626136172;9487;333;10538;10631;7.15;0.44;277.82;9.42;1051;61;3616.00;93
9488;60;626136186;9488;332;10539;10631;7.14;0.44;277.87;9.42;1051;61;3617.00;92
9490;60;626136200;9490;326;10543;10634;7.17;0.44;277.96;9.42;1053;61;3618.00;91
9495;60;626136215;9495;323;10546;10634;7.13;0.44;278.07;9.46;1051;61;3619.00;88
9497;60;626136228;9497;320;10549;10634;7.15;0.44;278.08;9.46;1052;61;3620.00;85
9502;60;626136242;9502;323;10554;10638;7.12;0.44;278.19;9.46;1052;61;3621.00;84
9509;60;626136257;9509;320;10556;10639;7.18;0.44;278.18;9.46;1047;61;3622.00;83
9513;60;626136272;9513;325;10556;10639;7.20;0.44;278.27;9.46;1043;61;3623.00;83
9517;60;626136286;9517;325;10560;10643;7.26;0.44;278.30;9.46;1043;61;3624.00;83
9519;60;626136306;9519;323;10561;10643;7.32;0.45;278.35;9.46;1042;61;3625.00;82
9522;60;626136320;9522;318;10561;10643;7.41;0.45;278.45;9.46;1039;61;3626.00;82
9524;60;626136341;9524;303;10566;10644;7.49;0.46;278.45;9.47;1042;61;3627.00;78
9527;61;626136360;9527;294;10567;10644;7.52;0.46;278.55;9.47;1040;62;3628.00;77
9527;61;626136385;9527;288;10571;10650;7.59;0.46;278.55;9.47;1044;62;3629.00;79
9530;62;626136402;9530;290;10573;10650;7.62;0.46;278.59;9.47;1043;63;3630.00;77
9532;62;626136433;9532;293;10574;10651;7.69;0.47;278.67;9.47;1042;63;3631.00;77
9535;62;626136448;9535;293;10574;10651;7.68;0.47;278.70;9.47;1039;63;3632.00;77
9538;62;626136468;9538;297;10576;10651;7.63;0.46;278.74;9.51;1038;63;3633.00;75
9539;62;626136483;9539;297;10577;10651;7.63;0.46;278.78;9.51;1038;63;3634.00;74
9541;62;626136497;9541;301;10578;10651;7.62;0.46;278.79;9.51;1037;63;3635.00;73
9543;62;626136511;9543;306;10588;10663;7.65;0.47;278.80;9.50;1045;63;3636.00;75
9546;62;626136526;9546;303;10588;10663;7.66;0.47;278.83;9.50;1042;63;3637.00;75
9548;62;626136545;9548;297;10588;10663;7.65;0.46;278.80;9.50;1040;63;3638.00;75
9551;62;626136558;9551;297;10588;10663;7.61;0.46;278.84;9.50;1037;63;3639.00;75
9556;62;626136572;9556;298;10588;10663;7.57;0.46;278.81;9.50;1032;63;3640.00;75
9557;62;626136586;9557;297;10589;10663;7.53;0.46;278.80;9.50;1032;63;3641.00;74
9563;62;626136600;9563;291;10592;10667;7.40;0.45;278.80;9.50;1029;63;3642.00;75
9563;62;626136614;9563;292;10592;10667;7.41;0.45;278.80;9.50;1029;63;3643.00;75
9564;62;626136627;9564;298;10595;10671;7.44;0.45;278.80;9.50;1031;63;3644.00;76
9565;62;626136641;9565;298;10597;10673;7.45;0.45;278.80;9.50;1032;63;3645.00;76
9566;62;626136655;9566;302;10598;10673;7.44;0.45;278.78;9.50;1032;63;3646.00;75
9570;62;626136668;9570;315;10600;10673;7.43;0.45;278.94;9.50;1030;63;3647.00;73
9572;62;626136681;9572;321;10609;10686;7.49;0.46;278.93;9.49;1037;63;3648.00;77
9573;62;626136696;9573;323;10609;10686;7.48;0.46;278.97;9.49;1036;63;3649.00;77
9575;62;626136709;9575;326;10610;10686;7.46;0.45;278.94;9.53;1035;63;3650.00;76
9577;62;626136728;9577;327;10611;10687;7.45;0.45;278.94;9.53;1034;63;3651.00;76
9577;62;626136741;9577;328;10611;10688;7.40;0.45;278.94;9.53;1034;63;3652.00;77
9579;62;626136754;9579;326;10611;10688;7.33;0.45;278.95;9.53;1032;63;3653.00;77
9581;62;626136767;9581;328;10613;10691;7.27;0.44;278.94;9.53;1032;63;3654.00;78
9583;62;626136780;9583;327;10613;10691;7.17;0.44;278.93;9.53;1030;63;3655.00;78
9584;62;626136792;9584;328;10614;10691;7.09;0.43;278.92;9.53;1030;63;3656.00;77
9587;62;626136805;9587;326;10614;10691;7.02;0.43;278.87;9.53;1027;63;3657.00;77
9590;62;626136817;9590;319;10618;10697;6.96;0.42;278.84;9.52;1028;63;3658.00;79
9591;62;626136830;9591;321;10618;10697;6.92;0.42;278.86;9.52;1027;63;3659.00;79
9594;62;626136844;9594;315;10619;10697;6.87;0.42;278.83;9.52;1025;63;3660.00;78
9595;62;626136857;9595;309;10619;10697;6.82;0.42;278.81;9.52;1024;63;3661.00;78
9598;62;626136868;9598;301;10622;10701;6.77;0.41;278.82;9.52;1024;63;3662.00;79
9599;62;626136881;9599;300;10623;10702;6.77;0.41;278.85;9.52;1024;63;3663.00;79
9601;62;626136893;9601;295;10623;10702;6.80;0.41;278.82;9.52;1022;63;3664.00;79
9603;62;626136906;9603;290;10624;10703;6.81;0.42;278.83;9.52;1021;63;3665.00;79
9605;62;626136918;9605;287;10625;10703;6.80;0.41;278.88;9.56;1020;63;3666.00;78
9609;62;626136930;9609;291;10626;10703;6.74;0.41;278.87;9.56;1017;63;3667.00;77
9612;62;626136941;9612;288;10626;10703;6.72;0.41;278.93;9.56;1014;63;3668.00;77
9612;62;626136959;9612;285;10626;10703;6.71;0.41;278.93;9.56;1014;63;3669.00;77
9616;62;626136971;9616;282;10626;10703;6.66;0.41;279.05;9.56;1010;63;3670.00;77
9617;62;626136983;9617;280;10627;10703;6.60;0.40;279.05;9.60;1010;63;3671.00;76
9620;62;626136994;9620;281;10657;10773;6.64;0.41;279.04;9.57;1037;63;3672.00;116
9622;62;626137016;9622;273;10659;10774;6.60;0.40;279.02;9.58;1037;63;3673.00;115
9624;62;626137035;9624;262;10665;10774;6.65;0.41;279.05;9.58;1041;63;3674.00;109
9627;62;626137053;9627;258;10672;10774;6.62;0.41;279.12;9.59;1045;63;3675.00;102
9628;62;626137079;9628;259;10678;10774;6.66;0.41;279.13;9.63;1050;63;3676.00;96
9631;62;626137097;9631;253;10683;10774;6.69;0.41;279.18;9.63;1052;63;3677.00;91
9638;62;626137118;9638;248;10684;10774;6.67;0.41;279.18;9.63;1046;63;3678.00;90
9641;62;626137135;9641;238;10687;10774;6.69;0.41;279.20;9.67;1046;63;3679.00;87
9642;62;626137152;9642;237;10688;10775;6.76;0.41;279.21;9.67;1046;63;3680.00;87
9644;62;626137167;9644;235;10690;10776;6.74;0.41;279.17;9.67;1046;63;3681.00;86
9646;62;626137182;9646;234;10691;10776;6.65;0.40;279.29;9.71;1045;63;3682.00;85
9650;62;626137202;9650;231;10694;10780;6.62;0.40;279.25;9.70;1044;63;3683.00;86
9651;62;626137216;9651;238;10694;10780;6.58;0.40;279.23;9.70;1043;63;3684.00;86
9653;62;626137230;9653;246;10695;10780;6.51;0.40;279.20;9.75;1042;63;3685.00;85
9654;62;626137243;9654;250;10696;10780;6.48;0.39;279.18;9.75;1042;63;3686.00;84
9656;62;626137256;9656;262;10700;10786;6.51;0.40;279.18;9.79;1044;63;3687.00;86
9658;62;626137269;9658;267;10701;10786;6.57;0.40;279.15;9.79;1043;63;3688.00;85
9661;62;626137281;9661;269;10705;10786;6.51;0.40;279.10;9.83;1044;63;3689.00;81
9662;62;626137295;9662;280;10708;10792;6.51;0.40;279.10;9.83;1046;63;3690.00;84
9664;62;626137308;9664;278;10708;10792;6.54;0.40;279.09;9.83;1044;63;3691.00;84
9668;62;626137331;9668;284;10711;10792;6.48;0.39;279.02;9.87;1043;63;3692.00;81
9671;62;626137345;9671;288;10712;10793;6.45;0.39;279.06;9.87;1041;63;3693.00;81
9676;62;626137358;9676;299;10716;10794;6.41;0.39;278.99;9.88;1040;63;3694.00;78
9676;62;626137371;9676;303;10717;10794;6.38;0.39;278.99;9.88;1041;63;3695.00;77
9679;62;626137383;9679;309;10728;10807;6.35;0.39;278.93;9.88;1049;63;3696.00;79
9680;62;626137397;9680;317;10730;10807;6.30;0.38;278.90;9.89;1050;63;3697.00;77
9681;62;626137409;9681;320;10732;10807;6.23;0.38;278.88;9.89;1051;63;3698.00;75
9683;62;626137422;9683;326;10733;10808;6.17;0.38;278.88;9.89;1050;63;3699.00;75
9685;62;626137437;9685;338;10736;10808;6.07;0.37;278.91;9.91;1051;63;3700.00;72
9690;62;626137456;9690;344;10740;10812;6.01;0.37;278.87;9.92;1050;63;3701.00;72
9692;62;626137471;9692;353;10740;10812;5.98;0.37;278.86;9.92;1048;63;3702.00;72
9695;62;626137483;9695;354;10746;10816;5.95;0.36;278.81;9.93;1051;63;3703.00;70
9699;62;626137496;9699;364;10747;10816;5.89;0.36;278.75;9.95;1048;63;3704.00;69
9700;62;626137509;9700;369;10748;10816;5.86;0.36;278.72;9.95;1048;63;3705.00;68
9703;62;626137521;9703;368;10750;10816;5.81;0.35;278.84;9.98;1047;63;3706.00;66
9704;62;626137541;9704;375;10750;10816;5.77;0.35;278.82;9.98;1046;63;3707.00;66
9707;62;626137553;9707;388;10763;10828;5.75;0.35;278.76;9.99;1056;63;3708.00;65
9709;62;626137567;9709;392;10765;10828;5.71;0.35;278.73;10.00;1056;63;3709.00;63
9710;62;626137579;9710;398;10767;10828;5.67;0.35;278.72;10.02;1057;63;3710.00;61
9713;62;626137591;9713;396;10768;10828;5.64;0.34;278.73;10.03;1055;63;3711.00;60
9713;62;626137610;9713;397;10769;10828;5.63;0.34;278.73;10.04;1056;63;3712.00;59
9714;62;626137622;9714;397;10771;10828;5.65;0.35;278.72;10.05;1057;63;3713.00;57
9714;62;626137634;9714;407;10773;10829;5.59;0.34;278.72;10.06;1059;63;3714.00;56
9716;62;626137646;9716;396;10774;10829;5.58;0.34;278.71;10.06;1058;63;3715.00;55
9716;62;626137658;9716;388;10781;10835;5.63;0.34;278.71;10.08;1065;63;3716.00;54
9716;62;626137671;9716;374;10783;10836;5.66;0.35;278.71;10.08;1067;63;3717.00;53
9718;62;626137683;9718;371;10786;10836;5.61;0.34;278.67;10.10;1068;63;3718.00;50
9720;62;626137696;9720;364;10787;10836;5.60;0.34;278.64;10.11;1067;63;3719.00;49
9720;62;626137710;9720;355;10791;10841;5.66;0.35;278.64;10.11;1071;63;3720.00;50
9722;62;626137723;9722;349;10793;10841;5.69;0.35;278.61;10.12;1071;63;3721.00;48
9723;62;626137742;9723;345;10794;10841;5.72;0.35;278.62;10.13;1071;63;3722.00;47
9723;62;626137755;9723;347;10795;10842;5.85;0.36;278.62;10.12;1072;63;3723.00;47
9723;62;626137769;9723;342;10800;10846;5.88;0.36;278.62;10.13;1077;63;3724.00;46
9724;62;626137781;9724;334;10800;10846;5.98;0.37;278.61;10.13;1076;63;3725.00;46
9725;62;626137795;9725;336;10803;10849;6.08;0.37;278.60;10.14;1078;63;3726.00;46
9727;62;626137808;9727;339;10805;10849;6.19;0.38;278.56;10.14;1078;63;3727.00;44
9728;62;626137822;9728;338;10807;10849;6.28;0.38;278.55;10.15;1079;63;3728.00;42
9729;62;626137835;9729;339;10807;10849;6.34;0.39;278.62;10.15;1078;63;3729.00;42
9731;62;626137848;9731;344;10810;10853;6.39;0.39;278.59;10.15;1079;63;3730.00;43
9735;62;626137860;9735;352;10811;10853;6.36;0.39;278.63;10.15;1076;63;3731.00;42
9736;62;626137872;9736;361;10813;10853;6.34;0.39;278.61;10.16;1077;63;3732.00;40
9739;62;626137891;9739;358;10815;10853;6.23;0.38;278.60;10.18;1076;63;3733.00;38
9740;62;626137903;9740;360;10816;10854;6.19;0.38;278.60;10.19;1076;63;3734.00;38
9744;62;626137915;9744;365;10818;10856;6.14;0.37;278.59;10.18;1074;63;3735.00;38
9749;62;626137927;9749;369;10819;10856;6.06;0.37;278.61;10.19;1070;63;3736.00;37
9752;62;626137940;9752;366;10821;10857;5.99;0.36;278.63;10.19;1069;63;3737.00;36
9753;62;626137952;9753;375;10822;10857;5.93;0.36;278.62;10.20;1069;63;3738.00;35
9755;62;626137963;9755;381;10823;10857;5.80;0.35;278.60;10.20;1068;63;3739.00;34
9758;62;626137976;9758;362;10823;10857;5.71;0.35;278.67;10.20;1065;63;3740.00;34
9761;62;626137987;9761;360;10824;10857;5.64;0.35;278.66;10.21;1063;63;3741.00;33
9767;62;626138001;9767;353;10826;10857;5.56;0.34;278.74;10.22;1059;63;3742.00;31
9771;62;626138015;9771;355;10827;10857;5.53;0.34;278.81;10.22;1056;63;3743.00;30
9775;62;626138027;9775;374;10893;10984;5.83;0.36;278.88;10.16;1118;63;3744.00;91
9778;62;626138049;9778;382;10897;10985;5.84;0.36;278.89;10.15;1119;63;3745.00;88
9782;62;626138063;9782;370;10904;10985;5.86;0.36;278.91;10.15;1122;63;3746.00;81
9786;62;626138075;9786;368;10910;10985;5.90;0.36;279.00;10.14;1124;63;3747.00;75
9789;62;626138087;9789;364;10916;10985;5.97;0.37;279.01;10.14;1127;63;3748.00;69
9791;62;626138100;9791;364;10920;10985;5.99;0.37;279.05;10.14;1129;63;3749.00;65
9798;62;626138115;9798;362;10926;10990;6.00;0.37;279.19;10.14;1128;63;3750.00;64
9799;62;626138129;9799;357;10929;10990;6.08;0.37;279.21;10.14;1130;63;3751.00;61
9801;62;626138142;9801;350;10934;10991;6.17;0.38;279.27;10.13;1133;63;3752.00;57
9806;62;626138155;9806;349;10936;10992;6.23;0.38;279.33;10.13;1130;63;3753.00;56
9809;62;626138173;9809;357;10938;10992;6.34;0.39;279.41;10.13;1129;63;3754.00;54
9815;62;626138188;9815;347;10939;10993;6.39;0.39;279.46;10.13;1124;63;3755.00;54
9818;62;626138203;9818;345;10942;10993;6.48;0.40;279.51;10.13;1124;63;3756.00;51
9823;62;626138218;9823;341;10943;10993;6.52;0.40;279.52;10.13;1120;63;3757.00;50
9828;62;626138234;9828;343;10944;10993;6.49;0.40;279.58;10.13;1116;63;3758.00;49
9831;62;626138250;9831;341;10948;10997;6.50;0.40;279.64;10.13;1117;63;3759.00;49
9832;62;626138266;9832;344;10949;10997;6.50;0.40;279.66;10.13;1117;63;3760.00;48
9835;62;626138287;9835;342;10949;10997;6.46;0.40;279.74;10.13;1114;63;3761.00;48
9838;62;626138307;9838;343;10953;11000;6.46;0.40;279.81;10.13;1115;63;3762.00;47
9843;62;626138322;9843;343;10953;11000;6.47;0.40;279.83;10.13;1110;63;3763.00;47
9844;62;626138339;9844;344;10954;11000;6.54;0.40;279.86;10.13;1110;63;3764.00;46
9850;62;626138355;9850;347;10958;11004;6.54;0.40;279.89;10.13;1108;63;3765.00;46
9854;62;626138370;9854;342;10959;11005;6.58;0.40;279.89;10.13;1105;63;3766.00;46
9860;62;626138392;9860;340;10959;11005;6.60;0.40;279.88;10.13;1099;63;3767.00;46
9865;62;626138408;9865;349;10962;11009;6.61;0.40;279.90;10.13;1097;63;3768.00;47
9870;62;626138423;9870;353;10962;11009;6.63;0.40;279.84;10.13;1092;63;3769.00;47
9871;62;626138439;9871;358;10962;11009;6.69;0.41;279.88;10.13;1091;63;3770.00;47
9875;62;626138455;9875;358;10964;11010;6.67;0.41;279.93;10.13;1089;63;3771.00;46
9877;62;626138476;9877;354;10964;11010;6.65;0.40;280.03;10.13;1087;63;3772.00;46
9882;62;626138492;9882;351;10969;11016;6.65;0.40;280.05;10.13;1087;63;3773.00;47
9886;62;626138509;9886;355;10969;11016;6.67;0.40;280.04;10.13;1083;63;3774.00;47
9890;62;626138525;9890;356;10969;11017;6.67;0.41;280.02;10.13;1079;63;3775.00;48
9896;62;626138541;9896;357;10970;11017;6.65;0.40;280.07;10.13;1074;63;3776.00;47
9899;62;626138562;9899;353;10971;11017;6.66;0.41;280.07;10.13;1072;63;3777.00;46
9902;62;626138578;9902;354;10971;11017;6.71;0.41;280.06;10.13;1069;63;3778.00;46
9907;62;626138593;9907;352;10972;11017;6.74;0.41;280.23;10.13;1065;63;3779.00;45
9910;62;626138610;9910;350;10997;11053;6.85;0.42;280.32;10.10;1087;63;3780.00;56
9912;62;626138628;9912;345;10998;11053;6.86;0.42;280.32;10.10;1086;63;3781.00;55
9916;62;626138644;9916;347;10999;11053;6.84;0.42;280.40;10.10;1083;63;3782.00;54
9923;62;626138660;9923;349;11000;11053;6.79;0.42;280.39;10.10;1077;63;3783.00;53
9927;62;626138675;9927;355;11000;11053;6.81;0.42;280.47;10.10;1073;63;3784.00;53
9934;62;626138692;9934;359;11001;11053;6.83;0.42;280.59;10.10;1067;63;3785.00;52
9939;62;626138708;9939;360;11004;11057;6.87;0.42;280.61;10.10;1065;63;3786.00;53
9941;62;626138724;9941;353;11005;11057;6.92;0.42;280.66;10.10;1064;63;3787.00;52
9945;62;626138739;9945;346;11007;11061;6.97;0.43;280.80;10.10;1062;63;3788.00;54
9952;62;626138755;9952;341;11009;11062;6.91;0.42;280.85;10.09;1057;63;3789.00;53
9954;62;626138772;9954;336;11010;11062;6.95;0.43;280.89;10.09;1056;63;3790.00;52
9958;62;626138787;9958;334;11010;11062;6.87;0.42;280.95;10.09;1052;63;3791.00;52
9962;62;626138804;9962;337;11022;11075;6.93;0.42;281.02;10.08;1060;63;3792.00;53
9967;62;626138821;9967;343;11023;11075;6.91;0.42;281.07;10.12;1056;63;3793.00;52
9972;62;626138838;9972;347;11023;11075;6.89;0.42;281.22;10.12;1051;63;3794.00;52
9974;62;626138854;9974;350;11024;11076;6.89;0.42;281.32;10.12;1050;63;3795.00;52
9977;62;626138868;9977;342;11024;11077;6.93;0.42;281.35;10.12;1047;63;3796.00;53
9982;62;626138884;9982;334;11024;11077;6.90;0.42;281.44;10.12;1042;63;3797.00;53
9987;62;626138905;9987;332;11026;11080;6.91;0.42;281.48;10.12;1039;63;3798.00;54
9987;62;626138927;9987;324;11026;11080;6.92;0.42;281.48;10.12;1039;63;3799.00;54
9990;62;626138943;9990;317;11027;11080;6.94;0.42;281.54;10.12;1037;63;3800.00;53
9991;62;626138962;9991;314;11027;11080;6.95;0.43;281.52;10.12;1036;63;3801.00;53
9995;62;626138979;9995;310;11031;11086;6.97;0.43;281.57;10.12;1036;63;3802.00;55
10000;62;626138995;10000;312;11032;11086;6.99;0.43;281.60;10.11;1032;63;3803.00;54
10005;62;626139012;10005;318;11032;11086;6.93;0.42;281.58;10.11;1027;63;3804.00;54
10008;62;626139037;10008;316;11033;11086;6.88;0.42;281.58;10.15;1025;63;3805.00;53
10013;62;626139060;10013;317;11036;11090;6.80;0.42;281.59;10.15;1023;63;3806.00;54
10017;62;626139085;10017;304;11037;11091;6.86;0.42;281.62;10.15;1020;63;3807.00;54
10019;62;626139108;10019;297;11037;11091;6.91;0.42;281.65;10.15;1018;63;3808.00;54
10023;62;626139131;10023;282;11038;11092;6.94;0.42;281.67;10.15;1015;63;3809.00;54
10024;62;626139150;10024;273;11038;11092;6.99;0.43;281.65;10.15;1014;63;3810.00;54
10025;62;626139167;10025;261;11038;11092;7.05;0.43;281.70;10.15;1013;63;3811.00;54
10028;62;626139183;10028;258;11038;11092;7.06;0.43;281.75;10.15;1010;63;3812.00;54
10029;62;626139205;10029;251;11038;11092;7.09;0.43;281.73;10.15;1009;63;3813.00;54
10032;62;626139221;10032;248;11038;11092;7.11;0.43;281.76;10.15;1006;63;3814.00;54
10035;62;626139237;10035;253;11038;11092;7.10;0.43;281.76;10.15;1003;63;3815.00;54
10037;62;626139254;10037;264;11075;11162;7.09;0.43;281.75;10.12;1038;63;3816.00;87
10039;62;626139282;10039;259;11075;11163;7.07;0.43;281.77;10.12;1036;63;3817.00;88
10041;62;626139298;10041;255;11079;11163;7.13;0.43;281.83;10.11;1038;63;3818.00;84
10042;62;626139314;10042;255;11081;11163;7.16;0.44;281.82;10.11;1039;63;3819.00;82
10044;62;626139329;10044;262;11086;11163;7.12;0.43;281.83;10.11;1042;63;3820.00;77
10046;62;626139345;10046;262;11092;11163;7.12;0.43;281.86;10.11;1046;63;3821.00;71
10048;62;626139361;10048;269;11097;11163;7.14;0.44;281.89;10.10;1049;63;3822.00;66
10051;62;626139379;10051;280;11100;11163;7.13;0.44;281.89;10.10;1049;63;3823.00;63
10052;62;626139395;10052;281;11102;11164;7.07;0.43;281.91;10.10;1050;63;3824.00;62
10052;62;626139409;10052;287;11104;11166;7.02;0.43;281.91;10.10;1052;63;3825.00;62
10054;62;626139428;10054;289;11105;11166;6.89;0.42;281.87;10.10;1051;63;3826.00;61
10055;62;626139443;10055;284;11108;11170;6.77;0.41;281.87;10.10;1053;63;3827.00;62
10058;62;626139458;10058;283;11108;11170;6.66;0.41;282.01;10.10;1050;63;3828.00;62
10059;62;626139472;10059;283;11108;11170;6.60;0.41;282.00;10.10;1049;63;3829.00;62
10065;62;626139488;10065;281;11108;11170;6.55;0.40;282.02;10.10;1043;63;3830.00;62
10065;62;626139502;10065;281;11112;11176;6.58;0.40;282.02;10.13;1047;63;3831.00;64
10066;62;626139517;10066;283;11112;11176;6.53;0.40;282.03;10.13;1046;63;3832.00;64
10069;62;626139531;10069;280;11113;11176;6.45;0.39;282.03;10.13;1044;63;3833.00;63
10071;62;626139552;10071;282;11115;11179;6.41;0.39;282.01;10.13;1044;63;3834.00;64
10073;62;626139567;10073;283;11116;11179;6.35;0.39;282.01;10.13;1043;63;3835.00;63
10076;62;626139581;10076;280;11116;11179;6.29;0.38;282.05;10.13;1040;63;3836.00;63
10077;62;626139596;10077;281;11116;11180;6.23;0.38;282.03;10.13;1039;63;3837.00;64
10082;62;626139608;10082;287;11117;11181;6.15;0.37;282.04;10.13;1035;63;3838.00;64
10085;62;626139622;10085;289;11117;11181;6.10;0.37;282.01;10.13;1032;63;3839.00;64
10089;62;626139637;10089;293;11132;11207;6.03;0.37;282.04;10.12;1043;63;3840.00;75
10092;62;626139655;10092;299;11134;11207;5.98;0.36;282.08;10.15;1042;63;3841.00;73
10093;62;626139668;10093;284;11136;11207;5.99;0.37;282.09;10.15;1043;63;3842.00;71
10097;62;626139681;10097;272;11138;11208;5.97;0.36;282.08;10.15;1041;63;3843.00;70
10098;62;626139697;10098;269;11138;11208;5.98;0.36;282.07;10.15;1040;63;3844.00;70
10101;62;626139710;10101;273;11141;11212;6.00;0.37;282.07;10.16;1040;63;3845.00;71
10106;62;626139725;10106;262;11143;11214;6.00;0.37;282.06;10.16;1037;63;3846.00;71
10107;62;626139738;10107;264;11147;11218;6.04;0.37;282.06;10.16;1040;63;3847.00;71
10112;62;626139753;10112;257;11147;11218;6.04;0.37;282.00;10.16;1035;63;3848.00;71
10114;62;626139766;10114;263;11147;11218;6.09;0.37;282.00;10.16;1033;63;3849.00;71
10116;62;626139780;10116;259;11147;11218;6.06;0.37;282.06;10.16;1031;63;3850.00;71
10119;62;626139793;10119;259;11147;11218;6.05;0.37;282.00;10.16;1028;63;3851.00;71
10123;62;626139806;10123;260;11159;11230;6.06;0.37;281.95;10.19;1036;63;3852.00;71
10126;62;626139820;10126;258;11159;11230;6.04;0.37;281.95;10.19;1033;63;3853.00;71
10129;62;626139834;10129;262;11159;11230;5.98;0.37;281.89;10.19;1030;63;3854.00;71
10131;62;626139847;10131;274;11159;11230;5.96;0.37;281.87;10.19;1028;63;3855.00;71
10135;62;626139860;10135;280;11159;11230;5.91;0.36;281.85;10.19;1024;63;3856.00;71
10137;62;626139873;10137;290;11160;11230;5.86;0.36;281.84;10.19;1023;63;3857.00;70
10137;62;626139885;10137;300;11160;11231;5.85;0.36;281.84;10.19;1023;63;3858.00;71
10142;62;626139897;10142;294;11160;11231;5.78;0.35;281.82;10.19;1018;63;3859.00;71
10142;62;626139910;10142;299;11166;11237;5.84;0.36;281.82;10.19;1024;63;3860.00;71
10145;62;626139923;10145;311;11168;11238;5.85;0.36;281.79;10.19;1023;63;3861.00;70
10148;62;626139937;10148;321;11168;11238;5.79;0.35;281.78;10.19;1020;63;3862.00;70
10151;62;626139950;10151;323;11169;11238;5.73;0.35;281.81;10.19;1018;63;3863.00;69
10152;62;626139962;10152;326;11171;11242;5.71;0.35;281.80;10.18;1019;63;3864.00;71
10154;62;626139977;10154;330;11171;11242;5.68;0.35;281.78;10.18;1017;63;3865.00;71
10154;62;626139996;10154;327;11173;11242;5.71;0.35;281.78;10.20;1019;63;3866.00;69
10157;62;626140010;10157;319;11174;11243;5.74;0.35;281.77;10.20;1017;63;3867.00;69
10157;62;626140025;10157;313;11178;11247;5.77;0.35;281.77;10.19;1021;63;3868.00;69
10160;62;626140040;10160;309;11179;11247;5.82;0.35;281.74;10.20;1019;63;3869.00;68
10162;62;626140055;10162;311;11183;11253;5.90;0.36;281.74;10.20;1021;63;3870.00;70
10163;62;626140071;10163;305;11185;11253;5.99;0.36;281.73;10.22;1022;63;3871.00;68
10164;62;626140084;10164;303;11188;11253;6.11;0.37;281.73;10.23;1024;63;3872.00;65
10164;62;626140097;10164;305;11188;11253;6.20;0.38;281.73;10.23;1024;63;3873.00;65
10165;62;626140111;10165;298;11193;11257;6.37;0.39;281.84;10.24;1028;63;3874.00;64
10168;62;626140124;10168;286;11193;11257;6.45;0.39;281.80;10.24;1025;63;3875.00;64
10170;62;626140139;10170;287;11195;11257;6.54;0.40;281.79;10.26;1025;63;3876.00;62
10170;62;626140153;10170;289;11196;11257;6.57;0.40;281.79;10.26;1026;63;3877.00;61
10172;62;626140171;10172;284;11198;11258;6.60;0.40;281.79;10.28;1026;63;3878.00;60
10174;62;626140184;10174;280;11199;11259;6.63;0.40;281.75;10.27;1025;63;3879.00;60
10175;62;626140199;10175;286;11201;11259;6.66;0.40;281.74;10.30;1026;63;3880.00;58
10176;62;626140212;10176;278;11202;11260;6.68;0.40;281.73;10.30;1026;63;3881.00;58
10176;62;626140231;10176;284;11204;11260;6.70;0.41;281.73;10.32;1028;63;3882.00;56
10176;62;626140244;10176;287;11205;11260;6.70;0.41;281.73;10.33;1029;63;3883.00;55
10177;62;626140258;10177;290;11206;11260;6.69;0.41;281.73;10.34;1029;63;3884.00;54
10178;62;626140271;10178;287;11208;11260;6.69;0.41;281.74;10.36;1030;63;3885.00;52
10179;62;626140283;10179;294;11209;11260;6.65;0.40;281.75;10.37;1030;63;3886.00;51
10182;62;626140296;10182;300;11209;11260;6.58;0.40;281.73;10.37;1027;63;3887.00;51
10184;62;626140309;10184;328;11278;11387;6.76;0.42;281.78;10.33;1094;63;3888.00;109
10184;62;626140335;10184;315;11279;11388;6.73;0.41;281.78;10.33;1095;63;3889.00;109
10184;62;626140349;10184;305;11288;11388;6.73;0.42;281.78;10.33;1104;63;3890.00;100
10187;62;626140362;10187;313;11297;11388;6.73;0.42;281.79;10.33;1110;63;3891.00;91
10188;62;626140375;10188;306;11305;11388;6.78;0.42;281.82;10.33;1117;63;3892.00;83
10190;62;626140389;10190;306;11309;11388;6.74;0.42;281.80;10.33;1119;63;3893.00;79
10193;62;626140402;10193;309;11316;11388;6.76;0.42;281.82;10.34;1123;63;3894.00;72
10194;62;626140421;10194;306;11317;11388;6.72;0.41;281.85;10.34;1123;63;3895.00;71
10201;62;626140434;10201;313;11323;11389;6.73;0.41;281.79;10.36;1122;63;3896.00;66
10202;62;626140449;10202;322;11325;11390;6.79;0.42;281.85;10.36;1123;63;3897.00;65
10204;62;626140464;10204;331;11330;11390;6.82;0.42;281.94;10.36;1126;63;3898.00;60
10207;62;626140479;10207;342;11331;11391;6.79;0.42;282.03;10.37;1124;63;3899.00;60
10208;62;626140495;10208;352;11338;11406;6.71;0.41;282.02;10.36;1130;63;3900.00;68
10212;62;626140515;10212;355;11339;11406;6.59;0.40;282.10;10.37;1127;63;3901.00;67
10213;62;626140530;10213;355;11343;11406;6.54;0.40;282.09;10.37;1130;63;3902.00;63
10218;62;626140544;10218;361;11346;11410;6.47;0.40;282.22;10.37;1128;63;3903.00;64
10220;62;626140559;10220;361;11348;11410;6.39;0.39;282.25;10.38;1128;63;3904.00;62
10225;62;626140573;10225;368;11349;11410;6.31;0.39;282.27;10.38;1124;63;3905.00;61
10229;62;626140588;10229;373;11354;11413;6.27;0.38;282.27;10.38;1125;63;3906.00;59
10230;62;626140602;10230;381;11355;11413;6.24;0.38;282.31;10.39;1125;63;3907.00;58
10235;62;626140616;10235;387;11356;11413;6.13;0.38;282.30;10.39;1121;63;3908.00;57
10242;62;626140630;10242;393;11360;11417;5.98;0.37;282.27;10.39;1118;63;3909.00;57
10244;62;626140644;10244;383;11362;11418;5.90;0.36;282.30;10.39;1118;63;3910.00;56
10251;62;626140659;10251;377;11363;11418;5.81;0.36;282.35;10.39;1112;63;3911.00;55
10253;62;626140674;10253;374;11367;11422;5.84;0.36;282.37;10.39;1114;63;3912.00;55
10258;62;626140688;10258;371;11368;11422;5.82;0.36;282.45;10.39;1110;63;3913.00;54
10260;62;626140702;10260;364;11369;11422;5.82;0.36;282.46;10.40;1109;63;3914.00;53
10264;62;626140716;10264;361;11371;11424;5.82;0.36;282.54;10.40;1107;63;3915.00;53
10265;62;626140731;10265;367;11372;11424;5.82;0.36;282.56;10.40;1107;63;3916.00;52
10267;62;626140751;10267;357;11376;11430;5.88;0.36;282.59;10.40;1109;63;3917.00;54
10270;62;626140766;10270;361;11377;11430;5.92;0.36;282.67;10.40;1107;63;3918.00;53
10275;62;626140781;10275;352;11378;11431;5.95;0.36;282.71;10.41;1103;63;3919.00;53
10278;62;626140795;10278;354;11378;11431;6.01;0.37;282.77;10.41;1100;63;3920.00;53
10282;62;626140810;10282;359;11380;11431;6.06;0.37;282.77;10.45;1098;63;3921.00;51
10286;62;626140824;10286;357;11380;11431;6.12;0.38;282.82;10.45;1094;63;3922.00;51
10289;62;626140838;10289;358;11381;11431;6.15;0.38;282.83;10.45;1092;63;3923.00;50
10293;62;626140852;10293;356;11389;11443;6.23;0.38;282.86;10.44;1096;63;3924.00;54
10297;62;626140874;10297;356;11389;11443;6.31;0.39;282.93;10.44;1092;63;3925.00;54
10303;62;626140889;10303;350;11390;11443;6.39;0.39;282.93;10.44;1087;63;3926.00;53
10305;62;626140903;10305;349;11391;11443;6.45;0.40;283.03;10.44;1086;63;3927.00;52
10310;62;626140917;10310;346;11391;11443;6.45;0.40;283.12;10.44;1081;63;3928.00;52
10312;62;626140932;10312;351;11393;11443;6.47;0.40;283.14;10.44;1081;63;3929.00;50
10317;62;626140948;10317;355;11396;11447;6.51;0.40;283.18;10.44;1079;63;3930.00;51
10320;62;626140963;10320;356;11396;11447;6.55;0.40;283.23;10.44;1076;63;3931.00;51
10326;62;626140977;10326;355;11398;11451;6.59;0.40;283.29;10.44;1072;63;3932.00;53
10332;62;626140994;10332;368;11400;11452;6.60;0.40;283.27;10.44;1068;63;3933.00;52
10338;62;626141009;10338;365;11400;11452;6.60;0.40;283.33;10.44;1062;63;3934.00;52
10343;62;626141030;10343;369;11402;11452;6.59;0.40;283.35;10.44;1059;63;3935.00;50
10346;62;626141055;10346;367;11411;11465;6.59;0.40;283.39;10.43;1065;63;3936.00;54
10352;62;626141082;10352;368;11414;11465;6.57;0.40;283.43;10.44;1062;63;3937.00;51
10357;62;626141105;10357;370;11414;11465;6.55;0.40;283.48;10.44;1057;63;3938.00;51
10360;62;626141126;10360;368;11416;11466;6.56;0.40;283.48;10.44;1056;63;3939.00;50
10362;62;626141145;10362;372;11416;11467;6.58;0.40;283.53;10.44;1054;63;3940.00;51
10368;62;626141161;10368;378;11417;11467;6.57;0.40;283.64;10.44;1049;63;3941.00;50
10371;62;626141187;10371;380;11420;11470;6.64;0.41;283.71;10.44;1049;63;3942.00;50
10374;62;626141204;10374;387;11422;11470;6.66;0.41;283.70;10.48;1048;63;3943.00;48
10377;62;626141220;10377;386;11423;11470;6.66;0.41;283.76;10.48;1046;63;3944.00;47
10382;62;626141237;10382;384;11424;11470;6.63;0.41;283.73;10.48;1042;63;3945.00;46
10385;62;626141253;10385;384;11428;11476;6.59;0.40;283.78;10.47;1043;63;3946.00;48
10388;62;626141270;10388;390;11428;11476;6.61;0.40;283.77;10.47;1040;63;3947.00;48
10390;62;626141286;10390;387;11429;11476;6.64;0.41;283.77;10.47;1039;63;3948.00;47
10396;62;626141301;10396;388;11429;11476;6.62;0.40;283.91;10.47;1033;63;3949.00;47
10401;62;626141317;10401;386;11432;11480;6.62;0.40;284.05;10.47;1031;63;3950.00;48
10403;62;626141333;10403;384;11433;11481;6.64;0.40;284.04;10.47;1030;63;3951.00;48
10411;62;626141349;10411;380;11433;11481;6.57;0.40;284.15;10.47;1022;63;3952.00;48
10415;62;626141364;10415;380;11434;11482;6.55;0.40;284.15;10.47;1019;63;3953.00;48
10421;62;626141380;10421;387;11434;11482;6.50;0.39;284.24;10.47;1013;63;3954.00;48
10424;62;626141396;10424;388;11434;11482;6.46;0.39;284.29;10.47;1010;63;3955.00;48
10430;62;626141411;10430;397;11434;11482;6.38;0.39;284.44;10.47;1004;63;3956.00;48
10433;62;626141425;10433;389;11434;11482;6.34;0.39;284.50;10.47;1001;63;3957.00;48
10435;62;626141440;10435;379;11434;11482;6.29;0.38;284.48;10.47;999;63;3958.00;48
10439;62;626141455;10439;377;11434;11482;6.30;0.38;284.56;10.47;995;63;3959.00;48
10442;62;626141473;10442;403;11505;11607;6.36;0.39;284.56;10.40;1063;63;3960.00;102
10446;62;626141502;10446;392;11508;11608;6.40;0.39;284.67;10.40;1062;63;3961.00;100
10450;62;626141518;10450;388;11513;11608;6.48;0.40;284.74;10.44;1063;63;3962.00;95
10454;62;626141534;10454;382;11516;11608;6.55;0.40;284.78;10.43;1062;63;3963.00;92
10458;62;626141550;10458;382;11519;11608;6.57;0.40;284.77;10.43;1061;63;3964.00;89
10461;62;626141568;10461;383;11522;11608;6.60;0.41;284.83;10.43;1061;63;3965.00;86
10464;62;626141583;10464;372;11525;11608;6.63;0.41;284.93;10.43;1061;63;3966.00;83
10468;62;626141606;10468;368;11528;11608;6.67;0.41;285.01;10.43;1060;63;3967.00;80
10472;62;626141622;10472;355;11532;11609;6.71;0.41;285.02;10.43;1060;63;3968.00;77
10475;62;626141638;10475;350;11537;11610;6.67;0.41;285.08;10.43;1062;63;3969.00;73
10478;62;626141653;10478;354;11538;11610;6.63;0.41;285.11;10.43;1060;63;3970.00;72
10480;62;626141670;10480;341;11542;11614;6.61;0.41;285.19;10.42;1062;63;3971.00;72
10481;62;626141687;10481;342;11543;11614;6.60;0.41;285.21;10.42;1062;63;3972.00;71
10482;62;626141703;10482;334;11544;11614;6.58;0.40;285.25;10.42;1062;63;3973.00;70
10484;62;626141718;10484;335;11545;11614;6.57;0.40;285.29;10.42;1061;63;3974.00;69
10488;62;626141734;10488;330;11549;11620;6.57;0.40;285.38;10.42;1061;63;3975.00;71
10489;62;626141750;10489;336;11549;11620;6.59;0.40;285.36;10.42;1060;63;3976.00;71
10491;62;626141765;10491;329;11550;11620;6.61;0.41;285.37;10.42;1059;63;3977.00;70
10495;62;626141781;10495;329;11553;11623;6.66;0.41;285.36;10.42;1058;63;3978.00;70
10495;62;626141797;10495;326;11553;11623;6.72;0.41;285.36;10.42;1058;63;3979.00;70
10498;62;626141813;10498;323;11553;11623;6.75;0.41;285.37;10.42;1055;63;3980.00;70
10499;62;626141829;10499;314;11553;11624;6.77;0.41;285.37;10.42;1054;63;3981.00;71
10500;62;626141845;10500;305;11554;11625;6.83;0.42;285.40;10.42;1054;63;3982.00;71
10504;62;626141860;10504;303;11554;11625;6.84;0.42;285.37;10.42;1050;63;3983.00;71
10508;62;626141875;10508;296;11564;11638;6.87;0.42;285.40;10.41;1056;63;3984.00;74
10512;62;626141899;10512;298;11564;11638;6.85;0.42;285.38;10.41;1052;63;3985.00;74
10512;62;626141929;10512;298;11564;11638;6.87;0.42;285.38;10.41;1052;63;3986.00;74
10517;62;626141944;10517;305;11565;11639;6.88;0.42;285.36;10.41;1048;63;3987.00;74
10518;62;626141961;10518;305;11565;11639;6.92;0.42;285.35;10.41;1047;63;3988.00;74
10518;62;626141977;10518;308;11569;11643;6.91;0.42;285.35;10.44;1051;63;3989.00;74
10523;62;626141995;10523;312;11570;11643;6.85;0.42;285.33;10.44;1047;63;3990.00;73
10524;62;626142010;10524;318;11573;11647;6.83;0.42;285.33;10.43;1049;63;3991.00;74
10526;62;626142027;10526;327;11573;11647;6.69;0.41;285.34;10.43;1047;63;3992.00;74
10527;62;626142041;10527;327;11573;11647;6.60;0.40;285.35;10.43;1046;63;3993.00;74
10531;62;626142055;10531;331;11573;11647;6.50;0.40;285.36;10.43;1042;63;3994.00;74
10534;62;626142069;10534;336;11573;11647;6.40;0.39;285.32;10.43;1039;63;3995.00;74
10538;62;626142082;10538;343;11582;11659;6.38;0.39;285.31;10.43;1044;63;3996.00;77
10540;62;626142097;10540;342;11583;11659;6.38;0.39;285.27;10.42;1043;63;3997.00;76
10542;62;626142110;10542;343;11583;11659;6.32;0.39;285.24;10.42;1041;63;3998.00;76
10543;62;626142124;10543;348;11583;11659;6.28;0.39;285.24;10.42;1040;63;3999.00;76
10547;62;626142138;10547;346;11583;11659;6.22;0.38;285.18;10.42;1036;63;4000.00;76
10548;63;626142154;10548;340;11583;11659;6.21;0.38;285.28;10.42;1035;64;4001.00;76
10550;63;626142179;10550;336;11583;11660;6.16;0.38;285.24;10.42;1033;64;4002.00;77
10553;63;626142193;10553;333;11583;11660;6.06;0.37;285.23;10.42;1030;64;4003.00;77
10559;63;626142206;10559;331;11587;11666;6.01;0.37;285.25;10.42;1028;64;4004.00;79
10559;63;626142220;10559;325;11590;11668;6.03;0.37;285.25;10.42;1031;64;4005.00;78
10562;63;626142233;10562;327;11590;11668;6.03;0.37;285.23;10.42;1028;64;4006.00;78
10563;63;626142246;10563;323;11590;11668;6.03;0.37;285.21;10.42;1027;64;4007.00;78
10565;63;626142258;10565;320;11593;11672;6.03;0.37;285.20;10.42;1028;64;4008.00;79
10569;63;626142271;10569;313;11593;11672;5.97;0.37;285.23;10.42;1024;64;4009.00;79
10571;63;626142284;10571;310;11593;11672;5.95;0.36;285.21;10.42;1022;64;4010.00;79
10574;63;626142296;10574;310;11595;11673;5.91;0.36;285.22;10.45;1021;64;4011.00;78
10577;63;626142308;10577;305;11598;11677;5.82;0.36;285.17;10.45;1021;64;4012.00;79
10579;63;626142325;10579;303;11598;11677;5.75;0.35;285.20;10.45;1019;64;4013.00;79
10583;63;626142340;10583;299;11601;11680;5.69;0.35;285.21;10.46;1018;64;4014.00;79
10586;63;626142352;10586;293;11604;11680;5.65;0.35;285.21;10.50;1018;64;4015.00;76
10589;63;626142363;10589;293;11604;11680;5.61;0.34;285.20;10.50;1015;64;4016.00;76
10592;63;626142380;10592;294;11604;11680;5.58;0.34;285.18;10.50;1012;64;4017.00;76
10595;63;626142391;10595;294;11609;11684;5.58;0.34;285.18;10.54;1014;64;4018.00;75
10596;63;626142402;10596;280;11610;11684;5.62;0.34;285.16;10.54;1014;64;4019.00;74
10598;63;626142414;10598;267;11610;11684;5.68;0.35;285.14;10.54;1012;64;4020.00;74
10599;63;626142426;10599;256;11611;11684;5.75;0.35;285.14;10.57;1012;64;4021.00;73
10601;63;626142436;10601;249;11611;11685;5.78;0.35;285.10;10.57;1010;64;4022.00;74
10603;63;626142448;10603;246;11612;11686;5.81;0.35;285.06;10.57;1009;64;4023.00;74
10604;63;626142459;10604;239;11613;11686;5.87;0.36;285.16;10.61;1009;64;4024.00;73
10604;63;626142471;10604;236;11614;11687;6.02;0.37;285.16;10.61;1010;64;4025.00;73
10606;63;626142482;10606;226;11615;11687;6.05;0.37;285.18;10.64;1009;64;4026.00;72
10608;63;626142498;10608;214;11616;11687;6.15;0.37;285.14;10.64;1008;64;4027.00;71
10609;63;626142509;10609;212;11617;11687;6.19;0.38;285.15;10.68;1008;64;4028.00;70
10610;63;626142526;10610;215;11617;11687;6.27;0.38;285.15;10.68;1007;64;4029.00;70
10610;63;626142537;10610;215;11618;11687;6.34;0.38;285.15;10.72;1008;64;4030.00;69
10610;63;626142548;10610;223;11618;11687;6.39;0.39;285.15;10.72;1008;64;4031.00;69
10611;63;626142560;10611;231;11681;11814;6.64;0.41;285.15;10.66;1070;64;4032.00;133
10612;63;626142582;10612;227;11685;11815;6.68;0.41;285.15;10.69;1073;64;4033.00;130
10613;63;626142594;10613;226;11692;11815;6.76;0.42;285.14;10.69;1079;64;4034.00;123
10613;63;626142606;10613;222;11698;11815;6.91;0.42;285.14;10.68;1085;64;4035.00;117
10614;63;626142619;10614;227;11703;11815;6.98;0.43;285.11;10.69;1089;64;4036.00;112
10615;63;626142631;10615;224;11706;11815;7.04;0.43;285.11;10.69;1091;64;4037.00;109
10615;63;626142644;10615;231;11709;11815;7.08;0.43;285.11;10.69;1094;64;4038.00;106
10617;63;626142657;10617;235;11711;11815;7.09;0.43;285.11;10.70;1094;64;4039.00;104
10619;63;626142670;10619;235;11718;11816;7.12;0.44;285.15;10.71;1099;64;4040.00;98
10622;63;626142683;10622;236;11719;11817;7.11;0.44;285.14;10.71;1097;64;4041.00;98
10625;63;626142697;10625;236;11724;11817;7.14;0.44;285.23;10.72;1099;64;4042.00;93
10627;63;626142711;10627;236;11729;11818;7.17;0.44;285.24;10.73;1102;64;4043.00;89
10629;63;626142725;10629;242;11734;11818;7.19;0.44;285.28;10.74;1105;64;4044.00;84
10630;63;626142738;10630;250;11736;11818;7.22;0.44;285.31;10.74;1106;64;4045.00;82
10632;63;626142751;10632;250;11741;11818;7.20;0.44;285.34;10.75;1109;64;4046.00;77
10633;63;626142764;10633;248;11744;11822;7.18;0.44;285.34;10.75;1111;64;4047.00;78
10634;63;626142778;10634;255;11747;11822;7.15;0.44;285.37;10.77;1113;64;4048.00;75
10636;63;626142791;10636;261;11749;11822;7.15;0.44;285.39;10.78;1113;64;4049.00;73
10639;63;626142806;10639;262;11753;11828;7.13;0.44;285.41;10.78;1114;64;4050.00;75
10641;63;626142819;10641;269;11755;11828;7.07;0.43;285.44;10.80;1114;64;4051.00;73
10643;63;626142833;10643;270;11758;11828;6.95;0.42;285.43;10.82;1115;64;4052.00;70
10647;63;626142853;10647;266;11761;11832;6.84;0.42;285.55;10.82;1114;64;4053.00;71
10652;63;626142866;10652;273;11764;11833;6.79;0.41;285.60;10.83;1112;64;4054.00;69
10652;63;626142880;10652;276;11765;11833;6.79;0.41;285.60;10.83;1113;64;4055.00;68
10656;63;626142892;10656;279;11770;11837;6.77;0.41;285.66;10.84;1114;64;4056.00;67
10660;63;626142911;10660;287;11772;11837;6.72;0.41;285.70;10.85;1112;64;4057.00;65
10661;63;626142924;10661;297;11773;11837;6.68;0.41;285.69;10.86;1112;64;4058.00;64
10664;63;626142937;10664;293;11776;11838;6.67;0.41;285.77;10.86;1112;64;4059.00;62
10665;63;626142950;10665;291;11777;11838;6.66;0.41;285.82;10.88;1112;64;4060.00;61
10667;63;626142963;10667;296;11781;11844;6.66;0.41;285.87;10.87;1114;64;4061.00;63
10668;63;626142977;10668;294;11784;11844;6.62;0.41;285.90;10.89;1116;64;4062.00;60
10670;63;626142990;10670;297;11784;11845;6.60;0.40;285.96;10.89;1114;64;4063.00;61
10673;63;626143003;10673;298;11786;11845;6.58;0.40;286.01;10.90;1113;64;4064.00;59
10676;63;626143016;10676;297;11786;11845;6.54;0.40;286.02;10.90;1110;64;4065.00;59
10678;63;626143038;10678;293;11789;11845;6.52;0.40;286.09;10.93;1111;64;4066.00;56
10678;63;626143060;10678;295;11789;11845;6.55;0.40;286.09;10.93;1111;64;4067.00;56
10683;63;626143081;10683;298;11798;11857;6.59;0.40;286.19;10.92;1115;64;4068.00;59
10686;63;626143102;10686;294;11800;11857;6.53;0.40;286.20;10.93;1114;64;4069.00;57
10691;63;626143121;10691;290;11802;11857;6.48;0.40;286.25;10.93;1111;64;4070.00;55
10695;63;626143138;10695;295;11804;11857;6.40;0.39;286.26;10.95;1109;64;4071.00;53
10700;63;626143153;10700;296;11805;11857;6.31;0.39;286.31;10.96;1105;64;4072.00;52
10701;63;626143167;10701;293;11805;11857;6.26;0.38;286.33;10.96;1104;64;4073.00;52
10710;63;626143181;10710;295;11809;11861;6.14;0.37;286.41;10.96;1099;64;4074.00;52
10713;63;626143196;10713;290;11809;11861;6.08;0.37;286.51;10.96;1096;64;4075.00;52
10716;63;626143210;10716;299;11812;11865;6.09;0.37;286.54;10.96;1096;64;4076.00;53
10718;63;626143224;10718;299;11815;11866;6.02;0.37;286.57;10.97;1097;64;4077.00;51
10723;63;626143237;10723;297;11817;11866;5.97;0.37;286.60;10.97;1094;64;4078.00;49
10727;63;626143251;10727;308;11818;11866;5.88;0.36;286.64;10.98;1091;64;4079.00;48
10732;63;626143265;10732;306;11837;11895;5.85;0.36;286.67;10.96;1105;64;4080.00;58
10737;63;626143281;10737;289;11839;11895;5.79;0.35;286.66;10.97;1102;64;4081.00;56
10741;63;626143293;10741;288;11842;11895;5.79;0.35;286.67;10.97;1101;64;4082.00;53
10744;63;626143306;10744;294;11845;11896;5.82;0.36;286.67;10.97;1101;64;4083.00;51
10748;63;626143319;10748;292;11848;11897;5.83;0.36;286.72;10.97;1100;64;4084.00;49
10754;63;626143333;10754;298;11848;11897;5.80;0.36;286.87;10.97;1094;64;4085.00;49
10758;63;626143346;10758;304;11851;11900;5.81;0.36;286.91;10.97;1093;64;4086.00;49
10760;63;626143360;10760;303;11853;11900;5.84;0.36;286.88;10.98;1093;64;4087.00;47
10763;63;626143372;10763;300;11853;11900;5.88;0.36;286.94;10.98;1090;64;4088.00;47
10766;63;626143387;10766;293;11853;11900;5.92;0.36;287.00;10.98;1087;64;4089.00;47
10770;63;626143400;10770;291;11857;11906;5.99;0.37;287.05;10.97;1087;64;4090.00;49
10777;63;626143414;10777;290;11858;11906;6.03;0.37;287.09;10.97;1081;64;4091.00;48
10777;63;626143428;10777;291;11858;11906;6.11;0.37;287.09;10.97;1081;64;4092.00;48
10781;63;626143441;10781;298;11858;11906;6.17;0.38;287.17;10.97;1077;64;4093.00;48
10785;63;626143456;10785;302;11861;11910;6.25;0.38;287.23;10.97;1076;64;4094.00;49
10788;63;626143473;10788;302;11863;11912;6.34;0.39;287.29;10.97;1075;64;4095.00;49
10792;63;626143489;10792;294;11863;11912;6.42;0.39;287.36;10.97;1071;64;4096.00;49
10798;63;626143506;10798;292;11864;11913;6.49;0.40;287.41;10.97;1066;64;4097.00;49
10801;63;626143521;10801;291;11864;11913;6.61;0.40;287.42;10.97;1063;64;4098.00;49
10807;63;626143537;10807;289;11864;11913;6.65;0.41;287.46;10.97;1057;64;4099.00;49
10808;63;626143555;10808;291;11864;11913;6.73;0.41;287.46;10.97;1056;64;4100.00;49
10812;64;626143576;10812;287;11864;11913;6.77;0.41;287.51;10.97;1052;65;4101.00;49
10816;64;626143611;10816;282;11864;11913;6.83;0.42;287.49;10.97;1048;65;4102.00;49
10822;64;626143627;10822;288;11864;11913;6.86;0.42;287.53;10.97;1042;65;4103.00;49
10830;64;626143643;10830;298;11903;11983;6.86;0.42;287.70;10.93;1073;65;4104.00;80
10832;64;626143666;10832;299;11904;11984;6.89;0.42;287.73;10.93;1072;65;4105.00;80
10837;64;626143681;10837;297;11908;11984;6.95;0.42;287.73;10.93;1071;65;4106.00;76
10840;64;626143697;10840;299;11909;11984;6.99;0.43;287.73;10.93;1069;65;4107.00;75
10846;64;626143712;10846;301;11911;11984;7.06;0.43;287.86;10.93;1065;65;4108.00;73
10850;64;626143728;10850;306;11916;11984;7.13;0.44;287.93;10.92;1066;65;4109.00;68
10853;64;626143745;10853;309;11917;11984;7.17;0.44;287.98;10.92;1064;65;4110.00;67
10858;64;626143766;10858;314;11921;11984;7.18;0.44;287.96;10.92;1063;65;4111.00;63
10864;64;626143782;10864;324;11922;11985;7.13;0.44;288.08;10.92;1058;65;4112.00;63
10868;64;626143798;10868;328;11926;11986;7.11;0.43;288.11;10.92;1058;65;4113.00;60
10874;64;626143815;10874;333;11930;11986;7.04;0.43;288.14;10.96;1056;65;4114.00;56
10881;64;626143831;10881;327;11932;11990;6.98;0.43;288.23;10.96;1051;65;4115.00;58
10884;64;626143849;10884;332;11932;11990;7.00;0.43;288.23;10.96;1048;65;4116.00;58
10890;64;626143864;10890;335;11932;11990;6.96;0.42;288.29;10.96;1042;65;4117.00;58
10896;64;626143879;10896;334;11932;11990;6.92;0.42;288.36;10.96;1036;65;4118.00;58
10900;64;626143897;10900;343;11936;11996;6.91;0.42;288.39;10.96;1036;65;4119.00;60
10905;64;626143913;10905;342;11938;11996;6.90;0.42;288.44;10.96;1033;65;4120.00;58
10909;64;626143929;10909;347;11939;11996;6.89;0.42;288.48;10.96;1030;65;4121.00;57
10912;64;626143945;10912;348;11942;11999;6.87;0.42;288.50;10.95;1030;65;4122.00;57
10916;64;626143960;10916;353;11942;11999;6.81;0.41;288.56;10.95;1026;65;4123.00;57
10920;64;626143976;10920;363;11944;11999;6.70;0.41;288.54;10.95;1024;65;4124.00;55
10928;64;626143991;10928;367;11944;12000;6.54;0.40;288.49;10.95;1016;65;4125.00;56
10930;64;626144007;10930;374;11945;12001;6.45;0.39;288.47;10.95;1015;65;4126.00;56
10932;64;626144024;10932;366;11945;12001;6.41;0.39;288.48;10.95;1013;65;4127.00;56
10934;64;626144039;10934;366;11956;12014;6.44;0.39;288.49;10.94;1022;65;4128.00;58
10936;64;626144055;10936;363;11956;12014;6.38;0.39;288.54;10.94;1020;65;4129.00;58
10938;64;626144071;10938;366;11956;12014;6.34;0.39;288.54;10.94;1018;65;4130.00;58
10940;64;626144086;10940;370;11958;12015;6.33;0.39;288.54;10.99;1018;65;4131.00;57
10942;64;626144100;10942;379;11958;12015;6.33;0.39;288.58;10.99;1016;65;4132.00;57
10944;64;626144115;10944;384;11961;12019;6.35;0.39;288.60;10.98;1017;65;4133.00;58
10947;64;626144129;10947;390;11961;12019;6.33;0.39;288.61;10.98;1014;65;4134.00;58
10949;64;626144144;10949;395;11965;12023;6.35;0.39;288.68;10.98;1016;65;4135.00;58
10952;64;626144158;10952;389;11965;12023;6.34;0.39;288.80;10.98;1013;65;4136.00;58
10954;64;626144173;10954;387;11965;12023;6.33;0.39;288.77;10.98;1011;65;4137.00;58
10958;64;626144188;10958;382;11965;12023;6.29;0.38;288.76;10.98;1007;65;4138.00;58
10959;64;626144202;10959;379;11965;12023;6.26;0.38;288.78;10.98;1006;65;4139.00;58
10962;64;626144218;10962;380;11988;12057;6.26;0.38;288.75;10.96;1026;65;4140.00;69
10965;64;626144236;10965;373;11989;12057;6.25;0.38;288.71;10.96;1024;65;4141.00;68
10968;64;626144250;10968;361;11991;12057;6.32;0.39;288.70;10.96;1023;65;4142.00;66
10970;64;626144270;10970;355;11991;12057;6.36;0.39;288.68;10.96;1021;65;4143.00;66
10971;64;626144284;10971;346;11992;12057;6.41;0.39;288.68;10.96;1021;65;4144.00;65
10973;64;626144298;10973;337;11992;12057;6.48;0.40;288.73;10.96;1019;65;4145.00;65
10975;64;626144313;10975;334;11993;12058;6.55;0.40;288.78;10.96;1018;65;4146.00;65
10978;64;626144326;10978;335;11993;12058;6.54;0.40;288.78;10.96;1015;65;4147.00;65
10980;64;626144347;10980;337;11997;12064;6.54;0.40;288.79;10.95;1017;65;4148.00;67
10985;64;626144361;10985;335;11998;12065;6.52;0.40;288.72;10.95;1013;65;4149.00;67
10987;64;626144376;10987;335;11999;12065;6.51;0.40;288.68;10.95;1012;65;4150.00;66
10988;64;626144389;10988;326;11999;12065;6.49;0.40;288.67;10.95;1011;65;4151.00;66
10992;64;626144403;10992;327;12003;12069;6.47;0.39;288.59;10.95;1011;65;4152.00;66
10995;64;626144417;10995;323;12003;12069;6.41;0.39;288.58;10.95;1008;65;4153.00;66
11000;64;626144430;11000;324;12003;12069;6.27;0.38;288.55;10.95;1003;65;4154.00;66
11000;64;626144444;11000;325;12004;12070;6.25;0.38;288.55;10.95;1004;65;4155.00;66
11002;64;626144463;11002;329;12007;12074;6.18;0.38;288.52;10.95;1005;65;4156.00;67
11004;64;626144482;11004;337;12007;12074;6.15;0.37;288.50;10.95;1003;65;4157.00;67
11007;64;626144495;11007;339;12009;12077;6.13;0.37;288.53;10.94;1002;65;4158.00;68
11007;64;626144508;11007;337;12009;12077;6.05;0.37;288.53;10.94;1002;65;4159.00;68
11010;64;626144526;11010;342;12010;12077;6.01;0.37;288.60;10.94;1000;65;4160.00;67
11012;64;626144539;11012;350;12010;12077;5.93;0.36;288.61;10.94;998;65;4161.00;67
11013;64;626144551;11013;348;12013;12081;5.90;0.36;288.61;10.94;1000;65;4162.00;68
11014;64;626144565;11014;350;12013;12081;5.83;0.36;288.61;10.94;999;65;4163.00;68
11016;64;626144577;11016;355;12014;12081;5.81;0.35;288.57;10.94;998;65;4164.00;67
11016;64;626144589;11016;359;12014;12081;5.76;0.35;288.57;10.94;998;65;4165.00;67
11016;64;626144601;11016;357;12014;12082;5.67;0.35;288.57;10.94;998;65;4166.00;68
11017;64;626144613;11017;359;12015;12083;5.57;0.34;288.56;10.94;998;65;4167.00;68
11017;64;626144625;11017;361;12016;12083;5.49;0.34;288.56;10.98;999;65;4168.00;67
11020;64;626144636;11020;363;12017;12084;5.43;0.33;288.55;10.98;997;65;4169.00;67
11023;64;626144650;11023;356;12017;12084;5.37;0.33;288.56;10.98;994;65;4170.00;67
11024;64;626144662;11024;341;12017;12084;5.36;0.33;288.56;10.98;993;65;4171.00;67
11026;64;626144675;11026;327;12017;12084;5.35;0.33;288.58;10.98;991;65;4172.00;67
11028;64;626144687;11028;316;12019;12086;5.40;0.33;288.56;10.98;991;65;4173.00;67
11030;64;626144699;11030;306;12019;12086;5.47;0.34;288.56;10.98;989;65;4174.00;67
11032;64;626144711;11032;292;12019;12086;5.53;0.34;288.55;10.98;987;65;4175.00;67
11032;65;626144723;11032;305;12087;12213;5.72;0.36;288.55;10.92;1055;66;4176.00;126
11034;65;626144758;11034;288;12088;12214;5.74;0.36;288.56;10.92;1054;66;4177.00;126
11036;65;626144777;11036;273;12095;12214;5.83;0.36;288.58;10.96;1059;66;4178.00;119
11038;65;626144795;11038;274;12098;12214;5.92;0.37;288.54;10.96;1060;66;4179.00;116
11039;65;626144807;11039;266;12101;12214;6.01;0.37;288.52;10.96;1062;66;4180.00;113
11041;65;626144820;11041;267;12104;12214;6.06;0.38;288.50;10.96;1063;66;4181.00;110
11043;65;626144833;11043;254;12106;12214;6.10;0.38;288.51;10.96;1063;66;4182.00;108
11047;65;626144850;11047;252;12109;12214;6.17;0.38;288.61;11.00;1062;66;4183.00;105
11050;66;626144862;11050;253;12111;12215;6.25;0.39;288.61;11.00;1061;67;4184.00;104
11056;66;626144882;11056;251;12116;12217;6.32;0.39;288.65;11.02;1060;67;4185.00;101
11059;66;626144901;11059;247;12117;12217;6.38;0.39;288.70;11.02;1058;67;4186.00;100
11060;66;626144915;11060;250;12120;12218;6.49;0.40;288.71;11.02;1060;67;4187.00;98
11063;66;626144928;11063;248;12125;12218;6.53;0.40;288.72;11.07;1062;67;4188.00;93
11065;66;626144942;11065;238;12127;12218;6.51;0.40;288.70;11.07;1062;67;4189.00;91
11065;66;626144955;11065;248;12129;12218;6.56;0.40;288.70;11.07;1064;67;4190.00;89
11067;66;626144970;11067;238;12132;12222;6.60;0.41;288.70;11.07;1065;67;4191.00;90
11069;66;626144984;11069;240;12135;12222;6.63;0.41;288.71;11.12;1066;67;4192.00;87
11072;66;626144998;11072;231;12139;12222;6.66;0.41;288.67;11.12;1067;67;4193.00;83
11076;66;626145011;11076;234;12142;12225;6.71;0.41;288.73;11.12;1066;67;4194.00;83
11080;66;626145031;11080;238;12145;12225;6.71;0.41;288.77;11.12;1065;67;4195.00;80
11081;66;626145053;11081;247;12145;12225;6.75;0.41;288.78;11.12;1064;67;4196.00;80
11085;66;626145077;11085;245;12150;12229;6.73;0.41;288.76;11.11;1065;67;4197.00;79
11090;66;626145114;11090;248;12151;12230;6.74;0.41;288.75;11.11;1061;67;4198.00;79
11092;66;626145148;11092;241;12151;12230;6.77;0.41;288.75;11.11;1059;67;4199.00;79
11096;66;626145180;11096;250;12160;12264;6.78;0.41;288.76;11.11;1064;67;4200.00;104
11099;66;626145209;11099;248;12163;12264;6.74;0.41;288.79;11.10;1064;67;4201.00;101
11100;66;626145227;11100;241;12165;12264;6.75;0.41;288.78;11.11;1065;67;4202.00;99
11105;66;626145245;11105;239;12169;12265;6.74;0.41;288.75;11.14;1064;67;4203.00;96
11106;66;626145265;11106;244;12170;12265;6.81;0.42;288.76;11.14;1064;67;4204.00;95
11111;66;626145284;11111;240;12173;12271;6.86;0.42;288.82;11.14;1062;67;4205.00;98
11113;66;626145307;11113;236;12176;12271;6.89;0.42;288.82;11.14;1063;67;4206.00;95
11114;66;626145325;11114;238;12178;12272;6.95;0.42;288.84;11.18;1064;67;4207.00;94
11115;66;626145343;11115;237;12178;12272;6.99;0.43;288.83;11.18;1063;67;4208.00;94
11119;66;626145363;11119;236;12179;12272;7.01;0.43;288.87;11.18;1060;67;4209.00;93
11121;66;626145381;11121;233;12181;12272;7.04;0.43;288.91;11.20;1060;67;4210.00;91
11126;66;626145408;11126;235;12182;12272;7.13;0.43;289.00;11.20;1056;67;4211.00;90
11127;66;626145425;11127;235;12192;12284;7.19;0.44;289.04;11.21;1065;67;4212.00;92
11130;66;626145450;11130;230;12195;12284;7.30;0.44;289.08;11.22;1065;67;4213.00;89
11133;66;626145470;11133;232;12195;12284;7.41;0.45;289.13;11.22;1062;67;4214.00;89
11136;66;626145490;11136;229;12197;12284;7.45;0.45;289.17;11.23;1061;67;4215.00;87
11138;66;626145509;11138;229;12198;12284;7.49;0.46;289.18;11.25;1060;67;4216.00;86
11140;66;626145529;11140;232;12199;12284;7.49;0.46;289.21;11.25;1059;67;4217.00;85
11143;66;626145546;11143;230;12204;12288;7.52;0.46;289.23;11.26;1061;67;4218.00;84
11147;66;626145568;11147;231;12206;12288;7.57;0.46;289.24;11.28;1059;67;4219.00;82
11148;66;626145586;11148;226;12208;12292;7.61;0.46;289.23;11.28;1060;67;4220.00;84
11152;66;626145607;11152;233;12212;12293;7.60;0.46;289.26;11.30;1060;67;4221.00;81
11156;66;626145625;11156;236;12212;12293;7.60;0.46;289.29;11.30;1056;67;4222.00;81
11158;66;626145646;11158;236;12214;12293;7.59;0.46;289.30;11.31;1056;67;4223.00;79
11161;66;626145666;11161;249;12223;12306;7.52;0.46;289.34;11.31;1062;67;4224.00;83
11164;66;626145688;11164;251;12225;12306;7.45;0.45;289.33;11.33;1061;67;4225.00;81
11166;66;626145707;11166;251;12226;12306;7.39;0.45;289.38;11.34;1060;67;4226.00;80
11168;66;626145730;11168;266;12229;12307;7.32;0.45;289.41;11.34;1061;67;4227.00;78
11170;66;626145746;11170;274;12231;12308;7.25;0.44;289.50;11.36;1061;67;4228.00;77
11172;66;626145764;11172;276;12233;12308;7.20;0.44;289.48;11.36;1061;67;4229.00;75
11174;66;626145783;11174;273;12239;12314;7.19;0.44;289.51;11.38;1065;67;4230.00;75
11177;66;626145802;11177;274;12239;12314;7.17;0.44;289.57;11.38;1062;67;4231.00;75
11180;66;626145821;11180;276;12239;12314;7.15;0.44;289.59;11.38;1059;67;4232.00;75
11181;66;626145839;11181;275;12239;12314;7.13;0.44;289.61;11.38;1058;67;4233.00;75
11186;66;626145858;11186;279;12246;12320;7.10;0.43;289.66;11.41;1060;67;4234.00;74
11191;66;626145878;11191;277;12246;12320;7.05;0.43;289.74;11.41;1055;67;4235.00;74
11194;66;626145898;11194;275;12248;12320;7.03;0.43;289.78;11.42;1054;67;4236.00;72
11198;66;626145916;11198;276;12248;12320;7.01;0.43;289.86;11.42;1050;67;4237.00;72
11199;66;626145935;11199;281;12252;12324;7.00;0.43;289.84;11.42;1053;67;4238.00;72
11201;66;626145953;11201;285;12254;12325;6.95;0.42;289.89;11.43;1053;67;4239.00;71
11205;66;626145972;11205;282;12255;12325;6.87;0.42;289.88;11.43;1050;67;4240.00;70
11206;66;626145990;11206;278;12256;12326;6.81;0.42;289.92;11.43;1050;67;4241.00;70
11211;66;626146009;11211;274;12258;12326;6.69;0.41;289.93;11.44;1047;67;4242.00;68
11216;66;626146030;11216;281;12259;12326;6.59;0.40;289.95;11.45;1043;67;4243.00;67
11218;66;626146047;11218;279;12260;12326;6.53;0.40;289.93;11.46;1042;67;4244.00;66
11222;66;626146063;11222;282;12261;12326;6.47;0.40;290.00;11.46;1039;67;4245.00;65
11227;66;626146080;11227;280;12265;12326;6.31;0.39;289.98;11.47;1038;67;4246.00;61
11230;66;626146094;11230;285;12265;12326;6.24;0.38;289.97;11.47;1035;67;4247.00;61
11234;66;626146114;11234;296;12302;12396;6.19;0.38;290.04;11.45;1068;67;4248.00;94
11238;66;626146137;11238;297;12302;12397;6.07;0.37;290.02;11.45;1064;67;4249.00;95
11241;66;626146152;11241;290;12307;12397;6.05;0.37;290.02;11.45;1066;67;4250.00;90
11244;66;626146167;11244;290;12315;12397;5.99;0.37;290.09;11.46;1071;67;4251.00;82
11249;66;626146188;11249;291;12320;12397;6.00;0.37;290.15;11.46;1071;67;4252.00;77
11251;66;626146204;11251;284;12323;12397;5.98;0.37;290.15;11.46;1072;67;4253.00;74
11255;66;626146217;11255;294;12330;12397;5.97;0.37;290.25;11.47;1075;67;4254.00;67
11258;66;626146231;11258;302;12334;12397;5.95;0.36;290.37;11.48;1076;67;4255.00;63
11262;66;626146244;11262;313;12338;12398;5.94;0.36;290.36;11.48;1076;67;4256.00;60
11268;66;626146258;11268;314;12340;12399;6.01;0.37;290.39;11.48;1072;67;4257.00;59
11271;66;626146275;11271;316;12342;12399;6.09;0.37;290.42;11.48;1071;67;4258.00;57
11277;66;626146291;11277;319;12347;12403;6.12;0.37;290.52;11.49;1070;67;4259.00;56
11280;66;626146312;11280;328;12348;12403;6.16;0.38;290.59;11.49;1068;67;4260.00;55
11285;66;626146329;11285;327;12349;12403;6.21;0.38;290.65;11.49;1064;67;4261.00;54
11287;66;626146353;11287;327;12351;12403;6.22;0.38;290.68;11.49;1064;67;4262.00;52
11291;66;626146379;11291;326;12354;12409;6.22;0.38;290.65;11.49;1063;67;4263.00;55
11295;66;626146398;11295;328;12355;12409;6.20;0.38;290.68;11.49;1060;67;4264.00;54
11296;66;626146414;11296;334;12356;12409;6.21;0.38;290.69;11.49;1060;67;4265.00;53
11302;66;626146432;11302;327;12359;12412;6.23;0.38;290.74;11.49;1057;67;4266.00;53
11305;66;626146451;11305;330;12359;12412;6.28;0.38;290.77;11.49;1054;67;4267.00;53
11307;66;626146466;11307;322;12359;12412;6.32;0.39;290.83;11.49;1052;67;4268.00;53
11313;66;626146481;11313;312;12360;12413;6.28;0.38;290.87;11.49;1047;67;4269.00;53
11317;66;626146496;11317;321;12362;12414;6.30;0.39;290.91;11.49;1045;67;4270.00;52
11323;67;626146510;11323;323;12362;12414;6.23;0.38;290.99;11.49;1039;68;4271.00;52
11326;67;626146540;11326;315;12374;12427;6.26;0.38;291.03;11.48;1048;68;4272.00;53
11331;67;626146556;11331;311;12374;12427;6.25;0.38;291.07;11.48;1043;68;4273.00;53
11335;67;626146571;11335;305;12374;12427;6.27;0.38;291.07;11.48;1039;68;4274.00;53
11339;67;626146587;11339;306;12378;12429;6.35;0.39;291.03;11.48;1039;68;4275.00;51
11341;67;626146603;11341;313;12378;12429;6.42;0.39;291.02;11.48;1037;68;4276.00;51
11344;67;626146619;11344;317;12380;12433;6.48;0.40;291.00;11.48;1036;68;4277.00;53
11346;67;626146635;11346;319;12381;12433;6.51;0.40;291.00;11.48;1035;68;4278.00;52
11352;67;626146651;11352;324;12384;12437;6.54;0.40;291.10;11.48;1032;68;4279.00;53
11357;67;626146668;11357;327;12385;12437;6.56;0.40;291.25;11.48;1028;68;4280.00;52
11363;67;626146685;11363;337;12386;12437;6.52;0.40;291.23;11.48;1023;68;4281.00;51
11368;67;626146708;11368;346;12387;12437;6.48;0.40;291.27;11.48;1019;68;4282.00;50
11370;67;626146725;11370;350;12387;12437;6.46;0.39;291.29;11.48;1017;68;4283.00;50
11374;67;626146740;11374;358;12398;12449;6.48;0.40;291.37;11.46;1024;68;4284.00;51
11379;67;626146761;11379;363;12398;12449;6.43;0.39;291.41;11.46;1019;68;4285.00;51
11382;67;626146786;11382;371;12398;12449;6.37;0.39;291.48;11.46;1016;68;4286.00;51
11385;67;626146804;11385;382;12398;12449;6.32;0.39;291.46;11.46;1013;68;4287.00;51
11387;67;626146818;11387;393;12398;12449;6.27;0.38;291.48;11.46;1011;68;4288.00;51
11389;67;626146832;11389;398;12398;12449;6.22;0.38;291.55;11.46;1009;68;4289.00;51
11389;67;626146852;11389;405;12398;12450;6.21;0.38;291.55;11.46;1009;68;4290.00;52
11392;67;626146869;11392;411;12398;12450;6.20;0.38;291.56;11.46;1006;68;4291.00;52
11398;67;626146886;11398;416;12402;12456;6.17;0.38;291.53;11.46;1004;68;4292.00;54
11401;67;626146902;11401;423;12403;12457;6.14;0.38;291.51;11.46;1002;68;4293.00;54
11404;67;626146916;11404;426;12404;12457;6.08;0.37;291.51;11.46;1000;68;4294.00;53
11405;67;626146930;11405;431;12404;12457;5.99;0.37;291.51;11.46;999;68;4295.00;53
11410;67;626146945;11410;435;12407;12461;5.92;0.36;291.56;11.46;997;68;4296.00;54
11413;67;626146964;11413;426;12407;12461;5.91;0.36;291.56;11.46;994;68;4297.00;54
11416;67;626146980;11416;421;12407;12461;5.90;0.36;291.52;11.46;991;68;4298.00;54
11417;67;626146996;11417;421;12408;12462;5.92;0.36;291.54;11.46;991;68;4299.00;54
11421;67;626147012;11421;424;12411;12466;5.97;0.36;291.63;11.45;990;68;4300.00;55
11423;67;626147036;11423;418;12411;12466;5.99;0.37;291.59;11.45;988;68;4301.00;55
11428;67;626147056;11428;421;12413;12469;6.02;0.37;291.69;11.45;985;68;4302.00;56
11435;67;626147079;11435;418;12413;12469;6.04;0.37;291.79;11.45;978;68;4303.00;56
11437;67;626147100;11437;418;12414;12469;6.07;0.37;291.77;11.45;977;68;4304.00;55
11441;67;626147124;11441;417;12414;12469;6.05;0.37;291.71;11.45;973;68;4305.00;55
11444;67;626147150;11444;410;12417;12473;6.12;0.37;291.70;11.45;973;68;4306.00;56
11446;67;626147172;11446;394;12417;12473;6.11;0.37;291.68;11.45;971;68;4307.00;56
11447;67;626147191;11447;384;12418;12473;6.15;0.38;291.67;11.45;971;68;4308.00;55
11447;67;626147212;11447;367;12418;12473;6.19;0.38;291.67;11.45;971;68;4309.00;55
11450;67;626147234;11450;359;12418;12474;6.25;0.38;291.63;11.45;968;68;4310.00;56
11453;67;626147257;11453;348;12419;12475;6.25;0.38;291.69;11.45;966;68;4311.00;56
11454;67;626147275;11454;344;12419;12475;6.25;0.38;291.68;11.45;965;68;4312.00;56
11457;67;626147295;11457;345;12420;12476;6.28;0.38;291.69;11.45;963;68;4313.00;56
11458;67;626147315;11458;345;12420;12476;6.32;0.39;291.67;11.45;962;68;4314.00;56
11461;68;626147338;11461;347;12421;12476;6.34;0.39;291.63;11.49;960;69;4315.00;55
11461;68;626147370;11461;341;12421;12476;6.35;0.39;291.63;11.49;960;69;4316.00;55
11462;68;626147389;11462;338;12421;12476;6.34;0.39;291.62;11.49;959;69;4317.00;55
11466;68;626147409;11466;335;12421;12476;6.34;0.39;291.60;11.49;955;69;4318.00;55
11469;68;626147425;11469;338;12421;12476;6.32;0.38;291.60;11.49;952;69;4319.00;55
11470;68;626147452;11470;376;12533;12706;6.55;0.41;291.59;11.39;1063;69;4320.00;173
11472;68;626147498;11472;365;12536;12707;6.47;0.40;291.57;11.38;1064;69;4321.00;171
11473;68;626147515;11473;342;12546;12707;6.52;0.41;291.57;11.38;1073;69;4322.00;161
11474;68;626147532;11474;328;12551;12707;6.52;0.41;291.59;11.37;1077;69;4323.00;156
11476;68;626147552;11476;311;12559;12707;6.55;0.41;291.56;11.37;1083;69;4324.00;148
11477;68;626147573;11477;299;12563;12707;6.54;0.41;291.62;11.37;1086;69;4325.00;144
11481;68;626147594;11481;300;12568;12707;6.52;0.40;291.69;11.36;1087;69;4326.00;139
11482;68;626147613;11482;301;12572;12707;6.55;0.41;291.68;11.36;1090;69;4327.00;135
11482;68;626147633;11482;296;12576;12708;6.56;0.41;291.68;11.36;1094;69;4328.00;132
11483;68;626147659;11483;298;12579;12709;6.54;0.41;291.68;11.36;1096;69;4329.00;130
11484;68;626147680;11484;294;12583;12709;6.48;0.40;291.68;11.36;1099;69;4330.00;126
11485;68;626147711;11485;290;12586;12710;6.42;0.40;291.67;11.36;1101;69;4331.00;124
11486;68;626147735;11486;295;12592;12710;6.37;0.40;291.68;11.40;1106;69;4332.00;118
11487;68;626147758;11487;296;12595;12710;6.35;0.39;291.67;11.40;1108;69;4333.00;115
11488;68;626147789;11488;292;12597;12710;6.35;0.39;291.67;11.40;1109;69;4334.00;113
11490;68;626147808;11490;299;12602;12714;6.29;0.39;291.67;11.40;1112;69;4335.00;112
11492;68;626147828;11492;297;12603;12714;6.23;0.39;291.67;11.40;1111;69;4336.00;111
11492;68;626147847;11492;300;12605;12714;6.19;0.38;291.67;11.40;1113;69;4337.00;109
11495;68;626147870;11495;305;12607;12717;6.20;0.38;291.64;11.40;1112;69;4338.00;110
11497;68;626147888;11497;313;12607;12717;6.16;0.38;291.63;11.40;1110;69;4339.00;110
11497;68;626147912;11497;307;12611;12717;6.16;0.38;291.63;11.41;1114;69;4340.00;106
11498;68;626147930;11498;301;12614;12721;6.19;0.38;291.62;11.40;1116;69;4341.00;107
11499;68;626147949;11499;306;12615;12722;6.16;0.38;291.61;11.40;1116;69;4342.00;107
11503;68;626147971;11503;305;12616;12722;6.13;0.38;291.57;11.40;1113;69;4343.00;106
11503;68;626147992;11503;303;12618;12726;6.17;0.38;291.57;11.40;1115;69;4344.00;108
11507;68;626148009;11507;295;12618;12726;6.14;0.38;291.54;11.40;1111;69;4345.00;108
11509;68;626148030;11509;286;12620;12726;6.11;0.37;291.57;11.40;1111;69;4346.00;106
11512;68;626148059;11512;288;12622;12727;6.07;0.37;291.59;11.44;1110;69;4347.00;105
11512;68;626148080;11512;288;12622;12727;6.11;0.37;291.59;11.44;1110;69;4348.00;105
11515;68;626148095;11515;283;12626;12733;6.09;0.37;291.63;11.48;1111;69;4349.00;107
11517;68;626148113;11517;280;12626;12733;6.11;0.37;291.66;11.48;1109;69;4350.00;107
11523;68;626148129;11523;268;12627;12734;6.08;0.37;291.62;11.48;1104;69;4351.00;107
11528;68;626148145;11528;266;12628;12734;6.02;0.37;291.67;11.52;1100;69;4352.00;106
11531;68;626148160;11531;258;12630;12734;6.01;0.37;291.72;11.52;1099;69;4353.00;104
11531;68;626148176;11531;251;12632;12734;6.05;0.37;291.72;11.56;1101;69;4354.00;102
11533;68;626148193;11533;249;12635;12734;6.07;0.37;291.70;11.58;1102;69;4355.00;99
11536;68;626148214;11536;240;12644;12746;6.13;0.37;291.69;11.57;1108;69;4356.00;102
11538;68;626148232;11538;237;12645;12746;6.14;0.37;291.71;11.57;1107;69;4357.00;101
11544;68;626148250;11544;228;12647;12746;6.12;0.37;291.76;11.61;1103;69;4358.00;99
11545;68;626148266;11545;221;12647;12746;6.15;0.37;291.77;11.61;1102;69;4359.00;99
11550;68;626148290;11550;219;12647;12746;6.16;0.37;291.82;11.61;1097;69;4360.00;99
11551;68;626148308;11551;220;12648;12746;6.29;0.38;291.81;11.64;1097;69;4361.00;98
11555;68;626148323;11555;216;12651;12750;6.34;0.38;291.84;11.63;1096;69;4362.00;99
11557;68;626148341;11557;211;12651;12750;6.45;0.39;291.92;11.63;1094;69;4363.00;99
11559;68;626148356;11559;208;12654;12754;6.54;0.40;291.94;11.66;1095;69;4364.00;100
11562;68;626148377;11562;195;12657;12756;6.58;0.40;291.96;11.66;1095;69;4365.00;99
11564;68;626148395;11564;195;12658;12756;6.61;0.40;292.06;11.66;1094;69;4366.00;98
11565;68;626148413;11565;189;12662;12756;6.65;0.40;292.07;11.70;1097;69;4367.00;94
11566;68;626148432;11566;193;12670;12769;6.71;0.41;292.09;11.69;1104;69;4368.00;99
11569;68;626148452;11569;188;12671;12769;6.72;0.41;292.08;11.69;1102;69;4369.00;98
11572;68;626148473;11572;191;12672;12769;6.80;0.41;292.10;11.69;1100;69;4370.00;97
11574;68;626148492;11574;193;12675;12770;6.82;0.42;292.17;11.73;1101;69;4371.00;95
11576;68;626148509;11576;197;12675;12771;6.88;0.42;292.22;11.73;1099;69;4372.00;96
11580;68;626148527;11580;194;12676;12771;6.93;0.42;292.24;11.73;1096;69;4373.00;95
11581;68;626148546;11581;198;12678;12774;6.99;0.43;292.29;11.73;1097;69;4374.00;96
11585;68;626148565;11585;198;12679;12774;7.01;0.43;292.30;11.73;1094;69;4375.00;95
11587;68;626148584;11587;205;12680;12774;7.07;0.43;292.31;11.73;1093;69;4376.00;94
11590;68;626148606;11590;217;12681;12774;7.12;0.43;292.30;11.73;1091;69;4377.00;93
11594;68;626148625;11594;222;12685;12780;7.22;0.44;292.38;11.73;1091;69;4378.00;95
11597;68;626148645;11597;226;12685;12780;7.28;0.44;292.45;11.73;1088;69;4379.00;95
11601;68;626148667;11601;229;12687;12780;7.29;0.44;292.41;11.73;1086;69;4380.00;93
11604;68;626148689;11604;230;12688;12780;7.29;0.44;292.47;11.75;1084;69;4381.00;92
11606;68;626148708;11606;231;12691;12784;7.31;0.44;292.49;11.74;1085;69;4382.00;93
11609;68;626148731;11609;234;12695;12785;7.32;0.44;292.48;11.77;1086;69;4383.00;90
11612;68;626148750;11612;238;12696;12785;7.31;0.44;292.57;11.78;1084;69;4384.00;89
11613;68;626148770;11613;245;12698;12786;7.33;0.44;292.60;11.79;1085;69;4385.00;88
11615;68;626148794;11615;247;12701;12786;7.32;0.45;292.57;11.81;1086;69;4386.00;85
11618;68;626148813;11618;258;12701;12786;7.27;0.44;292.64;11.81;1083;69;4387.00;85
11621;68;626148836;11621;260;12704;12786;7.22;0.44;292.61;11.84;1083;69;4388.00;82
11623;68;626148851;11623;266;12705;12786;7.19;0.44;292.64;11.85;1082;69;4389.00;81
11626;68;626148866;11626;267;12705;12786;7.17;0.44;292.66;11.85;1079;69;4390.00;81
11628;68;626148885;11628;271;12709;12786;7.15;0.43;292.73;11.88;1081;69;4391.00;77
11629;68;626148903;11629;270;12746;12856;7.29;0.44;292.76;11.86;1117;69;4392.00;110
11631;68;626148930;11631;270;12749;12857;7.32;0.45;292.76;11.87;1118;69;4393.00;108
11633;68;626148947;11633;270;12759;12857;7.39;0.45;292.78;11.87;1126;69;4394.00;98
11634;68;626148963;11634;268;12762;12857;7.43;0.45;292.77;11.87;1128;69;4395.00;95
11638;68;626148979;11638;277;12768;12857;7.45;0.45;292.88;11.88;1130;69;4396.00;89
11638;68;626149003;11638;270;12774;12857;7.47;0.46;292.88;11.88;1136;69;4397.00;83
11640;68;626149020;11640;272;12777;12857;7.47;0.46;292.87;11.88;1137;69;4398.00;80
11643;68;626149042;11643;270;12779;12857;7.41;0.45;292.92;11.89;1136;69;4399.00;78
11645;68;626149072;11645;264;12783;12858;7.38;0.45;292.89;11.90;1138;69;4400.00;75
11648;68;626149103;11648;264;12784;12859;7.39;0.45;292.91;11.90;1136;69;4401.00;75
11650;68;626149128;11650;262;12787;12859;7.33;0.45;292.94;11.91;1137;69;4402.00;72
11653;68;626149154;11653;261;12789;12863;7.31;0.45;292.95;11.91;1136;69;4403.00;74
11656;68;626149174;11656;267;12792;12863;7.29;0.45;292.99;11.93;1136;69;4404.00;71
11659;68;626149201;11659;267;12792;12863;7.35;0.45;293.01;11.93;1133;69;4405.00;71
11661;68;626149220;11661;275;12794;12863;7.35;0.45;293.05;11.93;1133;69;4406.00;69
11664;68;626149239;11664;279;12800;12869;7.37;0.45;293.08;11.94;1136;69;4407.00;69
11668;68;626149259;11668;286;12802;12869;7.35;0.45;293.16;11.94;1134;69;4408.00;67
11671;68;626149281;11671;290;12802;12869;7.31;0.45;293.19;11.94;1131;69;4409.00;67
11675;68;626149307;11675;296;12807;12875;7.27;0.44;293.15;11.95;1132;69;4410.00;68
11681;68;626149328;11681;298;12810;12875;7.20;0.44;293.27;11.95;1129;69;4411.00;65
11684;68;626149346;11684;309;12811;12875;7.08;0.43;293.32;11.96;1127;69;4412.00;64
11688;68;626149362;11688;306;12812;12876;6.94;0.42;293.40;11.96;1124;69;4413.00;64
11694;68;626149379;11694;301;12814;12877;6.84;0.42;293.55;11.96;1120;69;4414.00;63
11699;68;626149396;11699;306;12815;12877;6.67;0.41;293.55;11.97;1116;69;4415.00;62
11703;68;626149411;11703;304;12827;12890;6.46;0.40;293.56;11.96;1124;69;4416.00;63
11708;68;626149429;11708;305;12827;12890;6.34;0.39;293.59;11.96;1119;69;4417.00;63
11713;68;626149444;11713;312;12828;12890;6.19;0.38;293.63;11.96;1115;69;4418.00;62
11715;68;626149459;11715;318;12829;12891;6.08;0.37;293.66;11.96;1114;69;4419.00;62
11721;68;626149474;11721;313;12830;12891;5.98;0.37;293.72;11.97;1109;69;4420.00;61
11725;68;626149492;11725;304;12833;12895;5.96;0.37;293.77;11.97;1108;69;4421.00;62
11730;68;626149516;11730;302;12833;12895;5.91;0.36;293.79;11.97;1103;69;4422.00;62
11731;68;626149530;11731;305;12837;12899;5.92;0.36;293.82;11.97;1106;69;4423.00;62
11740;68;626149545;11740;301;12840;12899;5.90;0.36;293.92;11.99;1100;69;4424.00;59
11745;68;626149560;11745;306;12842;12899;5.93;0.36;294.05;12.00;1097;69;4425.00;57
11748;68;626149575;11748;304;12842;12899;5.95;0.37;294.10;12.00;1094;69;4426.00;57
11754;68;626149590;11754;292;12842;12899;5.94;0.36;294.11;12.00;1088;69;4427.00;57
11756;68;626149606;11756;301;12854;12911;6.01;0.37;294.13;11.99;1098;69;4428.00;57
11759;68;626149623;11759;300;12856;12911;6.00;0.37;294.18;11.99;1097;69;4429.00;55
11761;68;626149637;11761;295;12856;12911;5.99;0.37;294.21;11.99;1095;69;4430.00;55
11767;68;626149652;11767;299;12856;12911;5.99;0.37;294.25;11.99;1089;69;4431.00;55
11768;69;626149666;11768;291;12856;12911;6.04;0.37;294.24;11.99;1088;70;4432.00;55
11772;69;626149691;11772;292;12856;12911;6.06;0.37;294.26;11.99;1084;70;4433.00;55
11778;69;626149706;11778;293;12856;12912;6.05;0.37;294.33;11.99;1078;70;4434.00;56
11781;69;626149721;11781;291;12856;12912;6.08;0.37;294.31;11.99;1075;70;4435.00;56
11785;69;626149737;11785;292;12861;12918;6.14;0.38;294.40;11.99;1076;70;4436.00;57
11788;69;626149751;11788;298;12862;12919;6.16;0.38;294.42;11.98;1074;70;4437.00;57
11793;69;626149767;11793;303;12862;12919;6.16;0.38;294.43;11.98;1069;70;4438.00;57
11795;69;626149780;11795;311;12862;12919;6.22;0.38;294.40;11.98;1067;70;4439.00;57
11799;69;626149797;11799;322;12866;12924;6.27;0.38;294.37;11.98;1067;70;4440.00;58
11803;69;626149812;11803;322;12866;12924;6.28;0.39;294.39;11.98;1063;70;4441.00;58
11806;69;626149827;11806;322;12866;12924;6.30;0.39;294.39;11.98;1060;70;4442.00;58
11811;69;626149851;11811;327;12867;12925;6.28;0.38;294.40;11.98;1056;70;4443.00;58
11816;69;626149866;11816;332;12870;12929;6.24;0.38;294.36;11.98;1054;70;4444.00;59
11818;69;626149881;11818;335;12870;12929;6.25;0.38;294.37;11.98;1052;70;4445.00;59
11822;69;626149896;11822;339;12872;12932;6.26;0.38;294.36;11.98;1050;70;4446.00;60
11829;69;626149911;11829;347;12873;12932;6.26;0.38;294.39;11.97;1044;70;4447.00;59
11833;69;626149927;11833;354;12873;12932;6.21;0.38;294.38;11.97;1040;70;4448.00;59
11836;69;626149942;11836;357;12873;12932;6.20;0.38;294.38;11.97;1037;70;4449.00;59
11838;69;626149957;11838;357;12876;12936;6.23;0.38;294.36;11.97;1038;70;4450.00;60
11843;69;626149972;11843;360;12876;12936;6.19;0.38;294.31;11.97;1033;70;4451.00;60
11845;69;626149993;11845;361;12877;12936;6.21;0.38;294.30;11.97;1032;70;4452.00;59
11851;69;626150013;11851;375;12877;12936;6.19;0.38;294.27;11.97;1026;70;4453.00;59
11853;69;626150029;11853;374;12877;12937;6.22;0.38;294.27;11.97;1024;70;4454.00;60
11856;69;626150046;11856;381;12879;12939;6.25;0.38;294.22;11.97;1023;70;4455.00;60
11859;69;626150064;11859;378;12879;12939;6.22;0.38;294.17;11.97;1020;70;4456.00;60
11863;69;626150079;11863;381;12880;12940;6.22;0.38;294.11;11.97;1017;70;4457.00;60
11866;69;626150093;11866;388;12880;12940;6.18;0.38;294.06;11.97;1014;70;4458.00;60
11869;69;626150107;11869;394;12880;12940;6.11;0.37;294.06;11.97;1011;70;4459.00;60
11871;69;626150120;11871;396;12880;12940;6.04;0.37;294.06;11.97;1009;70;4460.00;60
11875;69;626150133;11875;406;12881;12940;5.98;0.36;294.05;12.01;1006;70;4461.00;59
11879;69;626150147;11879;412;12881;12940;5.96;0.36;294.00;12.01;1002;70;4462.00;59
11883;69;626150161;11883;416;12881;12940;5.93;0.36;293.98;12.01;998;70;4463.00;59
11887;69;626150174;11887;433;12949;13067;6.29;0.39;293.93;11.94;1062;70;4464.00;118
11888;69;626150200;11888;434;12951;13068;6.22;0.38;293.92;11.94;1063;70;4465.00;117
11892;69;626150213;11892;439;12961;13068;6.18;0.38;293.90;11.93;1069;70;4466.00;107
11892;69;626150226;11892;428;12963;13068;6.17;0.38;293.90;11.93;1071;70;4467.00;105
11894;69;626150240;11894;422;12969;13068;6.13;0.38;293.91;11.93;1075;70;4468.00;99
11897;69;626150254;11897;420;12973;13068;6.14;0.38;293.92;11.93;1076;70;4469.00;95
11899;69;626150270;11899;418;12978;13068;6.17;0.38;293.91;11.92;1079;70;4470.00;90
11901;69;626150286;11901;420;12980;13068;6.16;0.38;293.92;11.92;1079;70;4471.00;88
11903;69;626150302;11903;417;12985;13069;6.14;0.38;293.92;11.92;1082;70;4472.00;84
11904;69;626150319;11904;426;12989;13070;6.16;0.38;294.02;11.92;1085;70;4473.00;81
11905;69;626150335;11905;432;12992;13070;6.14;0.38;294.01;11.92;1087;70;4474.00;78
11906;69;626150349;11906;423;12993;13071;6.12;0.38;293.99;11.92;1087;70;4475.00;78
11909;69;626150364;11909;416;12995;13071;6.12;0.38;293.96;11.92;1086;70;4476.00;76
11909;69;626150379;11909;406;12996;13071;6.16;0.38;293.96;11.92;1087;70;4477.00;75
11912;69;626150395;11912;393;12998;13071;6.27;0.38;293.95;11.92;1086;70;4478.00;73
11912;69;626150410;11912;384;13000;13075;6.34;0.39;293.95;11.92;1088;70;4479.00;75
11913;69;626150426;11913;375;13003;13075;6.45;0.40;293.94;11.92;1090;70;4480.00;72
11914;69;626150442;11914;364;13003;13075;6.50;0.40;293.93;11.92;1089;70;4481.00;72
11916;69;626150464;11916;347;13006;13078;6.57;0.40;293.93;11.92;1090;70;4482.00;72
11917;69;626150481;11917;340;13006;13078;6.59;0.40;293.93;11.92;1089;70;4483.00;72
11917;69;626150497;11917;332;13007;13078;6.66;0.41;293.93;11.92;1090;70;4484.00;71
11917;69;626150512;11917;326;13010;13082;6.75;0.41;293.93;11.91;1093;70;4485.00;72
11920;69;626150528;11920;314;13012;13083;6.82;0.42;293.90;11.91;1092;70;4486.00;71
11923;69;626150544;11923;298;13013;13083;6.85;0.42;293.86;11.95;1090;70;4487.00;70
11923;69;626150560;11923;289;13016;13087;6.94;0.42;293.86;11.95;1093;70;4488.00;71
11925;69;626150576;11925;287;13016;13087;6.96;0.43;293.84;11.95;1091;70;4489.00;71
11927;69;626150593;11927;282;13016;13087;6.96;0.42;293.81;11.95;1089;70;4490.00;71
11928;69;626150608;11928;279;13017;13088;7.03;0.43;293.80;11.95;1089;70;4491.00;71
11928;69;626150624;11928;282;13017;13088;7.05;0.43;293.80;11.95;1089;70;4492.00;71
11931;69;626150641;11931;282;13021;13094;7.08;0.43;293.78;11.95;1090;70;4493.00;73
11934;69;626150657;11934;281;13021;13094;7.02;0.43;293.77;11.95;1087;70;4494.00;73
11934;69;626150673;11934;292;13022;13095;7.08;0.43;293.77;11.94;1088;70;4495.00;73
11937;69;626150689;11937;290;13022;13095;7.03;0.43;293.79;11.94;1085;70;4496.00;73
11939;69;626150704;11939;288;13022;13095;7.03;0.43;293.77;11.94;1083;70;4497.00;73
11944;69;626150720;11944;288;13022;13095;6.95;0.42;293.84;11.94;1078;70;4498.00;73
11947;69;626150735;11947;288;13022;13095;6.94;0.42;293.84;11.94;1075;70;4499.00;73
11950;69;626150752;11950;289;13045;13145;6.94;0.42;293.89;11.92;1095;70;4500.00;100
11953;69;626150781;11953;292;13046;13147;6.88;0.42;293.92;11.92;1093;70;4501.00;101
11955;69;626150797;11955;294;13048;13147;6.84;0.42;293.97;11.92;1093;70;4502.00;99
11958;69;626150818;11958;303;13048;13147;6.80;0.41;294.01;11.92;1090;70;4503.00;99
11962;69;626150834;11962;303;13050;13147;6.75;0.41;294.04;11.92;1088;70;4504.00;97
11963;69;626150849;11963;304;13051;13147;6.74;0.41;294.04;11.92;1088;70;4505.00;96
11965;70;626150864;11965;305;13057;13151;6.75;0.41;294.05;11.96;1092;71;4506.00;94
11966;70;626150894;11966;311;13057;13151;6.70;0.41;294.05;11.96;1091;71;4507.00;94
11966;70;626150909;11966;317;13061;13155;6.71;0.41;294.05;11.95;1095;71;4508.00;94
11970;70;626150929;11970;318;13063;13156;6.69;0.41;294.08;11.95;1093;71;4509.00;93
11973;70;626150944;11973;315;13063;13156;6.68;0.41;294.14;11.95;1090;71;4510.00;93
11975;70;626150959;11975;316;13063;13156;6.62;0.40;294.14;11.95;1088;71;4511.00;93
11979;70;626150974;11979;308;13070;13169;6.58;0.40;294.25;11.95;1091;71;4512.00;99
11981;70;626150989;11981;315;13071;13169;6.55;0.40;294.25;11.95;1090;71;4513.00;98
11985;70;626151003;11985;308;13071;13169;6.47;0.40;294.35;11.95;1086;71;4514.00;98
11988;70;626151017;11988;307;13073;13170;6.47;0.40;294.38;11.95;1085;71;4515.00;97
11994;70;626151033;11994;305;13073;13171;6.49;0.40;294.39;11.95;1079;71;4516.00;98
11997;70;626151058;11997;311;13073;13171;6.49;0.40;294.35;11.95;1076;71;4517.00;98
12003;70;626151079;12003;305;13075;13174;6.55;0.40;294.43;11.94;1072;71;4518.00;99
12006;70;626151101;12006;293;13076;13174;6.56;0.40;294.48;11.95;1070;71;4519.00;98
12010;70;626151122;12010;285;13077;13174;6.51;0.40;294.44;11.95;1067;71;4520.00;97
12015;70;626151143;12015;270;13077;13174;6.51;0.39;294.47;11.95;1062;71;4521.00;97
12016;70;626151158;12016;256;13080;13180;6.54;0.40;294.48;11.94;1064;71;4522.00;100
12018;70;626151175;12018;256;13080;13180;6.53;0.40;294.52;11.94;1062;71;4523.00;100
12019;70;626151190;12019;242;13080;13180;6.60;0.40;294.51;11.94;1061;71;4524.00;100
12023;70;626151206;12023;240;13083;13180;6.62;0.40;294.58;11.96;1060;71;4525.00;97
12025;70;626151224;12025;228;13086;13184;6.66;0.41;294.59;11.96;1061;71;4526.00;98
12027;70;626151240;12027;229;13088;13185;6.71;0.41;294.59;11.97;1061;71;4527.00;97
12031;70;626151257;12031;225;13088;13185;6.71;0.41;294.66;11.97;1057;71;4528.00;97
12035;70;626151273;12035;218;13089;13186;6.80;0.41;294.65;11.97;1054;71;4529.00;97
12039;70;626151291;12039;210;13091;13186;6.84;0.42;294.74;11.98;1052;71;4530.00;95
12043;70;626151306;12043;209;13092;13186;6.85;0.42;294.74;11.99;1049;71;4531.00;94
12045;70;626151322;12045;209;13092;13186;6.92;0.42;294.76;11.99;1047;71;4532.00;94
12047;70;626151342;12047;212;13092;13186;6.93;0.42;294.80;11.99;1045;71;4533.00;94
12052;70;626151357;12052;215;13093;13186;6.95;0.42;294.78;11.99;1041;71;4534.00;93
12055;70;626151372;12055;214;13093;13186;6.99;0.42;294.82;11.99;1038;71;4535.00;93
12059;70;626151387;12059;218;13128;13256;7.05;0.43;294.85;11.96;1069;71;4536.00;128
12061;70;626151411;12061;211;13132;13257;7.08;0.43;294.85;11.96;1071;71;4537.00;125
12064;70;626151426;12064;205;13137;13257;7.12;0.43;294.90;11.96;1073;71;4538.00;120
12064;70;626151442;12064;206;13140;13257;7.21;0.44;294.90;11.96;1076;71;4539.00;117
12068;70;626151458;12068;210;13147;13257;7.24;0.44;294.92;11.96;1079;71;4540.00;110
12070;70;626151474;12070;216;13151;13257;7.29;0.44;295.00;12.00;1081;71;4541.00;106
12072;70;626151490;12072;210;13156;13257;7.33;0.44;295.03;12.00;1084;71;4542.00;101
12075;70;626151505;12075;209;13161;13257;7.38;0.45;295.05;12.00;1086;71;4543.00;96
12078;70;626151523;12078;198;13163;13258;7.40;0.45;295.05;12.00;1085;71;4544.00;95
12080;70;626151540;12080;192;13167;13260;7.46;0.45;295.05;12.00;1087;71;4545.00;93
12085;70;626151556;12085;198;13169;13260;7.48;0.45;295.18;12.01;1084;71;4546.00;91
12087;70;626151574;12087;194;13173;13264;7.48;0.45;295.16;12.01;1086;71;4547.00;91
12092;70;626151590;12092;191;13174;13264;7.46;0.45;295.21;12.01;1082;71;4548.00;90
12096;70;626151608;12096;202;13176;13264;7.44;0.45;295.26;12.01;1080;71;4549.00;88
12096;70;626151624;12096;206;13177;13264;7.43;0.45;295.26;12.01;1081;71;4550.00;87
12098;70;626151641;12098;207;13181;13270;7.45;0.45;295.32;12.02;1083;71;4551.00;89
12103;70;626151658;12103;217;13183;13270;7.40;0.45;295.41;12.03;1080;71;4552.00;87
12106;70;626151677;12106;220;13183;13270;7.37;0.45;295.49;12.03;1077;71;4553.00;87
12110;70;626151694;12110;223;13187;13273;7.37;0.45;295.50;12.05;1077;71;4554.00;86
12113;70;626151712;12113;222;13188;13273;7.37;0.45;295.50;12.05;1075;71;4555.00;85
12116;70;626151730;12116;227;13190;13273;7.35;0.45;295.55;12.06;1074;71;4556.00;83
12118;70;626151746;12118;226;13192;13274;7.35;0.45;295.59;12.07;1074;71;4557.00;82
12123;70;626151761;12123;236;13195;13275;7.40;0.45;295.59;12.08;1072;71;4558.00;80
12128;70;626151777;12128;245;13196;13275;7.41;0.45;295.68;12.08;1068;71;4559.00;79
12129;70;626151794;12129;253;13213;13301;7.38;0.45;295.71;12.08;1084;71;4560.00;88
12130;70;626151813;12130;252;13214;13301;7.46;0.45;295.72;12.08;1084;71;4561.00;87
12133;70;626151830;12133;260;13219;13301;7.49;0.46;295.73;12.10;1086;71;4562.00;82
12136;70;626151846;12136;265;13220;13302;7.52;0.46;295.83;12.10;1084;71;4563.00;82
12139;70;626151862;12139;263;13222;13302;7.47;0.45;295.87;12.11;1083;71;4564.00;80
12141;70;626151877;12141;270;13227;13306;7.40;0.45;295.90;12.12;1086;71;4565.00;79
12143;70;626151893;12143;276;13228;13306;7.26;0.44;295.92;12.12;1085;71;4566.00;78
12144;70;626151915;12144;281;13232;13310;7.10;0.43;295.91;12.13;1088;71;4567.00;78
12146;70;626151930;12146;286;13233;13310;6.97;0.42;295.93;12.14;1087;71;4568.00;77
12148;70;626151945;12148;290;13233;13310;6.88;0.42;295.93;12.14;1085;71;4569.00;77
12150;70;626151959;12150;293;13235;13310;6.82;0.42;295.92;12.16;1085;71;4570.00;75
12151;70;626151974;12151;296;13235;13310;6.76;0.41;295.97;12.16;1084;71;4571.00;75
12155;70;626151990;12155;299;13246;13322;6.74;0.41;295.99;12.17;1091;71;4572.00;76
12155;70;626152005;12155;309;13246;13322;6.70;0.41;295.99;12.17;1091;71;4573.00;76
12158;70;626152020;12158;310;13248;13322;6.67;0.41;296.16;12.17;1090;71;4574.00;74
12158;70;626152036;12158;301;13251;13322;6.69;0.41;296.16;12.20;1093;71;4575.00;71
12163;70;626152051;12163;307;13252;13322;6.62;0.40;296.21;12.20;1089;71;4576.00;70
12167;70;626152066;12167;315;13255;13322;6.53;0.40;296.20;12.23;1088;71;4577.00;67
12168;70;626152082;12168;320;13255;13323;6.48;0.39;296.23;12.23;1087;71;4578.00;68
12170;70;626152096;12170;326;13256;13323;6.46;0.39;296.28;12.24;1086;71;4579.00;67
12171;70;626152110;12171;335;13261;13329;6.45;0.39;296.30;12.24;1090;71;4580.00;68
12174;70;626152123;12174;345;13262;13330;6.34;0.39;296.30;12.24;1088;71;4581.00;68
12177;70;626152137;12177;345;13265;13330;6.29;0.38;296.34;12.25;1088;71;4582.00;65
12179;70;626152151;12179;351;13265;13330;6.17;0.38;296.36;12.25;1086;71;4583.00;65
12184;70;626152163;12184;351;13269;13334;6.12;0.37;296.41;12.26;1085;71;4584.00;65
12188;70;626152177;12188;364;13270;13334;6.03;0.37;296.42;12.27;1082;71;4585.00;64
12191;70;626152190;12191;369;13270;13334;5.92;0.36;296.41;12.27;1079;71;4586.00;64
12193;70;626152202;12193;369;13273;13335;5.78;0.35;296.39;12.28;1080;71;4587.00;62
12197;70;626152215;12197;375;13276;13339;5.62;0.34;296.46;12.27;1079;71;4588.00;63
12198;70;626152227;12198;380;13276;13339;5.47;0.34;296.46;12.27;1078;71;4589.00;63
12202;70;626152241;12202;374;13281;13345;5.35;0.33;296.51;12.28;1079;71;4590.00;64
12206;70;626152254;12206;371;13281;13345;5.28;0.32;296.61;12.28;1075;71;4591.00;64
12211;70;626152266;12211;366;13284;13345;5.21;0.32;296.63;12.29;1073;71;4592.00;61
12216;70;626152278;12216;359;13284;13345;5.19;0.32;296.63;12.29;1068;71;4593.00;61
12217;70;626152290;12217;362;13288;13349;5.26;0.32;296.65;12.30;1071;71;4594.00;61
12222;70;626152302;12222;379;13288;13349;5.25;0.32;296.66;12.30;1066;71;4595.00;61
12227;70;626152314;12227;376;13290;13349;5.28;0.32;296.60;12.30;1063;71;4596.00;59
12230;70;626152326;12230;369;13290;13349;5.35;0.33;296.65;12.30;1060;71;4597.00;59
12233;70;626152339;12233;374;13291;13350;5.40;0.33;296.63;12.30;1058;71;4598.00;59
12237;70;626152351;12237;375;13292;13351;5.41;0.33;296.60;12.30;1055;71;4599.00;59
12242;70;626152365;12242;375;13293;13351;5.44;0.33;296.55;12.30;1051;71;4600.00;58
12245;70;626152381;12245;372;13294;13352;5.51;0.34;296.55;12.30;1049;71;4601.00;58
12247;70;626152394;12247;373;13294;13352;5.57;0.34;296.55;12.30;1047;71;4602.00;58
12252;70;626152407;12252;378;13294;13352;5.52;0.34;296.53;12.30;1042;71;4603.00;58
12255;70;626152419;12255;378;13294;13352;5.46;0.34;296.54;12.30;1039;71;4604.00;58
12260;70;626152432;12260;376;13294;13352;5.41;0.33;296.50;12.30;1034;71;4605.00;58
12263;70;626152445;12263;377;13294;13352;5.34;0.33;296.47;12.30;1031;71;4606.00;58
12265;70;626152457;12265;377;13294;13352;5.33;0.33;296.47;12.30;1029;71;4607.00;58
12270;70;626152470;12270;385;13357;13479;5.71;0.36;296.45;12.24;1087;71;4608.00;122
12273;70;626152495;12273;396;13363;13480;5.73;0.36;296.44;12.23;1090;71;4609.00;117
12276;70;626152508;12276;396;13370;13480;5.75;0.36;296.43;12.23;1094;71;4610.00;110
12280;70;626152521;12280;400;13375;13480;5.76;0.36;296.38;12.23;1095;71;4611.00;105
12281;70;626152534;12281;402;13378;13480;5.77;0.36;296.38;12.22;1097;71;4612.00;102
12284;70;626152548;12284;408;13383;13480;5.75;0.36;296.36;12.22;1099;71;4613.00;97
12286;70;626152567;12286;413;13386;13480;5.72;0.36;296.33;12.22;1100;71;4614.00;94
12291;70;626152581;12291;411;13390;13480;5.72;0.36;296.28;12.22;1099;71;4615.00;90
12294;70;626152596;12294;423;13392;13481;5.70;0.35;296.27;12.22;1098;71;4616.00;89
12295;70;626152610;12295;425;13397;13482;5.77;0.36;296.28;12.22;1102;71;4617.00;85
12297;70;626152624;12297;433;13400;13482;5.78;0.36;296.31;12.22;1103;71;4618.00;82
12300;70;626152638;12300;434;13404;13483;5.76;0.36;296.30;12.22;1104;71;4619.00;79
12303;70;626152660;12303;447;13406;13483;5.74;0.36;296.30;12.21;1103;71;4620.00;77
12308;70;626152675;12308;455;13408;13483;5.70;0.35;296.35;12.21;1100;71;4621.00;75
12312;70;626152690;12312;466;13409;13483;5.67;0.35;296.33;12.21;1097;71;4622.00;74
12318;70;626152704;12318;473;13413;13487;5.63;0.35;296.35;12.21;1095;71;4623.00;74
12322;70;626152719;12322;473;13413;13487;5.56;0.34;296.32;12.21;1091;71;4624.00;74
12325;70;626152739;12325;471;13415;13487;5.55;0.34;296.29;12.21;1090;71;4625.00;72
12328;70;626152753;12328;476;13418;13490;5.55;0.34;296.29;12.26;1090;71;4626.00;72
12331;70;626152768;12331;462;13420;13490;5.53;0.34;296.29;12.26;1089;71;4627.00;70
12333;70;626152782;12333;443;13420;13490;5.54;0.34;296.29;12.26;1087;71;4628.00;70
12333;70;626152797;12333;437;13424;13494;5.59;0.34;296.29;12.26;1091;71;4629.00;70
12334;70;626152813;12334;436;13425;13495;5.64;0.35;296.27;12.26;1091;71;4630.00;70
12338;70;626152827;12338;429;13426;13495;5.68;0.35;296.30;12.26;1088;71;4631.00;69
12340;70;626152841;12340;437;13429;13499;5.77;0.35;296.27;12.25;1089;71;4632.00;70
12343;70;626152857;12343;426;13429;13499;5.79;0.36;296.27;12.25;1086;71;4633.00;70
12343;70;626152870;12343;424;13429;13499;5.89;0.36;296.27;12.25;1086;71;4634.00;70
12346;70;626152885;12346;429;13431;13501;5.99;0.37;296.26;12.25;1085;71;4635.00;70
12350;70;626152901;12350;430;13431;13501;6.05;0.37;296.22;12.25;1081;71;4636.00;70
12352;70;626152916;12352;407;13435;13507;6.12;0.38;296.22;12.25;1083;71;4637.00;72
12354;70;626152931;12354;398;13435;13507;6.13;0.38;296.19;12.25;1081;71;4638.00;72
12357;70;626152951;12357;387;13437;13508;6.18;0.38;296.24;12.30;1080;71;4639.00;71
12359;70;626152967;12359;382;13437;13508;6.24;0.38;296.23;12.30;1078;71;4640.00;71
12362;70;626152982;12362;373;13437;13508;6.31;0.38;296.18;12.30;1075;71;4641.00;71
12365;70;626152998;12365;376;13437;13508;6.36;0.39;296.17;12.30;1072;71;4642.00;71
12367;70;626153013;12367;379;13437;13508;6.44;0.39;296.18;12.30;1070;71;4643.00;71
12370;70;626153029;12370;384;13447;13520;6.55;0.40;296.14;12.29;1077;71;4644.00;73
12371;70;626153052;12371;389;13448;13520;6.64;0.40;296.16;12.29;1077;71;4645.00;72
12374;70;626153079;12374;373;13448;13520;6.71;0.41;296.14;12.29;1074;71;4646.00;72
12377;70;626153103;12377;365;13448;13520;6.74;0.41;296.11;12.29;1071;71;4647.00;72
12379;70;626153123;12379;353;13448;13520;6.79;0.41;296.10;12.29;1069;71;4648.00;72
12383;70;626153146;12383;347;13448;13520;6.84;0.41;296.15;12.29;1065;71;4649.00;72
12387;70;626153174;12387;346;13453;13526;6.86;0.41;296.18;12.28;1066;71;4650.00;73
12388;70;626153193;12388;349;13453;13526;6.92;0.42;296.23;12.28;1065;71;4651.00;73
12389;70;626153212;12389;346;13457;13530;6.96;0.42;296.22;12.28;1068;71;4652.00;73
12391;70;626153230;12391;343;13458;13531;6.93;0.42;296.24;12.28;1067;71;4653.00;73
12393;70;626153247;12393;343;13458;13531;6.91;0.42;296.21;12.28;1065;71;4654.00;73
12395;70;626153263;12395;339;13458;13531;6.86;0.42;296.24;12.28;1063;71;4655.00;73
12398;70;626153285;12398;347;13469;13544;6.90;0.42;296.25;12.27;1071;71;4656.00;75
12399;70;626153302;12399;347;13469;13544;6.88;0.42;296.25;12.27;1070;71;4657.00;75
12402;70;626153320;12402;343;13469;13544;6.86;0.42;296.30;12.27;1067;71;4658.00;75
12406;70;626153335;12406;345;13470;13545;6.82;0.41;296.35;12.27;1064;71;4659.00;75
12408;70;626153351;12408;336;13470;13546;6.83;0.41;296.36;12.27;1062;71;4660.00;76
12410;70;626153371;12410;340;13470;13546;6.80;0.41;296.42;12.27;1060;71;4661.00;76
12412;70;626153392;12412;336;13472;13549;6.82;0.41;296.40;12.27;1060;71;4662.00;77
12416;70;626153412;12416;328;13472;13549;6.79;0.41;296.51;12.27;1056;71;4663.00;77
12418;70;626153428;12418;338;13473;13549;6.76;0.41;296.57;12.27;1055;71;4664.00;76
12422;70;626153444;12422;341;13473;13549;6.71;0.41;296.65;12.27;1051;71;4665.00;76
12425;70;626153458;12425;341;13477;13555;6.67;0.40;296.64;12.26;1052;71;4666.00;78
12427;70;626153476;12427;343;13477;13555;6.66;0.40;296.69;12.26;1050;71;4667.00;78
12429;70;626153491;12429;349;13478;13555;6.68;0.41;296.72;12.26;1049;71;4668.00;77
12433;70;626153506;12433;356;13478;13555;6.65;0.40;296.75;12.26;1045;71;4669.00;77
12438;70;626153521;12438;359;13481;13559;6.60;0.40;296.83;12.26;1043;71;4670.00;78
12438;70;626153537;12438;365;13482;13560;6.65;0.40;296.83;12.26;1044;71;4671.00;78
12443;70;626153552;12443;369;13482;13560;6.62;0.40;296.82;12.26;1039;71;4672.00;78
12444;70;626153566;12444;373;13483;13561;6.62;0.40;296.85;12.26;1039;71;4673.00;78
12448;70;626153581;12448;377;13483;13561;6.53;0.40;296.91;12.26;1035;71;4674.00;78
12450;70;626153595;12450;382;13483;13561;6.45;0.39;296.94;12.26;1033;71;4675.00;78
12453;70;626153610;12453;377;13483;13561;6.36;0.39;296.95;12.26;1030;71;4676.00;78
12454;70;626153624;12454;376;13484;13561;6.36;0.39;296.98;12.31;1030;71;4677.00;77
12458;70;626153639;12458;375;13484;13561;6.33;0.39;296.96;12.31;1026;71;4678.00;77
12459;70;626153653;12459;370;13484;13561;6.38;0.39;297.04;12.31;1025;71;4679.00;77
12461;70;626153669;12461;384;13548;13686;6.46;0.40;297.08;12.25;1087;71;4680.00;138
12462;70;626153697;12462;365;13548;13687;6.48;0.40;297.15;12.25;1086;71;4681.00;139
12464;70;626153712;12464;348;13555;13687;6.56;0.40;297.19;12.25;1091;71;4682.00;132
12467;70;626153727;12467;337;13559;13687;6.69;0.41;297.16;12.24;1092;71;4683.00;128
12470;70;626153741;12470;326;13563;13687;6.80;0.42;297.19;12.24;1093;71;4684.00;124
12471;70;626153756;12471;325;13566;13687;6.82;0.42;297.19;12.24;1095;71;4685.00;121
12476;70;626153779;12476;315;13572;13687;6.85;0.42;297.26;12.24;1096;71;4686.00;115
12479;70;626153793;12479;315;13574;13687;6.91;0.42;297.28;12.24;1095;71;4687.00;113
12484;70;626153808;12484;312;13579;13688;6.91;0.42;297.30;12.23;1095;71;4688.00;109
12487;70;626153825;12487;306;13580;13689;6.92;0.42;297.31;12.23;1093;71;4689.00;109
12491;70;626153842;12491;309;13581;13689;6.87;0.42;297.34;12.23;1090;71;4690.00;108
12496;70;626153858;12496;308;13585;13693;6.80;0.42;297.46;12.23;1089;71;4691.00;108
12499;70;626153874;12499;305;13587;13693;6.69;0.41;297.49;12.28;1088;71;4692.00;106
12504;70;626153891;12504;297;13588;13693;6.56;0.40;297.58;12.28;1084;71;4693.00;105
12509;70;626153906;12509;298;13589;13693;6.51;0.40;297.63;12.28;1080;71;4694.00;104
12512;70;626153927;12512;296;13595;13699;6.45;0.39;297.71;12.36;1083;71;4695.00;104
12515;70;626153945;12515;290;13595;13699;6.37;0.39;297.72;12.36;1080;71;4696.00;104
12519;70;626153960;12519;288;13597;13699;6.37;0.39;297.75;12.36;1078;71;4697.00;102
12523;70;626153977;12523;289;13600;13702;6.45;0.39;297.82;12.40;1077;71;4698.00;102
12527;70;626153992;12527;288;13601;13702;6.46;0.39;297.78;12.40;1074;71;4699.00;101
12531;70;626154009;12531;281;13601;13702;6.49;0.39;297.85;12.40;1070;71;4700.00;101
12533;70;626154029;12533;278;13601;13703;6.53;0.40;297.87;12.40;1068;71;4701.00;102
12536;70;626154047;12536;270;13603;13704;6.58;0.40;297.84;12.45;1067;71;4702.00;101
12537;70;626154063;12537;265;13603;13704;6.60;0.40;297.82;12.45;1066;71;4703.00;101
12539;70;626154078;12539;264;13612;13717;6.66;0.41;297.86;12.44;1073;71;4704.00;105
12544;70;626154096;12544;262;13612;13717;6.68;0.41;297.86;12.44;1068;71;4705.00;105
12546;70;626154112;12546;263;13612;13717;6.72;0.41;297.93;12.44;1066;71;4706.00;105
12549;70;626154127;12549;258;13614;13718;6.72;0.41;297.90;12.44;1065;71;4707.00;104
12552;70;626154142;12552;260;13615;13718;6.76;0.41;297.90;12.49;1063;71;4708.00;103
12553;70;626154157;12553;264;13620;13722;6.83;0.41;297.92;12.48;1067;71;4709.00;102
12556;70;626154174;12556;264;13620;13722;6.81;0.41;297.97;12.48;1064;71;4710.00;102
12560;70;626154196;12560;261;13624;13726;6.81;0.41;298.09;12.48;1064;71;4711.00;102
12562;70;626154211;12562;268;13625;13726;6.88;0.42;298.08;12.48;1063;71;4712.00;101
12564;70;626154226;12564;257;13625;13726;6.95;0.42;298.12;12.48;1061;71;4713.00;101
12567;70;626154241;12567;254;13626;13726;7.00;0.42;298.17;12.48;1059;71;4714.00;100
12567;70;626154256;12567;253;13626;13726;7.07;0.43;298.17;12.48;1059;71;4715.00;100
12570;70;626154271;12570;250;13636;13738;7.17;0.43;298.23;12.48;1066;71;4716.00;102
12572;70;626154288;12572;258;13637;13738;7.20;0.44;298.36;12.48;1065;71;4717.00;101
12573;70;626154303;12573;255;13639;13738;7.27;0.44;298.39;12.48;1066;71;4718.00;99
12575;70;626154318;12575;252;13640;13738;7.26;0.44;298.45;12.48;1065;71;4719.00;98
12577;70;626154334;12577;259;13640;13738;7.24;0.44;298.53;12.48;1063;71;4720.00;98
12580;70;626154349;12580;259;13640;13738;7.21;0.44;298.57;12.48;1060;71;4721.00;98
12584;70;626154364;12584;260;13640;13739;7.20;0.44;298.63;12.48;1056;71;4722.00;99
12586;70;626154379;12586;263;13642;13739;7.18;0.44;298.68;12.50;1056;71;4723.00;97
12588;70;626154395;12588;266;13647;13745;7.20;0.44;298.69;12.51;1059;71;4724.00;98
12590;70;626154410;12590;262;13651;13747;7.20;0.44;298.73;12.54;1061;71;4725.00;96
12593;70;626154425;12593;267;13653;13747;7.22;0.44;298.70;12.55;1060;71;4726.00;94
12596;70;626154440;12596;269;13653;13747;7.21;0.44;298.71;12.55;1057;71;4727.00;94
12600;70;626154455;12600;271;13659;13751;7.22;0.44;298.74;12.58;1059;71;4728.00;92
12602;70;626154471;12602;277;13660;13751;7.18;0.44;298.77;12.59;1058;71;4729.00;91
12605;70;626154486;12605;277;13660;13751;7.15;0.43;298.87;12.59;1055;71;4730.00;91
12607;70;626154501;12607;285;13663;13752;7.14;0.43;298.91;12.61;1056;71;4731.00;89
12608;70;626154516;12608;289;13667;13756;7.12;0.43;298.91;12.61;1059;71;4732.00;89
12611;70;626154530;12611;293;13667;13756;7.08;0.43;298.94;12.61;1056;71;4733.00;89
12613;70;626154544;12613;296;13670;13759;7.07;0.43;298.97;12.62;1057;71;4734.00;89
12615;70;626154559;12615;299;13672;13759;7.01;0.43;298.97;12.63;1057;71;4735.00;87
12616;70;626154573;12616;305;13673;13759;6.96;0.43;299.01;12.64;1057;71;4736.00;86
12617;70;626154587;12617;311;13673;13759;6.93;0.42;299.00;12.64;1056;71;4737.00;86
12621;70;626154601;12621;315;13677;13763;6.91;0.42;299.02;12.65;1056;71;4738.00;86
12623;70;626154614;12623;315;13680;13763;6.89;0.42;299.01;12.66;1057;71;4739.00;83
12623;70;626154630;12623;312;13681;13763;6.84;0.42;299.01;12.67;1058;71;4740.00;82
12627;70;626154645;12627;308;13682;13763;6.78;0.41;299.08;12.68;1055;71;4741.00;81
12629;70;626154659;12629;306;13683;13764;6.72;0.41;299.05;12.69;1054;71;4742.00;81
12632;70;626154673;12632;305;13685;13765;6.70;0.41;299.08;12.69;1053;71;4743.00;80
12634;70;626154687;12634;304;13687;13765;6.63;0.40;299.07;12.70;1053;71;4744.00;78
12637;70;626154700;12637;304;13688;13766;6.58;0.40;299.03;12.70;1051;71;4745.00;78
12638;70;626154714;12638;304;13689;13766;6.54;0.40;299.05;12.70;1051;71;4746.00;77
12639;70;626154727;12639;306;13690;13766;6.55;0.40;299.06;12.71;1051;71;4747.00;76
12641;70;626154740;12641;311;13690;13766;6.56;0.40;299.15;12.71;1049;71;4748.00;76
12642;70;626154753;12642;309;13691;13766;6.57;0.40;299.16;12.72;1049;71;4749.00;75
12646;70;626154767;12646;311;13692;13766;6.54;0.40;299.10;12.73;1046;71;4750.00;74
12647;70;626154780;12647;323;13693;13766;6.49;0.40;299.08;12.73;1046;71;4751.00;73
12650;70;626154793;12650;339;13755;13893;6.68;0.41;299.05;12.68;1105;71;4752.00;138
12652;70;626154819;12652;348;13758;13894;6.58;0.41;299.03;12.69;1106;71;4753.00;136
12655;70;626154833;12655;344;13767;13894;6.62;0.41;299.02;12.68;1112;71;4754.00;127
12658;70;626154846;12658;345;13774;13894;6.60;0.41;299.01;12.68;1116;71;4755.00;120
12660;70;626154859;12660;353;13782;13894;6.55;0.40;299.01;12.68;1122;71;4756.00;112
12663;70;626154873;12663;353;13787;13894;6.46;0.40;298.99;12.69;1124;71;4757.00;107
12666;70;626154886;12666;360;13793;13894;6.39;0.39;298.96;12.69;1127;71;4758.00;101
12669;71;626154899;12669;368;13797;13894;6.25;0.39;298.93;12.70;1128;72;4759.00;97
12674;71;626154923;12674;362;13801;13895;6.13;0.38;298.85;12.69;1127;72;4760.00;94
12676;71;626154937;12676;367;13805;13896;6.05;0.37;298.83;12.69;1129;72;4761.00;91
12680;71;626154950;12680;379;13809;13896;5.96;0.37;298.81;12.70;1129;72;4762.00;87
12683;71;626154964;12683;385;13814;13897;5.93;0.37;298.89;12.71;1131;72;4763.00;83
12687;71;626154978;12687;387;13817;13897;5.86;0.36;298.90;12.72;1130;72;4764.00;80
12689;71;626154992;12689;404;13818;13897;5.83;0.36;298.93;12.72;1129;72;4765.00;79
12693;71;626155006;12693;415;13822;13897;5.81;0.36;298.87;12.72;1129;72;4766.00;75
12698;71;626155020;12698;411;13824;13901;5.79;0.36;298.87;12.72;1126;72;4767.00;77
12701;71;626155035;12701;416;13826;13901;5.75;0.35;298.88;12.72;1125;72;4768.00;75
12702;71;626155058;12702;423;13827;13901;5.72;0.35;298.87;12.72;1125;72;4769.00;74
12706;71;626155081;12706;426;13831;13907;5.66;0.35;298.86;12.72;1125;72;4770.00;76
12708;71;626155104;12708;432;13832;13907;5.59;0.34;298.88;12.72;1124;72;4771.00;75
12711;71;626155126;12711;434;13833;13907;5.52;0.34;298.87;12.72;1122;72;4772.00;74
12714;71;626155146;12714;448;13835;13911;5.46;0.34;298.87;12.72;1121;72;4773.00;76
12717;71;626155166;12717;457;13838;13912;5.44;0.33;298.83;12.72;1121;72;4774.00;74
12721;71;626155182;12721;464;13838;13912;5.39;0.33;298.83;12.72;1117;72;4775.00;74
12724;71;626155197;12724;474;13842;13916;5.38;0.33;298.85;12.71;1118;72;4776.00;74
12726;71;626155212;12726;480;13842;13916;5.33;0.33;298.84;12.71;1116;72;4777.00;74
12730;71;626155232;12730;482;13843;13916;5.26;0.32;298.80;12.71;1113;72;4778.00;73
12732;71;626155247;12732;470;13844;13917;5.23;0.32;298.82;12.71;1112;72;4779.00;73
12738;71;626155263;12738;465;13844;13917;5.22;0.32;298.79;12.71;1106;72;4780.00;73
12740;71;626155277;12740;458;13848;13923;5.25;0.32;298.74;12.71;1108;72;4781.00;75
12744;71;626155292;12744;448;13848;13923;5.25;0.32;298.72;12.71;1104;72;4782.00;75
12746;71;626155307;12746;450;13849;13924;5.34;0.33;298.70;12.71;1103;72;4783.00;75
12748;71;626155322;12748;444;13849;13924;5.40;0.33;298.68;12.71;1101;72;4784.00;75
12750;71;626155338;12750;447;13849;13924;5.44;0.33;298.67;12.71;1099;72;4785.00;75
12752;71;626155354;12752;449;13849;13924;5.49;0.34;298.71;12.71;1097;72;4786.00;75
12753;71;626155369;12753;443;13849;13924;5.59;0.34;298.72;12.71;1096;72;4787.00;75
12756;71;626155384;12756;436;13859;13936;5.71;0.35;298.72;12.70;1103;72;4788.00;77
12764;71;626155408;12764;441;13859;13936;5.73;0.35;298.71;12.70;1095;72;4789.00;77
12767;71;626155423;12767;435;13860;13936;5.80;0.35;298.71;12.70;1093;72;4790.00;76
12771;71;626155438;12771;438;13860;13936;5.82;0.36;298.76;12.70;1089;72;4791.00;76
12774;71;626155454;12774;433;13860;13936;5.86;0.36;298.76;12.70;1086;72;4792.00;76
12775;71;626155470;12775;433;13860;13936;5.91;0.36;298.75;12.70;1085;72;4793.00;76
12778;71;626155485;12778;432;13864;13940;5.96;0.36;298.75;12.74;1086;72;4794.00;76
12780;71;626155502;12780;437;13864;13940;5.97;0.37;298.77;12.74;1084;72;4795.00;76
12782;71;626155517;12782;445;13867;13944;5.99;0.37;298.76;12.74;1085;72;4796.00;77
12784;71;626155534;12784;453;13868;13945;5.99;0.37;298.73;12.74;1084;72;4797.00;77
12789;71;626155559;12789;461;13869;13945;5.94;0.36;298.68;12.74;1080;72;4798.00;76
12793;71;626155574;12793;463;13869;13945;5.86;0.36;298.70;12.74;1076;72;4799.00;76
12796;71;626155593;12796;471;13890;13986;5.90;0.36;298.75;12.72;1094;72;4800.00;96
12798;71;626155617;12798;466;13891;13986;5.89;0.36;298.78;12.72;1093;72;4801.00;95
12799;71;626155632;12799;469;13893;13986;5.89;0.36;298.77;12.72;1094;72;4802.00;93
12804;71;626155647;12804;474;13895;13987;5.84;0.36;298.82;12.72;1091;72;4803.00;92
12808;71;626155662;12808;477;13896;13988;5.82;0.36;298.89;12.72;1088;72;4804.00;92
12811;71;626155678;12811;478;13896;13988;5.77;0.35;298.89;12.72;1085;72;4805.00;92
12813;71;626155693;12813;476;13900;13991;5.73;0.35;298.92;12.71;1087;72;4806.00;91
12815;71;626155708;12815;468;13901;13991;5.71;0.35;298.95;12.71;1086;72;4807.00;90
12817;71;626155726;12817;467;13902;13991;5.63;0.34;298.98;12.71;1085;72;4808.00;89
12821;71;626155741;12821;461;13903;13991;5.56;0.34;299.04;12.71;1082;72;4809.00;88
12825;71;626155757;12825;466;13909;13997;5.52;0.34;299.11;12.76;1084;72;4810.00;88
12826;71;626155776;12826;470;13909;13997;5.54;0.34;299.14;12.76;1083;72;4811.00;88
12829;71;626155793;12829;467;13911;13997;5.55;0.34;299.14;12.76;1082;72;4812.00;86
12832;71;626155817;12832;478;13911;13997;5.58;0.34;299.17;12.76;1079;72;4813.00;86
12835;71;626155836;12835;470;13915;14001;5.63;0.34;299.14;12.80;1080;72;4814.00;86
12841;71;626155851;12841;476;13917;14003;5.65;0.34;299.24;12.80;1076;72;4815.00;86
12848;71;626155867;12848;462;13917;14003;5.64;0.34;299.35;12.80;1069;72;4816.00;86
12848;71;626155883;12848;448;13920;14004;5.71;0.35;299.35;12.85;1072;72;4817.00;84
12853;71;626155898;12853;435;13920;14004;5.72;0.35;299.40;12.85;1067;72;4818.00;84
12855;71;626155913;12855;429;13920;14004;5.76;0.35;299.46;12.85;1065;72;4819.00;84
12857;71;626155929;12857;419;13920;14004;5.79;0.35;299.46;12.85;1063;72;4820.00;84
12859;71;626155945;12859;410;13920;14004;5.79;0.35;299.52;12.85;1061;72;4821.00;84
12860;71;626155960;12860;400;13920;14004;5.85;0.35;299.54;12.85;1060;72;4822.00;84
12862;71;626155977;12862;397;13921;14004;5.84;0.35;299.54;12.85;1059;72;4823.00;83
12865;71;626155992;12865;407;13964;14074;5.88;0.36;299.60;12.81;1099;72;4824.00;110
12866;71;626156015;12866;394;13964;14075;5.92;0.36;299.59;12.81;1098;72;4825.00;111
12868;71;626156031;12868;385;13969;14075;6.05;0.37;299.62;12.81;1101;72;4826.00;106
12870;71;626156054;12870;376;13969;14075;6.12;0.37;299.69;12.81;1099;72;4827.00;106
12873;71;626156069;12873;378;13975;14077;6.20;0.38;299.75;12.85;1102;72;4828.00;102
12876;71;626156087;12876;365;13976;14077;6.24;0.38;299.76;12.85;1100;72;4829.00;101
12878;72;626156104;12878;366;13980;14077;6.37;0.39;299.75;12.85;1102;73;4830.00;97
12880;72;626156130;12880;368;13982;14077;6.40;0.39;299.78;12.85;1102;73;4831.00;95
12885;72;626156145;12885;362;13985;14078;6.39;0.39;299.81;12.85;1100;73;4832.00;93
12886;72;626156162;12886;359;13988;14079;6.45;0.39;299.82;12.84;1102;73;4833.00;91
12889;72;626156177;12889;358;13989;14079;6.49;0.40;299.84;12.84;1100;73;4834.00;90
12892;72;626156193;12892;366;13996;14083;6.48;0.40;299.90;12.84;1104;73;4835.00;87
12895;72;626156208;12895;357;13996;14083;6.49;0.40;299.91;12.84;1101;73;4836.00;87
12897;72;626156223;12897;353;13996;14083;6.46;0.40;299.94;12.84;1099;73;4837.00;87
12902;72;626156237;12902;351;13996;14083;6.48;0.40;300.03;12.84;1094;73;4838.00;87
12903;72;626156252;12903;350;14001;14089;6.51;0.40;300.06;12.84;1098;73;4839.00;88
12905;72;626156267;12905;350;14002;14089;6.56;0.40;300.07;12.84;1097;73;4840.00;87
12908;72;626156282;12908;352;14003;14089;6.58;0.40;300.04;12.88;1095;73;4841.00;86
12912;72;626156297;12912;350;14006;14092;6.61;0.41;300.05;12.88;1094;73;4842.00;86
12913;72;626156322;12913;347;14006;14092;6.62;0.41;300.06;12.88;1093;73;4843.00;86
12914;72;626156337;12914;345;14006;14092;6.63;0.41;300.15;12.88;1092;73;4844.00;86
12917;72;626156357;12917;352;14006;14093;6.60;0.40;300.18;12.88;1089;73;4845.00;87
12920;72;626156372;12920;345;14007;14094;6.59;0.40;300.17;12.88;1087;73;4846.00;87
12923;72;626156387;12923;351;14007;14094;6.55;0.40;300.27;12.88;1084;73;4847.00;87
12927;72;626156401;12927;358;14017;14107;6.55;0.40;300.26;12.87;1090;73;4848.00;90
12932;72;626156416;12932;359;14018;14107;6.54;0.40;300.35;12.87;1086;73;4849.00;89
12935;72;626156431;12935;349;14018;14107;6.52;0.40;300.34;12.87;1083;73;4850.00;89
12937;72;626156446;12937;348;14019;14108;6.53;0.40;300.34;12.87;1082;73;4851.00;89
12941;72;626156461;12941;340;14019;14108;6.51;0.39;300.38;12.87;1078;73;4852.00;89
12943;72;626156475;12943;328;14022;14112;6.52;0.40;300.38;12.87;1079;73;4853.00;90
12944;72;626156491;12944;324;14022;14112;6.52;0.40;300.37;12.87;1078;73;4854.00;90
12945;72;626156505;12945;325;14026;14116;6.51;0.39;300.37;12.86;1081;73;4855.00;90
12948;72;626156520;12948;322;14027;14116;6.52;0.39;300.33;12.91;1079;73;4856.00;89
12949;72;626156534;12949;317;14027;14116;6.57;0.40;300.37;12.91;1078;73;4857.00;89
12952;72;626156548;12952;314;14028;14116;6.60;0.40;300.41;12.95;1076;73;4858.00;88
12953;72;626156562;12953;309;14028;14116;6.64;0.40;300.45;12.95;1075;73;4859.00;88
12958;72;626156578;12958;308;14048;14150;6.65;0.41;300.55;12.93;1090;73;4860.00;102
12962;72;626156597;12962;296;14049;14150;6.63;0.40;300.61;12.93;1087;73;4861.00;101
12964;72;626156611;12964;285;14049;14150;6.62;0.40;300.64;12.93;1085;73;4862.00;101
12968;72;626156626;12968;278;14050;14150;6.58;0.40;300.67;12.93;1082;73;4863.00;100
12973;72;626156640;12973;272;14051;14150;6.61;0.40;300.75;12.93;1078;73;4864.00;99
12977;72;626156655;12977;270;14052;14150;6.63;0.40;300.78;12.95;1075;73;4865.00;98
12982;72;626156671;12982;259;14053;14151;6.62;0.40;300.82;12.95;1071;73;4866.00;98
12985;72;626156685;12985;264;14053;14151;6.63;0.40;300.81;12.95;1068;73;4867.00;98
12989;72;626156699;12989;262;14058;14157;6.59;0.40;300.86;12.98;1069;73;4868.00;99
12992;72;626156715;12992;264;14059;14158;6.54;0.40;300.89;12.98;1067;73;4869.00;99
12992;72;626156730;12992;262;14060;14158;6.57;0.40;300.89;12.98;1068;73;4870.00;98
12995;72;626156744;12995;254;14061;14158;6.51;0.40;300.93;13.02;1066;73;4871.00;97
12996;72;626156758;12996;257;14064;14162;6.51;0.40;300.91;13.01;1068;73;4872.00;98
12999;72;626156773;12999;259;14065;14162;6.50;0.40;300.89;13.01;1066;73;4873.00;97
13000;72;626156787;13000;261;14066;14162;6.48;0.40;300.88;13.05;1066;73;4874.00;96
13004;72;626156800;13004;260;14067;14163;6.49;0.40;300.92;13.05;1063;73;4875.00;96
13006;72;626156814;13006;259;14071;14167;6.50;0.40;300.92;13.05;1065;73;4876.00;96
13011;72;626156829;13011;258;14071;14167;6.45;0.39;300.90;13.05;1060;73;4877.00;96
13014;72;626156844;13014;260;14073;14170;6.44;0.39;300.93;13.05;1059;73;4878.00;97
13020;72;626156859;13020;272;14075;14170;6.41;0.39;300.98;13.05;1055;73;4879.00;95
13022;72;626156873;13022;277;14075;14170;6.40;0.39;300.98;13.05;1053;73;4880.00;95
13025;72;626156887;13025;280;14075;14170;6.37;0.39;301.02;13.05;1050;73;4881.00;95
13030;72;626156907;13030;280;14079;14174;6.34;0.38;300.98;13.05;1049;73;4882.00;95
13034;72;626156922;13034;284;14079;14174;6.36;0.39;301.17;13.05;1045;73;4883.00;95
13036;72;626156937;13036;283;14080;14174;6.37;0.39;301.24;13.04;1044;73;4884.00;94
13039;72;626156951;13039;283;14081;14174;6.41;0.39;301.31;13.04;1042;73;4885.00;93
13041;72;626156966;13041;287;14082;14175;6.40;0.39;301.36;13.05;1041;73;4886.00;93
13043;72;626156984;13043;291;14083;14176;6.42;0.39;301.39;13.05;1040;73;4887.00;93
13044;72;626157005;13044;295;14083;14176;6.43;0.39;301.42;13.05;1039;73;4888.00;93
13048;72;626157019;13048;300;14084;14177;6.42;0.39;301.45;13.05;1036;73;4889.00;93
13050;72;626157035;13050;303;14086;14177;6.39;0.39;301.42;13.07;1036;73;4890.00;91
13051;72;626157056;13051;300;14086;14177;6.39;0.39;301.41;13.07;1035;73;4891.00;91
13052;72;626157086;13052;301;14087;14177;6.38;0.39;301.40;13.08;1035;73;4892.00;90
13053;72;626157105;13053;310;14088;14177;6.37;0.39;301.40;13.09;1035;73;4893.00;89
13054;72;626157123;13054;311;14088;14177;6.33;0.38;301.40;13.09;1034;73;4894.00;89
13055;72;626157145;13055;312;14089;14177;6.30;0.38;301.39;13.11;1034;73;4895.00;88
13059;72;626157160;13059;327;14152;14304;6.50;0.40;301.36;13.05;1093;73;4896.00;152
13060;72;626157189;13060;327;14158;14305;6.47;0.40;301.35;13.08;1098;73;4897.00;147
13064;72;626157204;13064;328;14167;14305;6.49;0.40;301.31;13.08;1103;73;4898.00;138
13064;72;626157220;13064;330;14171;14305;6.46;0.40;301.31;13.09;1107;73;4899.00;134
13066;72;626157235;13066;325;14179;14305;6.52;0.40;301.29;13.10;1113;73;4900.00;126
13066;72;626157255;13066;332;14184;14305;6.54;0.40;301.29;13.11;1118;73;4901.00;121
13067;73;626157268;13067;334;14191;14305;6.55;0.40;301.28;13.12;1124;74;4902.00;114
13068;73;626157302;13068;333;14194;14305;6.51;0.40;301.27;13.13;1126;74;4903.00;111
13069;73;626157316;13069;343;14201;14306;6.51;0.40;301.25;13.15;1132;74;4904.00;105
13071;73;626157329;13071;345;14206;14308;6.46;0.40;301.22;13.15;1135;74;4905.00;102
13075;73;626157342;13075;351;14210;14308;6.41;0.39;301.14;13.16;1135;74;4906.00;98
13077;73;626157356;13077;358;14215;14309;6.30;0.39;301.12;13.16;1138;74;4907.00;94
13080;73;626157370;13080;366;14217;14309;6.12;0.38;301.08;13.18;1137;74;4908.00;92
13080;73;626157383;13080;371;14218;14309;6.00;0.37;301.08;13.18;1138;74;4909.00;91
13081;73;626157398;13081;377;14222;14309;5.90;0.36;301.07;13.19;1141;74;4910.00;87
13082;73;626157413;13082;377;14225;14313;5.82;0.36;301.08;13.19;1143;74;4911.00;88
13083;73;626157427;13083;378;14228;14313;5.74;0.35;301.07;13.20;1145;74;4912.00;85
13086;73;626157441;13086;393;14229;14313;5.63;0.35;301.04;13.20;1143;74;4913.00;84
13086;73;626157455;13086;398;14233;14316;5.64;0.35;301.04;13.20;1147;74;4914.00;83
13089;73;626157470;13089;402;14235;14316;5.56;0.34;301.01;13.21;1146;74;4915.00;81
13090;73;626157484;13090;408;14237;14316;5.55;0.34;300.99;13.21;1147;74;4916.00;79
13091;73;626157498;13091;412;14241;14320;5.52;0.34;301.00;13.22;1150;74;4917.00;79
13092;73;626157512;13092;419;14243;14321;5.48;0.34;300.99;13.22;1151;74;4918.00;78
13094;73;626157526;13094;421;14246;14321;5.43;0.33;300.95;13.23;1152;74;4919.00;75
13094;73;626157541;13094;429;14250;14326;5.42;0.33;300.95;13.23;1156;74;4920.00;76
13094;73;626157555;13094;435;14251;14326;5.34;0.33;300.95;13.23;1157;74;4921.00;75
13097;73;626157567;13097;438;14252;14326;5.23;0.32;300.94;13.24;1155;74;4922.00;74
13099;73;626157581;13099;443;14253;14327;5.16;0.32;300.97;13.24;1154;74;4923.00;74
13102;73;626157595;13102;441;14254;14327;5.05;0.31;300.95;13.25;1152;74;4924.00;73
13105;73;626157609;13105;442;14259;14333;5.01;0.31;301.03;13.24;1154;74;4925.00;74
13109;73;626157623;13109;451;14259;14333;4.89;0.30;301.04;13.24;1150;74;4926.00;74
13110;73;626157636;13110;455;14261;14334;4.76;0.29;301.02;13.25;1151;74;4927.00;73
13113;73;626157648;13113;457;14262;14334;4.62;0.29;301.00;13.26;1149;74;4928.00;72
13118;73;626157661;13118;469;14262;14334;4.48;0.28;301.00;13.26;1144;74;4929.00;72
13119;73;626157672;13119;457;14263;14334;4.40;0.27;301.00;13.27;1144;74;4930.00;71
13121;73;626157684;13121;440;14264;14334;4.36;0.27;301.02;13.28;1143;74;4931.00;70
13124;73;626157698;13124;429;14273;14346;4.44;0.27;301.00;13.27;1149;74;4932.00;73
13127;73;626157711;13127;428;14274;14346;4.47;0.28;300.98;13.28;1147;74;4933.00;72
13128;73;626157725;13128;426;14276;14346;4.54;0.28;300.99;13.28;1148;74;4934.00;70
13131;73;626157737;13131;427;14276;14346;4.60;0.28;300.96;13.28;1145;74;4935.00;70
13133;73;626157751;13133;428;14276;14346;4.67;0.29;300.98;13.28;1143;74;4936.00;70
13136;73;626157765;13136;421;14276;14346;4.74;0.29;300.95;13.28;1140;74;4937.00;70
13137;73;626157778;13137;419;14279;14350;4.85;0.30;300.95;13.28;1142;74;4938.00;71
13139;74;626157792;13139;411;14279;14350;4.96;0.30;300.96;13.28;1140;75;4939.00;71
13143;74;626157818;13143;415;14282;14354;5.07;0.31;300.91;13.27;1139;75;4940.00;72
13144;75;626157833;13144;410;14283;14355;5.18;0.32;300.90;13.27;1139;76;4941.00;72
13149;75;626157860;13149;408;14284;14355;5.20;0.32;300.86;13.27;1135;76;4942.00;71
13150;75;626157874;13150;401;14284;14355;5.26;0.32;300.85;13.27;1134;76;4943.00;71
13154;75;626157888;13154;406;14295;14368;5.35;0.33;300.84;13.26;1141;76;4944.00;73
13157;75;626157905;13157;403;14295;14368;5.40;0.33;300.85;13.26;1138;76;4945.00;73
13160;75;626157920;13160;397;14295;14368;5.50;0.33;300.83;13.26;1135;76;4946.00;73
13161;75;626157936;13161;397;14296;14369;5.62;0.34;300.84;13.26;1135;76;4947.00;73
13163;76;626157950;13163;393;14296;14370;5.70;0.35;300.83;13.26;1133;77;4948.00;74
13166;76;626157984;13166;395;14296;14370;5.81;0.35;300.88;13.26;1130;77;4949.00;74
13169;77;626158000;13169;389;14300;14379;5.91;0.36;300.94;13.26;1131;78;4950.00;79
13172;77;626158030;13172;393;14300;14379;5.99;0.36;300.92;13.26;1128;78;4951.00;79
13177;77;626158053;13177;395;14302;14379;6.07;0.37;300.93;13.26;1125;78;4952.00;77
13181;77;626158075;13181;391;14303;14379;6.12;0.37;300.92;13.26;1122;78;4953.00;76
13186;77;626158097;13186;386;14306;14385;6.18;0.38;300.87;13.25;1120;78;4954.00;79
13193;77;626158117;13193;382;14307;14385;6.20;0.38;300.87;13.25;1114;78;4955.00;78
13195;77;626158131;13195;380;14308;14385;6.24;0.38;300.86;13.25;1113;78;4956.00;77
13198;77;626158146;13198;383;14309;14385;6.26;0.38;300.91;13.25;1111;78;4957.00;76
13203;77;626158162;13203;381;14312;14389;6.31;0.38;301.02;13.25;1109;78;4958.00;77
13206;77;626158177;13206;383;14314;14390;6.32;0.38;301.04;13.25;1108;78;4959.00;76
13209;77;626158193;13209;388;14315;14390;6.34;0.38;301.03;13.29;1106;78;4960.00;75
13213;77;626158208;13213;381;14316;14391;6.32;0.38;301.04;13.29;1103;78;4961.00;75
13215;77;626158223;13215;388;14316;14391;6.34;0.38;301.06;13.29;1101;78;4962.00;75
13217;77;626158237;13217;390;14316;14391;6.34;0.38;301.10;13.29;1099;78;4963.00;75
13221;77;626158252;13221;392;14316;14391;6.36;0.38;301.06;13.29;1095;78;4964.00;75
13225;77;626158268;13225;401;14316;14391;6.33;0.38;301.08;13.29;1091;78;4965.00;75
13227;77;626158283;13227;408;14316;14391;6.34;0.38;301.06;13.29;1089;78;4966.00;75
13231;77;626158298;13231;403;14316;14391;6.35;0.38;301.11;13.29;1085;78;4967.00;75
13236;77;626158313;13236;422;14357;14461;6.41;0.39;301.13;13.25;1121;78;4968.00;104
13237;77;626158336;13237;413;14358;14462;6.45;0.39;301.13;13.25;1121;78;4969.00;104
13241;77;626158352;13241;413;14365;14462;6.52;0.40;301.19;13.25;1124;78;4970.00;97
13244;77;626158367;13244;418;14366;14462;6.57;0.40;301.17;13.25;1122;78;4971.00;96
13247;77;626158382;13247;414;14370;14462;6.60;0.40;301.19;13.24;1123;78;4972.00;92
13249;77;626158398;13249;417;14372;14462;6.58;0.40;301.18;13.24;1123;78;4973.00;90
13252;77;626158414;13252;417;14375;14462;6.59;0.40;301.21;13.24;1123;78;4974.00;87
13257;77;626158435;13257;424;14377;14462;6.53;0.40;301.30;13.24;1120;78;4975.00;85
13260;77;626158451;13260;426;14380;14463;6.48;0.40;301.33;13.24;1120;78;4976.00;83
13264;77;626158467;13264;413;14382;14464;6.42;0.39;301.37;13.24;1118;78;4977.00;82
13269;77;626158483;13269;414;14384;14464;6.37;0.39;301.44;13.24;1115;78;4978.00;80
13274;77;626158499;13274;411;14387;14468;6.29;0.38;301.45;13.23;1113;78;4979.00;81
13277;77;626158518;13277;412;14387;14468;6.28;0.38;301.49;13.23;1110;78;4980.00;81
13279;77;626158534;13279;415;14387;14468;6.25;0.38;301.48;13.23;1108;78;4981.00;81
13281;77;626158555;13281;418;14387;14468;6.25;0.38;301.54;13.23;1106;78;4982.00;81
13284;77;626158570;13284;424;14391;14474;6.27;0.38;301.57;13.23;1107;78;4983.00;83
13288;77;626158592;13288;426;14391;14474;6.22;0.38;301.68;13.23;1103;78;4984.00;83
13295;77;626158608;13295;427;14392;14474;6.15;0.38;301.76;13.23;1097;78;4985.00;82
13298;77;626158629;13298;418;14394;14477;6.18;0.38;301.86;13.23;1096;78;4986.00;83
13301;77;626158645;13301;410;14394;14477;6.19;0.38;301.87;13.23;1093;78;4987.00;83
13308;77;626158660;13308;405;14395;14477;6.16;0.38;301.95;13.23;1087;78;4988.00;82
13311;77;626158677;13311;399;14395;14478;6.17;0.38;302.05;13.23;1084;78;4989.00;83
13314;77;626158692;13314;390;14396;14479;6.20;0.38;302.03;13.23;1082;78;4990.00;83
13316;77;626158708;13316;383;14396;14479;6.23;0.38;302.08;13.23;1080;78;4991.00;83
13318;77;626158730;13318;384;14407;14492;6.32;0.39;302.08;13.22;1089;78;4992.00;85
13322;77;626158747;13322;381;14407;14492;6.25;0.38;302.11;13.22;1085;78;4993.00;85
13328;77;626158763;13328;379;14407;14492;6.17;0.38;302.11;13.22;1079;78;4994.00;85
13332;77;626158779;13332;372;14409;14494;6.10;0.37;302.13;13.21;1077;78;4995.00;85
13334;77;626158800;13334;377;14409;14494;6.03;0.37;302.12;13.21;1075;78;4996.00;85
13339;77;626158816;13339;367;14412;14498;5.95;0.36;302.09;13.21;1073;78;4997.00;86
13341;77;626158832;13341;361;14412;14498;5.87;0.36;302.07;13.21;1071;78;4998.00;86
13346;77;626158853;13346;364;14416;14502;5.80;0.35;302.03;13.21;1070;78;4999.00;86
13350;77;626158870;13350;356;14416;14502;5.78;0.35;302.00;13.21;1066;78;5000.00;86
13352;77;626158888;13352;354;14416;14502;5.75;0.35;302.01;13.21;1064;78;5001.00;86
13355;77;626158904;13355;352;14416;14502;5.74;0.35;302.02;13.21;1061;78;5002.00;86
13358;77;626158918;13358;348;14416;14502;5.74;0.35;302.10;13.21;1058;78;5003.00;86
13361;77;626158933;13361;348;14425;14514;5.80;0.35;302.11;13.20;1064;78;5004.00;89
13361;77;626158948;13361;345;14425;14514;5.90;0.36;302.11;13.20;1064;78;5005.00;89
13364;77;626158963;13364;346;14427;14514;6.02;0.37;302.09;13.20;1063;78;5006.00;87
13367;77;626158976;13367;335;14427;14514;6.06;0.37;302.12;13.20;1060;78;5007.00;87
13369;77;626158991;13369;341;14427;14514;6.15;0.37;302.15;13.20;1058;78;5008.00;87
13371;77;626159004;13371;343;14427;14514;6.24;0.38;302.28;13.20;1056;78;5009.00;87
13373;77;626159020;13373;348;14427;14515;6.30;0.38;302.31;13.20;1054;78;5010.00;88
13378;77;626159034;13378;340;14427;14515;6.32;0.38;302.34;13.20;1049;78;5011.00;88
13380;77;626159054;13380;342;14431;14521;6.29;0.38;302.37;13.20;1051;78;5012.00;90
13384;77;626159077;13384;344;14432;14522;6.28;0.38;302.49;13.19;1048;78;5013.00;90
13385;77;626159100;13385;344;14433;14522;6.31;0.38;302.57;13.19;1048;78;5014.00;89
13388;77;626159121;13388;350;14433;14522;6.31;0.38;302.57;13.19;1045;78;5015.00;89
13390;77;626159144;13390;351;14436;14526;6.30;0.38;302.60;13.19;1046;78;5016.00;90
13391;77;626159164;13391;354;14437;14526;6.26;0.38;302.60;13.24;1046;78;5017.00;89
13393;77;626159181;13393;364;14437;14526;6.19;0.38;302.59;13.24;1044;78;5018.00;89
13394;77;626159196;13394;355;14438;14527;6.16;0.37;302.63;13.24;1044;78;5019.00;89
13394;77;626159213;13394;351;14441;14531;6.12;0.37;302.63;13.23;1047;78;5020.00;90
13395;77;626159228;13395;351;14441;14531;6.11;0.37;302.62;13.23;1046;78;5021.00;90
13395;77;626159243;13395;345;14443;14534;6.10;0.37;302.62;13.23;1048;78;5022.00;91
13396;77;626159258;13396;336;14443;14534;6.08;0.37;302.61;13.23;1047;78;5023.00;91
13396;77;626159273;13396;340;14444;14534;6.09;0.37;302.61;13.23;1048;78;5024.00;90
13396;77;626159287;13396;331;14444;14534;6.06;0.37;302.61;13.23;1048;78;5025.00;90
13396;77;626159300;13396;326;14448;14538;6.03;0.37;302.61;13.28;1052;78;5026.00;90
13401;77;626159313;13401;323;14448;14538;5.96;0.36;302.67;13.28;1047;78;5027.00;90
13402;77;626159326;13402;324;14449;14538;6.00;0.37;302.71;13.28;1047;78;5028.00;89
13404;77;626159339;13404;314;14449;14538;5.94;0.36;302.75;13.28;1045;78;5029.00;89
13409;77;626159351;13409;312;14449;14539;5.90;0.36;302.75;13.28;1040;78;5030.00;90
13409;77;626159364;13409;312;14451;14540;5.87;0.36;302.75;13.32;1042;78;5031.00;89
13411;77;626159377;13411;307;14451;14540;5.83;0.36;302.75;13.32;1040;78;5032.00;89
13413;77;626159389;13413;309;14452;14541;5.78;0.35;302.78;13.32;1039;78;5033.00;89
13416;77;626159402;13416;303;14453;14541;5.75;0.35;302.77;13.34;1037;78;5034.00;88
13421;77;626159416;13421;302;14455;14541;5.71;0.35;302.78;13.40;1034;78;5035.00;86
13425;77;626159428;13425;300;14455;14541;5.65;0.34;302.82;13.40;1030;78;5036.00;86
13428;77;626159441;13428;291;14456;14541;5.58;0.34;302.94;13.45;1028;78;5037.00;85
13434;77;626159454;13434;289;14456;14541;5.54;0.34;302.95;13.45;1022;78;5038.00;85
13437;77;626159467;13437;284;14457;14541;5.48;0.33;302.98;13.50;1020;78;5039.00;84
13440;77;626159484;13440;311;14558;14771;5.77;0.36;303.04;13.41;1118;78;5040.00;213
13442;77;626159523;13442;303;14559;14772;5.76;0.36;303.08;13.41;1117;78;5041.00;213
13443;77;626159538;13443;295;14569;14772;5.83;0.37;303.06;13.45;1126;78;5042.00;203
13446;77;626159553;13446;286;14574;14772;5.85;0.36;303.05;13.44;1128;78;5043.00;198
13447;77;626159567;13447;276;14581;14772;5.87;0.37;303.03;13.44;1134;78;5044.00;191
13448;77;626159582;13448;271;14587;14772;5.92;0.37;303.03;13.44;1139;78;5045.00;185
13449;77;626159598;13449;268;14596;14772;5.98;0.37;303.03;13.48;1147;78;5046.00;176
13449;77;626159613;13449;268;14601;14772;6.02;0.37;303.03;13.48;1152;78;5047.00;171
13452;77;626159628;13452;267;14609;14773;6.08;0.38;303.00;13.48;1157;78;5048.00;164
13455;77;626159646;13455;272;14611;14774;6.07;0.38;302.95;13.48;1156;78;5049.00;163
13456;77;626159662;13456;270;14616;14774;6.11;0.38;302.94;13.48;1160;78;5050.00;158
13457;77;626159677;13457;283;14618;14775;6.12;0.38;302.93;13.48;1161;78;5051.00;157
13458;77;626159693;13458;289;14621;14775;6.15;0.38;302.94;13.48;1163;78;5052.00;154
13462;77;626159709;13462;287;14622;14775;6.16;0.38;302.89;13.48;1160;78;5053.00;153
13464;77;626159724;13464;285;14626;14775;6.17;0.38;302.88;13.48;1162;78;5054.00;149
13466;77;626159740;13466;295;14630;14779;6.14;0.38;302.84;13.48;1164;78;5055.00;149
13468;77;626159756;13468;290;14633;14779;6.12;0.38;302.84;13.48;1165;78;5056.00;146
13468;77;626159772;13468;296;14638;14779;6.10;0.37;302.84;13.48;1170;78;5057.00;141
13471;77;626159788;13471;295;14642;14782;6.09;0.37;302.79;13.48;1171;78;5058.00;140
13472;77;626159811;13472;300;14644;14782;6.06;0.37;302.78;13.48;1172;78;5059.00;138
13473;77;626159828;13473;301;14647;14782;6.05;0.37;302.77;13.49;1174;78;5060.00;135
13473;77;626159845;13473;311;14654;14786;6.02;0.37;302.77;13.50;1181;78;5061.00;132
13474;77;626159872;13474;329;14658;14787;5.98;0.37;302.77;13.50;1184;78;5062.00;129
13474;77;626159889;13474;332;14661;14787;5.96;0.37;302.77;13.52;1187;78;5063.00;126
13478;77;626159918;13478;332;14665;14791;5.93;0.36;302.72;13.52;1187;78;5064.00;126
13479;77;626159944;13479;347;14671;14791;5.89;0.36;302.73;13.54;1192;78;5065.00;120
13481;77;626159960;13481;350;14672;14791;5.83;0.36;302.71;13.55;1191;78;5066.00;119
13483;77;626159978;13483;361;14674;14792;5.81;0.36;302.67;13.55;1191;78;5067.00;118
13488;77;626159993;13488;368;14676;14792;5.73;0.35;302.62;13.56;1188;78;5068.00;116
13490;77;626160016;13490;373;14684;14798;5.70;0.35;302.59;13.56;1194;78;5069.00;114
13493;77;626160047;13493;376;14685;14798;5.61;0.34;302.58;13.58;1192;78;5070.00;113
13495;77;626160065;13495;389;14688;14799;5.51;0.34;302.58;13.61;1193;78;5071.00;111
13495;77;626160081;13495;394;14690;14799;5.45;0.33;302.58;13.62;1195;78;5072.00;109
13496;77;626160097;13496;405;14691;14799;5.42;0.33;302.56;13.63;1195;78;5073.00;108
13497;77;626160112;13497;413;14694;14799;5.37;0.33;302.56;13.64;1197;78;5074.00;105
13501;77;626160127;13501;412;14695;14799;5.28;0.32;302.52;13.64;1194;78;5075.00;104
13503;77;626160142;13503;424;14705;14811;5.26;0.32;302.50;13.63;1202;78;5076.00;106
13503;77;626160158;13503;430;14709;14811;5.19;0.32;302.50;13.65;1206;78;5077.00;102
13504;77;626160173;13504;435;14710;14811;5.14;0.31;302.48;13.65;1206;78;5078.00;101
13506;77;626160188;13506;435;14713;14811;5.07;0.31;302.49;13.67;1207;78;5079.00;98
13506;77;626160203;13506;440;14715;14811;5.02;0.31;302.49;13.68;1209;78;5080.00;96
13506;77;626160217;13506;445;14717;14811;5.01;0.31;302.49;13.69;1211;78;5081.00;94
13509;77;626160231;13509;443;14722;14815;5.01;0.31;302.48;13.70;1213;78;5082.00;93
13513;77;626160247;13513;431;14722;14815;5.07;0.31;302.43;13.70;1209;78;5083.00;93
13513;77;626160262;13513;414;14727;14819;5.16;0.32;302.43;13.71;1214;78;5084.00;92
13514;77;626160277;13514;402;14729;14821;5.23;0.32;302.43;13.71;1215;78;5085.00;92
13515;77;626160291;13515;399;14732;14821;5.28;0.32;302.43;13.72;1217;78;5086.00;89
13517;77;626160306;13517;396;14732;14821;5.34;0.33;302.41;13.72;1215;78;5087.00;89
13517;77;626160322;13517;389;14743;14834;5.42;0.33;302.41;13.71;1226;78;5088.00;91
13519;77;626160339;13519;379;14745;14834;5.43;0.33;302.37;13.72;1226;78;5089.00;89
13520;77;626160360;13520;377;14745;14834;5.46;0.33;302.35;13.72;1225;78;5090.00;89
13522;77;626160375;13522;374;14747;14835;5.48;0.33;302.35;13.73;1225;78;5091.00;88
13523;78;626160391;13523;377;14748;14836;5.50;0.34;302.35;13.73;1225;79;5092.00;88
13524;78;626160417;13524;378;14749;14836;5.52;0.34;302.35;13.75;1225;79;5093.00;87
13527;78;626160432;13527;375;14751;14839;5.50;0.34;302.34;13.74;1224;79;5094.00;88
13530;78;626160455;13530;385;14751;14839;5.49;0.33;302.30;13.74;1221;79;5095.00;88
13531;78;626160470;13531;384;14754;14839;5.55;0.34;302.31;13.77;1223;79;5096.00;85
13533;78;626160485;13533;388;14755;14839;5.56;0.34;302.31;13.78;1222;79;5097.00;84
13536;78;626160500;13536;392;14760;14845;5.55;0.34;302.29;13.78;1224;79;5098.00;85
13537;78;626160515;13537;402;14760;14845;5.52;0.34;302.29;13.78;1223;79;5099.00;85
13540;78;626160532;13540;399;14765;14864;5.49;0.33;302.31;13.78;1225;79;5100.00;99
13541;78;626160554;13541;396;14765;14864;5.48;0.33;302.31;13.78;1224;79;5101.00;99
13546;78;626160569;13546;393;14775;14868;5.41;0.33;302.29;13.83;1229;79;5102.00;93
13548;78;626160585;13548;395;14776;14869;5.42;0.33;302.28;13.83;1228;79;5103.00;93
13552;78;626160600;13552;403;14776;14869;5.45;0.33;302.37;13.83;1224;79;5104.00;93
13556;78;626160615;13556;406;14778;14870;5.42;0.33;302.44;13.83;1222;79;5105.00;92
13560;78;626160630;13560;405;14779;14870;5.40;0.33;302.44;13.83;1219;79;5106.00;91
13562;78;626160645;13562;394;14779;14870;5.48;0.34;302.44;13.83;1217;79;5107.00;91
13567;78;626160660;13567;390;14780;14870;5.50;0.34;302.49;13.83;1213;79;5108.00;90
13571;78;626160676;13571;386;14780;14870;5.54;0.34;302.50;13.83;1209;79;5109.00;90
13574;78;626160690;13574;390;14780;14870;5.57;0.34;302.53;13.83;1206;79;5110.00;90
13579;78;626160705;13579;389;14781;14870;5.54;0.34;302.61;13.83;1202;79;5111.00;89
13582;78;626160721;13582;398;14817;14940;5.66;0.35;302.58;13.85;1235;79;5112.00;123
13585;78;626160743;13585;384;14820;14941;5.69;0.35;302.61;13.85;1235;79;5113.00;121
13590;78;626160759;13590;381;14826;14941;5.77;0.35;302.65;13.84;1236;79;5114.00;115
13596;78;626160775;13596;376;14828;14941;5.83;0.36;302.70;13.84;1232;79;5115.00;113
13601;78;626160790;13601;378;14833;14941;5.89;0.36;302.71;13.84;1232;79;5116.00;108
13606;78;626160807;13606;379;14837;14941;5.97;0.37;302.74;13.84;1231;79;5117.00;104
13609;78;626160823;13609;382;14840;14941;6.02;0.37;302.80;13.84;1231;79;5118.00;101
13613;78;626160839;13613;377;14843;14941;6.02;0.37;302.85;13.83;1230;79;5119.00;98
13618;78;626160857;13618;384;14845;14942;6.05;0.37;302.89;13.83;1227;79;5120.00;97
13621;78;626160873;13621;387;14846;14943;6.03;0.37;302.93;13.83;1225;79;5121.00;97
13626;78;626160889;13626;388;14846;14943;6.03;0.37;302.98;13.83;1220;79;5122.00;97
13628;78;626160906;13628;397;14850;14947;6.06;0.37;303.04;13.83;1222;79;5123.00;97
13633;78;626160924;13633;395;14851;14947;6.08;0.37;303.07;13.83;1218;79;5124.00;96
13636;78;626160941;13636;403;14851;14947;6.12;0.38;303.10;13.83;1215;79;5125.00;96
13641;78;626160958;13641;399;14851;14947;6.13;0.38;303.10;13.83;1210;79;5126.00;96
13647;78;626160975;13647;398;14854;14953;6.10;0.37;303.11;13.83;1207;79;5127.00;99
13651;78;626160993;13651;403;14855;14953;6.10;0.37;303.15;13.88;1204;79;5128.00;98
13656;78;626161011;13656;400;14857;14953;6.07;0.37;303.21;13.88;1201;79;5129.00;96
13661;78;626161036;13661;405;14860;14959;6.07;0.37;303.21;13.88;1199;79;5130.00;99
13663;78;626161059;13663;407;14860;14959;6.07;0.37;303.25;13.88;1197;79;5131.00;99
13665;78;626161083;13665;407;14862;14959;6.11;0.37;303.29;13.88;1197;79;5132.00;97
13673;78;626161110;13673;418;14862;14960;6.09;0.37;303.30;13.88;1189;79;5133.00;98
13676;78;626161135;13676;423;14865;14961;6.12;0.37;303.37;13.88;1189;79;5134.00;96
13681;78;626161162;13681;417;14866;14961;6.13;0.37;303.46;13.88;1185;79;5135.00;95
13688;78;626161182;13688;416;14875;14974;6.10;0.37;303.44;13.88;1187;79;5136.00;99
13692;78;626161202;13692;415;14875;14974;6.08;0.37;303.51;13.88;1183;79;5137.00;99
13696;78;626161221;13696;413;14876;14974;6.08;0.37;303.50;13.88;1180;79;5138.00;98
13698;78;626161241;13698;416;14878;14975;6.16;0.38;303.53;13.88;1180;79;5139.00;97
13703;78;626161259;13703;419;14880;14975;6.14;0.37;303.56;13.88;1177;79;5140.00;95
13706;78;626161277;13706;429;14882;14979;6.16;0.38;303.56;13.88;1176;79;5141.00;97
13714;78;626161296;13714;430;14885;14979;6.06;0.37;303.61;13.93;1171;79;5142.00;94
13715;78;626161314;13715;437;14890;14983;6.03;0.37;303.64;13.93;1175;79;5143.00;93
13717;78;626161332;13717;443;14891;14983;6.01;0.37;303.65;13.93;1174;79;5144.00;92
13720;78;626161350;13720;443;14891;14983;5.96;0.36;303.65;13.93;1171;79;5145.00;92
13723;78;626161368;13723;453;14892;14983;5.93;0.36;303.72;13.93;1169;79;5146.00;91
13728;78;626161385;13728;451;14893;14983;5.89;0.36;303.74;13.93;1165;79;5147.00;90
13729;78;626161403;13729;444;14904;14995;5.94;0.36;303.76;13.92;1175;79;5148.00;91
13732;78;626161422;13732;450;14904;14995;5.96;0.36;303.82;13.92;1172;79;5149.00;91
13735;78;626161439;13735;442;14905;14995;6.00;0.37;303.83;13.92;1170;79;5150.00;90
13736;78;626161456;13736;443;14906;14995;6.03;0.37;303.87;13.92;1170;79;5151.00;89
13743;78;626161474;13743;441;14906;14995;5.99;0.37;303.86;13.92;1163;79;5152.00;89
13750;78;626161499;13750;442;14906;14995;5.91;0.36;303.91;13.92;1156;79;5153.00;89
13753;78;626161517;13753;443;14906;14996;5.91;0.36;303.88;13.92;1153;79;5154.00;90
13758;78;626161534;13758;446;14908;14998;5.87;0.36;303.94;13.92;1150;79;5155.00;90
13763;78;626161551;13763;441;14912;15004;5.86;0.36;303.97;13.91;1149;79;5156.00;92
13769;78;626161570;13769;438;14914;15005;5.84;0.36;304.16;13.91;1145;79;5157.00;91
13773;78;626161589;13773;434;14914;15005;5.86;0.36;304.26;13.91;1141;79;5158.00;91
13775;78;626161607;13775;432;14914;15005;5.91;0.36;304.23;13.91;1139;79;5159.00;91
13778;78;626161626;13778;425;14918;15010;5.97;0.36;304.30;13.91;1140;79;5160.00;92
13780;78;626161645;13780;419;14918;15010;6.04;0.37;304.31;13.91;1138;79;5161.00;92
13783;78;626161662;13783;418;14918;15010;6.09;0.37;304.33;13.91;1135;79;5162.00;92
13788;78;626161678;13788;415;14919;15011;6.07;0.37;304.38;13.91;1131;79;5163.00;92
13791;78;626161696;13791;412;14922;15015;6.04;0.37;304.44;13.90;1131;79;5164.00;93
13792;78;626161713;13792;405;14922;15015;6.04;0.37;304.47;13.90;1130;79;5165.00;93
13794;78;626161729;13794;401;14925;15018;6.08;0.37;304.49;13.90;1131;79;5166.00;93
13798;78;626161745;13798;398;14925;15018;6.10;0.37;304.53;13.90;1127;79;5167.00;93
13800;78;626161761;13800;393;14925;15018;6.12;0.37;304.55;13.90;1125;79;5168.00;93
13802;78;626161778;13802;392;14925;15018;6.13;0.37;304.54;13.90;1123;79;5169.00;93
13803;78;626161795;13803;387;14928;15022;6.14;0.37;304.58;13.90;1125;79;5170.00;94
13807;78;626161812;13807;380;14929;15022;6.10;0.37;304.58;13.90;1122;79;5171.00;93
13810;78;626161828;13810;381;14929;15022;6.07;0.37;304.66;13.90;1119;79;5172.00;93
13811;78;626161846;13811;386;14929;15022;6.10;0.37;304.65;13.90;1118;79;5173.00;93
13815;78;626161861;13815;383;14929;15023;6.10;0.37;304.64;13.90;1114;79;5174.00;94
13816;78;626161876;13816;379;14931;15025;6.10;0.37;304.62;13.90;1115;79;5175.00;94
13819;78;626161892;13819;380;14931;15025;6.09;0.37;304.69;13.90;1112;79;5176.00;94
13820;78;626161908;13820;376;14932;15026;6.10;0.37;304.75;13.89;1112;79;5177.00;94
13823;78;626161923;13823;373;14932;15026;6.04;0.37;304.75;13.89;1109;79;5178.00;94
13828;78;626161939;13828;377;14932;15026;5.97;0.37;304.93;13.89;1104;79;5179.00;94
13830;78;626161955;13830;375;14932;15026;5.91;0.36;304.92;13.89;1102;79;5180.00;94
13832;78;626161971;13832;380;14932;15026;5.85;0.36;304.90;13.89;1100;79;5181.00;94
13836;78;626161986;13836;385;14932;15026;5.77;0.35;304.96;13.89;1096;79;5182.00;94
13837;78;626162001;13837;385;14932;15026;5.73;0.35;305.00;13.89;1095;79;5183.00;94
13839;78;626162016;13839;410;15003;15153;5.76;0.36;305.02;13.89;1164;79;5184.00;150
13840;78;626162045;13840;397;15005;15154;5.76;0.36;305.03;13.89;1165;79;5185.00;149
13841;79;626162066;13841;390;15010;15154;5.83;0.36;305.07;13.88;1169;80;5186.00;144
13842;79;626162095;13842;390;15013;15154;5.85;0.36;305.06;13.88;1171;80;5187.00;141
13842;79;626162110;13842;392;15018;15154;5.87;0.36;305.06;13.88;1176;80;5188.00;136
13847;79;626162123;13847;406;15020;15154;5.84;0.36;305.07;13.87;1173;80;5189.00;134
13850;79;626162140;13850;401;15024;15154;5.85;0.36;305.09;13.87;1174;80;5190.00;130
13852;79;626162154;13852;405;15026;15154;5.84;0.36;305.09;13.87;1174;80;5191.00;128
13854;79;626162169;13854;395;15030;15155;5.86;0.36;305.10;13.87;1176;80;5192.00;125
13855;79;626162189;13855;401;15034;15156;5.88;0.36;305.09;13.87;1179;80;5193.00;122
13860;79;626162205;13860;401;15038;15156;5.84;0.36;305.11;13.87;1178;80;5194.00;118
13862;79;626162220;13862;400;15041;15157;5.85;0.36;305.12;13.87;1179;80;5195.00;116
13868;79;626162235;13868;407;15043;15157;5.79;0.36;305.22;13.87;1175;80;5196.00;114
13870;79;626162255;13870;410;15044;15157;5.72;0.35;305.24;13.87;1174;80;5197.00;113
13874;79;626162270;13874;411;15046;15157;5.62;0.35;305.25;13.92;1172;80;5198.00;111
13876;79;626162284;13876;412;15049;15161;5.56;0.34;305.23;13.92;1173;80;5199.00;112
13881;79;626162298;13881;415;15050;15161;5.42;0.33;305.28;13.92;1169;80;5200.00;111
13882;79;626162317;13882;420;15052;15161;5.34;0.33;305.36;13.92;1170;80;5201.00;109
13885;79;626162331;13885;417;15054;15164;5.22;0.32;305.40;13.92;1169;80;5202.00;110
13887;79;626162345;13887;411;15055;15164;5.13;0.32;305.38;13.92;1168;80;5203.00;109
13892;79;626162359;13892;412;15056;15164;5.02;0.31;305.32;13.96;1164;80;5204.00;108
13896;79;626162373;13896;412;15062;15168;4.98;0.31;305.31;13.99;1166;80;5205.00;106
13899;79;626162389;13899;412;15064;15169;4.96;0.30;305.27;14.04;1165;80;5206.00;105
13900;79;626162403;13900;407;15066;15169;5.00;0.31;305.25;14.05;1166;80;5207.00;103
13901;79;626162417;13901;402;15068;15173;5.02;0.31;305.23;14.05;1167;80;5208.00;105
13902;79;626162436;13902;403;15069;15173;5.06;0.31;305.22;14.05;1167;80;5209.00;104
13903;79;626162450;13903;400;15069;15173;5.09;0.31;305.24;14.05;1166;80;5210.00;104
13908;79;626162464;13908;393;15070;15174;5.06;0.31;305.20;14.05;1162;80;5211.00;104
13909;79;626162478;13909;392;15071;15174;5.07;0.31;305.19;14.05;1162;80;5212.00;103
13912;79;626162493;13912;394;15074;15180;5.10;0.31;305.15;14.05;1162;80;5213.00;106
13915;79;626162507;13915;399;15074;15180;5.09;0.31;305.10;14.05;1159;80;5214.00;106
13917;79;626162520;13917;392;15076;15180;5.09;0.31;305.07;14.05;1159;80;5215.00;104
13919;79;626162534;13919;396;15076;15181;5.11;0.31;305.05;14.05;1157;80;5216.00;105
13923;79;626162547;13923;406;15077;15181;5.08;0.31;305.01;14.05;1154;80;5217.00;104
13924;79;626162562;13924;409;15078;15181;5.12;0.31;304.99;14.05;1154;80;5218.00;103
13925;79;626162575;13925;413;15078;15181;5.11;0.31;304.98;14.05;1153;80;5219.00;103
13926;79;626162590;13926;425;15099;15217;5.24;0.32;304.99;14.03;1173;80;5220.00;118
13926;79;626162607;13926;416;15100;15217;5.25;0.32;304.99;14.03;1174;80;5221.00;117
13928;79;626162621;13928;412;15102;15217;5.24;0.32;304.96;14.03;1174;80;5222.00;115
13928;79;626162635;13928;409;15103;15217;5.30;0.33;304.96;14.03;1175;80;5223.00;114
13932;79;626162649;13932;410;15103;15217;5.26;0.32;305.03;14.03;1171;80;5224.00;114
13934;79;626162663;13934;417;15105;15217;5.28;0.32;305.12;14.03;1171;80;5225.00;112
13937;79;626162677;13937;415;15109;15221;5.34;0.33;305.15;14.02;1172;80;5226.00;112
13938;79;626162692;13938;415;15109;15221;5.37;0.33;305.14;14.02;1171;80;5227.00;112
13939;79;626162706;13939;424;15113;15225;5.41;0.33;305.12;14.02;1174;80;5228.00;112
13942;79;626162721;13942;426;15115;15226;5.45;0.33;305.09;14.02;1173;80;5229.00;111
13944;79;626162736;13944;418;15117;15226;5.41;0.33;305.06;14.03;1173;80;5230.00;109
13945;79;626162750;13945;422;15119;15226;5.42;0.33;305.06;14.04;1174;80;5231.00;107
13948;79;626162765;13948;425;15130;15239;5.40;0.33;305.03;14.05;1182;80;5232.00;109
13950;79;626162781;13950;427;15130;15239;5.39;0.33;305.07;14.05;1180;80;5233.00;109
13952;79;626162800;13952;423;15131;15239;5.38;0.33;305.04;14.05;1179;80;5234.00;108
13952;79;626162814;13952;411;15133;15240;5.38;0.33;305.04;14.06;1181;80;5235.00;107
13953;79;626162829;13953;406;15135;15241;5.39;0.33;305.04;14.07;1182;80;5236.00;106
13954;79;626162850;13954;397;15135;15241;5.42;0.33;305.04;14.07;1181;80;5237.00;106
13954;79;626162869;13954;396;15141;15244;5.49;0.33;305.04;14.09;1187;80;5238.00;103
13954;79;626162885;13954;395;15141;15244;5.54;0.34;305.04;14.09;1187;80;5239.00;103
13955;79;626162899;13955;392;15142;15244;5.54;0.34;305.07;14.11;1187;80;5240.00;102
13958;79;626162915;13958;389;15143;15244;5.54;0.34;305.07;14.11;1185;80;5241.00;101
13959;79;626162929;13959;387;15149;15250;5.60;0.34;305.07;14.13;1190;80;5242.00;101
13960;79;626162945;13960;385;15149;15250;5.59;0.34;305.06;14.13;1189;80;5243.00;101
13960;79;626162959;13960;391;15151;15250;5.60;0.34;305.06;14.13;1191;80;5244.00;99
13961;79;626162980;13961;387;15152;15250;5.56;0.34;305.05;14.14;1191;80;5245.00;98
13964;80;626162995;13964;390;15156;15254;5.51;0.34;305.01;14.14;1192;81;5246.00;98
13965;80;626163025;13965;395;15159;15255;5.49;0.33;304.99;14.17;1194;81;5247.00;96
13966;80;626163040;13966;396;15159;15255;5.45;0.33;304.97;14.17;1193;81;5248.00;96
13968;80;626163068;13968;396;15161;15256;5.44;0.33;304.96;14.18;1193;81;5249.00;95
13970;80;626163093;13970;405;15163;15256;5.43;0.33;304.94;14.19;1193;81;5250.00;93
13974;80;626163113;13974;398;15163;15256;5.41;0.33;304.93;14.19;1189;81;5251.00;93
13975;80;626163133;13975;403;15165;15256;5.40;0.33;304.93;14.20;1190;81;5252.00;91
13975;80;626163156;13975;389;15165;15256;5.46;0.33;304.93;14.20;1190;81;5253.00;91
13976;80;626163179;13976;387;15168;15256;5.44;0.33;304.94;14.22;1192;81;5254.00;88
13976;80;626163194;13976;384;15168;15256;5.43;0.33;304.94;14.22;1192;81;5255.00;88
13979;80;626163219;13979;399;15204;15326;5.58;0.34;304.92;14.18;1225;81;5256.00;122
13980;80;626163250;13980;390;15206;15327;5.60;0.34;304.90;14.20;1226;81;5257.00;121
13982;80;626163267;13982;386;15214;15327;5.65;0.34;304.87;14.19;1232;81;5258.00;113
13982;80;626163282;13982;388;15223;15327;5.66;0.34;304.87;14.20;1241;81;5259.00;104
13985;80;626163297;13985;393;15226;15327;5.62;0.34;304.95;14.19;1241;81;5260.00;101
13986;80;626163313;13986;393;15233;15327;5.58;0.34;304.97;14.20;1247;81;5261.00;94
13990;80;626163333;13990;400;15236;15327;5.54;0.34;304.96;14.20;1246;81;5262.00;91
13992;80;626163348;13992;408;15238;15327;5.52;0.34;304.97;14.21;1246;81;5263.00;89
13998;80;626163362;13998;403;15241;15328;5.48;0.33;305.00;14.21;1243;81;5264.00;87
14002;80;626163378;14002;401;15243;15330;5.44;0.33;305.07;14.21;1241;81;5265.00;87
14009;80;626163401;14009;400;15244;15330;5.34;0.33;305.05;14.22;1235;81;5266.00;86
14011;80;626163417;14011;404;15249;15334;5.24;0.32;305.10;14.24;1238;81;5267.00;85
14016;80;626163433;14016;412;15250;15334;5.21;0.32;305.05;14.25;1234;81;5268.00;84
14021;80;626163447;14021;416;15250;15334;5.16;0.31;305.08;14.25;1229;81;5269.00;84
14022;80;626163462;14022;407;15251;15334;5.18;0.32;305.09;14.26;1229;81;5270.00;83
14026;80;626163478;14026;401;15256;15340;5.20;0.32;305.13;14.27;1230;81;5271.00;84
14029;80;626163495;14029;411;15256;15340;5.20;0.32;305.16;14.27;1227;81;5272.00;84
14033;80;626163510;14033;402;15258;15340;5.25;0.32;305.19;14.28;1225;81;5273.00;82
14038;80;626163527;14038;407;15260;15343;5.34;0.32;305.25;14.28;1222;81;5274.00;83
14038;80;626163543;14038;413;15263;15343;5.43;0.33;305.25;14.29;1225;81;5275.00;80
14043;80;626163559;14043;414;15263;15343;5.45;0.33;305.31;14.29;1220;81;5276.00;80
14047;80;626163575;14047;404;15263;15344;5.50;0.34;305.43;14.29;1216;81;5277.00;81
14050;80;626163593;14050;407;15264;15345;5.55;0.34;305.42;14.28;1214;81;5278.00;81
14054;80;626163610;14054;403;15264;15345;5.60;0.34;305.47;14.28;1210;81;5279.00;81
14060;80;626163628;14060;400;15284;15371;5.63;0.34;305.56;14.27;1224;81;5280.00;87
14065;80;626163647;14065;394;15284;15371;5.62;0.34;305.61;14.27;1219;81;5281.00;87
14068;80;626163664;14068;389;15286;15371;5.69;0.35;305.67;14.26;1218;81;5282.00;85
14071;80;626163680;14071;387;15287;15372;5.74;0.35;305.73;14.26;1216;81;5283.00;85
14076;80;626163696;14076;393;15287;15372;5.72;0.35;305.83;14.26;1211;81;5284.00;85
14080;80;626163714;14080;381;15291;15376;5.78;0.35;305.86;14.26;1211;81;5285.00;85
14082;80;626163732;14082;376;15291;15376;5.86;0.36;305.91;14.26;1209;81;5286.00;85
14088;80;626163749;14088;374;15294;15379;5.91;0.36;306.00;14.26;1206;81;5287.00;85
14092;80;626163765;14092;370;15294;15380;5.93;0.36;306.04;14.26;1202;81;5288.00;86
14096;80;626163782;14096;375;15294;15380;5.98;0.37;306.08;14.26;1198;81;5289.00;86
14100;80;626163798;14100;376;15294;15380;6.03;0.37;306.17;14.26;1194;81;5290.00;86
14105;80;626163816;14105;377;15295;15380;6.07;0.37;306.17;14.31;1190;81;5291.00;85
14110;80;626163843;14110;371;15305;15392;6.18;0.38;306.20;14.30;1195;81;5292.00;87
14113;80;626163862;14113;366;15306;15392;6.21;0.38;306.25;14.30;1193;81;5293.00;86
14118;80;626163879;14118;371;15306;15392;6.25;0.38;306.31;14.30;1188;81;5294.00;86
14125;80;626163897;14125;378;15306;15392;6.27;0.38;306.42;14.30;1181;81;5295.00;86
14132;80;626163915;14132;372;15306;15392;6.31;0.39;306.53;14.30;1174;81;5296.00;86
14137;80;626163933;14137;374;15306;15392;6.37;0.39;306.55;14.30;1169;81;5297.00;86
14145;80;626163953;14145;375;15306;15393;6.37;0.39;306.63;14.30;1161;81;5298.00;87
14150;80;626163974;14150;388;15306;15393;6.40;0.39;306.69;14.30;1156;81;5299.00;87
14152;80;626163993;14152;386;15310;15399;6.46;0.39;306.68;14.29;1158;81;5300.00;89
14160;80;626164017;14160;389;15311;15400;6.45;0.39;306.78;14.29;1151;81;5301.00;89
14164;80;626164036;14164;394;15312;15400;6.45;0.39;306.79;14.29;1148;81;5302.00;88
14167;80;626164055;14167;396;15312;15400;6.46;0.39;306.84;14.29;1145;81;5303.00;88
14173;80;626164075;14173;401;15315;15404;6.45;0.39;306.89;14.29;1142;81;5304.00;89
14178;80;626164095;14178;400;15315;15404;6.45;0.39;306.94;14.29;1137;81;5305.00;89
14179;80;626164119;14179;397;15315;15404;6.46;0.39;306.92;14.29;1136;81;5306.00;89
14183;80;626164135;14183;389;15317;15405;6.45;0.39;306.97;14.34;1134;81;5307.00;88
14185;80;626164152;14185;389;15320;15409;6.46;0.39;307.03;14.34;1135;81;5308.00;89
14190;80;626164169;14190;390;15320;15409;6.43;0.39;307.13;14.34;1130;81;5309.00;89
14194;80;626164188;14194;391;15323;15415;6.43;0.39;307.18;14.34;1129;81;5310.00;92
14197;80;626164205;14197;398;15324;15415;6.46;0.39;307.24;14.33;1127;81;5311.00;91
14203;80;626164221;14203;401;15324;15415;6.41;0.39;307.27;14.33;1121;81;5312.00;91
14207;80;626164238;14207;408;15326;15415;6.35;0.38;307.32;14.38;1119;81;5313.00;89
14209;80;626164255;14209;406;15328;15419;6.28;0.38;307.38;14.38;1119;81;5314.00;91
14212;80;626164272;14212;408;15329;15419;6.21;0.38;307.43;14.38;1117;81;5315.00;90
14216;80;626164288;14216;414;15329;15419;6.14;0.37;307.48;14.38;1113;81;5316.00;90
14217;80;626164304;14217;407;15330;15419;6.07;0.37;307.49;14.38;1113;81;5317.00;89
14221;80;626164321;14221;405;15330;15420;6.05;0.37;307.52;14.38;1109;81;5318.00;90
14222;80;626164337;14222;412;15332;15421;6.06;0.37;307.58;14.38;1110;81;5319.00;89
14223;80;626164354;14223;413;15332;15421;6.00;0.37;307.58;14.38;1109;81;5320.00;89
14225;80;626164370;14225;412;15334;15422;5.96;0.36;307.66;14.43;1109;81;5321.00;88
14225;80;626164387;14225;419;15334;15422;5.92;0.36;307.66;14.43;1109;81;5322.00;88
14229;80;626164403;14229;419;15334;15422;5.92;0.36;307.73;14.43;1105;81;5323.00;88
14233;80;626164418;14233;429;15334;15422;5.88;0.36;307.80;14.43;1101;81;5324.00;88
14237;80;626164445;14237;433;15334;15422;5.84;0.36;307.78;14.43;1097;81;5325.00;88
14240;80;626164460;14240;427;15334;15422;5.83;0.35;307.82;14.43;1094;81;5326.00;88
14242;80;626164477;14242;426;15334;15422;5.82;0.35;307.91;14.43;1092;81;5327.00;88
14246;80;626164491;14246;457;15406;15549;5.78;0.36;307.99;14.36;1160;81;5328.00;143
14247;80;626164519;14247;432;15406;15550;5.81;0.36;307.99;14.36;1159;81;5329.00;144
14249;80;626164535;14249;422;15412;15550;5.91;0.37;308.05;14.35;1163;81;5330.00;138
14251;80;626164551;14251;412;15413;15550;5.96;0.37;308.05;14.35;1162;81;5331.00;137
14254;80;626164572;14254;403;15418;15550;6.02;0.37;308.10;14.35;1164;81;5332.00;132
14257;80;626164589;14257;391;15421;15550;6.08;0.38;308.10;14.35;1164;81;5333.00;129
14257;80;626164611;14257;380;15425;15550;6.19;0.38;308.10;14.35;1168;81;5334.00;125
14260;80;626164628;14260;376;15427;15550;6.27;0.39;308.16;14.35;1167;81;5335.00;123
14264;80;626164644;14264;384;15434;15551;6.31;0.39;308.18;14.39;1170;81;5336.00;117
14266;80;626164660;14266;376;15438;15552;6.39;0.39;308.19;14.39;1172;81;5337.00;114
14268;80;626164677;14268;371;15440;15552;6.41;0.40;308.21;14.39;1172;81;5338.00;112
14270;80;626164693;14270;371;15445;15553;6.42;0.40;308.24;14.39;1175;81;5339.00;108
14272;80;626164712;14272;370;15448;15553;6.35;0.39;308.23;14.39;1176;81;5340.00;105
14276;80;626164733;14276;372;15448;15553;6.27;0.39;308.29;14.39;1172;81;5341.00;105
14280;80;626164749;14280;372;15450;15553;6.23;0.38;308.25;14.39;1170;81;5342.00;103
14282;80;626164766;14282;369;15453;15557;6.21;0.38;308.30;14.39;1171;81;5343.00;104
14286;80;626164782;14286;377;15455;15557;6.16;0.38;308.30;14.39;1169;81;5344.00;102
14287;80;626164798;14287;375;15456;15557;6.14;0.38;308.36;14.39;1169;81;5345.00;101
14291;80;626164814;14291;383;15458;15560;6.11;0.37;308.41;14.39;1167;81;5346.00;102
14294;80;626164836;14294;387;15459;15560;6.08;0.37;308.40;14.39;1165;81;5347.00;101
14295;80;626164852;14295;395;15460;15560;6.05;0.37;308.40;14.38;1165;81;5348.00;100
14298;80;626164867;14298;398;15463;15564;5.99;0.37;308.42;14.38;1165;81;5349.00;101
14302;80;626164883;14302;401;15465;15565;5.94;0.36;308.40;14.38;1163;81;5350.00;100
14306;80;626164899;14306;406;15466;15565;5.88;0.36;308.37;14.43;1160;81;5351.00;99
14308;80;626164914;14308;413;15470;15569;5.85;0.36;308.39;14.42;1162;81;5352.00;99
14310;80;626164930;14310;416;15470;15569;5.77;0.35;308.36;14.42;1160;81;5353.00;99
14311;80;626164945;14311;419;15470;15569;5.71;0.35;308.38;14.42;1159;81;5354.00;99
14313;80;626164959;14313;431;15472;15571;5.67;0.35;308.45;14.42;1159;81;5355.00;99
14314;80;626164974;14314;433;15472;15571;5.63;0.34;308.50;14.42;1158;81;5356.00;99
14316;80;626164988;14316;443;15476;15577;5.60;0.34;308.49;14.42;1160;81;5357.00;101
14320;80;626165004;14320;450;15476;15577;5.54;0.34;308.44;14.42;1156;81;5358.00;101
14322;80;626165019;14322;455;15477;15577;5.49;0.33;308.42;14.42;1155;81;5359.00;100
14324;80;626165034;14324;458;15477;15578;5.39;0.33;308.39;14.42;1153;81;5360.00;101
14325;80;626165049;14325;451;15477;15578;5.35;0.33;308.39;14.42;1152;81;5361.00;101
14327;80;626165067;14327;445;15477;15578;5.26;0.32;308.39;14.42;1150;81;5362.00;101
14329;80;626165101;14329;452;15477;15578;5.19;0.32;308.35;14.42;1148;81;5363.00;101
14332;80;626165121;14332;452;15487;15590;5.17;0.31;308.36;14.41;1155;81;5364.00;103
14335;80;626165140;14335;452;15487;15590;5.09;0.31;308.32;14.41;1152;81;5365.00;103
14339;80;626165158;14339;450;15488;15590;5.06;0.31;308.31;14.41;1149;81;5366.00;102
14341;80;626165173;14341;454;15488;15590;5.05;0.31;308.29;14.41;1147;81;5367.00;102
14343;80;626165188;14343;442;15488;15590;5.06;0.31;308.35;14.41;1145;81;5368.00;102
14348;80;626165203;14348;442;15489;15590;5.02;0.31;308.33;14.46;1141;81;5369.00;101
14349;80;626165219;14349;431;15492;15594;5.04;0.31;308.34;14.45;1143;81;5370.00;102
14352;80;626165233;14352;424;15492;15594;5.01;0.31;308.33;14.45;1140;81;5371.00;102
14358;80;626165248;14358;418;15495;15598;4.97;0.30;308.30;14.45;1137;81;5372.00;103
14361;80;626165263;14361;409;15497;15599;4.95;0.30;308.27;14.45;1136;81;5373.00;102
14363;80;626165276;14363;407;15498;15599;4.89;0.30;308.26;14.47;1135;81;5374.00;101
14366;80;626165292;14366;403;15499;15599;4.85;0.30;308.23;14.48;1133;81;5375.00;100
14367;80;626165305;14367;399;15509;15612;4.90;0.30;308.21;14.47;1142;81;5376.00;103
14367;80;626165321;14367;400;15509;15612;4.91;0.30;308.21;14.47;1142;81;5377.00;103
14369;80;626165335;14369;403;15510;15612;4.94;0.30;308.21;14.47;1141;81;5378.00;102
14370;80;626165349;14370;404;15511;15613;5.01;0.31;308.21;14.47;1141;81;5379.00;102
14374;80;626165362;14374;409;15511;15614;5.03;0.31;308.17;14.47;1137;81;5380.00;103
14377;80;626165377;14377;408;15511;15614;5.05;0.31;308.13;14.47;1134;81;5381.00;103
14378;80;626165390;14378;413;15513;15617;5.13;0.31;308.11;14.47;1135;81;5382.00;104
14380;80;626165404;14380;414;15514;15617;5.16;0.32;308.11;14.47;1134;81;5383.00;103
14381;80;626165417;14381;416;15514;15617;5.17;0.32;308.10;14.47;1133;81;5384.00;103
14385;80;626165431;14385;417;15514;15617;5.14;0.31;308.10;14.47;1129;81;5385.00;103
14387;80;626165446;14387;408;15518;15623;5.14;0.31;308.08;14.46;1131;81;5386.00;105
14387;80;626165461;14387;397;15519;15623;5.11;0.31;308.08;14.46;1132;81;5387.00;104
14389;80;626165477;14389;398;15521;15623;5.09;0.31;308.05;14.55;1132;81;5388.00;102
14390;80;626165491;14390;386;15521;15623;5.13;0.31;308.06;14.55;1131;81;5389.00;102
14392;80;626165505;14392;385;15524;15627;5.16;0.31;308.04;14.55;1132;81;5390.00;103
14392;80;626165520;14392;377;15526;15628;5.20;0.32;308.04;14.59;1134;81;5391.00;102
14394;80;626165535;14394;373;15526;15628;5.23;0.32;308.02;14.59;1132;81;5392.00;102
14397;80;626165550;14397;368;15528;15629;5.23;0.32;307.99;14.64;1131;81;5393.00;101
14399;80;626165565;14399;371;15528;15629;5.25;0.32;307.97;14.64;1129;81;5394.00;101
14400;80;626165580;14400;366;15528;15629;5.32;0.32;308.00;14.64;1128;81;5395.00;101
14401;80;626165595;14401;365;15529;15629;5.38;0.33;307.99;14.64;1128;81;5396.00;100
14402;80;626165612;14402;368;15529;15629;5.42;0.33;307.98;14.64;1127;81;5397.00;100
14403;80;626165627;14403;374;15529;15629;5.46;0.33;307.98;14.64;1126;81;5398.00;100
14404;80;626165648;14404;381;15531;15629;5.51;0.33;307.98;14.67;1127;81;5399.00;98
