step_arrived;step_collisions;step_duration;step_ended;step_halting;step_inserted;step_loaded;step_meanSpeed;step_meanSpeedRelative;step_meanTravelTime;step_meanWaitingTime;step_running;step_teleports;step_time;step_waiting
0;0;625503474;0;1;87;245;16.27;1.14;-1.00;0.00;87;0;0.00;158
0;0;625503503;0;0;102;245;15.39;1.06;-1.00;0.15;102;0;1.00;143
0;0;625503504;0;1;122;245;14.59;0.99;-1.00;0.45;122;0;2.00;123
0;0;625503505;0;2;139;245;13.45;0.91;-1.00;0.76;139;0;3.00;106
0;0;625503506;0;2;148;245;12.64;0.85;-1.00;0.96;148;0;4.00;97
0;0;625503508;0;3;157;245;11.73;0.78;-1.00;1.19;157;0;5.00;88
0;0;625503509;0;7;166;245;11.02;0.73;-1.00;1.45;166;0;6.00;79
0;0;625503511;0;9;173;245;10.33;0.69;-1.00;1.68;173;0;7.00;72
0;0;625503513;0;17;179;246;9.94;0.66;-1.00;1.89;179;0;8.00;67
0;0;625503516;0;18;184;247;9.65;0.64;-1.00;2.08;184;0;9.00;63
0;0;625503518;0;20;192;247;9.33;0.62;-1.00;2.38;192;0;10.00;55
0;0;625503520;0;21;197;248;9.28;0.61;-1.00;2.54;197;0;11.00;51
1;0;625503523;1;25;203;248;9.05;0.60;12.00;2.82;202;0;12.00;45
1;0;625503525;1;32;205;248;9.13;0.60;12.00;2.92;204;0;13.00;43
1;0;625503528;1;34;206;248;9.22;0.60;12.00;2.98;205;0;14.00;42
1;0;625503530;1;39;213;252;9.10;0.59;12.00;3.24;212;0;15.00;39
1;0;625503533;1;42;217;252;8.97;0.58;12.00;3.47;216;0;16.00;35
1;0;625503536;1;45;221;252;8.85;0.57;12.00;3.72;220;0;17.00;31
2;0;625503539;2;48;224;255;8.93;0.57;15.00;3.83;222;0;18.00;31
2;0;625503542;2;54;228;255;8.94;0.57;15.00;4.10;226;0;19.00;27
2;0;625503545;2;59;229;255;8.98;0.57;15.00;4.17;227;0;20.00;26
3;0;625503548;3;62;237;259;9.13;0.58;17.00;4.40;234;0;21.00;22
4;0;625503551;4;66;240;260;9.14;0.57;18.25;4.53;236;0;22.00;20
5;0;625503555;5;69;242;260;9.14;0.57;19.20;4.68;237;0;23.00;18
5;0;625503557;5;71;246;264;9.08;0.57;19.20;4.70;241;0;24.00;18
6;0;625503561;6;75;250;264;8.85;0.55;19.83;4.97;244;0;25.00;14
6;0;625503564;6;80;250;264;8.89;0.55;19.83;4.97;244;0;26.00;14
6;0;625503567;6;84;253;265;8.88;0.55;19.83;5.20;247;0;27.00;12
6;0;625503570;6;87;254;265;9.01;0.56;19.83;5.23;248;0;28.00;11
6;0;625503573;6;88;260;271;8.92;0.55;19.83;5.28;254;0;29.00;11
7;0;625503579;7;90;262;271;8.84;0.54;20.86;5.30;255;0;30.00;9
7;0;625503582;7;93;265;272;8.64;0.53;20.86;5.48;258;0;31.00;7
7;0;625503586;7;94;266;272;8.63;0.53;20.86;5.47;259;0;32.00;6
7;0;625503589;7;99;266;272;8.62;0.53;20.86;5.47;259;0;33.00;6
7;0;625503592;7;104;267;272;8.58;0.53;20.86;5.49;260;0;34.00;5
9;0;625503595;9;109;268;272;8.59;0.53;23.33;5.49;259;0;35.00;4
10;0;625503598;10;114;280;284;8.75;0.54;24.20;5.26;270;0;36.00;4
10;0;625503603;10;114;280;284;8.72;0.54;24.20;5.26;270;0;37.00;4
10;0;625503606;10;117;280;284;8.71;0.54;24.20;5.26;270;0;38.00;4
11;0;625503609;11;119;280;284;8.52;0.53;25.55;5.26;269;0;39.00;4
11;0;625503612;11;122;280;284;8.37;0.52;25.55;5.26;269;0;40.00;4
12;0;625503615;12;125;280;284;8.16;0.50;26.42;5.26;268;0;41.00;4
14;0;625503619;14;127;284;288;7.99;0.49;26.93;5.20;270;0;42.00;4
14;0;625503622;14;132;284;288;7.88;0.49;26.93;5.20;270;0;43.00;4
15;0;625503625;15;136;287;292;7.83;0.48;27.93;5.15;272;0;44.00;5
15;0;625503629;15;139;289;294;7.85;0.48;27.93;5.12;274;0;45.00;5
15;0;625503632;15;143;290;294;7.74;0.48;27.93;5.11;275;0;46.00;4
16;0;625503635;16;142;290;294;7.64;0.47;28.56;5.11;274;0;47.00;4
16;0;625503638;16;144;302;307;7.86;0.49;28.56;4.91;286;0;48.00;5
16;0;625503642;16;149;302;307;7.69;0.48;28.56;4.91;286;0;49.00;5
17;0;625503644;17;151;302;307;7.52;0.47;29.41;4.91;285;0;50.00;5
18;0;625503647;18;151;303;308;7.52;0.47;30.61;4.89;285;0;51.00;5
18;0;625503650;18;151;304;309;7.44;0.46;30.61;4.88;286;0;52.00;5
18;0;625503653;18;153;304;309;7.41;0.46;30.61;4.88;286;0;53.00;5
19;0;625503656;19;155;306;312;7.40;0.46;31.84;4.85;287;0;54.00;6
20;0;625503659;20;158;306;312;7.33;0.46;31.90;4.85;286;0;55.00;6
20;0;625503662;20;146;307;312;7.36;0.46;31.90;4.84;287;0;56.00;5
21;0;625503665;21;140;307;312;7.24;0.45;31.38;4.84;286;0;57.00;5
22;0;625503668;22;138;312;318;7.29;0.45;32.59;4.78;290;0;58.00;6
24;0;625503672;24;140;312;318;7.33;0.45;34.75;4.78;288;0;59.00;6
25;0;625503677;25;140;313;318;7.41;0.46;35.68;4.77;288;0;60.00;5
26;0;625503680;26;146;313;318;7.48;0.46;36.54;4.77;287;0;61.00;5
26;0;625503683;26;146;317;322;7.52;0.46;36.54;4.73;291;0;62.00;5
28;0;625503686;28;150;318;323;7.69;0.47;37.21;4.71;290;0;63.00;5
29;0;625503690;29;150;318;323;7.71;0.47;36.69;4.71;289;0;64.00;5
29;0;625503694;29;152;319;324;7.81;0.48;36.69;4.70;290;0;65.00;5
29;0;625503699;29;154;319;324;7.83;0.48;36.69;4.70;290;0;66.00;5
30;0;625503703;30;145;319;324;7.93;0.49;37.70;4.70;289;0;67.00;5
30;0;625503707;30;141;319;324;8.03;0.49;37.70;4.70;289;0;68.00;5
30;0;625503709;30;136;319;324;8.12;0.50;37.70;4.70;289;0;69.00;5
31;0;625503712;31;131;319;324;8.32;0.51;38.58;4.70;288;0;70.00;5
33;0;625503715;33;127;319;324;8.43;0.51;40.55;4.70;286;0;71.00;5
34;0;625503718;34;133;356;394;8.68;0.53;41.21;4.21;322;0;72.00;38
35;0;625503727;35;125;357;395;8.80;0.54;42.11;4.20;322;0;73.00;38
36;0;625503731;36;119;363;395;9.08;0.55;43.00;4.17;327;0;74.00;32
36;0;625503740;36;117;368;395;9.27;0.56;43.00;4.15;332;0;75.00;27
36;0;625503744;36;114;372;395;9.45;0.57;43.00;4.15;336;0;76.00;23
36;0;625503755;36;111;375;395;9.55;0.58;43.00;4.15;339;0;77.00;20
36;0;625503765;36;110;378;395;9.56;0.58;43.00;4.17;342;0;78.00;17
36;0;625503769;36;109;378;395;9.59;0.58;43.00;4.17;342;0;79.00;17
36;0;625503773;36;115;380;396;9.56;0.58;43.00;4.17;344;0;80.00;16
37;0;625503783;37;113;381;397;9.56;0.58;44.03;4.16;344;0;81.00;16
38;0;625503787;38;114;382;397;9.53;0.58;44.61;4.18;344;0;82.00;15
40;0;625503791;40;121;386;401;9.22;0.56;46.30;4.14;346;0;83.00;15
40;0;625503803;40;123;386;401;9.19;0.56;46.30;4.14;346;0;84.00;15
40;0;625503808;40;128;386;401;9.13;0.56;46.30;4.14;346;0;85.00;15
42;0;625503812;42;130;386;401;9.00;0.55;48.19;4.14;344;0;86.00;15
42;0;625503817;42;134;390;407;9.00;0.55;48.19;4.11;348;0;87.00;17
43;0;625503821;43;134;390;407;8.89;0.54;49.12;4.11;347;0;88.00;17
45;0;625503825;45;133;391;407;8.84;0.54;50.80;4.11;346;0;89.00;16
47;0;625503832;47;137;394;413;8.63;0.52;52.47;4.08;347;0;90.00;19
48;0;625503837;48;132;395;413;8.60;0.52;53.27;4.07;347;0;91.00;18
48;0;625503841;48;136;395;413;8.62;0.52;53.27;4.07;347;0;92.00;18
49;0;625503845;49;135;397;414;8.63;0.52;54.08;4.06;348;0;93.00;17
49;0;625503849;49;135;398;415;8.68;0.53;54.08;4.05;349;0;94.00;17
51;0;625503852;51;137;399;415;8.64;0.53;55.69;4.05;348;0;95.00;16
52;0;625503856;52;137;409;428;8.56;0.52;56.46;3.95;357;0;96.00;19
55;0;625503861;55;138;410;428;8.54;0.52;57.36;3.95;355;0;97.00;18
57;0;625503865;57;137;410;428;8.62;0.52;58.68;3.95;353;0;98.00;18
60;0;625503869;60;134;411;429;8.63;0.53;60.68;3.94;351;0;99.00;18
60;0;625503874;60;130;411;429;8.77;0.54;60.68;3.94;351;0;100.00;18
62;0;625503882;62;127;413;433;8.86;0.54;61.97;3.92;351;0;101.00;20
62;0;625503887;62;119;413;433;9.00;0.55;61.97;3.92;351;0;102.00;20
62;0;625503892;62;117;418;437;9.05;0.55;61.97;3.89;356;0;103.00;19
63;0;625503897;63;111;420;437;9.17;0.56;62.51;4.03;357;0;104.00;17
65;0;625503903;65;104;420;437;9.29;0.56;63.46;4.03;355;0;105.00;17
65;0;625503909;65;99;420;437;9.50;0.58;63.46;4.03;355;0;106.00;17
66;1;625503914;66;94;420;437;9.61;0.59;64.09;4.03;354;1;107.00;17
66;1;625503925;66;88;430;449;9.75;0.60;64.09;3.93;364;1;108.00;19
67;1;625503931;67;83;431;449;9.94;0.61;64.76;3.93;364;1;109.00;18
67;1;625503940;67;76;432;449;10.19;0.62;64.76;3.92;365;1;110.00;17
67;1;625503947;67;73;432;449;10.28;0.63;64.76;3.92;365;1;111.00;17
67;1;625503953;67;74;432;449;10.48;0.64;64.76;3.92;365;1;112.00;17
68;1;625503958;68;68;432;449;10.65;0.65;65.46;3.92;364;1;113.00;17
69;1;625503963;69;66;433;450;10.80;0.66;66.12;3.91;364;1;114.00;17
71;1;625503969;71;68;433;450;10.92;0.67;66.99;3.91;362;1;115.00;17
72;1;625503974;72;66;437;456;11.11;0.68;67.38;3.89;365;1;116.00;19
72;1;625503981;72;66;441;457;11.10;0.68;67.38;4.22;369;1;117.00;16
73;1;625503987;73;69;441;457;11.19;0.68;67.41;4.22;368;1;118.00;16
73;1;625503998;73;72;442;457;11.26;0.69;67.41;4.32;369;1;119.00;15
74;1;625504006;74;75;447;462;11.42;0.70;68.11;4.54;373;1;120.00;15
75;1;625504012;75;73;449;462;11.52;0.71;68.76;4.74;374;1;121.00;13
78;1;625504019;78;73;450;462;11.55;0.71;70.78;5.00;372;1;122.00;12
80;1;625504024;80;73;453;463;11.64;0.71;71.80;5.19;373;1;123.00;10
80;1;625504031;80;75;457;467;11.66;0.71;71.80;5.16;377;1;124.00;10
82;1;625504037;82;77;460;467;11.65;0.71;73.09;5.53;378;1;125.00;7
84;1;625504044;84;81;462;470;11.72;0.71;74.21;5.51;378;1;126.00;8
84;1;625504051;84;85;463;470;11.84;0.72;74.21;5.50;379;1;127.00;7
84;1;625504058;84;84;464;470;11.90;0.73;74.21;5.66;380;1;128.00;6
84;1;625504065;84;85;465;470;11.97;0.73;74.21;5.68;381;1;129.00;5
87;1;625504071;87;85;468;474;12.04;0.73;75.64;5.65;381;1;130.00;6
88;1;625504078;88;83;468;474;12.15;0.74;76.27;5.65;380;1;131.00;6
90;1;625504084;90;86;471;474;12.30;0.75;76.71;5.87;381;1;132.00;3
90;1;625504091;90;87;471;474;12.34;0.75;76.71;5.87;381;1;133.00;3
92;1;625504097;92;88;473;475;12.33;0.75;76.76;5.93;381;1;134.00;2
94;1;625504104;94;89;475;477;12.36;0.75;77.96;5.91;381;1;135.00;2
95;1;625504111;95;91;476;477;12.27;0.75;78.31;5.98;381;1;136.00;1
96;1;625504119;96;94;477;478;12.18;0.74;78.92;5.97;381;1;137.00;1
97;1;625504127;97;95;478;478;12.07;0.74;79.53;5.99;381;1;138.00;0
99;1;625504134;99;98;478;478;12.01;0.74;79.97;5.99;379;1;139.00;0
101;1;625504142;101;100;478;478;11.90;0.73;80.72;5.99;377;1;140.00;0
103;1;625504148;103;101;478;478;11.82;0.73;80.84;5.99;375;1;141.00;0
103;1;625504155;103;103;478;478;11.79;0.73;80.84;5.99;375;1;142.00;0
106;1;625504161;106;105;478;478;11.66;0.72;81.57;5.99;372;1;143.00;0
107;1;625504167;107;126;551;605;11.25;0.71;82.12;5.21;444;1;144.00;54
107;1;625504185;107;118;558;606;11.16;0.70;82.12;5.15;451;1;145.00;48
107;1;625504194;107;117;568;606;11.18;0.70;82.12;5.10;461;1;146.00;38
110;1;625504203;110;119;569;606;11.03;0.70;82.65;5.09;459;1;147.00;37
111;1;625504211;111;121;576;606;11.11;0.70;82.38;5.08;465;1;148.00;30
112;1;625504219;112;122;578;606;11.00;0.69;82.97;5.08;466;1;149.00;28
113;1;625504232;113;122;584;611;10.98;0.69;83.47;5.08;471;1;150.00;27
116;1;625504245;116;119;586;611;10.81;0.68;85.13;5.09;470;1;151.00;25
119;1;625504254;119;121;589;612;10.72;0.67;86.80;5.10;470;1;152.00;23
124;1;625504261;124;123;594;613;10.70;0.67;89.23;5.13;470;1;153.00;19
128;1;625504269;128;123;596;613;10.67;0.67;88.66;5.15;468;1;154.00;17
128;1;625504276;128;126;598;614;10.63;0.67;88.66;5.15;470;1;155.00;16
129;1;625504283;129;131;602;614;10.66;0.67;89.04;5.18;473;1;156.00;12
129;1;625504290;129;136;603;614;10.67;0.67;89.04;5.19;474;1;157.00;11
130;2;625504296;130;139;605;614;10.63;0.66;89.56;5.22;475;2;158.00;9
133;2;625504315;133;144;608;618;10.63;0.66;90.86;5.22;475;2;159.00;10
136;3;625504322;136;149;610;618;10.58;0.66;91.77;5.26;474;3;160.00;8
138;3;625504346;138;150;610;618;10.51;0.65;92.63;5.26;472;3;161.00;8
140;3;625504353;140;151;613;621;10.41;0.65;93.59;5.26;473;3;162.00;8
143;3;625504359;143;153;614;621;10.32;0.64;93.71;5.26;471;3;163.00;7
145;3;625504371;145;147;614;621;10.24;0.63;94.61;5.26;469;3;164.00;7
149;3;625504377;149;147;617;625;10.07;0.62;95.59;5.24;468;3;165.00;8
151;3;625504383;151;148;618;626;10.02;0.62;95.34;5.23;467;3;166.00;8
155;3;625504389;155;146;619;626;9.91;0.61;95.83;5.25;464;3;167.00;7
155;3;625504396;155;144;625;630;9.82;0.60;95.83;5.24;470;3;168.00;5
158;3;625504408;158;146;625;630;9.56;0.59;97.18;5.24;467;3;169.00;5
159;3;625504415;159;137;627;630;9.49;0.58;97.50;5.26;468;3;170.00;3
161;3;625504421;161;137;628;631;9.44;0.58;97.67;5.26;467;3;171.00;3
163;3;625504427;163;130;630;631;9.42;0.58;98.48;5.30;467;3;172.00;1
164;3;625504432;164;132;635;637;9.39;0.57;98.89;5.27;471;3;173.00;2
164;3;625504445;164;128;636;637;9.38;0.57;98.89;5.26;472;3;174.00;1
164;3;625504456;164;125;637;638;9.27;0.57;98.89;5.25;473;3;175.00;1
164;3;625504463;164;124;638;638;9.24;0.56;98.89;5.29;474;3;176.00;0
164;3;625504470;164;121;638;638;9.19;0.56;98.89;5.29;474;3;177.00;0
164;3;625504475;164;123;638;638;9.20;0.56;98.89;5.29;474;3;178.00;0
165;3;625504481;165;121;638;638;9.36;0.57;99.38;5.29;473;3;179.00;0
165;3;625504488;165;126;668;672;9.43;0.58;99.38;5.05;503;3;180.00;4
167;3;625504496;167;125;668;672;9.57;0.59;99.83;5.05;501;3;181.00;4
168;3;625504503;168;128;669;672;9.65;0.59;99.54;5.04;501;3;182.00;3
168;3;625504515;168;129;670;672;9.71;0.60;99.54;5.04;502;3;183.00;2
168;3;625504522;168;134;670;672;9.82;0.61;99.54;5.04;502;3;184.00;2
170;3;625504528;170;135;671;672;9.88;0.61;100.09;5.04;501;3;185.00;1
173;3;625504535;173;139;675;676;9.84;0.61;100.08;5.02;502;3;186.00;1
174;3;625504541;174;143;676;676;9.82;0.61;99.80;5.02;502;3;187.00;0
177;3;625504554;177;150;678;680;9.75;0.60;100.36;5.01;501;3;188.00;2
178;3;625504562;178;157;680;681;9.73;0.60;100.31;5.00;502;3;189.00;1
181;3;625504569;181;164;680;681;9.58;0.59;100.21;5.00;499;3;190.00;1
183;3;625504576;183;169;681;681;9.48;0.58;100.92;5.00;498;3;191.00;0
184;3;625504582;184;175;693;694;9.47;0.59;101.33;4.91;509;3;192.00;1
187;3;625504596;187;183;694;694;9.39;0.58;100.62;4.90;507;3;193.00;0
191;3;625504603;191;188;694;694;9.23;0.57;100.88;4.90;503;3;194.00;0
194;3;625504609;194;193;695;695;9.07;0.56;101.30;4.90;501;3;195.00;0
195;3;625504617;195;193;696;696;8.95;0.55;101.79;4.89;501;3;196.00;0
198;3;625504623;198;193;696;696;8.89;0.55;101.15;4.89;498;3;197.00;0
202;4;625504630;202;196;698;699;8.85;0.54;101.37;4.88;496;4;198.00;1
202;4;625504655;202;196;698;699;8.78;0.54;101.37;4.88;496;4;199.00;1
203;4;625504663;203;201;699;699;8.69;0.53;101.38;4.87;496;4;200.00;0
205;4;625504673;205;205;699;699;8.54;0.53;101.59;4.87;494;4;201.00;0
208;4;625504679;208;209;703;705;8.48;0.52;102.46;4.85;495;4;202.00;2
208;4;625504687;208;213;703;705;8.42;0.52;102.46;4.85;495;4;203.00;2
212;4;625504694;212;223;705;705;8.28;0.51;103.05;4.85;493;4;204.00;0
215;4;625504700;215;225;705;705;8.19;0.50;102.85;4.85;490;4;205.00;0
216;4;625504706;216;228;709;709;8.13;0.50;103.32;4.83;493;4;206.00;0
218;4;625504713;218;232;710;710;8.01;0.49;102.82;4.82;492;4;207.00;0
219;4;625504719;219;235;710;710;7.93;0.49;103.19;4.82;491;4;208.00;0
221;4;625504725;221;236;711;711;7.79;0.48;102.52;4.81;490;4;209.00;0
223;4;625504733;223;242;711;711;7.62;0.47;102.65;4.81;488;4;210.00;0
223;4;625504739;223;245;711;711;7.54;0.46;102.65;4.81;488;4;211.00;0
223;4;625504746;223;248;711;711;7.42;0.46;102.65;4.81;488;4;212.00;0
223;4;625504751;223;252;711;711;7.37;0.45;102.65;4.81;488;4;213.00;0
225;4;625504757;225;255;711;711;7.32;0.45;102.65;4.81;486;4;214.00;0
226;5;625504764;226;256;711;711;7.27;0.45;102.72;4.81;485;5;215.00;0
226;5;625504786;226;269;753;781;7.38;0.46;102.72;4.54;527;5;216.00;28
226;5;625504798;226;250;755;782;7.42;0.46;102.72;4.54;529;5;217.00;27
227;5;625504805;227;243;762;782;7.61;0.47;102.59;4.51;535;5;218.00;20
228;5;625504811;228;223;765;782;7.77;0.48;103.10;4.51;537;5;219.00;17
229;5;625504818;229;210;769;782;8.03;0.50;103.42;4.50;540;5;220.00;13
231;5;625504826;231;204;773;782;8.25;0.51;104.39;4.51;542;5;221.00;9
234;5;625504833;234;199;777;782;8.42;0.52;105.59;4.51;543;5;222.00;5
236;6;625504840;236;195;780;782;8.51;0.52;106.56;4.52;544;6;223.00;2
238;6;625504856;238;189;782;783;8.60;0.53;107.18;4.52;544;6;224.00;1
239;6;625504863;239;188;784;785;8.68;0.53;107.66;4.51;545;6;225.00;1
243;7;625504877;243;165;785;785;8.85;0.54;108.47;4.52;542;7;226.00;0
243;7;625504901;243;151;789;789;8.92;0.55;108.47;4.50;546;7;227.00;0
244;7;625504909;244;141;789;789;9.06;0.55;108.95;4.50;545;7;228.00;0
245;7;625504918;245;129;789;789;9.20;0.56;108.93;4.50;544;7;229.00;0
245;7;625504928;245;125;789;789;9.32;0.57;108.93;4.50;544;7;230.00;0
246;7;625504942;246;122;794;795;9.46;0.58;108.85;4.48;548;7;231.00;1
247;7;625504951;247;121;794;795;9.60;0.59;109.32;4.48;547;7;232.00;1
250;7;625504959;250;116;795;795;9.74;0.59;109.94;4.48;545;7;233.00;0
251;7;625504968;251;111;797;798;9.92;0.60;110.43;4.47;546;7;234.00;1
252;7;625504976;252;110;798;798;10.05;0.61;110.36;4.46;546;7;235.00;0
253;7;625504985;253;108;798;798;10.09;0.62;110.47;4.46;545;7;236.00;0
256;7;625504992;256;100;799;799;10.15;0.62;110.44;4.46;543;7;237.00;0
257;7;625505000;257;92;800;800;10.26;0.62;110.65;4.45;543;7;238.00;0
258;8;625505008;258;92;800;800;10.32;0.63;111.11;4.45;542;8;239.00;0
261;8;625505035;261;93;824;826;10.22;0.62;110.98;4.32;563;8;240.00;2
264;8;625505045;264;93;825;826;10.32;0.63;111.72;4.32;561;8;241.00;1
265;8;625505053;265;94;826;826;10.44;0.64;112.16;4.32;561;8;242.00;0
266;8;625505061;266;96;827;827;10.49;0.64;111.95;4.31;561;8;243.00;0
267;8;625505068;267;99;827;827;10.52;0.64;112.18;4.31;560;8;244.00;0
268;8;625505076;268;104;830;831;10.56;0.65;112.41;4.30;562;8;245.00;1
270;8;625505084;270;107;830;831;10.62;0.65;112.86;4.30;560;8;246.00;1
273;8;625505097;273;110;835;835;10.58;0.65;113.94;4.28;562;8;247.00;0
275;8;625505104;275;112;835;835;10.61;0.65;114.24;4.28;560;8;248.00;0
278;9;625505112;278;117;835;835;10.62;0.65;114.41;4.28;557;9;249.00;0
282;9;625505131;282;119;835;835;10.60;0.65;114.89;4.28;553;9;250.00;0
285;9;625505145;285;117;835;835;10.58;0.64;115.70;4.28;550;9;251.00;0
288;9;625505154;288;126;845;847;10.45;0.64;116.56;4.23;557;9;252.00;2
289;9;625505167;289;133;845;847;10.42;0.63;116.68;4.23;556;9;253.00;2
289;9;625505177;289;136;847;847;10.36;0.63;116.68;4.23;558;9;254.00;0
291;9;625505197;291;145;847;847;10.29;0.63;117.20;4.23;556;9;255.00;0
293;9;625505208;293;148;847;847;10.20;0.62;118.04;4.23;554;9;256.00;0
295;9;625505219;295;147;847;847;10.13;0.62;118.25;4.23;552;9;257.00;0
297;9;625505229;297;151;848;848;10.07;0.61;118.65;4.22;551;9;258.00;0
298;9;625505240;298;158;848;848;9.97;0.61;119.12;4.22;550;9;259.00;0
299;9;625505258;299;155;853;854;9.91;0.60;119.43;4.20;554;9;260.00;1
301;9;625505267;301;151;854;855;9.90;0.60;119.44;4.20;553;9;261.00;1
304;9;625505275;304;147;855;855;9.91;0.60;119.31;4.20;551;9;262.00;0
305;9;625505283;305;139;855;855;9.92;0.60;119.47;4.20;550;9;263.00;0
307;9;625505291;307;141;859;859;10.00;0.61;119.90;4.18;552;9;264.00;0
309;9;625505298;309;136;859;859;10.05;0.61;120.09;4.18;550;9;265.00;0
310;9;625505305;310;136;859;859;10.18;0.62;119.98;4.18;549;9;266.00;0
314;9;625505314;314;136;860;860;10.29;0.62;121.52;4.17;546;9;267.00;0
316;9;625505321;316;141;864;864;10.37;0.63;122.16;4.16;548;9;268.00;0
318;9;625505330;318;128;864;864;10.51;0.64;121.97;4.16;546;9;269.00;0
321;9;625505339;321;125;867;870;10.58;0.64;122.57;4.14;546;9;270.00;3
325;9;625505348;325;122;867;870;10.64;0.64;122.71;4.14;542;9;271.00;3
328;9;625505354;328;118;868;870;10.73;0.65;122.75;4.14;540;9;272.00;2
330;9;625505361;330;111;868;870;10.81;0.65;123.22;4.14;538;9;273.00;2
330;9;625505368;330;106;871;874;10.92;0.66;123.22;4.13;541;9;274.00;3
332;9;625505375;332;103;871;874;10.99;0.66;123.27;4.13;539;9;275.00;3
333;9;625505383;333;96;872;874;11.17;0.68;123.30;4.14;539;9;276.00;2
337;9;625505391;337;94;872;874;11.28;0.68;123.70;4.14;535;9;277.00;2
338;9;625505398;338;88;874;875;11.37;0.69;123.73;4.13;536;9;278.00;1
339;9;625505405;339;87;875;876;11.37;0.69;123.76;4.13;536;9;279.00;1
344;9;625505413;344;85;876;876;11.34;0.69;124.73;4.13;532;9;280.00;0
345;9;625505421;345;83;877;877;11.39;0.69;124.55;4.13;532;9;281.00;0
347;9;625505430;347;81;877;877;11.41;0.69;124.63;4.13;530;9;282.00;0
348;9;625505437;348;84;877;877;11.53;0.70;124.93;4.13;529;9;283.00;0
350;9;625505445;350;83;877;877;11.60;0.70;125.11;4.13;527;9;284.00;0
351;9;625505453;351;83;877;877;11.63;0.71;125.16;4.13;526;9;285.00;0
353;9;625505460;353;80;877;877;11.67;0.71;125.25;4.13;524;9;286.00;0
353;9;625505469;353;82;877;877;11.67;0.71;125.25;4.13;524;9;287.00;0
354;9;625505477;354;99;950;1004;11.25;0.69;125.66;3.81;596;9;288.00;54
354;9;625505496;354;90;952;1005;11.33;0.70;125.66;3.81;598;9;289.00;53
354;9;625505506;354;90;962;1005;11.44;0.71;125.66;3.79;608;9;290.00;43
355;9;625505515;355;89;964;1005;11.48;0.71;125.92;3.79;609;9;291.00;41
357;9;625505530;357;88;969;1005;11.56;0.71;126.56;3.79;612;9;292.00;36
357;9;625505545;357;86;973;1005;11.64;0.72;126.56;3.79;616;9;293.00;32
359;9;625505554;359;89;979;1005;11.72;0.72;126.59;3.81;620;9;294.00;26
361;9;625505569;361;88;982;1005;11.83;0.73;126.72;3.82;621;9;295.00;23
362;9;625505579;362;86;985;1006;11.97;0.74;126.40;3.83;623;9;296.00;21
368;9;625505589;368;86;988;1007;12.07;0.74;126.55;3.85;620;9;297.00;19
369;9;625505600;369;87;991;1007;12.15;0.75;126.43;3.86;622;9;298.00;16
371;9;625505609;371;88;992;1008;12.17;0.75;126.76;3.86;621;9;299.00;16
372;9;625505621;372;93;995;1014;12.03;0.74;126.89;3.88;623;9;300.00;19
375;9;625505643;375;99;996;1014;11.93;0.73;127.82;3.89;621;9;301.00;18
377;9;625505653;377;105;999;1014;11.79;0.72;127.97;3.92;622;9;302.00;15
378;9;625505664;378;108;1002;1018;11.75;0.72;127.96;3.92;624;9;303.00;16
379;9;625505674;379;114;1006;1018;11.69;0.72;128.37;3.96;627;9;304.00;12
380;9;625505684;380;120;1007;1018;11.67;0.72;128.75;3.97;627;9;305.00;11
383;9;625505693;383;128;1010;1021;11.65;0.71;129.08;3.98;627;9;306.00;11
385;9;625505705;385;132;1011;1021;11.66;0.71;129.77;3.97;626;9;307.00;10
386;9;625505714;386;137;1012;1021;11.58;0.71;129.93;3.98;626;9;308.00;9
386;9;625505723;386;143;1015;1025;11.38;0.70;129.93;3.97;629;9;309.00;10
389;9;625505739;389;149;1016;1026;11.28;0.69;130.36;3.97;627;9;310.00;10
392;9;625505749;392;154;1016;1026;11.11;0.68;131.10;3.97;624;9;311.00;10
392;9;625505758;392;154;1021;1030;11.03;0.68;131.10;3.96;629;9;312.00;9
398;9;625505768;398;154;1021;1030;10.89;0.67;132.07;3.96;623;9;313.00;9
400;9;625505777;400;164;1022;1030;10.79;0.67;132.67;3.97;622;9;314.00;8
403;9;625505791;403;170;1024;1032;10.69;0.66;133.45;3.96;621;9;315.00;8
404;9;625505800;404;174;1024;1032;10.63;0.66;133.78;3.96;620;9;316.00;8
410;9;625505814;410;178;1028;1038;10.48;0.65;134.97;3.95;618;9;317.00;10
411;9;625505824;411;179;1028;1038;10.34;0.64;134.83;3.95;617;9;318.00;10
416;9;625505833;416;179;1029;1039;10.21;0.63;136.04;3.95;613;9;319.00;10
418;9;625505842;418;179;1032;1039;10.07;0.62;135.96;4.02;614;9;320.00;7
423;9;625505851;423;190;1032;1039;10.06;0.62;136.62;4.02;609;9;321.00;7
425;9;625505859;425;191;1032;1039;10.03;0.61;136.73;4.02;607;9;322.00;7
427;9;625505874;427;190;1034;1039;9.97;0.61;136.86;4.05;607;9;323.00;5
430;9;625505882;430;196;1048;1051;9.97;0.61;136.96;4.07;618;9;324.00;3
431;9;625505892;431;195;1049;1051;9.95;0.61;136.98;4.07;618;9;325.00;2
434;9;625505900;434;195;1051;1051;9.99;0.61;137.38;4.07;617;9;326.00;0
437;9;625505908;437;197;1051;1051;10.00;0.61;137.97;4.07;614;9;327.00;0
439;9;625505916;439;196;1051;1051;9.98;0.61;138.32;4.07;612;9;328.00;0
440;9;625505924;440;197;1051;1051;9.97;0.61;138.25;4.07;611;9;329.00;0
442;9;625505939;442;202;1055;1055;9.90;0.61;138.82;4.06;613;9;330.00;0
443;9;625505947;443;199;1055;1055;9.88;0.60;138.61;4.06;612;9;331.00;0
445;9;625505955;445;205;1058;1059;9.86;0.60;138.50;4.05;613;9;332.00;1
448;9;625505963;448;209;1060;1060;9.76;0.60;138.87;4.04;612;9;333.00;0
452;9;625505977;452;210;1060;1060;9.58;0.58;139.82;4.04;608;9;334.00;0
454;9;625505985;454;211;1060;1060;9.49;0.58;140.20;4.04;606;9;335.00;0
459;9;625505993;459;215;1072;1073;9.31;0.57;140.83;4.00;613;9;336.00;1
460;9;625506002;460;215;1073;1073;9.24;0.57;141.26;4.00;613;9;337.00;0
467;9;625506009;467;223;1073;1073;9.05;0.55;142.21;4.00;606;9;338.00;0
472;9;625506017;472;227;1074;1074;8.86;0.54;143.05;3.99;602;9;339.00;0
474;9;625506024;474;218;1075;1075;8.70;0.54;143.42;3.99;601;9;340.00;0
479;9;625506032;479;211;1075;1075;8.59;0.53;144.05;3.99;596;9;341.00;0
484;9;625506039;484;207;1077;1078;8.49;0.52;144.63;3.98;593;9;342.00;1
485;9;625506047;485;206;1078;1078;8.45;0.52;144.59;3.98;593;9;343.00;0
488;9;625506053;488;208;1078;1078;8.46;0.52;145.02;3.98;590;9;344.00;0
491;9;625506060;491;203;1078;1078;8.47;0.52;145.85;3.98;587;9;345.00;0
494;9;625506068;494;204;1083;1084;8.53;0.52;146.01;3.97;589;9;346.00;1
494;9;625506075;494;195;1083;1084;8.51;0.52;146.01;3.97;589;9;347.00;1
494;9;625506082;494;198;1084;1084;8.50;0.52;146.01;3.96;590;9;348.00;0
499;9;625506089;499;200;1084;1084;8.41;0.52;146.16;3.96;585;9;349.00;0
502;9;625506096;502;203;1088;1088;8.37;0.51;146.44;3.95;586;9;350.00;0
504;9;625506103;504;200;1089;1089;8.34;0.51;147.20;3.95;585;9;351.00;0
507;9;625506110;507;204;1089;1089;8.32;0.51;147.68;3.95;582;9;352.00;0
510;9;625506118;510;205;1090;1090;8.29;0.51;147.95;3.95;580;9;353.00;0
511;9;625506128;511;205;1090;1090;8.18;0.51;147.88;3.95;579;9;354.00;0
516;9;625506140;516;210;1090;1090;8.06;0.50;147.34;3.95;574;9;355.00;0
522;9;625506149;522;213;1090;1090;7.97;0.49;147.51;3.95;568;9;356.00;0
526;9;625506156;526;213;1090;1090;7.90;0.49;147.54;3.95;564;9;357.00;0
529;9;625506164;529;214;1090;1090;7.81;0.48;147.87;3.95;561;9;358.00;0
533;9;625506172;533;220;1090;1090;7.61;0.47;148.18;3.95;557;9;359.00;0
534;9;625506181;534;240;1157;1215;7.86;0.49;148.10;3.72;623;9;360.00;58
537;9;625506197;537;237;1164;1216;7.79;0.49;148.20;3.70;627;9;361.00;52
540;9;625506205;540;229;1176;1216;7.93;0.50;148.69;3.69;636;9;362.00;40
543;9;625506213;543;227;1180;1216;7.91;0.49;148.87;3.68;637;9;363.00;36
545;9;625506220;545;230;1187;1216;7.92;0.49;148.60;3.68;642;9;364.00;29
547;9;625506228;547;234;1191;1216;7.95;0.49;148.80;3.69;644;9;365.00;25
549;9;625506235;549;237;1197;1216;7.98;0.50;148.82;3.70;648;9;366.00;19
552;10;625506249;552;243;1199;1216;7.92;0.49;149.21;3.71;647;10;367.00;17
555;10;625506271;555;246;1204;1217;7.87;0.49;149.18;3.72;649;10;368.00;13
559;10;625506279;559;252;1206;1218;7.72;0.48;149.32;3.73;647;10;369.00;12
560;10;625506287;560;259;1210;1218;7.60;0.47;149.41;3.75;650;10;370.00;8
562;10;625506295;562;250;1215;1222;7.51;0.46;149.00;3.74;653;10;371.00;7
562;10;625506304;562;244;1217;1222;7.56;0.47;149.00;3.75;655;10;372.00;5
563;10;625506312;563;242;1218;1222;7.57;0.47;148.89;3.76;655;10;373.00;4
565;10;625506320;565;236;1218;1222;7.59;0.47;149.06;3.76;653;10;374.00;4
565;10;625506328;565;238;1223;1228;7.65;0.47;149.06;3.76;658;10;375.00;5
567;10;625506337;567;234;1226;1228;7.70;0.47;149.29;3.78;659;10;376.00;2
567;10;625506346;567;232;1226;1228;7.82;0.48;149.29;3.78;659;10;377.00;2
569;10;625506365;569;225;1229;1231;8.01;0.49;149.43;3.77;660;10;378.00;2
570;10;625506378;570;222;1231;1231;8.08;0.50;149.51;3.78;661;10;379.00;0
571;10;625506387;571;220;1231;1231;8.17;0.50;149.28;3.78;660;10;380.00;0
574;10;625506395;574;215;1232;1232;8.24;0.50;149.46;3.78;658;10;381.00;0
576;10;625506404;576;218;1233;1233;8.28;0.51;149.14;3.78;657;10;382.00;0
577;10;625506413;577;222;1233;1233;8.39;0.51;148.92;3.78;656;10;383.00;0
578;10;625506422;578;222;1246;1246;8.55;0.52;149.02;3.74;668;10;384.00;0
578;10;625506432;578;223;1246;1246;8.57;0.53;149.02;3.74;668;10;385.00;0
581;10;625506441;581;228;1246;1246;8.63;0.53;148.96;3.74;665;10;386.00;0
583;10;625506450;583;218;1247;1247;8.74;0.53;149.01;3.73;664;10;387.00;0
584;10;625506464;584;215;1247;1247;8.76;0.53;149.29;3.73;663;10;388.00;0
584;10;625506474;584;211;1250;1251;8.85;0.54;149.29;3.73;666;10;389.00;1
585;10;625506485;585;212;1250;1251;8.85;0.54;149.45;3.73;665;10;390.00;1
587;10;625506494;587;213;1255;1255;8.88;0.54;149.16;3.72;668;10;391.00;0
591;10;625506504;591;215;1255;1255;8.88;0.54;149.75;3.72;664;10;392.00;0
592;10;625506514;592;221;1255;1255;8.92;0.54;149.55;3.72;663;10;393.00;0
594;10;625506523;594;218;1255;1255;8.88;0.54;149.76;3.72;661;10;394.00;0
596;10;625506532;596;218;1255;1255;8.85;0.54;150.15;3.72;659;10;395.00;0
598;10;625506542;598;205;1265;1267;8.87;0.54;150.49;3.69;667;10;396.00;2
599;10;625506556;599;197;1266;1267;8.94;0.54;150.66;3.69;667;10;397.00;1
601;10;625506571;601;190;1267;1267;9.04;0.55;151.34;3.69;666;10;398.00;0
602;10;625506581;602;179;1267;1267;9.11;0.56;151.36;3.69;665;10;399.00;0
605;10;625506591;605;174;1267;1267;9.17;0.56;151.93;3.69;662;10;400.00;0
605;10;625506604;605;167;1267;1267;9.23;0.56;151.93;3.69;662;10;401.00;0
610;10;625506614;610;165;1268;1268;9.28;0.57;152.20;3.68;658;10;402.00;0
614;10;625506624;614;169;1268;1268;9.37;0.57;152.13;3.68;654;10;403.00;0
617;10;625506633;617;166;1273;1274;9.48;0.58;152.97;3.67;656;10;404.00;1
618;10;625506643;618;169;1276;1276;9.64;0.59;152.92;3.67;658;10;405.00;0
620;10;625506653;620;168;1276;1276;9.76;0.60;153.40;3.67;656;10;406.00;0
621;10;625506668;621;165;1276;1276;9.83;0.60;153.72;3.67;655;10;407.00;0
623;10;625506679;623;166;1280;1280;9.91;0.61;153.79;3.65;657;10;408.00;0
627;10;625506691;627;162;1280;1280;9.92;0.61;154.05;3.65;653;10;409.00;0
629;10;625506700;629;160;1280;1280;9.97;0.61;154.54;3.65;651;10;410.00;0
630;10;625506710;630;164;1281;1281;9.97;0.61;154.90;3.65;651;10;411.00;0
634;10;625506719;634;164;1285;1285;9.96;0.61;155.33;3.64;651;10;412.00;0
637;10;625506728;637;165;1285;1285;9.97;0.61;156.22;3.64;648;10;413.00;0
642;10;625506737;642;160;1287;1288;10.11;0.62;156.88;3.64;645;10;414.00;1
643;10;625506746;643;154;1287;1288;10.25;0.63;156.84;3.64;644;10;415.00;1
645;10;625506755;645;156;1288;1288;10.31;0.63;157.45;3.64;643;10;416.00;0
650;10;625506764;650;153;1288;1288;10.33;0.63;157.98;3.64;638;10;417.00;0
651;10;625506772;651;155;1291;1292;10.42;0.64;158.03;3.63;640;10;418.00;1
655;10;625506782;655;159;1291;1292;10.47;0.64;158.68;3.63;636;10;419.00;1
659;10;625506792;659;162;1292;1292;10.52;0.64;159.24;3.63;633;10;420.00;0
663;10;625506801;663;161;1292;1292;10.54;0.64;159.67;3.63;629;10;421.00;0
669;10;625506809;669;162;1293;1293;10.51;0.64;160.36;3.63;624;10;422.00;0
669;10;625506818;669;164;1294;1294;10.54;0.64;160.36;3.63;625;10;423.00;0
674;10;625506826;674;165;1294;1294;10.47;0.64;161.62;3.63;620;10;424.00;0
677;10;625506835;677;168;1295;1295;10.39;0.63;162.17;3.62;618;10;425.00;0
680;10;625506844;680;168;1295;1295;10.32;0.63;162.36;3.62;615;10;426.00;0
682;10;625506852;682;168;1295;1295;10.21;0.62;162.35;3.62;613;10;427.00;0
684;10;625506860;684;169;1295;1295;10.22;0.62;162.64;3.62;611;10;428.00;0
686;10;625506868;686;170;1295;1295;10.19;0.62;163.39;3.62;609;10;429.00;0
689;10;625506876;689;169;1295;1295;10.13;0.62;163.71;3.62;606;10;430.00;0
691;10;625506884;691;160;1295;1295;10.18;0.62;163.61;3.62;604;10;431.00;0
692;10;625506892;692;193;1375;1422;9.67;0.60;163.78;3.42;683;10;432.00;47
695;10;625506910;695;171;1375;1423;9.73;0.60;163.86;3.42;680;10;433.00;48
697;10;625506920;697;156;1381;1423;9.96;0.61;164.18;3.41;684;10;434.00;42
699;10;625506928;699;145;1384;1423;10.03;0.62;164.17;3.41;685;10;435.00;39
704;10;625506937;704;143;1390;1423;10.14;0.62;164.88;3.41;686;10;436.00;33
705;10;625506946;705;141;1393;1423;10.18;0.63;165.05;3.41;688;10;437.00;30
708;10;625506953;708;144;1398;1423;10.29;0.63;165.19;3.42;690;10;438.00;25
710;10;625506962;710;143;1401;1423;10.32;0.63;165.06;3.43;691;10;439.00;22
716;10;625506970;716;145;1405;1424;10.34;0.63;166.00;3.44;689;10;440.00;19
718;10;625506989;718;139;1408;1425;10.39;0.63;165.86;3.45;690;10;441.00;17
723;10;625506999;723;132;1410;1425;10.42;0.63;166.11;3.46;687;10;442.00;15
724;10;625507008;724;128;1411;1426;10.41;0.63;166.20;3.47;687;10;443.00;15
729;10;625507017;729;131;1413;1426;10.38;0.63;166.66;3.48;684;10;444.00;13
732;11;625507027;732;124;1416;1426;10.35;0.63;167.23;3.50;684;11;445.00;10
734;11;625507046;734;126;1418;1426;10.31;0.63;167.60;3.51;684;11;446.00;8
737;11;625507056;737;118;1420;1430;10.29;0.63;167.92;3.52;683;11;447.00;10
739;11;625507066;739;120;1422;1430;10.26;0.62;168.15;3.53;683;11;448.00;8
741;11;625507075;741;123;1422;1430;10.23;0.62;168.36;3.53;681;11;449.00;8
745;11;625507086;745;123;1426;1436;10.25;0.62;168.95;3.52;681;11;450.00;10
745;11;625507096;745;121;1426;1436;10.29;0.62;168.95;3.52;681;11;451.00;10
747;11;625507110;747;123;1427;1436;10.32;0.63;169.18;3.52;680;11;452.00;9
750;12;625507119;750;123;1431;1440;10.30;0.63;169.25;3.52;681;12;453.00;9
751;12;625507149;751;119;1432;1441;10.39;0.63;169.25;3.52;681;12;454.00;9
754;12;625507167;754;121;1433;1441;10.48;0.64;169.24;3.52;679;12;455.00;8
758;12;625507182;758;123;1436;1445;10.53;0.64;168.98;3.52;678;12;456.00;9
761;12;625507200;761;122;1437;1445;10.59;0.64;169.16;3.53;676;12;457.00;8
761;12;625507214;761;123;1437;1445;10.75;0.65;169.16;3.53;676;12;458.00;8
764;12;625507227;764;125;1439;1446;10.89;0.66;169.44;3.54;675;12;459.00;7
764;12;625507242;764;121;1440;1446;10.96;0.67;169.44;3.55;676;12;460.00;6
764;12;625507256;764;128;1444;1452;10.98;0.67;169.44;3.54;680;12;461.00;8
766;12;625507268;766;125;1446;1452;10.94;0.67;169.44;3.56;680;12;462.00;6
769;12;625507279;769;126;1446;1453;10.84;0.66;169.47;3.56;677;12;463.00;7
769;12;625507291;769;127;1446;1453;10.78;0.66;169.47;3.56;677;12;464.00;7
772;12;625507301;772;129;1447;1453;10.67;0.65;169.37;3.58;675;12;465.00;6
774;12;625507313;774;126;1447;1453;10.63;0.65;169.58;3.58;673;12;466.00;6
776;12;625507323;776;127;1447;1453;10.63;0.64;169.42;3.58;671;12;467.00;6
777;12;625507335;777;130;1456;1465;10.70;0.65;169.43;3.56;679;12;468.00;9
778;12;625507348;778;131;1457;1465;10.76;0.65;169.62;3.57;679;12;469.00;8
779;12;625507360;779;132;1461;1465;10.79;0.66;169.54;3.59;682;12;470.00;4
779;12;625507371;779;137;1461;1465;10.81;0.66;169.54;3.59;682;12;471.00;4
780;12;625507381;780;139;1461;1465;10.86;0.66;169.46;3.59;681;12;472.00;4
782;12;625507391;782;147;1462;1465;10.99;0.67;169.41;3.60;680;12;473.00;3
786;12;625507402;786;151;1465;1469;11.00;0.67;169.55;3.59;679;12;474.00;4
789;12;625507416;789;154;1465;1469;11.03;0.67;169.29;3.59;676;12;475.00;4
793;12;625507427;793;156;1470;1473;11.08;0.67;169.29;3.60;677;12;476.00;3
793;12;625507438;793;156;1471;1474;11.12;0.68;169.29;3.60;678;12;477.00;3
796;12;625507449;796;159;1472;1474;11.14;0.68;169.44;3.60;676;12;478.00;2
797;12;625507460;797;164;1472;1474;11.17;0.68;169.24;3.60;675;12;479.00;2
799;12;625507473;799;174;1494;1500;10.98;0.67;169.33;3.56;695;12;480.00;6
801;12;625507485;801;174;1495;1500;10.87;0.66;169.65;3.56;694;12;481.00;5
803;12;625507496;803;176;1498;1500;10.87;0.66;169.64;3.56;695;12;482.00;2
803;12;625507506;803;179;1500;1501;10.82;0.66;169.64;3.55;697;12;483.00;1
804;12;625507517;804;186;1502;1502;10.71;0.66;169.58;3.55;698;12;484.00;0
804;12;625507526;804;189;1502;1502;10.64;0.65;169.58;3.55;698;12;485.00;0
804;12;625507535;804;197;1504;1505;10.50;0.64;169.58;3.55;700;12;486.00;1
804;12;625507545;804;200;1505;1505;10.48;0.64;169.58;3.55;701;12;487.00;0
805;12;625507554;805;211;1505;1505;10.45;0.64;169.62;3.55;700;12;488.00;0
808;12;625507564;808;208;1505;1505;10.41;0.64;169.37;3.55;697;12;489.00;0
814;12;625507573;814;210;1510;1511;10.39;0.64;169.64;3.54;696;12;490.00;1
817;12;625507584;817;209;1510;1511;10.31;0.63;169.40;3.54;693;12;491.00;1
819;12;625507594;819;213;1511;1511;10.20;0.63;169.30;3.54;692;12;492.00;0
822;12;625507604;822;211;1511;1511;10.14;0.62;169.50;3.54;689;12;493.00;0
824;12;625507613;824;215;1515;1515;9.97;0.61;169.33;3.53;691;12;494.00;0
825;12;625507622;825;219;1517;1517;9.89;0.61;169.20;3.53;692;12;495.00;0
828;12;625507631;828;222;1517;1517;9.80;0.60;169.05;3.53;689;12;496.00;0
832;12;625507640;832;227;1518;1518;9.72;0.60;169.04;3.53;686;12;497.00;0
839;12;625507650;839;228;1518;1518;9.65;0.59;168.69;3.53;679;12;498.00;0
841;12;625507660;841;229;1518;1518;9.59;0.59;168.72;3.53;677;12;499.00;0
845;12;625507670;845;233;1518;1518;9.47;0.58;168.49;3.53;673;12;500.00;0
847;12;625507684;847;235;1518;1518;9.37;0.57;168.66;3.53;671;12;501.00;0
849;12;625507692;849;236;1518;1518;9.30;0.57;169.10;3.53;669;12;502.00;0
850;12;625507700;850;240;1518;1518;9.18;0.56;169.15;3.53;668;12;503.00;0
854;12;625507708;854;251;1554;1588;9.21;0.56;169.85;3.44;700;12;504.00;34
857;12;625507722;857;248;1555;1589;9.05;0.55;170.10;3.44;698;12;505.00;34
861;12;625507730;861;255;1566;1589;8.98;0.55;170.24;3.43;705;12;506.00;23
865;12;625507739;865;258;1570;1589;8.81;0.54;170.39;3.43;705;12;507.00;19
866;12;625507747;866;259;1577;1589;8.68;0.53;170.70;3.43;711;12;508.00;12
871;12;625507754;871;269;1580;1589;8.41;0.52;171.09;3.44;709;12;509.00;9
873;12;625507765;873;255;1584;1589;8.26;0.51;171.77;3.44;711;12;510.00;5
874;12;625507773;874;255;1585;1589;8.22;0.50;171.75;3.44;711;12;511.00;4
877;12;625507781;877;246;1588;1590;8.16;0.50;172.37;3.45;711;12;512.00;2
880;12;625507790;880;244;1591;1591;8.14;0.50;172.29;3.45;711;12;513.00;0
883;12;625507798;883;254;1591;1591;8.13;0.50;172.00;3.45;708;12;514.00;0
885;12;625507807;885;252;1595;1595;8.06;0.49;172.11;3.45;710;12;515.00;0
886;12;625507817;886;258;1595;1595;8.06;0.49;171.97;3.45;709;12;516.00;0
891;12;625507825;891;255;1595;1595;8.02;0.49;172.32;3.45;704;12;517.00;0
893;12;625507835;893;253;1595;1595;8.02;0.49;172.85;3.45;702;12;518.00;0
897;12;625507844;897;255;1600;1601;8.00;0.49;173.24;3.44;703;12;519.00;1
897;12;625507853;897;264;1601;1601;8.02;0.49;173.24;3.44;704;12;520.00;0
900;12;625507861;900;267;1601;1601;7.98;0.49;173.61;3.44;701;12;521.00;0
902;12;625507870;902;262;1604;1604;8.03;0.49;174.21;3.43;702;12;522.00;0
904;12;625507880;904;248;1604;1604;8.00;0.49;174.70;3.43;700;12;523.00;0
907;12;625507890;907;234;1604;1604;7.95;0.49;174.50;3.43;697;12;524.00;0
910;12;625507899;910;226;1605;1605;7.97;0.49;174.98;3.43;695;12;525.00;0
912;12;625507908;912;216;1606;1606;8.01;0.49;175.05;3.43;694;12;526.00;0
918;12;625507917;918;221;1606;1606;8.02;0.49;175.11;3.43;688;12;527.00;0
920;12;625507927;920;216;1619;1619;8.12;0.50;175.25;3.40;699;12;528.00;0
925;12;625507939;925;212;1619;1619;8.19;0.50;175.85;3.40;694;12;529.00;0
925;12;625507961;925;209;1619;1619;8.30;0.51;175.85;3.40;694;12;530.00;0
931;12;625507971;931;211;1620;1620;8.33;0.51;176.41;3.40;689;12;531.00;0
932;12;625507981;932;209;1620;1620;8.43;0.51;176.25;3.40;688;12;532.00;0
937;12;625507991;937;201;1623;1624;8.52;0.52;176.48;3.40;686;12;533.00;1
941;12;625508001;941;198;1623;1624;8.58;0.52;176.83;3.40;682;12;534.00;1
943;12;625508011;943;195;1628;1628;8.72;0.53;177.06;3.39;685;12;535.00;0
948;12;625508022;948;196;1628;1628;8.64;0.53;177.22;3.39;680;12;536.00;0
950;12;625508033;950;193;1628;1628;8.63;0.53;177.27;3.39;678;12;537.00;0
955;12;625508044;955;193;1628;1628;8.58;0.52;177.56;3.39;673;12;538.00;0
959;12;625508054;959;199;1628;1628;8.50;0.52;177.89;3.39;669;12;539.00;0
963;12;625508066;963;207;1655;1662;8.54;0.52;178.29;3.33;692;12;540.00;7
966;12;625508078;966;207;1655;1662;8.52;0.52;178.53;3.33;689;12;541.00;7
971;12;625508088;971;211;1659;1662;8.57;0.53;178.80;3.33;688;12;542.00;3
975;12;625508098;975;212;1659;1662;8.65;0.53;179.17;3.33;684;12;543.00;3
980;12;625508108;980;212;1660;1662;8.76;0.54;179.27;3.33;680;12;544.00;2
984;12;625508118;984;213;1660;1662;8.78;0.54;179.53;3.33;676;12;545.00;2
986;12;625508128;986;210;1662;1663;8.84;0.54;179.45;3.33;676;12;546.00;1
987;12;625508140;987;208;1662;1663;8.86;0.54;179.53;3.33;675;12;547.00;1
987;12;625508150;987;210;1667;1669;8.94;0.55;179.53;3.33;680;12;548.00;2
992;12;625508160;992;213;1668;1670;8.99;0.55;179.89;3.33;676;12;549.00;2
996;12;625508171;996;219;1669;1670;9.08;0.56;180.02;3.33;673;12;550.00;1
1000;12;625508181;1000;218;1669;1670;9.04;0.55;180.07;3.33;669;12;551.00;1
1003;12;625508196;1003;218;1674;1674;9.10;0.56;180.06;3.32;671;12;552.00;0
1008;12;625508211;1008;219;1674;1674;9.03;0.55;180.12;3.32;666;12;553.00;0
1010;12;625508220;1010;229;1674;1674;8.98;0.55;180.05;3.32;664;12;554.00;0
1014;12;625508230;1014;232;1675;1675;8.89;0.54;180.65;3.32;661;12;555.00;0
1017;12;625508238;1017;234;1679;1679;8.74;0.53;181.03;3.31;662;12;556.00;0
1018;12;625508254;1018;221;1679;1679;8.71;0.53;181.11;3.31;661;12;557.00;0
1023;12;625508264;1023;216;1681;1682;8.71;0.53;181.35;3.31;658;12;558.00;1
1026;12;625508274;1026;213;1681;1682;8.73;0.53;181.66;3.31;655;12;559.00;1
1029;12;625508283;1029;210;1682;1682;8.78;0.53;181.72;3.31;653;12;560.00;0
1033;12;625508292;1033;207;1682;1682;8.83;0.53;181.90;3.31;649;12;561.00;0
1033;12;625508302;1033;211;1685;1686;8.91;0.54;181.90;3.30;652;12;562.00;1
1036;12;625508312;1036;218;1685;1686;8.95;0.54;182.70;3.30;649;12;563.00;1
1038;12;625508322;1038;214;1686;1686;9.04;0.55;183.04;3.30;648;12;564.00;0
1040;12;625508331;1040;212;1686;1686;9.02;0.55;183.30;3.30;646;12;565.00;0
1041;12;625508341;1041;196;1687;1687;9.09;0.55;183.54;3.30;646;12;566.00;0
1042;12;625508351;1042;186;1688;1688;9.23;0.56;183.85;3.30;646;12;567.00;0
1043;12;625508360;1043;176;1688;1688;9.30;0.57;183.87;3.30;645;12;568.00;0
1044;12;625508369;1044;166;1689;1689;9.40;0.57;184.08;3.30;645;12;569.00;0
1047;12;625508381;1047;165;1689;1689;9.45;0.58;184.30;3.30;642;12;570.00;0
1052;12;625508391;1052;164;1689;1689;9.44;0.57;184.93;3.30;637;12;571.00;0
1055;12;625508401;1055;163;1689;1689;9.55;0.58;185.42;3.30;634;12;572.00;0
1058;12;625508411;1058;168;1689;1689;9.58;0.58;185.73;3.30;631;12;573.00;0
1059;12;625508420;1059;172;1689;1689;9.66;0.59;185.89;3.30;630;12;574.00;0
1061;12;625508430;1061;176;1689;1689;9.79;0.60;186.10;3.30;628;12;575.00;0
1062;12;625508439;1062;207;1770;1816;9.76;0.60;186.14;3.15;708;12;576.00;46
1064;12;625508459;1064;185;1773;1817;9.84;0.61;186.56;3.15;709;12;577.00;44
1068;13;625508472;1068;170;1780;1817;9.95;0.61;186.96;3.14;712;13;578.00;37
1070;13;625508492;1070;158;1782;1817;10.07;0.62;186.99;3.14;712;13;579.00;35
1072;13;625508502;1072;152;1787;1817;10.19;0.63;187.27;3.14;715;13;580.00;30
1077;13;625508512;1077;149;1791;1817;10.26;0.63;187.70;3.15;714;13;581.00;26
1081;13;625508528;1081;154;1796;1817;10.36;0.64;187.79;3.16;715;13;582.00;21
1088;13;625508543;1088;152;1800;1817;10.35;0.64;188.68;3.16;712;13;583.00;17
1088;13;625508554;1088;154;1805;1818;10.38;0.64;188.68;3.17;717;13;584.00;13
1093;13;625508564;1093;158;1808;1820;10.41;0.64;189.10;3.18;715;13;585.00;12
1095;13;625508575;1095;158;1810;1820;10.51;0.65;189.08;3.19;715;13;586.00;10
1098;13;625508584;1098;164;1812;1821;10.54;0.65;189.10;3.19;714;13;587.00;9
1099;13;625508594;1099;167;1813;1821;10.59;0.65;189.14;3.19;714;13;588.00;8
1103;13;625508604;1103;169;1815;1821;10.66;0.65;189.12;3.20;712;13;589.00;6
1106;13;625508615;1106;169;1816;1821;10.64;0.65;189.26;3.21;710;13;590.00;5
1108;13;625508625;1108;167;1820;1825;10.63;0.65;189.23;3.22;712;13;591.00;5
1112;13;625508635;1112;168;1821;1825;10.65;0.65;189.30;3.22;709;13;592.00;4
1115;13;625508645;1115;169;1821;1825;10.65;0.65;189.57;3.22;706;13;593.00;4
1117;13;625508655;1117;172;1824;1828;10.76;0.66;189.63;3.23;707;13;594.00;4
1117;13;625508665;1117;173;1824;1828;10.85;0.66;189.63;3.23;707;13;595.00;4
1117;13;625508674;1117;178;1825;1828;10.86;0.66;189.63;3.23;708;13;596.00;3
1118;13;625508684;1118;180;1829;1832;10.81;0.66;189.55;3.22;711;13;597.00;3
1122;13;625508701;1122;181;1831;1833;10.80;0.66;189.88;3.23;709;13;598.00;2
1126;13;625508714;1126;185;1831;1833;10.78;0.66;190.03;3.23;705;13;599.00;2
1127;13;625508728;1127;189;1843;1859;10.70;0.65;189.97;3.21;716;13;600.00;16
1129;13;625508745;1129;180;1844;1859;10.74;0.66;190.18;3.21;715;13;601.00;15
1132;14;625508756;1132;178;1844;1859;10.75;0.66;190.33;3.21;712;14;602.00;15
1137;14;625508776;1137;180;1846;1860;10.74;0.65;190.18;3.21;709;14;603.00;14
1140;14;625508786;1140;176;1847;1860;10.66;0.65;190.52;3.21;707;14;604.00;13
1140;14;625508802;1140;176;1851;1866;10.67;0.65;190.52;3.20;711;14;605.00;15
1144;14;625508812;1144;171;1851;1866;10.65;0.65;190.54;3.20;707;14;606.00;15
1145;14;625508822;1145;172;1852;1867;10.61;0.64;190.73;3.21;707;14;607.00;15
1147;14;625508832;1147;174;1852;1867;10.66;0.65;190.80;3.21;705;14;608.00;15
1149;14;625508842;1149;168;1853;1867;10.67;0.65;191.09;3.21;704;14;609.00;14
1153;14;625508851;1153;161;1855;1867;10.68;0.65;191.49;3.21;702;14;610.00;12
1161;14;625508861;1161;157;1856;1867;10.63;0.64;192.26;3.22;695;14;611.00;11
1162;14;625508871;1162;149;1865;1879;10.74;0.65;192.49;3.20;703;14;612.00;14
1168;15;625508880;1168;145;1865;1879;10.79;0.65;192.81;3.20;697;15;613.00;14
1173;15;625508901;1173;139;1867;1879;10.74;0.65;192.88;3.21;694;15;614.00;12
1175;15;625508915;1175;129;1869;1879;10.69;0.65;193.19;3.21;694;15;615.00;10
1178;15;625508924;1178;119;1869;1879;10.69;0.65;193.20;3.21;691;15;616.00;10
1183;15;625508934;1183;115;1870;1879;10.68;0.65;193.10;3.22;687;15;617.00;9
1183;15;625508943;1183;106;1873;1883;10.71;0.65;193.10;3.22;690;15;618.00;10
1187;15;625508953;1187;103;1873;1883;10.82;0.66;193.54;3.22;686;15;619.00;10
1188;15;625508962;1188;98;1876;1887;11.01;0.67;193.76;3.21;688;15;620.00;11
1190;15;625508973;1190;98;1877;1888;11.09;0.67;193.94;3.21;687;15;621.00;11
1193;15;625508982;1193;95;1878;1888;11.13;0.67;194.08;3.21;685;15;622.00;10
1200;15;625508992;1200;94;1879;1888;11.18;0.67;194.29;3.22;679;15;623.00;9
1204;15;625509002;1204;98;1887;1901;11.21;0.68;194.41;3.21;683;15;624.00;14
1206;15;625509014;1206;103;1887;1901;11.19;0.68;194.47;3.21;681;15;625.00;14
1210;15;625509023;1210;107;1888;1901;11.12;0.67;194.68;3.23;678;15;626.00;13
1211;15;625509032;1211;110;1889;1902;11.20;0.68;194.80;3.23;678;15;627.00;13
1212;15;625509042;1212;116;1889;1903;11.22;0.68;194.77;3.23;677;15;628.00;14
1213;15;625509057;1213;120;1891;1903;11.24;0.68;195.00;3.25;678;15;629.00;12
1216;15;625509068;1216;123;1894;1909;11.25;0.68;195.04;3.25;678;15;630.00;15
1217;15;625509078;1217;128;1897;1909;11.29;0.69;194.90;3.26;680;15;631.00;12
1218;15;625509088;1218;132;1898;1909;11.29;0.69;194.90;3.26;680;15;632.00;11
1220;15;625509097;1220;133;1898;1909;11.28;0.69;194.82;3.26;678;15;633.00;11
1221;15;625509108;1221;136;1902;1915;11.28;0.69;194.77;3.26;681;15;634.00;13
1222;15;625509117;1222;140;1902;1915;11.18;0.68;194.63;3.26;680;15;635.00;13
1224;15;625509127;1224;141;1904;1915;11.10;0.67;194.69;3.28;680;15;636.00;11
1228;15;625509147;1228;139;1904;1915;11.06;0.67;194.61;3.28;676;15;637.00;11
1230;15;625509160;1230;146;1908;1919;11.02;0.67;194.59;3.27;678;15;638.00;11
1233;15;625509179;1233;151;1909;1920;11.05;0.67;194.77;3.27;676;15;639.00;11
1234;15;625509198;1234;153;1910;1920;11.01;0.67;194.82;3.28;676;15;640.00;10
1236;15;625509211;1236;157;1911;1921;10.94;0.66;194.68;3.28;675;15;641.00;10
1240;15;625509226;1240;162;1914;1921;10.83;0.66;194.47;3.32;674;15;642.00;7
1240;15;625509240;1240;165;1915;1921;10.74;0.65;194.47;3.33;675;15;643.00;6
1242;15;625509255;1242;171;1916;1921;10.65;0.65;194.42;3.33;674;15;644.00;5
1243;15;625509267;1243;174;1917;1921;10.48;0.64;194.32;3.34;674;15;645.00;4
1243;15;625509278;1243;178;1917;1921;10.44;0.64;194.32;3.34;674;15;646.00;4
1246;15;625509288;1246;183;1919;1921;10.35;0.63;194.02;3.38;673;15;647.00;2
1248;15;625509298;1248;189;1958;1991;10.40;0.64;194.05;3.31;710;15;648.00;33
1249;15;625509315;1249;192;1962;1992;10.33;0.63;194.13;3.32;713;15;649.00;30
1253;15;625509325;1253;190;1974;1992;10.32;0.63;193.93;3.31;721;15;650.00;18
1256;15;625509343;1256;197;1980;1992;10.29;0.63;193.72;3.31;724;15;651.00;12
1256;15;625509353;1256;198;1987;1992;10.26;0.63;193.72;3.31;731;15;652.00;5
1257;15;625509362;1257;206;1988;1992;10.18;0.62;193.66;3.32;731;15;653.00;4
1257;15;625509381;1257;213;1990;1992;10.11;0.62;193.66;3.32;733;15;654.00;2
1257;15;625509390;1257;216;1990;1992;10.02;0.61;193.66;3.32;733;15;655.00;2
1260;15;625509400;1260;223;1992;1993;9.83;0.60;193.62;3.32;732;15;656.00;1
1262;15;625509409;1262;232;1993;1994;9.60;0.59;193.54;3.32;731;15;657.00;1
1264;15;625509419;1264;234;1994;1994;9.43;0.58;193.53;3.32;730;15;658.00;0
1266;15;625509435;1266;240;1998;1998;9.25;0.57;193.48;3.32;732;15;659.00;0
1268;15;625509446;1268;238;1998;1998;9.10;0.56;193.48;3.32;730;15;660.00;0
1268;15;625509455;1268;247;1998;1998;8.99;0.55;193.48;3.32;730;15;661.00;0
1271;15;625509467;1271;250;1998;1998;8.91;0.55;193.32;3.32;727;15;662.00;0
1272;15;625509476;1272;258;2003;2004;8.95;0.55;193.46;3.31;731;15;663.00;1
1274;15;625509485;1274;264;2003;2004;8.88;0.54;193.40;3.31;729;15;664.00;1
1274;15;625509494;1274;269;2004;2004;8.86;0.54;193.40;3.31;730;15;665.00;0
1275;15;625509502;1275;276;2006;2007;8.81;0.54;193.36;3.31;731;15;666.00;1
1275;15;625509511;1275;280;2007;2007;8.69;0.53;193.36;3.31;732;15;667.00;0
1276;15;625509528;1276;283;2007;2007;8.55;0.52;193.32;3.31;731;15;668.00;0
1276;15;625509537;1276;287;2008;2008;8.41;0.51;193.32;3.30;732;15;669.00;0
1277;15;625509546;1277;291;2009;2009;8.30;0.51;193.18;3.30;732;15;670.00;0
1278;15;625509555;1278;294;2009;2009;8.18;0.50;193.22;3.30;731;15;671.00;0
1280;15;625509563;1280;303;2022;2022;8.03;0.49;193.06;3.28;742;15;672.00;0
1284;15;625509573;1284;305;2022;2022;7.82;0.48;192.85;3.28;738;15;673.00;0
1289;15;625509581;1289;308;2022;2022;7.64;0.47;192.59;3.28;733;15;674.00;0
1294;15;625509590;1294;296;2024;2024;7.53;0.46;192.63;3.28;730;15;675.00;0
1296;15;625509599;1296;289;2024;2024;7.43;0.45;192.81;3.28;728;15;676.00;0
1300;15;625509607;1300;285;2027;2028;7.32;0.45;193.17;3.28;727;15;677.00;1
1303;15;625509616;1303;282;2027;2028;7.22;0.44;193.48;3.28;724;15;678.00;1
1308;15;625509625;1308;283;2032;2032;7.08;0.43;193.55;3.27;724;15;679.00;0
1311;15;625509633;1311;263;2032;2032;7.01;0.43;193.80;3.27;721;15;680.00;0
1314;15;625509643;1314;256;2032;2032;6.96;0.43;194.11;3.27;718;15;681.00;0
1318;15;625509662;1318;248;2032;2032;6.96;0.43;194.59;3.27;714;15;682.00;0
1318;15;625509671;1318;239;2032;2032;7.05;0.43;194.59;3.27;714;15;683.00;0
1322;15;625509679;1322;237;2042;2044;7.21;0.44;194.76;3.26;720;15;684.00;2
1324;15;625509690;1324;236;2042;2044;7.35;0.45;194.89;3.26;718;15;685.00;2
1327;15;625509698;1327;234;2044;2044;7.47;0.46;195.09;3.25;717;15;686.00;0
1331;15;625509708;1331;218;2044;2044;7.57;0.46;195.11;3.25;713;15;687.00;0
1331;15;625509718;1331;212;2044;2044;7.74;0.47;195.11;3.25;713;15;688.00;0
1334;15;625509727;1334;208;2044;2044;7.88;0.48;195.25;3.25;710;15;689.00;0
1335;15;625509738;1335;205;2045;2045;8.00;0.49;195.44;3.25;710;15;690.00;0
1338;15;625509747;1338;209;2045;2045;8.12;0.50;195.61;3.25;707;15;691.00;0
1338;15;625509757;1338;204;2050;2051;8.29;0.51;195.61;3.25;712;15;692.00;1
1342;15;625509767;1342;202;2051;2052;8.36;0.51;196.15;3.25;709;15;693.00;1
1344;15;625509776;1344;196;2052;2052;8.44;0.52;196.24;3.25;708;15;694.00;0
1347;15;625509792;1347;192;2052;2052;8.51;0.52;196.71;3.25;705;15;695.00;0
1352;15;625509802;1352;195;2056;2056;8.61;0.53;197.00;3.24;704;15;696.00;0
1357;15;625509812;1357;195;2056;2056;8.66;0.53;197.36;3.24;699;15;697.00;0
1362;15;625509822;1362;197;2056;2056;8.74;0.53;197.38;3.24;694;15;698.00;0
1367;15;625509832;1367;191;2057;2057;8.79;0.54;197.74;3.24;690;15;699.00;0
1372;15;625509844;1372;183;2061;2061;8.86;0.54;197.82;3.23;689;15;700.00;0
1373;15;625509860;1373;183;2061;2061;8.95;0.55;197.84;3.23;688;15;701.00;0
1376;15;625509870;1376;172;2063;2064;9.06;0.56;197.84;3.23;687;15;702.00;1
1379;15;625509881;1379;162;2063;2064;9.17;0.56;197.66;3.23;684;15;703.00;1
1383;15;625509891;1383;157;2064;2064;9.27;0.57;197.74;3.23;681;15;704.00;0
1385;15;625509902;1385;155;2064;2064;9.38;0.57;197.89;3.23;679;15;705.00;0
1390;15;625509911;1390;157;2067;2068;9.49;0.58;197.91;3.23;677;15;706.00;1
1397;15;625509922;1397;161;2067;2068;9.59;0.59;198.41;3.23;670;15;707.00;1
1408;15;625509934;1408;162;2068;2068;9.63;0.59;198.42;3.23;660;15;708.00;0
1412;15;625509945;1412;157;2068;2068;9.62;0.59;198.54;3.23;656;15;709.00;0
1419;15;625509955;1419;152;2069;2069;9.59;0.58;198.68;3.23;650;15;710.00;0
1427;15;625509965;1427;150;2070;2070;9.55;0.58;198.73;3.22;643;15;711.00;0
1430;15;625509976;1430;150;2070;2070;9.52;0.58;198.74;3.22;640;15;712.00;0
1435;15;625509986;1435;154;2071;2071;9.52;0.58;199.02;3.22;636;15;713.00;0
1438;15;625509996;1438;156;2071;2071;9.53;0.58;199.41;3.22;633;15;714.00;0
1439;15;625510006;1439;156;2071;2071;9.58;0.58;199.43;3.22;632;15;715.00;0
1440;15;625510017;1440;158;2071;2071;9.66;0.59;199.46;3.22;631;15;716.00;0
1443;15;625510027;1443;163;2071;2071;9.75;0.59;199.46;3.22;628;15;717.00;0
1445;16;625510037;1445;162;2071;2071;9.85;0.60;199.48;3.22;626;16;718.00;0
1447;16;625510064;1447;162;2071;2071;9.92;0.60;199.63;3.22;624;16;719.00;0
1452;16;625510076;1452;200;2191;2301;9.89;0.62;200.04;3.05;739;16;720.00;110
1453;16;625510106;1453;194;2201;2302;9.87;0.62;200.27;3.04;748;16;721.00;101
1455;17;625510117;1455;172;2215;2302;9.94;0.62;200.29;3.03;760;17;722.00;87
1459;17;625510147;1459;170;2222;2302;9.89;0.62;200.48;3.03;763;17;723.00;80
1463;17;625510159;1463;163;2227;2302;9.77;0.61;200.70;3.03;764;17;724.00;75
1464;17;625510176;1464;168;2236;2302;9.68;0.61;200.85;3.04;772;17;725.00;66
1467;17;625510188;1467;168;2243;2302;9.59;0.60;201.13;3.05;776;17;726.00;59
1472;17;625510200;1472;169;2249;2302;9.48;0.59;201.58;3.06;777;17;727.00;53
1473;17;625510210;1473;171;2254;2303;9.46;0.59;201.77;3.07;781;17;728.00;49
1477;17;625510222;1477;172;2259;2304;9.42;0.59;202.10;3.09;782;17;729.00;45
1480;17;625510232;1480;176;2261;2304;9.40;0.59;202.43;3.09;781;17;730.00;43
1485;17;625510243;1485;183;2266;2305;9.35;0.58;202.62;3.11;781;17;731.00;39
1487;17;625510256;1487;190;2270;2305;9.31;0.58;202.75;3.12;783;17;732.00;35
1489;17;625510267;1489;195;2274;2305;9.30;0.58;202.92;3.14;785;17;733.00;31
1492;17;625510278;1492;204;2277;2305;9.33;0.58;203.08;3.15;785;17;734.00;28
1496;17;625510293;1496;211;2283;2309;9.29;0.58;203.32;3.17;787;17;735.00;26
1500;17;625510310;1500;204;2284;2309;9.25;0.57;203.88;3.17;784;17;736.00;25
1502;17;625510321;1502;198;2287;2309;9.25;0.57;203.84;3.19;785;17;737.00;22
1504;17;625510333;1504;187;2288;2312;9.34;0.58;203.90;3.19;784;17;738.00;24
1507;17;625510345;1507;191;2289;2312;9.44;0.58;204.03;3.20;782;17;739.00;23
1509;17;625510356;1509;186;2292;2312;9.45;0.58;204.30;3.22;783;17;740.00;20
1513;17;625510369;1513;186;2296;2316;9.47;0.58;204.15;3.22;783;17;741.00;20
1518;17;625510381;1518;189;2298;2317;9.59;0.59;204.56;3.22;780;17;742.00;19
1521;17;625510393;1521;193;2299;2317;9.70;0.60;204.72;3.23;778;17;743.00;18
1526;17;625510405;1526;198;2305;2321;9.79;0.60;204.86;3.25;779;17;744.00;16
1528;17;625510417;1528;203;2305;2321;9.90;0.61;204.90;3.25;777;17;745.00;16
1529;17;625510438;1529;212;2307;2321;9.96;0.61;204.85;3.26;778;17;746.00;14
1530;17;625510450;1530;201;2310;2322;9.99;0.61;204.92;3.28;780;17;747.00;12
1532;17;625510461;1532;196;2310;2322;10.06;0.62;204.96;3.28;778;17;748.00;12
1534;17;625510478;1534;195;2316;2328;10.07;0.62;204.96;3.29;782;17;749.00;12
1539;17;625510497;1539;196;2316;2328;10.17;0.62;205.30;3.29;777;17;750.00;12
1542;17;625510509;1542;197;2317;2329;10.17;0.62;205.40;3.29;775;17;751.00;12
1545;17;625510522;1545;200;2318;2329;10.16;0.62;205.40;3.29;773;17;752.00;11
1547;17;625510533;1547;194;2319;2329;10.19;0.62;205.52;3.30;772;17;753.00;10
1551;17;625510544;1551;195;2319;2329;10.15;0.62;205.49;3.30;768;17;754.00;10
1553;17;625510555;1553;200;2320;2329;10.18;0.62;205.63;3.31;767;17;755.00;9
1556;17;625510566;1556;203;2331;2341;10.22;0.62;205.67;3.29;775;17;756.00;10
1559;17;625510578;1559;201;2332;2341;10.25;0.62;205.84;3.29;773;17;757.00;9
1563;17;625510589;1563;205;2332;2341;10.28;0.63;206.07;3.29;769;17;758.00;9
1564;18;625510600;1564;211;2333;2341;10.31;0.63;206.11;3.30;769;18;759.00;8
1567;18;625510620;1567;211;2333;2341;10.34;0.63;206.12;3.30;766;18;760.00;8
1570;18;625510631;1570;213;2334;2341;10.38;0.63;206.24;3.30;764;18;761.00;7
1572;18;625510648;1572;220;2338;2345;10.35;0.63;206.26;3.29;766;18;762.00;7
1576;18;625510664;1576;221;2338;2345;10.34;0.63;206.21;3.29;762;18;763.00;7
1577;18;625510675;1577;219;2341;2349;10.33;0.63;206.44;3.29;764;18;764.00;8
1582;18;625510686;1582;224;2343;2351;10.26;0.63;206.68;3.29;761;18;765.00;8
1585;18;625510697;1585;225;2344;2351;10.24;0.63;206.80;3.29;759;18;766.00;7
1585;18;625510707;1585;225;2344;2351;10.23;0.63;206.80;3.29;759;18;767.00;7
1586;18;625510718;1586;228;2354;2364;10.18;0.62;206.79;3.27;768;18;768.00;10
1586;18;625510730;1586;222;2354;2364;10.11;0.62;206.79;3.27;768;18;769.00;10
1592;18;625510740;1592;221;2355;2364;10.03;0.61;206.99;3.27;763;18;770.00;9
1593;18;625510750;1593;220;2356;2365;10.04;0.61;207.08;3.27;763;18;771.00;9
1595;18;625510761;1595;215;2356;2366;9.97;0.61;207.00;3.27;761;18;772.00;10
1595;18;625510770;1595;210;2356;2366;9.92;0.61;207.00;3.27;761;18;773.00;10
1599;18;625510781;1599;208;2358;2369;9.92;0.61;207.12;3.27;759;18;774.00;11
1600;18;625510792;1600;206;2358;2369;9.94;0.61;207.24;3.27;758;18;775.00;11
1602;18;625510804;1602;202;2359;2369;9.96;0.61;207.36;3.27;757;18;776.00;10
1606;18;625510818;1606;204;2359;2369;9.89;0.61;207.26;3.27;753;18;777.00;10
1612;18;625510828;1612;206;2363;2375;9.85;0.60;207.35;3.27;751;18;778.00;12
1616;18;625510839;1616;200;2363;2375;9.79;0.60;207.40;3.27;747;18;779.00;12
1620;18;625510850;1620;199;2364;2375;9.70;0.59;207.61;3.27;744;18;780.00;11
1626;18;625510866;1626;199;2364;2375;9.57;0.58;207.76;3.27;738;18;781.00;11
1630;18;625510876;1630;194;2367;2379;9.51;0.58;208.00;3.26;737;18;782.00;12
1632;18;625510886;1632;185;2368;2380;9.45;0.58;207.93;3.26;736;18;783.00;12
1636;18;625510896;1636;186;2368;2380;9.43;0.58;207.97;3.26;732;18;784.00;12
1638;18;625510905;1638;183;2370;2381;9.42;0.57;208.05;3.26;732;18;785.00;11
1640;18;625510915;1640;178;2370;2381;9.45;0.58;207.98;3.26;730;18;786.00;11
1641;18;625510924;1641;175;2370;2381;9.53;0.58;207.89;3.26;729;18;787.00;11
1642;18;625510934;1642;174;2370;2381;9.58;0.59;207.87;3.26;728;18;788.00;11
1645;18;625510943;1645;172;2370;2381;9.64;0.59;207.76;3.26;725;18;789.00;11
1647;18;625510952;1647;171;2370;2381;9.69;0.59;207.60;3.26;723;18;790.00;11
1648;18;625510962;1648;170;2370;2381;9.76;0.60;207.52;3.26;722;18;791.00;11
1651;18;625510971;1651;173;2403;2451;9.88;0.60;207.30;3.22;752;18;792.00;48
1654;18;625510986;1654;177;2403;2452;9.86;0.60;207.21;3.22;749;18;793.00;49
1654;18;625510996;1654;174;2411;2452;9.92;0.61;207.21;3.22;757;18;794.00;41
1655;18;625511005;1655;178;2412;2452;9.88;0.60;207.16;3.22;757;18;795.00;40
1657;18;625511015;1657;178;2417;2452;9.93;0.61;207.08;3.22;760;18;796.00;35
1661;18;625511026;1661;173;2420;2452;9.99;0.61;206.96;3.25;759;18;797.00;32
1665;18;625511036;1665;178;2423;2452;9.99;0.61;206.69;3.25;758;18;798.00;29
1666;18;625511046;1666;177;2427;2452;9.97;0.61;206.60;3.29;761;18;799.00;25
1666;19;625511057;1666;175;2431;2453;9.99;0.61;206.60;3.30;765;19;800.00;22
1668;19;625511081;1668;181;2434;2454;9.97;0.61;206.45;3.30;766;19;801.00;20
1670;19;625511093;1670;182;2436;2454;9.92;0.60;206.37;3.33;766;19;802.00;18
1671;19;625511102;1671;185;2440;2458;9.84;0.60;206.27;3.33;769;19;803.00;18
1674;19;625511113;1674;187;2442;2458;9.72;0.59;206.05;3.37;768;19;804.00;16
1677;19;625511123;1677;195;2443;2458;9.59;0.58;205.86;3.37;766;19;805.00;15
1680;19;625511133;1680;203;2444;2458;9.49;0.58;205.78;3.41;764;19;806.00;14
1681;19;625511146;1681;211;2449;2464;9.47;0.58;205.68;3.41;768;19;807.00;15
1682;19;625511163;1682;217;2451;2464;9.39;0.57;205.62;3.44;769;19;808.00;13
1686;19;625511185;1686;225;2451;2464;9.34;0.57;205.54;3.44;765;19;809.00;13
1688;19;625511204;1688;230;2455;2470;9.30;0.57;205.47;3.45;767;19;810.00;15
1690;19;625511220;1690;240;2457;2470;9.21;0.56;205.57;3.50;767;19;811.00;13
1692;19;625511235;1692;251;2459;2470;9.14;0.56;205.38;3.51;767;19;812.00;11
1696;19;625511249;1696;255;2462;2471;9.10;0.55;205.58;3.53;766;19;813.00;9
1699;19;625511263;1699;263;2463;2472;9.03;0.55;205.33;3.52;764;19;814.00;9
1700;19;625511274;1700;267;2467;2472;8.96;0.54;205.27;3.55;767;19;815.00;5
1703;19;625511286;1703;273;2475;2485;8.92;0.54;205.21;3.54;772;19;816.00;10
1703;19;625511298;1703;277;2477;2485;8.87;0.54;205.21;3.55;774;19;817.00;8
1704;19;625511309;1704;281;2479;2485;8.83;0.54;205.23;3.56;775;19;818.00;6
1704;19;625511319;1704;284;2482;2486;8.79;0.54;205.23;3.57;778;19;819.00;4
1706;19;625511331;1706;294;2482;2486;8.76;0.53;205.06;3.57;776;19;820.00;4
1709;19;625511342;1709;301;2488;2490;8.71;0.53;204.83;3.57;779;19;821.00;2
1710;19;625511353;1710;299;2489;2490;8.64;0.53;204.77;3.57;779;19;822.00;1
1712;19;625511363;1712;305;2493;2494;8.55;0.52;204.65;3.57;781;19;823.00;1
1714;19;625511374;1714;313;2494;2494;8.41;0.51;204.44;3.57;780;19;824.00;0
1714;19;625511384;1714;315;2494;2494;8.33;0.51;204.44;3.57;780;19;825.00;0
1716;19;625511395;1716;321;2494;2494;8.22;0.50;204.35;3.57;778;19;826.00;0
1717;19;625511404;1717;309;2494;2494;8.16;0.50;204.36;3.57;777;19;827.00;0
1717;19;625511414;1717;304;2504;2506;8.17;0.50;204.36;3.55;787;19;828.00;2
1717;19;625511425;1717;298;2505;2506;8.18;0.50;204.36;3.55;788;19;829.00;1
1718;19;625511437;1718;292;2506;2506;8.23;0.51;204.41;3.55;788;19;830.00;0
1718;19;625511448;1718;286;2506;2506;8.28;0.51;204.41;3.55;788;19;831.00;0
1720;20;625511460;1720;284;2506;2506;8.36;0.51;204.35;3.55;786;20;832.00;0
1720;20;625511483;1720;279;2506;2506;8.43;0.52;204.35;3.55;786;20;833.00;0
1725;20;625511494;1725;279;2507;2507;8.44;0.52;204.28;3.55;782;20;834.00;0
1726;20;625511506;1726;277;2507;2507;8.54;0.52;204.31;3.55;781;20;835.00;0
1727;20;625511518;1727;274;2512;2513;8.64;0.53;204.38;3.55;785;20;836.00;1
1729;20;625511529;1729;275;2513;2514;8.69;0.53;204.33;3.54;784;20;837.00;1
1730;21;625511539;1730;277;2514;2514;8.78;0.54;204.44;3.54;784;21;838.00;0
1731;21;625511566;1731;282;2514;2514;8.80;0.54;204.59;3.54;783;21;839.00;0
1732;21;625511579;1732;283;2519;2519;8.81;0.54;204.59;3.54;787;21;840.00;0
1733;21;625511589;1733;290;2519;2519;8.73;0.53;204.48;3.54;786;21;841.00;0
1734;21;625511600;1734;287;2519;2519;8.62;0.53;204.52;3.54;785;21;842.00;0
1735;21;625511611;1735;291;2520;2520;8.55;0.52;204.56;3.54;785;21;843.00;0
1738;21;625511621;1738;288;2524;2524;8.42;0.51;204.62;3.53;786;21;844.00;0
1739;21;625511631;1739;289;2524;2524;8.31;0.51;204.80;3.53;785;21;845.00;0
1743;21;625511641;1743;285;2526;2527;8.19;0.50;205.02;3.53;783;21;846.00;1
1745;21;625511650;1745;287;2527;2527;8.09;0.50;205.09;3.53;782;21;847.00;0
1748;21;625511660;1748;290;2527;2527;8.03;0.49;205.33;3.53;779;21;848.00;0
1751;21;625511676;1751;292;2527;2527;7.92;0.49;205.36;3.53;776;21;849.00;0
1755;21;625511685;1755;276;2530;2531;7.93;0.49;205.85;3.53;775;21;850.00;1
1760;21;625511695;1760;262;2530;2531;7.87;0.48;206.45;3.53;770;21;851.00;1
1765;21;625511705;1765;259;2531;2531;7.91;0.48;206.44;3.53;766;21;852.00;0
1771;21;625511714;1771;259;2531;2531;7.89;0.48;206.55;3.53;760;21;853.00;0
1777;21;625511724;1777;251;2532;2532;7.88;0.48;207.24;3.52;755;21;854.00;0
1779;21;625511734;1779;250;2534;2534;7.96;0.49;207.15;3.52;755;21;855.00;0
1784;21;625511744;1784;250;2534;2534;8.04;0.49;207.49;3.52;750;21;856.00;0
1790;21;625511753;1790;248;2535;2535;8.11;0.49;207.87;3.52;745;21;857.00;0
1792;21;625511764;1792;234;2535;2535;8.20;0.50;208.08;3.52;743;21;858.00;0
1797;22;625511779;1797;223;2535;2535;8.27;0.50;208.28;3.52;738;22;859.00;0
1799;22;625511796;1799;215;2535;2535;8.34;0.51;208.34;3.52;736;22;860.00;0
1804;22;625511810;1804;210;2535;2535;8.37;0.51;208.64;3.52;731;22;861.00;0
1810;22;625511820;1810;204;2535;2535;8.45;0.51;209.17;3.52;725;22;862.00;0
1812;22;625511831;1812;197;2535;2535;8.54;0.52;209.23;3.52;723;22;863.00;0
1815;22;625511842;1815;206;2614;2662;8.78;0.54;209.38;3.42;799;22;864.00;48
1819;22;625511862;1819;194;2616;2663;8.84;0.55;209.45;3.41;797;22;865.00;47
1820;22;625511874;1820;193;2622;2663;9.05;0.56;209.54;3.41;802;22;866.00;41
1826;22;625511885;1826;190;2627;2663;9.13;0.56;209.80;3.41;801;22;867.00;36
1828;22;625511896;1828;191;2633;2663;9.25;0.57;209.77;3.41;805;22;868.00;30
1834;22;625511907;1834;192;2637;2663;9.24;0.57;210.01;3.41;803;22;869.00;26
1837;22;625511927;1837;192;2642;2663;9.22;0.57;210.15;3.42;805;22;870.00;21
1842;22;625511940;1842;191;2644;2663;9.20;0.57;210.08;3.42;802;22;871.00;19
1849;22;625511952;1849;187;2649;2664;9.13;0.56;210.41;3.43;800;22;872.00;15
1852;22;625511965;1852;193;2652;2665;9.09;0.56;210.64;3.44;800;22;873.00;13
1855;22;625511978;1855;201;2654;2665;9.06;0.56;210.89;3.44;799;22;874.00;11
1860;22;625511989;1860;198;2658;2666;9.06;0.56;210.78;3.45;798;22;875.00;8
1867;22;625512002;1867;206;2659;2666;9.09;0.56;211.04;3.45;792;22;876.00;7
1870;22;625512014;1870;207;2660;2666;9.12;0.56;211.02;3.45;790;22;877.00;6
1872;22;625512027;1872;211;2662;2666;9.18;0.57;211.35;3.46;790;22;878.00;4
1877;22;625512039;1877;216;2665;2670;9.24;0.57;211.58;3.46;788;22;879.00;5
1882;22;625512052;1882;220;2667;2670;9.25;0.57;211.63;3.47;785;22;880.00;3
1885;22;625512066;1885;222;2667;2670;9.29;0.57;211.56;3.47;782;22;881.00;3
1889;22;625512078;1889;224;2670;2673;9.37;0.58;211.90;3.47;781;22;882.00;3
1892;22;625512091;1892;224;2670;2673;9.39;0.58;211.86;3.47;778;22;883.00;3
1897;22;625512103;1897;220;2671;2673;9.44;0.58;211.87;3.47;774;22;884.00;2
1900;22;625512114;1900;219;2675;2677;9.51;0.58;211.98;3.47;775;22;885.00;2
1903;22;625512127;1903;216;2677;2678;9.59;0.59;212.01;3.47;774;22;886.00;1
1909;22;625512139;1909;217;2677;2678;9.62;0.59;212.05;3.47;768;22;887.00;1
1914;22;625512153;1914;219;2682;2682;9.70;0.59;212.03;3.47;768;22;888.00;0
1919;22;625512167;1919;223;2682;2682;9.66;0.59;212.18;3.47;763;22;889.00;0
1922;22;625512179;1922;219;2682;2682;9.67;0.59;212.15;3.47;760;22;890.00;0
1927;22;625512192;1927;222;2683;2683;9.56;0.58;212.07;3.46;756;22;891.00;0
1930;22;625512203;1930;224;2683;2683;9.47;0.58;212.27;3.46;753;22;892.00;0
1933;22;625512220;1933;226;2688;2689;9.35;0.57;212.30;3.46;755;22;893.00;1
1938;22;625512232;1938;230;2688;2689;9.27;0.57;212.47;3.46;750;22;894.00;1
1942;22;625512243;1942;231;2690;2690;9.23;0.56;212.65;3.46;748;22;895.00;0
1947;22;625512255;1947;238;2690;2690;9.20;0.56;212.92;3.46;743;22;896.00;0
1951;22;625512266;1951;221;2690;2690;9.16;0.56;213.13;3.46;739;22;897.00;0
1955;22;625512278;1955;217;2690;2690;9.19;0.56;213.25;3.46;735;22;898.00;0
1959;22;625512289;1959;212;2690;2690;9.11;0.55;213.41;3.46;731;22;899.00;0
1963;22;625512302;1963;217;2720;2736;9.04;0.55;213.76;3.42;757;22;900.00;16
1968;22;625512322;1968;208;2720;2736;9.04;0.55;213.78;3.42;752;22;901.00;16
1971;22;625512334;1971;208;2722;2736;9.06;0.55;213.77;3.42;751;22;902.00;14
1972;22;625512345;1972;204;2722;2736;9.13;0.56;213.94;3.42;750;22;903.00;14
1976;22;625512356;1976;206;2723;2736;9.13;0.56;214.15;3.42;747;22;904.00;13
1977;22;625512367;1977;209;2723;2736;9.16;0.56;214.17;3.42;746;22;905.00;13
1980;22;625512378;1980;195;2729;2740;9.17;0.56;214.30;3.42;749;22;906.00;11
1982;22;625512389;1982;188;2730;2740;9.16;0.56;214.44;3.42;748;22;907.00;10
1984;22;625512405;1984;180;2734;2744;9.08;0.56;214.45;3.42;750;22;908.00;10
1988;22;625512416;1988;176;2736;2745;9.07;0.55;214.52;3.42;748;22;909.00;9
1991;22;625512428;1991;179;2736;2745;9.04;0.55;214.53;3.42;745;22;910.00;9
1995;22;625512438;1995;180;2736;2745;9.11;0.56;214.42;3.42;741;22;911.00;9
1997;22;625512449;1997;182;2745;2758;9.21;0.56;214.53;3.41;748;22;912.00;13
2000;22;625512460;2000;188;2745;2758;9.30;0.57;214.68;3.41;745;22;913.00;13
2001;22;625512472;2001;191;2747;2758;9.31;0.57;214.81;3.42;746;22;914.00;11
2005;22;625512482;2005;189;2748;2759;9.28;0.57;214.90;3.42;743;22;915.00;11
2008;22;625512493;2008;194;2749;2760;9.30;0.57;215.02;3.42;741;22;916.00;11
2008;22;625512503;2008;188;2749;2760;9.23;0.56;215.02;3.42;741;22;917.00;11
2011;22;625512514;2011;186;2751;2763;9.23;0.56;214.96;3.41;740;22;918.00;12
2014;22;625512524;2014;185;2752;2763;9.22;0.56;215.02;3.42;738;22;919.00;11
2017;22;625512535;2017;178;2753;2763;9.23;0.56;215.19;3.43;736;22;920.00;10
2019;22;625512545;2019;174;2753;2763;9.22;0.56;215.24;3.43;734;22;921.00;10
2020;22;625512555;2020;169;2757;2769;9.24;0.56;215.23;3.42;737;22;922.00;12
2022;22;625512566;2022;162;2757;2769;9.23;0.56;215.21;3.42;735;22;923.00;12
2025;22;625512576;2025;158;2757;2769;9.29;0.57;215.26;3.42;732;22;924.00;12
2027;22;625512586;2027;163;2758;2769;9.35;0.57;215.21;3.43;731;22;925.00;11
2029;23;625512596;2029;164;2764;2773;9.30;0.57;215.23;3.44;735;23;926.00;9
2032;23;625512616;2032;162;2765;2774;9.29;0.57;215.32;3.44;733;23;927.00;9
2035;23;625512625;2035;163;2767;2774;9.25;0.56;215.52;3.45;732;23;928.00;7
2038;23;625512635;2038;166;2769;2775;9.28;0.57;215.47;3.45;731;23;929.00;6
2040;23;625512647;2040;175;2769;2775;9.32;0.57;215.53;3.45;729;23;930.00;6
2042;23;625512656;2042;179;2770;2775;9.33;0.57;215.56;3.46;728;23;931.00;5
2043;23;625512670;2043;186;2770;2775;9.37;0.57;215.56;3.46;727;23;932.00;5
2045;23;625512683;2045;192;2770;2775;9.36;0.57;215.61;3.46;725;23;933.00;5
2045;23;625512694;2045;196;2772;2775;9.34;0.57;215.61;3.46;727;23;934.00;3
2048;23;625512705;2048;207;2772;2775;9.33;0.57;215.84;3.46;724;23;935.00;3
2052;23;625512718;2052;215;2809;2845;9.06;0.55;215.92;3.42;757;23;936.00;36
2052;23;625512734;2052;219;2814;2846;9.06;0.55;215.92;3.43;762;23;937.00;32
2054;23;625512744;2054;216;2822;2846;9.15;0.56;215.87;3.43;768;23;938.00;24
2054;23;625512753;2054;220;2825;2846;9.15;0.56;215.87;3.43;771;23;939.00;21
2056;23;625512767;2056;225;2828;2846;9.13;0.56;215.98;3.43;772;23;940.00;18
2057;23;625512777;2057;224;2829;2846;9.08;0.56;216.01;3.43;772;23;941.00;17
2060;23;625512786;2060;227;2831;2846;9.08;0.55;215.94;3.43;771;23;942.00;15
2063;23;625512796;2063;229;2834;2846;9.13;0.56;215.97;3.43;771;23;943.00;12
2066;23;625512806;2066;228;2836;2847;9.15;0.56;216.00;3.44;770;23;944.00;11
2070;23;625512816;2070;224;2839;2849;9.09;0.55;216.02;3.44;769;23;945.00;10
2071;23;625512827;2071;219;2841;2849;9.11;0.56;216.05;3.44;770;23;946.00;8
2074;23;625512836;2074;216;2844;2853;9.09;0.55;216.10;3.44;770;23;947.00;9
2074;23;625512846;2074;215;2846;2853;9.06;0.55;216.10;3.44;772;23;948.00;7
2077;23;625512855;2077;209;2846;2853;9.01;0.55;216.04;3.44;769;23;949.00;7
2084;23;625512865;2084;207;2846;2853;8.86;0.54;215.86;3.44;762;23;950.00;7
2089;23;625512874;2089;209;2849;2859;8.75;0.53;215.88;3.44;760;23;951.00;10
2092;23;625512884;2092;201;2849;2859;8.61;0.53;215.84;3.44;757;23;952.00;10
2096;23;625512894;2096;196;2851;2859;8.56;0.52;215.90;3.44;755;23;953.00;8
2098;23;625512903;2098;192;2853;2862;8.50;0.52;215.91;3.44;755;23;954.00;9
2101;23;625512912;2101;195;2856;2862;8.46;0.52;215.77;3.45;755;23;955.00;6
2106;23;625512921;2106;192;2856;2862;8.42;0.51;215.73;3.45;750;23;956.00;6
2108;23;625512930;2108;188;2856;2863;8.35;0.51;215.68;3.45;748;23;957.00;7
2110;23;625512940;2110;189;2857;2864;8.33;0.51;215.70;3.45;747;23;958.00;7
2113;23;625512949;2113;189;2857;2864;8.32;0.51;215.50;3.45;744;23;959.00;7
2116;23;625512960;2116;195;2874;2890;8.24;0.50;215.40;3.43;758;23;960.00;16
2116;23;625512971;2116;193;2875;2890;8.25;0.50;215.40;3.43;759;23;961.00;15
2118;23;625512980;2118;190;2877;2890;8.37;0.51;215.23;3.43;759;23;962.00;13
2120;23;625512989;2120;190;2878;2891;8.51;0.52;215.06;3.43;758;23;963.00;13
2123;23;625512998;2123;192;2878;2891;8.61;0.53;215.09;3.43;755;23;964.00;13
2126;23;625513007;2126;197;2880;2895;8.68;0.53;214.91;3.43;754;23;965.00;15
2131;23;625513017;2131;195;2880;2895;8.68;0.53;214.93;3.43;749;23;966.00;15
2134;23;625513027;2134;200;2884;2899;8.72;0.53;215.15;3.42;750;23;967.00;15
2136;23;625513036;2136;201;2884;2899;8.81;0.54;215.14;3.42;748;23;968.00;15
2139;23;625513046;2139;206;2886;2899;8.80;0.54;215.14;3.46;747;23;969.00;13
2140;23;625513055;2140;207;2886;2899;8.84;0.54;215.16;3.46;746;23;970.00;13
2141;23;625513065;2141;209;2887;2899;8.84;0.54;215.17;3.47;746;23;971.00;12
2144;23;625513074;2144;213;2898;2911;8.84;0.54;215.12;3.47;754;23;972.00;13
2146;23;625513084;2146;217;2900;2911;8.80;0.54;215.15;3.47;754;23;973.00;11
2146;23;625513093;2146;224;2902;2911;8.76;0.53;215.15;3.47;756;23;974.00;9
2147;23;625513102;2147;230;2902;2911;8.74;0.53;215.17;3.47;755;23;975.00;9
2149;23;625513116;2149;233;2903;2911;8.69;0.53;215.25;3.47;754;23;976.00;8
2150;23;625513125;2150;241;2904;2911;8.66;0.53;215.22;3.48;754;23;977.00;7
2150;23;625513135;2150;245;2904;2912;8.59;0.52;215.22;3.48;754;23;978.00;8
2151;23;625513144;2151;237;2904;2912;8.61;0.52;215.24;3.48;753;23;979.00;8
2151;23;625513168;2151;235;2910;2918;8.62;0.53;215.24;3.49;759;23;980.00;8
2154;23;625513187;2154;227;2912;2919;8.70;0.53;215.18;3.49;758;23;981.00;7
2155;23;625513206;2155;230;2912;2919;8.73;0.53;215.09;3.49;757;23;982.00;7
2156;23;625513223;2156;226;2914;2919;8.82;0.54;215.03;3.51;758;23;983.00;5
2159;23;625513238;2159;228;2917;2923;8.86;0.54;214.89;3.50;758;23;984.00;6
2159;23;625513255;2159;226;2919;2923;8.85;0.54;214.89;3.51;760;23;985.00;4
2161;23;625513269;2161;225;2919;2923;8.87;0.54;214.83;3.51;758;23;986.00;4
2161;23;625513280;2161;227;2921;2924;8.93;0.54;214.83;3.52;760;23;987.00;3
2162;23;625513291;2162;227;2925;2928;9.00;0.55;214.81;3.52;763;23;988.00;3
2164;24;625513309;2164;232;2926;2928;9.05;0.55;214.79;3.52;762;24;989.00;2
2166;24;625513333;2166;228;2930;2934;9.08;0.55;214.72;3.52;764;24;990.00;4
2166;25;625513346;2166;227;2930;2934;9.14;0.56;214.72;3.52;764;25;991.00;4
2166;25;625513369;2166;224;2932;2934;9.13;0.56;214.72;3.52;766;25;992.00;2
2166;25;625513379;2166;225;2933;2934;9.11;0.56;214.72;3.52;767;25;993.00;1
2168;25;625513399;2168;229;2935;2938;9.03;0.55;214.83;3.52;767;25;994.00;3
2170;25;625513409;2170;227;2936;2938;8.96;0.55;214.84;3.52;766;25;995.00;2
2174;25;625513418;2174;232;2936;2938;8.88;0.54;214.78;3.52;762;25;996.00;2
2176;25;625513428;2176;228;2937;2938;8.83;0.54;214.79;3.52;761;25;997.00;1
2177;25;625513437;2177;233;2939;2939;8.75;0.53;214.82;3.52;762;25;998.00;0
2179;25;625513447;2179;230;2940;2940;8.70;0.53;214.84;3.52;761;25;999.00;0
2180;25;625513457;2180;232;2940;2940;8.63;0.53;214.87;3.52;760;25;1000.00;0
2185;25;625513472;2185;230;2941;2941;8.57;0.52;214.68;3.52;756;25;1001.00;0
2185;25;625513481;2185;227;2941;2941;8.57;0.52;214.68;3.52;756;25;1002.00;0
2188;25;625513491;2188;226;2941;2941;8.59;0.52;214.73;3.52;753;25;1003.00;0
2190;25;625513500;2190;226;2941;2941;8.59;0.52;214.97;3.52;751;25;1004.00;0
2193;25;625513509;2193;225;2941;2941;8.60;0.52;215.19;3.52;748;25;1005.00;0
2195;25;625513525;2195;229;2941;2941;8.67;0.53;215.27;3.52;746;25;1006.00;0
2197;25;625513534;2197;229;2941;2941;8.69;0.53;215.34;3.52;744;25;1007.00;0
2199;25;625513543;2199;257;3017;3068;8.79;0.54;215.49;3.43;818;25;1008.00;51
2201;25;625513562;2201;249;3022;3069;8.78;0.54;215.64;3.42;821;25;1009.00;47
2203;25;625513572;2203;242;3028;3069;8.78;0.54;215.77;3.42;825;25;1010.00;41
2210;25;625513582;2210;242;3034;3069;8.75;0.54;215.92;3.42;824;25;1011.00;35
2211;25;625513593;2211;244;3038;3069;8.72;0.54;215.92;3.42;827;25;1012.00;31
2215;25;625513602;2215;245;3040;3069;8.66;0.53;216.24;3.42;825;25;1013.00;29
2218;25;625513617;2218;240;3043;3069;8.65;0.53;216.28;3.42;825;25;1014.00;26
2223;25;625513627;2223;247;3046;3069;8.60;0.53;216.62;3.43;823;25;1015.00;23
2227;25;625513637;2227;249;3048;3070;8.58;0.53;216.81;3.43;821;25;1016.00;22
2234;25;625513649;2234;250;3051;3071;8.51;0.52;216.87;3.44;817;25;1017.00;20
2238;25;625513659;2238;254;3053;3071;8.42;0.52;216.98;3.44;815;25;1018.00;18
2243;25;625513670;2243;258;3058;3072;8.33;0.51;217.18;3.45;815;25;1019.00;14
2247;25;625513682;2247;249;3062;3072;8.28;0.51;217.06;3.46;815;25;1020.00;10
2249;25;625513693;2249;242;3064;3072;8.19;0.50;217.26;3.47;815;25;1021.00;8
2251;25;625513704;2251;242;3065;3072;8.07;0.49;217.50;3.47;814;25;1022.00;7
2254;25;625513717;2254;245;3068;3076;8.15;0.50;217.88;3.47;814;25;1023.00;8
2258;25;625513728;2258;249;3070;3076;8.11;0.50;218.24;3.48;812;25;1024.00;6
2261;25;625513739;2261;245;3071;3076;8.13;0.50;218.42;3.48;810;25;1025.00;5
2266;25;625513750;2266;245;3074;3079;8.13;0.50;218.75;3.49;808;25;1026.00;5
2271;25;625513761;2271;236;3076;3079;8.14;0.50;218.90;3.49;805;25;1027.00;3
2274;25;625513773;2274;229;3077;3079;8.28;0.51;219.16;3.49;803;25;1028.00;2
2279;25;625513784;2279;222;3082;3083;8.28;0.51;219.58;3.49;803;25;1029.00;1
2283;25;625513796;2283;224;3083;3084;8.37;0.51;220.13;3.49;800;25;1030.00;1
2285;25;625513807;2285;223;3084;3084;8.50;0.52;220.21;3.49;799;25;1031.00;0
2290;25;625513819;2290;224;3088;3088;8.61;0.53;220.46;3.49;798;25;1032.00;0
2293;25;625513834;2293;222;3088;3088;8.70;0.53;220.57;3.49;795;25;1033.00;0
2298;25;625513846;2298;219;3088;3088;8.72;0.53;220.65;3.49;790;25;1034.00;0
2301;25;625513858;2301;219;3090;3090;8.71;0.53;220.97;3.48;789;25;1035.00;0
2303;25;625513870;2303;209;3090;3090;8.81;0.54;221.05;3.48;787;25;1036.00;0
2307;25;625513881;2307;209;3095;3096;8.85;0.54;221.09;3.48;788;25;1037.00;1
2309;25;625513893;2309;212;3095;3096;8.97;0.55;221.17;3.48;786;25;1038.00;1
2316;25;625513905;2316;209;3097;3097;8.90;0.54;221.39;3.48;781;25;1039.00;0
2320;25;625513916;2320;212;3097;3097;8.93;0.54;221.41;3.48;777;25;1040.00;0
2323;25;625513927;2323;210;3097;3097;8.93;0.54;221.65;3.48;774;25;1041.00;0
2328;25;625513946;2328;208;3097;3097;8.91;0.54;221.76;3.48;769;25;1042.00;0
2334;25;625513957;2334;205;3097;3097;8.99;0.55;221.93;3.48;763;25;1043.00;0
2338;25;625513970;2338;205;3108;3109;9.09;0.55;222.09;3.47;770;25;1044.00;1
2341;25;625513988;2341;201;3109;3109;9.16;0.56;222.23;3.47;768;25;1045.00;0
2350;25;625514005;2350;201;3109;3109;9.18;0.56;222.53;3.47;759;25;1046.00;0
2354;25;625514018;2354;197;3109;3109;9.27;0.56;222.67;3.47;755;25;1047.00;0
2360;25;625514029;2360;199;3109;3109;9.30;0.56;222.60;3.47;749;25;1048.00;0
2364;25;625514041;2364;200;3109;3109;9.35;0.57;222.97;3.47;745;25;1049.00;0
2369;25;625514054;2369;204;3115;3115;9.39;0.57;223.19;3.46;746;25;1050.00;0
2371;25;625514066;2371;202;3115;3115;9.48;0.58;223.36;3.46;744;25;1051.00;0
2375;25;625514078;2375;202;3118;3119;9.56;0.58;223.28;3.46;743;25;1052.00;1
2378;25;625514090;2378;192;3120;3120;9.61;0.58;223.38;3.46;742;25;1053.00;0
2382;25;625514101;2382;190;3120;3120;9.64;0.59;223.29;3.46;738;25;1054.00;0
2386;25;625514112;2386;190;3120;3120;9.66;0.59;223.20;3.46;734;25;1055.00;0
2389;25;625514124;2389;189;3133;3133;9.70;0.59;223.30;3.44;744;25;1056.00;0
2392;25;625514136;2392;189;3133;3133;9.74;0.59;223.44;3.44;741;25;1057.00;0
2396;25;625514149;2396;187;3133;3133;9.83;0.60;223.55;3.44;737;25;1058.00;0
2400;25;625514160;2400;184;3134;3134;9.93;0.60;223.54;3.44;734;25;1059.00;0
2406;25;625514172;2406;185;3135;3135;9.95;0.61;223.66;3.44;729;25;1060.00;0
2409;25;625514183;2409;187;3135;3135;9.95;0.61;223.87;3.44;726;25;1061.00;0
2414;25;625514196;2414;191;3137;3138;9.91;0.60;223.77;3.44;723;25;1062.00;1
2416;25;625514212;2416;192;3137;3138;9.83;0.60;223.83;3.44;721;25;1063.00;1
2425;25;625514222;2425;193;3138;3138;9.71;0.59;223.87;3.44;713;25;1064.00;0
2428;25;625514234;2428;198;3138;3138;9.62;0.58;223.86;3.44;710;25;1065.00;0
2433;25;625514244;2433;200;3143;3144;9.56;0.58;223.87;3.43;710;25;1066.00;1
2435;25;625514256;2435;197;3143;3144;9.52;0.58;223.84;3.43;708;25;1067.00;1
2437;25;625514267;2437;190;3144;3144;9.49;0.58;223.93;3.43;707;25;1068.00;0
2439;25;625514278;2439;188;3144;3144;9.49;0.58;223.97;3.43;705;25;1069.00;0
2443;25;625514288;2443;184;3148;3148;9.47;0.57;224.03;3.43;705;25;1070.00;0
2443;25;625514299;2443;186;3149;3149;9.45;0.57;224.03;3.43;706;25;1071.00;0
2445;25;625514310;2445;186;3149;3149;9.41;0.57;224.06;3.43;704;25;1072.00;0
2448;25;625514320;2448;189;3150;3150;9.36;0.57;224.29;3.43;702;25;1073.00;0
2450;25;625514331;2450;191;3150;3150;9.33;0.57;224.28;3.43;700;25;1074.00;0
2454;25;625514341;2454;192;3150;3150;9.28;0.56;224.30;3.43;696;25;1075.00;0
2456;25;625514358;2456;184;3150;3150;9.32;0.57;224.19;3.43;694;25;1076.00;0
2458;25;625514368;2458;178;3150;3150;9.36;0.57;224.16;3.43;692;25;1077.00;0
2460;25;625514378;2460;167;3150;3150;9.39;0.57;224.42;3.43;690;25;1078.00;0
2461;26;625514388;2461;164;3150;3150;9.45;0.58;224.47;3.43;689;26;1079.00;0
2466;26;625514406;2466;196;3237;3275;9.27;0.57;224.66;3.34;771;26;1080.00;38
2467;26;625514431;2467;187;3242;3276;9.33;0.57;224.77;3.33;775;26;1081.00;34
2469;26;625514442;2469;162;3248;3276;9.43;0.58;224.86;3.33;779;26;1082.00;28
2473;26;625514452;2473;159;3253;3276;9.50;0.58;225.03;3.33;780;26;1083.00;23
2475;26;625514463;2475;152;3257;3276;9.49;0.58;225.19;3.33;782;26;1084.00;19
2477;26;625514474;2477;149;3262;3276;9.50;0.58;225.31;3.33;785;26;1085.00;14
2482;26;625514491;2482;152;3265;3276;9.40;0.58;225.28;3.34;783;26;1086.00;11
2485;26;625514502;2485;158;3265;3276;9.33;0.57;225.29;3.34;780;26;1087.00;11
2486;26;625514513;2486;152;3268;3277;9.27;0.57;225.25;3.34;782;26;1088.00;9
2488;26;625514525;2488;165;3270;3278;9.23;0.57;225.25;3.34;782;26;1089.00;8
2492;26;625514537;2492;171;3272;3278;9.14;0.56;225.15;3.35;780;26;1090.00;6
2494;26;625514549;2494;167;3278;3282;9.01;0.55;225.15;3.35;784;26;1091.00;4
2500;26;625514560;2500;176;3279;3282;8.83;0.54;225.47;3.35;779;26;1092.00;3
2502;26;625514571;2502;188;3279;3282;8.74;0.53;225.48;3.35;777;26;1093.00;3
2504;26;625514581;2504;195;3280;3282;8.67;0.53;225.45;3.35;776;26;1094.00;2
2505;26;625514592;2505;200;3283;3288;8.57;0.52;225.48;3.35;778;26;1095.00;5
2507;26;625514603;2507;205;3284;3288;8.51;0.52;225.45;3.35;777;26;1096.00;4
2508;26;625514613;2508;205;3285;3288;8.43;0.51;225.47;3.35;777;26;1097.00;3
2509;26;625514622;2509;215;3287;3291;8.43;0.52;225.42;3.35;778;26;1098.00;4
2511;26;625514632;2511;221;3287;3291;8.41;0.51;225.47;3.35;776;26;1099.00;4
2512;26;625514649;2512;228;3287;3291;8.36;0.51;225.46;3.35;775;26;1100.00;4
2515;26;625514661;2515;232;3288;3292;8.29;0.51;225.40;3.35;773;26;1101.00;4
2515;26;625514676;2515;234;3290;3293;8.26;0.51;225.40;3.35;775;26;1102.00;3
2520;26;625514686;2520;235;3290;3293;8.18;0.50;225.15;3.35;770;26;1103.00;3
2521;26;625514695;2521;245;3300;3306;8.20;0.50;225.13;3.34;779;26;1104.00;6
2523;26;625514706;2523;247;3300;3306;8.18;0.50;225.11;3.34;777;26;1105.00;6
2525;26;625514715;2525;251;3300;3306;8.18;0.50;225.13;3.34;775;26;1106.00;6
2526;26;625514724;2526;257;3301;3307;8.20;0.50;225.13;3.33;775;26;1107.00;6
2526;26;625514733;2526;259;3301;3307;8.17;0.50;225.13;3.33;775;26;1108.00;6
2529;26;625514742;2529;265;3304;3311;8.14;0.50;225.03;3.33;775;26;1109.00;7
2531;26;625514759;2531;262;3304;3311;8.17;0.50;224.98;3.33;773;26;1110.00;7
2535;26;625514769;2535;257;3308;3315;8.20;0.50;224.87;3.33;773;26;1111.00;7
2540;26;625514778;2540;253;3308;3315;8.26;0.51;224.79;3.33;768;26;1112.00;7
2541;26;625514788;2541;253;3308;3315;8.34;0.51;224.74;3.33;767;26;1113.00;7
2545;26;625514797;2545;250;3308;3315;8.37;0.51;224.65;3.33;763;26;1114.00;7
2547;26;625514807;2547;247;3308;3315;8.39;0.51;224.61;3.33;761;26;1115.00;7
2548;26;625514816;2548;248;3317;3327;8.46;0.52;224.72;3.32;769;26;1116.00;10
2549;26;625514826;2549;248;3318;3327;8.47;0.52;224.65;3.32;769;26;1117.00;9
2554;26;625514834;2554;245;3319;3327;8.45;0.52;224.61;3.32;765;26;1118.00;8
2556;26;625514844;2556;243;3319;3327;8.45;0.52;224.58;3.32;763;26;1119.00;8
2561;26;625514853;2561;242;3320;3327;8.33;0.51;224.44;3.33;759;26;1120.00;7
2561;26;625514862;2561;238;3320;3327;8.31;0.51;224.44;3.33;759;26;1121.00;7
2561;26;625514870;2561;229;3320;3328;8.24;0.51;224.44;3.33;759;26;1122.00;8
2564;26;625514879;2564;235;3322;3328;8.14;0.50;224.49;3.35;758;26;1123.00;6
2566;26;625514887;2566;225;3326;3334;8.13;0.50;224.47;3.34;760;26;1124.00;8
2569;26;625514897;2569;225;3331;3336;8.07;0.49;224.45;3.36;762;26;1125.00;5
2573;26;625514906;2573;224;3331;3336;8.00;0.49;224.50;3.36;758;26;1126.00;5
2575;26;625514915;2575;226;3331;3336;8.04;0.49;224.41;3.36;756;26;1127.00;5
2575;26;625514923;2575;227;3334;3340;8.03;0.49;224.41;3.35;759;26;1128.00;6
2578;26;625514939;2578;224;3334;3340;7.97;0.48;224.32;3.35;756;26;1129.00;6
2580;26;625514948;2580;220;3334;3340;7.96;0.48;224.24;3.35;754;26;1130.00;6
2583;26;625514957;2583;210;3335;3341;7.99;0.48;224.25;3.35;752;26;1131.00;6
2585;26;625514966;2585;197;3338;3345;8.08;0.49;224.18;3.35;753;26;1132.00;7
2586;26;625514976;2586;186;3338;3345;8.17;0.49;224.16;3.35;752;26;1133.00;7
2586;26;625514985;2586;179;3340;3348;8.38;0.51;224.16;3.35;754;26;1134.00;8
2586;26;625514995;2586;174;3341;3348;8.55;0.52;224.16;3.35;755;26;1135.00;7
2588;26;625515004;2588;166;3341;3348;8.74;0.53;224.17;3.35;753;26;1136.00;7
2590;26;625515019;2590;161;3341;3348;8.88;0.54;224.17;3.35;751;26;1137.00;7
2593;26;625515030;2593;156;3344;3352;8.99;0.54;224.05;3.35;751;26;1138.00;8
2594;26;625515041;2594;149;3344;3352;9.16;0.55;224.03;3.35;750;26;1139.00;8
2595;26;625515053;2595;144;3345;3352;9.28;0.56;223.97;3.35;750;26;1140.00;7
2596;26;625515064;2596;139;3345;3352;9.39;0.57;223.92;3.35;749;26;1141.00;7
2596;26;625515080;2596;137;3345;3353;9.48;0.57;223.92;3.35;749;26;1142.00;8
2596;26;625515091;2596;141;3346;3354;9.62;0.58;223.92;3.34;750;26;1143.00;8
2598;26;625515106;2598;140;3346;3354;9.66;0.59;223.87;3.34;748;26;1144.00;8
2599;26;625515121;2599;143;3347;3355;9.78;0.59;223.87;3.34;748;26;1145.00;8
2601;26;625515131;2601;142;3347;3355;9.83;0.60;223.82;3.34;746;26;1146.00;8
2602;26;625515142;2602;144;3347;3355;9.82;0.60;223.85;3.34;745;26;1147.00;8
2603;26;625515156;2603;147;3347;3355;9.86;0.60;223.86;3.34;744;26;1148.00;8
2605;26;625515170;2605;148;3348;3355;9.85;0.60;223.85;3.35;743;26;1149.00;7
2606;26;625515187;2606;155;3349;3355;9.88;0.60;223.84;3.37;743;26;1150.00;6
2606;26;625515204;2606;153;3349;3355;9.94;0.60;223.84;3.37;743;26;1151.00;6
2609;26;625515218;2609;180;3416;3482;9.93;0.61;223.91;3.31;807;26;1152.00;66
2611;26;625515254;2611;170;3418;3483;9.89;0.61;223.90;3.32;807;26;1153.00;65
2612;26;625515269;2612;163;3427;3483;10.00;0.61;223.87;3.32;815;26;1154.00;56
2614;26;625515281;2614;170;3434;3483;9.99;0.61;223.81;3.32;820;26;1155.00;49
2616;26;625515294;2616;168;3440;3483;9.98;0.61;223.94;3.33;824;26;1156.00;43
2618;26;625515314;2618;173;3445;3483;9.93;0.61;223.98;3.33;827;26;1157.00;38
2621;26;625515326;2621;176;3450;3483;9.88;0.61;224.09;3.34;829;26;1158.00;33
2624;27;625515338;2624;175;3451;3483;9.80;0.60;224.13;3.35;827;27;1159.00;32
2628;27;625515367;2628;170;3458;3484;9.79;0.60;224.20;3.36;830;27;1160.00;26
2631;27;625515385;2631;181;3460;3485;9.72;0.60;224.33;3.36;829;27;1161.00;25
2633;27;625515395;2633;184;3466;3485;9.65;0.59;224.36;3.37;833;27;1162.00;19
2635;27;625515406;2635;190;3470;3486;9.59;0.59;224.49;3.38;835;27;1163.00;16
2638;27;625515416;2638;198;3475;3486;9.49;0.58;224.58;3.39;837;27;1164.00;11
2638;27;625515427;2638;204;3478;3486;9.35;0.58;224.58;3.40;840;27;1165.00;8
2641;27;625515438;2641;215;3480;3486;9.29;0.57;224.64;3.41;839;27;1166.00;6
2642;27;625515448;2642;227;3485;3490;9.14;0.56;224.72;3.41;843;27;1167.00;5
2645;27;625515459;2645;229;3487;3490;8.99;0.55;224.80;3.42;842;27;1168.00;3
2647;27;625515477;2647;230;3487;3490;8.85;0.54;224.82;3.42;840;27;1169.00;3
2649;27;625515495;2649;226;3491;3496;8.74;0.54;224.90;3.42;842;27;1170.00;5
2651;27;625515507;2651;231;3491;3496;8.68;0.53;225.00;3.42;840;27;1171.00;5
2655;27;625515519;2655;234;3492;3496;8.63;0.53;225.05;3.42;837;27;1172.00;4
2658;27;625515530;2658;239;3496;3500;8.56;0.53;225.36;3.42;838;27;1173.00;4
2661;27;625515541;2661;241;3498;3501;8.59;0.53;225.31;3.42;837;27;1174.00;3
2665;27;625515557;2665;237;3498;3501;8.60;0.53;225.38;3.42;833;27;1175.00;3
2665;27;625515571;2665;235;3503;3505;8.81;0.54;225.38;3.41;838;27;1176.00;2
2670;27;625515583;2670;236;3504;3505;8.82;0.54;225.77;3.41;834;27;1177.00;1
2672;27;625515601;2672;233;3504;3505;8.83;0.54;225.82;3.41;832;27;1178.00;1
2676;27;625515614;2676;235;3506;3506;8.82;0.54;225.82;3.42;830;27;1179.00;0
2678;27;625515626;2678;236;3506;3506;8.81;0.54;225.85;3.42;828;27;1180.00;0
2681;27;625515637;2681;237;3510;3512;8.73;0.53;226.04;3.41;829;27;1181.00;2
2685;27;625515648;2685;240;3512;3512;8.62;0.53;226.11;3.41;827;27;1182.00;0
2689;27;625515659;2689;235;3513;3513;8.53;0.52;226.18;3.41;824;27;1183.00;0
2694;27;625515670;2694;235;3513;3513;8.46;0.52;226.37;3.41;819;27;1184.00;0
2698;27;625515681;2698;237;3513;3513;8.45;0.51;226.29;3.41;815;27;1185.00;0
2702;27;625515693;2702;242;3513;3513;8.37;0.51;226.36;3.41;811;27;1186.00;0
2707;27;625515704;2707;242;3513;3513;8.29;0.51;226.52;3.41;806;27;1187.00;0
2710;27;625515715;2710;246;3524;3525;8.23;0.50;226.67;3.40;814;27;1188.00;1
2715;27;625515726;2715;244;3524;3525;8.14;0.50;226.91;3.40;809;27;1189.00;1
2719;27;625515737;2719;233;3525;3525;8.09;0.49;227.08;3.40;806;27;1190.00;0
2721;27;625515747;2721;226;3525;3525;8.06;0.49;227.24;3.40;804;27;1191.00;0
2725;27;625515757;2725;223;3525;3525;8.05;0.49;227.52;3.40;800;27;1192.00;0
2728;27;625515767;2728;218;3525;3525;8.06;0.49;227.78;3.40;797;27;1193.00;0
2731;27;625515777;2731;214;3529;3529;8.03;0.49;227.92;3.40;798;27;1194.00;0
2734;27;625515788;2734;216;3529;3529;8.06;0.49;228.05;3.40;795;27;1195.00;0
2740;27;625515798;2740;217;3532;3533;8.06;0.49;228.58;3.40;792;27;1196.00;1
2743;27;625515809;2743;210;3534;3534;8.13;0.50;228.64;3.39;791;27;1197.00;0
2748;27;625515820;2748;202;3534;3534;8.12;0.50;228.78;3.39;786;27;1198.00;0
2749;27;625515830;2749;195;3534;3534;8.17;0.50;228.89;3.39;785;27;1199.00;0
2756;27;625515844;2756;194;3559;3575;8.07;0.49;229.03;3.37;803;27;1200.00;16
2758;27;625515863;2758;183;3560;3575;8.13;0.50;229.16;3.37;802;27;1201.00;15
2761;27;625515873;2761;192;3563;3575;8.21;0.50;229.29;3.37;802;27;1202.00;12
2768;27;625515884;2768;187;3565;3576;8.25;0.50;229.34;3.37;797;27;1203.00;11
2769;27;625515895;2769;190;3568;3577;8.30;0.51;229.40;3.37;799;27;1204.00;9
2772;27;625515906;2772;188;3570;3577;8.38;0.51;229.56;3.37;798;27;1205.00;7
2776;27;625515917;2776;190;3572;3580;8.52;0.52;229.64;3.37;796;27;1206.00;8
2781;27;625515929;2781;193;3572;3580;8.63;0.53;229.72;3.37;791;27;1207.00;8
2782;27;625515940;2782;196;3574;3580;8.69;0.53;229.74;3.37;792;27;1208.00;6
2788;27;625515950;2788;192;3574;3580;8.74;0.53;229.80;3.37;786;27;1209.00;6
2792;27;625515961;2792;190;3578;3586;8.75;0.54;230.01;3.37;786;27;1210.00;8
2796;27;625515973;2796;192;3581;3586;8.75;0.54;230.07;3.37;785;27;1211.00;5
2802;27;625515985;2802;192;3581;3586;8.77;0.54;230.26;3.37;779;27;1212.00;5
2806;27;625516004;2806;192;3582;3586;8.79;0.54;230.35;3.37;776;27;1213.00;4
2811;27;625516015;2811;191;3586;3590;8.75;0.54;230.50;3.37;775;27;1214.00;4
2817;27;625516027;2817;192;3588;3592;8.78;0.54;230.57;3.36;771;27;1215.00;4
2820;27;625516038;2820;196;3588;3592;8.79;0.54;230.61;3.36;768;27;1216.00;4
2826;27;625516049;2826;195;3590;3593;8.86;0.54;230.80;3.37;764;27;1217.00;3
2829;27;625516061;2829;193;3590;3593;8.95;0.55;231.14;3.37;761;27;1218.00;3
2833;27;625516072;2833;194;3590;3593;9.03;0.55;231.29;3.37;757;27;1219.00;3
2839;27;625516084;2839;199;3590;3593;9.04;0.55;231.24;3.37;751;27;1220.00;3
2843;27;625516096;2843;201;3590;3593;9.07;0.56;231.41;3.37;747;27;1221.00;3
2851;27;625516106;2851;203;3590;3593;9.02;0.55;231.37;3.37;739;27;1222.00;3
2858;27;625516118;2858;205;3591;3593;8.89;0.54;231.58;3.37;733;27;1223.00;2
2863;27;625516136;2863;211;3634;3663;8.75;0.54;231.78;3.33;771;27;1224.00;29
2865;27;625516154;2865;203;3635;3664;8.69;0.53;231.77;3.33;770;27;1225.00;29
2869;27;625516165;2869;204;3639;3664;8.67;0.53;231.84;3.33;770;27;1226.00;25
2873;27;625516176;2873;207;3642;3664;8.74;0.54;231.95;3.33;769;27;1227.00;22
2879;27;625516187;2879;211;3645;3666;8.86;0.54;231.98;3.33;766;27;1228.00;21
2883;27;625516199;2883;221;3648;3666;8.94;0.55;232.13;3.34;765;27;1229.00;18
2888;27;625516212;2888;222;3652;3666;8.95;0.55;232.13;3.34;764;27;1230.00;14
2893;27;625516237;2893;225;3654;3666;8.87;0.54;232.08;3.34;761;27;1231.00;12
2896;27;625516247;2896;234;3658;3667;8.81;0.54;232.12;3.35;762;27;1232.00;9
2900;27;625516258;2900;248;3661;3668;8.67;0.53;232.19;3.35;761;27;1233.00;7
2903;27;625516269;2903;259;3664;3668;8.57;0.52;232.28;3.36;761;27;1234.00;4
2908;27;625516279;2908;268;3669;3672;8.39;0.51;232.29;3.36;761;27;1235.00;3
2911;27;625516290;2911;272;3670;3672;8.30;0.51;232.41;3.37;759;27;1236.00;2
2914;27;625516300;2914;264;3670;3672;8.24;0.50;232.57;3.37;756;27;1237.00;2
2919;27;625516310;2919;261;3671;3672;8.19;0.50;232.61;3.37;752;27;1238.00;1
2923;27;625516321;2923;258;3677;3678;8.16;0.50;232.62;3.36;754;27;1239.00;1
2926;27;625516332;2926;256;3678;3678;8.21;0.50;232.74;3.36;752;27;1240.00;0
2928;27;625516343;2928;258;3678;3678;8.29;0.51;232.75;3.36;750;27;1241.00;0
2931;27;625516353;2931;262;3681;3681;8.39;0.51;232.89;3.36;750;27;1242.00;0
2937;27;625516368;2937;260;3681;3681;8.36;0.51;232.84;3.36;744;27;1243.00;0
2940;27;625516379;2940;262;3681;3681;8.37;0.51;232.84;3.36;741;27;1244.00;0
2941;27;625516389;2941;257;3682;3682;8.34;0.51;232.97;3.36;741;27;1245.00;0
2942;27;625516399;2942;251;3683;3683;8.31;0.51;233.02;3.36;741;27;1246.00;0
2943;27;625516410;2943;240;3683;3683;8.31;0.51;233.00;3.36;740;27;1247.00;0
2948;27;625516420;2948;229;3696;3696;8.36;0.51;232.91;3.35;748;27;1248.00;0
2950;27;625516432;2950;223;3696;3696;8.40;0.51;232.87;3.35;746;27;1249.00;0
2952;27;625516443;2952;224;3696;3696;8.43;0.51;232.98;3.35;744;27;1250.00;0
2956;27;625516453;2956;222;3697;3697;8.53;0.52;232.97;3.35;741;27;1251.00;0
2959;27;625516464;2959;221;3697;3697;8.55;0.52;232.99;3.35;738;27;1252.00;0
2959;28;625516475;2959;223;3700;3701;8.64;0.53;232.99;3.35;741;28;1253.00;1
2961;28;625516495;2961;224;3700;3701;8.75;0.53;233.20;3.35;739;28;1254.00;1
2964;28;625516507;2964;226;3705;3705;8.76;0.53;233.12;3.34;741;28;1255.00;0
2965;28;625516517;2965;232;3705;3705;8.80;0.53;233.08;3.34;740;28;1256.00;0
2966;28;625516528;2966;221;3705;3705;8.86;0.54;233.10;3.34;739;28;1257.00;0
2967;28;625516538;2967;218;3705;3705;8.84;0.54;233.06;3.34;738;28;1258.00;0
2968;28;625516555;2968;217;3705;3705;8.80;0.53;233.00;3.34;737;28;1259.00;0
2969;28;625516567;2969;225;3730;3739;8.77;0.54;232.96;3.32;761;28;1260.00;9
2971;28;625516579;2971;225;3730;3739;8.71;0.53;232.99;3.32;759;28;1261.00;9
2972;28;625516590;2972;223;3731;3739;8.69;0.53;232.95;3.32;759;28;1262.00;8
2973;28;625516599;2973;225;3731;3739;8.59;0.53;232.91;3.32;758;28;1263.00;8
2975;28;625516609;2975;225;3733;3739;8.52;0.52;232.84;3.32;758;28;1264.00;6
2976;28;625516619;2976;231;3733;3739;8.47;0.52;232.81;3.32;757;28;1265.00;6
2978;28;625516628;2978;235;3734;3740;8.42;0.52;232.74;3.32;756;28;1266.00;6
2982;28;625516638;2982;238;3735;3740;8.34;0.51;232.60;3.32;753;28;1267.00;5
2984;28;625516647;2984;243;3739;3746;8.34;0.51;232.60;3.32;755;28;1268.00;7
2985;28;625516657;2985;246;3741;3747;8.40;0.52;232.56;3.32;756;28;1269.00;6
2988;28;625516667;2988;251;3742;3747;8.35;0.51;232.41;3.32;754;28;1270.00;5
2991;28;625516676;2991;252;3743;3747;8.29;0.51;232.33;3.32;752;28;1271.00;4
2993;28;625516686;2993;246;3745;3751;8.24;0.50;232.33;3.32;752;28;1272.00;6
2994;28;625516702;2994;256;3746;3751;8.15;0.50;232.32;3.32;752;28;1273.00;5
2995;28;625516711;2995;265;3746;3751;8.05;0.49;232.33;3.32;751;28;1274.00;5
2996;28;625516726;2996;274;3747;3752;7.99;0.49;232.31;3.32;751;28;1275.00;5
2997;28;625516735;2997;282;3750;3756;7.93;0.48;232.45;3.32;753;28;1276.00;6
2998;28;625516745;2998;290;3750;3756;7.87;0.48;232.44;3.32;752;28;1277.00;6
3000;28;625516754;3000;294;3752;3759;7.88;0.48;232.33;3.32;752;28;1278.00;7
3002;28;625516763;3002;297;3752;3759;7.87;0.48;232.30;3.32;750;28;1279.00;7
3004;28;625516772;3004;298;3753;3759;7.84;0.48;232.20;3.32;749;28;1280.00;6
3007;28;625516781;3007;294;3753;3759;7.83;0.48;232.21;3.32;746;28;1281.00;6
3009;28;625516790;3009;294;3756;3763;7.80;0.47;232.23;3.31;747;28;1282.00;7
3009;28;625516800;3009;275;3756;3763;7.83;0.48;232.23;3.31;747;28;1283.00;7
3010;28;625516808;3010;260;3757;3763;7.91;0.48;232.29;3.31;747;28;1284.00;6
3012;28;625516817;3012;248;3757;3763;7.90;0.48;232.26;3.31;745;28;1285.00;6
3014;28;625516826;3014;238;3757;3764;7.94;0.48;232.29;3.31;743;28;1286.00;7
3016;28;625516836;3016;228;3758;3765;7.98;0.48;232.22;3.31;742;28;1287.00;7
3017;29;625516846;3017;219;3758;3765;8.02;0.49;232.17;3.31;741;29;1288.00;7
3018;29;625516866;3018;203;3759;3766;8.15;0.49;232.19;3.31;741;29;1289.00;7
3022;29;625516876;3022;198;3759;3766;8.25;0.50;232.20;3.31;737;29;1290.00;7
3022;30;625516886;3022;185;3759;3766;8.37;0.51;232.20;3.31;737;30;1291.00;7
3026;30;625516910;3026;180;3759;3766;8.43;0.51;232.26;3.31;733;30;1292.00;7
3028;31;625516919;3028;175;3759;3766;8.47;0.51;232.26;3.31;731;31;1293.00;7
3031;31;625516939;3031;170;3760;3766;8.49;0.52;232.27;3.32;729;31;1294.00;6
3034;31;625516948;3034;167;3761;3766;8.58;0.52;232.29;3.33;727;31;1295.00;5
3036;31;625516957;3036;177;3822;3893;8.67;0.53;232.24;3.27;786;31;1296.00;71
3039;31;625516977;3039;168;3822;3894;8.77;0.54;232.17;3.27;783;31;1297.00;72
3043;31;625516987;3043;160;3829;3894;8.90;0.55;232.10;3.27;786;31;1298.00;65
3046;31;625516996;3046;155;3832;3894;9.03;0.55;232.00;3.27;786;31;1299.00;62
3047;31;625517006;3047;149;3838;3894;9.17;0.56;231.98;3.27;791;31;1300.00;56
3047;31;625517020;3047;145;3842;3894;9.28;0.57;231.98;3.28;795;31;1301.00;52
3049;31;625517029;3049;142;3846;3894;9.41;0.58;231.97;3.28;797;31;1302.00;48
3049;31;625517038;3049;139;3849;3894;9.51;0.58;231.97;3.28;800;31;1303.00;45
3051;31;625517048;3051;139;3853;3895;9.63;0.59;232.03;3.29;802;31;1304.00;42
3055;31;625517058;3055;140;3857;3897;9.63;0.59;231.95;3.29;802;31;1305.00;40
3058;31;625517069;3058;136;3860;3897;9.67;0.59;232.21;3.29;802;31;1306.00;37
3060;31;625517079;3060;139;3865;3898;9.71;0.59;232.16;3.30;805;31;1307.00;33
3063;31;625517090;3063;136;3868;3898;9.70;0.59;232.16;3.31;805;31;1308.00;30
3065;31;625517100;3065;133;3870;3898;9.61;0.59;232.16;3.31;805;31;1309.00;28
3069;31;625517116;3069;141;3872;3898;9.60;0.59;232.06;3.32;803;31;1310.00;26
3073;31;625517126;3073;143;3874;3902;9.62;0.59;232.16;3.32;801;31;1311.00;28
3077;31;625517137;3077;144;3878;3902;9.60;0.59;232.20;3.34;801;31;1312.00;24
3080;31;625517147;3080;143;3880;3902;9.55;0.58;232.38;3.34;800;31;1313.00;22
3083;31;625517163;3083;151;3882;3905;9.56;0.58;232.46;3.34;799;31;1314.00;23
3087;31;625517183;3087;156;3886;3905;9.49;0.58;232.57;3.35;799;31;1315.00;19
3091;31;625517201;3091;157;3888;3905;9.45;0.57;232.59;3.37;797;31;1316.00;17
3094;31;625517227;3094;161;3895;3909;9.37;0.57;232.77;3.38;801;31;1317.00;14
3097;31;625517244;3097;170;3896;3910;9.42;0.57;232.92;3.38;799;31;1318.00;14
3098;31;625517262;3098;171;3897;3910;9.45;0.57;232.94;3.39;799;31;1319.00;13
3100;31;625517281;3100;172;3902;3915;9.45;0.57;233.11;3.40;802;31;1320.00;13
3101;31;625517293;3101;179;3903;3915;9.45;0.57;233.09;3.40;802;31;1321.00;12
3105;31;625517305;3105;179;3904;3915;9.43;0.57;233.27;3.41;799;31;1322.00;11
3108;31;625517323;3108;180;3906;3916;9.43;0.57;233.30;3.42;798;31;1323.00;10
3110;31;625517336;3110;184;3906;3916;9.48;0.58;233.40;3.42;796;31;1324.00;10
3113;31;625517347;3113;185;3912;3922;9.48;0.58;233.54;3.43;799;31;1325.00;10
3115;31;625517359;3115;189;3913;3922;9.48;0.58;233.66;3.43;798;31;1326.00;9
3119;31;625517370;3119;195;3915;3923;9.41;0.57;233.93;3.43;796;31;1327.00;8
3121;31;625517382;3121;195;3915;3923;9.44;0.58;234.05;3.43;794;31;1328.00;8
3123;31;625517393;3123;196;3915;3923;9.44;0.58;234.05;3.43;792;31;1329.00;8
3125;31;625517404;3125;198;3916;3923;9.45;0.58;234.14;3.44;791;31;1330.00;7
3130;31;625517415;3130;198;3916;3923;9.40;0.57;234.11;3.44;786;31;1331.00;7
3132;31;625517426;3132;202;3926;3935;9.37;0.57;234.24;3.44;794;31;1332.00;9
3135;31;625517438;3135;203;3928;3935;9.36;0.57;234.29;3.46;793;31;1333.00;7
3138;31;625517448;3138;208;3932;3935;9.41;0.57;234.34;3.47;794;31;1334.00;3
3144;31;625517459;3144;206;3932;3935;9.40;0.57;234.43;3.47;788;31;1335.00;3
3147;31;625517470;3147;208;3934;3935;9.37;0.57;234.46;3.47;787;31;1336.00;1
3151;31;625517481;3151;208;3934;3935;9.33;0.57;234.60;3.47;783;31;1337.00;1
3155;31;625517492;3155;211;3939;3939;9.22;0.56;234.79;3.47;784;31;1338.00;0
3157;31;625517503;3157;206;3939;3939;9.23;0.56;234.85;3.47;782;31;1339.00;0
3159;31;625517515;3159;207;3942;3943;9.27;0.56;234.94;3.47;783;31;1340.00;1
3161;31;625517533;3161;203;3943;3944;9.25;0.56;235.12;3.47;782;31;1341.00;1
3163;31;625517544;3163;201;3944;3944;9.30;0.57;235.11;3.47;781;31;1342.00;0
3169;31;625517556;3169;203;3944;3944;9.25;0.56;235.24;3.47;775;31;1343.00;0
3172;31;625517567;3172;201;3956;3957;9.22;0.56;235.32;3.46;784;31;1344.00;1
3173;31;625517580;3173;200;3956;3957;9.23;0.56;235.33;3.46;783;31;1345.00;1
3175;31;625517591;3175;198;3957;3957;9.29;0.57;235.43;3.46;782;31;1346.00;0
3177;31;625517603;3177;200;3958;3958;9.31;0.57;235.52;3.46;781;31;1347.00;0
3178;31;625517613;3178;204;3959;3959;9.32;0.57;235.48;3.46;781;31;1348.00;0
3180;31;625517624;3180;204;3959;3959;9.32;0.57;235.57;3.46;779;31;1349.00;0
3182;31;625517637;3182;208;3962;3968;9.28;0.57;235.59;3.45;780;31;1350.00;6
3185;31;625517649;3185;216;3963;3968;9.13;0.56;235.54;3.45;778;31;1351.00;5
3189;31;625517659;3189;218;3964;3968;9.02;0.55;235.61;3.45;775;31;1352.00;4
3191;31;625517669;3191;221;3964;3968;8.92;0.54;235.64;3.45;773;31;1353.00;4
3195;31;625517680;3195;223;3969;3974;8.89;0.54;235.73;3.45;774;31;1354.00;5
3200;31;625517692;3200;222;3970;3974;8.81;0.54;235.74;3.45;770;31;1355.00;4
3203;31;625517703;3203;220;3970;3974;8.76;0.53;235.87;3.45;767;31;1356.00;4
3207;31;625517713;3207;219;3972;3974;8.62;0.53;235.92;3.45;765;31;1357.00;2
3210;31;625517723;3210;221;3976;3978;8.48;0.52;236.12;3.45;766;31;1358.00;2
3212;31;625517734;3212;226;3978;3979;8.41;0.51;236.03;3.45;766;31;1359.00;1
3215;31;625517744;3215;213;3978;3979;8.34;0.51;236.09;3.45;763;31;1360.00;1
3219;31;625517754;3219;208;3979;3980;8.22;0.50;236.14;3.45;760;31;1361.00;1
3224;31;625517764;3224;206;3979;3980;8.16;0.50;236.24;3.45;755;31;1362.00;1
3228;31;625517773;3228;202;3979;3980;8.08;0.49;236.29;3.45;751;31;1363.00;1
3232;31;625517783;3232;209;3979;3980;8.07;0.49;236.37;3.45;747;31;1364.00;1
3234;31;625517793;3234;206;3979;3980;8.07;0.49;236.37;3.45;745;31;1365.00;1
3237;31;625517803;3237;207;3979;3980;8.10;0.49;236.46;3.45;742;31;1366.00;1
3240;31;625517818;3240;201;3979;3980;8.07;0.49;236.49;3.45;739;31;1367.00;1
3242;31;625517829;3242;206;4022;4050;8.21;0.50;236.61;3.41;780;31;1368.00;28
3245;31;625517848;3245;191;4027;4051;8.37;0.51;236.60;3.41;782;31;1369.00;24
3248;31;625517859;3248;188;4032;4051;8.55;0.52;236.55;3.41;784;31;1370.00;19
3253;31;625517869;3253;190;4038;4051;8.65;0.53;236.74;3.41;785;31;1371.00;13
3257;31;625517880;3257;186;4041;4051;8.68;0.53;236.76;3.41;784;31;1372.00;10
3261;31;625517891;3261;188;4044;4051;8.77;0.54;236.86;3.41;783;31;1373.00;7
3263;31;625517902;3263;190;4046;4051;8.87;0.54;236.86;3.41;783;31;1374.00;5
3269;31;625517912;3269;195;4047;4051;8.86;0.54;237.00;3.41;778;31;1375.00;4
3276;31;625517924;3276;191;4049;4052;8.89;0.54;236.88;3.41;773;31;1376.00;3
3281;31;625517935;3281;183;4050;4053;8.93;0.54;236.90;3.41;769;31;1377.00;3
3284;31;625517945;3284;185;4051;4053;9.00;0.55;236.85;3.41;767;31;1378.00;2
3291;31;625517956;3291;189;4054;4057;8.98;0.55;237.01;3.41;763;31;1379.00;3
3293;31;625517969;3293;191;4054;4057;9.06;0.55;237.11;3.41;761;31;1380.00;3
3297;31;625517980;3297;189;4054;4057;9.09;0.55;237.16;3.41;757;31;1381.00;3
3299;31;625517991;3299;191;4054;4057;9.11;0.56;237.15;3.41;755;31;1382.00;3
3302;31;625518001;3302;194;4058;4063;9.13;0.56;237.18;3.41;756;31;1383.00;5
3305;31;625518013;3305;202;4059;4063;9.13;0.56;237.22;3.41;754;31;1384.00;4
3311;31;625518024;3311;205;4060;4063;9.09;0.56;237.46;3.41;749;31;1385.00;3
3315;31;625518035;3315;207;4064;4066;9.06;0.55;237.42;3.41;749;31;1386.00;2
3319;31;625518046;3319;211;4064;4066;9.05;0.55;237.41;3.41;745;31;1387.00;2
3326;31;625518056;3326;221;4065;4066;8.99;0.55;237.71;3.42;739;31;1388.00;1
3330;31;625518068;3330;218;4066;4067;9.00;0.55;237.67;3.41;736;31;1389.00;1
3334;31;625518078;3334;221;4068;4068;8.94;0.55;237.76;3.42;734;31;1390.00;0
3342;31;625518089;3342;219;4068;4068;8.87;0.54;237.91;3.42;726;31;1391.00;0
3347;31;625518100;3347;226;4080;4081;8.89;0.54;237.83;3.41;733;31;1392.00;1
3353;31;625518111;3353;228;4080;4081;8.79;0.54;237.96;3.41;727;31;1393.00;1
3360;31;625518123;3360;236;4081;4081;8.68;0.53;238.11;3.41;721;31;1394.00;0
3364;31;625518134;3364;239;4083;4083;8.61;0.53;238.05;3.41;719;31;1395.00;0
3368;31;625518144;3368;248;4083;4083;8.51;0.52;238.34;3.41;715;31;1396.00;0
3372;31;625518156;3372;254;4086;4087;8.49;0.52;238.34;3.40;714;31;1397.00;1
3376;31;625518167;3376;261;4086;4087;8.39;0.51;238.39;3.40;710;31;1398.00;1
3380;32;625518177;3380;268;4091;4091;8.30;0.51;238.34;3.40;711;32;1399.00;0
3383;32;625518200;3383;275;4091;4091;8.22;0.50;238.50;3.40;708;32;1400.00;0
3386;32;625518213;3386;287;4091;4091;8.21;0.50;238.52;3.40;705;32;1401.00;0
3389;32;625518223;3389;295;4091;4091;8.12;0.49;238.43;3.40;702;32;1402.00;0
3392;32;625518232;3392;302;4091;4091;8.00;0.49;238.48;3.40;699;32;1403.00;0
3394;32;625518247;3394;304;4101;4103;7.94;0.48;238.46;3.39;707;32;1404.00;2
3395;32;625518257;3395;308;4101;4103;7.83;0.48;238.40;3.39;706;32;1405.00;2
3397;32;625518267;3397;312;4103;4103;7.75;0.47;238.39;3.39;706;32;1406.00;0
3400;32;625518276;3400;301;4103;4103;7.71;0.47;238.39;3.39;703;32;1407.00;0
3403;32;625518285;3403;298;4103;4103;7.70;0.47;238.43;3.39;700;32;1408.00;0
3403;32;625518295;3403;299;4103;4103;7.66;0.47;238.43;3.39;700;32;1409.00;0
3404;32;625518305;3404;299;4104;4104;7.71;0.47;238.43;3.39;700;32;1410.00;0
3407;32;625518315;3407;299;4104;4104;7.71;0.47;238.29;3.39;697;32;1411.00;0
3408;32;625518324;3408;304;4109;4110;7.76;0.47;238.23;3.39;701;32;1412.00;1
3409;32;625518334;3409;305;4110;4111;7.79;0.48;238.20;3.39;701;32;1413.00;1
3412;32;625518344;3412;307;4111;4111;7.74;0.47;238.09;3.39;699;32;1414.00;0
3415;32;625518353;3415;309;4111;4111;7.65;0.47;238.02;3.39;696;32;1415.00;0
3418;32;625518362;3418;296;4115;4115;7.71;0.47;237.98;3.39;697;32;1416.00;0
3420;32;625518372;3420;287;4115;4115;7.78;0.48;237.86;3.39;695;32;1417.00;0
3422;32;625518390;3422;275;4115;4115;7.85;0.48;237.81;3.39;693;32;1418.00;0
3423;32;625518400;3423;263;4116;4116;7.92;0.49;237.78;3.38;693;32;1419.00;0
3427;32;625518410;3427;259;4120;4120;7.95;0.49;237.62;3.38;693;32;1420.00;0
3427;32;625518420;3427;255;4120;4120;8.02;0.49;237.62;3.38;693;32;1421.00;0
3430;32;625518434;3430;253;4122;4123;8.14;0.50;237.53;3.38;692;32;1422.00;1
3433;32;625518444;3433;250;4122;4123;8.26;0.51;237.53;3.38;689;32;1423.00;1
3433;32;625518453;3433;248;4123;4123;8.40;0.51;237.53;3.38;690;32;1424.00;0
3435;32;625518463;3435;241;4123;4123;8.45;0.52;237.54;3.38;688;32;1425.00;0
3437;32;625518472;3437;246;4126;4127;8.55;0.52;237.51;3.38;689;32;1426.00;1
3440;32;625518482;3440;243;4126;4127;8.56;0.52;237.49;3.38;686;32;1427.00;1
3442;32;625518492;3442;245;4127;4127;8.58;0.52;237.45;3.38;685;32;1428.00;0
3442;32;625518501;3442;244;4127;4127;8.56;0.52;237.45;3.38;685;32;1429.00;0
3442;32;625518510;3442;240;4128;4128;8.55;0.52;237.45;3.38;686;32;1430.00;0
3442;32;625518519;3442;244;4129;4129;8.57;0.52;237.45;3.38;687;32;1431.00;0
3445;32;625518528;3445;241;4129;4129;8.53;0.52;237.40;3.38;684;32;1432.00;0
3445;32;625518537;3445;241;4130;4130;8.49;0.52;237.40;3.38;685;32;1433.00;0
3447;32;625518546;3447;243;4130;4130;8.44;0.51;237.33;3.38;683;32;1434.00;0
3448;32;625518554;3448;234;4130;4130;8.50;0.52;237.33;3.38;682;32;1435.00;0
3450;32;625518563;3450;230;4130;4130;8.51;0.52;237.31;3.38;680;32;1436.00;0
3453;33;625518572;3453;226;4130;4130;8.53;0.52;237.27;3.38;677;33;1437.00;0
3453;34;625518597;3453;223;4130;4130;8.54;0.52;237.27;3.38;677;34;1438.00;0
3455;34;625518614;3455;216;4130;4130;8.56;0.52;237.29;3.38;675;34;1439.00;0
3457;34;625518625;3457;256;4247;4360;8.63;0.54;237.26;3.28;790;34;1440.00;113
3458;34;625518657;3458;245;4251;4361;8.75;0.55;237.23;3.28;793;34;1441.00;110
3459;34;625518667;3459;225;4261;4361;8.93;0.56;237.17;3.28;802;34;1442.00;100
3461;35;625518683;3461;216;4269;4361;9.00;0.56;237.19;3.28;808;35;1443.00;92
3465;35;625518704;3465;218;4276;4361;9.01;0.56;237.16;3.28;811;35;1444.00;85
3465;35;625518714;3465;220;4282;4361;8.97;0.56;237.16;3.28;817;35;1445.00;79
3467;35;625518724;3467;229;4288;4361;8.95;0.56;237.19;3.29;821;35;1446.00;73
3468;35;625518734;3468;236;4292;4361;8.93;0.55;237.17;3.29;824;35;1447.00;69
3469;35;625518744;3469;236;4297;4362;8.93;0.55;237.19;3.30;828;35;1448.00;65
3474;35;625518754;3474;243;4301;4363;8.95;0.55;237.14;3.30;827;35;1449.00;62
3476;35;625518764;3476;243;4304;4363;8.92;0.55;237.11;3.30;828;35;1450.00;59
3478;35;625518775;3478;233;4308;4364;8.89;0.55;237.02;3.31;830;35;1451.00;56
3479;35;625518785;3479;242;4310;4364;8.85;0.55;236.99;3.31;831;35;1452.00;54
3481;35;625518795;3481;243;4315;4364;8.74;0.54;236.98;3.33;834;35;1453.00;49
3483;35;625518806;3483;241;4318;4364;8.65;0.53;236.97;3.33;835;35;1454.00;46
3486;35;625518817;3486;244;4323;4368;8.61;0.53;236.99;3.34;837;35;1455.00;45
3487;35;625518828;3487;248;4324;4368;8.64;0.53;237.08;3.34;837;35;1456.00;44
3491;35;625518839;3491;249;4325;4368;8.61;0.53;237.11;3.35;834;35;1457.00;43
3492;35;625518850;3492;242;4328;4371;8.68;0.53;237.10;3.35;836;35;1458.00;43
3494;35;625518860;3494;234;4329;4371;8.73;0.54;237.14;3.36;835;35;1459.00;42
3497;35;625518870;3497;234;4331;4371;8.81;0.54;237.16;3.36;834;35;1460.00;40
3500;35;625518880;3500;234;4334;4375;8.82;0.54;237.26;3.36;834;35;1461.00;41
3501;35;625518891;3501;215;4337;4376;8.87;0.54;237.26;3.37;836;35;1462.00;39
3504;35;625518901;3504;210;4339;4376;8.86;0.54;237.32;3.38;835;35;1463.00;37
3506;35;625518918;3506;200;4341;4380;8.97;0.55;237.49;3.38;835;35;1464.00;39
3510;35;625518928;3510;193;4345;4380;8.95;0.55;237.47;3.40;835;35;1465.00;35
3511;35;625518940;3511;189;4348;4380;8.95;0.55;237.57;3.41;837;35;1466.00;32
3512;35;625518950;3512;194;4348;4381;8.98;0.55;237.55;3.41;836;35;1467.00;33
3514;35;625518960;3514;185;4348;4381;9.02;0.55;237.47;3.41;834;35;1468.00;33
3519;35;625518971;3519;179;4351;4387;9.07;0.55;237.62;3.41;832;35;1469.00;36
3523;35;625518985;3523;170;4351;4387;9.12;0.55;237.61;3.41;828;35;1470.00;36
3526;35;625519002;3526;166;4351;4388;9.18;0.56;237.57;3.41;825;35;1471.00;37
3529;35;625519013;3529;161;4352;4388;9.26;0.56;237.66;3.41;823;35;1472.00;36
3531;35;625519024;3531;155;4352;4388;9.37;0.57;237.78;3.41;821;35;1473.00;36
3533;35;625519035;3533;151;4352;4388;9.49;0.58;237.79;3.41;819;35;1474.00;36
3534;35;625519046;3534;145;4353;4388;9.56;0.58;237.83;3.42;819;35;1475.00;35
3538;35;625519057;3538;151;4363;4400;9.67;0.59;237.94;3.42;825;35;1476.00;37
3541;35;625519069;3541;151;4364;4400;9.76;0.59;237.97;3.42;823;35;1477.00;36
3544;35;625519081;3544;154;4365;4400;9.87;0.60;238.05;3.42;821;35;1478.00;35
3545;35;625519092;3545;155;4367;4400;9.90;0.60;238.02;3.43;822;35;1479.00;33
3548;35;625519103;3548;155;4369;4400;9.98;0.61;238.04;3.44;821;35;1480.00;31
3552;35;625519114;3552;152;4369;4400;10.00;0.61;238.16;3.44;817;35;1481.00;31
3554;35;625519125;3554;156;4373;4404;10.02;0.61;238.12;3.44;819;35;1482.00;31
3555;35;625519137;3555;161;4374;4404;10.11;0.61;238.20;3.45;819;35;1483.00;30
3557;35;625519148;3557;162;4377;4408;10.13;0.62;238.28;3.45;820;35;1484.00;31
3558;35;625519165;3558;160;4381;4410;10.05;0.61;238.33;3.45;823;35;1485.00;29
3561;35;625519181;3561;163;4381;4410;10.01;0.61;238.38;3.45;820;35;1486.00;29
3564;35;625519201;3564;163;4383;4410;9.96;0.61;238.41;3.46;819;35;1487.00;27
3567;35;625519224;3567;171;4391;4423;9.89;0.60;238.50;3.46;824;35;1488.00;32
3568;35;625519245;3568;174;4391;4423;9.85;0.60;238.46;3.46;823;35;1489.00;32
3572;35;625519262;3572;178;4395;4423;9.81;0.60;238.61;3.49;823;35;1490.00;28
3573;35;625519280;3573;180;4396;4424;9.81;0.60;238.68;3.49;823;35;1491.00;28
3577;35;625519293;3577;182;4397;4425;9.76;0.59;238.66;3.50;820;35;1492.00;28
3579;35;625519306;3579;184;4398;4425;9.74;0.59;238.72;3.51;819;35;1493.00;27
3583;35;625519319;3583;189;4402;4428;9.70;0.59;238.73;3.53;819;35;1494.00;26
3586;35;625519333;3586;195;4404;4428;9.71;0.59;238.72;3.55;818;35;1495.00;24
3589;35;625519346;3589;196;4406;4428;9.76;0.59;238.78;3.56;817;35;1496.00;22
3594;35;625519358;3594;197;4408;4428;9.74;0.59;238.94;3.59;814;35;1497.00;20
3598;35;625519370;3598;196;4413;4434;9.78;0.59;238.82;3.59;815;35;1498.00;21
3600;35;625519390;3600;198;4414;4434;9.77;0.59;238.96;3.61;814;35;1499.00;20
3604;35;625519404;3604;205;4421;4453;9.66;0.59;239.11;3.63;817;35;1500.00;32
3606;35;625519424;3606;205;4421;4453;9.62;0.59;239.24;3.63;815;35;1501.00;32
3610;35;625519436;3610;211;4428;4457;9.56;0.58;239.34;3.66;818;35;1502.00;29
3613;35;625519448;3613;219;4431;4458;9.50;0.58;239.46;3.68;818;35;1503.00;27
3614;35;625519462;3614;226;4432;4458;9.46;0.58;239.49;3.68;818;35;1504.00;26
3617;35;625519474;3617;238;4434;4459;9.41;0.57;239.54;3.68;817;35;1505.00;25
3621;35;625519486;3621;238;4437;4459;9.28;0.57;239.48;3.70;816;35;1506.00;22
3621;35;625519498;3621;246;4439;4459;9.26;0.56;239.48;3.71;818;35;1507.00;20
3621;35;625519509;3621;248;4442;4459;9.23;0.56;239.48;3.74;821;35;1508.00;17
3622;35;625519521;3622;251;4442;4459;9.25;0.57;239.53;3.74;820;35;1509.00;17
3627;35;625519532;3627;247;4444;4459;9.29;0.57;239.62;3.75;817;35;1510.00;15
3628;35;625519545;3628;252;4446;4459;9.30;0.57;239.61;3.75;818;35;1511.00;13
3629;35;625519556;3629;256;4477;4529;9.29;0.57;239.68;3.73;848;35;1512.00;52
3632;35;625519574;3632;257;4480;4530;9.33;0.57;239.78;3.73;848;35;1513.00;50
3635;35;625519586;3635;262;4489;4530;9.35;0.57;239.76;3.73;854;35;1514.00;41
3639;35;625519598;3639;257;4493;4530;9.36;0.57;239.68;3.73;854;35;1515.00;37
3642;35;625519610;3642;263;4501;4530;9.36;0.57;239.83;3.74;859;35;1516.00;29
3646;35;625519623;3646;263;4503;4530;9.34;0.57;239.74;3.74;857;35;1517.00;27
3649;35;625519635;3649;260;4505;4530;9.35;0.57;239.77;3.74;856;35;1518.00;25
3649;35;625519648;3649;261;4506;4530;9.31;0.57;239.77;3.74;857;35;1519.00;24
3652;35;625519663;3652;265;4508;4531;9.27;0.56;239.87;3.74;856;35;1520.00;23
3655;35;625519676;3655;263;4510;4532;9.23;0.56;239.79;3.74;855;35;1521.00;22
3658;35;625519690;3658;268;4513;4532;9.15;0.56;239.73;3.75;855;35;1522.00;19
3664;35;625519703;3664;265;4518;4536;8.95;0.55;239.88;3.75;854;35;1523.00;18
3667;35;625519717;3667;264;4519;4536;8.82;0.54;239.84;3.76;852;35;1524.00;17
3672;35;625519729;3672;268;4519;4536;8.70;0.53;239.78;3.76;847;35;1525.00;17
3675;35;625519740;3675;270;4519;4536;8.59;0.53;239.80;3.76;844;35;1526.00;17
3680;35;625519751;3680;276;4523;4542;8.52;0.52;239.76;3.75;843;35;1527.00;19
3684;35;625519764;3684;283;4523;4542;8.47;0.52;239.98;3.75;839;35;1528.00;19
3689;35;625519775;3689;286;4524;4542;8.37;0.51;240.13;3.76;835;35;1529.00;18
3690;35;625519787;3690;273;4527;4548;8.36;0.51;240.13;3.76;837;35;1530.00;21
3698;35;625519799;3698;267;4527;4548;8.26;0.50;240.24;3.76;829;35;1531.00;21
3702;35;625519811;3702;266;4528;4548;8.16;0.50;240.19;3.76;826;35;1532.00;20
3705;35;625519822;3705;257;4529;4549;8.12;0.50;240.26;3.76;824;35;1533.00;20
3711;35;625519833;3711;269;4531;4550;8.08;0.49;240.47;3.77;820;35;1534.00;19
3714;35;625519845;3714;268;4531;4550;8.07;0.49;240.48;3.77;817;35;1535.00;19
3719;35;625519860;3719;270;4543;4563;8.02;0.49;240.62;3.76;824;35;1536.00;20
3723;35;625519873;3723;265;4544;4563;8.04;0.49;240.68;3.77;821;35;1537.00;19
3729;35;625519885;3729;261;4545;4563;8.07;0.49;240.74;3.77;816;35;1538.00;18
3733;35;625519902;3733;255;4546;4564;8.09;0.49;240.76;3.77;813;35;1539.00;18
3735;35;625519914;3735;253;4550;4564;8.18;0.50;240.75;3.80;815;35;1540.00;14
3741;35;625519924;3741;248;4552;4568;8.21;0.50;240.76;3.79;811;35;1541.00;16
3746;35;625519936;3746;244;4553;4568;8.17;0.50;240.83;3.80;807;35;1542.00;15
3751;35;625519948;3751;240;4558;4572;8.17;0.50;241.03;3.80;807;35;1543.00;14
3756;35;625519960;3756;233;4558;4572;8.21;0.50;241.08;3.80;802;35;1544.00;14
3760;35;625519972;3760;234;4558;4572;8.21;0.50;240.98;3.80;798;35;1545.00;14
3765;35;625519982;3765;234;4559;4572;8.13;0.50;241.07;3.81;794;35;1546.00;13
3772;35;625519993;3772;244;4560;4572;8.04;0.49;240.97;3.81;788;35;1547.00;12
3774;35;625520004;3774;244;4569;4584;8.02;0.49;241.16;3.81;795;35;1548.00;15
3778;35;625520016;3778;247;4571;4584;7.91;0.48;241.22;3.81;793;35;1549.00;13
3779;35;625520026;3779;250;4572;4584;7.90;0.48;241.27;3.81;793;35;1550.00;12
3781;35;625520037;3781;255;4572;4584;7.86;0.48;241.35;3.81;791;35;1551.00;12
3784;35;625520048;3784;263;4573;4584;7.82;0.48;241.41;3.82;789;35;1552.00;11
3785;35;625520060;3785;270;4573;4584;7.79;0.47;241.44;3.82;788;35;1553.00;11
3789;35;625520070;3789;283;4576;4585;7.68;0.47;241.45;3.84;787;35;1554.00;9
3792;35;625520082;3792;286;4577;4587;7.57;0.46;241.53;3.84;785;35;1555.00;10
3795;35;625520093;3795;287;4582;4593;7.44;0.45;241.64;3.84;787;35;1556.00;11
3796;35;625520104;3796;296;4583;4594;7.37;0.45;241.62;3.84;787;35;1557.00;11
3800;35;625520115;3800;299;4583;4594;7.27;0.45;241.47;3.84;783;35;1558.00;11
3804;35;625520126;3804;314;4585;4594;7.13;0.44;241.47;3.85;781;35;1559.00;9
3808;35;625520139;3808;317;4591;4599;7.14;0.44;241.40;3.85;783;35;1560.00;8
3812;35;625520153;3812;320;4591;4599;7.07;0.43;241.45;3.85;779;35;1561.00;8
3814;36;625520165;3814;324;4592;4599;7.03;0.43;241.48;3.86;778;36;1562.00;7
3817;36;625520195;3817;325;4594;4600;6.89;0.42;241.43;3.86;777;36;1563.00;6
3820;36;625520207;3820;322;4598;4604;6.88;0.42;241.47;3.86;778;36;1564.00;6
3823;36;625520217;3823;328;4601;4604;6.78;0.42;241.51;3.87;778;36;1565.00;3
3829;36;625520226;3829;330;4603;4607;6.72;0.41;241.41;3.87;774;36;1566.00;4
3830;36;625520236;3830;340;4604;4607;6.68;0.41;241.38;3.87;774;36;1567.00;3
3836;36;625520245;3836;343;4604;4607;6.63;0.41;241.35;3.87;768;36;1568.00;3
3841;36;625520256;3841;347;4605;4607;6.62;0.40;241.25;3.88;764;36;1569.00;2
3843;36;625520266;3843;356;4607;4611;6.62;0.41;241.30;3.87;764;36;1570.00;4
3848;36;625520276;3848;367;4607;4611;6.58;0.40;241.19;3.87;759;36;1571.00;4
3851;36;625520285;3851;372;4608;4611;6.54;0.40;241.13;3.88;757;36;1572.00;3
3853;36;625520294;3853;373;4609;4611;6.52;0.40;241.13;3.88;756;36;1573.00;2
3855;36;625520303;3855;385;4610;4612;6.43;0.39;241.13;3.88;755;36;1574.00;2
3859;36;625520312;3859;388;4613;4614;6.38;0.39;241.08;3.88;754;36;1575.00;1
3860;36;625520322;3860;391;4614;4614;6.33;0.39;241.08;3.88;754;36;1576.00;0
3861;36;625520331;3861;384;4615;4615;6.39;0.39;241.12;3.88;754;36;1577.00;0
3865;36;625520340;3865;378;4615;4615;6.41;0.39;241.19;3.88;750;36;1578.00;0
3865;36;625520349;3865;373;4615;4615;6.44;0.39;241.19;3.88;750;36;1579.00;0
3868;36;625520358;3868;371;4615;4615;6.49;0.40;241.23;3.88;747;36;1580.00;0
3869;36;625520366;3869;366;4615;4615;6.52;0.40;241.20;3.88;746;36;1581.00;0
3872;36;625520376;3872;367;4615;4615;6.52;0.40;241.17;3.88;743;36;1582.00;0
3873;36;625520385;3873;367;4615;4615;6.58;0.40;241.17;3.88;742;36;1583.00;0
3876;36;625520399;3876;385;4691;4742;6.97;0.43;241.10;3.81;815;36;1584.00;51
3876;36;625520418;3876;374;4693;4743;7.03;0.44;241.10;3.81;817;36;1585.00;50
3878;36;625520427;3878;351;4702;4743;7.11;0.44;241.08;3.81;824;36;1586.00;41
3878;36;625520437;3878;322;4706;4743;7.28;0.45;241.08;3.81;828;36;1587.00;37
3882;36;625520447;3882;302;4712;4743;7.41;0.46;241.08;3.81;830;36;1588.00;31
3883;36;625520457;3883;281;4717;4743;7.58;0.47;241.05;3.81;834;36;1589.00;26
3886;36;625520475;3886;277;4722;4743;7.72;0.48;241.06;3.81;836;36;1590.00;21
3886;36;625520487;3886;265;4726;4743;7.85;0.48;241.06;3.81;840;36;1591.00;17
3887;37;625520502;3887;262;4731;4744;7.99;0.49;241.06;3.82;844;37;1592.00;13
3889;37;625520524;3889;249;4732;4745;8.10;0.50;241.03;3.82;843;37;1593.00;13
3891;37;625520535;3891;240;4733;4745;8.32;0.51;240.99;3.82;842;37;1594.00;12
3892;37;625520547;3892;236;4734;4746;8.48;0.52;240.96;3.82;842;37;1595.00;12
3894;37;625520559;3894;232;4735;4746;8.64;0.53;240.96;3.82;841;37;1596.00;11
3895;37;625520571;3895;234;4736;4746;8.74;0.53;240.93;3.83;841;37;1597.00;10
3897;37;625520588;3897;228;4737;4746;8.80;0.54;240.89;3.83;840;37;1598.00;9
3898;37;625520600;3898;225;4741;4750;8.92;0.55;240.87;3.83;843;37;1599.00;9
3902;37;625520619;3902;222;4743;4750;8.98;0.55;240.81;3.83;841;37;1600.00;7
3903;37;625520639;3903;222;4744;4750;9.05;0.55;240.83;3.83;841;37;1601.00;6
3903;37;625520655;3903;220;4747;4753;9.11;0.55;240.83;3.83;844;37;1602.00;6
3904;37;625520669;3904;214;4747;4753;9.18;0.56;240.80;3.83;843;37;1603.00;6
3905;37;625520684;3905;213;4748;4753;9.25;0.56;240.84;3.84;843;37;1604.00;5
3908;37;625520697;3908;209;4752;4757;9.22;0.56;240.81;3.83;844;37;1605.00;5
3910;37;625520709;3910;214;4753;4758;9.20;0.56;240.79;3.83;843;37;1606.00;5
3911;37;625520722;3911;214;4753;4758;9.17;0.56;240.87;3.83;842;37;1607.00;5
3914;37;625520738;3914;216;4756;4762;9.16;0.56;240.97;3.83;842;37;1608.00;6
3916;37;625520750;3916;219;4756;4762;9.18;0.56;240.93;3.83;840;37;1609.00;6
3918;37;625520761;3918;222;4756;4762;9.20;0.56;241.00;3.83;838;37;1610.00;6
3921;37;625520772;3921;230;4757;4763;9.18;0.56;241.13;3.83;836;37;1611.00;6
3924;37;625520786;3924;233;4757;4763;9.19;0.56;241.22;3.83;833;37;1612.00;6
3926;37;625520803;3926;237;4761;4769;9.20;0.56;241.30;3.83;835;37;1613.00;8
3931;37;625520818;3931;241;4761;4769;9.22;0.56;241.45;3.83;830;37;1614.00;8
3933;37;625520831;3933;241;4762;4770;9.24;0.56;241.60;3.83;829;37;1615.00;8
3934;37;625520842;3934;239;4762;4770;9.23;0.56;241.55;3.83;828;37;1616.00;8
3938;37;625520853;3938;237;4762;4770;9.18;0.56;241.55;3.83;824;37;1617.00;8
3941;37;625520866;3941;239;4762;4770;9.13;0.56;241.50;3.83;821;37;1618.00;8
3943;37;625520877;3943;242;4762;4770;9.12;0.56;241.44;3.83;819;37;1619.00;8
3946;37;625520890;3946;236;4785;4806;9.05;0.55;241.46;3.81;839;37;1620.00;21
3949;37;625520904;3949;223;4785;4806;9.04;0.55;241.57;3.81;836;37;1621.00;21
3952;37;625520915;3952;222;4788;4806;9.09;0.56;241.64;3.81;836;37;1622.00;18
3957;37;625520927;3957;219;4789;4806;9.13;0.56;241.76;3.81;832;37;1623.00;17
3960;37;625520939;3960;214;4789;4806;9.20;0.56;241.76;3.81;829;37;1624.00;17
3964;37;625520949;3964;211;4790;4806;9.23;0.57;241.84;3.81;826;37;1625.00;16
3966;37;625520961;3966;207;4794;4810;9.32;0.57;241.89;3.81;828;37;1626.00;16
3967;37;625520972;3967;199;4794;4810;9.40;0.57;241.86;3.81;827;37;1627.00;16
3972;37;625520983;3972;193;4797;4814;9.42;0.58;242.02;3.81;825;37;1628.00;17
3975;37;625520994;3975;190;4799;4815;9.54;0.58;242.08;3.81;824;37;1629.00;16
3979;37;625521004;3979;187;4799;4815;9.61;0.59;242.10;3.81;820;37;1630.00;16
3985;37;625521016;3985;183;4800;4815;9.59;0.58;242.14;3.81;815;37;1631.00;15
3986;37;625521026;3986;177;4809;4828;9.60;0.58;242.17;3.80;823;37;1632.00;19
3992;37;625521037;3992;170;4809;4828;9.54;0.58;242.23;3.80;817;37;1633.00;19
3997;37;625521048;3997;165;4809;4828;9.55;0.58;242.30;3.80;812;37;1634.00;19
3998;37;625521059;3998;161;4811;4829;9.62;0.58;242.35;3.81;813;37;1635.00;18
4000;37;625521070;4000;153;4811;4830;9.74;0.59;242.36;3.81;811;37;1636.00;19
4004;37;625521081;4004;150;4811;4830;9.82;0.60;242.39;3.81;807;37;1637.00;19
4007;37;625521091;4007;145;4813;4833;9.87;0.60;242.46;3.81;806;37;1638.00;20
4010;37;625521102;4010;135;4814;4833;10.00;0.61;242.47;3.81;804;37;1639.00;19
4014;38;625521112;4014;133;4814;4833;10.09;0.61;242.52;3.81;800;38;1640.00;19
4017;39;625521135;4017;129;4814;4833;10.17;0.62;242.54;3.81;797;39;1641.00;19
4022;39;625521152;4022;128;4818;4839;10.22;0.62;242.53;3.80;796;39;1642.00;21
4022;39;625521168;4022;127;4818;4839;10.30;0.63;242.53;3.80;796;39;1643.00;21
4025;39;625521187;4025;123;4820;4839;10.32;0.63;242.64;3.81;795;39;1644.00;19
4029;39;625521204;4029;124;4820;4839;10.29;0.63;242.62;3.81;791;39;1645.00;19
4031;39;625521221;4031;126;4823;4843;10.28;0.62;242.67;3.81;792;39;1646.00;20
4034;39;625521242;4034;126;4824;4844;10.32;0.63;242.82;3.81;790;39;1647.00;20
4038;39;625521259;4038;121;4826;4844;10.37;0.63;242.82;3.83;788;39;1648.00;18
4041;39;625521274;4041;117;4827;4845;10.39;0.63;242.91;3.83;786;39;1649.00;18
4045;39;625521289;4045;115;4828;4845;10.39;0.63;242.96;3.83;783;39;1650.00;17
4047;39;625521301;4047;121;4828;4845;10.39;0.63;242.92;3.83;781;39;1651.00;17
4048;39;625521313;4048;122;4829;4845;10.42;0.63;242.93;3.85;781;39;1652.00;16
4051;39;625521325;4051;129;4830;4845;10.39;0.63;243.03;3.85;779;39;1653.00;15
4055;39;625521337;4055;133;4830;4845;10.44;0.63;243.00;3.85;775;39;1654.00;15
4058;39;625521350;4058;138;4830;4845;10.47;0.64;243.02;3.85;772;39;1655.00;15
4061;39;625521366;4061;148;4869;4915;10.43;0.64;243.25;3.84;808;39;1656.00;46
4062;39;625521384;4062;154;4871;4916;10.44;0.64;243.23;3.83;809;39;1657.00;45
4063;39;625521396;4063;154;4877;4916;10.49;0.64;243.26;3.83;814;39;1658.00;39
4067;39;625521407;4067;158;4883;4916;10.45;0.64;243.31;3.84;816;39;1659.00;33
4072;39;625521419;4072;164;4887;4916;10.45;0.64;243.33;3.86;815;39;1660.00;29
4074;39;625521433;4074;166;4893;4916;10.44;0.64;243.41;3.86;819;39;1661.00;23
4076;39;625521463;4076;171;4897;4916;10.41;0.64;243.43;3.87;821;39;1662.00;19
4080;39;625521494;4080;170;4901;4916;10.36;0.63;243.39;3.88;821;39;1663.00;15
4084;39;625521524;4084;173;4903;4917;10.41;0.64;243.37;3.88;819;39;1664.00;14
4084;40;625521542;4084;174;4906;4919;10.45;0.64;243.37;3.89;822;40;1665.00;13
4088;40;625521577;4088;175;4907;4919;10.42;0.64;243.46;3.89;819;40;1666.00;12
4092;40;625521593;4092;171;4910;4923;10.32;0.63;243.37;3.89;818;40;1667.00;13
4094;40;625521608;4094;176;4911;4923;10.31;0.63;243.37;3.90;817;40;1668.00;12
4098;40;625521622;4098;180;4912;4923;10.29;0.63;243.38;3.91;814;40;1669.00;11
4099;40;625521642;4099;179;4912;4923;10.21;0.63;243.40;3.91;813;40;1670.00;11
4102;40;625521658;4102;186;4918;4929;10.18;0.62;243.37;3.92;816;40;1671.00;11
4105;40;625521675;4105;181;4919;4929;10.09;0.62;243.43;3.92;814;40;1672.00;10
4108;40;625521691;4108;183;4921;4929;10.07;0.62;243.36;3.93;813;40;1673.00;8
4109;40;625521706;4109;185;4925;4932;10.00;0.61;243.33;3.93;816;40;1674.00;7
4111;40;625521721;4111;192;4926;4932;9.98;0.61;243.34;3.93;815;40;1675.00;6
4118;40;625521736;4118;194;4927;4932;9.88;0.60;243.27;3.93;809;40;1676.00;5
4120;40;625521750;4120;198;4927;4933;9.74;0.59;243.26;3.93;807;40;1677.00;6
4125;40;625521776;4125;204;4928;4934;9.58;0.58;243.26;3.93;803;40;1678.00;6
4126;40;625521790;4126;204;4929;4934;9.41;0.57;243.25;3.94;803;40;1679.00;5
4129;40;625521806;4129;211;4948;4960;9.22;0.56;243.25;3.92;819;40;1680.00;12
4133;40;625521821;4133;210;4951;4960;9.15;0.56;243.25;3.92;818;40;1681.00;9
4135;40;625521839;4135;211;4955;4960;9.10;0.55;243.25;3.93;820;40;1682.00;5
4139;40;625521853;4139;215;4956;4961;9.08;0.55;243.30;3.93;817;40;1683.00;5
4140;40;625521866;4140;221;4957;4961;9.07;0.55;243.34;3.93;817;40;1684.00;4
4146;40;625521890;4146;223;4960;4965;9.07;0.55;243.39;3.92;814;40;1685.00;5
4147;40;625521905;4147;227;4960;4965;9.11;0.55;243.37;3.92;813;40;1686.00;5
4150;40;625521928;4150;231;4964;4969;9.06;0.55;243.38;3.92;814;40;1687.00;5
4152;40;625521941;4152;239;4964;4969;9.03;0.55;243.35;3.92;812;40;1688.00;5
4155;40;625521955;4155;240;4966;4969;9.01;0.55;243.35;3.93;811;40;1689.00;3
4161;40;625521967;4161;248;4966;4969;8.92;0.54;243.41;3.93;805;40;1690.00;3
4163;40;625521980;4163;252;4966;4969;8.80;0.54;243.41;3.93;803;40;1691.00;3
4170;40;625521991;4170;261;4979;4981;8.61;0.53;243.53;3.93;809;40;1692.00;2
4174;40;625522007;4174;270;4979;4981;8.45;0.52;243.68;3.93;805;40;1693.00;2
4178;40;625522019;4178;278;4980;4981;8.26;0.51;243.70;3.92;802;40;1694.00;1
4184;40;625522031;4184;287;4981;4981;8.04;0.49;243.70;3.93;797;40;1695.00;0
4186;40;625522044;4186;293;4981;4981;7.84;0.48;243.81;3.93;795;40;1696.00;0
4190;40;625522057;4190;302;4981;4981;7.63;0.47;243.87;3.93;791;40;1697.00;0
4194;40;625522069;4194;307;4982;4982;7.38;0.45;244.03;3.93;788;40;1698.00;0
4196;40;625522084;4196;310;4982;4982;7.20;0.44;244.05;3.93;786;40;1699.00;0
4200;40;625522097;4200;304;4987;4988;7.12;0.44;244.00;3.92;787;40;1700.00;1
4203;40;625522115;4203;300;4988;4989;7.01;0.43;244.00;3.92;785;40;1701.00;1
4206;40;625522131;4206;297;4989;4989;6.94;0.43;244.13;3.92;783;40;1702.00;0
4210;40;625522146;4210;297;4989;4989;6.87;0.42;244.29;3.92;779;40;1703.00;0
4212;40;625522160;4212;291;4993;4993;6.84;0.42;244.32;3.92;781;40;1704.00;0
4215;40;625522173;4215;291;4993;4993;6.84;0.42;244.31;3.92;778;40;1705.00;0
4216;40;625522185;4216;291;4993;4993;6.88;0.42;244.30;3.92;777;40;1706.00;0
4218;40;625522196;4218;290;4994;4994;6.93;0.43;244.32;3.92;776;40;1707.00;0
4222;40;625522208;4222;285;4998;4998;6.98;0.43;244.23;3.92;776;40;1708.00;0
4223;40;625522219;4223;280;4998;4998;7.02;0.43;244.29;3.92;775;40;1709.00;0
4227;40;625522231;4227;283;5001;5004;7.05;0.43;244.29;3.91;774;40;1710.00;3
4232;40;625522243;4232;282;5002;5004;7.10;0.44;244.27;3.91;770;40;1711.00;2
4240;41;625522253;4240;285;5002;5004;7.05;0.43;244.08;3.91;762;41;1712.00;2
4242;41;625522278;4242;287;5003;5004;7.06;0.43;244.18;3.91;761;41;1713.00;1
4244;41;625522288;4244;291;5006;5008;7.10;0.44;244.14;3.91;762;41;1714.00;2
4249;41;625522300;4249;295;5006;5008;7.07;0.43;244.14;3.91;757;41;1715.00;2
4253;41;625522310;4253;290;5007;5008;7.04;0.43;244.08;3.91;754;41;1716.00;1
4256;41;625522320;4256;289;5007;5008;6.96;0.43;244.16;3.91;751;41;1717.00;1
4260;41;625522336;4260;291;5009;5009;6.88;0.42;244.12;3.91;749;41;1718.00;0
4263;41;625522346;4263;291;5010;5010;6.80;0.42;244.13;3.91;747;41;1719.00;0
4265;41;625522355;4265;296;5010;5010;6.79;0.42;244.11;3.91;745;41;1720.00;0
4268;41;625522371;4268;294;5011;5011;6.83;0.42;244.12;3.91;743;41;1721.00;0
4272;41;625522381;4272;295;5011;5011;6.79;0.42;244.04;3.91;739;41;1722.00;0
4273;41;625522396;4273;304;5011;5011;6.74;0.41;244.04;3.91;738;41;1723.00;0
4276;41;625522410;4276;305;5011;5011;6.66;0.41;243.94;3.91;735;41;1724.00;0
4281;41;625522422;4281;302;5011;5011;6.61;0.41;243.91;3.91;730;41;1725.00;0
4286;41;625522432;4286;301;5011;5011;6.57;0.40;243.83;3.91;725;41;1726.00;0
4288;41;625522442;4288;301;5011;5011;6.58;0.40;243.76;3.91;723;41;1727.00;0
4294;41;625522453;4294;318;5085;5138;6.94;0.43;243.71;3.85;791;41;1728.00;53
4295;41;625522475;4295;317;5088;5139;6.93;0.43;243.75;3.85;793;41;1729.00;51
4298;41;625522491;4298;317;5098;5139;7.03;0.44;243.74;3.85;800;41;1730.00;41
4302;41;625522503;4302;322;5102;5139;7.00;0.44;243.76;3.85;800;41;1731.00;37
4305;41;625522514;4305;324;5108;5139;7.04;0.44;243.70;3.85;803;41;1732.00;31
4312;41;625522526;4312;331;5112;5139;7.04;0.44;243.60;3.85;800;41;1733.00;27
4315;41;625522542;4315;334;5117;5139;7.04;0.44;243.64;3.85;802;41;1734.00;22
4320;41;625522554;4320;338;5120;5139;7.05;0.44;243.60;3.85;800;41;1735.00;19
4322;41;625522573;4322;343;5123;5140;7.03;0.43;243.64;3.86;801;41;1736.00;17
4324;41;625522586;4324;344;5127;5141;7.06;0.43;243.61;3.86;803;41;1737.00;14
4326;41;625522598;4326;353;5130;5141;7.03;0.43;243.62;3.86;804;41;1738.00;11
4327;41;625522615;4327;349;5133;5142;7.04;0.43;243.63;3.86;806;41;1739.00;9
4327;41;625522630;4327;348;5135;5142;7.15;0.44;243.63;3.87;808;41;1740.00;7
4328;41;625522642;4328;342;5135;5142;7.26;0.45;243.68;3.87;807;41;1741.00;7
4329;41;625522652;4329;341;5137;5142;7.37;0.45;243.72;3.87;808;41;1742.00;5
4333;41;625522669;4333;335;5140;5146;7.47;0.46;243.70;3.87;807;41;1743.00;6
4334;41;625522682;4334;336;5142;5146;7.59;0.47;243.69;3.87;808;41;1744.00;4
4334;41;625522694;4334;334;5143;5146;7.70;0.47;243.69;3.88;809;41;1745.00;3
4336;41;625522716;4336;328;5146;5149;7.80;0.48;243.73;3.88;810;41;1746.00;3
4338;41;625522729;4338;314;5147;5149;7.87;0.48;243.63;3.88;809;41;1747.00;2
4339;41;625522750;4339;302;5148;5149;7.98;0.49;243.64;3.88;809;41;1748.00;1
4343;41;625522764;4343;292;5153;5153;8.02;0.49;243.58;3.88;810;41;1749.00;0
4344;41;625522777;4344;286;5154;5154;8.10;0.50;243.56;3.88;810;41;1750.00;0
4346;41;625522791;4346;279;5154;5154;8.22;0.50;243.69;3.88;808;41;1751.00;0
4348;41;625522806;4348;272;5158;5158;8.33;0.51;243.76;3.87;810;41;1752.00;0
4352;42;625522820;4352;270;5158;5158;8.43;0.51;243.71;3.87;806;42;1753.00;0
4353;42;625522850;4353;267;5158;5158;8.57;0.52;243.72;3.87;805;42;1754.00;0
4356;42;625522870;4356;265;5160;5160;8.68;0.53;243.67;3.87;804;42;1755.00;0
4359;42;625522884;4359;253;5160;5160;8.82;0.54;243.69;3.87;801;42;1756.00;0
4362;42;625522897;4362;241;5164;5166;8.92;0.54;243.63;3.87;802;42;1757.00;2
4363;42;625522912;4363;231;5164;5166;9.00;0.55;243.62;3.87;801;42;1758.00;2
4365;42;625522926;4365;222;5165;5167;9.08;0.55;243.53;3.87;800;42;1759.00;2
4365;42;625522943;4365;216;5165;5167;9.14;0.55;243.53;3.87;800;42;1760.00;2
4366;42;625522956;4366;218;5165;5167;9.19;0.56;243.51;3.87;799;42;1761.00;2
4366;42;625522971;4366;218;5165;5167;9.25;0.56;243.51;3.87;799;42;1762.00;2
4369;43;625522983;4369;223;5165;5167;9.31;0.57;243.55;3.87;796;43;1763.00;2
4372;43;625523009;4372;227;5175;5179;9.47;0.58;243.63;3.86;803;43;1764.00;4
4374;43;625523025;4374;229;5175;5179;9.57;0.58;243.67;3.86;801;43;1765.00;4
4378;43;625523039;4378;231;5176;5179;9.59;0.58;243.69;3.86;798;43;1766.00;3
4382;43;625523053;4382;228;5176;5179;9.60;0.58;243.65;3.86;794;43;1767.00;3
4382;43;625523071;4382;225;5176;5179;9.67;0.59;243.65;3.86;794;43;1768.00;3
4384;43;625523086;4384;217;5176;5179;9.71;0.59;243.71;3.86;792;43;1769.00;3
4387;43;625523100;4387;217;5179;5183;9.66;0.58;243.82;3.86;792;43;1770.00;4
4391;43;625523113;4391;211;5179;5183;9.64;0.58;243.90;3.86;788;43;1771.00;4
4393;43;625523126;4393;205;5182;5187;9.58;0.58;243.93;3.86;789;43;1772.00;5
4397;43;625523139;4397;208;5183;5188;9.53;0.58;244.11;3.86;786;43;1773.00;5
4400;43;625523152;4400;211;5184;5188;9.49;0.57;244.20;3.86;784;43;1774.00;4
4402;43;625523171;4402;211;5184;5188;9.51;0.58;244.21;3.86;782;43;1775.00;4
4407;43;625523195;4407;212;5195;5201;9.47;0.57;244.25;3.85;788;43;1776.00;6
4407;43;625523216;4407;218;5195;5201;9.47;0.57;244.25;3.85;788;43;1777.00;6
4410;43;625523233;4410;221;5195;5201;9.45;0.57;244.32;3.85;785;43;1778.00;6
4413;43;625523254;4413;222;5196;5202;9.44;0.57;244.38;3.85;783;43;1779.00;6
4416;43;625523279;4416;226;5196;5203;9.42;0.57;244.45;3.85;780;43;1780.00;7
4418;43;625523295;4418;233;5196;5203;9.34;0.57;244.56;3.85;778;43;1781.00;7
4421;43;625523313;4421;234;5198;5206;9.34;0.57;244.63;3.85;777;43;1782.00;8
4423;43;625523332;4423;232;5198;5206;9.30;0.56;244.67;3.85;775;43;1783.00;8
4424;43;625523355;4424;240;5199;5206;9.31;0.56;244.67;3.85;775;43;1784.00;7
4427;43;625523370;4427;238;5199;5206;9.29;0.56;244.80;3.85;772;43;1785.00;7
4429;43;625523385;4429;248;5203;5212;9.35;0.57;244.82;3.84;774;43;1786.00;9
4431;43;625523403;4431;249;5203;5212;9.35;0.57;244.79;3.84;772;43;1787.00;9
4436;43;625523416;4436;245;5204;5212;9.31;0.56;244.92;3.84;768;43;1788.00;8
4438;43;625523429;4438;240;5204;5212;9.27;0.56;244.91;3.84;766;43;1789.00;8
4439;43;625523442;4439;233;5207;5216;9.25;0.56;244.92;3.84;768;43;1790.00;9
4442;43;625523457;4442;220;5208;5217;9.29;0.57;244.99;3.84;766;43;1791.00;9
4443;43;625523473;4443;215;5208;5217;9.36;0.57;244.98;3.84;765;43;1792.00;9
4448;43;625523485;4448;204;5209;5218;9.38;0.57;245.02;3.84;761;43;1793.00;9
4450;43;625523498;4450;202;5209;5218;9.40;0.57;245.05;3.84;759;43;1794.00;9
4455;43;625523513;4455;195;5209;5218;9.43;0.58;245.21;3.84;754;43;1795.00;9
4461;43;625523527;4461;185;5209;5218;9.49;0.58;245.31;3.84;748;43;1796.00;9
4465;43;625523543;4465;175;5209;5218;9.54;0.58;245.33;3.84;744;43;1797.00;9
4466;43;625523557;4466;173;5209;5218;9.59;0.59;245.32;3.84;743;43;1798.00;9
4469;43;625523570;4469;172;5209;5218;9.68;0.59;245.31;3.84;740;43;1799.00;9
4471;43;625523590;4471;190;5272;5356;9.51;0.59;245.37;3.80;801;43;1800.00;84
4478;43;625523626;4478;179;5272;5357;9.50;0.58;245.44;3.80;794;43;1801.00;85
4482;43;625523641;4482;163;5281;5357;9.56;0.59;245.52;3.79;799;43;1802.00;76
4484;43;625523659;4484;150;5287;5357;9.65;0.59;245.55;3.79;803;43;1803.00;70
4487;43;625523675;4487;141;5293;5357;9.61;0.59;245.60;3.79;806;43;1804.00;64
4490;43;625523689;4490;145;5300;5357;9.50;0.58;245.61;3.81;810;43;1805.00;57
4494;43;625523704;4494;144;5305;5357;9.47;0.58;245.63;3.81;811;43;1806.00;52
4499;43;625523718;4499;144;5307;5357;9.45;0.58;245.73;3.81;808;43;1807.00;50
4503;43;625523734;4503;139;5311;5358;9.46;0.58;245.83;3.81;808;43;1808.00;47
4509;43;625523750;4509;135;5313;5359;9.47;0.58;245.94;3.82;804;43;1809.00;46
4510;43;625523768;4510;129;5316;5359;9.55;0.58;245.97;3.82;806;43;1810.00;43
4514;43;625523783;4514;131;5319;5363;9.55;0.59;246.02;3.82;805;43;1811.00;44
4516;43;625523799;4516;128;5320;5363;9.67;0.59;246.02;3.82;804;43;1812.00;43
4521;43;625523815;4521;118;5322;5363;9.73;0.59;246.03;3.82;801;43;1813.00;41
4524;43;625523830;4524;124;5322;5363;9.82;0.60;246.05;3.82;798;43;1814.00;41
4527;43;625523847;4527;120;5326;5369;9.89;0.60;246.03;3.83;799;43;1815.00;43
4529;43;625523862;4529;125;5329;5369;9.90;0.60;246.07;3.83;800;43;1816.00;40
4531;43;625523877;4531;131;5329;5369;9.93;0.61;246.09;3.83;798;43;1817.00;40
4534;43;625523890;4534;130;5330;5372;9.97;0.61;246.06;3.83;796;43;1818.00;42
4538;43;625523904;4538;133;5331;5372;9.96;0.61;246.23;3.83;793;43;1819.00;41
4540;43;625523917;4540;128;5334;5372;9.96;0.61;246.28;3.84;794;43;1820.00;38
4546;43;625523934;4546;132;5336;5373;10.03;0.61;246.32;3.84;790;43;1821.00;37
4550;43;625523949;4550;134;5337;5374;10.19;0.62;246.44;3.84;787;43;1822.00;37
4553;43;625523969;4553;135;5337;5374;10.31;0.63;246.45;3.84;784;43;1823.00;37
4556;43;625523990;4556;139;5345;5387;10.31;0.63;246.48;3.84;789;43;1824.00;42
4558;43;625524006;4558;136;5345;5387;10.35;0.63;246.52;3.84;787;43;1825.00;42
4562;43;625524021;4562;135;5346;5387;10.39;0.63;246.52;3.85;784;43;1826.00;41
4566;43;625524050;4566;141;5350;5388;10.50;0.64;246.52;3.85;784;43;1827.00;38
4568;43;625524068;4568;138;5350;5388;10.53;0.64;246.51;3.85;782;43;1828.00;38
4570;43;625524090;4570;142;5353;5392;10.45;0.64;246.51;3.85;783;43;1829.00;39
4574;43;625524112;4574;146;5357;5392;10.31;0.63;246.54;3.88;783;43;1830.00;35
4575;43;625524133;4575;149;5361;5396;10.22;0.62;246.52;3.88;786;43;1831.00;35
4577;43;625524148;4577;154;5364;5396;10.14;0.62;246.58;3.90;787;43;1832.00;32
4581;43;625524163;4581;162;5364;5396;10.15;0.62;246.57;3.90;783;43;1833.00;32
4584;43;625524179;4584;169;5366;5396;10.09;0.62;246.68;3.91;782;43;1834.00;30
4586;43;625524193;4586;176;5368;5396;10.00;0.61;246.60;3.92;782;43;1835.00;28
4590;43;625524212;4590;184;5378;5408;9.92;0.61;246.69;3.92;788;43;1836.00;30
4594;43;625524226;4594;182;5381;5408;9.88;0.60;246.74;3.93;787;43;1837.00;27
4595;43;625524240;4595;189;5382;5408;9.85;0.60;246.76;3.94;787;43;1838.00;26
4597;43;625524253;4597;189;5384;5408;9.87;0.60;246.81;3.95;787;43;1839.00;24
4600;43;625524265;4600;199;5385;5408;9.88;0.60;246.75;3.96;785;43;1840.00;23
4603;43;625524278;4603;205;5387;5408;9.85;0.60;246.77;3.97;784;43;1841.00;21
4605;43;625524302;4605;204;5389;5409;9.73;0.60;246.74;3.98;784;43;1842.00;20
4609;43;625524322;4609;207;5390;5409;9.67;0.59;246.73;3.98;781;43;1843.00;19
4610;43;625524335;4610;210;5394;5415;9.63;0.59;246.68;3.98;784;43;1844.00;21
4613;43;625524348;4613;221;5398;5417;9.54;0.58;246.75;3.99;785;43;1845.00;19
4617;43;625524368;4617;224;5400;5417;9.48;0.58;246.81;4.00;783;43;1846.00;17
4620;43;625524380;4620;231;5402;5417;9.35;0.57;246.71;4.01;782;43;1847.00;15
4622;43;625524392;4622;234;5405;5421;9.30;0.57;246.80;4.01;783;43;1848.00;16
4622;43;625524424;4622;234;5406;5421;9.20;0.56;246.80;4.01;784;43;1849.00;15
4629;43;625524436;4629;238;5407;5421;9.02;0.55;246.96;4.02;778;43;1850.00;14
4630;43;625524450;4630;241;5409;5422;8.95;0.55;246.98;4.02;779;43;1851.00;13
4633;43;625524462;4633;239;5412;5426;8.80;0.54;247.02;4.02;779;43;1852.00;14
4634;43;625524475;4634;242;5412;5426;8.72;0.53;247.11;4.02;778;43;1853.00;14
4635;43;625524487;4635;243;5415;5429;8.70;0.53;247.08;4.02;780;43;1854.00;14
4637;43;625524500;4637;246;5416;5429;8.70;0.53;247.06;4.03;779;43;1855.00;13
4640;43;625524511;4640;251;5417;5429;8.71;0.53;247.06;4.02;777;43;1856.00;12
4641;43;625524522;4641;254;5418;5429;8.75;0.54;247.13;4.03;777;43;1857.00;11
4643;43;625524532;4643;259;5421;5433;8.73;0.53;247.07;4.03;778;43;1858.00;12
4646;43;625524544;4646;258;5422;5433;8.66;0.53;247.01;4.03;776;43;1859.00;11
4648;43;625524557;4648;265;5425;5433;8.56;0.52;246.94;4.03;777;43;1860.00;8
4651;43;625524568;4651;265;5425;5433;8.42;0.51;246.94;4.03;774;43;1861.00;8
4655;43;625524580;4655;268;5425;5434;8.24;0.50;247.00;4.03;770;43;1862.00;9
4657;43;625524591;4657;274;5427;5435;8.16;0.50;246.95;4.03;770;43;1863.00;8
4661;43;625524600;4661;278;5427;5435;7.97;0.49;246.85;4.03;766;43;1864.00;8
4663;43;625524613;4663;282;5428;5436;7.84;0.48;246.85;4.03;765;43;1865.00;8
4666;43;625524624;4666;288;5428;5436;7.63;0.47;246.85;4.03;762;43;1866.00;8
4668;43;625524634;4668;292;5428;5436;7.43;0.46;246.83;4.03;760;43;1867.00;8
4673;43;625524644;4673;303;5428;5436;7.14;0.44;246.81;4.03;755;43;1868.00;8
4673;43;625524653;4673;314;5428;5436;6.95;0.43;246.81;4.03;755;43;1869.00;8
4677;43;625524661;4677;305;5428;5436;6.78;0.42;246.76;4.03;751;43;1870.00;8
4679;43;625524672;4679;311;5428;5436;6.69;0.41;246.79;4.03;749;43;1871.00;8
4682;43;625524682;4682;325;5492;5563;6.91;0.43;246.77;3.98;810;43;1872.00;71
4686;43;625524703;4686;324;5504;5564;6.75;0.42;246.83;3.98;818;43;1873.00;60
4687;43;625524716;4687;325;5514;5564;6.83;0.43;246.81;3.97;827;43;1874.00;50
4690;43;625524726;4690;325;5517;5564;6.87;0.43;246.77;3.97;827;43;1875.00;47
4692;43;625524736;4692;326;5523;5564;6.98;0.44;246.96;3.97;831;43;1876.00;41
4695;43;625524748;4695;318;5528;5564;7.08;0.44;246.96;3.97;833;43;1877.00;36
4698;43;625524758;4698;315;5534;5564;7.15;0.44;246.99;3.98;836;43;1878.00;30
4699;43;625524773;4699;314;5536;5564;7.19;0.45;247.03;3.98;837;43;1879.00;28
4702;43;625524783;4702;314;5540;5565;7.27;0.45;246.93;3.98;838;43;1880.00;25
4708;43;625524795;4708;323;5544;5566;7.26;0.45;246.93;3.98;836;43;1881.00;22
4711;43;625524808;4711;324;5546;5568;7.24;0.45;246.88;3.98;835;43;1882.00;22
4712;43;625524820;4712;329;5549;5569;7.22;0.45;246.86;3.99;837;43;1883.00;20
4714;43;625524833;4714;332;5551;5569;7.18;0.44;246.85;3.99;837;43;1884.00;18
4715;43;625524844;4715;333;5552;5569;7.17;0.44;246.82;3.99;837;43;1885.00;17
4718;43;625524856;4718;327;5554;5569;7.17;0.44;246.78;3.99;836;43;1886.00;15
4721;43;625524868;4721;332;5557;5573;7.15;0.44;246.85;3.99;836;43;1887.00;16
4724;43;625524880;4724;336;5559;5573;7.10;0.44;246.84;4.00;835;43;1888.00;14
4725;43;625524892;4725;339;5559;5573;7.03;0.43;246.88;4.00;834;43;1889.00;14
4729;43;625524906;4729;341;5563;5579;6.98;0.43;246.95;4.00;834;43;1890.00;16
4730;43;625524919;4730;333;5563;5579;6.91;0.42;246.93;4.00;833;43;1891.00;16
4732;43;625524938;4732;324;5564;5579;6.91;0.42;246.92;4.00;832;43;1892.00;15
4735;43;625524951;4735;324;5569;5583;6.97;0.43;246.86;4.00;834;43;1893.00;14
4736;43;625524967;4736;321;5570;5584;7.09;0.43;246.81;4.00;834;43;1894.00;14
4737;43;625524980;4737;318;5572;5584;7.16;0.44;246.83;4.00;835;43;1895.00;12
4742;43;625524993;4742;313;5577;5588;7.18;0.44;246.82;3.99;835;43;1896.00;11
4744;43;625525006;4744;312;5578;5588;7.20;0.44;246.75;3.99;834;43;1897.00;10
4748;43;625525036;4748;317;5578;5588;7.23;0.44;246.74;3.99;830;43;1898.00;10
4754;43;625525050;4754;321;5579;5589;7.32;0.45;246.88;3.99;825;43;1899.00;10
4759;43;625525066;4759;324;5579;5589;7.36;0.45;247.03;3.99;820;43;1900.00;10
4762;43;625525087;4762;324;5583;5595;7.39;0.45;246.97;3.99;821;43;1901.00;12
4766;43;625525100;4766;317;5583;5595;7.43;0.46;246.98;3.99;817;43;1902.00;12
4769;43;625525112;4769;316;5585;5596;7.47;0.46;246.96;3.99;816;43;1903.00;11
4771;43;625525128;4771;315;5585;5596;7.47;0.46;246.95;3.99;814;43;1904.00;11
4773;43;625525140;4773;313;5585;5596;7.51;0.46;246.95;3.99;812;43;1905.00;11
4779;43;625525150;4779;316;5585;5596;7.48;0.46;246.94;3.99;806;43;1906.00;11
4782;43;625525171;4782;319;5585;5596;7.50;0.46;246.92;3.99;803;43;1907.00;11
4786;43;625525189;4786;318;5594;5608;7.67;0.47;246.90;3.98;808;43;1908.00;14
4789;43;625525208;4789;319;5595;5608;7.74;0.47;246.89;3.98;806;43;1909.00;13
4790;43;625525226;4790;320;5596;5608;7.82;0.47;246.92;3.98;806;43;1910.00;12
4792;43;625525242;4792;318;5596;5608;7.82;0.47;246.89;3.98;804;43;1911.00;12
4794;43;625525259;4794;319;5596;5608;7.82;0.48;246.93;3.98;802;43;1912.00;12
4795;43;625525274;4795;322;5596;5608;7.88;0.48;246.95;3.98;801;43;1913.00;12
4799;43;625525287;4799;323;5600;5612;7.82;0.47;246.97;4.00;801;43;1914.00;12
4802;43;625525300;4802;327;5600;5612;7.75;0.47;247.04;4.00;798;43;1915.00;12
4803;43;625525311;4803;336;5603;5616;7.72;0.47;247.10;4.00;800;43;1916.00;13
4806;43;625525331;4806;329;5605;5617;7.68;0.47;247.14;4.00;799;43;1917.00;12
4808;43;625525345;4808;318;5605;5617;7.66;0.47;247.25;4.00;797;43;1918.00;12
4809;43;625525357;4809;316;5605;5617;7.65;0.47;247.29;4.00;796;43;1919.00;12
4813;43;625525371;4813;320;5627;5646;7.68;0.47;247.34;3.98;814;43;1920.00;19
4815;43;625525385;4815;305;5627;5646;7.74;0.47;247.53;3.98;812;43;1921.00;19
4817;43;625525397;4817;307;5629;5646;7.78;0.48;247.56;3.98;812;43;1922.00;17
4820;43;625525408;4820;305;5631;5647;7.86;0.48;247.55;3.98;811;43;1923.00;16
4824;43;625525419;4824;304;5631;5648;7.89;0.48;247.53;3.98;807;43;1924.00;17
4829;43;625525431;4829;303;5631;5648;7.82;0.48;247.51;3.98;802;43;1925.00;17
4830;43;625525442;4830;289;5634;5651;7.87;0.48;247.52;3.98;804;43;1926.00;17
4832;43;625525454;4832;264;5634;5651;7.90;0.48;247.55;3.98;802;43;1927.00;17
4837;43;625525465;4837;246;5634;5651;7.92;0.48;247.44;3.98;797;43;1928.00;17
4838;43;625525478;4838;241;5634;5651;7.99;0.49;247.46;3.98;796;43;1929.00;17
4839;43;625525489;4839;233;5639;5657;8.07;0.49;247.43;4.00;800;43;1930.00;18
4845;43;625525501;4845;234;5639;5657;8.12;0.49;247.59;4.00;794;43;1931.00;18
4848;43;625525514;4848;232;5640;5657;8.13;0.49;247.68;4.00;792;43;1932.00;17
4849;43;625525526;4849;229;5640;5657;8.18;0.50;247.67;4.00;791;43;1933.00;17
4851;43;625525537;4851;236;5643;5661;8.16;0.49;247.73;4.00;792;43;1934.00;18
4855;43;625525548;4855;236;5645;5663;8.13;0.49;247.74;4.00;790;43;1935.00;18
4855;43;625525567;4855;242;5645;5663;8.17;0.50;247.74;4.00;790;43;1936.00;18
4859;43;625525578;4859;234;5646;5664;8.22;0.50;247.83;4.00;787;43;1937.00;18
4863;43;625525590;4863;236;5647;5664;8.27;0.50;247.83;4.02;784;43;1938.00;17
4865;43;625525602;4865;233;5647;5664;8.34;0.51;247.80;4.02;782;43;1939.00;17
4868;43;625525614;4868;224;5647;5664;8.32;0.50;247.82;4.02;779;43;1940.00;17
4869;43;625525625;4869;229;5647;5664;8.30;0.50;247.81;4.02;778;43;1941.00;17
4870;43;625525637;4870;227;5647;5664;8.35;0.51;247.82;4.02;777;43;1942.00;17
4872;43;625525648;4872;224;5647;5664;8.41;0.51;247.80;4.02;775;43;1943.00;17
4874;43;625525659;4874;243;5692;5734;8.32;0.51;247.84;3.99;818;43;1944.00;42
4874;43;625525675;4874;227;5692;5735;8.42;0.51;247.84;3.99;818;43;1945.00;43
4876;43;625525686;4876;222;5697;5735;8.58;0.52;247.82;3.99;821;43;1946.00;38
4877;43;625525697;4877;224;5702;5735;8.73;0.53;247.85;3.99;825;43;1947.00;33
4880;43;625525709;4880;218;5706;5735;8.76;0.53;247.83;3.99;826;43;1948.00;29
4882;43;625525726;4882;225;5707;5735;8.76;0.53;247.85;3.99;825;43;1949.00;28
4884;43;625525745;4884;220;5710;5737;8.85;0.54;247.81;3.99;826;43;1950.00;27
4887;43;625525757;4887;224;5711;5737;8.86;0.54;247.79;3.99;824;43;1951.00;26
4891;43;625525768;4891;227;5714;5738;8.92;0.54;247.79;3.99;823;43;1952.00;24
4892;43;625525781;4892;226;5715;5739;8.97;0.55;247.81;3.99;823;43;1953.00;24
4892;43;625525792;4892;224;5717;5739;9.03;0.55;247.81;4.01;825;43;1954.00;22
4894;43;625525803;4894;229;5720;5743;8.95;0.55;247.80;4.01;826;43;1955.00;23
4897;43;625525814;4897;237;5721;5743;8.92;0.54;247.83;4.01;824;43;1956.00;22
4897;43;625525825;4897;231;5721;5743;8.95;0.55;247.83;4.01;824;43;1957.00;22
4898;43;625525836;4898;237;5721;5743;8.96;0.55;247.88;4.01;823;43;1958.00;22
4899;43;625525847;4899;235;5726;5749;8.98;0.55;247.89;4.01;827;43;1959.00;23
4902;43;625525858;4902;235;5726;5749;9.09;0.55;247.88;4.01;824;43;1960.00;23
4904;43;625525869;4904;231;5726;5749;9.09;0.55;247.88;4.01;822;43;1961.00;23
4904;43;625525880;4904;225;5729;5752;9.08;0.55;247.88;4.01;825;43;1962.00;23
4911;43;625525891;4911;226;5729;5752;9.02;0.55;248.01;4.01;818;43;1963.00;23
4914;43;625525902;4914;227;5729;5752;8.99;0.55;248.04;4.01;815;43;1964.00;23
4915;43;625525918;4915;218;5729;5753;9.00;0.55;248.03;4.01;814;43;1965.00;24
4916;43;625525929;4916;218;5731;5754;8.98;0.55;248.04;4.04;815;43;1966.00;23
4921;43;625525940;4921;219;5731;5754;8.95;0.55;248.12;4.04;810;43;1967.00;23
4924;43;625525950;4924;215;5740;5767;8.97;0.55;248.10;4.03;816;43;1968.00;27
4928;43;625525962;4928;209;5740;5767;8.91;0.54;248.12;4.03;812;43;1969.00;27
4928;43;625525975;4928;209;5740;5767;8.86;0.54;248.12;4.03;812;43;1970.00;27
4932;43;625525986;4932;203;5741;5768;8.87;0.54;248.25;4.03;809;43;1971.00;27
4935;43;625525995;4935;195;5742;5768;8.85;0.54;248.27;4.06;807;43;1972.00;26
4941;43;625526006;4941;180;5745;5772;8.84;0.54;248.38;4.06;804;43;1973.00;27
4944;43;625526017;4944;173;5747;5772;8.92;0.54;248.41;4.07;803;43;1974.00;25
4947;43;625526029;4947;165;5752;5776;8.82;0.54;248.43;4.11;805;43;1975.00;24
4953;43;625526040;4953;159;5752;5776;8.83;0.54;248.47;4.11;799;43;1976.00;24
4954;43;625526052;4954;156;5752;5776;8.91;0.54;248.55;4.11;798;43;1977.00;24
4958;43;625526063;4958;152;5752;5776;8.91;0.54;248.62;4.11;794;43;1978.00;24
4961;43;625526073;4961;153;5752;5776;8.97;0.54;248.62;4.11;791;43;1979.00;24
4964;43;625526085;4964;155;5772;5810;9.04;0.55;248.63;4.09;808;43;1980.00;38
4966;43;625526099;4966;151;5773;5810;9.05;0.55;248.74;4.09;807;43;1981.00;37
4968;43;625526109;4968;148;5774;5810;9.06;0.55;248.76;4.09;806;43;1982.00;36
4970;43;625526119;4970;145;5774;5810;9.11;0.55;248.82;4.09;804;43;1983.00;36
4971;43;625526130;4971;149;5775;5810;9.15;0.56;248.89;4.09;804;43;1984.00;35
4973;43;625526140;4973;149;5775;5810;9.19;0.56;248.96;4.09;802;43;1985.00;35
4975;43;625526151;4975;154;5777;5811;9.24;0.56;248.99;4.10;802;43;1986.00;34
4978;43;625526165;4978;151;5778;5811;9.26;0.56;249.09;4.11;800;43;1987.00;33
4981;43;625526178;4981;152;5782;5817;9.31;0.57;249.07;4.14;801;43;1988.00;35
4987;43;625526191;4987;156;5783;5818;9.33;0.57;249.06;4.14;796;43;1989.00;35
4989;43;625526202;4989;156;5785;5818;9.39;0.57;249.05;4.14;796;43;1990.00;33
4991;43;625526212;4991;163;5786;5818;9.41;0.57;249.05;4.14;795;43;1991.00;32
4993;43;625526223;4993;165;5789;5822;9.48;0.58;249.12;4.14;796;43;1992.00;33
4997;43;625526234;4997;168;5789;5822;9.44;0.57;249.08;4.14;792;43;1993.00;33
5000;43;625526244;5000;173;5790;5822;9.46;0.58;249.24;4.14;790;43;1994.00;32
5002;43;625526254;5002;175;5791;5823;9.47;0.58;249.32;4.14;789;43;1995.00;32
5003;43;625526270;5003;179;5796;5827;9.45;0.58;249.35;4.15;793;43;1996.00;31
5006;43;625526287;5006;177;5796;5827;9.37;0.57;249.38;4.15;790;43;1997.00;31
5007;43;625526303;5007;181;5799;5830;9.41;0.57;249.40;4.15;792;43;1998.00;31
5009;43;625526314;5009;180;5799;5830;9.40;0.57;249.44;4.15;790;43;1999.00;31
5012;43;625526325;5012;185;5803;5830;9.47;0.58;249.49;4.18;791;43;2000.00;27
5014;43;625526339;5014;185;5803;5830;9.51;0.58;249.58;4.18;789;43;2001.00;27
5015;43;625526349;5015;195;5806;5834;9.60;0.59;249.59;4.18;791;43;2002.00;28
5018;43;625526360;5018;198;5810;5834;9.62;0.59;249.65;4.20;792;43;2003.00;24
5024;43;625526371;5024;195;5810;5834;9.60;0.58;249.76;4.20;786;43;2004.00;24
5025;43;625526388;5025;206;5812;5834;9.57;0.58;249.82;4.22;787;43;2005.00;22
5029;43;625526398;5029;209;5812;5835;9.51;0.58;249.92;4.22;783;43;2006.00;23
5031;43;625526409;5031;215;5815;5836;9.45;0.58;249.98;4.23;784;43;2007.00;21
5031;43;625526419;5031;220;5815;5836;9.46;0.58;249.98;4.23;784;43;2008.00;21
5036;43;625526429;5036;224;5816;5837;9.43;0.58;249.97;4.23;780;43;2009.00;21
5042;43;625526440;5042;227;5818;5837;9.37;0.57;249.82;4.25;776;43;2010.00;19
5044;43;625526450;5044;227;5818;5837;9.28;0.57;249.88;4.25;774;43;2011.00;19
5047;43;625526460;5047;233;5820;5837;9.22;0.56;249.85;4.26;773;43;2012.00;17
5053;43;625526476;5053;237;5820;5837;9.09;0.55;249.76;4.26;767;43;2013.00;17
5053;43;625526486;5053;243;5821;5837;9.04;0.55;249.76;4.27;768;43;2014.00;16
5054;43;625526495;5054;250;5822;5837;8.95;0.55;249.72;4.28;768;43;2015.00;15
5055;43;625526505;5055;273;5889;5964;8.97;0.56;249.71;4.23;834;43;2016.00;75
5059;43;625526524;5059;274;5892;5965;8.80;0.54;249.73;4.24;833;43;2017.00;73
5061;43;625526534;5061;270;5902;5965;8.74;0.54;249.67;4.24;841;43;2018.00;63
5063;43;625526544;5063;267;5907;5965;8.62;0.53;249.65;4.24;844;43;2019.00;58
5067;43;625526554;5067;275;5916;5965;8.55;0.53;249.57;4.24;849;43;2020.00;49
5069;43;625526564;5069;267;5922;5965;8.41;0.52;249.54;4.25;853;43;2021.00;43
5070;43;625526574;5070;270;5927;5965;8.33;0.51;249.52;4.25;857;43;2022.00;38
5070;43;625526583;5070;272;5934;5965;8.25;0.51;249.52;4.27;864;43;2023.00;31
5073;43;625526593;5073;267;5939;5966;8.22;0.50;249.43;4.27;866;43;2024.00;27
5075;43;625526604;5075;269;5941;5968;8.20;0.50;249.38;4.27;866;43;2025.00;27
5075;43;625526620;5075;269;5944;5968;8.21;0.50;249.38;4.28;869;43;2026.00;24
5075;43;625526630;5075;272;5945;5969;8.14;0.50;249.38;4.28;870;43;2027.00;24
5076;43;625526641;5076;276;5947;5969;8.09;0.50;249.37;4.28;871;43;2028.00;22
5077;43;625526651;5077;287;5950;5969;7.95;0.49;249.35;4.29;873;43;2029.00;19
5079;43;625526660;5079;293;5952;5969;7.87;0.48;249.33;4.29;873;43;2030.00;17
5080;43;625526670;5080;294;5957;5973;7.80;0.48;249.36;4.30;877;43;2031.00;16
5082;43;625526680;5082;304;5959;5973;7.69;0.47;249.36;4.30;877;43;2032.00;14
5083;43;625526690;5083;312;5960;5973;7.61;0.47;249.33;4.30;877;43;2033.00;13
5087;43;625526700;5087;319;5964;5976;7.48;0.46;249.33;4.30;877;43;2034.00;12
5088;43;625526710;5088;327;5964;5976;7.38;0.45;249.31;4.30;876;43;2035.00;12
5094;43;625526719;5094;335;5966;5976;7.24;0.44;249.22;4.30;872;43;2036.00;10
5096;43;625526729;5096;336;5970;5980;7.07;0.43;249.20;4.30;874;43;2037.00;10
5103;43;625526738;5103;345;5972;5981;6.96;0.43;249.11;4.30;869;43;2038.00;9
5105;43;625526748;5105;355;5972;5981;6.84;0.42;249.05;4.30;867;43;2039.00;9
5109;43;625526758;5109;349;5977;5986;6.76;0.41;249.01;4.30;868;43;2040.00;9
5110;43;625526774;5110;350;5977;5986;6.67;0.41;249.01;4.30;867;43;2041.00;9
5114;43;625526783;5114;345;5977;5986;6.52;0.40;248.94;4.30;863;43;2042.00;9
5117;43;625526793;5117;333;5978;5987;6.43;0.39;249.04;4.30;861;43;2043.00;9
5117;43;625526802;5117;324;5978;5987;6.48;0.40;249.04;4.30;861;43;2044.00;9
5122;43;625526811;5122;322;5983;5993;6.49;0.40;249.01;4.29;861;43;2045.00;10
5123;43;625526822;5123;318;5984;5993;6.60;0.40;248.97;4.29;861;43;2046.00;9
5126;43;625526832;5126;313;5985;5994;6.66;0.41;248.95;4.29;859;43;2047.00;9
5127;43;625526843;5127;303;5985;5994;6.74;0.41;249.00;4.29;858;43;2048.00;9
5130;43;625526852;5130;295;5985;5994;6.79;0.41;248.97;4.29;855;43;2049.00;9
5132;43;625526872;5132;283;5985;5994;6.88;0.42;249.04;4.29;853;43;2050.00;9
5132;43;625526883;5132;275;5985;5994;6.93;0.42;249.04;4.29;853;43;2051.00;9
5134;44;625526893;5134;275;5996;6006;7.04;0.43;249.11;4.28;862;44;2052.00;10
5136;44;625526915;5136;271;5996;6006;7.10;0.43;249.12;4.28;860;44;2053.00;10
5140;44;625526926;5140;268;5997;6006;7.17;0.44;249.08;4.28;857;44;2054.00;9
5142;44;625526937;5142;267;5997;6006;7.24;0.44;249.11;4.28;855;44;2055.00;9
5144;44;625526947;5144;267;5997;6006;7.26;0.44;249.15;4.28;853;44;2056.00;9
5144;44;625526957;5144;259;5997;6006;7.28;0.44;249.15;4.28;853;44;2057.00;9
5146;44;625526969;5146;254;6001;6010;7.35;0.45;249.23;4.28;855;44;2058.00;9
5148;44;625526980;5148;258;6001;6010;7.38;0.45;249.22;4.28;853;44;2059.00;9
5151;44;625526996;5151;253;6004;6014;7.46;0.45;249.17;4.28;853;44;2060.00;10
5154;44;625527007;5154;250;6005;6015;7.55;0.46;249.14;4.28;851;44;2061.00;10
5157;44;625527018;5157;247;6006;6015;7.63;0.46;249.19;4.28;849;44;2062.00;9
5159;44;625527029;5159;252;6006;6015;7.66;0.47;249.21;4.28;847;44;2063.00;9
5163;44;625527040;5163;254;6019;6028;7.66;0.47;249.16;4.27;856;44;2064.00;9
5165;44;625527053;5165;259;6019;6028;7.71;0.47;249.16;4.27;854;44;2065.00;9
5172;44;625527064;5172;256;6019;6028;7.69;0.47;249.26;4.27;847;44;2066.00;9
5175;44;625527075;5175;247;6020;6029;7.77;0.48;249.25;4.27;845;44;2067.00;9
5178;44;625527087;5178;246;6021;6030;7.81;0.48;249.30;4.27;843;44;2068.00;9
5185;44;625527103;5185;248;6021;6030;7.81;0.48;249.44;4.27;836;44;2069.00;9
5186;44;625527117;5186;256;6024;6036;7.96;0.49;249.44;4.27;838;44;2070.00;12
5191;44;625527129;5191;260;6024;6036;8.01;0.49;249.53;4.27;833;44;2071.00;12
5194;44;625527140;5194;257;6025;6036;8.08;0.49;249.65;4.27;831;44;2072.00;11
5200;44;625527151;5200;251;6025;6036;8.10;0.50;249.70;4.27;825;44;2073.00;11
5205;44;625527162;5205;257;6030;6042;8.05;0.49;249.86;4.26;825;44;2074.00;12
5210;44;625527181;5210;258;6030;6042;8.03;0.49;249.87;4.26;820;44;2075.00;12
5215;44;625527201;5215;260;6031;6042;8.05;0.49;249.90;4.26;816;44;2076.00;11
5222;44;625527218;5222;264;6031;6042;8.02;0.49;250.07;4.26;809;44;2077.00;11
5225;44;625527239;5225;263;6037;6046;8.01;0.49;250.20;4.30;812;44;2078.00;9
5227;44;625527258;5227;262;6038;6047;8.01;0.49;250.35;4.30;811;44;2079.00;9
5231;44;625527276;5231;261;6039;6047;7.92;0.48;250.37;4.30;808;44;2080.00;8
5238;44;625527291;5238;261;6040;6048;7.82;0.48;250.34;4.30;802;44;2081.00;8
5242;44;625527303;5242;262;6040;6048;7.82;0.48;250.32;4.30;798;44;2082.00;8
5246;44;625527315;5246;269;6040;6048;7.76;0.47;250.41;4.30;794;44;2083.00;8
5249;44;625527328;5249;276;6040;6048;7.71;0.47;250.54;4.30;791;44;2084.00;8
5251;44;625527341;5251;271;6040;6048;7.65;0.47;250.56;4.30;789;44;2085.00;8
5254;44;625527353;5254;277;6040;6048;7.61;0.47;250.67;4.30;786;44;2086.00;8
5259;44;625527366;5259;267;6040;6048;7.65;0.47;250.75;4.30;781;44;2087.00;8
5265;44;625527378;5265;276;6083;6118;7.70;0.47;250.83;4.27;818;44;2088.00;35
5270;44;625527397;5270;269;6084;6119;7.73;0.47;250.84;4.26;814;44;2089.00;35
5275;44;625527409;5275;263;6090;6119;7.86;0.48;251.01;4.26;815;44;2090.00;29
5280;44;625527421;5280;261;6091;6119;7.95;0.48;251.05;4.26;811;44;2091.00;28
5283;44;625527433;5283;261;6095;6119;8.13;0.49;251.08;4.26;812;44;2092.00;24
5286;44;625527445;5286;265;6099;6119;8.29;0.51;251.08;4.26;813;44;2093.00;20
5287;44;625527457;5287;264;6101;6119;8.39;0.51;251.14;4.26;814;44;2094.00;18
5290;44;625527470;5290;271;6105;6119;8.38;0.51;251.10;4.30;815;44;2095.00;14
5293;44;625527490;5293;261;6107;6120;8.41;0.51;251.30;4.30;814;44;2096.00;13
5297;44;625527510;5297;250;6108;6121;8.41;0.51;251.33;4.30;811;44;2097.00;13
5301;44;625527526;5301;243;6109;6121;8.45;0.52;251.38;4.30;808;44;2098.00;12
5303;44;625527541;5303;240;6112;6125;8.45;0.52;251.38;4.30;809;44;2099.00;13
5307;44;625527559;5307;246;6116;6140;8.42;0.52;251.37;4.30;809;44;2100.00;24
5308;44;625527583;5308;237;6116;6140;8.44;0.52;251.37;4.30;808;44;2101.00;24
5313;44;625527599;5313;236;6116;6140;8.46;0.52;251.38;4.30;803;44;2102.00;24
5317;44;625527612;5317;237;6119;6146;8.52;0.52;251.33;4.29;802;44;2103.00;27
5320;44;625527626;5320;233;6119;6146;8.61;0.53;251.33;4.29;799;44;2104.00;27
5323;44;625527645;5323;240;6121;6146;8.61;0.53;251.34;4.29;798;44;2105.00;25
5326;44;625527658;5326;235;6123;6149;8.68;0.53;251.39;4.29;797;44;2106.00;26
5330;44;625527670;5330;226;6124;6149;8.75;0.53;251.43;4.32;794;44;2107.00;25
5334;44;625527683;5334;223;6124;6149;8.77;0.53;251.48;4.32;790;44;2108.00;25
5338;44;625527696;5338;216;6124;6150;8.77;0.53;251.42;4.32;786;44;2109.00;26
5339;44;625527709;5339;211;6126;6151;8.82;0.54;251.39;4.32;787;44;2110.00;25
5340;44;625527721;5340;207;6127;6151;8.80;0.53;251.39;4.32;787;44;2111.00;24
5340;44;625527733;5340;202;6136;6164;8.81;0.54;251.39;4.32;796;44;2112.00;28
5340;44;625527745;5340;195;6136;6164;8.86;0.54;251.39;4.32;796;44;2113.00;28
5341;44;625527756;5341;193;6137;6164;8.93;0.54;251.39;4.35;796;44;2114.00;27
5342;44;625527775;5342;194;6139;6166;9.03;0.55;251.35;4.35;797;44;2115.00;27
5346;44;625527787;5346;190;6141;6166;9.06;0.55;251.35;4.35;795;44;2116.00;25
5348;45;625527799;5348;190;6143;6170;9.12;0.55;251.31;4.35;795;45;2117.00;27
5349;45;625527823;5349;190;6143;6170;9.16;0.56;251.32;4.35;794;45;2118.00;27
5349;45;625527836;5349;195;6146;6174;9.21;0.56;251.32;4.35;797;45;2119.00;28
5350;45;625527848;5350;203;6146;6174;9.31;0.57;251.33;4.35;796;45;2120.00;28
5353;45;625527863;5353;208;6147;6174;9.33;0.57;251.54;4.35;794;45;2121.00;27
5356;45;625527875;5356;208;6148;6174;9.31;0.57;251.57;4.35;792;45;2122.00;26
5357;45;625527887;5357;211;6148;6174;9.37;0.57;251.56;4.35;791;45;2123.00;26
5360;45;625527899;5360;213;6156;6186;9.34;0.57;251.64;4.35;796;45;2124.00;30
5364;45;625527914;5364;213;6158;6186;9.34;0.57;251.64;4.35;794;45;2125.00;28
5364;45;625527927;5364;215;6161;6186;9.42;0.57;251.64;4.36;797;45;2126.00;25
5367;45;625527938;5367;216;6163;6186;9.39;0.57;251.66;4.39;796;45;2127.00;23
5369;45;625527949;5369;218;6165;6186;9.37;0.57;251.61;4.39;796;45;2128.00;21
5371;45;625527960;5371;219;6165;6186;9.32;0.57;251.59;4.39;794;45;2129.00;21
5373;45;625527973;5373;217;6165;6187;9.26;0.56;251.59;4.39;792;45;2130.00;22
5374;45;625527985;5374;216;6166;6187;9.20;0.56;251.60;4.39;792;45;2131.00;21
5375;45;625528002;5375;216;6171;6193;9.12;0.56;251.63;4.40;796;45;2132.00;22
5375;45;625528014;5375;204;6173;6194;9.05;0.55;251.63;4.39;798;45;2133.00;21
5378;45;625528026;5378;199;6173;6194;9.01;0.55;251.58;4.39;795;45;2134.00;21
5380;45;625528037;5380;191;6174;6194;8.94;0.55;251.61;4.39;794;45;2135.00;20
5382;45;625528048;5382;193;6176;6198;8.97;0.55;251.72;4.39;794;45;2136.00;22
5387;45;625528059;5387;185;6177;6198;8.99;0.55;251.67;4.39;790;45;2137.00;21
5392;45;625528071;5392;181;6177;6198;8.99;0.55;251.76;4.39;785;45;2138.00;21
5397;45;625528082;5397;171;6178;6199;9.10;0.55;251.81;4.39;781;45;2139.00;21
5399;45;625528094;5399;173;6181;6203;9.17;0.56;251.80;4.39;782;45;2140.00;22
5402;45;625528104;5402;170;6182;6203;9.17;0.56;251.88;4.42;780;45;2141.00;21
5406;45;625528115;5406;169;6184;6206;9.15;0.56;251.88;4.41;778;45;2142.00;22
5413;45;625528126;5413;165;6186;6206;9.09;0.55;251.89;4.44;773;45;2143.00;20
5416;45;625528138;5416;168;6186;6206;9.12;0.55;252.06;4.44;770;45;2144.00;20
5418;45;625528149;5418;167;6188;6206;9.15;0.56;252.11;4.46;770;45;2145.00;18
5422;45;625528160;5422;168;6191;6210;9.23;0.56;252.08;4.45;769;45;2146.00;19
5426;45;625528180;5426;165;6192;6210;9.22;0.56;252.11;4.47;766;45;2147.00;18
5430;45;625528191;5430;164;6193;6210;9.24;0.56;252.18;4.47;763;45;2148.00;17
5435;45;625528202;5435;164;6194;6210;9.23;0.56;252.14;4.50;759;45;2149.00;16
5440;45;625528212;5440;167;6194;6211;9.15;0.56;252.20;4.50;754;45;2150.00;17
5442;45;625528223;5442;167;6196;6212;9.19;0.56;252.24;4.50;754;45;2151.00;16
5444;45;625528233;5444;167;6196;6212;9.21;0.56;252.21;4.50;752;45;2152.00;16
5445;45;625528243;5445;174;6197;6213;9.17;0.56;252.17;4.50;752;45;2153.00;16
5449;45;625528253;5449;171;6197;6213;9.10;0.55;252.23;4.50;748;45;2154.00;16
5450;45;625528263;5450;173;6197;6213;9.02;0.55;252.21;4.50;747;45;2155.00;16
5450;45;625528273;5450;170;6197;6213;9.02;0.55;252.21;4.50;747;45;2156.00;16
5451;45;625528282;5451;173;6197;6213;9.02;0.55;252.23;4.50;746;45;2157.00;16
5454;45;625528292;5454;178;6197;6213;9.11;0.56;252.15;4.50;743;45;2158.00;16
5456;45;625528301;5456;177;6197;6213;9.11;0.56;252.18;4.50;741;45;2159.00;16
5458;45;625528312;5458;214;6297;6443;9.08;0.57;252.18;4.43;839;45;2160.00;146
5459;45;625528340;5459;208;6298;6444;9.01;0.56;252.20;4.43;839;45;2161.00;146
5463;45;625528351;5463;202;6306;6444;9.09;0.57;252.15;4.43;843;45;2162.00;138
5465;45;625528361;5465;203;6312;6444;9.09;0.57;252.13;4.43;847;45;2163.00;132
5467;45;625528371;5467;196;6323;6444;9.15;0.57;252.21;4.43;856;45;2164.00;121
5468;45;625528381;5468;190;6327;6444;9.16;0.57;252.20;4.43;859;45;2165.00;117
5473;45;625528391;5473;191;6334;6444;9.14;0.57;252.12;4.43;861;45;2166.00;110
5479;46;625528401;5479;194;6340;6444;9.16;0.57;252.16;4.43;861;46;2167.00;104
5482;46;625528422;5482;202;6344;6445;9.12;0.57;252.05;4.43;862;46;2168.00;101
5486;46;625528438;5486;208;6349;6446;9.05;0.56;251.91;4.44;863;46;2169.00;97
5487;46;625528454;5487;215;6356;6446;8.98;0.56;251.89;4.45;869;46;2170.00;90
5489;46;625528464;5489;223;6361;6447;8.86;0.55;251.93;4.47;872;46;2171.00;86
5492;46;625528475;5492;228;6370;6447;8.75;0.54;251.90;4.49;878;46;2172.00;77
5493;46;625528487;5493;233;6374;6447;8.68;0.54;251.92;4.50;881;46;2173.00;73
5497;46;625528498;5497;243;6378;6447;8.57;0.53;251.88;4.51;881;46;2174.00;69
5499;46;625528509;5499;245;6384;6451;8.47;0.52;251.93;4.53;885;46;2175.00;67
5502;46;625528521;5502;245;6387;6451;8.33;0.51;251.89;4.54;885;46;2176.00;64
5504;46;625528532;5504;253;6389;6451;8.23;0.51;251.88;4.54;885;46;2177.00;62
5504;46;625528548;5504;263;6393;6454;8.20;0.50;251.88;4.55;889;46;2178.00;61
5505;46;625528564;5505;267;6396;6454;8.14;0.50;251.85;4.58;891;46;2179.00;58
5507;46;625528575;5507;271;6398;6454;8.02;0.49;251.84;4.58;891;46;2180.00;56
5509;46;625528585;5509;276;6406;6458;7.91;0.49;251.86;4.61;897;46;2181.00;52
5511;46;625528596;5511;282;6411;6459;7.87;0.48;251.78;4.63;900;46;2182.00;48
5514;46;625528607;5514;292;6415;6459;7.79;0.48;251.75;4.64;901;46;2183.00;44
5514;46;625528618;5514;297;6421;6463;7.77;0.48;251.75;4.66;907;46;2184.00;42
5515;46;625528629;5515;299;6422;6463;7.71;0.47;251.73;4.66;907;46;2185.00;41
5515;46;625528640;5515;311;6424;6463;7.60;0.47;251.73;4.67;909;46;2186.00;39
5518;46;625528651;5518;319;6427;6464;7.43;0.46;251.68;4.68;909;46;2187.00;37
5520;46;625528661;5520;331;6431;6464;7.32;0.45;251.65;4.68;911;46;2188.00;33
5522;46;625528671;5522;328;6436;6470;7.26;0.45;251.57;4.69;914;46;2189.00;34
5524;46;625528684;5524;335;6436;6470;7.21;0.44;251.54;4.69;912;46;2190.00;34
5527;46;625528694;5527;335;6439;6471;7.14;0.44;251.48;4.70;912;46;2191.00;32
5529;46;625528705;5529;345;6439;6471;7.11;0.43;251.49;4.70;910;46;2192.00;32
5532;46;625528716;5532;343;6443;6471;7.07;0.43;251.48;4.72;911;46;2193.00;28
5533;46;625528727;5533;347;6444;6471;7.04;0.43;251.46;4.72;911;46;2194.00;27
5534;46;625528737;5534;342;6448;6471;7.02;0.43;251.46;4.73;914;46;2195.00;23
5534;46;625528747;5534;340;6459;6483;7.10;0.43;251.46;4.73;925;46;2196.00;24
5535;46;625528759;5535;335;6459;6483;7.09;0.43;251.42;4.73;924;46;2197.00;24
5536;46;625528769;5536;337;6463;6483;7.11;0.43;251.42;4.74;927;46;2198.00;20
5539;46;625528780;5539;334;6464;6483;7.13;0.44;251.40;4.74;925;46;2199.00;19
5541;46;625528791;5541;336;6465;6483;7.12;0.43;251.38;4.74;924;46;2200.00;18
5543;46;625528805;5543;331;6465;6483;7.06;0.43;251.36;4.74;922;46;2201.00;18
5545;46;625528816;5545;328;6469;6487;7.02;0.43;251.32;4.75;924;46;2202.00;18
5547;46;625528826;5547;326;6469;6487;6.98;0.43;251.26;4.75;922;46;2203.00;18
5550;46;625528838;5550;328;6473;6491;6.94;0.42;251.26;4.74;923;46;2204.00;18
5550;46;625528850;5550;331;6477;6493;6.91;0.42;251.26;4.75;927;46;2205.00;16
5554;46;625528860;5554;339;6478;6493;6.84;0.42;251.29;4.75;924;46;2206.00;15
5556;46;625528871;5556;335;6478;6493;6.74;0.41;251.28;4.75;922;46;2207.00;15
5560;46;625528882;5560;338;6490;6506;6.62;0.40;251.21;4.74;930;46;2208.00;16
5563;46;625528894;5563;340;6491;6506;6.50;0.40;251.26;4.74;928;46;2209.00;15
5564;46;625528904;5564;336;6493;6508;6.46;0.39;251.29;4.74;929;46;2210.00;15
5565;46;625528915;5565;326;6495;6509;6.43;0.39;251.32;4.74;930;46;2211.00;14
5566;46;625528925;5566;323;6497;6510;6.39;0.39;251.33;4.74;931;46;2212.00;13
5569;46;625528936;5569;321;6497;6510;6.45;0.39;251.35;4.74;928;46;2213.00;13
5571;46;625528947;5571;328;6499;6513;6.50;0.40;251.50;4.74;928;46;2214.00;14
5575;46;625528963;5575;331;6499;6513;6.60;0.40;251.57;4.74;924;46;2215.00;14
5578;46;625528980;5578;324;6499;6513;6.69;0.41;251.69;4.74;921;46;2216.00;14
5581;46;625528991;5581;322;6500;6513;6.74;0.41;251.67;4.74;919;46;2217.00;13
5585;46;625529002;5585;316;6505;6519;6.81;0.42;251.75;4.74;920;46;2218.00;14
5587;46;625529013;5587;307;6505;6519;6.93;0.42;251.72;4.74;918;46;2219.00;14
5590;46;625529025;5590;299;6506;6519;7.00;0.43;251.85;4.74;916;46;2220.00;13
5592;46;625529036;5592;286;6506;6519;7.10;0.44;251.92;4.74;914;46;2221.00;13
5596;46;625529047;5596;270;6510;6523;7.22;0.44;251.97;4.73;914;46;2222.00;13
5600;46;625529058;5600;270;6511;6524;7.35;0.45;252.17;4.73;911;46;2223.00;13
5607;46;625529070;5607;265;6511;6524;7.44;0.46;252.16;4.73;904;46;2224.00;13
5609;46;625529081;5609;260;6512;6525;7.62;0.47;252.12;4.73;903;46;2225.00;13
5615;46;625529092;5615;262;6512;6525;7.72;0.47;252.28;4.73;897;46;2226.00;13
5620;46;625529103;5620;261;6512;6525;7.80;0.48;252.31;4.73;892;46;2227.00;13
5622;46;625529114;5622;258;6512;6525;7.87;0.48;252.31;4.73;890;46;2228.00;13
5628;46;625529126;5628;255;6512;6525;7.96;0.49;252.39;4.73;884;46;2229.00;13
5634;46;625529138;5634;255;6512;6525;7.99;0.49;252.39;4.73;878;46;2230.00;13
5636;46;625529149;5636;254;6512;6525;8.07;0.49;252.32;4.73;876;46;2231.00;13
5646;46;625529169;5646;255;6552;6595;8.19;0.50;252.48;4.70;906;46;2232.00;43
5648;46;625529196;5648;258;6553;6596;8.19;0.50;252.57;4.70;905;46;2233.00;43
5652;46;625529216;5652;255;6561;6596;8.23;0.50;252.63;4.70;909;46;2234.00;35
5656;46;625529236;5656;253;6565;6596;8.22;0.50;252.77;4.70;909;46;2235.00;31
5660;46;625529255;5660;254;6569;6596;8.24;0.50;252.80;4.70;909;46;2236.00;27
5664;46;625529285;5664;261;6572;6596;8.33;0.51;252.74;4.70;908;46;2237.00;24
5672;46;625529299;5672;267;6575;6596;8.31;0.51;252.84;4.70;903;46;2238.00;21
5678;46;625529313;5678;263;6576;6596;8.27;0.50;252.87;4.70;898;46;2239.00;20
5680;46;625529328;5680;272;6578;6597;8.27;0.50;252.83;4.70;898;46;2240.00;19
5682;46;625529341;5682;275;6579;6598;8.28;0.50;252.94;4.70;897;46;2241.00;19
5685;46;625529354;5685;275;6580;6598;8.26;0.50;252.91;4.70;895;46;2242.00;18
5690;46;625529369;5690;285;6583;6602;8.25;0.50;252.97;4.70;893;46;2243.00;19
5695;46;625529384;5695;288;6583;6602;8.22;0.50;253.14;4.70;888;46;2244.00;19
5699;46;625529398;5699;293;6583;6602;8.25;0.50;253.20;4.70;884;46;2245.00;19
5704;46;625529411;5704;291;6583;6602;8.23;0.50;253.27;4.70;879;46;2246.00;19
5710;46;625529424;5710;294;6588;6608;8.23;0.50;253.36;4.71;878;46;2247.00;20
5714;46;625529438;5714;297;6589;6608;8.25;0.50;253.42;4.71;875;46;2248.00;19
5718;46;625529451;5718;292;6589;6608;8.23;0.50;253.49;4.71;871;46;2249.00;19
5720;47;625529467;5720;290;6592;6614;8.20;0.50;253.58;4.70;872;47;2250.00;22
5723;47;625529496;5723;294;6592;6614;8.13;0.50;253.60;4.70;869;47;2251.00;22
5727;47;625529509;5727;294;6593;6614;8.03;0.49;253.64;4.70;866;47;2252.00;21
5731;47;625529529;5731;297;6594;6615;8.00;0.49;253.71;4.70;863;47;2253.00;21
5735;47;625529542;5735;299;6595;6616;7.97;0.49;253.74;4.70;860;47;2254.00;21
5737;47;625529554;5737;307;6596;6616;7.99;0.49;253.76;4.70;859;47;2255.00;20
5741;47;625529566;5741;314;6606;6629;8.07;0.49;253.88;4.70;865;47;2256.00;23
5745;47;625529579;5745;298;6607;6629;8.08;0.49;253.88;4.70;862;47;2257.00;22
5747;47;625529592;5747;301;6607;6629;8.08;0.49;253.94;4.70;860;47;2258.00;22
5750;47;625529610;5750;295;6608;6630;8.11;0.49;253.88;4.69;858;47;2259.00;22
5753;47;625529623;5753;296;6608;6630;8.11;0.49;254.10;4.69;855;47;2260.00;22
5756;47;625529635;5756;292;6611;6634;8.11;0.49;254.13;4.69;855;47;2261.00;23
5761;47;625529649;5761;290;6611;6634;8.04;0.49;254.19;4.69;850;47;2262.00;23
5764;47;625529668;5764;290;6615;6638;7.99;0.49;254.25;4.69;851;47;2263.00;23
5766;47;625529682;5766;290;6616;6638;7.90;0.48;254.29;4.71;850;47;2264.00;22
5770;47;625529695;5770;289;6616;6638;7.80;0.48;254.21;4.71;846;47;2265.00;22
5772;47;625529708;5772;280;6616;6638;7.82;0.48;254.21;4.71;844;47;2266.00;22
5774;47;625529721;5774;269;6616;6638;7.88;0.48;254.28;4.71;842;47;2267.00;22
5775;47;625529742;5775;258;6626;6650;7.96;0.49;254.27;4.70;851;47;2268.00;24
5778;47;625529756;5778;251;6627;6650;8.01;0.49;254.25;4.70;849;47;2269.00;23
5780;47;625529769;5780;248;6627;6650;8.05;0.49;254.25;4.70;847;47;2270.00;23
5789;47;625529782;5789;241;6627;6650;8.07;0.49;254.30;4.70;838;47;2271.00;23
5793;47;625529795;5793;238;6627;6650;8.11;0.49;254.37;4.70;834;47;2272.00;23
5798;47;625529807;5798;240;6627;6650;8.20;0.50;254.29;4.70;829;47;2273.00;23
5801;47;625529821;5801;236;6627;6651;8.27;0.50;254.29;4.70;826;47;2274.00;24
5803;47;625529834;5803;236;6627;6651;8.37;0.51;254.29;4.70;824;47;2275.00;24
5806;47;625529847;5806;229;6631;6657;8.46;0.51;254.31;4.70;825;47;2276.00;26
5808;47;625529860;5808;227;6632;6658;8.52;0.52;254.30;4.70;824;47;2277.00;26
5811;47;625529873;5811;214;6633;6658;8.57;0.52;254.35;4.70;822;47;2278.00;25
5816;48;625529886;5816;212;6633;6658;8.59;0.52;254.31;4.70;817;48;2279.00;25
5817;48;625529914;5817;214;6638;6663;8.68;0.53;254.35;4.71;821;48;2280.00;25
5819;48;625529927;5819;209;6638;6663;8.69;0.53;254.38;4.71;819;48;2281.00;25
5821;48;625529940;5821;200;6638;6663;8.74;0.53;254.40;4.71;817;48;2282.00;25
5823;48;625529952;5823;194;6639;6664;8.84;0.54;254.55;4.71;816;48;2283.00;25
5825;48;625529963;5825;196;6642;6668;8.92;0.54;254.55;4.71;817;48;2284.00;26
5827;48;625529977;5827;190;6642;6668;8.92;0.54;254.53;4.71;815;48;2285.00;26
5830;49;625529988;5830;190;6644;6671;8.96;0.54;254.47;4.71;814;49;2286.00;27
5831;49;625530028;5831;186;6644;6671;8.94;0.54;254.52;4.71;813;49;2287.00;27
5831;49;625530043;5831;183;6645;6671;8.94;0.54;254.52;4.71;814;49;2288.00;26
5835;49;625530055;5835;177;6645;6671;8.92;0.54;254.45;4.71;810;49;2289.00;26
5836;49;625530067;5836;172;6648;6675;8.93;0.54;254.43;4.70;812;49;2290.00;27
5838;49;625530079;5838;173;6648;6675;8.97;0.55;254.43;4.70;810;49;2291.00;27
5841;49;625530090;5841;171;6649;6675;8.97;0.55;254.45;4.70;808;49;2292.00;26
5841;50;625530101;5841;179;6649;6675;8.99;0.55;254.45;4.70;808;50;2293.00;26
5842;50;625530133;5842;179;6649;6676;8.97;0.55;254.44;4.70;807;50;2294.00;27
5844;50;625530145;5844;183;6651;6678;8.94;0.54;254.43;4.70;807;50;2295.00;27
5846;50;625530163;5846;190;6651;6678;8.82;0.54;254.44;4.70;805;50;2296.00;27
5848;50;625530178;5848;195;6652;6679;8.73;0.53;254.42;4.70;804;50;2297.00;27
5849;50;625530189;5849;197;6652;6679;8.64;0.53;254.42;4.70;803;50;2298.00;27
5852;50;625530208;5852;201;6652;6679;8.52;0.52;254.41;4.70;800;50;2299.00;27
5856;50;625530220;5856;200;6652;6679;8.43;0.51;254.44;4.70;796;50;2300.00;27
5856;50;625530234;5856;203;6652;6679;8.41;0.51;254.44;4.70;796;50;2301.00;27
5860;50;625530243;5860;198;6652;6679;8.38;0.51;254.40;4.70;792;50;2302.00;27
5864;50;625530254;5864;196;6652;6679;8.32;0.51;254.41;4.70;788;50;2303.00;27
5866;50;625530264;5866;224;6722;6806;8.26;0.51;254.39;4.65;856;50;2304.00;84
5866;50;625530284;5866;215;6722;6807;8.29;0.51;254.39;4.65;856;50;2305.00;85
5868;50;625530295;5868;201;6728;6807;8.37;0.52;254.44;4.65;860;50;2306.00;79
5869;50;625530304;5869;199;6730;6807;8.46;0.52;254.45;4.65;861;50;2307.00;77
5869;50;625530314;5869;193;6734;6807;8.55;0.53;254.45;4.65;865;50;2308.00;73
5869;50;625530324;5869;191;6737;6807;8.57;0.53;254.45;4.65;868;50;2309.00;70
5871;50;625530341;5871;196;6740;6807;8.61;0.53;254.47;4.65;869;50;2310.00;67
5873;50;625530351;5873;195;6747;6807;8.65;0.53;254.42;4.67;874;50;2311.00;60
5877;50;625530367;5877;186;6749;6808;8.66;0.53;254.42;4.68;872;50;2312.00;59
5878;50;625530377;5878;187;6754;6809;8.72;0.53;254.44;4.68;876;50;2313.00;55
5880;50;625530394;5880;195;6759;6809;8.74;0.54;254.43;4.68;879;50;2314.00;50
5883;50;625530404;5883;200;6764;6810;8.69;0.53;254.39;4.70;881;50;2315.00;46
5889;50;625530416;5889;197;6769;6810;8.61;0.53;254.31;4.71;880;50;2316.00;41
5893;50;625530427;5893;197;6770;6810;8.49;0.52;254.38;4.71;877;50;2317.00;40
5896;50;625530437;5896;200;6773;6810;8.35;0.51;254.34;4.74;877;50;2318.00;37
5901;50;625530447;5901;200;6775;6814;8.17;0.50;254.35;4.74;874;50;2319.00;39
5904;50;625530458;5904;204;6777;6814;8.06;0.49;254.35;4.75;873;50;2320.00;37
5905;50;625530469;5905;207;6777;6814;7.97;0.49;254.32;4.75;872;50;2321.00;37
5906;50;625530480;5906;209;6780;6817;7.94;0.49;254.29;4.75;874;50;2322.00;37
5907;50;625530490;5907;212;6780;6817;7.92;0.49;254.26;4.75;873;50;2323.00;37
5907;50;625530500;5907;221;6781;6817;7.94;0.49;254.26;4.75;874;50;2324.00;36
5911;50;625530510;5911;222;6784;6821;7.92;0.48;254.23;4.75;873;50;2325.00;37
5914;50;625530521;5914;224;6786;6822;7.89;0.48;254.14;4.75;872;50;2326.00;36
5916;50;625530532;5916;230;6788;6822;7.88;0.48;254.15;4.75;872;50;2327.00;34
5918;50;625530543;5918;234;6791;6826;7.84;0.48;254.11;4.77;873;50;2328.00;35
5919;50;625530554;5919;239;6792;6826;7.75;0.47;254.08;4.77;873;50;2329.00;34
5922;50;625530564;5922;243;6792;6826;7.69;0.47;253.99;4.77;870;50;2330.00;34
5922;50;625530574;5922;243;6794;6827;7.60;0.46;253.99;4.80;872;50;2331.00;33
5928;50;625530592;5928;243;6794;6827;7.49;0.46;253.86;4.80;866;50;2332.00;33
5929;50;625530602;5929;249;6798;6833;7.47;0.46;253.82;4.79;869;50;2333.00;35
5931;50;625530613;5931;256;6798;6833;7.39;0.45;253.80;4.79;867;50;2334.00;35
5934;50;625530629;5934;266;6799;6834;7.34;0.45;253.75;4.79;865;50;2335.00;35
5936;50;625530641;5936;272;6800;6834;7.28;0.44;253.70;4.81;864;50;2336.00;34
5937;50;625530652;5937;274;6801;6834;7.25;0.44;253.69;4.83;864;50;2337.00;33
5939;50;625530662;5939;281;6801;6834;7.16;0.44;253.72;4.83;862;50;2338.00;33
5939;50;625530674;5939;285;6802;6834;7.09;0.43;253.72;4.84;863;50;2339.00;32
5941;50;625530686;5941;297;6824;6870;7.12;0.44;253.71;4.84;883;50;2340.00;46
5941;50;625530699;5941;300;6825;6870;7.08;0.43;253.71;4.84;884;50;2341.00;45
5944;50;625530711;5944;304;6830;6870;7.13;0.43;253.66;4.86;886;50;2342.00;40
5945;50;625530721;5945;308;6831;6870;7.14;0.43;253.65;4.86;886;50;2343.00;39
5945;50;625530732;5945;307;6833;6870;7.12;0.43;253.65;4.86;888;50;2344.00;37
5948;50;625530742;5948;310;6835;6870;7.06;0.43;253.65;4.88;887;50;2345.00;35
5948;50;625530753;5948;320;6839;6874;7.08;0.43;253.65;4.88;891;50;2346.00;35
5949;50;625530764;5949;307;6840;6874;7.08;0.43;253.64;4.89;891;50;2347.00;34
5949;50;625530774;5949;297;6844;6878;7.16;0.44;253.64;4.89;895;50;2348.00;34
5949;50;625530785;5949;298;6847;6879;7.23;0.44;253.64;4.89;898;50;2349.00;32
5951;50;625530795;5951;288;6848;6879;7.24;0.44;253.63;4.91;897;50;2350.00;31
5951;50;625530806;5951;282;6851;6879;7.24;0.44;253.63;4.92;900;50;2351.00;28
5953;50;625530817;5953;282;6862;6892;7.19;0.44;253.60;4.91;909;50;2352.00;30
5953;50;625530829;5953;277;6864;6892;7.20;0.44;253.60;4.93;911;50;2353.00;28
5953;50;625530840;5953;280;6866;6892;7.21;0.44;253.60;4.94;913;50;2354.00;26
5954;50;625530850;5954;284;6867;6893;7.29;0.44;253.61;4.94;913;50;2355.00;26
5954;50;625530860;5954;285;6868;6894;7.31;0.45;253.61;4.95;914;50;2356.00;26
5956;50;625530876;5956;289;6869;6894;7.29;0.44;253.57;4.95;913;50;2357.00;25
5959;50;625530887;5959;293;6872;6897;7.26;0.44;253.50;4.96;913;50;2358.00;25
5961;50;625530903;5961;293;6872;6897;7.26;0.44;253.52;4.96;911;50;2359.00;25
5964;50;625530914;5964;293;6875;6897;7.26;0.44;253.50;4.97;911;50;2360.00;22
5965;50;625530935;5965;289;6876;6897;7.31;0.44;253.47;4.98;911;50;2361.00;21
5967;50;625530946;5967;283;6882;6903;7.36;0.45;253.45;4.98;915;50;2362.00;21
5967;50;625530957;5967;283;6882;6903;7.36;0.45;253.45;4.98;915;50;2363.00;21
5969;50;625530968;5969;284;6883;6903;7.34;0.45;253.43;4.98;914;50;2364.00;20
5971;50;625530978;5971;286;6884;6903;7.33;0.45;253.40;4.99;913;50;2365.00;19
5972;50;625530989;5972;290;6887;6907;7.31;0.44;253.39;4.99;915;50;2366.00;20
5972;50;625530999;5972;286;6888;6908;7.32;0.45;253.39;4.99;916;50;2367.00;20
5973;50;625531010;5973;293;6891;6908;7.29;0.44;253.36;5.01;918;50;2368.00;17
5976;50;625531020;5976;293;6892;6909;7.30;0.44;253.32;5.01;916;50;2369.00;17
5978;50;625531032;5978;296;6893;6909;7.29;0.44;253.30;5.02;915;50;2370.00;16
5981;50;625531042;5981;297;6893;6909;7.23;0.44;253.34;5.02;912;50;2371.00;16
5985;50;625531053;5985;296;6893;6909;7.19;0.44;253.42;5.02;908;50;2372.00;16
5987;50;625531063;5987;298;6896;6909;7.16;0.44;253.45;5.03;909;50;2373.00;13
5989;50;625531073;5989;295;6896;6909;7.20;0.44;253.46;5.03;907;50;2374.00;13
5994;50;625531083;5994;300;6896;6909;7.17;0.44;253.43;5.03;902;50;2375.00;13
6001;50;625531093;6001;307;6938;6979;7.28;0.44;253.45;5.00;937;50;2376.00;41
6004;50;625531109;6004;306;6941;6980;7.24;0.44;253.46;5.00;937;50;2377.00;39
6006;50;625531119;6006;307;6949;6980;7.22;0.44;253.48;5.00;943;50;2378.00;31
6009;50;625531129;6009;312;6952;6980;7.20;0.44;253.47;5.00;943;50;2379.00;28
6015;50;625531139;6015;296;6959;6980;7.11;0.44;253.52;5.00;944;50;2380.00;21
6017;50;625531149;6017;295;6963;6980;7.06;0.43;253.56;5.00;946;50;2381.00;17
6021;50;625531159;6021;286;6965;6980;7.07;0.43;253.57;5.00;944;50;2382.00;15
6024;50;625531172;6024;283;6968;6980;7.03;0.43;253.67;5.00;944;50;2383.00;12
6028;50;625531188;6028;284;6970;6981;7.05;0.43;253.77;5.00;942;50;2384.00;11
6031;50;625531209;6031;296;6972;6983;7.09;0.44;253.89;5.00;941;50;2385.00;11
6036;50;625531230;6036;299;6972;6983;7.09;0.44;253.92;5.00;936;50;2386.00;11
6041;50;625531247;6041;301;6976;6987;7.09;0.44;254.02;5.00;935;50;2387.00;11
6045;50;625531268;6045;296;6976;6987;7.18;0.44;254.01;5.00;931;50;2388.00;11
6049;50;625531284;6049;292;6976;6987;7.20;0.44;254.12;5.00;927;50;2389.00;11
6053;50;625531298;6053;288;6976;6987;7.28;0.45;254.20;5.00;923;50;2390.00;11
6056;50;625531311;6056;283;6982;6993;7.39;0.45;254.28;5.03;926;50;2391.00;11
6060;50;625531324;6060;285;6983;6993;7.51;0.46;254.36;5.03;923;50;2392.00;10
6064;50;625531337;6064;283;6983;6993;7.59;0.47;254.41;5.03;919;50;2393.00;10
6070;50;625531351;6070;286;6985;6996;7.68;0.47;254.45;5.02;915;50;2394.00;11
6075;50;625531365;6075;278;6985;6996;7.71;0.47;254.57;5.02;910;50;2395.00;11
6082;50;625531378;6082;280;6986;6996;7.75;0.47;254.56;5.02;904;50;2396.00;10
6088;50;625531391;6088;279;6987;6997;7.78;0.48;254.71;5.02;899;50;2397.00;10
6095;50;625531404;6095;270;6988;6998;7.78;0.48;254.84;5.02;893;50;2398.00;10
6099;50;625531416;6099;268;6988;6998;7.80;0.48;254.88;5.02;889;50;2399.00;10
6103;50;625531431;6103;266;7013;7057;7.78;0.48;254.89;5.00;910;50;2400.00;44
6113;50;625531455;6113;272;7015;7057;7.76;0.47;255.00;5.00;902;50;2401.00;42
6116;50;625531470;6116;265;7017;7057;7.84;0.48;254.94;5.00;901;50;2402.00;40
6120;50;625531484;6120;267;7019;7058;7.91;0.48;254.96;5.00;899;50;2403.00;39
6122;50;625531496;6122;265;7020;7058;7.95;0.49;255.03;5.00;898;50;2404.00;38
6125;50;625531510;6125;269;7023;7062;7.99;0.49;255.03;5.00;898;50;2405.00;39
6130;50;625531524;6130;277;7026;7062;7.96;0.49;255.06;5.00;896;50;2406.00;36
6135;50;625531538;6135;276;7029;7066;7.97;0.49;255.16;5.00;894;50;2407.00;37
6139;50;625531557;6139;280;7030;7066;7.89;0.48;255.21;5.00;891;50;2408.00;36
6142;50;625531570;6142;284;7030;7066;7.85;0.48;255.27;5.00;888;50;2409.00;36
6144;50;625531584;6144;276;7031;7066;7.85;0.48;255.26;5.00;887;50;2410.00;35
6150;50;625531598;6150;283;7031;7066;7.82;0.48;255.47;5.00;881;50;2411.00;35
6153;50;625531612;6153;291;7040;7078;7.84;0.48;255.50;5.00;887;50;2412.00;38
6159;50;625531626;6159;288;7040;7078;7.80;0.47;255.59;5.00;881;50;2413.00;38
6163;50;625531640;6163;288;7042;7078;7.77;0.47;255.61;5.00;879;50;2414.00;36
6166;50;625531653;6166;294;7042;7078;7.74;0.47;255.56;5.00;876;50;2415.00;36
6169;50;625531666;6169;290;7043;7078;7.73;0.47;255.66;5.00;874;50;2416.00;35
6169;50;625531679;6169;289;7043;7078;7.75;0.47;255.66;5.00;874;50;2417.00;35
6172;50;625531691;6172;292;7044;7079;7.76;0.47;255.70;5.00;872;50;2418.00;35
6174;50;625531704;6174;293;7044;7079;7.72;0.47;255.77;5.00;870;50;2419.00;35
6177;50;625531717;6177;293;7049;7085;7.66;0.47;255.81;5.00;872;50;2420.00;36
6183;50;625531730;6183;292;7050;7086;7.60;0.46;255.99;5.00;867;50;2421.00;36
6184;50;625531743;6184;292;7051;7086;7.52;0.46;256.04;5.00;867;50;2422.00;35
6189;51;625531755;6189;292;7051;7086;7.46;0.45;256.14;5.00;862;51;2423.00;35
6192;51;625531779;6192;300;7053;7090;7.44;0.45;256.25;5.01;861;51;2424.00;37
6193;51;625531792;6193;301;7054;7090;7.44;0.45;256.31;5.01;861;51;2425.00;36
6197;51;625531804;6197;301;7054;7090;7.44;0.45;256.42;5.01;857;51;2426.00;36
6200;51;625531816;6200;294;7057;7091;7.46;0.45;256.54;5.01;857;51;2427.00;34
6206;51;625531828;6206;292;7062;7095;7.49;0.46;256.65;5.01;856;51;2428.00;33
6208;51;625531841;6208;290;7062;7095;7.53;0.46;256.68;5.01;854;51;2429.00;33
6211;51;625531855;6211;292;7066;7101;7.60;0.46;256.83;5.01;855;51;2430.00;35
6213;51;625531868;6213;288;7067;7101;7.69;0.47;256.87;5.05;854;51;2431.00;34
6217;51;625531881;6217;288;7068;7101;7.76;0.47;256.88;5.05;851;51;2432.00;33
6221;51;625531894;6221;289;7069;7101;7.77;0.47;256.94;5.05;848;51;2433.00;32
6224;51;625531912;6224;286;7073;7105;7.81;0.47;257.13;5.05;849;51;2434.00;32
6227;51;625531926;6227;287;7073;7105;7.83;0.48;257.17;5.05;846;51;2435.00;32
6232;51;625531939;6232;268;7074;7105;7.81;0.47;257.34;5.05;842;51;2436.00;31
6235;51;625531953;6235;256;7074;7105;7.86;0.48;257.49;5.05;839;51;2437.00;31
6237;51;625531969;6237;246;7075;7106;7.97;0.48;257.51;5.05;838;51;2438.00;31
6239;51;625531982;6239;240;7077;7107;8.09;0.49;257.55;5.05;838;51;2439.00;30
6241;51;625531995;6241;235;7078;7107;8.11;0.49;257.61;5.06;837;51;2440.00;29
6245;51;625532008;6245;222;7079;7108;8.18;0.50;257.64;5.06;834;51;2441.00;29
6247;51;625532024;6247;217;7079;7108;8.31;0.50;257.64;5.06;832;51;2442.00;29
6251;51;625532037;6251;218;7079;7108;8.35;0.51;257.64;5.06;828;51;2443.00;29
6256;51;625532050;6256;216;7079;7108;8.37;0.51;257.66;5.06;823;51;2444.00;29
6258;51;625532062;6258;218;7079;7108;8.43;0.51;257.68;5.06;821;51;2445.00;29
6260;51;625532075;6260;220;7080;7108;8.43;0.51;257.79;5.06;820;51;2446.00;28
6263;51;625532088;6263;209;7080;7108;8.48;0.51;257.86;5.06;817;51;2447.00;28
6264;51;625532101;6264;217;7140;7235;8.69;0.54;257.86;5.02;876;51;2448.00;95
6265;51;625532123;6265;211;7144;7236;8.72;0.54;257.90;5.02;879;51;2449.00;92
6266;51;625532136;6266;201;7151;7236;8.84;0.54;257.89;5.02;885;51;2450.00;85
6271;51;625532149;6271;201;7155;7236;8.93;0.55;257.90;5.01;884;51;2451.00;81
6273;51;625532169;6273;201;7162;7236;8.95;0.55;257.90;5.02;889;51;2452.00;74
6275;51;625532183;6275;197;7165;7236;8.97;0.55;257.89;5.02;890;51;2453.00;71
6276;51;625532196;6276;198;7169;7236;9.00;0.55;257.97;5.06;893;51;2454.00;67
6279;51;625532209;6279;202;7174;7236;9.03;0.55;258.01;5.07;895;51;2455.00;62
6280;51;625532223;6280;203;7177;7237;9.03;0.55;258.02;5.07;897;51;2456.00;60
6285;51;625532235;6285;207;7180;7238;8.98;0.55;258.10;5.07;895;51;2457.00;58
6286;51;625532247;6286;214;7184;7238;8.92;0.55;258.11;5.08;898;51;2458.00;54
6289;51;625532259;6289;219;7186;7239;8.86;0.54;258.08;5.08;897;51;2459.00;53
6292;51;625532272;6292;226;7190;7239;8.79;0.54;258.08;5.08;898;51;2460.00;49
6293;51;625532284;6293;228;7191;7239;8.70;0.53;258.06;5.08;898;51;2461.00;48
6296;51;625532296;6296;235;7195;7239;8.60;0.53;258.04;5.09;899;51;2462.00;44
6297;51;625532308;6297;247;7198;7243;8.48;0.52;258.02;5.10;901;51;2463.00;45
6299;51;625532320;6299;245;7200;7243;8.37;0.51;258.02;5.10;901;51;2464.00;43
6299;51;625532331;6299;255;7201;7243;8.28;0.51;258.02;5.10;902;51;2465.00;42
6301;51;625532342;6301;269;7203;7246;8.19;0.50;257.98;5.10;902;51;2466.00;43
6305;51;625532353;6305;271;7204;7246;8.09;0.50;257.93;5.10;899;51;2467.00;42
6308;51;625532364;6308;279;7205;7246;7.98;0.49;257.97;5.10;897;51;2468.00;41
6312;51;625532375;6312;278;7212;7250;7.84;0.48;257.93;5.16;900;51;2469.00;38
6314;51;625532386;6314;273;7213;7251;7.75;0.48;257.88;5.16;899;51;2470.00;38
6319;51;625532397;6319;267;7215;7251;7.59;0.47;257.76;5.16;896;51;2471.00;36
6319;51;625532409;6319;264;7218;7255;7.57;0.46;257.76;5.16;899;51;2472.00;37
6323;51;625532419;6323;262;7218;7255;7.52;0.46;257.73;5.16;895;51;2473.00;37
6325;51;625532430;6325;263;7218;7255;7.50;0.46;257.71;5.16;893;51;2474.00;37
6327;51;625532441;6327;257;7220;7257;7.48;0.46;257.71;5.16;893;51;2475.00;37
6327;51;625532452;6327;255;7221;7257;7.42;0.45;257.71;5.20;894;51;2476.00;36
6331;51;625532467;6331;259;7225;7263;7.34;0.45;257.75;5.20;894;51;2477.00;38
6335;51;625532479;6335;263;7225;7263;7.28;0.44;257.87;5.20;890;51;2478.00;38
6335;51;625532489;6335;261;7226;7264;7.32;0.45;257.87;5.20;891;51;2479.00;38
6339;51;625532499;6339;257;7226;7264;7.25;0.44;257.86;5.20;887;51;2480.00;38
6343;51;625532509;6343;250;7227;7264;7.09;0.43;257.80;5.23;884;51;2481.00;37
6345;51;625532519;6345;243;7228;7264;7.00;0.43;257.79;5.26;883;51;2482.00;36
6346;51;625532529;6346;238;7228;7264;6.90;0.42;257.76;5.26;882;51;2483.00;36
6348;51;625532539;6348;231;7239;7276;6.83;0.42;257.72;5.27;891;51;2484.00;37
6353;51;625532550;6353;237;7241;7276;6.75;0.41;257.66;5.28;888;51;2485.00;35
6353;51;625532566;6353;231;7242;7276;6.76;0.41;257.66;5.30;889;51;2486.00;34
6355;51;625532576;6355;233;7242;7276;6.78;0.41;257.64;5.30;887;51;2487.00;34
6360;51;625532585;6360;229;7243;7276;6.77;0.41;257.57;5.32;883;51;2488.00;33
6360;51;625532595;6360;232;7243;7276;6.82;0.42;257.57;5.32;883;51;2489.00;33
6361;51;625532607;6361;232;7246;7280;6.86;0.42;257.54;5.32;885;51;2490.00;34
6363;51;625532617;6363;230;7247;7280;6.84;0.42;257.55;5.33;884;51;2491.00;33
6365;51;625532627;6365;229;7250;7284;6.87;0.42;257.50;5.33;885;51;2492.00;34
6367;51;625532637;6367;229;7252;7285;6.86;0.42;257.50;5.34;885;51;2493.00;33
6368;51;625532647;6368;226;7253;7285;6.86;0.42;257.47;5.34;885;51;2494.00;32
6371;51;625532657;6371;229;7254;7285;6.88;0.42;257.43;5.36;883;51;2495.00;31
6373;51;625532667;6373;234;7263;7298;6.91;0.42;257.42;5.35;890;51;2496.00;35
6375;51;625532678;6375;236;7264;7298;6.90;0.42;257.44;5.36;889;51;2497.00;34
6377;51;625532687;6377;241;7265;7298;6.91;0.42;257.39;5.37;888;51;2498.00;33
6377;51;625532697;6377;237;7266;7299;7.05;0.43;257.39;5.37;889;51;2499.00;33
6380;51;625532708;6380;227;7266;7300;7.07;0.43;257.35;5.37;886;51;2500.00;34
6382;51;625532721;6382;224;7266;7300;7.08;0.43;257.31;5.37;884;51;2501.00;34
6384;51;625532732;6384;219;7269;7303;7.14;0.43;257.42;5.37;885;51;2502.00;34
6385;51;625532743;6385;221;7271;7303;7.19;0.44;257.38;5.39;886;51;2503.00;32
6385;51;625532753;6385;216;7271;7303;7.25;0.44;257.38;5.39;886;51;2504.00;32
6386;51;625532764;6386;211;7271;7303;7.29;0.44;257.35;5.39;885;51;2505.00;32
6386;51;625532774;6386;210;7275;7309;7.46;0.45;257.35;5.38;889;51;2506.00;34
6388;51;625532786;6388;206;7275;7309;7.52;0.46;257.37;5.38;887;51;2507.00;34
6388;51;625532797;6388;203;7276;7309;7.55;0.46;257.37;5.38;888;51;2508.00;33
6390;51;625532813;6390;206;7278;7309;7.55;0.46;257.39;5.41;888;51;2509.00;31
6392;51;625532824;6392;205;7282;7313;7.56;0.46;257.35;5.42;890;51;2510.00;31
6396;51;625532836;6396;213;7285;7314;7.60;0.46;257.35;5.43;889;51;2511.00;29
6397;51;625532848;6397;214;7286;7314;7.63;0.46;257.34;5.45;889;51;2512.00;28
6398;51;625532859;6398;216;7289;7315;7.66;0.46;257.34;5.47;891;51;2513.00;26
6399;51;625532870;6399;218;7290;7315;7.70;0.47;257.34;5.47;891;51;2514.00;25
6399;52;625532882;6399;221;7293;7315;7.72;0.47;257.34;5.50;894;52;2515.00;22
6399;52;625532903;6399;217;7294;7315;7.75;0.47;257.34;5.50;895;52;2516.00;21
6400;52;625532914;6400;218;7296;7315;7.72;0.47;257.32;5.52;896;52;2517.00;19
6401;52;625532925;6401;218;7297;7315;7.77;0.47;257.29;5.53;896;52;2518.00;18
6402;52;625532936;6402;211;7297;7315;7.81;0.48;257.29;5.53;895;52;2519.00;18
6404;52;625532948;6404;217;7350;7440;8.02;0.49;257.24;5.51;946;52;2520.00;90
6408;52;625532969;6408;218;7354;7441;8.00;0.49;257.24;5.50;946;52;2521.00;87
6408;53;625532981;6408;218;7370;7441;8.02;0.49;257.24;5.51;962;53;2522.00;71
6411;53;625533001;6411;218;7375;7441;8.01;0.49;257.24;5.51;964;53;2523.00;66
6411;53;625533012;6411;211;7381;7441;7.98;0.49;257.24;5.52;970;53;2524.00;60
6415;53;625533023;6415;215;7386;7441;7.94;0.49;257.21;5.52;971;53;2525.00;55
6418;53;625533035;6418;217;7393;7441;7.87;0.48;257.29;5.53;975;53;2526.00;48
6419;53;625533045;6419;219;7395;7441;7.87;0.48;257.30;5.53;976;53;2527.00;46
6423;53;625533056;6423;233;7401;7442;7.86;0.48;257.35;5.54;978;53;2528.00;41
6426;53;625533067;6426;228;7405;7443;7.76;0.48;257.32;5.54;979;53;2529.00;38
6429;53;625533079;6429;228;7409;7443;7.68;0.47;257.30;5.55;980;53;2530.00;34
6431;53;625533090;6431;227;7413;7447;7.56;0.46;257.35;5.55;982;53;2531.00;34
6432;53;625533102;6432;234;7417;7447;7.48;0.46;257.32;5.56;985;53;2532.00;30
6435;53;625533113;6435;234;7418;7447;7.42;0.45;257.31;5.56;983;53;2533.00;29
6435;53;625533125;6435;236;7421;7447;7.39;0.45;257.31;5.57;986;53;2534.00;26
6439;54;625533137;6439;237;7425;7453;7.39;0.45;257.37;5.57;986;54;2535.00;28
6441;54;625533165;6441;237;7428;7453;7.38;0.45;257.40;5.57;987;54;2536.00;25
6444;54;625533181;6444;242;7431;7455;7.34;0.45;257.43;5.58;987;54;2537.00;24
6447;54;625533201;6447;246;7433;7458;7.34;0.45;257.49;5.58;986;54;2538.00;25
6449;54;625533220;6449;253;7434;7458;7.35;0.45;257.45;5.59;985;54;2539.00;24
6450;54;625533251;6450;262;7434;7458;7.34;0.45;257.46;5.59;984;54;2540.00;24
6452;54;625533269;6452;269;7435;7459;7.30;0.45;257.52;5.59;983;54;2541.00;24
6455;54;625533288;6455;270;7436;7460;7.25;0.44;257.57;5.59;981;54;2542.00;24
6458;54;625533302;6458;277;7438;7460;7.14;0.44;257.62;5.60;980;54;2543.00;22
6460;54;625533314;6460;275;7449;7473;7.08;0.43;257.65;5.59;989;54;2544.00;24
6465;54;625533329;6465;281;7450;7473;7.04;0.43;257.70;5.59;985;54;2545.00;23
6470;54;625533342;6470;280;7452;7473;6.99;0.43;257.71;5.60;982;54;2546.00;21
6473;54;625533355;6473;285;7454;7474;6.94;0.43;257.68;5.60;981;54;2547.00;20
6478;54;625533368;6478;290;7454;7474;6.84;0.42;257.65;5.60;976;54;2548.00;20
6481;54;625533380;6481;289;7457;7478;6.74;0.41;257.66;5.60;976;54;2549.00;21
6483;54;625533396;6483;278;7460;7481;6.68;0.41;257.65;5.61;977;54;2550.00;21
6486;54;625533417;6486;283;7465;7485;6.57;0.40;257.67;5.60;979;54;2551.00;20
6491;54;625533430;6491;272;7466;7485;6.57;0.40;257.78;5.61;975;54;2552.00;19
6495;54;625533443;6495;273;7467;7485;6.49;0.40;257.78;5.61;972;54;2553.00;18
6501;54;625533455;6501;266;7468;7485;6.46;0.40;257.84;5.61;967;54;2554.00;17
6506;54;625533468;6506;275;7470;7485;6.46;0.40;257.99;5.61;964;54;2555.00;15
6508;54;625533480;6508;268;7481;7497;6.60;0.41;258.03;5.61;973;54;2556.00;16
6510;54;625533494;6510;263;7482;7497;6.65;0.41;258.08;5.61;972;54;2557.00;15
6515;54;625533506;6515;261;7482;7497;6.68;0.41;258.20;5.61;967;54;2558.00;15
6517;54;625533520;6517;257;7482;7497;6.77;0.42;258.26;5.61;965;54;2559.00;15
6519;54;625533532;6519;254;7482;7497;6.84;0.42;258.34;5.61;963;54;2560.00;15
6523;54;625533544;6523;253;7482;7497;6.93;0.43;258.46;5.61;959;54;2561.00;15
6526;54;625533557;6526;247;7482;7498;6.99;0.43;258.49;5.61;956;54;2562.00;16
6531;54;625533576;6531;244;7482;7498;7.04;0.43;258.55;5.61;951;54;2563.00;16
6536;54;625533590;6536;239;7486;7504;7.15;0.44;258.59;5.60;950;54;2564.00;18
6539;54;625533604;6539;235;7489;7506;7.26;0.45;258.62;5.60;950;54;2565.00;17
6544;54;625533618;6544;229;7489;7506;7.34;0.45;258.67;5.60;945;54;2566.00;17
6548;54;625533630;6548;229;7489;7506;7.41;0.46;258.75;5.60;941;54;2567.00;17
6555;54;625533644;6555;227;7492;7510;7.48;0.46;258.82;5.60;937;54;2568.00;18
6557;54;625533657;6557;214;7492;7510;7.57;0.47;258.82;5.60;935;54;2569.00;18
6563;54;625533670;6563;215;7492;7510;7.62;0.47;258.91;5.60;929;54;2570.00;18
6571;54;625533683;6571;210;7493;7511;7.70;0.47;258.97;5.60;922;54;2571.00;18
6573;54;625533696;6573;221;7496;7515;7.80;0.48;259.00;5.60;923;54;2572.00;19
6578;54;625533711;6578;217;7496;7515;7.85;0.48;259.03;5.60;918;54;2573.00;19
6580;54;625533724;6580;219;7498;7518;7.96;0.49;259.10;5.60;918;54;2574.00;20
6585;54;625533738;6585;219;7499;7518;7.98;0.49;259.09;5.60;914;54;2575.00;19
6588;54;625533750;6588;220;7499;7518;8.00;0.49;259.07;5.60;911;54;2576.00;19
6592;54;625533763;6592;221;7499;7518;7.99;0.49;259.05;5.60;907;54;2577.00;19
6596;54;625533776;6596;227;7502;7522;7.98;0.49;259.23;5.59;906;54;2578.00;20
6602;54;625533789;6602;223;7502;7522;7.95;0.49;259.39;5.59;900;54;2579.00;20
6611;54;625533804;6611;222;7503;7522;7.92;0.48;259.43;5.59;892;54;2580.00;19
6613;54;625533818;6613;224;7503;7522;7.93;0.49;259.51;5.59;890;54;2581.00;19
6617;54;625533833;6617;225;7503;7523;7.89;0.48;259.57;5.59;886;54;2582.00;20
6626;54;625533846;6626;224;7504;7524;7.89;0.48;259.63;5.59;878;54;2583.00;20
6630;54;625533860;6630;223;7504;7524;7.84;0.48;259.61;5.59;874;54;2584.00;20
6635;54;625533872;6635;228;7505;7525;7.87;0.48;259.69;5.59;870;54;2585.00;20
6637;54;625533885;6637;225;7505;7525;7.88;0.48;259.76;5.59;868;54;2586.00;20
6639;54;625533898;6639;227;7505;7525;7.88;0.48;259.76;5.59;866;54;2587.00;20
6645;54;625533910;6645;230;7505;7525;7.78;0.48;259.81;5.59;860;54;2588.00;20
6650;54;625533923;6650;233;7506;7525;7.72;0.47;259.86;5.60;856;54;2589.00;19
6652;54;625533937;6652;242;7506;7525;7.67;0.47;259.89;5.60;854;54;2590.00;19
6656;54;625533948;6656;246;7506;7525;7.57;0.46;259.98;5.60;850;54;2591.00;19
6661;54;625533960;6661;269;7572;7652;7.76;0.48;260.08;5.55;911;54;2592.00;80
6666;54;625533983;6666;271;7576;7653;7.64;0.47;260.00;5.55;910;54;2593.00;77
6669;54;625533996;6669;275;7584;7653;7.65;0.47;260.05;5.55;915;54;2594.00;69
6674;54;625534008;6674;283;7587;7653;7.59;0.47;260.08;5.55;913;54;2595.00;66
6674;54;625534021;6674;293;7590;7653;7.57;0.47;260.08;5.54;916;54;2596.00;63
6679;54;625534033;6679;278;7594;7653;7.60;0.47;260.14;5.54;915;54;2597.00;59
6681;54;625534046;6681;276;7597;7653;7.68;0.47;260.19;5.54;916;54;2598.00;56
6681;54;625534060;6681;275;7600;7653;7.69;0.47;260.19;5.55;919;54;2599.00;53
6684;54;625534074;6684;269;7606;7654;7.68;0.47;260.25;5.55;922;54;2600.00;48
6685;54;625534093;6685;270;7609;7655;7.69;0.47;260.28;5.55;924;54;2601.00;46
6690;54;625534106;6690;270;7614;7655;7.69;0.47;260.37;5.55;924;54;2602.00;41
6694;54;625534119;6694;270;7617;7656;7.64;0.47;260.49;5.55;923;54;2603.00;39
6696;54;625534141;6696;274;7619;7656;7.58;0.47;260.53;5.55;923;54;2604.00;37
6697;54;625534154;6697;275;7620;7656;7.60;0.47;260.54;5.56;923;55;2605.00;36
6702;54;625534183;6702;267;7622;7656;7.64;0.47;260.54;5.56;920;55;2606.00;34
6704;54;625534197;6704;255;7624;7660;7.73;0.48;260.57;5.56;920;55;2607.00;36
6706;54;625534213;6706;256;7626;7660;7.84;0.48;260.56;5.56;920;55;2608.00;34
6708;54;625534226;6708;260;7627;7660;7.92;0.49;260.54;5.56;919;55;2609.00;33
6711;54;625534241;6711;249;7631;7666;8.01;0.49;260.64;5.56;920;55;2610.00;35
6713;54;625534255;6713;235;7632;7666;8.04;0.49;260.64;5.56;919;55;2611.00;34
6717;54;625534268;6717;232;7633;7666;8.08;0.49;260.65;5.56;916;55;2612.00;33
6719;54;625534281;6719;225;7637;7670;8.14;0.50;260.68;5.57;918;55;2613.00;33
6721;54;625534295;6721;219;7639;7671;8.19;0.50;260.72;5.57;918;55;2614.00;32
6723;54;625534313;6723;215;7639;7671;8.23;0.50;260.72;5.57;916;55;2615.00;32
6725;54;625534326;6725;220;7643;7675;8.31;0.51;260.70;5.57;918;55;2616.00;32
6726;54;625534339;6726;217;7643;7675;8.34;0.51;260.69;5.57;917;55;2617.00;32
6730;54;625534352;6730;224;7644;7675;8.38;0.51;260.74;5.57;914;55;2618.00;31
6732;54;625534364;6732;225;7645;7676;8.43;0.51;260.74;5.57;913;55;2619.00;31
6734;54;625534377;6734;225;7645;7676;8.39;0.51;260.85;5.57;911;55;2620.00;31
6736;54;625534389;6736;224;7649;7682;8.44;0.51;260.87;5.56;913;55;2621.00;33
6737;54;625534402;6737;227;7650;7682;8.47;0.51;260.85;5.56;913;55;2622.00;32
6737;54;625534415;6737;229;7650;7683;8.51;0.52;260.85;5.56;913;55;2623.00;33
6739;54;625534426;6739;228;7650;7683;8.49;0.52;260.90;5.56;911;55;2624.00;33
6742;54;625534438;6742;230;7650;7683;8.43;0.51;260.98;5.56;908;55;2625.00;33
6744;54;625534450;6744;232;7650;7683;8.38;0.51;260.93;5.56;906;55;2626.00;33
6746;54;625534461;6746;241;7650;7683;8.30;0.51;260.90;5.56;904;55;2627.00;33
6749;54;625534473;6749;249;7660;7695;8.27;0.51;260.82;5.56;911;55;2628.00;35
6753;54;625534485;6753;250;7661;7695;8.22;0.50;260.82;5.55;908;55;2629.00;34
6754;54;625534497;6754;254;7661;7695;8.20;0.50;260.83;5.55;907;55;2630.00;34
6755;54;625534509;6755;261;7661;7695;8.15;0.50;260.83;5.55;906;55;2631.00;34
6757;54;625534520;6757;268;7661;7695;8.11;0.49;260.81;5.55;904;55;2632.00;34
6760;54;625534531;6760;273;7661;7695;8.04;0.49;260.79;5.55;901;55;2633.00;34
6762;54;625534542;6762;280;7664;7699;8.01;0.49;260.76;5.55;902;55;2634.00;35
6765;54;625534553;6765;283;7664;7699;7.94;0.48;260.78;5.55;899;55;2635.00;35
6767;54;625534564;6767;291;7667;7703;7.88;0.48;260.75;5.55;900;55;2636.00;36
6770;54;625534575;6770;298;7668;7704;7.82;0.48;260.72;5.55;898;55;2637.00;36
6771;54;625534586;6771;301;7669;7704;7.74;0.47;260.72;5.55;898;55;2638.00;35
6775;54;625534597;6775;308;7669;7704;7.61;0.46;260.67;5.55;894;55;2639.00;35
6775;54;625534609;6775;308;7689;7733;7.52;0.46;260.67;5.54;914;55;2640.00;44
6776;54;625534622;6776;302;7691;7733;7.43;0.45;260.79;5.53;915;55;2641.00;42
6779;54;625534633;6779;307;7693;7733;7.39;0.45;260.76;5.53;914;55;2642.00;40
6779;54;625534644;6779;307;7695;7734;7.38;0.45;260.76;5.53;916;55;2643.00;39
6780;54;625534655;6780;300;7695;7735;7.35;0.45;260.75;5.53;915;55;2644.00;40
6784;54;625534665;6784;306;7695;7735;7.24;0.44;260.79;5.53;911;55;2645.00;40
6784;54;625534675;6784;307;7698;7738;7.24;0.44;260.79;5.53;914;55;2646.00;40
6787;54;625534686;6787;308;7698;7738;7.13;0.43;260.77;5.53;911;55;2647.00;40
6789;54;625534697;6789;313;7698;7738;7.04;0.43;260.80;5.53;909;55;2648.00;40
6791;54;625534707;6791;312;7698;7738;7.00;0.43;260.81;5.53;907;55;2649.00;40
6793;54;625534719;6793;313;7702;7744;6.93;0.42;260.83;5.53;909;55;2650.00;42
6796;54;625534731;6796;298;7702;7744;6.90;0.42;260.84;5.53;906;55;2651.00;42
6800;54;625534742;6800;280;7703;7744;6.85;0.42;260.84;5.53;903;55;2652.00;41
6801;54;625534754;6801;267;7703;7744;6.84;0.41;260.83;5.53;902;55;2653.00;41
6804;54;625534765;6804;264;7706;7748;6.82;0.41;260.85;5.53;902;55;2654.00;42
6806;54;625534778;6806;251;7709;7750;6.88;0.42;260.89;5.54;903;55;2655.00;41
6810;54;625534790;6810;245;7710;7750;6.89;0.42;260.86;5.55;900;55;2656.00;40
6810;55;625534802;6810;233;7711;7751;6.94;0.42;260.86;5.55;901;56;2657.00;40
6811;55;625534831;6811;226;7711;7751;7.01;0.43;260.87;5.55;900;56;2658.00;40
6813;55;625534842;6813;222;7711;7751;7.06;0.43;260.86;5.55;898;56;2659.00;40
6815;55;625534853;6815;218;7711;7751;7.13;0.43;260.82;5.55;896;56;2660.00;40
6816;55;625534864;6816;216;7711;7751;7.21;0.44;260.82;5.55;895;56;2661.00;40
6818;55;625534875;6818;218;7711;7751;7.30;0.44;260.78;5.55;893;56;2662.00;40
6818;56;625534886;6818;208;7711;7751;7.46;0.45;260.78;5.55;893;57;2663.00;40
6819;56;625534906;6819;212;7748;7821;7.68;0.47;260.75;5.52;929;57;2664.00;73
6822;56;625534924;6822;201;7749;7822;7.72;0.47;260.74;5.52;927;57;2665.00;73
6825;56;625534940;6825;197;7753;7822;7.71;0.47;260.66;5.52;928;57;2666.00;69
6827;56;625534951;6827;196;7758;7822;7.72;0.47;260.65;5.52;931;57;2667.00;64
6828;56;625534962;6828;191;7762;7822;7.76;0.47;260.65;5.52;934;57;2668.00;60
6830;56;625534973;6830;193;7765;7822;7.82;0.47;260.60;5.52;935;57;2669.00;57
6831;56;625534986;6831;189;7770;7822;7.86;0.48;260.61;5.52;939;57;2670.00;52
6832;56;625534996;6832;190;7772;7822;7.96;0.48;260.59;5.52;940;57;2671.00;50
6834;56;625535008;6834;191;7775;7823;8.00;0.49;260.55;5.52;941;57;2672.00;48
6836;56;625535019;6836;193;7777;7824;8.07;0.49;260.55;5.52;941;57;2673.00;47
6837;56;625535031;6837;192;7779;7824;8.09;0.49;260.64;5.52;942;57;2674.00;45
6841;56;625535048;6841;191;7782;7828;8.04;0.49;260.62;5.52;941;57;2675.00;46
6845;56;625535060;6845;195;7783;7828;7.98;0.49;260.67;5.53;938;57;2676.00;45
6847;56;625535072;6847;194;7783;7828;7.96;0.48;260.65;5.53;936;57;2677.00;45
6849;56;625535084;6849;199;7783;7828;7.96;0.48;260.63;5.53;934;57;2678.00;45
6853;56;625535095;6853;204;7787;7834;8.02;0.49;260.64;5.53;934;57;2679.00;47
6855;56;625535108;6855;208;7789;7834;8.02;0.49;260.62;5.54;934;57;2680.00;45
6857;56;625535119;6857;213;7790;7834;8.05;0.49;260.63;5.55;933;57;2681.00;44
6859;56;625535130;6859;224;7793;7837;8.07;0.49;260.67;5.56;934;57;2682.00;44
6863;56;625535144;6863;229;7794;7837;8.08;0.49;260.74;5.58;931;57;2683.00;43
6866;56;625535156;6866;236;7795;7837;8.07;0.49;260.79;5.58;929;57;2684.00;42
6869;56;625535170;6869;232;7796;7838;8.08;0.49;260.82;5.59;927;57;2685.00;42
6873;56;625535191;6873;234;7798;7839;8.08;0.49;260.74;5.60;925;57;2686.00;41
6876;56;625535212;6876;237;7798;7839;8.07;0.49;260.77;5.60;922;57;2687.00;41
6879;56;625535234;6879;239;7809;7852;8.07;0.49;260.92;5.60;930;57;2688.00;43
6882;56;625535253;6882;242;7810;7852;8.03;0.49;260.97;5.62;928;57;2689.00;42
6883;56;625535271;6883;246;7811;7852;7.98;0.49;260.98;5.61;928;57;2690.00;41
6888;56;625535287;6888;249;7813;7853;7.98;0.49;261.02;5.63;925;57;2691.00;40
6889;56;625535302;6889;252;7814;7853;7.98;0.49;260.99;5.64;925;57;2692.00;39
6893;56;625535315;6893;252;7819;7857;8.00;0.49;261.05;5.65;926;57;2693.00;38
6897;56;625535332;6897;253;7821;7857;7.94;0.48;261.18;5.68;924;57;2694.00;36
6898;56;625535346;6898;261;7826;7861;7.85;0.48;261.18;5.68;928;57;2695.00;35
6900;56;625535359;6900;261;7828;7861;7.74;0.47;261.25;5.70;928;57;2696.00;33
6905;56;625535372;6905;261;7828;7861;7.63;0.46;261.29;5.70;923;57;2697.00;33
6906;56;625535385;6906;262;7830;7861;7.52;0.46;261.31;5.71;924;57;2698.00;31
6909;56;625535397;6909;259;7830;7861;7.47;0.45;261.33;5.71;921;57;2699.00;31
6910;56;625535411;6910;260;7854;7910;7.49;0.46;261.37;5.70;944;57;2700.00;56
6913;56;625535432;6913;263;7857;7910;7.44;0.45;261.39;5.70;944;57;2701.00;53
6914;56;625535444;6914;268;7860;7910;7.44;0.45;261.42;5.70;946;57;2702.00;50
6914;56;625535457;6914;271;7862;7910;7.42;0.45;261.42;5.71;948;57;2703.00;48
6918;56;625535469;6918;267;7864;7910;7.41;0.45;261.42;5.71;946;57;2704.00;46
6919;56;625535482;6919;274;7866;7910;7.37;0.45;261.44;5.71;947;57;2705.00;44
6920;56;625535493;6920;277;7869;7911;7.33;0.45;261.47;5.72;949;57;2706.00;42
6923;56;625535506;6923;282;7870;7911;7.25;0.44;261.50;5.72;947;57;2707.00;41
6925;56;625535518;6925;285;7874;7917;7.26;0.44;261.48;5.72;949;57;2708.00;43
6929;56;625535531;6929;288;7876;7918;7.25;0.44;261.50;5.72;947;57;2709.00;42
6932;56;625535543;6932;293;7877;7918;7.22;0.44;261.53;5.72;945;57;2710.00;41
6933;56;625535555;6933;290;7879;7918;7.19;0.44;261.57;5.73;946;57;2711.00;39
6937;56;625535568;6937;298;7883;7922;7.17;0.44;261.64;5.73;946;57;2712.00;39
6939;56;625535580;6939;296;7883;7922;7.16;0.43;261.63;5.73;944;57;2713.00;39
6947;56;625535593;6947;297;7886;7922;7.11;0.43;261.74;5.75;939;57;2714.00;36
6951;56;625535605;6951;298;7887;7923;7.08;0.43;261.83;5.75;936;57;2715.00;36
6953;56;625535618;6953;301;7892;7927;7.06;0.43;261.87;5.76;939;57;2716.00;35
6960;56;625535630;6960;299;7892;7927;7.04;0.43;262.09;5.76;932;57;2717.00;35
6964;56;625535642;6964;301;7895;7930;7.02;0.43;262.14;5.76;931;57;2718.00;35
6967;56;625535654;6967;305;7898;7930;6.95;0.42;262.19;5.77;931;57;2719.00;32
6972;56;625535665;6972;293;7899;7930;6.87;0.42;262.29;5.78;927;57;2720.00;31
6973;56;625535678;6973;278;7899;7930;6.84;0.42;262.31;5.78;926;57;2721.00;31
6977;56;625535689;6977;279;7903;7934;6.83;0.42;262.45;5.78;926;57;2722.00;31
6982;56;625535708;6982;279;7904;7934;6.79;0.41;262.52;5.78;922;57;2723.00;30
6985;56;625535721;6985;281;7905;7934;6.79;0.41;262.62;5.78;920;57;2724.00;29
6991;56;625535733;6991;284;7907;7934;6.76;0.41;262.75;5.79;916;57;2725.00;27
6993;56;625535744;6993;285;7907;7935;6.77;0.41;262.81;5.79;914;57;2726.00;28
6997;56;625535756;6997;283;7909;7936;6.82;0.42;262.89;5.79;912;57;2727.00;27
7001;56;625535768;7001;274;7911;7936;6.87;0.42;262.96;5.79;910;57;2728.00;25
7003;56;625535780;7003;273;7912;7937;6.98;0.43;262.98;5.79;909;57;2729.00;25
7008;56;625535793;7008;272;7913;7937;7.00;0.43;262.99;5.79;905;57;2730.00;24
7012;56;625535804;7012;264;7913;7937;7.00;0.43;263.11;5.79;901;57;2731.00;24
7017;56;625535816;7017;276;7913;7937;7.03;0.43;263.19;5.79;896;57;2732.00;24
7019;56;625535828;7019;275;7915;7937;7.08;0.43;263.24;5.80;896;57;2733.00;22
7025;56;625535840;7025;272;7917;7937;7.05;0.43;263.26;5.80;892;57;2734.00;20
7032;56;625535852;7032;265;7918;7937;7.05;0.43;263.34;5.80;886;57;2735.00;19
7033;56;625535864;7033;261;7983;8064;7.35;0.46;263.37;5.76;950;57;2736.00;81
7039;56;625535886;7039;251;7986;8065;7.34;0.46;263.46;5.76;947;57;2737.00;79
7043;56;625535898;7043;256;7991;8065;7.39;0.46;263.40;5.75;948;57;2738.00;74
7050;56;625535910;7050;256;7995;8065;7.39;0.46;263.50;5.75;945;57;2739.00;70
7056;56;625535922;7056;253;8000;8065;7.45;0.46;263.56;5.75;944;57;2740.00;65
7059;56;625535935;7059;258;8005;8065;7.45;0.46;263.53;5.75;946;57;2741.00;60
7064;56;625535947;7064;249;8007;8065;7.43;0.46;263.66;5.75;943;57;2742.00;58
7070;56;625535966;7070;255;8010;8065;7.31;0.45;263.72;5.75;940;57;2743.00;55
7074;56;625535986;7074;252;8012;8066;7.30;0.45;263.74;5.75;938;57;2744.00;54
7077;56;625536005;7077;252;8015;8068;7.36;0.45;263.84;5.75;938;57;2745.00;53
7081;56;625536018;7081;260;8017;8068;7.41;0.46;263.86;5.75;936;57;2746.00;51
7086;56;625536031;7086;256;8021;8069;7.44;0.46;263.90;5.76;935;57;2747.00;48
7092;56;625536051;7092;265;8023;8069;7.44;0.46;264.01;5.76;931;57;2748.00;46
7099;56;625536067;7099;268;8027;8069;7.43;0.46;264.01;5.76;928;57;2749.00;42
7101;56;625536082;7101;262;8032;8069;7.47;0.46;264.03;5.77;931;57;2750.00;37
7105;56;625536095;7105;258;8036;8073;7.45;0.46;264.06;5.77;931;57;2751.00;37
7108;56;625536110;7108;263;8038;8073;7.43;0.46;264.11;5.77;930;57;2752.00;35
7113;56;625536125;7113;270;8041;8073;7.38;0.45;264.04;5.77;928;57;2753.00;32
7116;56;625536138;7116;277;8043;8076;7.35;0.45;264.15;5.77;927;57;2754.00;33
7118;56;625536152;7118;283;8046;8076;7.31;0.45;264.19;5.77;928;57;2755.00;30
7121;56;625536166;7121;290;8047;8076;7.35;0.45;264.17;5.77;926;57;2756.00;29
7125;56;625536181;7125;296;8050;8080;7.35;0.45;264.21;5.77;925;57;2757.00;30
7132;56;625536195;7132;304;8051;8081;7.27;0.44;264.23;5.77;919;57;2758.00;30
7134;56;625536210;7134;311;8052;8081;7.23;0.44;264.18;5.80;918;57;2759.00;29
7140;56;625536226;7140;318;8056;8086;7.19;0.44;264.19;5.80;916;57;2760.00;30
7144;56;625536239;7144;314;8056;8086;7.13;0.43;264.22;5.80;912;57;2761.00;30
7148;56;625536251;7148;312;8056;8086;7.08;0.43;264.24;5.80;908;57;2762.00;30
7150;56;625536263;7150;322;8057;8087;7.05;0.43;264.27;5.79;907;57;2763.00;30
7154;56;625536275;7154;327;8057;8087;6.94;0.42;264.32;5.79;903;57;2764.00;30
7155;56;625536287;7155;336;8061;8093;6.89;0.42;264.32;5.79;906;57;2765.00;32
7156;56;625536299;7156;341;8061;8093;6.83;0.42;264.33;5.79;905;57;2766.00;32
7157;56;625536310;7157;339;8062;8094;6.81;0.41;264.33;5.79;905;57;2767.00;32
7161;56;625536323;7161;334;8062;8094;6.77;0.41;264.35;5.79;901;57;2768.00;32
7162;56;625536335;7162;325;8062;8094;6.78;0.41;264.34;5.79;900;57;2769.00;32
7163;56;625536347;7163;316;8062;8094;6.83;0.42;264.33;5.79;899;57;2770.00;32
7167;56;625536358;7167;317;8062;8094;6.86;0.42;264.38;5.79;895;57;2771.00;32
7168;56;625536370;7168;312;8072;8106;7.02;0.43;264.36;5.78;904;57;2772.00;34
7172;56;625536388;7172;312;8073;8106;7.05;0.43;264.36;5.78;901;57;2773.00;33
7174;56;625536400;7174;309;8073;8106;7.10;0.43;264.36;5.78;899;57;2774.00;33
7177;56;625536411;7177;305;8073;8106;7.11;0.43;264.47;5.78;896;57;2775.00;33
7180;56;625536423;7180;299;8074;8106;7.12;0.43;264.45;5.82;894;57;2776.00;32
7181;56;625536435;7181;284;8074;8106;7.20;0.44;264.44;5.82;893;57;2777.00;32
7187;56;625536447;7187;280;8077;8110;7.32;0.45;264.56;5.81;890;57;2778.00;33
7188;56;625536459;7188;277;8077;8110;7.41;0.45;264.55;5.81;889;57;2779.00;33
7191;56;625536471;7191;278;8080;8114;7.46;0.45;264.52;5.81;889;57;2780.00;34
7195;56;625536483;7195;273;8082;8115;7.42;0.45;264.48;5.81;887;57;2781.00;33
7199;56;625536496;7199;272;8082;8115;7.41;0.45;264.45;5.81;883;57;2782.00;33
7200;56;625536507;7200;272;8082;8115;7.49;0.46;264.43;5.81;882;57;2783.00;33
7200;56;625536524;7200;272;8092;8128;7.60;0.46;264.43;5.80;892;57;2784.00;36
7204;56;625536542;7204;275;8092;8128;7.59;0.46;264.34;5.80;888;57;2785.00;36
7204;56;625536554;7204;277;8093;8128;7.70;0.47;264.34;5.80;889;57;2786.00;35
7207;56;625536566;7207;275;8094;8129;7.72;0.47;264.26;5.80;887;57;2787.00;35
7209;56;625536578;7209;270;8094;8130;7.76;0.47;264.24;5.80;885;57;2788.00;36
7210;56;625536589;7210;270;8094;8130;7.78;0.47;264.21;5.80;884;57;2789.00;36
7212;56;625536607;7212;275;8097;8136;7.78;0.47;264.20;5.80;885;57;2790.00;39
7215;56;625536620;7215;270;8097;8136;7.75;0.47;264.18;5.80;882;57;2791.00;39
7217;56;625536631;7217;272;8099;8136;7.72;0.47;264.14;5.83;882;57;2792.00;37
7218;56;625536643;7218;266;8099;8136;7.63;0.46;264.14;5.83;881;57;2793.00;37
7220;56;625536654;7220;271;8103;8142;7.59;0.46;264.12;5.83;883;57;2794.00;39
7224;56;625536666;7224;274;8103;8142;7.49;0.45;264.09;5.83;879;57;2795.00;39
7225;56;625536678;7225;277;8104;8142;7.42;0.45;264.10;5.83;879;57;2796.00;38
7225;56;625536689;7225;275;8104;8142;7.42;0.45;264.10;5.83;879;57;2797.00;38
7227;56;625536700;7227;282;8108;8146;7.37;0.45;264.17;5.83;881;57;2798.00;38
7230;56;625536711;7230;288;8109;8147;7.28;0.44;264.13;5.83;879;57;2799.00;38
7231;56;625536723;7231;293;8110;8147;7.24;0.44;264.13;5.83;879;57;2800.00;37
7232;56;625536738;7232;297;8111;8148;7.16;0.43;264.13;5.83;879;57;2801.00;37
7236;56;625536749;7236;306;8111;8148;7.03;0.43;264.14;5.83;875;57;2802.00;37
7236;56;625536760;7236;299;8111;8148;7.00;0.43;264.14;5.83;875;57;2803.00;37
7237;56;625536771;7237;291;8111;8148;6.95;0.42;264.14;5.83;874;57;2804.00;37
7239;56;625536782;7239;282;8111;8148;6.93;0.42;264.12;5.83;872;57;2805.00;37
7239;56;625536792;7239;281;8111;8148;6.96;0.43;264.12;5.83;872;57;2806.00;37
7240;56;625536802;7240;274;8111;8148;6.98;0.43;264.13;5.83;871;57;2807.00;37
7241;56;625536813;7241;287;8152;8218;6.98;0.43;264.13;5.80;911;57;2808.00;66
7241;56;625536834;7241;273;8152;8219;6.98;0.43;264.13;5.80;911;57;2809.00;67
7248;56;625536846;7248;257;8160;8219;7.14;0.44;264.15;5.83;912;57;2810.00;59
7250;56;625536857;7250;245;8162;8219;7.27;0.44;264.15;5.83;912;57;2811.00;57
7252;56;625536874;7252;237;8166;8219;7.37;0.45;264.12;5.83;914;57;2812.00;53
7254;56;625536886;7254;235;8169;8219;7.39;0.45;264.11;5.86;915;57;2813.00;50
7254;56;625536903;7254;238;8172;8219;7.47;0.45;264.11;5.86;918;57;2814.00;47
7255;56;625536914;7255;240;8174;8219;7.47;0.45;264.10;5.86;919;57;2815.00;45
7255;56;625536931;7255;236;8177;8220;7.55;0.46;264.10;5.86;922;57;2816.00;43
7258;56;625536948;7258;234;8179;8221;7.56;0.46;264.06;5.86;921;57;2817.00;42
7258;56;625536959;7258;232;8181;8221;7.64;0.47;264.06;5.86;923;57;2818.00;40
7260;56;625536970;7260;231;8184;8225;7.64;0.47;264.05;5.86;924;57;2819.00;41
7261;56;625536984;7261;226;8185;8225;7.64;0.47;264.08;5.90;924;57;2820.00;40
7263;56;625536995;7263;225;8185;8225;7.52;0.46;264.08;5.90;922;57;2821.00;40
7264;56;625537006;7264;218;8185;8225;7.46;0.46;264.07;5.90;921;57;2822.00;40
7265;56;625537017;7265;215;8190;8231;7.47;0.46;264.05;5.93;925;57;2823.00;41
7271;56;625537028;7271;221;8191;8231;7.43;0.46;264.15;5.93;920;57;2824.00;40
7272;56;625537039;7272;222;8194;8231;7.40;0.45;264.18;5.99;922;57;2825.00;37
7276;56;625537057;7276;219;8196;8234;7.42;0.45;264.17;5.99;920;57;2826.00;38
7280;56;625537069;7280;228;8196;8234;7.44;0.45;264.21;5.99;916;57;2827.00;38
7285;56;625537080;7285;228;8198;8234;7.49;0.46;264.19;6.02;913;57;2828.00;36
7288;56;625537092;7288;219;8198;8235;7.51;0.46;264.17;6.02;910;57;2829.00;37
7292;56;625537103;7292;217;8199;8236;7.56;0.46;264.14;6.02;907;57;2830.00;37
7294;56;625537113;7294;208;8199;8236;7.68;0.47;264.25;6.02;905;57;2831.00;37
7296;56;625537124;7296;202;8209;8249;7.81;0.47;264.20;6.05;913;57;2832.00;40
7301;56;625537136;7301;197;8209;8249;7.88;0.48;264.25;6.05;908;57;2833.00;40
7302;56;625537147;7302;193;8210;8249;7.96;0.48;264.25;6.09;908;57;2834.00;39
7305;56;625537158;7305;191;8212;8251;7.99;0.48;264.32;6.09;907;57;2835.00;39
7309;56;625537176;7309;187;8212;8251;8.08;0.49;264.27;6.09;903;57;2836.00;39
7310;56;625537193;7310;176;8216;8255;8.18;0.50;264.33;6.12;906;57;2837.00;39
7313;56;625537212;7313;179;8218;8255;8.26;0.50;264.36;6.12;905;57;2838.00;37
7317;56;625537232;7317;185;8223;8259;8.22;0.50;264.42;6.14;906;57;2839.00;36
7317;56;625537251;7317;190;8223;8259;8.26;0.50;264.42;6.14;906;57;2840.00;36
7320;56;625537268;7320;197;8224;8259;8.24;0.50;264.48;6.17;904;57;2841.00;35
7323;56;625537286;7323;192;8224;8259;8.23;0.50;264.48;6.17;901;57;2842.00;35
7324;56;625537300;7324;194;8224;8259;8.13;0.49;264.46;6.17;900;57;2843.00;35
7328;56;625537312;7328;194;8233;8271;8.11;0.49;264.53;6.16;905;57;2844.00;38
7332;56;625537326;7332;189;8234;8271;8.07;0.49;264.63;6.16;902;57;2845.00;37
7332;56;625537339;7332;190;8235;8271;8.12;0.49;264.63;6.16;903;57;2846.00;36
7338;56;625537351;7338;198;8235;8271;8.09;0.49;264.82;6.16;897;57;2847.00;36
7344;56;625537363;7344;201;8235;8271;8.09;0.49;264.87;6.16;891;57;2848.00;36
7346;56;625537375;7346;204;8236;8271;8.18;0.50;264.86;6.17;890;57;2849.00;35
7348;56;625537389;7348;198;8239;8274;8.19;0.50;264.90;6.18;891;57;2850.00;35
7352;56;625537403;7352;195;8239;8274;8.23;0.50;265.04;6.18;887;57;2851.00;35
7353;56;625537415;7353;194;8245;8280;8.27;0.50;265.04;6.21;892;57;2852.00;35
7357;56;625537428;7357;193;8247;8281;8.29;0.50;265.10;6.21;890;57;2853.00;34
7360;56;625537440;7360;193;8247;8281;8.31;0.50;265.12;6.21;887;57;2854.00;34
7361;56;625537453;7361;194;8249;8281;8.32;0.51;265.12;6.23;888;57;2855.00;32
7364;56;625537471;7364;195;8252;8285;8.36;0.51;265.22;6.23;888;57;2856.00;33
7364;56;625537484;7364;198;8253;8285;8.37;0.51;265.22;6.24;889;57;2857.00;32
7365;56;625537497;7365;200;8254;8285;8.41;0.51;265.21;6.25;889;57;2858.00;31
7367;56;625537509;7367;202;8255;8286;8.47;0.52;265.25;6.25;888;57;2859.00;31
7371;56;625537521;7371;199;8260;8290;8.51;0.52;265.36;6.27;889;57;2860.00;30
7373;56;625537534;7373;205;8260;8290;8.49;0.52;265.39;6.27;887;57;2861.00;30
7375;56;625537545;7375;204;8263;8293;8.51;0.52;265.45;6.27;888;57;2862.00;30
7379;56;625537557;7379;203;8264;8293;8.45;0.51;265.56;6.27;885;57;2863.00;29
7383;56;625537569;7383;209;8268;8295;8.34;0.51;265.56;6.29;885;57;2864.00;27
7387;56;625537589;7387;207;8268;8295;8.28;0.50;265.65;6.29;881;57;2865.00;27
7391;56;625537601;7391;216;8273;8299;8.25;0.50;265.67;6.31;882;57;2866.00;26
7394;56;625537613;7394;219;8276;8299;8.17;0.50;265.69;6.32;882;57;2867.00;23
7396;56;625537625;7396;220;8277;8299;8.13;0.49;265.71;6.32;881;57;2868.00;22
7397;56;625537636;7397;214;8278;8299;8.08;0.49;265.69;6.33;881;57;2869.00;21
7399;56;625537654;7399;207;8278;8300;8.02;0.49;265.70;6.33;879;57;2870.00;22
7404;56;625537666;7404;216;8279;8301;7.94;0.48;265.84;6.33;875;57;2871.00;22
7406;56;625537677;7406;207;8280;8301;7.87;0.48;265.86;6.34;874;57;2872.00;21
7409;56;625537688;7409;206;8281;8302;7.83;0.48;265.96;6.34;872;57;2873.00;21
7411;56;625537699;7411;208;8284;8302;7.77;0.47;265.92;6.37;873;57;2874.00;18
7414;56;625537711;7414;208;8284;8302;7.69;0.47;265.99;6.37;870;57;2875.00;18
7416;56;625537722;7416;209;8284;8302;7.71;0.47;266.01;6.37;868;57;2876.00;18
7417;56;625537733;7417;209;8285;8302;7.72;0.47;266.03;6.38;868;57;2877.00;17
7419;56;625537743;7419;215;8285;8302;7.72;0.47;266.13;6.38;866;57;2878.00;17
7423;56;625537754;7423;218;8288;8302;7.73;0.47;266.12;6.40;865;57;2879.00;14
7426;56;625537766;7426;258;8389;8532;7.77;0.48;266.11;6.32;963;57;2880.00;143
7427;56;625537795;7427;251;8392;8533;7.75;0.48;266.15;6.32;965;57;2881.00;141
7430;56;625537806;7430;242;8399;8533;7.79;0.49;266.22;6.32;969;57;2882.00;134
7435;56;625537818;7435;248;8409;8533;7.77;0.48;266.25;6.32;974;57;2883.00;124
7438;56;625537829;7438;244;8417;8533;7.77;0.48;266.26;6.32;979;57;2884.00;116
7440;56;625537841;7440;239;8424;8533;7.77;0.48;266.26;6.32;984;57;2885.00;109
7446;56;625537852;7446;246;8431;8533;7.74;0.48;266.22;6.32;985;57;2886.00;102
7450;56;625537864;7450;246;8434;8533;7.72;0.48;266.24;6.32;984;57;2887.00;99
7455;56;625537876;7455;246;8443;8534;7.66;0.47;266.31;6.33;988;57;2888.00;91
7458;56;625537888;7458;252;8446;8535;7.58;0.47;266.36;6.33;988;57;2889.00;89
7461;56;625537900;7461;248;8448;8535;7.54;0.47;266.42;6.33;987;57;2890.00;87
7467;56;625537912;7467;242;8451;8536;7.38;0.46;266.46;6.33;984;57;2891.00;85
7472;56;625537924;7472;235;8460;8536;7.18;0.44;266.58;6.34;988;57;2892.00;76
7476;56;625537936;7476;245;8461;8536;7.02;0.43;266.64;6.34;985;57;2893.00;75
7479;56;625537948;7479;250;8468;8536;6.88;0.42;266.71;6.35;989;57;2894.00;68
7481;56;625537960;7481;263;8472;8540;6.79;0.42;266.73;6.35;991;57;2895.00;68
7484;56;625537974;7484;267;8476;8540;6.67;0.41;266.83;6.35;992;57;2896.00;64
7487;56;625537986;7487;266;8479;8540;6.58;0.41;266.88;6.36;992;57;2897.00;61
7492;56;625537998;7492;266;8481;8543;6.57;0.41;267.04;6.36;989;57;2898.00;62
7495;56;625538011;7495;265;8484;8543;6.62;0.41;267.10;6.36;989;57;2899.00;59
7499;56;625538030;7499;265;8486;8543;6.64;0.41;267.08;6.37;987;57;2900.00;57
7503;56;625538047;7503;267;8491;8547;6.64;0.41;267.13;6.37;988;57;2901.00;56
7505;56;625538068;7505;269;8493;8548;6.70;0.41;267.13;6.37;988;57;2902.00;55
7508;56;625538082;7508;276;8493;8548;6.74;0.42;267.15;6.37;985;57;2903.00;55
7512;56;625538095;7512;277;8499;8552;6.77;0.42;267.22;6.38;987;57;2904.00;53
7513;56;625538107;7513;277;8503;8552;6.79;0.42;267.26;6.38;990;57;2905.00;49
7519;56;625538120;7519;279;8504;8552;6.76;0.42;267.24;6.39;985;57;2906.00;48
7522;56;625538132;7522;288;8506;8553;6.81;0.42;267.33;6.39;984;57;2907.00;47
7527;56;625538145;7527;290;8507;8553;6.82;0.42;267.35;6.39;980;57;2908.00;46
7530;56;625538157;7530;289;8514;8559;6.80;0.42;267.40;6.40;984;57;2909.00;45
7534;56;625538174;7534;298;8515;8559;6.76;0.41;267.44;6.40;981;57;2910.00;44
7538;56;625538193;7538;301;8517;8560;6.73;0.41;267.50;6.41;979;57;2911.00;43
7544;56;625538207;7544;309;8519;8560;6.67;0.41;267.56;6.41;975;57;2912.00;41
7547;56;625538220;7547;307;8520;8560;6.64;0.41;267.57;6.41;973;57;2913.00;40
7549;56;625538232;7549;306;8521;8560;6.61;0.41;267.60;6.41;972;57;2914.00;39
7553;56;625538245;7553;306;8523;8560;6.50;0.40;267.59;6.42;970;57;2915.00;37
7559;56;625538258;7559;307;8533;8572;6.53;0.40;267.73;6.41;974;57;2916.00;39
7562;56;625538271;7562;318;8535;8572;6.51;0.40;267.78;6.42;973;57;2917.00;37
7567;56;625538283;7567;324;8536;8572;6.55;0.40;267.76;6.42;969;57;2918.00;36
7572;56;625538295;7572;327;8539;8572;6.57;0.40;267.70;6.42;967;57;2919.00;33
7577;56;625538308;7577;334;8539;8572;6.60;0.41;267.83;6.42;962;57;2920.00;33
7583;56;625538319;7583;337;8540;8572;6.60;0.41;267.85;6.45;957;57;2921.00;32
7585;56;625538332;7585;343;8543;8576;6.61;0.41;267.91;6.45;958;57;2922.00;33
7589;56;625538344;7589;354;8543;8576;6.54;0.40;268.01;6.45;954;57;2923.00;33
7590;56;625538356;7590;357;8546;8580;6.53;0.40;268.02;6.45;956;57;2924.00;34
7590;56;625538367;7590;365;8548;8582;6.54;0.40;268.02;6.45;958;57;2925.00;34
7593;56;625538379;7593;376;8549;8582;6.49;0.40;267.98;6.45;956;57;2926.00;33
7595;56;625538391;7595;383;8549;8582;6.47;0.40;268.01;6.45;954;57;2927.00;33
7598;56;625538403;7598;388;8559;8595;6.52;0.40;268.00;6.44;961;57;2928.00;36
7602;56;625538415;7602;385;8559;8595;6.49;0.40;267.94;6.44;957;57;2929.00;36
7606;56;625538426;7606;389;8559;8595;6.48;0.40;267.88;6.44;953;57;2930.00;36
7608;56;625538437;7608;393;8561;8596;6.48;0.40;267.90;6.47;953;57;2931.00;35
7609;56;625538449;7609;398;8561;8597;6.47;0.40;267.88;6.47;952;57;2932.00;36
7613;56;625538460;7613;404;8561;8597;6.40;0.39;267.82;6.47;948;57;2933.00;36
7618;56;625538472;7618;408;8563;8600;6.30;0.39;267.79;6.47;945;57;2934.00;37
7621;56;625538483;7621;411;8564;8600;6.25;0.38;267.73;6.47;943;57;2935.00;36
7622;56;625538494;7622;419;8564;8600;6.21;0.38;267.73;6.47;942;57;2936.00;36
7625;56;625538505;7625;412;8564;8600;6.24;0.38;267.71;6.47;939;57;2937.00;36
7628;56;625538516;7628;409;8568;8606;6.29;0.39;267.69;6.46;940;57;2938.00;38
7630;56;625538528;7630;404;8568;8606;6.31;0.39;267.67;6.46;938;57;2939.00;38
7633;56;625538541;7633;398;8569;8606;6.35;0.39;267.62;6.46;936;57;2940.00;37
7634;56;625538552;7634;392;8569;8606;6.36;0.39;267.63;6.46;935;57;2941.00;37
7638;56;625538563;7638;387;8572;8610;6.40;0.39;267.62;6.46;934;57;2942.00;38
7643;56;625538575;7643;383;8573;8611;6.39;0.39;267.60;6.46;930;57;2943.00;38
7645;56;625538591;7645;387;8573;8611;6.43;0.39;267.55;6.46;928;57;2944.00;38
7646;56;625538603;7646;382;8575;8612;6.43;0.39;267.55;6.49;929;57;2945.00;37
7646;56;625538619;7646;374;8575;8612;6.45;0.39;267.55;6.49;929;57;2946.00;37
7649;56;625538630;7649;364;8575;8612;6.49;0.39;267.50;6.49;926;57;2947.00;37
7651;56;625538642;7651;360;8575;8612;6.47;0.39;267.45;6.49;924;57;2948.00;37
7652;56;625538659;7652;354;8576;8612;6.54;0.40;267.44;6.52;924;57;2949.00;36
7652;56;625538671;7652;354;8576;8612;6.62;0.40;267.44;6.52;924;57;2950.00;36
7653;56;625538682;7653;348;8576;8612;6.74;0.41;267.43;6.52;923;57;2951.00;36
7658;56;625538694;7658;351;8612;8682;7.03;0.43;267.35;6.49;954;57;2952.00;70
7659;56;625538712;7659;350;8613;8683;7.14;0.43;267.35;6.49;954;57;2953.00;70
7660;56;625538724;7660;345;8620;8683;7.29;0.44;267.36;6.51;960;57;2954.00;63
7663;56;625538736;7663;334;8626;8683;7.40;0.45;267.36;6.51;963;57;2955.00;57
7664;56;625538749;7664;324;8630;8683;7.45;0.45;267.33;6.51;966;57;2956.00;53
7665;56;625538761;7665;315;8634;8683;7.51;0.46;267.33;6.51;969;57;2957.00;49
7666;56;625538774;7666;311;8635;8683;7.60;0.46;267.33;6.51;969;57;2958.00;48
7668;56;625538787;7668;295;8637;8683;7.73;0.47;267.32;6.53;969;57;2959.00;46
7669;56;625538799;7669;283;8639;8684;7.79;0.47;267.33;6.53;970;57;2960.00;45
7670;56;625538812;7670;276;8640;8685;7.79;0.47;267.32;6.53;970;57;2961.00;45
7670;57;625538830;7670;266;8641;8685;7.77;0.47;267.32;6.53;971;58;2962.00;44
7671;58;625538854;7671;259;8644;8689;7.79;0.47;267.31;6.53;973;59;2963.00;45
7672;58;625538877;7672;251;8644;8689;7.83;0.48;267.30;6.53;972;59;2964.00;45
7675;58;625538890;7675;255;8645;8689;7.83;0.48;267.27;6.55;970;59;2965.00;44
7677;58;625538908;7677;256;8645;8689;7.87;0.48;267.35;6.55;968;59;2966.00;44
7678;58;625538921;7678;250;8648;8695;7.91;0.48;267.36;6.54;970;59;2967.00;47
7678;58;625538934;7678;246;8648;8695;7.94;0.48;267.36;6.54;970;59;2968.00;47
7680;58;625538951;7680;246;8649;8695;7.93;0.48;267.36;6.54;969;59;2969.00;46
7680;58;625538966;7680;253;8652;8701;7.93;0.48;267.36;6.54;972;59;2970.00;49
7681;58;625538979;7681;247;8654;8701;7.86;0.48;267.35;6.55;973;59;2971.00;47
7681;58;625538992;7681;251;8654;8701;7.90;0.48;267.35;6.55;973;59;2972.00;47
7682;58;625539004;7682;255;8655;8702;7.91;0.48;267.35;6.55;973;59;2973.00;47
7685;58;625539016;7685;260;8656;8703;7.96;0.49;267.35;6.55;971;59;2974.00;47
7687;58;625539028;7687;265;8657;8703;7.95;0.49;267.40;6.55;970;59;2975.00;46
7687;58;625539041;7687;270;8665;8716;8.00;0.49;267.40;6.54;978;59;2976.00;51
7692;58;625539054;7692;264;8666;8716;7.98;0.49;267.33;6.54;974;59;2977.00;50
7693;58;625539067;7693;266;8666;8716;7.98;0.49;267.33;6.54;973;59;2978.00;50
7695;58;625539079;7695;267;8667;8717;7.94;0.48;267.33;6.54;972;59;2979.00;50
7698;58;625539092;7698;267;8667;8717;7.91;0.48;267.36;6.54;969;59;2980.00;50
7704;58;625539104;7704;271;8669;8721;7.85;0.48;267.47;6.54;965;59;2981.00;52
7705;58;625539117;7705;278;8670;8721;7.83;0.48;267.49;6.55;965;59;2982.00;51
7711;58;625539129;7711;275;8674;8725;7.84;0.48;267.54;6.55;963;59;2983.00;51
7715;58;625539142;7715;277;8674;8725;7.84;0.48;267.62;6.55;959;59;2984.00;51
7719;58;625539155;7719;272;8674;8725;7.79;0.47;267.61;6.55;955;59;2985.00;51
7723;58;625539166;7723;276;8674;8725;7.76;0.47;267.63;6.55;951;59;2986.00;51
7726;58;625539182;7726;266;8674;8725;7.77;0.47;267.77;6.55;948;59;2987.00;51
7729;58;625539201;7729;254;8683;8737;7.80;0.47;267.74;6.54;954;59;2988.00;54
7733;58;625539224;7733;244;8684;8737;7.76;0.47;267.81;6.55;951;59;2989.00;53
7736;58;625539245;7736;244;8686;8737;7.77;0.47;267.83;6.54;950;59;2990.00;51
7741;58;625539264;7741;233;8686;8737;7.71;0.47;267.89;6.54;945;59;2991.00;51
7743;58;625539282;7743;222;8686;8737;7.70;0.47;267.86;6.54;943;59;2992.00;51
7744;58;625539298;7744;229;8687;8737;7.71;0.47;267.84;6.56;943;59;2993.00;50
7747;58;625539310;7747;225;8689;8738;7.65;0.47;267.83;6.56;942;59;2994.00;49
7749;58;625539323;7749;219;8691;8738;7.62;0.46;267.85;6.59;942;59;2995.00;47
7754;58;625539343;7754;216;8694;8744;7.67;0.47;267.91;6.59;940;59;2996.00;50
7756;58;625539358;7756;217;8697;8745;7.73;0.47;267.94;6.60;941;59;2997.00;48
7758;58;625539371;7758;211;8697;8745;7.77;0.47;267.98;6.60;939;59;2998.00;48
7761;58;625539383;7761;207;8697;8745;7.80;0.47;267.98;6.60;936;59;2999.00;48
7766;58;625539400;7766;211;8703;8765;7.79;0.47;268.01;6.61;937;59;3000.00;62
7768;58;625539419;7768;200;8703;8765;7.90;0.48;268.10;6.61;935;59;3001.00;62
7773;58;625539431;7773;195;8703;8765;7.90;0.48;268.06;6.61;930;59;3002.00;62
7776;58;625539444;7776;196;8704;8766;8.01;0.49;268.03;6.61;928;59;3003.00;62
7779;58;625539456;7779;194;8708;8770;8.06;0.49;268.05;6.62;929;59;3004.00;62
7781;58;625539469;7781;195;8708;8770;8.13;0.49;268.07;6.62;927;59;3005.00;62
7785;58;625539481;7785;198;8713;8773;8.15;0.49;268.10;6.63;928;59;3006.00;60
7786;58;625539494;7786;190;8714;8773;8.25;0.50;268.11;6.64;928;59;3007.00;59
7789;58;625539506;7789;187;8714;8773;8.29;0.50;268.20;6.64;925;59;3008.00;59
7793;58;625539519;7793;186;8717;8773;8.30;0.50;268.23;6.66;924;59;3009.00;56
7794;58;625539531;7794;182;8719;8777;8.32;0.50;268.22;6.67;925;59;3010.00;58
7798;58;625539544;7798;184;8722;8777;8.29;0.50;268.26;6.67;924;59;3011.00;55
7798;58;625539557;7798;182;8724;8777;8.36;0.51;268.26;6.67;926;59;3012.00;53
7803;58;625539568;7803;182;8725;8777;8.40;0.51;268.33;6.68;922;59;3013.00;52
7804;58;625539581;7804;180;8726;8778;8.52;0.52;268.31;6.68;922;59;3014.00;52
7806;58;625539594;7806;181;8731;8780;8.53;0.52;268.36;6.68;925;59;3015.00;49
7808;58;625539607;7808;179;8732;8780;8.56;0.52;268.39;6.68;924;59;3016.00;48
7811;58;625539620;7811;181;8735;8781;8.58;0.52;268.35;6.68;924;59;3017.00;46
7814;58;625539633;7814;185;8735;8781;8.65;0.52;268.42;6.68;921;59;3018.00;46
7818;58;625539647;7818;186;8735;8781;8.68;0.52;268.46;6.68;917;59;3019.00;46
7820;58;625539659;7820;185;8736;8781;8.74;0.53;268.53;6.70;916;59;3020.00;45
7822;58;625539672;7822;184;8738;8781;8.79;0.53;268.53;6.71;916;59;3021.00;43
7824;58;625539684;7824;192;8739;8781;8.81;0.53;268.60;6.71;915;59;3022.00;42
7826;58;625539697;7826;187;8740;8781;8.91;0.54;268.60;6.73;914;59;3023.00;41
7830;58;625539710;7830;207;8806;8908;8.90;0.55;268.65;6.69;976;59;3024.00;102
7834;58;625539735;7834;201;8810;8909;8.91;0.55;268.75;6.71;976;59;3025.00;99
7834;58;625539749;7834;201;8820;8909;8.93;0.55;268.75;6.72;986;59;3026.00;89
7835;58;625539763;7835;203;8824;8909;8.95;0.55;268.75;6.74;989;59;3027.00;85
7838;58;625539777;7838;206;8829;8909;8.98;0.55;268.77;6.74;991;59;3028.00;80
7842;58;625539791;7842;207;8831;8909;8.96;0.55;268.87;6.75;989;59;3029.00;78
7844;58;625539806;7844;207;8837;8909;8.99;0.55;268.97;6.76;993;59;3030.00;72
7847;58;625539820;7847;211;8840;8909;9.00;0.55;268.98;6.77;993;59;3031.00;69
7850;58;625539840;7850;214;8845;8910;9.01;0.55;269.01;6.79;995;59;3032.00;65
7854;58;625539854;7854;211;8849;8911;9.06;0.56;269.06;6.79;995;59;3033.00;62
7856;58;625539868;7856;213;8855;8911;9.06;0.56;269.07;6.82;999;59;3034.00;56
7859;58;625539880;7859;210;8858;8912;9.03;0.55;269.11;6.82;999;59;3035.00;54
7862;58;625539894;7862;216;8863;8912;8.97;0.55;269.12;6.83;1001;59;3036.00;49
7864;58;625539907;7864;219;8867;8912;8.86;0.54;269.16;6.84;1003;59;3037.00;45
7870;58;625539920;7870;227;8869;8912;8.75;0.54;269.13;6.85;999;59;3038.00;43
7870;58;625539934;7870;232;8873;8916;8.70;0.53;269.13;6.85;1003;59;3039.00;43
7874;58;625539948;7874;237;8877;8916;8.59;0.53;269.14;6.86;1003;59;3040.00;39
7876;58;625539961;7876;242;8879;8916;8.53;0.52;269.20;6.86;1003;59;3041.00;37
7880;58;625539975;7880;251;8881;8919;8.39;0.52;269.26;6.87;1001;59;3042.00;38
7883;58;625539987;7883;254;8883;8919;8.31;0.51;269.30;6.87;1000;59;3043.00;36
7888;58;625540001;7888;260;8885;8919;8.21;0.50;269.38;6.88;997;59;3044.00;34
7892;58;625540013;7892;266;8891;8923;8.03;0.49;269.31;6.88;999;59;3045.00;32
7895;58;625540027;7895;272;8894;8924;7.91;0.49;269.42;6.89;999;59;3046.00;30
7899;58;625540040;7899;284;8894;8924;7.75;0.47;269.38;6.89;995;59;3047.00;30
7901;58;625540053;7901;290;8898;8928;7.66;0.47;269.43;6.89;997;59;3048.00;30
7909;58;625540066;7909;291;8899;8928;7.59;0.46;269.45;6.89;990;59;3049.00;29
7910;58;625540078;7910;292;8900;8928;7.52;0.46;269.42;6.90;990;59;3050.00;28
7913;58;625540090;7913;289;8901;8929;7.40;0.45;269.49;6.90;988;59;3051.00;28
7917;58;625540102;7917;300;8901;8929;7.31;0.45;269.54;6.90;984;59;3052.00;28
7921;58;625540113;7921;304;8908;8935;7.26;0.44;269.69;6.91;987;59;3053.00;27
7925;58;625540127;7925;306;8908;8935;7.16;0.44;269.70;6.91;983;59;3054.00;27
7931;58;625540140;7931;311;8909;8936;7.10;0.43;269.74;6.91;978;59;3055.00;27
7934;58;625540153;7934;315;8910;8936;7.05;0.43;269.78;6.91;976;59;3056.00;26
7939;58;625540168;7939;316;8911;8936;6.95;0.43;269.79;6.92;972;59;3057.00;25
7944;58;625540181;7944;322;8911;8936;6.84;0.42;269.87;6.92;967;59;3058.00;25
7947;58;625540193;7947;334;8913;8936;6.66;0.41;269.95;6.93;966;59;3059.00;23
7954;58;625540207;7954;328;8939;8972;6.61;0.41;270.01;6.92;985;59;3060.00;33
7959;58;625540223;7959;320;8940;8972;6.55;0.41;270.09;6.92;981;59;3061.00;32
7962;58;625540236;7962;324;8943;8972;6.48;0.40;270.13;6.92;981;59;3062.00;29
7968;58;625540246;7968;327;8945;8972;6.44;0.40;270.19;6.92;977;59;3063.00;27
7970;58;625540257;7970;321;8947;8972;6.40;0.40;270.21;6.92;977;59;3064.00;25
7974;58;625540268;7974;323;8948;8972;6.35;0.39;270.30;6.92;974;59;3065.00;24
7979;58;625540284;7979;326;8952;8976;6.30;0.39;270.37;6.92;973;59;3066.00;24
7981;58;625540295;7981;329;8953;8976;6.35;0.39;270.41;6.92;972;59;3067.00;23
7986;58;625540306;7986;326;8955;8980;6.38;0.39;270.44;6.92;969;59;3068.00;25
7989;58;625540317;7989;325;8959;8981;6.36;0.39;270.52;6.93;970;59;3069.00;22
7993;58;625540328;7993;327;8959;8981;6.29;0.39;270.56;6.93;966;59;3070.00;22
7996;58;625540339;7996;326;8960;8981;6.23;0.38;270.63;6.93;964;59;3071.00;21
7998;58;625540350;7998;333;8971;8994;6.24;0.38;270.65;6.92;973;59;3072.00;23
8000;58;625540361;8000;339;8971;8994;6.23;0.38;270.66;6.92;971;59;3073.00;23
8006;58;625540372;8006;347;8971;8994;6.16;0.38;270.58;6.92;965;59;3074.00;23
8008;58;625540383;8008;351;8972;8995;6.15;0.38;270.55;6.92;964;59;3075.00;23
8014;58;625540394;8014;358;8972;8996;6.12;0.38;270.53;6.92;958;59;3076.00;24
8017;58;625540405;8017;359;8972;8996;6.11;0.38;270.50;6.92;955;59;3077.00;24
8021;58;625540415;8021;352;8974;8999;6.13;0.38;270.48;6.92;953;59;3078.00;25
8024;58;625540426;8024;347;8975;8999;6.11;0.38;270.46;6.92;951;59;3079.00;24
8027;58;625540437;8027;341;8975;8999;6.17;0.38;270.49;6.92;948;59;3080.00;24
8033;58;625540448;8033;340;8975;8999;6.15;0.38;270.54;6.92;942;59;3081.00;24
8038;58;625540459;8038;339;8979;9005;6.23;0.38;270.57;6.91;941;59;3082.00;26
8041;58;625540470;8041;345;8979;9005;6.24;0.38;270.64;6.91;938;59;3083.00;26
8046;58;625540481;8046;353;8980;9005;6.23;0.38;270.62;6.91;934;59;3084.00;25
8050;58;625540492;8050;352;8980;9005;6.17;0.38;270.55;6.91;930;59;3085.00;25
8056;58;625540503;8056;358;8983;9009;6.16;0.38;270.49;6.91;927;59;3086.00;26
8059;58;625540515;8059;360;8984;9010;6.12;0.38;270.52;6.91;925;59;3087.00;26
8062;58;625540526;8062;359;8984;9010;6.05;0.37;270.48;6.91;922;59;3088.00;26
8068;58;625540537;8068;367;8985;9011;5.95;0.36;270.50;6.91;917;59;3089.00;26
8073;58;625540550;8073;373;8985;9011;5.85;0.36;270.45;6.91;912;59;3090.00;26
8075;58;625540561;8075;382;8985;9011;5.78;0.35;270.40;6.91;910;59;3091.00;26
8078;58;625540571;8078;385;8985;9011;5.74;0.35;270.52;6.91;907;59;3092.00;26
8081;58;625540582;8081;388;8985;9011;5.74;0.35;270.54;6.91;904;59;3093.00;26
8084;58;625540593;8084;389;8986;9011;5.69;0.35;270.49;6.93;902;59;3094.00;25
8088;58;625540604;8088;385;8986;9011;5.70;0.35;270.51;6.93;898;59;3095.00;25
8092;58;625540614;8092;403;9024;9081;5.97;0.37;270.61;6.90;932;59;3096.00;57
8094;58;625540631;8094;401;9025;9082;6.00;0.37;270.64;6.90;931;59;3097.00;57
8095;58;625540642;8095;400;9034;9082;6.15;0.38;270.65;6.90;939;59;3098.00;48
8097;58;625540653;8097;402;9037;9082;6.21;0.38;270.63;6.90;940;59;3099.00;45
8100;58;625540665;8100;406;9041;9082;6.24;0.38;270.57;6.89;941;59;3100.00;41
8105;58;625540681;8105;402;9045;9082;6.25;0.38;270.56;6.89;940;59;3101.00;37
8107;58;625540692;8107;405;9048;9082;6.23;0.38;270.52;6.89;941;59;3102.00;34
8111;58;625540708;8111;409;9050;9082;6.22;0.38;270.51;6.89;939;59;3103.00;32
8112;58;625540720;8112;411;9052;9083;6.19;0.38;270.50;6.89;940;59;3104.00;31
8114;58;625540731;8114;412;9054;9085;6.14;0.38;270.49;6.89;940;59;3105.00;31
8116;58;625540742;8116;418;9055;9085;6.03;0.37;270.51;6.89;939;59;3106.00;30
8117;58;625540753;8117;395;9058;9089;6.03;0.37;270.52;6.89;941;59;3107.00;31
8120;58;625540774;8120;373;9058;9089;6.05;0.37;270.50;6.89;938;59;3108.00;31
8122;58;625540786;8122;362;9058;9089;6.13;0.38;270.48;6.89;936;59;3109.00;31
8123;58;625540797;8123;361;9058;9089;6.21;0.38;270.50;6.89;935;59;3110.00;31
8126;58;625540810;8126;351;9063;9095;6.35;0.39;270.47;6.91;937;59;3111.00;32
8127;58;625540822;8127;347;9063;9095;6.52;0.40;270.46;6.91;936;59;3112.00;32
8130;58;625540834;8130;336;9064;9095;6.70;0.41;270.44;6.91;934;59;3113.00;31
8133;58;625540853;8133;329;9066;9098;6.88;0.42;270.45;6.91;933;59;3114.00;32
8134;58;625540866;8134;325;9067;9098;6.98;0.43;270.44;6.91;933;59;3115.00;31
8136;58;625540883;8136;312;9067;9098;7.06;0.43;270.44;6.91;931;59;3116.00;31
8139;59;625540896;8139;297;9067;9099;7.17;0.44;270.49;6.91;928;60;3117.00;32
8141;59;625540919;8141;288;9068;9100;7.31;0.44;270.46;6.91;927;60;3118.00;32
8143;59;625540932;8143;279;9068;9100;7.43;0.45;270.45;6.91;925;60;3119.00;32
8144;59;625540953;8144;275;9088;9126;7.64;0.46;270.45;6.89;944;60;3120.00;38
8145;59;625540968;8145;272;9089;9126;7.79;0.47;270.44;6.89;944;60;3121.00;37
8147;59;625540981;8147;265;9090;9126;7.88;0.48;270.44;6.89;943;60;3122.00;36
8148;59;625540999;8148;271;9091;9127;8.05;0.49;270.43;6.89;943;60;3123.00;36
8148;59;625541012;8148;273;9091;9127;8.19;0.50;270.43;6.89;943;60;3124.00;36
8150;59;625541026;8150;270;9094;9131;8.28;0.50;270.42;6.89;944;60;3125.00;37
8151;59;625541039;8151;262;9094;9131;8.38;0.51;270.39;6.89;943;60;3126.00;37
8153;59;625541053;8153;250;9098;9135;8.43;0.51;270.40;6.89;945;60;3127.00;37
8155;60;625541066;8155;246;9098;9135;8.47;0.51;270.40;6.89;943;61;3128.00;37
8158;60;625541086;8158;239;9098;9135;8.51;0.52;270.38;6.89;940;61;3129.00;37
8163;60;625541099;8163;242;9098;9135;8.46;0.51;270.38;6.89;935;62;3130.00;37
8166;60;625541121;8166;236;9098;9135;8.40;0.51;270.42;6.89;932;62;3131.00;37
8170;60;625541139;8170;244;9107;9147;8.42;0.51;270.38;6.88;937;62;3132.00;40
8172;60;625541152;8172;243;9107;9147;8.39;0.51;270.43;6.88;935;62;3133.00;40
8175;60;625541165;8175;245;9109;9147;8.39;0.51;270.41;6.88;934;62;3134.00;38
8176;60;625541178;8176;246;9109;9147;8.45;0.51;270.40;6.88;933;62;3135.00;38
8181;60;625541196;8181;250;9109;9147;8.44;0.51;270.45;6.88;928;62;3136.00;38
8185;60;625541220;8185;252;9109;9147;8.51;0.52;270.45;6.88;924;62;3137.00;38
8187;60;625541242;8187;250;9110;9148;8.56;0.52;270.56;6.91;923;62;3138.00;38
8187;60;625541262;8187;250;9110;9148;8.60;0.52;270.56;6.91;923;62;3139.00;38
8191;60;625541281;8191;256;9114;9154;8.55;0.52;270.62;6.90;923;62;3140.00;40
8194;60;625541301;8194;258;9115;9155;8.53;0.52;270.64;6.90;921;62;3141.00;40
8197;60;625541316;8197;262;9116;9155;8.52;0.52;270.70;6.90;919;62;3142.00;39
8199;60;625541330;8199;262;9116;9155;8.44;0.51;270.78;6.90;917;62;3143.00;39
8202;60;625541343;8202;266;9119;9159;8.40;0.51;270.79;6.90;917;62;3144.00;40
8206;60;625541357;8206;274;9119;9159;8.38;0.51;270.92;6.90;913;62;3145.00;40
8208;60;625541370;8208;283;9119;9159;8.30;0.50;270.91;6.90;911;62;3146.00;40
8212;60;625541383;8212;278;9120;9160;8.19;0.50;270.97;6.90;908;62;3147.00;40
8213;60;625541397;8213;287;9123;9164;8.10;0.49;271.01;6.90;910;62;3148.00;41
8217;60;625541409;8217;287;9123;9164;8.07;0.49;271.13;6.90;906;62;3149.00;41
8220;60;625541422;8220;283;9126;9170;8.06;0.49;271.11;6.90;906;62;3150.00;44
8223;60;625541435;8223;281;9126;9170;8.07;0.49;271.15;6.90;903;62;3151.00;44
8226;60;625541447;8226;279;9127;9170;8.13;0.49;271.15;6.90;901;62;3152.00;43
8229;60;625541460;8229;277;9127;9170;8.15;0.50;271.16;6.90;898;62;3153.00;43
8233;60;625541472;8233;272;9131;9174;8.22;0.50;271.21;6.92;898;62;3154.00;43
8237;60;625541485;8237;260;9131;9174;8.25;0.50;271.24;6.92;894;62;3155.00;43
8239;60;625541497;8239;257;9132;9174;8.29;0.50;271.24;6.92;893;62;3156.00;42
8244;60;625541508;8244;250;9132;9174;8.19;0.50;271.25;6.92;888;62;3157.00;42
8246;60;625541520;8246;250;9133;9175;8.21;0.50;271.29;6.92;887;62;3158.00;42
8250;60;625541532;8250;241;9134;9176;8.26;0.50;271.30;6.92;884;62;3159.00;42
8253;60;625541544;8253;235;9135;9176;8.25;0.50;271.33;6.92;882;62;3160.00;41
8255;60;625541556;8255;230;9136;9177;8.27;0.50;271.32;6.92;881;62;3161.00;41
8260;60;625541567;8260;214;9136;9177;8.25;0.50;271.36;6.92;876;62;3162.00;41
8265;60;625541579;8265;205;9136;9177;8.23;0.50;271.48;6.92;871;62;3163.00;41
8268;60;625541591;8268;197;9137;9177;8.24;0.50;271.45;6.94;869;62;3164.00;40
8273;60;625541604;8273;192;9137;9177;8.27;0.50;271.43;6.94;864;62;3165.00;40
8275;60;625541617;8275;185;9138;9177;8.32;0.51;271.43;6.95;863;62;3166.00;39
8280;60;625541629;8280;177;9138;9177;8.31;0.50;271.42;6.95;858;62;3167.00;39
8282;60;625541641;8282;198;9206;9304;8.26;0.51;271.48;6.90;924;62;3168.00;98
8286;60;625541664;8286;180;9207;9305;8.23;0.51;271.48;6.93;921;62;3169.00;98
8290;60;625541677;8290;167;9215;9305;8.27;0.51;271.48;6.92;925;62;3170.00;90
8292;60;625541689;8292;167;9218;9305;8.29;0.51;271.52;6.92;926;62;3171.00;87
8295;60;625541701;8295;169;9222;9305;8.39;0.51;271.50;6.92;927;62;3172.00;83
8296;60;625541714;8296;168;9225;9305;8.47;0.52;271.51;6.95;929;62;3173.00;80
8299;60;625541726;8299;168;9229;9305;8.58;0.53;271.49;6.95;930;62;3174.00;76
8303;60;625541738;8303;168;9234;9305;8.58;0.52;271.48;6.98;931;62;3175.00;71
8305;60;625541750;8305;166;9238;9306;8.67;0.53;271.52;6.98;933;62;3176.00;68
8307;60;625541762;8307;169;9242;9307;8.75;0.53;271.59;6.98;935;62;3177.00;65
8310;60;625541774;8310;174;9249;9307;8.85;0.54;271.62;7.02;939;62;3178.00;58
8315;60;625541787;8315;180;9251;9308;8.84;0.54;271.70;7.02;936;62;3179.00;57
8316;60;625541802;8316;179;9255;9308;8.84;0.54;271.70;7.02;939;62;3180.00;53
8320;60;625541815;8320;189;9256;9308;8.83;0.54;271.79;7.02;936;62;3181.00;52
8320;60;625541828;8320;188;9258;9308;8.79;0.54;271.79;7.02;938;62;3182.00;50
8324;60;625541840;8324;195;9262;9312;8.76;0.54;271.93;7.02;938;62;3183.00;50
8329;60;625541853;8329;202;9263;9312;8.72;0.53;271.99;7.02;934;62;3184.00;49
8334;60;625541866;8334;206;9263;9312;8.67;0.53;272.02;7.02;929;62;3185.00;49
8337;60;625541879;8337;210;9267;9315;8.68;0.53;272.10;7.03;930;62;3186.00;48
8339;60;625541898;8339;217;9267;9315;8.67;0.53;272.16;7.03;928;62;3187.00;48
8343;60;625541911;8343;218;9268;9315;8.71;0.53;272.24;7.03;925;62;3188.00;47
8345;60;625541924;8345;222;9272;9319;8.76;0.53;272.30;7.03;927;62;3189.00;47
8348;60;625541938;8348;222;9274;9320;8.79;0.53;272.31;7.04;926;62;3190.00;46
8350;60;625541951;8350;229;9276;9322;8.77;0.53;272.34;7.06;926;62;3191.00;46
8352;60;625541972;8352;231;9282;9326;8.78;0.53;272.38;7.06;930;62;3192.00;44
8356;60;625541984;8356;230;9283;9326;8.77;0.53;272.41;7.08;927;62;3193.00;43
8360;60;625542005;8360;232;9283;9326;8.78;0.53;272.42;7.08;923;62;3194.00;43
8362;60;625542027;8362;231;9286;9328;8.85;0.54;272.46;7.09;924;62;3195.00;42
8364;60;625542040;8364;236;9287;9328;8.88;0.54;272.49;7.10;923;62;3196.00;41
8366;60;625542052;8366;233;9292;9334;8.84;0.54;272.53;7.10;926;62;3197.00;42
8368;60;625542066;8368;238;9294;9334;8.69;0.53;272.57;7.12;926;62;3198.00;40
8369;60;625542078;8369;243;9295;9335;8.59;0.52;272.59;7.12;926;62;3199.00;40
8371;60;625542092;8371;257;9296;9335;8.46;0.52;272.57;7.13;925;62;3200.00;39
8373;60;625542115;8373;254;9297;9335;8.42;0.51;272.57;7.14;924;62;3201.00;38
8373;60;625542128;8373;250;9297;9335;8.44;0.52;272.57;7.14;924;62;3202.00;38
8380;60;625542140;8380;255;9298;9335;8.35;0.51;272.65;7.14;918;62;3203.00;37
8381;60;625542152;8381;265;9307;9347;8.35;0.51;272.67;7.14;926;62;3204.00;40
8383;60;625542164;8383;260;9310;9347;8.33;0.51;272.69;7.18;927;62;3205.00;37
8387;60;625542176;8387;264;9312;9347;8.35;0.51;272.67;7.17;925;62;3206.00;35
8390;61;625542189;8390;262;9312;9347;8.34;0.51;272.69;7.17;922;63;3207.00;35
8392;61;625542212;8392;271;9314;9347;8.27;0.51;272.76;7.20;922;63;3208.00;33
8394;61;625542224;8394;267;9314;9347;8.27;0.51;272.81;7.20;920;63;3209.00;33
8397;61;625542237;8397;270;9317;9351;8.22;0.50;272.86;7.20;920;63;3210.00;34
8400;61;625542250;8400;273;9319;9351;8.16;0.50;272.89;7.22;919;63;3211.00;32
8401;61;625542261;8401;277;9323;9355;8.23;0.50;272.90;7.22;922;63;3212.00;32
8404;61;625542272;8404;281;9325;9356;8.18;0.50;272.93;7.23;921;63;3213.00;31
8406;61;625542283;8406;283;9326;9356;8.09;0.49;272.94;7.23;920;63;3214.00;30
8409;61;625542298;8409;288;9326;9356;7.99;0.49;272.98;7.23;917;63;3215.00;30
8411;61;625542309;8411;288;9335;9369;7.95;0.49;273.00;7.23;924;63;3216.00;34
8412;61;625542322;8412;288;9340;9369;7.91;0.48;273.03;7.26;928;63;3217.00;29
8414;61;625542332;8414;297;9341;9369;7.90;0.48;273.04;7.26;927;63;3218.00;28
8417;61;625542343;8417;294;9344;9370;7.91;0.48;273.02;7.27;927;63;3219.00;26
8420;61;625542354;8420;300;9345;9371;7.84;0.48;272.98;7.27;925;63;3220.00;26
8424;61;625542364;8424;306;9345;9371;7.76;0.47;272.97;7.27;921;63;3221.00;26
8426;61;625542375;8426;308;9348;9374;7.70;0.47;273.02;7.28;922;63;3222.00;26
8428;61;625542385;8428;312;9348;9374;7.59;0.46;273.06;7.28;920;63;3223.00;26
8430;61;625542395;8430;314;9351;9374;7.52;0.46;273.04;7.29;921;63;3224.00;23
8436;61;625542405;8436;315;9351;9374;7.45;0.46;273.07;7.29;915;63;3225.00;23
8441;61;625542415;8441;327;9355;9380;7.41;0.45;273.06;7.28;914;63;3226.00;25
8446;61;625542426;8446;333;9360;9380;7.22;0.44;273.03;7.30;914;63;3227.00;20
8447;61;625542436;8447;339;9360;9380;7.11;0.44;273.02;7.30;913;63;3228.00;20
8453;61;625542445;8453;346;9360;9380;6.86;0.42;272.97;7.30;907;63;3229.00;20
8455;61;625542455;8455;342;9365;9384;6.71;0.41;272.99;7.31;910;63;3230.00;19
8460;61;625542466;8460;334;9366;9385;6.58;0.40;273.04;7.31;906;63;3231.00;19
8462;61;625542476;8462;336;9366;9385;6.49;0.40;273.07;7.31;904;63;3232.00;19
8466;61;625542485;8466;333;9369;9386;6.36;0.39;273.07;7.31;903;63;3233.00;17
8467;61;625542495;8467;333;9369;9386;6.26;0.38;273.08;7.31;902;63;3234.00;17
8472;61;625542505;8472;329;9369;9386;6.18;0.38;273.05;7.31;897;63;3235.00;17
8477;61;625542514;8477;329;9371;9386;6.17;0.38;272.97;7.31;894;63;3236.00;15
8479;61;625542524;8479;336;9371;9386;6.16;0.38;272.99;7.31;892;63;3237.00;15
8482;61;625542533;8482;338;9373;9386;6.14;0.38;272.97;7.32;891;63;3238.00;13
8486;61;625542543;8486;341;9373;9386;6.09;0.37;272.96;7.32;887;63;3239.00;13
8486;61;625542554;8486;345;9431;9511;6.37;0.40;272.96;7.27;945;63;3240.00;80
8491;61;625542572;8491;339;9436;9512;6.29;0.39;272.88;7.27;945;63;3241.00;76
8494;61;625542582;8494;343;9447;9512;6.32;0.39;272.89;7.26;953;63;3242.00;65
8497;61;625542593;8497;337;9451;9512;6.30;0.39;272.86;7.26;954;63;3243.00;61
8498;61;625542603;8498;337;9455;9512;6.31;0.39;272.85;7.26;957;63;3244.00;57
8501;61;625542613;8501;342;9459;9512;6.27;0.39;272.91;7.26;958;63;3245.00;53
8504;61;625542623;8504;345;9463;9512;6.26;0.39;272.88;7.26;959;63;3246.00;49
8508;61;625542633;8508;354;9465;9512;6.20;0.38;272.88;7.26;957;63;3247.00;47
8510;61;625542645;8510;352;9469;9513;6.22;0.38;272.89;7.26;959;63;3248.00;44
8515;61;625542655;8515;357;9471;9514;6.26;0.39;272.96;7.26;956;63;3249.00;43
8518;61;625542667;8518;361;9473;9514;6.23;0.38;272.97;7.26;955;63;3250.00;41
8520;61;625542677;8520;367;9476;9518;6.21;0.38;272.97;7.25;956;63;3251.00;42
8522;61;625542688;8522;365;9478;9518;6.13;0.38;272.93;7.26;956;63;3252.00;40
8525;61;625542698;8525;376;9479;9518;6.05;0.37;272.90;7.26;954;63;3253.00;39
8528;61;625542709;8528;376;9481;9518;5.95;0.37;272.89;7.26;953;63;3254.00;37
8530;61;625542721;8530;383;9485;9524;5.93;0.37;272.87;7.26;955;63;3255.00;39
8534;61;625542731;8534;379;9485;9524;5.88;0.36;272.86;7.26;951;63;3256.00;39
8538;61;625542742;8538;386;9488;9524;5.79;0.36;272.90;7.29;950;63;3257.00;36
8541;61;625542754;8541;388;9491;9527;5.76;0.35;272.88;7.29;950;63;3258.00;36
8543;61;625542765;8543;377;9491;9527;5.78;0.36;272.91;7.29;948;63;3259.00;36
8548;61;625542776;8548;370;9492;9527;5.74;0.35;272.88;7.29;944;63;3260.00;35
8550;61;625542787;8550;371;9492;9528;5.77;0.36;272.88;7.29;942;63;3261.00;36
8556;61;625542798;8556;360;9493;9529;5.83;0.36;272.89;7.29;937;63;3262.00;36
8558;61;625542809;8558;357;9493;9529;5.87;0.36;272.90;7.29;935;63;3263.00;36
8560;61;625542820;8560;352;9504;9542;6.02;0.37;272.89;7.28;944;63;3264.00;38
8563;61;625542832;8563;349;9504;9542;6.06;0.37;272.90;7.28;941;63;3265.00;38
8567;61;625542849;8567;350;9504;9542;6.15;0.38;272.88;7.28;937;63;3266.00;38
8570;61;625542866;8570;341;9505;9543;6.26;0.38;272.88;7.28;935;63;3267.00;38
8573;61;625542878;8573;333;9505;9543;6.32;0.39;272.91;7.28;932;63;3268.00;38
8575;61;625542895;8575;329;9508;9547;6.41;0.39;272.91;7.27;933;63;3269.00;39
8575;61;625542909;8575;322;9508;9547;6.48;0.40;272.91;7.27;933;63;3270.00;39
8577;61;625542925;8577;330;9512;9551;6.57;0.40;272.87;7.27;935;63;3271.00;39
8583;61;625542937;8583;331;9512;9551;6.57;0.40;272.82;7.27;929;63;3272.00;39
8584;61;625542949;8584;337;9512;9551;6.62;0.40;272.81;7.27;928;63;3273.00;39
8584;61;625542960;8584;336;9512;9551;6.60;0.40;272.81;7.27;928;63;3274.00;39
8586;61;625542972;8586;345;9512;9551;6.61;0.40;272.77;7.27;926;63;3275.00;39
8586;61;625542983;8586;353;9522;9563;6.66;0.41;272.77;7.26;936;63;3276.00;41
8588;61;625542995;8588;354;9522;9563;6.66;0.41;272.76;7.26;934;63;3277.00;41
8589;61;625543008;8589;353;9523;9563;6.72;0.41;272.75;7.26;934;63;3278.00;40
8593;61;625543019;8593;349;9523;9563;6.78;0.41;272.74;7.26;930;63;3279.00;40
8596;61;625543031;8596;351;9523;9563;6.85;0.42;272.77;7.26;927;63;3280.00;40
8597;61;625543043;8597;350;9523;9563;6.89;0.42;272.81;7.26;926;63;3281.00;40
8602;61;625543055;8602;352;9524;9564;6.88;0.42;272.88;7.29;922;63;3282.00;40
8604;61;625543073;8604;349;9524;9564;6.90;0.42;272.85;7.29;920;63;3283.00;40
8606;61;625543085;8606;347;9528;9570;6.92;0.42;272.86;7.29;922;63;3284.00;42
8608;61;625543098;8608;349;9531;9572;6.93;0.42;272.86;7.32;923;63;3285.00;41
8610;61;625543115;8610;339;9532;9572;6.98;0.42;272.90;7.31;922;63;3286.00;40
8612;61;625543128;8612;327;9532;9572;7.00;0.43;272.97;7.31;920;63;3287.00;40
8613;61;625543139;8613;319;9535;9576;7.07;0.43;273.01;7.31;922;63;3288.00;41
8615;61;625543156;8615;310;9535;9576;7.15;0.43;273.06;7.31;920;63;3289.00;41
8619;61;625543168;8619;299;9535;9576;7.20;0.44;273.12;7.31;916;63;3290.00;41
8621;61;625543181;8621;298;9536;9577;7.25;0.44;273.15;7.31;915;63;3291.00;41
8627;61;625543198;8627;293;9539;9581;7.31;0.44;273.17;7.31;912;63;3292.00;42
8629;61;625543227;8629;296;9539;9581;7.35;0.45;273.17;7.31;910;63;3293.00;42
8630;61;625543248;8630;297;9541;9584;7.43;0.45;273.21;7.31;911;63;3294.00;43
8632;61;625543266;8632;302;9541;9584;7.49;0.46;273.22;7.31;909;63;3295.00;43
8633;61;625543285;8633;301;9542;9584;7.53;0.46;273.24;7.31;909;63;3296.00;42
8635;61;625543300;8635;301;9542;9584;7.62;0.46;273.22;7.31;907;63;3297.00;42
8636;61;625543316;8636;303;9545;9588;7.71;0.47;273.20;7.31;909;63;3298.00;43
8639;61;625543330;8639;302;9545;9588;7.73;0.47;273.29;7.31;906;63;3299.00;43
8644;61;625543347;8644;303;9549;9607;7.65;0.47;273.28;7.30;905;63;3300.00;58
8645;61;625543367;8645;303;9549;9607;7.64;0.47;273.31;7.30;904;63;3301.00;58
8647;61;625543380;8647;303;9550;9608;7.61;0.46;273.31;7.30;903;63;3302.00;58
8651;61;625543394;8651;301;9551;9609;7.55;0.46;273.33;7.30;900;63;3303.00;58
8653;61;625543407;8653;303;9551;9609;7.54;0.46;273.36;7.30;898;63;3304.00;58
8654;61;625543419;8654;304;9552;9610;7.62;0.46;273.35;7.30;898;63;3305.00;58
8658;61;625543431;8658;307;9553;9610;7.61;0.46;273.39;7.30;895;63;3306.00;57
8662;61;625543444;8662;304;9553;9610;7.58;0.46;273.40;7.30;891;63;3307.00;57
8663;61;625543456;8663;301;9554;9610;7.55;0.46;273.38;7.30;891;63;3308.00;56
8665;61;625543469;8665;298;9555;9610;7.60;0.46;273.37;7.33;890;63;3309.00;55
8667;61;625543482;8667;300;9555;9610;7.63;0.47;273.38;7.33;888;63;3310.00;55
8671;61;625543496;8671;298;9555;9610;7.61;0.46;273.40;7.33;884;63;3311.00;55
8674;61;625543508;8674;315;9618;9737;7.73;0.48;273.57;7.28;944;63;3312.00;119
8676;61;625543531;8676;304;9624;9738;7.73;0.48;273.61;7.28;948;63;3313.00;114
8680;61;625543545;8680;294;9630;9738;7.78;0.48;273.71;7.28;950;63;3314.00;108
8683;61;625543557;8683;296;9634;9738;7.85;0.48;273.78;7.28;951;63;3315.00;104
8685;61;625543569;8685;290;9636;9738;7.85;0.48;273.81;7.28;951;63;3316.00;102
8686;61;625543582;8686;295;9638;9738;7.85;0.48;273.81;7.27;952;63;3317.00;100
8689;61;625543594;8689;295;9642;9738;7.83;0.48;273.86;7.28;953;63;3318.00;96
8690;61;625543606;8690;302;9645;9738;7.81;0.48;273.84;7.28;955;63;3319.00;93
8692;61;625543619;8692;298;9647;9739;7.80;0.48;273.87;7.28;955;63;3320.00;92
8695;61;625543631;8695;289;9649;9740;7.75;0.48;273.90;7.28;954;63;3321.00;91
8698;61;625543650;8698;287;9651;9740;7.72;0.47;273.91;7.28;953;63;3322.00;89
8702;61;625543663;8702;291;9655;9741;7.67;0.47;273.90;7.28;953;63;3323.00;86
8703;61;625543677;8703;292;9659;9741;7.64;0.47;273.89;7.31;956;63;3324.00;82
8708;61;625543690;8708;291;9661;9741;7.62;0.47;273.91;7.31;953;63;3325.00;80
8709;61;625543703;8709;296;9663;9741;7.60;0.46;273.91;7.31;954;63;3326.00;78
8709;61;625543715;8709;295;9665;9745;7.64;0.47;273.91;7.34;956;63;3327.00;80
8714;61;625543728;8714;305;9667;9745;7.61;0.46;273.95;7.34;953;63;3328.00;78
8716;61;625543741;8716;303;9669;9745;7.61;0.46;273.94;7.34;953;63;3329.00;76
8721;61;625543755;8721;303;9674;9751;7.57;0.46;274.02;7.37;953;63;3330.00;77
8723;61;625543770;8723;291;9675;9751;7.55;0.46;274.02;7.37;952;63;3331.00;76
8726;61;625543782;8726;287;9676;9751;7.50;0.46;274.02;7.37;950;63;3332.00;75
8727;61;625543795;8727;281;9683;9755;7.43;0.45;274.05;7.39;956;63;3333.00;72
8730;62;625543808;8730;274;9684;9756;7.39;0.45;274.05;7.39;954;64;3334.00;72
8731;62;625543835;8731;275;9689;9756;7.39;0.45;274.10;7.44;958;64;3335.00;67
8733;62;625543850;8733;268;9691;9760;7.40;0.45;274.09;7.44;958;64;3336.00;69
8740;62;625543864;8740;275;9692;9760;7.38;0.45;274.10;7.45;952;64;3337.00;68
8743;62;625543877;8743;268;9693;9760;7.43;0.45;274.19;7.45;950;64;3338.00;67
8747;62;625543890;8747;261;9695;9761;7.47;0.45;274.18;7.46;948;64;3339.00;66
8752;62;625543903;8752;257;9697;9761;7.47;0.45;274.19;7.47;945;64;3340.00;64
8755;62;625543916;8755;252;9701;9767;7.49;0.45;274.27;7.48;946;64;3341.00;66
8756;62;625543930;8756;255;9702;9767;7.51;0.46;274.25;7.48;946;64;3342.00;65
8758;62;625543943;8758;251;9705;9768;7.51;0.46;274.28;7.50;947;64;3343.00;63
8761;62;625543962;8761;252;9705;9768;7.52;0.46;274.29;7.50;944;64;3344.00;63
8763;62;625543977;8763;241;9707;9768;7.56;0.46;274.28;7.51;944;64;3345.00;61
8764;62;625543990;8764;237;9708;9768;7.61;0.46;274.25;7.51;944;64;3346.00;60
8766;62;625544003;8766;239;9708;9768;7.66;0.46;274.24;7.51;942;64;3347.00;60
8768;62;625544015;8768;243;9717;9780;7.70;0.47;274.23;7.51;949;64;3348.00;63
8770;62;625544029;8770;249;9719;9780;7.77;0.47;274.24;7.51;949;64;3349.00;61
8774;62;625544042;8774;248;9724;9780;7.68;0.47;274.20;7.52;950;64;3350.00;56
8776;62;625544055;8776;249;9728;9780;7.65;0.46;274.25;7.53;952;64;3351.00;52
8777;62;625544068;8777;251;9730;9780;7.59;0.46;274.24;7.53;953;64;3352.00;50
8782;62;625544080;8782;257;9731;9780;7.52;0.45;274.21;7.53;949;64;3353.00;49
8782;62;625544093;8782;260;9734;9784;7.49;0.45;274.21;7.53;952;64;3354.00;50
8786;62;625544106;8786;262;9735;9784;7.50;0.45;274.20;7.53;949;64;3355.00;49
8788;62;625544118;8788;269;9738;9788;7.54;0.46;274.24;7.53;950;64;3356.00;50
8789;62;625544132;8789;270;9739;9789;7.62;0.46;274.26;7.53;950;64;3357.00;50
8791;62;625544144;8791;269;9740;9789;7.66;0.46;274.24;7.53;949;64;3358.00;49
8794;62;625544156;8794;280;9741;9789;7.69;0.46;274.23;7.54;947;64;3359.00;48
8797;62;625544170;8797;289;9760;9818;7.67;0.46;274.25;7.54;963;64;3360.00;58
8800;62;625544187;8800;291;9761;9818;7.69;0.46;274.40;7.54;961;64;3361.00;57
8801;62;625544201;8801;290;9764;9818;7.71;0.47;274.43;7.55;963;64;3362.00;54
8803;62;625544214;8803;301;9769;9819;7.74;0.47;274.48;7.56;966;64;3363.00;50
8806;62;625544227;8806;306;9770;9820;7.66;0.46;274.53;7.56;964;64;3364.00;50
8808;62;625544241;8808;311;9771;9820;7.62;0.46;274.55;7.57;963;64;3365.00;49
8810;62;625544254;8810;316;9775;9823;7.59;0.46;274.59;7.58;965;64;3366.00;48
8811;62;625544269;8811;324;9775;9823;7.58;0.46;274.60;7.58;964;64;3367.00;48
8815;62;625544281;8815;328;9776;9823;7.54;0.46;274.63;7.59;961;64;3368.00;47
8817;63;625544293;8817;333;9777;9823;7.50;0.46;274.69;7.60;960;65;3369.00;46
8817;63;625544324;8817;333;9783;9829;7.49;0.46;274.69;7.61;966;65;3370.00;46
8818;63;625544337;8818;341;9784;9829;7.46;0.46;274.72;7.62;966;65;3371.00;45
8820;63;625544349;8820;343;9786;9829;7.38;0.45;274.73;7.64;966;65;3372.00;43
8822;63;625544361;8822;340;9788;9829;7.28;0.45;274.70;7.66;966;65;3373.00;41
8824;63;625544373;8824;346;9792;9833;7.19;0.44;274.67;7.67;968;65;3374.00;41
8826;63;625544385;8826;349;9794;9835;7.10;0.44;274.65;7.67;968;65;3375.00;41
8828;63;625544396;8828;356;9796;9835;7.02;0.43;274.68;7.69;968;65;3376.00;39
8829;63;625544407;8829;361;9797;9836;6.94;0.43;274.66;7.69;968;65;3377.00;39
8830;63;625544418;8830;366;9799;9836;6.88;0.42;274.65;7.70;969;65;3378.00;37
8833;63;625544429;8833;373;9799;9836;6.83;0.42;274.60;7.70;966;65;3379.00;37
8835;63;625544440;8835;370;9799;9836;6.78;0.42;274.65;7.70;964;65;3380.00;37
8838;63;625544451;8838;372;9799;9836;6.72;0.41;274.61;7.70;961;65;3381.00;37
8840;63;625544462;8840;369;9799;9836;6.64;0.41;274.56;7.70;959;65;3382.00;37
8843;63;625544473;8843;367;9799;9836;6.57;0.40;274.55;7.70;956;65;3383.00;37
8849;63;625544483;8849;371;9834;9906;6.65;0.41;274.55;7.70;985;65;3384.00;72
8850;63;625544500;8850;369;9834;9907;6.62;0.41;274.53;7.70;984;65;3385.00;73
8854;63;625544511;8854;372;9847;9907;6.69;0.41;274.47;7.70;993;65;3386.00;60
8859;63;625544522;8859;377;9853;9907;6.62;0.41;274.39;7.70;994;65;3387.00;54
8859;63;625544539;8859;385;9859;9907;6.59;0.40;274.39;7.69;1000;65;3388.00;48
8863;63;625544549;8863;386;9860;9907;6.55;0.40;274.31;7.69;997;65;3389.00;47
8863;63;625544562;8863;390;9863;9907;6.53;0.40;274.31;7.69;1000;65;3390.00;44
8865;63;625544572;8865;395;9864;9907;6.51;0.40;274.28;7.69;999;65;3391.00;43
8869;63;625544583;8869;405;9874;9908;6.41;0.39;274.30;7.74;1005;65;3392.00;34
8869;63;625544594;8869;407;9876;9909;6.36;0.39;274.30;7.74;1007;65;3393.00;33
8876;63;625544605;8876;404;9880;9909;6.30;0.38;274.28;7.75;1004;65;3394.00;29
8877;63;625544617;8877;410;9885;9913;6.22;0.38;274.28;7.76;1008;65;3395.00;28
8881;63;625544627;8881;416;9885;9913;6.13;0.37;274.22;7.76;1004;65;3396.00;28
8884;63;625544638;8884;432;9887;9913;6.03;0.37;274.25;7.76;1003;65;3397.00;26
8887;63;625544649;8887;441;9887;9913;5.89;0.36;274.22;7.76;1000;65;3398.00;26
8890;63;625544660;8890;446;9891;9919;5.78;0.35;274.23;7.76;1001;65;3399.00;28
8891;63;625544671;8891;439;9892;9919;5.71;0.35;274.24;7.77;1001;65;3400.00;27
8893;63;625544686;8893;442;9893;9919;5.65;0.35;274.23;7.77;1000;65;3401.00;26
8898;63;625544696;8898;443;9896;9922;5.58;0.34;274.21;7.77;998;65;3402.00;26
8898;63;625544708;8898;444;9896;9922;5.54;0.34;274.21;7.77;998;65;3403.00;26
8900;63;625544718;8900;450;9896;9922;5.48;0.34;274.24;7.77;996;65;3404.00;26
8903;63;625544728;8903;451;9898;9923;5.39;0.33;274.23;7.78;995;65;3405.00;25
8906;63;625544739;8906;456;9899;9924;5.37;0.33;274.27;7.77;993;65;3406.00;25
8909;63;625544750;8909;457;9899;9924;5.32;0.33;274.24;7.77;990;65;3407.00;25
8911;63;625544760;8911;451;9911;9937;5.42;0.33;274.27;7.77;1000;65;3408.00;26
8912;63;625544772;8912;455;9911;9937;5.45;0.34;274.25;7.77;999;65;3409.00;26
8917;63;625544783;8917;457;9912;9937;5.49;0.34;274.20;7.77;995;65;3410.00;25
8920;63;625544793;8920;429;9914;9938;5.54;0.34;274.20;7.79;994;65;3411.00;24
8925;63;625544804;8925;412;9914;9938;5.62;0.34;274.19;7.79;989;65;3412.00;24
8929;63;625544816;8929;405;9917;9942;5.68;0.35;274.22;7.78;988;65;3413.00;25
8932;63;625544828;8932;399;9917;9942;5.75;0.35;274.24;7.78;985;65;3414.00;25
8936;63;625544839;8936;399;9921;9946;5.84;0.36;274.23;7.78;985;65;3415.00;25
8941;63;625544851;8941;384;9921;9946;5.88;0.36;274.22;7.78;980;65;3416.00;25
8941;63;625544863;8941;380;9921;9946;5.93;0.36;274.22;7.78;980;65;3417.00;25
8943;63;625544880;8943;377;9921;9946;5.98;0.37;274.24;7.78;978;65;3418.00;25
8945;63;625544891;8945;368;9921;9946;6.06;0.37;274.23;7.78;976;65;3419.00;25
8947;63;625544904;8947;367;9946;9980;6.31;0.39;274.25;7.76;999;65;3420.00;34
8949;63;625544918;8949;362;9948;9980;6.42;0.39;274.26;7.76;999;65;3421.00;32
8950;63;625544930;8950;352;9948;9980;6.52;0.40;274.27;7.76;998;65;3422.00;32
8953;63;625544942;8953;346;9949;9980;6.58;0.40;274.27;7.76;996;65;3423.00;31
8955;63;625544954;8955;340;9949;9980;6.63;0.41;274.21;7.76;994;65;3424.00;31
8960;63;625544966;8960;339;9950;9980;6.61;0.41;274.22;7.76;990;65;3425.00;30
8960;63;625544979;8960;337;9950;9981;6.66;0.41;274.22;7.76;990;65;3426.00;31
8964;63;625544991;8964;345;9950;9981;6.65;0.41;274.23;7.76;986;65;3427.00;31
8964;63;625545003;8964;349;9954;9987;6.70;0.41;274.23;7.76;990;65;3428.00;33
8968;63;625545016;8968;355;9955;9988;6.71;0.41;274.20;7.76;987;65;3429.00;33
8972;63;625545028;8972;353;9956;9988;6.76;0.42;274.27;7.76;984;65;3430.00;32
8976;63;625545040;8976;352;9956;9988;6.79;0.42;274.39;7.76;980;65;3431.00;32
8983;63;625545053;8983;355;9959;9992;6.81;0.42;274.37;7.75;976;65;3432.00;33
8988;63;625545065;8988;354;9959;9992;6.84;0.42;274.41;7.75;971;65;3433.00;33
8992;63;625545078;8992;349;9959;9992;6.87;0.42;274.41;7.75;967;65;3434.00;33
8995;63;625545090;8995;348;9960;9993;6.85;0.42;274.47;7.75;965;65;3435.00;33
8996;63;625545107;8996;346;9963;9997;6.90;0.42;274.49;7.75;967;65;3436.00;34
9003;63;625545120;9003;343;9963;9997;6.85;0.42;274.46;7.75;960;65;3437.00;34
9006;63;625545131;9006;346;9965;10000;6.92;0.42;274.50;7.75;959;65;3438.00;35
9009;63;625545144;9009;348;9966;10000;6.94;0.42;274.59;7.75;957;65;3439.00;34
9011;63;625545155;9011;344;9966;10000;6.94;0.42;274.58;7.75;955;65;3440.00;34
9018;63;625545168;9018;346;9966;10000;6.84;0.42;274.64;7.75;948;65;3441.00;34
9020;63;625545180;9020;340;9970;10004;6.82;0.42;274.72;7.77;950;65;3442.00;34
9022;63;625545203;9022;344;9971;10004;6.76;0.41;274.71;7.77;949;65;3443.00;33
9024;63;625545224;9024;347;9971;10004;6.70;0.41;274.75;7.77;947;65;3444.00;33
9028;63;625545244;9028;352;9971;10004;6.64;0.40;274.76;7.77;943;65;3445.00;33
9030;63;625545263;9030;351;9971;10005;6.54;0.40;274.83;7.77;941;65;3446.00;34
9033;63;625545284;9033;343;9972;10006;6.54;0.40;274.80;7.76;939;65;3447.00;34
9034;63;625545300;9034;335;9972;10006;6.57;0.40;274.84;7.76;938;65;3448.00;34
9038;63;625545316;9038;329;9973;10007;6.58;0.40;274.94;7.76;935;65;3449.00;34
9040;63;625545333;9040;320;9973;10007;6.61;0.40;274.99;7.76;933;65;3450.00;34
9042;63;625545347;9042;324;9973;10007;6.66;0.40;275.04;7.76;931;65;3451.00;34
9046;63;625545360;9046;319;9973;10007;6.64;0.40;275.10;7.76;927;65;3452.00;34
9046;63;625545374;9046;321;9973;10007;6.70;0.41;275.10;7.76;927;65;3453.00;34
9050;63;625545388;9050;315;9973;10007;6.68;0.41;275.37;7.76;923;65;3454.00;34
9055;63;625545401;9055;315;9973;10007;6.67;0.41;275.38;7.76;918;65;3455.00;34
9057;63;625545415;9057;328;10045;10134;6.89;0.43;275.42;7.71;988;65;3456.00;89
9059;63;625545440;9059;304;10047;10135;6.99;0.43;275.47;7.71;988;65;3457.00;88
9062;63;625545454;9062;290;10056;10135;7.21;0.44;275.53;7.70;994;65;3458.00;79
9064;63;625545469;9064;281;10061;10135;7.38;0.45;275.56;7.70;997;65;3459.00;74
9067;63;625545484;9067;272;10066;10135;7.52;0.46;275.59;7.70;999;65;3460.00;69
9069;63;625545498;9069;267;10067;10135;7.64;0.47;275.60;7.70;998;65;3461.00;68
9071;63;625545512;9071;258;10072;10135;7.76;0.48;275.62;7.70;1001;65;3462.00;63
9072;63;625545527;9072;262;10074;10135;7.81;0.48;275.67;7.70;1002;65;3463.00;61
9077;63;625545541;9077;273;10078;10136;7.81;0.48;275.70;7.70;1001;65;3464.00;58
9078;63;625545556;9078;276;10083;10138;7.79;0.48;275.70;7.72;1005;65;3465.00;55
9081;63;625545571;9081;285;10085;10138;7.70;0.47;275.74;7.72;1004;65;3466.00;53
9084;63;625545586;9084;277;10086;10139;7.68;0.47;275.76;7.72;1002;65;3467.00;53
9087;63;625545601;9087;282;10088;10139;7.72;0.47;275.83;7.72;1001;65;3468.00;51
9091;63;625545614;9091;285;10089;10139;7.72;0.47;275.89;7.72;998;65;3469.00;50
9094;63;625545629;9094;286;10091;10139;7.73;0.47;275.95;7.72;997;65;3470.00;48
9098;63;625545643;9098;287;10093;10143;7.70;0.47;275.97;7.72;995;65;3471.00;50
9099;63;625545658;9099;283;10095;10143;7.73;0.47;275.95;7.72;996;65;3472.00;48
9101;63;625545672;9101;285;10096;10143;7.73;0.47;275.97;7.72;995;65;3473.00;47
9101;63;625545691;9101;287;10099;10146;7.75;0.47;275.97;7.72;998;65;3474.00;47
9104;63;625545706;9104;288;10100;10146;7.74;0.47;275.99;7.72;996;65;3475.00;46
9107;63;625545720;9107;285;10101;10146;7.77;0.47;275.97;7.72;994;65;3476.00;45
9111;63;625545735;9111;288;10105;10150;7.73;0.47;276.12;7.72;994;65;3477.00;45
9113;63;625545749;9113;289;10106;10151;7.77;0.47;276.17;7.72;993;65;3478.00;45
9114;63;625545764;9114;290;10106;10151;7.80;0.48;276.16;7.72;992;65;3479.00;45
9117;63;625545779;9117;287;10110;10156;7.83;0.48;276.19;7.71;993;65;3480.00;46
9118;63;625545793;9118;284;10110;10156;7.84;0.48;276.22;7.71;992;65;3481.00;46
9123;63;625545813;9123;291;10110;10156;7.82;0.48;276.30;7.71;987;65;3482.00;46
9127;63;625545827;9127;294;10111;10157;7.85;0.48;276.42;7.71;984;65;3483.00;46
9131;63;625545840;9131;305;10111;10157;7.84;0.48;276.48;7.71;980;65;3484.00;46
9132;63;625545855;9132;307;10115;10163;7.84;0.48;276.55;7.71;983;65;3485.00;48
9135;63;625545868;9135;307;10116;10163;7.79;0.47;276.63;7.71;981;65;3486.00;47
9135;63;625545881;9135;308;10116;10164;7.70;0.47;276.63;7.71;981;65;3487.00;48
9138;63;625545894;9138;315;10116;10164;7.67;0.47;276.63;7.71;978;65;3488.00;48
9140;63;625545907;9140;319;10116;10164;7.61;0.46;276.67;7.71;976;65;3489.00;48
9143;63;625545920;9143;315;10116;10164;7.58;0.46;276.67;7.71;973;65;3490.00;48
9144;63;625545933;9144;302;10116;10164;7.61;0.46;276.67;7.71;972;65;3491.00;48
9146;63;625545946;9146;300;10126;10176;7.69;0.47;276.71;7.70;980;65;3492.00;50
9149;63;625545959;9149;299;10127;10176;7.71;0.47;276.68;7.70;978;65;3493.00;49
9154;63;625545973;9154;295;10127;10176;7.70;0.47;276.66;7.70;973;65;3494.00;49
9156;63;625545986;9156;289;10127;10176;7.71;0.47;276.67;7.70;971;65;3495.00;49
9158;63;625545998;9158;286;10128;10176;7.75;0.47;276.70;7.73;970;65;3496.00;48
9163;63;625546012;9163;277;10128;10176;7.79;0.47;276.79;7.73;965;65;3497.00;48
9167;63;625546025;9167;279;10131;10180;7.82;0.48;276.82;7.72;964;65;3498.00;49
9171;64;625546038;9171;278;10131;10180;7.85;0.48;276.86;7.72;960;66;3499.00;49
9173;64;625546058;9173;268;10134;10184;7.87;0.48;276.89;7.72;961;66;3500.00;50
9175;64;625546076;9175;257;10135;10185;7.83;0.47;276.89;7.72;960;66;3501.00;50
9179;64;625546093;9179;251;10136;10185;7.74;0.47;276.95;7.72;957;66;3502.00;49
9182;64;625546105;9182;247;10136;10185;7.68;0.46;276.98;7.72;954;66;3503.00;49
9185;64;625546117;9185;238;10146;10198;7.62;0.46;276.93;7.71;961;66;3504.00;52
9188;64;625546130;9188;233;10147;10198;7.55;0.46;277.03;7.73;959;66;3505.00;51
9193;64;625546144;9193;226;10147;10198;7.54;0.46;277.14;7.73;954;66;3506.00;51
9195;64;625546157;9195;221;10148;10199;7.59;0.46;277.15;7.73;953;66;3507.00;51
9199;64;625546169;9199;225;10148;10200;7.63;0.46;277.20;7.73;949;66;3508.00;52
9200;64;625546182;9200;216;10148;10200;7.61;0.46;277.22;7.73;948;66;3509.00;52
9204;64;625546196;9204;215;10151;10206;7.59;0.46;277.22;7.72;947;66;3510.00;55
9209;64;625546231;9209;209;10153;10206;7.57;0.46;277.23;7.75;944;66;3511.00;53
9211;64;625546243;9211;216;10154;10206;7.56;0.46;277.24;7.75;943;66;3512.00;52
9215;64;625546255;9215;214;10154;10206;7.50;0.45;277.29;7.75;939;66;3513.00;52
9216;64;625546266;9216;215;10158;10212;7.48;0.45;277.32;7.75;942;66;3514.00;54
9219;64;625546278;9219;219;10159;10212;7.48;0.45;277.31;7.75;940;66;3515.00;53
9220;64;625546290;9220;220;10160;10212;7.47;0.45;277.30;7.75;940;66;3516.00;52
9223;64;625546302;9223;219;10161;10212;7.46;0.45;277.31;7.75;938;66;3517.00;51
9228;64;625546313;9228;223;10165;10216;7.41;0.45;277.40;7.77;937;66;3518.00;51
9229;64;625546325;9229;229;10167;10219;7.42;0.45;277.46;7.77;938;66;3519.00;52
9233;64;625546336;9233;231;10168;10219;7.37;0.45;277.48;7.77;935;66;3520.00;51
9234;64;625546348;9234;236;10171;10220;7.29;0.44;277.50;7.81;937;66;3521.00;49
9236;64;625546359;9236;242;10171;10220;7.20;0.44;277.51;7.81;935;66;3522.00;49
9236;64;625546371;9236;243;10171;10220;7.24;0.44;277.51;7.81;935;66;3523.00;49
9239;64;625546382;9239;251;10171;10220;7.26;0.44;277.53;7.81;932;66;3524.00;49
9240;64;625546394;9240;254;10172;10220;7.26;0.44;277.54;7.82;932;66;3525.00;48
9241;64;625546405;9241;255;10172;10220;7.25;0.44;277.52;7.82;931;66;3526.00;48
9241;64;625546416;9241;264;10172;10220;7.25;0.44;277.52;7.82;931;66;3527.00;48
9243;64;625546427;9243;274;10209;10290;7.45;0.45;277.50;7.80;966;66;3528.00;81
9244;64;625546445;9244;279;10210;10291;7.38;0.45;277.49;7.82;966;66;3529.00;81
9247;64;625546456;9247;279;10219;10291;7.37;0.45;277.45;7.82;972;66;3530.00;72
9247;64;625546468;9247;286;10225;10291;7.36;0.45;277.45;7.82;978;66;3531.00;66
9249;64;625546479;9249;286;10229;10291;7.33;0.45;277.41;7.83;980;66;3532.00;62
9252;64;625546491;9252;294;10235;10291;7.30;0.45;277.46;7.84;983;66;3533.00;56
9254;64;625546503;9254;295;10239;10291;7.30;0.45;277.42;7.85;985;66;3534.00;52
9255;64;625546514;9255;299;10243;10291;7.31;0.45;277.40;7.85;988;66;3535.00;48
9259;64;625546526;9259;299;10246;10292;7.31;0.45;277.37;7.87;987;66;3536.00;46
9261;64;625546543;9261;306;10248;10293;7.31;0.45;277.34;7.87;987;66;3537.00;45
9266;64;625546555;9266;309;10250;10293;7.28;0.45;277.25;7.89;984;66;3538.00;43
9268;64;625546567;9268;310;10253;10297;7.20;0.44;277.24;7.89;985;66;3539.00;44
9271;64;625546581;9271;311;10254;10297;7.12;0.44;277.24;7.90;983;66;3540.00;43
9273;64;625546593;9273;323;10255;10297;7.02;0.43;277.23;7.91;982;66;3541.00;42
9274;64;625546604;9274;326;10257;10297;6.88;0.42;277.22;7.93;983;66;3542.00;40
9274;64;625546615;9274;337;10262;10303;6.84;0.42;277.22;7.93;988;66;3543.00;41
9278;64;625546627;9278;343;10262;10303;6.73;0.41;277.24;7.93;984;66;3544.00;41
9278;64;625546638;9278;355;10263;10303;6.71;0.41;277.24;7.93;985;66;3545.00;40
9283;64;625546649;9283;359;10267;10306;6.65;0.41;277.23;7.94;984;66;3546.00;39
9283;64;625546661;9283;362;10268;10306;6.55;0.40;277.23;7.95;985;66;3547.00;38
9285;64;625546671;9285;368;10272;10306;6.47;0.40;277.23;7.99;987;66;3548.00;34
9286;64;625546682;9286;372;10272;10307;6.33;0.39;277.21;7.99;986;66;3549.00;35
9289;64;625546692;9289;382;10275;10308;6.18;0.38;277.15;8.00;986;66;3550.00;33
9290;64;625546703;9290;378;10275;10308;6.08;0.37;277.14;8.00;985;66;3551.00;33
9293;64;625546713;9293;375;10288;10321;6.02;0.37;277.11;8.00;995;66;3552.00;33
9295;64;625546725;9295;381;10288;10321;5.95;0.36;277.07;8.00;993;66;3553.00;33
9298;64;625546736;9298;389;10288;10321;5.88;0.36;277.03;8.00;990;66;3554.00;33
9299;64;625546752;9299;384;10291;10323;5.88;0.36;277.00;8.00;992;66;3555.00;32
9299;64;625546762;9299;388;10292;10323;5.90;0.36;277.00;8.00;993;66;3556.00;31
9299;64;625546772;9299;390;10296;10327;5.97;0.36;277.00;8.01;997;66;3557.00;31
9300;64;625546783;9300;389;10296;10327;5.97;0.36;277.00;8.01;996;66;3558.00;31
9303;64;625546794;9303;395;10302;10331;5.96;0.36;276.99;8.03;999;66;3559.00;29
9303;64;625546804;9303;394;10302;10331;5.91;0.36;276.99;8.03;999;66;3560.00;29
9306;64;625546814;9306;404;10304;10331;5.81;0.35;276.96;8.04;998;66;3561.00;27
9309;64;625546830;9309;409;10304;10331;5.69;0.35;276.96;8.04;995;66;3562.00;27
9311;64;625546846;9311;399;10306;10331;5.59;0.34;276.92;8.06;995;66;3563.00;25
9316;64;625546856;9316;389;10316;10343;5.56;0.34;276.93;8.05;1000;66;3564.00;27
9317;64;625546868;9317;378;10316;10343;5.48;0.33;276.93;8.05;999;66;3565.00;27
9320;64;625546878;9320;375;10319;10343;5.48;0.33;276.91;8.06;999;66;3566.00;24
9320;64;625546889;9320;368;10319;10343;5.45;0.33;276.91;8.06;999;66;3567.00;24
9324;64;625546899;9324;376;10320;10343;5.38;0.33;276.90;8.06;996;66;3568.00;23
9326;64;625546909;9326;371;10321;10343;5.33;0.32;276.94;8.07;995;66;3569.00;22
9331;64;625546927;9331;358;10321;10344;5.25;0.32;276.94;8.07;990;66;3570.00;23
9332;64;625546938;9332;349;10323;10344;5.25;0.32;276.92;8.08;991;66;3571.00;21
9336;64;625546948;9336;351;10327;10350;5.27;0.32;276.91;8.07;991;66;3572.00;23
9338;64;625546961;9338;344;10331;10351;5.29;0.32;276.90;8.08;993;66;3573.00;20
9339;64;625546973;9339;343;10331;10351;5.31;0.32;276.87;8.08;992;66;3574.00;20
9342;64;625546985;9342;346;10331;10351;5.33;0.32;276.92;8.08;989;66;3575.00;20
9343;64;625546996;9343;341;10336;10355;5.38;0.33;276.91;8.08;993;66;3576.00;19
9344;64;625547007;9344;341;10336;10355;5.41;0.33;276.91;8.08;992;66;3577.00;19
9347;64;625547018;9347;334;10336;10355;5.49;0.33;276.93;8.08;989;66;3578.00;19
9348;64;625547029;9348;338;10337;10356;5.60;0.34;276.92;8.08;989;66;3579.00;19
9350;64;625547041;9350;340;10340;10360;5.66;0.35;276.95;8.08;990;66;3580.00;20
9351;64;625547053;9351;340;10340;10360;5.76;0.35;276.97;8.08;989;66;3581.00;20
9352;64;625547063;9352;331;10342;10363;5.91;0.36;276.99;8.08;990;66;3582.00;21
9356;64;625547074;9356;319;10343;10363;6.06;0.37;277.03;8.08;987;66;3583.00;20
9359;64;625547086;9359;310;10343;10363;6.20;0.38;277.10;8.08;984;66;3584.00;20
9364;64;625547098;9364;297;10343;10363;6.33;0.39;277.11;8.08;979;66;3585.00;20
9370;64;625547110;9370;296;10346;10367;6.50;0.40;277.17;8.08;976;66;3586.00;21
9373;64;625547123;9373;299;10346;10367;6.62;0.40;277.13;8.08;973;66;3587.00;21
9378;64;625547134;9378;303;10347;10367;6.72;0.41;277.11;8.08;969;66;3588.00;20
9382;64;625547146;9382;296;10347;10367;6.75;0.41;277.19;8.08;965;66;3589.00;20
9385;64;625547159;9385;289;10347;10368;6.83;0.42;277.17;8.08;962;66;3590.00;21
9389;64;625547171;9389;289;10348;10369;6.90;0.42;277.19;8.07;959;66;3591.00;21
9394;64;625547183;9394;283;10348;10369;6.94;0.42;277.23;8.07;954;66;3592.00;21
9398;64;625547201;9398;278;10349;10370;6.95;0.43;277.26;8.07;951;66;3593.00;21
9402;64;625547225;9402;266;10349;10370;6.97;0.43;277.26;8.07;947;66;3594.00;21
9406;64;625547247;9406;263;10349;10370;7.00;0.43;277.30;8.07;943;66;3595.00;21
9410;64;625547265;9410;257;10349;10370;7.02;0.43;277.26;8.07;939;66;3596.00;21
9414;64;625547286;9414;258;10350;10370;7.06;0.43;277.32;8.11;936;66;3597.00;20
9417;64;625547305;9417;255;10350;10370;7.12;0.44;277.34;8.11;933;66;3598.00;20
9419;64;625547319;9419;250;10350;10370;7.21;0.44;277.34;8.11;931;66;3599.00;20
9424;64;625547336;9424;283;10464;10623;7.50;0.47;277.41;8.02;1040;66;3600.00;159
9428;64;625547377;9428;278;10470;10624;7.46;0.47;277.48;8.02;1042;66;3601.00;154
9434;64;625547392;9434;269;10479;10624;7.55;0.47;277.50;8.01;1045;66;3602.00;145
9442;64;625547406;9442;267;10488;10624;7.53;0.47;277.47;8.01;1046;66;3603.00;136
9448;64;625547420;9448;273;10493;10624;7.51;0.47;277.56;8.00;1045;66;3604.00;131
9456;64;625547434;9456;279;10499;10624;7.46;0.46;277.69;8.00;1043;66;3605.00;125
9460;64;625547449;9460;280;10506;10624;7.48;0.46;277.72;8.00;1046;66;3606.00;118
9463;64;625547464;9463;283;10513;10624;7.46;0.46;277.77;8.00;1050;66;3607.00;111
9468;64;625547479;9468;285;10518;10625;7.49;0.47;277.79;8.00;1050;66;3608.00;107
9471;64;625547494;9471;292;10522;10626;7.50;0.47;277.78;8.00;1051;66;3609.00;104
9473;64;625547509;9473;292;10528;10626;7.49;0.47;277.84;8.04;1055;66;3610.00;98
9478;64;625547523;9478;299;10532;10627;7.42;0.46;277.87;8.04;1054;66;3611.00;95
9481;64;625547538;9481;304;10536;10627;7.40;0.46;277.87;8.04;1055;66;3612.00;91
9487;64;625547553;9487;318;10541;10627;7.32;0.45;277.96;8.08;1054;66;3613.00;86
9491;64;625547567;9491;323;10543;10627;7.24;0.45;278.04;8.08;1052;66;3614.00;84
9494;64;625547582;9494;334;10549;10631;7.13;0.44;278.10;8.08;1055;66;3615.00;82
9498;64;625547603;9498;340;10551;10631;7.03;0.43;278.16;8.11;1053;66;3616.00;80
9502;64;625547618;9502;328;10554;10631;6.99;0.43;278.18;8.11;1052;66;3617.00;77
9505;64;625547633;9505;323;10556;10634;7.02;0.43;278.23;8.11;1051;66;3618.00;78
9509;64;625547649;9509;323;10557;10634;7.01;0.43;278.32;8.14;1048;66;3619.00;77
9510;64;625547669;9510;320;10557;10634;7.07;0.43;278.34;8.14;1047;66;3620.00;77
9514;64;625547684;9514;330;10562;10638;7.04;0.43;278.33;8.14;1048;66;3621.00;76
9517;64;625547712;9517;331;10568;10639;7.08;0.43;278.37;8.17;1051;66;3622.00;71
9522;64;625547728;9522;331;10568;10639;7.09;0.43;278.33;8.17;1046;67;3623.00;71
9524;65;625547753;9524;337;10573;10643;7.13;0.44;278.37;8.17;1049;68;3624.00;70
9530;65;625547779;9530;335;10574;10643;7.07;0.43;278.38;8.17;1044;68;3625.00;69
9533;65;625547800;9533;330;10576;10643;7.07;0.43;278.44;8.19;1043;68;3626.00;67
9533;65;625547821;9533;325;10577;10644;7.15;0.44;278.44;8.19;1044;68;3627.00;67
9536;65;625547842;9536;317;10579;10644;7.24;0.44;278.50;8.22;1043;68;3628.00;65
9540;65;625547857;9540;309;10583;10650;7.31;0.45;278.54;8.22;1043;68;3629.00;67
9542;65;625547875;9542;311;10584;10650;7.42;0.45;278.55;8.22;1042;68;3630.00;66
9546;65;625547890;9546;311;10585;10651;7.51;0.46;278.57;8.24;1039;68;3631.00;66
9548;65;625547907;9548;310;10586;10651;7.57;0.46;278.63;8.24;1038;68;3632.00;65
9550;65;625547928;9550;314;10586;10651;7.64;0.47;278.68;8.24;1036;68;3633.00;65
9554;65;625547943;9554;315;10588;10651;7.63;0.46;278.77;8.26;1034;68;3634.00;63
9556;65;625547957;9556;317;10589;10651;7.62;0.46;278.83;8.26;1033;68;3635.00;62
9559;65;625547975;9559;317;10599;10663;7.56;0.46;278.86;8.26;1040;68;3636.00;64
9562;65;625547999;9562;318;10599;10663;7.51;0.46;279.01;8.26;1037;68;3637.00;64
9564;65;625548019;9564;317;10600;10663;7.45;0.45;278.99;8.26;1036;68;3638.00;63
9568;65;625548042;9568;316;10600;10663;7.40;0.45;278.96;8.26;1032;68;3639.00;63
9569;65;625548064;9569;308;10601;10663;7.36;0.45;278.95;8.26;1032;68;3640.00;62
9570;65;625548081;9570;310;10602;10663;7.32;0.45;278.93;8.26;1032;68;3641.00;61
9570;65;625548100;9570;311;10606;10667;7.27;0.44;278.93;8.26;1036;68;3642.00;61
9574;65;625548125;9574;319;10606;10667;7.22;0.44;278.98;8.26;1032;68;3643.00;61
9577;65;625548147;9577;323;10609;10671;7.26;0.44;279.03;8.26;1032;68;3644.00;62
9582;65;625548164;9582;323;10612;10673;7.30;0.45;279.01;8.26;1030;68;3645.00;61
9585;65;625548178;9585;324;10612;10673;7.35;0.45;279.08;8.26;1027;68;3646.00;61
9586;65;625548193;9586;318;10615;10673;7.35;0.45;279.07;8.26;1029;68;3647.00;58
9587;65;625548207;9587;318;10623;10686;7.41;0.45;279.09;8.25;1036;68;3648.00;63
9590;65;625548223;9590;316;10624;10686;7.35;0.45;279.08;8.25;1034;68;3649.00;62
9593;65;625548239;9593;316;10624;10686;7.34;0.45;279.12;8.25;1031;68;3650.00;62
9597;65;625548254;9597;314;10625;10687;7.33;0.45;279.22;8.25;1028;68;3651.00;62
9599;65;625548272;9599;319;10625;10688;7.31;0.45;279.23;8.25;1026;68;3652.00;63
9601;65;625548289;9601;317;10625;10688;7.27;0.45;279.27;8.25;1024;68;3653.00;63
9604;65;625548302;9604;317;10627;10691;7.19;0.44;279.24;8.25;1023;68;3654.00;64
9604;65;625548323;9604;321;10627;10691;7.17;0.44;279.24;8.25;1023;68;3655.00;64
9605;65;625548350;9605;326;10628;10691;7.18;0.44;279.24;8.25;1023;68;3656.00;63
9607;65;625548365;9607;328;10629;10691;7.14;0.44;279.25;8.27;1022;68;3657.00;62
9612;65;625548379;9612;323;10633;10697;7.10;0.44;279.23;8.26;1021;68;3658.00;64
9615;65;625548393;9615;322;10633;10697;7.08;0.43;279.29;8.26;1018;68;3659.00;64
9619;65;625548409;9619;315;10634;10697;7.06;0.43;279.37;8.26;1015;68;3660.00;63
9621;65;625548424;9621;311;10634;10697;7.06;0.43;279.35;8.26;1013;68;3661.00;63
9625;65;625548438;9625;306;10637;10701;6.97;0.42;279.33;8.26;1012;68;3662.00;64
9628;65;625548451;9628;303;10638;10702;6.95;0.42;279.30;8.26;1010;68;3663.00;64
9629;65;625548465;9629;305;10638;10702;6.97;0.43;279.31;8.26;1009;68;3664.00;64
9630;65;625548478;9630;309;10639;10703;6.97;0.43;279.32;8.26;1009;68;3665.00;64
9633;65;625548491;9633;305;10639;10703;6.94;0.42;279.37;8.26;1006;68;3666.00;64
9635;66;625548503;9635;303;10639;10703;6.92;0.42;279.35;8.26;1004;69;3667.00;64
9640;66;625548521;9640;296;10639;10703;6.87;0.42;279.37;8.26;999;69;3668.00;64
9642;66;625548533;9642;301;10640;10703;6.83;0.42;279.37;8.27;998;69;3669.00;63
9642;66;625548544;9642;288;10640;10703;6.81;0.42;279.37;8.27;998;69;3670.00;63
9643;66;625548556;9643;292;10640;10703;6.75;0.41;279.38;8.27;997;69;3671.00;63
9647;66;625548573;9647;293;10669;10773;6.76;0.41;279.43;8.24;1022;69;3672.00;104
9649;66;625548595;9649;291;10670;10774;6.73;0.41;279.44;8.26;1021;69;3673.00;104
9652;66;625548607;9652;286;10678;10774;6.78;0.42;279.42;8.26;1026;69;3674.00;96
9657;66;625548619;9657;283;10682;10774;6.73;0.41;279.48;8.29;1025;69;3675.00;92
9660;66;625548634;9660;281;10689;10774;6.76;0.41;279.53;8.30;1029;69;3676.00;85
9663;66;625548648;9663;275;10691;10774;6.73;0.41;279.57;8.30;1028;69;3677.00;83
9666;66;625548660;9666;270;10694;10774;6.73;0.41;279.52;8.30;1028;69;3678.00;80
9670;67;625548672;9670;273;10697;10774;6.75;0.41;279.48;8.30;1027;70;3679.00;77
9672;67;625548699;9672;273;10699;10775;6.80;0.41;279.44;8.31;1027;70;3680.00;76
9674;67;625548712;9674;257;10703;10776;6.85;0.42;279.41;8.31;1029;70;3681.00;73
9676;67;625548726;9676;252;10705;10776;6.80;0.41;279.39;8.31;1029;70;3682.00;71
9678;67;625548739;9678;252;10709;10780;6.73;0.41;279.34;8.31;1031;70;3683.00;71
9680;67;625548753;9680;242;10709;10780;6.69;0.41;279.30;8.31;1029;70;3684.00;71
9681;67;625548767;9681;257;10710;10780;6.69;0.41;279.29;8.32;1029;70;3685.00;70
9683;67;625548779;9683;253;10710;10780;6.71;0.41;279.26;8.32;1027;70;3686.00;70
9685;67;625548792;9685;256;10715;10786;6.74;0.41;279.22;8.33;1030;70;3687.00;71
9688;67;625548807;9688;262;10716;10786;6.73;0.41;279.18;8.33;1028;70;3688.00;70
9689;67;625548820;9689;268;10719;10786;6.73;0.41;279.16;8.34;1030;70;3689.00;67
9691;67;625548835;9691;272;10723;10792;6.69;0.41;279.11;8.35;1032;70;3690.00;69
9693;67;625548850;9693;283;10723;10792;6.66;0.41;279.08;8.35;1030;70;3691.00;69
9695;67;625548863;9695;286;10725;10792;6.66;0.41;279.04;8.35;1030;70;3692.00;67
9696;67;625548877;9696;295;10728;10793;6.65;0.41;279.07;8.36;1032;70;3693.00;65
9700;67;625548890;9700;304;10731;10794;6.64;0.40;278.99;8.36;1031;70;3694.00;63
9701;67;625548903;9701;308;10733;10794;6.57;0.40;279.02;8.37;1032;70;3695.00;61
9702;67;625548917;9702;314;10743;10807;6.49;0.39;279.01;8.37;1041;70;3696.00;64
9706;67;625548932;9706;315;10745;10807;6.40;0.39;279.05;8.38;1039;70;3697.00;62
9707;67;625548947;9707;329;10745;10807;6.34;0.38;279.10;8.38;1038;70;3698.00;62
9708;67;625548960;9708;333;10749;10808;6.29;0.38;279.12;8.39;1041;70;3699.00;59
9712;67;625548975;9712;333;10751;10808;6.21;0.38;279.08;8.42;1039;70;3700.00;57
9712;67;625548993;9712;337;10753;10812;6.20;0.38;279.08;8.41;1041;70;3701.00;59
9717;67;625549005;9717;339;10757;10812;6.15;0.37;279.01;8.44;1040;70;3702.00;55
9722;67;625549019;9722;345;10762;10816;6.11;0.37;278.95;8.44;1040;70;3703.00;54
9724;67;625549033;9724;352;10763;10816;6.05;0.37;278.96;8.45;1039;70;3704.00;53
9724;67;625549046;9724;346;10764;10816;6.04;0.37;278.96;8.46;1040;70;3705.00;52
9725;67;625549058;9725;349;10765;10816;5.99;0.36;278.94;8.47;1040;70;3706.00;51
9725;67;625549078;9725;346;10766;10816;5.98;0.36;278.94;8.48;1041;70;3707.00;50
9728;67;625549090;9728;356;10778;10828;5.98;0.36;279.00;8.49;1050;70;3708.00;50
9729;67;625549104;9729;362;10780;10828;5.98;0.36;279.00;8.50;1051;70;3709.00;48
9730;67;625549116;9730;359;10781;10828;5.95;0.36;278.98;8.51;1051;70;3710.00;47
9731;67;625549129;9731;364;10783;10828;5.92;0.36;278.98;8.53;1052;70;3711.00;45
9731;67;625549143;9731;371;10784;10828;5.87;0.36;278.98;8.54;1053;70;3712.00;44
9731;67;625549158;9731;383;10787;10828;5.78;0.35;278.98;8.56;1056;70;3713.00;41
9731;67;625549173;9731;386;10788;10829;5.75;0.35;278.98;8.57;1057;70;3714.00;41
9734;67;625549189;9734;385;10789;10829;5.73;0.35;278.94;8.58;1055;70;3715.00;40
9734;67;625549208;9734;377;10796;10835;5.79;0.35;278.94;8.60;1062;70;3716.00;39
9734;67;625549229;9734;375;10799;10836;5.82;0.36;278.94;8.60;1065;70;3717.00;37
9735;67;625549247;9735;372;10800;10836;5.81;0.36;278.93;8.60;1065;70;3718.00;36
9738;67;625549271;9738;365;10801;10836;5.84;0.36;278.89;8.60;1063;70;3719.00;35
9741;67;625549292;9741;360;10806;10841;5.88;0.36;278.94;8.62;1065;70;3720.00;35
9742;67;625549310;9742;348;10809;10841;5.90;0.36;278.92;8.64;1067;70;3721.00;32
9742;67;625549335;9742;345;10811;10841;5.87;0.36;278.92;8.65;1069;70;3722.00;30
9743;67;625549350;9743;344;10812;10842;5.88;0.36;278.91;8.65;1069;70;3723.00;30
9745;67;625549373;9745;341;10816;10846;5.87;0.36;278.91;8.65;1071;70;3724.00;30
9746;67;625549387;9746;338;10818;10846;5.89;0.36;278.89;8.67;1072;70;3725.00;28
9746;67;625549401;9746;337;10820;10849;5.96;0.37;278.89;8.66;1074;70;3726.00;29
9747;68;625549414;9747;339;10821;10849;6.06;0.37;278.88;8.66;1074;71;3727.00;28
9748;68;625549451;9748;334;10823;10849;6.13;0.38;278.86;8.67;1075;71;3728.00;26
9748;68;625549468;9748;339;10823;10849;6.16;0.38;278.86;8.67;1075;71;3729.00;26
9751;68;625549485;9751;343;10827;10853;6.18;0.38;278.84;8.68;1076;71;3730.00;26
9756;68;625549501;9756;348;10828;10853;6.12;0.37;278.89;8.68;1072;71;3731.00;25
9758;68;625549515;9758;354;10830;10853;6.07;0.37;278.88;8.69;1072;71;3732.00;23
9759;68;625549529;9759;367;10830;10853;6.03;0.37;278.87;8.69;1071;71;3733.00;23
9762;68;625549542;9762;369;10832;10854;5.94;0.36;278.87;8.70;1070;71;3734.00;22
9763;68;625549556;9763;370;10834;10856;5.88;0.36;278.87;8.70;1071;71;3735.00;22
9767;68;625549569;9767;373;10835;10856;5.76;0.35;278.89;8.70;1068;71;3736.00;21
9768;68;625549583;9768;373;10836;10857;5.72;0.35;278.88;8.70;1068;71;3737.00;21
9772;68;625549596;9772;373;10836;10857;5.67;0.35;278.91;8.70;1064;71;3738.00;21
9774;68;625549609;9774;375;10837;10857;5.65;0.35;278.89;8.71;1063;71;3739.00;20
9778;68;625549621;9778;365;10838;10857;5.64;0.35;278.89;8.71;1060;71;3740.00;19
9780;68;625549635;9780;352;10838;10857;5.68;0.35;278.87;8.71;1058;71;3741.00;19
9783;68;625549647;9783;354;10839;10857;5.74;0.35;278.94;8.72;1056;71;3742.00;18
9785;68;625549662;9785;354;10840;10857;5.78;0.35;278.99;8.72;1055;71;3743.00;17
9788;68;625549677;9788;377;10908;10984;6.13;0.38;279.06;8.67;1120;71;3744.00;76
9794;68;625549703;9794;368;10914;10985;6.12;0.38;279.11;8.67;1120;71;3745.00;71
9798;68;625549717;9798;362;10922;10985;6.15;0.38;279.16;8.66;1124;71;3746.00;63
9801;68;625549731;9801;359;10928;10985;6.22;0.38;279.17;8.66;1127;71;3747.00;57
9805;68;625549746;9805;358;10934;10985;6.26;0.39;279.26;8.66;1129;71;3748.00;51
9809;68;625549760;9809;349;10939;10985;6.32;0.39;279.31;8.66;1130;71;3749.00;46
9811;68;625549776;9811;332;10943;10990;6.36;0.39;279.33;8.66;1132;71;3750.00;47
9816;68;625549791;9816;330;10946;10990;6.40;0.39;279.40;8.66;1130;71;3751.00;44
9818;68;625549806;9818;331;10951;10991;6.38;0.39;279.41;8.66;1133;71;3752.00;40
9823;68;625549827;9823;324;10953;10992;6.40;0.39;279.56;8.66;1130;71;3753.00;39
9827;68;625549845;9827;326;10954;10992;6.46;0.40;279.76;8.66;1127;71;3754.00;38
9832;68;625549863;9832;335;10956;10993;6.49;0.40;279.75;8.66;1124;71;3755.00;37
9837;68;625549883;9837;333;10958;10993;6.50;0.40;279.83;8.66;1121;71;3756.00;35
9839;68;625549898;9839;334;10959;10993;6.53;0.40;279.87;8.66;1120;71;3757.00;34
9841;68;625549915;9841;332;10960;10993;6.58;0.40;279.86;8.66;1119;71;3758.00;33
9847;68;625549932;9847;324;10963;10997;6.63;0.41;279.88;8.66;1116;71;3759.00;34
9850;68;625549949;9850;334;10966;10997;6.65;0.41;279.95;8.66;1116;71;3760.00;31
9854;68;625549967;9854;326;10966;10997;6.63;0.41;280.07;8.66;1112;71;3761.00;31
9856;68;625549988;9856;326;10969;11000;6.65;0.41;280.08;8.66;1113;71;3762.00;31
9860;68;625550005;9860;324;10969;11000;6.65;0.41;280.16;8.66;1109;71;3763.00;31
9861;68;625550021;9861;324;10970;11000;6.67;0.41;280.16;8.66;1109;71;3764.00;30
9866;68;625550038;9866;325;10974;11004;6.63;0.41;280.26;8.66;1108;71;3765.00;30
9870;68;625550058;9870;321;10975;11005;6.67;0.41;280.21;8.66;1105;71;3766.00;30
9874;68;625550075;9874;327;10975;11005;6.64;0.41;280.25;8.66;1101;71;3767.00;30
9877;68;625550095;9877;327;10977;11009;6.67;0.41;280.27;8.66;1100;71;3768.00;32
9883;68;625550111;9883;326;10978;11009;6.62;0.40;280.25;8.65;1095;71;3769.00;31
9888;68;625550134;9888;331;10978;11009;6.62;0.40;280.25;8.65;1090;71;3770.00;31
9892;68;625550152;9892;323;10980;11010;6.62;0.40;280.37;8.66;1088;71;3771.00;30
9896;68;625550172;9896;324;10980;11010;6.66;0.41;280.37;8.66;1084;71;3772.00;30
9900;68;625550189;9900;328;10984;11016;6.68;0.41;280.34;8.65;1084;71;3773.00;32
9905;68;625550208;9905;320;10985;11016;6.69;0.41;280.40;8.65;1080;71;3774.00;31
9909;68;625550226;9909;317;10985;11017;6.76;0.41;280.45;8.65;1076;71;3775.00;32
9915;68;625550244;9915;314;10986;11017;6.80;0.41;280.61;8.65;1071;71;3776.00;31
9918;68;625550260;9918;313;10987;11017;6.88;0.42;280.68;8.65;1069;71;3777.00;30
9921;68;625550278;9921;315;10987;11017;6.98;0.42;280.67;8.65;1066;71;3778.00;30
9925;68;625550296;9925;321;10987;11017;7.02;0.43;280.68;8.65;1062;71;3779.00;30
9929;68;625550314;9929;321;11012;11053;7.15;0.44;280.80;8.64;1083;71;3780.00;41
9931;68;625550333;9931;323;11014;11053;7.13;0.43;280.81;8.63;1083;71;3781.00;39
9938;68;625550349;9938;325;11017;11053;7.05;0.43;280.81;8.63;1079;71;3782.00;36
9939;68;625550363;9939;329;11017;11053;7.05;0.43;280.84;8.63;1078;71;3783.00;36
9943;68;625550378;9943;333;11018;11053;7.01;0.43;280.90;8.63;1075;71;3784.00;35
9948;68;625550395;9948;333;11018;11053;6.96;0.42;280.93;8.63;1070;71;3785.00;35
9954;68;625550415;9954;339;11022;11057;6.90;0.42;280.96;8.63;1068;71;3786.00;35
9957;68;625550432;9957;337;11022;11057;6.86;0.42;280.99;8.63;1065;71;3787.00;35
9959;68;625550450;9959;331;11026;11061;6.84;0.42;281.02;8.63;1067;71;3788.00;35
9964;68;625550469;9964;333;11027;11062;6.83;0.41;281.01;8.63;1063;71;3789.00;35
9966;68;625550485;9966;334;11027;11062;6.81;0.41;281.05;8.63;1061;71;3790.00;35
9968;68;625550501;9968;341;11027;11062;6.85;0.42;281.05;8.63;1059;71;3791.00;35
9970;68;625550517;9970;339;11037;11075;6.93;0.42;281.11;8.62;1067;71;3792.00;38
9970;68;625550533;9970;336;11037;11075;6.95;0.42;281.11;8.62;1067;71;3793.00;38
9974;68;625550549;9974;347;11038;11075;6.94;0.42;281.23;8.62;1064;71;3794.00;37
9977;68;625550567;9977;346;11039;11076;6.95;0.42;281.24;8.62;1062;71;3795.00;37
9979;68;625550590;9979;326;11039;11077;6.98;0.43;281.31;8.62;1060;71;3796.00;38
9983;68;625550604;9983;316;11039;11077;6.99;0.43;281.36;8.62;1056;71;3797.00;38
9985;68;625550619;9985;308;11041;11080;7.05;0.43;281.39;8.62;1056;71;3798.00;39
9990;68;625550634;9990;300;11042;11080;7.10;0.43;281.35;8.61;1052;71;3799.00;38
9994;68;625550655;9994;287;11042;11080;7.17;0.44;281.34;8.61;1048;71;3800.00;38
9998;68;625550673;9998;272;11042;11080;7.19;0.44;281.36;8.61;1044;71;3801.00;38
10001;68;625550688;10001;267;11046;11086;7.23;0.44;281.39;8.61;1045;71;3802.00;40
10005;68;625550708;10005;269;11047;11086;7.20;0.44;281.49;8.61;1042;71;3803.00;39
10006;68;625550727;10006;269;11047;11086;7.15;0.44;281.52;8.61;1041;71;3804.00;39
10008;68;625550750;10008;272;11048;11086;7.10;0.43;281.54;8.63;1040;71;3805.00;38
10013;68;625550770;10013;271;11051;11090;7.01;0.43;281.51;8.63;1038;71;3806.00;39
10018;68;625550784;10018;262;11052;11091;7.01;0.43;281.50;8.63;1034;71;3807.00;39
10019;68;625550799;10019;261;11052;11091;7.01;0.43;281.54;8.63;1033;71;3808.00;39
10023;68;625550812;10023;255;11053;11092;7.07;0.43;281.58;8.63;1030;71;3809.00;39
10026;68;625550829;10026;250;11053;11092;7.10;0.43;281.63;8.63;1027;71;3810.00;39
10028;68;625550843;10028;239;11053;11092;7.14;0.44;281.62;8.63;1025;71;3811.00;39
10030;68;625550862;10030;238;11053;11092;7.12;0.44;281.65;8.63;1023;71;3812.00;39
10033;68;625550883;10033;235;11053;11092;7.12;0.44;281.67;8.63;1020;71;3813.00;39
10035;68;625550897;10035;228;11053;11092;7.14;0.44;281.66;8.63;1018;71;3814.00;39
10038;68;625550910;10038;235;11053;11092;7.17;0.44;281.68;8.63;1015;71;3815.00;39
10046;68;625550923;10046;244;11091;11162;7.13;0.44;281.77;8.60;1045;71;3816.00;71
10048;68;625550943;10048;236;11095;11163;7.15;0.44;281.77;8.59;1047;71;3817.00;68
10053;68;625550956;10053;231;11100;11163;7.17;0.44;281.77;8.59;1047;71;3818.00;63
10057;68;625550976;10057;233;11101;11163;7.14;0.44;281.77;8.59;1044;71;3819.00;62
10060;68;625550990;10060;236;11105;11163;7.21;0.44;281.78;8.59;1045;71;3820.00;58
10064;68;625551002;10064;245;11107;11163;7.22;0.44;281.80;8.59;1043;71;3821.00;56
10065;68;625551015;10065;252;11112;11163;7.25;0.44;281.85;8.59;1047;71;3822.00;51
10068;68;625551028;10068;255;11114;11163;7.22;0.44;281.82;8.59;1046;71;3823.00;49
10072;68;625551041;10072;265;11116;11164;7.17;0.44;281.88;8.59;1044;71;3824.00;48
10074;68;625551055;10074;270;11120;11166;7.12;0.43;281.93;8.58;1046;71;3825.00;46
10079;68;625551068;10079;277;11120;11166;7.01;0.43;281.96;8.58;1041;71;3826.00;46
10080;68;625551082;10080;283;11123;11170;6.88;0.42;281.96;8.58;1043;71;3827.00;47
10081;68;625551096;10081;296;11123;11170;6.79;0.41;281.97;8.58;1042;71;3828.00;47
10085;68;625551108;10085;315;11124;11170;6.65;0.41;282.02;8.60;1039;71;3829.00;46
10087;68;625551122;10087;309;11124;11170;6.56;0.40;282.01;8.60;1037;71;3830.00;46
10090;68;625551134;10090;302;11127;11176;6.50;0.40;282.04;8.60;1037;71;3831.00;49
10094;68;625551147;10094;302;11128;11176;6.44;0.39;282.02;8.60;1034;71;3832.00;48
10095;68;625551159;10095;302;11128;11176;6.43;0.39;282.00;8.60;1033;71;3833.00;48
10096;68;625551171;10096;303;11130;11179;6.43;0.39;281.98;8.60;1034;71;3834.00;49
10098;68;625551184;10098;304;11130;11179;6.41;0.39;281.95;8.60;1032;71;3835.00;49
10099;68;625551201;10099;302;11131;11179;6.37;0.39;281.95;8.60;1032;71;3836.00;48
10103;68;625551219;10103;311;11131;11180;6.28;0.38;281.95;8.60;1028;71;3837.00;49
10106;68;625551238;10106;314;11132;11181;6.15;0.37;281.91;8.60;1026;71;3838.00;49
10111;68;625551259;10111;316;11132;11181;6.02;0.37;281.92;8.60;1021;71;3839.00;49
10115;68;625551280;10115;319;11147;11207;5.95;0.36;281.92;8.58;1032;71;3840.00;60
10117;68;625551301;10117;316;11148;11207;5.90;0.36;281.90;8.58;1031;71;3841.00;59
10124;68;625551316;10124;304;11150;11207;5.82;0.35;281.82;8.58;1026;71;3842.00;57
10126;68;625551330;10126;302;11152;11208;5.81;0.35;281.79;8.58;1026;71;3843.00;56
10127;68;625551343;10127;301;11153;11208;5.75;0.35;281.78;8.60;1026;71;3844.00;55
10131;68;625551358;10131;302;11155;11212;5.74;0.35;281.70;8.59;1024;71;3845.00;57
10136;68;625551371;10136;299;11158;11214;5.71;0.35;281.63;8.60;1022;71;3846.00;56
10137;68;625551384;10137;302;11162;11218;5.70;0.35;281.63;8.60;1025;71;3847.00;56
10141;68;625551397;10141;296;11162;11218;5.66;0.34;281.57;8.60;1021;71;3848.00;56
10144;68;625551409;10144;295;11162;11218;5.68;0.35;281.51;8.60;1018;71;3849.00;56
10145;68;625551420;10145;293;11162;11218;5.70;0.35;281.49;8.60;1017;71;3850.00;56
10147;68;625551433;10147;292;11162;11218;5.68;0.34;281.52;8.60;1015;71;3851.00;56
10150;68;625551444;10150;294;11173;11230;5.73;0.35;281.58;8.59;1023;71;3852.00;57
10150;68;625551458;10150;295;11173;11230;5.78;0.35;281.58;8.59;1023;71;3853.00;57
10153;68;625551471;10153;297;11173;11230;5.81;0.35;281.53;8.59;1020;71;3854.00;57
10155;68;625551482;10155;303;11173;11230;5.81;0.35;281.48;8.59;1018;71;3855.00;57
10155;68;625551494;10155;309;11173;11230;5.84;0.36;281.48;8.59;1018;71;3856.00;57
10157;68;625551506;10157;314;11174;11230;5.86;0.36;281.46;8.60;1017;71;3857.00;56
10160;68;625551518;10160;314;11174;11231;5.85;0.36;281.41;8.60;1014;71;3858.00;57
10162;68;625551529;10162;317;11174;11231;5.80;0.35;281.39;8.60;1012;71;3859.00;57
10163;68;625551542;10163;321;11178;11237;5.81;0.35;281.42;8.60;1015;71;3860.00;59
10164;68;625551554;10164;331;11183;11238;5.81;0.35;281.39;8.61;1019;71;3861.00;55
10164;68;625551567;10164;340;11184;11238;5.81;0.35;281.39;8.61;1020;71;3862.00;54
10167;68;625551579;10167;345;11185;11238;5.79;0.35;281.48;8.61;1018;71;3863.00;53
10169;68;625551590;10169;347;11187;11242;5.82;0.35;281.48;8.61;1018;71;3864.00;55
10171;68;625551603;10171;358;11188;11242;5.78;0.35;281.47;8.61;1017;71;3865.00;54
10172;68;625551614;10172;354;11189;11242;5.71;0.35;281.47;8.62;1017;71;3866.00;53
10173;68;625551626;10173;348;11191;11243;5.73;0.35;281.47;8.62;1018;71;3867.00;52
10173;68;625551639;10173;344;11195;11247;5.81;0.35;281.47;8.62;1022;71;3868.00;52
10174;68;625551652;10174;333;11196;11247;5.90;0.36;281.45;8.62;1022;71;3869.00;51
10176;68;625551667;10176;329;11200;11253;5.99;0.36;281.45;8.63;1024;71;3870.00;53
10176;69;625551680;10176;325;11201;11253;6.10;0.37;281.45;8.63;1025;72;3871.00;52
10177;69;625551700;10177;320;11203;11253;6.20;0.38;281.45;8.64;1026;72;3872.00;50
10179;69;625551714;10179;318;11203;11253;6.33;0.38;281.51;8.64;1024;72;3873.00;50
10182;69;625551727;10182;311;11208;11257;6.48;0.39;281.49;8.66;1026;72;3874.00;49
10182;69;625551746;10182;309;11208;11257;6.55;0.40;281.49;8.66;1026;72;3875.00;49
10185;69;625551767;10185;304;11210;11257;6.61;0.40;281.46;8.67;1025;72;3876.00;47
10186;69;625551780;10186;310;11211;11257;6.65;0.40;281.48;8.68;1025;72;3877.00;46
10187;69;625551799;10187;305;11213;11258;6.66;0.40;281.48;8.69;1026;72;3878.00;45
10188;69;625551811;10188;301;11215;11259;6.64;0.40;281.50;8.70;1027;72;3879.00;44
10190;69;625551824;10190;305;11216;11259;6.63;0.40;281.47;8.71;1026;72;3880.00;43
10191;69;625551837;10191;305;11218;11260;6.58;0.40;281.46;8.71;1027;72;3881.00;42
10191;69;625551850;10191;311;11219;11260;6.57;0.40;281.46;8.72;1028;72;3882.00;41
10194;69;625551862;10194;311;11221;11260;6.56;0.40;281.48;8.74;1027;72;3883.00;39
10195;69;625551876;10195;310;11221;11260;6.58;0.40;281.47;8.74;1026;72;3884.00;39
10196;69;625551888;10196;313;11222;11260;6.59;0.40;281.46;8.75;1026;72;3885.00;38
10199;69;625551906;10199;318;11223;11260;6.57;0.40;281.52;8.75;1024;72;3886.00;37
10201;69;625551919;10201;319;11224;11260;6.54;0.40;281.50;8.76;1023;72;3887.00;36
10202;69;625551932;10202;338;11292;11387;6.71;0.41;281.49;8.72;1090;72;3888.00;95
10202;69;625551955;10202;325;11295;11388;6.70;0.41;281.49;8.71;1093;72;3889.00;93
10203;69;625551970;10203;319;11304;11388;6.73;0.41;281.53;8.72;1101;72;3890.00;84
10205;69;625551983;10205;308;11313;11388;6.74;0.42;281.54;8.72;1108;72;3891.00;75
10205;69;625552011;10205;302;11321;11388;6.76;0.42;281.54;8.72;1116;72;3892.00;67
10207;69;625552027;10207;294;11326;11388;6.78;0.42;281.58;8.72;1119;72;3893.00;62
10209;69;625552046;10209;291;11332;11388;6.81;0.42;281.64;8.73;1123;72;3894.00;56
10211;69;625552060;10211;295;11335;11388;6.83;0.42;281.67;8.73;1124;72;3895.00;53
10214;69;625552074;10214;296;11339;11389;6.86;0.42;281.77;8.73;1125;72;3896.00;50
10218;69;625552089;10218;302;11341;11390;6.85;0.42;281.79;8.74;1123;72;3897.00;49
10220;69;625552104;10220;307;11343;11390;6.86;0.42;281.81;8.74;1123;72;3898.00;47
10223;69;625552118;10223;314;11346;11391;6.80;0.42;281.89;8.76;1123;72;3899.00;45
10225;69;625552141;10225;319;11351;11406;6.72;0.41;281.92;8.76;1126;72;3900.00;55
10227;69;625552164;10227;316;11354;11406;6.68;0.41;281.90;8.77;1127;72;3901.00;52
10230;69;625552180;10230;322;11356;11406;6.64;0.41;281.96;8.78;1126;72;3902.00;50
10235;69;625552196;10235;329;11358;11410;6.57;0.40;282.04;8.77;1123;72;3903.00;52
10238;69;625552211;10238;329;11362;11410;6.52;0.40;282.08;8.79;1124;72;3904.00;48
10244;69;625552225;10244;342;11363;11410;6.44;0.40;282.09;8.79;1119;72;3905.00;47
10247;69;625552239;10247;350;11369;11413;6.38;0.39;282.13;8.80;1122;72;3906.00;44
10251;69;625552253;10251;363;11369;11413;6.30;0.39;282.18;8.80;1118;72;3907.00;44
10255;69;625552267;10255;370;11370;11413;6.24;0.38;282.22;8.80;1115;72;3908.00;43
10259;69;625552280;10259;380;11375;11417;6.16;0.38;282.34;8.81;1116;72;3909.00;42
10264;69;625552293;10264;363;11376;11418;6.12;0.38;282.40;8.81;1112;72;3910.00;42
10268;69;625552307;10268;359;11376;11418;6.06;0.37;282.47;8.81;1108;72;3911.00;42
10270;69;625552320;10270;356;11381;11422;6.06;0.37;282.53;8.82;1111;72;3912.00;41
10274;69;625552333;10274;353;11382;11422;6.00;0.37;282.55;8.82;1108;72;3913.00;40
10279;69;625552346;10279;354;11383;11422;5.97;0.37;282.66;8.82;1104;72;3914.00;39
10282;69;625552359;10282;352;11385;11424;5.98;0.37;282.73;8.82;1103;72;3915.00;39
10285;69;625552372;10285;357;11387;11424;5.97;0.37;282.77;8.83;1102;72;3916.00;37
10290;69;625552386;10290;349;11390;11430;5.99;0.37;282.88;8.83;1100;72;3917.00;40
10296;69;625552401;10296;354;11393;11430;5.98;0.37;282.94;8.84;1097;72;3918.00;37
10300;69;625552414;10300;355;11394;11431;5.97;0.37;282.98;8.84;1094;72;3919.00;37
10304;69;625552428;10304;346;11394;11431;5.98;0.37;283.02;8.84;1090;72;3920.00;37
10307;69;625552446;10307;347;11394;11431;6.02;0.37;283.08;8.84;1087;72;3921.00;37
10309;69;625552460;10309;342;11394;11431;6.07;0.37;283.12;8.84;1085;72;3922.00;37
10311;69;625552475;10311;338;11395;11431;6.09;0.37;283.10;8.84;1084;72;3923.00;36
10314;69;625552489;10314;340;11404;11443;6.15;0.37;283.13;8.83;1090;72;3924.00;39
10318;69;625552509;10318;342;11404;11443;6.21;0.38;283.17;8.83;1086;72;3925.00;39
10322;69;625552525;10322;349;11405;11443;6.25;0.38;283.23;8.83;1083;72;3926.00;38
10324;69;625552539;10324;355;11405;11443;6.31;0.38;283.24;8.83;1081;72;3927.00;38
10328;69;625552552;10328;359;11406;11443;6.35;0.39;283.29;8.83;1078;72;3928.00;37
10332;69;625552565;10332;356;11406;11443;6.36;0.39;283.34;8.83;1074;72;3929.00;37
10335;69;625552581;10335;356;11411;11447;6.43;0.39;283.37;8.83;1076;72;3930.00;36
10338;69;625552595;10338;351;11411;11447;6.44;0.39;283.38;8.83;1073;72;3931.00;36
10343;69;625552609;10343;352;11413;11451;6.44;0.39;283.42;8.83;1070;72;3932.00;38
10345;69;625552623;10345;357;11416;11452;6.44;0.39;283.44;8.84;1071;72;3933.00;36
10347;69;625552636;10347;360;11416;11452;6.47;0.39;283.44;8.84;1069;72;3934.00;36
10350;69;625552650;10350;368;11417;11452;6.47;0.39;283.43;8.84;1067;72;3935.00;35
10359;69;625552663;10359;364;11428;11465;6.47;0.39;283.57;8.83;1069;72;3936.00;37
10361;69;625552678;10361;357;11428;11465;6.48;0.39;283.58;8.83;1067;72;3937.00;37
10368;69;625552691;10368;359;11430;11465;6.46;0.39;283.56;8.86;1062;72;3938.00;35
10372;69;625552705;10372;356;11431;11466;6.47;0.39;283.58;8.86;1059;72;3939.00;35
10376;69;625552719;10376;350;11431;11467;6.49;0.39;283.56;8.86;1055;72;3940.00;36
10379;69;625552733;10379;348;11432;11467;6.54;0.40;283.54;8.86;1053;72;3941.00;35
10382;69;625552747;10382;355;11435;11470;6.62;0.40;283.60;8.86;1053;72;3942.00;35
10387;69;625552761;10387;359;11435;11470;6.65;0.40;283.54;8.86;1048;72;3943.00;35
10391;69;625552774;10391;356;11437;11470;6.64;0.40;283.60;8.86;1046;72;3944.00;33
10397;69;625552787;10397;351;11437;11470;6.60;0.40;283.71;8.86;1040;72;3945.00;33
10398;69;625552801;10398;349;11441;11476;6.62;0.40;283.72;8.86;1043;72;3946.00;35
10401;69;625552815;10401;349;11442;11476;6.63;0.40;283.85;8.86;1041;72;3947.00;34
10403;69;625552829;10403;352;11442;11476;6.67;0.41;283.87;8.86;1039;72;3948.00;34
10408;69;625552843;10408;358;11443;11476;6.67;0.40;283.93;8.86;1035;72;3949.00;33
10413;69;625552857;10413;363;11446;11480;6.65;0.40;284.01;8.85;1033;72;3950.00;34
10414;69;625552871;10414;355;11447;11481;6.67;0.41;283.98;8.85;1033;72;3951.00;34
10421;69;625552883;10421;357;11447;11481;6.63;0.40;284.08;8.85;1026;72;3952.00;34
10425;69;625552898;10425;360;11448;11482;6.60;0.40;284.21;8.85;1023;72;3953.00;34
10430;69;625552911;10430;360;11449;11482;6.49;0.40;284.29;8.88;1019;72;3954.00;33
10434;69;625552924;10434;371;11449;11482;6.44;0.39;284.35;8.88;1015;72;3955.00;33
10437;69;625552938;10437;370;11449;11482;6.42;0.39;284.38;8.88;1012;72;3956.00;33
10442;69;625552950;10442;363;11449;11482;6.38;0.39;284.41;8.88;1007;72;3957.00;33
10447;69;625552964;10447;352;11449;11482;6.29;0.39;284.51;8.88;1002;72;3958.00;33
10450;69;625552978;10450;358;11449;11482;6.24;0.38;284.54;8.88;999;72;3959.00;33
10456;69;625552991;10456;380;11518;11607;6.25;0.39;284.69;8.83;1062;72;3960.00;89
10465;69;625553014;10465;367;11520;11608;6.26;0.39;284.76;8.83;1055;72;3961.00;88
10468;69;625553029;10468;356;11526;11608;6.39;0.39;284.81;8.82;1058;72;3962.00;82
10472;69;625553043;10472;360;11528;11608;6.51;0.40;284.84;8.82;1056;72;3963.00;80
10474;69;625553057;10474;355;11531;11608;6.63;0.41;284.89;8.82;1057;72;3964.00;77
10478;69;625553070;10478;348;11535;11608;6.71;0.41;284.89;8.82;1057;72;3965.00;73
10482;69;625553089;10482;340;11540;11608;6.79;0.42;284.96;8.82;1058;72;3966.00;68
10483;69;625553103;10483;328;11541;11608;6.83;0.42;284.98;8.82;1058;72;3967.00;67
10486;69;625553116;10486;327;11546;11609;6.86;0.42;285.02;8.82;1060;72;3968.00;63
10490;69;625553130;10490;326;11549;11610;6.84;0.42;285.08;8.82;1059;72;3969.00;61
10493;69;625553145;10493;324;11551;11610;6.82;0.42;285.08;8.82;1058;72;3970.00;59
10497;69;625553158;10497;319;11556;11614;6.80;0.42;285.14;8.82;1059;72;3971.00;58
10501;69;625553178;10501;321;11557;11614;6.76;0.41;285.14;8.82;1056;72;3972.00;57
10505;69;625553192;10505;321;11558;11614;6.75;0.41;285.19;8.82;1053;72;3973.00;56
10509;69;625553212;10509;322;11558;11614;6.75;0.41;285.25;8.82;1049;72;3974.00;56
10511;69;625553239;10511;328;11563;11620;6.78;0.41;285.29;8.81;1052;72;3975.00;57
10512;69;625553263;10512;327;11563;11620;6.79;0.42;285.34;8.81;1051;72;3976.00;57
10515;69;625553283;10515;319;11564;11620;6.77;0.41;285.40;8.81;1049;72;3977.00;56
10517;69;625553306;10517;311;11566;11623;6.82;0.42;285.48;8.81;1049;72;3978.00;57
10519;69;625553329;10519;309;11567;11623;6.84;0.42;285.46;8.81;1048;72;3979.00;56
10521;69;625553345;10521;302;11567;11623;6.82;0.42;285.47;8.81;1046;72;3980.00;56
10523;69;625553360;10523;303;11567;11624;6.84;0.42;285.53;8.81;1044;72;3981.00;57
10525;69;625553375;10525;298;11568;11625;6.87;0.42;285.57;8.81;1043;72;3982.00;57
10529;69;625553392;10529;303;11568;11625;6.87;0.42;285.63;8.81;1039;72;3983.00;57
10532;69;625553406;10532;301;11578;11638;6.88;0.42;285.60;8.80;1046;72;3984.00;60
10534;69;625553422;10534;305;11578;11638;6.88;0.42;285.73;8.80;1044;72;3985.00;60
10537;70;625553436;10537;307;11578;11638;6.88;0.42;285.69;8.80;1041;73;3986.00;60
10537;70;625553463;10537;303;11579;11639;6.88;0.42;285.69;8.80;1042;73;3987.00;60
10540;70;625553479;10540;294;11579;11639;6.91;0.42;285.66;8.80;1039;73;3988.00;60
10542;70;625553492;10542;297;11582;11643;6.92;0.42;285.65;8.80;1040;73;3989.00;61
10542;70;625553509;10542;304;11583;11643;6.90;0.42;285.65;8.80;1041;73;3990.00;60
10546;70;625553522;10546;307;11586;11647;6.81;0.42;285.60;8.80;1040;73;3991.00;61
10548;70;625553537;10548;313;11586;11647;6.65;0.41;285.59;8.80;1038;73;3992.00;61
10548;70;625553550;10548;314;11586;11647;6.61;0.40;285.59;8.80;1038;73;3993.00;61
10550;70;625553563;10550;316;11586;11647;6.61;0.41;285.59;8.80;1036;73;3994.00;61
10553;70;625553576;10553;322;11586;11647;6.54;0.40;285.58;8.80;1033;73;3995.00;61
10556;70;625553590;10556;327;11597;11659;6.55;0.40;285.55;8.82;1041;73;3996.00;62
10558;70;625553606;10558;325;11597;11659;6.47;0.40;285.56;8.82;1039;73;3997.00;62
10559;70;625553620;10559;332;11598;11659;6.41;0.39;285.56;8.82;1039;73;3998.00;61
10563;70;625553632;10563;337;11598;11659;6.36;0.39;285.54;8.82;1035;73;3999.00;61
10563;70;625553646;10563;329;11598;11659;6.30;0.39;285.54;8.82;1035;73;4000.00;61
10567;70;625553663;10567;325;11598;11659;6.25;0.38;285.48;8.82;1031;73;4001.00;61
10571;70;625553676;10571;319;11598;11660;6.16;0.38;285.43;8.82;1027;73;4002.00;62
10574;70;625553689;10574;319;11598;11660;6.08;0.37;285.42;8.82;1024;73;4003.00;62
10574;70;625553701;10574;318;11602;11666;6.05;0.37;285.42;8.82;1028;73;4004.00;64
10575;70;625553714;10575;319;11605;11668;6.02;0.37;285.40;8.82;1030;73;4005.00;63
10579;70;625553727;10579;318;11605;11668;5.97;0.37;285.39;8.82;1026;73;4006.00;63
10581;70;625553740;10581;323;11605;11668;5.93;0.36;285.36;8.82;1024;73;4007.00;63
10582;70;625553752;10582;320;11608;11672;5.93;0.36;285.35;8.82;1026;73;4008.00;64
10582;70;625553764;10582;317;11608;11672;5.87;0.36;285.35;8.82;1026;73;4009.00;64
10583;70;625553775;10583;317;11608;11672;5.84;0.36;285.35;8.82;1025;73;4010.00;64
10586;70;625553786;10586;318;11610;11673;5.77;0.35;285.37;8.85;1024;73;4011.00;63
10588;70;625553798;10588;313;11613;11677;5.74;0.35;285.35;8.85;1025;73;4012.00;64
10591;70;625553809;10591;304;11613;11677;5.67;0.35;285.38;8.85;1022;73;4013.00;64
10594;70;625553821;10594;300;11616;11680;5.61;0.34;285.34;8.88;1022;73;4014.00;64
10595;70;625553834;10595;301;11619;11680;5.58;0.34;285.35;8.90;1024;73;4015.00;61
10597;70;625553847;10597;296;11620;11680;5.55;0.34;285.32;8.94;1023;73;4016.00;60
10598;70;625553858;10598;296;11620;11680;5.52;0.34;285.32;8.94;1022;73;4017.00;60
10602;70;625553869;10602;302;11623;11684;5.50;0.34;285.32;8.94;1021;73;4018.00;61
10606;70;625553881;10606;295;11624;11684;5.50;0.34;285.30;8.96;1018;73;4019.00;60
10610;70;625553894;10610;277;11625;11684;5.60;0.34;285.23;8.96;1015;73;4020.00;59
10610;70;625553906;10610;268;11626;11684;5.65;0.35;285.23;8.99;1016;73;4021.00;58
10612;70;625553918;10612;258;11626;11685;5.69;0.35;285.24;8.99;1014;73;4022.00;59
10616;70;625553930;10616;249;11628;11686;5.70;0.35;285.21;9.01;1012;73;4023.00;58
10617;70;625553943;10617;246;11628;11686;5.74;0.35;285.21;9.01;1011;73;4024.00;58
10618;71;625553955;10618;235;11630;11687;5.85;0.36;285.19;9.03;1012;74;4025.00;57
10620;71;625553979;10620;238;11630;11687;5.92;0.36;285.15;9.03;1010;74;4026.00;57
10622;71;625553992;10622;235;11631;11687;5.94;0.36;285.18;9.03;1009;74;4027.00;56
10623;71;625554010;10623;225;11632;11687;6.01;0.37;285.19;9.05;1009;74;4028.00;55
10623;71;625554023;10623;231;11632;11687;6.10;0.37;285.19;9.05;1009;74;4029.00;55
10624;71;625554035;10624;220;11632;11687;6.18;0.38;285.20;9.05;1008;74;4030.00;55
10624;71;625554054;10624;217;11633;11687;6.25;0.38;285.20;9.07;1009;74;4031.00;54
10627;71;625554067;10627;234;11697;11814;6.51;0.40;285.17;9.02;1070;74;4032.00;117
10627;71;625554100;10627;229;11699;11815;6.56;0.41;285.17;9.02;1072;74;4033.00;116
10628;71;625554113;10628;223;11708;11815;6.67;0.41;285.17;9.01;1080;74;4034.00;107
10629;71;625554126;10629;228;11711;11815;6.79;0.42;285.16;9.01;1082;74;4035.00;104
10630;71;625554140;10630;223;11715;11815;6.85;0.42;285.16;9.01;1085;74;4036.00;100
10630;71;625554153;10630;223;11719;11815;6.91;0.43;285.16;9.01;1089;74;4037.00;96
10631;71;625554166;10631;224;11721;11815;6.98;0.43;285.16;9.01;1090;74;4038.00;94
10631;71;625554179;10631;227;11726;11815;7.10;0.44;285.16;9.01;1095;74;4039.00;89
10636;71;625554196;10636;230;11729;11816;7.13;0.44;285.14;9.02;1093;74;4040.00;87
10639;71;625554215;10639;239;11732;11817;7.16;0.44;285.16;9.02;1093;74;4041.00;85
10641;71;625554230;10641;238;11738;11817;7.20;0.44;285.19;9.03;1097;74;4042.00;79
10644;71;625554244;10644;249;11743;11818;7.26;0.45;285.25;9.05;1099;74;4043.00;75
10648;71;625554257;10648;250;11749;11818;7.25;0.44;285.37;9.07;1101;74;4044.00;69
10650;71;625554272;10650;255;11751;11818;7.26;0.45;285.41;9.07;1101;74;4045.00;67
10653;71;625554285;10653;258;11752;11818;7.25;0.44;285.47;9.07;1099;74;4046.00;66
10656;71;625554298;10656;271;11757;11822;7.24;0.44;285.51;9.08;1101;74;4047.00;65
10659;71;625554312;10659;278;11760;11822;7.22;0.44;285.55;9.11;1101;74;4048.00;62
10660;71;625554325;10660;286;11762;11822;7.21;0.44;285.57;9.12;1102;74;4049.00;60
10664;71;625554340;10664;285;11768;11828;7.18;0.44;285.59;9.13;1104;74;4050.00;60
10665;71;625554355;10665;292;11768;11828;7.11;0.43;285.58;9.13;1103;74;4051.00;60
10667;71;625554367;10667;298;11772;11828;7.06;0.43;285.66;9.16;1105;74;4052.00;56
10670;71;625554381;10670;302;11776;11832;6.93;0.42;285.66;9.17;1106;74;4053.00;56
10671;71;625554397;10671;313;11778;11833;6.88;0.42;285.72;9.17;1107;74;4054.00;55
10676;71;625554409;10676;317;11779;11833;6.79;0.41;285.77;9.17;1103;74;4055.00;54
10679;71;625554423;10679;321;11785;11837;6.76;0.41;285.80;9.19;1106;74;4056.00;52
10680;71;625554436;10680;329;11786;11837;6.70;0.41;285.84;9.19;1106;74;4057.00;51
10684;71;625554448;10684;330;11788;11837;6.61;0.40;285.93;9.21;1104;74;4058.00;49
10685;71;625554461;10685;331;11791;11838;6.58;0.40;285.96;9.21;1106;74;4059.00;47
10686;71;625554473;10686;336;11792;11838;6.57;0.40;285.98;9.22;1106;74;4060.00;46
10691;71;625554487;10691;332;11797;11844;6.54;0.40;286.02;9.23;1106;74;4061.00;47
10693;71;625554501;10693;334;11798;11844;6.51;0.40;286.04;9.22;1105;74;4062.00;46
10695;71;625554514;10695;331;11800;11845;6.50;0.40;286.11;9.24;1105;74;4063.00;45
10698;71;625554527;10698;329;11801;11845;6.47;0.40;286.14;9.24;1103;74;4064.00;44
10700;71;625554539;10700;335;11802;11845;6.44;0.39;286.20;9.24;1102;74;4065.00;43
10701;71;625554552;10701;329;11803;11845;6.45;0.39;286.20;9.25;1102;74;4066.00;42
10703;71;625554567;10703;329;11803;11845;6.50;0.40;286.22;9.25;1100;74;4067.00;42
10704;71;625554580;10704;326;11815;11857;6.55;0.40;286.25;9.25;1111;74;4068.00;42
10705;71;625554594;10705;327;11815;11857;6.53;0.40;286.24;9.25;1110;74;4069.00;42
10708;71;625554606;10708;326;11817;11857;6.48;0.40;286.30;9.26;1109;74;4070.00;40
10714;71;625554619;10714;327;11818;11857;6.41;0.39;286.35;9.26;1104;74;4071.00;39
10717;71;625554632;10717;329;11818;11857;6.37;0.39;286.36;9.26;1101;74;4072.00;39
10721;71;625554645;10721;325;11819;11857;6.31;0.38;286.42;9.27;1098;74;4073.00;38
10726;71;625554658;10726;323;11823;11861;6.21;0.38;286.42;9.27;1097;74;4074.00;38
10727;71;625554670;10727;321;11824;11861;6.15;0.38;286.41;9.27;1097;74;4075.00;37
10733;71;625554683;10733;330;11828;11865;6.09;0.37;286.42;9.28;1095;74;4076.00;37
10738;71;625554695;10738;336;11829;11866;5.98;0.36;286.50;9.28;1091;74;4077.00;37
10739;71;625554708;10739;340;11830;11866;5.90;0.36;286.53;9.28;1091;74;4078.00;36
10745;71;625554720;10745;342;11831;11866;5.74;0.35;286.57;9.28;1086;74;4079.00;35
10747;71;625554733;10747;346;11853;11895;5.69;0.35;286.60;9.27;1106;74;4080.00;42
10751;71;625554748;10751;334;11854;11895;5.66;0.35;286.66;9.27;1103;74;4081.00;41
10756;71;625554759;10756;336;11858;11895;5.68;0.35;286.76;9.28;1102;74;4082.00;37
10761;71;625554772;10761;332;11860;11896;5.72;0.35;286.85;9.27;1099;74;4083.00;36
10765;71;625554784;10765;335;11861;11897;5.77;0.35;286.82;9.28;1096;74;4084.00;36
10770;71;625554796;10770;336;11863;11897;5.82;0.36;286.83;9.29;1093;74;4085.00;34
10775;71;625554808;10775;335;11866;11900;5.93;0.36;286.93;9.29;1091;74;4086.00;34
10779;72;625554821;10779;328;11867;11900;6.00;0.37;286.90;9.29;1088;75;4087.00;33
10785;72;625554849;10785;329;11867;11900;6.06;0.37;286.93;9.29;1082;75;4088.00;33
10788;72;625554862;10788;327;11867;11900;6.10;0.37;286.91;9.29;1079;75;4089.00;33
10793;72;625554874;10793;329;11871;11906;6.14;0.38;286.96;9.29;1078;75;4090.00;35
10796;72;625554888;10796;338;11871;11906;6.16;0.38;287.02;9.29;1075;75;4091.00;35
10798;72;625554900;10798;324;11872;11906;6.22;0.38;287.03;9.29;1074;75;4092.00;34
10800;72;625554912;10800;322;11872;11906;6.28;0.39;287.06;9.29;1072;75;4093.00;34
10806;72;625554925;10806;321;11875;11910;6.28;0.39;287.10;9.29;1069;75;4094.00;35
10811;72;625554939;10811;323;11877;11912;6.38;0.39;287.13;9.28;1066;75;4095.00;35
10814;72;625554952;10814;321;11877;11912;6.51;0.40;287.12;9.28;1063;75;4096.00;35
10820;72;625554964;10820;320;11878;11913;6.53;0.40;287.19;9.28;1058;75;4097.00;35
10824;72;625554978;10824;317;11878;11913;6.61;0.40;287.21;9.28;1054;75;4098.00;35
10829;72;625554992;10829;319;11878;11913;6.63;0.40;287.21;9.28;1049;75;4099.00;35
10833;72;625555005;10833;323;11878;11913;6.69;0.41;287.25;9.28;1045;75;4100.00;35
10836;72;625555022;10836;326;11878;11913;6.76;0.41;287.27;9.28;1042;75;4101.00;35
10842;72;625555035;10842;321;11878;11913;6.76;0.41;287.31;9.28;1036;75;4102.00;35
10847;72;625555049;10847;328;11878;11913;6.83;0.42;287.33;9.28;1031;75;4103.00;35
10852;72;625555063;10852;333;11917;11983;6.88;0.42;287.39;9.25;1065;75;4104.00;66
10860;72;625555082;10860;326;11917;11984;6.90;0.42;287.38;9.25;1057;75;4105.00;67
10863;72;625555096;10863;319;11921;11984;6.99;0.43;287.43;9.25;1058;75;4106.00;63
10867;72;625555110;10867;317;11922;11984;7.03;0.43;287.53;9.25;1055;75;4107.00;62
10872;72;625555123;10872;310;11925;11984;7.06;0.43;287.56;9.25;1053;75;4108.00;59
10877;72;625555136;10877;319;11928;11984;7.09;0.43;287.75;9.25;1051;75;4109.00;56
10882;72;625555152;10882;321;11930;11984;7.12;0.43;287.82;9.25;1048;75;4110.00;54
10886;73;625555165;10886;330;11933;11984;7.16;0.44;287.82;9.25;1047;76;4111.00;51
10893;73;625555190;10893;335;11934;11985;7.03;0.43;287.89;9.25;1041;76;4112.00;51
10896;73;625555210;10896;333;11938;11986;6.99;0.43;287.94;9.25;1042;76;4113.00;48
10899;73;625555244;10899;341;11942;11986;7.01;0.43;288.00;9.25;1043;76;4114.00;44
10901;73;625555272;10901;352;11945;11990;6.99;0.42;288.01;9.24;1044;76;4115.00;45
10906;73;625555291;10906;368;11945;11990;6.91;0.42;288.15;9.24;1039;76;4116.00;45
10908;73;625555318;10908;369;11945;11990;6.92;0.42;288.14;9.24;1037;76;4117.00;45
10912;73;625555333;10912;372;11945;11990;6.93;0.42;288.22;9.24;1033;76;4118.00;45
10915;73;625555348;10915;380;11949;11996;6.93;0.42;288.26;9.24;1034;76;4119.00;47
10921;73;625555364;10921;374;11952;11996;6.88;0.42;288.31;9.26;1031;76;4120.00;44
10923;73;625555380;10923;384;11952;11996;6.80;0.42;288.33;9.26;1029;76;4121.00;44
10926;73;625555393;10926;386;11955;11999;6.76;0.41;288.36;9.26;1029;76;4122.00;44
10928;73;625555407;10928;386;11957;11999;6.68;0.41;288.40;9.26;1029;76;4123.00;42
10931;73;625555421;10931;391;11958;11999;6.63;0.41;288.38;9.26;1027;76;4124.00;41
10933;73;625555435;10933;388;11958;12000;6.54;0.40;288.47;9.26;1025;76;4125.00;42
10937;73;625555449;10937;391;11959;12001;6.44;0.39;288.50;9.26;1022;76;4126.00;42
10941;74;625555463;10941;382;11959;12001;6.39;0.39;288.53;9.26;1018;77;4127.00;42
10945;74;625555490;10945;380;11970;12014;6.36;0.39;288.50;9.25;1025;77;4128.00;44
10950;74;625555505;10950;387;11970;12014;6.30;0.38;288.55;9.25;1020;77;4129.00;44
10953;74;625555520;10953;384;11970;12014;6.28;0.38;288.51;9.25;1017;77;4130.00;44
10960;75;625555533;10960;390;11971;12015;6.27;0.38;288.63;9.25;1011;78;4131.00;44
10963;75;625555566;10963;393;11971;12015;6.26;0.38;288.64;9.25;1008;78;4132.00;44
10965;75;625555580;10965;391;11974;12019;6.29;0.38;288.73;9.25;1009;78;4133.00;45
10970;75;625555594;10970;393;11974;12019;6.30;0.38;288.72;9.25;1004;78;4134.00;45
10971;75;625555608;10971;402;11978;12023;6.33;0.39;288.71;9.25;1007;78;4135.00;45
10973;75;625555622;10973;390;11978;12023;6.34;0.39;288.77;9.25;1005;78;4136.00;45
10975;75;625555635;10975;381;11978;12023;6.42;0.39;288.78;9.25;1003;78;4137.00;45
10979;75;625555655;10979;380;11978;12023;6.42;0.39;288.76;9.25;999;78;4138.00;45
10982;75;625555668;10982;372;11978;12023;6.45;0.39;288.74;9.25;996;78;4139.00;45
10986;75;625555690;10986;385;12001;12057;6.43;0.39;288.79;9.23;1015;78;4140.00;56
10988;75;625555712;10988;374;12002;12057;6.40;0.39;288.76;9.23;1014;78;4141.00;55
10989;75;625555726;10989;371;12004;12057;6.42;0.39;288.78;9.23;1015;78;4142.00;53
10991;75;625555740;10991;365;12004;12057;6.43;0.39;288.76;9.23;1013;78;4143.00;53
10994;75;625555754;10994;363;12005;12057;6.45;0.39;288.73;9.23;1011;78;4144.00;52
10994;75;625555768;10994;368;12005;12057;6.49;0.40;288.73;9.23;1011;78;4145.00;52
10996;75;625555780;10996;368;12006;12058;6.52;0.40;288.72;9.23;1010;78;4146.00;52
10999;75;625555795;10999;354;12006;12058;6.50;0.40;288.76;9.23;1007;78;4147.00;52
11003;75;625555809;11003;346;12010;12064;6.50;0.40;288.74;9.23;1007;78;4148.00;54
11003;75;625555823;11003;343;12011;12065;6.54;0.40;288.74;9.23;1008;78;4149.00;54
11004;75;625555843;11004;340;12012;12065;6.59;0.40;288.72;9.22;1008;78;4150.00;53
11008;75;625555856;11008;336;12012;12065;6.59;0.40;288.66;9.22;1004;78;4151.00;53
11010;75;625555868;11010;336;12016;12069;6.58;0.40;288.70;9.22;1006;78;4152.00;53
11012;75;625555883;11012;330;12016;12069;6.55;0.40;288.67;9.22;1004;78;4153.00;53
11015;75;625555897;11015;335;12016;12069;6.49;0.40;288.65;9.22;1001;78;4154.00;53
11017;75;625555910;11017;338;12017;12070;6.44;0.39;288.73;9.22;1000;78;4155.00;53
11022;75;625555922;11022;337;12020;12074;6.39;0.39;288.72;9.22;998;78;4156.00;54
11025;75;625555936;11025;341;12021;12074;6.35;0.39;288.68;9.25;996;78;4157.00;53
11026;75;625555948;11026;345;12023;12077;6.34;0.39;288.68;9.24;997;78;4158.00;54
11027;75;625555962;11027;343;12023;12077;6.30;0.39;288.67;9.24;996;78;4159.00;54
11029;75;625555975;11029;344;12024;12077;6.25;0.38;288.65;9.24;995;78;4160.00;53
11029;75;625555987;11029;344;12024;12077;6.21;0.38;288.65;9.24;995;78;4161.00;53
11030;75;625555999;11030;346;12027;12081;6.19;0.38;288.70;9.24;997;78;4162.00;54
11030;75;625556012;11030;349;12028;12081;6.13;0.38;288.70;9.26;998;78;4163.00;53
11031;75;625556025;11031;353;12029;12081;6.09;0.37;288.69;9.26;998;78;4164.00;52
11032;75;625556037;11032;357;12030;12081;6.00;0.37;288.67;9.28;998;78;4165.00;51
11033;75;625556048;11033;366;12030;12082;5.92;0.36;288.66;9.28;997;78;4166.00;52
11034;75;625556060;11034;374;12031;12083;5.88;0.36;288.63;9.28;997;78;4167.00;52
11036;75;625556071;11036;383;12031;12083;5.82;0.36;288.62;9.28;995;78;4168.00;52
11038;75;625556084;11038;382;12033;12084;5.75;0.35;288.63;9.30;995;78;4169.00;51
11041;75;625556097;11041;380;12033;12084;5.67;0.35;288.62;9.30;992;78;4170.00;51
11041;75;625556109;11041;362;12034;12084;5.64;0.35;288.62;9.32;993;78;4171.00;50
11041;75;625556121;11041;340;12034;12084;5.61;0.34;288.62;9.32;993;78;4172.00;50
11041;75;625556132;11041;332;12036;12086;5.60;0.34;288.62;9.32;995;78;4173.00;50
11044;75;625556144;11044;315;12037;12086;5.63;0.34;288.62;9.33;993;78;4174.00;49
11044;75;625556155;11044;311;12037;12086;5.66;0.35;288.62;9.33;993;78;4175.00;49
11049;75;625556166;11049;318;12107;12213;5.77;0.36;288.62;9.28;1058;78;4176.00;106
11052;75;625556189;11052;299;12109;12214;5.80;0.36;288.72;9.30;1057;78;4177.00;105
11057;75;625556204;11057;281;12114;12214;5.86;0.36;288.76;9.29;1057;78;4178.00;100
11058;76;625556223;11058;272;12119;12214;5.99;0.37;288.77;9.29;1061;79;4179.00;95
11061;76;625556246;11061;268;12123;12214;6.09;0.38;288.77;9.29;1062;79;4180.00;91
11061;76;625556259;11061;272;12130;12214;6.16;0.38;288.77;9.29;1069;79;4181.00;84
11062;76;625556275;11062;267;12131;12214;6.26;0.39;288.77;9.28;1069;79;4182.00;83
11063;76;625556287;11063;262;12134;12214;6.38;0.39;288.75;9.28;1071;79;4183.00;80
11066;76;625556298;11066;263;12136;12215;6.40;0.39;288.74;9.28;1070;79;4184.00;79
11067;76;625556316;11067;255;12141;12217;6.47;0.40;288.74;9.31;1074;79;4185.00;76
11070;76;625556330;11070;248;12145;12217;6.52;0.40;288.77;9.31;1075;79;4186.00;72
11071;77;625556342;11071;246;12148;12218;6.61;0.40;288.77;9.31;1077;80;4187.00;70
11074;77;625556361;11074;239;12149;12218;6.72;0.41;288.79;9.31;1075;80;4188.00;69
11076;77;625556374;11076;235;12151;12218;6.81;0.42;288.78;9.33;1075;80;4189.00;67
11078;77;625556390;11078;233;12152;12218;6.91;0.42;288.75;9.33;1074;80;4190.00;66
11080;77;625556403;11080;227;12157;12222;6.94;0.42;288.78;9.35;1077;80;4191.00;65
11083;77;625556416;11083;230;12159;12222;6.95;0.43;288.82;9.36;1076;80;4192.00;63
11085;77;625556429;11085;228;12161;12222;6.98;0.43;288.84;9.36;1076;80;4193.00;61
11086;77;625556441;11086;219;12163;12225;7.05;0.43;288.82;9.36;1077;80;4194.00;62
11090;77;625556454;11090;221;12164;12225;7.08;0.43;288.84;9.36;1074;80;4195.00;61
11094;77;625556468;11094;226;12165;12225;7.13;0.43;288.79;9.36;1071;80;4196.00;60
11098;77;625556481;11098;226;12169;12229;7.14;0.43;288.81;9.36;1071;80;4197.00;60
11098;77;625556494;11098;222;12170;12230;7.22;0.44;288.81;9.35;1072;80;4198.00;60
11104;77;625556507;11104;226;12170;12230;7.23;0.44;288.77;9.35;1066;80;4199.00;60
11110;77;625556522;11110;239;12180;12264;7.22;0.44;288.89;9.35;1070;80;4200.00;84
11111;77;625556542;11111;236;12182;12264;7.23;0.44;288.87;9.35;1071;80;4201.00;82
11116;77;625556556;11116;238;12185;12264;7.17;0.43;288.95;9.35;1069;80;4202.00;79
11121;77;625556571;11121;243;12186;12265;7.13;0.43;289.02;9.35;1065;80;4203.00;79
11121;77;625556585;11121;238;12186;12265;7.16;0.43;289.02;9.35;1065;80;4204.00;79
11124;77;625556598;11124;242;12190;12271;7.15;0.43;289.08;9.35;1066;80;4205.00;81
11126;77;625556613;11126;241;12193;12271;7.19;0.44;289.07;9.36;1067;80;4206.00;78
11130;77;625556627;11130;237;12194;12272;7.19;0.44;289.08;9.36;1064;80;4207.00;78
11130;77;625556641;11130;231;12195;12272;7.24;0.44;289.08;9.36;1065;80;4208.00;77
11134;77;625556654;11134;238;12195;12272;7.25;0.44;289.16;9.36;1061;80;4209.00;77
11137;77;625556668;11137;235;12197;12272;7.24;0.44;289.23;9.38;1060;80;4210.00;75
11140;77;625556682;11140;237;12199;12272;7.23;0.44;289.23;9.38;1059;80;4211.00;73
11141;77;625556701;11141;243;12210;12284;7.25;0.44;289.29;9.37;1069;80;4212.00;74
11145;77;625556715;11145;237;12212;12284;7.29;0.44;289.36;9.39;1067;80;4213.00;72
11145;77;625556730;11145;229;12212;12284;7.44;0.45;289.36;9.39;1067;80;4214.00;72
11147;77;625556743;11147;234;12213;12284;7.51;0.46;289.42;9.40;1066;80;4215.00;71
11152;77;625556756;11152;235;12214;12284;7.53;0.46;289.41;9.41;1062;80;4216.00;70
11155;77;625556770;11155;237;12218;12284;7.50;0.45;289.43;9.43;1063;80;4217.00;66
11156;77;625556784;11156;231;12222;12288;7.47;0.45;289.45;9.43;1066;80;4218.00;66
11162;77;625556798;11162;228;12223;12288;7.44;0.45;289.53;9.43;1061;80;4219.00;65
11164;77;625556812;11164;232;12226;12292;7.45;0.45;289.53;9.45;1062;80;4220.00;66
11165;78;625556826;11165;234;12229;12293;7.43;0.45;289.51;9.45;1064;81;4221.00;64
11170;78;625556857;11170;235;12232;12293;7.39;0.45;289.55;9.46;1062;81;4222.00;61
11172;78;625556871;11172;240;12233;12293;7.40;0.45;289.56;9.47;1061;81;4223.00;60
11173;78;625556890;11173;244;12240;12306;7.45;0.45;289.55;9.46;1067;81;4224.00;66
11177;78;625556904;11177;248;12241;12306;7.42;0.45;289.60;9.48;1064;81;4225.00;65
11180;78;625556917;11180;251;12243;12306;7.38;0.45;289.64;9.50;1063;81;4226.00;63
11183;78;625556934;11183;247;12244;12307;7.32;0.45;289.65;9.50;1061;81;4227.00;63
11184;78;625556947;11184;257;12249;12308;7.23;0.44;289.68;9.52;1065;81;4228.00;59
11186;78;625556960;11186;256;12249;12308;7.23;0.44;289.70;9.52;1063;81;4229.00;59
11192;78;625556975;11192;261;12255;12314;7.20;0.44;289.78;9.54;1063;81;4230.00;59
11194;78;625556989;11194;259;12256;12314;7.18;0.44;289.81;9.55;1062;81;4231.00;58
11195;78;625557002;11195;253;12257;12314;7.17;0.44;289.83;9.56;1062;81;4232.00;57
11197;78;625557015;11197;256;12257;12314;7.13;0.43;289.85;9.56;1060;81;4233.00;57
11200;78;625557027;11200;261;12261;12320;7.13;0.43;289.86;9.56;1061;81;4234.00;59
11204;78;625557041;11204;257;12263;12320;7.07;0.43;289.84;9.58;1059;81;4235.00;57
11205;78;625557054;11205;260;12264;12320;7.04;0.43;289.84;9.59;1059;81;4236.00;56
11205;78;625557067;11205;269;12265;12320;7.01;0.43;289.84;9.59;1060;81;4237.00;55
11206;78;625557079;11206;278;12268;12324;7.01;0.43;289.89;9.59;1062;81;4238.00;56
11208;78;625557091;11208;278;12271;12325;7.00;0.43;289.89;9.60;1063;81;4239.00;54
11213;78;625557103;11213;277;12272;12325;7.00;0.43;289.87;9.61;1059;81;4240.00;53
11216;78;625557117;11216;280;12273;12326;6.97;0.43;289.95;9.61;1057;81;4241.00;53
11219;78;625557136;11219;283;12275;12326;6.88;0.42;289.99;9.62;1056;81;4242.00;51
11222;78;625557148;11222;290;12276;12326;6.75;0.41;290.06;9.62;1054;81;4243.00;50
11226;78;625557160;11226;293;12278;12326;6.66;0.41;290.05;9.63;1052;81;4244.00;48
11231;78;625557172;11231;290;12278;12326;6.58;0.40;290.04;9.63;1047;81;4245.00;48
11237;78;625557184;11237;294;12279;12326;6.46;0.40;290.04;9.64;1042;81;4246.00;47
11242;78;625557196;11242;303;12281;12326;6.32;0.39;290.03;9.65;1039;81;4247.00;45
11247;78;625557212;11247;314;12316;12396;6.37;0.39;290.03;9.62;1069;81;4248.00;80
11252;78;625557241;11252;314;12321;12397;6.25;0.38;290.05;9.63;1069;81;4249.00;76
11259;78;625557266;11259;308;12325;12397;6.18;0.38;290.18;9.62;1066;81;4250.00;72
11261;78;625557284;11261;299;12325;12397;6.14;0.38;290.24;9.62;1064;81;4251.00;72
11265;78;625557302;11265;303;12332;12397;6.10;0.38;290.26;9.64;1067;81;4252.00;65
11270;78;625557319;11270;303;12334;12397;6.07;0.37;290.32;9.64;1064;81;4253.00;63
11272;78;625557333;11272;309;12339;12397;6.07;0.37;290.36;9.64;1067;81;4254.00;58
11276;78;625557347;11276;309;12343;12397;6.04;0.37;290.42;9.65;1067;81;4255.00;54
11282;78;625557362;11282;319;12344;12398;6.04;0.37;290.44;9.65;1062;81;4256.00;54
11286;78;625557376;11286;307;12350;12399;6.10;0.37;290.46;9.66;1064;81;4257.00;49
11289;78;625557390;11289;315;12352;12399;6.12;0.38;290.54;9.66;1063;81;4258.00;47
11293;78;625557403;11293;314;12356;12403;6.13;0.38;290.56;9.66;1063;81;4259.00;47
11296;78;625557419;11296;321;12359;12403;6.16;0.38;290.62;9.66;1063;81;4260.00;44
11300;78;625557432;11300;327;12360;12403;6.13;0.38;290.69;9.66;1060;81;4261.00;43
11304;78;625557446;11304;326;12361;12403;6.13;0.38;290.74;9.66;1057;81;4262.00;42
11306;78;625557459;11306;328;12365;12409;6.17;0.38;290.80;9.66;1059;81;4263.00;44
11312;78;625557474;11312;333;12365;12409;6.17;0.38;290.86;9.66;1053;81;4264.00;44
11314;78;625557492;11314;336;12366;12409;6.23;0.38;290.93;9.66;1052;81;4265.00;43
11318;78;625557505;11318;337;12368;12412;6.24;0.38;291.02;9.66;1050;81;4266.00;44
11325;78;625557519;11325;342;12368;12412;6.18;0.38;290.98;9.66;1043;81;4267.00;44
11330;78;625557531;11330;342;12368;12412;6.14;0.37;291.05;9.66;1038;81;4268.00;44
11335;78;625557544;11335;345;12368;12413;6.10;0.37;291.04;9.66;1033;81;4269.00;45
11339;78;625557558;11339;349;12370;12414;6.07;0.37;291.06;9.66;1031;81;4270.00;44
11342;78;625557571;11342;346;12371;12414;6.06;0.37;291.08;9.66;1029;81;4271.00;43
11346;78;625557584;11346;343;12383;12427;6.13;0.37;291.11;9.68;1037;81;4272.00;44
11350;78;625557599;11350;344;12384;12427;6.08;0.37;291.17;9.68;1034;81;4273.00;43
11355;78;625557611;11355;345;12386;12427;6.07;0.37;291.18;9.68;1031;81;4274.00;41
11359;78;625557624;11359;348;12388;12429;6.10;0.37;291.23;9.68;1029;81;4275.00;41
11361;78;625557638;11361;354;12389;12429;6.09;0.37;291.28;9.68;1028;81;4276.00;40
11366;78;625557651;11366;359;12392;12433;6.05;0.37;291.27;9.68;1026;81;4277.00;41
11370;78;625557665;11370;366;12392;12433;6.01;0.37;291.34;9.68;1022;81;4278.00;41
11375;78;625557679;11375;366;12397;12437;5.98;0.36;291.30;9.68;1022;81;4279.00;40
11377;78;625557693;11377;365;12398;12437;5.92;0.36;291.31;9.68;1021;81;4280.00;39
11383;78;625557705;11383;378;12399;12437;5.82;0.35;291.31;9.69;1016;81;4281.00;38
11384;78;625557725;11384;380;12399;12437;5.83;0.36;291.37;9.69;1015;81;4282.00;38
11387;78;625557738;11387;384;12399;12437;5.85;0.36;291.38;9.69;1012;81;4283.00;38
11390;78;625557758;11390;395;12410;12449;5.95;0.36;291.37;9.68;1020;81;4284.00;39
11391;78;625557772;11391;394;12410;12449;6.00;0.37;291.36;9.68;1019;81;4285.00;39
11396;78;625557785;11396;400;12413;12449;6.00;0.37;291.35;9.68;1017;81;4286.00;36
11398;78;625557805;11398;403;12413;12449;6.07;0.37;291.43;9.68;1015;81;4287.00;36
11400;78;625557819;11400;402;12413;12449;6.12;0.37;291.43;9.68;1013;81;4288.00;36
11404;78;625557831;11404;411;12413;12449;6.10;0.37;291.40;9.68;1009;81;4289.00;36
11406;78;625557848;11406;410;12413;12450;6.06;0.37;291.42;9.68;1007;81;4290.00;37
11408;78;625557862;11408;422;12413;12450;6.05;0.37;291.41;9.68;1005;81;4291.00;37
11410;78;625557875;11410;430;12417;12456;6.02;0.37;291.39;9.67;1007;81;4292.00;39
11414;78;625557890;11414;442;12419;12457;6.00;0.37;291.36;9.67;1005;81;4293.00;38
11415;78;625557903;11415;452;12419;12457;5.95;0.36;291.34;9.67;1004;81;4294.00;38
11417;78;625557916;11417;459;12419;12457;5.89;0.36;291.33;9.67;1002;81;4295.00;38
11421;78;625557937;11421;471;12422;12461;5.79;0.35;291.38;9.67;1001;81;4296.00;39
11422;78;625557951;11422;464;12422;12461;5.77;0.35;291.36;9.67;1000;81;4297.00;39
11423;78;625557963;11423;459;12422;12461;5.80;0.35;291.36;9.67;999;81;4298.00;39
11426;78;625557976;11426;457;12423;12462;5.83;0.36;291.33;9.67;997;81;4299.00;39
11432;78;625557989;11432;456;12426;12466;5.88;0.36;291.30;9.67;994;81;4300.00;40
11437;78;625558009;11437;454;12426;12466;5.89;0.36;291.41;9.67;989;81;4301.00;40
11440;78;625558024;11440;452;12428;12469;5.93;0.36;291.39;9.67;988;81;4302.00;41
11443;78;625558038;11443;445;12428;12469;5.89;0.36;291.36;9.67;985;81;4303.00;41
11445;78;625558051;11445;445;12429;12469;5.87;0.36;291.33;9.67;984;81;4304.00;40
11450;78;625558071;11450;442;12430;12469;5.83;0.35;291.28;9.69;980;81;4305.00;39
11451;78;625558092;11451;428;12433;12473;5.88;0.36;291.29;9.69;982;81;4306.00;40
11452;78;625558105;11452;414;12433;12473;5.87;0.36;291.28;9.69;981;81;4307.00;40
11456;78;625558118;11456;398;12434;12473;5.87;0.36;291.21;9.69;978;81;4308.00;39
11457;78;625558131;11457;386;12434;12473;5.89;0.36;291.20;9.69;977;81;4309.00;39
11459;78;625558143;11459;376;12434;12474;5.94;0.36;291.18;9.69;975;81;4310.00;40
11461;78;625558157;11461;370;12435;12475;5.99;0.37;291.25;9.69;974;81;4311.00;40
11463;78;625558170;11463;354;12435;12475;5.99;0.36;291.24;9.69;972;81;4312.00;40
11463;78;625558182;11463;345;12436;12476;6.04;0.37;291.24;9.69;973;81;4313.00;40
11466;78;625558195;11466;347;12436;12476;6.08;0.37;291.21;9.69;970;81;4314.00;40
11466;78;625558208;11466;340;12436;12476;6.08;0.37;291.21;9.69;970;81;4315.00;40
11467;78;625558220;11467;337;12436;12476;6.10;0.37;291.22;9.69;969;81;4316.00;40
11470;78;625558232;11470;334;12436;12476;6.13;0.37;291.18;9.69;966;81;4317.00;40
11470;78;625558244;11470;328;12436;12476;6.15;0.38;291.18;9.69;966;81;4318.00;40
11473;78;625558256;11473;332;12436;12476;6.15;0.38;291.18;9.69;963;81;4319.00;40
11473;78;625558270;11473;376;12549;12706;6.44;0.40;291.18;9.60;1076;81;4320.00;157
11476;78;625558299;11476;362;12553;12707;6.43;0.40;291.14;9.63;1077;81;4321.00;154
11479;78;625558312;11479;344;12563;12707;6.53;0.41;291.17;9.62;1084;81;4322.00;144
11480;78;625558324;11480;336;12570;12707;6.58;0.41;291.16;9.62;1090;81;4323.00;137
11481;78;625558337;11481;321;12576;12707;6.63;0.41;291.23;9.62;1095;81;4324.00;131
11482;78;625558349;11482;319;12582;12707;6.63;0.41;291.22;9.61;1100;81;4325.00;125
11483;78;625558362;11483;309;12588;12707;6.63;0.41;291.19;9.61;1105;81;4326.00;119
11483;78;625558374;11483;299;12591;12707;6.58;0.41;291.19;9.64;1108;81;4327.00;116
11485;78;625558387;11485;306;12595;12708;6.56;0.41;291.18;9.64;1110;81;4328.00;113
11486;78;625558400;11486;296;12599;12709;6.49;0.40;291.21;9.64;1113;81;4329.00;110
11489;78;625558419;11489;298;12601;12709;6.43;0.40;291.25;9.64;1112;81;4330.00;108
11489;78;625558432;11489;299;12605;12710;6.45;0.40;291.25;9.64;1116;81;4331.00;105
11490;78;625558445;11490;310;12608;12710;6.45;0.40;291.24;9.64;1118;81;4332.00;102
11493;78;625558464;11493;309;12611;12710;6.40;0.40;291.25;9.64;1118;81;4333.00;99
11493;78;625558477;11493;311;12613;12710;6.34;0.39;291.25;9.64;1120;81;4334.00;97
11496;78;625558496;11496;305;12618;12714;6.28;0.39;291.32;9.64;1122;81;4335.00;96
11498;78;625558509;11498;311;12618;12714;6.25;0.39;291.31;9.64;1120;81;4336.00;96
11498;78;625558523;11498;324;12620;12714;6.22;0.38;291.31;9.64;1122;81;4337.00;94
11498;78;625558537;11498;326;12622;12717;6.20;0.38;291.31;9.64;1124;81;4338.00;95
11501;78;625558550;11501;339;12624;12717;6.14;0.38;291.30;9.64;1123;81;4339.00;93
11501;78;625558563;11501;335;12625;12717;6.11;0.37;291.30;9.64;1124;81;4340.00;92
11502;78;625558576;11502;333;12630;12721;6.12;0.38;291.28;9.67;1128;81;4341.00;91
11504;78;625558590;11504;328;12631;12722;6.14;0.38;291.27;9.67;1127;81;4342.00;91
11504;78;625558603;11504;327;12632;12722;6.21;0.38;291.27;9.70;1128;81;4343.00;90
11506;78;625558616;11506;329;12635;12726;6.20;0.38;291.27;9.70;1129;81;4344.00;91
11511;78;625558629;11511;332;12636;12726;6.19;0.38;291.24;9.70;1125;81;4345.00;90
11515;78;625558643;11515;323;12637;12726;6.18;0.38;291.38;9.70;1122;81;4346.00;89
11519;78;625558656;11519;327;12639;12727;6.19;0.38;291.37;9.73;1120;81;4347.00;88
11522;78;625558670;11522;324;12640;12727;6.20;0.38;291.37;9.73;1118;81;4348.00;87
11526;78;625558683;11526;324;12643;12733;6.16;0.38;291.39;9.73;1117;81;4349.00;90
11528;78;625558703;11528;323;12645;12733;6.11;0.37;291.39;9.75;1117;81;4350.00;88
11533;78;625558716;11533;319;12645;12734;5.99;0.36;291.43;9.75;1112;81;4351.00;89
11533;78;625558729;11533;316;12646;12734;5.99;0.36;291.43;9.75;1113;81;4352.00;88
11539;78;625558741;11539;310;12646;12734;5.94;0.36;291.44;9.75;1107;81;4353.00;88
11542;78;625558754;11542;307;12648;12734;5.92;0.36;291.48;9.77;1106;81;4354.00;86
11543;78;625558768;11543;306;12650;12734;5.97;0.36;291.48;9.79;1107;81;4355.00;84
11547;78;625558781;11547;295;12660;12746;6.06;0.37;291.52;9.79;1113;81;4356.00;86
11549;78;625558796;11549;293;12662;12746;6.09;0.37;291.52;9.81;1113;81;4357.00;84
11552;78;625558808;11552;282;12663;12746;6.14;0.37;291.55;9.81;1111;81;4358.00;83
11555;78;625558822;11555;273;12665;12746;6.22;0.38;291.62;9.83;1110;81;4359.00;81
11556;78;625558836;11556;273;12665;12746;6.29;0.38;291.64;9.83;1109;81;4360.00;81
11562;78;625558850;11562;270;12665;12746;6.32;0.38;291.71;9.83;1103;81;4361.00;81
11564;78;625558863;11564;263;12669;12750;6.38;0.39;291.69;9.84;1105;81;4362.00;81
11567;78;625558877;11567;255;12669;12750;6.43;0.39;291.70;9.84;1102;81;4363.00;81
11569;78;625558891;11569;251;12671;12754;6.51;0.40;291.73;9.84;1102;81;4364.00;83
11571;78;625558904;11571;259;12676;12756;6.56;0.40;291.78;9.86;1105;81;4365.00;80
11574;78;625558917;11574;261;12676;12756;6.58;0.40;291.81;9.86;1102;81;4366.00;80
11576;78;625558930;11576;255;12676;12756;6.63;0.40;291.93;9.86;1100;81;4367.00;80
11580;78;625558944;11580;252;12686;12769;6.70;0.41;292.05;9.85;1106;81;4368.00;83
11582;78;625558959;11582;243;12686;12769;6.77;0.41;292.09;9.85;1104;81;4369.00;83
11583;78;625558973;11583;245;12688;12769;6.85;0.42;292.15;9.85;1105;81;4370.00;81
11586;78;625558986;11586;246;12689;12770;6.89;0.42;292.22;9.85;1103;81;4371.00;81
11590;78;625559000;11590;246;12690;12771;6.90;0.42;292.36;9.86;1100;81;4372.00;81
11593;78;625559013;11593;245;12690;12771;6.98;0.43;292.38;9.86;1097;81;4373.00;81
11595;78;625559027;11595;245;12693;12774;7.00;0.43;292.40;9.86;1098;81;4374.00;81
11598;78;625559042;11598;236;12693;12774;7.05;0.43;292.43;9.86;1095;81;4375.00;81
11602;78;625559056;11602;238;12695;12774;7.09;0.43;292.46;9.86;1093;81;4376.00;79
11604;78;625559069;11604;242;12695;12774;7.15;0.44;292.52;9.86;1091;81;4377.00;79
11608;78;625559084;11608;250;12700;12780;7.17;0.44;292.55;9.86;1092;81;4378.00;80
11610;78;625559098;11610;256;12701;12780;7.24;0.44;292.54;9.88;1091;81;4379.00;79
11611;78;625559115;11611;254;12702;12780;7.32;0.45;292.54;9.88;1091;81;4380.00;78
11613;78;625559128;11613;261;12703;12780;7.28;0.44;292.56;9.88;1090;81;4381.00;77
11618;78;625559143;11618;269;12706;12784;7.27;0.44;292.59;9.88;1088;81;4382.00;78
11621;78;625559157;11621;274;12707;12785;7.30;0.45;292.61;9.88;1086;81;4383.00;78
11625;78;625559171;11625;272;12708;12785;7.27;0.44;292.63;9.89;1083;81;4384.00;77
11628;78;625559185;11628;281;12713;12786;7.31;0.45;292.68;9.93;1085;81;4385.00;73
11633;78;625559199;11633;281;12714;12786;7.33;0.45;292.68;9.94;1081;81;4386.00;72
11635;78;625559218;11635;286;12718;12786;7.37;0.45;292.69;9.98;1083;81;4387.00;68
11637;78;625559242;11637;292;12719;12786;7.38;0.45;292.68;9.99;1082;81;4388.00;67
11643;78;625559264;11643;298;12722;12786;7.42;0.45;292.69;10.01;1079;81;4389.00;64
11643;78;625559284;11643;302;12724;12786;7.45;0.45;292.69;10.03;1081;81;4390.00;62
11647;78;625559305;11647;307;12726;12786;7.44;0.45;292.79;10.04;1079;81;4391.00;60
11650;78;625559324;11650;311;12763;12856;7.48;0.46;292.78;10.03;1113;81;4392.00;93
11651;78;625559345;11651;310;12764;12857;7.50;0.46;292.77;10.03;1113;81;4393.00;93
11656;78;625559361;11656;312;12776;12857;7.45;0.45;292.86;10.05;1120;81;4394.00;81
11657;78;625559376;11657;307;12777;12857;7.39;0.45;292.89;10.05;1120;81;4395.00;80
11658;78;625559391;11658;314;12786;12857;7.39;0.45;292.87;10.07;1128;81;4396.00;71
11661;78;625559407;11661;317;12789;12857;7.30;0.45;292.94;10.07;1128;81;4397.00;68
11664;78;625559421;11664;321;12792;12857;7.20;0.44;292.99;10.08;1128;81;4398.00;65
11664;78;625559436;11664;312;12798;12857;7.18;0.44;292.99;10.09;1134;81;4399.00;59
11667;78;625559451;11667;308;12801;12858;7.19;0.44;293.01;10.10;1134;81;4400.00;57
11669;78;625559471;11669;302;12805;12859;7.16;0.44;293.08;10.10;1136;81;4401.00;54
11673;78;625559488;11673;302;12807;12859;7.15;0.44;293.16;10.11;1134;81;4402.00;52
11675;78;625559505;11675;296;12810;12863;7.16;0.44;293.23;10.12;1135;81;4403.00;53
11680;78;625559522;11680;300;12810;12863;7.14;0.44;293.32;10.12;1130;81;4404.00;53
11684;78;625559539;11684;304;12812;12863;7.17;0.44;293.36;10.13;1128;81;4405.00;51
11686;78;625559556;11686;309;12813;12863;7.20;0.44;293.34;10.13;1127;81;4406.00;50
11688;78;625559572;11688;323;12821;12869;7.25;0.44;293.42;10.14;1133;81;4407.00;48
11690;78;625559589;11690;320;12822;12869;7.24;0.44;293.42;10.14;1132;81;4408.00;47
11693;78;625559607;11693;323;12823;12869;7.25;0.44;293.45;10.15;1130;81;4409.00;46
11696;78;625559624;11696;330;12828;12875;7.21;0.44;293.52;10.15;1132;81;4410.00;47
11698;78;625559643;11698;329;12829;12875;7.14;0.43;293.57;10.15;1131;81;4411.00;46
11702;78;625559658;11702;334;12830;12875;7.04;0.43;293.64;10.15;1128;81;4412.00;45
11705;78;625559673;11705;338;12832;12876;6.94;0.42;293.72;10.16;1127;81;4413.00;44
11709;78;625559689;11709;341;12833;12877;6.81;0.41;293.66;10.16;1124;81;4414.00;44
11713;78;625559705;11713;345;12834;12877;6.69;0.41;293.71;10.16;1121;81;4415.00;43
11718;78;625559720;11718;355;12846;12890;6.52;0.40;293.72;10.16;1128;81;4416.00;44
11721;78;625559736;11721;345;12847;12890;6.34;0.39;293.79;10.16;1126;81;4417.00;43
11726;78;625559751;11726;355;12848;12890;6.21;0.38;293.83;10.16;1122;81;4418.00;42
11731;78;625559766;11731;362;12850;12891;6.08;0.37;293.81;10.17;1119;81;4419.00;41
11733;78;625559780;11733;353;12851;12891;6.01;0.37;293.81;10.17;1118;81;4420.00;40
11739;78;625559795;11739;356;12854;12895;5.96;0.36;293.85;10.17;1115;81;4421.00;41
11743;78;625559809;11743;346;12856;12895;5.93;0.36;293.86;10.17;1113;81;4422.00;39
11749;78;625559823;11749;341;12858;12899;5.93;0.36;293.87;10.17;1109;81;4423.00;41
11752;78;625559837;11752;351;12860;12899;5.88;0.36;293.93;10.17;1108;81;4424.00;39
11755;78;625559852;11755;349;12861;12899;5.90;0.36;293.97;10.18;1106;81;4425.00;38
11759;78;625559867;11759;346;12861;12899;5.85;0.36;294.02;10.18;1102;81;4426.00;38
11763;78;625559881;11763;343;12861;12899;5.85;0.36;294.09;10.18;1098;81;4427.00;38
11768;78;625559896;11768;345;12873;12911;5.93;0.36;294.15;10.18;1105;81;4428.00;38
11773;78;625559911;11773;340;12874;12911;5.92;0.36;294.14;10.18;1101;81;4429.00;37
11776;78;625559926;11776;341;12875;12911;5.93;0.36;294.16;10.18;1099;81;4430.00;36
11780;78;625559940;11780;348;12875;12911;5.93;0.36;294.20;10.18;1095;81;4431.00;36
11782;78;625559955;11782;341;12875;12911;5.95;0.37;294.24;10.18;1093;81;4432.00;36
11785;78;625559970;11785;335;12875;12911;6.00;0.37;294.24;10.18;1090;81;4433.00;36
11789;78;625559984;11789;333;12875;12912;6.02;0.37;294.26;10.18;1086;81;4434.00;37
11793;78;625559998;11793;332;12875;12912;6.03;0.37;294.24;10.18;1082;81;4435.00;37
11796;78;625560022;11796;337;12879;12918;6.09;0.38;294.23;10.17;1083;81;4436.00;39
11799;78;625560046;11799;339;12881;12919;6.14;0.38;294.24;10.17;1082;81;4437.00;38
11804;78;625560061;11804;342;12881;12919;6.15;0.38;294.25;10.17;1077;81;4438.00;38
11807;78;625560081;11807;341;12881;12919;6.21;0.38;294.22;10.17;1074;81;4439.00;38
11811;78;625560097;11811;340;12885;12924;6.26;0.38;294.22;10.17;1074;81;4440.00;39
11815;78;625560110;11815;352;12885;12924;6.28;0.39;294.22;10.17;1070;81;4441.00;39
11820;78;625560124;11820;350;12885;12924;6.25;0.38;294.29;10.17;1065;81;4442.00;39
11823;79;625560138;11823;350;12886;12925;6.24;0.38;294.28;10.17;1063;82;4443.00;39
11827;79;625560174;11827;353;12889;12929;6.21;0.38;294.29;10.16;1062;82;4444.00;40
11831;79;625560188;11831;361;12889;12929;6.16;0.38;294.26;10.16;1058;82;4445.00;40
11837;79;625560203;11837;363;12891;12932;6.16;0.38;294.38;10.16;1054;82;4446.00;41
11841;79;625560218;11841;359;12891;12932;6.17;0.38;294.45;10.16;1050;82;4447.00;41
11844;79;625560231;11844;359;12892;12932;6.19;0.38;294.45;10.16;1048;82;4448.00;40
11850;79;625560244;11850;362;12892;12932;6.12;0.38;294.45;10.16;1042;82;4449.00;40
11852;79;625560258;11852;366;12895;12936;6.16;0.38;294.42;10.16;1043;82;4450.00;41
11858;79;625560271;11858;369;12895;12936;6.04;0.37;294.42;10.16;1037;82;4451.00;41
11863;79;625560283;11863;381;12896;12936;6.02;0.37;294.39;10.16;1033;82;4452.00;40
11868;79;625560296;11868;389;12896;12936;6.00;0.37;294.36;10.16;1028;82;4453.00;40
11873;79;625560308;11873;393;12896;12937;5.95;0.36;294.32;10.16;1023;82;4454.00;41
11880;79;625560321;11880;394;12899;12939;5.89;0.36;294.26;10.18;1019;82;4455.00;40
11884;79;625560334;11884;398;12899;12939;5.81;0.35;294.23;10.18;1015;82;4456.00;40
11889;79;625560346;11889;404;12900;12940;5.75;0.35;294.20;10.18;1011;82;4457.00;40
11891;79;625560358;11891;407;12900;12940;5.71;0.35;294.17;10.18;1009;82;4458.00;40
11894;79;625560370;11894;411;12900;12940;5.64;0.34;294.13;10.18;1006;82;4459.00;40
11897;79;625560382;11897;414;12900;12940;5.57;0.34;294.09;10.18;1003;82;4460.00;40
11899;79;625560393;11899;416;12900;12940;5.51;0.34;294.08;10.18;1001;82;4461.00;40
11902;79;625560404;11902;426;12900;12940;5.40;0.33;294.04;10.18;998;82;4462.00;40
11903;79;625560416;11903;430;12900;12940;5.37;0.33;294.02;10.18;997;82;4463.00;40
11905;79;625560427;11905;447;12968;13067;5.79;0.36;294.01;10.13;1063;82;4464.00;99
11907;79;625560449;11907;448;12971;13068;5.79;0.36;293.99;10.12;1064;82;4465.00;97
11909;79;625560461;11909;457;12981;13068;5.81;0.36;293.96;10.12;1072;82;4466.00;87
11911;79;625560473;11911;451;12982;13068;5.82;0.36;293.95;10.12;1071;82;4467.00;86
11911;79;625560485;11911;445;12989;13068;5.87;0.36;293.95;10.11;1078;82;4468.00;79
11913;79;625560498;11913;442;12993;13068;5.89;0.36;293.94;10.11;1080;82;4469.00;75
11914;79;625560512;11914;445;12999;13068;5.94;0.37;293.93;10.11;1085;82;4470.00;69
11915;79;625560530;11915;447;13003;13068;5.92;0.36;293.93;10.11;1088;82;4471.00;65
11917;79;625560553;11917;449;13008;13069;5.91;0.36;293.92;10.11;1091;82;4472.00;61
11918;79;625560567;11918;448;13009;13070;5.92;0.36;293.92;10.11;1091;82;4473.00;61
11920;79;625560580;11920;451;13010;13070;5.91;0.36;293.90;10.11;1090;82;4474.00;60
11921;79;625560593;11921;447;13011;13071;5.91;0.36;293.90;10.11;1090;82;4475.00;60
11922;79;625560606;11922;434;13013;13071;5.94;0.37;293.89;10.11;1091;82;4476.00;58
11924;79;625560619;11924;418;13014;13071;5.99;0.37;293.87;10.11;1090;82;4477.00;57
11924;79;625560634;11924;407;13016;13071;6.03;0.37;293.87;10.11;1092;82;4478.00;55
11927;79;625560653;11927;394;13019;13075;6.11;0.38;293.85;10.11;1092;82;4479.00;56
11928;79;625560670;11928;380;13021;13075;6.21;0.38;293.84;10.11;1093;83;4480.00;54
11930;79;625560694;11930;371;13022;13075;6.30;0.39;293.84;10.11;1092;83;4481.00;53
11931;79;625560710;11931;364;13025;13078;6.48;0.40;293.83;10.11;1094;83;4482.00;53
11933;80;625560728;11933;359;13025;13078;6.60;0.40;293.81;10.11;1092;84;4483.00;53
11934;80;625560755;11934;344;13026;13078;6.68;0.41;293.81;10.11;1092;84;4484.00;52
11935;80;625560775;11935;339;13029;13082;6.67;0.41;293.81;10.10;1094;84;4485.00;53
11935;80;625560795;11935;337;13031;13083;6.76;0.41;293.81;10.10;1096;84;4486.00;52
11938;80;625560809;11938;332;13031;13083;6.80;0.41;293.77;10.10;1093;84;4487.00;52
11938;80;625560823;11938;330;13034;13087;6.88;0.42;293.77;10.10;1096;84;4488.00;53
11940;80;625560837;11940;320;13034;13087;6.94;0.42;293.73;10.10;1094;84;4489.00;53
11941;80;625560857;11941;319;13034;13087;6.99;0.43;293.73;10.10;1093;84;4490.00;53
11942;80;625560877;11942;312;13035;13088;7.01;0.43;293.71;10.10;1093;84;4491.00;53
11944;80;625560891;11944;315;13035;13088;7.05;0.43;293.68;10.10;1091;84;4492.00;53
11946;80;625560905;11946;312;13039;13094;7.05;0.43;293.66;10.10;1093;84;4493.00;55
11947;80;625560920;11947;303;13039;13094;7.11;0.43;293.65;10.10;1092;84;4494.00;55
11948;80;625560934;11948;306;13041;13095;7.16;0.44;293.65;10.11;1093;84;4495.00;54
11951;80;625560948;11951;314;13041;13095;7.13;0.43;293.68;10.11;1090;84;4496.00;54
11953;80;625560963;11953;311;13041;13095;7.13;0.43;293.78;10.11;1088;84;4497.00;54
11955;80;625560977;11955;310;13041;13095;7.10;0.43;293.76;10.11;1086;84;4498.00;54
11958;80;625560993;11958;311;13041;13095;7.07;0.43;293.79;10.11;1083;84;4499.00;54
11961;80;625561009;11961;317;13064;13145;7.02;0.43;293.79;10.10;1103;84;4500.00;81
11965;80;625561031;11965;320;13066;13147;6.93;0.42;293.86;10.10;1101;84;4501.00;81
11965;80;625561045;11965;315;13067;13147;6.92;0.42;293.86;10.09;1102;84;4502.00;80
11969;80;625561059;11969;319;13067;13147;6.84;0.42;293.86;10.09;1098;84;4503.00;80
11974;80;625561073;11974;320;13068;13147;6.79;0.41;293.91;10.09;1094;84;4504.00;79
11974;80;625561087;11974;325;13069;13147;6.73;0.41;293.91;10.09;1095;84;4505.00;78
11977;80;625561099;11977;317;13075;13151;6.64;0.41;293.99;10.09;1098;84;4506.00;76
11978;80;625561113;11978;313;13076;13151;6.59;0.40;294.02;10.09;1098;84;4507.00;75
11980;80;625561125;11980;321;13079;13155;6.58;0.40;294.07;10.09;1099;84;4508.00;76
11984;80;625561139;11984;328;13081;13156;6.55;0.40;294.14;10.09;1097;84;4509.00;75
11986;80;625561152;11986;324;13081;13156;6.50;0.40;294.12;10.09;1095;84;4510.00;75
11991;80;625561165;11991;321;13081;13156;6.40;0.39;294.20;10.09;1090;84;4511.00;75
11993;80;625561179;11993;318;13088;13169;6.39;0.39;294.24;10.08;1095;84;4512.00;81
11997;80;625561193;11997;322;13089;13169;6.39;0.39;294.25;10.08;1092;84;4513.00;80
11999;80;625561210;11999;315;13089;13169;6.41;0.39;294.26;10.08;1090;84;4514.00;80
12004;80;625561229;12004;320;13091;13170;6.38;0.39;294.27;10.08;1087;84;4515.00;79
12005;80;625561262;12005;314;13091;13171;6.42;0.39;294.26;10.08;1086;84;4516.00;80
12008;80;625561281;12008;317;13091;13171;6.46;0.39;294.32;10.08;1083;84;4517.00;80
12011;80;625561301;12011;311;13093;13174;6.53;0.40;294.35;10.08;1082;84;4518.00;81
12014;80;625561321;12014;306;13094;13174;6.62;0.40;294.39;10.08;1080;84;4519.00;80
12018;80;625561335;12018;298;13095;13174;6.68;0.41;294.39;10.08;1077;84;4520.00;79
12024;80;625561350;12024;300;13095;13174;6.67;0.40;294.42;10.08;1071;84;4521.00;79
12029;80;625561364;12029;297;13098;13180;6.65;0.40;294.42;10.08;1069;84;4522.00;82
12030;80;625561379;12030;292;13099;13180;6.65;0.40;294.42;10.10;1069;84;4523.00;81
12032;80;625561393;12032;290;13100;13180;6.60;0.40;294.44;10.11;1068;84;4524.00;80
12033;80;625561415;12033;281;13101;13180;6.63;0.40;294.48;10.11;1068;84;4525.00;79
12033;80;625561430;12033;280;13105;13184;6.63;0.40;294.48;10.12;1072;84;4526.00;79
12035;80;625561444;12035;279;13107;13185;6.67;0.40;294.47;10.12;1072;84;4527.00;78
12040;80;625561458;12040;269;13107;13185;6.65;0.40;294.54;10.12;1067;84;4528.00;78
12043;80;625561472;12043;264;13108;13186;6.69;0.41;294.54;10.12;1065;84;4529.00;78
12046;80;625561488;12046;261;13109;13186;6.68;0.40;294.61;10.13;1063;84;4530.00;77
12050;80;625561502;12050;255;13110;13186;6.63;0.40;294.61;10.13;1060;84;4531.00;76
12055;80;625561516;12055;256;13110;13186;6.61;0.40;294.64;10.13;1055;84;4532.00;76
12057;80;625561531;12057;259;13111;13186;6.66;0.40;294.68;10.13;1054;84;4533.00;75
12060;80;625561545;12060;256;13111;13186;6.74;0.41;294.68;10.13;1051;84;4534.00;75
12064;80;625561559;12064;256;13112;13186;6.76;0.41;294.74;10.13;1048;84;4535.00;74
12065;80;625561573;12065;261;13149;13256;6.87;0.42;294.77;10.10;1084;84;4536.00;107
12070;80;625561592;12070;260;13154;13257;6.86;0.42;294.82;10.12;1084;84;4537.00;103
12072;80;625561607;12072;248;13158;13257;6.95;0.42;294.79;10.12;1086;84;4538.00;99
12073;80;625561620;12073;249;13162;13257;7.01;0.43;294.78;10.12;1089;84;4539.00;95
12075;80;625561633;12075;245;13165;13257;7.02;0.43;294.81;10.12;1090;84;4540.00;92
12080;80;625561648;12080;249;13167;13257;7.06;0.43;294.83;10.12;1087;84;4541.00;90
12080;80;625561662;12080;252;13170;13257;7.13;0.43;294.83;10.12;1090;84;4542.00;87
12085;80;625561679;12085;248;13177;13257;7.16;0.43;294.86;10.13;1092;84;4543.00;80
12088;80;625561693;12088;246;13179;13258;7.21;0.44;294.85;10.13;1091;84;4544.00;79
12090;80;625561708;12090;246;13185;13260;7.22;0.44;294.85;10.13;1095;84;4545.00;75
12092;80;625561723;12092;245;13186;13260;7.20;0.44;294.82;10.13;1094;84;4546.00;74
12094;80;625561737;12094;246;13191;13264;7.20;0.44;294.89;10.13;1097;84;4547.00;73
12100;80;625561752;12100;249;13192;13264;7.19;0.44;294.94;10.13;1092;84;4548.00;72
12103;80;625561767;12103;250;13195;13264;7.18;0.44;295.02;10.14;1092;84;4549.00;69
12107;80;625561781;12107;252;13195;13264;7.18;0.43;295.04;10.14;1088;84;4550.00;69
12107;80;625561796;12107;260;13200;13270;7.23;0.44;295.04;10.15;1093;84;4551.00;70
12111;80;625561810;12111;259;13202;13270;7.26;0.44;295.10;10.16;1091;84;4552.00;68
12113;80;625561825;12113;260;13204;13270;7.31;0.44;295.16;10.17;1091;84;4553.00;66
12115;80;625561839;12115;255;13206;13273;7.38;0.45;295.15;10.17;1091;84;4554.00;67
12117;80;625561854;12117;264;13208;13273;7.42;0.45;295.23;10.17;1091;84;4555.00;65
12119;80;625561869;12119;266;13210;13273;7.42;0.45;295.24;10.19;1091;84;4556.00;63
12123;80;625561883;12123;268;13213;13274;7.37;0.45;295.32;10.19;1090;84;4557.00;61
12125;80;625561897;12125;268;13215;13275;7.33;0.44;295.34;10.20;1090;84;4558.00;60
12127;80;625561912;12127;271;13217;13275;7.29;0.44;295.40;10.22;1090;84;4559.00;58
12129;80;625561928;12129;278;13233;13301;7.31;0.44;295.46;10.21;1104;84;4560.00;68
12133;80;625561945;12133;281;13236;13301;7.36;0.45;295.47;10.22;1103;84;4561.00;65
12135;80;625561959;12135;282;13239;13301;7.35;0.45;295.45;10.22;1104;84;4562.00;62
12138;80;625561972;12138;280;13241;13302;7.39;0.45;295.52;10.23;1103;84;4563.00;61
12142;80;625561987;12142;288;13243;13302;7.36;0.45;295.64;10.24;1101;84;4564.00;59
12144;80;625562000;12144;287;13247;13306;7.35;0.45;295.63;10.24;1103;84;4565.00;59
12149;80;625562015;12149;290;13248;13306;7.18;0.44;295.67;10.25;1099;84;4566.00;58
12151;80;625562030;12151;297;13252;13310;7.03;0.43;295.72;10.25;1101;84;4567.00;58
12153;80;625562044;12153;297;13255;13310;6.95;0.42;295.77;10.26;1102;84;4568.00;55
12157;80;625562057;12157;294;13255;13310;6.86;0.42;295.82;10.26;1098;84;4569.00;55
12158;80;625562071;12158;288;13256;13310;6.73;0.41;295.87;10.27;1098;84;4570.00;54
12162;80;625562084;12162;280;13256;13310;6.67;0.41;295.88;10.27;1094;84;4571.00;54
12166;80;625562098;12166;283;13267;13322;6.65;0.40;295.91;10.28;1101;84;4572.00;55
12168;80;625562111;12168;285;13267;13322;6.59;0.40;295.91;10.28;1099;84;4573.00;55
12171;80;625562124;12171;285;13268;13322;6.57;0.40;295.93;10.28;1097;84;4574.00;54
12174;80;625562137;12174;298;13269;13322;6.58;0.40;295.95;10.29;1095;84;4575.00;53
12177;80;625562150;12177;301;13272;13322;6.57;0.40;295.95;10.31;1095;84;4576.00;50
12182;80;625562164;12182;298;13273;13322;6.55;0.40;295.98;10.32;1091;84;4577.00;49
12185;80;625562176;12185;300;13273;13323;6.53;0.40;296.05;10.32;1088;84;4578.00;50
12187;80;625562189;12187;303;13273;13323;6.53;0.40;296.11;10.32;1086;84;4579.00;50
12187;80;625562201;12187;307;13280;13329;6.50;0.39;296.11;10.33;1093;84;4580.00;49
12190;80;625562215;12190;309;13281;13330;6.42;0.39;296.24;10.33;1091;84;4581.00;49
12193;80;625562229;12193;318;13283;13330;6.29;0.38;296.27;10.33;1090;84;4582.00;47
12196;80;625562241;12196;331;13284;13330;6.17;0.38;296.31;10.34;1088;84;4583.00;46
12201;80;625562254;12201;338;13287;13334;6.11;0.37;296.34;10.34;1086;84;4584.00;47
12203;80;625562266;12203;345;13288;13334;6.05;0.37;296.35;10.35;1085;84;4585.00;46
12208;80;625562277;12208;349;13289;13334;5.91;0.36;296.30;10.36;1081;84;4586.00;45
12214;80;625562289;12214;355;13290;13335;5.77;0.35;296.38;10.36;1076;84;4587.00;45
12218;80;625562300;12218;368;13294;13339;5.63;0.34;296.41;10.36;1076;84;4588.00;45
12220;80;625562312;12220;374;13295;13339;5.53;0.34;296.49;10.37;1075;84;4589.00;44
12224;80;625562324;12224;361;13298;13345;5.47;0.33;296.53;10.37;1074;84;4590.00;47
12226;80;625562336;12226;355;13299;13345;5.43;0.33;296.52;10.38;1073;84;4591.00;46
12228;80;625562346;12228;354;13300;13345;5.37;0.33;296.50;10.38;1072;84;4592.00;45
12232;80;625562357;12232;354;13303;13345;5.32;0.33;296.50;10.40;1071;84;4593.00;42
12237;80;625562367;12237;359;13306;13349;5.34;0.33;296.51;10.40;1069;84;4594.00;43
12242;80;625562379;12242;368;13307;13349;5.28;0.32;296.48;10.41;1065;84;4595.00;42
12244;80;625562390;12244;373;13308;13349;5.30;0.33;296.48;10.41;1064;84;4596.00;41
12246;80;625562401;12246;379;13308;13349;5.30;0.32;296.49;10.41;1062;84;4597.00;41
12248;80;625562411;12248;391;13309;13350;5.30;0.33;296.50;10.41;1061;84;4598.00;41
12250;80;625562423;12250;390;13310;13351;5.35;0.33;296.49;10.40;1060;84;4599.00;41
12252;80;625562434;12252;388;13311;13351;5.36;0.33;296.48;10.40;1059;84;4600.00;40
12255;80;625562449;12255;397;13312;13352;5.39;0.33;296.47;10.40;1057;84;4601.00;40
12259;80;625562460;12259;408;13312;13352;5.34;0.33;296.43;10.40;1053;84;4602.00;40
12262;80;625562472;12262;407;13312;13352;5.31;0.33;296.43;10.40;1050;84;4603.00;40
12265;80;625562483;12265;407;13312;13352;5.33;0.33;296.42;10.40;1047;84;4604.00;40
12269;80;625562493;12269;406;13312;13352;5.29;0.33;296.41;10.40;1043;84;4605.00;40
12272;80;625562505;12272;406;13312;13352;5.29;0.33;296.42;10.40;1040;84;4606.00;40
12276;80;625562516;12276;407;13312;13352;5.26;0.32;296.37;10.40;1036;84;4607.00;40
12280;80;625562527;12280;413;13379;13479;5.71;0.36;296.38;10.35;1099;84;4608.00;100
12285;80;625562549;12285;408;13383;13480;5.70;0.36;296.32;10.35;1098;84;4609.00;97
12289;80;625562560;12289;408;13391;13480;5.80;0.36;296.32;10.34;1102;84;4610.00;89
12294;80;625562572;12294;408;13396;13480;5.79;0.36;296.28;10.34;1102;84;4611.00;84
12297;80;625562584;12297;407;13404;13480;5.79;0.36;296.30;10.34;1107;84;4612.00;76
12298;80;625562597;12298;408;13408;13480;5.77;0.36;296.31;10.34;1110;84;4613.00;72
12302;80;625562608;12302;401;13414;13480;5.72;0.36;296.28;10.33;1112;84;4614.00;66
12306;80;625562620;12306;409;13415;13480;5.69;0.35;296.26;10.33;1109;84;4615.00;65
12308;80;625562632;12308;414;13421;13481;5.73;0.36;296.23;10.33;1113;84;4616.00;60
12312;80;625562644;12312;415;13421;13482;5.72;0.36;296.24;10.33;1109;84;4617.00;61
12316;80;625562657;12316;422;13423;13482;5.69;0.35;296.21;10.35;1107;84;4618.00;59
12318;80;625562670;12318;431;13425;13483;5.69;0.35;296.23;10.35;1107;84;4619.00;58
12320;80;625562685;12320;438;13426;13483;5.69;0.35;296.22;10.35;1106;84;4620.00;57
12322;80;625562697;12322;452;13428;13483;5.67;0.35;296.29;10.35;1106;84;4621.00;55
12328;80;625562709;12328;455;13429;13483;5.59;0.35;296.37;10.35;1101;84;4622.00;54
12330;80;625562722;12330;462;13433;13487;5.60;0.35;296.36;10.35;1103;84;4623.00;54
12335;80;625562735;12335;471;13434;13487;5.55;0.34;296.33;10.35;1099;84;4624.00;53
12337;80;625562747;12337;474;13434;13487;5.55;0.34;296.31;10.35;1097;84;4625.00;53
12340;80;625562760;12340;481;13437;13490;5.58;0.34;296.32;10.35;1097;84;4626.00;53
12344;80;625562772;12344;463;13438;13490;5.55;0.34;296.33;10.35;1094;84;4627.00;52
12346;80;625562791;12346;456;13438;13490;5.60;0.34;296.32;10.35;1092;84;4628.00;52
12351;80;625562803;12351;447;13442;13494;5.64;0.35;296.32;10.35;1091;84;4629.00;52
12353;80;625562816;12353;446;13443;13495;5.70;0.35;296.33;10.35;1090;84;4630.00;52
12356;80;625562829;12356;441;13444;13495;5.74;0.35;296.31;10.35;1088;84;4631.00;51
12359;81;625562842;12359;436;13447;13499;5.78;0.35;296.29;10.35;1088;85;4632.00;52
12362;81;625562866;12362;441;13447;13499;5.81;0.36;296.25;10.35;1085;85;4633.00;52
12364;81;625562879;12364;435;13448;13499;5.87;0.36;296.22;10.37;1084;85;4634.00;51
12364;81;625562893;12364;438;13450;13501;5.98;0.37;296.22;10.37;1086;85;4635.00;51
12367;81;625562912;12367;439;13450;13501;5.98;0.37;296.22;10.37;1083;85;4636.00;51
12368;81;625562925;12368;423;13454;13507;6.01;0.37;296.19;10.36;1086;85;4637.00;53
12369;81;625562945;12369;409;13454;13507;6.05;0.37;296.20;10.36;1085;85;4638.00;53
12374;81;625562959;12374;405;13455;13508;6.09;0.37;296.17;10.36;1081;85;4639.00;53
12376;81;625562973;12376;401;13455;13508;6.14;0.37;296.16;10.36;1079;85;4640.00;53
12379;81;625562987;12379;389;13455;13508;6.12;0.37;296.17;10.36;1076;85;4641.00;53
12380;81;625563007;12380;384;13455;13508;6.16;0.38;296.15;10.36;1075;85;4642.00;53
12381;81;625563020;12381;384;13455;13508;6.24;0.38;296.14;10.36;1074;85;4643.00;53
12382;81;625563035;12382;381;13465;13520;6.38;0.39;296.14;10.36;1083;85;4644.00;55
12383;81;625563050;12383;378;13466;13520;6.50;0.40;296.19;10.36;1083;85;4645.00;54
12387;81;625563064;12387;367;13466;13520;6.55;0.40;296.20;10.36;1079;85;4646.00;54
12388;81;625563078;12388;366;13466;13520;6.64;0.40;296.22;10.36;1078;85;4647.00;54
12390;81;625563092;12390;359;13466;13520;6.77;0.41;296.20;10.36;1076;85;4648.00;54
12393;81;625563106;12393;352;13466;13520;6.82;0.42;296.26;10.36;1073;85;4649.00;54
12395;81;625563122;12395;353;13472;13526;6.86;0.42;296.29;10.38;1077;85;4650.00;54
12397;81;625563137;12397;350;13472;13526;6.92;0.42;296.27;10.38;1075;85;4651.00;54
12403;81;625563151;12403;340;13475;13530;6.90;0.42;296.33;10.37;1072;85;4652.00;55
12404;81;625563166;12404;337;13477;13531;6.90;0.42;296.39;10.37;1073;85;4653.00;54
12405;81;625563181;12405;343;13477;13531;6.93;0.42;296.38;10.37;1072;85;4654.00;54
12411;81;625563195;12411;346;13477;13531;6.88;0.42;296.42;10.37;1066;85;4655.00;54
12412;81;625563216;12412;348;13488;13544;6.92;0.42;296.44;10.36;1076;85;4656.00;56
12414;81;625563237;12414;344;13489;13544;6.93;0.42;296.43;10.39;1075;85;4657.00;55
12418;81;625563266;12418;337;13489;13544;6.91;0.42;296.51;10.39;1071;85;4658.00;55
12420;81;625563289;12420;337;13490;13545;6.89;0.42;296.53;10.39;1070;85;4659.00;55
12423;81;625563312;12423;331;13490;13546;6.83;0.41;296.60;10.39;1067;85;4660.00;56
12427;81;625563331;12427;329;13490;13546;6.88;0.42;296.66;10.39;1063;85;4661.00;56
12429;81;625563347;12429;327;13492;13549;6.94;0.42;296.69;10.39;1063;85;4662.00;57
12432;81;625563363;12432;319;13492;13549;6.93;0.42;296.68;10.39;1060;85;4663.00;57
12435;81;625563378;12435;319;13493;13549;6.95;0.42;296.75;10.39;1058;85;4664.00;56
12437;81;625563395;12437;326;13493;13549;6.97;0.42;296.85;10.39;1056;85;4665.00;56
12442;81;625563411;12442;333;13497;13555;6.94;0.42;296.88;10.38;1055;85;4666.00;58
12446;81;625563426;12446;334;13497;13555;6.86;0.42;296.92;10.38;1051;85;4667.00;58
12452;81;625563440;12452;342;13498;13555;6.83;0.41;297.02;10.38;1046;85;4668.00;57
12453;81;625563456;12453;343;13498;13555;6.79;0.41;297.04;10.38;1045;85;4669.00;57
12458;81;625563470;12458;354;13501;13559;6.74;0.41;297.10;10.38;1043;85;4670.00;58
12461;81;625563485;12461;353;13502;13560;6.71;0.41;297.18;10.38;1041;85;4671.00;58
12463;81;625563499;12463;350;13502;13560;6.67;0.40;297.19;10.38;1039;85;4672.00;58
12466;81;625563512;12466;350;13503;13561;6.63;0.40;297.23;10.38;1037;85;4673.00;58
12468;81;625563528;12468;355;13503;13561;6.55;0.40;297.29;10.38;1035;85;4674.00;58
12471;81;625563547;12471;360;13503;13561;6.48;0.39;297.34;10.38;1032;85;4675.00;58
12473;81;625563564;12473;358;13503;13561;6.41;0.39;297.37;10.38;1030;85;4676.00;58
12473;81;625563588;12473;353;13504;13561;6.42;0.39;297.37;10.40;1031;85;4677.00;57
12476;81;625563614;12476;356;13504;13561;6.43;0.39;297.46;10.40;1028;85;4678.00;57
12477;81;625563635;12477;348;13504;13561;6.43;0.39;297.46;10.40;1027;85;4679.00;57
12479;81;625563657;12479;361;13568;13686;6.47;0.40;297.53;10.35;1089;85;4680.00;118
12480;81;625563682;12480;345;13568;13687;6.51;0.40;297.54;10.35;1088;85;4681.00;119
12481;81;625563696;12481;336;13575;13687;6.59;0.40;297.54;10.35;1094;85;4682.00;112
12483;81;625563710;12483;330;13581;13687;6.68;0.41;297.59;10.35;1098;85;4683.00;106
12484;81;625563724;12484;318;13586;13687;6.75;0.41;297.60;10.34;1102;85;4684.00;101
12489;81;625563738;12489;313;13590;13687;6.78;0.42;297.60;10.34;1101;85;4685.00;97
12494;81;625563752;12494;316;13595;13687;6.82;0.42;297.68;10.34;1101;85;4686.00;92
12498;81;625563767;12498;319;13597;13687;6.88;0.42;297.72;10.34;1099;85;4687.00;90
12501;81;625563782;12501;309;13600;13688;6.94;0.42;297.75;10.34;1099;85;4688.00;88
12505;81;625563802;12505;303;13601;13689;6.99;0.43;297.81;10.34;1096;85;4689.00;88
12509;81;625563817;12509;291;13603;13689;6.95;0.43;297.87;10.34;1094;85;4690.00;86
12512;81;625563832;12512;295;13607;13693;6.90;0.42;297.90;10.34;1095;85;4691.00;86
12515;81;625563847;12515;288;13607;13693;6.80;0.42;297.93;10.34;1092;85;4692.00;86
12520;81;625563861;12520;290;13609;13693;6.67;0.41;297.97;10.36;1089;85;4693.00;84
12522;81;625563875;12522;280;13610;13693;6.61;0.40;298.00;10.38;1088;85;4694.00;83
12525;81;625563891;12525;281;13614;13699;6.57;0.40;298.02;10.39;1089;85;4695.00;85
12529;81;625563906;12529;284;13614;13699;6.52;0.40;298.07;10.39;1085;85;4696.00;85
12533;81;625563922;12533;287;13616;13699;6.48;0.40;298.11;10.39;1083;85;4697.00;83
12538;81;625563936;12538;276;13618;13702;6.48;0.40;298.09;10.39;1080;85;4698.00;84
12542;81;625563951;12542;271;13619;13702;6.49;0.40;298.07;10.39;1077;85;4699.00;83
12543;81;625563968;12543;259;13619;13702;6.50;0.40;298.07;10.39;1076;85;4700.00;83
12547;81;625563986;12547;253;13620;13703;6.50;0.40;298.21;10.39;1073;85;4701.00;83
12548;81;625564000;12548;256;13621;13704;6.55;0.40;298.20;10.39;1073;85;4702.00;83
12553;81;625564014;12553;253;13621;13704;6.57;0.40;298.20;10.39;1068;85;4703.00;83
12555;81;625564028;12555;253;13630;13717;6.63;0.40;298.20;10.38;1075;85;4704.00;87
12559;81;625564044;12559;249;13630;13717;6.68;0.41;298.25;10.38;1071;85;4705.00;87
12562;81;625564060;12562;250;13630;13717;6.71;0.41;298.31;10.38;1068;85;4706.00;87
12564;81;625564074;12564;243;13632;13718;6.73;0.41;298.29;10.38;1068;85;4707.00;86
12567;81;625564088;12567;251;13632;13718;6.70;0.41;298.31;10.38;1065;85;4708.00;86
12571;81;625564109;12571;253;13635;13722;6.71;0.41;298.31;10.38;1064;85;4709.00;87
12574;81;625564125;12574;258;13637;13722;6.74;0.41;298.30;10.39;1063;85;4710.00;85
12578;81;625564140;12578;260;13641;13726;6.74;0.41;298.36;10.38;1063;85;4711.00;85
12578;81;625564155;12578;260;13642;13726;6.75;0.41;298.36;10.38;1064;85;4712.00;84
12580;81;625564169;12580;262;13642;13726;6.72;0.41;298.41;10.38;1062;85;4713.00;84
12581;81;625564183;12581;266;13642;13726;6.74;0.41;298.45;10.38;1061;85;4714.00;84
12583;81;625564197;12583;265;13643;13726;6.71;0.41;298.48;10.39;1060;85;4715.00;83
12585;81;625564213;12585;262;13652;13738;6.82;0.41;298.50;10.38;1067;85;4716.00;86
12589;81;625564234;12589;274;13655;13738;6.81;0.41;298.51;10.39;1066;85;4717.00;83
12591;81;625564249;12591;278;13656;13738;6.86;0.42;298.55;10.39;1065;85;4718.00;82
12592;81;625564263;12592;282;13657;13738;6.92;0.42;298.54;10.39;1065;85;4719.00;81
12594;81;625564277;12594;284;13660;13738;6.88;0.42;298.61;10.41;1066;85;4720.00;78
12597;81;625564290;12597;289;13660;13738;6.83;0.42;298.61;10.41;1063;85;4721.00;78
12600;81;625564305;12600;294;13660;13739;6.81;0.41;298.61;10.41;1060;85;4722.00;79
12603;81;625564320;12603;294;13662;13739;6.80;0.41;298.69;10.43;1059;85;4723.00;77
12606;81;625564334;12606;299;13666;13745;6.87;0.42;298.69;10.43;1060;85;4724.00;79
12607;81;625564350;12607;298;13671;13747;6.93;0.42;298.69;10.44;1064;85;4725.00;76
12613;81;625564363;12613;308;13672;13747;6.93;0.42;298.83;10.45;1059;85;4726.00;75
12616;81;625564376;12616;314;13673;13747;6.94;0.42;298.88;10.45;1057;85;4727.00;74
12620;81;625564395;12620;311;13677;13751;6.99;0.43;298.83;10.46;1057;85;4728.00;74
12623;81;625564408;12623;311;13677;13751;7.01;0.43;298.83;10.46;1054;85;4729.00;74
12625;81;625564421;12625;313;13677;13751;7.02;0.43;298.88;10.46;1052;85;4730.00;74
12628;81;625564434;12628;318;13680;13752;7.00;0.43;298.90;10.48;1052;85;4731.00;72
12629;81;625564452;12629;325;13684;13756;6.98;0.43;298.93;10.49;1055;85;4732.00;72
12631;81;625564465;12631;323;13685;13756;6.96;0.42;298.97;10.49;1054;85;4733.00;71
12632;81;625564478;12632;327;13687;13759;6.98;0.43;298.97;10.49;1055;85;4734.00;72
12634;81;625564491;12634;327;13690;13759;6.96;0.42;299.03;10.50;1056;85;4735.00;69
12636;81;625564503;12636;331;13690;13759;6.94;0.42;299.07;10.50;1054;85;4736.00;69
12637;81;625564516;12637;335;13692;13759;6.89;0.42;299.09;10.52;1055;85;4737.00;67
12642;81;625564528;12642;341;13695;13763;6.80;0.41;299.12;10.52;1053;85;4738.00;68
12644;81;625564541;12644;342;13697;13763;6.74;0.41;299.13;10.53;1053;85;4739.00;66
12645;81;625564555;12645;343;13698;13763;6.73;0.41;299.12;10.53;1053;85;4740.00;65
12646;81;625564568;12646;335;13699;13763;6.70;0.41;299.10;10.54;1053;85;4741.00;64
12648;81;625564586;12648;333;13699;13764;6.64;0.41;299.14;10.54;1051;85;4742.00;65
12653;81;625564599;12653;348;13702;13765;6.59;0.40;299.12;10.57;1049;85;4743.00;63
12656;81;625564612;12656;338;13703;13765;6.57;0.40;299.13;10.57;1047;85;4744.00;62
12658;81;625564624;12658;335;13706;13766;6.57;0.40;299.15;10.58;1048;85;4745.00;60
12658;81;625564636;12658;340;13706;13766;6.59;0.40;299.15;10.58;1048;85;4746.00;60
12659;81;625564648;12659;338;13706;13766;6.59;0.40;299.21;10.58;1047;85;4747.00;60
12659;81;625564660;12659;346;13707;13766;6.56;0.40;299.21;10.59;1048;85;4748.00;59
12661;81;625564672;12661;347;13707;13766;6.54;0.40;299.19;10.59;1046;85;4749.00;59
12664;81;625564684;12664;352;13710;13766;6.46;0.40;299.14;10.62;1046;85;4750.00;56
12670;81;625564695;12670;361;13710;13766;6.40;0.39;299.10;10.62;1040;85;4751.00;56
12675;81;625564707;12675;376;13775;13893;6.55;0.41;299.16;10.58;1100;85;4752.00;118
12676;81;625564728;12676;371;13779;13894;6.51;0.40;299.18;10.58;1103;85;4753.00;115
12680;81;625564741;12680;381;13790;13894;6.55;0.41;299.16;10.57;1110;85;4754.00;104
12682;81;625564753;12682;381;13794;13894;6.49;0.40;299.14;10.58;1112;85;4755.00;100
12684;81;625564766;12684;380;13800;13894;6.48;0.40;299.13;10.58;1116;85;4756.00;94
12687;81;625564780;12687;384;13806;13894;6.39;0.40;299.14;10.57;1119;85;4757.00;88
12689;81;625564792;12689;393;13813;13894;6.33;0.39;299.12;10.58;1124;85;4758.00;81
12692;81;625564810;12692;396;13815;13894;6.17;0.38;299.08;10.58;1123;85;4759.00;79
12696;81;625564822;12696;392;13819;13895;6.08;0.38;299.02;10.58;1123;85;4760.00;76
12700;81;625564836;12700;387;13823;13896;6.00;0.37;299.02;10.59;1123;85;4761.00;73
12705;81;625564848;12705;392;13826;13896;5.95;0.37;298.95;10.59;1121;85;4762.00;70
12708;81;625564860;12708;403;13831;13897;5.90;0.36;298.95;10.62;1123;85;4763.00;66
12710;81;625564872;12710;412;13833;13897;5.83;0.36;298.94;10.62;1123;85;4764.00;64
12713;81;625564885;12713;426;13834;13897;5.79;0.36;298.99;10.62;1121;85;4765.00;63
12714;81;625564897;12714;431;13837;13897;5.77;0.36;299.00;10.63;1123;85;4766.00;60
12716;81;625564909;12716;436;13839;13901;5.72;0.35;298.99;10.62;1123;85;4767.00;62
12718;81;625564922;12718;440;13842;13901;5.68;0.35;298.97;10.63;1124;85;4768.00;59
12720;81;625564935;12720;455;13844;13901;5.65;0.35;298.97;10.64;1124;85;4769.00;57
12723;81;625564949;12723;456;13848;13907;5.65;0.35;299.00;10.64;1125;85;4770.00;59
12726;81;625564961;12726;465;13849;13907;5.58;0.34;298.99;10.64;1123;85;4771.00;58
12729;81;625564974;12729;474;13851;13907;5.51;0.34;299.00;10.64;1122;85;4772.00;56
12733;81;625564987;12733;479;13853;13911;5.48;0.34;298.95;10.64;1120;85;4773.00;58
12736;81;625564999;12736;478;13856;13912;5.50;0.34;298.91;10.63;1120;85;4774.00;56
12738;81;625565012;12738;487;13856;13912;5.49;0.34;298.94;10.63;1118;85;4775.00;56
12745;81;625565024;12745;490;13860;13916;5.46;0.34;298.92;10.63;1115;85;4776.00;56
12747;81;625565037;12747;497;13860;13916;5.46;0.34;298.89;10.63;1113;85;4777.00;56
12751;81;625565049;12751;502;13860;13916;5.40;0.33;298.94;10.63;1109;85;4778.00;56
12753;81;625565061;12753;486;13861;13917;5.45;0.34;298.93;10.63;1108;85;4779.00;56
12757;81;625565073;12757;478;13862;13917;5.45;0.34;298.90;10.66;1105;85;4780.00;55
12762;81;625565087;12762;474;13866;13923;5.49;0.34;298.85;10.66;1104;86;4781.00;57
12767;81;625565109;12767;465;13866;13923;5.51;0.34;298.84;10.66;1099;86;4782.00;57
12770;81;625565121;12770;466;13867;13924;5.55;0.34;298.84;10.66;1097;86;4783.00;57
12772;82;625565134;12772;460;13867;13924;5.59;0.34;298.83;10.66;1095;87;4784.00;57
12776;82;625565157;12776;458;13867;13924;5.64;0.35;298.79;10.66;1091;87;4785.00;57
12778;82;625565175;12778;463;13867;13924;5.68;0.35;298.78;10.66;1089;87;4786.00;57
12782;82;625565188;12782;468;13867;13924;5.75;0.35;298.76;10.66;1085;87;4787.00;57
12787;82;625565200;12787;470;13877;13936;5.85;0.36;298.76;10.65;1090;87;4788.00;59
12790;82;625565219;12790;472;13877;13936;5.92;0.36;298.77;10.65;1087;87;4789.00;59
12794;82;625565241;12794;471;13878;13936;5.96;0.36;298.74;10.65;1084;87;4790.00;58
12798;82;625565264;12798;470;13878;13936;6.00;0.37;298.78;10.65;1080;87;4791.00;58
12799;82;625565285;12799;475;13878;13936;6.05;0.37;298.78;10.65;1079;87;4792.00;58
12801;82;625565307;12801;477;13878;13936;6.02;0.37;298.77;10.65;1077;87;4793.00;58
12803;82;625565327;12803;485;13881;13940;6.04;0.37;298.76;10.65;1078;87;4794.00;59
12805;82;625565342;12805;490;13881;13940;6.04;0.37;298.74;10.65;1076;87;4795.00;59
12806;82;625565357;12806;492;13884;13944;6.02;0.37;298.72;10.65;1078;87;4796.00;60
12808;82;625565372;12808;495;13885;13945;6.01;0.37;298.70;10.65;1077;87;4797.00;60
12812;82;625565387;12812;501;13886;13945;5.97;0.36;298.74;10.65;1074;87;4798.00;59
12817;82;625565402;12817;501;13886;13945;5.96;0.36;298.73;10.65;1069;87;4799.00;59
12821;82;625565420;12821;504;13907;13986;6.03;0.37;298.87;10.63;1086;87;4800.00;79
12825;82;625565443;12825;497;13908;13986;5.95;0.36;298.86;10.66;1083;87;4801.00;78
12827;82;625565458;12827;498;13911;13986;5.90;0.36;298.84;10.66;1084;87;4802.00;75
12830;82;625565472;12830;493;13912;13987;5.85;0.36;298.85;10.66;1082;87;4803.00;75
12832;82;625565486;12832;493;13913;13988;5.82;0.36;298.89;10.66;1081;87;4804.00;75
12836;82;625565500;12836;496;13914;13988;5.81;0.35;298.91;10.66;1078;87;4805.00;74
12837;82;625565514;12837;491;13917;13991;5.84;0.36;298.89;10.66;1080;87;4806.00;74
12839;82;625565528;12839;483;13918;13991;5.81;0.35;298.89;10.66;1079;87;4807.00;73
12840;82;625565542;12840;473;13920;13991;5.80;0.35;298.93;10.66;1080;87;4808.00;71
12844;82;625565556;12844;473;13921;13991;5.77;0.35;298.94;10.66;1077;87;4809.00;70
12848;82;625565570;12848;470;13925;13997;5.77;0.35;298.92;10.65;1077;87;4810.00;72
12852;82;625565585;12852;474;13926;13997;5.74;0.35;298.98;10.65;1074;87;4811.00;71
12855;82;625565600;12855;468;13927;13997;5.72;0.35;299.01;10.65;1072;87;4812.00;70
12857;82;625565614;12857;474;13928;13997;5.78;0.35;299.04;10.65;1071;87;4813.00;69
12862;82;625565628;12862;469;13932;14001;5.78;0.35;299.10;10.69;1070;87;4814.00;69
12867;82;625565643;12867;477;13934;14003;5.82;0.36;299.12;10.68;1067;87;4815.00;69
12869;82;625565658;12869;460;13934;14003;5.91;0.36;299.16;10.68;1065;87;4816.00;69
12873;82;625565672;12873;448;13935;14004;6.01;0.37;299.19;10.68;1062;87;4817.00;69
12875;83;625565687;12875;433;13936;14004;6.04;0.37;299.22;10.68;1061;88;4818.00;68
12876;83;625565714;12876;424;13936;14004;6.11;0.37;299.20;10.68;1060;88;4819.00;68
12880;83;625565735;12880;413;13936;14004;6.11;0.37;299.21;10.68;1056;88;4820.00;68
12883;83;625565749;12883;408;13936;14004;6.08;0.37;299.23;10.68;1053;88;4821.00;68
12885;83;625565765;12885;394;13937;14004;6.04;0.37;299.23;10.72;1052;88;4822.00;67
12889;83;625565780;12889;404;13938;14004;6.00;0.36;299.29;10.72;1049;88;4823.00;66
12893;83;625565793;12893;401;13980;14074;6.06;0.37;299.36;10.69;1087;88;4824.00;94
12894;83;625565814;12894;394;13981;14075;6.07;0.37;299.37;10.69;1087;88;4825.00;94
12898;83;625565829;12898;388;13987;14075;6.16;0.37;299.37;10.68;1089;88;4826.00;88
12901;83;625565843;12901;379;13989;14075;6.23;0.38;299.45;10.68;1088;88;4827.00;86
12903;83;625565858;12903;375;13993;14077;6.37;0.39;299.47;10.68;1090;88;4828.00;84
12907;83;625565873;12907;372;13995;14077;6.35;0.39;299.52;10.68;1088;88;4829.00;82
12910;83;625565890;12910;367;13998;14077;6.40;0.39;299.58;10.68;1088;88;4830.00;79
12911;83;625565905;12911;363;14000;14077;6.43;0.39;299.58;10.68;1089;88;4831.00;77
12913;83;625565923;12913;357;14002;14078;6.44;0.39;299.62;10.68;1089;88;4832.00;76
12915;83;625565938;12915;361;14004;14079;6.41;0.39;299.66;10.68;1089;88;4833.00;75
12917;84;625565953;12917;354;14007;14079;6.41;0.39;299.65;10.71;1090;89;4834.00;72
12917;84;625565986;12917;360;14013;14083;6.41;0.39;299.65;10.71;1096;89;4835.00;70
12921;84;625566001;12921;360;14013;14083;6.44;0.39;299.66;10.71;1092;89;4836.00;70
12923;84;625566016;12923;357;14013;14083;6.48;0.39;299.71;10.71;1090;89;4837.00;70
12925;84;625566030;12925;357;14013;14083;6.49;0.39;299.74;10.71;1088;89;4838.00;70
12928;84;625566045;12928;362;14018;14089;6.51;0.40;299.73;10.71;1090;89;4839.00;71
12929;84;625566061;12929;362;14018;14089;6.50;0.39;299.71;10.71;1089;89;4840.00;71
12929;84;625566076;12929;358;14019;14089;6.47;0.39;299.71;10.71;1090;89;4841.00;70
12929;84;625566090;12929;352;14022;14092;6.49;0.39;299.71;10.71;1093;89;4842.00;70
12929;84;625566104;12929;355;14022;14092;6.52;0.40;299.71;10.71;1093;89;4843.00;70
12932;84;625566118;12932;352;14022;14092;6.52;0.40;299.71;10.71;1090;89;4844.00;70
12933;84;625566131;12933;357;14022;14093;6.50;0.40;299.71;10.71;1089;89;4845.00;71
12935;84;625566145;12935;357;14023;14094;6.47;0.39;299.69;10.71;1088;89;4846.00;71
12935;84;625566158;12935;354;14023;14094;6.43;0.39;299.69;10.71;1088;89;4847.00;71
12941;84;625566172;12941;363;14034;14107;6.37;0.39;299.67;10.70;1093;89;4848.00;73
12942;84;625566187;12942;355;14034;14107;6.28;0.38;299.67;10.70;1092;89;4849.00;73
12944;84;625566201;12944;347;14034;14107;6.24;0.38;299.81;10.70;1090;89;4850.00;73
12946;84;625566216;12946;341;14035;14108;6.19;0.38;299.82;10.70;1089;89;4851.00;73
12949;84;625566229;12949;339;14035;14108;6.16;0.38;299.82;10.70;1086;89;4852.00;73
12950;84;625566248;12950;332;14038;14112;6.19;0.38;299.83;10.70;1088;89;4853.00;74
12953;84;625566263;12953;334;14039;14112;6.21;0.38;299.87;10.73;1086;89;4854.00;73
12954;84;625566277;12954;321;14043;14116;6.21;0.38;299.86;10.73;1089;89;4855.00;73
12958;84;625566289;12958;315;14043;14116;6.22;0.38;299.88;10.73;1085;89;4856.00;73
12963;84;625566302;12963;309;14043;14116;6.16;0.38;299.94;10.73;1080;89;4857.00;73
12967;84;625566315;12967;311;14043;14116;6.20;0.38;300.09;10.73;1076;89;4858.00;73
12972;84;625566327;12972;305;14043;14116;6.20;0.38;300.09;10.73;1071;89;4859.00;73
12978;84;625566342;12978;301;14063;14150;6.19;0.38;300.10;10.72;1085;89;4860.00;87
12981;84;625566357;12981;290;14064;14150;6.17;0.38;300.14;10.71;1083;89;4861.00;86
12984;84;625566369;12984;277;14065;14150;6.18;0.38;300.21;10.71;1081;89;4862.00;85
12987;84;625566381;12987;272;14065;14150;6.18;0.38;300.20;10.71;1078;89;4863.00;85
12989;84;625566394;12989;268;14066;14150;6.23;0.38;300.23;10.71;1077;89;4864.00;84
12993;84;625566407;12993;270;14068;14150;6.24;0.38;300.29;10.73;1075;89;4865.00;82
12997;84;625566421;12997;261;14069;14151;6.29;0.38;300.35;10.74;1072;89;4866.00;82
12999;84;625566433;12999;254;14069;14151;6.29;0.38;300.36;10.74;1070;89;4867.00;82
13002;84;625566446;13002;256;14073;14157;6.34;0.39;300.34;10.74;1071;89;4868.00;84
13005;84;625566459;13005;249;14074;14158;6.33;0.39;300.36;10.74;1069;89;4869.00;84
13009;84;625566472;13009;248;14075;14158;6.29;0.38;300.40;10.74;1066;89;4870.00;83
13011;84;625566486;13011;248;14075;14158;6.30;0.38;300.42;10.74;1064;89;4871.00;83
13014;84;625566498;13014;245;14079;14162;6.36;0.39;300.45;10.78;1065;89;4872.00;83
13016;84;625566512;13016;239;14080;14162;6.42;0.39;300.57;10.78;1064;89;4873.00;82
13019;84;625566524;13019;235;14081;14162;6.46;0.39;300.63;10.82;1062;89;4874.00;81
13021;84;625566537;13021;239;14082;14163;6.54;0.40;300.61;10.82;1061;89;4875.00;81
13025;84;625566551;13025;233;14085;14167;6.53;0.40;300.62;10.82;1060;89;4876.00;82
13029;84;625566564;13029;236;14086;14167;6.51;0.40;300.61;10.82;1057;89;4877.00;81
13034;84;625566577;13034;228;14088;14170;6.54;0.40;300.64;10.82;1054;89;4878.00;82
13037;84;625566590;13037;232;14090;14170;6.53;0.40;300.65;10.82;1053;89;4879.00;80
13040;84;625566603;13040;224;14090;14170;6.52;0.40;300.62;10.82;1050;89;4880.00;80
13045;84;625566616;13045;229;14090;14170;6.50;0.40;300.69;10.82;1045;89;4881.00;80
13047;84;625566630;13047;235;14094;14174;6.56;0.40;300.70;10.82;1047;89;4882.00;80
13050;85;625566643;13050;229;14094;14174;6.55;0.40;300.70;10.82;1044;90;4883.00;80
13052;85;625566673;13052;228;14095;14174;6.59;0.40;300.68;10.81;1043;90;4884.00;79
13055;85;625566686;13055;231;14096;14174;6.59;0.40;300.75;10.81;1041;90;4885.00;78
13058;85;625566699;13058;238;14096;14175;6.59;0.40;300.82;10.81;1038;90;4886.00;79
13059;85;625566712;13059;236;14097;14176;6.65;0.40;300.86;10.81;1038;90;4887.00;79
13062;85;625566725;13062;235;14097;14176;6.64;0.40;300.88;10.81;1035;90;4888.00;79
13067;85;625566738;13067;237;14098;14177;6.61;0.40;301.06;10.81;1031;90;4889.00;79
13071;85;625566752;13071;239;14099;14177;6.61;0.40;301.12;10.83;1028;90;4890.00;78
13071;85;625566765;13071;245;14100;14177;6.64;0.40;301.12;10.84;1029;90;4891.00;77
13077;85;625566777;13077;247;14100;14177;6.61;0.40;301.17;10.84;1023;90;4892.00;77
13078;85;625566790;13078;256;14102;14177;6.56;0.40;301.19;10.86;1024;90;4893.00;75
13080;85;625566802;13080;263;14102;14177;6.48;0.39;301.23;10.86;1022;90;4894.00;75
13083;85;625566814;13083;269;14104;14177;6.44;0.39;301.22;10.88;1021;90;4895.00;73
13084;85;625566826;13084;289;14164;14304;6.66;0.41;301.32;10.84;1080;90;4896.00;140
13086;85;625566848;13086;287;14166;14305;6.61;0.41;301.33;10.85;1080;90;4897.00;139
13090;85;625566861;13090;286;14177;14305;6.66;0.41;301.32;10.87;1087;90;4898.00;128
13093;85;625566873;13093;284;14183;14305;6.66;0.41;301.27;10.87;1090;90;4899.00;122
13094;85;625566886;13094;284;14190;14305;6.65;0.41;301.26;10.88;1096;90;4900.00;115
13094;85;625566903;13094;288;14194;14305;6.58;0.41;301.26;10.88;1100;90;4901.00;111
13094;85;625566921;13094;290;14203;14305;6.58;0.41;301.26;10.90;1109;90;4902.00;102
13099;85;625566933;13099;298;14205;14305;6.52;0.40;301.26;10.90;1106;90;4903.00;100
13101;85;625566946;13101;303;14211;14306;6.51;0.40;301.21;10.91;1110;90;4904.00;95
13103;85;625566959;13103;316;14216;14308;6.46;0.40;301.19;10.93;1113;90;4905.00;92
13104;85;625566972;13104;318;14221;14308;6.43;0.40;301.17;10.93;1117;90;4906.00;87
13104;85;625566985;13104;324;14225;14309;6.38;0.39;301.17;10.93;1121;90;4907.00;84
13107;85;625566997;13107;330;14230;14309;6.26;0.39;301.13;10.94;1123;90;4908.00;79
13110;85;625567010;13110;331;14232;14309;6.20;0.38;301.09;10.94;1122;90;4909.00;77
13113;85;625567023;13113;335;14237;14309;6.10;0.37;301.11;10.96;1124;90;4910.00;72
13114;85;625567036;13114;339;14239;14313;6.05;0.37;301.10;10.95;1125;90;4911.00;74
13114;85;625567049;13114;345;14242;14313;5.99;0.37;301.10;10.97;1128;90;4912.00;71
13114;85;625567062;13114;348;14244;14313;5.95;0.37;301.10;10.97;1130;90;4913.00;69
13117;85;625567075;13117;346;14247;14316;5.89;0.36;301.06;10.98;1130;90;4914.00;69
13119;85;625567088;13119;354;14249;14316;5.83;0.36;301.05;10.98;1130;90;4915.00;67
13119;85;625567100;13119;356;14250;14316;5.81;0.36;301.05;10.98;1131;90;4916.00;66
13122;85;625567113;13122;367;14254;14320;5.81;0.36;301.17;10.99;1132;90;4917.00;66
13123;85;625567126;13123;365;14258;14321;5.78;0.36;301.15;10.99;1135;90;4918.00;63
13125;85;625567138;13125;371;14259;14321;5.75;0.35;301.14;11.00;1134;90;4919.00;62
13128;85;625567152;13128;371;14264;14326;5.78;0.36;301.12;10.99;1136;90;4920.00;62
13131;85;625567164;13131;379;14265;14326;5.66;0.35;301.14;11.00;1134;90;4921.00;61
13134;85;625567177;13134;380;14265;14326;5.55;0.34;301.11;11.00;1131;90;4922.00;61
13135;85;625567189;13135;388;14266;14327;5.48;0.34;301.11;11.00;1131;90;4923.00;61
13136;85;625567200;13136;387;14267;14327;5.44;0.33;301.10;11.01;1131;90;4924.00;60
13140;85;625567212;13140;395;14273;14333;5.38;0.33;301.10;11.02;1133;90;4925.00;60
13144;85;625567229;13144;402;14273;14333;5.23;0.32;301.06;11.02;1129;90;4926.00;60
13148;85;625567257;13148;402;14275;14334;5.08;0.31;301.02;11.03;1127;90;4927.00;59
13150;85;625567278;13150;415;14275;14334;4.98;0.31;301.01;11.03;1125;90;4928.00;59
13156;85;625567295;13156;427;14276;14334;4.81;0.30;301.00;11.04;1120;90;4929.00;58
13158;85;625567312;13158;421;14277;14334;4.70;0.29;300.99;11.05;1119;90;4930.00;57
13160;85;625567328;13160;398;14277;14334;4.62;0.28;300.98;11.05;1117;90;4931.00;57
13163;85;625567343;13163;386;14288;14346;4.70;0.29;300.98;11.05;1125;90;4932.00;58
13165;85;625567358;13165;385;14289;14346;4.75;0.29;301.02;11.06;1124;90;4933.00;57
13167;85;625567370;13167;384;14291;14346;4.82;0.30;301.04;11.06;1124;90;4934.00;55
13170;85;625567383;13170;376;14291;14346;4.91;0.30;301.04;11.06;1121;90;4935.00;55
13171;85;625567397;13171;378;14291;14346;5.00;0.31;301.05;11.06;1120;90;4936.00;55
13172;85;625567410;13172;370;14291;14346;5.11;0.31;301.06;11.06;1119;90;4937.00;55
13173;85;625567431;13173;364;14294;14350;5.23;0.32;301.06;11.06;1121;90;4938.00;56
13175;85;625567444;13175;360;14294;14350;5.28;0.32;301.06;11.06;1119;90;4939.00;56
13178;85;625567463;13178;359;14297;14354;5.37;0.33;301.08;11.06;1119;90;4940.00;57
13183;85;625567478;13183;366;14298;14355;5.42;0.33;301.03;11.06;1115;90;4941.00;57
13185;85;625567491;13185;363;14300;14355;5.48;0.33;301.02;11.10;1115;90;4942.00;55
13186;85;625567506;13186;355;14300;14355;5.54;0.34;301.02;11.10;1114;90;4943.00;55
13190;85;625567520;13190;348;14311;14368;5.65;0.34;301.03;11.09;1121;90;4944.00;57
13192;85;625567536;13192;351;14311;14368;5.67;0.35;301.02;11.09;1119;90;4945.00;57
13195;85;625567550;13195;355;14311;14368;5.69;0.35;301.02;11.09;1116;90;4946.00;57
13200;85;625567563;13200;346;14312;14369;5.71;0.35;301.02;11.09;1112;90;4947.00;57
13202;85;625567577;13202;348;14312;14370;5.77;0.35;301.00;11.09;1110;90;4948.00;58
13205;85;625567591;13205;351;14312;14370;5.82;0.35;301.00;11.09;1107;90;4949.00;58
13208;85;625567608;13208;353;14316;14379;5.88;0.36;301.00;11.09;1108;90;4950.00;63
13209;85;625567622;13209;344;14318;14379;5.95;0.36;300.99;11.09;1109;90;4951.00;61
13212;85;625567636;13212;339;14318;14379;5.94;0.36;300.98;11.09;1106;90;4952.00;61
13217;85;625567657;13217;337;14319;14379;6.04;0.37;300.95;11.09;1102;90;4953.00;60
13221;85;625567671;13221;334;14322;14385;6.12;0.37;300.98;11.08;1101;90;4954.00;63
13225;85;625567686;13225;340;14323;14385;6.14;0.38;301.00;11.08;1098;90;4955.00;62
13230;85;625567700;13230;336;14323;14385;6.12;0.37;300.99;11.08;1093;90;4956.00;62
13233;85;625567714;13233;340;14324;14385;6.13;0.38;300.98;11.08;1091;90;4957.00;61
13238;85;625567728;13238;344;14329;14389;6.18;0.38;300.94;11.12;1091;90;4958.00;60
13242;85;625567751;13242;346;14331;14390;6.20;0.38;300.96;11.12;1089;90;4959.00;59
13246;85;625567766;13246;351;14331;14390;6.24;0.38;301.01;11.12;1085;90;4960.00;59
13253;86;625567780;13253;362;14332;14391;6.25;0.38;301.04;11.12;1079;91;4961.00;59
13255;86;625567813;13255;361;14332;14391;6.31;0.38;301.10;11.12;1077;91;4962.00;59
13263;86;625567828;13263;362;14332;14391;6.25;0.38;301.25;11.12;1069;91;4963.00;59
13265;86;625567842;13265;358;14332;14391;6.24;0.38;301.26;11.12;1067;91;4964.00;59
13268;86;625567856;13268;358;14332;14391;6.24;0.38;301.29;11.12;1064;91;4965.00;59
13270;86;625567870;13270;359;14332;14391;6.24;0.38;301.34;11.12;1062;91;4966.00;59
13274;86;625567891;13274;361;14332;14391;6.29;0.38;301.38;11.12;1058;91;4967.00;59
13278;86;625567905;13278;377;14376;14461;6.37;0.39;301.44;11.08;1098;91;4968.00;85
13285;86;625567926;13285;373;14376;14462;6.39;0.39;301.48;11.08;1091;91;4969.00;86
13287;86;625567941;13287;370;14381;14462;6.51;0.40;301.50;11.08;1094;91;4970.00;81
13289;86;625567956;13289;370;14382;14462;6.54;0.40;301.48;11.08;1093;91;4971.00;80
13291;86;625567971;13291;374;14385;14462;6.56;0.40;301.55;11.08;1094;91;4972.00;77
13293;86;625567985;13293;376;14388;14462;6.59;0.40;301.57;11.08;1095;91;4973.00;74
13298;86;625568000;13298;383;14392;14462;6.61;0.40;301.65;11.11;1094;91;4974.00;70
13299;86;625568015;13299;387;14394;14462;6.62;0.40;301.66;11.11;1095;91;4975.00;68
13304;86;625568040;13304;390;14396;14463;6.56;0.40;301.71;11.11;1092;91;4976.00;67
13308;86;625568055;13308;382;14399;14464;6.48;0.39;301.70;11.11;1091;91;4977.00;65
13310;86;625568071;13310;383;14401;14464;6.42;0.39;301.75;11.11;1091;91;4978.00;63
13311;86;625568086;13311;386;14404;14468;6.38;0.39;301.78;11.11;1093;91;4979.00;64
13314;86;625568103;13314;385;14404;14468;6.38;0.39;301.83;11.11;1090;91;4980.00;64
13318;86;625568118;13318;384;14404;14468;6.38;0.39;301.84;11.11;1086;91;4981.00;64
13322;86;625568133;13322;385;14404;14468;6.41;0.39;301.88;11.11;1082;91;4982.00;64
13326;87;625568148;13326;394;14408;14474;6.42;0.39;301.95;11.10;1082;92;4983.00;66
13327;87;625568182;13327;400;14409;14474;6.46;0.39;301.95;11.10;1082;92;4984.00;65
13329;87;625568198;13329;400;14409;14474;6.44;0.39;301.94;11.10;1080;92;4985.00;65
13333;87;625568214;13333;391;14412;14477;6.47;0.39;302.00;11.10;1079;92;4986.00;65
13335;88;625568232;13335;378;14412;14477;6.53;0.40;302.01;11.10;1077;93;4987.00;65
13340;88;625568256;13340;366;14412;14477;6.52;0.40;302.07;11.10;1072;93;4988.00;65
13342;88;625568271;13342;360;14412;14478;6.57;0.40;302.15;11.10;1070;93;4989.00;66
13344;88;625568284;13344;351;14413;14479;6.65;0.40;302.15;11.10;1069;93;4990.00;66
13346;88;625568303;13346;341;14413;14479;6.69;0.41;302.20;11.10;1067;93;4991.00;66
13350;88;625568317;13350;341;14424;14492;6.71;0.41;302.26;11.09;1074;93;4992.00;68
13353;88;625568340;13353;343;14424;14492;6.69;0.41;302.24;11.09;1071;93;4993.00;68
13356;88;625568353;13356;347;14424;14492;6.62;0.40;302.24;11.09;1068;93;4994.00;68
13358;88;625568374;13358;350;14426;14494;6.59;0.40;302.24;11.09;1068;93;4995.00;68
13362;88;625568389;13362;355;14426;14494;6.54;0.40;302.35;11.09;1064;93;4996.00;68
13365;88;625568409;13365;353;14429;14498;6.50;0.40;302.36;11.09;1064;93;4997.00;69
13367;88;625568423;13367;350;14429;14498;6.43;0.39;302.40;11.09;1062;93;4998.00;69
13372;88;625568437;13372;348;14433;14502;6.38;0.39;302.42;11.08;1061;93;4999.00;69
13376;88;625568452;13376;344;14434;14502;6.31;0.38;302.51;11.12;1058;93;5000.00;68
13376;88;625568471;13376;338;14434;14502;6.36;0.39;302.51;11.12;1058;93;5001.00;68
13380;88;625568484;13380;337;14434;14502;6.35;0.39;302.55;11.12;1054;93;5002.00;68
13383;88;625568498;13383;330;14434;14502;6.36;0.39;302.55;11.12;1051;93;5003.00;68
13386;88;625568511;13386;325;14444;14514;6.44;0.39;302.51;11.11;1058;93;5004.00;70
13387;89;625568526;13387;318;14444;14514;6.47;0.39;302.49;11.11;1057;94;5005.00;70
13390;89;625568550;13390;314;14445;14514;6.49;0.39;302.63;11.11;1055;94;5006.00;69
13393;89;625568564;13393;309;14445;14514;6.50;0.39;302.64;11.11;1052;94;5007.00;69
13395;89;625568583;13395;304;14445;14514;6.57;0.40;302.64;11.11;1050;94;5008.00;69
13398;89;625568596;13398;309;14445;14514;6.55;0.40;302.69;11.11;1047;94;5009.00;69
13399;89;625568611;13399;306;14445;14515;6.53;0.40;302.68;11.11;1046;94;5010.00;70
13401;89;625568624;13401;300;14445;14515;6.55;0.40;302.69;11.11;1044;94;5011.00;70
13404;89;625568642;13404;306;14449;14521;6.58;0.40;302.72;11.11;1045;94;5012.00;72
13406;89;625568655;13406;302;14450;14522;6.60;0.40;302.73;11.11;1044;94;5013.00;72
13409;89;625568669;13409;304;14451;14522;6.60;0.40;302.78;11.11;1042;94;5014.00;71
13411;89;625568681;13411;308;14451;14522;6.62;0.40;302.81;11.11;1040;94;5015.00;71
13412;89;625568693;13412;313;14454;14526;6.60;0.40;302.81;11.11;1042;94;5016.00;72
13413;89;625568708;13413;324;14454;14526;6.59;0.40;302.79;11.11;1041;94;5017.00;72
13414;89;625568726;13414;317;14454;14526;6.55;0.40;302.79;11.11;1040;94;5018.00;72
13415;89;625568739;13415;319;14455;14527;6.57;0.40;302.79;11.11;1040;94;5019.00;72
13415;89;625568752;13415;315;14458;14531;6.55;0.40;302.79;11.10;1043;94;5020.00;73
13416;89;625568765;13416;309;14458;14531;6.49;0.40;302.80;11.10;1042;94;5021.00;73
13418;89;625568778;13418;308;14460;14534;6.45;0.39;302.79;11.10;1042;94;5022.00;74
13421;89;625568791;13421;309;14460;14534;6.34;0.39;302.79;11.10;1039;94;5023.00;74
13427;89;625568803;13427;307;14461;14534;6.22;0.38;302.81;11.10;1034;94;5024.00;73
13429;89;625568816;13429;299;14461;14534;6.20;0.38;302.80;11.10;1032;94;5025.00;73
13431;89;625568829;13431;300;14464;14538;6.17;0.38;302.80;11.10;1033;94;5026.00;74
13433;89;625568843;13433;299;14465;14538;6.14;0.37;302.82;11.13;1032;94;5027.00;73
13437;89;625568856;13437;295;14466;14538;6.16;0.38;302.92;11.13;1029;94;5028.00;72
13440;89;625568870;13440;287;14466;14538;6.14;0.37;303.00;11.13;1026;94;5029.00;72
13442;89;625568883;13442;278;14466;14539;6.06;0.37;303.03;11.13;1024;94;5030.00;73
13447;89;625568895;13447;268;14467;14540;5.98;0.36;303.08;11.13;1020;94;5031.00;73
13453;89;625568907;13453;256;14467;14540;5.86;0.36;303.09;11.13;1014;94;5032.00;73
13456;89;625568920;13456;253;14468;14541;5.83;0.35;303.14;11.13;1012;94;5033.00;73
13460;89;625568933;13460;245;14470;14541;5.82;0.35;303.17;11.18;1010;94;5034.00;71
13461;89;625568946;13461;238;14471;14541;5.86;0.36;303.23;11.20;1010;94;5035.00;70
13465;89;625568958;13465;229;14471;14541;5.80;0.35;303.24;11.20;1006;94;5036.00;70
13469;89;625568970;13469;228;14472;14541;5.78;0.35;303.27;11.23;1003;94;5037.00;69
13472;89;625568982;13472;225;14472;14541;5.77;0.35;303.24;11.23;1000;94;5038.00;69
13477;89;625568998;13477;223;14472;14541;5.77;0.35;303.26;11.23;995;94;5039.00;69
13481;89;625569012;13481;254;14571;14771;6.04;0.38;303.30;11.15;1090;94;5040.00;200
13483;89;625569043;13483;254;14572;14772;6.06;0.38;303.32;11.15;1089;94;5041.00;200
13485;89;625569056;13485;240;14583;14772;6.17;0.38;303.33;11.21;1098;94;5042.00;189
13486;89;625569068;13486;235;14588;14772;6.21;0.39;303.31;11.21;1102;94;5043.00;184
13489;89;625569087;13489;235;14595;14772;6.19;0.38;303.37;11.21;1106;94;5044.00;177
13491;89;625569105;13491;238;14601;14772;6.17;0.38;303.46;11.20;1110;94;5045.00;171
13491;89;625569123;13491;228;14608;14772;6.21;0.39;303.46;11.20;1117;94;5046.00;164
13491;89;625569135;13491;230;14614;14772;6.26;0.39;303.46;11.21;1123;94;5047.00;158
13495;89;625569147;13495;231;14620;14773;6.29;0.39;303.42;11.20;1125;94;5048.00;153
13497;89;625569169;13497;232;14625;14774;6.31;0.39;303.43;11.20;1128;94;5049.00;149
13501;89;625569182;13501;239;14629;14774;6.36;0.39;303.38;11.20;1128;94;5050.00;145
13501;89;625569195;13501;243;14633;14775;6.40;0.40;303.38;11.20;1132;94;5051.00;142
13502;89;625569208;13502;243;14638;14775;6.41;0.40;303.45;11.20;1136;94;5052.00;137
13505;89;625569225;13505;239;14640;14775;6.40;0.39;303.42;11.20;1135;94;5053.00;135
13506;89;625569248;13506;240;14644;14775;6.41;0.39;303.41;11.20;1138;94;5054.00;131
13507;89;625569269;13507;246;14646;14779;6.43;0.40;303.39;11.20;1139;94;5055.00;133
13509;89;625569291;13509;249;14651;14779;6.35;0.39;303.36;11.21;1142;94;5056.00;128
13512;89;625569321;13512;256;14653;14779;6.29;0.39;303.32;11.21;1141;94;5057.00;126
13512;89;625569347;13512;254;14657;14782;6.27;0.39;303.32;11.21;1145;94;5058.00;125
13515;89;625569373;13515;255;14659;14782;6.22;0.38;303.29;11.21;1144;94;5059.00;123
13515;89;625569390;13515;265;14663;14782;6.25;0.38;303.29;11.23;1148;94;5060.00;119
13517;89;625569405;13517;266;14670;14786;6.21;0.38;303.28;11.23;1153;94;5061.00;116
13519;89;625569421;13519;275;14673;14787;6.19;0.38;303.28;11.25;1154;94;5062.00;114
13519;89;625569436;13519;279;14674;14787;6.19;0.38;303.28;11.25;1155;94;5063.00;113
13523;89;625569451;13523;279;14678;14791;6.23;0.38;303.24;11.25;1155;94;5064.00;113
13523;89;625569479;13523;277;14682;14791;6.25;0.38;303.24;11.28;1159;94;5065.00;109
13525;89;625569493;13525;282;14684;14791;6.26;0.38;303.22;11.28;1159;94;5066.00;107
13527;89;625569508;13527;289;14685;14792;6.25;0.38;303.20;11.28;1158;94;5067.00;107
13529;89;625569523;13529;296;14687;14792;6.25;0.38;303.18;11.29;1158;94;5068.00;105
13530;89;625569537;13530;302;14692;14798;6.25;0.38;303.16;11.29;1162;94;5069.00;106
13532;89;625569553;13532;304;14695;14798;6.19;0.38;303.14;11.31;1163;94;5070.00;103
13533;89;625569568;13533;319;14696;14799;6.12;0.38;303.12;11.31;1163;94;5071.00;103
13539;89;625569582;13539;327;14697;14799;6.00;0.37;303.05;11.31;1158;94;5072.00;102
13542;89;625569596;13542;339;14699;14799;5.93;0.36;303.04;11.33;1157;94;5073.00;100
13543;89;625569609;13543;343;14701;14799;5.86;0.36;303.05;11.34;1158;94;5074.00;98
13547;89;625569623;13547;351;14704;14799;5.76;0.35;303.02;11.35;1157;94;5075.00;95
13547;89;625569636;13547;359;14718;14811;5.75;0.35;303.02;11.38;1171;94;5076.00;93
13547;89;625569651;13547;370;14721;14811;5.64;0.35;303.02;11.39;1174;94;5077.00;90
13549;89;625569664;13549;380;14723;14811;5.57;0.34;302.99;11.41;1174;94;5078.00;88
13552;89;625569677;13552;377;14726;14811;5.52;0.34;302.98;11.42;1174;94;5079.00;85
13552;89;625569690;13552;390;14730;14811;5.47;0.33;302.98;11.42;1178;94;5080.00;81
13553;89;625569703;13553;388;14732;14811;5.46;0.33;302.96;11.44;1179;94;5081.00;79
13555;89;625569716;13555;392;14737;14815;5.40;0.33;302.94;11.44;1182;94;5082.00;78
13555;89;625569729;13555;379;14738;14815;5.41;0.33;302.94;11.45;1183;94;5083.00;77
13556;89;625569743;13556;370;14742;14819;5.46;0.33;302.92;11.45;1186;94;5084.00;77
13560;89;625569763;13560;371;14745;14821;5.50;0.34;302.90;11.45;1185;94;5085.00;76
13561;89;625569778;13561;362;14746;14821;5.56;0.34;302.89;11.46;1185;94;5086.00;75
13561;89;625569792;13561;358;14747;14821;5.58;0.34;302.89;11.46;1186;94;5087.00;74
13564;89;625569806;13564;364;14759;14834;5.63;0.34;302.85;11.46;1195;94;5088.00;75
13564;90;625569821;13564;356;14759;14834;5.66;0.35;302.85;11.46;1195;95;5089.00;75
13564;90;625569853;13564;363;14760;14834;5.72;0.35;302.85;11.46;1196;95;5090.00;74
13566;90;625569867;13566;365;14762;14835;5.72;0.35;302.83;11.47;1196;95;5091.00;73
13567;90;625569881;13567;367;14763;14836;5.72;0.35;302.82;11.47;1196;95;5092.00;73
13570;90;625569900;13570;366;14764;14836;5.73;0.35;302.86;11.49;1194;95;5093.00;72
13573;90;625569915;13573;379;14767;14839;5.75;0.35;302.82;11.48;1194;95;5094.00;72
13575;90;625569936;13575;378;14768;14839;5.72;0.35;302.81;11.48;1193;95;5095.00;71
13579;90;625569950;13579;386;14769;14839;5.67;0.35;302.78;11.49;1190;95;5096.00;70
13580;90;625569964;13580;393;14769;14839;5.62;0.34;302.79;11.49;1189;95;5097.00;70
13582;90;625569979;13582;403;14776;14845;5.59;0.34;302.79;11.52;1194;95;5098.00;69
13583;90;625569993;13583;405;14776;14845;5.54;0.34;302.80;11.52;1193;95;5099.00;69
13584;90;625570008;13584;400;14781;14864;5.51;0.34;302.80;11.52;1197;95;5100.00;83
13586;90;625570029;13586;398;14783;14864;5.45;0.33;302.81;11.52;1197;95;5101.00;81
13587;90;625570043;13587;406;14787;14868;5.45;0.33;302.82;11.52;1200;95;5102.00;81
13591;90;625570057;13591;412;14789;14869;5.50;0.34;302.87;11.53;1198;95;5103.00;80
13593;90;625570072;13593;414;14789;14869;5.49;0.34;302.86;11.53;1196;95;5104.00;80
13597;90;625570086;13597;416;14791;14870;5.51;0.34;302.91;11.53;1194;95;5105.00;79
13600;90;625570100;13600;417;14792;14870;5.50;0.34;302.97;11.53;1192;95;5106.00;78
13603;90;625570114;13603;413;14793;14870;5.55;0.34;302.98;11.53;1190;95;5107.00;77
13605;90;625570129;13605;394;14793;14870;5.60;0.34;302.99;11.53;1188;95;5108.00;77
13610;90;625570144;13610;393;14797;14870;5.60;0.34;303.02;11.56;1187;95;5109.00;73
13612;90;625570159;13612;382;14797;14870;5.63;0.35;303.03;11.56;1185;95;5110.00;73
13616;90;625570173;13616;382;14798;14870;5.65;0.35;303.01;11.56;1182;95;5111.00;72
13623;90;625570187;13623;372;14830;14940;5.77;0.35;303.07;11.54;1207;95;5112.00;110
13626;90;625570210;13626;366;14833;14941;5.80;0.36;303.05;11.53;1207;95;5113.00;108
13629;90;625570230;13629;357;14840;14941;5.86;0.36;303.09;11.53;1211;95;5114.00;101
13632;90;625570245;13632;360;14844;14941;5.96;0.37;303.09;11.53;1212;95;5115.00;97
13636;90;625570259;13636;358;14848;14941;6.04;0.37;303.12;11.53;1212;95;5116.00;93
13640;90;625570274;13640;357;14852;14941;6.12;0.38;303.16;11.52;1212;95;5117.00;89
13644;90;625570288;13644;355;14856;14941;6.17;0.38;303.21;11.52;1212;95;5118.00;85
13648;90;625570302;13648;360;14858;14941;6.19;0.38;303.24;11.52;1210;95;5119.00;83
13656;90;625570317;13656;363;14858;14942;6.11;0.38;303.24;11.52;1202;95;5120.00;84
13661;90;625570332;13661;367;14861;14943;6.14;0.38;303.30;11.52;1200;95;5121.00;82
13667;90;625570347;13667;375;14862;14943;6.11;0.37;303.35;11.52;1195;95;5122.00;81
13670;90;625570362;13670;381;14867;14947;6.15;0.38;303.35;11.52;1197;95;5123.00;80
13675;90;625570377;13675;389;14867;14947;6.18;0.38;303.44;11.52;1192;95;5124.00;80
13682;90;625570391;13682;392;14867;14947;6.20;0.38;303.45;11.52;1185;95;5125.00;80
13688;90;625570405;13688;401;14867;14947;6.19;0.38;303.43;11.52;1179;95;5126.00;80
13692;90;625570421;13692;403;14870;14953;6.23;0.38;303.49;11.52;1178;95;5127.00;83
13697;90;625570436;13697;410;14871;14953;6.22;0.38;303.49;11.52;1174;95;5128.00;82
13702;90;625570451;13702;415;14872;14953;6.20;0.38;303.57;11.52;1170;95;5129.00;81
13706;90;625570468;13706;409;14875;14959;6.28;0.38;303.66;11.52;1169;95;5130.00;84
13710;90;625570484;13710;410;14877;14959;6.29;0.38;303.63;11.52;1167;95;5131.00;82
13714;90;625570499;13714;407;14877;14959;6.30;0.39;303.71;11.52;1163;95;5132.00;82
13719;90;625570513;13719;410;14878;14960;6.34;0.39;303.73;11.52;1159;95;5133.00;82
13722;90;625570528;13722;407;14880;14961;6.39;0.39;303.73;11.52;1158;95;5134.00;81
13730;90;625570544;13730;416;14881;14961;6.34;0.39;303.80;11.52;1151;95;5135.00;80
13737;90;625570559;13737;417;14889;14974;6.33;0.38;303.81;11.52;1152;95;5136.00;85
13738;90;625570575;13738;419;14890;14974;6.32;0.38;303.84;11.51;1152;95;5137.00;84
13740;90;625570590;13740;418;14891;14974;6.32;0.38;303.87;11.52;1151;95;5138.00;83
13745;90;625570604;13745;425;14894;14975;6.29;0.38;303.89;11.52;1149;95;5139.00;81
13748;90;625570619;13748;420;14895;14975;6.33;0.39;303.87;11.52;1147;95;5140.00;80
13750;90;625570634;13750;425;14899;14979;6.29;0.38;303.88;11.52;1149;95;5141.00;80
13753;90;625570650;13753;424;14899;14979;6.27;0.38;303.86;11.52;1146;95;5142.00;80
13757;90;625570664;13757;429;14902;14983;6.22;0.38;303.84;11.52;1145;95;5143.00;81
13761;90;625570680;13761;435;14902;14983;6.14;0.37;303.84;11.52;1141;95;5144.00;81
13765;90;625570694;13765;441;14903;14983;6.08;0.37;303.89;11.52;1138;95;5145.00;80
13768;90;625570709;13768;449;14904;14983;5.99;0.37;304.00;11.52;1136;95;5146.00;79
13770;90;625570723;13770;442;14905;14983;5.95;0.36;304.06;11.52;1135;95;5147.00;78
13774;90;625570738;13774;441;14913;14995;5.96;0.36;304.06;11.51;1139;95;5148.00;82
13776;90;625570754;13776;438;14915;14995;5.93;0.36;304.11;11.51;1139;95;5149.00;80
13779;90;625570769;13779;439;14916;14995;5.94;0.36;304.15;11.51;1137;95;5150.00;79
13782;90;625570784;13782;436;14916;14995;5.92;0.36;304.25;11.51;1134;95;5151.00;79
13786;90;625570799;13786;425;14917;14995;5.94;0.36;304.29;11.51;1131;95;5152.00;78
13788;90;625570814;13788;425;14917;14995;5.97;0.37;304.41;11.51;1129;95;5153.00;78
13789;90;625570828;13789;424;14918;14996;5.98;0.37;304.43;11.51;1129;95;5154.00;78
13795;90;625570841;13795;425;14920;14998;5.99;0.37;304.52;11.51;1125;95;5155.00;78
13799;90;625570856;13799;410;14924;15004;5.95;0.36;304.57;11.54;1125;95;5156.00;80
13807;90;625570872;13807;409;14926;15005;5.95;0.36;304.60;11.54;1119;95;5157.00;79
13811;90;625570887;13811;403;14926;15005;5.97;0.36;304.61;11.54;1115;95;5158.00;79
13815;90;625570901;13815;403;14926;15005;5.99;0.36;304.67;11.54;1111;95;5159.00;79
13819;90;625570917;13819;389;14930;15010;6.05;0.37;304.75;11.54;1111;95;5160.00;80
13822;90;625570933;13822;393;14930;15010;6.11;0.37;304.73;11.54;1108;95;5161.00;80
13823;90;625570947;13823;387;14931;15010;6.19;0.38;304.76;11.54;1108;95;5162.00;79
13827;90;625570961;13827;379;14932;15011;6.21;0.38;304.80;11.54;1105;95;5163.00;79
13827;90;625570981;13827;379;14937;15015;6.23;0.38;304.80;11.54;1110;95;5164.00;78
13831;90;625570995;13831;379;14937;15015;6.20;0.38;304.89;11.54;1106;95;5165.00;78
13834;90;625571015;13834;372;14940;15018;6.22;0.38;304.86;11.53;1106;95;5166.00;78
13835;90;625571029;13835;366;14940;15018;6.25;0.38;304.85;11.53;1105;95;5167.00;78
13836;90;625571048;13836;363;14940;15018;6.25;0.38;304.83;11.53;1104;95;5168.00;78
13836;90;625571063;13836;362;14940;15018;6.27;0.38;304.83;11.53;1104;95;5169.00;78
13837;90;625571076;13837;357;14944;15022;6.27;0.38;304.82;11.57;1107;95;5170.00;78
13840;90;625571091;13840;361;14945;15022;6.31;0.38;304.84;11.57;1105;95;5171.00;77
13842;90;625571105;13842;362;14945;15022;6.34;0.39;304.83;11.57;1103;95;5172.00;77
13845;90;625571119;13845;357;14945;15022;6.34;0.38;304.82;11.57;1100;95;5173.00;77
13849;90;625571132;13849;353;14945;15023;6.30;0.38;304.90;11.57;1096;95;5174.00;78
13852;90;625571147;13852;357;14948;15025;6.22;0.38;304.94;11.60;1096;95;5175.00;77
13854;90;625571160;13854;359;14948;15025;6.20;0.38;304.94;11.60;1094;95;5176.00;77
13857;90;625571174;13857;347;14949;15026;6.14;0.37;305.02;11.60;1092;95;5177.00;77
13858;90;625571187;13858;344;14949;15026;6.08;0.37;305.01;11.60;1091;95;5178.00;77
13861;90;625571200;13861;348;14949;15026;6.02;0.36;305.04;11.60;1088;95;5179.00;77
13863;90;625571214;13863;348;14949;15026;6.00;0.36;305.04;11.60;1086;95;5180.00;77
13865;90;625571232;13865;341;14949;15026;5.97;0.36;305.06;11.60;1084;95;5181.00;77
13867;90;625571254;13867;346;14949;15026;5.99;0.36;305.13;11.60;1082;95;5182.00;77
13869;90;625571274;13869;351;14949;15026;6.00;0.36;305.15;11.60;1080;95;5183.00;77
13869;90;625571294;13869;376;15023;15153;6.10;0.37;305.15;11.54;1154;95;5184.00;130
13871;90;625571325;13871;367;15024;15154;6.07;0.37;305.17;11.54;1153;95;5185.00;130
13873;90;625571344;13873;360;15029;15154;6.11;0.37;305.15;11.54;1156;95;5186.00;125
13873;90;625571359;13873;357;15030;15154;6.09;0.37;305.15;11.54;1157;95;5187.00;124
13873;90;625571373;13873;364;15037;15154;6.10;0.37;305.15;11.53;1164;95;5188.00;117
13877;90;625571387;13877;374;15037;15154;6.00;0.37;305.11;11.53;1160;95;5189.00;117
13878;90;625571404;13878;375;15042;15154;6.00;0.37;305.11;11.53;1164;95;5190.00;112
13878;90;625571418;13878;373;15044;15154;6.02;0.37;305.11;11.53;1166;95;5191.00;110
13882;90;625571433;13882;367;15046;15155;6.02;0.37;305.13;11.53;1164;95;5192.00;109
13882;90;625571449;13882;371;15050;15156;6.07;0.37;305.13;11.53;1168;95;5193.00;106
13884;90;625571462;13884;364;15051;15156;5.99;0.37;305.12;11.53;1167;95;5194.00;105
13884;90;625571479;13884;371;15056;15157;6.00;0.37;305.12;11.53;1172;95;5195.00;101
13887;90;625571494;13887;366;15059;15157;5.97;0.37;305.22;11.53;1172;95;5196.00;98
13888;90;625571514;13888;351;15060;15157;5.98;0.37;305.21;11.53;1172;95;5197.00;97
13888;90;625571528;13888;351;15062;15157;5.98;0.37;305.21;11.53;1174;95;5198.00;95
13890;90;625571542;13890;349;15064;15161;5.94;0.36;305.24;11.53;1174;95;5199.00;97
13895;90;625571557;13895;345;15064;15161;5.84;0.36;305.22;11.53;1169;95;5200.00;97
13898;90;625571576;13898;353;15066;15161;5.69;0.35;305.19;11.53;1168;95;5201.00;95
13901;90;625571590;13901;349;15068;15164;5.55;0.34;305.18;11.53;1167;95;5202.00;96
13905;90;625571604;13905;350;15070;15164;5.47;0.34;305.15;11.53;1165;95;5203.00;94
13909;91;625571619;13909;353;15071;15164;5.40;0.33;305.12;11.53;1162;96;5204.00;93
13911;91;625571645;13911;361;15077;15168;5.33;0.33;305.09;11.59;1166;96;5205.00;91
13913;91;625571662;13913;353;15079;15169;5.34;0.33;305.07;11.59;1166;96;5206.00;90
13915;91;625571675;13915;363;15079;15169;5.30;0.33;305.04;11.59;1164;96;5207.00;90
13919;91;625571689;13919;363;15082;15173;5.29;0.32;305.01;11.58;1163;96;5208.00;91
13921;91;625571702;13921;361;15082;15173;5.27;0.32;304.98;11.58;1161;96;5209.00;91
13926;91;625571715;13926;361;15082;15173;5.20;0.32;304.96;11.58;1156;96;5210.00;91
13927;91;625571729;13927;359;15084;15174;5.18;0.32;304.95;11.62;1157;96;5211.00;90
13928;91;625571742;13928;358;15085;15174;5.18;0.32;304.93;11.62;1157;96;5212.00;89
13930;91;625571755;13930;367;15088;15180;5.21;0.32;304.90;11.62;1158;96;5213.00;92
13930;91;625571771;13930;369;15088;15180;5.24;0.32;304.90;11.62;1158;96;5214.00;92
13935;91;625571784;13935;371;15090;15180;5.25;0.32;304.85;11.62;1155;96;5215.00;90
13936;91;625571797;13936;383;15091;15181;5.24;0.32;304.83;11.65;1155;96;5216.00;90
13940;91;625571811;13940;382;15092;15181;5.19;0.32;304.77;11.65;1152;96;5217.00;89
13942;91;625571824;13942;380;15092;15181;5.20;0.32;304.74;11.65;1150;96;5218.00;89
13946;91;625571837;13946;371;15093;15181;5.18;0.32;304.79;11.69;1147;96;5219.00;88
13948;91;625571853;13948;383;15114;15217;5.26;0.32;304.77;11.67;1166;96;5220.00;103
13948;91;625571869;13948;374;15115;15217;5.29;0.32;304.77;11.67;1167;96;5221.00;102
13950;91;625571882;13950;393;15118;15217;5.28;0.32;304.77;11.67;1168;96;5222.00;99
13951;91;625571896;13951;397;15118;15217;5.28;0.32;304.77;11.67;1167;96;5223.00;99
13952;91;625571909;13952;395;15119;15217;5.33;0.33;304.78;11.67;1167;96;5224.00;98
13953;91;625571923;13953;398;15120;15217;5.33;0.33;304.77;11.67;1167;96;5225.00;97
13954;91;625571936;13954;400;15124;15221;5.38;0.33;304.77;11.67;1170;96;5226.00;97
13958;91;625571950;13958;407;15125;15221;5.42;0.33;304.78;11.67;1167;96;5227.00;96
13960;91;625571964;13960;415;15130;15225;5.49;0.34;304.82;11.66;1170;96;5228.00;95
13960;91;625571979;13960;418;15133;15226;5.54;0.34;304.82;11.68;1173;96;5229.00;93
13960;91;625571993;13960;420;15134;15226;5.54;0.34;304.82;11.68;1174;96;5230.00;92
13963;91;625572006;13963;420;15135;15226;5.51;0.34;304.83;11.68;1172;96;5231.00;91
13963;91;625572020;13963;424;15146;15239;5.55;0.34;304.83;11.70;1183;96;5232.00;93
13964;91;625572034;13964;418;15147;15239;5.49;0.34;304.80;11.71;1183;96;5233.00;92
13966;91;625572048;13966;421;15147;15239;5.47;0.33;304.81;11.71;1181;96;5234.00;92
13967;91;625572061;13967;417;15151;15240;5.49;0.33;304.80;11.72;1184;96;5235.00;89
13971;91;625572075;13971;409;15152;15241;5.46;0.33;304.81;11.73;1181;96;5236.00;89
13972;91;625572096;13972;404;15152;15241;5.50;0.33;304.79;11.73;1180;96;5237.00;89
13977;91;625572109;13977;396;15157;15244;5.47;0.33;304.80;11.75;1180;96;5238.00;87
13977;91;625572124;13977;390;15158;15244;5.48;0.33;304.80;11.75;1181;96;5239.00;86
13977;92;625572137;13977;385;15159;15244;5.47;0.33;304.80;11.76;1182;97;5240.00;85
13977;92;625572163;13977;384;15160;15244;5.48;0.33;304.80;11.78;1183;97;5241.00;84
13978;92;625572176;13978;379;15165;15250;5.48;0.33;304.81;11.78;1187;97;5242.00;85
13978;92;625572190;13978;379;15167;15250;5.45;0.33;304.81;11.79;1189;97;5243.00;83
13979;92;625572209;13979;380;15169;15250;5.42;0.33;304.81;11.80;1190;97;5244.00;81
13980;92;625572230;13980;381;15170;15250;5.46;0.33;304.81;11.81;1190;97;5245.00;80
13981;92;625572244;13981;375;15174;15254;5.52;0.34;304.79;11.82;1193;97;5246.00;80
13983;92;625572258;13983;376;15175;15255;5.50;0.33;304.79;11.82;1192;97;5247.00;80
13984;92;625572273;13984;380;15177;15255;5.50;0.34;304.77;11.84;1193;97;5248.00;78
13985;92;625572285;13985;382;15178;15256;5.53;0.34;304.75;11.84;1193;97;5249.00;78
13989;92;625572300;13989;373;15180;15256;5.51;0.34;304.73;11.84;1191;97;5250.00;76
13990;92;625572318;13990;377;15181;15256;5.52;0.34;304.73;11.85;1191;97;5251.00;75
13993;92;625572331;13993;381;15182;15256;5.51;0.33;304.69;11.86;1189;97;5252.00;74
13993;92;625572350;13993;382;15183;15256;5.50;0.33;304.69;11.86;1190;97;5253.00;73
13994;92;625572362;13994;386;15185;15256;5.51;0.33;304.68;11.87;1191;97;5254.00;71
13994;92;625572375;13994;389;15185;15256;5.53;0.34;304.68;11.87;1191;97;5255.00;71
13995;92;625572387;13995;403;15219;15326;5.70;0.35;304.67;11.84;1224;97;5256.00;107
13996;92;625572406;13996;400;15221;15327;5.68;0.35;304.65;11.85;1225;97;5257.00;106
13997;92;625572425;13997;392;15231;15327;5.73;0.35;304.64;11.85;1234;97;5258.00;96
13998;92;625572438;13998;388;15237;15327;5.70;0.35;304.65;11.87;1239;97;5259.00;90
13999;92;625572456;13999;396;15244;15327;5.67;0.35;304.64;11.86;1245;97;5260.00;83
14003;92;625572469;14003;406;15250;15327;5.57;0.34;304.68;11.87;1247;97;5261.00;77
14007;92;625572482;14007;411;15255;15327;5.50;0.34;304.75;11.87;1248;97;5262.00;72
14009;92;625572495;14009;411;15255;15327;5.46;0.33;304.80;11.87;1246;97;5263.00;72
14012;92;625572508;14012;412;15258;15328;5.46;0.33;304.88;11.88;1246;97;5264.00;70
14017;92;625572521;14017;412;15262;15330;5.40;0.33;304.88;11.89;1245;97;5265.00;68
14021;92;625572535;14021;424;15262;15330;5.42;0.33;304.96;11.89;1241;97;5266.00;68
14025;92;625572549;14025;427;15266;15334;5.38;0.33;305.02;11.90;1241;97;5267.00;68
14031;92;625572562;14031;435;15266;15334;5.32;0.32;305.11;11.90;1235;97;5268.00;68
14034;92;625572575;14034;439;15267;15334;5.30;0.32;305.13;11.91;1233;97;5269.00;67
14038;92;625572588;14038;430;15268;15334;5.31;0.32;305.12;11.92;1230;97;5270.00;66
14043;92;625572601;14043;426;15274;15340;5.33;0.33;305.20;11.92;1231;97;5271.00;66
14045;92;625572615;14045;425;15275;15340;5.37;0.33;305.18;11.93;1230;97;5272.00;65
14053;92;625572629;14053;437;15275;15340;5.32;0.33;305.22;11.93;1222;97;5273.00;65
14057;92;625572643;14057;436;15278;15343;5.30;0.32;305.23;11.94;1221;97;5274.00;65
14062;92;625572657;14062;443;15279;15343;5.27;0.32;305.28;11.94;1217;97;5275.00;64
14065;92;625572670;14065;438;15279;15343;5.30;0.32;305.32;11.94;1214;97;5276.00;64
14067;92;625572684;14067;428;15279;15344;5.32;0.32;305.38;11.94;1212;97;5277.00;65
14070;92;625572699;14070;431;15280;15345;5.31;0.32;305.43;11.94;1210;97;5278.00;65
14073;92;625572713;14073;430;15280;15345;5.31;0.32;305.45;11.94;1207;97;5279.00;65
14075;92;625572728;14075;438;15300;15371;5.36;0.33;305.46;11.92;1225;97;5280.00;71
14078;92;625572744;14078;436;15301;15371;5.42;0.33;305.49;11.92;1223;97;5281.00;70
14082;92;625572758;14082;426;15302;15371;5.48;0.33;305.51;11.92;1220;97;5282.00;69
14086;92;625572772;14086;424;15303;15372;5.55;0.34;305.57;11.92;1217;97;5283.00;69
14090;92;625572787;14090;424;15303;15372;5.61;0.34;305.57;11.92;1213;97;5284.00;69
14094;92;625572801;14094;421;15307;15376;5.69;0.35;305.60;11.92;1213;97;5285.00;69
14097;92;625572816;14097;419;15307;15376;5.80;0.35;305.64;11.92;1210;97;5286.00;69
14098;92;625572831;14098;417;15310;15379;5.87;0.36;305.62;11.91;1212;97;5287.00;69
14105;92;625572851;14105;417;15310;15380;5.87;0.36;305.65;11.91;1205;97;5288.00;70
14111;92;625572866;14111;417;15310;15380;5.87;0.36;305.68;11.91;1199;97;5289.00;70
14114;92;625572880;14114;427;15310;15380;5.87;0.36;305.71;11.91;1196;97;5290.00;70
14120;92;625572894;14120;424;15310;15380;5.83;0.35;305.73;11.91;1190;97;5291.00;70
14126;92;625572909;14126;422;15318;15392;5.86;0.36;305.85;11.91;1192;97;5292.00;74
14128;92;625572925;14128;421;15319;15392;5.91;0.36;305.85;11.91;1191;97;5293.00;73
14132;92;625572940;14132;423;15320;15392;5.94;0.36;305.97;11.91;1188;97;5294.00;72
14139;92;625572956;14139;423;15320;15392;5.92;0.36;306.05;11.91;1181;97;5295.00;72
14144;92;625572974;14144;415;15320;15392;5.98;0.36;306.15;11.91;1176;97;5296.00;72
14150;92;625572989;14150;414;15320;15392;5.95;0.36;306.21;11.91;1170;97;5297.00;72
14153;92;625573009;14153;413;15320;15393;5.98;0.36;306.22;11.91;1167;97;5298.00;73
14157;92;625573024;14157;416;15320;15393;6.00;0.37;306.33;11.91;1163;97;5299.00;73
14160;92;625573041;14160;412;15324;15399;6.08;0.37;306.35;11.90;1164;97;5300.00;75
14164;92;625573062;14164;414;15326;15400;6.17;0.38;306.42;11.90;1162;97;5301.00;74
14168;92;625573078;14168;417;15326;15400;6.19;0.38;306.50;11.90;1158;97;5302.00;74
14173;92;625573093;14173;421;15326;15400;6.19;0.38;306.55;11.90;1153;97;5303.00;74
14175;92;625573108;14175;422;15329;15404;6.25;0.38;306.62;11.90;1154;97;5304.00;75
14180;92;625573123;14180;422;15330;15404;6.26;0.38;306.70;11.94;1150;97;5305.00;74
14184;92;625573138;14184;421;15330;15404;6.32;0.38;306.70;11.94;1146;97;5306.00;74
14190;92;625573153;14190;427;15331;15405;6.30;0.38;306.72;11.94;1141;97;5307.00;74
14194;92;625573168;14194;429;15334;15409;6.29;0.38;306.74;11.94;1140;97;5308.00;75
14200;92;625573189;14200;434;15334;15409;6.24;0.38;306.81;11.94;1134;97;5309.00;75
14203;92;625573206;14203;438;15337;15415;6.29;0.38;306.86;11.93;1134;97;5310.00;78
14205;92;625573220;14205;446;15338;15415;6.29;0.38;306.87;11.93;1133;97;5311.00;77
14207;92;625573246;14207;442;15338;15415;6.23;0.38;306.93;11.93;1131;97;5312.00;77
14208;92;625573276;14208;443;15339;15415;6.20;0.38;306.95;11.93;1131;97;5313.00;76
14210;92;625573309;14210;448;15341;15419;6.18;0.38;306.94;11.93;1131;97;5314.00;78
14212;92;625573332;14212;452;15342;15419;6.14;0.38;306.94;11.93;1130;97;5315.00;77
14216;92;625573350;14216;456;15342;15419;6.07;0.37;306.93;11.93;1126;97;5316.00;77
14218;92;625573365;14218;440;15343;15419;6.03;0.37;306.95;11.93;1125;97;5317.00;76
14221;92;625573381;14221;437;15343;15420;6.00;0.37;307.01;11.93;1122;97;5318.00;77
14223;92;625573399;14223;436;15345;15421;6.03;0.37;307.06;11.93;1122;97;5319.00;76
14226;92;625573414;14226;438;15345;15421;6.00;0.37;307.09;11.93;1119;97;5320.00;76
14231;92;625573430;14231;442;15346;15422;5.97;0.36;307.12;11.93;1115;97;5321.00;76
14234;92;625573446;14234;444;15346;15422;5.92;0.36;307.19;11.93;1112;97;5322.00;76
14239;92;625573493;14239;442;15346;15422;5.87;0.36;307.28;11.93;1107;97;5323.00;76
14243;92;625573514;14243;441;15346;15422;5.81;0.35;307.34;11.93;1103;97;5324.00;76
14247;92;625573535;14247;446;15347;15422;5.78;0.35;307.35;11.97;1100;97;5325.00;75
14253;92;625573550;14253;435;15347;15422;5.77;0.35;307.42;11.97;1094;97;5326.00;75
14255;92;625573572;14255;430;15347;15422;5.78;0.35;307.44;11.97;1092;97;5327.00;75
14257;92;625573587;14257;445;15413;15549;5.85;0.36;307.41;11.92;1156;97;5328.00;136
14258;92;625573613;14258;419;15415;15550;5.87;0.36;307.41;11.92;1157;97;5329.00;135
14262;92;625573630;14262;408;15424;15550;6.00;0.37;307.43;11.91;1162;97;5330.00;126
14263;92;625573646;14263;409;15426;15550;6.07;0.37;307.43;11.91;1163;97;5331.00;124
14265;92;625573662;14265;399;15430;15550;6.23;0.38;307.49;11.91;1165;97;5332.00;120
14269;92;625573677;14269;394;15434;15550;6.32;0.39;307.51;11.91;1165;97;5333.00;116
14270;92;625573693;14270;392;15439;15550;6.42;0.39;307.53;11.90;1169;97;5334.00;111
14270;92;625573709;14270;389;15440;15550;6.47;0.40;307.53;11.90;1170;97;5335.00;110
14273;92;625573725;14273;394;15446;15551;6.51;0.40;307.57;11.90;1173;97;5336.00;105
14273;92;625573741;14273;392;15450;15552;6.57;0.40;307.57;11.90;1177;97;5337.00;102
14278;92;625573756;14278;385;15453;15552;6.53;0.40;307.66;11.90;1175;97;5338.00;99
14279;92;625573773;14279;389;15457;15553;6.45;0.40;307.66;11.90;1178;97;5339.00;96
14284;93;625573791;14284;383;15459;15553;6.40;0.39;307.69;11.90;1175;98;5340.00;94
14288;93;625573826;14288;387;15460;15553;6.40;0.39;307.71;11.90;1172;98;5341.00;93
14288;93;625573842;14288;381;15463;15553;6.42;0.39;307.71;11.94;1175;98;5342.00;90
14292;93;625573860;14292;385;15466;15557;6.45;0.39;307.70;11.94;1174;98;5343.00;91
14294;93;625573876;14294;386;15467;15557;6.43;0.39;307.69;11.94;1173;98;5344.00;90
14296;93;625573891;14296;383;15468;15557;6.42;0.39;307.68;11.94;1172;98;5345.00;89
14298;93;625573906;14298;390;15471;15560;6.41;0.39;307.69;11.94;1173;98;5346.00;89
14299;93;625573921;14299;395;15471;15560;6.36;0.39;307.68;11.94;1172;98;5347.00;89
14300;93;625573938;14300;399;15472;15560;6.34;0.39;307.71;11.94;1172;98;5348.00;88
14303;93;625573952;14303;403;15475;15564;6.28;0.38;307.73;11.94;1172;98;5349.00;89
14306;93;625573978;14306;403;15477;15565;6.23;0.38;307.73;11.94;1171;98;5350.00;88
14308;93;625573993;14308;406;15477;15565;6.20;0.38;307.71;11.94;1169;98;5351.00;88
14308;93;625574008;14308;410;15481;15569;6.17;0.38;307.71;11.93;1173;98;5352.00;88
14311;93;625574023;14311;414;15481;15569;6.09;0.37;307.71;11.93;1170;98;5353.00;88
14315;93;625574038;14315;410;15481;15569;5.98;0.37;307.77;11.93;1166;98;5354.00;88
14318;93;625574053;14318;423;15483;15571;5.88;0.36;307.73;11.93;1165;98;5355.00;88
14321;93;625574068;14321;426;15483;15571;5.76;0.35;307.72;11.93;1162;98;5356.00;88
14323;93;625574083;14323;428;15488;15577;5.70;0.35;307.72;11.94;1165;98;5357.00;89
14324;93;625574098;14324;436;15488;15577;5.61;0.34;307.70;11.94;1164;98;5358.00;89
14327;93;625574111;14327;437;15489;15577;5.56;0.34;307.68;11.94;1162;98;5359.00;88
14329;93;625574125;14329;445;15489;15578;5.54;0.34;307.65;11.94;1160;98;5360.00;89
14334;93;625574139;14334;439;15489;15578;5.46;0.33;307.61;11.94;1155;98;5361.00;89
14336;93;625574160;14336;437;15490;15578;5.43;0.33;307.61;11.98;1154;98;5362.00;88
14340;93;625574174;14340;434;15490;15578;5.40;0.33;307.58;11.98;1150;98;5363.00;88
14341;93;625574188;14341;436;15498;15590;5.39;0.33;307.56;11.97;1157;98;5364.00;92
14343;93;625574202;14343;438;15498;15590;5.34;0.33;307.53;11.97;1155;98;5365.00;92
14344;93;625574215;14344;436;15500;15590;5.33;0.33;307.52;11.97;1156;98;5366.00;90
14344;93;625574230;14344;431;15500;15590;5.32;0.32;307.52;11.97;1156;98;5367.00;90
14346;93;625574243;14346;426;15500;15590;5.30;0.32;307.52;11.97;1154;98;5368.00;90
14349;93;625574256;14349;425;15500;15590;5.28;0.32;307.53;11.97;1151;98;5369.00;90
14352;93;625574272;14352;417;15503;15594;5.25;0.32;307.52;11.97;1151;98;5370.00;91
14353;93;625574286;14353;401;15503;15594;5.24;0.32;307.50;11.97;1150;98;5371.00;91
14357;93;625574298;14357;399;15506;15598;5.19;0.32;307.46;11.97;1149;98;5372.00;92
14362;93;625574310;14362;397;15509;15599;5.15;0.32;307.48;11.97;1147;98;5373.00;90
14363;93;625574322;14363;398;15510;15599;5.12;0.31;307.48;11.98;1147;98;5374.00;89
14369;93;625574336;14369;400;15511;15599;5.04;0.31;307.45;12.00;1142;98;5375.00;88
14374;93;625574348;14374;398;15521;15612;5.03;0.31;307.44;11.99;1147;98;5376.00;91
14380;93;625574361;14380;393;15521;15612;4.96;0.30;307.43;11.99;1141;98;5377.00;91
14382;93;625574374;14382;390;15523;15612;4.90;0.30;307.43;12.03;1141;98;5378.00;89
14385;93;625574385;14385;388;15525;15613;4.87;0.30;307.48;12.03;1140;98;5379.00;88
14387;93;625574397;14387;384;15525;15614;4.86;0.30;307.47;12.03;1138;98;5380.00;89
14388;93;625574409;14388;387;15526;15614;4.83;0.30;307.46;12.08;1138;98;5381.00;88
14390;93;625574427;14390;387;15528;15617;4.88;0.30;307.45;12.08;1138;98;5382.00;89
14392;93;625574439;14392;387;15530;15617;4.91;0.30;307.41;12.12;1138;98;5383.00;87
14393;93;625574452;14393;390;15530;15617;4.95;0.30;307.39;12.12;1137;98;5384.00;87
14394;93;625574464;14394;387;15530;15617;4.99;0.31;307.39;12.12;1136;98;5385.00;87
14399;93;625574476;14399;390;15534;15623;5.04;0.31;307.39;12.12;1135;98;5386.00;89
14399;93;625574489;14399;378;15534;15623;5.10;0.31;307.39;12.12;1135;98;5387.00;89
14402;93;625574501;14402;373;15537;15623;5.12;0.31;307.35;12.20;1135;98;5388.00;86
14403;93;625574513;14403;374;15538;15623;5.14;0.31;307.33;12.20;1135;98;5389.00;85
14405;93;625574526;14405;358;15542;15627;5.17;0.31;307.36;12.21;1137;98;5390.00;85
14407;93;625574539;14407;351;15544;15628;5.18;0.31;307.34;12.25;1137;98;5391.00;84
14407;93;625574552;14407;350;15544;15628;5.20;0.32;307.34;12.25;1137;98;5392.00;84
14409;93;625574564;14409;346;15545;15629;5.24;0.32;307.31;12.25;1136;98;5393.00;84
14410;93;625574584;14410;340;15545;15629;5.29;0.32;307.32;12.25;1135;98;5394.00;84
14411;93;625574597;14411;340;15545;15629;5.35;0.32;307.31;12.25;1134;98;5395.00;84
14411;93;625574610;14411;336;15546;15629;5.40;0.33;307.31;12.27;1135;98;5396.00;83
14413;93;625574623;14413;344;15546;15629;5.47;0.33;307.31;12.27;1133;98;5397.00;83
14413;93;625574636;14413;340;15546;15629;5.50;0.33;307.31;12.27;1133;98;5398.00;83
14413;93;625574654;14413;345;15546;15629;5.54;0.33;307.31;12.27;1133;98;5399.00;83
