step_arrived;step_collisions;step_duration;step_ended;step_halting;step_inserted;step_loaded;step_meanSpeed;step_meanSpeedRelative;step_meanTravelTime;step_meanWaitingTime;step_running;step_teleports;step_time;step_waiting
0;0;626309949;0;1;85;245;16.06;1.14;-1.00;0.00;85;0;0.00;160
0;0;626309978;0;1;97;245;15.27;1.06;-1.00;0.12;97;0;1.00;148
0;0;626309979;0;1;115;245;14.56;1.00;-1.00;0.42;115;0;2.00;130
0;0;626309980;0;2;131;245;13.24;0.90;-1.00;0.73;131;0;3.00;114
0;0;626309982;0;3;142;245;12.39;0.83;-1.00;0.99;142;0;4.00;103
0;0;626309983;0;8;154;245;11.38;0.76;-1.00;1.30;154;0;5.00;91
0;0;626309985;0;8;162;245;10.88;0.73;-1.00;1.53;162;0;6.00;83
0;0;626309986;0;11;168;245;10.41;0.69;-1.00;1.73;168;0;7.00;77
0;0;626309988;0;17;176;246;9.89;0.66;-1.00;2.01;176;0;8.00;70
0;0;626309990;0;18;181;247;9.52;0.63;-1.00;2.20;181;0;9.00;66
0;0;626309992;0;18;188;247;9.15;0.61;-1.00;2.49;188;0;10.00;59
0;0;626309994;0;21;194;248;9.01;0.60;-1.00;2.67;194;0;11.00;54
1;0;626309997;1;26;201;248;8.88;0.58;12.00;3.00;200;0;12.00;47
1;0;626309999;1;28;204;248;9.00;0.59;12.00;3.14;203;0;13.00;44
1;0;626310002;1;32;206;248;9.17;0.60;12.00;3.25;205;0;14.00;42
1;0;626310004;1;35;212;252;9.24;0.60;12.00;3.45;211;0;15.00;40
1;0;626310008;1;39;216;252;9.14;0.59;12.00;3.68;215;0;16.00;36
1;0;626310023;1;41;220;252;9.00;0.58;12.00;3.92;219;0;17.00;32
2;0;626310027;2;46;224;255;9.13;0.58;15.00;4.09;222;0;18.00;31
2;0;626310030;2;52;225;255;9.19;0.58;15.00;4.10;223;0;19.00;30
2;0;626310033;2;54;230;255;9.29;0.59;15.00;4.44;228;0;20.00;25
3;0;626310037;3;60;239;259;9.44;0.60;17.00;4.67;236;0;21.00;20
3;0;626310041;3;64;244;260;9.48;0.60;17.00;4.94;241;0;22.00;16
5;0;626310044;5;68;248;260;9.40;0.59;19.40;5.23;243;0;23.00;12
5;0;626310048;5;69;251;264;9.29;0.58;19.40;5.17;246;0;24.00;13
6;0;626310051;6;75;254;264;9.09;0.57;20.00;5.37;248;0;25.00;10
6;0;626310054;6;81;257;264;8.96;0.56;20.00;5.47;251;0;26.00;7
6;0;626310057;6;83;257;265;8.95;0.56;20.00;5.47;251;0;27.00;8
6;0;626310061;6;87;259;265;8.96;0.56;20.00;5.54;253;0;28.00;6
6;0;626310064;6;87;264;271;9.02;0.56;20.00;5.45;258;0;29.00;7
6;0;626310070;6;93;266;271;9.05;0.56;20.00;5.53;260;0;30.00;5
6;0;626310073;6;94;267;272;8.96;0.55;20.00;5.52;261;0;31.00;5
7;0;626310077;7;98;267;272;8.86;0.55;21.29;5.52;260;0;32.00;5
7;0;626310080;7;100;268;272;8.72;0.54;21.29;5.53;261;0;33.00;4
9;0;626310084;9;105;268;272;8.58;0.53;23.11;5.53;259;0;34.00;4
9;0;626310087;9;111;268;272;8.51;0.53;23.11;5.53;259;0;35.00;4
10;0;626310090;10;112;279;284;8.73;0.54;24.40;5.31;269;0;36.00;5
10;0;626310095;10;116;279;284;8.64;0.53;24.40;5.31;269;0;37.00;5
10;0;626310098;10;119;280;284;8.55;0.53;24.40;5.30;270;0;38.00;4
11;0;626310101;11;120;280;284;8.38;0.52;25.73;5.30;269;0;39.00;4
11;0;626310104;11;125;280;284;8.28;0.51;25.73;5.30;269;0;40.00;4
12;0;626310107;12;128;280;284;8.09;0.50;26.75;5.30;268;0;41.00;4
13;0;626310110;13;130;284;288;8.01;0.50;27.54;5.24;271;0;42.00;4
13;0;626310114;13;132;284;288;7.93;0.49;27.54;5.24;271;0;43.00;4
13;0;626310117;13;136;287;292;7.87;0.49;27.54;5.20;274;0;44.00;5
15;0;626310120;15;137;289;294;7.67;0.48;27.93;5.16;274;0;45.00;5
16;0;626310123;16;141;290;294;7.62;0.47;28.94;5.15;274;0;46.00;4
17;0;626310126;17;142;290;294;7.59;0.47;29.65;5.15;273;0;47.00;4
17;0;626310129;17;144;302;307;7.87;0.49;29.65;4.95;285;0;48.00;5
18;0;626310133;18;146;302;307;7.76;0.48;30.72;4.95;284;0;49.00;5
18;0;626310136;18;146;302;307;7.70;0.48;30.72;4.95;284;0;50.00;5
18;0;626310139;18;148;303;308;7.69;0.48;30.72;4.93;285;0;51.00;5
18;0;626310142;18;149;304;309;7.62;0.47;30.72;4.92;286;0;52.00;5
18;0;626310145;18;151;304;309;7.65;0.48;30.72;4.92;286;0;53.00;5
19;0;626310148;19;153;306;312;7.62;0.47;31.95;4.89;287;0;54.00;6
20;0;626310151;20;152;306;312;7.53;0.47;33.05;4.89;286;0;55.00;6
23;0;626310154;23;142;307;312;7.50;0.46;33.48;4.88;284;0;56.00;5
23;0;626310158;23;138;307;312;7.50;0.46;33.48;4.88;284;0;57.00;5
24;0;626310161;24;138;312;318;7.37;0.46;34.50;4.82;288;0;58.00;6
25;0;626310165;25;141;312;318;7.40;0.46;34.44;4.82;287;0;59.00;6
25;0;626310169;25;145;313;318;7.48;0.46;34.44;4.81;288;0;60.00;5
25;0;626310172;25;146;313;318;7.50;0.46;34.44;4.81;288;0;61.00;5
28;0;626310175;28;149;317;322;7.43;0.46;37.32;4.76;289;0;62.00;5
29;0;626310178;29;152;318;323;7.48;0.46;38.10;4.75;289;0;63.00;5
30;0;626310182;30;152;318;323;7.45;0.46;37.57;4.75;288;0;64.00;5
30;0;626310186;30;153;319;324;7.53;0.46;37.57;4.74;289;0;65.00;5
30;0;626310191;30;155;319;324;7.59;0.47;37.57;4.74;289;0;66.00;5
32;0;626310194;32;144;319;324;7.65;0.47;39.28;4.74;287;0;67.00;5
32;0;626310197;32;141;319;324;7.75;0.47;39.28;4.74;287;0;68.00;5
32;0;626310207;32;138;319;324;7.83;0.48;39.28;4.74;287;0;69.00;5
32;0;626310210;32;132;319;324;7.89;0.48;39.28;4.74;287;0;70.00;5
33;0;626310214;33;130;319;324;8.05;0.49;40.06;4.74;286;0;71.00;5
33;0;626310217;33;135;356;394;8.22;0.51;40.06;4.24;323;0;72.00;38
33;0;626310226;33;126;358;395;8.44;0.52;40.06;4.23;325;0;73.00;37
34;0;626310230;34;120;363;395;8.74;0.54;40.44;4.20;329;0;74.00;32
36;0;626310234;36;116;368;395;9.07;0.55;42.14;4.18;332;0;75.00;27
37;0;626310237;37;114;372;395;9.33;0.57;43.05;4.18;335;0;76.00;23
37;1;626310241;37;113;374;395;9.52;0.58;43.05;4.18;337;1;77.00;21
37;2;626310255;37;113;377;395;9.80;0.60;43.05;4.20;340;2;78.00;18
38;2;626310270;38;114;378;395;9.81;0.60;43.55;4.20;340;2;79.00;17
38;2;626310280;38;116;380;396;9.86;0.60;43.55;4.21;342;2;80.00;16
39;3;626310284;39;114;381;397;9.81;0.60;44.51;4.22;342;3;81.00;16
39;3;626310307;39;118;382;397;9.77;0.59;44.51;4.21;343;3;82.00;15
39;3;626310311;39;124;386;401;9.56;0.58;44.51;4.18;347;3;83.00;15
39;3;626310315;39;126;386;401;9.34;0.57;44.51;4.18;347;3;84.00;15
40;3;626310319;40;129;386;401;9.22;0.56;45.27;4.18;346;3;85.00;15
40;3;626310323;40;130;386;401;9.08;0.55;45.27;4.18;346;3;86.00;15
41;3;626310327;41;135;390;407;9.01;0.55;46.29;4.14;349;3;87.00;17
41;3;626310332;41;137;390;407;8.93;0.54;46.29;4.14;349;3;88.00;17
44;3;626310335;44;139;391;407;8.73;0.53;49.09;4.14;347;3;89.00;16
48;3;626310342;48;138;394;413;8.55;0.52;52.50;4.11;346;3;90.00;19
49;3;626310354;49;138;395;413;8.62;0.52;53.29;4.10;346;3;91.00;18
50;3;626310359;50;136;395;413;8.62;0.52;54.06;4.10;345;3;92.00;18
50;3;626310363;50;136;397;414;8.68;0.53;54.06;4.09;347;3;93.00;17
50;3;626310367;50;137;398;415;8.76;0.53;54.06;4.08;348;3;94.00;17
51;3;626310377;51;134;399;415;8.81;0.53;54.86;4.09;348;3;95.00;16
53;3;626310380;53;136;409;428;8.68;0.53;56.40;3.99;356;3;96.00;19
56;3;626310386;56;134;410;428;8.67;0.52;57.29;3.98;354;3;97.00;18
58;3;626310390;58;134;410;428;8.60;0.52;58.69;3.98;352;3;98.00;18
60;3;626310394;60;132;411;429;8.67;0.52;59.92;3.97;351;3;99.00;18
61;3;626310399;61;134;411;429;8.69;0.52;60.52;3.97;350;3;100.00;18
61;3;626310407;61;131;413;433;8.80;0.53;60.52;3.95;352;3;101.00;20
61;3;626310412;61;125;413;433;8.90;0.54;60.52;3.95;352;3;102.00;20
62;3;626310416;62;119;418;437;8.91;0.54;61.19;3.92;356;3;103.00;19
63;3;626310421;63;113;418;437;9.01;0.55;61.86;3.92;355;3;104.00;19
63;3;626310425;63;113;418;437;9.15;0.56;61.86;3.92;355;3;105.00;19
65;3;626310431;65;105;418;437;9.29;0.56;63.20;3.92;353;3;106.00;19
65;3;626310436;65;99;418;437;9.49;0.58;63.20;3.92;353;3;107.00;19
66;3;626310440;66;91;428;449;9.63;0.59;63.88;3.83;362;3;108.00;21
67;3;626310445;67;89;429;449;9.81;0.60;64.40;3.83;362;3;109.00;20
67;3;626310457;67;82;430;449;10.05;0.61;64.40;3.82;363;3;110.00;19
67;3;626310462;67;79;430;449;10.28;0.63;64.40;3.82;363;3;111.00;19
67;3;626310473;67;76;430;449;10.53;0.64;64.40;3.82;363;3;112.00;19
67;3;626310478;67;72;430;449;10.76;0.66;64.40;3.82;363;3;113.00;19
69;3;626310484;69;70;431;450;10.92;0.67;65.81;3.81;362;3;114.00;19
69;3;626310489;69;70;431;450;11.06;0.68;65.81;3.81;362;3;115.00;19
70;3;626310495;70;67;435;456;11.29;0.69;66.50;3.79;365;3;116.00;21
70;3;626310501;70;65;438;457;11.33;0.69;66.50;4.03;368;3;117.00;19
70;3;626310507;70;66;438;457;11.42;0.70;66.50;4.03;368;3;118.00;19
73;3;626310520;73;68;438;457;11.50;0.70;67.48;4.03;365;3;119.00;19
74;3;626310527;74;72;445;462;11.58;0.71;68.15;4.46;371;3;120.00;17
75;3;626310534;75;73;445;462;11.71;0.72;68.80;4.46;370;3;121.00;17
75;3;626310540;75;71;445;462;11.75;0.72;68.80;4.46;370;3;122.00;17
76;3;626310546;76;74;449;463;11.72;0.72;69.50;4.92;373;3;123.00;14
77;3;626310553;77;76;453;467;11.67;0.71;69.27;4.89;376;3;124.00;14
79;3;626310559;79;81;456;467;11.71;0.72;70.51;5.36;377;3;125.00;11
79;3;626310566;79;83;458;470;11.84;0.73;70.51;5.34;379;3;126.00;12
80;3;626310572;80;84;459;470;11.95;0.73;71.08;5.33;379;3;127.00;11
81;3;626310578;81;86;459;470;11.97;0.73;71.48;5.33;378;3;128.00;11
81;3;626310585;81;89;462;470;11.96;0.73;71.48;5.71;381;3;129.00;8
81;3;626310591;81;90;466;474;11.98;0.74;71.48;5.83;385;3;130.00;8
84;3;626310597;84;88;467;474;12.07;0.74;73.39;5.94;383;3;131.00;7
87;3;626310604;87;89;468;474;12.11;0.74;75.23;5.94;381;3;132.00;6
89;3;626310610;89;89;470;474;12.09;0.74;76.29;6.08;381;3;133.00;4
91;3;626310617;91;91;471;475;12.00;0.73;77.54;6.07;380;3;134.00;4
92;3;626310624;92;91;475;477;11.92;0.73;76.99;6.11;383;3;135.00;2
93;3;626310630;93;92;475;477;11.89;0.73;77.62;6.11;382;3;136.00;2
93;3;626310636;93;94;477;478;11.86;0.73;77.62;6.17;384;3;137.00;1
95;3;626310644;95;94;477;478;11.92;0.73;78.57;6.17;382;3;138.00;1
97;3;626310650;97;98;478;478;11.87;0.73;79.03;6.20;381;3;139.00;0
99;3;626310657;99;100;478;478;11.75;0.72;79.45;6.20;379;3;140.00;0
102;3;626310663;102;101;478;478;11.68;0.72;80.50;6.20;376;3;141.00;0
103;3;626310669;103;101;478;478;11.66;0.72;81.10;6.20;375;3;142.00;0
105;3;626310675;105;103;478;478;11.58;0.71;82.28;6.20;373;3;143.00;0
106;3;626310681;106;127;550;605;11.20;0.71;82.86;5.39;444;3;144.00;55
108;3;626310702;108;120;556;606;11.03;0.70;83.34;5.35;448;3;145.00;50
112;3;626310710;112;116;564;606;11.00;0.69;84.24;5.30;452;3;146.00;42
113;3;626310718;113;121;571;606;10.93;0.69;84.68;5.27;458;3;147.00;35
116;3;626310727;116;123;576;606;10.85;0.68;85.52;5.26;460;3;148.00;30
117;3;626310736;117;120;581;606;10.81;0.67;86.03;5.26;464;3;149.00;25
119;3;626310754;119;122;586;611;10.63;0.66;87.07;5.26;467;3;150.00;25
120;4;626310764;120;122;590;611;10.61;0.66;87.00;5.28;470;4;151.00;21
122;4;626310782;122;123;592;612;10.62;0.66;86.89;5.27;470;4;152.00;20
124;4;626310790;124;121;594;613;10.65;0.66;86.79;5.29;470;4;153.00;19
126;4;626310802;126;124;596;613;10.70;0.67;87.86;5.30;470;4;154.00;17
127;4;626310811;127;129;599;614;10.64;0.66;88.22;5.30;472;4;155.00;15
129;4;626310821;129;128;601;614;10.54;0.66;88.82;5.33;472;4;156.00;13
130;4;626310831;130;134;601;614;10.44;0.65;89.28;5.33;471;4;157.00;13
130;4;626310844;130;138;604;614;10.44;0.65;89.28;5.37;474;4;158.00;10
132;4;626310853;132;143;606;618;10.40;0.65;90.14;5.35;474;4;159.00;12
134;4;626310864;134;148;608;618;10.26;0.64;91.07;5.39;474;4;160.00;10
135;4;626310873;135;150;610;618;10.13;0.63;91.05;5.40;475;4;161.00;8
137;4;626310883;137;151;612;621;10.04;0.62;91.86;5.42;475;4;162.00;9
138;4;626310892;138;153;613;621;9.95;0.61;92.38;5.41;475;4;163.00;8
138;4;626310900;138;152;614;621;9.91;0.61;92.38;5.42;476;4;164.00;7
140;4;626310908;140;151;617;625;9.83;0.61;92.72;5.40;477;4;165.00;8
141;4;626310915;141;149;618;626;9.82;0.61;93.24;5.39;477;4;166.00;8
145;4;626310922;145;145;618;626;9.75;0.60;94.23;5.39;473;4;167.00;8
148;4;626310930;148;148;624;630;9.64;0.60;94.36;5.39;476;4;168.00;6
153;5;626310938;153;149;624;630;9.52;0.59;96.01;5.39;471;5;169.00;6
154;5;626310957;154;140;625;630;9.43;0.58;96.40;5.41;471;5;170.00;5
156;6;626310963;156;136;627;631;9.49;0.58;97.31;5.44;471;6;171.00;4
157;6;626310990;157;132;627;631;9.52;0.59;97.68;5.44;470;6;172.00;4
158;6;626310995;158;129;633;637;9.61;0.59;98.04;5.44;475;6;173.00;4
161;6;626311002;161;128;634;637;9.57;0.59;99.06;5.45;473;6;174.00;3
163;6;626311009;163;124;635;638;9.53;0.59;99.70;5.44;472;6;175.00;3
165;6;626311015;165;127;637;638;9.58;0.59;99.87;5.47;472;6;176.00;1
165;6;626311022;165;123;637;638;9.71;0.60;99.87;5.47;472;6;177.00;1
165;6;626311028;165;116;638;638;9.85;0.60;99.87;5.47;473;6;178.00;0
166;6;626311035;166;115;638;638;9.92;0.61;99.91;5.47;472;6;179.00;0
166;6;626311043;166;116;669;672;10.00;0.62;99.91;5.22;503;6;180.00;3
166;6;626311051;166;107;669;672;10.21;0.63;99.91;5.22;503;6;181.00;3
167;6;626311057;167;106;670;672;10.35;0.64;99.88;5.21;503;6;182.00;2
167;6;626311064;167;109;670;672;10.46;0.65;99.88;5.21;503;6;183.00;2
168;6;626311070;168;117;671;672;10.55;0.65;100.37;5.21;503;6;184.00;1
171;6;626311077;171;126;671;672;10.55;0.65;101.12;5.21;500;6;185.00;1
172;6;626311091;172;131;676;676;10.57;0.65;101.58;5.19;504;6;186.00;0
174;7;626311098;174;132;676;676;10.58;0.65;102.20;5.19;502;7;187.00;0
179;7;626311122;179;134;679;680;10.48;0.65;102.87;5.17;500;7;188.00;1
179;7;626311130;179;140;680;681;10.44;0.64;102.87;5.16;501;7;189.00;1
181;7;626311137;181;145;681;681;10.27;0.64;103.04;5.16;500;7;190.00;0
183;7;626311144;183;151;681;681;9.99;0.62;102.80;5.16;498;7;191.00;0
186;7;626311151;186;155;693;694;9.88;0.61;103.77;5.07;507;7;192.00;1
189;7;626311159;189;161;694;694;9.75;0.60;103.58;5.06;505;7;193.00;0
194;7;626311166;194;162;694;694;9.60;0.59;103.51;5.06;500;7;194.00;0
198;7;626311173;198;172;695;695;9.51;0.59;104.32;5.06;497;7;195.00;0
204;7;626311186;204;179;696;696;9.39;0.58;104.23;5.05;492;7;196.00;0
205;7;626311199;205;183;696;696;9.42;0.58;104.68;5.05;491;7;197.00;0
207;7;626311206;207;184;699;699;9.43;0.58;104.54;5.03;492;7;198.00;0
209;7;626311213;209;189;699;699;9.37;0.57;104.51;5.03;490;7;199.00;0
212;7;626311221;212;190;699;699;9.21;0.56;104.15;5.03;487;7;200.00;0
212;7;626311233;212;192;699;699;9.12;0.56;104.15;5.03;487;7;201.00;0
214;7;626311239;214;197;704;705;8.99;0.55;103.59;5.00;490;7;202.00;1
215;7;626311247;215;197;704;705;8.87;0.54;103.70;5.00;489;7;203.00;1
218;7;626311254;218;206;705;705;8.75;0.54;103.36;5.00;487;7;204.00;0
219;7;626311260;219;210;705;705;8.54;0.53;103.80;5.00;486;7;205.00;0
222;7;626311265;222;216;709;709;8.35;0.51;103.73;4.98;487;7;206.00;0
222;7;626311279;222;222;710;710;8.17;0.50;103.73;4.97;488;7;207.00;0
223;7;626311286;223;228;710;710;8.00;0.49;103.85;4.97;487;7;208.00;0
225;7;626311292;225;230;711;711;7.87;0.48;104.12;4.96;486;7;209.00;0
226;7;626311300;226;238;711;711;7.69;0.47;103.74;4.96;485;7;210.00;0
227;7;626311307;227;248;711;711;7.54;0.46;103.81;4.96;484;7;211.00;0
227;7;626311313;227;249;711;711;7.54;0.47;103.81;4.96;484;7;212.00;0
231;7;626311318;231;250;711;711;7.47;0.46;103.13;4.96;480;7;213.00;0
231;7;626311324;231;254;711;711;7.45;0.46;103.13;4.96;480;7;214.00;0
231;7;626311330;231;255;711;711;7.40;0.46;103.13;4.96;480;7;215.00;0
232;7;626311336;232;273;753;781;7.51;0.47;102.99;4.69;521;7;216.00;28
232;7;626311355;232;256;755;782;7.57;0.47;102.99;4.68;523;7;217.00;27
234;7;626311362;234;246;761;782;7.68;0.47;103.79;4.66;527;7;218.00;21
235;7;626311369;235;229;763;782;7.81;0.48;104.28;4.65;528;7;219.00;19
237;7;626311376;237;209;768;782;8.12;0.50;104.99;4.65;531;7;220.00;14
237;7;626311382;237;203;769;782;8.32;0.51;104.99;4.65;532;7;221.00;13
241;7;626311389;241;196;775;782;8.58;0.53;106.37;4.66;534;7;222.00;7
244;7;626311397;244;190;775;782;8.71;0.53;107.64;4.66;531;7;223.00;7
244;7;626311404;244;183;779;783;8.91;0.55;107.64;4.68;535;7;224.00;4
245;7;626311411;245;180;784;785;8.95;0.55;108.11;4.67;539;7;225.00;1
246;7;626311424;246;165;785;785;9.04;0.55;108.17;4.68;539;7;226.00;0
246;7;626311432;246;151;789;789;9.12;0.56;108.17;4.66;543;7;227.00;0
249;7;626311441;249;139;789;789;9.22;0.56;108.91;4.66;540;7;228.00;0
250;7;626311459;250;133;789;789;9.39;0.58;108.57;4.66;539;7;229.00;0
250;7;626311468;250;126;789;789;9.58;0.59;108.57;4.66;539;7;230.00;0
254;7;626311476;254;122;794;795;9.74;0.60;109.17;4.64;540;7;231.00;1
255;7;626311485;255;118;794;795;9.83;0.60;109.62;4.64;539;7;232.00;1
257;7;626311493;257;115;795;795;9.89;0.60;110.00;4.63;538;7;233.00;0
258;7;626311501;258;111;797;798;9.94;0.61;110.11;4.62;539;7;234.00;1
260;7;626311510;260;107;798;798;10.02;0.61;110.99;4.62;538;7;235.00;0
260;7;626311519;260;103;798;798;10.10;0.62;110.99;4.62;538;7;236.00;0
260;7;626311526;260;99;799;799;10.12;0.62;110.99;4.61;539;7;237.00;0
262;7;626311535;262;95;800;800;10.22;0.62;111.11;4.61;538;7;238.00;0
263;7;626311543;263;91;800;800;10.26;0.63;111.05;4.61;537;7;239.00;0
264;7;626311552;264;98;824;826;10.19;0.62;110.91;4.47;560;7;240.00;2
267;7;626311562;267;98;825;826;10.32;0.63;111.89;4.47;558;7;241.00;1
269;7;626311569;269;94;826;826;10.47;0.64;112.83;4.47;557;7;242.00;0
271;7;626311576;271;96;827;827;10.59;0.65;113.60;4.46;556;7;243.00;0
273;7;626311584;273;102;827;827;10.59;0.65;113.77;4.46;554;7;244.00;0
276;7;626311592;276;108;830;831;10.54;0.64;114.32;4.45;554;7;245.00;1
279;8;626311600;279;113;830;831;10.55;0.64;114.67;4.45;551;8;246.00;1
282;8;626311618;282;121;835;835;10.45;0.64;115.25;4.43;553;8;247.00;0
284;8;626311625;284;124;835;835;10.43;0.64;115.62;4.43;551;8;248.00;0
285;8;626311633;285;128;835;835;10.35;0.63;115.59;4.43;550;8;249.00;0
289;8;626311640;289;132;835;835;10.35;0.63;116.69;4.43;546;8;250.00;0
291;8;626311648;291;134;835;835;10.28;0.63;117.18;4.43;544;8;251.00;0
293;8;626311654;293;139;845;847;10.27;0.62;117.36;4.38;552;8;252.00;2
293;8;626311663;293;143;845;847;10.21;0.62;117.36;4.38;552;8;253.00;2
295;8;626311670;295;150;847;847;10.15;0.62;117.77;4.37;552;8;254.00;0
295;8;626311677;295;153;847;847;10.17;0.62;117.77;4.37;552;8;255.00;0
298;8;626311683;298;154;847;847;10.11;0.62;118.19;4.37;549;8;256.00;0
299;8;626311691;299;157;847;847;10.18;0.62;118.63;4.37;548;8;257.00;0
300;8;626311697;300;157;848;848;10.13;0.62;118.75;4.37;548;8;258.00;0
302;8;626311705;302;160;848;848;10.04;0.61;118.57;4.37;546;8;259.00;0
302;8;626311711;302;160;853;854;9.99;0.61;118.57;4.35;551;8;260.00;1
304;8;626311726;304;152;854;855;10.01;0.61;118.56;4.34;550;8;261.00;1
304;8;626311734;304;149;855;855;10.09;0.61;118.56;4.34;551;8;262.00;0
307;8;626311742;307;146;855;855;10.11;0.61;118.65;4.34;548;8;263.00;0
308;8;626311749;308;141;859;859;10.17;0.62;118.66;4.32;551;8;264.00;0
309;8;626311758;309;141;859;859;10.27;0.62;118.66;4.32;550;8;265.00;0
312;8;626311768;312;136;859;859;10.37;0.63;119.63;4.32;547;8;266.00;0
315;8;626311775;315;133;860;860;10.45;0.63;120.27;4.32;545;8;267.00;0
318;8;626311782;318;136;864;864;10.36;0.63;120.48;4.30;546;8;268.00;0
321;8;626311789;321;135;864;864;10.35;0.63;120.86;4.30;543;8;269.00;0
325;8;626311798;325;130;867;870;10.36;0.63;121.82;4.29;542;8;270.00;3
328;8;626311806;328;129;867;870;10.37;0.63;121.69;4.29;539;8;271.00;3
331;8;626311814;331;117;868;870;10.47;0.63;122.40;4.29;537;8;272.00;2
333;8;626311823;333;111;868;870;10.58;0.64;122.65;4.29;535;8;273.00;2
335;8;626311829;335;105;871;874;10.70;0.65;122.90;4.28;536;8;274.00;3
338;8;626311837;338;102;871;874;10.86;0.66;123.45;4.28;533;8;275.00;3
340;8;626311845;340;96;872;874;11.01;0.66;123.36;4.28;532;8;276.00;2
341;8;626311852;341;95;872;874;11.10;0.67;123.78;4.28;531;8;277.00;2
343;8;626311859;343;88;874;875;11.20;0.68;123.72;4.28;531;8;278.00;1
343;8;626311867;343;83;875;876;11.25;0.68;123.72;4.27;532;8;279.00;1
345;8;626311875;345;80;876;876;11.30;0.69;123.58;4.28;531;8;280.00;0
347;8;626311882;347;77;877;877;11.39;0.69;123.63;4.27;530;8;281.00;0
350;8;626311892;350;78;877;877;11.43;0.69;123.54;4.27;527;8;282.00;0
351;8;626311900;351;79;877;877;11.41;0.69;123.78;4.27;526;8;283.00;0
354;8;626311908;354;81;877;877;11.43;0.69;123.82;4.27;523;8;284.00;0
355;8;626311922;355;81;877;877;11.43;0.69;124.14;4.27;522;8;285.00;0
355;8;626311930;355;83;877;877;11.46;0.69;124.14;4.27;522;8;286.00;0
357;8;626311938;357;79;877;877;11.47;0.70;124.14;4.27;520;8;287.00;0
358;8;626311945;358;97;951;1004;11.14;0.69;124.60;3.94;593;8;288.00;53
358;8;626311970;358;88;954;1005;11.20;0.69;124.60;3.93;596;8;289.00;51
358;8;626311979;358;86;960;1005;11.43;0.71;124.60;3.92;602;8;290.00;45
360;8;626311987;360;85;966;1005;11.44;0.71;124.92;3.92;606;8;291.00;39
360;8;626311996;360;91;971;1005;11.48;0.71;124.92;3.92;611;8;292.00;34
362;8;626312005;362;90;976;1005;11.47;0.71;125.10;3.92;614;8;293.00;29
365;8;626312015;365;87;981;1005;11.55;0.71;125.93;3.93;616;8;294.00;24
367;8;626312024;367;85;984;1005;11.60;0.71;126.06;3.94;617;8;295.00;21
369;8;626312033;369;85;987;1006;11.69;0.72;126.00;3.95;618;8;296.00;19
372;8;626312042;372;84;988;1007;11.76;0.72;126.46;3.95;616;8;297.00;19
372;8;626312052;372;87;990;1007;11.90;0.73;126.46;3.96;618;8;298.00;17
376;8;626312060;376;89;991;1008;11.98;0.73;126.77;3.97;615;8;299.00;17
377;8;626312072;377;93;996;1014;11.91;0.73;127.08;4.00;619;8;300.00;18
379;8;626312087;379;97;997;1014;11.90;0.73;127.37;4.01;618;8;301.00;17
379;8;626312097;379;102;999;1014;11.89;0.73;127.37;4.03;620;8;302.00;15
381;8;626312105;381;109;1001;1018;11.83;0.73;127.66;4.02;620;8;303.00;17
382;8;626312115;382;117;1004;1018;11.73;0.72;127.93;4.06;622;8;304.00;14
384;8;626312125;384;126;1007;1018;11.58;0.71;128.56;4.08;623;8;305.00;11
385;8;626312134;385;130;1011;1021;11.47;0.70;128.72;4.09;626;8;306.00;10
387;8;626312144;387;136;1011;1021;11.37;0.70;129.54;4.09;624;8;307.00;10
392;8;626312153;392;144;1012;1021;11.25;0.69;129.97;4.09;620;8;308.00;9
392;8;626312162;392;147;1015;1025;11.09;0.68;129.97;4.08;623;8;309.00;10
396;8;626312171;396;150;1016;1026;11.00;0.68;131.07;4.08;620;8;310.00;10
400;8;626312180;400;152;1017;1026;10.79;0.67;131.57;4.08;617;8;311.00;9
401;8;626312189;401;156;1021;1030;10.79;0.67;131.57;4.07;620;8;312.00;9
403;8;626312197;403;156;1021;1030;10.73;0.66;131.85;4.07;618;8;313.00;9
406;8;626312206;406;160;1022;1030;10.61;0.66;132.01;4.08;616;8;314.00;8
407;8;626312215;407;167;1024;1032;10.55;0.65;131.87;4.07;617;8;315.00;8
412;8;626312224;412;171;1024;1032;10.44;0.64;132.88;4.07;612;8;316.00;8
414;8;626312232;414;175;1028;1038;10.32;0.64;133.40;4.06;614;8;317.00;10
418;8;626312249;418;176;1028;1038;10.19;0.63;133.82;4.06;610;8;318.00;10
421;8;626312258;421;176;1029;1039;10.01;0.62;134.96;4.05;608;8;319.00;10
425;8;626312267;425;182;1031;1039;9.89;0.61;134.98;4.10;606;8;320.00;8
427;8;626312275;427;180;1032;1039;9.80;0.60;135.39;4.11;605;8;321.00;7
430;9;626312283;430;188;1034;1039;9.80;0.60;135.56;4.14;604;9;322.00;5
430;9;626312304;430;191;1036;1039;9.90;0.61;135.56;4.18;606;9;323.00;3
432;9;626312312;432;192;1047;1051;9.96;0.61;135.83;4.13;615;9;324.00;4
433;9;626312321;433;193;1048;1051;9.97;0.61;135.97;4.14;615;9;325.00;3
436;9;626312330;436;195;1050;1051;9.96;0.61;136.09;4.18;614;9;326.00;1
438;9;626312338;438;193;1050;1051;10.00;0.61;135.82;4.18;612;9;327.00;1
438;9;626312347;438;199;1051;1051;10.01;0.61;135.82;4.18;613;9;328.00;0
441;9;626312354;441;197;1051;1051;10.09;0.62;135.64;4.18;610;9;329.00;0
447;9;626312365;447;201;1055;1055;10.00;0.61;136.48;4.16;608;9;330.00;0
447;9;626312373;447;203;1055;1055;10.01;0.61;136.48;4.16;608;9;331.00;0
448;9;626312380;448;209;1058;1059;10.01;0.61;136.91;4.16;610;9;332.00;1
451;9;626312394;451;212;1059;1060;9.92;0.60;137.66;4.15;608;9;333.00;1
454;9;626312401;454;213;1060;1060;9.79;0.60;138.17;4.15;606;9;334.00;0
459;9;626312408;459;214;1060;1060;9.67;0.59;139.08;4.15;601;9;335.00;0
462;9;626312415;462;211;1071;1073;9.47;0.58;139.66;4.11;609;9;336.00;2
462;9;626312424;462;217;1071;1073;9.29;0.57;139.66;4.11;609;9;337.00;2
468;9;626312430;468;219;1073;1073;9.06;0.55;139.93;4.10;605;9;338.00;0
470;9;626312437;470;225;1074;1074;8.80;0.54;140.32;4.10;604;9;339.00;0
474;9;626312443;474;216;1075;1075;8.54;0.52;141.13;4.10;601;9;340.00;0
477;9;626312450;477;213;1075;1075;8.33;0.51;141.26;4.10;598;9;341.00;0
478;9;626312457;478;209;1077;1078;8.27;0.51;141.68;4.09;599;9;342.00;1
482;9;626312463;482;211;1078;1078;8.19;0.50;142.32;4.09;596;9;343.00;0
485;9;626312470;485;211;1078;1078;8.10;0.50;143.06;4.09;593;9;344.00;0
488;9;626312476;488;219;1078;1078;8.04;0.50;143.64;4.09;590;9;345.00;0
488;9;626312483;488;218;1083;1084;8.15;0.50;143.64;4.07;595;9;346.00;1
493;9;626312490;493;212;1083;1084;8.09;0.50;144.30;4.07;590;9;347.00;1
494;9;626312497;494;208;1084;1084;8.14;0.50;144.53;4.07;590;9;348.00;0
497;9;626312504;497;209;1084;1084;8.20;0.51;144.82;4.07;587;9;349.00;0
502;9;626312510;502;208;1088;1088;8.18;0.50;144.78;4.06;586;9;350.00;0
502;9;626312517;502;210;1089;1089;8.16;0.50;144.78;4.06;587;9;351.00;0
507;9;626312524;507;212;1089;1089;8.10;0.50;145.62;4.06;582;9;352.00;0
509;9;626312530;509;212;1090;1090;8.17;0.50;145.67;4.06;581;9;353.00;0
514;9;626312538;514;216;1090;1090;8.07;0.50;145.72;4.06;576;9;354.00;0
522;9;626312545;522;222;1090;1090;7.89;0.49;145.66;4.06;568;9;355.00;0
525;9;626312552;525;217;1090;1090;7.82;0.48;145.32;4.06;565;9;356.00;0
525;9;626312559;525;221;1090;1090;7.78;0.48;145.32;4.06;565;9;357.00;0
526;9;626312565;526;228;1090;1090;7.72;0.48;145.17;4.06;564;9;358.00;0
529;9;626312572;529;229;1090;1090;7.66;0.47;145.60;4.06;561;9;359.00;0
532;9;626312580;532;244;1160;1215;7.92;0.50;146.05;3.81;628;9;360.00;55
534;9;626312597;534;242;1167;1216;7.85;0.49;146.23;3.79;633;9;361.00;49
539;9;626312611;539;236;1180;1216;7.90;0.49;146.49;3.77;641;9;362.00;36
540;9;626312619;540;232;1187;1216;7.93;0.49;146.53;3.77;647;9;363.00;29
540;9;626312626;540;237;1192;1216;7.96;0.50;146.53;3.77;652;9;364.00;24
545;9;626312633;545;238;1195;1216;7.92;0.49;146.60;3.77;650;9;365.00;21
546;9;626312642;546;238;1200;1216;7.89;0.49;146.47;3.78;654;9;366.00;16
549;9;626312650;549;241;1202;1216;7.80;0.48;146.68;3.79;653;9;367.00;14
551;9;626312658;551;245;1206;1217;7.71;0.48;146.52;3.80;655;9;368.00;11
551;9;626312666;551;248;1207;1218;7.70;0.48;146.52;3.80;656;9;369.00;11
553;9;626312674;553;252;1210;1218;7.65;0.48;146.69;3.81;657;9;370.00;8
556;9;626312682;556;244;1215;1222;7.61;0.47;146.56;3.80;659;9;371.00;7
559;9;626312691;559;235;1217;1222;7.55;0.47;146.80;3.82;658;9;372.00;5
562;9;626312699;562;237;1218;1222;7.54;0.47;146.82;3.83;656;9;373.00;4
563;9;626312707;563;238;1218;1222;7.62;0.47;147.20;3.83;655;9;374.00;4
567;9;626312715;567;230;1224;1228;7.61;0.47;147.25;3.83;657;9;375.00;4
568;9;626312725;568;222;1225;1228;7.73;0.48;147.31;3.83;657;9;376.00;3
570;9;626312733;570;221;1225;1228;7.89;0.48;147.18;3.83;655;9;377.00;3
571;9;626312760;571;221;1229;1231;8.07;0.50;147.33;3.84;658;9;378.00;2
575;9;626312769;575;217;1229;1231;8.22;0.50;147.55;3.84;654;9;379.00;2
576;9;626312778;576;215;1230;1231;8.31;0.51;147.66;3.85;654;9;380.00;1
577;9;626312793;577;214;1232;1232;8.45;0.52;147.80;3.85;655;9;381.00;0
578;9;626312808;578;214;1233;1233;8.54;0.52;147.89;3.85;655;9;382.00;0
579;9;626312835;579;214;1233;1233;8.62;0.53;147.68;3.85;654;9;383.00;0
581;9;626312849;581;217;1246;1246;8.72;0.53;147.69;3.81;665;9;384.00;0
581;9;626312864;581;215;1246;1246;8.75;0.53;147.69;3.81;665;9;385.00;0
582;9;626312877;582;219;1246;1246;8.72;0.53;147.48;3.81;664;9;386.00;0
584;9;626312891;584;211;1247;1247;8.77;0.54;147.06;3.80;663;9;387.00;0
584;9;626312917;584;210;1247;1247;8.81;0.54;147.06;3.80;663;9;388.00;0
585;10;626312928;585;205;1250;1251;8.93;0.55;146.98;3.80;665;10;389.00;1
585;10;626312954;585;208;1250;1251;8.98;0.55;146.98;3.80;665;10;390.00;1
588;10;626312965;588;209;1255;1255;9.00;0.55;147.40;3.79;667;10;391.00;0
591;10;626312976;591;209;1255;1255;9.10;0.55;147.68;3.79;664;10;392.00;0
593;10;626312987;593;216;1255;1255;9.16;0.56;147.52;3.79;662;10;393.00;0
596;10;626312997;596;214;1255;1255;9.13;0.56;148.15;3.79;659;10;394.00;0
598;10;626313007;598;214;1255;1255;9.11;0.55;148.17;3.79;657;10;395.00;0
600;10;626313024;600;208;1266;1267;9.14;0.56;148.74;3.75;666;10;396.00;1
601;10;626313036;601;189;1267;1267;9.19;0.56;148.73;3.75;666;10;397.00;0
603;10;626313051;603;177;1267;1267;9.22;0.56;149.43;3.75;664;10;398.00;0
605;10;626313061;605;168;1267;1267;9.27;0.56;149.52;3.75;662;10;399.00;0
608;10;626313071;608;162;1267;1267;9.27;0.57;150.22;3.75;659;10;400.00;0
611;10;626313091;611;156;1267;1267;9.40;0.57;150.82;3.75;656;10;401.00;0
612;10;626313102;612;157;1268;1268;9.49;0.58;151.18;3.75;656;10;402.00;0
615;10;626313112;615;155;1268;1268;9.57;0.59;151.43;3.75;653;10;403.00;0
616;10;626313122;616;156;1273;1274;9.66;0.59;151.61;3.74;657;10;404.00;1
619;10;626313132;619;157;1275;1276;9.77;0.60;151.82;3.73;656;10;405.00;1
620;11;626313142;620;162;1276;1276;9.88;0.61;152.17;3.73;656;11;406.00;0
623;11;626313158;623;163;1276;1276;9.95;0.61;152.61;3.73;653;11;407.00;0
626;11;626313172;626;160;1280;1280;10.03;0.61;153.65;3.72;654;11;408.00;0
629;11;626313183;629;154;1280;1280;10.09;0.62;153.68;3.72;651;11;409.00;0
630;11;626313193;630;158;1280;1280;10.14;0.62;153.85;3.72;650;11;410.00;0
635;11;626313202;635;158;1281;1281;10.19;0.62;154.54;3.72;646;11;411.00;0
639;11;626313211;639;159;1285;1285;10.15;0.62;155.78;3.71;646;11;412.00;0
645;11;626313222;645;161;1285;1285;10.24;0.62;156.32;3.71;640;11;413.00;0
645;11;626313231;645;158;1287;1288;10.36;0.63;156.32;3.70;642;11;414.00;1
648;11;626313239;648;154;1287;1288;10.41;0.63;157.28;3.70;639;11;415.00;1
651;11;626313248;651;156;1288;1288;10.48;0.64;157.85;3.70;637;11;416.00;0
653;11;626313258;653;152;1288;1288;10.48;0.64;157.74;3.70;635;11;417.00;0
658;11;626313266;658;153;1291;1292;10.46;0.64;158.64;3.70;633;11;418.00;1
660;11;626313277;660;152;1291;1292;10.46;0.64;159.32;3.70;631;11;419.00;1
661;11;626313289;661;149;1292;1292;10.50;0.64;159.38;3.70;631;11;420.00;0
664;11;626313298;664;153;1292;1292;10.51;0.64;159.39;3.70;628;11;421.00;0
665;11;626313307;665;155;1293;1293;10.53;0.64;159.56;3.69;628;11;422.00;0
667;11;626313315;667;157;1294;1294;10.57;0.65;160.01;3.69;627;11;423.00;0
670;11;626313324;670;156;1294;1294;10.57;0.65;160.11;3.69;624;11;424.00;0
674;11;626313335;674;162;1295;1295;10.60;0.65;160.70;3.69;621;11;425.00;0
679;11;626313345;679;162;1295;1295;10.50;0.64;161.39;3.69;616;11;426.00;0
681;11;626313354;681;160;1295;1295;10.42;0.63;161.55;3.69;614;11;427.00;0
683;11;626313362;683;163;1295;1295;10.37;0.63;162.32;3.69;612;11;428.00;0
686;11;626313371;686;165;1295;1295;10.35;0.63;162.15;3.69;609;11;429.00;0
689;11;626313379;689;160;1295;1295;10.33;0.63;162.38;3.69;606;11;430.00;0
691;11;626313389;691;154;1295;1295;10.34;0.63;162.63;3.69;604;11;431.00;0
693;11;626313398;693;187;1376;1422;9.82;0.61;162.67;3.47;683;11;432.00;46
696;11;626313418;696;161;1377;1423;9.90;0.61;162.76;3.47;681;11;433.00;46
696;11;626313428;696;148;1382;1423;10.09;0.62;162.76;3.47;686;11;434.00;41
700;11;626313437;700;140;1385;1423;10.16;0.63;163.10;3.47;685;11;435.00;38
702;11;626313447;702;134;1390;1423;10.19;0.63;163.15;3.47;688;11;436.00;33
706;11;626313456;706;132;1392;1423;10.22;0.63;163.53;3.47;686;11;437.00;31
708;11;626313474;708;128;1395;1423;10.32;0.63;163.61;3.48;687;11;438.00;28
711;11;626313483;711;130;1399;1423;10.45;0.64;164.00;3.49;688;11;439.00;24
713;11;626313493;713;133;1402;1424;10.54;0.64;163.97;3.50;689;11;440.00;22
718;11;626313508;718;131;1404;1425;10.56;0.64;164.08;3.50;686;11;441.00;21
720;11;626313518;720;131;1409;1425;10.59;0.65;164.51;3.52;689;11;442.00;16
724;11;626313527;724;126;1410;1426;10.49;0.64;164.78;3.53;686;11;443.00;16
726;11;626313536;726;121;1412;1426;10.41;0.63;164.96;3.54;686;11;444.00;14
730;11;626313546;730;121;1415;1426;10.27;0.63;165.30;3.56;685;11;445.00;11
733;11;626313556;733;113;1417;1426;10.26;0.62;165.47;3.57;684;11;446.00;9
734;11;626313565;734;113;1419;1430;10.26;0.62;165.46;3.58;685;11;447.00;11
737;11;626313575;737;110;1420;1430;10.24;0.62;165.60;3.59;683;11;448.00;10
740;11;626313584;740;112;1421;1430;10.26;0.62;165.71;3.59;681;11;449.00;9
741;11;626313596;741;115;1425;1436;10.24;0.62;165.90;3.59;684;11;450.00;11
745;11;626313606;745;113;1425;1436;10.21;0.62;166.41;3.59;680;11;451.00;11
746;11;626313616;746;110;1426;1436;10.26;0.62;166.31;3.60;680;11;452.00;10
749;11;626313625;749;109;1429;1440;10.20;0.62;166.62;3.59;680;11;453.00;11
750;11;626313635;750;113;1431;1441;10.33;0.63;166.42;3.59;681;11;454.00;10
751;11;626313646;751;119;1432;1441;10.43;0.63;166.33;3.59;681;11;455.00;9
757;11;626313658;757;119;1434;1445;10.43;0.63;166.73;3.59;677;11;456.00;11
758;11;626313671;758;116;1437;1445;10.50;0.64;166.82;3.62;679;11;457.00;8
759;11;626313680;759;118;1439;1445;10.55;0.64;166.92;3.63;680;11;458.00;6
760;11;626313691;760;119;1441;1446;10.63;0.64;167.11;3.64;681;11;459.00;5
761;11;626313701;761;122;1442;1446;10.62;0.65;167.39;3.65;681;11;460.00;4
763;11;626313717;763;121;1446;1452;10.58;0.64;167.39;3.65;683;11;461.00;6
764;11;626313728;764;125;1447;1452;10.52;0.64;167.42;3.66;683;11;462.00;5
767;11;626313738;767;129;1448;1453;10.46;0.64;167.44;3.66;681;11;463.00;5
768;11;626313749;768;129;1449;1453;10.39;0.63;167.52;3.67;681;11;464.00;4
768;11;626313759;768;136;1449;1453;10.40;0.63;167.52;3.67;681;11;465.00;4
768;11;626313769;768;135;1449;1453;10.47;0.64;167.52;3.67;681;11;466.00;4
769;11;626313779;769;138;1449;1453;10.50;0.64;167.62;3.67;680;11;467.00;4
772;11;626313789;772;139;1459;1465;10.60;0.65;167.88;3.64;687;11;468.00;6
772;11;626313805;772;142;1459;1465;10.65;0.65;167.88;3.64;687;11;469.00;6
773;11;626313816;773;140;1461;1465;10.73;0.65;168.24;3.64;688;11;470.00;4
777;12;626313826;777;141;1462;1465;10.76;0.66;168.22;3.65;685;12;471.00;3
779;12;626313853;779;144;1462;1465;10.86;0.66;168.17;3.65;683;12;472.00;3
782;12;626313863;782;148;1462;1465;10.99;0.67;168.20;3.65;680;12;473.00;3
784;13;626313873;784;156;1466;1469;10.98;0.67;168.28;3.66;682;13;474.00;3
786;13;626313893;786;159;1466;1469;11.02;0.67;168.25;3.66;680;13;475.00;3
790;13;626313903;790;163;1470;1473;10.99;0.67;168.07;3.66;680;13;476.00;3
791;13;626313917;791;163;1474;1474;10.98;0.67;168.04;3.66;683;13;477.00;0
793;13;626313927;793;166;1474;1474;10.96;0.67;168.09;3.66;681;13;478.00;0
797;13;626313937;797;170;1474;1474;10.85;0.66;167.89;3.66;677;13;479.00;0
798;13;626313947;798;173;1494;1500;10.74;0.66;167.82;3.61;696;13;480.00;6
798;13;626313964;798;174;1494;1500;10.65;0.65;167.82;3.61;696;13;481.00;6
799;13;626313978;799;181;1497;1500;10.62;0.65;167.88;3.61;698;13;482.00;3
803;13;626313987;803;186;1500;1501;10.54;0.64;168.19;3.61;697;13;483.00;1
804;13;626313996;804;192;1502;1502;10.41;0.64;168.24;3.60;698;13;484.00;0
804;13;626314006;804;202;1502;1502;10.32;0.63;168.24;3.60;698;13;485.00;0
805;13;626314014;805;204;1504;1505;10.23;0.63;168.18;3.60;699;13;486.00;1
807;13;626314023;807;204;1504;1505;10.13;0.62;168.16;3.60;697;13;487.00;1
807;13;626314032;807;209;1505;1505;10.05;0.62;168.16;3.60;698;13;488.00;0
810;13;626314040;810;211;1505;1505;10.05;0.62;168.02;3.60;695;13;489.00;0
814;13;626314049;814;207;1510;1511;10.00;0.61;167.84;3.59;696;13;490.00;1
815;13;626314058;815;211;1510;1511;9.91;0.61;167.97;3.59;695;13;491.00;1
817;13;626314068;817;212;1511;1511;9.88;0.61;168.06;3.59;694;13;492.00;0
819;13;626314076;819;215;1511;1511;9.81;0.60;167.95;3.59;692;13;493.00;0
821;13;626314086;821;216;1515;1515;9.73;0.60;167.69;3.58;694;13;494.00;0
824;13;626314095;824;218;1517;1517;9.70;0.59;167.57;3.58;693;13;495.00;0
827;13;626314104;827;221;1517;1517;9.66;0.59;167.31;3.58;690;13;496.00;0
829;13;626314113;829;226;1518;1518;9.65;0.59;167.50;3.58;689;13;497.00;0
832;13;626314122;832;229;1518;1518;9.60;0.58;167.30;3.58;686;13;498.00;0
834;13;626314130;834;230;1518;1518;9.57;0.58;167.50;3.58;684;13;499.00;0
834;13;626314139;834;232;1518;1518;9.48;0.58;167.50;3.58;684;13;500.00;0
838;13;626314151;838;233;1518;1518;9.38;0.57;167.25;3.58;680;13;501.00;0
840;13;626314159;840;238;1518;1518;9.24;0.56;167.16;3.58;678;13;502.00;0
847;13;626314166;847;243;1518;1518;9.06;0.55;167.15;3.58;671;13;503.00;0
849;13;626314174;849;252;1557;1588;9.10;0.55;167.76;3.49;708;13;504.00;31
853;13;626314187;853;255;1561;1589;8.85;0.54;168.25;3.48;708;13;505.00;28
856;13;626314195;856;257;1570;1589;8.80;0.54;168.72;3.47;714;13;506.00;19
859;13;626314203;859;259;1573;1589;8.63;0.53;169.29;3.47;714;13;507.00;16
861;13;626314211;861;261;1580;1589;8.48;0.52;169.78;3.47;719;13;508.00;9
862;13;626314219;862;265;1583;1589;8.22;0.50;170.01;3.48;721;13;509.00;6
865;13;626314227;865;259;1587;1589;8.09;0.49;170.55;3.48;722;13;510.00;2
866;13;626314235;866;259;1587;1589;7.95;0.49;170.85;3.48;721;13;511.00;2
870;13;626314248;870;262;1589;1590;7.89;0.48;171.12;3.48;719;13;512.00;1
872;13;626314256;872;262;1590;1591;7.88;0.48;171.31;3.48;718;13;513.00;1
875;13;626314264;875;261;1591;1591;7.84;0.48;171.90;3.49;716;13;514.00;0
877;13;626314272;877;265;1595;1595;7.81;0.48;171.59;3.48;718;13;515.00;0
881;13;626314280;881;270;1595;1595;7.75;0.47;171.75;3.48;714;13;516.00;0
884;13;626314288;884;266;1595;1595;7.73;0.47;171.72;3.48;711;13;517.00;0
886;13;626314297;886;264;1595;1595;7.79;0.48;172.09;3.48;709;13;518.00;0
888;13;626314305;888;261;1600;1601;7.84;0.48;172.62;3.47;712;13;519.00;1
890;13;626314314;890;265;1601;1601;7.88;0.48;172.90;3.47;711;13;520.00;0
893;13;626314327;893;266;1601;1601;7.94;0.48;173.09;3.47;708;13;521.00;0
894;13;626314336;894;266;1604;1604;7.99;0.49;173.32;3.46;710;13;522.00;0
896;13;626314344;896;257;1604;1604;7.98;0.49;173.51;3.46;708;13;523.00;0
898;13;626314353;898;238;1604;1604;7.98;0.49;173.89;3.46;706;13;524.00;0
902;13;626314362;902;229;1605;1605;8.00;0.49;174.42;3.46;703;13;525.00;0
902;13;626314371;902;228;1606;1606;8.13;0.50;174.42;3.46;704;13;526.00;0
908;13;626314380;908;219;1606;1606;8.11;0.50;175.00;3.46;698;13;527.00;0
912;13;626314389;912;215;1619;1619;8.14;0.50;174.64;3.43;707;13;528.00;0
916;13;626314399;916;204;1619;1619;8.22;0.50;175.23;3.43;703;13;529.00;0
918;13;626314413;918;201;1619;1619;8.32;0.51;175.46;3.43;701;13;530.00;0
919;13;626314422;919;201;1620;1620;8.45;0.52;175.37;3.43;701;13;531.00;0
923;13;626314431;923;197;1620;1620;8.51;0.52;175.53;3.43;697;13;532.00;0
926;13;626314441;926;195;1623;1624;8.60;0.53;175.48;3.43;697;13;533.00;1
934;13;626314451;934;190;1623;1624;8.62;0.53;175.81;3.43;689;13;534.00;1
937;13;626314461;937;189;1628;1628;8.77;0.54;175.99;3.42;691;13;535.00;0
944;13;626314471;944;188;1628;1628;8.74;0.53;176.17;3.42;684;13;536.00;0
944;13;626314480;944;187;1628;1628;8.80;0.54;176.17;3.42;684;13;537.00;0
947;13;626314490;947;185;1628;1628;8.83;0.54;176.35;3.42;681;13;538.00;0
949;13;626314499;949;188;1628;1628;8.89;0.54;176.52;3.42;679;13;539.00;0
951;13;626314510;951;197;1658;1662;9.02;0.55;176.94;3.36;707;13;540.00;4
955;13;626314522;955;191;1658;1662;9.00;0.55;177.33;3.36;703;13;541.00;4
959;13;626314532;959;195;1659;1662;9.07;0.56;177.36;3.36;700;13;542.00;3
962;13;626314542;962;194;1659;1662;9.16;0.56;177.80;3.36;697;13;543.00;3
966;13;626314551;966;195;1660;1662;9.26;0.57;177.93;3.36;694;13;544.00;2
969;13;626314561;969;192;1660;1662;9.34;0.57;178.31;3.36;691;13;545.00;2
975;13;626314571;975;193;1662;1663;9.37;0.58;178.30;3.36;687;13;546.00;1
980;13;626314581;980;192;1662;1663;9.39;0.58;178.59;3.36;682;13;547.00;1
981;13;626314592;981;197;1666;1669;9.35;0.57;178.53;3.36;685;13;548.00;3
984;13;626314602;984;195;1667;1670;9.34;0.57;178.69;3.36;683;13;549.00;3
990;13;626314611;990;206;1669;1670;9.29;0.57;179.29;3.35;679;13;550.00;1
994;13;626314621;994;204;1669;1670;9.24;0.57;179.26;3.35;675;13;551.00;1
998;13;626314630;998;210;1674;1674;9.18;0.56;179.33;3.35;676;13;552.00;0
1000;13;626314645;1000;212;1674;1674;9.15;0.56;179.62;3.35;674;13;553.00;0
1004;13;626314659;1004;215;1674;1674;9.07;0.56;179.78;3.35;670;13;554.00;0
1008;13;626314669;1008;223;1675;1675;9.00;0.55;180.15;3.35;667;13;555.00;0
1008;13;626314678;1008;228;1679;1679;9.08;0.56;180.15;3.34;671;13;556.00;0
1012;13;626314687;1012;220;1679;1679;9.08;0.56;180.71;3.34;667;13;557.00;0
1013;13;626314697;1013;212;1681;1682;9.18;0.56;180.72;3.34;668;13;558.00;1
1016;13;626314707;1016;208;1681;1682;9.22;0.56;180.78;3.34;665;13;559.00;1
1021;13;626314717;1021;205;1682;1682;9.15;0.56;180.73;3.34;661;13;560.00;0
1023;13;626314726;1023;200;1682;1682;9.17;0.56;180.95;3.34;659;13;561.00;0
1026;13;626314736;1026;199;1685;1686;9.21;0.56;181.52;3.33;659;13;562.00;1
1027;13;626314745;1027;206;1685;1686;9.24;0.56;181.43;3.33;658;13;563.00;1
1031;13;626314755;1031;208;1686;1686;9.34;0.57;182.21;3.33;655;13;564.00;0
1036;13;626314765;1036;210;1686;1686;9.36;0.57;182.86;3.33;650;13;565.00;0
1041;13;626314775;1041;197;1687;1687;9.42;0.57;182.93;3.33;646;13;566.00;0
1044;13;626314785;1044;184;1688;1688;9.50;0.58;183.31;3.33;644;13;567.00;0
1047;13;626314796;1047;176;1688;1688;9.53;0.58;183.67;3.33;641;13;568.00;0
1048;13;626314814;1048;172;1689;1689;9.57;0.58;183.96;3.33;641;13;569.00;0
1050;13;626314832;1050;165;1689;1689;9.67;0.59;184.39;3.33;639;13;570.00;0
1055;13;626314848;1055;162;1689;1689;9.76;0.59;184.78;3.33;634;13;571.00;0
1056;13;626314866;1056;157;1689;1689;9.85;0.60;184.81;3.33;633;13;572.00;0
1059;13;626314882;1059;163;1689;1689;9.89;0.60;185.30;3.33;630;13;573.00;0
1062;13;626314897;1062;162;1689;1689;9.92;0.60;185.74;3.33;627;13;574.00;0
1064;13;626314913;1064;166;1689;1689;10.01;0.61;185.89;3.33;625;13;575.00;0
1069;13;626314925;1069;193;1771;1816;9.92;0.61;186.38;3.17;702;13;576.00;45
1071;13;626314948;1071;179;1774;1817;10.00;0.62;186.45;3.17;703;13;577.00;43
1074;13;626314960;1074;166;1782;1817;10.17;0.63;186.93;3.17;708;13;578.00;35
1077;13;626314973;1077;158;1786;1817;10.24;0.63;186.92;3.17;709;13;579.00;31
1079;13;626314991;1079;153;1790;1817;10.34;0.64;186.91;3.17;711;13;580.00;27
1083;13;626315002;1083;147;1793;1817;10.41;0.64;186.97;3.17;710;13;581.00;24
1085;13;626315012;1085;145;1797;1817;10.48;0.65;187.25;3.18;712;13;582.00;20
1087;13;626315024;1087;148;1799;1817;10.50;0.65;187.21;3.18;712;13;583.00;18
1090;13;626315035;1090;146;1802;1818;10.50;0.65;187.37;3.19;712;13;584.00;16
1094;13;626315052;1094;145;1806;1820;10.48;0.64;187.39;3.20;712;13;585.00;14
1094;13;626315064;1094;145;1810;1820;10.50;0.64;187.39;3.21;716;13;586.00;10
1097;13;626315074;1097;153;1811;1821;10.45;0.64;187.66;3.21;714;13;587.00;10
1100;13;626315085;1100;161;1813;1821;10.49;0.64;187.99;3.22;713;13;588.00;8
1103;13;626315095;1103;166;1814;1821;10.43;0.64;188.34;3.22;711;13;589.00;7
1105;13;626315106;1105;164;1816;1821;10.38;0.64;188.47;3.23;711;13;590.00;5
1105;13;626315117;1105;168;1819;1825;10.40;0.64;188.47;3.24;714;13;591.00;6
1107;13;626315127;1107;174;1821;1825;10.49;0.64;188.40;3.25;714;13;592.00;4
1108;13;626315137;1108;181;1822;1825;10.54;0.64;188.71;3.26;714;13;593.00;3
1112;13;626315149;1112;180;1825;1828;10.58;0.65;189.22;3.26;713;13;594.00;3
1116;13;626315159;1116;183;1826;1828;10.56;0.64;189.31;3.26;710;13;595.00;2
1117;13;626315170;1117;180;1827;1828;10.56;0.64;189.28;3.26;710;13;596.00;1
1118;14;626315180;1118;183;1831;1832;10.44;0.64;189.33;3.26;713;14;597.00;1
1120;14;626315199;1120;190;1833;1833;10.50;0.64;189.22;3.26;713;14;598.00;0
1122;14;626315210;1122;192;1833;1833;10.55;0.64;189.14;3.26;711;14;599.00;0
1122;14;626315222;1122;191;1845;1859;10.44;0.64;189.14;3.23;723;14;600.00;14
1126;14;626315247;1126;181;1845;1859;10.50;0.64;189.07;3.23;719;14;601.00;14
1127;14;626315259;1127;183;1846;1859;10.55;0.64;189.11;3.23;719;14;602.00;13
1128;14;626315269;1128;181;1847;1860;10.63;0.65;189.08;3.23;719;14;603.00;13
1131;14;626315280;1131;178;1848;1860;10.64;0.65;189.51;3.23;717;14;604.00;12
1137;14;626315291;1137;173;1852;1866;10.65;0.64;189.43;3.23;715;14;605.00;14
1137;14;626315304;1137;173;1853;1866;10.76;0.65;189.43;3.23;716;14;606.00;13
1143;14;626315314;1143;166;1854;1867;10.81;0.65;189.96;3.23;711;14;607.00;13
1147;15;626315324;1147;167;1857;1867;10.88;0.66;190.31;3.23;710;15;608.00;10
1151;15;626315346;1151;159;1857;1867;10.90;0.66;190.64;3.23;706;15;609.00;10
1153;15;626315357;1153;155;1857;1867;10.94;0.66;191.12;3.23;704;15;610.00;10
1159;15;626315367;1159;151;1857;1867;10.96;0.66;191.61;3.23;698;15;611.00;10
1163;15;626315377;1163;144;1866;1879;10.99;0.67;192.00;3.22;703;15;612.00;13
1165;15;626315394;1165;134;1868;1879;10.87;0.66;192.06;3.23;703;15;613.00;11
1169;15;626315405;1169;125;1869;1879;10.85;0.66;192.09;3.23;700;15;614.00;10
1174;15;626315416;1174;119;1870;1879;10.86;0.66;192.79;3.23;696;15;615.00;9
1177;15;626315426;1177;113;1871;1879;10.82;0.65;192.84;3.23;694;15;616.00;8
1179;15;626315437;1179;110;1871;1879;10.85;0.66;192.89;3.23;692;15;617.00;8
1183;15;626315447;1183;103;1875;1883;10.88;0.66;193.19;3.24;692;15;618.00;8
1186;15;626315457;1186;99;1875;1883;10.97;0.66;193.54;3.24;689;15;619.00;8
1188;15;626315468;1188;97;1878;1887;11.13;0.67;193.52;3.23;690;15;620.00;9
1191;15;626315479;1191;97;1879;1888;11.19;0.68;193.48;3.23;688;15;621.00;9
1193;15;626315489;1193;96;1880;1888;11.20;0.68;193.71;3.23;687;15;622.00;8
1195;15;626315499;1195;98;1880;1888;11.23;0.68;193.82;3.23;685;15;623.00;8
1197;15;626315509;1197;104;1889;1901;11.18;0.68;193.69;3.23;692;15;624.00;12
1200;15;626315521;1200;101;1889;1901;11.22;0.68;193.82;3.23;689;15;625.00;12
1204;15;626315531;1204;107;1889;1901;11.31;0.68;194.36;3.23;685;15;626.00;12
1209;15;626315541;1209;113;1890;1902;11.34;0.69;194.31;3.23;681;15;627.00;12
1210;15;626315552;1210;115;1890;1903;11.36;0.69;194.32;3.23;680;15;628.00;13
1212;15;626315563;1212;120;1891;1903;11.37;0.69;194.65;3.24;679;15;629.00;12
1212;15;626315575;1212;124;1896;1909;11.40;0.69;194.65;3.26;684;15;630.00;13
1214;15;626315591;1214;125;1897;1909;11.42;0.69;194.89;3.26;683;15;631.00;12
1217;15;626315603;1217;127;1899;1909;11.41;0.69;194.83;3.26;682;15;632.00;10
1219;15;626315613;1219;128;1899;1909;11.38;0.69;194.94;3.26;680;15;633.00;10
1220;15;626315624;1220;132;1903;1915;11.43;0.69;194.80;3.25;683;15;634.00;12
1222;15;626315635;1222;128;1904;1915;11.38;0.69;194.73;3.27;682;15;635.00;11
1223;15;626315646;1223;125;1905;1915;11.40;0.69;194.68;3.27;682;15;636.00;10
1227;15;626315656;1227;128;1905;1915;11.38;0.69;194.95;3.27;678;15;637.00;10
1230;15;626315666;1230;134;1909;1919;11.41;0.69;194.94;3.27;679;15;638.00;10
1232;15;626315677;1232;137;1910;1920;11.35;0.69;194.96;3.27;678;15;639.00;10
1233;15;626315688;1233;142;1911;1920;11.21;0.68;194.89;3.28;678;15;640.00;9
1235;15;626315698;1235;148;1913;1921;11.13;0.68;194.68;3.30;678;15;641.00;8
1235;15;626315709;1235;149;1913;1921;11.07;0.68;194.68;3.30;678;15;642.00;8
1239;15;626315719;1239;153;1915;1921;10.95;0.67;194.58;3.31;676;15;643.00;6
1240;15;626315728;1240;163;1916;1921;10.79;0.66;194.47;3.32;676;15;644.00;5
1242;15;626315738;1242;166;1916;1921;10.69;0.65;194.33;3.32;674;15;645.00;5
1244;15;626315748;1244;168;1917;1921;10.57;0.65;194.20;3.32;673;15;646.00;4
1247;15;626315758;1247;177;1919;1921;10.42;0.64;194.18;3.36;672;15;647.00;2
1249;15;626315768;1249;189;1956;1991;10.41;0.64;194.04;3.30;707;15;648.00;35
1251;15;626315784;1251;190;1961;1992;10.24;0.63;193.87;3.31;710;15;649.00;31
1254;15;626315794;1254;189;1971;1992;10.24;0.63;193.73;3.30;717;15;650.00;21
1255;16;626315806;1255;192;1974;1992;10.15;0.62;193.64;3.30;719;16;651.00;18
1255;16;626315829;1255;197;1979;1992;10.11;0.62;193.64;3.30;724;16;652.00;13
1256;16;626315838;1256;199;1984;1992;10.03;0.62;193.51;3.30;728;16;653.00;8
1259;16;626315849;1259;201;1988;1992;9.98;0.61;193.39;3.31;729;16;654.00;4
1259;16;626315860;1259;202;1990;1992;9.91;0.61;193.39;3.31;731;16;655.00;2
1260;16;626315869;1260;209;1992;1993;9.81;0.60;193.24;3.32;732;16;656.00;1
1263;16;626315878;1263;212;1994;1994;9.68;0.59;193.28;3.32;731;16;657.00;0
1265;16;626315893;1265;220;1994;1994;9.50;0.58;193.21;3.32;729;16;658.00;0
1268;16;626315902;1268;226;1998;1998;9.30;0.57;193.29;3.31;730;16;659.00;0
1270;16;626315914;1270;230;1998;1998;9.13;0.56;193.10;3.31;728;16;660.00;0
1271;16;626315924;1271;232;1998;1998;8.95;0.55;193.07;3.31;727;16;661.00;0
1271;16;626315938;1271;238;1998;1998;8.82;0.54;193.07;3.31;727;16;662.00;0
1271;16;626315946;1271;247;2003;2004;8.78;0.54;193.07;3.31;732;16;663.00;1
1272;16;626315955;1272;256;2004;2004;8.69;0.53;193.02;3.31;732;16;664.00;0
1273;16;626315963;1273;262;2004;2004;8.59;0.53;192.97;3.31;731;16;665.00;0
1275;16;626315972;1275;269;2007;2007;8.59;0.53;192.85;3.30;732;16;666.00;0
1277;16;626315981;1277;274;2007;2007;8.54;0.52;192.80;3.30;730;16;667.00;0
1277;16;626315989;1277;278;2007;2007;8.49;0.52;192.80;3.30;730;16;668.00;0
1280;16;626315997;1280;283;2008;2008;8.38;0.51;192.54;3.30;728;16;669.00;0
1281;16;626316006;1281;288;2009;2009;8.30;0.51;192.57;3.30;728;16;670.00;0
1282;16;626316014;1282;292;2009;2009;8.18;0.50;192.44;3.30;727;16;671.00;0
1286;16;626316022;1286;301;2022;2022;8.02;0.49;192.47;3.28;736;16;672.00;0
1289;16;626316031;1289;309;2022;2022;7.83;0.48;192.41;3.28;733;16;673.00;0
1293;16;626316039;1293;306;2022;2022;7.69;0.47;192.34;3.28;729;16;674.00;0
1297;16;626316047;1297;295;2024;2024;7.53;0.46;192.70;3.27;727;16;675.00;0
1299;16;626316056;1299;283;2024;2024;7.42;0.45;192.72;3.27;725;16;676.00;0
1303;16;626316064;1303;282;2027;2028;7.37;0.45;193.21;3.27;724;16;677.00;1
1306;16;626316072;1306;276;2027;2028;7.30;0.45;193.33;3.27;721;16;678.00;1
1311;16;626316080;1311;274;2032;2032;7.22;0.44;193.49;3.27;721;16;679.00;0
1314;17;626316088;1314;255;2032;2032;7.27;0.44;193.94;3.27;718;17;680.00;0
1318;17;626316107;1318;243;2032;2032;7.24;0.44;193.99;3.27;714;17;681.00;0
1321;18;626316115;1321;229;2032;2032;7.30;0.45;194.40;3.27;711;18;682.00;0
1324;18;626316134;1324;218;2032;2032;7.37;0.45;194.61;3.27;708;18;683.00;0
1326;18;626316142;1326;221;2043;2044;7.53;0.46;194.59;3.25;717;18;684.00;1
1329;18;626316157;1329;213;2043;2044;7.65;0.47;194.78;3.25;714;18;685.00;1
1331;18;626316166;1331;212;2044;2044;7.78;0.48;195.14;3.25;713;18;686.00;0
1333;18;626316180;1333;204;2044;2044;7.94;0.49;195.50;3.25;711;18;687.00;0
1334;18;626316188;1334;200;2044;2044;8.04;0.49;195.67;3.25;710;18;688.00;0
1335;18;626316197;1335;198;2044;2044;8.14;0.50;195.87;3.25;709;18;689.00;0
1338;18;626316208;1338;195;2045;2045;8.25;0.51;196.09;3.25;707;18;690.00;0
1339;18;626316217;1339;196;2045;2045;8.39;0.51;196.19;3.25;706;18;691.00;0
1343;18;626316226;1343;193;2050;2051;8.54;0.52;196.18;3.24;707;18;692.00;1
1344;18;626316236;1344;195;2052;2052;8.71;0.53;196.28;3.24;708;18;693.00;0
1346;18;626316245;1346;189;2052;2052;8.80;0.54;196.65;3.24;706;18;694.00;0
1349;18;626316255;1349;188;2052;2052;8.88;0.54;196.85;3.24;703;18;695.00;0
1353;18;626316264;1353;186;2056;2056;8.94;0.55;196.82;3.23;703;18;696.00;0
1356;18;626316274;1356;180;2056;2056;8.98;0.55;197.02;3.23;700;18;697.00;0
1361;18;626316283;1361;173;2056;2056;9.02;0.55;197.35;3.23;695;18;698.00;0
1366;18;626316293;1366;171;2057;2057;9.13;0.56;197.59;3.23;691;18;699.00;0
1370;18;626316302;1370;168;2061;2061;9.22;0.56;197.94;3.23;691;18;700.00;0
1374;18;626316316;1374;163;2061;2061;9.31;0.57;198.31;3.23;687;18;701.00;0
1380;18;626316325;1380;163;2063;2064;9.35;0.57;198.15;3.22;683;18;702.00;1
1383;18;626316341;1383;160;2063;2064;9.45;0.57;198.07;3.22;680;18;703.00;1
1388;18;626316351;1388;157;2064;2064;9.52;0.58;198.22;3.22;676;18;704.00;0
1395;18;626316360;1395;158;2064;2064;9.55;0.58;198.28;3.22;669;18;705.00;0
1396;18;626316370;1396;147;2067;2068;9.68;0.59;198.39;3.22;671;18;706.00;1
1401;18;626316380;1401;145;2067;2068;9.77;0.59;198.28;3.22;666;18;707.00;1
1403;18;626316390;1403;151;2068;2068;9.86;0.60;198.21;3.22;665;18;708.00;0
1407;18;626316400;1407;151;2068;2068;9.88;0.60;198.47;3.22;661;18;709.00;0
1413;18;626316410;1413;152;2069;2069;9.91;0.60;198.63;3.22;656;18;710.00;0
1417;18;626316419;1417;157;2070;2070;9.94;0.60;198.95;3.22;653;18;711.00;0
1421;18;626316435;1421;159;2070;2070;9.98;0.61;199.31;3.22;649;18;712.00;0
1427;18;626316445;1427;159;2071;2071;9.97;0.61;199.42;3.22;644;18;713.00;0
1430;18;626316455;1430;162;2071;2071;9.96;0.61;199.69;3.22;641;18;714.00;0
1436;18;626316464;1436;159;2071;2071;10.01;0.61;200.00;3.22;635;18;715.00;0
1440;18;626316480;1440;157;2071;2071;10.06;0.61;199.99;3.22;631;18;716.00;0
1440;18;626316489;1440;153;2071;2071;10.10;0.61;199.99;3.22;631;18;717.00;0
1444;18;626316506;1444;153;2071;2071;10.07;0.61;200.07;3.22;627;18;718.00;0
1449;18;626316522;1449;152;2071;2071;10.08;0.61;200.07;3.22;622;18;719.00;0
1450;18;626316533;1450;190;2193;2301;10.03;0.63;200.11;3.04;743;18;720.00;108
1452;18;626316561;1452;184;2203;2302;9.99;0.63;200.32;3.03;751;18;721.00;99
1456;18;626316571;1456;171;2213;2302;9.93;0.62;200.56;3.02;757;18;722.00;89
1459;18;626316582;1459;164;2220;2302;9.89;0.62;200.58;3.02;761;18;723.00;82
1462;18;626316592;1462;167;2227;2302;9.82;0.61;200.90;3.03;765;18;724.00;75
1464;18;626316602;1464;175;2231;2302;9.74;0.61;201.33;3.03;767;18;725.00;71
1466;18;626316613;1466;180;2241;2302;9.61;0.60;201.41;3.04;775;18;726.00;61
1470;18;626316623;1470;174;2243;2302;9.48;0.59;201.67;3.05;773;18;727.00;59
1477;18;626316634;1477;176;2247;2303;9.45;0.59;202.02;3.06;770;18;728.00;56
1478;18;626316646;1478;170;2252;2304;9.44;0.59;201.96;3.07;774;18;729.00;52
1482;18;626316663;1482;176;2257;2304;9.43;0.59;202.20;3.09;775;18;730.00;47
1484;18;626316676;1484;183;2262;2305;9.41;0.58;202.35;3.10;778;18;731.00;43
1486;18;626316689;1486;188;2267;2305;9.38;0.58;202.36;3.12;781;18;732.00;38
1492;18;626316707;1492;195;2271;2305;9.37;0.58;202.38;3.14;779;18;733.00;34
1495;18;626316719;1495;203;2274;2305;9.38;0.58;202.59;3.15;779;18;734.00;31
1498;18;626316730;1498;213;2279;2309;9.39;0.58;202.82;3.17;781;18;735.00;30
1501;18;626316749;1501;200;2282;2309;9.40;0.58;203.11;3.18;781;18;736.00;27
1505;18;626316761;1505;194;2286;2309;9.43;0.58;203.28;3.20;781;18;737.00;23
1508;18;626316773;1508;191;2289;2312;9.47;0.58;203.33;3.21;781;18;738.00;23
1512;18;626316785;1512;187;2289;2312;9.55;0.58;203.36;3.21;777;18;739.00;23
1513;18;626316806;1513;188;2290;2312;9.66;0.59;203.48;3.22;777;18;740.00;22
1516;18;626316823;1516;191;2296;2316;9.73;0.60;203.62;3.23;780;18;741.00;20
1519;18;626316841;1519;191;2299;2317;9.81;0.60;203.81;3.25;780;18;742.00;18
1523;18;626316860;1523;191;2300;2317;9.94;0.61;204.04;3.25;777;18;743.00;17
1527;18;626316893;1527;198;2304;2321;10.06;0.62;204.07;3.25;777;18;744.00;17
1530;18;626316913;1530;202;2305;2321;10.10;0.62;204.23;3.25;775;18;745.00;16
1532;18;626316928;1532;204;2306;2321;10.14;0.62;204.37;3.26;774;18;746.00;15
1536;18;626316944;1536;203;2307;2322;10.21;0.62;204.41;3.26;771;18;747.00;15
1538;18;626316958;1538;196;2308;2322;10.20;0.62;204.46;3.27;770;18;748.00;14
1542;18;626316979;1542;195;2312;2328;10.17;0.62;204.72;3.26;770;18;749.00;16
1543;18;626317001;1543;193;2312;2328;10.13;0.62;204.88;3.26;769;18;750.00;16
1545;18;626317014;1545;191;2313;2329;10.11;0.62;204.87;3.26;768;18;751.00;16
1546;18;626317026;1546;192;2313;2329;10.07;0.62;204.81;3.26;767;18;752.00;16
1551;18;626317038;1551;188;2315;2329;10.04;0.61;205.02;3.28;764;18;753.00;14
1554;18;626317058;1554;194;2317;2329;10.05;0.61;205.12;3.28;763;18;754.00;12
1557;18;626317070;1557;198;2317;2329;10.05;0.61;205.24;3.28;760;18;755.00;12
1561;18;626317082;1561;203;2329;2341;10.07;0.61;205.36;3.27;768;18;756.00;12
1565;18;626317095;1565;203;2329;2341;10.07;0.61;205.15;3.27;764;18;757.00;12
1567;18;626317106;1567;208;2330;2341;10.04;0.61;205.21;3.27;763;18;758.00;11
1569;18;626317118;1569;211;2330;2341;10.00;0.61;205.59;3.27;761;18;759.00;11
1570;18;626317129;1570;214;2330;2341;10.06;0.61;205.67;3.27;760;18;760.00;11
1571;18;626317141;1571;217;2330;2341;10.08;0.62;205.87;3.27;759;18;761.00;11
1573;18;626317152;1573;219;2334;2345;10.05;0.62;206.02;3.26;761;18;762.00;11
1578;18;626317171;1578;224;2334;2345;10.10;0.62;206.15;3.26;756;18;763.00;11
1580;18;626317181;1580;228;2337;2349;10.09;0.62;206.49;3.26;757;18;764.00;12
1582;18;626317194;1582;227;2339;2351;10.11;0.62;206.45;3.26;757;18;765.00;12
1585;18;626317205;1585;230;2340;2351;10.14;0.62;206.45;3.26;755;18;766.00;11
1585;18;626317216;1585;235;2340;2351;10.07;0.61;206.45;3.26;755;18;767.00;11
1588;18;626317227;1588;235;2349;2364;10.03;0.61;206.54;3.25;761;18;768.00;15
1589;18;626317239;1589;236;2349;2364;10.02;0.61;206.62;3.25;760;18;769.00;15
1593;18;626317252;1593;228;2351;2364;9.94;0.61;206.46;3.27;758;18;770.00;13
1594;18;626317266;1594;226;2352;2365;9.88;0.60;206.43;3.26;758;18;771.00;13
1596;18;626317279;1596;225;2352;2366;9.81;0.60;206.61;3.26;756;18;772.00;14
1599;18;626317290;1599;217;2352;2366;9.79;0.60;206.57;3.26;753;18;773.00;14
1602;18;626317301;1602;213;2354;2369;9.78;0.60;206.73;3.26;752;18;774.00;15
1604;18;626317313;1604;213;2354;2369;9.74;0.59;206.66;3.26;750;18;775.00;15
1606;18;626317324;1606;213;2355;2369;9.78;0.60;206.89;3.26;749;18;776.00;14
1608;18;626317336;1608;218;2355;2369;9.80;0.60;207.16;3.26;747;18;777.00;14
1611;18;626317346;1611;216;2359;2375;9.79;0.60;207.43;3.26;748;18;778.00;16
1616;18;626317357;1616;214;2359;2375;9.74;0.59;207.69;3.26;743;18;779.00;16
1621;18;626317369;1621;210;2360;2375;9.61;0.59;207.89;3.26;739;18;780.00;15
1628;18;626317380;1628;209;2360;2375;9.43;0.58;208.35;3.26;732;18;781.00;15
1631;18;626317390;1631;207;2363;2379;9.35;0.57;208.44;3.25;732;18;782.00;16
1636;18;626317409;1636;201;2364;2380;9.28;0.57;208.47;3.25;728;18;783.00;16
1640;19;626317419;1640;191;2364;2380;9.23;0.56;208.40;3.25;724;19;784.00;16
1641;19;626317446;1641;183;2367;2381;9.25;0.56;208.34;3.26;726;19;785.00;14
1643;19;626317462;1643;180;2368;2381;9.23;0.56;208.34;3.29;725;19;786.00;13
1645;19;626317473;1645;177;2369;2381;9.26;0.56;208.33;3.32;724;19;787.00;12
1648;19;626317482;1648;177;2369;2381;9.27;0.57;208.25;3.32;721;19;788.00;12
1651;19;626317497;1651;169;2369;2381;9.31;0.57;208.12;3.32;718;19;789.00;12
1652;19;626317507;1652;165;2369;2381;9.36;0.57;208.29;3.32;717;19;790.00;12
1653;19;626317518;1653;168;2369;2381;9.46;0.58;208.20;3.32;716;19;791.00;12
1656;19;626317528;1656;170;2402;2451;9.51;0.58;208.11;3.27;746;19;792.00;49
1658;19;626317545;1658;165;2402;2452;9.52;0.58;207.97;3.27;744;19;793.00;50
1659;19;626317556;1659;165;2410;2452;9.66;0.59;207.89;3.27;751;19;794.00;42
1661;19;626317566;1661;165;2413;2452;9.68;0.59;207.80;3.30;752;19;795.00;39
1663;19;626317576;1663;167;2418;2452;9.79;0.60;207.69;3.30;755;19;796.00;34
1666;19;626317594;1666;167;2419;2452;9.79;0.60;207.65;3.33;753;19;797.00;33
1669;19;626317606;1669;170;2426;2452;9.83;0.60;207.58;3.34;757;19;798.00;26
1671;19;626317616;1671;171;2430;2452;9.87;0.60;207.55;3.34;759;19;799.00;22
1674;19;626317628;1674;170;2433;2453;9.84;0.60;207.31;3.38;759;19;800.00;20
1677;19;626317644;1677;177;2436;2454;9.84;0.60;207.21;3.38;759;19;801.00;18
1679;19;626317656;1679;179;2437;2454;9.80;0.59;207.10;3.38;758;19;802.00;17
1679;19;626317666;1679;184;2442;2458;9.69;0.59;207.10;3.41;763;19;803.00;16
1683;19;626317676;1683;188;2443;2458;9.55;0.58;206.76;3.42;760;19;804.00;15
1685;19;626317686;1685;195;2444;2458;9.41;0.57;206.77;3.45;759;19;805.00;14
1686;19;626317696;1686;199;2444;2458;9.24;0.56;206.67;3.45;758;19;806.00;14
1690;19;626317707;1690;204;2449;2464;9.14;0.56;206.63;3.48;759;19;807.00;15
1690;19;626317717;1690;218;2450;2464;9.14;0.56;206.63;3.48;760;19;808.00;14
1691;19;626317727;1691;223;2451;2464;9.11;0.55;206.59;3.52;760;19;809.00;13
1693;19;626317739;1693;228;2457;2470;9.08;0.55;206.60;3.54;764;19;810.00;13
1694;19;626317752;1694;232;2457;2470;9.05;0.55;206.53;3.54;763;19;811.00;13
1696;19;626317762;1696;237;2459;2470;8.99;0.55;206.44;3.57;763;19;812.00;11
1698;19;626317772;1698;241;2462;2471;8.93;0.54;206.45;3.61;764;19;813.00;9
1699;19;626317783;1699;246;2464;2472;8.88;0.54;206.40;3.61;765;19;814.00;8
1701;19;626317793;1701;253;2468;2472;8.78;0.53;206.32;3.63;767;19;815.00;4
1704;19;626317810;1704;261;2478;2485;8.70;0.53;206.17;3.62;774;19;816.00;7
1705;19;626317822;1705;266;2479;2485;8.66;0.53;206.06;3.62;774;19;817.00;6
1707;19;626317832;1707;275;2481;2485;8.56;0.52;206.00;3.62;774;19;818.00;4
1710;19;626317843;1710;282;2482;2486;8.54;0.52;205.81;3.62;772;19;819.00;4
1710;19;626317854;1710;287;2483;2486;8.56;0.52;205.81;3.63;773;19;820.00;3
1714;19;626317865;1714;293;2487;2490;8.59;0.52;205.83;3.64;773;19;821.00;3
1714;19;626317876;1714;301;2489;2490;8.57;0.52;205.83;3.64;775;19;822.00;1
1715;19;626317887;1715;307;2493;2494;8.48;0.52;205.77;3.64;778;19;823.00;1
1716;19;626317898;1716;305;2494;2494;8.38;0.51;205.79;3.64;778;19;824.00;0
1717;19;626317909;1717;313;2494;2494;8.24;0.50;205.77;3.64;777;19;825.00;0
1718;19;626317919;1718;314;2494;2494;8.09;0.49;205.73;3.64;776;19;826.00;0
1719;19;626317929;1719;307;2494;2494;7.94;0.49;205.63;3.64;775;19;827.00;0
1721;19;626317940;1721;299;2505;2506;7.92;0.48;205.63;3.62;784;19;828.00;1
1723;19;626317952;1723;297;2506;2506;7.92;0.48;205.62;3.62;783;19;829.00;0
1726;19;626317962;1726;294;2506;2506;7.85;0.48;205.45;3.62;780;19;830.00;0
1728;19;626317972;1728;286;2506;2506;7.86;0.48;205.42;3.62;778;19;831.00;0
1728;20;626317983;1728;282;2506;2506;7.90;0.48;205.42;3.62;778;20;832.00;0
1729;20;626318003;1729;278;2506;2506;8.00;0.49;205.44;3.62;777;20;833.00;0
1729;20;626318019;1729;277;2507;2507;8.06;0.49;205.44;3.62;778;20;834.00;0
1730;20;626318034;1730;274;2507;2507;8.13;0.50;205.43;3.62;777;20;835.00;0
1730;20;626318043;1730;276;2512;2513;8.31;0.51;205.43;3.61;782;20;836.00;1
1732;20;626318054;1732;274;2513;2514;8.41;0.51;205.35;3.61;781;20;837.00;1
1732;20;626318063;1732;276;2514;2514;8.51;0.52;205.35;3.61;782;20;838.00;0
1732;20;626318073;1732;277;2514;2514;8.58;0.52;205.35;3.61;782;20;839.00;0
1732;20;626318084;1732;277;2519;2519;8.62;0.53;205.35;3.60;787;20;840.00;0
1736;20;626318100;1736;279;2519;2519;8.55;0.52;205.39;3.60;783;20;841.00;0
1737;20;626318109;1737;280;2519;2519;8.46;0.52;205.35;3.60;782;20;842.00;0
1739;20;626318118;1739;283;2520;2520;8.38;0.51;205.41;3.60;781;20;843.00;0
1742;20;626318127;1742;285;2524;2524;8.28;0.50;205.72;3.60;782;20;844.00;0
1745;20;626318136;1745;292;2524;2524;8.21;0.50;205.87;3.60;779;20;845.00;0
1747;20;626318146;1747;293;2526;2527;8.12;0.50;206.07;3.60;779;20;846.00;1
1751;20;626318155;1751;298;2527;2527;8.00;0.49;206.32;3.59;776;20;847.00;0
1753;20;626318164;1753;297;2527;2527;7.83;0.48;206.60;3.59;774;20;848.00;0
1754;20;626318173;1754;298;2527;2527;7.76;0.47;206.55;3.59;773;20;849.00;0
1759;20;626318181;1759;285;2530;2531;7.69;0.47;206.84;3.59;771;20;850.00;1
1762;20;626318190;1762;280;2530;2531;7.63;0.47;206.86;3.59;768;20;851.00;1
1765;20;626318199;1765;281;2531;2531;7.65;0.47;206.95;3.59;766;20;852.00;0
1771;20;626318207;1771;273;2531;2531;7.62;0.47;207.43;3.59;760;20;853.00;0
1775;20;626318217;1775;266;2532;2532;7.70;0.47;207.54;3.59;757;20;854.00;0
1780;20;626318227;1780;266;2534;2534;7.77;0.48;207.67;3.59;754;20;855.00;0
1784;20;626318237;1784;263;2534;2534;7.84;0.48;208.06;3.59;750;20;856.00;0
1787;20;626318246;1787;256;2535;2535;7.96;0.49;208.22;3.59;748;20;857.00;0
1790;20;626318256;1790;245;2535;2535;8.07;0.49;208.32;3.59;745;20;858.00;0
1795;20;626318272;1795;234;2535;2535;8.15;0.50;208.57;3.59;740;20;859.00;0
1801;20;626318281;1801;226;2535;2535;8.21;0.50;208.89;3.59;734;20;860.00;0
1803;20;626318290;1803;221;2535;2535;8.34;0.51;209.07;3.59;732;20;861.00;0
1806;20;626318300;1806;216;2535;2535;8.44;0.51;209.28;3.59;729;20;862.00;0
1810;20;626318309;1810;206;2535;2535;8.54;0.52;209.67;3.59;725;20;863.00;0
1813;20;626318319;1813;214;2613;2662;8.70;0.54;210.17;3.48;800;20;864.00;49
1817;20;626318339;1817;204;2618;2663;8.66;0.53;210.39;3.48;801;20;865.00;45
1822;20;626318349;1822;193;2624;2663;8.82;0.54;210.45;3.47;802;20;866.00;39
1826;20;626318360;1826;192;2628;2663;8.86;0.55;210.73;3.47;802;20;867.00;35
1830;20;626318370;1830;190;2631;2663;8.95;0.55;210.64;3.47;801;20;868.00;32
1835;20;626318382;1835;192;2635;2663;9.06;0.56;210.76;3.47;800;20;869.00;28
1837;20;626318395;1837;190;2640;2663;9.13;0.56;210.73;3.48;803;20;870.00;23
1844;20;626318405;1844;192;2642;2663;9.09;0.56;210.97;3.48;798;20;871.00;21
1848;20;626318416;1848;192;2645;2664;9.05;0.56;211.15;3.49;797;20;872.00;19
1849;20;626318433;1849;200;2647;2665;9.01;0.55;211.17;3.49;798;20;873.00;18
1853;20;626318444;1853;204;2651;2665;9.02;0.55;211.15;3.50;798;20;874.00;14
1859;20;626318456;1859;213;2655;2666;8.99;0.55;211.37;3.51;796;20;875.00;11
1863;20;626318468;1863;220;2657;2666;8.96;0.55;212.09;3.51;794;20;876.00;9
1865;20;626318480;1865;219;2658;2666;8.93;0.55;212.12;3.52;793;20;877.00;8
1869;20;626318491;1869;224;2659;2666;8.88;0.55;212.24;3.52;790;20;878.00;7
1873;20;626318507;1873;225;2662;2670;8.86;0.55;212.44;3.52;789;20;879.00;8
1878;20;626318520;1878;223;2664;2670;8.90;0.55;212.37;3.53;786;20;880.00;6
1880;20;626318532;1880;224;2665;2670;8.95;0.55;212.45;3.54;785;20;881.00;5
1886;20;626318544;1886;224;2668;2673;9.03;0.56;212.49;3.54;782;20;882.00;5
1888;20;626318556;1888;222;2668;2673;9.09;0.56;212.54;3.54;780;20;883.00;5
1895;20;626318567;1895;221;2670;2673;9.15;0.56;212.64;3.54;775;20;884.00;3
1897;20;626318579;1897;218;2674;2677;9.22;0.57;212.75;3.54;777;20;885.00;3
1904;20;626318591;1904;219;2677;2678;9.19;0.56;212.71;3.55;773;20;886.00;1
1907;20;626318603;1907;218;2677;2678;9.20;0.57;212.93;3.55;770;20;887.00;1
1909;20;626318614;1909;222;2682;2682;9.33;0.57;212.95;3.54;773;20;888.00;0
1914;20;626318626;1914;224;2682;2682;9.44;0.58;212.96;3.54;768;20;889.00;0
1916;20;626318637;1916;225;2682;2682;9.42;0.58;213.02;3.54;766;20;890.00;0
1921;20;626318648;1921;224;2683;2683;9.46;0.58;213.12;3.54;762;20;891.00;0
1924;20;626318660;1924;226;2683;2683;9.39;0.58;213.01;3.54;759;20;892.00;0
1928;20;626318672;1928;227;2688;2689;9.38;0.58;213.17;3.54;760;20;893.00;1
1933;20;626318683;1933;227;2688;2689;9.32;0.57;213.27;3.54;755;20;894.00;1
1936;20;626318695;1936;231;2690;2690;9.22;0.57;213.31;3.53;754;20;895.00;0
1942;20;626318706;1942;236;2690;2690;9.13;0.56;213.53;3.53;748;20;896.00;0
1948;20;626318717;1948;228;2690;2690;9.13;0.56;213.72;3.53;742;20;897.00;0
1952;20;626318729;1952;224;2690;2690;9.09;0.56;213.96;3.53;738;20;898.00;0
1955;20;626318740;1955;223;2690;2690;9.07;0.55;214.18;3.53;735;20;899.00;0
1957;20;626318759;1957;229;2717;2736;8.97;0.55;214.44;3.50;760;20;900.00;19
1959;20;626318779;1959;220;2717;2736;9.01;0.56;214.58;3.50;758;20;901.00;19
1962;20;626318790;1962;214;2719;2736;9.09;0.56;214.74;3.50;757;20;902.00;17
1966;20;626318803;1966;214;2721;2736;9.09;0.56;214.89;3.50;755;20;903.00;15
1970;20;626318820;1970;215;2722;2736;9.09;0.56;214.83;3.50;752;20;904.00;14
1973;20;626318837;1973;218;2722;2736;9.02;0.55;215.06;3.50;749;20;905.00;14
1977;20;626318855;1977;208;2727;2740;8.95;0.55;215.27;3.50;750;20;906.00;13
1979;20;626318873;1979;198;2728;2740;8.94;0.55;215.44;3.50;749;20;907.00;12
1983;21;626318889;1983;190;2731;2744;8.96;0.55;215.42;3.50;748;21;908.00;13
1985;21;626318926;1985;184;2733;2745;9.04;0.55;215.39;3.50;748;21;909.00;12
1989;21;626318940;1989;187;2734;2745;9.12;0.56;215.60;3.50;745;21;910.00;11
1990;21;626318952;1990;179;2734;2745;9.20;0.56;215.59;3.50;744;21;911.00;11
1993;21;626318964;1993;180;2743;2758;9.37;0.57;215.70;3.49;750;21;912.00;15
1995;21;626318979;1995;179;2743;2758;9.45;0.58;215.83;3.49;748;21;913.00;15
1997;21;626318993;1997;189;2744;2758;9.53;0.58;215.93;3.49;747;21;914.00;14
2000;21;626319005;2000;185;2746;2759;9.48;0.58;216.01;3.50;746;21;915.00;13
2003;21;626319018;2003;190;2747;2760;9.50;0.58;216.20;3.49;744;21;916.00;13
2007;21;626319030;2007;190;2747;2760;9.55;0.58;216.34;3.49;740;21;917.00;13
2010;21;626319042;2010;187;2749;2763;9.57;0.58;216.31;3.49;739;21;918.00;14
2014;21;626319061;2014;188;2749;2763;9.51;0.58;216.23;3.49;735;21;919.00;14
2017;21;626319073;2017;184;2750;2763;9.49;0.58;216.28;3.50;733;21;920.00;13
2020;22;626319088;2020;182;2751;2763;9.44;0.57;216.19;3.50;731;22;921.00;12
2023;22;626319111;2023;173;2755;2769;9.43;0.57;216.19;3.50;732;22;922.00;14
2025;22;626319134;2025;176;2755;2769;9.46;0.58;216.15;3.50;730;22;923.00;14
2026;22;626319146;2026;172;2755;2769;9.54;0.58;216.19;3.50;729;22;924.00;14
2028;22;626319155;2028;168;2755;2769;9.59;0.58;216.25;3.50;727;22;925.00;14
2033;22;626319166;2033;175;2761;2773;9.50;0.58;216.33;3.52;728;22;926.00;12
2035;22;626319177;2035;169;2764;2774;9.51;0.58;216.28;3.52;729;22;927.00;10
2037;22;626319188;2037;172;2764;2774;9.54;0.58;216.35;3.52;727;22;928.00;10
2038;22;626319205;2038;177;2766;2775;9.50;0.58;216.33;3.53;728;22;929.00;9
2041;22;626319217;2041;183;2767;2775;9.46;0.58;216.41;3.54;726;22;930.00;8
2042;22;626319237;2042;188;2767;2775;9.36;0.57;216.51;3.54;725;22;931.00;8
2043;22;626319247;2043;186;2768;2775;9.25;0.56;216.64;3.54;725;22;932.00;7
2045;22;626319264;2045;192;2769;2775;9.25;0.56;216.64;3.55;724;22;933.00;6
2049;22;626319280;2049;198;2769;2775;9.22;0.56;216.66;3.55;720;22;934.00;6
2052;22;626319289;2052;199;2770;2775;9.16;0.56;216.67;3.55;718;22;935.00;5
2054;22;626319299;2054;219;2808;2845;8.96;0.55;216.73;3.50;754;22;936.00;37
2055;22;626319314;2055;218;2810;2846;8.86;0.54;216.73;3.52;755;22;937.00;36
2057;22;626319324;2057;222;2815;2846;8.80;0.54;216.70;3.51;758;22;938.00;31
2059;22;626319334;2059;224;2818;2846;8.73;0.53;216.96;3.51;759;22;939.00;28
2061;22;626319345;2061;221;2823;2846;8.70;0.53;217.06;3.51;762;22;940.00;23
2062;22;626319355;2062;226;2824;2846;8.67;0.53;217.04;3.51;762;22;941.00;22
2062;22;626319364;2062;217;2826;2846;8.73;0.53;217.04;3.52;764;22;942.00;20
2064;22;626319373;2064;222;2831;2846;8.79;0.54;217.11;3.52;767;22;943.00;15
2067;22;626319383;2067;221;2836;2847;8.85;0.54;217.02;3.54;769;22;944.00;11
2069;22;626319393;2069;219;2840;2849;8.93;0.55;217.18;3.54;771;22;945.00;9
2071;22;626319402;2071;209;2842;2849;9.02;0.55;217.19;3.55;771;22;946.00;7
2073;22;626319412;2073;209;2845;2853;9.06;0.55;217.22;3.54;772;22;947.00;8
2077;22;626319422;2077;208;2845;2853;9.05;0.55;217.33;3.54;768;22;948.00;8
2079;22;626319432;2079;206;2846;2853;9.00;0.55;217.25;3.55;767;22;949.00;7
2084;22;626319442;2084;203;2846;2853;8.95;0.55;217.35;3.55;762;22;950.00;7
2087;22;626319452;2087;199;2849;2859;8.90;0.55;217.31;3.54;762;22;951.00;10
2091;22;626319461;2091;191;2849;2859;8.82;0.54;217.11;3.54;758;22;952.00;10
2095;22;626319472;2095;194;2851;2859;8.74;0.53;217.13;3.56;756;22;953.00;8
2098;22;626319481;2098;196;2853;2862;8.64;0.53;217.00;3.55;755;22;954.00;9
2102;22;626319491;2102;198;2855;2862;8.57;0.52;216.92;3.56;753;22;955.00;7
2106;22;626319500;2106;199;2855;2862;8.51;0.52;216.75;3.56;749;22;956.00;7
2109;22;626319509;2109;197;2855;2863;8.49;0.52;216.83;3.56;746;22;957.00;8
2110;22;626319518;2110;199;2856;2864;8.54;0.52;216.77;3.56;746;22;958.00;8
2115;22;626319527;2115;199;2856;2864;8.51;0.52;216.54;3.56;741;22;959.00;8
2116;22;626319538;2116;199;2873;2890;8.51;0.52;216.48;3.54;757;22;960.00;17
2118;22;626319549;2118;192;2874;2890;8.57;0.52;216.40;3.54;756;22;961.00;16
2122;22;626319559;2122;193;2876;2890;8.56;0.52;216.23;3.53;754;22;962.00;14
2123;22;626319568;2123;196;2877;2891;8.63;0.53;216.24;3.53;754;22;963.00;14
2125;22;626319577;2125;199;2877;2891;8.68;0.53;216.06;3.53;752;22;964.00;14
2126;22;626319587;2126;200;2880;2895;8.76;0.53;216.00;3.54;754;22;965.00;15
2127;23;626319596;2127;203;2880;2895;8.82;0.54;215.92;3.54;753;23;966.00;15
2130;23;626319616;2130;210;2884;2899;8.87;0.54;216.12;3.54;754;23;967.00;15
2133;23;626319625;2133;216;2884;2899;8.84;0.54;216.03;3.54;751;23;968.00;15
2135;23;626319635;2135;219;2887;2899;8.80;0.53;215.98;3.57;752;23;969.00;12
2137;23;626319649;2137;219;2887;2899;8.79;0.53;215.93;3.57;750;23;970.00;12
2139;23;626319664;2139;221;2889;2899;8.74;0.53;216.00;3.59;750;23;971.00;10
2140;23;626319673;2140;226;2899;2911;8.73;0.53;215.97;3.58;759;23;972.00;12
2141;23;626319683;2141;228;2900;2911;8.72;0.53;215.92;3.57;759;23;973.00;11
2143;23;626319693;2143;233;2901;2911;8.68;0.53;215.96;3.58;758;23;974.00;10
2146;23;626319703;2146;232;2902;2911;8.66;0.53;215.94;3.58;756;23;975.00;9
2148;23;626319712;2148;240;2902;2911;8.60;0.52;215.97;3.58;754;23;976.00;9
2149;23;626319722;2149;244;2903;2911;8.57;0.52;215.98;3.59;754;23;977.00;8
2151;23;626319732;2151;249;2904;2912;8.51;0.52;216.01;3.59;753;23;978.00;8
2151;23;626319742;2151;244;2904;2912;8.50;0.52;216.01;3.59;753;23;979.00;8
2151;23;626319751;2151;240;2910;2918;8.60;0.53;216.01;3.61;759;23;980.00;8
2153;23;626319761;2153;237;2912;2919;8.69;0.53;216.01;3.61;759;23;981.00;7
2155;23;626319771;2155;227;2912;2919;8.76;0.53;216.11;3.61;757;23;982.00;7
2155;23;626319781;2155;224;2914;2919;8.83;0.54;216.11;3.62;759;23;983.00;5
2158;23;626319799;2158;219;2917;2923;8.91;0.54;216.11;3.62;759;23;984.00;6
2159;23;626319810;2159;219;2919;2923;8.96;0.55;216.05;3.63;760;23;985.00;4
2162;23;626319820;2162;219;2919;2923;8.98;0.55;215.86;3.63;757;23;986.00;4
2163;23;626319837;2163;214;2921;2924;9.07;0.55;215.82;3.63;758;23;987.00;3
2163;23;626319848;2163;216;2924;2928;9.09;0.55;215.82;3.63;761;23;988.00;4
2166;23;626319858;2166;213;2926;2928;9.14;0.56;215.85;3.63;760;23;989.00;2
2167;23;626319870;2167;220;2930;2934;9.26;0.56;215.76;3.63;763;23;990.00;4
2168;23;626319885;2168;216;2932;2934;9.26;0.56;215.67;3.63;764;23;991.00;2
2168;23;626319895;2168;215;2932;2934;9.27;0.57;215.67;3.63;764;23;992.00;2
2171;23;626319904;2171;215;2933;2934;9.27;0.57;215.80;3.63;762;23;993.00;1
2175;23;626319915;2175;219;2935;2938;9.24;0.56;215.80;3.63;760;23;994.00;3
2177;23;626319925;2177;217;2936;2938;9.17;0.56;215.85;3.63;759;23;995.00;2
2178;23;626319935;2178;220;2937;2938;9.13;0.56;215.82;3.63;759;23;996.00;1
2180;23;626319944;2180;220;2937;2938;9.03;0.55;215.81;3.63;757;23;997.00;1
2180;23;626319954;2180;223;2939;2939;8.94;0.54;215.81;3.63;759;23;998.00;0
2181;23;626319965;2181;222;2940;2940;8.83;0.54;215.78;3.63;759;23;999.00;0
2182;23;626319977;2182;220;2940;2940;8.75;0.53;215.78;3.63;758;23;1000.00;0
2184;23;626319996;2184;227;2941;2941;8.73;0.53;215.71;3.63;757;23;1001.00;0
2186;23;626320006;2186;222;2941;2941;8.67;0.53;215.60;3.63;755;23;1002.00;0
2189;23;626320016;2189;223;2941;2941;8.69;0.53;215.85;3.63;752;23;1003.00;0
2193;23;626320025;2193;225;2941;2941;8.65;0.53;215.86;3.63;748;23;1004.00;0
2193;23;626320034;2193;224;2941;2941;8.68;0.53;215.86;3.63;748;23;1005.00;0
2195;23;626320043;2195;229;2941;2941;8.69;0.53;215.97;3.63;746;23;1006.00;0
2198;23;626320051;2198;224;2941;2941;8.65;0.53;216.13;3.63;743;23;1007.00;0
2201;23;626320060;2201;249;3018;3068;8.78;0.54;216.40;3.54;817;23;1008.00;50
2202;23;626320080;2202;242;3020;3069;8.81;0.55;216.42;3.53;818;23;1009.00;49
2206;23;626320090;2206;238;3027;3069;8.83;0.55;216.46;3.53;821;23;1010.00;42
2208;23;626320100;2208;235;3035;3069;8.79;0.54;216.60;3.53;827;23;1011.00;34
2213;23;626320109;2213;232;3043;3069;8.74;0.54;216.93;3.53;830;23;1012.00;26
2217;23;626320118;2217;236;3047;3069;8.65;0.53;217.11;3.53;830;23;1013.00;22
2222;23;626320127;2222;242;3052;3069;8.56;0.53;217.33;3.54;830;23;1014.00;17
2226;23;626320137;2226;248;3055;3069;8.47;0.52;217.45;3.54;829;23;1015.00;14
2232;23;626320147;2232;254;3058;3070;8.32;0.51;217.33;3.54;826;23;1016.00;12
2238;23;626320158;2238;259;3058;3071;8.21;0.51;217.45;3.54;820;23;1017.00;13
2242;23;626320167;2242;265;3060;3071;8.09;0.50;217.83;3.55;818;23;1018.00;11
2246;23;626320177;2246;274;3062;3072;7.91;0.49;217.89;3.55;816;23;1019.00;10
2250;23;626320188;2250;270;3064;3072;7.82;0.48;218.15;3.55;814;23;1020.00;8
2254;23;626320198;2254;263;3064;3072;7.73;0.48;218.60;3.55;810;23;1021.00;8
2259;23;626320208;2259;264;3065;3072;7.62;0.47;218.79;3.56;806;23;1022.00;7
2262;23;626320218;2262;256;3068;3076;7.66;0.47;218.97;3.56;806;23;1023.00;8
2267;23;626320229;2267;260;3070;3076;7.63;0.47;219.16;3.57;803;23;1024.00;6
2272;23;626320240;2272;258;3072;3076;7.70;0.47;219.24;3.58;800;23;1025.00;4
2276;23;626320251;2276;256;3074;3079;7.74;0.47;219.42;3.57;798;23;1026.00;5
2279;23;626320261;2279;247;3075;3079;7.77;0.48;219.60;3.58;796;23;1027.00;4
2284;23;626320272;2284;243;3077;3079;7.87;0.48;219.76;3.58;793;23;1028.00;2
2288;23;626320283;2288;240;3082;3083;7.93;0.48;220.03;3.58;794;23;1029.00;1
2292;23;626320294;2292;236;3084;3084;8.07;0.49;220.40;3.58;792;23;1030.00;0
2294;23;626320305;2294;231;3084;3084;8.20;0.50;220.38;3.58;790;23;1031.00;0
2302;23;626320315;2302;222;3088;3088;8.29;0.51;220.87;3.57;786;23;1032.00;0
2305;23;626320327;2305;216;3088;3088;8.33;0.51;221.14;3.57;783;23;1033.00;0
2308;23;626320338;2308;215;3088;3088;8.43;0.51;221.05;3.57;780;23;1034.00;0
2314;23;626320350;2314;215;3090;3090;8.46;0.52;221.39;3.57;776;23;1035.00;0
2316;23;626320361;2316;211;3090;3090;8.61;0.53;221.56;3.57;774;23;1036.00;0
2320;23;626320372;2320;210;3095;3096;8.73;0.53;221.70;3.57;775;23;1037.00;1
2325;23;626320389;2325;207;3095;3096;8.77;0.54;221.69;3.57;770;23;1038.00;1
2328;23;626320400;2328;202;3097;3097;8.82;0.54;221.82;3.57;769;23;1039.00;0
2332;23;626320417;2332;198;3097;3097;8.89;0.54;221.96;3.57;765;23;1040.00;0
2336;23;626320429;2336;192;3097;3097;8.96;0.55;221.96;3.57;761;23;1041.00;0
2338;23;626320440;2338;193;3097;3097;9.07;0.55;222.03;3.57;759;23;1042.00;0
2340;23;626320451;2340;193;3097;3097;9.15;0.56;222.03;3.57;757;23;1043.00;0
2343;23;626320462;2343;192;3108;3109;9.31;0.57;221.99;3.55;765;23;1044.00;1
2344;23;626320475;2344;187;3109;3109;9.43;0.58;221.98;3.55;765;23;1045.00;0
2347;23;626320486;2347;185;3109;3109;9.43;0.58;221.94;3.55;762;23;1046.00;0
2352;23;626320497;2352;186;3109;3109;9.46;0.58;222.19;3.55;757;23;1047.00;0
2356;23;626320508;2356;186;3109;3109;9.43;0.57;222.61;3.55;753;23;1048.00;0
2359;23;626320520;2359;182;3109;3109;9.48;0.58;222.60;3.55;750;23;1049.00;0
2364;23;626320533;2364;186;3115;3115;9.50;0.58;222.82;3.55;751;23;1050.00;0
2370;23;626320545;2370;186;3115;3115;9.49;0.58;222.91;3.55;745;23;1051.00;0
2376;23;626320556;2376;183;3118;3119;9.62;0.58;223.01;3.54;742;23;1052.00;1
2381;23;626320568;2381;187;3120;3120;9.61;0.58;223.16;3.54;739;23;1053.00;0
2386;23;626320580;2386;187;3120;3120;9.57;0.58;223.33;3.54;734;23;1054.00;0
2388;23;626320591;2388;190;3120;3120;9.65;0.59;223.36;3.54;732;23;1055.00;0
2394;23;626320602;2394;194;3133;3133;9.57;0.58;223.34;3.53;739;23;1056.00;0
2397;23;626320614;2397;196;3133;3133;9.53;0.58;223.36;3.53;736;23;1057.00;0
2399;23;626320625;2399;195;3133;3133;9.57;0.58;223.41;3.53;734;23;1058.00;0
2404;23;626320636;2404;194;3134;3134;9.55;0.58;223.44;3.53;730;23;1059.00;0
2408;23;626320647;2408;191;3135;3135;9.59;0.58;223.50;3.53;727;23;1060.00;0
2412;23;626320658;2412;192;3135;3135;9.61;0.58;223.50;3.53;723;23;1061.00;0
2414;23;626320669;2414;188;3137;3138;9.63;0.59;223.54;3.52;723;23;1062.00;1
2420;23;626320680;2420;190;3137;3138;9.57;0.58;223.73;3.52;717;23;1063.00;1
2425;23;626320690;2425;196;3138;3138;9.56;0.58;223.82;3.52;713;23;1064.00;0
2430;23;626320701;2430;197;3138;3138;9.50;0.58;223.95;3.52;708;23;1065.00;0
2432;23;626320712;2432;208;3143;3144;9.46;0.58;223.99;3.52;711;23;1066.00;1
2434;23;626320723;2434;197;3143;3144;9.45;0.58;223.89;3.52;709;23;1067.00;1
2439;23;626320734;2439;192;3144;3144;9.41;0.57;224.05;3.52;705;23;1068.00;0
2442;23;626320744;2442;196;3144;3144;9.33;0.57;224.15;3.52;702;23;1069.00;0
2444;23;626320754;2444;198;3148;3148;9.27;0.57;224.14;3.52;704;23;1070.00;0
2448;23;626320765;2448;202;3149;3149;9.27;0.57;224.33;3.52;701;23;1071.00;0
2451;23;626320775;2451;209;3149;3149;9.24;0.56;224.35;3.52;698;23;1072.00;0
2455;23;626320786;2455;207;3150;3150;9.22;0.56;224.45;3.51;695;23;1073.00;0
2458;23;626320797;2458;207;3150;3150;9.18;0.56;224.54;3.51;692;23;1074.00;0
2462;23;626320813;2462;211;3150;3150;9.20;0.56;224.53;3.51;688;23;1075.00;0
2466;23;626320840;2466;201;3150;3150;9.21;0.56;224.64;3.51;684;23;1076.00;0
2466;23;626320858;2466;186;3150;3150;9.32;0.57;224.64;3.51;684;23;1077.00;0
2467;23;626320885;2467;173;3150;3150;9.37;0.57;224.74;3.51;683;23;1078.00;0
2470;23;626320902;2470;170;3150;3150;9.47;0.58;224.82;3.51;680;23;1079.00;0
2471;23;626320920;2471;194;3226;3275;9.34;0.58;224.78;3.43;755;23;1080.00;49
2472;23;626320953;2472;180;3230;3276;9.35;0.58;224.87;3.43;758;23;1081.00;46
2474;23;626320966;2474;165;3236;3276;9.44;0.58;224.91;3.43;762;23;1082.00;40
2477;23;626320978;2477;154;3240;3276;9.57;0.59;224.87;3.43;763;23;1083.00;36
2481;23;626320997;2481;153;3246;3276;9.62;0.59;225.03;3.43;765;23;1084.00;30
2484;23;626321017;2484;156;3249;3276;9.62;0.59;225.09;3.43;765;23;1085.00;27
2488;23;626321029;2488;153;3253;3276;9.58;0.59;225.21;3.43;765;23;1086.00;23
2492;23;626321041;2492;148;3255;3276;9.57;0.59;225.31;3.43;763;23;1087.00;21
2495;23;626321053;2495;147;3258;3277;9.53;0.59;225.22;3.44;763;23;1088.00;19
2495;23;626321065;2495;151;3260;3278;9.43;0.58;225.22;3.44;765;23;1089.00;18
2499;23;626321077;2499;151;3261;3278;9.25;0.57;225.11;3.44;762;23;1090.00;17
2499;23;626321088;2499;153;3267;3282;9.15;0.56;225.11;3.44;768;23;1091.00;15
2500;23;626321100;2500;163;3268;3282;9.09;0.56;225.11;3.44;768;23;1092.00;14
2501;23;626321111;2501;167;3269;3282;9.02;0.55;225.05;3.45;768;23;1093.00;13
2501;23;626321122;2501;173;3270;3282;8.89;0.55;225.05;3.45;769;23;1094.00;12
2503;23;626321133;2503;175;3275;3288;8.83;0.54;225.05;3.45;772;23;1095.00;13
2505;23;626321145;2505;176;3275;3288;8.86;0.54;224.98;3.45;770;23;1096.00;13
2506;23;626321156;2506;180;3276;3288;8.85;0.54;224.97;3.45;770;23;1097.00;12
2507;23;626321173;2507;182;3278;3291;8.92;0.55;224.91;3.45;771;23;1098.00;13
2508;23;626321184;2508;187;3279;3291;9.01;0.55;224.86;3.45;771;23;1099.00;12
2510;23;626321196;2510;187;3280;3291;8.97;0.55;224.83;3.45;770;23;1100.00;11
2511;23;626321211;2511;195;3281;3292;8.94;0.55;224.89;3.45;770;23;1101.00;11
2512;23;626321223;2512;200;3282;3293;8.91;0.55;224.87;3.45;770;23;1102.00;11
2517;23;626321234;2517;207;3282;3293;8.88;0.54;224.88;3.45;765;23;1103.00;11
2520;23;626321245;2520;221;3292;3306;8.82;0.54;224.86;3.44;772;23;1104.00;14
2523;23;626321258;2523;229;3292;3306;8.77;0.54;224.71;3.44;769;23;1105.00;14
2524;23;626321269;2524;238;3292;3306;8.79;0.54;224.66;3.44;768;23;1106.00;14
2525;23;626321279;2525;241;3294;3307;8.81;0.54;224.66;3.45;769;23;1107.00;13
2527;23;626321289;2527;250;3294;3307;8.78;0.54;224.56;3.45;767;23;1108.00;13
2531;23;626321305;2531;258;3297;3311;8.74;0.54;224.41;3.44;766;23;1109.00;14
2535;23;626321324;2535;255;3297;3311;8.76;0.54;224.27;3.44;762;23;1110.00;14
2535;23;626321336;2535;252;3301;3315;8.85;0.54;224.27;3.44;766;23;1111.00;14
2538;23;626321348;2538;244;3302;3315;8.89;0.54;224.23;3.45;764;23;1112.00;13
2540;23;626321358;2540;244;3302;3315;8.88;0.54;224.22;3.45;762;23;1113.00;13
2543;23;626321370;2543;244;3302;3315;8.86;0.54;224.38;3.45;759;23;1114.00;13
2544;23;626321381;2544;243;3303;3315;8.84;0.54;224.44;3.46;759;23;1115.00;12
2546;23;626321393;2546;236;3313;3327;8.82;0.54;224.35;3.45;767;23;1116.00;14
2548;23;626321404;2548;233;3313;3327;8.80;0.54;224.40;3.45;765;23;1117.00;14
2554;23;626321414;2554;231;3314;3327;8.79;0.53;224.28;3.45;760;23;1118.00;13
2558;23;626321426;2558;227;3315;3327;8.70;0.53;224.26;3.46;757;23;1119.00;12
2562;23;626321436;2562;225;3316;3327;8.58;0.52;224.25;3.47;754;23;1120.00;11
2563;23;626321448;2563;226;3316;3327;8.52;0.52;224.27;3.47;753;23;1121.00;11
2566;23;626321457;2566;220;3317;3328;8.43;0.51;224.26;3.48;751;23;1122.00;11
2568;23;626321467;2568;221;3318;3328;8.33;0.51;224.18;3.49;750;23;1123.00;10
2573;23;626321477;2573;216;3323;3334;8.28;0.50;224.08;3.50;750;23;1124.00;11
2575;23;626321487;2575;216;3327;3336;8.19;0.50;224.00;3.51;752;23;1125.00;9
2576;23;626321497;2576;215;3329;3336;8.21;0.50;224.23;3.52;753;23;1126.00;7
2577;23;626321506;2577;219;3329;3336;8.19;0.50;224.19;3.52;752;23;1127.00;7
2578;23;626321515;2578;222;3333;3340;8.19;0.50;224.14;3.53;755;23;1128.00;7
2579;23;626321524;2579;221;3333;3340;8.19;0.50;224.12;3.53;754;23;1129.00;7
2580;23;626321534;2580;222;3334;3340;8.19;0.50;224.07;3.54;754;23;1130.00;6
2583;23;626321542;2583;208;3335;3341;8.30;0.50;224.13;3.54;752;23;1131.00;6
2584;23;626321552;2584;197;3338;3345;8.41;0.51;224.05;3.54;754;23;1132.00;7
2584;23;626321562;2584;185;3338;3345;8.56;0.52;224.05;3.54;754;23;1133.00;7
2584;23;626321571;2584;177;3340;3348;8.78;0.53;224.05;3.54;756;23;1134.00;8
2586;23;626321581;2586;173;3341;3348;8.92;0.54;223.92;3.54;755;23;1135.00;7
2586;23;626321592;2586;161;3341;3348;9.02;0.55;223.92;3.54;755;23;1136.00;7
2588;23;626321602;2588;163;3341;3348;9.09;0.55;223.86;3.54;753;23;1137.00;7
2591;23;626321612;2591;162;3344;3352;9.16;0.55;223.80;3.54;753;23;1138.00;8
2593;24;626321623;2593;157;3345;3352;9.24;0.56;223.73;3.53;752;24;1139.00;7
2594;24;626321647;2594;150;3345;3352;9.32;0.56;223.68;3.53;751;24;1140.00;7
2594;25;626321658;2594;149;3345;3352;9.45;0.57;223.68;3.53;751;25;1141.00;7
2595;25;626321681;2595;150;3345;3353;9.55;0.58;223.67;3.53;750;25;1142.00;8
2597;25;626321691;2597;154;3346;3354;9.63;0.58;223.63;3.53;749;25;1143.00;8
2598;25;626321701;2598;152;3346;3354;9.73;0.59;223.63;3.53;748;25;1144.00;8
2600;25;626321712;2600;150;3347;3355;9.81;0.59;223.62;3.53;747;25;1145.00;8
2602;25;626321728;2602;153;3347;3355;9.92;0.60;223.63;3.53;745;25;1146.00;8
2604;25;626321739;2604;160;3347;3355;9.97;0.60;223.88;3.53;743;25;1147.00;8
2605;25;626321757;2605;159;3347;3355;10.05;0.61;223.88;3.53;742;25;1148.00;8
2605;25;626321768;2605;157;3347;3355;10.06;0.61;223.88;3.53;742;25;1149.00;8
2606;25;626321777;2606;162;3349;3355;10.04;0.61;223.85;3.56;743;25;1150.00;6
2608;25;626321788;2608;162;3349;3355;10.09;0.61;223.91;3.56;741;25;1151.00;6
2610;25;626321801;2610;179;3414;3482;10.12;0.62;223.85;3.49;804;25;1152.00;68
2612;25;626321828;2612;174;3417;3483;10.11;0.62;223.98;3.51;805;25;1153.00;66
2615;25;626321840;2615;168;3427;3483;10.18;0.63;224.30;3.50;812;25;1154.00;56
2615;25;626321852;2615;166;3435;3483;10.24;0.63;224.30;3.50;820;25;1155.00;48
2617;25;626321863;2617;172;3443;3483;10.30;0.64;224.29;3.51;826;25;1156.00;40
2621;26;626321874;2621;169;3449;3483;10.32;0.64;224.38;3.52;828;26;1157.00;34
2625;26;626321891;2625;170;3456;3483;10.21;0.63;224.66;3.53;831;26;1158.00;27
2626;26;626321901;2626;171;3462;3483;10.10;0.62;224.77;3.54;836;26;1159.00;21
2629;26;626321912;2629;170;3464;3484;10.04;0.62;224.73;3.54;835;26;1160.00;20
2633;26;626321922;2633;177;3468;3485;10.00;0.62;225.00;3.55;835;26;1161.00;17
2637;26;626321933;2637;175;3471;3485;9.99;0.62;225.09;3.55;834;26;1162.00;14
2640;26;626321944;2640;183;3472;3486;9.93;0.61;225.35;3.56;832;26;1163.00;14
2644;26;626321955;2644;188;3475;3486;9.89;0.61;225.34;3.56;831;26;1164.00;11
2648;26;626321965;2648;199;3478;3486;9.78;0.60;225.60;3.57;830;26;1165.00;8
2650;26;626321981;2650;201;3481;3486;9.68;0.59;225.58;3.58;831;26;1166.00;5
2656;26;626321992;2656;210;3484;3490;9.60;0.59;225.51;3.58;828;26;1167.00;6
2659;26;626322003;2659;221;3486;3490;9.48;0.58;225.64;3.59;827;26;1168.00;4
2661;26;626322013;2661;221;3487;3490;9.31;0.57;225.74;3.59;826;26;1169.00;3
2663;26;626322025;2663;227;3491;3496;9.16;0.56;225.94;3.59;828;26;1170.00;5
2665;26;626322041;2665;226;3492;3496;9.03;0.55;225.99;3.59;827;26;1171.00;4
2666;26;626322058;2666;230;3493;3496;8.92;0.55;226.14;3.59;827;26;1172.00;3
2668;26;626322068;2668;235;3497;3500;8.79;0.54;226.18;3.59;829;26;1173.00;3
2671;26;626322079;2671;234;3499;3501;8.71;0.53;226.44;3.59;828;26;1174.00;2
2675;26;626322096;2675;244;3499;3501;8.62;0.53;226.42;3.59;824;26;1175.00;2
2679;26;626322106;2679;249;3504;3505;8.68;0.53;226.37;3.58;825;26;1176.00;1
2681;26;626322117;2681;252;3505;3505;8.68;0.53;226.46;3.58;824;26;1177.00;0
2682;26;626322127;2682;252;3505;3505;8.67;0.53;226.53;3.58;823;26;1178.00;0
2684;26;626322143;2684;252;3506;3506;8.62;0.52;226.65;3.58;822;26;1179.00;0
2688;26;626322154;2688;252;3506;3506;8.54;0.52;226.77;3.58;818;26;1180.00;0
2689;26;626322164;2689;252;3511;3512;8.54;0.52;226.77;3.58;822;26;1181.00;1
2693;26;626322174;2693;252;3511;3512;8.41;0.51;226.94;3.58;818;26;1182.00;1
2699;26;626322184;2699;253;3513;3513;8.28;0.51;227.16;3.58;814;26;1183.00;0
2702;26;626322195;2702;251;3513;3513;8.23;0.50;227.08;3.58;811;26;1184.00;0
2707;26;626322204;2707;257;3513;3513;8.16;0.50;227.20;3.58;806;26;1185.00;0
2710;26;626322220;2710;265;3513;3513;8.13;0.50;227.27;3.58;803;26;1186.00;0
2714;26;626322229;2714;272;3513;3513;8.07;0.49;227.23;3.58;799;26;1187.00;0
2718;26;626322239;2718;271;3524;3525;8.07;0.49;227.63;3.57;806;26;1188.00;1
2722;26;626322255;2722;275;3524;3525;7.98;0.49;227.79;3.57;802;26;1189.00;1
2728;26;626322265;2728;262;3525;3525;7.90;0.48;227.92;3.57;797;26;1190.00;0
2729;26;626322275;2729;245;3525;3525;7.85;0.48;227.99;3.57;796;26;1191.00;0
2732;26;626322284;2732;246;3525;3525;7.82;0.48;228.11;3.57;793;26;1192.00;0
2735;26;626322293;2735;242;3525;3525;7.82;0.48;228.27;3.57;790;26;1193.00;0
2737;26;626322303;2737;244;3529;3529;7.82;0.48;228.39;3.56;792;26;1194.00;0
2742;26;626322313;2742;243;3529;3529;7.85;0.48;228.54;3.56;787;26;1195.00;0
2744;26;626322323;2744;237;3532;3533;8.01;0.49;228.61;3.56;788;26;1196.00;1
2749;26;626322333;2749;238;3534;3534;8.09;0.49;228.59;3.56;785;26;1197.00;0
2753;26;626322344;2753;223;3534;3534;8.12;0.50;228.70;3.56;781;26;1198.00;0
2758;26;626322354;2758;216;3534;3534;8.18;0.50;228.72;3.56;776;26;1199.00;0
2760;26;626322367;2760;221;3557;3575;8.26;0.51;228.82;3.54;797;26;1200.00;18
2766;26;626322385;2766;209;3560;3575;8.37;0.51;229.04;3.53;794;26;1201.00;15
2768;26;626322397;2768;197;3561;3575;8.50;0.52;229.13;3.53;793;26;1202.00;14
2773;26;626322413;2773;196;3565;3576;8.60;0.53;229.06;3.53;792;26;1203.00;11
2777;26;626322424;2777;190;3567;3577;8.67;0.53;229.24;3.53;790;26;1204.00;10
2783;26;626322439;2783;184;3569;3577;8.69;0.53;229.33;3.53;786;26;1205.00;8
2787;26;626322450;2787;187;3571;3580;8.81;0.54;229.62;3.53;784;26;1206.00;9
2795;26;626322461;2795;192;3572;3580;8.78;0.53;229.59;3.53;777;26;1207.00;8
2799;26;626322472;2799;197;3573;3580;8.78;0.53;229.72;3.53;774;26;1208.00;7
2801;26;626322482;2801;197;3573;3580;8.82;0.54;229.62;3.53;772;26;1209.00;7
2803;26;626322492;2803;197;3578;3586;8.89;0.54;229.66;3.53;775;26;1210.00;8
2804;26;626322503;2804;199;3581;3586;8.89;0.54;229.67;3.53;777;26;1211.00;5
2808;26;626322514;2808;198;3581;3586;8.81;0.54;229.73;3.53;773;26;1212.00;5
2811;26;626322525;2811;192;3581;3586;8.73;0.53;229.75;3.53;770;26;1213.00;5
2816;26;626322535;2816;191;3585;3590;8.69;0.53;229.86;3.53;769;26;1214.00;5
2819;26;626322546;2819;191;3587;3592;8.70;0.53;229.87;3.53;768;26;1215.00;5
2823;26;626322557;2823;191;3587;3592;8.73;0.53;229.82;3.53;764;26;1216.00;5
2828;26;626322567;2828;195;3589;3593;8.79;0.54;230.07;3.53;761;26;1217.00;4
2831;26;626322578;2831;194;3589;3593;8.81;0.54;230.15;3.53;758;26;1218.00;4
2837;26;626322589;2837;202;3589;3593;8.85;0.54;230.37;3.53;752;26;1219.00;4
2842;26;626322605;2842;207;3589;3593;8.82;0.54;230.46;3.53;747;26;1220.00;4
2849;26;626322616;2849;211;3589;3593;8.75;0.53;230.53;3.53;740;26;1221.00;4
2855;26;626322626;2855;212;3589;3593;8.72;0.53;230.71;3.53;734;26;1222.00;4
2862;26;626322637;2862;216;3590;3593;8.56;0.52;230.81;3.54;728;26;1223.00;3
2866;26;626322647;2866;225;3632;3663;8.40;0.51;230.69;3.49;766;26;1224.00;31
2871;26;626322663;2871;225;3633;3664;8.40;0.52;230.86;3.49;762;26;1225.00;31
2876;26;626322679;2876;227;3638;3664;8.42;0.52;231.14;3.49;762;26;1226.00;26
2881;26;626322689;2881;228;3638;3664;8.42;0.52;231.26;3.49;757;26;1227.00;26
2888;26;626322699;2888;234;3642;3666;8.42;0.52;231.66;3.50;754;26;1228.00;24
2890;26;626322710;2890;234;3644;3666;8.45;0.52;231.71;3.50;754;26;1229.00;22
2892;26;626322722;2892;239;3646;3666;8.45;0.52;231.81;3.50;754;26;1230.00;20
2896;26;626322732;2896;238;3649;3666;8.40;0.52;231.92;3.51;753;26;1231.00;17
2901;26;626322742;2901;246;3652;3667;8.34;0.51;232.05;3.51;751;26;1232.00;15
2902;26;626322758;2902;260;3655;3668;8.22;0.50;232.06;3.52;753;26;1233.00;13
2908;26;626322767;2908;269;3659;3668;8.12;0.50;232.16;3.53;751;26;1234.00;9
2911;26;626322777;2911;272;3664;3672;7.98;0.49;232.39;3.53;753;26;1235.00;8
2915;26;626322788;2915;276;3667;3672;7.84;0.48;232.52;3.54;752;26;1236.00;5
2918;26;626322798;2918;265;3668;3672;7.81;0.48;232.46;3.54;750;26;1237.00;4
2921;26;626322812;2921;261;3670;3672;7.77;0.48;232.47;3.54;749;26;1238.00;2
2924;26;626322828;2924;256;3676;3678;7.78;0.48;232.49;3.54;752;26;1239.00;2
2927;26;626322849;2927;254;3677;3678;7.77;0.47;232.47;3.54;750;26;1240.00;1
2930;26;626322868;2930;253;3677;3678;7.82;0.48;232.68;3.54;747;26;1241.00;1
2931;26;626322886;2931;255;3680;3681;7.96;0.49;232.68;3.54;749;26;1242.00;1
2931;26;626322901;2931;260;3681;3681;7.98;0.49;232.68;3.54;750;26;1243.00;0
2933;26;626322918;2933;263;3681;3681;8.03;0.49;232.69;3.54;748;26;1244.00;0
2934;26;626322930;2934;263;3682;3682;8.03;0.49;232.63;3.54;748;26;1245.00;0
2935;26;626322949;2935;251;3683;3683;8.05;0.49;232.67;3.54;748;26;1246.00;0
2936;26;626322961;2936;244;3683;3683;8.16;0.50;232.68;3.54;747;26;1247.00;0
2938;26;626322973;2938;244;3696;3696;8.32;0.51;232.63;3.53;758;26;1248.00;0
2941;26;626322986;2941;233;3696;3696;8.34;0.51;232.53;3.53;755;26;1249.00;0
2943;26;626322998;2943;230;3696;3696;8.42;0.51;232.48;3.53;753;26;1250.00;0
2943;26;626323009;2943;233;3697;3697;8.55;0.52;232.48;3.53;754;26;1251.00;0
2946;26;626323021;2946;230;3697;3697;8.56;0.52;232.38;3.53;751;26;1252.00;0
2948;26;626323032;2948;230;3700;3701;8.62;0.53;232.46;3.52;752;26;1253.00;1
2950;26;626323044;2950;232;3700;3701;8.56;0.52;232.51;3.52;750;26;1254.00;1
2953;26;626323055;2953;237;3705;3705;8.51;0.52;232.42;3.52;752;26;1255.00;0
2953;26;626323068;2953;240;3705;3705;8.50;0.52;232.42;3.52;752;26;1256.00;0
2955;26;626323079;2955;240;3705;3705;8.51;0.52;232.36;3.52;750;26;1257.00;0
2957;26;626323091;2957;231;3705;3705;8.49;0.52;232.40;3.52;748;26;1258.00;0
2960;26;626323102;2960;228;3705;3705;8.47;0.52;232.29;3.52;745;26;1259.00;0
2963;26;626323114;2963;232;3729;3739;8.50;0.52;232.21;3.50;766;26;1260.00;10
2967;26;626323128;2967;226;3729;3739;8.52;0.52;232.22;3.50;762;26;1261.00;10
2970;26;626323139;2970;222;3730;3739;8.60;0.53;232.10;3.50;760;26;1262.00;9
2972;26;626323151;2972;224;3730;3739;8.66;0.53;232.02;3.50;758;26;1263.00;9
2973;26;626323162;2973;225;3731;3739;8.70;0.53;231.98;3.50;758;26;1264.00;8
2975;26;626323172;2975;231;3731;3739;8.73;0.53;231.99;3.50;756;26;1265.00;8
2976;26;626323183;2976;229;3732;3740;8.75;0.54;231.94;3.50;756;26;1266.00;8
2977;26;626323193;2977;231;3733;3740;8.77;0.54;231.90;3.50;756;26;1267.00;7
2979;26;626323204;2979;227;3736;3746;8.67;0.53;231.82;3.50;757;26;1268.00;10
2981;26;626323215;2981;232;3738;3747;8.60;0.53;231.71;3.50;757;26;1269.00;9
2982;26;626323226;2982;240;3739;3747;8.55;0.52;231.70;3.50;757;26;1270.00;8
2984;26;626323236;2984;243;3739;3747;8.42;0.52;231.63;3.50;755;26;1271.00;8
2990;26;626323246;2990;242;3742;3751;8.30;0.51;231.48;3.50;752;26;1272.00;9
2991;26;626323259;2991;251;3742;3751;8.20;0.50;231.45;3.50;751;26;1273.00;9
2992;26;626323269;2992;255;3742;3751;8.10;0.49;231.44;3.50;750;26;1274.00;9
2993;26;626323279;2993;264;3743;3752;8.00;0.49;231.45;3.50;750;26;1275.00;9
2994;26;626323289;2994;273;3746;3756;7.90;0.48;231.39;3.49;752;26;1276.00;10
2996;26;626323308;2996;274;3746;3756;7.86;0.48;231.35;3.49;750;26;1277.00;10
2996;26;626323324;2996;283;3748;3759;7.87;0.48;231.35;3.49;752;26;1278.00;11
2999;26;626323333;2999;291;3749;3759;7.77;0.47;231.32;3.49;750;26;1279.00;10
2999;26;626323344;2999;290;3749;3759;7.77;0.47;231.32;3.49;750;26;1280.00;10
3001;26;626323354;3001;286;3749;3759;7.80;0.48;231.31;3.49;748;26;1281.00;10
3002;26;626323363;3002;283;3752;3763;7.81;0.48;231.32;3.49;750;26;1282.00;11
3004;26;626323373;3004;272;3752;3763;7.85;0.48;231.44;3.49;748;26;1283.00;11
3005;26;626323383;3005;248;3753;3763;7.89;0.48;231.42;3.49;748;26;1284.00;10
3007;26;626323395;3007;238;3753;3763;7.93;0.48;231.42;3.49;746;26;1285.00;10
3008;26;626323404;3008;224;3753;3764;8.03;0.49;231.37;3.49;745;26;1286.00;11
3011;26;626323415;3011;213;3754;3765;8.15;0.50;231.54;3.49;743;26;1287.00;11
3013;26;626323425;3013;201;3754;3765;8.24;0.50;231.54;3.49;741;26;1288.00;11
3014;26;626323435;3014;193;3755;3766;8.33;0.51;231.58;3.49;741;26;1289.00;11
3016;26;626323454;3016;189;3755;3766;8.35;0.51;231.56;3.49;739;26;1290.00;11
3017;26;626323464;3017;176;3755;3766;8.38;0.51;231.57;3.49;738;26;1291.00;11
3021;26;626323474;3021;167;3755;3766;8.38;0.51;231.57;3.49;734;26;1292.00;11
3022;26;626323490;3022;158;3755;3766;8.48;0.52;231.55;3.49;733;26;1293.00;11
3023;26;626323499;3023;159;3756;3766;8.48;0.52;231.55;3.50;733;26;1294.00;10
3024;26;626323509;3024;152;3757;3766;8.55;0.52;231.52;3.50;733;26;1295.00;9
3025;26;626323519;3025;166;3823;3893;8.68;0.54;231.53;3.44;798;26;1296.00;70
3028;26;626323539;3028;153;3823;3894;8.72;0.54;231.52;3.44;795;26;1297.00;71
3031;26;626323551;3031;142;3833;3894;8.89;0.55;231.43;3.45;802;26;1298.00;61
3034;26;626323562;3034;145;3835;3894;8.98;0.55;231.46;3.45;801;26;1299.00;59
3034;26;626323574;3034;141;3840;3894;9.11;0.56;231.46;3.45;806;26;1300.00;54
3037;26;626323589;3037;133;3846;3894;9.24;0.57;231.49;3.45;809;26;1301.00;48
3037;26;626323599;3037;131;3849;3894;9.31;0.57;231.49;3.45;812;26;1302.00;45
3038;26;626323616;3038;126;3853;3894;9.40;0.58;231.46;3.47;815;26;1303.00;41
3040;26;626323626;3040;128;3857;3895;9.46;0.58;231.43;3.47;817;26;1304.00;38
3042;26;626323637;3042;133;3861;3897;9.50;0.58;231.47;3.48;819;26;1305.00;36
3046;26;626323648;3046;136;3865;3897;9.56;0.58;231.62;3.49;819;26;1306.00;32
3049;27;626323659;3049;141;3868;3898;9.56;0.58;231.54;3.50;819;27;1307.00;30
3052;27;626323683;3052;141;3869;3898;9.48;0.58;231.52;3.50;817;27;1308.00;29
3053;27;626323699;3053;142;3871;3898;9.46;0.58;231.46;3.51;818;27;1309.00;27
3058;27;626323709;3058;146;3873;3898;9.40;0.57;231.54;3.51;815;27;1310.00;25
3061;27;626323720;3061;146;3877;3902;9.37;0.57;231.56;3.52;816;27;1311.00;25
3064;27;626323733;3064;154;3880;3902;9.38;0.57;231.56;3.53;816;27;1312.00;22
3069;27;626323744;3069;152;3881;3902;9.38;0.57;231.71;3.53;812;27;1313.00;21
3071;27;626323761;3071;153;3884;3905;9.43;0.57;231.87;3.54;813;27;1314.00;21
3071;27;626323773;3071;155;3886;3905;9.48;0.58;231.87;3.54;815;27;1315.00;19
3074;27;626323784;3074;158;3888;3905;9.57;0.58;232.00;3.54;814;27;1316.00;17
3078;27;626323796;3078;156;3893;3909;9.51;0.58;232.10;3.56;815;27;1317.00;16
3079;27;626323810;3079;160;3895;3910;9.57;0.58;232.12;3.56;816;27;1318.00;15
3082;27;626323822;3082;165;3896;3910;9.62;0.58;232.26;3.56;814;27;1319.00;14
3087;27;626323837;3087;165;3900;3915;9.63;0.58;232.39;3.57;813;27;1320.00;15
3090;27;626323850;3090;166;3902;3915;9.62;0.58;232.41;3.58;812;27;1321.00;13
3090;27;626323862;3090;170;3902;3915;9.63;0.58;232.41;3.58;812;27;1322.00;13
3092;27;626323872;3092;175;3904;3916;9.59;0.58;232.57;3.59;812;27;1323.00;12
3094;27;626323889;3094;181;3905;3916;9.62;0.58;232.55;3.60;811;27;1324.00;11
3098;27;626323901;3098;190;3909;3922;9.71;0.59;232.70;3.60;811;27;1325.00;13
3099;27;626323913;3099;193;3911;3922;9.71;0.59;232.78;3.61;812;27;1326.00;11
3102;27;626323924;3102;200;3912;3923;9.68;0.59;232.91;3.61;810;27;1327.00;11
3106;27;626323935;3106;200;3914;3923;9.59;0.58;233.01;3.63;808;27;1328.00;9
3107;27;626323947;3107;199;3914;3923;9.58;0.58;233.06;3.63;807;27;1329.00;9
3109;27;626323958;3109;204;3916;3923;9.49;0.58;233.13;3.64;807;27;1330.00;7
3111;27;626323969;3111;203;3916;3923;9.38;0.57;233.25;3.64;805;27;1331.00;7
3112;27;626323980;3112;209;3927;3935;9.38;0.57;233.32;3.63;815;27;1332.00;8
3117;27;626323992;3117;206;3927;3935;9.30;0.57;233.61;3.63;810;27;1333.00;8
3121;27;626324003;3121;205;3929;3935;9.23;0.56;233.72;3.64;808;27;1334.00;6
3124;27;626324014;3124;205;3930;3935;9.14;0.56;233.80;3.65;806;27;1335.00;5
3127;27;626324024;3127;205;3930;3935;9.03;0.55;234.05;3.65;803;27;1336.00;5
3128;27;626324040;3128;211;3933;3935;8.92;0.54;234.05;3.67;805;27;1337.00;2
3131;27;626324058;3131;218;3936;3939;8.74;0.53;234.13;3.66;805;27;1338.00;3
3134;27;626324069;3134;212;3937;3939;8.68;0.53;234.24;3.67;803;27;1339.00;2
3134;27;626324080;3134;209;3940;3943;8.70;0.53;234.24;3.67;806;27;1340.00;3
3139;27;626324091;3139;212;3943;3944;8.67;0.53;234.32;3.67;804;27;1341.00;1
3142;27;626324102;3142;214;3944;3944;8.62;0.53;234.32;3.67;802;27;1342.00;0
3145;27;626324114;3145;210;3944;3944;8.61;0.53;234.29;3.67;799;27;1343.00;0
3147;27;626324124;3147;212;3956;3957;8.60;0.53;234.37;3.65;809;27;1344.00;1
3148;27;626324135;3148;212;3956;3957;8.61;0.53;234.43;3.65;808;27;1345.00;1
3149;27;626324145;3149;213;3957;3957;8.71;0.53;234.46;3.65;808;27;1346.00;0
3151;27;626324155;3151;216;3958;3958;8.78;0.54;234.46;3.65;807;27;1347.00;0
3153;27;626324165;3153;225;3959;3959;8.88;0.54;234.52;3.65;806;27;1348.00;0
3155;27;626324176;3155;221;3959;3959;8.96;0.55;234.63;3.65;804;27;1349.00;0
3158;27;626324188;3158;223;3962;3968;8.95;0.55;234.74;3.65;804;27;1350.00;6
3168;27;626324199;3168;225;3962;3968;8.83;0.54;234.71;3.65;794;27;1351.00;6
3169;27;626324210;3169;227;3964;3968;8.90;0.54;234.70;3.65;795;27;1352.00;4
3173;27;626324220;3173;230;3964;3968;8.84;0.54;234.92;3.65;791;27;1353.00;4
3175;27;626324230;3175;231;3969;3974;8.87;0.54;234.86;3.65;794;27;1354.00;5
3180;27;626324240;3180;228;3969;3974;8.82;0.54;235.04;3.65;789;27;1355.00;5
3184;27;626324251;3184;226;3970;3974;8.71;0.53;235.05;3.65;786;27;1356.00;4
3186;27;626324260;3186;229;3970;3974;8.58;0.52;235.06;3.65;784;27;1357.00;4
3191;27;626324269;3191;242;3975;3978;8.43;0.52;235.27;3.65;784;27;1358.00;3
3193;27;626324279;3193;243;3977;3979;8.34;0.51;235.33;3.65;784;27;1359.00;2
3197;27;626324288;3197;232;3978;3979;8.27;0.50;235.54;3.65;781;27;1360.00;1
3201;27;626324297;3201;225;3979;3980;8.16;0.50;235.65;3.65;778;27;1361.00;1
3204;27;626324307;3204;221;3979;3980;8.13;0.50;235.58;3.65;775;27;1362.00;1
3210;27;626324316;3210;216;3979;3980;8.12;0.50;235.63;3.65;769;27;1363.00;1
3211;27;626324326;3211;217;3979;3980;8.16;0.50;235.67;3.65;768;27;1364.00;1
3218;27;626324335;3218;214;3979;3980;8.10;0.49;235.77;3.65;761;27;1365.00;1
3221;27;626324345;3221;207;3979;3980;8.13;0.50;235.73;3.65;758;27;1366.00;1
3226;27;626324354;3226;201;3979;3980;8.14;0.50;236.10;3.65;753;27;1367.00;1
3231;27;626324364;3231;210;4019;4050;8.28;0.51;236.22;3.61;788;27;1368.00;31
3235;27;626324379;3235;196;4024;4051;8.39;0.51;236.30;3.61;789;27;1369.00;27
3238;27;626324390;3238;193;4031;4051;8.64;0.53;236.33;3.60;793;27;1370.00;20
3243;27;626324400;3243;194;4034;4051;8.81;0.54;236.61;3.60;791;27;1371.00;17
3248;27;626324410;3248;192;4039;4051;8.99;0.55;236.66;3.60;791;27;1372.00;12
3252;27;626324420;3252;197;4043;4051;9.10;0.55;236.86;3.60;791;27;1373.00;8
3256;27;626324430;3256;198;4047;4051;9.13;0.56;236.97;3.61;791;27;1374.00;4
3260;27;626324442;3260;197;4047;4051;9.12;0.56;236.96;3.61;787;27;1375.00;4
3266;27;626324452;3266;208;4049;4052;9.10;0.55;237.11;3.61;783;27;1376.00;3
3268;27;626324463;3268;201;4050;4053;9.06;0.55;237.14;3.61;782;27;1377.00;3
3274;27;626324474;3274;198;4051;4053;9.04;0.55;237.12;3.61;777;27;1378.00;2
3279;27;626324484;3279;204;4053;4057;9.07;0.55;236.96;3.61;774;27;1379.00;4
3282;27;626324498;3282;202;4053;4057;9.08;0.55;237.05;3.61;771;27;1380.00;4
3287;27;626324508;3287;207;4054;4057;9.00;0.55;237.12;3.61;767;27;1381.00;3
3293;27;626324524;3293;205;4054;4057;8.91;0.54;237.04;3.61;761;27;1382.00;3
3297;27;626324535;3297;206;4059;4063;8.84;0.54;237.04;3.60;762;27;1383.00;4
3304;27;626324546;3304;208;4059;4063;8.80;0.54;237.01;3.60;755;27;1384.00;4
3309;27;626324557;3309;214;4060;4063;8.83;0.54;237.06;3.60;751;27;1385.00;3
3314;27;626324587;3314;221;4062;4066;8.84;0.54;236.97;3.60;748;27;1386.00;4
3319;27;626324598;3319;222;4065;4066;8.83;0.54;237.18;3.61;746;27;1387.00;1
3323;27;626324608;3323;229;4065;4066;8.82;0.54;237.33;3.61;742;27;1388.00;1
3327;27;626324619;3327;227;4067;4067;8.76;0.53;237.50;3.61;740;27;1389.00;0
3333;27;626324629;3333;228;4068;4068;8.62;0.53;237.57;3.61;735;27;1390.00;0
3337;27;626324639;3337;230;4068;4068;8.48;0.52;237.56;3.61;731;27;1391.00;0
3338;27;626324655;3338;236;4081;4081;8.40;0.51;237.58;3.60;743;27;1392.00;0
3341;27;626324666;3341;244;4081;4081;8.29;0.51;237.69;3.60;740;27;1393.00;0
3343;27;626324676;3343;248;4081;4081;8.29;0.51;237.71;3.60;738;27;1394.00;0
3348;27;626324686;3348;252;4083;4083;8.25;0.50;237.71;3.60;735;27;1395.00;0
3352;27;626324696;3352;255;4083;4083;8.23;0.50;237.69;3.60;731;27;1396.00;0
3356;27;626324707;3356;260;4086;4087;8.22;0.50;237.67;3.60;730;27;1397.00;1
3360;27;626324718;3360;270;4086;4087;8.11;0.49;237.61;3.60;726;27;1398.00;1
3364;27;626324728;3364;276;4091;4091;8.09;0.49;237.56;3.60;727;27;1399.00;0
3365;27;626324738;3365;279;4091;4091;8.04;0.49;237.58;3.60;726;27;1400.00;0
3368;27;626324752;3368;289;4091;4091;8.02;0.49;237.65;3.60;723;27;1401.00;0
3371;27;626324761;3371;293;4091;4091;7.96;0.49;237.56;3.60;720;27;1402.00;0
3374;27;626324771;3374;296;4091;4091;7.83;0.48;237.59;3.60;717;27;1403.00;0
3377;27;626324780;3377;302;4102;4103;7.84;0.48;237.61;3.59;725;27;1404.00;1
3379;27;626324791;3379;310;4102;4103;7.80;0.48;237.56;3.59;723;27;1405.00;1
3380;27;626324800;3380;313;4103;4103;7.73;0.47;237.55;3.59;723;27;1406.00;0
3382;27;626324814;3382;309;4103;4103;7.67;0.47;237.51;3.59;721;27;1407.00;0
3385;27;626324841;3385;309;4103;4103;7.68;0.47;237.50;3.59;718;27;1408.00;0
3385;27;626324856;3385;307;4103;4103;7.65;0.47;237.50;3.59;718;27;1409.00;0
3389;27;626324874;3389;305;4104;4104;7.55;0.46;237.51;3.58;715;27;1410.00;0
3390;27;626324889;3390;307;4104;4104;7.56;0.46;237.67;3.58;714;27;1411.00;0
3396;27;626324903;3396;310;4109;4110;7.51;0.46;237.48;3.58;713;27;1412.00;1
3400;27;626324916;3400;308;4110;4111;7.56;0.46;237.47;3.58;710;27;1413.00;1
3402;27;626324930;3402;313;4111;4111;7.63;0.47;237.44;3.58;709;27;1414.00;0
3403;27;626324941;3403;314;4111;4111;7.63;0.47;237.39;3.58;708;27;1415.00;0
3404;27;626324957;3404;301;4115;4115;7.65;0.47;237.35;3.58;711;27;1416.00;0
3408;27;626324971;3408;293;4115;4115;7.62;0.47;237.43;3.58;707;27;1417.00;0
3411;27;626324983;3411;280;4115;4115;7.64;0.47;237.38;3.58;704;27;1418.00;0
3412;27;626324993;3412;276;4116;4116;7.69;0.47;237.33;3.58;704;27;1419.00;0
3414;27;626325004;3414;271;4120;4120;7.71;0.47;237.31;3.57;706;27;1420.00;0
3417;27;626325016;3417;266;4120;4120;7.69;0.47;237.16;3.57;703;27;1421.00;0
3419;27;626325026;3419;268;4122;4123;7.77;0.47;237.11;3.57;703;27;1422.00;1
3419;27;626325036;3419;268;4122;4123;7.83;0.48;237.11;3.57;703;27;1423.00;1
3419;27;626325047;3419;267;4123;4123;7.91;0.48;237.11;3.57;704;27;1424.00;0
3423;27;626325059;3423;265;4123;4123;7.98;0.49;237.12;3.57;700;27;1425.00;0
3425;27;626325069;3425;269;4126;4127;8.01;0.49;237.18;3.57;701;27;1426.00;1
3427;27;626325080;3427;268;4126;4127;8.01;0.49;237.20;3.57;699;27;1427.00;1
3429;27;626325090;3429;260;4127;4127;8.03;0.49;237.16;3.57;698;27;1428.00;0
3430;27;626325100;3430;262;4127;4127;8.07;0.49;237.16;3.57;697;27;1429.00;0
3430;27;626325110;3430;261;4128;4128;8.04;0.49;237.16;3.57;698;27;1430.00;0
3431;27;626325120;3431;261;4129;4129;8.06;0.49;237.13;3.57;698;27;1431.00;0
3431;27;626325129;3431;266;4129;4129;7.98;0.49;237.13;3.57;698;27;1432.00;0
3434;27;626325147;3434;270;4130;4130;7.86;0.48;237.12;3.57;696;27;1433.00;0
3434;27;626325157;3434;270;4130;4130;7.83;0.48;237.12;3.57;696;27;1434.00;0
3434;27;626325166;3434;266;4130;4130;7.87;0.48;237.12;3.57;696;27;1435.00;0
3434;27;626325176;3434;256;4130;4130;7.97;0.49;237.12;3.57;696;27;1436.00;0
3439;27;626325185;3439;251;4130;4130;8.04;0.49;237.03;3.57;691;27;1437.00;0
3442;27;626325195;3442;243;4130;4130;8.15;0.50;237.01;3.57;688;27;1438.00;0
3446;27;626325204;3446;242;4130;4130;8.27;0.50;236.94;3.57;684;27;1439.00;0
3446;28;626325215;3446;282;4242;4360;8.26;0.52;236.94;3.47;796;28;1440.00;118
3451;28;626325258;3451;270;4252;4361;8.24;0.51;236.86;3.47;801;28;1441.00;109
3452;28;626325269;3452;249;4262;4361;8.36;0.52;236.85;3.47;810;28;1442.00;99
3454;28;626325279;3454;248;4267;4361;8.45;0.53;236.82;3.46;813;28;1443.00;94
3455;28;626325289;3455;241;4273;4361;8.55;0.53;236.80;3.47;818;28;1444.00;88
3456;28;626325308;3456;243;4278;4361;8.66;0.54;236.77;3.47;822;28;1445.00;83
3456;28;626325319;3456;238;4284;4361;8.72;0.54;236.77;3.47;828;28;1446.00;77
3458;29;626325337;3458;247;4289;4361;8.73;0.54;236.69;3.47;831;29;1447.00;72
3459;29;626325366;3459;248;4293;4362;8.78;0.54;236.67;3.48;834;29;1448.00;69
3461;29;626325377;3461;256;4298;4363;8.80;0.54;236.67;3.49;837;29;1449.00;65
3463;29;626325396;3463;251;4301;4363;8.79;0.54;236.62;3.49;838;29;1450.00;62
3464;29;626325413;3464;248;4304;4364;8.76;0.54;236.62;3.50;840;29;1451.00;60
3466;29;626325425;3466;242;4308;4364;8.74;0.54;236.62;3.50;842;29;1452.00;56
3466;29;626325436;3466;245;4312;4364;8.75;0.54;236.62;3.51;846;29;1453.00;52
3468;29;626325447;3468;241;4315;4364;8.76;0.54;236.59;3.52;847;29;1454.00;49
3471;29;626325458;3471;247;4320;4368;8.75;0.54;236.58;3.52;849;29;1455.00;48
3475;29;626325471;3475;240;4321;4368;8.67;0.53;236.69;3.53;846;29;1456.00;47
3478;29;626325483;3478;246;4321;4368;8.70;0.53;236.69;3.53;843;29;1457.00;47
3479;29;626325494;3479;246;4325;4371;8.80;0.54;236.65;3.54;846;29;1458.00;46
3480;29;626325505;3480;248;4326;4371;8.86;0.54;236.67;3.54;846;29;1459.00;45
3482;29;626325516;3482;243;4326;4371;8.88;0.54;236.81;3.54;844;29;1460.00;45
3484;29;626325527;3484;236;4329;4375;8.90;0.54;236.84;3.54;845;29;1461.00;46
3486;29;626325538;3486;229;4332;4376;8.95;0.55;236.86;3.55;846;29;1462.00;44
3491;29;626325549;3491;221;4333;4376;8.93;0.55;236.65;3.55;842;29;1463.00;43
3494;29;626325560;3494;215;4335;4380;9.00;0.55;236.80;3.55;841;29;1464.00;45
3496;29;626325572;3496;211;4338;4380;9.03;0.55;236.80;3.56;842;29;1465.00;42
3498;29;626325584;3498;209;4338;4380;9.12;0.56;236.98;3.56;840;29;1466.00;42
3503;29;626325596;3503;201;4340;4381;9.12;0.56;237.11;3.57;837;29;1467.00;41
3505;29;626325608;3505;195;4340;4381;9.13;0.56;237.07;3.57;835;29;1468.00;41
3508;29;626325620;3508;195;4345;4387;9.11;0.55;237.25;3.58;837;29;1469.00;42
3510;29;626325634;3510;194;4346;4387;9.11;0.55;237.41;3.58;836;29;1470.00;41
3513;29;626325648;3513;186;4347;4388;9.09;0.55;237.44;3.58;834;29;1471.00;41
3515;29;626325660;3515;180;4347;4388;9.18;0.56;237.55;3.58;832;29;1472.00;41
3518;29;626325672;3518;180;4349;4388;9.20;0.56;237.55;3.59;831;29;1473.00;39
3521;29;626325685;3521;176;4350;4388;9.26;0.56;237.65;3.59;829;29;1474.00;38
3522;29;626325697;3522;171;4352;4388;9.34;0.57;237.65;3.60;830;29;1475.00;36
3524;29;626325709;3524;169;4363;4400;9.41;0.57;237.80;3.60;839;29;1476.00;37
3528;29;626325722;3528;176;4363;4400;9.43;0.57;237.80;3.60;835;29;1477.00;37
3529;29;626325734;3529;183;4365;4400;9.58;0.58;237.88;3.61;836;29;1478.00;35
3531;29;626325745;3531;186;4367;4400;9.64;0.58;237.87;3.62;836;29;1479.00;33
3534;29;626325756;3534;185;4368;4400;9.70;0.59;238.04;3.63;834;29;1480.00;32
3536;29;626325768;3536;186;4369;4400;9.66;0.59;238.05;3.64;833;29;1481.00;31
3539;29;626325781;3539;183;4372;4404;9.61;0.58;238.16;3.63;833;29;1482.00;32
3542;29;626325794;3542;186;4374;4404;9.62;0.58;238.23;3.65;832;29;1483.00;30
3544;29;626325807;3544;187;4377;4408;9.65;0.59;238.22;3.65;833;29;1484.00;31
3546;29;626325820;3546;182;4380;4410;9.68;0.59;238.36;3.66;834;29;1485.00;30
3547;29;626325833;3547;187;4381;4410;9.73;0.59;238.33;3.66;834;29;1486.00;29
3550;29;626325854;3550;189;4381;4410;9.77;0.59;238.46;3.66;831;29;1487.00;29
3552;29;626325867;3552;193;4391;4423;9.73;0.59;238.52;3.66;839;29;1488.00;32
3555;29;626325881;3555;196;4391;4423;9.70;0.59;238.48;3.66;836;29;1489.00;32
3557;29;626325893;3557;198;4391;4423;9.66;0.59;238.57;3.66;834;29;1490.00;32
3558;29;626325905;3558;203;4394;4424;9.71;0.59;238.52;3.68;836;29;1491.00;30
3563;29;626325917;3563;204;4395;4425;9.71;0.59;238.59;3.69;832;29;1492.00;30
3566;29;626325950;3566;206;4398;4425;9.68;0.59;238.55;3.73;832;29;1493.00;27
3569;29;626325962;3569;209;4400;4428;9.68;0.59;238.60;3.72;831;29;1494.00;28
3572;29;626325974;3572;213;4403;4428;9.57;0.58;238.68;3.76;831;29;1495.00;25
3576;29;626325986;3576;216;4404;4428;9.48;0.58;238.76;3.76;828;29;1496.00;24
3581;29;626325997;3581;219;4405;4428;9.51;0.58;238.76;3.77;824;29;1497.00;23
3582;29;626326009;3582;222;4413;4434;9.54;0.58;238.83;3.82;831;29;1498.00;21
3586;29;626326021;3586;228;4414;4434;9.50;0.58;238.85;3.81;828;29;1499.00;20
3589;29;626326036;3589;236;4421;4453;9.40;0.57;238.92;3.86;832;29;1500.00;32
3591;30;626326056;3591;237;4424;4453;9.38;0.57;239.00;3.88;833;30;1501.00;29
3593;30;626326087;3593;245;4427;4457;9.36;0.57;239.04;3.88;834;30;1502.00;30
3596;30;626326099;3596;249;4431;4458;9.33;0.57;239.03;3.91;835;30;1503.00;27
3601;30;626326110;3601;253;4432;4458;9.31;0.57;239.30;3.91;831;30;1504.00;26
3602;30;626326120;3602;257;4435;4459;9.30;0.57;239.35;3.93;833;30;1505.00;24
3607;30;626326131;3607;263;4437;4459;9.24;0.56;239.45;3.94;830;30;1506.00;22
3612;30;626326142;3612;275;4440;4459;9.10;0.56;239.53;3.95;828;30;1507.00;19
3612;30;626326153;3612;270;4442;4459;9.08;0.55;239.53;3.96;830;30;1508.00;17
3615;30;626326163;3615;270;4442;4459;9.01;0.55;239.63;3.96;827;30;1509.00;17
3619;30;626326174;3619;271;4444;4459;8.97;0.55;239.68;3.96;825;30;1510.00;15
3619;30;626326184;3619;270;4445;4459;8.96;0.55;239.68;3.97;826;30;1511.00;14
3621;30;626326195;3621;271;4475;4529;8.95;0.55;239.72;3.94;854;30;1512.00;54
3624;30;626326211;3624;265;4477;4530;8.94;0.55;239.69;3.95;853;30;1513.00;53
3626;30;626326223;3626;263;4483;4530;9.02;0.55;239.68;3.94;857;30;1514.00;47
3628;30;626326234;3628;265;4489;4530;9.05;0.55;239.72;3.95;861;30;1515.00;41
3632;30;626326245;3632;271;4497;4530;9.09;0.55;239.77;3.95;865;30;1516.00;33
3633;30;626326256;3633;269;4499;4530;9.11;0.56;239.85;3.95;866;30;1517.00;31
3637;30;626326268;3637;275;4505;4530;9.13;0.56;239.86;3.96;868;30;1518.00;25
3640;30;626326279;3640;275;4508;4530;9.19;0.56;239.93;3.96;868;30;1519.00;22
3642;31;626326290;3642;275;4509;4531;9.24;0.56;239.90;3.96;867;31;1520.00;22
3643;31;626326318;3643;273;4512;4532;9.19;0.56;239.89;3.96;869;31;1521.00;20
3645;31;626326329;3645;273;4513;4532;9.10;0.55;239.84;3.96;868;31;1522.00;19
3652;31;626326341;3652;271;4517;4536;8.89;0.54;239.84;3.96;865;31;1523.00;19
3657;31;626326352;3657;274;4517;4536;8.80;0.54;239.81;3.96;860;31;1524.00;19
3661;31;626326363;3661;281;4517;4536;8.67;0.53;239.85;3.96;856;31;1525.00;19
3664;31;626326374;3664;288;4517;4536;8.60;0.53;239.91;3.96;853;31;1526.00;19
3668;31;626326385;3668;299;4521;4542;8.53;0.52;239.90;3.96;853;31;1527.00;21
3671;31;626326396;3671;298;4521;4542;8.46;0.52;240.00;3.96;850;31;1528.00;21
3677;31;626326407;3677;301;4523;4542;8.28;0.51;240.19;3.97;846;31;1529.00;19
3680;31;626326419;3680;294;4526;4548;8.19;0.50;240.30;3.97;846;31;1530.00;22
3684;31;626326430;3684;281;4526;4548;8.07;0.49;240.40;3.97;842;31;1531.00;22
3689;31;626326441;3689;279;4526;4548;7.97;0.49;240.55;3.97;837;31;1532.00;22
3694;31;626326452;3694;274;4527;4549;7.95;0.49;240.63;3.97;833;31;1533.00;22
3696;31;626326463;3696;272;4529;4550;7.96;0.49;240.58;3.97;833;31;1534.00;21
3702;31;626326474;3702;272;4529;4550;7.93;0.48;240.55;3.97;827;31;1535.00;21
3707;31;626326484;3707;274;4542;4563;7.86;0.48;240.56;3.98;835;31;1536.00;21
3709;31;626326496;3709;269;4543;4563;7.95;0.49;240.61;3.98;834;31;1537.00;20
3712;31;626326506;3712;262;4543;4563;8.03;0.49;240.66;3.98;831;31;1538.00;20
3717;31;626326517;3717;263;4546;4564;8.04;0.49;240.81;3.99;829;31;1539.00;18
3721;31;626326528;3721;258;4548;4564;8.03;0.49;240.89;4.00;827;31;1540.00;16
3725;31;626326550;3725;251;4551;4568;8.03;0.49;240.90;4.01;826;31;1541.00;17
3727;31;626326562;3727;241;4552;4568;8.02;0.49;240.91;4.01;825;31;1542.00;16
3733;31;626326572;3733;241;4556;4572;8.05;0.49;241.01;4.01;823;31;1543.00;16
3735;31;626326584;3735;241;4556;4572;8.10;0.50;241.06;4.01;821;31;1544.00;16
3738;31;626326595;3738;236;4556;4572;8.10;0.50;241.04;4.01;818;31;1545.00;16
3742;31;626326605;3742;246;4557;4572;8.03;0.49;241.08;4.02;815;31;1546.00;15
3748;31;626326615;3748;243;4557;4572;7.97;0.49;241.16;4.02;809;31;1547.00;15
3754;31;626326626;3754;247;4568;4584;7.97;0.49;241.19;4.01;814;31;1548.00;16
3757;31;626326638;3757;253;4570;4584;7.92;0.49;241.14;4.02;813;31;1549.00;14
3760;31;626326648;3760;262;4570;4584;7.78;0.48;241.27;4.02;810;31;1550.00;14
3764;31;626326658;3764;265;4571;4584;7.68;0.47;241.21;4.03;807;31;1551.00;13
3765;31;626326668;3765;275;4571;4584;7.65;0.47;241.21;4.03;806;31;1552.00;13
3768;31;626326678;3768;275;4571;4584;7.58;0.46;241.31;4.03;803;31;1553.00;13
3770;31;626326689;3770;281;4573;4585;7.48;0.46;241.31;4.04;803;31;1554.00;12
3775;31;626326698;3775;282;4575;4587;7.33;0.45;241.45;4.04;800;31;1555.00;12
3779;31;626326709;3779;288;4580;4593;7.31;0.45;241.50;4.05;801;31;1556.00;13
3782;31;626326720;3782;296;4581;4594;7.27;0.45;241.54;4.05;799;31;1557.00;13
3786;31;626326730;3786;306;4581;4594;7.18;0.44;241.50;4.05;795;31;1558.00;13
3791;32;626326741;3791;311;4582;4594;7.06;0.43;241.45;4.05;791;32;1559.00;12
3792;32;626326765;3792;322;4588;4599;7.04;0.43;241.44;4.06;796;32;1560.00;11
3797;32;626326775;3797;331;4589;4599;6.92;0.42;241.40;4.06;792;32;1561.00;10
3802;32;626326785;3802;332;4589;4599;6.81;0.42;241.36;4.06;787;32;1562.00;10
3807;32;626326800;3807;340;4590;4600;6.76;0.41;241.24;4.06;783;32;1563.00;10
3813;32;626326810;3813;342;4595;4604;6.65;0.41;241.15;4.07;782;32;1564.00;9
3815;33;626326827;3815;349;4596;4604;6.53;0.40;241.13;4.07;781;33;1565.00;8
3819;33;626326864;3819;353;4598;4607;6.52;0.40;240.94;4.07;779;33;1566.00;9
3819;33;626326881;3819;355;4599;4607;6.49;0.40;240.94;4.08;780;33;1567.00;8
3822;33;626326902;3822;360;4600;4607;6.45;0.40;240.86;4.08;778;33;1568.00;7
3823;33;626326915;3823;369;4601;4607;6.41;0.39;240.83;4.09;778;33;1569.00;6
3825;33;626326931;3825;379;4604;4611;6.42;0.39;240.84;4.09;779;33;1570.00;7
3827;33;626326943;3827;386;4604;4611;6.37;0.39;240.85;4.09;777;33;1571.00;7
3829;33;626326953;3829;394;4604;4611;6.34;0.39;240.76;4.09;775;33;1572.00;7
3834;33;626326962;3834;400;4604;4611;6.35;0.39;240.89;4.09;770;33;1573.00;7
3838;33;626326973;3838;407;4606;4612;6.35;0.39;240.81;4.09;768;33;1574.00;6
3842;33;626326983;3842;411;4608;4614;6.35;0.39;240.85;4.09;766;33;1575.00;6
3843;33;626326993;3843;415;4610;4614;6.30;0.39;240.82;4.10;767;33;1576.00;4
3846;33;626327003;3846;410;4611;4615;6.25;0.38;241.03;4.10;765;33;1577.00;4
3848;33;626327013;3848;404;4612;4615;6.20;0.38;240.97;4.10;764;33;1578.00;3
3851;33;626327024;3851;396;4613;4615;6.22;0.38;241.00;4.10;762;33;1579.00;2
3853;33;626327034;3853;392;4614;4615;6.29;0.39;241.03;4.10;761;33;1580.00;1
3853;33;626327044;3853;388;4614;4615;6.35;0.39;241.03;4.10;761;33;1581.00;1
3854;33;626327054;3854;385;4614;4615;6.46;0.40;240.98;4.10;760;33;1582.00;1
3855;33;626327063;3855;383;4614;4615;6.53;0.40;240.98;4.10;759;33;1583.00;1
3859;33;626327073;3859;402;4686;4742;6.83;0.43;241.05;4.04;827;33;1584.00;56
3862;33;626327094;3862;393;4689;4743;6.88;0.43;240.97;4.04;827;33;1585.00;54
3866;33;626327104;3866;370;4697;4743;6.99;0.43;240.86;4.03;831;33;1586.00;46
3867;33;626327115;3867;340;4701;4743;7.12;0.44;240.83;4.03;834;33;1587.00;42
3868;33;626327125;3868;316;4704;4743;7.28;0.45;240.83;4.03;836;33;1588.00;39
3869;33;626327137;3869;304;4709;4743;7.45;0.46;240.81;4.03;840;33;1589.00;34
3873;33;626327150;3873;289;4711;4743;7.54;0.46;240.76;4.04;838;33;1590.00;32
3874;33;626327164;3874;279;4715;4743;7.72;0.47;240.75;4.04;841;33;1591.00;28
3874;33;626327176;3874;268;4717;4744;7.88;0.48;240.75;4.04;843;33;1592.00;27
3875;33;626327187;3875;261;4720;4745;7.97;0.49;240.73;4.04;845;33;1593.00;25
3875;33;626327205;3875;250;4722;4745;8.08;0.50;240.73;4.04;847;33;1594.00;23
3876;33;626327217;3876;241;4725;4746;8.17;0.50;240.74;4.05;849;33;1595.00;21
3876;33;626327230;3876;234;4727;4746;8.28;0.51;240.74;4.05;851;33;1596.00;19
3878;33;626327242;3878;238;4730;4746;8.42;0.52;240.72;4.07;852;33;1597.00;16
3879;33;626327255;3879;240;4732;4746;8.48;0.52;240.69;4.08;853;33;1598.00;14
3880;33;626327268;3880;233;4736;4750;8.53;0.52;240.66;4.08;856;33;1599.00;14
3883;33;626327288;3883;226;4737;4750;8.56;0.52;240.66;4.08;854;33;1600.00;13
3886;33;626327304;3886;228;4738;4750;8.62;0.53;240.64;4.08;852;33;1601.00;12
3887;33;626327316;3887;229;4741;4753;8.73;0.53;240.66;4.08;854;33;1602.00;12
3888;33;626327335;3888;231;4742;4753;8.82;0.54;240.64;4.09;854;33;1603.00;11
3889;33;626327348;3889;231;4743;4753;8.90;0.54;240.62;4.09;854;33;1604.00;10
3891;33;626327360;3891;228;4747;4757;8.96;0.55;240.62;4.09;856;33;1605.00;10
3893;34;626327372;3893;229;4749;4758;9.06;0.55;240.65;4.09;856;34;1606.00;9
3897;34;626327402;3897;231;4749;4758;9.14;0.56;240.59;4.09;852;34;1607.00;9
3900;34;626327415;3900;230;4752;4762;9.21;0.56;240.62;4.08;852;34;1608.00;10
3903;34;626327427;3903;230;4752;4762;9.21;0.56;240.74;4.08;849;34;1609.00;10
3905;34;626327440;3905;225;4752;4762;9.19;0.56;240.88;4.08;847;34;1610.00;10
3906;34;626327452;3906;225;4753;4763;9.14;0.55;240.88;4.08;847;34;1611.00;10
3913;34;626327464;3913;228;4753;4763;9.11;0.55;240.86;4.08;840;34;1612.00;10
3914;34;626327477;3914;232;4757;4769;9.12;0.55;240.95;4.08;843;34;1613.00;12
3915;34;626327489;3915;239;4757;4769;9.14;0.56;240.97;4.08;842;34;1614.00;12
3916;34;626327500;3916;234;4758;4770;9.18;0.56;241.02;4.08;842;34;1615.00;12
3918;34;626327511;3918;238;4758;4770;9.17;0.56;241.14;4.08;840;34;1616.00;12
3921;34;626327523;3921;233;4758;4770;9.16;0.56;241.26;4.08;837;34;1617.00;12
3924;34;626327533;3924;230;4758;4770;9.18;0.56;241.31;4.08;834;34;1618.00;12
3927;34;626327544;3927;230;4758;4770;9.16;0.56;241.45;4.08;831;34;1619.00;12
3930;34;626327558;3930;229;4779;4806;9.16;0.56;241.46;4.06;849;34;1620.00;27
3933;34;626327573;3933;213;4779;4806;9.14;0.56;241.51;4.06;846;34;1621.00;27
3936;34;626327584;3936;211;4782;4806;9.21;0.56;241.56;4.07;846;34;1622.00;24
3938;34;626327596;3938;209;4784;4806;9.30;0.57;241.65;4.07;846;34;1623.00;22
3944;34;626327607;3944;201;4784;4806;9.29;0.57;242.00;4.07;840;34;1624.00;22
3948;34;626327624;3948;197;4786;4806;9.33;0.57;242.05;4.07;838;34;1625.00;20
3951;34;626327636;3951;195;4789;4810;9.37;0.57;242.14;4.07;838;34;1626.00;21
3956;34;626327647;3956;190;4790;4810;9.43;0.57;242.32;4.07;834;34;1627.00;20
3961;34;626327659;3961;184;4793;4814;9.50;0.58;242.37;4.07;832;34;1628.00;21
3963;34;626327670;3963;176;4796;4815;9.58;0.58;242.41;4.07;833;34;1629.00;19
3965;34;626327681;3965;171;4797;4815;9.59;0.58;242.52;4.07;832;34;1630.00;18
3968;34;626327691;3968;161;4798;4815;9.53;0.58;242.62;4.07;830;34;1631.00;17
3969;34;626327702;3969;158;4807;4828;9.43;0.57;242.66;4.06;838;34;1632.00;21
3974;34;626327714;3974;149;4807;4828;9.31;0.57;242.83;4.06;833;34;1633.00;21
3977;34;626327725;3977;149;4808;4828;9.30;0.57;242.76;4.06;831;34;1634.00;20
3980;34;626327736;3980;146;4810;4829;9.29;0.57;242.82;4.07;830;34;1635.00;19
3983;34;626327746;3983;146;4810;4830;9.36;0.57;242.80;4.07;827;34;1636.00;20
3985;34;626327757;3985;145;4810;4830;9.46;0.58;242.82;4.07;825;34;1637.00;20
3989;34;626327768;3989;139;4813;4833;9.55;0.58;242.88;4.08;824;34;1638.00;20
3995;34;626327779;3995;139;4813;4833;9.65;0.59;242.94;4.08;818;34;1639.00;20
3997;34;626327791;3997;141;4814;4833;9.75;0.59;242.91;4.08;817;34;1640.00;19
4000;34;626327801;4000;143;4814;4833;9.76;0.60;242.97;4.08;814;34;1641.00;19
4006;34;626327819;4006;139;4818;4839;9.79;0.60;242.95;4.07;812;34;1642.00;21
4008;34;626327832;4008;135;4818;4839;9.83;0.60;243.06;4.07;810;34;1643.00;21
4011;34;626327842;4011;131;4820;4839;9.85;0.60;243.13;4.08;809;34;1644.00;19
4015;34;626327853;4015;129;4820;4839;9.81;0.60;243.22;4.08;805;34;1645.00;19
4017;34;626327865;4017;129;4823;4843;9.78;0.60;243.24;4.08;806;34;1646.00;20
4020;34;626327876;4020;133;4826;4844;9.78;0.60;243.28;4.08;806;34;1647.00;18
4024;34;626327887;4024;132;4826;4844;9.76;0.59;243.35;4.08;802;34;1648.00;18
4025;34;626327897;4025;135;4827;4845;9.80;0.60;243.42;4.08;802;34;1649.00;18
4028;34;626327910;4028;132;4827;4845;9.86;0.60;243.52;4.08;799;34;1650.00;18
4031;34;626327921;4031;130;4827;4845;9.95;0.61;243.59;4.08;796;34;1651.00;18
4034;34;626327932;4034;130;4827;4845;10.01;0.61;243.66;4.08;793;34;1652.00;18
4038;34;626327943;4038;131;4827;4845;10.11;0.62;243.72;4.08;789;34;1653.00;18
4042;34;626327955;4042;135;4827;4845;10.13;0.62;243.70;4.08;785;34;1654.00;18
4043;34;626327966;4043;136;4827;4845;10.15;0.62;243.76;4.08;784;34;1655.00;18
4046;34;626327977;4046;149;4862;4915;10.14;0.62;243.82;4.05;816;34;1656.00;53
4050;34;626327994;4050;145;4862;4916;10.11;0.62;243.94;4.05;812;34;1657.00;54
4053;34;626328006;4053;147;4870;4916;10.21;0.62;243.95;4.06;817;34;1658.00;46
4055;34;626328018;4055;157;4877;4916;10.26;0.63;243.95;4.06;822;34;1659.00;39
4057;34;626328029;4057;156;4886;4916;10.22;0.62;244.01;4.09;829;34;1660.00;30
4061;34;626328040;4061;160;4890;4916;10.25;0.63;244.08;4.09;829;34;1661.00;26
4066;34;626328052;4066;155;4895;4916;10.29;0.63;244.23;4.11;829;34;1662.00;21
4068;34;626328069;4068;155;4896;4916;10.29;0.63;244.31;4.12;828;34;1663.00;20
4074;34;626328080;4074;156;4899;4917;10.34;0.63;244.24;4.13;825;34;1664.00;18
4077;34;626328098;4077;159;4901;4919;10.34;0.63;244.23;4.13;824;34;1665.00;18
4078;34;626328110;4078;164;4903;4919;10.32;0.63;244.23;4.14;825;34;1666.00;16
4080;34;626328126;4080;167;4906;4923;10.23;0.62;244.19;4.15;826;34;1667.00;17
4082;34;626328138;4082;169;4907;4923;10.10;0.62;244.17;4.16;825;34;1668.00;16
4084;34;626328159;4084;173;4908;4923;10.03;0.61;244.22;4.17;824;34;1669.00;15
4086;34;626328171;4086;179;4909;4923;9.97;0.61;244.21;4.18;823;34;1670.00;14
4090;34;626328182;4090;183;4915;4929;9.95;0.61;244.22;4.19;825;34;1671.00;14
4092;34;626328194;4092;185;4916;4929;9.93;0.61;244.27;4.19;824;34;1672.00;13
4093;34;626328207;4093;187;4918;4929;9.94;0.61;244.29;4.20;825;34;1673.00;11
4098;34;626328218;4098;189;4921;4932;9.84;0.61;244.35;4.20;823;34;1674.00;11
4104;34;626328229;4104;192;4922;4932;9.73;0.60;244.38;4.20;818;34;1675.00;10
4105;34;626328240;4105;202;4923;4932;9.65;0.59;244.38;4.21;818;34;1676.00;9
4106;34;626328250;4106;212;4923;4933;9.54;0.59;244.48;4.21;817;34;1677.00;10
4108;34;626328261;4108;218;4926;4934;9.40;0.58;244.45;4.23;818;34;1678.00;8
4111;34;626328271;4111;217;4926;4934;9.30;0.57;244.38;4.23;815;34;1679.00;8
4118;34;626328283;4118;222;4946;4960;9.18;0.56;244.28;4.23;828;34;1680.00;14
4119;34;626328296;4119;217;4947;4960;9.14;0.56;244.25;4.23;828;34;1681.00;13
4123;34;626328306;4123;215;4950;4960;9.07;0.56;244.23;4.22;827;34;1682.00;10
4127;34;626328317;4127;218;4953;4961;9.03;0.55;244.16;4.23;826;34;1683.00;8
4133;34;626328328;4133;220;4953;4961;8.98;0.55;244.18;4.23;820;34;1684.00;8
4134;34;626328341;4134;225;4956;4965;9.01;0.55;244.14;4.23;822;34;1685.00;9
4136;34;626328352;4136;233;4959;4965;8.95;0.55;244.23;4.23;823;34;1686.00;6
4138;34;626328362;4138;237;4963;4969;8.87;0.54;244.30;4.23;825;34;1687.00;6
4141;34;626328372;4141;240;4965;4969;8.81;0.54;244.23;4.24;824;34;1688.00;4
4145;34;626328387;4145;250;4965;4969;8.71;0.53;244.31;4.24;820;34;1689.00;4
4147;34;626328397;4147;249;4965;4969;8.64;0.53;244.34;4.24;818;34;1690.00;4
4151;34;626328406;4151;252;4967;4969;8.50;0.52;244.33;4.24;816;34;1691.00;2
4155;34;626328416;4155;256;4977;4981;8.39;0.51;244.35;4.23;822;34;1692.00;4
4158;34;626328426;4158;263;4977;4981;8.31;0.51;244.28;4.23;819;34;1693.00;4
4162;34;626328436;4162;270;4980;4981;8.25;0.50;244.31;4.23;818;34;1694.00;1
4164;34;626328445;4164;273;4980;4981;8.21;0.50;244.43;4.23;816;34;1695.00;1
4170;34;626328454;4170;284;4980;4981;8.05;0.49;244.35;4.23;810;34;1696.00;1
4172;34;626328462;4172;285;4980;4981;7.89;0.48;244.42;4.23;808;34;1697.00;1
4176;34;626328474;4176;296;4980;4982;7.70;0.47;244.46;4.23;804;34;1698.00;2
4182;34;626328483;4182;304;4980;4982;7.49;0.46;244.50;4.23;798;34;1699.00;2
4186;34;626328497;4186;298;4986;4988;7.36;0.45;244.53;4.23;800;34;1700.00;2
4192;34;626328511;4192;300;4987;4989;7.12;0.43;244.84;4.23;795;34;1701.00;2
4195;34;626328520;4195;300;4988;4989;6.99;0.43;244.90;4.23;793;34;1702.00;1
4198;34;626328529;4198;304;4988;4989;6.84;0.42;244.89;4.23;790;34;1703.00;1
4202;34;626328537;4202;303;4992;4993;6.82;0.42;245.03;4.22;790;34;1704.00;1
4202;34;626328546;4202;303;4992;4993;6.84;0.42;245.03;4.22;790;34;1705.00;1
4205;34;626328554;4205;302;4992;4993;6.81;0.42;245.01;4.22;787;34;1706.00;1
4207;34;626328563;4207;301;4993;4994;6.84;0.42;245.07;4.22;786;34;1707.00;1
4211;34;626328572;4211;293;4997;4998;6.89;0.42;245.02;4.22;786;34;1708.00;1
4216;34;626328582;4216;290;4997;4998;6.98;0.43;245.01;4.22;781;34;1709.00;1
4217;34;626328592;4217;287;5000;5004;7.09;0.43;245.00;4.22;783;34;1710.00;4
4220;34;626328602;4220;288;5001;5004;7.18;0.44;245.04;4.22;781;34;1711.00;3
4220;34;626328611;4220;284;5001;5004;7.24;0.44;245.04;4.22;781;34;1712.00;3
4222;34;626328619;4222;283;5002;5004;7.28;0.45;245.05;4.22;780;34;1713.00;2
4227;34;626328628;4227;280;5005;5008;7.24;0.44;245.08;4.22;778;34;1714.00;3
4230;34;626328638;4230;285;5006;5008;7.22;0.44;245.07;4.21;776;34;1715.00;2
4234;34;626328648;4234;286;5006;5008;7.16;0.44;245.00;4.21;772;34;1716.00;2
4237;34;626328659;4237;282;5007;5008;7.04;0.43;245.01;4.21;770;34;1717.00;1
4243;34;626328668;4243;286;5008;5009;6.94;0.43;244.86;4.21;765;34;1718.00;1
4243;34;626328677;4243;284;5009;5010;7.00;0.43;244.86;4.21;766;34;1719.00;1
4251;34;626328686;4251;288;5009;5010;6.92;0.42;244.91;4.21;758;34;1720.00;1
4257;34;626328695;4257;290;5010;5011;6.88;0.42;244.84;4.21;753;34;1721.00;1
4259;34;626328705;4259;298;5010;5011;6.86;0.42;244.78;4.21;751;34;1722.00;1
4262;34;626328714;4262;302;5010;5011;6.80;0.42;244.77;4.21;748;34;1723.00;1
4263;34;626328723;4263;297;5010;5011;6.80;0.42;244.78;4.21;747;34;1724.00;1
4267;34;626328732;4267;305;5010;5011;6.79;0.42;244.70;4.21;743;34;1725.00;1
4268;34;626328741;4268;312;5010;5011;6.80;0.42;244.67;4.21;742;34;1726.00;1
4271;34;626328749;4271;316;5010;5011;6.81;0.42;244.66;4.21;739;34;1727.00;1
4274;34;626328758;4274;319;5076;5138;7.20;0.45;244.71;4.16;802;34;1728.00;62
4278;34;626328777;4278;318;5080;5139;7.20;0.45;244.66;4.16;802;34;1729.00;59
4280;34;626328786;4280;317;5092;5139;7.36;0.46;244.75;4.15;812;34;1730.00;47
4283;34;626328796;4283;320;5096;5139;7.33;0.45;244.79;4.15;813;34;1731.00;43
4287;34;626328805;4287;322;5102;5139;7.37;0.45;244.76;4.15;815;34;1732.00;37
4290;34;626328818;4290;324;5109;5139;7.37;0.45;244.73;4.15;819;34;1733.00;30
4297;34;626328832;4297;333;5115;5139;7.35;0.45;244.67;4.15;818;34;1734.00;24
4299;34;626328848;4299;342;5117;5139;7.36;0.45;244.77;4.15;818;34;1735.00;22
4300;34;626328866;4300;349;5120;5140;7.39;0.45;244.81;4.16;820;34;1736.00;20
4303;34;626328883;4303;357;5125;5141;7.41;0.46;244.77;4.16;822;34;1737.00;16
4304;34;626328899;4304;366;5127;5141;7.37;0.45;244.78;4.16;823;34;1738.00;14
4305;34;626328915;4305;354;5131;5142;7.32;0.45;244.77;4.17;826;34;1739.00;11
4308;34;626328934;4308;347;5132;5142;7.27;0.45;244.76;4.17;824;34;1740.00;10
4311;34;626328947;4311;347;5133;5142;7.26;0.45;244.73;4.17;822;34;1741.00;9
4314;34;626328958;4314;347;5135;5142;7.31;0.45;244.85;4.17;821;34;1742.00;7
4314;34;626328978;4314;343;5138;5146;7.36;0.45;244.85;4.17;824;34;1743.00;8
4317;34;626328998;4317;343;5140;5146;7.53;0.46;244.86;4.18;823;34;1744.00;6
4317;34;626329011;4317;345;5140;5146;7.68;0.47;244.86;4.18;823;34;1745.00;6
4319;34;626329031;4319;342;5143;5149;7.79;0.48;244.85;4.18;824;34;1746.00;6
4321;34;626329056;4321;330;5143;5149;7.82;0.48;244.88;4.18;822;34;1747.00;6
4324;34;626329069;4324;316;5144;5149;7.88;0.48;244.86;4.18;820;34;1748.00;5
4325;34;626329082;4325;306;5147;5153;7.98;0.49;244.86;4.18;822;34;1749.00;6
4328;34;626329095;4328;294;5149;5154;8.06;0.49;244.77;4.18;821;34;1750.00;5
4334;34;626329107;4334;290;5149;5154;8.12;0.50;244.80;4.18;815;34;1751.00;5
4336;34;626329120;4336;283;5153;5158;8.26;0.50;244.79;4.17;817;34;1752.00;5
4339;35;626329132;4339;273;5153;5158;8.41;0.51;244.74;4.17;814;35;1753.00;5
4341;35;626329154;4341;273;5153;5158;8.49;0.52;244.75;4.17;812;35;1754.00;5
4344;35;626329171;4344;278;5155;5160;8.53;0.52;244.67;4.17;811;35;1755.00;5
4345;35;626329183;4345;263;5155;5160;8.59;0.52;244.69;4.17;810;35;1756.00;5
4347;35;626329197;4347;254;5159;5166;8.64;0.52;244.64;4.17;812;35;1757.00;7
4348;35;626329218;4348;242;5160;5166;8.74;0.53;244.63;4.17;812;35;1758.00;6
4349;35;626329230;4349;236;5160;5167;8.82;0.53;244.64;4.17;811;35;1759.00;7
4350;35;626329244;4350;238;5160;5167;8.88;0.54;244.64;4.17;810;35;1760.00;7
4352;35;626329257;4352;238;5160;5167;9.00;0.55;244.66;4.17;808;35;1761.00;7
4354;35;626329270;4354;237;5160;5167;9.08;0.55;244.64;4.17;806;35;1762.00;7
4357;35;626329281;4357;239;5160;5167;9.14;0.55;244.67;4.17;803;35;1763.00;7
4358;35;626329299;4358;238;5170;5179;9.27;0.56;244.66;4.16;812;35;1764.00;9
4364;35;626329320;4364;234;5171;5179;9.26;0.56;244.68;4.16;807;35;1765.00;8
4366;35;626329332;4366;234;5171;5179;9.30;0.56;244.71;4.16;805;35;1766.00;8
4368;35;626329345;4368;225;5171;5179;9.34;0.57;244.71;4.16;803;35;1767.00;8
4373;35;626329358;4373;231;5171;5179;9.38;0.57;244.78;4.16;798;35;1768.00;8
4375;35;626329371;4375;229;5171;5179;9.37;0.57;244.80;4.16;796;35;1769.00;8
4377;35;626329384;4377;223;5174;5183;9.38;0.57;244.82;4.16;797;35;1770.00;9
4383;35;626329397;4383;220;5174;5183;9.38;0.57;244.85;4.16;791;35;1771.00;9
4384;35;626329409;4384;217;5177;5187;9.43;0.57;244.86;4.16;793;35;1772.00;10
4387;35;626329421;4387;216;5178;5188;9.39;0.57;244.91;4.16;791;35;1773.00;10
4390;35;626329433;4390;219;5179;5188;9.47;0.58;244.98;4.16;789;35;1774.00;9
4391;35;626329445;4391;221;5180;5188;9.50;0.58;245.12;4.17;789;35;1775.00;8
4393;35;626329457;4393;221;5190;5201;9.52;0.58;245.20;4.17;797;35;1776.00;11
4395;35;626329470;4395;227;5190;5201;9.48;0.58;245.24;4.17;795;35;1777.00;11
4397;35;626329482;4397;225;5191;5201;9.48;0.58;245.25;4.17;794;35;1778.00;10
4400;35;626329493;4400;228;5192;5202;9.48;0.58;245.33;4.16;792;35;1779.00;10
4402;35;626329504;4402;228;5192;5203;9.50;0.58;245.42;4.16;790;35;1780.00;11
4406;35;626329516;4406;235;5192;5203;9.54;0.58;245.47;4.16;786;35;1781.00;11
4411;35;626329527;4411;231;5194;5206;9.51;0.58;245.50;4.16;783;35;1782.00;12
4413;35;626329539;4413;228;5194;5206;9.49;0.58;245.57;4.16;781;35;1783.00;12
4420;35;626329551;4420;231;5195;5206;9.45;0.57;245.74;4.16;775;35;1784.00;11
4421;35;626329568;4421;231;5195;5206;9.43;0.57;245.76;4.16;774;35;1785.00;11
4424;35;626329579;4424;235;5199;5212;9.44;0.57;245.82;4.16;775;35;1786.00;13
4429;35;626329591;4429;232;5199;5212;9.38;0.57;245.89;4.16;770;35;1787.00;13
4430;35;626329602;4430;230;5200;5212;9.36;0.57;245.92;4.16;770;35;1788.00;12
4433;35;626329613;4433;227;5200;5212;9.34;0.57;246.00;4.16;767;35;1789.00;12
4434;35;626329624;4434;224;5203;5216;9.37;0.57;246.00;4.16;769;35;1790.00;13
4436;35;626329635;4436;217;5204;5217;9.47;0.58;246.06;4.16;768;35;1791.00;13
4439;35;626329647;4439;210;5204;5217;9.54;0.58;246.01;4.16;765;35;1792.00;13
4441;35;626329658;4441;207;5206;5218;9.64;0.59;246.03;4.17;765;35;1793.00;12
4446;35;626329670;4446;197;5206;5218;9.70;0.59;246.11;4.17;760;35;1794.00;12
4446;35;626329681;4446;192;5206;5218;9.76;0.60;246.11;4.17;760;35;1795.00;12
4449;35;626329691;4449;183;5206;5218;9.81;0.60;246.16;4.17;757;35;1796.00;12
4454;35;626329702;4454;178;5206;5218;9.80;0.60;246.26;4.17;752;35;1797.00;12
4458;35;626329713;4458;180;5207;5218;9.88;0.60;246.42;4.18;749;35;1798.00;11
4460;35;626329724;4460;174;5207;5218;9.88;0.60;246.38;4.18;747;35;1799.00;11
4462;35;626329737;4462;186;5271;5356;9.67;0.59;246.40;4.13;809;35;1800.00;85
4466;35;626329766;4466;172;5271;5357;9.69;0.60;246.49;4.13;805;35;1801.00;86
4470;35;626329778;4470;159;5282;5357;9.71;0.60;246.54;4.13;812;35;1802.00;75
4472;35;626329789;4472;148;5286;5357;9.77;0.60;246.58;4.12;814;35;1803.00;71
4473;35;626329802;4473;149;5291;5357;9.78;0.60;246.61;4.12;818;35;1804.00;66
4474;35;626329816;4474;145;5298;5357;9.77;0.60;246.66;4.14;824;35;1805.00;59
4480;35;626329834;4480;145;5303;5357;9.72;0.60;246.80;4.15;823;35;1806.00;54
4483;35;626329853;4483;140;5306;5357;9.71;0.60;246.85;4.15;823;35;1807.00;51
4489;35;626329866;4489;141;5310;5358;9.77;0.60;246.94;4.15;821;35;1808.00;48
4496;35;626329877;4496;135;5311;5359;9.80;0.60;246.92;4.15;815;35;1809.00;48
4500;35;626329888;4500;134;5314;5359;9.87;0.60;246.86;4.15;814;35;1810.00;45
4505;35;626329900;4505;133;5318;5363;9.87;0.60;246.93;4.15;813;35;1811.00;45
4508;35;626329912;4508;127;5319;5363;9.90;0.60;246.93;4.15;811;35;1812.00;44
4510;35;626329923;4510;124;5321;5363;9.89;0.60;247.01;4.16;811;35;1813.00;42
4513;35;626329934;4513;122;5323;5363;9.87;0.60;247.07;4.17;810;35;1814.00;40
4516;36;626329946;4516;124;5325;5369;9.89;0.60;247.04;4.17;809;36;1815.00;44
4520;36;626329971;4520;128;5326;5369;9.91;0.60;247.06;4.17;806;36;1816.00;43
4523;36;626329982;4523;128;5328;5369;9.94;0.61;247.07;4.17;805;36;1817.00;41
4526;36;626330003;4526;130;5330;5372;10.06;0.61;247.07;4.17;804;36;1818.00;42
4530;36;626330015;4530;136;5333;5372;10.05;0.61;247.14;4.18;803;36;1819.00;39
4533;36;626330091;4533;130;5335;5372;10.04;0.61;247.13;4.18;802;36;1820.00;37
4537;36;626330103;4537;132;5335;5373;10.06;0.61;247.15;4.18;798;36;1821.00;38
4539;36;626330114;4539;136;5336;5374;10.13;0.62;247.25;4.18;797;36;1822.00;38
4542;36;626330125;4542;135;5337;5374;10.12;0.62;247.25;4.19;795;36;1823.00;37
4543;36;626330137;4543;132;5344;5387;10.16;0.62;247.24;4.18;801;36;1824.00;43
4547;36;626330149;4547;134;5347;5387;10.17;0.62;247.25;4.19;800;36;1825.00;40
4549;36;626330160;4549;140;5347;5387;10.26;0.62;247.27;4.19;798;36;1826.00;40
4554;36;626330172;4554;148;5349;5388;10.30;0.63;247.30;4.19;795;36;1827.00;39
4558;36;626330184;4558;151;5350;5388;10.32;0.63;247.36;4.20;792;36;1828.00;38
4558;36;626330196;4558;152;5352;5392;10.39;0.63;247.36;4.20;794;36;1829.00;40
4564;36;626330210;4564;158;5356;5392;10.29;0.63;247.37;4.22;792;36;1830.00;36
4566;36;626330221;4566;163;5360;5396;10.20;0.62;247.41;4.23;794;36;1831.00;36
4570;36;626330238;4570;170;5362;5396;10.15;0.62;247.45;4.24;792;36;1832.00;34
4571;36;626330250;4571;171;5364;5396;10.10;0.62;247.43;4.25;793;36;1833.00;32
4572;36;626330262;4572;180;5365;5396;10.07;0.61;247.48;4.26;793;36;1834.00;31
4574;36;626330273;4574;177;5367;5396;10.07;0.62;247.53;4.27;793;36;1835.00;29
4575;36;626330283;4575;178;5378;5408;10.15;0.62;247.48;4.26;803;36;1836.00;30
4579;36;626330295;4579;181;5380;5408;10.11;0.62;247.61;4.28;801;36;1837.00;28
4582;36;626330306;4582;180;5382;5408;10.08;0.62;247.67;4.28;800;36;1838.00;26
4584;36;626330317;4584;186;5383;5408;10.08;0.62;247.72;4.29;799;36;1839.00;25
4587;36;626330328;4587;184;5383;5408;10.03;0.62;247.79;4.29;796;36;1840.00;25
4592;36;626330339;4592;193;5386;5408;9.89;0.61;247.82;4.31;794;36;1841.00;22
4595;36;626330350;4595;197;5387;5409;9.77;0.60;247.84;4.32;792;36;1842.00;22
4599;36;626330367;4599;206;5388;5409;9.71;0.59;247.96;4.32;789;36;1843.00;21
4603;36;626330383;4603;209;5394;5415;9.67;0.59;248.06;4.33;791;36;1844.00;21
4604;36;626330395;4604;217;5397;5417;9.63;0.59;248.03;4.33;793;36;1845.00;20
4607;36;626330405;4607;224;5399;5417;9.50;0.58;248.02;4.34;792;36;1846.00;18
4609;36;626330416;4609;231;5399;5417;9.34;0.57;247.97;4.34;790;36;1847.00;18
4611;36;626330426;4611;236;5404;5421;9.17;0.56;247.92;4.35;793;36;1848.00;17
4613;36;626330447;4613;240;5404;5421;9.07;0.56;248.01;4.35;791;36;1849.00;17
4616;36;626330458;4616;241;5406;5421;9.02;0.55;248.06;4.37;790;36;1850.00;15
4619;36;626330468;4619;236;5407;5422;8.95;0.55;248.08;4.36;788;36;1851.00;15
4621;36;626330478;4621;241;5410;5426;8.91;0.54;248.05;4.36;789;36;1852.00;16
4627;36;626330488;4627;246;5410;5426;8.85;0.54;248.01;4.36;783;36;1853.00;16
4628;36;626330497;4628;244;5415;5429;8.82;0.54;247.99;4.38;787;36;1854.00;14
4629;36;626330507;4629;236;5415;5429;8.82;0.54;247.96;4.38;786;36;1855.00;14
4632;36;626330517;4632;230;5417;5429;8.82;0.54;247.94;4.38;785;36;1856.00;12
4634;36;626330526;4634;233;5419;5429;8.86;0.54;247.87;4.39;785;36;1857.00;10
4635;36;626330536;4635;231;5423;5433;8.89;0.54;247.83;4.39;788;36;1858.00;10
4637;36;626330546;4637;234;5424;5433;8.80;0.54;247.81;4.39;787;36;1859.00;9
4639;36;626330557;4639;236;5425;5433;8.77;0.54;247.81;4.39;786;36;1860.00;8
4639;36;626330567;4639;236;5426;5433;8.66;0.53;247.81;4.39;787;36;1861.00;7
4645;36;626330581;4645;239;5427;5434;8.48;0.52;247.80;4.39;782;36;1862.00;7
4647;36;626330591;4647;245;5428;5435;8.34;0.51;247.77;4.39;781;36;1863.00;7
4652;36;626330600;4652;246;5428;5435;8.18;0.50;247.78;4.39;776;36;1864.00;7
4655;36;626330610;4655;251;5429;5436;8.02;0.49;247.78;4.39;774;36;1865.00;7
4659;36;626330619;4659;261;5429;5436;7.89;0.48;247.74;4.39;770;36;1866.00;7
4661;36;626330627;4661;268;5429;5436;7.71;0.47;247.68;4.39;768;36;1867.00;7
4664;36;626330635;4664;275;5429;5436;7.52;0.46;247.63;4.39;765;36;1868.00;7
4667;36;626330644;4667;284;5429;5436;7.32;0.45;247.53;4.39;762;36;1869.00;7
4670;36;626330652;4670;283;5429;5436;7.11;0.44;247.64;4.39;759;36;1870.00;7
4673;36;626330660;4673;280;5429;5436;7.00;0.43;247.62;4.39;756;36;1871.00;7
4679;36;626330668;4679;307;5499;5563;7.15;0.45;247.77;4.34;820;36;1872.00;64
4682;36;626330691;4682;300;5504;5564;7.07;0.44;247.75;4.33;822;36;1873.00;60
4685;36;626330700;4685;294;5511;5564;7.11;0.44;247.78;4.33;826;36;1874.00;53
4686;36;626330709;4686;302;5515;5564;7.07;0.44;247.83;4.33;829;36;1875.00;49
4689;36;626330718;4689;312;5520;5564;7.10;0.44;247.87;4.33;831;36;1876.00;44
4690;36;626330726;4690;305;5527;5564;7.12;0.44;247.90;4.33;837;36;1877.00;37
4692;36;626330735;4692;302;5532;5564;7.10;0.44;247.90;4.33;840;36;1878.00;32
4694;36;626330744;4694;303;5536;5564;7.08;0.44;247.90;4.33;842;36;1879.00;28
4697;36;626330753;4697;306;5541;5565;7.08;0.44;247.97;4.34;844;36;1880.00;24
4700;36;626330763;4700;309;5545;5566;7.07;0.44;247.92;4.34;845;36;1881.00;21
4701;36;626330773;4701;311;5547;5568;7.05;0.44;247.96;4.34;846;36;1882.00;21
4705;36;626330782;4705;317;5549;5569;6.99;0.43;247.96;4.34;844;36;1883.00;20
4708;36;626330792;4708;317;5551;5569;7.01;0.43;247.92;4.34;843;36;1884.00;18
4710;36;626330802;4710;321;5552;5569;6.97;0.43;247.92;4.34;842;36;1885.00;17
4716;36;626330812;4716;320;5554;5569;6.88;0.42;247.87;4.35;838;36;1886.00;15
4716;36;626330826;4716;324;5557;5573;6.89;0.42;247.87;4.35;841;36;1887.00;16
4718;36;626330841;4718;326;5559;5573;6.88;0.42;247.84;4.35;841;36;1888.00;14
4718;36;626330856;4718;326;5560;5573;6.88;0.42;247.84;4.35;842;36;1889.00;13
4722;36;626330874;4722;328;5563;5579;6.82;0.42;247.76;4.35;841;36;1890.00;16
4723;36;626330891;4723;311;5564;5579;6.83;0.42;247.74;4.35;841;36;1891.00;15
4726;36;626330906;4726;305;5564;5579;6.82;0.42;247.73;4.35;838;36;1892.00;15
4729;36;626330921;4729;305;5570;5583;6.85;0.42;247.68;4.35;841;36;1893.00;13
4732;36;626330936;4732;305;5571;5584;6.93;0.43;247.71;4.35;839;36;1894.00;13
4734;36;626330949;4734;303;5573;5584;6.98;0.43;247.82;4.35;839;36;1895.00;11
4740;36;626330961;4740;306;5577;5588;6.98;0.43;247.85;4.35;837;36;1896.00;11
4742;36;626330974;4742;304;5578;5588;7.01;0.43;247.94;4.35;836;36;1897.00;10
4747;36;626330992;4747;306;5579;5588;7.01;0.43;247.98;4.35;832;36;1898.00;9
4747;36;626331004;4747;308;5580;5589;7.12;0.44;247.98;4.35;833;36;1899.00;9
4752;36;626331016;4752;308;5580;5589;7.20;0.44;248.00;4.35;828;36;1900.00;9
4757;36;626331032;4757;309;5584;5595;7.26;0.44;247.93;4.35;827;36;1901.00;11
4760;36;626331044;4760;310;5586;5595;7.29;0.45;247.94;4.36;826;36;1902.00;9
4764;36;626331056;4764;314;5587;5596;7.30;0.45;247.89;4.36;823;36;1903.00;9
4768;36;626331067;4768;318;5587;5596;7.34;0.45;247.88;4.36;819;36;1904.00;9
4769;36;626331082;4769;314;5587;5596;7.46;0.46;247.84;4.36;818;36;1905.00;9
4772;36;626331096;4772;314;5587;5596;7.49;0.46;247.80;4.36;815;36;1906.00;9
4776;36;626331117;4776;317;5587;5596;7.49;0.46;247.78;4.36;811;36;1907.00;9
4777;36;626331128;4777;318;5597;5608;7.63;0.47;247.83;4.36;820;36;1908.00;11
4779;36;626331141;4779;312;5597;5608;7.61;0.46;247.81;4.36;818;36;1909.00;11
4781;36;626331153;4781;312;5598;5608;7.66;0.47;247.81;4.36;817;36;1910.00;10
4783;36;626331165;4783;313;5598;5608;7.61;0.46;247.81;4.36;815;36;1911.00;10
4785;36;626331176;4785;318;5598;5608;7.55;0.46;247.81;4.36;813;36;1912.00;10
4788;36;626331187;4788;319;5598;5608;7.45;0.45;247.81;4.36;810;36;1913.00;10
4790;36;626331199;4790;324;5601;5612;7.42;0.45;247.84;4.35;811;36;1914.00;11
4796;36;626331211;4796;334;5601;5612;7.38;0.45;247.85;4.35;805;36;1915.00;11
4800;36;626331224;4800;342;5604;5616;7.32;0.45;247.96;4.35;804;36;1916.00;12
4803;36;626331236;4803;336;5605;5617;7.29;0.44;247.94;4.35;802;36;1917.00;12
4805;36;626331248;4805;328;5607;5617;7.33;0.45;248.09;4.37;802;36;1918.00;10
4806;36;626331260;4806;325;5607;5617;7.34;0.45;248.08;4.37;801;36;1919.00;10
4809;36;626331273;4809;327;5628;5646;7.48;0.46;248.24;4.35;819;36;1920.00;18
4812;36;626331287;4812;319;5629;5646;7.47;0.45;248.22;4.35;817;36;1921.00;17
4814;36;626331299;4814;317;5630;5646;7.49;0.45;248.23;4.35;816;36;1922.00;16
4815;36;626331312;4815;312;5631;5647;7.53;0.46;248.20;4.35;816;36;1923.00;16
4817;36;626331326;4817;317;5632;5648;7.55;0.46;248.24;4.35;815;36;1924.00;16
4820;36;626331354;4820;317;5633;5648;7.60;0.46;248.19;4.35;813;36;1925.00;15
4823;36;626331368;4823;302;5636;5651;7.65;0.47;248.22;4.35;813;37;1926.00;15
4825;36;626331399;4825;285;5636;5651;7.72;0.47;248.24;4.35;811;37;1927.00;15
4827;36;626331416;4827;268;5636;5651;7.77;0.47;248.23;4.35;809;37;1928.00;15
4828;36;626331433;4828;266;5636;5651;7.81;0.48;248.24;4.35;808;37;1929.00;15
4831;36;626331461;4831;266;5640;5657;7.82;0.48;248.25;4.35;809;37;1930.00;17
4834;36;626331482;4834;264;5641;5657;7.85;0.48;248.37;4.35;807;37;1931.00;16
4834;36;626331495;4834;264;5641;5657;7.88;0.48;248.37;4.35;807;37;1932.00;16
4835;36;626331507;4835;262;5641;5657;7.97;0.49;248.37;4.35;806;37;1933.00;16
4840;36;626331518;4840;262;5644;5661;8.00;0.49;248.31;4.35;804;37;1934.00;17
4841;36;626331531;4841;263;5646;5663;8.02;0.49;248.29;4.34;805;37;1935.00;17
4847;36;626331543;4847;265;5646;5663;7.98;0.48;248.32;4.34;799;37;1936.00;17
4850;36;626331555;4850;261;5647;5664;8.03;0.49;248.31;4.34;797;37;1937.00;17
4853;36;626331567;4853;255;5648;5664;8.06;0.49;248.39;4.37;795;37;1938.00;16
4857;37;626331579;4857;252;5648;5664;8.10;0.49;248.45;4.37;791;38;1939.00;16
4859;38;626331612;4859;245;5648;5664;8.20;0.50;248.49;4.37;789;39;1940.00;16
4861;38;626331638;4861;242;5649;5664;8.24;0.50;248.49;4.39;788;39;1941.00;15
4864;38;626331650;4864;235;5649;5664;8.28;0.50;248.59;4.39;785;39;1942.00;15
4866;38;626331661;4866;230;5649;5664;8.33;0.51;248.59;4.39;783;39;1943.00;15
4869;38;626331673;4869;247;5693;5734;8.18;0.50;248.61;4.36;824;39;1944.00;41
4871;38;626331696;4871;237;5693;5735;8.24;0.50;248.68;4.36;822;39;1945.00;42
4873;38;626331708;4873;232;5699;5735;8.43;0.51;248.66;4.36;826;39;1946.00;36
4876;38;626331726;4876;228;5700;5735;8.56;0.52;248.65;4.36;824;39;1947.00;35
4880;38;626331737;4880;231;5704;5735;8.64;0.53;248.69;4.35;824;39;1948.00;31
4884;38;626331749;4884;230;5705;5735;8.67;0.53;248.74;4.35;821;39;1949.00;30
4885;38;626331762;4885;238;5709;5737;8.76;0.53;248.76;4.36;824;39;1950.00;28
4886;39;626331775;4886;238;5710;5737;8.79;0.54;248.79;4.36;824;40;1951.00;27
4889;39;626331794;4889;239;5712;5738;8.82;0.54;248.78;4.36;823;40;1952.00;26
4891;40;626331805;4891;240;5715;5739;8.89;0.54;248.80;4.36;824;41;1953.00;24
4893;40;626331842;4893;237;5716;5739;8.95;0.54;248.81;4.36;823;41;1954.00;23
4898;40;626331857;4898;241;5721;5743;8.89;0.54;248.90;4.36;823;41;1955.00;22
4899;40;626331872;4899;243;5722;5743;8.91;0.54;248.86;4.36;823;41;1956.00;21
4900;40;626331895;4900;238;5722;5743;8.90;0.54;248.86;4.36;822;41;1957.00;21
4901;40;626331905;4901;240;5722;5743;8.85;0.54;248.85;4.36;821;41;1958.00;21
4903;40;626331918;4903;243;5727;5749;8.83;0.54;248.82;4.36;824;41;1959.00;22
4906;40;626331941;4906;247;5727;5749;8.83;0.54;248.77;4.36;821;41;1960.00;22
4907;40;626331954;4907;239;5727;5749;8.80;0.54;248.78;4.36;820;41;1961.00;22
4909;40;626331965;4909;239;5730;5752;8.86;0.54;248.78;4.35;821;41;1962.00;22
4912;40;626331978;4912;241;5730;5752;8.88;0.54;248.78;4.35;818;41;1963.00;22
4917;40;626331989;4917;237;5730;5752;8.90;0.54;248.87;4.35;813;41;1964.00;22
4917;40;626332000;4917;231;5730;5753;8.87;0.54;248.87;4.35;813;41;1965.00;23
4920;40;626332011;4920;230;5731;5754;8.96;0.54;248.91;4.35;811;41;1966.00;23
4921;40;626332022;4921;232;5731;5754;9.06;0.55;248.90;4.35;810;41;1967.00;23
4923;40;626332032;4923;230;5740;5767;9.13;0.56;248.89;4.35;817;41;1968.00;27
4925;40;626332044;4925;223;5740;5767;9.14;0.56;248.95;4.35;815;41;1969.00;27
4931;40;626332056;4931;214;5740;5767;9.15;0.55;248.88;4.35;809;41;1970.00;27
4937;40;626332067;4937;207;5741;5768;9.12;0.55;249.02;4.34;804;41;1971.00;27
4942;40;626332078;4942;196;5741;5768;9.07;0.55;249.25;4.34;799;41;1972.00;27
4943;40;626332089;4943;188;5744;5772;9.12;0.55;249.23;4.34;801;41;1973.00;28
4949;40;626332100;4949;184;5746;5772;9.12;0.55;249.35;4.36;797;41;1974.00;26
4953;40;626332112;4953;185;5750;5776;9.08;0.55;249.47;4.38;797;41;1975.00;26
4957;40;626332123;4957;174;5751;5776;9.10;0.55;249.52;4.39;794;41;1976.00;25
4962;40;626332134;4962;166;5751;5776;9.15;0.55;249.61;4.39;789;41;1977.00;25
4965;40;626332145;4965;161;5751;5776;9.19;0.56;249.67;4.39;786;41;1978.00;25
4969;40;626332156;4969;158;5751;5776;9.20;0.56;249.65;4.39;782;41;1979.00;25
4972;40;626332170;4972;157;5770;5810;9.17;0.56;249.66;4.38;798;41;1980.00;40
4973;40;626332202;4973;158;5771;5810;9.14;0.56;249.72;4.38;798;41;1981.00;39
4977;40;626332228;4977;156;5773;5810;9.16;0.56;249.78;4.38;796;41;1982.00;37
4978;40;626332253;4978;153;5773;5810;9.16;0.56;249.83;4.38;795;41;1983.00;37
4980;40;626332270;4980;154;5774;5810;9.21;0.56;249.83;4.38;794;41;1984.00;36
4983;40;626332282;4983;157;5774;5810;9.26;0.56;249.92;4.38;791;41;1985.00;36
4985;40;626332296;4985;159;5775;5811;9.34;0.57;249.93;4.38;790;41;1986.00;36
4988;40;626332308;4988;163;5776;5811;9.37;0.57;249.92;4.38;788;41;1987.00;35
4991;40;626332327;4991;160;5780;5817;9.45;0.57;250.00;4.39;789;41;1988.00;37
4993;40;626332340;4993;159;5781;5818;9.52;0.58;250.00;4.39;788;41;1989.00;37
4996;40;626332362;4996;156;5784;5818;9.47;0.58;250.02;4.39;788;41;1990.00;34
4997;40;626332377;4997;163;5784;5818;9.47;0.58;250.00;4.39;787;41;1991.00;34
4998;41;626332390;4998;166;5787;5822;9.42;0.57;250.00;4.40;789;42;1992.00;35
5002;41;626332418;5002;168;5788;5822;9.37;0.57;250.11;4.40;786;42;1993.00;34
5004;41;626332430;5004;176;5788;5822;9.31;0.57;250.14;4.40;784;42;1994.00;34
5007;41;626332443;5007;180;5790;5823;9.28;0.56;250.32;4.41;783;42;1995.00;33
5011;41;626332456;5011;184;5793;5827;9.23;0.56;250.30;4.40;782;42;1996.00;34
5014;41;626332473;5014;186;5795;5827;9.15;0.56;250.26;4.42;781;42;1997.00;32
5016;41;626332485;5016;191;5797;5830;9.20;0.56;250.30;4.42;781;42;1998.00;33
5016;41;626332498;5016;193;5798;5830;9.22;0.56;250.30;4.42;782;42;1999.00;32
5019;41;626332510;5019;196;5801;5830;9.16;0.56;250.36;4.44;782;42;2000.00;29
5024;41;626332526;5024;201;5801;5830;9.17;0.56;250.44;4.44;777;42;2001.00;29
5026;41;626332541;5026;203;5804;5834;9.24;0.56;250.50;4.44;778;42;2002.00;30
5027;41;626332556;5027;201;5808;5834;9.27;0.56;250.56;4.46;781;42;2003.00;26
5029;41;626332569;5029;205;5808;5834;9.30;0.57;250.57;4.46;779;42;2004.00;26
5032;41;626332582;5032;216;5810;5834;9.25;0.56;250.59;4.47;778;42;2005.00;24
5032;41;626332594;5032;215;5811;5835;9.23;0.56;250.59;4.48;779;42;2006.00;24
5033;41;626332609;5033;215;5812;5836;9.21;0.56;250.58;4.48;779;42;2007.00;24
5035;41;626332621;5035;218;5814;5836;9.19;0.56;250.59;4.49;779;42;2008.00;22
5038;41;626332632;5038;224;5817;5837;9.10;0.55;250.52;4.51;779;42;2009.00;20
5039;41;626332646;5039;227;5817;5837;9.07;0.55;250.55;4.51;778;42;2010.00;20
5041;41;626332658;5041;233;5818;5837;8.95;0.55;250.52;4.52;777;42;2011.00;19
5045;41;626332669;5045;233;5819;5837;8.85;0.54;250.53;4.53;774;42;2012.00;18
5046;41;626332681;5046;242;5819;5837;8.81;0.54;250.54;4.53;773;42;2013.00;18
5048;41;626332694;5048;244;5821;5837;8.74;0.53;250.54;4.54;773;42;2014.00;16
5051;41;626332707;5051;247;5821;5837;8.67;0.53;250.45;4.54;770;42;2015.00;16
5054;41;626332719;5054;265;5882;5964;8.62;0.53;250.34;4.49;828;42;2016.00;82
5057;41;626332742;5057;269;5884;5965;8.43;0.52;250.33;4.50;827;42;2017.00;81
5057;41;626332753;5057;271;5895;5965;8.47;0.52;250.33;4.49;838;42;2018.00;70
5059;41;626332766;5059;268;5902;5965;8.44;0.52;250.34;4.50;843;42;2019.00;63
5061;41;626332780;5061;267;5907;5965;8.35;0.52;250.28;4.50;846;42;2020.00;58
5063;41;626332792;5063;267;5916;5965;8.27;0.51;250.25;4.51;853;42;2021.00;49
5066;41;626332803;5066;270;5922;5965;8.25;0.51;250.21;4.51;856;42;2022.00;43
5067;41;626332815;5067;273;5926;5965;8.22;0.51;250.22;4.51;859;42;2023.00;39
5069;41;626332843;5069;266;5931;5966;8.25;0.51;250.13;4.53;862;42;2024.00;35
5072;41;626332865;5072;274;5936;5968;8.28;0.51;250.13;4.53;864;42;2025.00;32
5073;41;626332887;5073;276;5940;5968;8.22;0.51;250.10;4.53;867;42;2026.00;28
5075;41;626332909;5075;277;5943;5969;8.18;0.51;250.07;4.54;868;42;2027.00;26
5079;41;626332932;5079;281;5946;5969;8.08;0.50;250.03;4.54;867;42;2028.00;23
5080;41;626332954;5080;289;5947;5969;7.93;0.49;250.01;4.54;867;42;2029.00;22
5083;41;626332974;5083;300;5949;5969;7.83;0.48;249.94;4.54;866;42;2030.00;20
5084;41;626332987;5084;304;5952;5973;7.75;0.48;249.90;4.54;868;42;2031.00;21
5088;41;626333011;5088;312;5957;5973;7.60;0.47;249.97;4.55;869;42;2032.00;16
5091;41;626333024;5091;319;5957;5973;7.45;0.46;249.90;4.55;866;42;2033.00;16
5093;41;626333038;5093;329;5961;5976;7.34;0.45;249.95;4.56;868;42;2034.00;15
5096;41;626333051;5096;335;5962;5976;7.24;0.44;249.94;4.56;866;42;2035.00;14
5098;41;626333064;5098;343;5963;5976;7.11;0.44;249.88;4.56;865;42;2036.00;13
5102;41;626333078;5102;350;5967;5980;6.98;0.43;249.79;4.55;865;42;2037.00;13
5104;41;626333095;5104;357;5969;5981;6.90;0.42;249.75;4.55;865;42;2038.00;12
5106;41;626333107;5106;364;5969;5981;6.76;0.42;249.71;4.55;863;42;2039.00;12
5111;41;626333123;5111;357;5975;5986;6.68;0.41;249.67;4.55;864;42;2040.00;11
5115;41;626333138;5115;352;5975;5986;6.57;0.40;249.73;4.55;860;42;2041.00;11
5117;41;626333149;5117;353;5975;5986;6.47;0.40;249.69;4.55;858;42;2042.00;11
5120;41;626333162;5120;343;5976;5987;6.46;0.40;249.88;4.55;856;42;2043.00;11
5123;41;626333177;5123;332;5976;5987;6.47;0.40;249.84;4.55;853;42;2044.00;11
5126;41;626333202;5126;325;5981;5993;6.56;0.40;249.86;4.55;855;42;2045.00;12
5130;41;626333216;5130;324;5981;5993;6.58;0.40;249.94;4.55;851;42;2046.00;12
5131;41;626333231;5131;317;5983;5994;6.68;0.41;249.90;4.55;852;42;2047.00;11
5133;41;626333244;5133;308;5983;5994;6.74;0.41;249.95;4.55;850;42;2048.00;11
5137;41;626333260;5137;301;5983;5994;6.79;0.42;249.93;4.55;846;42;2049.00;11
5137;41;626333284;5137;287;5983;5994;6.88;0.42;249.93;4.55;846;42;2050.00;11
5140;41;626333299;5140;279;5983;5994;6.89;0.42;249.94;4.55;843;42;2051.00;11
5143;41;626333320;5143;272;5993;6006;7.04;0.43;249.93;4.54;850;42;2052.00;13
5145;41;626333336;5145;273;5993;6006;7.10;0.43;249.87;4.54;848;42;2053.00;13
5147;41;626333356;5147;272;5995;6006;7.21;0.44;249.90;4.54;848;42;2054.00;11
5149;41;626333372;5149;277;5995;6006;7.24;0.44;249.93;4.54;846;42;2055.00;11
5151;41;626333387;5151;275;5995;6006;7.30;0.45;249.87;4.54;844;42;2056.00;11
5153;41;626333403;5153;275;5995;6006;7.35;0.45;249.88;4.54;842;42;2057.00;11
5154;41;626333418;5154;269;5999;6010;7.39;0.45;249.87;4.53;845;42;2058.00;11
5156;41;626333433;5156;265;5999;6010;7.49;0.46;249.86;4.53;843;42;2059.00;11
5159;41;626333452;5159;265;6002;6014;7.65;0.47;249.88;4.53;843;42;2060.00;12
5162;41;626333469;5162;266;6003;6015;7.77;0.47;249.90;4.53;841;42;2061.00;12
5163;41;626333484;5163;262;6004;6015;7.84;0.48;249.93;4.53;841;42;2062.00;11
5167;41;626333500;5167;266;6004;6015;7.85;0.48;249.86;4.53;837;42;2063.00;11
5171;41;626333516;5171;269;6016;6028;7.88;0.48;249.93;4.52;845;42;2064.00;12
5176;41;626333532;5176;273;6016;6028;7.93;0.48;250.03;4.52;840;42;2065.00;12
5179;41;626333546;5179;266;6017;6028;7.95;0.48;250.03;4.52;838;42;2066.00;11
5185;41;626333561;5185;264;6018;6029;7.97;0.48;250.14;4.52;833;42;2067.00;11
5189;41;626333575;5189;266;6018;6030;7.96;0.48;250.22;4.52;829;42;2068.00;12
5196;41;626333590;5196;265;6019;6030;7.89;0.48;250.33;4.52;823;42;2069.00;11
5200;41;626333607;5200;268;6022;6036;7.95;0.48;250.44;4.52;822;42;2070.00;14
5205;41;626333621;5205;270;6022;6036;7.93;0.48;250.67;4.52;817;42;2071.00;14
5209;41;626333636;5209;275;6023;6036;7.95;0.48;250.66;4.52;814;42;2072.00;13
5215;41;626333650;5215;270;6024;6036;7.98;0.49;250.72;4.56;809;42;2073.00;12
5219;41;626333666;5219;271;6029;6042;8.03;0.49;250.84;4.56;810;42;2074.00;13
5223;41;626333681;5223;266;6029;6042;8.08;0.49;250.93;4.56;806;42;2075.00;13
5227;41;626333701;5227;269;6030;6042;8.13;0.49;250.92;4.56;803;42;2076.00;12
5231;41;626333716;5231;277;6030;6042;8.12;0.50;251.17;4.56;799;42;2077.00;12
5238;41;626333731;5238;278;6035;6046;8.11;0.50;251.26;4.56;797;42;2078.00;11
5242;41;626333748;5242;276;6036;6047;8.08;0.49;251.43;4.56;794;42;2079.00;11
5248;41;626333763;5248;273;6037;6047;7.99;0.49;251.49;4.56;789;42;2080.00;10
5251;41;626333778;5251;275;6038;6048;7.93;0.49;251.65;4.56;787;42;2081.00;10
5252;41;626333804;5252;280;6038;6048;7.88;0.48;251.68;4.56;786;42;2082.00;10
5258;41;626333820;5258;287;6038;6048;7.70;0.47;251.71;4.56;780;42;2083.00;10
5260;41;626333836;5260;295;6038;6048;7.59;0.47;251.76;4.56;778;42;2084.00;10
5262;41;626333850;5262;290;6038;6048;7.61;0.47;251.76;4.56;776;42;2085.00;10
5266;41;626333865;5266;294;6038;6048;7.61;0.47;251.85;4.56;772;42;2086.00;10
5270;41;626333878;5270;280;6038;6048;7.59;0.46;251.89;4.56;768;42;2087.00;10
5273;41;626333892;5273;295;6081;6118;7.69;0.47;251.96;4.53;808;42;2088.00;37
5275;41;626333915;5275;286;6082;6119;7.80;0.48;251.98;4.53;807;42;2089.00;37
5277;41;626333929;5277;281;6087;6119;7.91;0.48;252.01;4.52;810;42;2090.00;32
5279;41;626333948;5279;279;6089;6119;8.00;0.49;252.04;4.52;810;42;2091.00;30
5280;41;626333963;5280;272;6093;6119;8.10;0.50;252.06;4.52;813;42;2092.00;26
5287;41;626333982;5287;280;6098;6119;8.19;0.50;252.04;4.57;811;42;2093.00;21
5288;41;626333997;5288;283;6103;6119;8.34;0.51;252.04;4.57;815;42;2094.00;16
5291;41;626334010;5291;288;6105;6119;8.38;0.51;252.07;4.61;814;42;2095.00;14
5293;41;626334023;5293;270;6108;6120;8.47;0.51;252.08;4.61;815;42;2096.00;12
5296;41;626334037;5296;262;6109;6121;8.44;0.51;252.17;4.61;813;42;2097.00;12
5297;41;626334065;5297;257;6110;6121;8.44;0.51;252.15;4.61;813;42;2098.00;11
5299;41;626334083;5299;250;6113;6125;8.36;0.51;252.16;4.61;814;42;2099.00;12
5303;41;626334106;5303;248;6117;6140;8.33;0.51;252.17;4.60;814;42;2100.00;23
5304;41;626334139;5304;246;6117;6140;8.40;0.51;252.18;4.60;813;42;2101.00;23
5307;41;626334154;5307;247;6117;6140;8.50;0.52;252.21;4.60;810;42;2102.00;23
5309;41;626334167;5309;251;6120;6146;8.60;0.52;252.29;4.60;811;42;2103.00;26
5313;41;626334182;5313;247;6120;6146;8.68;0.53;252.36;4.60;807;42;2104.00;26
5314;41;626334196;5314;245;6120;6146;8.75;0.53;252.37;4.60;806;42;2105.00;26
5317;41;626334210;5317;246;6124;6149;8.81;0.54;252.39;4.60;807;42;2106.00;25
5320;41;626334225;5320;241;6124;6149;8.86;0.54;252.37;4.60;804;42;2107.00;25
5322;41;626334240;5322;237;6124;6149;8.94;0.55;252.38;4.60;802;42;2108.00;25
5326;41;626334255;5326;221;6124;6150;9.03;0.55;252.35;4.60;798;42;2109.00;26
5327;41;626334270;5327;215;6125;6151;9.11;0.56;252.32;4.60;798;42;2110.00;26
5334;41;626334285;5334;207;6125;6151;9.04;0.55;252.20;4.60;791;42;2111.00;26
5336;41;626334300;5336;206;6136;6164;9.00;0.55;252.20;4.60;800;42;2112.00;28
5338;41;626334317;5338;200;6136;6164;8.91;0.54;252.29;4.60;798;42;2113.00;28
5339;41;626334332;5339;199;6136;6164;8.91;0.54;252.29;4.60;797;42;2114.00;28
5340;41;626334348;5340;196;6138;6166;8.94;0.54;252.41;4.59;798;42;2115.00;28
5340;41;626334362;5340;194;6139;6166;8.98;0.55;252.41;4.63;799;42;2116.00;27
5343;41;626334375;5343;202;6141;6170;9.00;0.55;252.44;4.63;798;42;2117.00;29
5345;41;626334390;5345;204;6143;6170;9.11;0.55;252.41;4.64;798;42;2118.00;27
5347;41;626334402;5347;204;6146;6174;9.12;0.55;252.44;4.63;799;42;2119.00;28
5350;41;626334424;5350;199;6146;6174;9.14;0.55;252.44;4.63;796;42;2120.00;28
5351;41;626334439;5351;199;6146;6174;9.15;0.56;252.46;4.63;795;42;2121.00;28
5352;41;626334454;5352;201;6146;6174;9.21;0.56;252.46;4.63;794;42;2122.00;28
5354;41;626334467;5354;202;6146;6174;9.23;0.56;252.42;4.63;792;42;2123.00;28
5357;41;626334480;5357;204;6157;6186;9.24;0.56;252.46;4.63;800;42;2124.00;29
5358;42;626334503;5358;205;6157;6186;9.29;0.56;252.46;4.63;799;43;2125.00;29
5359;42;626334526;5359;200;6157;6186;9.35;0.57;252.46;4.63;798;43;2126.00;29
5362;42;626334543;5362;202;6159;6186;9.35;0.57;252.46;4.64;797;43;2127.00;27
5362;42;626334565;5362;200;6159;6186;9.42;0.57;252.46;4.64;797;43;2128.00;27
5365;42;626334581;5365;200;6159;6186;9.44;0.57;252.45;4.64;794;43;2129.00;27
5366;42;626334596;5366;199;6163;6187;9.45;0.58;252.43;4.65;797;43;2130.00;24
5367;42;626334609;5367;199;6163;6187;9.47;0.58;252.42;4.65;796;43;2131.00;24
5368;42;626334621;5368;196;6168;6193;9.44;0.58;252.45;4.68;800;43;2132.00;25
5372;42;626334635;5372;189;6170;6194;9.42;0.57;252.41;4.69;798;43;2133.00;24
5373;42;626334650;5373;188;6171;6194;9.40;0.57;252.42;4.69;798;43;2134.00;23
5377;42;626334667;5377;182;6172;6194;9.35;0.57;252.46;4.69;795;43;2135.00;22
5380;42;626334683;5380;178;6175;6198;9.32;0.57;252.43;4.69;795;43;2136.00;23
5382;42;626334695;5382;176;6176;6198;9.34;0.57;252.42;4.69;794;43;2137.00;22
5385;42;626334709;5385;174;6177;6198;9.35;0.57;252.40;4.69;792;43;2138.00;21
5385;42;626334720;5385;172;6178;6199;9.31;0.57;252.40;4.69;793;43;2139.00;21
5388;42;626334732;5388;171;6182;6203;9.26;0.56;252.40;4.72;794;43;2140.00;21
5394;42;626334747;5394;171;6182;6203;9.19;0.56;252.38;4.72;788;43;2141.00;21
5399;42;626334759;5399;163;6185;6206;9.13;0.55;252.32;4.72;786;43;2142.00;21
5404;42;626334771;5404;165;6186;6206;9.08;0.55;252.29;4.75;782;43;2143.00;20
5406;42;626334782;5406;165;6186;6206;9.06;0.55;252.33;4.75;780;43;2144.00;20
5410;42;626334795;5410;165;6188;6206;8.98;0.55;252.35;4.78;778;43;2145.00;18
5413;42;626334808;5413;166;6191;6210;8.99;0.55;252.28;4.78;778;43;2146.00;19
5416;42;626334822;5416;167;6191;6210;8.97;0.55;252.38;4.78;775;43;2147.00;19
5422;42;626334844;5422;164;6192;6210;8.93;0.54;252.46;4.78;770;43;2148.00;18
5424;42;626334862;5424;164;6193;6210;8.89;0.54;252.46;4.81;769;43;2149.00;17
5427;42;626334879;5427;165;6193;6211;8.82;0.54;252.43;4.81;766;43;2150.00;18
5428;42;626334904;5428;166;6194;6212;8.78;0.53;252.50;4.81;766;43;2151.00;18
5432;42;626334921;5432;172;6195;6212;8.72;0.53;252.45;4.83;763;43;2152.00;17
5433;42;626334940;5433;173;6196;6213;8.70;0.53;252.43;4.83;763;43;2153.00;17
5435;42;626334956;5435;178;6196;6213;8.79;0.53;252.37;4.83;761;43;2154.00;17
5437;42;626334970;5437;180;6197;6213;8.80;0.54;252.37;4.85;760;43;2155.00;16
5438;42;626334987;5438;183;6197;6213;8.82;0.54;252.35;4.85;759;43;2156.00;16
5443;42;626335000;5443;179;6197;6213;8.70;0.53;252.30;4.85;754;43;2157.00;16
5443;42;626335016;5443;186;6197;6213;8.72;0.53;252.30;4.85;754;43;2158.00;16
5444;42;626335029;5444;185;6198;6213;8.71;0.53;252.27;4.86;754;43;2159.00;15
5445;42;626335045;5445;225;6295;6443;8.77;0.55;252.25;4.79;850;43;2160.00;148
5448;42;626335088;5448;217;6296;6444;8.67;0.54;252.32;4.78;848;43;2161.00;148
5450;42;626335103;5450;214;6305;6444;8.69;0.54;252.33;4.78;855;43;2162.00;139
5453;42;626335117;5453;212;6314;6444;8.66;0.54;252.30;4.78;861;43;2163.00;130
5454;42;626335131;5454;215;6322;6444;8.69;0.54;252.28;4.78;868;43;2164.00;122
5456;42;626335147;5456;217;6328;6444;8.71;0.54;252.27;4.78;872;43;2165.00;116
5459;42;626335159;5459;220;6336;6444;8.74;0.54;252.28;4.78;877;43;2166.00;108
5462;42;626335173;5462;219;6341;6444;8.70;0.54;252.26;4.78;879;43;2167.00;103
5463;42;626335197;5463;222;6344;6445;8.73;0.54;252.39;4.78;881;43;2168.00;101
5468;43;626335213;5468;224;6349;6446;8.70;0.54;252.31;4.79;881;44;2169.00;97
5470;43;626335238;5470;225;6353;6446;8.73;0.54;252.26;4.80;883;44;2170.00;93
5472;43;626335268;5472;230;6358;6447;8.71;0.54;252.24;4.80;886;44;2171.00;89
5475;43;626335293;5475;232;6361;6447;8.66;0.53;252.18;4.81;886;44;2172.00;86
5478;43;626335310;5478;235;6369;6447;8.63;0.53;252.15;4.84;891;44;2173.00;78
5478;43;626335326;5478;243;6373;6447;8.58;0.53;252.15;4.84;895;44;2174.00;74
5480;43;626335341;5480;245;6380;6451;8.51;0.52;252.16;4.86;900;44;2175.00;71
5480;43;626335355;5480;254;6383;6451;8.39;0.52;252.16;4.87;903;44;2176.00;68
5482;43;626335372;5482;262;6386;6451;8.28;0.51;252.11;4.88;904;44;2177.00;65
5483;43;626335394;5483;264;6390;6454;8.15;0.50;252.09;4.89;907;44;2178.00;64
5486;43;626335408;5486;268;6391;6454;8.05;0.49;252.08;4.89;905;44;2179.00;63
5487;43;626335424;5487;271;6394;6454;7.99;0.49;252.05;4.90;907;44;2180.00;60
5487;43;626335438;5487;282;6402;6458;8.00;0.49;252.05;4.93;915;44;2181.00;56
5492;43;626335453;5492;288;6407;6459;7.92;0.49;251.93;4.95;915;44;2182.00;52
5494;43;626335469;5494;296;6408;6459;7.86;0.48;251.96;4.95;914;44;2183.00;51
5494;43;626335486;5494;310;6411;6463;7.83;0.48;251.96;4.96;917;44;2184.00;52
5498;43;626335501;5498;315;6417;6463;7.78;0.48;251.88;4.98;919;44;2185.00;46
5498;43;626335514;5498;323;6419;6463;7.71;0.47;251.88;4.99;921;44;2186.00;44
5503;43;626335528;5503;334;6424;6464;7.58;0.46;251.76;5.01;921;44;2187.00;40
5503;43;626335549;5503;342;6427;6464;7.47;0.46;251.76;5.02;924;44;2188.00;37
5503;45;626335564;5503;343;6432;6470;7.37;0.45;251.76;5.03;929;46;2189.00;38
5508;45;626335607;5508;347;6433;6470;7.26;0.44;251.80;5.03;925;46;2190.00;37
5511;46;626335622;5511;353;6439;6471;7.16;0.44;251.75;5.05;928;47;2191.00;32
5513;46;626335652;5513;359;6439;6471;7.11;0.43;251.74;5.05;926;47;2192.00;32
5514;46;626335667;5514;368;6443;6471;7.00;0.43;251.71;5.06;929;47;2193.00;28
5514;46;626335690;5514;369;6444;6471;6.92;0.42;251.71;5.06;930;47;2194.00;27
5515;46;626335705;5515;362;6445;6471;6.83;0.42;251.70;5.06;930;47;2195.00;26
5515;46;626335720;5515;355;6457;6483;6.81;0.42;251.70;5.06;942;47;2196.00;26
5517;46;626335743;5517;349;6459;6483;6.84;0.42;251.66;5.07;942;47;2197.00;24
5519;46;626335758;5519;345;6461;6483;6.91;0.42;251.66;5.07;942;47;2198.00;22
5520;46;626335774;5520;347;6462;6483;7.01;0.43;251.66;5.07;942;47;2199.00;21
5522;46;626335791;5522;350;6462;6483;7.05;0.43;251.64;5.07;940;47;2200.00;21
5527;46;626335813;5527;345;6462;6483;7.06;0.43;251.75;5.07;935;47;2201.00;21
5528;46;626335829;5528;348;6466;6487;7.11;0.43;251.70;5.08;938;47;2202.00;21
5528;47;626335849;5528;347;6466;6487;7.14;0.44;251.70;5.08;938;48;2203.00;21
5531;47;626335881;5531;342;6471;6491;7.18;0.44;251.74;5.08;940;48;2204.00;20
5533;47;626335893;5533;341;6473;6493;7.14;0.44;251.74;5.08;940;48;2205.00;20
5536;47;626335907;5536;348;6474;6493;7.04;0.43;251.81;5.08;938;48;2206.00;19
5539;47;626335927;5539;345;6475;6493;6.90;0.42;251.80;5.08;936;48;2207.00;18
5541;47;626335948;5541;353;6488;6506;6.77;0.41;251.83;5.07;947;48;2208.00;18
5545;47;626335962;5545;352;6488;6506;6.62;0.40;251.81;5.07;943;48;2209.00;18
5547;47;626335975;5547;343;6489;6508;6.56;0.40;251.81;5.07;942;48;2210.00;19
5549;47;626335988;5549;334;6491;6509;6.53;0.40;251.90;5.07;942;48;2211.00;18
5549;47;626336000;5549;328;6491;6510;6.54;0.40;251.90;5.07;942;48;2212.00;19
5553;47;626336014;5553;322;6491;6510;6.56;0.40;251.98;5.07;938;48;2213.00;19
5553;47;626336026;5553;328;6495;6513;6.69;0.41;251.98;5.07;942;48;2214.00;18
5555;47;626336039;5555;327;6495;6513;6.78;0.41;252.05;5.07;940;48;2215.00;18
5559;47;626336052;5559;317;6495;6513;6.87;0.42;252.18;5.07;936;48;2216.00;18
5562;47;626336065;5562;310;6495;6513;6.93;0.42;252.16;5.07;933;48;2217.00;18
5567;47;626336079;5567;296;6498;6519;7.02;0.43;252.28;5.07;931;48;2218.00;21
5570;47;626336094;5570;296;6499;6519;7.06;0.43;252.34;5.07;929;48;2219.00;20
5572;47;626336117;5572;286;6499;6519;7.15;0.44;252.36;5.07;927;48;2220.00;20
5577;47;626336134;5577;276;6501;6519;7.19;0.44;252.47;5.07;924;48;2221.00;18
5580;47;626336148;5580;273;6507;6523;7.28;0.45;252.56;5.07;927;48;2222.00;16
5582;47;626336160;5582;267;6508;6524;7.42;0.46;252.64;5.07;926;48;2223.00;16
5586;47;626336171;5586;266;6509;6524;7.54;0.46;252.75;5.07;923;48;2224.00;15
5591;47;626336183;5591;270;6510;6525;7.63;0.47;252.71;5.07;919;48;2225.00;15
5596;47;626336195;5596;270;6510;6525;7.67;0.47;252.73;5.07;914;48;2226.00;15
5603;47;626336208;5603;274;6510;6525;7.62;0.47;252.75;5.07;907;48;2227.00;15
5607;47;626336220;5607;272;6510;6525;7.65;0.47;252.81;5.07;903;48;2228.00;15
5614;47;626336231;5614;266;6510;6525;7.64;0.47;252.90;5.07;896;48;2229.00;15
5616;47;626336243;5616;264;6510;6525;7.64;0.47;252.84;5.07;894;48;2230.00;15
5621;47;626336255;5621;263;6510;6525;7.58;0.46;252.85;5.07;889;48;2231.00;15
5623;47;626336267;5623;264;6549;6595;7.81;0.48;252.81;5.04;926;48;2232.00;46
5627;47;626336284;5627;267;6553;6596;7.83;0.48;252.83;5.04;926;48;2233.00;43
5632;47;626336297;5632;270;6560;6596;7.90;0.48;252.91;5.04;928;48;2234.00;36
5637;47;626336310;5637;267;6564;6596;7.96;0.49;253.02;5.04;927;48;2235.00;32
5641;47;626336323;5641;269;6568;6596;8.02;0.49;253.05;5.04;927;48;2236.00;28
5647;47;626336336;5647;270;6572;6596;8.02;0.49;253.35;5.04;925;48;2237.00;24
5651;47;626336351;5651;273;6573;6596;7.99;0.49;253.41;5.04;922;48;2238.00;23
5653;47;626336366;5653;279;6574;6596;8.02;0.49;253.51;5.04;921;48;2239.00;22
5658;47;626336379;5658;277;6577;6597;8.03;0.49;253.52;5.05;919;48;2240.00;20
5664;47;626336393;5664;282;6578;6598;8.05;0.49;253.66;5.05;914;48;2241.00;20
5667;47;626336407;5667;282;6580;6598;8.10;0.49;253.59;5.06;913;48;2242.00;18
5672;47;626336420;5672;280;6583;6602;8.08;0.49;253.71;5.06;911;48;2243.00;19
5680;47;626336434;5680;277;6583;6602;8.05;0.49;253.80;5.06;903;48;2244.00;19
5684;47;626336447;5684;277;6583;6602;8.06;0.49;253.82;5.06;899;48;2245.00;19
5687;47;626336460;5687;275;6583;6602;8.12;0.49;253.91;5.06;896;48;2246.00;19
5690;47;626336473;5690;281;6587;6608;8.17;0.50;253.93;5.05;897;48;2247.00;21
5694;47;626336486;5694;285;6588;6608;8.20;0.50;254.02;5.05;894;48;2248.00;20
5698;47;626336498;5698;287;6588;6608;8.24;0.50;254.06;5.05;890;48;2249.00;20
5700;47;626336513;5700;298;6592;6614;8.30;0.51;254.14;5.05;892;48;2250.00;22
5709;47;626336526;5709;290;6592;6614;8.23;0.50;254.17;5.05;883;48;2251.00;22
5711;47;626336539;5711;294;6593;6614;8.21;0.50;254.12;5.05;882;48;2252.00;21
5718;47;626336552;5718;294;6593;6615;8.07;0.49;254.22;5.05;875;48;2253.00;22
5722;47;626336564;5722;294;6595;6616;8.03;0.49;254.32;5.05;873;48;2254.00;21
5725;47;626336578;5725;304;6595;6616;8.00;0.49;254.33;5.05;870;48;2255.00;21
5730;47;626336591;5730;312;6606;6629;8.08;0.49;254.44;5.04;876;48;2256.00;23
5735;47;626336605;5735;301;6606;6629;8.00;0.49;254.58;5.04;871;48;2257.00;23
5735;47;626336618;5735;296;6607;6629;8.00;0.49;254.58;5.06;872;48;2258.00;22
5740;47;626336631;5740;294;6608;6630;8.00;0.49;254.69;5.05;868;48;2259.00;22
5741;47;626336644;5741;286;6608;6630;8.00;0.49;254.72;5.05;867;48;2260.00;22
5743;47;626336656;5743;287;6611;6634;8.08;0.49;254.86;5.05;868;48;2261.00;23
5747;47;626336670;5747;288;6612;6634;8.14;0.50;254.96;5.05;865;48;2262.00;22
5751;47;626336682;5751;292;6615;6638;8.16;0.50;254.96;5.05;864;48;2263.00;23
5754;47;626336695;5754;293;6615;6638;8.20;0.50;254.99;5.05;861;48;2264.00;23
5758;47;626336714;5758;294;6615;6638;8.22;0.50;254.99;5.05;857;48;2265.00;23
5764;47;626336727;5764;283;6615;6638;8.26;0.50;255.09;5.05;851;48;2266.00;23
5765;47;626336739;5765;269;6615;6638;8.34;0.51;255.06;5.05;850;48;2267.00;23
5766;47;626336751;5766;261;6625;6650;8.47;0.52;255.06;5.04;859;48;2268.00;25
5767;47;626336765;5767;251;6625;6650;8.55;0.52;255.06;5.04;858;48;2269.00;25
5773;47;626336778;5773;254;6626;6650;8.65;0.53;254.99;5.04;853;48;2270.00;24
5776;47;626336790;5776;243;6626;6650;8.74;0.53;254.97;5.04;850;48;2271.00;24
5781;47;626336815;5781;244;6626;6650;8.80;0.54;254.94;5.04;845;48;2272.00;24
5786;47;626336833;5786;246;6626;6650;8.85;0.54;254.84;5.04;840;48;2273.00;24
5791;47;626336856;5791;241;6626;6651;8.83;0.54;254.90;5.04;835;48;2274.00;25
5794;47;626336888;5794;243;6626;6651;8.95;0.54;254.98;5.04;832;48;2275.00;25
5797;47;626336906;5797;243;6630;6657;8.95;0.54;255.04;5.04;833;48;2276.00;27
5801;47;626336924;5801;240;6632;6658;8.93;0.54;255.01;5.04;831;48;2277.00;26
5804;47;626336944;5804;234;6632;6658;8.98;0.54;255.05;5.04;828;48;2278.00;26
5807;47;626336958;5807;231;6632;6658;9.00;0.54;255.09;5.04;825;48;2279.00;26
5810;47;626336974;5810;224;6636;6663;8.99;0.54;255.13;5.04;826;48;2280.00;27
5813;47;626336987;5813;210;6636;6663;8.98;0.54;255.21;5.04;823;48;2281.00;27
5819;47;626336999;5819;207;6636;6663;9.03;0.55;255.39;5.04;817;48;2282.00;27
5823;47;626337012;5823;205;6637;6664;9.09;0.55;255.40;5.04;814;48;2283.00;27
5823;47;626337025;5823;198;6640;6668;9.15;0.55;255.40;5.03;817;48;2284.00;28
5824;47;626337037;5824;201;6640;6668;9.15;0.55;255.37;5.03;816;48;2285.00;28
5825;47;626337049;5825;195;6642;6671;9.16;0.56;255.38;5.03;817;48;2286.00;29
5827;47;626337063;5827;188;6642;6671;9.12;0.55;255.39;5.03;815;48;2287.00;29
5828;47;626337075;5828;187;6643;6671;9.06;0.55;255.38;5.03;815;48;2288.00;28
5829;47;626337088;5829;185;6643;6671;9.05;0.55;255.36;5.03;814;48;2289.00;28
5830;47;626337100;5830;181;6646;6675;9.02;0.55;255.35;5.03;816;48;2290.00;29
5832;47;626337111;5832;174;6647;6675;8.93;0.54;255.30;5.05;815;48;2291.00;28
5834;47;626337129;5834;171;6648;6675;8.91;0.54;255.38;5.05;814;48;2292.00;27
5836;47;626337141;5836;173;6648;6675;8.88;0.54;255.42;5.05;812;48;2293.00;27
5838;47;626337151;5838;178;6648;6676;8.83;0.54;255.46;5.05;810;48;2294.00;28
5839;47;626337169;5839;179;6650;6678;8.80;0.54;255.46;5.05;811;48;2295.00;28
5842;47;626337181;5842;184;6650;6678;8.79;0.54;255.46;5.05;808;48;2296.00;28
5843;47;626337192;5843;189;6651;6679;8.71;0.53;255.48;5.05;808;48;2297.00;28
5845;47;626337203;5845;201;6651;6679;8.66;0.53;255.50;5.05;806;48;2298.00;28
5847;47;626337214;5847;201;6651;6679;8.50;0.52;255.46;5.05;804;48;2299.00;28
5849;47;626337225;5849;197;6651;6679;8.40;0.51;255.47;5.05;802;48;2300.00;28
5850;47;626337240;5850;190;6651;6679;8.33;0.51;255.49;5.05;801;48;2301.00;28
5854;47;626337252;5854;188;6651;6679;8.27;0.50;255.47;5.05;797;48;2302.00;28
5854;47;626337262;5854;186;6651;6679;8.23;0.50;255.47;5.05;797;48;2303.00;28
5859;47;626337273;5859;213;6722;6806;8.13;0.50;255.49;4.99;863;48;2304.00;84
5860;47;626337295;5860;203;6722;6807;8.13;0.50;255.58;4.99;862;48;2305.00;85
5862;47;626337305;5862;194;6730;6807;8.23;0.51;255.62;5.01;868;48;2306.00;77
5865;47;626337316;5865;192;6732;6807;8.29;0.51;255.67;5.01;867;48;2307.00;75
5867;47;626337327;5867;195;6738;6807;8.35;0.51;255.68;5.01;871;48;2308.00;69
5871;47;626337338;5871;192;6741;6807;8.35;0.51;255.69;5.03;870;48;2309.00;66
5871;47;626337351;5871;196;6746;6807;8.39;0.52;255.69;5.03;875;48;2310.00;61
5874;47;626337364;5874;197;6747;6807;8.39;0.52;255.69;5.03;873;48;2311.00;60
5877;47;626337374;5877;193;6752;6808;8.40;0.52;255.63;5.06;875;48;2312.00;56
5880;47;626337385;5880;185;6755;6809;8.33;0.51;255.65;5.06;875;48;2313.00;54
5883;48;626337397;5883;190;6758;6809;8.29;0.51;255.57;5.06;875;49;2314.00;51
5885;48;626337419;5885;187;6762;6810;8.27;0.51;255.57;5.07;877;49;2315.00;48
5889;48;626337432;5889;188;6765;6810;8.23;0.50;255.54;5.09;876;49;2316.00;45
5890;48;626337443;5890;192;6769;6810;8.23;0.51;255.53;5.09;879;49;2317.00;41
5894;48;626337454;5894;188;6771;6810;8.21;0.50;255.49;5.09;877;49;2318.00;39
5897;48;626337465;5897;185;6776;6814;8.14;0.50;255.40;5.12;879;49;2319.00;38
5899;48;626337477;5899;192;6779;6814;8.09;0.50;255.36;5.13;880;49;2320.00;35
5901;48;626337489;5901;188;6780;6814;8.06;0.49;255.31;5.13;879;49;2321.00;34
5903;48;626337500;5903;197;6782;6817;8.02;0.49;255.30;5.13;879;49;2322.00;35
5907;48;626337512;5907;199;6783;6817;7.93;0.49;255.28;5.13;876;49;2323.00;34
5909;48;626337524;5909;206;6784;6817;7.87;0.48;255.30;5.13;875;49;2324.00;33
5911;48;626337542;5911;211;6788;6821;7.81;0.48;255.30;5.15;877;49;2325.00;33
5913;48;626337554;5913;213;6790;6822;7.77;0.47;255.26;5.15;877;49;2326.00;32
5917;48;626337565;5917;223;6790;6822;7.74;0.47;255.18;5.15;873;49;2327.00;32
5919;48;626337577;5919;224;6794;6826;7.70;0.47;255.13;5.17;875;49;2328.00;32
5921;48;626337589;5921;242;6794;6826;7.64;0.47;255.18;5.17;873;49;2329.00;32
5925;48;626337600;5925;248;6794;6826;7.59;0.46;255.09;5.17;869;49;2330.00;32
5925;48;626337612;5925;253;6795;6827;7.57;0.46;255.09;5.17;870;49;2331.00;32
5929;48;626337623;5929;258;6795;6827;7.44;0.45;255.01;5.17;866;49;2332.00;32
5930;48;626337635;5930;271;6799;6833;7.47;0.45;255.04;5.17;869;49;2333.00;34
5932;48;626337647;5932;282;6799;6833;7.40;0.45;255.10;5.17;867;49;2334.00;34
5933;48;626337657;5933;285;6800;6834;7.38;0.45;255.06;5.17;867;49;2335.00;34
5933;48;626337669;5933;291;6801;6834;7.37;0.45;255.06;5.18;868;49;2336.00;33
5934;48;626337679;5934;295;6801;6834;7.39;0.45;255.02;5.18;867;49;2337.00;33
5935;48;626337690;5935;303;6801;6834;7.41;0.45;255.03;5.18;866;49;2338.00;33
5936;48;626337702;5936;303;6802;6834;7.40;0.45;255.01;5.19;866;49;2339.00;32
5938;48;626337715;5938;309;6824;6870;7.44;0.46;255.02;5.19;886;49;2340.00;46
5938;48;626337729;5938;309;6826;6870;7.46;0.46;255.02;5.19;888;49;2341.00;44
5941;48;626337747;5941;316;6829;6870;7.45;0.46;254.98;5.19;888;49;2342.00;41
5943;48;626337758;5943;322;6832;6870;7.41;0.45;254.94;5.21;889;49;2343.00;38
5946;48;626337770;5946;326;6834;6870;7.35;0.45;254.89;5.21;888;49;2344.00;36
5948;48;626337781;5948;327;6835;6870;7.30;0.44;254.89;5.21;887;49;2345.00;35
5948;48;626337792;5948;328;6839;6874;7.28;0.44;254.89;5.22;891;49;2346.00;35
5949;48;626337804;5949;318;6841;6874;7.34;0.45;254.85;5.23;892;49;2347.00;33
5949;48;626337815;5949;311;6843;6878;7.40;0.45;254.85;5.23;894;49;2348.00;35
5950;48;626337831;5950;307;6848;6879;7.42;0.45;254.88;5.24;898;49;2349.00;31
5951;48;626337847;5951;300;6848;6879;7.42;0.45;254.86;5.24;897;49;2350.00;31
5952;48;626337858;5952;294;6851;6879;7.44;0.45;254.86;5.26;899;49;2351.00;28
5954;48;626337869;5954;292;6862;6892;7.40;0.45;254.79;5.25;908;49;2352.00;30
5955;48;626337882;5955;289;6864;6892;7.41;0.45;254.77;5.26;909;49;2353.00;28
5956;48;626337898;5956;284;6864;6892;7.38;0.45;254.75;5.26;908;49;2354.00;28
5957;48;626337910;5957;283;6867;6893;7.37;0.45;254.74;5.27;910;49;2355.00;26
5957;48;626337921;5957;281;6867;6894;7.31;0.45;254.74;5.27;910;49;2356.00;27
5957;48;626337931;5957;285;6867;6894;7.30;0.45;254.74;5.27;910;49;2357.00;27
5958;48;626337948;5958;290;6870;6897;7.28;0.45;254.73;5.28;912;49;2358.00;27
5960;48;626337959;5960;286;6871;6897;7.25;0.44;254.67;5.28;911;49;2359.00;26
5963;48;626337970;5963;291;6874;6897;7.25;0.44;254.63;5.31;911;49;2360.00;23
5964;48;626337980;5964;288;6874;6897;7.26;0.44;254.64;5.31;910;49;2361.00;23
5964;48;626337991;5964;287;6880;6903;7.29;0.44;254.64;5.32;916;49;2362.00;23
5966;48;626338002;5966;281;6880;6903;7.31;0.44;254.61;5.32;914;49;2363.00;23
5967;48;626338013;5967;281;6882;6903;7.34;0.45;254.63;5.32;915;49;2364.00;21
5969;48;626338023;5969;281;6882;6903;7.35;0.45;254.60;5.32;913;49;2365.00;21
5971;48;626338033;5971;282;6885;6907;7.33;0.44;254.56;5.32;914;49;2366.00;22
5971;48;626338044;5971;282;6886;6908;7.41;0.45;254.56;5.32;915;49;2367.00;22
5974;48;626338055;5974;280;6889;6908;7.37;0.45;254.48;5.35;915;49;2368.00;19
5975;48;626338071;5975;283;6890;6909;7.37;0.45;254.50;5.35;915;49;2369.00;19
5975;48;626338083;5975;293;6891;6909;7.40;0.45;254.50;5.35;916;49;2370.00;18
5976;48;626338094;5976;291;6891;6909;7.37;0.45;254.48;5.35;915;49;2371.00;18
5982;48;626338104;5982;294;6894;6909;7.29;0.44;254.50;5.37;912;49;2372.00;15
5984;48;626338114;5984;297;6894;6909;7.27;0.44;254.49;5.37;910;49;2373.00;15
5987;48;626338124;5987;291;6895;6909;7.18;0.44;254.50;5.37;908;49;2374.00;14
5992;48;626338135;5992;294;6895;6909;7.09;0.43;254.51;5.37;903;49;2375.00;14
5995;48;626338146;5995;303;6936;6979;7.22;0.44;254.57;5.34;941;49;2376.00;43
6001;48;626338162;6001;303;6936;6980;7.10;0.43;254.56;5.34;935;49;2377.00;44
6004;48;626338172;6004;313;6948;6980;7.03;0.43;254.57;5.35;944;49;2378.00;32
6007;48;626338182;6007;315;6954;6980;6.91;0.42;254.56;5.35;947;49;2379.00;26
6014;48;626338193;6014;315;6961;6980;6.85;0.42;254.65;5.35;947;49;2380.00;19
6016;48;626338206;6016;306;6965;6980;6.85;0.42;254.70;5.35;949;49;2381.00;15
6019;48;626338216;6019;300;6966;6980;6.81;0.42;254.68;5.35;947;49;2382.00;14
6022;48;626338226;6022;302;6968;6980;6.76;0.41;254.72;5.35;946;49;2383.00;12
6025;48;626338237;6025;301;6970;6981;6.81;0.42;254.80;5.35;945;49;2384.00;11
6027;48;626338249;6027;302;6972;6983;6.87;0.42;254.86;5.34;945;49;2385.00;11
6032;48;626338260;6032;309;6972;6983;6.87;0.42;255.00;5.34;940;49;2386.00;11
6034;48;626338272;6034;313;6976;6987;6.91;0.42;254.98;5.34;942;49;2387.00;11
6038;48;626338284;6038;311;6976;6987;7.02;0.43;255.10;5.34;938;49;2388.00;11
6041;48;626338295;6041;306;6976;6987;7.13;0.44;255.18;5.34;935;49;2389.00;11
6045;48;626338307;6045;311;6976;6987;7.24;0.44;255.28;5.34;931;49;2390.00;11
6049;48;626338318;6049;311;6980;6993;7.32;0.45;255.40;5.34;931;49;2391.00;13
6053;48;626338330;6053;307;6981;6993;7.46;0.46;255.53;5.34;928;49;2392.00;12
6056;48;626338342;6056;301;6982;6993;7.51;0.46;255.64;5.34;926;49;2393.00;11
6061;48;626338354;6061;293;6984;6996;7.60;0.47;255.80;5.34;923;49;2394.00;12
6062;48;626338366;6062;283;6984;6996;7.68;0.47;255.79;5.34;922;49;2395.00;12
6069;48;626338378;6069;279;6985;6996;7.71;0.47;255.97;5.34;916;49;2396.00;11
6075;48;626338390;6075;274;6986;6997;7.78;0.48;256.02;5.34;911;49;2397.00;11
6078;48;626338402;6078;273;6987;6998;7.91;0.48;255.99;5.34;909;49;2398.00;11
6086;48;626338414;6086;268;6987;6998;7.94;0.49;256.10;5.34;901;49;2399.00;11
6093;48;626338429;6093;277;7013;7057;8.01;0.49;256.09;5.32;920;49;2400.00;44
6095;48;626338451;6095;270;7015;7057;8.11;0.50;256.26;5.31;920;49;2401.00;42
6101;48;626338470;6101;263;7017;7057;8.14;0.50;256.33;5.31;916;49;2402.00;40
6103;48;626338483;6103;262;7018;7058;8.22;0.50;256.31;5.31;915;49;2403.00;40
6111;48;626338496;6111;257;7020;7058;8.15;0.50;256.34;5.31;909;49;2404.00;38
6116;48;626338509;6116;259;7022;7062;8.17;0.50;256.33;5.31;906;49;2405.00;40
6121;48;626338522;6121;259;7024;7062;8.09;0.49;256.39;5.31;903;49;2406.00;38
6125;48;626338534;6125;265;7028;7066;8.06;0.49;256.40;5.31;903;49;2407.00;38
6131;48;626338547;6131;263;7029;7066;8.05;0.49;256.50;5.31;898;49;2408.00;37
6136;48;626338560;6136;267;7029;7066;8.05;0.49;256.58;5.31;893;49;2409.00;37
6137;48;626338572;6137;277;7030;7066;8.07;0.49;256.58;5.31;893;49;2410.00;36
6144;48;626338585;6144;277;7030;7066;8.06;0.49;256.79;5.31;886;49;2411.00;36
6145;48;626338598;6145;286;7040;7078;8.09;0.49;256.75;5.31;895;49;2412.00;38
6149;48;626338611;6149;285;7041;7078;8.06;0.49;256.79;5.34;892;49;2413.00;37
6152;48;626338624;6152;287;7042;7078;8.07;0.49;256.85;5.34;890;49;2414.00;36
6157;48;626338636;6157;296;7042;7078;7.99;0.49;256.93;5.34;885;49;2415.00;36
6161;48;626338649;6161;297;7043;7078;7.88;0.48;256.92;5.34;882;49;2416.00;35
6165;48;626338661;6165;296;7043;7078;7.78;0.48;257.02;5.34;878;49;2417.00;35
6167;48;626338674;6167;299;7044;7079;7.75;0.47;257.08;5.35;877;49;2418.00;35
6171;48;626338686;6171;299;7044;7079;7.74;0.47;257.18;5.35;873;49;2419.00;35
6175;48;626338698;6175;302;7049;7085;7.68;0.47;257.17;5.35;874;49;2420.00;36
6178;48;626338712;6178;303;7050;7086;7.71;0.47;257.19;5.35;872;49;2421.00;36
6181;48;626338724;6181;307;7051;7086;7.68;0.47;257.27;5.35;870;49;2422.00;35
6183;48;626338736;6183;312;7051;7086;7.66;0.47;257.37;5.35;868;49;2423.00;35
6185;48;626338748;6185;316;7054;7090;7.75;0.47;257.43;5.35;869;49;2424.00;36
6191;48;626338760;6191;315;7054;7090;7.72;0.47;257.59;5.35;863;49;2425.00;36
6196;48;626338772;6196;314;7054;7090;7.63;0.46;257.71;5.35;858;49;2426.00;36
6199;48;626338784;6199;302;7057;7091;7.57;0.46;257.76;5.35;858;49;2427.00;34
6202;48;626338797;6202;298;7062;7095;7.53;0.46;257.83;5.36;860;49;2428.00;33
6204;48;626338810;6204;293;7063;7095;7.52;0.46;257.88;5.36;859;49;2429.00;32
6207;48;626338824;6207;288;7066;7101;7.56;0.46;257.97;5.36;859;49;2430.00;35
6210;48;626338845;6210;294;7067;7101;7.59;0.46;258.00;5.39;857;49;2431.00;34
6215;48;626338865;6215;290;7069;7101;7.62;0.46;258.13;5.39;854;49;2432.00;32
6216;48;626338895;6216;284;7069;7101;7.68;0.47;258.16;5.39;853;49;2433.00;32
6222;48;626338914;6222;283;7074;7105;7.68;0.47;258.17;5.40;852;49;2434.00;31
6227;48;626338948;6227;285;7074;7105;7.68;0.47;258.31;5.40;847;49;2435.00;31
6232;48;626338971;6232;274;7076;7105;7.70;0.47;258.27;5.40;844;49;2436.00;29
6234;48;626338990;6234;260;7076;7105;7.77;0.47;258.42;5.40;842;49;2437.00;29
6239;48;626339003;6239;257;7076;7106;7.85;0.48;258.51;5.40;837;49;2438.00;30
6240;48;626339021;6240;243;7078;7107;7.92;0.48;258.53;5.40;838;49;2439.00;29
6243;48;626339038;6243;235;7078;7107;7.97;0.48;258.57;5.40;835;49;2440.00;29
6243;48;626339053;6243;223;7079;7108;8.13;0.49;258.57;5.40;836;49;2441.00;29
6248;48;626339079;6248;213;7079;7108;8.18;0.50;258.74;5.40;831;49;2442.00;29
6250;48;626339092;6250;206;7079;7108;8.29;0.51;258.81;5.40;829;49;2443.00;29
6253;48;626339106;6253;210;7079;7108;8.39;0.51;258.84;5.40;826;49;2444.00;29
6257;48;626339119;6257;204;7079;7108;8.49;0.52;258.87;5.40;822;49;2445.00;29
6260;48;626339137;6260;208;7081;7108;8.51;0.52;258.95;5.44;821;49;2446.00;27
6263;48;626339151;6263;201;7081;7108;8.59;0.52;258.97;5.44;818;49;2447.00;27
6266;48;626339164;6266;213;7142;7235;8.76;0.54;259.02;5.40;876;49;2448.00;93
6268;48;626339186;6268;201;7146;7236;8.81;0.54;259.06;5.40;878;49;2449.00;90
6271;48;626339199;6271;198;7151;7236;8.92;0.55;259.08;5.39;880;49;2450.00;85
6273;48;626339211;6273;195;7155;7236;9.01;0.55;259.13;5.39;882;49;2451.00;81
6277;48;626339224;6277;195;7159;7236;9.06;0.56;259.17;5.40;882;49;2452.00;77
6280;48;626339244;6280;192;7163;7236;9.08;0.56;259.12;5.40;883;49;2453.00;73
6282;48;626339258;6282;191;7166;7236;9.07;0.56;259.10;5.40;884;49;2454.00;70
6283;48;626339270;6283;203;7172;7236;9.02;0.55;259.11;5.44;889;49;2455.00;64
6286;48;626339282;6286;200;7175;7237;8.97;0.55;259.15;5.44;889;49;2456.00;62
6288;48;626339295;6288;201;7178;7238;8.90;0.54;259.14;5.44;890;49;2457.00;60
6290;48;626339308;6290;206;7182;7238;8.78;0.54;259.14;5.45;892;49;2458.00;56
6293;48;626339320;6293;211;7185;7239;8.68;0.53;259.24;5.46;892;49;2459.00;54
6296;48;626339334;6296;220;7188;7239;8.60;0.53;259.23;5.46;892;49;2460.00;51
6297;48;626339347;6297;232;7193;7239;8.50;0.52;259.26;5.50;896;49;2461.00;46
6298;48;626339359;6298;234;7195;7239;8.39;0.51;259.25;5.51;897;49;2462.00;44
6299;48;626339372;6299;244;7199;7243;8.30;0.51;259.30;5.51;900;49;2463.00;44
6300;48;626339385;6300;258;7200;7243;8.24;0.50;259.30;5.52;900;49;2464.00;43
6302;48;626339397;6302;255;7202;7243;8.13;0.50;259.26;5.52;900;49;2465.00;41
6302;48;626339415;6302;267;7204;7246;8.12;0.50;259.26;5.52;902;49;2466.00;42
6305;48;626339428;6305;272;7206;7246;8.06;0.49;259.20;5.55;901;49;2467.00;40
6305;48;626339439;6305;278;7207;7246;8.02;0.49;259.20;5.55;902;49;2468.00;39
6306;48;626339450;6306;290;7213;7250;7.96;0.49;259.19;5.59;907;49;2469.00;37
6311;48;626339462;6311;283;7215;7251;7.91;0.48;259.10;5.59;904;49;2470.00;36
6313;48;626339476;6313;279;7216;7251;7.82;0.48;259.13;5.59;903;49;2471.00;35
6316;48;626339487;6316;277;7221;7255;7.76;0.48;259.10;5.61;905;49;2472.00;34
6318;48;626339499;6318;275;7221;7255;7.65;0.47;259.07;5.61;903;49;2473.00;34
6321;48;626339511;6321;275;7222;7255;7.60;0.47;259.08;5.61;901;49;2474.00;33
6323;48;626339523;6323;274;7225;7257;7.62;0.47;259.01;5.63;902;49;2475.00;32
6324;48;626339534;6324;277;7225;7257;7.58;0.47;259.03;5.63;901;49;2476.00;32
6327;48;626339545;6327;274;7229;7263;7.53;0.46;258.95;5.63;902;49;2477.00;34
6331;48;626339557;6331;283;7230;7263;7.44;0.46;258.93;5.65;899;49;2478.00;33
6335;48;626339569;6335;279;7231;7264;7.34;0.45;258.90;5.65;896;49;2479.00;33
6341;48;626339581;6341;274;7231;7264;7.24;0.44;258.96;5.65;890;49;2480.00;33
6342;48;626339592;6342;264;7231;7264;7.14;0.44;258.98;5.65;889;49;2481.00;33
6347;48;626339602;6347;256;7232;7264;7.02;0.43;258.99;5.66;885;49;2482.00;32
6350;48;626339612;6350;256;7233;7264;6.89;0.42;258.98;5.67;883;49;2483.00;31
6353;48;626339622;6353;254;7243;7276;6.84;0.42;258.98;5.66;890;49;2484.00;33
6356;48;626339634;6356;246;7245;7276;6.82;0.42;258.97;5.67;889;49;2485.00;31
6357;48;626339644;6357;246;7246;7276;6.82;0.42;258.97;5.68;889;49;2486.00;30
6362;48;626339655;6362;244;7246;7276;6.81;0.42;258.85;5.68;884;49;2487.00;30
6366;48;626339666;6366;248;7246;7276;6.80;0.42;258.84;5.68;880;49;2488.00;30
6370;48;626339676;6370;246;7246;7276;6.78;0.41;258.85;5.68;876;49;2489.00;30
6371;48;626339689;6371;241;7250;7280;6.82;0.42;258.83;5.69;879;49;2490.00;30
6373;48;626339700;6373;247;7250;7280;6.83;0.42;258.93;5.69;877;49;2491.00;30
6375;48;626339710;6375;253;7254;7284;6.87;0.42;258.96;5.69;879;49;2492.00;30
6377;48;626339722;6377;254;7256;7285;6.93;0.42;258.90;5.69;879;49;2493.00;29
6378;48;626339732;6378;257;7256;7285;6.93;0.42;258.95;5.69;878;49;2494.00;29
6379;48;626339743;6379;261;7256;7285;6.94;0.42;258.92;5.69;877;49;2495.00;29
6381;48;626339753;6381;262;7266;7298;6.92;0.42;258.92;5.69;885;49;2496.00;32
6385;48;626339764;6385;267;7266;7298;6.87;0.42;258.89;5.69;881;49;2497.00;32
6386;48;626339775;6386;274;7266;7298;6.89;0.42;258.86;5.69;880;49;2498.00;32
6389;48;626339786;6389;259;7267;7299;6.93;0.42;258.80;5.69;878;49;2499.00;32
6389;48;626339798;6389;254;7267;7300;6.97;0.42;258.80;5.69;878;49;2500.00;33
6392;48;626339814;6392;250;7268;7300;6.99;0.42;258.74;5.71;876;49;2501.00;32
6393;48;626339826;6393;247;7270;7303;7.07;0.43;258.70;5.70;877;49;2502.00;33
6395;48;626339839;6395;242;7271;7303;7.15;0.43;258.65;5.70;876;49;2503.00;32
6395;48;626339850;6395;239;7271;7303;7.21;0.44;258.65;5.70;876;49;2504.00;32
6398;48;626339870;6398;234;7271;7303;7.28;0.44;258.68;5.70;873;49;2505.00;32
6400;48;626339881;6400;227;7275;7309;7.40;0.45;258.64;5.70;875;49;2506.00;34
6400;48;626339893;6400;221;7278;7309;7.49;0.45;258.64;5.72;878;49;2507.00;31
6400;48;626339904;6400;222;7278;7309;7.51;0.45;258.64;5.72;878;49;2508.00;31
6401;48;626339915;6401;225;7279;7309;7.54;0.45;258.68;5.73;878;49;2509.00;30
6401;48;626339925;6401;221;7283;7313;7.57;0.46;258.68;5.74;882;49;2510.00;30
6403;48;626339943;6403;224;7285;7314;7.61;0.46;258.65;5.74;882;49;2511.00;29
6404;48;626339955;6404;221;7286;7314;7.65;0.46;258.64;5.74;882;49;2512.00;28
6404;48;626339966;6404;221;7290;7315;7.73;0.47;258.64;5.77;886;49;2513.00;25
6405;48;626339977;6405;220;7291;7315;7.80;0.47;258.65;5.78;886;49;2514.00;24
6406;48;626339989;6406;223;7293;7315;7.82;0.47;258.64;5.81;887;49;2515.00;22
6407;48;626340000;6407;220;7294;7315;7.87;0.48;258.61;5.81;887;49;2516.00;21
6408;48;626340017;6408;217;7295;7315;7.93;0.48;258.59;5.83;887;49;2517.00;20
6408;48;626340032;6408;220;7297;7315;7.98;0.48;258.59;5.85;889;49;2518.00;18
6408;48;626340047;6408;224;7298;7315;8.03;0.49;258.59;5.85;890;49;2519.00;17
6408;48;626340060;6408;238;7353;7440;8.20;0.50;258.59;5.81;945;49;2520.00;87
6412;48;626340081;6412;233;7357;7441;8.14;0.50;258.74;5.82;945;49;2521.00;84
6415;48;626340094;6415;226;7369;7441;8.14;0.50;258.71;5.82;954;49;2522.00;72
6418;48;626340105;6418;224;7376;7441;8.09;0.50;258.73;5.83;958;49;2523.00;65
6420;48;626340117;6420;224;7382;7441;8.01;0.49;258.76;5.83;962;49;2524.00;59
6421;48;626340128;6421;230;7388;7441;7.93;0.49;258.78;5.84;967;49;2525.00;53
6422;48;626340139;6422;229;7391;7441;7.86;0.48;258.80;5.85;969;49;2526.00;50
6424;49;626340150;6424;232;7397;7441;7.83;0.48;258.83;5.85;973;50;2527.00;44
6427;49;626340171;6427;239;7400;7442;7.77;0.48;258.87;5.86;973;50;2528.00;42
6431;49;626340182;6431;247;7402;7443;7.68;0.47;258.86;5.86;971;50;2529.00;41
6432;49;626340194;6432;246;7407;7443;7.65;0.47;258.84;5.86;975;50;2530.00;36
6437;49;626340206;6437;247;7415;7447;7.58;0.47;258.83;5.87;978;50;2531.00;32
6438;49;626340218;6438;247;7418;7447;7.56;0.46;258.80;5.87;980;50;2532.00;29
6442;49;626340229;6442;247;7422;7447;7.55;0.46;258.82;5.88;980;50;2533.00;25
6446;49;626340240;6446;249;7425;7447;7.49;0.46;258.81;5.89;979;50;2534.00;22
6448;49;626340252;6448;247;7428;7453;7.54;0.46;258.83;5.89;980;50;2535.00;25
6450;49;626340265;6450;247;7430;7453;7.53;0.46;258.89;5.90;980;50;2536.00;23
6452;49;626340277;6452;249;7433;7455;7.59;0.46;258.87;5.90;981;50;2537.00;22
6453;49;626340289;6453;248;7435;7458;7.65;0.47;258.85;5.90;982;50;2538.00;23
6455;49;626340307;6455;249;7437;7458;7.63;0.47;258.89;5.90;982;50;2539.00;21
6460;49;626340319;6460;255;7437;7458;7.58;0.46;258.96;5.90;977;50;2540.00;21
6463;49;626340337;6463;269;7438;7459;7.50;0.46;258.97;5.91;975;50;2541.00;21
6468;49;626340348;6468;273;7439;7460;7.39;0.45;258.98;5.91;971;50;2542.00;21
6470;49;626340360;6470;280;7441;7460;7.26;0.44;259.04;5.91;971;50;2543.00;19
6478;49;626340371;6478;283;7452;7473;7.09;0.43;259.14;5.91;974;50;2544.00;21
6480;49;626340384;6480;292;7454;7473;7.05;0.43;259.14;5.91;974;50;2545.00;19
6483;49;626340395;6483;295;7455;7473;6.97;0.43;259.19;5.91;972;50;2546.00;18
6484;49;626340407;6484;302;7456;7474;6.91;0.42;259.21;5.91;972;50;2547.00;18
6489;49;626340418;6489;302;7456;7474;6.80;0.42;259.25;5.91;967;50;2548.00;18
6495;49;626340431;6495;307;7463;7478;6.67;0.41;259.26;5.92;968;50;2549.00;15
6500;49;626340444;6500;297;7466;7481;6.66;0.41;259.34;5.92;966;50;2550.00;15
6502;49;626340459;6502;287;7470;7485;6.65;0.41;259.42;5.92;968;50;2551.00;15
6508;49;626340472;6508;279;7471;7485;6.60;0.40;259.52;5.92;963;50;2552.00;14
6511;49;626340484;6511;274;7472;7485;6.64;0.41;259.56;5.92;961;50;2553.00;13
6513;49;626340495;6513;267;7473;7485;6.70;0.41;259.63;5.92;960;50;2554.00;12
6518;49;626340509;6518;266;7473;7485;6.69;0.41;259.77;5.92;955;50;2555.00;12
6520;49;626340521;6520;263;7484;7497;6.79;0.42;259.82;5.91;964;50;2556.00;13
6523;49;626340534;6523;266;7484;7497;6.88;0.42;259.84;5.91;961;50;2557.00;13
6529;49;626340546;6529;252;7484;7497;6.96;0.43;259.98;5.91;955;50;2558.00;13
6533;49;626340558;6533;247;7484;7497;7.00;0.43;260.01;5.91;951;50;2559.00;13
6537;49;626340570;6537;241;7484;7497;7.06;0.43;260.11;5.91;947;50;2560.00;13
6540;49;626340581;6540;241;7484;7497;7.14;0.44;260.22;5.91;944;50;2561.00;13
6543;49;626340593;6543;237;7484;7498;7.20;0.44;260.25;5.91;941;50;2562.00;14
6548;49;626340605;6548;234;7484;7498;7.22;0.44;260.32;5.91;936;50;2563.00;14
6552;49;626340618;6552;235;7488;7504;7.38;0.45;260.35;5.91;936;50;2564.00;16
6558;49;626340631;6558;236;7491;7506;7.46;0.46;260.37;5.91;933;50;2565.00;15
6562;49;626340644;6562;241;7491;7506;7.52;0.46;260.59;5.91;929;50;2566.00;15
6567;49;626340656;6567;241;7491;7506;7.62;0.47;260.57;5.91;924;50;2567.00;15
6572;49;626340668;6572;241;7494;7510;7.73;0.48;260.62;5.90;922;50;2568.00;16
6577;49;626340680;6577;242;7494;7510;7.75;0.48;260.65;5.90;917;50;2569.00;16
6580;49;626340693;6580;238;7494;7510;7.85;0.48;260.72;5.90;914;50;2570.00;16
6588;49;626340704;6588;233;7495;7511;7.89;0.49;260.80;5.90;907;50;2571.00;16
6590;49;626340717;6590;224;7498;7515;7.97;0.49;260.78;5.90;908;50;2572.00;17
6595;49;626340730;6595;224;7498;7515;8.04;0.49;260.77;5.90;903;50;2573.00;17
6601;49;626340742;6601;217;7500;7518;8.13;0.50;260.78;5.90;899;50;2574.00;18
6606;49;626340755;6606;217;7501;7518;8.14;0.50;260.83;5.90;895;50;2575.00;17
6608;49;626340767;6608;219;7501;7518;8.14;0.50;260.85;5.90;893;50;2576.00;17
6611;49;626340779;6611;218;7501;7518;8.15;0.50;260.95;5.90;890;50;2577.00;17
6615;49;626340791;6615;221;7504;7522;8.16;0.50;260.98;5.90;889;50;2578.00;18
6620;49;626340809;6620;219;7504;7522;8.12;0.50;261.02;5.90;884;50;2579.00;18
6624;49;626340823;6624;220;7505;7522;8.15;0.50;261.07;5.90;881;50;2580.00;17
6631;49;626340840;6631;222;7505;7522;8.15;0.50;261.13;5.90;874;50;2581.00;17
6634;49;626340859;6634;221;7505;7523;8.18;0.50;261.13;5.90;871;50;2582.00;18
6640;49;626340878;6640;221;7507;7524;8.19;0.50;261.23;5.90;867;50;2583.00;17
6643;49;626340904;6643;222;7507;7524;8.23;0.50;261.26;5.90;864;50;2584.00;17
6645;49;626340923;6645;226;7508;7525;8.23;0.50;261.31;5.90;863;50;2585.00;17
6650;49;626340941;6650;231;7508;7525;8.15;0.50;261.36;5.90;858;50;2586.00;17
6658;49;626340956;6658;233;7508;7525;8.03;0.49;261.37;5.90;850;50;2587.00;17
6662;49;626340972;6662;239;7508;7525;8.02;0.49;261.35;5.90;846;50;2588.00;17
6666;49;626340985;6666;245;7508;7525;7.91;0.48;261.42;5.90;842;50;2589.00;17
6668;49;626340998;6668;248;7508;7525;7.78;0.47;261.49;5.90;840;50;2590.00;17
6672;49;626341010;6672;254;7508;7525;7.64;0.46;261.46;5.90;836;50;2591.00;17
6677;49;626341022;6677;275;7574;7652;7.82;0.48;261.45;5.85;897;50;2592.00;78
6680;49;626341045;6680;271;7577;7653;7.77;0.48;261.55;5.85;897;50;2593.00;76
6682;49;626341059;6682;281;7585;7653;7.73;0.48;261.57;5.85;903;50;2594.00;68
6683;49;626341072;6683;288;7587;7653;7.68;0.47;261.57;5.85;904;50;2595.00;66
6685;49;626341084;6685;292;7591;7653;7.59;0.47;261.55;5.84;906;50;2596.00;62
6687;49;626341099;6687;281;7592;7653;7.52;0.46;261.54;5.84;905;50;2597.00;61
6688;49;626341112;6688;274;7595;7653;7.54;0.47;261.53;5.84;907;50;2598.00;58
6689;49;626341124;6689;272;7596;7653;7.56;0.47;261.51;5.84;907;50;2599.00;57
6694;49;626341139;6694;276;7604;7654;7.57;0.47;261.55;5.85;910;50;2600.00;50
6696;49;626341163;6696;281;7605;7655;7.58;0.47;261.58;5.85;909;50;2601.00;50
6698;49;626341176;6698;282;7610;7655;7.60;0.47;261.58;5.85;912;50;2602.00;45
6699;49;626341190;6699;285;7614;7656;7.61;0.47;261.58;5.85;915;50;2603.00;42
6701;49;626341203;6701;286;7620;7656;7.62;0.47;261.61;5.86;919;50;2604.00;36
6702;49;626341216;6702;278;7622;7656;7.59;0.47;261.64;5.86;920;50;2605.00;34
6706;49;626341231;6706;268;7624;7656;7.57;0.47;261.68;5.86;918;50;2606.00;32
6709;49;626341245;6709;264;7627;7660;7.62;0.47;261.76;5.86;918;50;2607.00;33
6709;49;626341260;6709;249;7629;7660;7.73;0.48;261.76;5.86;920;50;2608.00;31
6713;49;626341274;6713;243;7629;7660;7.77;0.48;261.75;5.86;916;50;2609.00;31
6716;49;626341289;6716;237;7633;7666;7.88;0.48;261.80;5.86;917;50;2610.00;33
6721;49;626341303;6721;231;7634;7666;7.90;0.48;261.85;5.86;913;50;2611.00;32
6722;49;626341316;6722;237;7634;7666;7.92;0.49;261.92;5.86;912;50;2612.00;32
6725;50;626341329;6725;236;7638;7670;7.97;0.49;261.85;5.86;913;51;2613.00;32
6729;50;626341351;6729;236;7639;7671;8.00;0.49;261.89;5.86;910;51;2614.00;32
6731;50;626341365;6731;238;7640;7671;8.08;0.50;261.84;5.86;909;51;2615.00;31
6735;50;626341382;6735;239;7643;7675;8.13;0.50;262.07;5.86;908;51;2616.00;32
6738;50;626341397;6738;236;7644;7675;8.18;0.50;262.05;5.86;906;51;2617.00;31
6739;50;626341417;6739;230;7644;7675;8.26;0.51;262.07;5.86;905;51;2618.00;31
6742;50;626341431;6742;223;7646;7676;8.22;0.50;262.04;5.86;904;51;2619.00;30
6743;50;626341445;6743;218;7646;7676;8.26;0.50;262.01;5.86;903;51;2620.00;30
6747;50;626341460;6747;230;7651;7682;8.25;0.50;262.02;5.87;904;51;2621.00;31
6749;50;626341481;6749;224;7651;7682;8.23;0.50;262.01;5.87;902;51;2622.00;31
6753;50;626341495;6753;221;7652;7683;8.22;0.50;261.98;5.87;899;51;2623.00;31
6757;50;626341508;6757;230;7652;7683;8.19;0.50;261.95;5.87;895;51;2624.00;31
6758;50;626341521;6758;236;7652;7683;8.15;0.50;261.92;5.87;894;51;2625.00;31
6760;50;626341532;6760;231;7652;7683;8.10;0.49;261.91;5.87;892;51;2626.00;31
6760;50;626341545;6760;240;7652;7683;8.09;0.49;261.91;5.87;892;51;2627.00;31
6760;50;626341556;6760;243;7662;7695;8.10;0.50;261.91;5.86;902;51;2628.00;33
6762;50;626341570;6762;255;7662;7695;8.04;0.49;261.89;5.86;900;51;2629.00;33
6763;50;626341582;6763;263;7663;7695;7.99;0.49;261.89;5.86;900;51;2630.00;32
6768;50;626341596;6768;263;7663;7695;7.88;0.48;261.83;5.86;895;51;2631.00;32
6770;50;626341608;6770;267;7663;7695;7.79;0.47;261.81;5.86;893;51;2632.00;32
6773;50;626341620;6773;269;7663;7695;7.74;0.47;261.81;5.86;890;51;2633.00;32
6776;50;626341632;6776;281;7666;7699;7.69;0.47;261.77;5.86;890;51;2634.00;33
6778;50;626341645;6778;283;7667;7699;7.64;0.46;261.74;5.87;889;51;2635.00;32
6779;50;626341656;6779;286;7670;7703;7.62;0.46;261.71;5.87;891;51;2636.00;33
6782;50;626341668;6782;291;7671;7704;7.56;0.46;261.64;5.87;889;51;2637.00;33
6783;50;626341680;6783;298;7672;7704;7.53;0.46;261.77;5.87;889;51;2638.00;32
6785;50;626341692;6785;295;7672;7704;7.42;0.45;261.72;5.87;887;51;2639.00;32
6786;50;626341705;6786;304;7691;7733;7.36;0.45;261.71;5.85;905;51;2640.00;42
6787;50;626341719;6787;304;7692;7733;7.23;0.44;261.68;5.85;905;51;2641.00;41
6790;50;626341730;6790;303;7695;7733;7.20;0.44;261.70;5.85;905;51;2642.00;38
6791;50;626341742;6791;305;7697;7734;7.25;0.44;261.70;5.85;906;51;2643.00;37
6793;50;626341752;6793;305;7698;7735;7.24;0.44;261.71;5.85;905;51;2644.00;37
6794;50;626341764;6794;305;7698;7735;7.17;0.44;261.70;5.85;904;51;2645.00;37
6796;50;626341775;6796;304;7701;7738;7.17;0.44;261.73;5.85;905;51;2646.00;37
6797;50;626341787;6797;310;7701;7738;7.12;0.43;261.74;5.85;904;51;2647.00;37
6798;50;626341797;6798;313;7702;7738;7.05;0.43;261.76;5.86;904;51;2648.00;36
6798;50;626341808;6798;308;7702;7738;6.98;0.42;261.76;5.86;904;51;2649.00;36
6798;50;626341824;6798;310;7706;7744;6.91;0.42;261.76;5.86;908;51;2650.00;38
6800;50;626341836;6800;305;7707;7744;6.82;0.41;261.73;5.86;907;51;2651.00;37
6802;50;626341847;6802;287;7707;7744;6.72;0.41;261.72;5.86;905;51;2652.00;37
6803;50;626341858;6803;280;7707;7744;6.65;0.40;261.71;5.86;904;51;2653.00;37
6805;50;626341869;6805;273;7711;7748;6.60;0.40;261.74;5.87;906;51;2654.00;37
6810;50;626341881;6810;261;7714;7750;6.54;0.40;261.78;5.88;904;51;2655.00;36
6810;50;626341893;6810;253;7714;7750;6.60;0.40;261.78;5.88;904;51;2656.00;36
6814;50;626341908;6814;241;7715;7751;6.68;0.41;261.83;5.88;901;51;2657.00;36
6815;50;626341919;6815;234;7715;7751;6.80;0.41;261.83;5.88;900;51;2658.00;36
6818;50;626341930;6818;236;7715;7751;6.86;0.42;261.82;5.88;897;51;2659.00;36
6819;50;626341941;6819;227;7715;7751;7.02;0.43;261.86;5.88;896;51;2660.00;36
6822;50;626341958;6822;222;7715;7751;7.07;0.43;261.84;5.88;893;51;2661.00;36
6824;50;626341969;6824;220;7715;7751;7.16;0.43;261.79;5.88;891;51;2662.00;36
6825;50;626341979;6825;217;7716;7751;7.26;0.44;261.78;5.90;891;51;2663.00;35
6828;50;626341990;6828;225;7753;7821;7.44;0.45;261.74;5.87;925;51;2664.00;68
6828;50;626342007;6828;220;7756;7822;7.49;0.46;261.74;5.87;928;51;2665.00;66
6832;50;626342018;6832;212;7762;7822;7.58;0.46;261.67;5.87;930;51;2666.00;60
6833;50;626342029;6833;210;7768;7822;7.64;0.46;261.64;5.86;935;51;2667.00;54
6834;50;626342040;6834;208;7774;7822;7.62;0.46;261.63;5.88;940;51;2668.00;48
6834;50;626342051;6834;214;7777;7822;7.68;0.47;261.63;5.88;943;51;2669.00;45
6836;50;626342064;6836;201;7780;7822;7.74;0.47;261.60;5.88;944;51;2670.00;42
6837;50;626342076;6837;202;7781;7822;7.80;0.47;261.57;5.88;944;51;2671.00;41
6839;50;626342088;6839;201;7783;7823;7.87;0.48;261.56;5.88;944;51;2672.00;40
6840;50;626342100;6840;201;7784;7824;7.89;0.48;261.52;5.88;944;51;2673.00;40
6842;50;626342112;6842;199;7785;7824;7.92;0.48;261.51;5.88;943;51;2674.00;39
6844;50;626342123;6844;200;7788;7828;7.87;0.48;261.51;5.88;944;51;2675.00;40
6848;50;626342135;6848;203;7788;7828;7.86;0.48;261.48;5.88;940;51;2676.00;40
6851;50;626342147;6851;202;7788;7828;7.81;0.48;261.46;5.88;937;51;2677.00;40
6854;50;626342158;6854;202;7789;7828;7.84;0.48;261.42;5.89;935;51;2678.00;39
6854;50;626342170;6854;207;7794;7834;7.95;0.49;261.42;5.90;940;51;2679.00;40
6855;50;626342182;6855;211;7796;7834;8.03;0.49;261.47;5.91;941;51;2680.00;38
6859;50;626342193;6859;211;7796;7834;8.05;0.49;261.52;5.91;937;51;2681.00;38
6862;50;626342206;6862;215;7801;7837;8.13;0.50;261.54;5.94;939;51;2682.00;36
6866;50;626342218;6866;220;7801;7837;8.15;0.50;261.61;5.94;935;51;2683.00;36
6868;50;626342230;6868;227;7802;7837;8.14;0.49;261.63;5.95;934;51;2684.00;35
6874;50;626342242;6874;233;7803;7838;8.13;0.49;261.62;5.96;929;51;2685.00;35
6876;50;626342254;6876;235;7804;7839;8.17;0.50;261.61;5.96;928;51;2686.00;35
6880;50;626342266;6880;242;7806;7839;8.10;0.49;261.71;5.98;926;51;2687.00;33
6881;50;626342278;6881;245;7817;7852;8.04;0.49;261.76;5.97;936;51;2688.00;35
6884;50;626342291;6884;242;7818;7852;8.01;0.49;261.76;5.98;934;51;2689.00;34
6885;50;626342303;6885;245;7819;7852;8.00;0.49;261.75;5.99;934;51;2690.00;33
6889;50;626342315;6889;248;7821;7853;8.01;0.49;261.80;6.00;932;51;2691.00;32
6893;50;626342327;6893;245;7822;7853;8.00;0.49;261.89;6.01;929;51;2692.00;31
6898;50;626342339;6898;250;7826;7857;7.97;0.48;261.98;6.02;928;51;2693.00;31
6898;50;626342351;6898;252;7828;7857;7.95;0.48;261.98;6.03;930;51;2694.00;29
6901;50;626342362;6901;252;7832;7861;7.83;0.48;262.01;6.03;931;51;2695.00;29
6903;50;626342374;6903;254;7833;7861;7.77;0.47;262.07;6.04;930;51;2696.00;28
6904;50;626342386;6904;259;7834;7861;7.71;0.47;262.06;6.04;930;51;2697.00;27
6907;50;626342397;6907;258;7835;7861;7.65;0.47;262.07;6.05;928;51;2698.00;26
6908;50;626342408;6908;258;7836;7861;7.59;0.46;262.13;6.05;928;51;2699.00;25
6913;50;626342422;6913;255;7858;7910;7.67;0.47;262.19;6.04;945;51;2700.00;52
6914;50;626342442;6914;252;7861;7910;7.64;0.47;262.24;6.05;947;51;2701.00;49
6918;50;626342453;6918;251;7864;7910;7.59;0.46;262.28;6.05;946;51;2702.00;46
6921;50;626342465;6921;254;7866;7910;7.51;0.46;262.34;6.06;945;51;2703.00;44
6923;50;626342477;6923;253;7869;7910;7.44;0.45;262.36;6.05;946;51;2704.00;41
6925;50;626342488;6925;253;7869;7910;7.35;0.45;262.40;6.05;944;51;2705.00;41
6929;50;626342499;6929;248;7872;7911;7.28;0.44;262.56;6.06;943;51;2706.00;39
6930;50;626342511;6930;247;7873;7911;7.24;0.44;262.55;6.06;943;51;2707.00;38
6931;50;626342522;6931;254;7880;7917;7.25;0.44;262.59;6.09;949;51;2708.00;37
6933;50;626342533;6933;258;7882;7918;7.23;0.44;262.66;6.09;949;51;2709.00;36
6935;50;626342545;6935;267;7884;7918;7.17;0.44;262.65;6.10;949;51;2710.00;34
6937;50;626342556;6937;269;7884;7918;7.15;0.44;262.60;6.10;947;51;2711.00;34
6943;50;626342567;6943;278;7888;7922;7.10;0.43;262.78;6.09;945;51;2712.00;34
6946;50;626342578;6946;283;7890;7922;7.06;0.43;262.82;6.10;944;51;2713.00;32
6950;50;626342590;6950;283;7893;7922;7.05;0.43;262.84;6.11;943;51;2714.00;29
6954;50;626342601;6954;283;7894;7923;7.02;0.43;262.90;6.11;940;51;2715.00;29
6958;50;626342612;6958;284;7899;7927;6.94;0.42;262.98;6.12;941;51;2716.00;28
6965;50;626342624;6965;278;7899;7927;6.88;0.42;263.08;6.12;934;51;2717.00;28
6967;50;626342634;6967;279;7901;7930;6.89;0.42;263.03;6.12;934;51;2718.00;29
6973;50;626342647;6973;284;7905;7930;6.80;0.41;263.10;6.13;932;51;2719.00;25
6978;50;626342657;6978;273;7905;7930;6.80;0.41;263.17;6.13;927;51;2720.00;25
6980;50;626342669;6980;264;7907;7930;6.81;0.41;263.20;6.14;927;51;2721.00;23
6985;50;626342680;6985;253;7909;7934;6.84;0.42;263.28;6.13;924;51;2722.00;25
6990;50;626342691;6990;256;7909;7934;6.85;0.42;263.34;6.13;919;51;2723.00;25
6993;50;626342702;6993;251;7911;7934;6.89;0.42;263.42;6.14;918;51;2724.00;23
6996;50;626342713;6996;251;7913;7934;6.88;0.42;263.50;6.14;917;51;2725.00;21
6999;50;626342724;6999;244;7915;7935;6.88;0.42;263.57;6.14;916;51;2726.00;20
7001;50;626342735;7001;234;7916;7936;6.91;0.42;263.57;6.14;915;51;2727.00;20
7006;50;626342746;7006;239;7916;7936;6.90;0.42;263.63;6.14;910;51;2728.00;20
7008;50;626342757;7008;227;7917;7937;6.97;0.42;263.67;6.14;909;51;2729.00;20
7011;50;626342770;7011;231;7918;7937;6.99;0.43;263.74;6.14;907;51;2730.00;19
7015;50;626342781;7015;234;7920;7937;7.03;0.43;263.90;6.17;905;51;2731.00;17
7018;50;626342792;7018;237;7920;7937;7.05;0.43;263.91;6.17;902;51;2732.00;17
7023;50;626342803;7023;237;7922;7937;7.01;0.43;264.01;6.18;899;51;2733.00;15
7028;50;626342814;7028;239;7922;7937;7.01;0.43;264.11;6.18;894;51;2734.00;15
7032;50;626342825;7032;241;7923;7937;7.03;0.43;264.10;6.18;891;51;2735.00;14
7036;50;626342841;7036;251;7989;8064;7.32;0.45;264.17;6.13;953;51;2736.00;75
7039;50;626342874;7039;252;7994;8065;7.39;0.46;264.32;6.13;955;51;2737.00;71
7045;50;626342893;7045;251;8000;8065;7.44;0.46;264.31;6.13;955;51;2738.00;65
7050;50;626342911;7050;250;8004;8065;7.42;0.46;264.38;6.13;954;51;2739.00;61
7051;50;626342928;7051;250;8008;8065;7.52;0.47;264.41;6.13;957;51;2740.00;57
7059;50;626342944;7059;258;8009;8065;7.44;0.46;264.51;6.13;950;51;2741.00;56
7065;50;626342959;7065;256;8012;8065;7.45;0.46;264.58;6.13;947;51;2742.00;53
7068;50;626342973;7068;259;8016;8065;7.44;0.46;264.56;6.13;948;51;2743.00;49
7070;50;626342987;7070;258;8019;8066;7.41;0.46;264.59;6.13;949;51;2744.00;47
7073;50;626343000;7073;260;8025;8068;7.41;0.46;264.63;6.13;952;51;2745.00;43
7076;50;626343014;7076;266;8026;8068;7.37;0.46;264.68;6.13;950;51;2746.00;42
7083;50;626343028;7083;271;8030;8069;7.38;0.46;264.72;6.13;947;51;2747.00;39
7086;50;626343042;7086;277;8032;8069;7.41;0.46;264.75;6.13;946;51;2748.00;37
7090;50;626343056;7090;276;8035;8069;7.41;0.46;264.82;6.14;945;51;2749.00;34
7093;50;626343070;7093;275;8038;8069;7.42;0.46;264.84;6.14;945;51;2750.00;31
7096;50;626343083;7096;274;8042;8073;7.45;0.46;264.92;6.14;946;51;2751.00;31
7100;50;626343097;7100;278;8044;8073;7.45;0.46;264.87;6.14;944;51;2752.00;29
7107;50;626343109;7107;279;8046;8073;7.43;0.46;264.89;6.14;939;51;2753.00;27
7111;50;626343123;7111;285;8049;8076;7.49;0.46;264.89;6.14;938;51;2754.00;27
7117;50;626343136;7117;289;8050;8076;7.50;0.46;265.06;6.14;933;51;2755.00;26
7118;50;626343149;7118;296;8052;8076;7.56;0.47;265.04;6.17;934;51;2756.00;24
7125;50;626343162;7125;297;8056;8080;7.51;0.46;265.20;6.17;931;51;2757.00;24
7132;50;626343176;7132;305;8058;8081;7.49;0.46;265.31;6.17;926;51;2758.00;23
7135;50;626343190;7135;312;8059;8081;7.46;0.46;265.31;6.17;924;51;2759.00;22
7142;50;626343204;7142;312;8063;8086;7.35;0.45;265.31;6.17;921;51;2760.00;23
7146;50;626343217;7146;319;8063;8086;7.24;0.45;265.25;6.17;917;51;2761.00;23
7149;50;626343230;7149;320;8063;8086;7.19;0.44;265.31;6.17;914;51;2762.00;23
7154;50;626343243;7154;327;8064;8087;7.13;0.44;265.36;6.17;910;51;2763.00;23
7159;50;626343257;7159;334;8064;8087;7.07;0.43;265.41;6.17;905;51;2764.00;23
7161;50;626343270;7161;333;8068;8093;7.07;0.43;265.43;6.17;907;51;2765.00;25
7166;50;626343288;7166;335;8068;8093;7.07;0.43;265.47;6.17;902;51;2766.00;25
7169;50;626343301;7169;321;8069;8094;7.09;0.43;265.46;6.17;900;51;2767.00;25
7171;50;626343314;7171;319;8069;8094;7.07;0.43;265.47;6.17;898;51;2768.00;25
7174;50;626343326;7174;312;8069;8094;7.09;0.43;265.45;6.17;895;51;2769.00;25
7180;50;626343339;7180;307;8069;8094;7.12;0.43;265.58;6.17;889;51;2770.00;25
7184;50;626343351;7184;307;8069;8094;7.15;0.44;265.62;6.17;885;51;2771.00;25
7186;50;626343364;7186;304;8079;8106;7.30;0.45;265.63;6.19;893;51;2772.00;27
7189;50;626343379;7189;304;8079;8106;7.37;0.45;265.63;6.19;890;52;2773.00;27
7191;50;626343403;7191;300;8081;8106;7.43;0.45;265.59;6.19;890;52;2774.00;25
7194;50;626343416;7194;305;8082;8106;7.40;0.45;265.61;6.22;888;52;2775.00;24
7196;50;626343435;7196;299;8082;8106;7.41;0.45;265.59;6.22;886;52;2776.00;24
7198;50;626343448;7198;290;8082;8106;7.42;0.45;265.55;6.22;884;52;2777.00;24
7201;50;626343461;7201;277;8085;8110;7.50;0.46;265.62;6.22;884;52;2778.00;25
7206;50;626343480;7206;276;8085;8110;7.53;0.46;265.67;6.22;879;52;2779.00;25
7207;50;626343493;7207;270;8089;8114;7.63;0.46;265.67;6.25;882;52;2780.00;25
7207;50;626343507;7207;265;8091;8115;7.73;0.47;265.67;6.24;884;52;2781.00;24
7209;50;626343521;7209;268;8091;8115;7.77;0.47;265.62;6.24;882;52;2782.00;24
7210;50;626343534;7210;268;8091;8115;7.78;0.47;265.68;6.24;881;52;2783.00;24
7213;51;626343547;7213;275;8102;8128;7.90;0.48;265.66;6.24;889;53;2784.00;26
7216;51;626343575;7216;275;8102;8128;7.96;0.49;265.60;6.24;886;53;2785.00;26
7219;51;626343588;7219;282;8102;8128;8.00;0.49;265.59;6.24;883;53;2786.00;26
7221;51;626343601;7221;282;8103;8129;8.05;0.49;265.56;6.24;882;53;2787.00;26
7222;51;626343613;7222;280;8103;8130;8.05;0.49;265.56;6.24;881;53;2788.00;27
7224;51;626343626;7224;281;8104;8130;8.05;0.49;265.52;6.26;880;53;2789.00;26
7226;51;626343640;7226;280;8107;8136;8.04;0.49;265.52;6.26;881;53;2790.00;29
7227;51;626343653;7227;279;8108;8136;8.07;0.49;265.51;6.26;881;53;2791.00;28
7229;51;626343665;7229;278;8108;8136;8.00;0.49;265.50;6.26;879;53;2792.00;28
7231;51;626343678;7231;282;8109;8136;7.92;0.48;265.48;6.26;878;53;2793.00;27
7232;51;626343690;7232;280;8112;8142;7.80;0.47;265.45;6.25;880;53;2794.00;30
7233;51;626343703;7233;282;8113;8142;7.67;0.47;265.45;6.25;880;53;2795.00;29
7236;51;626343714;7236;291;8113;8142;7.55;0.46;265.41;6.25;877;53;2796.00;29
7238;51;626343726;7238;298;8114;8142;7.48;0.45;265.40;6.25;876;53;2797.00;28
7238;51;626343738;7238;304;8117;8146;7.38;0.45;265.40;6.25;879;53;2798.00;29
7240;51;626343750;7240;314;8119;8147;7.28;0.44;265.37;6.25;879;53;2799.00;28
7241;51;626343767;7241;317;8119;8147;7.25;0.44;265.36;6.25;878;53;2800.00;28
7242;51;626343783;7242;325;8120;8148;7.22;0.44;265.36;6.25;878;53;2801.00;28
7247;51;626343794;7247;331;8120;8148;7.10;0.43;265.51;6.25;873;53;2802.00;28
7249;51;626343813;7249;322;8120;8148;7.03;0.43;265.48;6.25;871;53;2803.00;28
7250;51;626343824;7250;316;8120;8148;6.91;0.42;265.46;6.25;870;53;2804.00;28
7250;51;626343839;7250;308;8120;8148;6.89;0.42;265.46;6.25;870;53;2805.00;28
7252;51;626343851;7252;302;8120;8148;6.86;0.42;265.45;6.25;868;53;2806.00;28
7252;51;626343862;7252;296;8121;8148;6.87;0.42;265.45;6.28;869;53;2807.00;27
7252;51;626343873;7252;311;8163;8218;6.93;0.42;265.45;6.24;911;53;2808.00;55
7252;51;626343890;7252;297;8163;8219;6.94;0.42;265.45;6.24;911;53;2809.00;56
7254;51;626343908;7254;288;8169;8219;7.07;0.43;265.45;6.24;915;53;2810.00;50
7255;51;626343919;7255;274;8174;8219;7.19;0.44;265.44;6.24;919;53;2811.00;45
7257;51;626343930;7257;267;8179;8219;7.28;0.44;265.44;6.24;922;53;2812.00;40
7257;51;626343942;7257;257;8183;8219;7.34;0.45;265.44;6.24;926;53;2813.00;36
7258;51;626343953;7258;251;8184;8219;7.37;0.45;265.43;6.24;926;53;2814.00;35
7259;52;626343965;7259;243;8185;8219;7.42;0.45;265.43;6.24;926;54;2815.00;34
7262;52;626343986;7262;242;8187;8220;7.46;0.45;265.40;6.24;925;54;2816.00;33
7262;52;626343998;7262;241;8188;8221;7.48;0.46;265.40;6.24;926;54;2817.00;33
7263;53;626344015;7263;243;8189;8221;7.46;0.45;265.38;6.24;926;55;2818.00;32
7264;53;626344046;7264;241;8192;8225;7.46;0.45;265.37;6.23;928;55;2819.00;33
7266;53;626344059;7266;242;8192;8225;7.47;0.46;265.35;6.23;926;55;2820.00;33
7267;53;626344070;7267;246;8192;8225;7.54;0.46;265.36;6.23;925;55;2821.00;33
7268;53;626344081;7268;242;8193;8225;7.54;0.46;265.34;6.26;925;55;2822.00;32
7270;53;626344092;7270;224;8196;8231;7.54;0.46;265.33;6.25;926;55;2823.00;35
7274;53;626344104;7274;229;8197;8231;7.52;0.46;265.34;6.25;923;55;2824.00;34
7279;53;626344116;7279;223;8200;8231;7.45;0.45;265.40;6.29;921;55;2825.00;31
7283;53;626344128;7283;219;8202;8234;7.50;0.46;265.48;6.29;919;55;2826.00;32
7283;53;626344140;7283;213;8202;8234;7.56;0.46;265.48;6.29;919;55;2827.00;32
7285;53;626344150;7285;210;8203;8234;7.61;0.46;265.49;6.29;918;55;2828.00;31
7291;53;626344161;7291;206;8204;8235;7.65;0.47;265.44;6.31;913;55;2829.00;31
7295;53;626344172;7295;200;8205;8236;7.70;0.47;265.44;6.31;910;55;2830.00;31
7296;53;626344184;7296;191;8206;8236;7.79;0.47;265.45;6.33;910;55;2831.00;30
7299;53;626344195;7299;185;8216;8249;7.78;0.47;265.51;6.32;917;55;2832.00;33
7300;53;626344207;7300;181;8217;8249;7.78;0.47;265.51;6.34;917;55;2833.00;32
7305;53;626344218;7305;185;8217;8249;7.80;0.47;265.59;6.34;912;55;2834.00;32
7309;53;626344229;7309;180;8220;8251;7.84;0.48;265.67;6.35;911;55;2835.00;31
7312;53;626344241;7312;184;8220;8251;7.82;0.48;265.61;6.35;908;55;2836.00;31
7316;53;626344253;7316;183;8224;8255;7.84;0.48;265.61;6.36;908;55;2837.00;31
7320;53;626344265;7320;180;8225;8255;7.86;0.48;265.60;6.35;905;55;2838.00;30
7324;53;626344276;7324;180;8229;8259;7.89;0.48;265.66;6.35;905;55;2839.00;30
7327;53;626344287;7327;184;8231;8259;7.88;0.48;265.71;6.36;904;55;2840.00;28
7328;53;626344298;7328;188;8231;8259;7.93;0.48;265.78;6.36;903;55;2841.00;28
7332;53;626344309;7332;191;8231;8259;7.88;0.48;265.77;6.36;899;55;2842.00;28
7335;53;626344320;7335;190;8231;8259;7.83;0.48;265.87;6.36;896;55;2843.00;28
7338;53;626344331;7338;190;8240;8271;7.88;0.48;265.87;6.35;902;55;2844.00;31
7339;53;626344343;7339;192;8241;8271;7.90;0.48;265.87;6.35;902;55;2845.00;30
7343;53;626344355;7343;187;8242;8271;7.91;0.48;265.90;6.35;899;55;2846.00;29
7346;53;626344366;7346;193;8242;8271;7.94;0.48;265.99;6.35;896;55;2847.00;29
7349;53;626344377;7349;197;8242;8271;7.98;0.48;266.07;6.35;893;55;2848.00;29
7352;53;626344388;7352;191;8243;8271;8.01;0.49;266.08;6.36;891;55;2849.00;28
7353;53;626344402;7353;203;8245;8274;8.02;0.49;266.11;6.36;892;55;2850.00;29
7354;53;626344414;7354;200;8245;8274;8.07;0.49;266.12;6.36;891;55;2851.00;29
7358;53;626344425;7358;199;8250;8280;8.15;0.50;266.19;6.37;892;55;2852.00;30
7359;53;626344437;7359;199;8252;8281;8.15;0.50;266.20;6.37;893;55;2853.00;29
7364;53;626344449;7364;199;8254;8281;8.17;0.50;266.25;6.40;890;55;2854.00;27
7369;53;626344461;7369;198;8254;8281;8.22;0.50;266.33;6.40;885;55;2855.00;27
7374;53;626344473;7374;200;8258;8285;8.31;0.50;266.40;6.41;884;55;2856.00;27
7375;53;626344486;7375;207;8258;8285;8.35;0.51;266.41;6.41;883;55;2857.00;27
7376;53;626344498;7376;205;8259;8285;8.42;0.51;266.45;6.42;883;55;2858.00;26
7376;53;626344510;7376;199;8261;8286;8.48;0.52;266.45;6.43;885;55;2859.00;25
7381;53;626344523;7381;203;8265;8290;8.44;0.51;266.42;6.44;884;55;2860.00;25
7383;53;626344536;7383;205;8266;8290;8.42;0.51;266.47;6.45;883;55;2861.00;24
7386;53;626344551;7386;210;8270;8293;8.41;0.51;266.44;6.47;884;55;2862.00;23
7389;53;626344563;7389;212;8272;8293;8.45;0.51;266.48;6.48;883;55;2863.00;21
7390;53;626344575;7390;218;8276;8295;8.45;0.51;266.50;6.50;886;55;2864.00;19
7393;53;626344588;7393;215;8276;8295;8.46;0.52;266.63;6.50;883;55;2865.00;19
7395;53;626344600;7395;223;8279;8299;8.47;0.52;266.65;6.50;884;55;2866.00;20
7397;53;626344613;7397;226;8282;8299;8.37;0.51;266.69;6.52;885;55;2867.00;17
7399;53;626344623;7399;222;8283;8299;8.32;0.51;266.71;6.52;884;55;2868.00;16
7402;53;626344634;7402;218;8284;8299;8.23;0.50;266.70;6.53;882;55;2869.00;15
7404;53;626344645;7404;214;8284;8300;8.11;0.49;266.75;6.53;880;55;2870.00;16
7406;53;626344655;7406;215;8287;8301;8.02;0.49;266.78;6.55;881;55;2871.00;14
7410;53;626344666;7410;217;8287;8301;7.93;0.48;266.78;6.55;877;55;2872.00;14
7415;53;626344678;7415;212;8288;8302;7.89;0.48;266.81;6.55;873;55;2873.00;14
7417;53;626344689;7417;211;8290;8302;7.86;0.48;266.82;6.56;873;55;2874.00;12
7421;53;626344699;7421;216;8291;8302;7.83;0.48;266.87;6.57;870;55;2875.00;11
7424;53;626344710;7424;220;8292;8302;7.83;0.48;266.92;6.57;868;55;2876.00;10
7427;53;626344721;7427;220;8292;8302;7.80;0.47;266.97;6.57;865;55;2877.00;10
7429;53;626344731;7429;218;8294;8302;7.77;0.47;267.05;6.58;865;55;2878.00;8
7431;53;626344741;7431;222;8295;8302;7.79;0.47;267.11;6.59;864;55;2879.00;7
7432;53;626344753;7432;260;8400;8532;7.83;0.49;267.15;6.51;968;55;2880.00;132
7436;53;626344782;7436;256;8404;8533;7.71;0.48;267.17;6.51;968;55;2881.00;129
7439;53;626344794;7439;241;8414;8533;7.73;0.48;267.19;6.51;975;55;2882.00;119
7444;53;626344805;7444;244;8421;8533;7.74;0.48;267.17;6.51;977;55;2883.00;112
7447;53;626344816;7447;241;8425;8533;7.76;0.48;267.20;6.51;978;55;2884.00;108
7454;53;626344827;7454;243;8431;8533;7.70;0.48;267.30;6.51;977;55;2885.00;102
7459;53;626344851;7459;251;8439;8533;7.68;0.48;267.36;6.51;980;55;2886.00;94
7462;53;626344871;7462;257;8444;8533;7.63;0.47;267.39;6.51;982;55;2887.00;89
7470;53;626344888;7470;262;8452;8534;7.51;0.46;267.45;6.52;982;55;2888.00;82
7472;53;626344906;7472;269;8458;8535;7.44;0.46;267.51;6.52;986;55;2889.00;77
7476;53;626344922;7476;257;8461;8535;7.33;0.45;267.55;6.52;985;55;2890.00;74
7481;53;626344939;7481;261;8464;8536;7.21;0.45;267.58;6.52;983;55;2891.00;72
7485;53;626344954;7485;267;8469;8536;7.08;0.44;267.61;6.52;984;55;2892.00;67
7489;53;626344968;7489;276;8472;8536;6.94;0.43;267.69;6.52;983;55;2893.00;64
7491;53;626344981;7491;286;8476;8536;6.81;0.42;267.73;6.53;985;55;2894.00;60
7493;53;626344995;7493;292;8480;8540;6.64;0.41;267.78;6.53;987;55;2895.00;60
7495;53;626345009;7495;296;8483;8540;6.57;0.41;267.82;6.53;988;55;2896.00;57
7498;53;626345022;7498;300;8487;8540;6.51;0.40;267.86;6.54;989;55;2897.00;53
7500;53;626345036;7500;300;8491;8543;6.49;0.40;267.88;6.54;991;55;2898.00;52
7506;53;626345049;7506;303;8493;8543;6.51;0.40;267.91;6.54;987;55;2899.00;50
7508;53;626345063;7508;301;8495;8543;6.59;0.41;267.91;6.55;987;55;2900.00;48
7513;53;626345080;7513;301;8499;8547;6.66;0.41;267.95;6.55;986;55;2901.00;48
7519;53;626345100;7519;294;8502;8548;6.64;0.41;268.02;6.55;983;55;2902.00;46
7520;53;626345112;7520;294;8502;8548;6.76;0.41;268.03;6.55;982;55;2903.00;46
7525;53;626345124;7525;296;8510;8552;6.78;0.42;268.08;6.56;985;55;2904.00;42
7528;53;626345137;7528;299;8513;8552;6.74;0.41;268.05;6.56;985;55;2905.00;39
7533;53;626345158;7533;304;8513;8552;6.73;0.41;268.11;6.56;980;55;2906.00;39
7535;53;626345170;7535;299;8518;8553;6.69;0.41;268.18;6.57;983;55;2907.00;35
7537;53;626345183;7537;304;8519;8553;6.71;0.41;268.20;6.57;982;55;2908.00;34
7541;53;626345196;7541;309;8524;8559;6.70;0.41;268.20;6.57;983;55;2909.00;35
7545;53;626345211;7545;313;8527;8559;6.66;0.41;268.26;6.58;982;55;2910.00;32
7552;53;626345224;7552;322;8528;8560;6.66;0.41;268.26;6.58;976;55;2911.00;32
7554;53;626345237;7554;333;8531;8560;6.66;0.41;268.28;6.59;977;55;2912.00;29
7555;53;626345260;7555;343;8531;8560;6.67;0.41;268.29;6.59;976;55;2913.00;29
7559;53;626345273;7559;350;8532;8560;6.62;0.41;268.28;6.59;973;55;2914.00;28
7561;53;626345286;7561;351;8532;8560;6.60;0.41;268.28;6.59;971;55;2915.00;28
7564;53;626345299;7564;354;8544;8572;6.58;0.41;268.30;6.59;980;55;2916.00;28
7567;53;626345312;7567;358;8544;8572;6.55;0.41;268.44;6.59;977;55;2917.00;28
7572;53;626345325;7572;361;8545;8572;6.56;0.41;268.41;6.59;973;55;2918.00;27
7577;53;626345338;7577;367;8546;8572;6.53;0.40;268.47;6.59;969;55;2919.00;26
7579;53;626345351;7579;366;8546;8572;6.52;0.40;268.54;6.59;967;55;2920.00;26
7583;53;626345364;7583;365;8547;8572;6.47;0.40;268.55;6.59;964;55;2921.00;25
7587;53;626345377;7587;366;8550;8576;6.48;0.40;268.54;6.59;963;55;2922.00;26
7590;53;626345391;7590;370;8551;8576;6.50;0.40;268.51;6.60;961;55;2923.00;25
7594;53;626345403;7594;367;8554;8580;6.57;0.40;268.61;6.59;960;55;2924.00;26
7600;53;626345416;7600;363;8557;8582;6.63;0.41;268.59;6.59;957;55;2925.00;25
7601;53;626345429;7601;357;8557;8582;6.64;0.41;268.59;6.59;956;55;2926.00;25
7605;53;626345441;7605;361;8557;8582;6.58;0.40;268.54;6.59;952;55;2927.00;25
7607;53;626345455;7607;363;8567;8595;6.67;0.41;268.53;6.58;960;55;2928.00;28
7613;53;626345468;7613;363;8567;8595;6.59;0.40;268.41;6.58;954;55;2929.00;28
7614;53;626345480;7614;362;8567;8595;6.56;0.40;268.38;6.58;953;55;2930.00;28
7615;53;626345493;7615;370;8568;8596;6.52;0.40;268.36;6.58;953;55;2931.00;28
7619;53;626345505;7619;377;8568;8597;6.46;0.40;268.32;6.58;949;55;2932.00;29
7620;53;626345518;7620;389;8568;8597;6.43;0.39;268.30;6.58;948;55;2933.00;29
7622;53;626345530;7622;398;8571;8600;6.43;0.39;268.29;6.59;949;55;2934.00;29
7624;53;626345542;7624;405;8571;8600;6.39;0.39;268.26;6.59;947;55;2935.00;29
7626;53;626345556;7626;408;8573;8600;6.36;0.39;268.21;6.59;947;55;2936.00;27
7628;53;626345568;7628;399;8573;8600;6.29;0.39;268.19;6.59;945;55;2937.00;27
7629;53;626345581;7629;396;8577;8606;6.30;0.39;268.22;6.59;948;55;2938.00;29
7631;53;626345594;7631;394;8577;8606;6.27;0.39;268.20;6.59;946;55;2939.00;29
7636;53;626345608;7636;391;8579;8606;6.28;0.39;268.10;6.60;943;55;2940.00;27
7636;53;626345621;7636;392;8579;8606;6.35;0.39;268.10;6.60;943;55;2941.00;27
7640;53;626345633;7640;389;8582;8610;6.42;0.39;268.04;6.59;942;55;2942.00;28
7642;53;626345647;7642;391;8583;8611;6.49;0.40;268.04;6.59;941;55;2943.00;28
7646;53;626345659;7646;390;8583;8611;6.56;0.40;268.11;6.59;937;55;2944.00;28
7649;53;626345672;7649;393;8584;8612;6.56;0.40;268.09;6.59;935;55;2945.00;28
7652;53;626345696;7652;379;8584;8612;6.62;0.40;268.05;6.59;932;55;2946.00;28
7656;53;626345708;7656;369;8584;8612;6.65;0.40;267.96;6.59;928;55;2947.00;28
7657;53;626345728;7657;362;8585;8612;6.74;0.41;267.96;6.60;928;55;2948.00;27
7658;53;626345740;7658;352;8585;8612;6.81;0.41;267.96;6.60;927;55;2949.00;27
7660;53;626345753;7660;347;8585;8612;6.91;0.42;267.96;6.60;925;55;2950.00;27
7660;53;626345765;7660;340;8585;8612;7.00;0.43;267.96;6.60;925;55;2951.00;27
7660;53;626345777;7660;343;8619;8682;7.28;0.44;267.96;6.57;959;55;2952.00;63
7662;53;626345795;7662;333;8620;8683;7.34;0.45;268.02;6.57;958;55;2953.00;63
7662;53;626345809;7662;327;8627;8683;7.45;0.45;268.02;6.57;965;55;2954.00;56
7662;53;626345823;7662;320;8630;8683;7.57;0.46;268.02;6.57;968;55;2955.00;53
7663;53;626345843;7663;311;8633;8683;7.59;0.46;268.04;6.57;970;55;2956.00;50
7665;53;626345856;7665;310;8636;8683;7.61;0.46;268.04;6.57;971;55;2957.00;47
7667;53;626345869;7667;300;8637;8683;7.62;0.46;268.03;6.57;970;55;2958.00;46
7667;53;626345884;7667;293;8641;8683;7.65;0.47;268.03;6.57;974;55;2959.00;42
7668;53;626345897;7668;288;8642;8684;7.69;0.47;268.02;6.57;974;55;2960.00;42
7669;53;626345910;7669;285;8646;8685;7.73;0.47;268.01;6.57;977;55;2961.00;39
7670;53;626345929;7670;286;8648;8685;7.73;0.47;268.00;6.57;978;55;2962.00;37
7673;53;626345942;7673;280;8651;8689;7.67;0.47;267.99;6.56;978;55;2963.00;38
7673;53;626345956;7673;277;8651;8689;7.67;0.47;267.99;6.56;978;55;2964.00;38
7676;53;626345970;7676;285;8651;8689;7.65;0.47;268.07;6.56;975;55;2965.00;38
7679;53;626345982;7679;282;8651;8689;7.64;0.47;268.02;6.56;972;55;2966.00;38
7681;53;626345995;7681;281;8654;8695;7.69;0.47;268.02;6.56;973;55;2967.00;41
7684;53;626346009;7684;277;8654;8695;7.70;0.47;268.01;6.56;970;55;2968.00;41
7685;53;626346022;7685;273;8656;8695;7.69;0.47;268.00;6.57;971;55;2969.00;39
7687;53;626346036;7687;278;8659;8701;7.68;0.47;267.98;6.57;972;55;2970.00;42
7688;53;626346050;7688;276;8660;8701;7.69;0.47;267.97;6.57;972;55;2971.00;41
7688;53;626346063;7688;276;8660;8701;7.70;0.47;267.97;6.57;972;55;2972.00;41
7688;53;626346075;7688;277;8661;8702;7.74;0.47;267.97;6.57;973;55;2973.00;41
7689;53;626346093;7689;282;8662;8703;7.77;0.47;267.94;6.57;973;55;2974.00;41
7689;53;626346106;7689;282;8663;8703;7.79;0.47;267.94;6.57;974;55;2975.00;40
7694;53;626346119;7694;286;8671;8716;7.79;0.47;267.99;6.56;977;55;2976.00;45
7695;53;626346132;7695;288;8672;8716;7.78;0.47;267.98;6.56;977;55;2977.00;44
7698;53;626346146;7698;290;8672;8716;7.75;0.47;268.05;6.56;974;55;2978.00;44
7699;53;626346158;7699;294;8673;8717;7.75;0.47;268.03;6.56;974;55;2979.00;44
7699;53;626346171;7699;292;8673;8717;7.74;0.47;268.03;6.56;974;55;2980.00;44
7701;53;626346184;7701;286;8675;8721;7.76;0.47;267.99;6.56;974;55;2981.00;46
7705;53;626346196;7705;285;8675;8721;7.73;0.47;268.10;6.56;970;55;2982.00;46
7707;53;626346209;7707;285;8679;8725;7.75;0.47;268.10;6.56;972;55;2983.00;46
7711;53;626346222;7711;283;8680;8725;7.70;0.47;268.16;6.57;969;55;2984.00;45
7711;53;626346235;7711;276;8680;8725;7.73;0.47;268.16;6.57;969;55;2985.00;45
7716;53;626346247;7716;283;8680;8725;7.69;0.47;268.29;6.57;964;55;2986.00;45
7717;53;626346260;7717;279;8680;8725;7.71;0.47;268.30;6.57;963;55;2987.00;45
7721;53;626346271;7721;282;8689;8737;7.69;0.47;268.31;6.56;968;55;2988.00;48
7725;53;626346284;7725;275;8690;8737;7.64;0.47;268.36;6.56;965;55;2989.00;47
7727;53;626346296;7727;272;8692;8737;7.68;0.47;268.33;6.56;965;55;2990.00;45
7733;53;626346308;7733;266;8692;8737;7.58;0.46;268.46;6.56;959;55;2991.00;45
7737;53;626346319;7737;252;8692;8737;7.50;0.46;268.46;6.56;955;55;2992.00;45
7739;53;626346331;7739;243;8693;8737;7.45;0.45;268.42;6.58;954;55;2993.00;44
7744;53;626346343;7744;242;8695;8738;7.42;0.45;268.47;6.58;951;55;2994.00;43
7744;53;626346355;7744;238;8697;8738;7.42;0.45;268.47;6.61;953;55;2995.00;41
7748;53;626346368;7748;234;8700;8744;7.40;0.45;268.49;6.61;952;55;2996.00;44
7754;53;626346381;7754;235;8703;8745;7.44;0.45;268.61;6.62;949;55;2997.00;42
7756;53;626346394;7756;225;8704;8745;7.52;0.46;268.61;6.62;948;55;2998.00;41
7761;53;626346406;7761;226;8704;8745;7.57;0.46;268.70;6.62;943;55;2999.00;41
7764;53;626346420;7764;224;8709;8765;7.67;0.47;268.68;6.63;945;55;3000.00;56
7766;53;626346438;7766;213;8710;8765;7.71;0.47;268.68;6.63;944;55;3001.00;55
7772;53;626346451;7772;202;8710;8765;7.70;0.47;268.70;6.63;938;55;3002.00;55
7775;53;626346463;7775;197;8712;8766;7.73;0.47;268.77;6.64;937;55;3003.00;54
7778;53;626346476;7778;195;8715;8770;7.79;0.47;268.72;6.64;937;55;3004.00;55
7782;53;626346489;7782;195;8715;8770;7.83;0.47;268.72;6.64;933;55;3005.00;55
7783;53;626346501;7783;202;8719;8773;7.93;0.48;268.73;6.64;936;55;3006.00;54
7787;53;626346513;7787;200;8720;8773;8.01;0.48;268.79;6.65;933;55;3007.00;53
7788;53;626346525;7788;198;8720;8773;8.10;0.49;268.84;6.65;932;55;3008.00;53
7793;53;626346537;7793;201;8722;8773;8.14;0.49;268.91;6.66;929;55;3009.00;51
7797;53;626346549;7797;200;8724;8777;8.18;0.49;268.96;6.66;927;55;3010.00;53
7798;53;626346562;7798;199;8727;8777;8.21;0.50;268.95;6.66;929;55;3011.00;50
7801;53;626346574;7801;199;8729;8777;8.23;0.50;268.95;6.67;928;55;3012.00;48
7803;53;626346587;7803;195;8730;8777;8.29;0.50;269.08;6.67;927;55;3013.00;47
7804;53;626346599;7804;198;8733;8778;8.33;0.50;269.07;6.67;929;55;3014.00;45
7806;53;626346612;7806;201;8736;8780;8.39;0.51;269.10;6.67;930;55;3015.00;44
7810;53;626346625;7810;207;8737;8780;8.44;0.51;269.16;6.67;927;55;3016.00;43
7812;53;626346638;7812;203;8739;8781;8.49;0.51;269.21;6.67;927;55;3017.00;42
7815;53;626346650;7815;204;8740;8781;8.56;0.52;269.23;6.67;925;55;3018.00;41
7818;53;626346663;7818;208;8741;8781;8.59;0.52;269.31;6.68;923;55;3019.00;40
7824;53;626346677;7824;206;8742;8781;8.62;0.52;269.36;6.70;918;55;3020.00;39
7826;53;626346690;7826;212;8743;8781;8.65;0.52;269.33;6.71;917;55;3021.00;38
7828;53;626346703;7828;216;8744;8781;8.67;0.52;269.43;6.71;916;55;3022.00;37
7831;53;626346715;7831;218;8747;8781;8.71;0.53;269.48;6.74;916;55;3023.00;34
7834;53;626346727;7834;241;8811;8908;8.59;0.53;269.54;6.69;977;55;3024.00;97
7838;53;626346750;7838;233;8816;8909;8.56;0.52;269.59;6.71;978;55;3025.00;93
7839;53;626346763;7839;224;8824;8909;8.61;0.53;269.60;6.72;985;55;3026.00;85
7842;53;626346776;7842;227;8825;8909;8.59;0.53;269.63;6.71;983;55;3027.00;84
7844;53;626346789;7844;219;8835;8909;8.62;0.53;269.69;6.74;991;55;3028.00;74
7845;53;626346802;7845;225;8837;8909;8.67;0.53;269.67;6.74;992;55;3029.00;72
7848;53;626346817;7848;225;8841;8909;8.70;0.53;269.68;6.74;993;55;3030.00;68
7852;53;626346830;7852;224;8844;8909;8.67;0.53;269.72;6.76;992;55;3031.00;65
7856;53;626346848;7856;219;8847;8910;8.69;0.53;269.71;6.76;991;55;3032.00;63
7857;53;626346870;7857;222;8854;8911;8.73;0.53;269.74;6.78;997;55;3033.00;57
7859;53;626346892;7859;224;8858;8911;8.70;0.53;269.79;6.79;999;55;3034.00;53
7861;53;626346911;7861;225;8862;8912;8.60;0.53;269.84;6.80;1001;55;3035.00;50
7866;53;626346932;7866;233;8866;8912;8.53;0.52;269.96;6.81;1000;55;3036.00;46
7868;53;626346952;7868;235;8870;8912;8.50;0.52;270.03;6.82;1002;55;3037.00;42
7873;53;626346970;7873;242;8873;8912;8.39;0.52;270.06;6.83;1000;55;3038.00;39
7876;53;626346984;7876;251;8877;8916;8.31;0.51;270.06;6.84;1001;55;3039.00;39
7882;53;626346999;7882;252;8881;8916;8.17;0.50;270.10;6.84;999;55;3040.00;35
7883;53;626347014;7883;248;8883;8916;8.08;0.50;270.12;6.85;1000;55;3041.00;33
7886;53;626347036;7886;257;8885;8919;7.98;0.49;270.10;6.85;999;55;3042.00;34
7888;53;626347057;7888;267;8888;8919;7.96;0.49;270.17;6.87;1000;55;3043.00;31
7892;53;626347071;7892;268;8889;8919;7.91;0.49;270.22;6.87;997;55;3044.00;30
7894;53;626347085;7894;276;8894;8923;7.89;0.48;270.18;6.87;1000;55;3045.00;29
7898;53;626347099;7898;279;8897;8924;7.79;0.48;270.22;6.88;999;55;3046.00;27
7902;53;626347113;7902;286;8898;8924;7.73;0.47;270.32;6.89;996;55;3047.00;26
7903;53;626347126;7903;292;8902;8928;7.73;0.47;270.35;6.90;999;55;3048.00;26
7907;53;626347149;7907;297;8904;8928;7.70;0.47;270.42;6.90;997;55;3049.00;24
7910;53;626347163;7910;295;8904;8928;7.68;0.47;270.45;6.90;994;55;3050.00;24
7913;53;626347175;7913;294;8905;8929;7.59;0.46;270.45;6.90;992;55;3051.00;24
7918;53;626347189;7918;300;8905;8929;7.44;0.45;270.46;6.90;987;55;3052.00;24
7920;53;626347201;7920;304;8912;8935;7.34;0.45;270.54;6.91;992;55;3053.00;23
7925;53;626347214;7925;309;8912;8935;7.15;0.44;270.50;6.91;987;55;3054.00;23
7928;53;626347227;7928;310;8915;8936;7.01;0.43;270.52;6.92;987;55;3055.00;21
7933;53;626347239;7933;317;8917;8936;6.85;0.42;270.56;6.92;984;55;3056.00;19
7938;53;626347251;7938;323;8918;8936;6.70;0.41;270.60;6.92;980;55;3057.00;18
7942;53;626347263;7942;330;8919;8936;6.52;0.40;270.61;6.93;977;55;3058.00;17
7948;53;626347274;7948;344;8920;8936;6.36;0.39;270.64;6.93;972;55;3059.00;16
7951;53;626347296;7951;340;8942;8972;6.39;0.39;270.71;6.92;991;55;3060.00;30
7954;53;626347310;7954;332;8943;8972;6.27;0.39;270.79;6.92;989;55;3061.00;29
7958;53;626347322;7958;336;8947;8972;6.20;0.38;270.83;6.92;989;55;3062.00;25
7960;53;626347334;7960;336;8949;8972;6.17;0.38;270.87;6.92;989;55;3063.00;23
7962;53;626347346;7962;337;8951;8972;6.14;0.38;270.94;6.92;989;55;3064.00;21
7965;53;626347357;7965;342;8953;8972;6.13;0.38;271.00;6.92;988;55;3065.00;19
7968;53;626347369;7968;341;8957;8976;6.16;0.38;271.00;6.92;989;55;3066.00;19
7971;53;626347381;7971;343;8957;8976;6.12;0.38;271.06;6.92;986;55;3067.00;19
7974;53;626347392;7974;344;8960;8980;6.10;0.37;271.08;6.92;986;55;3068.00;20
7977;53;626347412;7977;342;8962;8981;6.06;0.37;271.11;6.92;985;55;3069.00;19
7978;53;626347424;7978;345;8963;8981;6.00;0.37;271.14;6.92;985;55;3070.00;18
7980;53;626347436;7980;352;8963;8981;5.96;0.37;271.20;6.92;983;55;3071.00;18
7986;53;626347448;7986;360;8974;8994;5.99;0.37;271.30;6.91;988;55;3072.00;20
7989;53;626347461;7989;360;8974;8994;5.96;0.37;271.38;6.91;985;55;3073.00;20
7992;53;626347473;7992;366;8974;8994;5.92;0.36;271.35;6.91;982;56;3074.00;20
7997;53;626347491;7997;361;8975;8995;5.86;0.36;271.33;6.91;978;56;3075.00;20
7999;53;626347503;7999;354;8975;8996;5.80;0.36;271.35;6.91;976;56;3076.00;21
8003;53;626347515;8003;357;8975;8996;5.74;0.35;271.34;6.91;972;56;3077.00;21
8005;53;626347526;8005;357;8977;8999;5.72;0.35;271.33;6.91;972;56;3078.00;22
8008;53;626347538;8008;362;8978;8999;5.70;0.35;271.32;6.90;970;56;3079.00;21
8013;53;626347549;8013;364;8978;8999;5.62;0.35;271.30;6.90;965;56;3080.00;21
8015;53;626347561;8015;366;8978;8999;5.62;0.35;271.30;6.90;963;56;3081.00;21
8019;53;626347573;8019;366;8982;9005;5.63;0.35;271.25;6.90;963;56;3082.00;23
8025;53;626347585;8025;363;8982;9005;5.65;0.35;271.17;6.90;957;56;3083.00;23
8031;53;626347598;8031;359;8983;9005;5.65;0.34;271.15;6.90;952;56;3084.00;22
8036;53;626347615;8036;362;8983;9005;5.61;0.34;271.09;6.90;947;56;3085.00;22
8040;53;626347627;8040;363;8986;9009;5.61;0.34;271.07;6.90;946;56;3086.00;23
8044;53;626347639;8044;365;8987;9010;5.60;0.34;271.03;6.90;943;56;3087.00;23
8048;53;626347651;8048;373;8987;9010;5.56;0.34;270.97;6.90;939;56;3088.00;23
8053;53;626347662;8053;377;8988;9011;5.49;0.34;270.92;6.90;935;56;3089.00;23
8059;53;626347675;8059;378;8989;9011;5.45;0.33;271.04;6.92;930;56;3090.00;22
8059;53;626347688;8059;381;8989;9011;5.50;0.34;271.04;6.92;930;56;3091.00;22
8062;53;626347698;8062;383;8989;9011;5.48;0.34;271.14;6.92;927;56;3092.00;22
8065;53;626347709;8065;385;8989;9011;5.50;0.34;271.13;6.92;924;56;3093.00;22
8066;53;626347720;8066;383;8989;9011;5.57;0.34;271.18;6.92;923;56;3094.00;22
8068;53;626347731;8068;385;8989;9011;5.61;0.35;271.18;6.92;921;56;3095.00;22
8069;53;626347742;8069;397;9027;9081;5.91;0.37;271.15;6.89;958;56;3096.00;54
8072;53;626347759;8072;395;9030;9082;5.92;0.37;271.16;6.89;958;56;3097.00;52
8078;53;626347772;8078;397;9035;9082;6.00;0.37;271.21;6.89;957;56;3098.00;47
8083;53;626347784;8083;393;9039;9082;6.06;0.37;271.19;6.89;956;56;3099.00;43
8084;53;626347797;8084;398;9041;9082;6.15;0.38;271.18;6.88;957;56;3100.00;41
8089;53;626347814;8089;397;9045;9082;6.20;0.38;271.21;6.88;956;56;3101.00;37
8091;53;626347827;8091;401;9046;9082;6.23;0.38;271.19;6.88;955;56;3102.00;36
8097;53;626347839;8097;394;9050;9082;6.20;0.38;271.17;6.88;953;56;3103.00;32
8098;53;626347852;8098;402;9054;9083;6.25;0.38;271.20;6.88;956;56;3104.00;29
8099;53;626347864;8099;408;9057;9085;6.27;0.38;271.18;6.88;958;56;3105.00;28
8100;53;626347884;8100;411;9058;9085;6.20;0.38;271.19;6.88;958;56;3106.00;27
8103;53;626347896;8103;394;9061;9089;6.18;0.38;271.14;6.88;958;56;3107.00;28
8104;53;626347909;8104;376;9061;9089;6.22;0.38;271.13;6.88;957;56;3108.00;28
8105;53;626347921;8105;365;9061;9089;6.27;0.38;271.13;6.88;956;56;3109.00;28
8109;53;626347933;8109;363;9061;9089;6.30;0.38;271.09;6.88;952;56;3110.00;28
8110;53;626347950;8110;356;9065;9095;6.41;0.39;271.08;6.88;955;56;3111.00;30
8113;53;626347964;8113;348;9065;9095;6.48;0.39;271.09;6.88;952;56;3112.00;30
8115;53;626347981;8115;342;9066;9095;6.56;0.40;271.09;6.88;951;56;3113.00;29
8118;53;626348004;8118;332;9069;9098;6.65;0.40;271.17;6.90;951;56;3114.00;29
8120;53;626348017;8120;325;9070;9098;6.79;0.41;271.13;6.90;950;56;3115.00;28
8120;53;626348029;8120;300;9070;9098;6.89;0.42;271.13;6.90;950;56;3116.00;28
8121;53;626348042;8121;284;9070;9099;6.97;0.42;271.12;6.90;949;56;3117.00;29
8122;54;626348055;8122;265;9071;9100;7.09;0.43;271.15;6.90;949;57;3118.00;29
8126;54;626348080;8126;252;9071;9100;7.23;0.44;271.12;6.90;945;57;3119.00;29
8127;54;626348095;8127;251;9091;9126;7.46;0.45;271.12;6.88;964;57;3120.00;35
8129;54;626348116;8129;237;9092;9126;7.61;0.46;271.10;6.88;963;57;3121.00;34
8131;54;626348129;8131;231;9093;9126;7.73;0.47;271.07;6.88;962;57;3122.00;33
8135;54;626348142;8135;231;9094;9127;7.82;0.47;271.07;6.88;959;57;3123.00;33
8136;55;626348156;8136;228;9094;9127;7.94;0.48;271.06;6.88;958;58;3124.00;33
8137;55;626348180;8137;222;9097;9131;8.04;0.49;271.05;6.88;960;58;3125.00;34
8137;55;626348195;8137;223;9097;9131;8.04;0.49;271.05;6.88;960;58;3126.00;34
8139;55;626348208;8139;220;9101;9135;8.11;0.49;271.10;6.88;962;58;3127.00;34
8140;55;626348221;8140;211;9102;9135;8.13;0.50;271.09;6.91;962;58;3128.00;33
8143;55;626348234;8143;216;9102;9135;8.14;0.50;271.12;6.91;959;58;3129.00;33
8143;55;626348254;8143;211;9102;9135;8.19;0.50;271.12;6.91;959;58;3130.00;33
8147;55;626348268;8147;208;9102;9135;8.19;0.50;271.15;6.91;955;58;3131.00;33
8151;55;626348281;8151;217;9112;9147;8.24;0.50;271.17;6.90;961;58;3132.00;35
8154;55;626348295;8154;214;9112;9147;8.28;0.50;271.16;6.90;958;58;3133.00;35
8154;55;626348308;8154;216;9113;9147;8.31;0.51;271.16;6.90;959;58;3134.00;34
8155;55;626348321;8155;216;9113;9147;8.33;0.51;271.16;6.90;958;58;3135.00;34
8162;55;626348334;8162;217;9113;9147;8.32;0.51;271.26;6.90;951;58;3136.00;34
8164;55;626348347;8164;226;9113;9147;8.36;0.51;271.26;6.90;949;58;3137.00;34
8167;55;626348360;8167;230;9113;9148;8.34;0.51;271.33;6.90;946;58;3138.00;35
8169;55;626348372;8169;232;9113;9148;8.40;0.51;271.38;6.90;944;58;3139.00;35
8172;55;626348387;8172;234;9117;9154;8.39;0.51;271.47;6.89;945;58;3140.00;37
8179;55;626348401;8179;240;9118;9155;8.34;0.51;271.48;6.89;939;58;3141.00;37
8182;55;626348419;8182;241;9119;9155;8.37;0.51;271.52;6.89;937;58;3142.00;36
8185;55;626348432;8185;244;9119;9155;8.27;0.50;271.52;6.89;934;58;3143.00;36
8190;55;626348444;8190;244;9123;9159;8.18;0.50;271.58;6.92;933;58;3144.00;36
8191;55;626348457;8191;250;9123;9159;8.21;0.50;271.59;6.92;932;58;3145.00;36
8193;55;626348470;8193;255;9123;9159;8.15;0.50;271.64;6.92;930;58;3146.00;36
8196;55;626348483;8196;250;9124;9160;8.07;0.49;271.73;6.92;928;58;3147.00;36
8197;55;626348496;8197;252;9127;9164;7.98;0.49;271.78;6.92;930;58;3148.00;37
8202;55;626348509;8202;261;9127;9164;7.92;0.48;271.81;6.92;925;58;3149.00;37
8206;55;626348522;8206;258;9130;9170;7.91;0.48;271.79;6.91;924;58;3150.00;40
8210;55;626348535;8210;255;9130;9170;7.91;0.48;271.76;6.91;920;58;3151.00;40
8212;55;626348547;8212;252;9131;9170;7.92;0.48;271.74;6.91;919;58;3152.00;39
8215;55;626348559;8215;252;9131;9170;7.94;0.48;271.77;6.91;916;58;3153.00;39
8219;55;626348571;8219;251;9134;9174;7.92;0.48;271.84;6.91;915;58;3154.00;40
8223;55;626348584;8223;239;9134;9174;7.96;0.48;271.89;6.91;911;58;3155.00;40
8226;55;626348597;8226;234;9135;9174;8.03;0.49;271.91;6.91;909;58;3156.00;39
8231;55;626348609;8231;235;9135;9174;8.09;0.49;271.97;6.91;904;58;3157.00;39
8233;55;626348621;8233;231;9136;9175;8.11;0.49;272.01;6.91;903;58;3158.00;39
8234;55;626348634;8234;229;9137;9176;8.15;0.50;272.05;6.91;903;58;3159.00;39
8238;55;626348648;8238;229;9138;9176;8.09;0.49;272.17;6.91;900;58;3160.00;38
8240;55;626348661;8240;225;9139;9177;8.04;0.49;272.24;6.91;899;58;3161.00;38
8244;55;626348673;8244;212;9139;9177;8.01;0.49;272.24;6.91;895;58;3162.00;38
8248;55;626348685;8248;197;9139;9177;8.05;0.49;272.22;6.91;891;58;3163.00;38
8252;55;626348698;8252;193;9141;9177;8.03;0.49;272.23;6.95;889;58;3164.00;36
8256;55;626348714;8256;191;9142;9177;8.10;0.49;272.21;6.96;886;58;3165.00;35
8259;55;626348729;8259;193;9142;9177;8.13;0.49;272.25;6.96;883;58;3166.00;35
8266;55;626348742;8266;191;9142;9177;8.12;0.49;272.32;6.96;876;58;3167.00;35
8266;55;626348754;8266;216;9212;9304;8.17;0.50;272.32;6.91;946;58;3168.00;92
8273;55;626348776;8273;201;9213;9305;8.20;0.50;272.34;6.91;940;58;3169.00;92
8275;55;626348788;8275;188;9220;9305;8.26;0.51;272.33;6.90;945;58;3170.00;85
8280;55;626348801;8280;193;9222;9305;8.31;0.51;272.31;6.90;942;58;3171.00;83
8284;55;626348813;8284;195;9224;9305;8.33;0.51;272.31;6.90;940;58;3172.00;81
8285;55;626348826;8285;199;9227;9305;8.41;0.52;272.35;6.90;942;58;3173.00;78
8288;55;626348842;8288;195;9230;9305;8.50;0.52;272.36;6.90;942;58;3174.00;75
8291;55;626348861;8291;195;9233;9305;8.61;0.53;272.41;6.90;942;58;3175.00;72
8295;55;626348881;8295;190;9236;9306;8.71;0.53;272.45;6.90;941;58;3176.00;70
8301;55;626348903;8301;188;9241;9307;8.82;0.54;272.42;6.92;940;58;3177.00;66
8306;55;626348923;8306;185;9243;9307;8.94;0.54;272.48;6.92;937;58;3178.00;64
8308;55;626348942;8308;182;9251;9308;9.02;0.55;272.52;6.92;943;58;3179.00;57
8310;55;626348968;8310;181;9252;9308;9.04;0.55;272.52;6.92;942;58;3180.00;56
8313;55;626348983;8313;185;9255;9308;9.06;0.55;272.54;6.92;942;58;3181.00;53
8315;55;626348997;8315;185;9258;9308;9.01;0.55;272.62;6.92;943;58;3182.00;50
8319;55;626349011;8319;194;9261;9312;8.98;0.55;272.75;6.92;942;58;3183.00;51
8319;55;626349027;8319;192;9263;9312;9.03;0.55;272.75;6.93;944;58;3184.00;49
8323;55;626349040;8323;195;9264;9312;9.04;0.55;272.78;6.93;941;58;3185.00;48
8329;55;626349055;8329;199;9268;9315;9.00;0.55;272.77;6.94;939;58;3186.00;47
8329;55;626349071;8329;208;9270;9315;9.05;0.55;272.77;6.95;941;58;3187.00;45
8333;55;626349085;8333;208;9271;9315;9.06;0.55;272.87;6.95;938;58;3188.00;44
8335;55;626349100;8335;215;9274;9319;9.05;0.55;272.92;6.95;939;58;3189.00;45
8339;55;626349115;8339;211;9278;9320;9.06;0.55;273.00;6.98;939;58;3190.00;42
8341;55;626349129;8341;226;9281;9322;9.01;0.55;273.00;6.99;940;58;3191.00;41
8344;55;626349143;8344;228;9285;9326;8.99;0.55;273.04;7.00;941;58;3192.00;41
8346;55;626349157;8346;229;9286;9326;8.92;0.54;273.05;7.01;940;58;3193.00;40
8350;55;626349170;8350;235;9286;9326;8.95;0.54;273.08;7.01;936;58;3194.00;40
8352;56;626349184;8352;237;9290;9328;8.96;0.55;273.13;7.03;938;59;3195.00;38
8356;56;626349210;8356;236;9290;9328;8.96;0.55;273.25;7.03;934;59;3196.00;38
8357;56;626349224;8357;241;9295;9334;8.92;0.54;273.27;7.04;938;59;3197.00;39
8361;56;626349244;8361;238;9296;9334;8.80;0.54;273.30;7.05;935;59;3198.00;38
8362;56;626349265;8362;238;9298;9335;8.73;0.53;273.35;7.06;936;59;3199.00;37
8365;56;626349279;8365;249;9299;9335;8.58;0.52;273.41;7.07;934;59;3200.00;36
8367;56;626349301;8367;254;9300;9335;8.48;0.52;273.44;7.08;933;59;3201.00;35
8370;56;626349315;8370;258;9301;9335;8.41;0.51;273.40;7.09;931;59;3202.00;34
8373;56;626349328;8373;259;9301;9335;8.30;0.51;273.42;7.09;928;59;3203.00;34
8374;56;626349342;8374;260;9313;9347;8.29;0.51;273.41;7.10;939;59;3204.00;34
8378;56;626349355;8378;268;9313;9347;8.21;0.50;273.49;7.10;935;59;3205.00;34
8382;56;626349367;8382;266;9315;9347;8.20;0.50;273.55;7.10;933;59;3206.00;32
8384;56;626349380;8384;266;9316;9347;8.12;0.50;273.58;7.11;932;59;3207.00;31
8389;56;626349392;8389;273;9317;9347;8.08;0.50;273.59;7.11;928;59;3208.00;30
8391;56;626349404;8391;275;9318;9347;8.05;0.49;273.57;7.12;927;59;3209.00;29
8393;56;626349418;8393;282;9322;9351;8.01;0.49;273.62;7.12;929;59;3210.00;29
8394;56;626349430;8394;281;9322;9351;8.02;0.49;273.60;7.12;928;59;3211.00;29
8396;56;626349441;8396;279;9326;9355;8.03;0.49;273.67;7.13;930;59;3212.00;29
8397;56;626349454;8397;282;9327;9356;8.01;0.49;273.69;7.13;930;59;3213.00;29
8399;56;626349466;8399;281;9328;9356;7.94;0.49;273.68;7.13;929;59;3214.00;28
8402;56;626349480;8402;276;9329;9356;7.84;0.48;273.69;7.14;927;59;3215.00;27
8403;56;626349499;8403;276;9340;9369;7.78;0.48;273.73;7.13;937;59;3216.00;29
8403;56;626349511;8403;279;9341;9369;7.75;0.48;273.73;7.14;938;59;3217.00;28
8406;56;626349522;8406;278;9342;9369;7.75;0.48;273.70;7.14;936;59;3218.00;27
8408;56;626349534;8408;288;9343;9370;7.71;0.47;273.74;7.14;935;59;3219.00;27
8409;56;626349552;8409;290;9346;9371;7.65;0.47;273.72;7.17;937;59;3220.00;25
8416;56;626349565;8416;297;9346;9371;7.58;0.46;273.87;7.17;930;59;3221.00;25
8418;56;626349577;8418;299;9348;9374;7.54;0.46;273.85;7.16;930;59;3222.00;26
8424;56;626349588;8424;305;9349;9374;7.42;0.45;273.86;7.17;925;59;3223.00;25
8427;56;626349599;8427;311;9350;9374;7.32;0.45;273.93;7.17;923;59;3224.00;24
8430;56;626349611;8430;315;9353;9374;7.21;0.44;273.91;7.19;923;59;3225.00;21
8436;56;626349622;8436;321;9357;9380;7.10;0.43;273.89;7.19;921;59;3226.00;23
8440;56;626349634;8440;326;9358;9380;6.95;0.43;273.90;7.19;918;59;3227.00;22
8443;56;626349645;8443;333;9361;9380;6.76;0.41;273.89;7.20;918;59;3228.00;19
8446;56;626349655;8446;346;9361;9380;6.59;0.40;273.89;7.20;915;59;3229.00;19
8449;56;626349665;8449;335;9364;9384;6.48;0.40;273.91;7.20;915;59;3230.00;20
8451;56;626349676;8451;328;9366;9385;6.40;0.39;273.96;7.20;915;59;3231.00;19
8454;56;626349686;8454;325;9367;9385;6.30;0.39;273.98;7.21;913;59;3232.00;18
8456;56;626349696;8456;323;9368;9386;6.26;0.39;274.02;7.21;912;59;3233.00;18
8459;56;626349706;8459;330;9370;9386;6.18;0.38;274.01;7.22;911;59;3234.00;16
8461;56;626349717;8461;328;9370;9386;6.11;0.38;274.01;7.22;909;59;3235.00;16
8467;56;626349727;8467;332;9372;9386;6.05;0.37;273.93;7.22;905;59;3236.00;14
8470;56;626349737;8470;338;9372;9386;6.05;0.37;273.90;7.22;902;59;3237.00;14
8477;56;626349748;8477;332;9372;9386;6.05;0.37;273.81;7.22;895;59;3238.00;14
8481;56;626349759;8481;333;9374;9386;6.00;0.37;273.80;7.23;893;59;3239.00;12
8483;56;626349771;8483;339;9429;9511;6.37;0.39;273.81;7.19;946;59;3240.00;82
8486;56;626349791;8486;333;9433;9512;6.39;0.40;273.84;7.18;947;59;3241.00;79
8490;56;626349802;8490;341;9443;9512;6.46;0.40;273.84;7.18;953;59;3242.00;69
8492;56;626349814;8492;343;9450;9512;6.52;0.40;273.84;7.18;958;59;3243.00;62
8496;56;626349825;8496;348;9455;9512;6.53;0.40;273.91;7.17;959;59;3244.00;57
8497;56;626349837;8497;351;9458;9512;6.54;0.40;273.92;7.17;961;59;3245.00;54
8500;56;626349849;8500;349;9463;9512;6.52;0.40;273.91;7.17;963;59;3246.00;49
8503;56;626349860;8503;343;9466;9512;6.49;0.40;273.94;7.17;963;59;3247.00;46
8505;56;626349871;8505;349;9469;9513;6.43;0.40;273.97;7.17;964;59;3248.00;44
8510;56;626349882;8510;349;9470;9514;6.38;0.39;273.93;7.17;960;59;3249.00;44
8512;56;626349894;8512;352;9472;9514;6.36;0.39;273.95;7.17;960;59;3250.00;42
8515;56;626349905;8515;361;9478;9518;6.33;0.39;273.92;7.17;963;59;3251.00;40
8516;56;626349917;8516;361;9479;9518;6.33;0.39;273.95;7.17;963;59;3252.00;39
8522;56;626349934;8522;370;9481;9518;6.26;0.39;273.89;7.17;959;59;3253.00;37
8523;56;626349946;8523;374;9482;9518;6.23;0.39;273.89;7.17;959;59;3254.00;36
8526;56;626349957;8526;374;9487;9524;6.18;0.38;273.90;7.17;961;59;3255.00;37
8528;56;626349969;8528;386;9487;9524;6.21;0.38;273.90;7.17;959;59;3256.00;37
8530;56;626349981;8530;385;9489;9524;6.20;0.38;273.88;7.17;959;59;3257.00;35
8533;56;626349992;8533;382;9492;9527;6.16;0.38;273.88;7.17;959;59;3258.00;35
8537;56;626350004;8537;374;9492;9527;6.10;0.38;273.92;7.17;955;59;3259.00;35
8542;56;626350016;8542;361;9493;9527;6.05;0.37;273.85;7.19;951;59;3260.00;34
8546;56;626350028;8546;358;9493;9528;6.01;0.37;273.84;7.19;947;59;3261.00;35
8551;56;626350039;8551;354;9494;9529;6.03;0.37;273.81;7.19;943;59;3262.00;35
8553;56;626350050;8553;354;9494;9529;6.05;0.37;273.83;7.19;941;59;3263.00;35
8558;57;626350062;8558;358;9505;9542;6.12;0.38;273.86;7.19;947;60;3264.00;37
8560;57;626350086;8560;350;9505;9542;6.19;0.38;273.86;7.19;945;60;3265.00;37
8565;57;626350103;8565;347;9505;9542;6.28;0.39;273.89;7.19;940;60;3266.00;37
8569;57;626350115;8569;344;9506;9543;6.40;0.39;273.86;7.18;937;60;3267.00;37
8574;57;626350127;8574;343;9506;9543;6.50;0.40;273.91;7.18;932;60;3268.00;37
8578;57;626350139;8578;342;9509;9547;6.56;0.40;273.92;7.18;931;60;3269.00;38
8580;57;626350154;8580;345;9509;9547;6.58;0.40;273.92;7.18;929;60;3270.00;38
8583;57;626350165;8583;341;9513;9551;6.70;0.41;273.85;7.18;930;60;3271.00;38
8584;57;626350177;8584;345;9513;9551;6.78;0.41;273.86;7.18;929;60;3272.00;38
8588;57;626350189;8588;341;9513;9551;6.80;0.41;273.85;7.18;925;60;3273.00;38
8589;57;626350201;8589;350;9513;9551;6.83;0.42;273.84;7.18;924;60;3274.00;38
8591;57;626350213;8591;351;9513;9551;6.84;0.42;273.82;7.18;922;60;3275.00;38
8592;57;626350225;8592;355;9522;9563;6.95;0.42;273.84;7.17;930;60;3276.00;41
8595;57;626350243;8595;348;9522;9563;7.01;0.43;273.87;7.17;927;60;3277.00;41
8597;57;626350256;8597;340;9524;9563;7.05;0.43;273.88;7.17;927;60;3278.00;39
8599;57;626350269;8599;341;9524;9563;7.05;0.43;273.89;7.17;925;60;3279.00;39
8601;57;626350280;8601;339;9524;9563;7.08;0.43;273.95;7.17;923;60;3280.00;39
8602;57;626350293;8602;341;9524;9563;7.11;0.43;273.97;7.17;922;60;3281.00;39
8604;57;626350305;8604;335;9524;9564;7.14;0.43;274.07;7.17;920;60;3282.00;40
8606;57;626350317;8606;346;9524;9564;7.15;0.44;274.08;7.17;918;60;3283.00;40
8611;57;626350340;8611;340;9528;9570;7.19;0.44;274.08;7.17;917;60;3284.00;42
8613;57;626350353;8613;343;9530;9572;7.27;0.44;274.16;7.17;917;60;3285.00;42
8615;57;626350366;8615;332;9531;9572;7.31;0.45;274.18;7.17;916;60;3286.00;41
8618;57;626350378;8618;326;9531;9572;7.39;0.45;274.25;7.17;913;60;3287.00;41
8621;57;626350391;8621;310;9534;9576;7.49;0.46;274.23;7.17;913;60;3288.00;42
8623;57;626350404;8623;301;9534;9576;7.59;0.46;274.24;7.17;911;60;3289.00;42
8626;57;626350416;8626;292;9534;9576;7.65;0.46;274.28;7.17;908;60;3290.00;42
8626;57;626350428;8626;291;9535;9577;7.72;0.47;274.28;7.17;909;60;3291.00;42
8630;57;626350441;8630;288;9538;9581;7.76;0.47;274.30;7.16;908;60;3292.00;43
8632;57;626350453;8632;290;9538;9581;7.78;0.47;274.36;7.16;906;60;3293.00;43
8632;57;626350465;8632;289;9540;9584;7.88;0.48;274.36;7.16;908;60;3294.00;44
8635;57;626350484;8635;287;9540;9584;7.92;0.48;274.37;7.16;905;60;3295.00;44
8637;57;626350503;8637;292;9541;9584;7.97;0.48;274.34;7.16;904;60;3296.00;43
8640;57;626350516;8640;291;9541;9584;7.97;0.48;274.33;7.16;901;60;3297.00;43
8643;57;626350528;8643;295;9544;9588;7.99;0.49;274.35;7.16;901;60;3298.00;44
8646;57;626350540;8646;292;9544;9588;8.02;0.49;274.42;7.16;898;60;3299.00;44
8648;57;626350555;8648;291;9548;9607;8.01;0.49;274.45;7.16;900;60;3300.00;59
8653;57;626350573;8653;287;9549;9607;7.99;0.49;274.48;7.16;896;60;3301.00;58
8655;57;626350586;8655;277;9549;9608;8.03;0.49;274.52;7.16;894;60;3302.00;59
8660;57;626350598;8660;278;9550;9609;7.95;0.48;274.53;7.16;890;60;3303.00;59
8661;57;626350616;8661;274;9550;9609;7.98;0.49;274.54;7.16;889;60;3304.00;59
8665;57;626350627;8665;275;9551;9610;7.95;0.48;274.56;7.15;886;60;3305.00;59
8668;57;626350640;8668;275;9552;9610;7.95;0.48;274.54;7.15;884;60;3306.00;58
8671;57;626350652;8671;272;9553;9610;7.82;0.48;274.61;7.15;882;60;3307.00;57
8673;57;626350663;8673;270;9553;9610;7.78;0.47;274.61;7.15;880;60;3308.00;57
8677;57;626350675;8677;268;9553;9610;7.74;0.47;274.65;7.15;876;60;3309.00;57
8681;57;626350692;8681;265;9553;9610;7.74;0.47;274.70;7.15;872;60;3310.00;57
8684;57;626350709;8684;272;9554;9610;7.74;0.47;274.70;7.15;870;60;3311.00;56
8687;57;626350721;8687;295;9614;9737;7.85;0.48;274.67;7.11;927;60;3312.00;123
8688;57;626350742;8688;287;9621;9738;7.81;0.48;274.67;7.11;933;60;3313.00;117
8689;57;626350753;8689;280;9625;9738;7.87;0.48;274.66;7.11;936;60;3314.00;113
8691;57;626350765;8691;282;9627;9738;7.92;0.49;274.69;7.10;936;60;3315.00;111
8694;57;626350776;8694;283;9632;9738;7.97;0.49;274.70;7.10;938;60;3316.00;106
8697;57;626350788;8697;281;9634;9738;7.94;0.49;274.76;7.13;937;60;3317.00;104
8699;57;626350800;8699;291;9638;9738;7.96;0.49;274.79;7.13;939;60;3318.00;100
8701;57;626350817;8701;295;9642;9738;7.86;0.48;274.83;7.13;941;60;3319.00;96
8702;57;626350829;8702;288;9644;9739;7.82;0.48;274.83;7.13;942;60;3320.00;95
8705;57;626350841;8705;290;9646;9740;7.80;0.48;274.92;7.13;941;60;3321.00;94
8710;57;626350859;8710;282;9649;9740;7.76;0.48;274.94;7.13;939;60;3322.00;91
8713;57;626350880;8713;287;9651;9741;7.63;0.47;274.91;7.13;938;60;3323.00;90
8713;57;626350900;8713;284;9654;9741;7.57;0.46;274.91;7.14;941;60;3324.00;87
8716;57;626350918;8716;283;9657;9741;7.48;0.46;274.95;7.14;941;60;3325.00;84
8719;57;626350943;8719;280;9659;9741;7.46;0.46;274.96;7.14;940;60;3326.00;82
8723;57;626350959;8723;287;9662;9745;7.42;0.46;275.00;7.14;939;60;3327.00;83
8725;57;626350973;8725;286;9665;9745;7.43;0.46;274.98;7.14;940;60;3328.00;80
8726;57;626350987;8726;288;9667;9745;7.46;0.46;274.97;7.14;941;60;3329.00;78
8730;57;626351007;8730;284;9671;9751;7.39;0.45;274.97;7.14;941;60;3330.00;80
8736;57;626351021;8736;281;9672;9751;7.33;0.45;274.91;7.15;936;60;3331.00;79
8739;57;626351040;8739;278;9672;9751;7.36;0.45;275.00;7.15;933;60;3332.00;79
8744;57;626351053;8744;271;9677;9755;7.31;0.44;274.98;7.15;933;60;3333.00;78
8750;57;626351067;8750;267;9680;9756;7.29;0.44;275.00;7.18;930;60;3334.00;76
8753;57;626351080;8753;267;9682;9756;7.28;0.44;275.01;7.20;929;60;3335.00;74
8759;57;626351094;8759;260;9685;9760;7.24;0.44;275.06;7.23;926;60;3336.00;75
8761;57;626351108;8761;259;9686;9760;7.27;0.44;275.04;7.24;925;60;3337.00;74
8763;57;626351120;8763;253;9687;9760;7.32;0.44;275.04;7.24;924;60;3338.00;73
8766;57;626351132;8766;253;9690;9761;7.37;0.45;275.03;7.26;924;60;3339.00;71
8767;57;626351145;8767;250;9691;9761;7.38;0.45;275.05;7.26;924;60;3340.00;70
8768;57;626351157;8768;251;9693;9767;7.47;0.45;275.05;7.26;925;60;3341.00;74
8771;57;626351171;8771;252;9697;9767;7.53;0.46;275.09;7.29;926;60;3342.00;70
8772;57;626351184;8772;246;9698;9768;7.58;0.46;275.19;7.30;926;60;3343.00;70
8774;57;626351197;8774;251;9699;9768;7.60;0.46;275.19;7.30;925;60;3344.00;69
8775;57;626351210;8775;241;9700;9768;7.66;0.46;275.19;7.32;925;60;3345.00;68
8777;57;626351223;8777;239;9702;9768;7.75;0.47;275.19;7.32;925;60;3346.00;66
8781;57;626351235;8781;238;9703;9768;7.74;0.47;275.19;7.33;922;60;3347.00;65
8785;57;626351249;8785;240;9712;9780;7.79;0.47;275.24;7.32;927;60;3348.00;68
8788;57;626351263;8788;243;9713;9780;7.77;0.47;275.29;7.32;925;60;3349.00;67
8789;57;626351276;8789;242;9717;9780;7.78;0.47;275.28;7.33;928;60;3350.00;63
8791;57;626351289;8791;239;9719;9780;7.75;0.47;275.26;7.33;928;60;3351.00;61
8795;57;626351300;8795;241;9722;9780;7.73;0.47;275.24;7.34;927;60;3352.00;58
8795;57;626351313;8795;240;9724;9780;7.79;0.47;275.24;7.34;929;60;3353.00;56
8796;57;626351325;8796;230;9727;9784;7.85;0.48;275.25;7.34;931;60;3354.00;57
8798;57;626351338;8798;238;9728;9784;7.87;0.48;275.25;7.34;930;60;3355.00;56
8801;58;626351350;8801;240;9731;9788;7.91;0.48;275.24;7.34;930;61;3356.00;57
8804;58;626351378;8804;246;9732;9789;7.91;0.48;275.25;7.34;928;61;3357.00;57
8807;58;626351391;8807;241;9733;9789;7.97;0.48;275.29;7.34;926;61;3358.00;56
8808;58;626351409;8808;241;9733;9789;7.97;0.48;275.30;7.34;925;61;3359.00;56
8811;58;626351424;8811;248;9751;9818;7.92;0.48;275.29;7.34;940;61;3360.00;67
8811;58;626351440;8811;251;9753;9818;7.96;0.48;275.29;7.35;942;61;3361.00;65
8813;58;626351453;8813;257;9758;9818;8.01;0.49;275.35;7.36;945;61;3362.00;60
8814;58;626351466;8814;263;9761;9819;8.00;0.49;275.37;7.37;947;61;3363.00;58
8817;58;626351479;8817;269;9763;9820;7.94;0.48;275.42;7.37;946;61;3364.00;57
8817;58;626351492;8817;275;9765;9820;7.89;0.48;275.42;7.38;948;61;3365.00;55
8822;58;626351505;8822;284;9769;9823;7.87;0.48;275.49;7.39;947;61;3366.00;54
8825;58;626351518;8825;294;9769;9823;7.89;0.48;275.62;7.39;944;61;3367.00;54
8827;58;626351537;8827;296;9771;9823;7.85;0.48;275.65;7.41;944;61;3368.00;52
8831;58;626351549;8831;301;9771;9823;7.80;0.48;275.67;7.41;940;61;3369.00;52
8834;58;626351562;8834;300;9775;9829;7.75;0.47;275.69;7.41;941;61;3370.00;54
8835;58;626351575;8835;309;9777;9829;7.68;0.47;275.67;7.43;942;61;3371.00;52
8836;58;626351587;8836;314;9778;9829;7.59;0.46;275.69;7.43;942;61;3372.00;51
8838;58;626351599;8838;313;9780;9829;7.47;0.46;275.66;7.46;942;61;3373.00;49
8840;58;626351612;8840;311;9783;9833;7.34;0.45;275.69;7.45;943;61;3374.00;50
8841;58;626351623;8841;320;9787;9835;7.22;0.44;275.71;7.47;946;61;3375.00;48
8843;58;626351636;8843;322;9788;9835;7.13;0.44;275.70;7.49;945;61;3376.00;47
8845;58;626351648;8845;327;9789;9836;7.10;0.44;275.69;7.48;944;61;3377.00;47
8846;58;626351661;8846;336;9789;9836;7.02;0.43;275.70;7.48;943;61;3378.00;47
8847;58;626351672;8847;339;9791;9836;6.98;0.43;275.71;7.50;944;61;3379.00;45
8851;58;626351683;8851;341;9793;9836;6.89;0.42;275.74;7.52;942;61;3380.00;43
8852;58;626351695;8852;343;9793;9836;6.81;0.42;275.71;7.52;941;61;3381.00;43
8854;58;626351706;8854;345;9793;9836;6.75;0.41;275.67;7.52;939;61;3382.00;43
8856;58;626351718;8856;344;9793;9836;6.71;0.41;275.66;7.52;937;61;3383.00;43
8858;58;626351729;8858;353;9829;9906;6.89;0.42;275.61;7.51;971;61;3384.00;77
8860;58;626351747;8860;360;9831;9907;6.89;0.42;275.56;7.52;971;61;3385.00;76
8861;58;626351758;8861;358;9842;9907;6.95;0.43;275.54;7.51;981;61;3386.00;65
8864;58;626351770;8864;362;9846;9907;6.95;0.43;275.51;7.51;982;61;3387.00;61
8866;58;626351781;8866;368;9855;9907;6.97;0.43;275.48;7.53;989;61;3388.00;52
8868;58;626351792;8868;379;9859;9907;6.97;0.43;275.61;7.53;991;61;3389.00;48
8871;58;626351806;8871;385;9864;9907;6.90;0.42;275.54;7.53;993;61;3390.00;43
8872;58;626351818;8872;386;9864;9907;6.81;0.42;275.54;7.53;992;61;3391.00;43
8874;58;626351831;8874;391;9866;9908;6.73;0.41;275.49;7.53;992;61;3392.00;42
8877;58;626351845;8877;396;9867;9909;6.59;0.40;275.44;7.53;990;61;3393.00;42
8881;58;626351858;8881;395;9875;9909;6.44;0.39;275.45;7.58;994;61;3394.00;34
8885;58;626351870;8885;399;9878;9913;6.32;0.39;275.41;7.58;993;61;3395.00;35
8890;58;626351882;8890;405;9880;9913;6.18;0.38;275.36;7.59;990;61;3396.00;33
8894;58;626351894;8894;410;9880;9913;6.05;0.37;275.33;7.59;986;61;3397.00;33
8896;58;626351905;8896;413;9880;9913;5.93;0.36;275.33;7.59;984;61;3398.00;33
8898;58;626351915;8898;422;9887;9919;5.83;0.36;275.33;7.60;989;61;3399.00;32
8902;58;626351926;8902;412;9887;9919;5.72;0.35;275.32;7.60;985;61;3400.00;32
8905;58;626351941;8905;405;9888;9919;5.64;0.35;275.31;7.60;983;61;3401.00;31
8909;58;626351951;8909;411;9890;9922;5.56;0.34;275.31;7.60;981;61;3402.00;32
8911;58;626351962;8911;416;9891;9922;5.47;0.34;275.32;7.60;980;61;3403.00;31
8916;58;626351973;8916;419;9892;9922;5.43;0.33;275.32;7.61;976;61;3404.00;30
8918;58;626351983;8918;422;9892;9923;5.43;0.33;275.35;7.61;974;61;3405.00;31
8922;58;626351993;8922;421;9895;9924;5.35;0.33;275.30;7.61;973;61;3406.00;29
8923;58;626352004;8923;416;9895;9924;5.31;0.33;275.31;7.61;972;61;3407.00;29
8927;58;626352014;8927;421;9905;9937;5.36;0.33;275.30;7.60;978;61;3408.00;32
8930;58;626352026;8930;422;9905;9937;5.38;0.33;275.32;7.60;975;61;3409.00;32
8933;58;626352037;8933;423;9906;9937;5.42;0.33;275.26;7.60;973;61;3410.00;31
8935;58;626352047;8935;413;9907;9938;5.50;0.34;275.27;7.60;972;61;3411.00;31
8937;58;626352059;8937;405;9908;9938;5.56;0.34;275.28;7.62;971;61;3412.00;30
8938;58;626352070;8938;399;9911;9942;5.65;0.35;275.25;7.62;973;61;3413.00;31
8942;58;626352081;8942;402;9912;9942;5.73;0.35;275.34;7.62;970;61;3414.00;30
8945;58;626352092;8945;397;9915;9946;5.82;0.36;275.28;7.62;970;61;3415.00;31
8950;58;626352104;8950;398;9915;9946;5.87;0.36;275.25;7.62;965;61;3416.00;31
8952;58;626352115;8952;394;9915;9946;5.99;0.37;275.25;7.62;963;61;3417.00;31
8956;58;626352132;8956;379;9915;9946;6.09;0.37;275.23;7.62;959;61;3418.00;31
8960;58;626352144;8960;370;9915;9946;6.21;0.38;275.23;7.62;955;61;3419.00;31
8960;58;626352157;8960;364;9940;9980;6.50;0.40;275.23;7.60;980;61;3420.00;40
8963;58;626352171;8963;360;9940;9980;6.55;0.40;275.24;7.60;977;61;3421.00;40
8967;59;626352190;8967;352;9941;9980;6.59;0.41;275.24;7.60;974;62;3422.00;39
8967;59;626352218;8967;353;9942;9980;6.65;0.41;275.24;7.60;975;62;3423.00;38
8970;59;626352230;8970;354;9943;9980;6.69;0.41;275.22;7.60;973;62;3424.00;37
8972;59;626352242;8972;353;9943;9980;6.78;0.42;275.22;7.60;971;62;3425.00;37
8975;59;626352254;8975;353;9944;9981;6.89;0.42;275.24;7.60;969;62;3426.00;37
8979;59;626352267;8979;358;9944;9981;6.95;0.43;275.29;7.60;965;62;3427.00;37
8981;59;626352279;8981;362;9948;9987;7.07;0.43;275.30;7.60;967;62;3428.00;39
8987;59;626352292;8987;352;9949;9988;7.07;0.43;275.31;7.60;962;62;3429.00;39
8989;59;626352304;8989;352;9950;9988;7.10;0.43;275.29;7.59;961;62;3430.00;38
8992;59;626352317;8992;351;9950;9988;7.11;0.44;275.30;7.59;958;62;3431.00;38
8994;59;626352329;8994;354;9953;9992;7.08;0.43;275.30;7.59;959;62;3432.00;39
8998;59;626352340;8998;347;9953;9992;7.03;0.43;275.35;7.59;955;62;3433.00;39
9003;59;626352352;9003;350;9953;9992;6.99;0.43;275.35;7.59;950;62;3434.00;39
9006;59;626352370;9006;352;9954;9993;6.97;0.43;275.42;7.59;948;62;3435.00;39
9012;59;626352383;9012;351;9957;9997;7.00;0.43;275.54;7.59;945;62;3436.00;40
9014;59;626352401;9014;351;9958;9997;7.00;0.43;275.53;7.62;944;62;3437.00;39
9021;59;626352413;9021;349;9960;10000;7.04;0.43;275.63;7.61;939;62;3438.00;40
9024;59;626352426;9024;341;9960;10000;7.07;0.43;275.62;7.61;936;62;3439.00;40
9026;59;626352438;9026;342;9961;10000;7.05;0.43;275.69;7.61;935;62;3440.00;39
9028;59;626352450;9028;336;9961;10000;6.93;0.42;275.74;7.61;933;62;3441.00;39
9032;59;626352462;9032;341;9964;10004;6.92;0.42;275.80;7.61;932;62;3442.00;40
9036;59;626352475;9036;341;9964;10004;6.88;0.42;275.87;7.61;928;62;3443.00;40
9042;59;626352487;9042;340;9965;10004;6.83;0.42;275.94;7.61;923;62;3444.00;39
9046;59;626352499;9046;349;9965;10004;6.78;0.41;275.93;7.61;919;62;3445.00;39
9051;59;626352516;9051;357;9965;10005;6.70;0.41;276.00;7.61;914;62;3446.00;40
9055;59;626352529;9055;342;9966;10006;6.71;0.41;276.03;7.61;911;62;3447.00;40
9057;59;626352541;9057;331;9966;10006;6.72;0.41;276.06;7.61;909;62;3448.00;40
9061;59;626352553;9061;328;9967;10007;6.75;0.41;276.25;7.61;906;62;3449.00;40
9063;59;626352567;9063;321;9967;10007;6.86;0.42;276.24;7.61;904;62;3450.00;40
9068;59;626352579;9068;318;9967;10007;6.88;0.42;276.32;7.61;899;62;3451.00;40
9072;59;626352592;9072;317;9967;10007;6.92;0.42;276.44;7.61;895;62;3452.00;40
9073;59;626352603;9073;318;9968;10007;6.98;0.42;276.42;7.63;895;62;3453.00;39
9075;59;626352616;9075;316;9968;10007;7.01;0.43;276.44;7.63;893;62;3454.00;39
9079;59;626352633;9079;317;9968;10007;7.06;0.43;276.52;7.63;889;62;3455.00;39
9079;59;626352645;9079;321;10041;10134;7.29;0.45;276.52;7.58;962;62;3456.00;93
9083;59;626352672;9083;300;10043;10135;7.33;0.45;276.54;7.57;960;62;3457.00;92
9086;59;626352685;9086;278;10050;10135;7.46;0.46;276.60;7.57;964;62;3458.00;85
9087;59;626352697;9087;273;10055;10135;7.61;0.47;276.59;7.57;968;62;3459.00;80
9090;59;626352711;9090;270;10060;10135;7.66;0.47;276.70;7.57;970;62;3460.00;75
9092;59;626352724;9092;267;10064;10135;7.70;0.47;276.71;7.57;972;62;3461.00;71
9094;59;626352737;9094;265;10070;10135;7.72;0.48;276.72;7.59;976;62;3462.00;65
9098;59;626352753;9098;273;10072;10135;7.73;0.48;276.76;7.59;974;62;3463.00;63
9100;59;626352767;9100;277;10076;10136;7.79;0.48;276.76;7.59;976;62;3464.00;60
9103;59;626352780;9103;275;10079;10138;7.76;0.48;276.80;7.58;976;62;3465.00;59
9107;59;626352794;9107;275;10080;10138;7.73;0.47;276.84;7.58;973;62;3466.00;58
9111;59;626352809;9111;276;10082;10139;7.73;0.47;276.84;7.59;971;62;3467.00;57
9112;59;626352830;9112;281;10083;10139;7.70;0.47;276.86;7.59;971;62;3468.00;56
9113;59;626352846;9113;285;10084;10139;7.70;0.47;276.87;7.59;971;62;3469.00;55
9114;59;626352866;9114;284;10085;10139;7.65;0.47;276.86;7.59;971;62;3470.00;54
9118;59;626352885;9118;272;10088;10143;7.62;0.47;276.91;7.59;970;62;3471.00;55
9122;59;626352912;9122;278;10089;10143;7.60;0.46;277.12;7.59;967;62;3472.00;54
9125;59;626352930;9125;274;10090;10143;7.61;0.47;277.17;7.59;965;62;3473.00;53
9126;59;626352952;9126;269;10093;10146;7.66;0.47;277.15;7.59;967;62;3474.00;53
9130;59;626352970;9130;266;10094;10146;7.74;0.47;277.20;7.59;964;62;3475.00;52
9135;59;626352984;9135;264;10095;10146;7.76;0.47;277.25;7.59;960;62;3476.00;51
9137;59;626352998;9137;268;10098;10150;7.77;0.47;277.24;7.59;961;62;3477.00;52
9140;59;626353013;9140;272;10100;10151;7.84;0.48;277.28;7.59;960;62;3478.00;51
9143;59;626353026;9143;270;10100;10151;7.89;0.48;277.31;7.59;957;62;3479.00;51
9144;59;626353043;9144;270;10105;10156;7.90;0.48;277.31;7.58;961;62;3480.00;51
9148;59;626353057;9148;278;10105;10156;7.86;0.48;277.35;7.58;957;62;3481.00;51
9150;59;626353071;9150;272;10105;10156;7.81;0.47;277.34;7.58;955;62;3482.00;51
9152;59;626353085;9152;277;10106;10157;7.78;0.47;277.39;7.58;954;62;3483.00;51
9153;59;626353099;9153;282;10106;10157;7.72;0.47;277.39;7.58;953;62;3484.00;51
9155;59;626353112;9155;288;10110;10163;7.67;0.46;277.38;7.58;955;62;3485.00;53
9155;59;626353126;9155;291;10110;10163;7.64;0.46;277.38;7.58;955;62;3486.00;53
9158;59;626353139;9158;292;10111;10164;7.64;0.46;277.38;7.58;953;62;3487.00;53
9158;59;626353152;9158;299;10111;10164;7.63;0.46;277.38;7.58;953;62;3488.00;53
9159;59;626353165;9159;300;10111;10164;7.59;0.46;277.37;7.58;952;62;3489.00;53
9160;59;626353178;9160;301;10111;10164;7.57;0.46;277.34;7.58;951;62;3490.00;53
9161;59;626353192;9161;290;10111;10164;7.58;0.46;277.34;7.58;950;62;3491.00;53
9165;59;626353204;9165;284;10121;10176;7.60;0.46;277.32;7.57;956;62;3492.00;55
9168;59;626353219;9168;278;10121;10176;7.58;0.46;277.31;7.57;953;62;3493.00;55
9168;59;626353232;9168;268;10122;10176;7.63;0.46;277.31;7.57;954;62;3494.00;54
9173;59;626353245;9173;259;10122;10176;7.62;0.46;277.33;7.57;949;62;3495.00;54
9174;59;626353259;9174;259;10122;10176;7.62;0.46;277.31;7.57;948;62;3496.00;54
9175;59;626353272;9175;253;10122;10176;7.68;0.47;277.34;7.57;947;62;3497.00;54
9177;59;626353284;9177;253;10125;10180;7.68;0.47;277.34;7.57;948;62;3498.00;55
9179;59;626353297;9179;242;10125;10180;7.67;0.46;277.37;7.57;946;62;3499.00;55
9182;59;626353311;9182;235;10128;10184;7.66;0.46;277.36;7.57;946;62;3500.00;56
9184;59;626353328;9184;232;10130;10185;7.58;0.46;277.35;7.57;946;62;3501.00;55
9186;59;626353347;9186;227;10130;10185;7.45;0.45;277.41;7.57;944;62;3502.00;55
9188;59;626353360;9188;215;10130;10185;7.35;0.45;277.54;7.57;942;62;3503.00;55
9189;59;626353371;9189;215;10140;10198;7.25;0.44;277.58;7.56;951;62;3504.00;58
9193;59;626353384;9193;209;10141;10198;7.16;0.44;277.69;7.57;948;62;3505.00;57
9197;59;626353399;9197;212;10141;10198;7.12;0.43;277.69;7.57;944;62;3506.00;57
9201;59;626353411;9201;215;10142;10199;7.14;0.43;277.75;7.57;941;62;3507.00;57
9203;59;626353423;9203;209;10142;10200;7.18;0.43;277.77;7.57;939;62;3508.00;58
9205;59;626353435;9205;206;10143;10200;7.20;0.44;277.77;7.60;938;62;3509.00;57
9208;59;626353448;9208;207;10146;10206;7.25;0.44;277.81;7.59;938;62;3510.00;60
9210;59;626353462;9210;202;10147;10206;7.34;0.44;277.80;7.59;937;62;3511.00;59
9214;59;626353475;9214;205;10148;10206;7.38;0.45;277.83;7.59;934;62;3512.00;58
9217;59;626353487;9217;209;10148;10206;7.43;0.45;277.89;7.59;931;62;3513.00;58
9219;59;626353499;9219;217;10152;10212;7.47;0.45;277.91;7.59;933;62;3514.00;60
9222;59;626353511;9222;207;10152;10212;7.47;0.45;278.02;7.59;930;62;3515.00;60
9224;59;626353524;9224;202;10153;10212;7.44;0.45;278.05;7.59;929;62;3516.00;59
9226;59;626353536;9226;202;10154;10212;7.41;0.45;278.07;7.59;928;62;3517.00;58
9228;59;626353547;9228;208;10158;10216;7.38;0.45;278.07;7.59;930;62;3518.00;58
9233;59;626353560;9233;215;10160;10219;7.36;0.45;278.11;7.59;927;62;3519.00;59
9234;59;626353573;9234;213;10161;10219;7.35;0.45;278.13;7.59;927;62;3520.00;58
9236;59;626353585;9236;213;10162;10220;7.33;0.44;278.16;7.59;926;62;3521.00;58
9238;59;626353597;9238;220;10162;10220;7.30;0.44;278.15;7.59;924;62;3522.00;58
9239;59;626353609;9239;224;10162;10220;7.27;0.44;278.14;7.59;923;62;3523.00;58
9240;59;626353621;9240;224;10162;10220;7.29;0.44;278.13;7.59;922;62;3524.00;58
9243;59;626353633;9243;230;10164;10220;7.22;0.44;278.20;7.61;921;62;3525.00;56
9245;59;626353645;9245;227;10164;10220;7.19;0.44;278.22;7.61;919;62;3526.00;56
9245;59;626353657;9245;232;10164;10220;7.18;0.44;278.22;7.61;919;62;3527.00;56
9248;59;626353669;9248;243;10199;10290;7.28;0.44;278.31;7.58;951;62;3528.00;91
9249;59;626353687;9249;247;10203;10291;7.23;0.44;278.29;7.59;954;62;3529.00;88
9250;59;626353699;9250;256;10209;10291;7.25;0.44;278.27;7.59;959;62;3530.00;82
9250;59;626353711;9250;262;10213;10291;7.27;0.44;278.27;7.60;963;62;3531.00;78
9254;59;626353723;9254;263;10218;10291;7.23;0.44;278.30;7.61;964;62;3532.00;73
9256;59;626353735;9256;267;10222;10291;7.25;0.44;278.29;7.62;966;62;3533.00;69
9259;59;626353748;9259;265;10227;10291;7.24;0.44;278.33;7.63;968;62;3534.00;64
9262;59;626353760;9262;274;10230;10291;7.17;0.44;278.26;7.65;968;62;3535.00;61
9264;59;626353773;9264;272;10233;10292;7.19;0.44;278.23;7.65;969;62;3536.00;59
9267;59;626353785;9267;273;10237;10293;7.15;0.44;278.20;7.67;970;62;3537.00;56
9270;59;626353798;9270;279;10240;10293;7.16;0.44;278.25;7.68;970;62;3538.00;53
9271;59;626353811;9271;273;10245;10297;7.13;0.43;278.23;7.69;974;62;3539.00;52
9272;59;626353825;9272;286;10245;10297;7.02;0.43;278.21;7.69;973;62;3540.00;52
9275;59;626353840;9275;287;10246;10297;6.86;0.42;278.20;7.70;971;62;3541.00;51
9275;59;626353857;9275;300;10246;10297;6.73;0.41;278.20;7.70;971;62;3542.00;51
9276;59;626353870;9276;301;10253;10303;6.68;0.41;278.18;7.72;977;62;3543.00;50
9276;59;626353882;9276;307;10253;10303;6.57;0.40;278.18;7.72;977;62;3544.00;50
9278;59;626353894;9278;313;10256;10303;6.44;0.40;278.14;7.74;978;62;3545.00;47
9279;59;626353905;9279;322;10259;10306;6.36;0.39;278.13;7.75;980;62;3546.00;47
9282;59;626353916;9282;328;10261;10306;6.24;0.38;278.12;7.75;979;62;3547.00;45
9286;59;626353927;9286;332;10262;10306;6.09;0.37;278.07;7.76;976;62;3548.00;44
9288;59;626353938;9288;335;10263;10307;5.95;0.37;278.08;7.77;975;62;3549.00;44
9290;59;626353949;9290;339;10265;10308;5.85;0.36;278.03;7.78;975;62;3550.00;43
9292;59;626353960;9292;342;10265;10308;5.78;0.35;278.00;7.78;973;62;3551.00;43
9294;59;626353971;9294;346;10277;10321;5.77;0.35;277.96;7.77;983;62;3552.00;44
9295;59;626353989;9295;353;10278;10321;5.74;0.35;277.97;7.78;983;62;3553.00;43
9296;59;626353999;9296;359;10279;10321;5.75;0.35;277.96;7.78;983;62;3554.00;42
9298;59;626354010;9298;360;10282;10323;5.73;0.35;277.92;7.79;984;62;3555.00;41
9300;59;626354021;9300;367;10282;10323;5.70;0.35;277.88;7.79;982;62;3556.00;41
9301;59;626354031;9301;369;10285;10327;5.70;0.35;277.87;7.79;984;62;3557.00;42
9301;59;626354042;9301;373;10286;10327;5.72;0.35;277.87;7.80;985;62;3558.00;41
9303;59;626354052;9303;381;10290;10331;5.71;0.35;277.87;7.79;987;62;3559.00;41
9305;59;626354063;9305;385;10291;10331;5.63;0.34;277.82;7.80;986;62;3560.00;40
9309;59;626354073;9309;387;10291;10331;5.53;0.34;277.90;7.80;982;62;3561.00;40
9311;59;626354089;9311;390;10294;10331;5.43;0.33;277.90;7.83;983;62;3562.00;37
9314;59;626354099;9314;371;10294;10331;5.40;0.33;277.89;7.83;980;62;3563.00;37
9317;59;626354110;9317;370;10303;10343;5.42;0.33;277.86;7.82;986;62;3564.00;40
9321;59;626354121;9321;366;10304;10343;5.41;0.33;277.84;7.83;983;62;3565.00;39
9323;59;626354131;9323;370;10306;10343;5.44;0.33;277.86;7.83;983;62;3566.00;37
9323;59;626354142;9323;362;10309;10343;5.45;0.33;277.86;7.86;986;62;3567.00;34
9325;59;626354152;9325;359;10309;10343;5.37;0.33;277.87;7.86;984;62;3568.00;34
9326;59;626354162;9326;353;10310;10343;5.30;0.32;277.90;7.87;984;62;3569.00;33
9328;59;626354179;9328;336;10310;10344;5.26;0.32;277.92;7.87;982;62;3570.00;34
9331;59;626354190;9331;327;10311;10344;5.25;0.32;277.91;7.87;980;62;3571.00;33
9333;59;626354200;9333;327;10317;10350;5.29;0.32;277.92;7.88;984;62;3572.00;33
9337;59;626354212;9337;317;10318;10351;5.32;0.33;277.91;7.87;981;62;3573.00;33
9339;59;626354222;9339;313;10320;10351;5.40;0.33;277.90;7.88;981;62;3574.00;31
9341;59;626354238;9341;313;10320;10351;5.46;0.33;277.87;7.88;979;62;3575.00;31
9344;59;626354250;9344;321;10324;10355;5.54;0.34;277.85;7.88;980;62;3576.00;31
9347;59;626354262;9347;312;10325;10355;5.55;0.34;277.86;7.89;978;62;3577.00;30
9348;59;626354273;9348;316;10325;10355;5.56;0.34;277.85;7.89;977;62;3578.00;30
9351;59;626354284;9351;314;10326;10356;5.66;0.35;277.86;7.89;975;62;3579.00;30
9353;59;626354295;9353;315;10329;10360;5.72;0.35;277.87;7.89;976;62;3580.00;31
9354;59;626354306;9354;314;10329;10360;5.79;0.35;277.88;7.89;975;62;3581.00;31
9356;59;626354318;9356;313;10331;10363;5.91;0.36;277.88;7.88;975;62;3582.00;32
9359;59;626354329;9359;310;10332;10363;5.99;0.37;277.86;7.88;973;62;3583.00;31
9361;59;626354340;9361;313;10332;10363;6.12;0.37;277.86;7.88;971;62;3584.00;31
9367;59;626354352;9367;310;10332;10363;6.17;0.38;277.92;7.88;965;62;3585.00;31
9370;59;626354364;9370;312;10335;10367;6.32;0.39;277.94;7.88;965;62;3586.00;32
9375;59;626354376;9375;308;10335;10367;6.40;0.39;277.95;7.88;960;62;3587.00;32
9379;59;626354387;9379;303;10336;10367;6.44;0.39;277.94;7.88;957;62;3588.00;31
9383;59;626354398;9383;299;10336;10367;6.44;0.39;277.97;7.88;953;62;3589.00;31
9387;59;626354410;9387;299;10336;10368;6.48;0.40;278.04;7.88;949;62;3590.00;32
9392;59;626354422;9392;297;10337;10369;6.52;0.40;278.05;7.88;945;62;3591.00;32
9398;60;626354434;9398;288;10337;10369;6.59;0.40;278.06;7.88;939;63;3592.00;32
9402;60;626354463;9402;276;10338;10370;6.75;0.41;278.10;7.88;936;63;3593.00;32
9405;60;626354476;9405;264;10338;10370;6.80;0.42;278.13;7.88;933;63;3594.00;32
9411;60;626354493;9411;272;10338;10370;6.80;0.42;278.14;7.88;927;63;3595.00;32
9413;60;626354505;9413;271;10338;10370;6.87;0.42;278.14;7.88;925;63;3596.00;32
9416;60;626354517;9416;271;10338;10370;6.93;0.43;278.17;7.88;922;63;3597.00;32
9423;60;626354529;9423;267;10338;10370;7.00;0.43;278.12;7.88;915;63;3598.00;32
9427;60;626354540;9427;273;10338;10370;7.13;0.44;278.16;7.88;911;63;3599.00;32
9435;60;626354555;9435;302;10446;10623;7.40;0.47;278.14;7.80;1011;63;3600.00;177
9440;60;626354592;9440;297;10453;10624;7.44;0.47;278.21;7.79;1013;63;3601.00;171
9446;60;626354606;9446;289;10463;10624;7.58;0.47;278.14;7.79;1017;63;3602.00;161
9450;60;626354619;9450;287;10470;10624;7.60;0.48;278.23;7.79;1020;63;3603.00;154
9457;60;626354632;9457;285;10475;10624;7.56;0.47;278.36;7.78;1018;63;3604.00;149
9459;60;626354646;9459;280;10482;10624;7.58;0.47;278.39;7.78;1023;63;3605.00;142
9463;61;626354659;9463;285;10490;10624;7.61;0.47;278.39;7.78;1027;64;3606.00;134
9468;61;626354685;9468;290;10494;10624;7.61;0.48;278.43;7.78;1026;64;3607.00;130
9470;61;626354704;9470;295;10499;10625;7.63;0.48;278.43;7.78;1029;64;3608.00;126
9474;61;626354723;9474;299;10502;10626;7.60;0.47;278.43;7.82;1028;64;3609.00;124
9479;61;626354738;9479;304;10507;10626;7.58;0.47;278.44;7.82;1028;64;3610.00;119
9485;61;626354751;9485;310;10513;10627;7.49;0.46;278.54;7.82;1028;64;3611.00;114
9491;61;626354765;9491;314;10517;10627;7.39;0.46;278.57;7.82;1026;64;3612.00;110
9493;61;626354779;9493;319;10521;10627;7.32;0.45;278.59;7.82;1028;64;3613.00;106
9497;61;626354798;9497;328;10525;10627;7.22;0.45;278.60;7.82;1028;64;3614.00;102
9501;61;626354811;9501;339;10530;10631;7.16;0.44;278.70;7.83;1029;64;3615.00;101
9502;61;626354826;9502;352;10531;10631;7.13;0.44;278.71;7.83;1029;64;3616.00;100
9505;61;626354839;9505;334;10535;10631;7.09;0.44;278.76;7.83;1030;64;3617.00;96
9507;61;626354859;9507;329;10538;10634;7.06;0.43;278.80;7.83;1031;64;3618.00;96
9509;61;626354897;9509;331;10539;10634;7.11;0.44;278.80;7.83;1030;64;3619.00;95
9512;61;626354917;9512;328;10541;10634;7.19;0.44;278.84;7.84;1029;64;3620.00;93
9513;61;626354952;9513;327;10547;10638;7.26;0.45;278.84;7.84;1034;64;3621.00;91
9517;61;626354970;9517;329;10549;10639;7.30;0.45;278.90;7.84;1032;64;3622.00;90
9520;61;626354986;9520;331;10553;10639;7.38;0.45;278.99;7.84;1033;64;3623.00;86
9524;61;626355002;9524;335;10554;10643;7.41;0.45;279.03;7.84;1030;64;3624.00;89
9526;61;626355017;9526;340;10556;10643;7.47;0.46;279.10;7.88;1030;64;3625.00;87
9530;61;626355032;9530;331;10561;10643;7.52;0.46;279.12;7.88;1031;64;3626.00;82
9534;61;626355054;9534;319;10563;10644;7.59;0.46;279.14;7.88;1029;64;3627.00;81
9536;61;626355070;9536;309;10564;10644;7.58;0.46;279.19;7.88;1028;64;3628.00;80
9538;61;626355085;9538;295;10567;10650;7.58;0.46;279.19;7.88;1029;64;3629.00;83
9542;61;626355102;9542;287;10569;10650;7.59;0.46;279.25;7.88;1027;64;3630.00;81
9545;61;626355117;9545;282;10569;10651;7.62;0.46;279.30;7.88;1024;64;3631.00;82
9547;62;626355132;9547;283;10570;10651;7.62;0.46;279.31;7.88;1023;65;3632.00;81
9548;62;626355161;9548;283;10570;10651;7.62;0.46;279.34;7.88;1022;65;3633.00;81
9551;62;626355176;9551;285;10571;10651;7.62;0.46;279.41;7.88;1020;65;3634.00;80
9551;62;626355191;9551;286;10571;10651;7.68;0.47;279.41;7.88;1020;65;3635.00;80
9555;62;626355205;9555;293;10582;10663;7.68;0.47;279.49;7.92;1027;65;3636.00;81
9555;62;626355228;9555;281;10582;10663;7.68;0.47;279.49;7.92;1027;65;3637.00;81
9558;62;626355249;9558;279;10584;10663;7.65;0.46;279.52;7.92;1026;65;3638.00;79
9563;62;626355266;9563;282;10584;10663;7.63;0.46;279.62;7.92;1021;65;3639.00;79
9566;62;626355281;9566;280;10585;10663;7.56;0.46;279.60;7.92;1019;65;3640.00;78
9568;62;626355295;9568;284;10586;10663;7.54;0.46;279.62;7.95;1018;65;3641.00;77
9570;62;626355310;9570;284;10590;10667;7.46;0.45;279.67;7.96;1020;65;3642.00;77
9572;62;626355324;9572;289;10590;10667;7.43;0.45;279.69;7.96;1018;65;3643.00;77
9574;62;626355338;9574;288;10593;10671;7.46;0.45;279.71;7.95;1019;65;3644.00;78
9576;62;626355353;9576;285;10595;10673;7.49;0.46;279.75;7.95;1019;65;3645.00;78
9579;62;626355366;9579;294;10596;10673;7.49;0.46;279.76;7.95;1017;65;3646.00;77
9581;62;626355380;9581;295;10596;10673;7.51;0.46;279.79;7.95;1015;65;3647.00;77
9587;62;626355393;9587;298;10606;10686;7.50;0.46;279.96;7.95;1019;65;3648.00;80
9590;62;626355408;9590;301;10606;10686;7.45;0.45;279.95;7.95;1016;65;3649.00;80
9593;62;626355420;9593;303;10607;10686;7.38;0.45;280.02;7.95;1014;65;3650.00;79
9594;62;626355433;9594;306;10608;10687;7.37;0.45;280.02;7.95;1014;65;3651.00;79
9596;62;626355446;9596;303;10608;10688;7.33;0.45;280.00;7.95;1012;65;3652.00;80
9597;62;626355459;9597;308;10608;10688;7.30;0.45;280.03;7.95;1011;65;3653.00;80
9599;62;626355473;9599;309;10611;10691;7.26;0.44;280.01;7.99;1012;65;3654.00;80
9602;62;626355487;9602;308;10611;10691;7.21;0.44;280.07;7.99;1009;65;3655.00;80
9603;62;626355501;9603;312;10612;10691;7.15;0.44;280.06;7.99;1009;65;3656.00;79
9606;62;626355513;9606;312;10612;10691;7.11;0.43;280.06;7.99;1006;65;3657.00;79
9606;62;626355526;9606;314;10616;10697;7.12;0.43;280.06;7.98;1010;65;3658.00;81
9610;62;626355539;9610;307;10616;10697;7.02;0.43;280.03;7.98;1006;65;3659.00;81
9613;62;626355553;9613;310;10617;10697;7.00;0.43;280.01;7.98;1004;65;3660.00;80
9617;62;626355566;9617;310;10617;10697;6.98;0.43;280.10;7.98;1000;65;3661.00;80
9619;62;626355578;9619;311;10620;10701;6.93;0.42;280.07;7.98;1001;65;3662.00;81
9620;62;626355592;9620;309;10621;10702;6.94;0.42;280.06;7.98;1001;65;3663.00;81
9621;62;626355605;9621;308;10621;10702;6.96;0.42;280.07;7.98;1000;65;3664.00;81
9624;62;626355617;9624;303;10622;10703;6.92;0.42;280.06;7.98;998;65;3665.00;81
9625;62;626355629;9625;303;10622;10703;6.89;0.42;280.10;7.98;997;65;3666.00;81
9628;62;626355642;9628;296;10623;10703;6.82;0.41;280.12;7.98;995;65;3667.00;80
9629;62;626355654;9629;293;10624;10703;6.77;0.41;280.15;8.02;995;65;3668.00;79
9633;62;626355666;9633;304;10624;10703;6.70;0.41;280.22;8.02;991;65;3669.00;79
9638;62;626355678;9638;301;10624;10703;6.60;0.40;280.34;8.02;986;65;3670.00;79
9640;62;626355696;9640;299;10625;10703;6.56;0.40;280.32;8.06;985;65;3671.00;78
9642;62;626355707;9642;301;10653;10773;6.55;0.40;280.32;8.04;1011;65;3672.00;120
9644;62;626355724;9644;288;10654;10774;6.46;0.39;280.31;8.05;1010;65;3673.00;120
9646;62;626355735;9646;282;10660;10774;6.51;0.40;280.35;8.04;1014;65;3674.00;114
9648;62;626355747;9648;272;10667;10774;6.53;0.40;280.35;8.07;1019;65;3675.00;107
9649;62;626355762;9649;265;10675;10774;6.58;0.40;280.39;8.11;1026;65;3676.00;99
9651;62;626355774;9651;256;10679;10774;6.65;0.41;280.41;8.10;1028;65;3677.00;95
9654;62;626355786;9654;256;10684;10774;6.72;0.41;280.37;8.14;1030;65;3678.00;90
9655;62;626355799;9655;248;10684;10774;6.74;0.41;280.35;8.14;1029;65;3679.00;90
9656;62;626355811;9656;239;10687;10775;6.80;0.41;280.33;8.18;1031;65;3680.00;88
9656;62;626355823;9656;243;10688;10776;6.88;0.42;280.33;8.18;1032;65;3681.00;88
9659;62;626355836;9659;234;10689;10776;6.93;0.42;280.32;8.18;1030;65;3682.00;87
9661;62;626355850;9661;239;10693;10780;6.89;0.42;280.34;8.22;1032;65;3683.00;87
9664;62;626355863;9664;243;10693;10780;6.83;0.42;280.29;8.22;1029;65;3684.00;87
9666;62;626355882;9666;246;10694;10780;6.79;0.41;280.26;8.25;1028;65;3685.00;86
9668;62;626355896;9668;248;10694;10780;6.75;0.41;280.23;8.25;1026;65;3686.00;86
9669;62;626355910;9669;254;10698;10786;6.81;0.41;280.21;8.25;1029;65;3687.00;88
9673;62;626355938;9673;258;10700;10786;6.78;0.41;280.16;8.28;1027;65;3688.00;86
9676;62;626355951;9676;261;10702;10786;6.75;0.41;280.13;8.29;1026;65;3689.00;84
9678;62;626355968;9678;269;10705;10792;6.77;0.41;280.09;8.29;1027;65;3690.00;87
9680;62;626355981;9680;275;10705;10792;6.75;0.41;280.05;8.29;1025;65;3691.00;87
9682;62;626355993;9682;283;10708;10792;6.67;0.40;280.01;8.30;1026;65;3692.00;84
9682;62;626356006;9682;286;10709;10793;6.65;0.40;280.01;8.30;1027;65;3693.00;84
9685;62;626356018;9685;294;10711;10794;6.61;0.40;280.04;8.30;1026;65;3694.00;83
9686;62;626356030;9686;297;10714;10794;6.54;0.40;280.01;8.31;1028;65;3695.00;80
9687;62;626356042;9687;305;10722;10807;6.52;0.40;279.98;8.30;1035;65;3696.00;85
9688;62;626356054;9688;307;10726;10807;6.47;0.39;279.96;8.31;1038;65;3697.00;81
9690;62;626356066;9690;320;10726;10807;6.40;0.39;279.98;8.31;1036;65;3698.00;81
9693;62;626356078;9693;326;10727;10808;6.36;0.39;279.97;8.31;1034;65;3699.00;81
9695;62;626356092;9695;328;10732;10808;6.30;0.38;279.96;8.35;1037;65;3700.00;76
9696;62;626356107;9696;333;10734;10812;6.29;0.38;279.96;8.35;1038;65;3701.00;78
9701;62;626356120;9701;339;10737;10812;6.23;0.38;279.85;8.35;1036;65;3702.00;75
9703;62;626356138;9703;341;10743;10816;6.14;0.37;279.83;8.38;1040;65;3703.00;73
9706;62;626356155;9706;349;10743;10816;6.11;0.37;279.77;8.38;1037;65;3704.00;73
9709;62;626356167;9709;353;10744;10816;6.12;0.37;279.85;8.39;1035;65;3705.00;72
9710;62;626356179;9710;353;10745;10816;6.13;0.37;279.84;8.40;1035;65;3706.00;71
9710;62;626356191;9710;360;10747;10816;6.11;0.37;279.84;8.42;1037;65;3707.00;69
9710;62;626356202;9710;362;10759;10828;6.15;0.38;279.84;8.44;1049;65;3708.00;69
9712;62;626356215;9712;362;10759;10828;6.10;0.37;279.79;8.44;1047;65;3709.00;69
9715;62;626356226;9715;367;10760;10828;6.05;0.37;279.79;8.44;1045;65;3710.00;68
9716;62;626356238;9716;365;10762;10828;5.98;0.36;279.82;8.46;1046;65;3711.00;66
9716;62;626356250;9716;368;10762;10828;5.94;0.36;279.82;8.46;1046;65;3712.00;66
9718;62;626356262;9718;379;10766;10828;5.88;0.36;279.78;8.50;1048;65;3713.00;62
9719;62;626356274;9719;389;10767;10829;5.81;0.36;279.76;8.51;1048;65;3714.00;62
9719;62;626356285;9719;377;10770;10829;5.80;0.36;279.76;8.52;1051;65;3715.00;59
9720;62;626356297;9720;378;10776;10835;5.86;0.36;279.77;8.54;1056;65;3716.00;59
9723;62;626356309;9723;381;10777;10836;5.84;0.36;279.78;8.54;1054;65;3717.00;59
9725;62;626356322;9725;379;10781;10836;5.86;0.36;279.76;8.56;1056;65;3718.00;55
9725;62;626356334;9725;371;10782;10836;5.89;0.36;279.76;8.56;1057;65;3719.00;54
9728;63;626356347;9728;365;10785;10841;5.91;0.36;279.71;8.56;1057;66;3720.00;56
9728;63;626356370;9728;362;10788;10841;5.93;0.36;279.71;8.58;1060;66;3721.00;53
9730;63;626356388;9730;358;10788;10841;5.96;0.37;279.69;8.58;1058;66;3722.00;53
9730;63;626356400;9730;351;10789;10842;6.06;0.37;279.69;8.58;1059;66;3723.00;53
9733;63;626356411;9733;348;10794;10846;6.08;0.37;279.67;8.60;1061;66;3724.00;52
9733;63;626356430;9733;341;10794;10846;6.15;0.38;279.67;8.60;1061;66;3725.00;52
9735;63;626356442;9735;341;10796;10849;6.23;0.38;279.66;8.60;1061;66;3726.00;53
9736;63;626356454;9736;338;10797;10849;6.37;0.39;279.75;8.59;1061;66;3727.00;52
9738;63;626356466;9738;334;10800;10849;6.40;0.39;279.74;8.63;1062;66;3728.00;49
9738;63;626356478;9738;337;10800;10849;6.45;0.40;279.74;8.63;1062;66;3729.00;49
9741;63;626356490;9741;344;10805;10853;6.47;0.40;279.76;8.64;1064;66;3730.00;48
9741;63;626356508;9741;350;10807;10853;6.50;0.40;279.76;8.65;1066;66;3731.00;46
9745;63;626356520;9745;349;10808;10853;6.40;0.39;279.78;8.66;1063;66;3732.00;45
9749;63;626356532;9749;350;10809;10853;6.34;0.39;279.71;8.66;1060;66;3733.00;44
9755;63;626356543;9755;356;10810;10854;6.24;0.38;279.72;8.67;1055;66;3734.00;44
9757;63;626356556;9757;358;10812;10856;6.23;0.38;279.71;8.67;1055;66;3735.00;44
9764;63;626356568;9764;358;10813;10856;6.13;0.37;279.68;8.68;1049;66;3736.00;43
9765;63;626356580;9765;358;10815;10857;6.11;0.37;279.66;8.68;1050;66;3737.00;42
9769;63;626356591;9769;362;10816;10857;6.05;0.37;279.66;8.69;1047;66;3738.00;41
9772;63;626356602;9772;364;10817;10857;6.04;0.37;279.66;8.70;1045;66;3739.00;40
9778;63;626356613;9778;355;10818;10857;5.97;0.37;279.74;8.70;1040;66;3740.00;39
9782;63;626356624;9782;344;10819;10857;5.97;0.37;279.77;8.71;1037;66;3741.00;38
9786;63;626356636;9786;335;10819;10857;5.96;0.36;279.80;8.71;1033;66;3742.00;38
9788;63;626356647;9788;338;10820;10857;5.92;0.36;279.84;8.71;1032;66;3743.00;37
9791;63;626356658;9791;349;10886;10984;6.25;0.39;279.88;8.66;1095;66;3744.00;98
9797;63;626356680;9797;348;10888;10985;6.20;0.38;279.87;8.66;1091;66;3745.00;97
9799;63;626356692;9799;337;10898;10985;6.29;0.39;279.92;8.66;1099;66;3746.00;87
9804;63;626356704;9804;329;10906;10985;6.39;0.39;280.01;8.66;1102;66;3747.00;79
9806;63;626356717;9806;320;10912;10985;6.47;0.40;280.08;8.66;1106;66;3748.00;73
9809;63;626356729;9809;310;10917;10985;6.48;0.40;280.10;8.65;1108;66;3749.00;68
9811;63;626356744;9811;309;10922;10990;6.50;0.40;280.09;8.65;1111;66;3750.00;68
9816;63;626356757;9816;312;10927;10990;6.46;0.40;280.19;8.65;1111;66;3751.00;63
9821;63;626356771;9821;308;10928;10991;6.43;0.40;280.30;8.65;1107;66;3752.00;63
9823;63;626356790;9823;306;10933;10992;6.48;0.40;280.31;8.65;1110;66;3753.00;59
9830;63;626356803;9830;310;10934;10992;6.48;0.40;280.40;8.65;1104;66;3754.00;58
9832;63;626356818;9832;311;10936;10993;6.51;0.40;280.42;8.65;1104;66;3755.00;57
9838;63;626356832;9838;312;10938;10993;6.58;0.40;280.47;8.65;1100;66;3756.00;55
9842;63;626356857;9842;321;10938;10993;6.61;0.41;280.56;8.65;1096;66;3757.00;55
9844;63;626356880;9844;316;10940;10993;6.68;0.41;280.54;8.65;1096;66;3758.00;53
9850;63;626356900;9850;320;10943;10997;6.70;0.41;280.59;8.65;1093;66;3759.00;54
9855;63;626356924;9855;318;10946;10997;6.73;0.41;280.58;8.65;1091;66;3760.00;51
9858;63;626356943;9858;314;10947;10997;6.74;0.41;280.64;8.65;1089;66;3761.00;50
9861;63;626356965;9861;312;10950;11000;6.82;0.42;280.68;8.65;1089;66;3762.00;50
9866;63;626356981;9866;310;10951;11000;6.81;0.42;280.75;8.65;1085;66;3763.00;49
9870;63;626357004;9870;310;10951;11000;6.80;0.42;280.77;8.65;1081;66;3764.00;49
9874;63;626357019;9874;314;10954;11004;6.86;0.42;280.87;8.65;1080;66;3765.00;50
9879;63;626357035;9879;315;10955;11005;6.89;0.42;280.97;8.65;1076;66;3766.00;50
9882;63;626357050;9882;314;10956;11005;6.87;0.42;280.98;8.69;1074;66;3767.00;49
9889;63;626357066;9889;310;10959;11009;6.89;0.42;280.98;8.69;1070;66;3768.00;50
9892;63;626357081;9892;310;10960;11009;6.94;0.43;281.01;8.69;1068;66;3769.00;49
9895;63;626357096;9895;314;10960;11009;7.00;0.43;281.04;8.69;1065;66;3770.00;49
9901;63;626357110;9901;311;10963;11010;6.98;0.43;281.07;8.69;1062;66;3771.00;47
9907;63;626357124;9907;315;10964;11010;6.95;0.42;281.10;8.69;1057;66;3772.00;46
9912;63;626357138;9912;315;10967;11016;6.95;0.42;281.19;8.68;1055;66;3773.00;49
9916;63;626357154;9916;315;10968;11016;6.95;0.42;281.23;8.68;1052;66;3774.00;48
9924;63;626357168;9924;323;10968;11017;6.90;0.42;281.28;8.68;1044;66;3775.00;49
9925;63;626357183;9925;320;10969;11017;6.96;0.42;281.26;8.68;1044;66;3776.00;48
9929;63;626357197;9929;322;10969;11017;7.02;0.43;281.33;8.68;1040;66;3777.00;48
9935;63;626357217;9935;323;10969;11017;7.02;0.43;281.47;8.68;1034;66;3778.00;48
9937;63;626357232;9937;325;10969;11017;7.04;0.43;281.45;8.68;1032;66;3779.00;48
9945;63;626357248;9945;331;10992;11053;7.07;0.43;281.60;8.66;1047;66;3780.00;61
9947;63;626357266;9947;336;10994;11053;7.01;0.43;281.67;8.66;1047;66;3781.00;59
9954;63;626357281;9954;332;10996;11053;6.95;0.42;281.77;8.66;1042;66;3782.00;57
9958;63;626357295;9958;335;10997;11053;6.89;0.42;281.84;8.70;1039;66;3783.00;56
9961;63;626357309;9961;332;10999;11053;6.86;0.42;281.90;8.70;1038;66;3784.00;54
9964;63;626357324;9964;341;10999;11053;6.84;0.42;281.96;8.70;1035;66;3785.00;54
9967;63;626357338;9967;344;11003;11057;6.81;0.41;282.02;8.69;1036;66;3786.00;54
9969;63;626357352;9969;332;11003;11057;6.80;0.41;282.06;8.69;1034;66;3787.00;54
9973;63;626357365;9973;332;11005;11061;6.80;0.41;282.04;8.69;1032;66;3788.00;56
9977;63;626357380;9977;329;11007;11062;6.74;0.41;282.16;8.69;1030;66;3789.00;55
9979;63;626357395;9979;320;11007;11062;6.70;0.41;282.20;8.69;1028;66;3790.00;55
9982;63;626357409;9982;332;11009;11062;6.71;0.41;282.23;8.69;1027;66;3791.00;53
9986;63;626357423;9986;330;11018;11075;6.77;0.41;282.26;8.68;1032;66;3792.00;57
9987;63;626357438;9987;329;11019;11075;6.79;0.41;282.29;8.68;1032;66;3793.00;56
9989;63;626357453;9989;332;11020;11075;6.82;0.42;282.30;8.68;1031;66;3794.00;55
9994;63;626357466;9994;335;11021;11076;6.85;0.42;282.40;8.68;1027;66;3795.00;55
9996;63;626357491;9996;323;11021;11077;6.93;0.42;282.45;8.68;1025;66;3796.00;56
9998;63;626357505;9998;309;11021;11077;6.98;0.43;282.46;8.68;1023;66;3797.00;56
10000;63;626357519;10000;307;11023;11080;7.08;0.43;282.50;8.68;1023;66;3798.00;57
10002;63;626357533;10002;297;11024;11080;7.16;0.44;282.52;8.68;1022;66;3799.00;56
10003;63;626357547;10003;291;11024;11080;7.24;0.44;282.51;8.68;1021;66;3800.00;56
10004;63;626357565;10004;279;11024;11080;7.34;0.45;282.53;8.68;1020;66;3801.00;56
10008;63;626357579;10008;276;11028;11086;7.32;0.45;282.51;8.68;1020;66;3802.00;58
10013;63;626357595;10013;273;11028;11086;7.34;0.45;282.56;8.68;1015;66;3803.00;58
10019;63;626357610;10019;268;11029;11086;7.33;0.45;282.58;8.68;1010;66;3804.00;57
10023;63;626357624;10023;264;11029;11086;7.29;0.44;282.61;8.68;1006;66;3805.00;57
10025;63;626357637;10025;274;11032;11090;7.26;0.44;282.64;8.67;1007;66;3806.00;58
10029;63;626357651;10029;264;11034;11091;7.22;0.44;282.65;8.71;1005;66;3807.00;57
10032;63;626357665;10032;259;11034;11091;7.18;0.44;282.66;8.71;1002;66;3808.00;57
10034;63;626357679;10034;251;11035;11092;7.19;0.44;282.72;8.71;1001;66;3809.00;57
10034;63;626357694;10034;250;11035;11092;7.17;0.44;282.72;8.71;1001;66;3810.00;57
10038;63;626357708;10038;242;11035;11092;7.14;0.43;282.80;8.71;997;66;3811.00;57
10039;63;626357721;10039;241;11035;11092;7.15;0.44;282.83;8.71;996;66;3812.00;57
10042;63;626357734;10042;240;11035;11092;7.14;0.43;282.83;8.71;993;66;3813.00;57
10044;63;626357747;10044;237;11035;11092;7.16;0.44;282.83;8.71;991;66;3814.00;57
10048;63;626357760;10048;238;11035;11092;7.18;0.44;282.79;8.71;987;66;3815.00;57
10050;63;626357773;10050;247;11071;11162;7.10;0.43;282.81;8.68;1021;66;3816.00;91
10052;63;626357792;10052;245;11073;11163;7.08;0.43;282.84;8.68;1021;66;3817.00;90
10055;63;626357805;10055;246;11076;11163;7.13;0.43;282.84;8.68;1021;66;3818.00;87
10057;63;626357819;10057;251;11079;11163;7.15;0.44;282.91;8.67;1022;66;3819.00;84
10061;63;626357832;10061;258;11083;11163;7.19;0.44;282.88;8.67;1022;66;3820.00;80
10064;63;626357846;10064;270;11085;11163;7.18;0.44;282.91;8.67;1021;66;3821.00;78
10065;63;626357860;10065;274;11088;11163;7.21;0.44;282.89;8.67;1023;66;3822.00;75
10070;63;626357873;10070;271;11092;11163;7.16;0.43;282.87;8.67;1022;66;3823.00;71
10072;63;626357885;10072;288;11093;11164;7.11;0.43;282.89;8.67;1021;66;3824.00;71
10072;63;626357898;10072;290;11098;11166;7.10;0.43;282.89;8.67;1026;66;3825.00;68
10072;63;626357912;10072;294;11102;11166;7.07;0.43;282.89;8.67;1030;66;3826.00;64
10073;63;626357924;10073;295;11105;11170;6.99;0.42;282.93;8.67;1032;66;3827.00;65
10075;63;626357937;10075;304;11105;11170;6.89;0.42;282.90;8.67;1030;66;3828.00;65
10076;63;626357949;10076;307;11105;11170;6.79;0.41;282.89;8.67;1029;66;3829.00;65
10076;63;626357968;10076;307;11105;11170;6.67;0.41;282.89;8.67;1029;66;3830.00;65
10079;63;626357980;10079;309;11108;11176;6.58;0.40;282.89;8.66;1029;66;3831.00;68
10082;63;626357993;10082;314;11108;11176;6.52;0.40;282.84;8.66;1026;66;3832.00;68
10085;63;626358006;10085;317;11109;11176;6.49;0.40;282.84;8.66;1024;66;3833.00;67
10087;63;626358024;10087;310;11111;11179;6.46;0.39;282.84;8.66;1024;66;3834.00;68
10087;63;626358037;10087;307;11111;11179;6.45;0.39;282.84;8.66;1024;66;3835.00;68
10089;63;626358048;10089;311;11112;11179;6.43;0.39;282.83;8.66;1023;66;3836.00;67
10090;63;626358060;10090;313;11112;11180;6.43;0.39;282.82;8.66;1022;66;3837.00;68
10094;63;626358071;10094;314;11113;11181;6.39;0.39;282.80;8.66;1019;66;3838.00;68
10098;63;626358083;10098;309;11113;11181;6.34;0.39;282.83;8.66;1015;66;3839.00;68
10103;63;626358097;10103;311;11128;11207;6.29;0.38;282.78;8.65;1025;66;3840.00;79
10105;63;626358110;10105;305;11129;11207;6.19;0.38;282.77;8.65;1024;66;3841.00;78
10106;63;626358122;10106;299;11131;11207;6.14;0.38;282.74;8.65;1025;66;3842.00;76
10113;63;626358133;10113;296;11133;11208;6.04;0.37;282.78;8.65;1020;66;3843.00;75
10115;63;626358145;10115;301;11133;11208;6.00;0.37;282.76;8.65;1018;66;3844.00;75
10118;63;626358157;10118;292;11136;11212;5.94;0.36;282.73;8.66;1018;66;3845.00;76
10122;63;626358170;10122;298;11138;11214;5.86;0.36;282.66;8.66;1016;66;3846.00;76
10124;63;626358189;10124;296;11141;11218;5.84;0.36;282.66;8.66;1017;66;3847.00;77
10129;63;626358200;10129;292;11142;11218;5.83;0.35;282.59;8.66;1013;66;3848.00;76
10132;63;626358212;10132;292;11142;11218;5.79;0.35;282.53;8.66;1010;66;3849.00;76
10133;63;626358223;10133;288;11142;11218;5.77;0.35;282.52;8.66;1009;66;3850.00;76
10134;63;626358233;10134;284;11142;11218;5.74;0.35;282.50;8.66;1008;66;3851.00;76
10137;63;626358245;10137;287;11153;11230;5.74;0.35;282.46;8.65;1016;66;3852.00;77
10140;63;626358257;10140;284;11153;11230;5.65;0.34;282.39;8.65;1013;66;3853.00;77
10143;63;626358269;10143;280;11153;11230;5.62;0.34;282.36;8.65;1010;66;3854.00;77
10146;63;626358281;10146;283;11153;11230;5.59;0.34;282.31;8.65;1007;66;3855.00;77
10149;63;626358292;10149;287;11153;11230;5.60;0.34;282.28;8.65;1004;66;3856.00;77
10149;63;626358303;10149;292;11154;11230;5.61;0.34;282.28;8.65;1005;66;3857.00;76
10150;63;626358313;10150;295;11154;11231;5.61;0.34;282.26;8.65;1004;66;3858.00;77
10151;63;626358324;10151;293;11155;11231;5.58;0.34;282.24;8.65;1004;66;3859.00;76
10152;63;626358335;10152;297;11160;11237;5.63;0.34;282.23;8.65;1008;66;3860.00;77
10154;63;626358347;10154;304;11161;11238;5.61;0.34;282.24;8.65;1007;66;3861.00;77
10156;63;626358358;10156;305;11163;11238;5.59;0.34;282.27;8.65;1007;66;3862.00;75
10158;63;626358369;10158;303;11164;11238;5.59;0.34;282.24;8.66;1006;66;3863.00;74
10158;63;626358380;10158;304;11166;11242;5.64;0.34;282.24;8.66;1008;66;3864.00;76
10159;63;626358392;10159;307;11168;11242;5.64;0.34;282.24;8.67;1009;66;3865.00;74
10162;63;626358404;10162;312;11169;11242;5.64;0.34;282.29;8.68;1007;66;3866.00;73
10162;63;626358415;10162;307;11171;11243;5.69;0.35;282.29;8.69;1009;66;3867.00;72
10164;63;626358426;10164;307;11174;11247;5.76;0.35;282.30;8.68;1010;66;3868.00;73
10165;63;626358438;10165;300;11175;11247;5.80;0.35;282.27;8.69;1010;66;3869.00;72
10166;63;626358451;10166;295;11179;11253;5.90;0.36;282.28;8.69;1013;66;3870.00;74
10169;63;626358463;10169;297;11182;11253;5.99;0.36;282.27;8.71;1013;66;3871.00;71
10170;63;626358475;10170;295;11183;11253;6.08;0.37;282.25;8.71;1013;66;3872.00;70
10171;63;626358487;10171;290;11185;11253;6.18;0.38;282.25;8.73;1014;66;3873.00;68
10172;63;626358499;10172;287;11188;11257;6.35;0.39;282.23;8.73;1016;66;3874.00;69
10175;63;626358512;10175;289;11190;11257;6.40;0.39;282.20;8.75;1015;66;3875.00;67
10177;64;626358529;10177;281;11191;11257;6.48;0.39;282.20;8.75;1014;67;3876.00;66
10178;64;626358552;10178;283;11191;11257;6.57;0.40;282.20;8.75;1013;67;3877.00;66
10179;64;626358565;10179;280;11194;11258;6.64;0.40;282.18;8.77;1015;67;3878.00;64
10180;64;626358578;10180;280;11195;11259;6.69;0.40;282.20;8.77;1015;67;3879.00;64
10180;64;626358591;10180;275;11196;11259;6.76;0.41;282.20;8.78;1016;67;3880.00;63
10180;64;626358603;10180;278;11198;11260;6.81;0.41;282.20;8.79;1018;67;3881.00;62
10180;64;626358627;10180;274;11198;11260;6.80;0.41;282.20;8.79;1018;67;3882.00;62
10181;64;626358644;10181;274;11200;11260;6.83;0.42;282.18;8.82;1019;67;3883.00;60
10183;64;626358657;10183;278;11200;11260;6.78;0.41;282.17;8.82;1017;67;3884.00;60
10184;64;626358669;10184;278;11201;11260;6.79;0.41;282.17;8.83;1017;67;3885.00;59
10185;64;626358680;10185;279;11202;11260;6.79;0.41;282.16;8.85;1017;67;3886.00;58
10186;64;626358692;10186;288;11203;11260;6.78;0.41;282.15;8.86;1017;67;3887.00;57
10186;64;626358704;10186;301;11269;11387;6.96;0.43;282.15;8.82;1083;67;3888.00;118
10187;64;626358726;10187;298;11274;11388;6.92;0.43;282.13;8.83;1087;67;3889.00;114
10189;64;626358739;10189;288;11281;11388;6.93;0.43;282.23;8.83;1092;67;3890.00;107
10191;64;626358751;10191;291;11286;11388;6.89;0.43;282.24;8.84;1095;67;3891.00;102
10192;64;626358764;10192;284;11291;11388;6.93;0.43;282.28;8.84;1099;67;3892.00;97
10193;64;626358776;10193;285;11293;11388;6.90;0.43;282.26;8.84;1100;67;3893.00;95
10197;64;626358793;10197;288;11301;11388;6.90;0.42;282.25;8.86;1104;67;3894.00;87
10199;64;626358811;10199;287;11302;11388;6.91;0.43;282.22;8.86;1103;67;3895.00;86
10202;64;626358824;10202;295;11309;11389;6.92;0.43;282.23;8.88;1107;67;3896.00;80
10203;64;626358837;10203;303;11314;11390;6.95;0.43;282.26;8.89;1111;67;3897.00;76
10208;64;626358852;10208;307;11318;11390;6.96;0.43;282.30;8.89;1110;67;3898.00;72
10210;64;626358871;10210;318;11323;11391;6.92;0.42;282.33;8.90;1113;67;3899.00;68
10212;64;626358896;10212;326;11328;11406;6.86;0.42;282.30;8.90;1116;67;3900.00;78
10213;64;626358922;10213;332;11332;11406;6.75;0.41;282.33;8.92;1119;67;3901.00;74
10218;64;626358943;10218;338;11333;11406;6.61;0.41;282.41;8.92;1115;67;3902.00;73
10219;64;626358963;10219;348;11336;11410;6.57;0.40;282.40;8.92;1117;67;3903.00;74
10225;64;626358981;10225;352;11340;11410;6.40;0.39;282.45;8.93;1115;67;3904.00;70
10229;64;626358996;10229;355;11340;11410;6.30;0.39;282.45;8.93;1111;67;3905.00;70
10231;64;626359009;10231;363;11346;11413;6.25;0.38;282.53;8.96;1115;67;3906.00;67
10234;64;626359023;10234;369;11349;11413;6.19;0.38;282.58;8.96;1115;67;3907.00;64
10240;64;626359037;10240;372;11350;11413;6.09;0.37;282.69;8.96;1110;67;3908.00;63
10241;64;626359051;10241;383;11354;11417;6.07;0.37;282.67;8.96;1113;67;3909.00;63
10245;64;626359064;10245;371;11355;11418;6.02;0.37;282.76;8.96;1110;67;3910.00;63
10249;64;626359078;10249;371;11355;11418;6.01;0.37;282.79;8.96;1106;67;3911.00;63
10255;64;626359092;10255;371;11361;11422;6.00;0.37;282.87;8.98;1106;67;3912.00;61
10260;64;626359105;10260;366;11364;11422;6.00;0.37;282.96;8.98;1104;67;3913.00;58
10261;64;626359118;10261;364;11365;11422;6.03;0.37;282.98;8.99;1104;67;3914.00;57
10265;64;626359131;10265;370;11368;11424;6.03;0.37;283.07;8.99;1103;67;3915.00;56
10270;64;626359145;10270;371;11368;11424;6.02;0.37;283.08;8.99;1098;67;3916.00;56
10275;64;626359159;10275;361;11373;11430;6.09;0.37;283.15;9.00;1098;67;3917.00;57
10279;64;626359173;10279;359;11375;11430;6.12;0.37;283.28;9.00;1096;67;3918.00;55
10283;64;626359186;10283;354;11375;11431;6.15;0.37;283.39;9.00;1092;67;3919.00;56
10285;64;626359199;10285;356;11375;11431;6.22;0.38;283.46;9.00;1090;67;3920.00;56
10289;64;626359214;10289;352;11375;11431;6.28;0.38;283.56;9.00;1086;67;3921.00;56
10292;64;626359230;10292;345;11375;11431;6.32;0.39;283.59;9.00;1083;67;3922.00;56
10295;64;626359244;10295;348;11375;11431;6.35;0.39;283.65;9.00;1080;67;3923.00;56
10298;64;626359258;10298;348;11385;11443;6.45;0.39;283.69;8.99;1087;67;3924.00;58
10302;64;626359279;10302;351;11385;11443;6.49;0.40;283.79;8.99;1083;67;3925.00;58
10303;64;626359293;10303;356;11386;11443;6.56;0.40;283.80;8.99;1083;67;3926.00;57
10308;64;626359307;10308;358;11386;11443;6.59;0.40;283.85;8.99;1078;67;3927.00;57
10311;64;626359320;10311;355;11386;11443;6.65;0.41;283.88;8.99;1075;67;3928.00;57
10313;64;626359334;10313;355;11386;11443;6.68;0.41;283.91;8.99;1073;67;3929.00;57
10318;64;626359349;10318;359;11392;11447;6.66;0.41;284.01;9.00;1074;67;3930.00;55
10321;64;626359364;10321;352;11392;11447;6.66;0.41;284.04;9.00;1071;67;3931.00;55
10324;64;626359378;10324;356;11396;11451;6.70;0.41;284.12;9.00;1072;67;3932.00;55
10329;64;626359392;10329;351;11397;11452;6.72;0.41;284.18;9.00;1068;67;3933.00;55
10334;64;626359406;10334;353;11398;11452;6.68;0.41;284.19;9.00;1064;67;3934.00;54
10339;64;626359421;10339;358;11399;11452;6.62;0.41;284.29;9.00;1060;67;3935.00;53
10344;64;626359434;10344;360;11409;11465;6.57;0.40;284.35;8.99;1065;67;3936.00;56
10347;64;626359449;10347;359;11409;11465;6.56;0.40;284.37;8.99;1062;67;3937.00;56
10352;64;626359463;10352;361;11411;11465;6.56;0.40;284.44;8.99;1059;67;3938.00;54
10358;64;626359478;10358;371;11414;11466;6.54;0.40;284.54;9.04;1056;67;3939.00;52
10362;64;626359493;10362;355;11414;11467;6.56;0.40;284.55;9.04;1052;67;3940.00;53
10367;64;626359507;10367;353;11415;11467;6.60;0.40;284.59;9.04;1048;67;3941.00;52
10370;64;626359521;10370;349;11418;11470;6.66;0.40;284.59;9.04;1048;67;3942.00;52
10376;64;626359535;10376;346;11419;11470;6.65;0.40;284.67;9.03;1043;67;3943.00;51
10381;64;626359550;10381;341;11419;11470;6.71;0.41;284.68;9.03;1038;67;3944.00;51
10384;64;626359564;10384;338;11419;11470;6.73;0.41;284.79;9.03;1035;67;3945.00;51
10386;64;626359578;10386;339;11424;11476;6.76;0.41;284.82;9.03;1038;67;3946.00;52
10390;64;626359593;10390;337;11424;11476;6.79;0.41;284.87;9.03;1034;67;3947.00;52
10397;64;626359607;10397;342;11424;11476;6.74;0.41;284.91;9.03;1027;67;3948.00;52
10399;64;626359621;10399;342;11424;11476;6.75;0.41;284.94;9.03;1025;67;3949.00;52
10402;64;626359635;10402;343;11427;11480;6.75;0.41;285.02;9.03;1025;67;3950.00;53
10408;64;626359650;10408;344;11428;11481;6.76;0.41;285.09;9.03;1020;67;3951.00;53
10411;64;626359664;10411;344;11428;11481;6.76;0.41;285.12;9.03;1017;67;3952.00;53
10415;64;626359678;10415;348;11430;11482;6.74;0.41;285.09;9.07;1015;67;3953.00;52
10419;64;626359691;10419;358;11430;11482;6.71;0.41;285.13;9.07;1011;67;3954.00;52
10422;64;626359706;10422;369;11430;11482;6.66;0.41;285.22;9.07;1008;67;3955.00;52
10425;64;626359720;10425;380;11430;11482;6.66;0.41;285.22;9.07;1005;67;3956.00;52
10429;64;626359733;10429;374;11430;11482;6.61;0.40;285.25;9.07;1001;67;3957.00;52
10435;64;626359747;10435;362;11430;11482;6.51;0.40;285.34;9.07;995;67;3958.00;52
10439;64;626359760;10439;358;11430;11482;6.43;0.39;285.40;9.07;991;67;3959.00;52
10442;64;626359775;10442;387;11501;11607;6.48;0.40;285.38;9.01;1059;67;3960.00;106
10448;64;626359797;10448;381;11503;11608;6.45;0.40;285.43;9.01;1055;67;3961.00;105
10454;64;626359812;10454;365;11508;11608;6.54;0.40;285.46;9.01;1054;67;3962.00;100
10456;64;626359826;10456;366;11510;11608;6.63;0.41;285.49;9.01;1054;67;3963.00;98
10461;64;626359842;10461;364;11515;11608;6.67;0.41;285.53;9.05;1054;67;3964.00;93
10465;64;626359858;10465;362;11518;11608;6.73;0.41;285.57;9.05;1053;67;3965.00;90
10468;64;626359879;10468;354;11522;11608;6.78;0.42;285.60;9.05;1054;67;3966.00;86
10473;64;626359894;10473;346;11523;11608;6.80;0.42;285.65;9.05;1050;67;3967.00;85
10477;64;626359908;10477;337;11530;11609;6.86;0.42;285.68;9.05;1053;67;3968.00;79
10480;64;626359923;10480;332;11530;11610;6.79;0.42;285.68;9.05;1050;67;3969.00;80
10482;64;626359942;10482;331;11533;11610;6.75;0.41;285.70;9.05;1051;67;3970.00;77
10483;64;626359955;10483;328;11537;11614;6.71;0.41;285.74;9.04;1054;67;3971.00;77
10486;64;626359969;10486;322;11538;11614;6.69;0.41;285.74;9.04;1052;67;3972.00;76
10489;64;626359983;10489;318;11538;11614;6.69;0.41;285.74;9.04;1049;67;3973.00;76
10492;64;626359997;10492;323;11539;11614;6.70;0.41;285.77;9.04;1047;67;3974.00;75
10495;64;626360012;10495;315;11543;11620;6.70;0.41;285.83;9.04;1048;67;3975.00;77
10497;64;626360026;10497;319;11544;11620;6.70;0.41;285.80;9.04;1047;67;3976.00;76
10498;64;626360040;10498;319;11544;11620;6.74;0.41;285.84;9.04;1046;67;3977.00;76
10500;64;626360053;10500;312;11546;11623;6.78;0.41;285.81;9.04;1046;67;3978.00;77
10500;64;626360067;10500;309;11547;11623;6.84;0.42;285.81;9.04;1047;67;3979.00;76
10501;64;626360081;10501;308;11547;11623;6.91;0.42;285.84;9.04;1046;67;3980.00;76
10504;64;626360094;10504;297;11548;11624;6.96;0.43;285.88;9.04;1044;67;3981.00;76
10506;64;626360110;10506;292;11550;11625;7.01;0.43;285.91;9.04;1044;67;3982.00;75
10511;64;626360124;10511;292;11550;11625;7.01;0.43;285.89;9.04;1039;67;3983.00;75
10515;64;626360138;10515;290;11560;11638;6.99;0.43;285.86;9.03;1045;67;3984.00;78
10517;64;626360153;10517;290;11560;11638;6.97;0.43;285.86;9.03;1043;67;3985.00;78
10517;64;626360166;10517;301;11560;11638;6.94;0.42;285.86;9.03;1043;67;3986.00;78
10519;64;626360179;10519;306;11561;11639;6.91;0.42;285.87;9.03;1042;67;3987.00;78
10522;64;626360192;10522;314;11561;11639;6.89;0.42;285.95;9.03;1039;67;3988.00;78
10523;64;626360205;10523;322;11565;11643;6.90;0.42;285.93;9.07;1042;67;3989.00;78
10524;64;626360221;10524;324;11566;11643;6.87;0.42;285.94;9.07;1042;67;3990.00;77
10524;64;626360233;10524;332;11569;11647;6.81;0.42;285.94;9.07;1045;67;3991.00;78
10527;64;626360247;10527;337;11569;11647;6.76;0.41;285.92;9.07;1042;67;3992.00;78
10528;64;626360259;10528;343;11569;11647;6.70;0.41;285.91;9.07;1041;67;3993.00;78
10530;64;626360272;10530;342;11569;11647;6.58;0.40;285.89;9.07;1039;67;3994.00;78
10532;64;626360284;10532;345;11569;11647;6.52;0.40;285.92;9.07;1037;67;3995.00;78
10532;64;626360297;10532;336;11579;11659;6.51;0.40;285.92;9.06;1047;67;3996.00;80
10536;64;626360309;10536;345;11580;11659;6.47;0.40;285.87;9.06;1044;67;3997.00;79
10537;64;626360321;10537;354;11580;11659;6.45;0.40;285.84;9.06;1043;67;3998.00;79
10539;64;626360333;10539;351;11580;11659;6.39;0.39;285.81;9.06;1041;67;3999.00;79
10544;64;626360346;10544;344;11580;11659;6.40;0.39;285.76;9.06;1036;67;4000.00;79
10546;64;626360362;10546;339;11580;11659;6.33;0.39;285.73;9.06;1034;67;4001.00;79
10548;64;626360373;10548;335;11580;11660;6.27;0.39;285.70;9.06;1032;67;4002.00;80
10552;64;626360385;10552;334;11580;11660;6.22;0.38;285.68;9.06;1028;67;4003.00;80
10555;64;626360397;10555;331;11584;11666;6.17;0.38;285.65;9.06;1029;67;4004.00;82
10556;64;626360410;10556;321;11588;11668;6.14;0.38;285.64;9.09;1032;67;4005.00;80
10559;64;626360421;10559;320;11588;11668;6.14;0.38;285.67;9.09;1029;67;4006.00;80
10561;64;626360434;10561;322;11588;11668;6.12;0.38;285.70;9.09;1027;67;4007.00;80
10564;64;626360445;10564;319;11591;11672;6.12;0.38;285.71;9.08;1027;67;4008.00;81
10564;64;626360456;10564;322;11591;11672;6.09;0.37;285.71;9.08;1027;67;4009.00;81
10567;64;626360468;10567;315;11591;11672;6.04;0.37;285.72;9.08;1024;67;4010.00;81
10570;64;626360479;10570;319;11592;11673;5.99;0.37;285.81;9.08;1022;67;4011.00;81
10575;64;626360491;10575;317;11596;11677;5.91;0.36;285.81;9.12;1021;67;4012.00;81
10578;64;626360502;10578;311;11596;11677;5.87;0.36;285.82;9.12;1018;67;4013.00;81
10580;64;626360513;10580;311;11598;11680;5.81;0.36;285.83;9.12;1018;67;4014.00;82
10584;64;626360524;10584;306;11602;11680;5.75;0.35;285.84;9.17;1018;67;4015.00;78
10591;64;626360536;10591;310;11602;11680;5.66;0.35;285.84;9.17;1011;67;4016.00;78
10593;64;626360553;10593;301;11602;11680;5.67;0.35;285.85;9.17;1009;67;4017.00;78
10595;64;626360564;10595;306;11606;11684;5.69;0.35;285.85;9.21;1011;67;4018.00;78
10598;64;626360575;10598;293;11606;11684;5.74;0.35;285.82;9.21;1008;67;4019.00;78
10600;64;626360588;10600;282;11607;11684;5.82;0.36;285.85;9.21;1007;67;4020.00;77
10603;64;626360599;10603;268;11608;11684;5.85;0.36;285.81;9.24;1005;67;4021.00;76
10604;64;626360611;10604;256;11608;11685;5.91;0.36;285.80;9.24;1004;67;4022.00;77
10605;64;626360622;10605;252;11609;11686;5.98;0.36;285.78;9.24;1004;67;4023.00;77
10606;64;626360633;10606;245;11610;11686;6.02;0.37;285.78;9.28;1004;67;4024.00;76
10609;64;626360645;10609;244;11611;11687;6.04;0.37;285.78;9.28;1002;67;4025.00;76
10610;64;626360663;10610;240;11611;11687;6.10;0.37;285.76;9.28;1001;67;4026.00;76
10612;64;626360674;10612;244;11612;11687;6.13;0.37;285.72;9.31;1000;67;4027.00;75
10614;64;626360685;10614;235;11613;11687;6.18;0.38;285.76;9.31;999;67;4028.00;74
10617;64;626360697;10617;234;11613;11687;6.24;0.38;285.78;9.31;996;67;4029.00;74
10618;64;626360709;10618;232;11614;11687;6.32;0.38;285.79;9.35;996;67;4030.00;73
10619;64;626360720;10619;229;11614;11687;6.38;0.39;285.76;9.35;995;67;4031.00;73
10621;64;626360732;10621;248;11678;11814;6.66;0.41;285.76;9.30;1057;67;4032.00;136
10623;64;626360754;10623;233;11682;11815;6.71;0.41;285.85;9.33;1059;67;4033.00;133
10624;64;626360767;10624;228;11692;11815;6.86;0.42;285.85;9.33;1068;67;4034.00;123
10624;64;626360779;10624;223;11695;11815;6.93;0.43;285.85;9.33;1071;67;4035.00;120
10627;64;626360791;10627;230;11703;11815;7.03;0.43;285.84;9.32;1076;67;4036.00;112
10627;64;626360804;10627;230;11707;11815;7.07;0.43;285.84;9.32;1080;67;4037.00;108
10629;64;626360816;10629;232;11712;11815;7.20;0.44;285.84;9.32;1083;67;4038.00;103
10631;64;626360829;10631;232;11714;11815;7.26;0.44;285.86;9.32;1083;67;4039.00;101
10635;64;626360843;10635;234;11719;11816;7.29;0.45;285.85;9.34;1084;67;4040.00;97
10637;64;626360857;10637;238;11722;11817;7.37;0.45;285.86;9.34;1085;67;4041.00;95
10641;64;626360878;10641;239;11726;11817;7.39;0.45;285.96;9.34;1085;67;4042.00;91
10642;64;626360898;10642;238;11730;11818;7.38;0.45;285.98;9.37;1088;67;4043.00;88
10645;64;626360919;10645;240;11732;11818;7.38;0.45;286.03;9.37;1087;67;4044.00;86
10647;64;626360939;10647;244;11734;11818;7.35;0.45;286.10;9.38;1087;67;4045.00;84
10648;64;626360959;10648;255;11737;11818;7.37;0.45;286.10;9.40;1089;67;4046.00;81
10650;64;626360982;10650;255;11740;11822;7.35;0.45;286.18;9.39;1090;67;4047.00;82
10652;64;626360999;10652;265;11741;11822;7.28;0.44;286.25;9.39;1089;67;4048.00;81
10656;64;626361015;10656;268;11742;11822;7.24;0.44;286.34;9.41;1086;67;4049.00;80
10658;64;626361038;10658;273;11747;11828;7.25;0.44;286.37;9.42;1089;67;4050.00;81
10662;64;626361052;10662;274;11748;11828;7.13;0.43;286.37;9.43;1086;67;4051.00;80
10664;64;626361067;10664;281;11750;11828;7.09;0.43;286.41;9.45;1086;67;4052.00;78
10668;64;626361082;10668;287;11753;11832;6.98;0.43;286.45;9.44;1085;67;4053.00;79
10669;64;626361098;10669;289;11757;11833;6.90;0.42;286.44;9.47;1088;67;4054.00;76
10671;64;626361115;10671;291;11758;11833;6.79;0.41;286.54;9.48;1087;67;4055.00;75
10674;64;626361131;10674;302;11765;11837;6.78;0.41;286.62;9.51;1091;67;4056.00;72
10675;64;626361146;10675;305;11765;11837;6.68;0.41;286.61;9.51;1090;67;4057.00;72
10677;64;626361165;10677;313;11766;11837;6.62;0.40;286.69;9.51;1089;67;4058.00;71
10679;64;626361179;10679;305;11770;11838;6.52;0.40;286.74;9.53;1091;67;4059.00;68
10682;64;626361192;10682;313;11771;11838;6.46;0.39;286.73;9.53;1089;67;4060.00;67
10686;64;626361206;10686;312;11776;11844;6.41;0.39;286.79;9.55;1090;67;4061.00;68
10689;64;626361220;10689;310;11778;11844;6.37;0.39;286.82;9.56;1089;67;4062.00;66
10691;64;626361234;10691;314;11780;11845;6.34;0.39;286.88;9.57;1089;67;4063.00;65
10693;64;626361248;10693;311;11781;11845;6.29;0.38;286.91;9.58;1088;67;4064.00;64
10693;64;626361261;10693;306;11782;11845;6.33;0.39;286.91;9.58;1089;67;4065.00;63
10697;64;626361274;10697;306;11784;11845;6.31;0.39;286.99;9.59;1087;67;4066.00;61
10698;64;626361287;10698;305;11784;11845;6.33;0.39;287.02;9.59;1086;67;4067.00;61
10700;64;626361300;10700;305;11793;11857;6.38;0.39;287.10;9.59;1093;67;4068.00;64
10702;64;626361313;10702;303;11795;11857;6.35;0.39;287.08;9.60;1093;67;4069.00;62
10705;64;626361337;10705;300;11797;11857;6.32;0.39;287.10;9.60;1092;67;4070.00;60
10708;64;626361361;10708;307;11797;11857;6.31;0.39;287.16;9.60;1089;67;4071.00;60
10711;64;626361393;10711;298;11799;11857;6.26;0.38;287.19;9.62;1088;67;4072.00;58
10715;64;626361407;10715;305;11799;11857;6.23;0.38;287.26;9.62;1084;67;4073.00;58
10717;64;626361420;10717;304;11803;11861;6.18;0.38;287.29;9.62;1086;67;4074.00;58
10721;64;626361434;10721;299;11804;11861;6.14;0.38;287.37;9.63;1083;67;4075.00;57
10728;64;626361447;10728;291;11808;11865;6.10;0.37;287.46;9.63;1080;67;4076.00;57
10730;64;626361462;10730;294;11810;11866;6.08;0.37;287.48;9.64;1080;67;4077.00;56
10735;64;626361476;10735;300;11811;11866;6.02;0.37;287.43;9.64;1076;67;4078.00;55
10739;64;626361488;10739;312;11812;11866;5.93;0.36;287.48;9.64;1073;67;4079.00;54
10744;64;626361503;10744;311;11833;11895;5.88;0.36;287.52;9.64;1089;67;4080.00;62
10748;64;626361519;10748;302;11834;11895;5.87;0.36;287.49;9.63;1086;67;4081.00;61
10751;64;626361532;10751;309;11839;11895;5.88;0.36;287.48;9.64;1088;67;4082.00;56
10758;64;626361553;10758;307;11841;11896;5.88;0.36;287.54;9.64;1083;67;4083.00;55
10759;64;626361567;10759;304;11842;11897;5.91;0.36;287.58;9.65;1083;67;4084.00;55
10764;64;626361580;10764;305;11843;11897;5.89;0.36;287.58;9.65;1079;67;4085.00;54
10768;64;626361593;10768;308;11847;11900;5.92;0.36;287.58;9.65;1079;67;4086.00;53
10769;64;626361607;10769;312;11847;11900;5.99;0.37;287.59;9.65;1078;67;4087.00;53
10772;64;626361619;10772;306;11847;11900;6.01;0.37;287.60;9.65;1075;67;4088.00;53
10776;64;626361633;10776;305;11847;11900;6.03;0.37;287.61;9.65;1071;67;4089.00;53
10781;64;626361646;10781;307;11851;11906;6.08;0.37;287.65;9.65;1070;67;4090.00;55
10784;64;626361659;10784;300;11852;11906;6.16;0.38;287.64;9.65;1068;67;4091.00;54
10788;64;626361672;10788;305;11852;11906;6.17;0.38;287.72;9.65;1064;67;4092.00;54
10789;64;626361685;10789;297;11852;11906;6.25;0.38;287.75;9.65;1063;67;4093.00;54
10796;64;626361698;10796;302;11855;11910;6.27;0.38;287.79;9.65;1059;67;4094.00;55
10800;64;626361712;10800;297;11857;11912;6.37;0.39;287.79;9.65;1057;67;4095.00;55
10804;64;626361726;10804;299;11857;11912;6.44;0.39;287.86;9.65;1053;67;4096.00;55
10808;64;626361739;10808;293;11858;11913;6.50;0.40;287.88;9.65;1050;67;4097.00;55
10812;64;626361752;10812;291;11858;11913;6.56;0.40;287.92;9.65;1046;67;4098.00;55
10818;64;626361766;10818;293;11858;11913;6.66;0.41;288.06;9.65;1040;67;4099.00;55
10824;64;626361782;10824;301;11858;11913;6.71;0.41;288.08;9.65;1034;67;4100.00;55
10829;64;626361801;10829;295;11858;11913;6.76;0.41;288.17;9.65;1029;67;4101.00;55
10833;64;626361821;10833;293;11858;11913;6.81;0.42;288.24;9.65;1025;67;4102.00;55
10837;64;626361835;10837;293;11858;11913;6.89;0.42;288.23;9.65;1021;67;4103.00;55
10843;64;626361850;10843;307;11900;11983;6.95;0.42;288.45;9.61;1057;67;4104.00;83
10849;64;626361871;10849;301;11900;11984;6.98;0.42;288.47;9.61;1051;67;4105.00;84
10853;64;626361885;10853;291;11906;11984;7.09;0.43;288.52;9.61;1053;67;4106.00;78
10855;64;626361901;10855;290;11908;11984;7.19;0.44;288.54;9.65;1053;67;4107.00;76
10858;64;626361915;10858;291;11912;11984;7.31;0.45;288.56;9.65;1054;67;4108.00;72
10860;64;626361929;10860;298;11914;11984;7.35;0.45;288.54;9.65;1054;67;4109.00;70
10864;64;626361945;10864;306;11916;11984;7.38;0.45;288.52;9.65;1052;67;4110.00;68
10870;64;626361959;10870;311;11919;11984;7.37;0.45;288.51;9.64;1049;67;4111.00;65
10875;64;626361973;10875;316;11921;11985;7.32;0.45;288.58;9.64;1046;67;4112.00;64
10880;64;626361986;10880;322;11923;11986;7.27;0.44;288.63;9.64;1043;67;4113.00;63
10885;64;626362001;10885;319;11924;11986;7.22;0.44;288.69;9.64;1039;67;4114.00;62
10888;64;626362014;10888;330;11926;11990;7.21;0.44;288.74;9.64;1038;67;4115.00;64
10892;64;626362028;10892;338;11926;11990;7.16;0.44;288.78;9.64;1034;67;4116.00;64
10898;64;626362041;10898;354;11926;11990;7.15;0.44;288.84;9.64;1028;67;4117.00;64
10901;64;626362055;10901;367;11926;11990;7.08;0.43;288.84;9.64;1025;67;4118.00;64
10905;64;626362075;10905;367;11930;11996;7.02;0.43;288.87;9.64;1025;67;4119.00;66
10909;64;626362088;10909;374;11931;11996;6.94;0.42;288.87;9.64;1022;67;4120.00;65
10916;64;626362102;10916;378;11933;11996;6.83;0.42;288.99;9.64;1017;67;4121.00;63
10921;64;626362115;10921;382;11935;11999;6.73;0.41;289.05;9.64;1014;67;4122.00;64
10922;64;626362128;10922;393;11937;11999;6.68;0.41;289.08;9.64;1015;67;4123.00;62
10928;64;626362141;10928;397;11938;11999;6.59;0.40;289.04;9.64;1010;67;4124.00;61
10934;64;626362155;10934;402;11938;12000;6.48;0.39;289.19;9.64;1004;67;4125.00;62
10937;64;626362168;10937;408;11939;12001;6.38;0.39;289.20;9.64;1002;67;4126.00;62
10943;64;626362180;10943;394;11939;12001;6.31;0.38;289.29;9.64;996;67;4127.00;62
10945;64;626362193;10945;393;11950;12014;6.36;0.39;289.28;9.63;1005;67;4128.00;64
10947;64;626362207;10947;392;11950;12014;6.35;0.39;289.30;9.63;1003;67;4129.00;64
10952;64;626362220;10952;389;11950;12014;6.31;0.38;289.29;9.63;998;67;4130.00;64
10955;64;626362232;10955;393;11951;12015;6.31;0.38;289.37;9.63;996;67;4131.00;64
10957;64;626362245;10957;395;11951;12015;6.32;0.39;289.38;9.63;994;67;4132.00;64
10961;64;626362259;10961;396;11954;12019;6.38;0.39;289.45;9.63;993;67;4133.00;65
10962;64;626362272;10962;406;11954;12019;6.43;0.39;289.43;9.63;992;67;4134.00;65
10963;64;626362286;10963;410;11958;12023;6.44;0.39;289.46;9.62;995;67;4135.00;65
10966;64;626362298;10966;396;11958;12023;6.45;0.39;289.52;9.62;992;67;4136.00;65
10969;64;626362311;10969;387;11958;12023;6.43;0.39;289.52;9.62;989;67;4137.00;65
10973;64;626362324;10973;385;11958;12023;6.42;0.39;289.58;9.62;985;67;4138.00;65
10975;64;626362337;10975;377;11958;12023;6.41;0.39;289.56;9.62;983;67;4139.00;65
10979;64;626362351;10979;384;11982;12057;6.46;0.39;289.58;9.60;1003;67;4140.00;75
10980;64;626362367;10980;373;11983;12057;6.47;0.40;289.56;9.60;1003;67;4141.00;74
10982;64;626362382;10982;370;11984;12057;6.46;0.40;289.55;9.60;1002;67;4142.00;73
10987;64;626362400;10987;364;11984;12057;6.46;0.40;289.56;9.60;997;67;4143.00;73
10990;64;626362413;10990;367;11986;12057;6.49;0.40;289.52;9.65;996;67;4144.00;71
10990;64;626362427;10990;364;11986;12057;6.55;0.40;289.52;9.65;996;67;4145.00;71
10991;64;626362439;10991;365;11987;12058;6.58;0.40;289.51;9.65;996;67;4146.00;71
10994;64;626362452;10994;351;11987;12058;6.61;0.40;289.54;9.65;993;67;4147.00;71
10995;64;626362464;10995;351;11991;12064;6.64;0.41;289.52;9.64;996;67;4148.00;73
10997;64;626362478;10997;342;11992;12065;6.63;0.41;289.51;9.64;995;67;4149.00;73
10999;64;626362495;10999;342;11993;12065;6.63;0.41;289.49;9.64;994;67;4150.00;72
11001;64;626362508;11001;340;11993;12065;6.55;0.40;289.47;9.64;992;67;4151.00;72
11003;64;626362521;11003;337;11997;12069;6.52;0.40;289.44;9.64;994;67;4152.00;72
11007;64;626362532;11007;341;11997;12069;6.41;0.39;289.40;9.64;990;67;4153.00;72
11009;64;626362544;11009;336;11997;12069;6.34;0.39;289.39;9.64;988;67;4154.00;72
11009;64;626362555;11009;335;11998;12070;6.28;0.38;289.39;9.64;989;67;4155.00;72
11012;64;626362567;11012;335;12001;12074;6.21;0.38;289.45;9.64;989;67;4156.00;73
11013;64;626362579;11013;340;12001;12074;6.22;0.38;289.42;9.64;988;67;4157.00;73
11015;64;626362592;11015;344;12003;12077;6.15;0.38;289.40;9.63;988;67;4158.00;74
11018;64;626362609;11018;346;12003;12077;6.09;0.37;289.37;9.63;985;67;4159.00;74
11019;64;626362621;11019;347;12004;12077;6.10;0.37;289.35;9.63;985;67;4160.00;73
11021;64;626362633;11021;356;12004;12077;6.07;0.37;289.38;9.63;983;67;4161.00;73
11026;64;626362645;11026;354;12007;12081;6.04;0.37;289.38;9.63;981;67;4162.00;74
11027;64;626362657;11027;355;12007;12081;6.02;0.37;289.38;9.63;980;67;4163.00;74
11028;64;626362668;11028;351;12008;12081;5.99;0.36;289.41;9.63;980;67;4164.00;73
11031;64;626362678;11031;353;12008;12081;5.88;0.36;289.38;9.63;977;67;4165.00;73
11032;64;626362690;11032;355;12009;12082;5.75;0.35;289.38;9.68;977;67;4166.00;73
11033;64;626362701;11033;357;12010;12083;5.66;0.34;289.37;9.68;977;67;4167.00;73
11036;64;626362712;11036;356;12010;12083;5.54;0.34;289.38;9.68;974;67;4168.00;73
11036;64;626362728;11036;367;12011;12084;5.44;0.33;289.38;9.68;975;67;4169.00;73
11036;64;626362741;11036;356;12011;12084;5.34;0.32;289.38;9.68;975;67;4170.00;73
11036;64;626362751;11036;341;12011;12084;5.32;0.32;289.38;9.68;975;67;4171.00;73
11037;64;626362762;11037;323;12011;12084;5.30;0.32;289.37;9.68;974;67;4172.00;73
11037;64;626362773;11037;315;12013;12086;5.30;0.32;289.37;9.67;976;67;4173.00;73
11039;64;626362783;11039;306;12013;12086;5.34;0.33;289.35;9.67;974;67;4174.00;73
11039;64;626362794;11039;298;12013;12086;5.41;0.33;289.35;9.67;974;67;4175.00;73
11040;64;626362805;11040;303;12083;12213;5.57;0.35;289.34;9.62;1043;67;4176.00;130
11043;64;626362826;11043;292;12084;12214;5.64;0.35;289.34;9.62;1041;67;4177.00;130
11046;64;626362838;11046;276;12090;12214;5.77;0.36;289.35;9.61;1044;67;4178.00;124
11048;64;626362850;11048;265;12091;12214;5.88;0.36;289.35;9.61;1043;67;4179.00;123
11050;64;626362866;11050;258;12095;12214;6.07;0.37;289.43;9.61;1045;67;4180.00;119
11050;64;626362884;11050;257;12100;12214;6.18;0.38;289.43;9.61;1050;67;4181.00;114
11052;64;626362904;11052;243;12105;12214;6.27;0.39;289.40;9.66;1053;67;4182.00;109
11055;64;626362924;11055;230;12109;12214;6.38;0.39;289.38;9.66;1054;67;4183.00;105
11058;65;626362941;11058;217;12113;12215;6.49;0.40;289.45;9.65;1055;68;4184.00;102
11060;65;626362973;11060;212;12117;12217;6.56;0.40;289.42;9.65;1057;68;4185.00;100
11063;65;626362987;11063;207;12120;12217;6.66;0.41;289.39;9.67;1057;68;4186.00;97
11064;65;626363006;11064;211;12123;12218;6.77;0.42;289.38;9.67;1059;68;4187.00;95
11066;65;626363020;11066;205;12126;12218;6.87;0.42;289.37;9.67;1060;68;4188.00;92
11068;65;626363041;11068;201;12127;12218;6.89;0.42;289.35;9.67;1059;68;4189.00;91
11069;65;626363054;11069;193;12129;12218;6.95;0.43;289.36;9.67;1060;68;4190.00;89
11072;65;626363067;11072;192;12131;12222;6.99;0.43;289.36;9.67;1059;68;4191.00;91
11075;65;626363081;11075;195;12132;12222;7.01;0.43;289.39;9.67;1057;68;4192.00;90
11080;65;626363095;11080;196;12133;12222;7.02;0.43;289.36;9.67;1053;68;4193.00;89
11082;65;626363108;11082;196;12135;12225;7.06;0.43;289.37;9.67;1053;68;4194.00;90
11087;65;626363121;11087;203;12136;12225;7.05;0.43;289.37;9.67;1049;68;4195.00;89
11088;65;626363134;11088;205;12137;12225;7.02;0.43;289.40;9.71;1049;68;4196.00;88
11091;65;626363147;11091;213;12142;12229;7.01;0.43;289.39;9.71;1051;68;4197.00;87
11094;65;626363161;11094;210;12143;12230;7.01;0.43;289.39;9.71;1049;68;4198.00;87
11097;65;626363173;11097;219;12143;12230;7.01;0.43;289.41;9.71;1046;68;4199.00;87
11099;65;626363189;11099;221;12154;12264;6.97;0.42;289.37;9.71;1055;68;4200.00;110
11101;65;626363209;11101;219;12155;12264;6.99;0.43;289.41;9.71;1054;68;4201.00;109
11102;65;626363223;11102;220;12156;12264;7.02;0.43;289.43;9.71;1054;68;4202.00;108
11104;65;626363235;11104;219;12158;12265;7.05;0.43;289.43;9.71;1054;68;4203.00;107
11108;65;626363249;11108;218;12158;12265;7.05;0.43;289.47;9.71;1050;68;4204.00;107
11112;65;626363262;11112;217;12162;12271;7.09;0.43;289.53;9.71;1050;68;4205.00;109
11112;65;626363277;11112;220;12167;12271;7.10;0.43;289.53;9.77;1055;68;4206.00;104
11117;65;626363289;11117;216;12168;12272;7.10;0.43;289.71;9.77;1051;68;4207.00;104
11118;65;626363302;11118;219;12168;12272;7.12;0.43;289.72;9.77;1050;68;4208.00;104
11119;65;626363316;11119;219;12170;12272;7.16;0.44;289.76;9.78;1051;68;4209.00;102
11122;65;626363331;11122;228;12171;12272;7.20;0.44;289.88;9.80;1049;68;4210.00;101
11124;65;626363344;11124;232;12171;12272;7.29;0.44;289.90;9.80;1047;68;4211.00;101
11128;65;626363358;11128;243;12185;12284;7.35;0.45;289.91;9.82;1057;68;4212.00;99
11129;65;626363373;11129;231;12186;12284;7.39;0.45;289.92;9.82;1057;68;4213.00;98
11131;65;626363388;11131;230;12187;12284;7.47;0.46;289.96;9.83;1056;68;4214.00;97
11135;65;626363403;11135;223;12188;12284;7.53;0.46;289.92;9.85;1053;68;4215.00;96
11137;65;626363416;11137;221;12189;12284;7.57;0.46;289.96;9.86;1052;68;4216.00;95
11141;65;626363431;11141;222;12190;12284;7.61;0.46;289.98;9.87;1049;68;4217.00;94
11142;65;626363445;11142;222;12195;12288;7.63;0.47;289.98;9.87;1053;68;4218.00;93
11146;65;626363459;11146;220;12198;12288;7.65;0.47;290.04;9.90;1052;68;4219.00;90
11147;65;626363474;11147;222;12200;12292;7.75;0.47;290.08;9.89;1053;68;4220.00;92
11148;65;626363488;11148;220;12204;12293;7.80;0.48;290.05;9.92;1056;68;4221.00;89
11151;65;626363502;11151;225;12205;12293;7.77;0.48;290.12;9.94;1054;68;4222.00;88
11152;65;626363516;11152;233;12205;12293;7.71;0.47;290.10;9.94;1053;68;4223.00;88
11153;65;626363529;11153;240;12214;12306;7.65;0.47;290.14;9.94;1061;68;4224.00;92
11156;65;626363544;11156;243;12218;12306;7.63;0.47;290.20;9.96;1062;68;4225.00;88
11160;65;626363556;11160;250;12218;12306;7.57;0.46;290.27;9.96;1058;68;4226.00;88
11166;65;626363570;11166;252;12221;12307;7.51;0.46;290.36;9.98;1055;68;4227.00;86
11170;65;626363584;11170;259;12221;12308;7.48;0.46;290.40;9.98;1051;68;4228.00;87
11176;65;626363598;11176;259;12222;12308;7.44;0.45;290.43;9.99;1046;68;4229.00;86
11177;65;626363613;11177;259;12227;12314;7.44;0.45;290.45;9.99;1050;68;4230.00;87
11180;65;626363626;11180;256;12230;12314;7.40;0.45;290.51;10.01;1050;68;4231.00;84
11183;65;626363640;11183;263;12230;12314;7.35;0.45;290.48;10.01;1047;68;4232.00;84
11186;65;626363652;11186;261;12232;12314;7.30;0.45;290.51;10.01;1046;68;4233.00;82
11191;65;626363666;11191;261;12237;12320;7.25;0.44;290.57;10.03;1046;68;4234.00;83
11192;65;626363679;11192;265;12238;12320;7.22;0.44;290.60;10.04;1046;68;4235.00;82
11194;65;626363692;11194;274;12239;12320;7.19;0.44;290.70;10.05;1045;68;4236.00;81
11198;65;626363711;11198;269;12239;12320;7.12;0.44;290.73;10.05;1041;68;4237.00;81
11199;65;626363724;11199;280;12244;12324;7.08;0.43;290.71;10.07;1045;68;4238.00;80
11202;65;626363736;11202;277;12245;12325;7.07;0.43;290.79;10.06;1043;68;4239.00;80
11205;65;626363749;11205;280;12247;12325;7.00;0.43;290.79;10.09;1042;68;4240.00;78
11207;65;626363761;11207;280;12248;12326;6.96;0.43;290.81;10.08;1041;68;4241.00;78
11212;65;626363774;11212;281;12251;12326;6.82;0.42;290.89;10.11;1039;68;4242.00;75
11214;65;626363786;11214;284;12251;12326;6.73;0.41;290.94;10.11;1037;68;4243.00;75
11219;65;626363798;11219;283;12252;12326;6.64;0.41;290.98;10.11;1033;68;4244.00;74
11227;65;626363810;11227;290;12253;12326;6.53;0.40;291.02;10.12;1026;68;4245.00;73
11228;65;626363822;11228;296;12253;12326;6.51;0.40;291.04;10.12;1025;68;4246.00;73
11239;65;626363835;11239;303;12255;12326;6.36;0.39;291.17;10.12;1016;68;4247.00;71
11243;65;626363849;11243;311;12292;12396;6.33;0.39;291.30;10.12;1049;68;4248.00;104
11245;65;626363869;11245;311;12293;12397;6.26;0.38;291.35;10.12;1048;68;4249.00;104
11249;65;626363881;11249;303;12301;12397;6.17;0.38;291.34;10.13;1052;68;4250.00;96
11254;65;626363894;11254;298;12307;12397;6.11;0.37;291.50;10.13;1053;68;4251.00;90
11259;65;626363907;11259;296;12312;12397;6.06;0.37;291.56;10.14;1053;68;4252.00;85
11262;65;626363919;11262;294;12316;12397;6.08;0.37;291.60;10.15;1054;68;4253.00;81
11268;65;626363931;11268;295;12319;12397;6.06;0.37;291.66;10.15;1051;68;4254.00;78
11272;65;626363943;11272;299;12326;12397;6.04;0.37;291.72;10.16;1054;68;4255.00;71
11278;65;626363956;11278;295;12328;12398;6.01;0.37;291.75;10.16;1050;68;4256.00;70
11280;65;626363969;11280;304;12331;12399;6.09;0.37;291.77;10.16;1051;68;4257.00;68
11284;65;626363981;11284;309;12334;12399;6.19;0.38;291.84;10.16;1050;68;4258.00;65
11288;65;626363993;11288;306;12336;12403;6.29;0.39;291.90;10.16;1048;68;4259.00;67
11292;65;626364007;11292;308;12338;12403;6.34;0.39;291.90;10.21;1046;68;4260.00;65
11294;65;626364020;11294;301;12339;12403;6.38;0.39;291.92;10.22;1045;68;4261.00;64
11298;65;626364032;11298;302;12340;12403;6.43;0.40;291.93;10.22;1042;68;4262.00;63
11302;65;626364044;11302;300;12343;12409;6.44;0.40;291.94;10.21;1041;68;4263.00;66
11306;65;626364057;11306;299;12344;12409;6.43;0.40;291.95;10.21;1038;68;4264.00;65
11308;65;626364069;11308;298;12345;12409;6.46;0.40;291.98;10.22;1037;68;4265.00;64
11315;65;626364081;11315;302;12347;12412;6.47;0.40;291.96;10.21;1032;68;4266.00;65
11319;65;626364095;11319;310;12347;12412;6.48;0.40;291.98;10.21;1028;68;4267.00;65
11322;65;626364107;11322;312;12348;12412;6.48;0.40;291.97;10.21;1026;68;4268.00;64
11326;65;626364119;11326;308;12348;12413;6.47;0.40;291.95;10.21;1022;68;4269.00;65
11330;65;626364131;11330;309;12349;12414;6.50;0.40;292.00;10.21;1019;68;4270.00;65
11337;65;626364143;11337;306;12350;12414;6.53;0.40;292.05;10.21;1013;68;4271.00;64
11340;65;626364155;11340;320;12362;12427;6.59;0.40;292.06;10.21;1022;68;4272.00;65
11346;65;626364168;11346;322;12364;12427;6.52;0.40;292.09;10.21;1018;68;4273.00;63
11350;65;626364181;11350;330;12365;12427;6.53;0.40;292.13;10.21;1015;68;4274.00;62
11355;65;626364193;11355;333;12367;12429;6.52;0.40;292.15;10.21;1012;68;4275.00;62
11364;65;626364206;11364;336;12368;12429;6.44;0.39;292.25;10.21;1004;68;4276.00;61
11369;65;626364218;11369;335;12371;12433;6.41;0.39;292.31;10.21;1002;68;4277.00;62
11371;65;626364230;11371;336;12372;12433;6.42;0.39;292.34;10.21;1001;68;4278.00;61
11376;65;626364242;11376;341;12375;12437;6.40;0.39;292.31;10.21;999;68;4279.00;62
11379;65;626364260;11379;344;12375;12437;6.38;0.39;292.37;10.21;996;68;4280.00;62
11384;65;626364273;11384;352;12377;12437;6.34;0.39;292.39;10.20;993;68;4281.00;60
11387;65;626364285;11387;347;12378;12437;6.28;0.38;292.46;10.25;991;68;4282.00;59
11391;65;626364297;11391;354;12378;12437;6.24;0.38;292.52;10.25;987;68;4283.00;59
11396;65;626364315;11396;359;12389;12449;6.25;0.38;292.48;10.24;993;68;4284.00;60
11400;65;626364328;11400;364;12389;12449;6.22;0.38;292.51;10.24;989;68;4285.00;60
11403;65;626364341;11403;366;12389;12449;6.25;0.38;292.55;10.24;986;68;4286.00;60
11406;65;626364352;11406;375;12389;12449;6.21;0.38;292.53;10.24;983;68;4287.00;60
11406;65;626364364;11406;385;12389;12449;6.20;0.38;292.53;10.24;983;68;4288.00;60
11408;65;626364376;11408;388;12389;12449;6.18;0.38;292.54;10.24;981;68;4289.00;60
11413;65;626364390;11413;398;12389;12450;6.14;0.37;292.45;10.24;976;68;4290.00;61
11415;65;626364401;11415;405;12389;12450;6.15;0.38;292.42;10.24;974;68;4291.00;61
11418;65;626364413;11418;411;12393;12456;6.13;0.37;292.43;10.24;975;68;4292.00;63
11420;65;626364430;11420;421;12394;12457;6.14;0.38;292.41;10.24;974;68;4293.00;63
11422;65;626364442;11422;420;12395;12457;6.14;0.38;292.42;10.24;973;68;4294.00;62
11425;65;626364454;11425;427;12395;12457;6.04;0.37;292.42;10.24;970;68;4295.00;62
11425;65;626364465;11425;435;12398;12461;6.05;0.37;292.42;10.24;973;68;4296.00;63
11427;65;626364477;11427;418;12398;12461;6.04;0.37;292.43;10.24;971;68;4297.00;63
11430;65;626364489;11430;412;12399;12461;5.97;0.36;292.39;10.28;969;68;4298.00;62
11433;65;626364501;11433;410;12400;12462;5.99;0.36;292.50;10.28;967;68;4299.00;62
11434;65;626364514;11434;405;12403;12466;6.00;0.37;292.48;10.28;969;68;4300.00;63
11440;65;626364529;11440;408;12403;12466;5.95;0.36;292.43;10.28;963;68;4301.00;63
11444;65;626364541;11444;409;12405;12469;5.98;0.37;292.37;10.28;961;68;4302.00;64
11445;65;626364553;11445;416;12406;12469;6.04;0.37;292.36;10.28;961;68;4303.00;63
11446;65;626364565;11446;420;12406;12469;6.06;0.37;292.36;10.28;960;68;4304.00;63
11447;65;626364577;11447;421;12406;12469;6.05;0.37;292.39;10.28;959;68;4305.00;63
11450;65;626364594;11450;407;12409;12473;6.07;0.37;292.38;10.27;959;68;4306.00;64
11453;65;626364612;11453;391;12409;12473;6.05;0.37;292.35;10.27;956;68;4307.00;64
11455;65;626364625;11455;385;12410;12473;6.11;0.37;292.31;10.27;955;68;4308.00;63
11456;65;626364637;11456;375;12410;12473;6.15;0.38;292.31;10.27;954;68;4309.00;63
11458;65;626364649;11458;369;12410;12474;6.17;0.38;292.29;10.27;952;68;4310.00;64
11458;65;626364661;11458;360;12411;12475;6.26;0.38;292.29;10.27;953;68;4311.00;64
11462;65;626364673;11462;354;12411;12475;6.28;0.38;292.25;10.27;949;68;4312.00;64
11466;65;626364685;11466;355;12412;12476;6.32;0.38;292.24;10.27;946;68;4313.00;64
11468;65;626364698;11468;353;12412;12476;6.36;0.39;292.23;10.27;944;68;4314.00;64
11468;65;626364710;11468;349;12412;12476;6.45;0.39;292.23;10.27;944;68;4315.00;64
11468;65;626364721;11468;350;12412;12476;6.48;0.39;292.23;10.27;944;68;4316.00;64
11469;65;626364734;11469;351;12412;12476;6.59;0.40;292.22;10.27;943;68;4317.00;64
11471;65;626364746;11471;341;12413;12476;6.58;0.40;292.19;10.32;942;68;4318.00;63
11471;65;626364757;11471;338;12413;12476;6.57;0.40;292.19;10.32;942;68;4319.00;63
11474;65;626364771;11474;378;12526;12706;6.71;0.42;292.18;10.22;1052;68;4320.00;180
11476;65;626364800;11476;371;12529;12707;6.68;0.42;292.19;10.22;1053;68;4321.00;178
11478;65;626364812;11478;356;12539;12707;6.66;0.42;292.24;10.21;1061;68;4322.00;168
11482;65;626364824;11482;339;12546;12707;6.66;0.41;292.23;10.21;1064;68;4323.00;161
11484;65;626364837;11484;323;12553;12707;6.65;0.41;292.21;10.21;1069;68;4324.00;154
11485;65;626364849;11485;310;12558;12707;6.68;0.42;292.21;10.21;1073;68;4325.00;149
11485;65;626364866;11485;306;12562;12707;6.70;0.42;292.21;10.20;1077;68;4326.00;145
11485;65;626364885;11485;305;12569;12707;6.69;0.42;292.21;10.20;1084;68;4327.00;138
11486;65;626364904;11486;309;12571;12708;6.72;0.42;292.21;10.20;1085;68;4328.00;137
11487;65;626364923;11487;302;12574;12709;6.75;0.42;292.21;10.20;1087;68;4329.00;135
11489;65;626364943;11489;300;12577;12709;6.74;0.42;292.21;10.20;1088;68;4330.00;132
11490;65;626364962;11490;293;12578;12710;6.74;0.42;292.21;10.20;1088;68;4331.00;132
11491;65;626364980;11491;296;12582;12710;6.69;0.41;292.20;10.20;1091;68;4332.00;128
11491;65;626364994;11491;300;12585;12710;6.65;0.41;292.20;10.20;1094;68;4333.00;125
11492;65;626365008;11492;307;12587;12710;6.59;0.41;292.20;10.20;1095;68;4334.00;123
11494;65;626365033;11494;310;12591;12714;6.52;0.40;292.19;10.20;1097;68;4335.00;123
11494;65;626365052;11494;305;12594;12714;6.48;0.40;292.19;10.25;1100;68;4336.00;120
11495;65;626365068;11495;310;12594;12714;6.50;0.40;292.18;10.25;1099;68;4337.00;120
11495;65;626365083;11495;313;12597;12717;6.48;0.40;292.18;10.25;1102;68;4338.00;120
11498;65;626365097;11498;317;12598;12717;6.46;0.40;292.16;10.25;1100;68;4339.00;119
11499;65;626365114;11499;313;12601;12717;6.50;0.40;292.16;10.25;1102;68;4340.00;116
11501;65;626365127;11501;311;12606;12721;6.50;0.40;292.16;10.25;1105;68;4341.00;115
11503;65;626365142;11503;309;12607;12722;6.49;0.40;292.15;10.25;1104;68;4342.00;115
11505;65;626365156;11505;301;12608;12722;6.50;0.40;292.17;10.25;1103;68;4343.00;114
11506;65;626365169;11506;307;12611;12726;6.55;0.40;292.17;10.25;1105;68;4344.00;115
11511;65;626365183;11511;302;12612;12726;6.51;0.40;292.21;10.25;1101;68;4345.00;114
11513;65;626365196;11513;302;12613;12726;6.46;0.40;292.21;10.25;1100;68;4346.00;113
11518;65;626365210;11518;305;12614;12727;6.45;0.39;292.29;10.25;1096;68;4347.00;113
11521;65;626365224;11521;296;12614;12727;6.46;0.40;292.29;10.25;1093;68;4348.00;113
11524;65;626365236;11524;296;12617;12733;6.45;0.39;292.29;10.25;1093;68;4349.00;116
11526;65;626365253;11526;292;12617;12733;6.44;0.39;292.32;10.25;1091;68;4350.00;116
11527;65;626365267;11527;299;12618;12734;6.40;0.39;292.38;10.29;1091;68;4351.00;116
11530;65;626365280;11530;285;12619;12734;6.36;0.39;292.40;10.29;1089;68;4352.00;115
11537;65;626365294;11537;282;12620;12734;6.29;0.38;292.44;10.29;1083;68;4353.00;114
11539;65;626365308;11539;276;12621;12734;6.33;0.39;292.43;10.29;1082;68;4354.00;113
11543;65;626365320;11543;271;12625;12734;6.26;0.38;292.45;10.36;1082;68;4355.00;109
11545;65;626365335;11545;262;12635;12746;6.34;0.39;292.46;10.35;1090;68;4356.00;111
11550;65;626365349;11550;255;12637;12746;6.34;0.39;292.42;10.39;1087;68;4357.00;109
11552;65;626365363;11552;245;12637;12746;6.46;0.39;292.41;10.39;1085;68;4358.00;109
11554;65;626365376;11554;243;12638;12746;6.49;0.40;292.38;10.43;1084;68;4359.00;108
11559;65;626365396;11559;232;12638;12746;6.53;0.40;292.37;10.43;1079;68;4360.00;108
11559;65;626365416;11559;229;12638;12746;6.63;0.40;292.37;10.43;1079;68;4361.00;108
11563;65;626365429;11563;228;12642;12750;6.69;0.41;292.36;10.47;1079;68;4362.00;108
11566;65;626365444;11566;228;12642;12750;6.79;0.41;292.41;10.47;1076;68;4363.00;108
11569;65;626365459;11569;227;12645;12754;6.86;0.42;292.40;10.50;1076;68;4364.00;109
11571;65;626365479;11571;222;12647;12756;6.94;0.42;292.44;10.50;1076;68;4365.00;109
11574;65;626365493;11574;218;12648;12756;7.02;0.42;292.50;10.50;1074;68;4366.00;108
11576;65;626365507;11576;227;12650;12756;7.07;0.43;292.54;10.53;1074;68;4367.00;106
11577;65;626365521;11577;233;12660;12769;7.15;0.43;292.57;10.53;1083;68;4368.00;109
11578;65;626365536;11578;228;12661;12769;7.25;0.44;292.58;10.53;1083;68;4369.00;108
11582;65;626365549;11582;227;12663;12769;7.34;0.45;292.64;10.53;1081;68;4370.00;106
11584;65;626365563;11584;224;12664;12770;7.40;0.45;292.70;10.53;1080;68;4371.00;106
11588;65;626365576;11588;217;12665;12771;7.49;0.45;292.70;10.54;1077;68;4372.00;106
11593;65;626365590;11593;223;12665;12771;7.50;0.45;292.79;10.54;1072;68;4373.00;106
11596;65;626365605;11596;223;12668;12774;7.52;0.46;292.89;10.54;1072;68;4374.00;106
11599;65;626365620;11599;223;12668;12774;7.56;0.46;292.89;10.54;1069;68;4375.00;106
11604;65;626365634;11604;223;12670;12774;7.59;0.46;292.96;10.54;1066;68;4376.00;104
11609;65;626365650;11609;223;12671;12774;7.63;0.46;293.06;10.54;1062;68;4377.00;103
11609;65;626365664;11609;221;12675;12780;7.71;0.47;293.06;10.54;1066;68;4378.00;105
11611;65;626365678;11611;221;12676;12780;7.75;0.47;293.12;10.54;1065;68;4379.00;104
11615;65;626365694;11615;224;12679;12780;7.81;0.47;293.14;10.56;1064;68;4380.00;101
11617;65;626365709;11617;223;12679;12780;7.85;0.48;293.16;10.56;1062;68;4381.00;101
11620;65;626365724;11620;230;12684;12784;7.85;0.48;293.21;10.58;1064;68;4382.00;100
11627;65;626365739;11627;227;12687;12785;7.81;0.47;293.21;10.60;1060;68;4383.00;98
11628;65;626365754;11628;231;12688;12785;7.81;0.47;293.18;10.60;1060;68;4384.00;97
11629;65;626365770;11629;238;12692;12786;7.85;0.48;293.21;10.63;1063;68;4385.00;94
11634;65;626365784;11634;235;12692;12786;7.86;0.48;293.17;10.63;1058;68;4386.00;94
11635;65;626365799;11635;238;12696;12786;7.89;0.48;293.21;10.67;1061;68;4387.00;90
11637;65;626365814;11637;246;12697;12786;7.81;0.48;293.28;10.68;1060;68;4388.00;89
11640;65;626365828;11640;245;12701;12786;7.75;0.47;293.33;10.71;1061;68;4389.00;85
11641;65;626365842;11641;255;12703;12786;7.74;0.47;293.34;10.73;1062;68;4390.00;83
11645;65;626365857;11645;251;12704;12786;7.72;0.47;293.35;10.73;1059;68;4391.00;82
11646;65;626365873;11646;259;12739;12856;7.77;0.47;293.38;10.73;1093;68;4392.00;117
11647;65;626365893;11647;263;12740;12857;7.73;0.47;293.41;10.73;1093;68;4393.00;117
11650;65;626365907;11650;265;12747;12857;7.71;0.47;293.46;10.74;1097;68;4394.00;110
11651;65;626365920;11651;271;12754;12857;7.72;0.47;293.45;10.75;1103;68;4395.00;103
11654;65;626365934;11654;279;12763;12857;7.65;0.47;293.49;10.76;1109;68;4396.00;94
11658;65;626365948;11658;278;12767;12857;7.58;0.46;293.48;10.77;1109;68;4397.00;90
11660;65;626365962;11660;278;12772;12857;7.57;0.46;293.49;10.78;1112;68;4398.00;85
11663;65;626365976;11663;278;12773;12857;7.53;0.46;293.51;10.78;1110;68;4399.00;84
11666;65;626365991;11666;280;12778;12858;7.45;0.45;293.59;10.79;1112;68;4400.00;80
11668;65;626366010;11668;279;12780;12859;7.41;0.45;293.61;10.79;1112;68;4401.00;79
11670;65;626366024;11670;277;12781;12859;7.38;0.45;293.60;10.80;1111;68;4402.00;78
11675;65;626366037;11675;269;12784;12863;7.27;0.44;293.62;10.81;1109;68;4403.00;79
11681;65;626366051;11681;270;12784;12863;7.29;0.44;293.71;10.81;1103;68;4404.00;79
11684;65;626366065;11684;267;12787;12863;7.29;0.44;293.70;10.83;1103;68;4405.00;76
11687;65;626366079;11687;273;12787;12863;7.30;0.44;293.77;10.83;1100;68;4406.00;76
11688;65;626366093;11688;280;12793;12869;7.37;0.45;293.77;10.83;1105;68;4407.00;76
11690;65;626366107;11690;283;12794;12869;7.41;0.45;293.79;10.84;1104;68;4408.00;75
11692;65;626366128;11692;290;12795;12869;7.47;0.46;293.86;10.85;1103;68;4409.00;74
11693;65;626366144;11693;297;12799;12875;7.49;0.46;293.87;10.85;1106;68;4410.00;76
11698;65;626366158;11698;297;12802;12875;7.47;0.46;293.86;10.86;1104;68;4411.00;73
11700;65;626366172;11700;299;12803;12875;7.42;0.45;293.93;10.87;1103;68;4412.00;72
11705;65;626366185;11705;304;12805;12876;7.26;0.44;293.96;10.88;1100;68;4413.00;71
11711;65;626366199;11711;300;12806;12877;7.07;0.43;293.98;10.87;1095;68;4414.00;71
11713;65;626366212;11713;313;12807;12877;6.93;0.42;294.02;10.88;1094;68;4415.00;70
11720;65;626366225;11720;316;12819;12890;6.74;0.41;294.01;10.88;1099;68;4416.00;71
11725;65;626366239;11725;320;12820;12890;6.56;0.40;294.04;10.88;1095;68;4417.00;70
11729;65;626366251;11729;324;12820;12890;6.38;0.39;294.11;10.88;1091;68;4418.00;70
11733;65;626366265;11733;327;12823;12891;6.19;0.38;294.16;10.89;1090;68;4419.00;68
11737;65;626366277;11737;325;12823;12891;6.07;0.37;294.20;10.89;1086;68;4420.00;68
11740;65;626366290;11740;324;12827;12895;6.01;0.37;294.21;10.90;1087;68;4421.00;68
11743;65;626366303;11743;327;12829;12895;5.96;0.37;294.24;10.90;1086;68;4422.00;66
11749;65;626366315;11749;332;12831;12899;5.93;0.36;294.20;10.90;1082;68;4423.00;68
11754;65;626366328;11754;336;12834;12899;5.92;0.36;294.17;10.91;1080;68;4424.00;65
11757;65;626366346;11757;343;12834;12899;5.93;0.36;294.17;10.91;1077;68;4425.00;65
11761;65;626366364;11761;334;12834;12899;5.92;0.36;294.25;10.91;1073;68;4426.00;65
11764;65;626366376;11764;329;12836;12899;5.97;0.37;294.23;10.91;1072;68;4427.00;63
11768;65;626366389;11768;327;12848;12911;6.04;0.37;294.31;10.90;1080;68;4428.00;63
11772;65;626366402;11772;323;12848;12911;6.09;0.37;294.31;10.90;1076;68;4429.00;63
11773;65;626366415;11773;317;12848;12911;6.14;0.38;294.38;10.90;1075;68;4430.00;63
11780;65;626366427;11780;316;12848;12911;6.15;0.38;294.37;10.90;1068;68;4431.00;63
11784;65;626366439;11784;321;12848;12911;6.14;0.38;294.40;10.90;1064;68;4432.00;63
11786;65;626366451;11786;324;12848;12911;6.17;0.38;294.40;10.90;1062;68;4433.00;63
11790;65;626366464;11790;320;12848;12912;6.20;0.38;294.48;10.90;1058;68;4434.00;64
11796;65;626366477;11796;313;12848;12912;6.23;0.38;294.53;10.90;1052;68;4435.00;64
11797;65;626366490;11797;309;12852;12918;6.34;0.39;294.56;10.90;1055;68;4436.00;66
11804;65;626366503;11804;313;12853;12919;6.32;0.39;294.52;10.90;1049;68;4437.00;66
11805;65;626366517;11805;316;12854;12919;6.38;0.39;294.52;10.90;1049;68;4438.00;65
11808;65;626366529;11808;318;12855;12919;6.38;0.39;294.52;10.93;1047;68;4439.00;64
11811;65;626366544;11811;317;12859;12924;6.39;0.39;294.57;10.93;1048;68;4440.00;65
11813;65;626366557;11813;323;12859;12924;6.40;0.39;294.57;10.93;1046;68;4441.00;65
11818;65;626366576;11818;327;12859;12924;6.38;0.39;294.56;10.93;1041;68;4442.00;65
11824;65;626366590;11824;328;12860;12925;6.33;0.39;294.52;10.93;1036;68;4443.00;65
11824;65;626366603;11824;329;12863;12929;6.31;0.39;294.52;10.93;1039;68;4444.00;66
11828;65;626366617;11828;335;12863;12929;6.32;0.39;294.58;10.93;1035;68;4445.00;66
11831;65;626366629;11831;336;12865;12932;6.34;0.39;294.54;10.92;1034;68;4446.00;67
11836;65;626366643;11836;341;12866;12932;6.37;0.39;294.49;10.92;1030;68;4447.00;66
11842;65;626366655;11842;341;12866;12932;6.35;0.39;294.47;10.92;1024;68;4448.00;66
11845;65;626366668;11845;337;12866;12932;6.36;0.39;294.46;10.92;1021;68;4449.00;66
11850;65;626366681;11850;346;12869;12936;6.36;0.39;294.45;10.92;1019;68;4450.00;67
11855;65;626366694;11855;350;12869;12936;6.34;0.39;294.42;10.92;1014;68;4451.00;67
11860;65;626366707;11860;360;12870;12936;6.27;0.38;294.37;10.92;1010;68;4452.00;66
11864;65;626366720;11864;362;12870;12936;6.19;0.38;294.34;10.92;1006;68;4453.00;66
11866;65;626366732;11866;369;12870;12937;6.13;0.37;294.33;10.92;1004;68;4454.00;67
11869;65;626366744;11869;374;12872;12939;6.08;0.37;294.32;10.92;1003;68;4455.00;67
11872;65;626366757;11872;383;12872;12939;6.04;0.37;294.29;10.92;1000;68;4456.00;67
11878;65;626366769;11878;388;12873;12940;5.98;0.37;294.25;10.92;995;68;4457.00;67
11884;65;626366782;11884;398;12873;12940;5.96;0.36;294.29;10.92;989;68;4458.00;67
11886;65;626366794;11886;400;12873;12940;5.90;0.36;294.28;10.92;987;68;4459.00;67
11891;65;626366805;11891;409;12873;12940;5.81;0.35;294.23;10.92;982;68;4460.00;67
11892;65;626366817;11892;413;12873;12940;5.76;0.35;294.22;10.92;981;68;4461.00;67
11895;65;626366829;11895;413;12873;12940;5.68;0.35;294.18;10.92;978;68;4462.00;67
11895;65;626366841;11895;423;12873;12940;5.61;0.34;294.18;10.92;978;68;4463.00;67
11897;65;626366853;11897;438;12938;13067;5.99;0.37;294.17;10.86;1041;68;4464.00;129
11898;65;626366880;11898;440;12941;13068;5.97;0.37;294.14;10.86;1043;68;4465.00;127
11900;65;626366902;11900;442;12950;13068;5.99;0.37;294.12;10.85;1050;68;4466.00;118
11900;65;626366923;11900;434;12955;13068;6.11;0.38;294.12;10.85;1055;68;4467.00;113
11902;65;626366942;11902;421;12960;13068;6.13;0.38;294.10;10.85;1058;68;4468.00;108
11903;65;626366960;11903;430;12964;13068;6.12;0.38;294.11;10.85;1061;68;4469.00;104
11904;65;626366984;11904;425;12969;13068;6.17;0.38;294.11;10.84;1065;68;4470.00;99
11904;65;626366999;11904;427;12972;13068;6.21;0.38;294.11;10.84;1068;68;4471.00;96
11904;65;626367014;11904;430;12976;13069;6.23;0.38;294.11;10.84;1072;68;4472.00;93
11904;65;626367036;11904;428;12978;13070;6.21;0.38;294.11;10.84;1074;68;4473.00;92
11905;65;626367050;11905;433;12983;13070;6.21;0.38;294.12;10.84;1078;68;4474.00;87
11907;65;626367065;11907;426;12984;13071;6.16;0.38;294.10;10.84;1077;68;4475.00;87
11908;65;626367085;11908;407;12985;13071;6.19;0.38;294.11;10.84;1077;68;4476.00;86
11912;65;626367099;11912;396;12986;13071;6.24;0.39;294.14;10.84;1074;68;4477.00;85
11914;65;626367115;11914;383;12988;13071;6.37;0.39;294.17;10.84;1074;68;4478.00;83
11915;65;626367130;11915;373;12991;13075;6.51;0.40;294.17;10.84;1076;68;4479.00;84
11917;65;626367146;11917;354;12993;13075;6.65;0.41;294.16;10.84;1076;68;4480.00;82
11920;65;626367162;11920;342;12994;13075;6.80;0.42;294.17;10.84;1074;68;4481.00;81
11921;65;626367177;11921;332;12996;13078;6.92;0.42;294.17;10.84;1075;68;4482.00;82
11922;65;626367193;11922;330;12997;13078;6.99;0.43;294.16;10.84;1075;68;4483.00;81
11922;65;626367208;11922;319;12998;13078;7.08;0.43;294.16;10.84;1076;68;4484.00;80
11926;65;626367229;11926;320;13001;13082;7.08;0.43;294.11;10.84;1075;68;4485.00;81
11928;65;626367245;11928;309;13003;13083;7.14;0.44;294.10;10.84;1075;68;4486.00;80
11929;65;626367267;11929;305;13003;13083;7.20;0.44;294.09;10.84;1074;68;4487.00;80
11932;65;626367282;11932;304;13007;13087;7.23;0.44;294.05;10.83;1075;68;4488.00;80
11935;65;626367297;11935;299;13007;13087;7.30;0.44;294.04;10.83;1072;68;4489.00;80
11937;65;626367311;11937;294;13007;13087;7.28;0.44;294.02;10.83;1070;68;4490.00;80
11939;65;626367326;11939;295;13008;13088;7.27;0.44;293.99;10.83;1069;68;4491.00;80
11939;65;626367346;11939;302;13008;13088;7.28;0.44;293.99;10.83;1069;68;4492.00;80
11940;65;626367360;11940;304;13012;13094;7.29;0.44;293.97;10.83;1072;68;4493.00;82
11942;65;626367375;11942;299;13012;13094;7.32;0.45;293.96;10.83;1070;68;4494.00;82
11943;65;626367389;11943;300;13013;13095;7.39;0.45;293.96;10.83;1070;68;4495.00;82
11948;65;626367404;11948;296;13013;13095;7.37;0.45;294.02;10.83;1065;68;4496.00;82
11951;65;626367418;11951;302;13013;13095;7.35;0.45;294.03;10.83;1062;68;4497.00;82
11952;65;626367438;11952;298;13013;13095;7.40;0.45;294.03;10.83;1061;68;4498.00;82
11953;65;626367452;11953;308;13013;13095;7.37;0.45;294.01;10.83;1060;68;4499.00;82
11957;65;626367469;11957;304;13035;13145;7.36;0.45;294.05;10.81;1078;68;4500.00;110
11962;65;626367491;11962;303;13036;13147;7.36;0.45;294.05;10.81;1074;68;4501.00;111
11966;65;626367506;11966;313;13039;13147;7.30;0.45;294.14;10.81;1073;68;4502.00;108
11969;65;626367520;11969;316;13040;13147;7.20;0.44;294.15;10.81;1071;68;4503.00;107
11969;65;626367534;11969;320;13042;13147;7.14;0.44;294.15;10.81;1073;68;4504.00;105
11973;65;626367547;11973;317;13042;13147;7.11;0.43;294.17;10.81;1069;68;4505.00;105
11975;65;626367562;11975;320;13047;13151;7.10;0.43;294.20;10.80;1072;68;4506.00;104
11976;65;626367576;11976;322;13047;13151;7.08;0.43;294.22;10.80;1071;68;4507.00;104
11980;65;626367589;11980;322;13050;13155;7.05;0.43;294.32;10.80;1070;68;4508.00;105
11982;65;626367604;11982;324;13051;13156;7.01;0.43;294.35;10.80;1069;68;4509.00;105
11984;65;626367618;11984;323;13053;13156;7.03;0.43;294.35;10.80;1069;68;4510.00;103
11985;65;626367633;11985;316;13053;13156;7.06;0.43;294.37;10.80;1068;68;4511.00;103
11986;65;626367646;11986;316;13060;13169;7.02;0.43;294.43;10.80;1074;68;4512.00;109
11990;65;626367670;11990;323;13060;13169;6.99;0.43;294.45;10.80;1070;68;4513.00;109
11995;65;626367683;11995;321;13060;13169;6.95;0.42;294.52;10.80;1065;68;4514.00;109
11999;65;626367698;11999;312;13061;13170;6.90;0.42;294.55;10.80;1062;68;4515.00;109
12003;65;626367712;12003;310;13063;13171;6.88;0.42;294.59;10.80;1060;68;4516.00;108
12006;65;626367726;12006;302;13063;13171;6.93;0.42;294.56;10.80;1057;68;4517.00;108
12010;65;626367739;12010;302;13066;13174;6.99;0.43;294.63;10.84;1056;68;4518.00;108
12013;65;626367754;12013;293;13066;13174;7.05;0.43;294.66;10.84;1053;68;4519.00;108
12015;65;626367767;12015;291;13066;13174;7.11;0.43;294.70;10.84;1051;68;4520.00;108
12020;65;626367780;12020;288;13067;13174;7.03;0.43;294.71;10.84;1047;68;4521.00;107
12026;65;626367793;12026;275;13071;13180;6.97;0.42;294.72;10.84;1045;68;4522.00;109
12029;65;626367808;12029;270;13071;13180;6.98;0.43;294.77;10.84;1042;68;4523.00;109
12034;65;626367821;12034;260;13071;13180;6.89;0.42;294.83;10.84;1037;68;4524.00;109
12036;65;626367835;12036;255;13072;13180;6.88;0.42;294.82;10.85;1036;68;4525.00;108
12041;65;626367850;12041;250;13075;13184;6.87;0.42;294.83;10.85;1034;68;4526.00;109
12046;65;626367865;12046;246;13077;13185;6.87;0.42;294.80;10.85;1031;68;4527.00;108
12050;65;626367879;12050;241;13078;13185;6.87;0.42;294.80;10.85;1028;68;4528.00;107
12055;65;626367892;12055;239;13079;13186;6.91;0.42;294.86;10.85;1024;68;4529.00;107
12060;65;626367908;12060;231;13079;13186;6.96;0.42;294.86;10.85;1019;68;4530.00;107
12063;65;626367923;12063;232;13079;13186;7.00;0.43;294.90;10.85;1016;68;4531.00;107
12067;65;626367936;12067;233;13082;13186;6.98;0.42;294.92;10.90;1015;68;4532.00;104
12070;65;626367949;12070;226;13082;13186;7.00;0.42;295.04;10.90;1012;68;4533.00;104
12072;65;626367961;12072;230;13083;13186;7.05;0.43;295.05;10.90;1011;68;4534.00;103
12075;65;626367975;12075;235;13085;13186;7.06;0.43;295.14;10.95;1010;68;4535.00;101
12076;65;626367988;12076;230;13121;13256;7.19;0.44;295.19;10.92;1045;68;4536.00;135
12079;65;626368006;12079;230;13125;13257;7.25;0.44;295.23;10.92;1046;68;4537.00;132
12083;65;626368020;12083;229;13130;13257;7.31;0.45;295.32;10.96;1047;68;4538.00;127
12085;65;626368033;12085;224;13134;13257;7.36;0.45;295.30;10.96;1049;68;4539.00;123
12088;65;626368046;12088;221;13138;13257;7.45;0.45;295.33;10.96;1050;68;4540.00;119
12092;65;626368059;12092;221;13139;13257;7.47;0.45;295.36;10.96;1047;68;4541.00;118
12095;65;626368073;12095;227;13146;13257;7.53;0.46;295.33;10.97;1051;68;4542.00;111
12098;65;626368086;12098;225;13150;13257;7.58;0.46;295.36;10.97;1052;68;4543.00;107
12103;65;626368100;12103;230;13153;13258;7.66;0.46;295.37;10.97;1050;68;4544.00;105
12105;65;626368113;12105;231;13158;13260;7.72;0.47;295.39;10.97;1053;68;4545.00;102
12108;65;626368128;12108;229;13160;13260;7.71;0.47;295.44;10.97;1052;68;4546.00;100
12111;65;626368142;12111;237;13164;13264;7.70;0.47;295.52;10.97;1053;68;4547.00;100
12113;65;626368156;12113;236;13165;13264;7.68;0.47;295.50;10.97;1052;68;4548.00;99
12115;65;626368170;12115;239;13166;13264;7.71;0.47;295.55;10.98;1051;68;4549.00;98
12120;65;626368183;12120;242;13168;13264;7.68;0.47;295.61;11.00;1048;68;4550.00;96
12123;65;626368197;12123;252;13171;13270;7.74;0.47;295.60;11.00;1048;68;4551.00;99
12124;65;626368212;12124;254;13173;13270;7.77;0.47;295.60;11.00;1049;68;4552.00;97
12127;65;626368225;12127;255;13173;13270;7.73;0.47;295.64;11.00;1046;68;4553.00;97
12130;65;626368240;12130;259;13177;13273;7.71;0.47;295.65;11.02;1047;68;4554.00;96
12132;65;626368254;12132;265;13178;13273;7.69;0.47;295.63;11.03;1046;68;4555.00;95
12137;65;626368268;12137;262;13182;13273;7.68;0.47;295.63;11.06;1045;68;4556.00;91
12139;65;626368281;12139;267;13183;13274;7.66;0.47;295.63;11.06;1044;68;4557.00;91
12142;65;626368295;12142;266;13187;13275;7.67;0.47;295.66;11.09;1045;68;4558.00;88
12144;65;626368308;12144;270;13187;13275;7.66;0.47;295.71;11.09;1043;68;4559.00;88
12147;65;626368323;12147;271;13205;13301;7.67;0.47;295.69;11.09;1058;68;4560.00;96
12150;65;626368339;12150;276;13209;13301;7.65;0.46;295.66;11.11;1059;68;4561.00;92
12151;65;626368353;12151;275;13212;13301;7.67;0.47;295.65;11.12;1061;68;4562.00;89
12153;65;626368366;12153;272;13213;13302;7.66;0.47;295.65;11.12;1060;68;4563.00;89
12158;65;626368379;12158;268;13215;13302;7.60;0.46;295.65;11.14;1057;68;4564.00;87
12159;65;626368393;12159;283;13220;13306;7.56;0.46;295.68;11.15;1061;68;4565.00;86
12161;65;626368406;12161;287;13222;13306;7.44;0.45;295.67;11.15;1061;68;4566.00;84
12163;65;626368425;12163;299;13226;13310;7.27;0.44;295.74;11.16;1063;68;4567.00;84
12163;65;626368437;12163;304;13226;13310;7.18;0.44;295.74;11.16;1063;68;4568.00;84
12167;65;626368449;12167;298;13228;13310;7.08;0.43;295.82;11.19;1061;68;4569.00;82
12170;65;626368462;12170;302;13228;13310;7.01;0.43;295.84;11.19;1058;68;4570.00;82
12176;65;626368475;12176;301;13228;13310;6.95;0.42;295.92;11.19;1052;68;4571.00;82
12181;65;626368487;12181;308;13239;13322;6.94;0.42;296.01;11.21;1058;68;4572.00;83
12184;65;626368501;12184;303;13239;13322;6.92;0.42;296.04;11.21;1055;68;4573.00;83
12187;65;626368513;12187;300;13243;13322;6.90;0.42;296.11;11.23;1056;68;4574.00;79
12189;65;626368525;12189;301;13243;13322;6.88;0.42;296.16;11.23;1054;68;4575.00;79
12192;65;626368539;12192;307;13245;13322;6.84;0.42;296.21;11.25;1053;68;4576.00;77
12194;65;626368552;12194;311;13246;13322;6.81;0.42;296.22;11.25;1052;68;4577.00;76
12197;65;626368564;12197;319;13246;13323;6.80;0.41;296.26;11.25;1049;68;4578.00;77
12201;65;626368576;12201;326;13248;13323;6.76;0.41;296.27;11.27;1047;68;4579.00;75
12205;65;626368588;12205;328;13252;13329;6.76;0.41;296.39;11.27;1047;68;4580.00;77
12209;65;626368600;12209;328;13254;13330;6.75;0.41;296.44;11.27;1045;68;4581.00;76
12214;65;626368612;12214;337;13255;13330;6.61;0.40;296.43;11.27;1041;68;4582.00;75
12218;65;626368624;12218;343;13257;13330;6.47;0.39;296.42;11.28;1039;68;4583.00;73
12223;65;626368636;12223;341;13260;13334;6.42;0.39;296.43;11.28;1037;68;4584.00;74
12224;65;626368648;12224;342;13261;13334;6.38;0.39;296.45;11.29;1037;68;4585.00;73
12228;65;626368659;12228;345;13261;13334;6.26;0.38;296.43;11.29;1033;68;4586.00;73
12233;65;626368670;12233;355;13262;13335;6.09;0.37;296.57;11.29;1029;68;4587.00;73
12236;65;626368681;12236;369;13267;13339;5.96;0.36;296.57;11.31;1031;68;4588.00;72
12242;65;626368692;12242;375;13267;13339;5.81;0.35;296.58;11.31;1025;68;4589.00;72
12244;65;626368705;12244;369;13273;13345;5.74;0.35;296.59;11.33;1029;68;4590.00;72
12247;65;626368716;12247;361;13273;13345;5.63;0.34;296.56;11.33;1026;68;4591.00;72
12251;65;626368727;12251;360;13274;13345;5.57;0.34;296.66;11.33;1023;68;4592.00;71
12251;65;626368737;12251;369;13275;13345;5.57;0.34;296.66;11.34;1024;68;4593.00;70
12254;65;626368747;12254;371;13278;13349;5.61;0.34;296.67;11.33;1024;68;4594.00;71
12256;65;626368758;12256;378;13281;13349;5.61;0.34;296.66;11.36;1025;68;4595.00;68
12261;65;626368769;12261;379;13282;13349;5.59;0.34;296.64;11.35;1021;68;4596.00;67
12261;65;626368780;12261;372;13282;13349;5.59;0.34;296.64;11.35;1021;68;4597.00;67
12265;65;626368791;12265;370;13284;13350;5.58;0.34;296.60;11.36;1019;68;4598.00;66
12271;65;626368802;12271;368;13286;13351;5.51;0.34;296.60;11.37;1015;68;4599.00;65
12271;65;626368815;12271;372;13287;13351;5.52;0.34;296.60;11.37;1016;68;4600.00;64
12274;65;626368829;12274;378;13288;13352;5.48;0.34;296.61;11.36;1014;68;4601.00;64
12280;65;626368841;12280;385;13288;13352;5.44;0.33;296.60;11.36;1008;68;4602.00;64
12282;65;626368852;12282;392;13288;13352;5.45;0.33;296.59;11.36;1006;68;4603.00;64
12287;65;626368863;12287;400;13288;13352;5.39;0.33;296.58;11.36;1001;68;4604.00;64
12290;65;626368879;12290;404;13288;13352;5.41;0.33;296.56;11.36;998;68;4605.00;64
12294;65;626368898;12294;406;13288;13352;5.39;0.33;296.54;11.36;994;68;4606.00;64
12295;65;626368923;12295;404;13288;13352;5.39;0.33;296.53;11.36;993;68;4607.00;64
12298;65;626368939;12298;411;13354;13479;5.87;0.37;296.50;11.31;1056;68;4608.00;125
12300;65;626368976;12300;407;13358;13480;5.86;0.36;296.51;11.31;1058;68;4609.00;122
12302;65;626368991;12302;415;13369;13480;5.95;0.37;296.47;11.30;1067;68;4610.00;111
12305;65;626369004;12305;419;13373;13480;5.96;0.37;296.45;11.30;1068;68;4611.00;107
12309;65;626369018;12309;424;13380;13480;5.97;0.37;296.46;11.29;1071;68;4612.00;100
12312;65;626369030;12312;428;13384;13480;5.94;0.37;296.42;11.29;1072;68;4613.00;96
12316;65;626369044;12316;429;13390;13480;5.92;0.37;296.39;11.29;1074;68;4614.00;90
12320;65;626369057;12320;430;13392;13480;5.88;0.36;296.39;11.29;1072;68;4615.00;88
12322;65;626369077;12322;438;13395;13481;5.86;0.36;296.39;11.29;1073;68;4616.00;86
12327;65;626369091;12327;444;13396;13482;5.83;0.36;296.35;11.29;1069;68;4617.00;86
12329;65;626369106;12329;444;13397;13482;5.82;0.36;296.37;11.29;1068;68;4618.00;85
12335;65;626369121;12335;448;13399;13483;5.76;0.35;296.39;11.29;1064;68;4619.00;84
12337;65;626369137;12337;450;13400;13483;5.74;0.35;296.38;11.29;1063;68;4620.00;83
12340;65;626369156;12340;458;13402;13483;5.71;0.35;296.39;11.33;1062;68;4621.00;81
12343;65;626369174;12343;461;13403;13483;5.64;0.35;296.37;11.33;1060;68;4622.00;80
12344;65;626369189;12344;468;13406;13487;5.58;0.34;296.37;11.33;1062;68;4623.00;81
12346;65;626369202;12346;477;13408;13487;5.58;0.34;296.37;11.33;1062;68;4624.00;79
12346;65;626369216;12346;478;13409;13487;5.55;0.34;296.37;11.33;1063;68;4625.00;78
12348;65;626369238;12348;482;13411;13490;5.51;0.34;296.37;11.33;1063;68;4626.00;79
12350;65;626369252;12350;471;13412;13490;5.48;0.34;296.36;11.33;1062;68;4627.00;78
12354;65;626369266;12354;458;13412;13490;5.46;0.33;296.33;11.33;1058;68;4628.00;78
12356;65;626369279;12356;448;13416;13494;5.57;0.34;296.34;11.33;1060;68;4629.00;78
12360;65;626369299;12360;446;13418;13495;5.62;0.34;296.29;11.33;1058;68;4630.00;77
12363;65;626369313;12363;441;13419;13495;5.69;0.35;296.27;11.33;1056;68;4631.00;76
12364;65;626369327;12364;439;13422;13499;5.76;0.35;296.26;11.33;1058;68;4632.00;77
12365;65;626369341;12365;433;13423;13499;5.81;0.35;296.26;11.33;1058;68;4633.00;76
12368;65;626369361;12368;432;13423;13499;5.84;0.36;296.25;11.33;1055;68;4634.00;76
12369;65;626369374;12369;428;13425;13501;5.95;0.36;296.24;11.32;1056;68;4635.00;76
12371;65;626369387;12371;424;13425;13501;5.98;0.36;296.22;11.32;1054;68;4636.00;76
12374;65;626369414;12374;410;13429;13507;6.03;0.37;296.18;11.32;1055;68;4637.00;78
12376;65;626369430;12376;398;13430;13507;6.14;0.37;296.15;11.32;1054;68;4638.00;77
12380;65;626369444;12380;393;13430;13508;6.20;0.38;296.12;11.32;1050;68;4639.00;78
12381;65;626369459;12381;382;13430;13508;6.24;0.38;296.13;11.32;1049;68;4640.00;78
12384;65;626369474;12384;376;13430;13508;6.30;0.38;296.15;11.32;1046;68;4641.00;78
12385;65;626369488;12385;371;13430;13508;6.37;0.39;296.19;11.32;1045;68;4642.00;78
12386;65;626369502;12386;365;13430;13508;6.42;0.39;296.19;11.32;1044;68;4643.00;78
12387;65;626369522;12387;363;13440;13520;6.56;0.40;296.18;11.31;1053;68;4644.00;80
12388;65;626369538;12388;364;13441;13520;6.62;0.40;296.18;11.31;1053;68;4645.00;79
12389;65;626369554;12389;349;13441;13520;6.67;0.41;296.18;11.31;1052;68;4646.00;79
12390;65;626369568;12390;346;13441;13520;6.74;0.41;296.17;11.31;1051;68;4647.00;79
12392;65;626369583;12392;340;13441;13520;6.82;0.41;296.19;11.31;1049;68;4648.00;79
12394;65;626369598;12394;326;13441;13520;6.93;0.42;296.17;11.31;1047;68;4649.00;79
12396;65;626369614;12396;319;13446;13526;6.97;0.42;296.20;11.31;1050;68;4650.00;80
12403;65;626369629;12403;309;13446;13526;6.97;0.42;296.29;11.31;1043;68;4651.00;80
12406;65;626369645;12406;313;13450;13530;7.05;0.43;296.32;11.30;1044;68;4652.00;80
12410;65;626369660;12410;299;13451;13531;7.02;0.43;296.35;11.30;1041;68;4653.00;80
12411;65;626369676;12411;299;13451;13531;7.03;0.43;296.34;11.30;1040;68;4654.00;80
12413;65;626369690;12413;292;13451;13531;7.06;0.43;296.39;11.30;1038;68;4655.00;80
12418;65;626369705;12418;290;13462;13544;7.10;0.43;296.43;11.29;1044;68;4656.00;82
12421;65;626369721;12421;287;13462;13544;7.10;0.43;296.44;11.29;1041;68;4657.00;82
12425;65;626369736;12425;284;13462;13544;7.07;0.43;296.44;11.29;1037;68;4658.00;82
12429;65;626369750;12429;283;13464;13545;7.05;0.43;296.48;11.34;1035;68;4659.00;81
12431;65;626369766;12431;276;13464;13546;7.09;0.43;296.50;11.34;1033;68;4660.00;82
12434;66;626369780;12434;272;13464;13546;7.11;0.43;296.53;11.34;1030;69;4661.00;82
12437;66;626369815;12437;267;13466;13549;7.15;0.43;296.62;11.34;1029;69;4662.00;83
12440;66;626369830;12440;263;13466;13549;7.14;0.43;296.68;11.34;1026;69;4663.00;83
12442;66;626369846;12442;264;13467;13549;7.14;0.43;296.71;11.34;1025;69;4664.00;82
12446;66;626369873;12446;266;13467;13549;7.11;0.43;296.73;11.34;1021;69;4665.00;82
12450;66;626369888;12450;276;13471;13555;7.03;0.42;296.77;11.34;1021;69;4666.00;84
12452;66;626369904;12452;278;13471;13555;7.02;0.42;296.80;11.34;1019;69;4667.00;84
12454;66;626369917;12454;282;13472;13555;7.00;0.42;296.81;11.34;1018;69;4668.00;83
12458;66;626369931;12458;280;13472;13555;6.99;0.42;296.86;11.34;1014;69;4669.00;83
12461;66;626369944;12461;278;13475;13559;6.96;0.42;296.91;11.34;1014;69;4670.00;84
12463;66;626369957;12463;275;13476;13560;6.94;0.42;296.91;11.34;1013;69;4671.00;84
12466;66;626369975;12466;274;13476;13560;6.91;0.42;296.98;11.34;1010;69;4672.00;84
12468;66;626369988;12468;275;13477;13561;6.89;0.42;297.01;11.34;1009;69;4673.00;84
12471;66;626370001;12471;275;13477;13561;6.84;0.41;297.06;11.34;1006;69;4674.00;84
12472;66;626370016;12472;278;13477;13561;6.82;0.41;297.09;11.34;1005;69;4675.00;84
12475;66;626370030;12475;282;13477;13561;6.76;0.41;297.14;11.34;1002;69;4676.00;84
12477;66;626370044;12477;285;13477;13561;6.75;0.41;297.22;11.34;1000;69;4677.00;84
12479;66;626370057;12479;289;13477;13561;6.76;0.41;297.22;11.34;998;69;4678.00;84
12481;66;626370070;12481;284;13477;13561;6.76;0.41;297.32;11.34;996;69;4679.00;84
12482;66;626370085;12482;302;13539;13686;6.76;0.41;297.30;11.28;1057;69;4680.00;147
12482;66;626370107;12482;282;13539;13687;6.84;0.42;297.30;11.28;1057;69;4681.00;148
12485;66;626370122;12485;265;13545;13687;6.88;0.42;297.37;11.28;1060;69;4682.00;142
12488;66;626370135;12488;264;13550;13687;6.96;0.43;297.42;11.33;1062;69;4683.00;137
12491;66;626370148;12491;258;13552;13687;7.01;0.43;297.49;11.33;1061;69;4684.00;135
12492;66;626370161;12492;253;13554;13687;7.08;0.43;297.53;11.33;1062;69;4685.00;133
12494;66;626370174;12494;250;13557;13687;7.09;0.43;297.51;11.33;1063;69;4686.00;130
12496;66;626370187;12496;254;13559;13687;7.09;0.43;297.55;11.33;1063;69;4687.00;128
12498;66;626370200;12498;256;13565;13688;7.13;0.44;297.56;11.32;1067;69;4688.00;123
12502;66;626370213;12502;255;13567;13689;7.09;0.43;297.63;11.32;1065;69;4689.00;122
12504;66;626370227;12504;250;13572;13689;7.12;0.44;297.67;11.32;1068;69;4690.00;117
12508;66;626370240;12508;246;13579;13693;7.06;0.43;297.69;11.32;1071;69;4691.00;114
12509;66;626370254;12509;241;13582;13693;6.98;0.43;297.68;11.32;1073;69;4692.00;111
12512;66;626370267;12512;232;13583;13693;6.89;0.42;297.70;11.32;1071;69;4693.00;110
12520;66;626370280;12520;228;13583;13693;6.74;0.41;297.76;11.32;1063;69;4694.00;110
12525;66;626370293;12525;233;13587;13699;6.69;0.41;297.80;11.33;1062;69;4695.00;112
12527;66;626370308;12527;228;13589;13699;6.65;0.41;297.79;11.38;1062;69;4696.00;110
12529;66;626370327;12529;230;13589;13699;6.59;0.40;297.82;11.38;1060;69;4697.00;110
12531;66;626370341;12531;234;13592;13702;6.61;0.40;297.81;11.38;1061;69;4698.00;110
12533;66;626370355;12533;232;13593;13702;6.71;0.41;297.82;11.38;1060;69;4699.00;109
12534;66;626370370;12534;230;13594;13702;6.80;0.41;297.80;11.43;1060;69;4700.00;108
12537;66;626370387;12537;230;13594;13703;6.79;0.41;297.81;11.43;1057;69;4701.00;109
12542;66;626370400;12542;223;13595;13704;6.79;0.41;297.87;11.43;1053;69;4702.00;109
12545;66;626370413;12545;218;13595;13704;6.72;0.41;297.83;11.43;1050;69;4703.00;109
12548;66;626370426;12548;232;13603;13717;6.78;0.41;297.83;11.43;1055;69;4704.00;114
12552;66;626370441;12552;221;13603;13717;6.81;0.42;297.91;11.43;1051;69;4705.00;114
12554;66;626370454;12554;222;13604;13717;6.84;0.42;297.88;11.43;1050;69;4706.00;113
12557;66;626370466;12557;223;13606;13718;6.84;0.42;297.92;11.43;1049;69;4707.00;112
12559;66;626370480;12559;220;13606;13718;6.89;0.42;297.95;11.43;1047;69;4708.00;112
12561;66;626370493;12561;220;13609;13722;6.96;0.42;297.94;11.42;1048;69;4709.00;113
12565;66;626370509;12565;218;13610;13722;6.97;0.42;297.95;11.42;1045;69;4710.00;112
12569;66;626370522;12569;222;13614;13726;6.96;0.42;297.92;11.42;1045;69;4711.00;112
12570;66;626370535;12570;230;13615;13726;7.01;0.43;297.93;11.42;1045;69;4712.00;111
12574;66;626370549;12574;232;13615;13726;7.03;0.43;297.98;11.42;1041;69;4713.00;111
12578;66;626370561;12578;241;13616;13726;7.08;0.43;298.11;11.43;1038;69;4714.00;110
12581;66;626370575;12581;248;13617;13726;7.13;0.43;298.13;11.43;1036;69;4715.00;109
12583;66;626370587;12583;253;13626;13738;7.20;0.44;298.14;11.42;1043;69;4716.00;112
12588;66;626370602;12588;254;13627;13738;7.22;0.44;298.16;11.42;1039;69;4717.00;111
12590;66;626370615;12590;262;13629;13738;7.21;0.44;298.17;11.42;1039;69;4718.00;109
12593;66;626370629;12593;268;13629;13738;7.22;0.44;298.21;11.42;1036;69;4719.00;109
12595;66;626370643;12595;276;13630;13738;7.23;0.44;298.26;11.42;1035;69;4720.00;108
12598;66;626370657;12598;280;13630;13738;7.20;0.44;298.28;11.42;1032;69;4721.00;108
12600;66;626370670;12600;289;13632;13739;7.20;0.44;298.30;11.45;1032;69;4722.00;107
12602;66;626370683;12602;293;13633;13739;7.19;0.44;298.29;11.46;1031;69;4723.00;106
12604;66;626370697;12604;297;13639;13745;7.21;0.44;298.32;11.49;1035;69;4724.00;106
12608;66;626370710;12608;302;13643;13747;7.24;0.44;298.33;11.50;1035;69;4725.00;104
12610;66;626370724;12610;305;13644;13747;7.23;0.44;298.32;11.51;1034;69;4726.00;103
12614;66;626370737;12614;306;13645;13747;7.23;0.44;298.33;11.52;1031;69;4727.00;102
12615;66;626370750;12615;303;13649;13751;7.24;0.44;298.34;11.53;1034;69;4728.00;102
12617;66;626370764;12617;308;13650;13751;7.18;0.44;298.38;11.55;1033;69;4729.00;101
12618;66;626370778;12618;302;13651;13751;7.14;0.44;298.38;11.56;1033;69;4730.00;100
12621;66;626370792;12621;308;13654;13752;7.08;0.43;298.44;11.58;1033;69;4731.00;98
12625;66;626370806;12625;313;13657;13756;7.01;0.43;298.42;11.57;1032;69;4732.00;99
12626;66;626370820;12626;311;13659;13756;6.97;0.43;298.40;11.60;1033;69;4733.00;97
12628;66;626370835;12628;314;13662;13759;6.95;0.43;298.39;11.61;1034;69;4734.00;97
12630;66;626370848;12630;318;13664;13759;6.94;0.42;298.39;11.61;1034;69;4735.00;95
12634;66;626370860;12634;317;13665;13759;6.90;0.42;298.44;11.63;1031;69;4736.00;94
12635;66;626370878;12635;320;13666;13759;6.87;0.42;298.52;11.63;1031;69;4737.00;93
12636;66;626370901;12636;324;13670;13763;6.91;0.42;298.56;11.64;1034;69;4738.00;93
12636;66;626370921;12636;325;13671;13763;6.88;0.42;298.56;11.65;1035;69;4739.00;92
12640;66;626370942;12640;328;13673;13763;6.83;0.42;298.67;11.66;1033;69;4740.00;90
12643;66;626370960;12643;324;13674;13763;6.82;0.42;298.81;11.66;1031;69;4741.00;89
12645;66;626370981;12645;328;13675;13764;6.77;0.42;298.79;11.67;1030;69;4742.00;89
12649;66;626370996;12649;327;13677;13765;6.71;0.41;298.77;11.68;1028;69;4743.00;88
12651;66;626371008;12651;332;13677;13765;6.64;0.41;298.76;11.68;1026;69;4744.00;88
12652;66;626371021;12652;339;13679;13766;6.61;0.41;298.76;11.69;1027;69;4745.00;87
12652;66;626371034;12652;337;13682;13766;6.60;0.41;298.76;11.70;1030;69;4746.00;84
12657;66;626371047;12657;338;13683;13766;6.54;0.40;298.74;11.71;1026;69;4747.00;83
12659;66;626371060;12659;336;13683;13766;6.51;0.40;298.77;11.71;1024;69;4748.00;83
12665;66;626371072;12665;344;13683;13766;6.46;0.40;298.72;11.71;1018;69;4749.00;83
12668;66;626371085;12668;347;13685;13766;6.41;0.39;298.67;11.72;1017;69;4750.00;81
12672;66;626371097;12672;347;13685;13766;6.35;0.39;298.65;11.72;1013;69;4751.00;81
12674;66;626371109;12674;368;13749;13893;6.52;0.40;298.68;11.68;1075;69;4752.00;144
12677;66;626371130;12677;365;13753;13894;6.44;0.40;298.68;11.68;1076;69;4753.00;141
12681;66;626371143;12681;359;13763;13894;6.41;0.40;298.73;11.68;1082;69;4754.00;131
12683;66;626371155;12683;361;13769;13894;6.38;0.39;298.74;11.68;1086;69;4755.00;125
12687;66;626371167;12687;362;13780;13894;6.30;0.39;298.74;11.70;1093;69;4756.00;114
12692;66;626371179;12692;356;13787;13894;6.16;0.38;298.71;11.71;1095;69;4757.00;107
12695;66;626371192;12695;364;13793;13894;6.08;0.38;298.71;11.71;1098;69;4758.00;101
12697;66;626371203;12697;375;13795;13894;6.02;0.37;298.70;11.71;1098;69;4759.00;99
12701;66;626371214;12701;362;13799;13895;5.94;0.37;298.66;11.71;1098;69;4760.00;96
12707;66;626371227;12707;366;13801;13896;5.85;0.36;298.59;11.71;1094;69;4761.00;95
12708;66;626371240;12708;372;13804;13896;5.83;0.36;298.62;11.72;1096;69;4762.00;92
12710;66;626371252;12710;378;13805;13897;5.79;0.36;298.60;11.72;1095;69;4763.00;92
12713;66;626371265;12713;381;13807;13897;5.77;0.36;298.59;11.72;1094;69;4764.00;90
12714;66;626371277;12714;390;13809;13897;5.73;0.35;298.58;11.73;1095;69;4765.00;88
12717;66;626371289;12717;401;13811;13897;5.72;0.35;298.55;11.73;1094;69;4766.00;86
12719;66;626371301;12719;402;13813;13901;5.70;0.35;298.56;11.73;1094;69;4767.00;88
12722;66;626371320;12722;403;13815;13901;5.74;0.35;298.65;11.73;1093;69;4768.00;86
12727;66;626371333;12727;402;13816;13901;5.75;0.35;298.62;11.73;1089;69;4769.00;85
12728;66;626371348;12728;411;13820;13907;5.84;0.36;298.60;11.73;1092;69;4770.00;87
12733;66;626371361;12733;417;13821;13907;5.84;0.36;298.58;11.73;1088;69;4771.00;86
12733;66;626371373;12733;418;13822;13907;5.82;0.36;298.58;11.73;1089;69;4772.00;85
12736;66;626371385;12736;417;13824;13911;5.79;0.36;298.57;11.73;1088;69;4773.00;87
12738;66;626371398;12738;417;13827;13912;5.73;0.35;298.59;11.72;1089;69;4774.00;85
12741;66;626371412;12741;420;13827;13912;5.65;0.35;298.54;11.72;1086;69;4775.00;85
12745;66;626371424;12745;422;13831;13916;5.67;0.35;298.58;11.72;1086;69;4776.00;85
12748;66;626371437;12748;426;13831;13916;5.65;0.35;298.57;11.72;1083;69;4777.00;85
12751;66;626371450;12751;428;13832;13916;5.64;0.35;298.54;11.72;1081;69;4778.00;84
12753;66;626371463;12753;415;13833;13917;5.62;0.34;298.57;11.72;1080;69;4779.00;84
12756;66;626371477;12756;407;13834;13917;5.63;0.35;298.55;11.72;1078;69;4780.00;83
12759;66;626371490;12759;408;13837;13923;5.65;0.35;298.55;11.72;1078;69;4781.00;86
12763;66;626371504;12763;401;13838;13923;5.70;0.35;298.52;11.72;1075;69;4782.00;85
12766;66;626371518;12766;395;13838;13924;5.79;0.35;298.50;11.72;1072;69;4783.00;86
12770;66;626371532;12770;392;13839;13924;5.89;0.36;298.47;11.72;1069;69;4784.00;85
12772;66;626371545;12772;383;13839;13924;5.99;0.37;298.46;11.72;1067;69;4785.00;85
12773;66;626371565;12773;377;13839;13924;6.08;0.37;298.46;11.72;1066;69;4786.00;85
12778;66;626371579;12778;381;13839;13924;6.08;0.37;298.46;11.72;1061;69;4787.00;85
12782;67;626371592;12782;380;13849;13936;6.21;0.38;298.45;11.71;1067;70;4788.00;87
12785;67;626371619;12785;385;13849;13936;6.24;0.38;298.43;11.71;1064;70;4789.00;87
12788;67;626371633;12788;389;13850;13936;6.29;0.39;298.42;11.71;1062;70;4790.00;86
12793;67;626371653;12793;387;13850;13936;6.32;0.39;298.39;11.71;1057;70;4791.00;86
12798;67;626371667;12798;387;13850;13936;6.30;0.39;298.39;11.71;1052;70;4792.00;86
12804;67;626371681;12804;392;13850;13936;6.28;0.38;298.38;11.71;1046;70;4793.00;86
12807;67;626371694;12807;392;13853;13940;6.32;0.39;298.37;11.70;1046;70;4794.00;87
12811;67;626371709;12811;393;13854;13940;6.29;0.38;298.36;11.76;1043;70;4795.00;86
12815;67;626371722;12815;401;13857;13944;6.30;0.38;298.33;11.76;1042;70;4796.00;87
12816;67;626371737;12816;403;13858;13945;6.30;0.38;298.33;11.76;1042;70;4797.00;87
12819;67;626371750;12819;400;13859;13945;6.31;0.38;298.36;11.76;1040;70;4798.00;86
12819;67;626371763;12819;395;13859;13945;6.32;0.39;298.36;11.76;1040;70;4799.00;86
12822;67;626371778;12822;407;13881;13986;6.40;0.39;298.36;11.74;1059;70;4800.00;105
12828;67;626371799;12828;408;13881;13986;6.33;0.39;298.39;11.74;1053;70;4801.00;105
12831;67;626371814;12831;413;13884;13986;6.27;0.38;298.41;11.74;1053;70;4802.00;102
12834;67;626371827;12834;415;13886;13987;6.25;0.38;298.36;11.74;1052;70;4803.00;101
12835;67;626371840;12835;416;13886;13988;6.24;0.38;298.36;11.74;1051;70;4804.00;102
12837;67;626371854;12837;416;13887;13988;6.20;0.38;298.41;11.74;1050;70;4805.00;101
12841;67;626371866;12841;425;13890;13991;6.15;0.38;298.44;11.74;1049;70;4806.00;101
12845;67;626371882;12845;420;13892;13991;6.09;0.37;298.44;11.74;1047;70;4807.00;99
12848;67;626371896;12848;416;13893;13991;6.07;0.37;298.43;11.73;1045;70;4808.00;98
12851;67;626371916;12851;414;13893;13991;6.09;0.37;298.42;11.73;1042;70;4809.00;98
12855;67;626371929;12855;411;13899;13997;6.09;0.37;298.48;11.73;1044;70;4810.00;98
12859;67;626371943;12859;415;13900;13997;6.12;0.37;298.55;11.73;1041;70;4811.00;97
12860;67;626371957;12860;414;13900;13997;6.19;0.38;298.54;11.73;1040;70;4812.00;97
12865;67;626371976;12865;415;13900;13997;6.14;0.37;298.64;11.73;1035;70;4813.00;97
12870;67;626372001;12870;421;13903;14001;6.13;0.37;298.69;11.73;1033;70;4814.00;98
12870;67;626372014;12870;418;13905;14003;6.25;0.38;298.69;11.73;1035;70;4815.00;98
12874;67;626372027;12874;395;13906;14003;6.29;0.38;298.71;11.73;1032;70;4816.00;97
12877;67;626372040;12877;386;13907;14004;6.36;0.39;298.75;11.73;1030;70;4817.00;97
12881;67;626372053;12881;386;13907;14004;6.39;0.39;298.75;11.73;1026;70;4818.00;97
12885;67;626372066;12885;381;13907;14004;6.45;0.39;298.75;11.73;1022;70;4819.00;97
12888;68;626372080;12888;367;13907;14004;6.51;0.39;298.79;11.73;1019;71;4820.00;97
12890;68;626372100;12890;357;13908;14004;6.53;0.39;298.84;11.73;1018;71;4821.00;96
12892;68;626372113;12892;347;13908;14004;6.51;0.39;298.88;11.73;1016;71;4822.00;96
12893;68;626372126;12893;348;13908;14004;6.47;0.39;298.86;11.73;1015;71;4823.00;96
12899;68;626372139;12899;364;13949;14074;6.39;0.39;298.96;11.69;1050;71;4824.00;125
12901;68;626372158;12901;353;13949;14075;6.36;0.39;298.99;11.69;1048;71;4825.00;126
12904;68;626372176;12904;353;13954;14075;6.42;0.39;299.00;11.69;1050;71;4826.00;121
12908;68;626372189;12908;346;13955;14075;6.41;0.39;299.05;11.69;1047;71;4827.00;120
12909;68;626372202;12909;341;13959;14077;6.48;0.39;299.04;11.69;1050;71;4828.00;118
12911;68;626372216;12911;345;13959;14077;6.49;0.39;299.01;11.69;1048;71;4829.00;118
12911;68;626372231;12911;338;13962;14077;6.53;0.40;299.01;11.69;1051;71;4830.00;115
12911;68;626372245;12911;336;13963;14077;6.56;0.40;299.01;11.69;1052;71;4831.00;114
12913;68;626372258;12913;341;13966;14078;6.60;0.40;299.09;11.69;1053;71;4832.00;112
12915;68;626372271;12915;338;13969;14079;6.63;0.40;299.14;11.69;1054;71;4833.00;110
12917;68;626372285;12917;337;13970;14079;6.65;0.40;299.22;11.69;1053;71;4834.00;109
12921;68;626372298;12921;340;13975;14083;6.62;0.40;299.23;11.68;1054;71;4835.00;108
12922;68;626372311;12922;340;13978;14083;6.60;0.40;299.25;11.68;1056;71;4836.00;105
12926;68;626372324;12926;341;13980;14083;6.59;0.40;299.26;11.68;1054;71;4837.00;103
12929;68;626372338;12929;342;13981;14083;6.59;0.40;299.30;11.68;1052;71;4838.00;102
12931;68;626372357;12931;341;13987;14089;6.63;0.40;299.29;11.68;1056;71;4839.00;102
12932;68;626372371;12932;349;13987;14089;6.62;0.40;299.36;11.68;1055;71;4840.00;102
12934;68;626372384;12934;347;13988;14089;6.62;0.40;299.38;11.68;1054;71;4841.00;101
12934;68;626372397;12934;348;13991;14092;6.63;0.40;299.38;11.68;1057;71;4842.00;101
12935;68;626372410;12935;351;13991;14092;6.63;0.40;299.37;11.68;1056;71;4843.00;101
12937;68;626372423;12937;361;13991;14092;6.62;0.40;299.43;11.68;1054;71;4844.00;101
12938;68;626372436;12938;360;13991;14093;6.59;0.40;299.41;11.68;1053;71;4845.00;102
12940;68;626372448;12940;366;13992;14094;6.58;0.40;299.44;11.68;1052;71;4846.00;102
12940;68;626372462;12940;367;13992;14094;6.57;0.40;299.44;11.68;1052;71;4847.00;102
12944;68;626372474;12944;370;14002;14107;6.57;0.40;299.47;11.67;1058;71;4848.00;105
12946;68;626372488;12946;369;14003;14107;6.56;0.40;299.45;11.67;1057;71;4849.00;104
12949;68;626372501;12949;361;14003;14107;6.56;0.40;299.44;11.67;1054;71;4850.00;104
12950;68;626372514;12950;353;14004;14108;6.58;0.40;299.44;11.67;1054;71;4851.00;104
12953;68;626372526;12953;345;14004;14108;6.52;0.40;299.42;11.67;1051;71;4852.00;104
12955;68;626372538;12955;343;14007;14112;6.49;0.39;299.41;11.66;1052;71;4853.00;105
12956;68;626372551;12956;332;14007;14112;6.47;0.39;299.40;11.66;1051;71;4854.00;105
12958;68;626372563;12958;327;14011;14116;6.46;0.39;299.40;11.66;1053;71;4855.00;105
12964;68;626372576;12964;317;14011;14116;6.46;0.39;299.41;11.66;1047;71;4856.00;105
12965;68;626372589;12965;310;14011;14116;6.48;0.39;299.41;11.66;1046;71;4857.00;105
12969;68;626372606;12969;306;14011;14116;6.44;0.39;299.43;11.66;1042;71;4858.00;105
12970;68;626372618;12970;300;14011;14116;6.45;0.39;299.46;11.66;1041;71;4859.00;105
12972;68;626372632;12972;301;14032;14150;6.50;0.40;299.53;11.64;1060;71;4860.00;118
12974;68;626372647;12974;282;14033;14150;6.51;0.40;299.53;11.71;1059;71;4861.00;117
12974;68;626372660;12974;268;14034;14150;6.59;0.40;299.53;11.71;1060;71;4862.00;116
12981;68;626372672;12981;257;14035;14150;6.56;0.40;299.56;11.71;1054;71;4863.00;115
12984;68;626372684;12984;257;14036;14150;6.61;0.40;299.56;11.71;1052;71;4864.00;114
12987;68;626372696;12987;250;14037;14150;6.59;0.40;299.55;11.72;1050;71;4865.00;113
12991;68;626372709;12991;244;14038;14151;6.58;0.40;299.63;11.72;1047;71;4866.00;113
12995;68;626372722;12995;232;14038;14151;6.61;0.40;299.73;11.72;1043;71;4867.00;113
13001;68;626372735;13001;227;14042;14157;6.59;0.40;299.89;11.72;1041;71;4868.00;115
13001;68;626372747;13001;229;14043;14158;6.64;0.40;299.89;11.72;1042;71;4869.00;115
13006;68;626372760;13006;222;14044;14158;6.62;0.40;299.91;11.72;1038;71;4870.00;114
13008;68;626372772;13008;219;14044;14158;6.64;0.40;299.95;11.72;1036;71;4871.00;114
13012;68;626372785;13012;221;14046;14162;6.66;0.40;299.95;11.71;1034;71;4872.00;116
13013;68;626372797;13013;223;14046;14162;6.65;0.40;299.97;11.71;1033;71;4873.00;116
13017;68;626372809;13017;232;14046;14162;6.66;0.41;300.03;11.71;1029;71;4874.00;116
13018;68;626372821;13018;228;14047;14163;6.73;0.41;300.02;11.71;1029;71;4875.00;116
13023;68;626372833;13023;225;14051;14167;6.72;0.41;300.06;11.77;1028;71;4876.00;116
13024;68;626372846;13024;220;14052;14167;6.73;0.41;300.09;11.77;1028;71;4877.00;115
13028;68;626372858;13028;214;14054;14170;6.76;0.41;300.11;11.77;1026;71;4878.00;116
13030;68;626372872;13030;220;14056;14170;6.77;0.41;300.10;11.77;1026;71;4879.00;114
13034;68;626372892;13034;225;14056;14170;6.72;0.41;300.10;11.77;1022;71;4880.00;114
13036;68;626372910;13036;223;14057;14170;6.68;0.41;300.13;11.83;1021;71;4881.00;113
13042;68;626372933;13042;219;14061;14174;6.67;0.40;300.09;11.83;1019;71;4882.00;113
13043;68;626372954;13043;224;14062;14174;6.70;0.41;300.11;11.83;1019;71;4883.00;112
13045;68;626372973;13045;231;14063;14174;6.73;0.41;300.10;11.83;1018;71;4884.00;111
13047;68;626372990;13047;233;14064;14174;6.71;0.41;300.10;11.83;1017;71;4885.00;110
13050;68;626373006;13050;238;14065;14175;6.67;0.41;300.10;11.84;1015;71;4886.00;110
13050;68;626373021;13050;242;14066;14176;6.68;0.41;300.10;11.83;1016;71;4887.00;110
13052;68;626373036;13052;245;14066;14176;6.66;0.41;300.07;11.83;1014;71;4888.00;110
13055;68;626373050;13055;255;14068;14177;6.62;0.40;300.06;11.85;1013;71;4889.00;109
13062;68;626373067;13062;254;14069;14177;6.52;0.40;300.09;11.86;1007;71;4890.00;108
13063;68;626373081;13063;253;14069;14177;6.50;0.39;300.18;11.86;1006;71;4891.00;108
13064;68;626373095;13064;268;14071;14177;6.48;0.39;300.18;11.88;1007;71;4892.00;106
13067;68;626373108;13067;266;14071;14177;6.47;0.39;300.24;11.88;1004;71;4893.00;106
13069;68;626373122;13069;275;14071;14177;6.43;0.39;300.21;11.88;1002;71;4894.00;106
13072;68;626373134;13072;269;14073;14177;6.40;0.39;300.24;11.91;1001;71;4895.00;104
13074;68;626373148;13074;296;14136;14304;6.69;0.41;300.27;11.86;1062;71;4896.00;168
13077;68;626373171;13077;301;14142;14305;6.68;0.41;300.26;11.87;1065;71;4897.00;163
13077;68;626373185;13077;300;14151;14305;6.76;0.42;300.26;11.87;1074;71;4898.00;154
13078;68;626373197;13078;296;14154;14305;6.73;0.42;300.25;11.88;1076;71;4899.00;151
13081;68;626373212;13081;292;14162;14305;6.79;0.42;300.23;11.89;1081;71;4900.00;143
13082;68;626373229;13082;295;14165;14305;6.71;0.41;300.28;11.90;1083;71;4901.00;140
13083;68;626373243;13083;299;14173;14305;6.70;0.41;300.31;11.91;1090;71;4902.00;132
13088;68;626373264;13088;304;14174;14305;6.62;0.41;300.25;11.92;1086;71;4903.00;131
13090;68;626373280;13090;302;14180;14306;6.64;0.41;300.22;11.92;1090;71;4904.00;126
13093;68;626373293;13093;305;14186;14308;6.62;0.41;300.17;11.93;1093;71;4905.00;122
13094;68;626373307;13094;318;14190;14308;6.56;0.40;300.15;11.94;1096;71;4906.00;118
13097;68;626373321;13097;323;14193;14309;6.49;0.40;300.14;11.94;1096;71;4907.00;116
13098;68;626373336;13098;322;14198;14309;6.44;0.40;300.13;11.95;1100;71;4908.00;111
13101;68;626373349;13101;325;14202;14309;6.35;0.39;300.10;11.96;1101;71;4909.00;107
13102;68;626373362;13102;324;14204;14309;6.33;0.39;300.08;11.96;1102;71;4910.00;105
13104;68;626373375;13104;323;14207;14313;6.27;0.38;300.10;11.97;1103;71;4911.00;106
13105;68;626373396;13105;341;14210;14313;6.21;0.38;300.10;11.97;1105;71;4912.00;103
13107;68;626373409;13107;340;14211;14313;6.17;0.38;300.07;11.97;1104;71;4913.00;102
13107;68;626373422;13107;354;14215;14316;6.10;0.37;300.07;11.99;1108;71;4914.00;101
13109;68;626373435;13109;358;14216;14316;6.03;0.37;300.11;11.99;1107;71;4915.00;100
13110;68;626373456;13110;378;14218;14316;5.94;0.36;300.09;12.00;1108;71;4916.00;98
13111;68;626373469;13111;381;14223;14320;5.88;0.36;300.08;12.00;1112;71;4917.00;97
13112;68;626373482;13112;393;14225;14321;5.90;0.36;300.06;12.00;1113;71;4918.00;96
13115;68;626373495;13115;395;14227;14321;5.83;0.36;300.01;12.01;1112;71;4919.00;94
13115;68;626373508;13115;401;14231;14326;5.81;0.36;300.01;12.01;1116;71;4920.00;95
13115;68;626373520;13115;411;14232;14326;5.69;0.35;300.01;12.02;1117;71;4921.00;94
13118;68;626373532;13118;412;14232;14326;5.54;0.34;300.04;12.02;1114;71;4922.00;94
13121;68;626373543;13121;420;14233;14327;5.41;0.33;300.06;12.02;1112;71;4923.00;94
13126;68;626373555;13126;420;14234;14327;5.27;0.32;300.02;12.03;1108;71;4924.00;93
13129;68;626373567;13129;429;14239;14333;5.21;0.32;300.02;12.03;1110;71;4925.00;94
13131;68;626373579;13131;434;14239;14333;5.13;0.31;300.01;12.03;1108;71;4926.00;94
13134;68;626373590;13134;443;14241;14334;4.98;0.31;299.99;12.04;1107;71;4927.00;93
13137;68;626373603;13137;457;14241;14334;4.89;0.30;299.96;12.04;1104;71;4928.00;93
13142;68;626373614;13142;456;14242;14334;4.71;0.29;299.94;12.05;1100;71;4929.00;92
13145;68;626373625;13145;449;14243;14334;4.61;0.28;299.91;12.07;1098;71;4930.00;91
13148;68;626373637;13148;424;14244;14334;4.53;0.28;299.87;12.08;1096;71;4931.00;90
13151;68;626373648;13151;417;14254;14346;4.63;0.28;299.90;12.07;1103;71;4932.00;92
13152;68;626373660;13152;419;14255;14346;4.64;0.28;299.91;12.08;1103;71;4933.00;91
13153;68;626373672;13153;421;14257;14346;4.69;0.29;299.92;12.09;1104;71;4934.00;89
13155;68;626373683;13155;420;14257;14346;4.75;0.29;299.94;12.09;1102;71;4935.00;89
13158;68;626373695;13158;415;14258;14346;4.82;0.30;299.96;12.10;1100;71;4936.00;88
13159;68;626373707;13159;403;14258;14346;4.89;0.30;299.97;12.10;1099;71;4937.00;88
13163;68;626373726;13163;399;14261;14350;4.97;0.30;300.08;12.10;1098;71;4938.00;89
13163;68;626373738;13163;393;14261;14350;5.06;0.31;300.08;12.10;1098;71;4939.00;89
13166;69;626373750;13166;389;14264;14354;5.20;0.32;300.09;12.10;1098;72;4940.00;90
13169;69;626373775;13169;382;14265;14355;5.29;0.33;300.09;12.10;1096;72;4941.00;90
13170;69;626373788;13170;377;14266;14355;5.40;0.33;300.09;12.10;1096;72;4942.00;89
13172;69;626373801;13172;369;14266;14355;5.48;0.34;300.09;12.10;1094;72;4943.00;89
13177;69;626373814;13177;374;14277;14368;5.60;0.34;300.06;12.09;1100;72;4944.00;91
13179;69;626373829;13179;367;14277;14368;5.64;0.35;300.05;12.09;1098;72;4945.00;91
13181;69;626373843;13181;366;14277;14368;5.69;0.35;300.06;12.09;1096;72;4946.00;91
13185;69;626373855;13185;368;14278;14369;5.76;0.35;300.04;12.09;1093;72;4947.00;91
13190;69;626373868;13190;360;14278;14370;5.85;0.36;300.00;12.09;1088;72;4948.00;92
13195;69;626373883;13195;361;14278;14370;5.87;0.36;300.01;12.09;1083;72;4949.00;92
13197;69;626373905;13197;358;14282;14379;5.99;0.37;300.00;12.08;1085;72;4950.00;97
13199;69;626373919;13199;364;14283;14379;6.01;0.37;300.01;12.08;1084;72;4951.00;96
13201;69;626373938;13201;369;14284;14379;6.06;0.37;300.01;12.08;1083;72;4952.00;95
13203;69;626373951;13203;368;14284;14379;6.10;0.38;300.01;12.08;1081;72;4953.00;95
13210;69;626373964;13210;366;14288;14385;6.17;0.38;299.99;12.08;1078;72;4954.00;97
13213;69;626373978;13213;362;14288;14385;6.18;0.38;300.05;12.08;1075;72;4955.00;97
13218;69;626373991;13218;365;14289;14385;6.23;0.38;300.04;12.08;1071;72;4956.00;96
13222;69;626374004;13222;369;14290;14385;6.21;0.38;300.02;12.08;1068;72;4957.00;95
13226;69;626374017;13226;369;14293;14389;6.23;0.38;300.07;12.08;1067;72;4958.00;96
13234;69;626374030;13234;373;14295;14390;6.25;0.38;300.05;12.08;1061;72;4959.00;95
13238;69;626374044;13238;379;14296;14390;6.23;0.38;300.01;12.08;1058;72;4960.00;94
13245;69;626374057;13245;378;14297;14391;6.21;0.38;300.09;12.07;1052;72;4961.00;94
13249;69;626374071;13249;381;14297;14391;6.23;0.38;300.15;12.07;1048;72;4962.00;94
13254;69;626374083;13254;381;14297;14391;6.28;0.38;300.22;12.07;1043;72;4963.00;94
13256;69;626374097;13256;389;14297;14391;6.31;0.39;300.20;12.07;1041;72;4964.00;94
13260;69;626374110;13260;381;14297;14391;6.32;0.39;300.16;12.07;1037;72;4965.00;94
13265;69;626374123;13265;382;14297;14391;6.36;0.39;300.20;12.07;1032;72;4966.00;94
13267;69;626374135;13267;377;14297;14391;6.40;0.39;300.26;12.07;1030;72;4967.00;94
13270;69;626374154;13270;395;14342;14461;6.42;0.39;300.31;12.10;1072;72;4968.00;119
13271;69;626374173;13271;390;14342;14462;6.49;0.40;300.31;12.10;1071;72;4969.00;120
13275;69;626374187;13275;387;14347;14462;6.53;0.40;300.39;12.10;1072;72;4970.00;115
13279;69;626374200;13279;385;14349;14462;6.56;0.40;300.49;12.09;1070;72;4971.00;113
13283;69;626374219;13283;387;14352;14462;6.59;0.40;300.56;12.09;1069;72;4972.00;110
13285;69;626374233;13285;390;14357;14462;6.61;0.40;300.59;12.09;1072;72;4973.00;105
13289;69;626374246;13289;392;14361;14462;6.60;0.40;300.60;12.09;1072;72;4974.00;101
13292;69;626374260;13292;396;14362;14462;6.55;0.40;300.65;12.09;1070;72;4975.00;100
13297;69;626374274;13297;399;14364;14463;6.47;0.40;300.69;12.09;1067;72;4976.00;99
13298;69;626374287;13298;390;14365;14464;6.43;0.39;300.68;12.09;1067;72;4977.00;99
13303;69;626374300;13303;384;14366;14464;6.36;0.39;300.87;12.09;1063;72;4978.00;98
13307;69;626374315;13307;373;14369;14468;6.30;0.39;300.92;12.08;1062;72;4979.00;99
13308;69;626374330;13308;374;14369;14468;6.31;0.39;300.91;12.08;1061;72;4980.00;99
13311;69;626374344;13311;378;14369;14468;6.28;0.39;300.92;12.08;1058;72;4981.00;99
13314;69;626374358;13314;379;14369;14468;6.32;0.39;300.93;12.08;1055;72;4982.00;99
13318;69;626374371;13318;381;14373;14474;6.37;0.39;301.00;12.08;1055;72;4983.00;101
13322;69;626374385;13322;386;14373;14474;6.42;0.39;301.03;12.08;1051;72;4984.00;101
13324;69;626374398;13324;384;14374;14474;6.51;0.40;301.07;12.08;1050;72;4985.00;100
13326;69;626374417;13326;373;14376;14477;6.61;0.40;301.07;12.08;1050;72;4986.00;101
13328;69;626374437;13328;364;14377;14477;6.69;0.41;301.15;12.08;1049;72;4987.00;100
13333;69;626374450;13333;350;14377;14477;6.76;0.41;301.20;12.08;1044;72;4988.00;100
13336;69;626374464;13336;342;14377;14478;6.85;0.42;301.21;12.08;1041;72;4989.00;101
13341;69;626374478;13341;340;14378;14479;6.91;0.42;301.19;12.08;1037;72;4990.00;101
13344;69;626374498;13344;342;14378;14479;6.94;0.42;301.18;12.08;1034;72;4991.00;101
13348;69;626374512;13348;347;14389;14492;6.96;0.42;301.22;12.07;1041;72;4992.00;103
13351;69;626374527;13351;343;14389;14492;6.94;0.42;301.29;12.07;1038;72;4993.00;103
13355;69;626374541;13355;346;14389;14492;6.88;0.42;301.31;12.07;1034;72;4994.00;103
13357;69;626374561;13357;349;14391;14494;6.85;0.41;301.35;12.07;1034;72;4995.00;103
13359;69;626374581;13359;343;14391;14494;6.81;0.41;301.35;12.07;1032;72;4996.00;103
13363;69;626374601;13363;333;14395;14498;6.73;0.41;301.39;12.13;1032;72;4997.00;103
13365;69;626374616;13365;330;14395;14498;6.70;0.41;301.41;12.13;1030;72;4998.00;103
13368;69;626374629;13368;325;14399;14502;6.68;0.41;301.45;12.12;1031;72;4999.00;103
13370;69;626374644;13370;322;14399;14502;6.68;0.40;301.49;12.12;1029;72;5000.00;103
13372;69;626374661;13372;317;14399;14502;6.72;0.41;301.49;12.12;1027;72;5001.00;103
13377;69;626374675;13377;307;14399;14502;6.76;0.41;301.59;12.12;1022;72;5002.00;103
13377;69;626374688;13377;305;14399;14502;6.79;0.41;301.59;12.12;1022;72;5003.00;103
13382;69;626374701;13382;295;14408;14514;6.79;0.41;301.64;12.12;1026;72;5004.00;106
13385;69;626374716;13385;293;14408;14514;6.75;0.41;301.77;12.12;1023;72;5005.00;106
13385;69;626374729;13385;294;14410;14514;6.78;0.41;301.77;12.11;1025;72;5006.00;104
13386;69;626374742;13386;288;14410;14514;6.82;0.41;301.80;12.11;1024;72;5007.00;104
13387;69;626374754;13387;288;14410;14514;6.83;0.42;301.81;12.11;1023;72;5008.00;104
13388;69;626374774;13388;294;14410;14514;6.87;0.42;301.84;12.11;1022;72;5009.00;104
13391;69;626374788;13391;294;14410;14515;6.85;0.42;301.83;12.11;1019;72;5010.00;105
13395;69;626374801;13395;297;14410;14515;6.84;0.42;301.90;12.11;1015;72;5011.00;105
13397;69;626374814;13397;301;14414;14521;6.82;0.41;301.88;12.11;1017;72;5012.00;107
13399;69;626374827;13399;301;14415;14522;6.78;0.41;301.88;12.11;1016;72;5013.00;107
13401;69;626374839;13401;302;14416;14522;6.76;0.41;301.88;12.11;1015;72;5014.00;106
13402;69;626374852;13402;306;14416;14522;6.75;0.41;301.87;12.11;1014;72;5015.00;106
13405;69;626374864;13405;315;14419;14526;6.69;0.41;301.87;12.11;1014;72;5016.00;107
13406;69;626374880;13406;313;14419;14526;6.69;0.41;301.86;12.11;1013;72;5017.00;107
13407;69;626374900;13407;313;14419;14526;6.66;0.40;301.85;12.11;1012;72;5018.00;107
13407;69;626374917;13407;318;14420;14527;6.64;0.40;301.85;12.11;1013;72;5019.00;107
13409;69;626374939;13409;307;14423;14531;6.55;0.40;301.88;12.10;1014;72;5020.00;108
13409;69;626374960;13409;308;14423;14531;6.48;0.39;301.88;12.10;1014;72;5021.00;108
13410;69;626374978;13410;302;14425;14534;6.47;0.39;301.88;12.10;1015;72;5022.00;109
13411;69;626374995;13411;295;14425;14534;6.41;0.39;301.87;12.10;1014;72;5023.00;109
13413;69;626375010;13413;287;14426;14534;6.29;0.38;301.88;12.10;1013;72;5024.00;108
13418;69;626375024;13418;286;14426;14534;6.18;0.38;301.90;12.10;1008;72;5025.00;108
13422;69;626375038;13422;277;14429;14538;6.14;0.37;301.93;12.10;1007;72;5026.00;109
13425;69;626375052;13425;273;14430;14538;6.06;0.37;301.99;12.16;1005;72;5027.00;108
13427;69;626375065;13427;264;14431;14538;6.05;0.37;302.02;12.16;1004;72;5028.00;107
13430;69;626375078;13430;263;14431;14538;6.01;0.37;302.04;12.16;1001;72;5029.00;107
13434;69;626375090;13434;252;14431;14539;5.94;0.36;302.06;12.16;997;72;5030.00;108
13438;69;626375102;13438;240;14432;14540;5.90;0.36;302.08;12.16;994;72;5031.00;108
13442;69;626375115;13442;235;14432;14540;5.83;0.36;302.11;12.16;990;72;5032.00;108
13448;69;626375127;13448;229;14433;14541;5.81;0.35;302.14;12.16;985;72;5033.00;108
13453;69;626375140;13453;226;14434;14541;5.77;0.35;302.16;12.18;981;72;5034.00;107
13457;69;626375153;13457;221;14435;14541;5.77;0.35;302.22;12.20;978;72;5035.00;106
13461;69;626375165;13461;217;14435;14541;5.82;0.36;302.27;12.20;974;72;5036.00;106
13466;69;626375177;13466;211;14435;14541;5.81;0.35;302.31;12.20;969;72;5037.00;106
13470;69;626375189;13470;209;14435;14541;5.85;0.36;302.33;12.20;965;72;5038.00;106
13474;69;626375201;13474;210;14435;14541;5.90;0.36;302.33;12.20;961;72;5039.00;106
13476;69;626375215;13476;238;14535;14771;6.22;0.39;302.30;12.11;1059;72;5040.00;236
13477;69;626375247;13477;232;14537;14772;6.20;0.39;302.36;12.11;1060;72;5041.00;235
13481;69;626375260;13481;217;14545;14772;6.30;0.39;302.37;12.10;1064;72;5042.00;227
13483;69;626375274;13483;217;14550;14772;6.37;0.40;302.36;12.16;1067;72;5043.00;222
13484;69;626375287;13484;217;14556;14772;6.41;0.40;302.34;12.16;1072;72;5044.00;216
13486;70;626375299;13486;214;14562;14772;6.43;0.40;302.43;12.16;1076;73;5045.00;210
13490;70;626375331;13490;215;14570;14772;6.46;0.40;302.37;12.22;1080;73;5046.00;202
13491;70;626375345;13491;225;14578;14772;6.49;0.40;302.35;12.22;1087;73;5047.00;194
13496;70;626375359;13496;222;14584;14773;6.48;0.40;302.29;12.22;1088;73;5048.00;189
13498;70;626375373;13498;234;14590;14774;6.50;0.40;302.27;12.28;1092;73;5049.00;184
13499;70;626375386;13499;241;14596;14774;6.48;0.40;302.25;12.27;1097;73;5050.00;178
13500;70;626375399;13500;244;14599;14775;6.42;0.40;302.25;12.27;1099;73;5051.00;176
13500;70;626375420;13500;263;14604;14775;6.41;0.40;302.25;12.33;1104;73;5052.00;171
13502;70;626375434;13502;260;14606;14775;6.35;0.39;302.23;12.33;1104;73;5053.00;169
13503;70;626375447;13503;256;14611;14775;6.34;0.39;302.22;12.33;1108;73;5054.00;164
13505;70;626375462;13505;268;14614;14779;6.36;0.39;302.19;12.33;1109;73;5055.00;165
13505;70;626375476;13505;271;14617;14779;6.35;0.39;302.19;12.33;1112;73;5056.00;162
13507;70;626375490;13507;277;14621;14779;6.32;0.39;302.16;12.34;1114;73;5057.00;158
13510;70;626375505;13510;282;14624;14782;6.31;0.39;302.13;12.34;1114;73;5058.00;158
13511;70;626375520;13511;292;14626;14782;6.31;0.39;302.11;12.36;1115;73;5059.00;156
13511;70;626375534;13511;288;14630;14782;6.31;0.39;302.11;12.37;1119;73;5060.00;152
13511;70;626375548;13511;292;14635;14786;6.34;0.39;302.11;12.38;1124;73;5061.00;151
13514;70;626375563;13514;296;14638;14787;6.35;0.39;302.08;12.38;1124;73;5062.00;149
13516;70;626375577;13516;304;14641;14787;6.37;0.39;302.07;12.39;1125;73;5063.00;146
13518;70;626375592;13518;305;14644;14791;6.34;0.39;302.05;12.39;1126;73;5064.00;147
13518;70;626375607;13518;314;14647;14791;6.30;0.39;302.05;12.41;1129;73;5065.00;144
13520;70;626375645;13520;325;14651;14791;6.25;0.38;302.06;12.42;1131;73;5066.00;140
13522;70;626375664;13522;332;14654;14792;6.23;0.38;302.13;12.43;1132;73;5067.00;138
13526;70;626375688;13526;332;14657;14792;6.14;0.38;302.08;12.44;1131;73;5068.00;135
13527;70;626375702;13527;345;14661;14798;6.11;0.37;302.07;12.45;1134;73;5069.00;137
13529;70;626375720;13529;361;14665;14798;6.03;0.37;302.06;12.47;1136;73;5070.00;133
13532;70;626375734;13532;359;14667;14799;5.95;0.37;302.01;12.47;1135;73;5071.00;132
13534;70;626375748;13534;366;14670;14799;5.86;0.36;302.00;12.48;1136;73;5072.00;129
13536;70;626375763;13536;381;14671;14799;5.78;0.35;301.97;12.49;1135;73;5073.00;128
13539;70;626375776;13539;391;14673;14799;5.68;0.35;301.95;12.50;1134;73;5074.00;126
13539;70;626375790;13539;393;14676;14799;5.65;0.35;301.95;12.52;1137;73;5075.00;123
13543;70;626375802;13543;400;14689;14811;5.63;0.34;301.90;12.51;1146;73;5076.00;122
13544;70;626375818;13544;404;14692;14811;5.53;0.34;301.88;12.53;1148;73;5077.00;119
13545;70;626375831;13545;412;14694;14811;5.47;0.33;301.88;12.53;1149;73;5078.00;117
13546;70;626375844;13546;412;14695;14811;5.48;0.34;301.87;12.53;1149;73;5079.00;116
13549;70;626375857;13549;417;14697;14811;5.43;0.33;301.86;12.55;1148;73;5080.00;114
13549;70;626375871;13549;415;14697;14811;5.43;0.33;301.86;12.55;1148;73;5081.00;114
13549;70;626375886;13549;413;14702;14815;5.41;0.33;301.86;12.56;1153;73;5082.00;113
13551;70;626375900;13551;401;14702;14815;5.40;0.33;301.85;12.56;1151;73;5083.00;113
13551;70;626375913;13551;390;14705;14819;5.47;0.33;301.85;12.56;1154;73;5084.00;114
13551;70;626375929;13551;385;14709;14821;5.50;0.34;301.85;12.57;1158;73;5085.00;112
13552;70;626375942;13552;389;14710;14821;5.51;0.34;301.83;12.57;1158;73;5086.00;111
13553;70;626375955;13553;382;14711;14821;5.57;0.34;301.82;12.59;1158;73;5087.00;110
13553;70;626375969;13553;382;14723;14834;5.65;0.34;301.82;12.58;1170;73;5088.00;111
13554;70;626375983;13554;383;14724;14834;5.71;0.35;301.80;12.59;1170;73;5089.00;110
13556;70;626376002;13556;377;14724;14834;5.73;0.35;301.81;12.59;1168;73;5090.00;110
13556;70;626376015;13556;384;14725;14835;5.78;0.35;301.81;12.59;1169;73;5091.00;110
13558;70;626376033;13558;382;14726;14836;5.78;0.35;301.79;12.61;1168;73;5092.00;110
13560;70;626376048;13560;389;14726;14836;5.76;0.35;301.77;12.61;1166;73;5093.00;110
13564;70;626376061;13564;387;14731;14839;5.75;0.35;301.72;12.65;1167;73;5094.00;108
13567;70;626376076;13567;384;14732;14839;5.75;0.35;301.69;12.65;1165;73;5095.00;107
13572;70;626376089;13572;393;14732;14839;5.71;0.35;301.67;12.65;1160;73;5096.00;107
13574;70;626376101;13574;399;14733;14839;5.66;0.35;301.65;12.66;1159;73;5097.00;106
13577;70;626376114;13577;406;14738;14845;5.58;0.34;301.65;12.66;1161;73;5098.00;107
13579;70;626376127;13579;415;14739;14845;5.49;0.34;301.65;12.67;1160;73;5099.00;106
13581;70;626376142;13581;411;14744;14864;5.43;0.33;301.65;12.67;1163;73;5100.00;120
13583;70;626376162;13583;400;14746;14864;5.38;0.33;301.66;12.69;1163;73;5101.00;118
13586;70;626376176;13586;408;14750;14868;5.39;0.33;301.64;12.69;1164;73;5102.00;118
13588;70;626376189;13588;407;14751;14869;5.37;0.33;301.67;12.69;1163;73;5103.00;118
13593;70;626376203;13593;406;14753;14869;5.33;0.33;301.82;12.72;1160;73;5104.00;116
13594;70;626376223;13594;406;14756;14870;5.37;0.33;301.82;12.71;1162;73;5105.00;114
13597;70;626376242;13597;410;14758;14870;5.39;0.33;301.86;12.74;1161;73;5106.00;112
13600;70;626376256;13600;408;14758;14870;5.43;0.33;301.88;12.74;1158;73;5107.00;112
13603;70;626376269;13603;401;14759;14870;5.50;0.34;301.97;12.74;1156;73;5108.00;111
13606;70;626376287;13606;399;14759;14870;5.59;0.34;302.04;12.74;1153;73;5109.00;111
13608;70;626376301;13608;394;14760;14870;5.66;0.35;302.06;12.74;1152;73;5110.00;110
13612;70;626376313;13612;391;14760;14870;5.73;0.35;302.05;12.74;1148;73;5111.00;110
13614;70;626376326;13614;388;14792;14940;5.90;0.36;302.10;12.71;1178;73;5112.00;148
13620;70;626376345;13620;380;14794;14941;5.97;0.37;302.10;12.71;1174;73;5113.00;147
13622;70;626376359;13622;381;14803;14941;6.12;0.38;302.07;12.70;1181;73;5114.00;138
13630;70;626376373;13630;376;14806;14941;6.17;0.38;302.16;12.70;1176;73;5115.00;135
13637;70;626376387;13637;373;14810;14941;6.24;0.38;302.11;12.70;1173;73;5116.00;131
13642;70;626376400;13642;372;14813;14941;6.28;0.38;302.19;12.70;1171;73;5117.00;128
13647;70;626376420;13647;371;14815;14941;6.26;0.38;302.20;12.70;1168;73;5118.00;126
13650;70;626376433;13650;368;14816;14941;6.21;0.38;302.29;12.70;1166;73;5119.00;125
13653;70;626376448;13653;369;14818;14942;6.17;0.38;302.33;12.70;1165;73;5120.00;124
13656;70;626376462;13656;367;14820;14943;6.21;0.38;302.36;12.70;1164;73;5121.00;123
13659;70;626376477;13659;385;14823;14943;6.22;0.38;302.43;12.70;1164;73;5122.00;120
13665;70;626376491;13665;387;14828;14947;6.23;0.38;302.40;12.69;1163;73;5123.00;119
13668;70;626376506;13668;392;14828;14947;6.25;0.38;302.44;12.69;1160;73;5124.00;119
13675;70;626376521;13675;389;14828;14947;6.24;0.38;302.51;12.69;1153;73;5125.00;119
13680;70;626376535;13680;394;14829;14947;6.24;0.38;302.55;12.69;1149;73;5126.00;118
13684;70;626376550;13684;400;14833;14953;6.21;0.38;302.55;12.69;1149;73;5127.00;120
13688;70;626376565;13688;398;14833;14953;6.22;0.38;302.54;12.69;1145;73;5128.00;120
13694;70;626376579;13694;402;14833;14953;6.24;0.38;302.57;12.69;1139;73;5129.00;120
13698;70;626376595;13698;403;14836;14959;6.26;0.38;302.61;12.69;1138;73;5130.00;123
13703;70;626376611;13703;408;14836;14959;6.27;0.38;302.71;12.69;1133;73;5131.00;123
13707;70;626376625;13707;413;14837;14959;6.31;0.38;302.68;12.69;1130;73;5132.00;122
13711;70;626376640;13711;408;14838;14960;6.32;0.38;302.69;12.69;1127;73;5133.00;122
13717;70;626376661;13717;410;14839;14961;6.31;0.38;302.74;12.69;1122;73;5134.00;122
13719;70;626376678;13719;409;14841;14961;6.33;0.38;302.74;12.69;1122;73;5135.00;120
13728;70;626376692;13728;416;14850;14974;6.27;0.38;302.79;12.69;1122;73;5136.00;124
13732;70;626376708;13732;426;14851;14974;6.26;0.38;302.80;12.69;1119;73;5137.00;123
13735;70;626376722;13735;428;14851;14974;6.31;0.38;302.85;12.69;1116;73;5138.00;123
13741;70;626376737;13741;430;14854;14975;6.34;0.39;302.91;12.69;1113;73;5139.00;121
13744;70;626376751;13744;432;14855;14975;6.38;0.39;302.97;12.69;1111;73;5140.00;120
13746;70;626376766;13746;432;14859;14979;6.40;0.39;303.02;12.69;1113;73;5141.00;120
13751;70;626376780;13751;443;14859;14979;6.35;0.39;303.17;12.69;1108;73;5142.00;120
13754;70;626376794;13754;444;14863;14983;6.32;0.39;303.16;12.69;1109;73;5143.00;120
13757;70;626376809;13757;446;14863;14983;6.29;0.38;303.23;12.69;1106;73;5144.00;120
13759;70;626376823;13759;446;14864;14983;6.29;0.38;303.20;12.69;1105;73;5145.00;119
13762;70;626376837;13762;451;14864;14983;6.31;0.38;303.22;12.69;1102;73;5146.00;119
13768;70;626376851;13768;439;14866;14983;6.28;0.38;303.28;12.69;1098;73;5147.00;117
13770;70;626376865;13770;439;14878;14995;6.32;0.38;303.32;12.68;1108;73;5148.00;117
13776;70;626376884;13776;436;14878;14995;6.30;0.38;303.40;12.68;1102;73;5149.00;117
13778;70;626376907;13778;430;14879;14995;6.33;0.39;303.51;12.68;1101;73;5150.00;116
13780;70;626376931;13780;429;14880;14995;6.37;0.39;303.51;12.68;1100;73;5151.00;115
13786;70;626376953;13786;424;14880;14995;6.34;0.39;303.55;12.68;1094;73;5152.00;115
13788;70;626376975;13788;426;14882;14995;6.31;0.38;303.53;12.68;1094;73;5153.00;113
13793;70;626376995;13793;425;14882;14996;6.28;0.38;303.61;12.68;1089;73;5154.00;114
13798;70;626377013;13798;428;14884;14998;6.26;0.38;303.68;12.74;1086;73;5155.00;114
13800;70;626377029;13800;425;14887;15004;6.26;0.38;303.71;12.74;1087;73;5156.00;117
13802;70;626377053;13802;417;14888;15005;6.31;0.38;303.71;12.74;1086;73;5157.00;117
13806;70;626377070;13806;417;14889;15005;6.29;0.38;303.78;12.74;1083;73;5158.00;116
13807;70;626377085;13807;400;14889;15005;6.33;0.39;303.77;12.74;1082;73;5159.00;116
13813;70;626377103;13813;393;14895;15010;6.32;0.38;303.79;12.73;1082;73;5160.00;115
13815;70;626377120;13815;390;14895;15010;6.36;0.39;303.84;12.73;1080;73;5161.00;115
13816;70;626377135;13816;383;14895;15010;6.38;0.39;303.84;12.73;1079;73;5162.00;115
13817;70;626377150;13817;379;14896;15011;6.44;0.39;303.84;12.73;1079;73;5163.00;115
13820;70;626377164;13820;381;14899;15015;6.45;0.39;303.87;12.73;1079;73;5164.00;116
13821;70;626377181;13821;384;14899;15015;6.45;0.39;303.88;12.73;1078;73;5165.00;116
13823;70;626377196;13823;384;14901;15018;6.49;0.39;303.92;12.73;1078;73;5166.00;117
13826;70;626377211;13826;379;14901;15018;6.47;0.39;303.97;12.73;1075;73;5167.00;117
13827;70;626377226;13827;366;14902;15018;6.47;0.39;304.03;12.73;1075;73;5168.00;116
13829;70;626377241;13829;366;14902;15018;6.49;0.40;304.12;12.73;1073;73;5169.00;116
13831;70;626377255;13831;360;14905;15022;6.53;0.40;304.10;12.72;1074;73;5170.00;117
13835;70;626377272;13835;360;14905;15022;6.50;0.40;304.13;12.72;1070;73;5171.00;117
13839;70;626377285;13839;355;14906;15022;6.50;0.40;304.16;12.72;1067;73;5172.00;116
13841;70;626377299;13841;352;14906;15022;6.46;0.39;304.15;12.72;1065;73;5173.00;116
13844;70;626377313;13844;349;14906;15023;6.45;0.39;304.22;12.72;1062;73;5174.00;117
13848;70;626377328;13848;348;14908;15025;6.40;0.39;304.24;12.72;1060;73;5175.00;117
13850;70;626377343;13850;347;14908;15025;6.31;0.38;304.26;12.72;1058;73;5176.00;117
13854;70;626377357;13854;348;14909;15026;6.26;0.38;304.27;12.72;1055;73;5177.00;117
13857;70;626377373;13857;343;14909;15026;6.21;0.38;304.29;12.72;1052;73;5178.00;117
13858;70;626377389;13858;346;14909;15026;6.20;0.38;304.32;12.72;1051;73;5179.00;117
13860;70;626377402;13860;344;14909;15026;6.15;0.38;304.31;12.72;1049;73;5180.00;117
13861;70;626377425;13861;343;14909;15026;6.10;0.37;304.33;12.72;1048;73;5181.00;117
13863;70;626377441;13863;344;14909;15026;6.04;0.37;304.31;12.72;1046;73;5182.00;117
13864;70;626377454;13864;350;14909;15026;6.05;0.37;304.39;12.72;1045;73;5183.00;117
13865;70;626377467;13865;385;14983;15153;6.08;0.38;304.38;12.66;1118;73;5184.00;170
13865;70;626377491;13865;375;14983;15154;6.07;0.38;304.38;12.66;1118;73;5185.00;171
13866;70;626377505;13866;373;14988;15154;6.10;0.38;304.37;12.65;1122;73;5186.00;166
13867;70;626377527;13867;377;14992;15154;6.16;0.38;304.36;12.65;1125;73;5187.00;162
13870;70;626377543;13870;375;14994;15154;6.13;0.38;304.34;12.65;1124;73;5188.00;160
13872;70;626377558;13872;391;14996;15154;6.12;0.38;304.33;12.65;1124;73;5189.00;158
13874;70;626377574;13874;385;14999;15154;6.14;0.38;304.36;12.65;1125;73;5190.00;155
13877;70;626377588;13877;393;15004;15154;6.18;0.38;304.35;12.70;1127;73;5191.00;150
13877;70;626377602;13877;393;15005;15155;6.19;0.38;304.35;12.70;1128;73;5192.00;150
13877;70;626377616;13877;399;15008;15156;6.18;0.38;304.35;12.70;1131;73;5193.00;148
13881;70;626377637;13881;394;15011;15156;6.13;0.38;304.34;12.70;1130;73;5194.00;145
13888;70;626377651;13888;399;15014;15157;6.02;0.37;304.36;12.70;1126;73;5195.00;143
13888;70;626377665;13888;395;15016;15157;5.96;0.37;304.36;12.70;1128;73;5196.00;141
13890;70;626377678;13890;388;15020;15157;5.90;0.36;304.34;12.70;1130;73;5197.00;137
13892;70;626377692;13892;388;15022;15157;5.82;0.36;304.35;12.70;1130;73;5198.00;135
13894;70;626377705;13894;394;15025;15161;5.77;0.35;304.35;12.70;1131;73;5199.00;136
13897;70;626377720;13897;385;15026;15161;5.68;0.35;304.31;12.70;1129;73;5200.00;135
13898;70;626377738;13898;390;15027;15161;5.60;0.34;304.32;12.70;1129;73;5201.00;134
13899;70;626377750;13899;379;15030;15164;5.56;0.34;304.31;12.70;1131;73;5202.00;134
13901;70;626377765;13901;367;15031;15164;5.50;0.34;304.29;12.70;1130;73;5203.00;133
13904;70;626377778;13904;367;15032;15164;5.49;0.34;304.25;12.70;1128;73;5204.00;132
13907;70;626377792;13907;365;15038;15168;5.44;0.34;304.22;12.73;1131;73;5205.00;130
13910;70;626377806;13910;360;15039;15169;5.44;0.34;304.24;12.73;1129;73;5206.00;130
13915;70;626377820;13915;354;15040;15169;5.36;0.33;304.23;12.73;1125;73;5207.00;129
13919;70;626377833;13919;350;15042;15173;5.34;0.33;304.23;12.73;1123;73;5208.00;131
13921;70;626377847;13921;349;15042;15173;5.32;0.33;304.21;12.73;1121;73;5209.00;131
13923;70;626377860;13923;356;15042;15173;5.31;0.33;304.28;12.73;1119;73;5210.00;131
13924;70;626377873;13924;356;15043;15174;5.32;0.33;304.27;12.73;1119;73;5211.00;131
13925;70;626377888;13925;358;15045;15174;5.31;0.33;304.26;12.80;1120;73;5212.00;129
13927;70;626377902;13927;364;15048;15180;5.35;0.33;304.23;12.79;1121;73;5213.00;132
13928;70;626377915;13928;364;15049;15180;5.35;0.33;304.21;12.85;1121;73;5214.00;131
13930;70;626377929;13930;371;15050;15180;5.38;0.33;304.17;12.85;1120;73;5215.00;130
13932;70;626377942;13932;372;15051;15181;5.34;0.33;304.14;12.85;1119;73;5216.00;130
13937;70;626377954;13937;377;15053;15181;5.30;0.32;304.06;12.91;1116;73;5217.00;128
13938;70;626377966;13938;383;15053;15181;5.28;0.32;304.06;12.91;1115;73;5218.00;128
13945;70;626377979;13945;380;15054;15181;5.23;0.32;303.98;12.91;1109;73;5219.00;127
13945;70;626377993;13945;390;15075;15217;5.29;0.33;303.98;12.89;1130;73;5220.00;142
13949;70;626378007;13949;386;15075;15217;5.25;0.32;303.94;12.89;1126;73;5221.00;142
13950;70;626378020;13950;381;15078;15217;5.25;0.32;303.93;12.89;1128;73;5222.00;139
13952;70;626378032;13952;387;15078;15217;5.25;0.32;303.95;12.89;1126;73;5223.00;139
13954;70;626378044;13954;390;15080;15217;5.27;0.32;303.93;12.89;1126;73;5224.00;137
13955;70;626378056;13955;396;15081;15217;5.28;0.32;303.91;12.89;1126;73;5225.00;136
13956;70;626378069;13956;398;15085;15221;5.34;0.33;303.93;12.89;1129;73;5226.00;136
13957;70;626378081;13957;403;15086;15221;5.36;0.33;303.92;12.89;1129;73;5227.00;135
13958;70;626378093;13958;395;15089;15225;5.40;0.33;303.91;12.89;1131;73;5228.00;136
13959;70;626378107;13959;395;15090;15226;5.46;0.33;303.91;12.88;1131;73;5229.00;136
13960;70;626378119;13960;399;15093;15226;5.49;0.34;303.91;12.90;1133;73;5230.00;133
13960;70;626378132;13960;403;15095;15226;5.51;0.34;303.91;12.90;1135;73;5231.00;131
13964;70;626378145;13964;412;15105;15239;5.45;0.33;303.89;12.91;1141;73;5232.00;134
13965;70;626378159;13965;409;15107;15239;5.45;0.33;303.98;12.93;1142;73;5233.00;132
13966;70;626378172;13966;411;15107;15239;5.44;0.33;303.97;12.93;1141;73;5234.00;132
13968;70;626378190;13968;397;15110;15240;5.47;0.33;303.97;12.97;1142;73;5235.00;130
13969;70;626378203;13969;397;15111;15241;5.51;0.34;303.96;12.96;1142;73;5236.00;130
13971;70;626378217;13971;395;15112;15241;5.54;0.34;303.93;12.98;1141;73;5237.00;129
13972;70;626378241;13972;390;15116;15244;5.60;0.34;303.94;13.00;1144;73;5238.00;128
13973;70;626378254;13973;389;15116;15244;5.63;0.34;303.93;13.00;1143;73;5239.00;128
13974;70;626378268;13974;390;15118;15244;5.65;0.34;303.94;13.02;1144;73;5240.00;126
13975;70;626378281;13975;382;15118;15244;5.64;0.34;303.98;13.02;1143;73;5241.00;126
13977;70;626378301;13977;388;15125;15250;5.69;0.34;303.97;13.05;1148;73;5242.00;125
13977;70;626378315;13977;386;15126;15250;5.67;0.34;303.97;13.05;1149;73;5243.00;124
13979;70;626378328;13979;392;15127;15250;5.64;0.34;303.95;13.06;1148;73;5244.00;123
13980;70;626378342;13980;393;15130;15250;5.57;0.34;303.96;13.09;1150;73;5245.00;120
13981;70;626378354;13981;399;15133;15254;5.53;0.34;303.94;13.09;1152;73;5246.00;121
13983;70;626378368;13983;398;15134;15255;5.49;0.33;303.93;13.09;1151;73;5247.00;121
13983;70;626378381;13983;391;15136;15255;5.48;0.33;303.93;13.11;1153;73;5248.00;119
13984;70;626378394;13984;382;15138;15256;5.46;0.33;303.91;13.11;1154;73;5249.00;118
13985;70;626378409;13985;378;15139;15256;5.46;0.33;303.90;13.13;1154;73;5250.00;117
13987;70;626378421;13987;378;15140;15256;5.46;0.33;303.88;13.13;1153;73;5251.00;116
13989;70;626378440;13989;380;15141;15256;5.51;0.33;303.88;13.14;1152;73;5252.00;115
13989;71;626378452;13989;381;15142;15256;5.58;0.34;303.88;13.15;1153;74;5253.00;114
13991;71;626378477;13991;370;15143;15256;5.62;0.34;303.87;13.16;1152;74;5254.00;113
13991;71;626378489;13991;372;15143;15256;5.66;0.34;303.87;13.16;1152;74;5255.00;113
13992;71;626378507;13992;381;15179;15326;5.86;0.36;303.86;13.13;1187;74;5256.00;147
13993;71;626378529;13993;378;15180;15327;5.90;0.36;303.86;13.15;1187;74;5257.00;147
13995;71;626378543;13995;379;15190;15327;5.96;0.36;303.88;13.14;1195;74;5258.00;137
13996;71;626378556;13996;374;15199;15327;5.95;0.36;303.93;13.15;1203;74;5259.00;128
13998;71;626378569;13998;382;15204;15327;5.90;0.36;303.91;13.15;1206;74;5260.00;123
13999;71;626378582;13999;379;15205;15327;5.85;0.36;303.93;13.15;1206;74;5261.00;122
14003;71;626378594;14003;390;15210;15327;5.80;0.35;303.97;13.16;1207;74;5262.00;117
14005;71;626378607;14005;388;15214;15327;5.77;0.35;303.99;13.16;1209;74;5263.00;113
14009;71;626378619;14009;392;15217;15328;5.73;0.35;304.02;13.17;1208;74;5264.00;111
14013;71;626378632;14013;393;15221;15330;5.64;0.34;304.05;13.17;1208;74;5265.00;109
14014;71;626378647;14014;400;15221;15330;5.60;0.34;304.11;13.17;1207;74;5266.00;109
14022;71;626378659;14022;406;15225;15334;5.48;0.33;304.13;13.18;1203;74;5267.00;109
14027;71;626378672;14027;405;15225;15334;5.41;0.33;304.14;13.18;1198;74;5268.00;109
14031;71;626378686;14031;410;15225;15334;5.37;0.33;304.12;13.18;1194;74;5269.00;109
14037;71;626378699;14037;403;15226;15334;5.34;0.33;304.13;13.20;1189;74;5270.00;108
14042;71;626378712;14042;404;15233;15340;5.35;0.33;304.17;13.22;1191;74;5271.00;107
14043;71;626378726;14043;411;15234;15340;5.41;0.33;304.18;13.23;1191;74;5272.00;106
14048;71;626378740;14048;404;15234;15340;5.45;0.33;304.18;13.23;1186;74;5273.00;106
14051;71;626378753;14051;404;15237;15343;5.50;0.33;304.22;13.24;1186;74;5274.00;106
14055;71;626378766;14055;413;15237;15343;5.52;0.34;304.21;13.24;1182;74;5275.00;106
14060;71;626378780;14060;415;15237;15343;5.49;0.33;304.27;13.24;1177;74;5276.00;106
14061;71;626378793;14061;404;15240;15344;5.55;0.34;304.29;13.26;1179;74;5277.00;104
14064;71;626378807;14064;389;15241;15345;5.66;0.34;304.35;13.26;1177;74;5278.00;104
14070;71;626378821;14070;381;15241;15345;5.69;0.35;304.38;13.26;1171;74;5279.00;104
14073;71;626378838;14073;380;15260;15371;5.74;0.35;304.44;13.24;1187;74;5280.00;111
14078;71;626378853;14078;375;15261;15371;5.79;0.35;304.49;13.24;1183;74;5281.00;110
14080;71;626378868;14080;373;15264;15371;5.85;0.36;304.54;13.30;1184;74;5282.00;107
14085;71;626378885;14085;364;15265;15372;5.87;0.36;304.64;13.30;1180;74;5283.00;107
14087;71;626378919;14087;362;15265;15372;5.96;0.36;304.65;13.30;1178;74;5284.00;107
14092;71;626378942;14092;356;15268;15376;6.03;0.37;304.71;13.30;1176;74;5285.00;108
14096;71;626378964;14096;356;15268;15376;6.08;0.37;304.79;13.30;1172;74;5286.00;108
14101;71;626378987;14101;350;15272;15379;6.10;0.37;304.85;13.29;1171;74;5287.00;107
14104;71;626379007;14104;350;15272;15380;6.13;0.37;304.91;13.29;1168;74;5288.00;108
14108;71;626379024;14108;353;15272;15380;6.14;0.37;304.89;13.29;1164;74;5289.00;108
14111;71;626379039;14111;351;15272;15380;6.11;0.37;304.95;13.29;1161;74;5290.00;108
14120;71;626379055;14120;354;15272;15380;6.01;0.36;304.99;13.29;1152;74;5291.00;108
14121;71;626379072;14121;356;15282;15392;6.09;0.37;304.98;13.28;1161;74;5292.00;110
14126;71;626379089;14126;361;15282;15392;6.10;0.37;305.04;13.28;1156;74;5293.00;110
14130;71;626379118;14130;365;15283;15392;6.11;0.37;305.11;13.28;1153;74;5294.00;109
14135;71;626379134;14135;367;15283;15392;6.12;0.37;305.09;13.28;1148;74;5295.00;109
14139;71;626379150;14139;373;15283;15392;6.10;0.37;305.16;13.28;1144;74;5296.00;109
14143;71;626379166;14143;375;15283;15392;6.05;0.37;305.20;13.28;1140;74;5297.00;109
14148;71;626379182;14148;381;15283;15393;6.01;0.37;305.18;13.28;1135;74;5298.00;110
14152;71;626379197;14152;387;15283;15393;6.02;0.37;305.26;13.28;1131;74;5299.00;110
14155;71;626379213;14155;386;15287;15399;6.05;0.37;305.31;13.28;1132;74;5300.00;112
14160;71;626379232;14160;392;15289;15400;6.03;0.37;305.38;13.28;1129;74;5301.00;111
14163;71;626379249;14163;398;15289;15400;6.08;0.37;305.39;13.28;1126;74;5302.00;111
14167;71;626379265;14167;397;15289;15400;6.09;0.37;305.40;13.28;1122;74;5303.00;111
14171;71;626379286;14171;403;15292;15404;6.08;0.37;305.46;13.28;1121;74;5304.00;112
14173;71;626379302;14173;402;15292;15404;6.10;0.37;305.48;13.28;1119;74;5305.00;112
14175;71;626379316;14175;398;15293;15404;6.13;0.38;305.49;13.34;1118;74;5306.00;111
14177;71;626379331;14177;408;15294;15405;6.18;0.38;305.52;13.34;1117;74;5307.00;111
14178;71;626379346;14178;408;15297;15409;6.23;0.38;305.52;13.34;1119;74;5308.00;112
14182;71;626379361;14182;414;15297;15409;6.20;0.38;305.56;13.34;1115;74;5309.00;112
14189;71;626379378;14189;423;15300;15415;6.20;0.38;305.59;13.33;1111;74;5310.00;115
14192;71;626379394;14192;426;15301;15415;6.15;0.38;305.64;13.33;1109;74;5311.00;114
14197;71;626379408;14197;430;15302;15415;6.17;0.37;305.63;13.33;1105;74;5312.00;113
14200;71;626379425;14200;434;15302;15415;6.14;0.37;305.70;13.33;1102;74;5313.00;113
14203;71;626379447;14203;433;15305;15419;6.10;0.37;305.67;13.33;1102;74;5314.00;114
14207;71;626379470;14207;440;15305;15419;6.07;0.37;305.71;13.33;1098;74;5315.00;114
14212;71;626379484;14212;450;15306;15419;6.02;0.36;305.73;13.33;1094;74;5316.00;113
14214;71;626379499;14214;444;15306;15419;6.00;0.36;305.77;13.33;1092;74;5317.00;113
14219;71;626379514;14219;442;15307;15420;5.93;0.36;305.90;13.33;1088;74;5318.00;113
14220;71;626379529;14220;441;15308;15421;5.93;0.36;305.89;13.33;1088;74;5319.00;113
14223;71;626379545;14223;438;15308;15421;5.91;0.36;305.93;13.33;1085;74;5320.00;113
14226;71;626379559;14226;443;15309;15422;5.89;0.36;306.05;13.33;1083;74;5321.00;113
14228;71;626379574;14228;443;15309;15422;5.85;0.36;306.05;13.33;1081;74;5322.00;113
14234;71;626379588;14234;442;15309;15422;5.81;0.35;306.14;13.33;1075;74;5323.00;113
14237;71;626379604;14237;442;15309;15422;5.78;0.35;306.19;13.33;1072;74;5324.00;113
14239;71;626379619;14239;440;15309;15422;5.77;0.35;306.24;13.33;1070;74;5325.00;113
14244;71;626379632;14244;431;15309;15422;5.76;0.35;306.25;13.33;1065;74;5326.00;113
14248;71;626379647;14248;424;15309;15422;5.74;0.35;306.30;13.33;1061;74;5327.00;113
14252;71;626379662;14252;449;15377;15549;5.83;0.36;306.30;13.27;1125;74;5328.00;172
14252;71;626379688;14252;430;15379;15550;5.88;0.36;306.30;13.27;1127;74;5329.00;171
14255;71;626379702;14255;406;15386;15550;5.99;0.37;306.32;13.26;1131;74;5330.00;164
14257;71;626379718;14257;406;15390;15550;6.04;0.37;306.32;13.26;1133;74;5331.00;160
14260;71;626379733;14260;404;15393;15550;6.10;0.38;306.36;13.26;1133;74;5332.00;157
14262;71;626379747;14262;399;15397;15550;6.20;0.38;306.36;13.25;1135;74;5333.00;153
14266;71;626379769;14266;393;15401;15550;6.23;0.38;306.34;13.25;1135;74;5334.00;149
14268;71;626379784;14268;386;15403;15550;6.26;0.39;306.38;13.25;1135;74;5335.00;147
14272;71;626379798;14272;395;15409;15551;6.26;0.39;306.42;13.25;1137;74;5336.00;142
14273;71;626379814;14273;390;15412;15552;6.27;0.39;306.45;13.25;1139;74;5337.00;140
14278;71;626379829;14278;388;15415;15552;6.21;0.38;306.48;13.25;1137;74;5338.00;137
14280;71;626379844;14280;388;15419;15553;6.21;0.38;306.47;13.25;1139;74;5339.00;134
14281;71;626379861;14281;385;15420;15553;6.22;0.38;306.50;13.25;1139;74;5340.00;133
14282;71;626379877;14282;390;15422;15553;6.22;0.38;306.51;13.25;1140;74;5341.00;131
14285;71;626379895;14285;392;15423;15553;6.20;0.38;306.50;13.25;1138;74;5342.00;130
14289;71;626379910;14289;396;15427;15557;6.19;0.38;306.46;13.25;1138;74;5343.00;130
14291;71;626379925;14291;392;15428;15557;6.23;0.38;306.45;13.25;1137;74;5344.00;129
14293;71;626379941;14293;394;15430;15557;6.18;0.38;306.43;13.25;1137;74;5345.00;127
14294;71;626379955;14294;396;15432;15560;6.18;0.38;306.47;13.25;1138;74;5346.00;128
14296;71;626379969;14296;404;15434;15560;6.13;0.38;306.45;13.24;1138;74;5347.00;126
14299;71;626379983;14299;400;15435;15560;6.06;0.37;306.44;13.24;1136;74;5348.00;125
14301;71;626379997;14301;410;15439;15564;5.98;0.37;306.41;13.24;1138;74;5349.00;125
14301;71;626380011;14301;413;15440;15565;5.98;0.37;306.41;13.24;1139;74;5350.00;125
14303;71;626380024;14303;418;15440;15565;5.91;0.36;306.44;13.24;1137;74;5351.00;125
14304;71;626380038;14304;421;15443;15569;5.82;0.36;306.45;13.24;1139;74;5352.00;126
14305;71;626380051;14305;433;15443;15569;5.76;0.35;306.44;13.24;1138;74;5353.00;126
14308;71;626380064;14308;433;15443;15569;5.65;0.35;306.42;13.24;1135;74;5354.00;126
14310;71;626380077;14310;440;15445;15571;5.59;0.34;306.40;13.24;1135;74;5355.00;126
14311;71;626380090;14311;443;15445;15571;5.52;0.34;306.39;13.24;1134;74;5356.00;126
14311;71;626380103;14311;455;15449;15577;5.47;0.33;306.39;13.23;1138;74;5357.00;128
14313;71;626380116;14313;462;15449;15577;5.45;0.33;306.39;13.23;1136;74;5358.00;128
14316;71;626380129;14316;464;15450;15577;5.37;0.33;306.37;13.23;1134;74;5359.00;127
14317;71;626380141;14317;475;15450;15578;5.32;0.33;306.37;13.23;1133;74;5360.00;128
14319;71;626380154;14319;471;15450;15578;5.24;0.32;306.34;13.23;1131;74;5361.00;128
14322;71;626380167;14322;467;15450;15578;5.24;0.32;306.33;13.23;1128;74;5362.00;128
14327;71;626380180;14327;470;15450;15578;5.11;0.31;306.34;13.23;1123;74;5363.00;128
14328;71;626380192;14328;475;15459;15590;5.13;0.31;306.33;13.22;1131;74;5364.00;131
14328;71;626380206;14328;458;15459;15590;5.11;0.31;306.33;13.22;1131;74;5365.00;131
14330;71;626380218;14330;456;15461;15590;5.14;0.31;306.32;13.22;1131;74;5366.00;129
14333;71;626380229;14333;451;15461;15590;5.10;0.31;306.28;13.22;1128;74;5367.00;129
14335;71;626380241;14335;447;15461;15590;5.06;0.31;306.32;13.22;1126;74;5368.00;129
14336;71;626380254;14336;434;15461;15590;5.04;0.31;306.33;13.22;1125;74;5369.00;129
14336;71;626380267;14336;430;15465;15594;5.06;0.31;306.33;13.29;1129;74;5370.00;129
14339;71;626380279;14339;432;15465;15594;5.05;0.31;306.32;13.29;1126;74;5371.00;129
14340;71;626380291;14340;412;15468;15598;5.04;0.31;306.32;13.29;1128;74;5372.00;130
14344;71;626380303;14344;406;15469;15599;5.02;0.31;306.31;13.28;1125;74;5373.00;130
14349;72;626380314;14349;406;15471;15599;5.01;0.31;306.34;13.30;1122;75;5374.00;128
14353;72;626380338;14353;394;15471;15599;5.00;0.31;306.30;13.30;1118;75;5375.00;128
14356;72;626380350;14356;392;15483;15612;5.01;0.31;306.26;13.38;1127;75;5376.00;129
14360;72;626380364;14360;397;15483;15612;5.00;0.31;306.25;13.38;1123;75;5377.00;129
14362;72;626380376;14362;395;15484;15612;5.00;0.31;306.24;13.38;1122;75;5378.00;128
14369;72;626380387;14369;396;15485;15613;4.99;0.30;306.23;13.38;1116;75;5379.00;128
14373;72;626380399;14373;395;15485;15614;5.05;0.31;306.23;13.38;1112;75;5380.00;129
14377;72;626380412;14377;396;15486;15614;5.07;0.31;306.18;13.45;1109;75;5381.00;128
14378;72;626380424;14378;398;15488;15617;5.13;0.31;306.16;13.44;1110;75;5382.00;129
14379;72;626380436;14379;400;15490;15617;5.19;0.32;306.15;13.51;1111;75;5383.00;127
14380;72;626380448;14380;394;15491;15617;5.16;0.31;306.14;13.52;1111;75;5384.00;126
14384;72;626380460;14384;396;15492;15617;5.05;0.31;306.09;13.58;1108;75;5385.00;125
14386;72;626380473;14386;396;15496;15623;5.07;0.31;306.11;13.58;1110;75;5386.00;127
14386;72;626380485;14386;382;15496;15623;5.07;0.31;306.11;13.58;1110;75;5387.00;127
14387;72;626380497;14387;381;15497;15623;5.06;0.31;306.11;13.58;1110;75;5388.00;126
14389;72;626380509;14389;370;15498;15623;5.08;0.31;306.09;13.65;1109;75;5389.00;125
14389;72;626380521;14389;372;15501;15627;5.13;0.31;306.09;13.65;1112;75;5390.00;126
14392;72;626380534;14392;364;15504;15628;5.17;0.31;306.06;13.73;1112;75;5391.00;124
14394;72;626380547;14394;360;15504;15628;5.19;0.31;306.09;13.73;1110;75;5392.00;124
14395;72;626380565;14395;352;15506;15629;5.21;0.32;306.12;13.80;1111;75;5393.00;123
14395;72;626380578;14395;345;15506;15629;5.26;0.32;306.12;13.80;1111;75;5394.00;123
14396;72;626380590;14396;336;15506;15629;5.36;0.32;306.12;13.80;1110;75;5395.00;123
14397;72;626380603;14397;338;15507;15629;5.44;0.33;306.11;13.80;1110;75;5396.00;122
14399;72;626380617;14399;335;15507;15629;5.51;0.33;306.10;13.80;1108;75;5397.00;122
14401;72;626380629;14401;327;15507;15629;5.63;0.34;306.18;13.80;1106;75;5398.00;122
14402;72;626380648;14402;326;15507;15629;5.69;0.34;306.18;13.80;1105;75;5399.00;122
