step_arrived;step_collisions;step_duration;step_ended;step_halting;step_inserted;step_loaded;step_meanSpeed;step_meanSpeedRelative;step_meanTravelTime;step_meanWaitingTime;step_running;step_teleports;step_time;step_waiting
0;0;625353545;0;1;86;245;16.16;1.14;-1.00;0.00;86;0;0.00;159
0;0;625353573;0;1;101;245;15.17;1.05;-1.00;0.15;101;0;1.00;144
0;0;625353574;0;1;119;245;14.53;0.99;-1.00;0.43;119;0;2.00;126
0;0;625353575;0;3;133;245;13.35;0.90;-1.00;0.70;133;0;3.00;112
0;0;625353576;0;2;145;245;12.54;0.85;-1.00;0.97;145;0;4.00;100
0;0;625353577;0;6;157;245;11.49;0.77;-1.00;1.28;157;0;5.00;88
0;0;625353579;0;5;163;245;11.09;0.74;-1.00;1.45;163;0;6.00;82
0;0;625353581;0;10;171;245;10.54;0.70;-1.00;1.71;171;0;7.00;74
0;0;625353583;0;15;178;246;10.11;0.67;-1.00;1.96;178;0;8.00;68
0;0;625353585;0;16;181;247;9.81;0.65;-1.00;2.08;181;0;9.00;66
0;0;625353587;0;20;188;247;9.53;0.63;-1.00;2.37;188;0;10.00;59
0;0;625353589;0;23;194;248;9.49;0.63;-1.00;2.59;194;0;11.00;54
0;0;625353592;0;26;204;248;9.32;0.61;-1.00;3.01;204;0;12.00;44
1;0;625353594;1;32;206;248;9.27;0.61;13.00;3.11;205;0;13.00;42
1;0;625353597;1;37;211;248;9.10;0.59;13.00;3.37;210;0;14.00;37
1;0;625353602;1;40;215;252;9.02;0.58;13.00;3.46;214;0;15.00;37
1;0;625353605;1;44;217;252;8.94;0.58;13.00;3.57;216;0;16.00;35
1;0;625353615;1;49;222;252;8.76;0.56;13.00;3.87;221;0;17.00;30
1;0;625353617;1;55;223;255;8.75;0.56;13.00;3.86;222;0;18.00;32
2;0;625353628;2;57;224;255;8.75;0.56;16.00;3.92;222;0;19.00;31
3;0;625353631;3;61;225;255;8.79;0.56;17.33;4.00;222;0;20.00;30
3;0;625353634;3;65;233;259;8.85;0.56;17.33;4.24;230;0;21.00;26
5;0;625353637;5;67;235;260;8.85;0.56;19.20;4.30;230;0;22.00;25
5;0;625353640;5;72;240;260;8.66;0.54;19.20;4.69;235;0;23.00;20
6;0;625353651;6;76;245;264;8.54;0.54;19.67;4.75;239;0;24.00;19
6;0;625353654;6;78;248;264;8.49;0.53;19.67;4.92;242;0;25.00;16
6;0;625353657;6;83;248;264;8.46;0.53;19.67;4.92;242;0;26.00;16
6;0;625353660;6;85;251;265;8.47;0.53;19.67;5.08;245;0;27.00;14
6;0;625353663;6;91;254;265;8.38;0.52;19.67;5.35;248;0;28.00;11
6;0;625353666;6;91;258;271;8.44;0.52;19.67;5.28;252;0;29.00;13
6;0;625353672;6;92;259;271;8.45;0.52;19.67;5.38;253;0;30.00;12
7;0;625353675;7;97;261;272;8.40;0.52;20.86;5.46;254;0;31.00;11
7;0;625353679;7;101;262;272;8.32;0.51;20.86;5.47;255;0;32.00;10
7;0;625353682;7;104;265;272;8.30;0.51;20.86;5.68;258;0;33.00;7
10;0;625353685;10;109;265;272;8.20;0.51;23.90;5.68;255;0;34.00;7
10;0;625353688;10;112;266;272;8.27;0.51;23.90;5.72;256;0;35.00;6
10;0;625353691;10;117;277;284;8.53;0.53;23.90;5.49;267;0;36.00;7
10;0;625353695;10;118;278;284;8.45;0.52;23.90;5.50;268;0;37.00;6
11;0;625353698;11;120;278;284;8.34;0.52;25.18;5.50;267;0;38.00;6
11;0;625353702;11;122;279;284;8.22;0.51;25.18;5.52;268;0;39.00;5
11;0;625353705;11;125;279;284;8.21;0.51;25.18;5.52;268;0;40.00;5
12;0;625353708;12;127;279;284;8.11;0.50;26.08;5.52;267;0;41.00;5
13;0;625353711;13;129;284;288;8.11;0.50;27.08;5.46;271;0;42.00;4
13;0;625353715;13;133;284;288;8.04;0.50;27.08;5.46;271;0;43.00;4
13;0;625353718;13;136;287;292;8.05;0.50;27.08;5.41;274;0;44.00;5
14;0;625353722;14;136;289;294;8.03;0.50;28.21;5.38;275;0;45.00;5
15;0;625353725;15;139;290;294;7.91;0.49;28.00;5.37;275;0;46.00;4
16;0;625353728;16;141;290;294;7.89;0.49;28.56;5.37;274;0;47.00;4
17;0;625353731;17;142;301;307;8.07;0.50;29.71;5.17;284;0;48.00;6
18;0;625353736;18;141;301;307;7.94;0.49;30.72;5.17;283;0;49.00;6
19;0;625353739;19;146;302;307;7.83;0.48;31.37;5.16;283;0;50.00;5
19;0;625353742;19;148;303;308;7.75;0.48;31.37;5.15;284;0;51.00;5
19;0;625353745;19;150;304;309;7.63;0.47;31.37;5.13;285;0;52.00;5
19;0;625353748;19;151;304;309;7.56;0.47;31.37;5.13;285;0;53.00;5
20;0;625353751;20;153;306;312;7.59;0.47;32.50;5.10;286;0;54.00;6
21;0;625353754;21;154;306;312;7.42;0.46;31.86;5.10;285;0;55.00;6
22;0;625353758;22;144;307;312;7.41;0.46;31.91;5.09;285;0;56.00;5
23;0;625353761;23;139;307;312;7.45;0.46;33.00;5.09;284;0;57.00;5
23;0;625353764;23;139;311;318;7.52;0.46;33.00;5.04;288;0;58.00;7
23;0;625353768;23;143;311;318;7.55;0.46;33.00;5.04;288;0;59.00;7
25;0;625353773;25;141;313;318;7.46;0.46;35.08;5.03;288;0;60.00;5
25;0;625353776;25;145;313;318;7.45;0.46;35.08;5.03;288;0;61.00;5
26;0;625353780;26;148;317;322;7.43;0.46;35.96;4.97;291;0;62.00;5
28;0;625353784;28;152;318;323;7.55;0.47;36.39;4.96;290;0;63.00;5
28;0;625353789;28;154;318;323;7.70;0.48;36.39;4.96;290;0;64.00;5
29;0;625353793;29;154;319;324;7.84;0.48;36.24;4.95;290;0;65.00;5
31;0;625353796;31;155;319;324;7.83;0.48;38.03;4.95;288;0;66.00;5
32;0;625353800;32;144;319;324;7.89;0.48;38.94;4.95;287;0;67.00;5
32;0;625353804;32;139;319;324;7.97;0.49;38.94;4.95;287;0;68.00;5
32;0;625353807;32;134;319;324;8.04;0.49;38.94;4.95;287;0;69.00;5
33;0;625353811;33;133;319;324;8.16;0.50;39.88;4.95;286;0;70.00;5
33;0;625353815;33;129;319;324;8.29;0.51;39.88;4.95;286;0;71.00;5
33;0;625353819;33;134;354;394;8.39;0.51;39.88;4.46;321;0;72.00;40
33;0;625353830;33;124;355;395;8.50;0.52;39.88;4.45;322;0;73.00;40
33;0;625353835;33;118;362;395;8.99;0.55;39.88;4.40;329;0;74.00;33
34;0;625353839;34;112;364;395;9.25;0.57;40.91;4.39;330;0;75.00;31
35;0;625353843;35;109;369;395;9.56;0.58;41.71;4.39;334;0;76.00;26
37;0;625353855;37;108;373;395;9.66;0.59;42.89;4.39;336;0;77.00;22
37;0;625353859;37;108;378;395;9.78;0.60;42.89;4.42;341;0;78.00;17
38;0;625353877;38;106;378;395;9.77;0.59;43.39;4.42;340;0;79.00;17
39;0;625353882;39;109;380;396;9.77;0.59;44.33;4.42;341;0;80.00;16
39;0;625353886;39;110;381;397;9.85;0.60;44.33;4.40;342;0;81.00;16
39;0;625353891;39;113;382;397;9.91;0.60;44.33;4.42;343;0;82.00;15
39;0;625353895;39;116;386;401;9.77;0.60;44.33;4.38;347;0;83.00;15
39;0;625353900;39;116;386;401;9.74;0.59;44.33;4.38;347;0;84.00;15
39;1;625353904;39;121;386;401;9.61;0.59;44.33;4.38;347;1;85.00;15
40;1;625353917;40;125;386;401;9.47;0.58;45.38;4.38;346;1;86.00;15
40;1;625353922;40;126;390;407;9.33;0.57;45.38;4.35;350;1;87.00;17
42;1;625353933;42;130;390;407;9.12;0.56;47.17;4.35;348;1;88.00;17
43;1;625353937;43;131;391;407;8.98;0.55;48.02;4.35;348;1;89.00;16
46;1;625353942;46;134;394;413;8.95;0.54;49.20;4.31;348;1;90.00;19
46;1;625353947;46;136;395;413;8.88;0.54;49.20;4.30;349;1;91.00;18
48;1;625353961;48;134;395;413;8.73;0.53;50.98;4.30;347;1;92.00;18
49;1;625353965;49;134;397;414;8.73;0.53;51.84;4.29;348;1;93.00;17
49;1;625353971;49;135;398;415;8.83;0.54;51.84;4.28;349;1;94.00;17
50;1;625353975;50;135;399;415;8.81;0.54;52.68;4.29;349;1;95.00;16
52;1;625353979;52;137;409;428;8.59;0.52;54.35;4.18;357;1;96.00;19
53;1;625353984;53;137;410;428;8.63;0.52;55.15;4.17;357;1;97.00;18
56;1;625353988;56;138;410;428;8.63;0.52;57.30;4.17;354;1;98.00;18
58;1;625353992;58;137;411;429;8.74;0.53;58.74;4.16;353;1;99.00;18
59;1;625353999;59;136;411;429;8.91;0.54;59.44;4.16;352;1;100.00;18
61;1;625354010;61;135;413;433;8.96;0.54;60.75;4.15;352;1;101.00;20
62;1;625354016;62;129;413;433;8.98;0.54;61.08;4.15;351;1;102.00;20
62;1;625354020;62;123;418;437;9.01;0.55;61.08;4.11;356;1;103.00;19
62;1;625354025;62;120;418;437;9.16;0.56;61.08;4.11;356;1;104.00;19
65;1;625354029;65;114;418;437;9.26;0.56;62.97;4.11;353;1;105.00;19
66;1;625354035;66;106;418;437;9.38;0.57;63.62;4.11;352;1;106.00;19
67;1;625354040;67;96;418;437;9.62;0.58;64.25;4.11;351;1;107.00;19
68;1;625354045;68;88;428;449;9.77;0.59;64.90;4.02;360;1;108.00;21
68;1;625354050;68;82;429;449;9.95;0.61;64.90;4.01;361;1;109.00;20
68;1;625354055;68;79;430;449;10.24;0.62;64.90;4.01;362;1;110.00;19
68;1;625354060;68;78;430;449;10.39;0.63;64.90;4.01;362;1;111.00;19
68;1;625354065;68;78;430;449;10.59;0.65;64.90;4.01;362;1;112.00;19
68;1;625354071;68;73;430;449;10.82;0.66;64.90;4.01;362;1;113.00;19
70;1;625354076;70;72;431;450;10.91;0.67;66.23;4.00;361;1;114.00;19
70;1;625354088;70;71;431;450;11.09;0.68;66.23;4.00;361;1;115.00;19
73;1;625354094;73;67;435;456;11.21;0.68;67.07;3.97;362;1;116.00;21
73;1;625354099;73;68;438;457;11.30;0.69;67.07;4.22;365;1;117.00;19
73;1;625354105;73;70;438;457;11.39;0.70;67.07;4.22;365;1;118.00;19
74;1;625354111;74;70;441;457;11.56;0.71;67.76;4.67;367;1;119.00;16
75;1;625354119;75;72;445;462;11.77;0.72;68.44;4.63;370;1;120.00;17
77;1;625354125;77;70;445;462;11.83;0.72;69.79;4.63;368;1;121.00;17
78;1;625354131;78;72;446;462;11.91;0.73;70.46;4.73;368;1;122.00;16
78;1;625354137;78;77;449;463;12.00;0.73;70.46;5.09;371;1;123.00;14
79;1;625354144;79;76;454;467;11.95;0.73;70.23;5.16;375;1;124.00;13
79;1;625354150;79;79;456;467;11.95;0.73;70.23;5.52;377;1;125.00;11
79;1;625354156;79;81;459;470;11.98;0.73;70.23;5.61;380;1;126.00;11
80;1;625354163;80;85;462;470;12.01;0.73;70.94;5.86;382;1;127.00;8
80;1;625354170;80;86;463;470;12.02;0.74;70.94;5.94;383;1;128.00;7
80;1;625354176;80;88;465;470;12.01;0.74;70.94;6.10;385;1;129.00;5
84;1;625354182;84;91;469;474;12.14;0.74;73.08;6.21;385;1;130.00;5
84;1;625354190;84;90;469;474;12.21;0.75;73.08;6.21;385;1;131.00;5
86;1;625354196;86;90;471;474;12.30;0.75;74.43;6.19;385;1;132.00;3
87;1;625354203;87;88;472;474;12.27;0.75;75.10;6.26;385;1;133.00;2
91;1;625354208;91;89;473;475;12.29;0.75;76.44;6.25;382;1;134.00;2
92;1;625354216;92;90;476;477;12.23;0.75;76.85;6.29;384;1;135.00;1
95;1;625354223;95;93;476;477;12.21;0.75;78.66;6.29;381;1;136.00;1
97;1;625354230;97;94;478;478;12.09;0.74;79.71;6.30;381;1;137.00;0
98;1;625354236;98;95;478;478;12.07;0.74;79.97;6.30;380;1;138.00;0
101;1;625354243;101;98;478;478;11.93;0.73;80.65;6.30;377;1;139.00;0
102;1;625354249;102;101;478;478;11.86;0.73;81.24;6.30;376;1;140.00;0
104;1;625354256;104;102;478;478;11.70;0.72;82.22;6.30;374;1;141.00;0
106;1;625354262;106;103;478;478;11.68;0.72;81.99;6.30;372;1;142.00;0
107;1;625354268;107;107;478;478;11.57;0.71;82.56;6.30;371;1;143.00;0
108;1;625354273;108;127;553;605;11.08;0.70;82.80;5.45;445;1;144.00;52
109;1;625354292;109;120;559;606;10.94;0.69;82.96;5.40;450;1;145.00;47
111;1;625354301;111;118;565;606;10.90;0.69;83.97;5.37;454;1;146.00;41
112;1;625354309;112;121;569;606;10.84;0.68;84.54;5.35;457;1;147.00;37
116;1;625354317;116;125;573;606;10.76;0.68;85.26;5.34;457;1;148.00;33
118;1;625354326;118;126;575;606;10.74;0.68;86.25;5.34;457;1;149.00;31
120;1;625354338;120;127;579;611;10.75;0.67;87.01;5.35;459;1;150.00;32
121;1;625354350;121;124;581;611;10.73;0.67;87.06;5.35;460;1;151.00;30
122;1;625354358;122;122;585;612;10.76;0.67;87.56;5.37;463;1;152.00;27
126;1;625354365;126;121;589;613;10.81;0.67;89.29;5.39;463;1;153.00;24
127;1;625354374;127;124;594;613;10.95;0.68;89.80;5.43;467;1;154.00;19
129;1;625354380;129;126;598;614;10.89;0.68;89.69;5.44;469;1;155.00;16
131;1;625354389;131;130;599;614;10.91;0.68;89.58;5.45;468;1;156.00;15
133;1;625354396;133;135;601;614;10.83;0.67;90.36;5.47;468;1;157.00;13
134;1;625354405;134;138;603;614;10.78;0.67;90.72;5.50;469;1;158.00;11
134;1;625354414;134;142;606;618;10.68;0.66;90.72;5.50;472;1;159.00;12
135;1;625354422;135;145;607;618;10.64;0.66;91.21;5.51;472;1;160.00;11
135;2;625354429;135;145;608;618;10.50;0.65;91.21;5.53;473;2;161.00;10
138;2;625354462;138;148;611;621;10.38;0.64;92.20;5.55;473;2;162.00;10
143;2;625354472;143;150;613;621;10.19;0.63;93.84;5.55;470;2;163.00;8
145;2;625354479;145;146;614;621;10.05;0.62;93.65;5.57;469;2;164.00;7
149;2;625354485;149;148;617;625;9.91;0.61;94.47;5.55;468;2;165.00;8
151;2;625354492;151;149;618;626;9.85;0.61;95.29;5.54;467;2;166.00;8
153;2;625354499;153;146;618;626;9.76;0.60;95.91;5.54;465;2;167.00;8
153;2;625354504;153;147;623;630;9.65;0.59;95.91;5.54;470;2;168.00;7
155;2;625354511;155;150;624;630;9.60;0.59;96.45;5.53;469;2;169.00;6
156;2;625354517;156;140;625;630;9.60;0.59;96.77;5.56;469;2;170.00;5
157;2;625354524;157;133;627;631;9.66;0.59;96.77;5.58;470;2;171.00;4
158;2;625354537;158;126;627;631;9.72;0.60;97.24;5.58;469;2;172.00;4
160;2;625354543;160;122;633;637;9.81;0.60;98.05;5.58;473;2;173.00;4
160;2;625354550;160;117;633;637;9.87;0.61;98.05;5.58;473;2;174.00;4
160;2;625354556;160;112;635;638;9.88;0.61;98.05;5.59;475;2;175.00;3
161;2;625354563;161;116;637;638;9.88;0.61;97.80;5.62;476;2;176.00;1
163;2;625354569;163;113;637;638;9.92;0.61;98.31;5.62;474;2;177.00;1
164;2;625354576;164;113;637;638;10.08;0.62;98.34;5.62;473;2;178.00;1
164;2;625354583;164;110;638;638;10.22;0.63;98.34;5.62;474;2;179.00;0
164;2;625354591;164;109;668;672;10.29;0.64;98.34;5.37;504;2;180.00;4
164;2;625354601;164;109;669;672;10.38;0.64;98.34;5.36;505;2;181.00;3
165;2;625354608;165;111;671;672;10.51;0.65;98.82;5.35;506;2;182.00;1
167;2;625354615;167;107;671;672;10.54;0.65;99.31;5.35;504;2;183.00;1
168;2;625354622;168;115;672;672;10.56;0.65;99.52;5.35;504;2;184.00;0
169;2;625354629;169;123;672;672;10.52;0.65;100.02;5.35;503;2;185.00;0
171;2;625354636;171;128;676;676;10.50;0.65;100.17;5.32;505;2;186.00;0
173;2;625354643;173;129;676;676;10.45;0.64;100.01;5.32;503;2;187.00;0
175;2;625354650;175;134;679;680;10.41;0.64;100.19;5.30;504;2;188.00;1
177;2;625354658;177;139;680;681;10.35;0.64;100.45;5.29;503;2;189.00;1
180;2;625354665;180;146;681;681;10.21;0.63;100.83;5.29;501;2;190.00;0
181;2;625354672;181;150;681;681;10.09;0.62;100.93;5.29;500;2;191.00;0
184;2;625354678;184;154;694;694;9.99;0.62;101.82;5.19;510;2;192.00;0
189;2;625354686;189;160;694;694;9.75;0.60;101.67;5.19;505;2;193.00;0
192;2;625354695;192;173;694;694;9.60;0.59;102.46;5.19;502;2;194.00;0
196;2;625354702;196;177;695;695;9.49;0.58;101.71;5.19;499;2;195.00;0
198;2;625354710;198;181;696;696;9.41;0.58;101.70;5.18;498;2;196.00;0
201;2;625354717;201;189;696;696;9.27;0.57;101.20;5.18;495;2;197.00;0
202;2;625354730;202;192;698;699;9.19;0.57;101.40;5.16;496;2;198.00;1
206;2;625354738;206;193;699;699;9.05;0.56;101.52;5.16;493;2;199.00;0
209;2;625354747;209;194;699;699;8.91;0.55;101.42;5.16;490;2;200.00;0
210;2;625354758;210;193;699;699;8.86;0.55;101.08;5.16;489;2;201.00;0
213;2;625354766;213;200;704;705;8.80;0.54;101.13;5.13;491;2;202.00;1
215;2;625354773;215;203;704;705;8.61;0.53;101.70;5.13;489;2;203.00;1
215;2;625354779;215;207;705;705;8.46;0.52;101.70;5.13;490;2;204.00;0
216;2;625354786;216;212;705;705;8.30;0.51;102.16;5.13;489;2;205.00;0
217;2;625354792;217;220;709;709;8.20;0.50;102.53;5.10;492;2;206.00;0
217;2;625354799;217;226;710;710;8.12;0.50;102.53;5.10;493;2;207.00;0
219;2;625354806;219;231;710;710;8.00;0.49;102.06;5.10;491;2;208.00;0
222;2;625354812;222;235;711;711;7.90;0.49;102.68;5.09;489;2;209.00;0
224;2;625354821;224;236;711;711;7.77;0.48;103.26;5.09;487;2;210.00;0
224;2;625354827;224;241;711;711;7.63;0.47;103.26;5.09;487;2;211.00;0
225;2;625354833;225;245;711;711;7.50;0.46;102.89;5.09;486;2;212.00;0
226;2;625354841;226;253;711;711;7.38;0.45;102.74;5.09;485;2;213.00;0
228;2;625354847;228;257;711;711;7.27;0.45;102.50;5.09;483;2;214.00;0
229;2;625354854;229;260;711;711;7.24;0.45;102.81;5.09;482;2;215.00;0
231;2;625354861;231;272;754;781;7.41;0.46;103.34;4.80;523;2;216.00;27
232;2;625354876;232;253;756;782;7.43;0.46;103.83;4.79;524;2;217.00;26
233;2;625354884;233;246;763;782;7.57;0.47;104.32;4.76;530;2;218.00;19
234;2;625354892;234;228;768;782;7.80;0.48;104.80;4.75;534;2;219.00;14
234;2;625354900;234;215;773;782;8.10;0.50;104.80;4.75;539;2;220.00;9
235;2;625354908;235;207;776;782;8.34;0.51;105.03;4.75;541;2;221.00;6
236;2;625354920;236;198;779;782;8.54;0.53;105.51;4.75;543;2;222.00;3
239;2;625354933;239;190;780;782;8.67;0.53;106.35;4.76;541;2;223.00;2
240;2;625354944;240;187;782;783;8.84;0.54;106.24;4.76;542;2;224.00;1
242;2;625354956;242;179;784;785;8.89;0.55;106.87;4.74;542;2;225.00;1
242;2;625354968;242;164;785;785;8.95;0.55;106.87;4.75;543;2;226.00;0
244;2;625354981;244;153;789;789;9.04;0.56;107.24;4.73;545;2;227.00;0
245;2;625354994;245;146;789;789;9.19;0.56;107.71;4.73;544;2;228.00;0
247;2;625355029;247;135;789;789;9.39;0.58;107.85;4.73;542;2;229.00;0
249;2;625355041;249;128;789;789;9.55;0.59;108.32;4.73;540;2;230.00;0
249;2;625355060;249;121;794;795;9.70;0.60;108.32;4.71;545;2;231.00;1
251;2;625355070;251;113;794;795;9.88;0.61;108.03;4.71;543;2;232.00;1
252;2;625355080;252;110;795;795;9.99;0.61;108.52;4.71;543;2;233.00;0
255;2;625355088;255;98;797;798;10.11;0.62;109.02;4.69;542;2;234.00;1
256;2;625355097;256;99;798;798;10.22;0.62;109.49;4.69;542;2;235.00;0
257;2;625355106;257;99;798;798;10.28;0.63;109.82;4.69;541;2;236.00;0
258;2;625355114;258;91;799;799;10.27;0.63;109.67;4.68;541;2;237.00;0
260;2;625355122;260;91;800;800;10.31;0.63;109.79;4.68;540;2;238.00;0
261;2;625355130;261;87;800;800;10.37;0.63;110.25;4.68;539;2;239.00;0
263;2;625355140;263;97;824;826;10.25;0.63;110.79;4.54;561;2;240.00;2
266;2;625355150;266;94;825;826;10.31;0.63;111.50;4.54;559;2;241.00;1
270;2;625355157;270;95;826;826;10.38;0.63;112.33;4.54;556;2;242.00;0
271;2;625355165;271;94;827;827;10.47;0.64;112.81;4.53;556;2;243.00;0
272;2;625355181;272;101;827;827;10.52;0.64;112.61;4.53;555;2;244.00;0
275;3;625355188;275;106;830;831;10.51;0.64;113.47;4.52;555;3;245.00;1
279;3;625355210;279;111;830;831;10.51;0.64;114.81;4.52;551;3;246.00;1
281;3;625355218;281;116;835;835;10.49;0.64;115.15;4.50;554;3;247.00;0
283;3;625355226;283;125;835;835;10.50;0.64;115.54;4.50;552;3;248.00;0
286;3;625355233;286;127;835;835;10.48;0.64;116.03;4.50;549;3;249.00;0
287;3;625355241;287;133;835;835;10.41;0.63;116.07;4.50;548;3;250.00;0
289;3;625355248;289;132;835;835;10.39;0.63;116.44;4.50;546;3;251.00;0
291;3;625355255;291;135;845;847;10.33;0.63;116.82;4.45;554;3;252.00;2
293;3;625355263;293;137;845;847;10.31;0.63;117.08;4.45;552;3;253.00;2
293;4;625355271;293;140;847;847;10.32;0.63;117.08;4.44;554;4;254.00;0
295;5;625355295;295;146;847;847;10.30;0.63;117.73;4.44;552;5;255.00;0
298;5;625355310;298;153;847;847;10.30;0.63;118.52;4.44;549;5;256.00;0
299;5;625355318;299;151;847;847;10.32;0.63;118.97;4.44;548;5;257.00;0
300;5;625355325;300;157;848;848;10.34;0.63;119.43;4.44;548;5;258.00;0
300;5;625355339;300;155;848;848;10.39;0.63;119.43;4.44;548;5;259.00;0
302;5;625355346;302;155;853;854;10.34;0.63;120.01;4.42;551;5;260.00;1
303;5;625355354;303;145;854;855;10.27;0.63;120.00;4.41;551;5;261.00;1
305;5;625355361;305;142;855;855;10.24;0.62;120.43;4.41;550;5;262.00;0
307;5;625355376;307;138;855;855;10.20;0.62;120.27;4.41;548;5;263.00;0
310;5;625355385;310;138;859;859;10.17;0.62;120.64;4.39;549;5;264.00;0
313;5;625355395;313;136;859;859;10.18;0.62;120.64;4.39;546;5;265.00;0
319;5;625355403;319;134;859;859;10.20;0.62;121.93;4.39;540;5;266.00;0
320;5;625355410;320;136;860;860;10.27;0.62;122.39;4.38;540;5;267.00;0
324;5;625355417;324;132;864;864;10.23;0.62;122.67;4.37;540;5;268.00;0
326;5;625355426;326;126;864;864;10.31;0.62;122.77;4.37;538;5;269.00;0
329;5;625355435;329;122;867;870;10.37;0.63;122.91;4.35;538;5;270.00;3
333;5;625355444;333;119;867;870;10.50;0.64;123.68;4.35;534;5;271.00;3
335;5;625355451;335;114;868;870;10.61;0.64;123.43;4.35;533;5;272.00;2
337;5;625355460;337;108;868;870;10.74;0.65;123.97;4.35;531;5;273.00;2
338;5;625355468;338;106;871;874;10.84;0.65;124.40;4.34;533;5;274.00;3
338;5;625355477;338;103;871;874;10.92;0.66;124.40;4.34;533;5;275.00;3
340;5;625355485;340;101;872;874;11.10;0.67;124.45;4.35;532;5;276.00;2
341;5;625355495;341;97;872;874;11.20;0.68;124.72;4.35;531;5;277.00;2
344;5;625355504;344;92;874;875;11.24;0.68;124.81;4.34;530;5;278.00;1
345;5;625355517;345;89;875;876;11.33;0.69;124.83;4.34;530;5;279.00;1
349;5;625355526;349;85;876;876;11.33;0.69;125.07;4.34;527;5;280.00;0
350;5;625355535;350;83;877;877;11.39;0.69;125.10;4.34;527;5;281.00;0
352;5;625355543;352;83;877;877;11.41;0.69;124.97;4.34;525;5;282.00;0
355;5;625355553;355;81;877;877;11.45;0.69;125.46;4.34;522;5;283.00;0
356;5;625355562;356;82;877;877;11.55;0.70;125.51;4.34;521;5;284.00;0
356;5;625355572;356;84;877;877;11.72;0.71;125.51;4.34;521;5;285.00;0
357;5;625355582;357;84;877;877;11.78;0.72;125.82;4.34;520;5;286.00;0
359;5;625355591;359;80;877;877;11.88;0.72;126.12;4.34;518;5;287.00;0
359;5;625355599;359;97;949;1004;11.53;0.71;126.12;4.01;590;5;288.00;55
360;5;625355623;360;89;951;1005;11.48;0.71;126.17;4.00;591;5;289.00;54
361;5;625355633;361;86;958;1005;11.57;0.72;126.41;3.99;597;5;290.00;47
362;5;625355644;362;87;963;1005;11.65;0.72;126.77;3.98;601;5;291.00;42
363;5;625355653;363;85;970;1005;11.76;0.73;126.82;3.98;607;5;292.00;35
364;5;625355663;364;83;975;1005;11.84;0.73;127.26;3.99;611;5;293.00;30
367;5;625355672;367;82;979;1005;11.87;0.73;126.98;4.00;612;5;294.00;26
369;5;625355682;369;87;984;1005;11.92;0.73;127.36;4.01;615;5;295.00;21
372;5;625355691;372;86;987;1006;12.04;0.74;127.26;4.03;615;5;296.00;19
375;5;625355702;375;87;989;1007;12.11;0.74;127.08;4.03;614;5;297.00;18
378;5;625355712;378;92;991;1007;12.18;0.75;127.55;4.04;613;5;298.00;16
380;5;625355723;380;93;993;1008;12.16;0.75;127.81;4.05;613;5;299.00;15
382;5;625355737;382;96;997;1014;12.06;0.74;128.31;4.07;615;5;300.00;17
384;5;625355761;384;103;998;1014;11.91;0.73;128.65;4.08;614;5;301.00;16
385;5;625355771;385;106;999;1014;11.83;0.72;128.80;4.09;614;5;302.00;15
387;5;625355782;387;115;1004;1018;11.74;0.72;129.19;4.11;617;5;303.00;14
389;5;625355792;389;122;1006;1018;11.62;0.71;129.99;4.13;617;5;304.00;12
390;5;625355802;390;128;1007;1018;11.56;0.71;130.18;4.14;617;5;305.00;11
393;5;625355811;393;133;1011;1021;11.43;0.70;130.64;4.14;618;5;306.00;10
396;5;625355822;396;138;1011;1021;11.35;0.70;131.12;4.14;615;5;307.00;10
397;5;625355838;397;145;1012;1021;11.31;0.69;131.02;4.15;615;5;308.00;9
397;5;625355848;397;146;1015;1025;11.22;0.69;131.02;4.14;618;5;309.00;10
398;5;625355857;398;152;1016;1026;11.13;0.68;131.11;4.14;618;5;310.00;10
401;5;625355867;401;156;1017;1026;11.00;0.68;131.84;4.14;616;5;311.00;9
404;5;625355884;404;162;1020;1030;10.94;0.67;131.90;4.13;616;5;312.00;10
409;5;625355900;409;164;1021;1030;10.86;0.67;132.67;4.13;612;5;313.00;9
410;5;625355910;410;166;1022;1030;10.80;0.66;133.00;4.14;612;5;314.00;8
411;5;625355921;411;165;1024;1032;10.66;0.66;133.14;4.13;613;5;315.00;8
414;5;625355932;414;172;1024;1032;10.56;0.65;133.66;4.13;610;5;316.00;8
417;5;625355948;417;174;1028;1038;10.52;0.65;133.99;4.12;611;5;317.00;10
420;5;625355958;420;175;1028;1038;10.41;0.64;134.48;4.12;608;5;318.00;10
421;5;625355967;421;174;1029;1039;10.32;0.63;134.57;4.11;608;5;319.00;10
425;5;625355976;425;181;1031;1039;10.22;0.63;134.76;4.16;606;5;320.00;8
428;5;625355985;428;181;1032;1039;10.18;0.62;135.28;4.16;604;5;321.00;7
431;5;625355995;431;184;1034;1039;10.12;0.62;135.54;4.20;603;5;322.00;5
434;5;625356005;434;184;1036;1039;10.09;0.62;135.75;4.24;602;5;323.00;3
436;5;625356014;436;188;1048;1051;10.09;0.62;136.26;4.20;612;5;324.00;3
437;5;625356022;437;191;1049;1051;10.07;0.61;136.68;4.20;612;5;325.00;2
439;5;625356029;439;194;1051;1051;10.01;0.61;136.94;4.23;612;5;326.00;0
441;5;625356037;441;194;1051;1051;10.05;0.61;136.71;4.23;610;5;327.00;0
442;5;625356044;442;197;1051;1051;10.08;0.62;136.74;4.23;609;5;328.00;0
443;5;625356052;443;197;1051;1051;10.07;0.62;136.76;4.23;608;5;329.00;0
446;5;625356066;446;201;1055;1055;9.92;0.61;137.70;4.22;609;5;330.00;0
451;5;625356074;451;198;1055;1055;9.85;0.60;138.51;4.22;604;5;331.00;0
453;5;625356082;453;204;1058;1059;9.78;0.60;139.07;4.21;605;5;332.00;1
454;5;625356092;454;207;1060;1060;9.67;0.59;139.02;4.20;606;5;333.00;0
457;5;625356100;457;210;1060;1060;9.59;0.59;139.08;4.20;603;5;334.00;0
459;5;625356108;459;210;1060;1060;9.49;0.58;139.07;4.20;601;5;335.00;0
462;5;625356117;462;220;1072;1073;9.24;0.57;140.32;4.16;610;5;336.00;1
466;5;625356126;466;222;1073;1073;8.97;0.55;141.07;4.15;607;5;337.00;0
467;5;625356133;467;227;1073;1073;8.70;0.53;141.49;4.15;606;5;338.00;0
470;5;625356140;470;231;1074;1074;8.46;0.52;141.83;4.15;604;5;339.00;0
472;5;625356147;472;224;1075;1075;8.28;0.51;142.67;4.15;603;5;340.00;0
476;5;625356154;476;221;1075;1075;8.20;0.50;142.99;4.15;599;5;341.00;0
478;5;625356161;478;214;1078;1078;8.21;0.50;143.55;4.14;600;5;342.00;0
481;5;625356169;481;211;1078;1078;8.12;0.50;143.87;4.14;597;5;343.00;0
486;5;625356176;486;217;1078;1078;8.06;0.49;144.69;4.14;592;5;344.00;0
488;5;625356184;488;215;1078;1078;8.11;0.50;144.95;4.14;590;5;345.00;0
493;5;625356191;493;219;1083;1084;8.06;0.49;145.44;4.12;590;5;346.00;1
495;5;625356199;495;215;1084;1084;8.01;0.49;145.59;4.12;589;5;347.00;0
497;5;625356207;497;216;1084;1084;7.95;0.49;145.96;4.12;587;5;348.00;0
499;5;625356214;499;218;1084;1084;7.88;0.48;146.73;4.12;585;5;349.00;0
502;5;625356222;502;222;1088;1088;7.83;0.48;146.15;4.11;586;5;350.00;0
504;5;625356229;504;222;1089;1089;7.80;0.48;146.24;4.10;585;5;351.00;0
509;5;625356236;509;224;1089;1089;7.72;0.47;146.59;4.10;580;5;352.00;0
513;5;625356243;513;223;1090;1090;7.70;0.47;146.87;4.10;577;5;353.00;0
519;5;625356250;519;227;1090;1090;7.65;0.47;146.79;4.10;571;5;354.00;0
522;5;625356257;522;228;1090;1090;7.61;0.47;146.44;4.10;568;5;355.00;0
525;5;625356264;525;225;1090;1090;7.56;0.46;146.22;4.10;565;5;356.00;0
526;5;625356270;526;228;1090;1090;7.57;0.46;146.07;4.10;564;5;357.00;0
527;5;625356277;527;230;1090;1090;7.56;0.46;146.20;4.10;563;5;358.00;0
530;5;625356284;530;241;1090;1090;7.49;0.46;145.84;4.10;560;5;359.00;0
531;5;625356292;531;255;1156;1215;7.72;0.48;145.66;3.87;625;5;360.00;59
535;5;625356309;535;247;1163;1216;7.70;0.48;145.93;3.85;628;5;361.00;53
538;6;625356317;538;242;1177;1216;7.81;0.48;146.64;3.83;639;6;362.00;39
539;6;625356339;539;240;1183;1216;7.86;0.49;146.69;3.82;644;6;363.00;33
541;6;625356348;541;237;1189;1216;7.87;0.49;146.71;3.83;648;6;364.00;27
542;6;625356357;542;236;1194;1216;7.91;0.49;146.49;3.83;652;6;365.00;22
542;6;625356365;542;241;1199;1216;7.92;0.49;146.49;3.84;657;6;366.00;17
543;6;625356378;543;243;1201;1216;7.87;0.49;146.64;3.84;658;6;367.00;15
544;6;625356387;544;244;1205;1217;7.88;0.49;146.51;3.86;661;6;368.00;12
546;6;625356396;546;249;1207;1218;7.81;0.49;146.38;3.85;661;6;369.00;11
547;6;625356404;547;254;1209;1218;7.79;0.48;146.34;3.86;662;6;370.00;9
551;6;625356413;551;251;1213;1222;7.70;0.48;146.43;3.85;662;6;371.00;9
553;6;625356423;553;243;1214;1222;7.70;0.48;146.45;3.86;661;6;372.00;8
553;6;625356432;553;243;1214;1222;7.68;0.48;146.45;3.86;661;6;373.00;8
555;6;625356446;555;244;1215;1222;7.68;0.48;146.73;3.87;660;6;374.00;7
556;6;625356456;556;242;1221;1228;7.78;0.48;146.88;3.88;665;6;375.00;7
557;6;625356466;557;240;1222;1228;7.90;0.49;147.03;3.89;665;6;376.00;6
559;6;625356476;559;238;1223;1228;8.00;0.50;147.24;3.90;664;6;377.00;5
563;7;625356485;563;238;1226;1231;8.13;0.50;147.83;3.90;663;7;378.00;5
564;7;625356506;564;235;1228;1231;8.24;0.51;147.92;3.93;664;7;379.00;3
567;7;625356516;567;230;1229;1231;8.33;0.51;148.37;3.93;662;7;380.00;2
569;7;625356531;569;231;1231;1232;8.41;0.52;148.55;3.93;662;7;381.00;1
572;7;625356541;572;230;1233;1233;8.47;0.52;148.24;3.93;661;7;382.00;0
573;7;625356556;573;232;1233;1233;8.48;0.52;148.03;3.93;660;7;383.00;0
576;7;625356566;576;228;1246;1246;8.55;0.52;148.03;3.89;670;7;384.00;0
578;7;625356576;578;232;1246;1246;8.56;0.52;147.81;3.89;668;7;385.00;0
580;7;625356585;580;234;1246;1246;8.56;0.52;147.82;3.89;666;7;386.00;0
582;7;625356594;582;229;1247;1247;8.60;0.53;147.67;3.88;665;7;387.00;0
583;7;625356604;583;228;1247;1247;8.64;0.53;147.59;3.88;664;7;388.00;0
584;7;625356613;584;223;1250;1251;8.71;0.53;147.69;3.88;666;7;389.00;1
585;7;625356624;585;220;1250;1251;8.76;0.53;147.61;3.88;665;7;390.00;1
585;7;625356633;585;218;1255;1255;8.82;0.54;147.61;3.87;670;7;391.00;0
588;7;625356643;588;217;1255;1255;8.86;0.54;147.39;3.87;667;7;392.00;0
590;7;625356653;590;219;1255;1255;8.90;0.54;147.97;3.87;665;7;393.00;0
592;7;625356662;592;219;1255;1255;8.96;0.55;148.67;3.87;663;7;394.00;0
593;7;625356672;593;223;1255;1255;9.00;0.55;148.88;3.87;662;7;395.00;0
597;7;625356681;597;208;1266;1267;9.15;0.56;149.28;3.83;669;7;396.00;1
599;7;625356698;599;190;1267;1267;9.17;0.56;149.70;3.83;668;7;397.00;0
601;7;625356707;601;185;1267;1267;9.21;0.56;149.88;3.83;666;7;398.00;0
605;7;625356717;605;170;1267;1267;9.25;0.57;150.60;3.83;662;7;399.00;0
605;7;625356734;605;164;1267;1267;9.29;0.57;150.60;3.83;662;7;400.00;0
608;7;625356749;608;159;1267;1267;9.37;0.58;150.99;3.83;659;7;401.00;0
609;7;625356759;609;155;1268;1268;9.44;0.58;151.16;3.83;659;7;402.00;0
611;8;625356774;611;157;1268;1268;9.53;0.59;150.98;3.83;657;8;403.00;0
614;8;625356795;614;158;1273;1274;9.61;0.59;151.29;3.82;659;8;404.00;1
616;8;625356807;616;160;1275;1276;9.75;0.60;151.76;3.81;659;8;405.00;1
617;8;625356817;617;160;1276;1276;9.93;0.61;152.13;3.81;659;8;406.00;0
619;8;625356828;619;157;1276;1276;10.07;0.62;152.17;3.81;657;8;407.00;0
622;9;625356838;622;158;1280;1280;10.07;0.62;153.02;3.80;658;9;408.00;0
624;9;625356867;624;155;1280;1280;10.03;0.62;153.11;3.80;656;9;409.00;0
632;9;625356877;632;151;1280;1280;9.99;0.61;154.45;3.80;648;9;410.00;0
638;9;625356887;638;151;1281;1281;10.02;0.61;155.24;3.80;643;9;411.00;0
640;9;625356896;640;151;1285;1285;9.99;0.61;155.38;3.79;645;9;412.00;0
645;9;625356906;645;148;1285;1285;10.00;0.61;156.14;3.79;640;9;413.00;0
647;9;625356914;647;147;1287;1288;10.15;0.62;156.34;3.78;640;9;414.00;1
649;9;625356928;649;143;1287;1288;10.21;0.63;156.59;3.78;638;9;415.00;1
650;9;625356941;650;148;1288;1288;10.34;0.63;156.76;3.78;638;9;416.00;0
654;9;625356957;654;147;1288;1288;10.40;0.64;157.54;3.78;634;9;417.00;0
657;9;625356982;657;149;1291;1292;10.47;0.64;158.14;3.77;634;9;418.00;1
660;9;625356997;660;149;1291;1292;10.56;0.64;158.24;3.77;631;9;419.00;1
664;9;625357012;664;150;1292;1292;10.60;0.65;159.02;3.77;628;9;420.00;0
669;9;625357025;669;153;1292;1292;10.65;0.65;159.45;3.77;623;9;421.00;0
671;10;625357050;671;155;1293;1293;10.68;0.65;159.74;3.77;622;10;422.00;0
676;10;625357078;676;158;1294;1294;10.64;0.65;159.89;3.77;618;10;423.00;0
681;10;625357088;681;157;1294;1294;10.61;0.64;161.00;3.77;613;10;424.00;0
683;10;625357097;683;161;1295;1295;10.57;0.64;161.00;3.77;612;10;425.00;0
684;10;625357106;684;163;1295;1295;10.50;0.64;161.07;3.77;611;10;426.00;0
685;10;625357120;685;161;1295;1295;10.45;0.64;161.04;3.77;610;10;427.00;0
687;10;625357129;687;163;1295;1295;10.43;0.64;161.58;3.77;608;10;428.00;0
688;10;625357138;688;161;1295;1295;10.45;0.64;161.71;3.77;607;10;429.00;0
689;10;625357146;689;156;1295;1295;10.52;0.64;161.68;3.77;606;10;430.00;0
690;10;625357154;690;151;1295;1295;10.53;0.64;161.96;3.77;605;10;431.00;0
692;10;625357163;692;183;1374;1422;9.91;0.61;161.91;3.55;682;10;432.00;48
695;10;625357182;695;160;1374;1423;9.94;0.62;162.23;3.55;679;10;433.00;49
697;10;625357192;697;142;1379;1423;10.12;0.63;162.68;3.55;682;10;434.00;44
703;10;625357200;703;145;1384;1423;10.22;0.63;163.12;3.54;681;10;435.00;39
707;10;625357209;707;143;1388;1423;10.28;0.63;163.35;3.55;681;10;436.00;35
709;10;625357218;709;143;1391;1423;10.30;0.63;163.18;3.55;682;10;437.00;32
712;10;625357227;712;143;1393;1423;10.31;0.63;163.63;3.55;681;10;438.00;30
717;10;625357235;717;145;1395;1423;10.40;0.64;163.71;3.56;678;10;439.00;28
723;10;625357244;723;143;1400;1424;10.46;0.64;164.33;3.57;677;10;440.00;24
725;10;625357254;725;144;1403;1425;10.51;0.64;164.26;3.59;678;10;441.00;22
728;10;625357263;728;133;1406;1425;10.53;0.64;165.37;3.60;678;10;442.00;19
730;10;625357272;730;129;1410;1426;10.52;0.64;165.64;3.61;680;10;443.00;16
733;10;625357282;733;127;1412;1426;10.45;0.64;165.75;3.63;679;10;444.00;14
734;10;625357291;734;120;1415;1426;10.32;0.63;166.04;3.65;681;10;445.00;11
736;10;625357300;736;120;1417;1426;10.26;0.63;166.46;3.66;681;10;446.00;9
738;10;625357309;738;116;1419;1430;10.22;0.62;166.61;3.67;681;10;447.00;11
741;10;625357319;741;114;1420;1430;10.16;0.62;166.58;3.68;679;10;448.00;10
745;10;625357328;745;116;1421;1430;10.14;0.62;167.31;3.69;676;10;449.00;9
747;10;625357340;747;122;1425;1436;10.16;0.62;167.41;3.68;678;10;450.00;11
749;10;625357350;749;119;1425;1436;10.21;0.62;167.25;3.68;676;10;451.00;11
752;10;625357360;752;114;1427;1436;10.29;0.63;167.23;3.68;675;10;452.00;9
754;10;625357370;754;119;1430;1440;10.30;0.63;167.13;3.68;676;10;453.00;10
754;10;625357380;754;117;1432;1441;10.37;0.63;167.13;3.68;678;10;454.00;9
758;10;625357389;758;117;1432;1441;10.38;0.63;166.94;3.68;674;10;455.00;9
761;10;625357400;761;118;1435;1445;10.48;0.64;167.51;3.67;674;10;456.00;10
765;10;625357410;765;116;1437;1445;10.59;0.64;167.34;3.69;672;10;457.00;8
767;10;625357420;767;121;1438;1445;10.66;0.65;167.72;3.71;671;10;458.00;7
768;10;625357430;768;120;1441;1446;10.74;0.65;167.77;3.73;673;10;459.00;5
768;10;625357440;768;122;1441;1446;10.83;0.66;167.77;3.73;673;10;460.00;5
771;10;625357450;771;121;1444;1452;10.85;0.66;167.92;3.72;673;10;461.00;8
772;10;625357462;772;124;1446;1452;10.86;0.66;167.83;3.74;674;10;462.00;6
774;10;625357473;774;122;1447;1453;10.80;0.66;167.69;3.74;673;10;463.00;6
774;10;625357490;774;123;1448;1453;10.64;0.65;167.69;3.74;674;10;464.00;5
777;10;625357500;777;123;1448;1453;10.56;0.64;167.51;3.74;671;10;465.00;5
778;10;625357510;778;129;1448;1453;10.50;0.64;167.70;3.74;670;10;466.00;5
779;10;625357519;779;132;1448;1453;10.51;0.64;167.80;3.74;669;10;467.00;5
783;10;625357529;783;136;1458;1465;10.58;0.64;167.83;3.71;675;10;468.00;7
785;10;625357539;785;136;1458;1465;10.64;0.65;167.98;3.71;673;10;469.00;7
787;10;625357549;787;141;1461;1465;10.75;0.65;168.35;3.73;674;10;470.00;4
789;10;625357559;789;141;1461;1465;10.84;0.66;168.35;3.73;672;10;471.00;4
791;10;625357569;791;144;1461;1465;10.93;0.67;168.30;3.73;670;10;472.00;4
795;10;625357579;795;148;1462;1465;10.94;0.67;168.50;3.75;667;10;473.00;3
795;10;625357589;795;151;1465;1469;10.95;0.67;168.50;3.74;670;10;474.00;4
798;10;625357600;798;156;1465;1469;10.99;0.67;168.36;3.74;667;10;475.00;4
802;10;625357610;802;156;1470;1473;11.06;0.67;168.42;3.75;668;10;476.00;3
804;10;625357626;804;157;1473;1474;11.09;0.68;168.49;3.75;669;10;477.00;1
805;11;625357636;805;156;1474;1474;11.11;0.68;168.42;3.75;669;11;478.00;0
807;11;625357663;807;161;1474;1474;11.06;0.68;168.35;3.75;667;11;479.00;0
808;11;625357675;808;170;1494;1500;11.01;0.67;168.54;3.70;686;11;480.00;6
809;11;625357687;809;170;1494;1500;10.94;0.67;168.59;3.70;685;11;481.00;6
811;11;625357695;811;175;1497;1500;10.89;0.67;168.50;3.70;686;11;482.00;3
812;11;625357711;812;180;1500;1501;10.86;0.67;168.42;3.70;688;11;483.00;1
813;11;625357721;813;186;1502;1502;10.84;0.66;168.45;3.70;689;11;484.00;0
815;11;625357731;815;186;1502;1502;10.71;0.66;168.41;3.70;687;11;485.00;0
816;11;625357746;816;194;1504;1505;10.60;0.65;168.35;3.69;688;11;486.00;1
818;11;625357755;818;198;1504;1505;10.46;0.64;168.33;3.69;686;11;487.00;1
820;11;625357765;820;207;1505;1505;10.35;0.63;168.32;3.69;685;11;488.00;0
823;11;625357774;823;211;1505;1505;10.26;0.63;168.02;3.69;682;11;489.00;0
826;11;625357784;826;213;1510;1511;10.20;0.62;167.76;3.68;684;11;490.00;1
827;11;625357794;827;211;1510;1511;10.22;0.63;167.70;3.68;683;11;491.00;1
829;11;625357804;829;212;1511;1511;10.15;0.62;167.61;3.68;682;11;492.00;0
829;11;625357819;829;217;1511;1511;10.05;0.62;167.61;3.68;682;11;493.00;0
832;11;625357828;832;219;1515;1515;9.92;0.61;167.94;3.67;683;11;494.00;0
834;11;625357838;834;218;1517;1517;9.80;0.60;167.85;3.67;683;11;495.00;0
835;11;625357853;835;218;1517;1517;9.75;0.60;167.75;3.67;682;11;496.00;0
836;11;625357862;836;222;1518;1518;9.74;0.60;167.72;3.67;682;11;497.00;0
839;11;625357877;839;226;1518;1518;9.65;0.59;167.33;3.67;679;11;498.00;0
843;11;625357885;843;229;1518;1518;9.60;0.59;167.14;3.67;675;11;499.00;0
848;11;625357894;848;228;1518;1518;9.55;0.58;167.15;3.67;670;11;500.00;0
850;11;625357906;850;232;1518;1518;9.40;0.57;167.09;3.67;668;11;501.00;0
852;12;625357913;852;235;1518;1518;9.28;0.57;167.35;3.67;666;12;502.00;0
855;12;625357935;855;242;1518;1518;9.12;0.56;167.19;3.67;663;12;503.00;0
856;12;625357944;856;250;1557;1588;9.20;0.56;167.33;3.57;701;12;504.00;31
860;12;625357958;860;249;1561;1589;8.99;0.55;167.95;3.57;701;12;505.00;28
863;12;625357967;863;255;1570;1589;8.93;0.55;168.61;3.56;707;12;506.00;19
866;12;625357976;866;259;1571;1589;8.75;0.54;168.65;3.56;705;12;507.00;18
868;12;625357983;868;258;1577;1589;8.59;0.53;169.09;3.56;709;12;508.00;12
873;12;625357991;873;263;1581;1589;8.42;0.52;169.80;3.56;708;12;509.00;8
875;12;625358001;875;259;1586;1589;8.30;0.51;169.97;3.57;711;12;510.00;3
877;12;625358009;877;255;1588;1589;8.16;0.50;170.61;3.58;711;12;511.00;1
881;12;625358017;881;253;1590;1590;8.13;0.50;170.63;3.58;709;12;512.00;0
882;12;625358025;882;252;1591;1591;8.04;0.49;170.88;3.58;709;12;513.00;0
886;12;625358033;886;252;1591;1591;7.93;0.49;171.49;3.58;705;12;514.00;0
887;12;625358041;887;256;1595;1595;7.89;0.48;171.55;3.57;708;12;515.00;0
889;12;625358049;889;269;1595;1595;7.82;0.48;171.36;3.57;706;12;516.00;0
889;12;625358057;889;266;1595;1595;7.81;0.48;171.36;3.57;706;12;517.00;0
889;12;625358065;889;266;1595;1595;7.85;0.48;171.36;3.57;706;12;518.00;0
892;12;625358073;892;269;1600;1601;7.89;0.49;171.45;3.56;708;12;519.00;1
896;12;625358083;896;269;1600;1601;7.93;0.49;171.81;3.56;704;12;520.00;1
899;12;625358091;899;262;1601;1601;7.97;0.49;172.22;3.56;702;12;521.00;0
901;12;625358100;901;265;1603;1604;8.00;0.49;172.47;3.56;702;12;522.00;1
905;12;625358108;905;247;1604;1604;7.98;0.49;173.13;3.55;699;12;523.00;0
910;12;625358117;910;232;1604;1604;8.04;0.49;173.43;3.55;694;12;524.00;0
913;12;625358126;913;225;1605;1605;8.14;0.50;173.74;3.55;692;12;525.00;0
920;12;625358134;920;219;1606;1606;8.17;0.50;173.74;3.55;686;12;526.00;0
922;12;625358144;922;213;1606;1606;8.20;0.50;174.03;3.55;684;12;527.00;0
925;12;625358153;925;215;1619;1619;8.27;0.51;174.43;3.52;694;12;528.00;0
931;12;625358162;931;206;1619;1619;8.20;0.50;174.81;3.52;688;12;529.00;0
933;12;625358177;933;198;1619;1619;8.14;0.50;174.76;3.52;686;12;530.00;0
937;12;625358186;937;192;1620;1620;8.18;0.50;175.35;3.52;683;12;531.00;0
940;12;625358195;940;194;1620;1620;8.23;0.50;175.36;3.52;680;12;532.00;0
947;12;625358204;947;190;1623;1624;8.27;0.50;175.65;3.52;676;12;533.00;1
949;12;625358214;949;190;1623;1624;8.33;0.51;175.69;3.52;674;12;534.00;1
953;12;625358223;953;191;1628;1628;8.38;0.51;175.74;3.51;675;12;535.00;0
957;12;625358233;957;196;1628;1628;8.36;0.51;175.79;3.51;671;12;536.00;0
962;12;625358242;962;194;1628;1628;8.34;0.51;175.71;3.51;666;12;537.00;0
964;12;625358252;964;194;1628;1628;8.33;0.51;175.55;3.51;664;12;538.00;0
966;12;625358261;966;194;1628;1628;8.34;0.51;175.71;3.51;662;12;539.00;0
968;12;625358271;968;210;1658;1662;8.47;0.52;176.06;3.45;690;12;540.00;4
968;12;625358284;968;200;1658;1662;8.58;0.53;176.06;3.45;690;12;541.00;4
973;12;625358293;973;197;1659;1662;8.67;0.53;176.60;3.44;686;12;542.00;3
977;12;625358303;977;197;1659;1662;8.74;0.54;176.61;3.44;682;12;543.00;3
980;12;625358313;980;195;1660;1662;8.83;0.54;176.81;3.45;680;12;544.00;2
983;12;625358327;983;195;1660;1662;8.83;0.54;177.33;3.45;677;12;545.00;2
986;12;625358337;986;195;1662;1663;8.82;0.54;177.59;3.45;676;12;546.00;1
987;12;625358346;987;202;1662;1663;8.79;0.54;177.58;3.45;675;12;547.00;1
992;12;625358355;992;203;1667;1669;8.74;0.53;177.45;3.44;675;12;548.00;2
996;12;625358366;996;204;1668;1670;8.69;0.53;177.80;3.44;672;12;549.00;2
997;12;625358375;997;210;1669;1670;8.80;0.54;177.76;3.44;672;12;550.00;1
1003;12;625358384;1003;215;1669;1670;8.78;0.54;177.93;3.44;666;12;551.00;1
1005;12;625358394;1005;216;1674;1674;8.75;0.53;177.81;3.43;669;12;552.00;0
1007;12;625358403;1007;222;1674;1674;8.72;0.53;177.95;3.43;667;12;553.00;0
1009;12;625358412;1009;230;1674;1674;8.63;0.53;178.19;3.43;665;12;554.00;0
1012;12;625358421;1012;230;1675;1675;8.57;0.52;178.19;3.43;663;12;555.00;0
1015;12;625358430;1015;239;1679;1679;8.54;0.52;178.73;3.43;664;12;556.00;0
1016;12;625358439;1016;226;1679;1679;8.51;0.52;179.00;3.43;663;12;557.00;0
1019;13;625358449;1019;217;1681;1682;8.58;0.53;179.29;3.42;662;13;558.00;1
1023;13;625358469;1023;211;1681;1682;8.66;0.53;179.44;3.42;658;13;559.00;1
1026;13;625358480;1026;207;1682;1682;8.69;0.53;180.19;3.42;656;13;560.00;0
1027;13;625358490;1027;208;1682;1682;8.76;0.53;180.48;3.42;655;13;561.00;0
1032;13;625358499;1032;206;1685;1686;8.82;0.54;180.93;3.42;653;13;562.00;1
1036;13;625358510;1036;209;1685;1686;8.83;0.54;181.33;3.42;649;13;563.00;1
1036;13;625358520;1036;208;1686;1686;8.87;0.54;181.33;3.42;650;13;564.00;0
1041;13;625358530;1041;210;1686;1686;8.84;0.54;181.91;3.42;645;13;565.00;0
1045;13;625358539;1045;196;1687;1687;8.82;0.54;182.22;3.41;642;13;566.00;0
1046;13;625358550;1046;181;1688;1688;8.89;0.54;182.32;3.41;642;13;567.00;0
1050;13;625358559;1050;180;1688;1688;8.95;0.54;182.75;3.41;638;13;568.00;0
1051;13;625358569;1051;179;1689;1689;9.10;0.55;183.00;3.41;638;13;569.00;0
1054;13;625358580;1054;169;1689;1689;9.15;0.56;183.17;3.41;635;13;570.00;0
1057;13;625358591;1057;164;1689;1689;9.22;0.56;183.37;3.41;632;13;571.00;0
1058;13;625358601;1058;162;1689;1689;9.39;0.57;183.43;3.41;631;13;572.00;0
1062;13;625358610;1062;166;1689;1689;9.47;0.58;183.71;3.41;627;13;573.00;0
1064;13;625358620;1064;167;1689;1689;9.52;0.58;183.92;3.41;625;13;574.00;0
1068;13;625358630;1068;163;1689;1689;9.58;0.58;184.41;3.41;621;13;575.00;0
1069;13;625358639;1069;194;1772;1816;9.50;0.59;184.57;3.25;703;13;576.00;44
1073;13;625358659;1073;178;1775;1817;9.53;0.59;184.99;3.25;702;13;577.00;42
1077;13;625358675;1077;170;1783;1817;9.69;0.60;185.26;3.24;706;13;578.00;34
1079;13;625358686;1079;158;1788;1817;9.84;0.61;185.42;3.24;709;13;579.00;29
1079;13;625358696;1079;155;1793;1817;9.99;0.62;185.42;3.24;714;13;580.00;24
1081;13;625358706;1081;148;1797;1817;10.10;0.62;185.70;3.25;716;13;581.00;20
1081;13;625358722;1081;149;1800;1817;10.18;0.63;185.70;3.25;719;13;582.00;17
1084;13;625358732;1084;143;1803;1817;10.15;0.62;185.97;3.26;719;13;583.00;14
1087;13;625358741;1087;146;1806;1818;10.21;0.63;186.40;3.26;719;13;584.00;12
1092;13;625358752;1092;148;1808;1820;10.21;0.63;186.61;3.26;716;13;585.00;12
1094;13;625358762;1094;150;1810;1820;10.25;0.63;186.65;3.27;716;13;586.00;10
1097;13;625358778;1097;153;1812;1821;10.25;0.63;186.89;3.28;715;13;587.00;9
1099;13;625358794;1099;156;1814;1821;10.34;0.63;186.97;3.29;715;13;588.00;7
1099;13;625358810;1099;160;1814;1821;10.43;0.64;186.97;3.29;715;13;589.00;7
1102;13;625358826;1102;161;1816;1821;10.49;0.64;187.14;3.30;714;13;590.00;5
1103;13;625358837;1103;163;1819;1825;10.53;0.64;187.12;3.30;716;13;591.00;6
1104;13;625358847;1104;170;1821;1825;10.61;0.65;187.11;3.31;717;13;592.00;4
1107;13;625358857;1107;170;1821;1825;10.62;0.65;187.42;3.31;714;13;593.00;4
1108;13;625358867;1108;174;1824;1828;10.75;0.66;187.52;3.31;716;13;594.00;4
1109;13;625358877;1109;174;1824;1828;10.77;0.66;187.46;3.31;715;13;595.00;4
1111;13;625358887;1111;176;1825;1828;10.83;0.66;187.77;3.32;714;13;596.00;3
1112;13;625358897;1112;177;1829;1832;10.79;0.66;187.75;3.32;717;13;597.00;3
1114;13;625358912;1114;180;1831;1833;10.79;0.66;188.09;3.32;717;13;598.00;2
1115;13;625358924;1115;178;1831;1833;10.80;0.66;188.07;3.32;716;13;599.00;2
1121;13;625358941;1121;180;1843;1859;10.72;0.65;188.15;3.30;722;13;600.00;16
1123;13;625358985;1123;172;1844;1859;10.73;0.65;188.11;3.30;721;13;601.00;15
1125;13;625359001;1125;168;1845;1859;10.76;0.65;188.06;3.30;720;13;602.00;14
1127;13;625359025;1127;167;1847;1860;10.79;0.66;188.16;3.30;720;13;603.00;13
1131;13;625359039;1131;165;1848;1860;10.81;0.66;188.47;3.30;717;13;604.00;12
1135;13;625359057;1135;162;1852;1866;10.86;0.66;188.95;3.30;717;13;605.00;14
1140;13;625359069;1140;161;1853;1866;10.92;0.66;189.35;3.30;713;13;606.00;13
1144;13;625359081;1144;160;1854;1867;11.00;0.67;189.65;3.30;710;13;607.00;13
1151;13;625359092;1151;156;1855;1867;10.96;0.66;189.99;3.30;704;13;608.00;12
1155;13;625359103;1155;153;1855;1867;10.93;0.66;190.38;3.30;700;13;609.00;12
1157;13;625359113;1157;150;1855;1867;10.95;0.66;190.57;3.30;698;13;610.00;12
1161;13;625359124;1161;146;1857;1867;10.94;0.66;190.64;3.31;696;13;611.00;10
1164;14;625359142;1164;141;1868;1879;10.91;0.66;190.98;3.30;704;14;612.00;11
1166;14;625359161;1166;133;1869;1879;10.86;0.66;191.01;3.30;703;14;613.00;10
1171;14;625359172;1171;126;1869;1879;10.80;0.65;191.07;3.30;698;14;614.00;10
1173;14;625359183;1173;122;1871;1879;10.75;0.65;191.27;3.30;698;14;615.00;8
1176;14;625359193;1176;114;1871;1879;10.78;0.65;191.46;3.30;695;14;616.00;8
1179;14;625359203;1179;113;1871;1879;10.89;0.66;191.60;3.30;692;14;617.00;8
1181;14;625359213;1181;110;1875;1883;10.92;0.66;191.71;3.31;694;14;618.00;8
1183;14;625359224;1183;106;1875;1883;11.05;0.67;191.84;3.31;692;14;619.00;8
1186;14;625359239;1186;101;1878;1887;11.14;0.67;192.45;3.30;692;14;620.00;9
1189;14;625359250;1189;95;1879;1888;11.26;0.68;192.66;3.30;690;14;621.00;9
1194;14;625359261;1194;92;1880;1888;11.34;0.69;192.61;3.30;686;14;622.00;8
1198;14;625359271;1198;95;1880;1888;11.41;0.69;192.87;3.30;682;14;623.00;8
1201;14;625359282;1201;97;1889;1901;11.42;0.69;192.63;3.30;688;14;624.00;12
1204;14;625359293;1204;95;1889;1901;11.46;0.69;192.82;3.30;685;14;625.00;12
1206;14;625359304;1206;98;1889;1901;11.44;0.69;193.03;3.30;683;14;626.00;12
1206;14;625359314;1206;105;1890;1902;11.41;0.69;193.03;3.30;684;14;627.00;12
1209;14;625359324;1209;109;1890;1903;11.42;0.69;193.09;3.30;681;14;628.00;13
1211;14;625359335;1211;119;1890;1903;11.34;0.68;193.14;3.30;679;14;629.00;13
1212;14;625359347;1212;122;1896;1909;11.29;0.68;193.01;3.33;684;14;630.00;13
1216;14;625359359;1216;122;1896;1909;11.29;0.68;193.30;3.33;680;14;631.00;13
1220;14;625359369;1220;124;1898;1909;11.27;0.68;193.29;3.33;678;14;632.00;11
1221;14;625359379;1221;127;1899;1909;11.31;0.69;193.53;3.33;678;14;633.00;10
1222;14;625359389;1222;132;1902;1915;11.35;0.69;193.40;3.33;680;14;634.00;13
1224;14;625359399;1224;133;1903;1915;11.28;0.69;193.85;3.33;679;14;635.00;12
1228;14;625359410;1228;133;1904;1915;11.18;0.68;193.80;3.34;676;14;636.00;11
1228;14;625359419;1228;135;1905;1915;11.14;0.68;193.80;3.34;677;14;637.00;10
1230;14;625359429;1230;138;1908;1919;11.10;0.67;193.78;3.34;678;14;638.00;11
1232;14;625359441;1232;143;1910;1920;11.07;0.67;193.63;3.34;678;14;639.00;10
1236;14;625359459;1236;147;1912;1920;10.94;0.66;193.81;3.36;676;14;640.00;8
1236;14;625359471;1236;155;1913;1921;10.84;0.66;193.81;3.36;677;14;641.00;8
1238;14;625359481;1238;162;1916;1921;10.66;0.65;193.77;3.39;678;14;642.00;5
1240;14;625359491;1240;167;1916;1921;10.63;0.65;193.55;3.39;676;14;643.00;5
1240;14;625359507;1240;169;1916;1921;10.59;0.65;193.55;3.39;676;14;644.00;5
1240;14;625359520;1240;172;1917;1921;10.56;0.64;193.55;3.39;677;14;645.00;4
1240;14;625359529;1240;173;1918;1921;10.49;0.64;193.55;3.40;678;14;646.00;3
1242;14;625359539;1242;180;1918;1921;10.36;0.63;193.52;3.40;676;14;647.00;3
1245;14;625359548;1245;189;1958;1991;10.33;0.63;193.21;3.36;713;14;648.00;33
1247;14;625359563;1247;191;1960;1992;10.20;0.63;193.11;3.36;713;14;649.00;32
1249;14;625359573;1249;193;1971;1992;10.16;0.62;192.88;3.37;722;14;650.00;21
1251;14;625359583;1251;198;1975;1992;10.07;0.62;192.83;3.37;724;14;651.00;17
1251;14;625359594;1251;197;1980;1992;10.07;0.62;192.83;3.37;729;14;652.00;12
1253;14;625359603;1253;199;1982;1992;10.02;0.61;192.67;3.37;729;14;653.00;10
1253;14;625359615;1253;203;1985;1992;9.95;0.61;192.67;3.37;732;14;654.00;7
1255;14;625359631;1255;209;1988;1992;9.84;0.60;192.55;3.38;733;14;655.00;4
1257;14;625359641;1257;214;1990;1993;9.76;0.60;192.31;3.38;733;14;656.00;3
1259;14;625359650;1259;219;1993;1994;9.71;0.59;192.53;3.39;734;14;657.00;1
1262;14;625359660;1262;229;1994;1994;9.56;0.58;192.22;3.39;732;14;658.00;0
1262;14;625359679;1262;233;1998;1998;9.32;0.57;192.22;3.38;736;14;659.00;0
1263;14;625359692;1263;238;1998;1998;9.12;0.56;192.35;3.38;735;14;660.00;0
1265;14;625359701;1265;246;1998;1998;8.91;0.54;192.28;3.38;733;14;661.00;0
1266;14;625359711;1266;251;1998;1998;8.76;0.54;192.22;3.38;732;14;662.00;0
1269;14;625359719;1269;264;2003;2004;8.75;0.53;192.18;3.38;734;14;663.00;1
1270;14;625359729;1270;268;2003;2004;8.70;0.53;192.14;3.38;733;14;664.00;1
1271;14;625359738;1271;275;2004;2004;8.70;0.53;192.08;3.38;733;14;665.00;0
1271;14;625359748;1271;274;2006;2007;8.71;0.53;192.08;3.37;735;14;666.00;1
1271;14;625359757;1271;282;2007;2007;8.71;0.53;192.08;3.37;736;14;667.00;0
1272;14;625359767;1272;288;2007;2007;8.67;0.53;192.02;3.37;735;14;668.00;0
1272;14;625359775;1272;291;2008;2008;8.57;0.52;192.02;3.37;736;14;669.00;0
1274;14;625359784;1274;297;2009;2009;8.46;0.52;191.92;3.37;735;14;670.00;0
1275;14;625359793;1275;301;2009;2009;8.25;0.50;191.78;3.37;734;14;671.00;0
1276;14;625359802;1276;311;2022;2022;8.08;0.49;191.74;3.35;746;14;672.00;0
1283;14;625359811;1283;314;2022;2022;7.81;0.48;191.75;3.35;739;14;673.00;0
1288;14;625359820;1288;310;2022;2022;7.63;0.46;191.38;3.35;734;14;674.00;0
1291;14;625359829;1291;297;2024;2024;7.51;0.46;191.66;3.34;733;14;675.00;0
1295;14;625359838;1295;286;2024;2024;7.36;0.45;191.61;3.34;729;14;676.00;0
1296;14;625359847;1296;282;2027;2028;7.31;0.44;191.76;3.34;731;14;677.00;1
1297;14;625359855;1297;282;2028;2028;7.23;0.44;191.94;3.34;731;14;678.00;0
1300;14;625359864;1300;278;2032;2032;7.13;0.43;192.06;3.34;732;14;679.00;0
1304;14;625359872;1304;258;2032;2032;7.07;0.43;192.05;3.34;728;14;680.00;0
1307;14;625359881;1307;245;2032;2032;7.05;0.43;192.43;3.34;725;14;681.00;0
1307;15;625359896;1307;235;2032;2032;7.18;0.44;192.43;3.34;725;15;682.00;0
1310;15;625359919;1310;226;2032;2032;7.22;0.44;192.79;3.34;722;15;683.00;0
1311;15;625359928;1311;226;2043;2044;7.41;0.45;193.00;3.32;732;15;684.00;1
1314;15;625359939;1314;228;2043;2044;7.53;0.46;193.27;3.32;729;15;685.00;1
1319;15;625359955;1319;221;2044;2044;7.60;0.46;193.73;3.32;725;15;686.00;0
1320;15;625359964;1320;212;2044;2044;7.76;0.47;193.88;3.32;724;15;687.00;0
1323;15;625359980;1323;207;2044;2044;7.94;0.48;194.10;3.32;721;15;688.00;0
1325;15;625359989;1325;197;2044;2044;8.01;0.49;194.42;3.32;719;15;689.00;0
1326;15;625360000;1326;202;2045;2045;8.08;0.49;194.36;3.32;719;15;690.00;0
1328;15;625360009;1328;197;2045;2045;8.18;0.50;194.34;3.32;717;15;691.00;0
1329;15;625360019;1329;197;2050;2051;8.29;0.51;194.50;3.31;721;15;692.00;1
1332;15;625360029;1332;193;2052;2052;8.47;0.52;194.57;3.31;720;15;693.00;0
1333;15;625360039;1333;189;2052;2052;8.60;0.53;194.79;3.31;719;15;694.00;0
1335;15;625360048;1335;182;2052;2052;8.73;0.53;194.93;3.31;717;15;695.00;0
1337;15;625360057;1337;185;2056;2056;8.84;0.54;194.99;3.30;719;15;696.00;0
1343;15;625360067;1343;178;2056;2056;8.87;0.54;195.24;3.30;713;15;697.00;0
1345;15;625360077;1345;177;2056;2056;8.91;0.54;195.25;3.30;711;15;698.00;0
1350;15;625360087;1350;175;2057;2057;8.98;0.55;195.53;3.30;707;15;699.00;0
1356;15;625360097;1356;174;2060;2061;9.09;0.55;195.78;3.30;704;15;700.00;1
1360;15;625360111;1360;164;2060;2061;9.20;0.56;195.77;3.30;700;15;701.00;1
1366;15;625360121;1366;155;2062;2064;9.28;0.57;196.49;3.29;696;15;702.00;2
1373;15;625360132;1373;155;2064;2064;9.39;0.57;196.69;3.29;691;15;703.00;0
1375;15;625360143;1375;157;2064;2064;9.50;0.58;196.75;3.29;689;15;704.00;0
1380;15;625360152;1380;153;2064;2064;9.57;0.58;196.98;3.29;684;15;705.00;0
1384;15;625360162;1384;155;2067;2068;9.68;0.59;197.01;3.29;683;15;706.00;1
1388;15;625360172;1388;151;2067;2068;9.68;0.59;197.33;3.29;679;15;707.00;1
1394;15;625360188;1394;153;2068;2068;9.74;0.59;197.39;3.29;674;15;708.00;0
1399;15;625360198;1399;155;2068;2068;9.76;0.60;197.20;3.29;669;15;709.00;0
1404;15;625360208;1404;154;2069;2069;9.75;0.60;197.50;3.29;665;15;710.00;0
1408;15;625360219;1408;152;2070;2070;9.74;0.59;197.57;3.29;662;15;711.00;0
1417;15;625360229;1417;152;2070;2070;9.68;0.59;197.78;3.29;653;15;712.00;0
1420;15;625360239;1420;148;2071;2071;9.77;0.59;197.91;3.29;651;15;713.00;0
1422;15;625360250;1422;154;2071;2071;9.89;0.60;198.00;3.29;649;15;714.00;0
1427;15;625360259;1427;154;2071;2071;9.96;0.61;198.28;3.29;644;15;715.00;0
1432;15;625360276;1432;150;2071;2071;10.02;0.61;198.33;3.29;639;15;716.00;0
1435;15;625360286;1435;151;2071;2071;10.11;0.62;198.44;3.29;636;15;717.00;0
1441;15;625360296;1441;150;2071;2071;10.03;0.61;198.58;3.29;630;15;718.00;0
1443;15;625360305;1443;149;2071;2071;10.08;0.61;198.83;3.29;628;15;719.00;0
1448;15;625360317;1448;187;2192;2301;9.99;0.63;198.97;3.11;744;15;720.00;109
1449;15;625360346;1449;179;2202;2302;9.99;0.63;199.08;3.10;753;15;721.00;100
1453;15;625360362;1453;162;2214;2302;10.07;0.63;199.35;3.09;761;15;722.00;88
1457;15;625360373;1457;160;2222;2302;10.04;0.63;199.52;3.09;765;15;723.00;80
1459;15;625360390;1459;162;2228;2302;9.97;0.62;199.74;3.09;769;15;724.00;74
1462;15;625360400;1462;162;2236;2302;9.92;0.62;200.10;3.10;774;15;725.00;66
1466;15;625360417;1466;170;2243;2302;9.88;0.62;200.22;3.11;777;15;726.00;59
1468;15;625360428;1468;164;2248;2302;9.83;0.61;200.30;3.12;780;15;727.00;54
1474;15;625360439;1474;169;2254;2303;9.76;0.61;200.81;3.13;780;15;728.00;49
1477;15;625360451;1477;168;2256;2304;9.71;0.60;201.13;3.14;779;15;729.00;48
1478;15;625360462;1478;171;2261;2304;9.64;0.60;201.09;3.15;783;15;730.00;43
1481;15;625360475;1481;180;2266;2305;9.58;0.60;201.51;3.16;785;15;731.00;39
1485;15;625360487;1485;183;2267;2305;9.58;0.60;201.72;3.17;782;15;732.00;38
1487;15;625360499;1487;193;2273;2305;9.66;0.60;201.68;3.19;786;15;733.00;32
1492;15;625360511;1492;196;2275;2305;9.64;0.60;201.93;3.20;783;15;734.00;30
1493;15;625360533;1493;209;2280;2309;9.65;0.60;202.03;3.21;787;15;735.00;29
1498;15;625360550;1498;204;2281;2309;9.60;0.60;202.38;3.22;783;15;736.00;28
1502;15;625360561;1502;198;2285;2309;9.60;0.60;202.63;3.24;783;15;737.00;24
1505;15;625360573;1505;194;2289;2312;9.72;0.60;202.67;3.26;784;15;738.00;23
1509;15;625360586;1509;193;2293;2312;9.82;0.61;202.81;3.28;784;15;739.00;19
1513;15;625360598;1513;190;2294;2312;9.88;0.61;202.94;3.29;781;15;740.00;18
1516;15;625360610;1516;192;2301;2316;9.91;0.61;203.11;3.30;785;15;741.00;15
1517;15;625360623;1517;190;2302;2317;10.10;0.62;203.25;3.30;785;15;742.00;15
1520;15;625360635;1520;195;2303;2317;10.26;0.63;203.58;3.31;783;15;743.00;14
1522;15;625360648;1522;197;2308;2321;10.36;0.64;203.56;3.32;786;15;744.00;13
1528;15;625360660;1528;198;2308;2321;10.37;0.64;203.69;3.32;780;15;745.00;13
1530;15;625360672;1530;196;2310;2321;10.43;0.64;203.89;3.33;780;15;746.00;11
1534;15;625360684;1534;194;2311;2322;10.49;0.64;204.30;3.33;777;15;747.00;11
1536;15;625360696;1536;194;2311;2322;10.50;0.64;204.35;3.33;775;15;748.00;11
1540;15;625360709;1540;194;2317;2328;10.44;0.64;204.56;3.33;777;15;749.00;11
1543;15;625360729;1543;192;2317;2328;10.44;0.64;204.66;3.33;774;15;750.00;11
1546;15;625360747;1546;185;2318;2329;10.44;0.64;204.69;3.33;772;15;751.00;11
1551;15;625360760;1551;183;2320;2329;10.41;0.63;204.92;3.34;769;15;752.00;9
1552;15;625360772;1552;184;2321;2329;10.36;0.63;204.91;3.34;769;15;753.00;8
1554;15;625360783;1554;187;2321;2329;10.34;0.63;204.83;3.34;767;15;754.00;8
1559;15;625360794;1559;194;2322;2329;10.36;0.63;204.98;3.36;763;15;755.00;7
1562;15;625360806;1562;196;2334;2341;10.35;0.63;205.09;3.34;772;15;756.00;7
1566;15;625360819;1566;197;2334;2341;10.36;0.63;205.43;3.34;768;15;757.00;7
1568;15;625360831;1568;199;2334;2341;10.37;0.63;205.40;3.34;766;15;758.00;7
1571;15;625360847;1571;202;2334;2341;10.41;0.63;205.54;3.34;763;15;759.00;7
1575;15;625360858;1575;206;2334;2341;10.35;0.63;205.56;3.34;759;15;760.00;7
1578;15;625360870;1578;212;2334;2341;10.40;0.63;205.55;3.34;756;15;761.00;7
1581;15;625360887;1581;216;2338;2345;10.34;0.63;205.50;3.33;757;15;762.00;7
1581;15;625360904;1581;218;2338;2345;10.39;0.63;205.50;3.33;757;15;763.00;7
1583;15;625360914;1583;221;2341;2349;10.43;0.63;205.49;3.33;758;15;764.00;8
1585;15;625360928;1585;222;2343;2351;10.37;0.63;205.92;3.33;758;15;765.00;8
1587;15;625360947;1587;228;2344;2351;10.32;0.63;205.77;3.33;757;15;766.00;7
1587;16;625360972;1587;227;2344;2351;10.22;0.62;205.77;3.33;757;16;767.00;7
1588;16;625361015;1588;229;2355;2364;10.14;0.62;205.76;3.31;767;16;768.00;9
1591;16;625361032;1591;224;2355;2364;10.04;0.61;205.95;3.31;764;16;769.00;9
1595;16;625361048;1595;218;2355;2364;9.94;0.60;206.01;3.31;760;16;770.00;9
1596;16;625361061;1596;217;2356;2365;9.93;0.61;206.00;3.31;760;16;771.00;9
1596;16;625361073;1596;215;2356;2366;9.93;0.61;206.00;3.31;760;16;772.00;10
1600;16;625361084;1600;215;2356;2366;9.89;0.60;206.12;3.31;756;16;773.00;10
1602;16;625361096;1602;210;2358;2369;9.86;0.60;206.28;3.31;756;16;774.00;11
1602;16;625361115;1602;205;2358;2369;9.85;0.60;206.28;3.31;756;16;775.00;11
1606;16;625361127;1606;210;2359;2369;9.83;0.60;206.48;3.31;753;16;776.00;10
1607;16;625361151;1607;205;2359;2369;9.82;0.60;206.62;3.31;752;16;777.00;10
1611;16;625361163;1611;211;2363;2375;9.77;0.60;206.94;3.31;752;16;778.00;12
1614;16;625361173;1614;211;2363;2375;9.68;0.59;207.19;3.31;749;16;779.00;12
1620;16;625361186;1620;204;2364;2375;9.60;0.58;207.50;3.30;744;16;780.00;11
1623;16;625361198;1623;204;2364;2375;9.47;0.58;207.70;3.30;741;16;781.00;11
1629;16;625361207;1629;198;2367;2379;9.42;0.57;207.74;3.30;738;16;782.00;12
1631;16;625361227;1631;200;2368;2380;9.36;0.57;208.12;3.30;737;16;783.00;12
1633;16;625361237;1633;201;2368;2380;9.36;0.57;208.08;3.30;735;16;784.00;12
1635;16;625361247;1635;198;2369;2381;9.36;0.57;208.06;3.30;734;16;785.00;12
1639;16;625361258;1639;193;2370;2381;9.28;0.57;207.99;3.30;731;16;786.00;11
1641;16;625361268;1641;190;2370;2381;9.22;0.56;207.95;3.30;729;16;787.00;11
1643;16;625361278;1643;174;2370;2381;9.25;0.57;207.86;3.30;727;16;788.00;11
1647;16;625361288;1647;174;2370;2381;9.20;0.56;207.69;3.30;723;16;789.00;11
1649;16;625361297;1649;171;2370;2381;9.13;0.56;207.54;3.30;721;16;790.00;11
1652;16;625361307;1652;172;2370;2381;9.17;0.56;207.49;3.30;718;16;791.00;11
1653;16;625361317;1653;183;2403;2451;9.28;0.57;207.58;3.26;750;16;792.00;48
1655;16;625361333;1655;181;2403;2452;9.30;0.57;207.46;3.26;748;16;793.00;49
1657;16;625361343;1657;178;2411;2452;9.42;0.58;207.40;3.26;754;16;794.00;41
1660;16;625361354;1660;181;2415;2452;9.48;0.58;207.39;3.25;755;16;795.00;37
1662;16;625361364;1662;181;2420;2452;9.51;0.58;207.25;3.26;758;16;796.00;32
1663;16;625361374;1663;183;2424;2452;9.47;0.58;207.17;3.29;761;16;797.00;28
1665;16;625361385;1665;184;2425;2452;9.44;0.58;207.08;3.29;760;16;798.00;27
1667;16;625361395;1667;183;2426;2452;9.44;0.58;207.01;3.29;759;16;799.00;26
1669;16;625361407;1669;188;2431;2453;9.47;0.58;206.86;3.33;762;16;800.00;22
1673;16;625361421;1673;193;2436;2454;9.44;0.58;206.70;3.34;763;16;801.00;18
1673;16;625361432;1673;194;2438;2454;9.44;0.58;206.70;3.37;765;16;802.00;16
1677;16;625361442;1677;195;2441;2458;9.37;0.57;206.49;3.37;764;16;803.00;17
1678;16;625361453;1678;200;2444;2458;9.28;0.57;206.41;3.41;766;16;804.00;14
1679;16;625361463;1679;204;2444;2458;9.20;0.56;206.32;3.41;765;16;805.00;14
1682;16;625361474;1682;211;2445;2458;9.13;0.56;206.27;3.44;763;16;806.00;13
1686;16;625361484;1686;212;2449;2464;9.08;0.55;206.03;3.44;763;16;807.00;15
1688;16;625361495;1688;220;2450;2464;8.99;0.55;205.98;3.47;762;16;808.00;14
1689;16;625361506;1689;231;2451;2464;8.96;0.55;205.89;3.47;762;16;809.00;13
1692;16;625361517;1692;244;2455;2470;8.94;0.54;205.81;3.48;763;16;810.00;15
1695;16;625361528;1695;245;2458;2470;8.98;0.55;205.64;3.53;763;16;811.00;12
1697;16;625361538;1697;251;2460;2470;8.92;0.54;205.58;3.53;763;16;812.00;10
1700;16;625361548;1700;256;2462;2471;8.85;0.54;205.48;3.56;762;16;813.00;9
1700;16;625361559;1700;261;2466;2472;8.88;0.54;205.48;3.57;766;16;814.00;6
1702;16;625361569;1702;268;2466;2472;8.90;0.54;205.44;3.57;764;16;815.00;6
1702;16;625361579;1702;277;2477;2485;8.93;0.54;205.44;3.57;775;16;816.00;8
1703;16;625361590;1703;280;2477;2485;8.95;0.54;205.33;3.57;774;16;817.00;8
1705;16;625361601;1705;283;2477;2485;8.87;0.54;205.20;3.57;772;16;818.00;8
1708;16;625361610;1708;289;2481;2486;8.81;0.54;204.96;3.59;773;16;819.00;5
1708;16;625361620;1708;296;2483;2486;8.76;0.53;204.96;3.60;775;16;820.00;3
1711;16;625361630;1711;303;2487;2490;8.72;0.53;204.94;3.60;776;16;821.00;3
1712;16;625361640;1712;304;2488;2490;8.58;0.52;204.83;3.60;776;16;822.00;2
1713;16;625361649;1713;309;2493;2494;8.57;0.52;204.83;3.60;780;16;823.00;1
1714;16;625361659;1714;311;2494;2494;8.50;0.52;204.81;3.60;780;16;824.00;0
1715;16;625361669;1715;314;2494;2494;8.39;0.51;204.71;3.60;779;16;825.00;0
1715;16;625361678;1715;319;2494;2494;8.24;0.50;204.71;3.60;779;16;826.00;0
1716;16;625361687;1716;309;2494;2494;8.16;0.50;204.61;3.60;778;16;827.00;0
1717;16;625361697;1717;298;2505;2506;8.10;0.50;204.71;3.58;788;16;828.00;1
1718;16;625361707;1718;291;2505;2506;8.08;0.49;204.67;3.58;787;16;829.00;1
1719;16;625361717;1719;285;2506;2506;8.12;0.50;204.68;3.58;787;16;830.00;0
1721;16;625361726;1721;278;2506;2506;8.16;0.50;204.76;3.58;785;16;831.00;0
1722;16;625361736;1722;276;2506;2506;8.20;0.50;204.70;3.58;784;16;832.00;0
1725;16;625361746;1725;272;2506;2506;8.23;0.50;204.66;3.58;781;16;833.00;0
1725;16;625361761;1725;267;2507;2507;8.28;0.50;204.66;3.58;782;16;834.00;0
1726;17;625361772;1726;265;2507;2507;8.37;0.51;204.61;3.58;781;17;835.00;0
1726;18;625361793;1726;261;2512;2513;8.53;0.52;204.61;3.57;786;18;836.00;1
1727;18;625361815;1727;259;2513;2514;8.60;0.52;204.56;3.57;786;18;837.00;1
1728;18;625361826;1728;263;2514;2514;8.64;0.53;204.51;3.57;786;18;838.00;0
1728;18;625361842;1728;262;2514;2514;8.63;0.53;204.51;3.57;786;18;839.00;0
1729;18;625361853;1729;264;2519;2519;8.67;0.53;204.47;3.57;790;18;840.00;0
1730;18;625361863;1730;272;2519;2519;8.60;0.53;204.35;3.57;789;18;841.00;0
1732;18;625361873;1732;275;2519;2519;8.54;0.52;204.34;3.57;787;18;842.00;0
1733;18;625361882;1733;275;2520;2520;8.46;0.52;204.34;3.57;787;18;843.00;0
1738;18;625361892;1738;281;2524;2524;8.42;0.51;204.47;3.56;786;18;844.00;0
1739;18;625361902;1739;277;2524;2524;8.41;0.51;204.59;3.56;785;18;845.00;0
1743;18;625361912;1743;283;2526;2527;8.37;0.51;204.94;3.56;783;18;846.00;1
1745;18;625361926;1745;285;2527;2527;8.26;0.51;205.06;3.56;782;18;847.00;0
1748;18;625361939;1748;286;2527;2527;8.06;0.49;205.29;3.56;779;18;848.00;0
1751;18;625361949;1751;290;2527;2527;7.94;0.49;205.59;3.56;776;18;849.00;0
1756;18;625361958;1756;278;2530;2531;7.87;0.48;205.83;3.55;774;18;850.00;1
1761;18;625361969;1761;274;2530;2531;7.83;0.48;206.20;3.55;769;18;851.00;1
1767;18;625361980;1767;267;2531;2531;7.80;0.48;206.29;3.55;764;18;852.00;0
1770;18;625361989;1770;261;2531;2531;7.87;0.48;206.47;3.55;761;18;853.00;0
1776;18;625361998;1776;263;2532;2532;7.89;0.48;206.90;3.55;756;18;854.00;0
1780;18;625362008;1780;260;2534;2534;8.01;0.49;207.06;3.55;754;18;855.00;0
1783;18;625362018;1783;253;2534;2534;8.05;0.49;207.24;3.55;751;18;856.00;0
1787;18;625362027;1787;238;2535;2535;8.18;0.50;207.36;3.55;748;18;857.00;0
1788;18;625362037;1788;223;2535;2535;8.30;0.51;207.50;3.55;747;18;858.00;0
1791;18;625362046;1791;213;2535;2535;8.35;0.51;207.70;3.55;744;18;859.00;0
1795;18;625362056;1795;208;2535;2535;8.38;0.51;207.95;3.55;740;18;860.00;0
1799;18;625362065;1799;203;2535;2535;8.43;0.52;208.23;3.55;736;18;861.00;0
1799;18;625362075;1799;199;2535;2535;8.55;0.52;208.23;3.55;736;18;862.00;0
1805;18;625362084;1805;192;2535;2535;8.60;0.53;208.17;3.55;730;18;863.00;0
1810;18;625362094;1810;200;2614;2662;8.77;0.54;208.56;3.44;804;18;864.00;48
1817;18;625362114;1817;188;2618;2663;8.83;0.55;208.25;3.44;801;18;865.00;45
1822;18;625362125;1822;188;2626;2663;9.05;0.56;208.51;3.43;804;18;866.00;37
1828;18;625362135;1828;185;2628;2663;9.19;0.57;208.83;3.43;800;18;867.00;35
1829;18;625362146;1829;182;2633;2663;9.34;0.58;208.77;3.44;804;18;868.00;30
1834;18;625362157;1834;183;2634;2663;9.35;0.58;208.79;3.44;800;18;869.00;29
1837;18;625362169;1837;174;2638;2663;9.39;0.58;208.68;3.44;801;18;870.00;25
1839;18;625362182;1839;176;2640;2663;9.40;0.58;208.81;3.44;801;18;871.00;23
1843;18;625362194;1843;178;2644;2664;9.41;0.58;209.11;3.45;801;18;872.00;20
1846;18;625362212;1846;183;2646;2665;9.38;0.58;209.24;3.45;800;18;873.00;19
1851;18;625362223;1851;183;2649;2665;9.39;0.58;209.32;3.46;798;18;874.00;16
1858;18;625362235;1858;188;2652;2666;9.33;0.57;209.71;3.47;794;18;875.00;14
1861;18;625362247;1861;192;2657;2666;9.38;0.58;209.90;3.48;796;18;876.00;9
1865;18;625362258;1865;202;2659;2666;9.38;0.58;209.91;3.49;794;18;877.00;7
1869;18;625362271;1869;203;2662;2666;9.42;0.58;210.11;3.50;793;18;878.00;4
1874;18;625362288;1874;209;2664;2670;9.42;0.58;210.43;3.50;790;18;879.00;6
1879;18;625362301;1879;214;2666;2670;9.41;0.58;210.55;3.51;787;18;880.00;4
1881;18;625362312;1881;212;2667;2670;9.40;0.58;210.73;3.51;786;18;881.00;3
1886;18;625362323;1886;212;2669;2673;9.37;0.58;210.95;3.51;783;18;882.00;4
1892;18;625362336;1892;213;2670;2673;9.39;0.58;211.04;3.51;778;18;883.00;3
1895;18;625362348;1895;212;2671;2673;9.40;0.58;211.15;3.51;776;18;884.00;2
1900;18;625362360;1900;211;2676;2677;9.47;0.58;211.09;3.51;776;18;885.00;1
1905;18;625362371;1905;214;2677;2678;9.49;0.58;211.00;3.51;772;18;886.00;1
1908;18;625362384;1908;214;2678;2678;9.51;0.58;211.15;3.51;770;18;887.00;0
1912;18;625362401;1912;214;2682;2682;9.53;0.58;211.22;3.50;770;18;888.00;0
1915;18;625362413;1915;212;2682;2682;9.51;0.58;211.38;3.50;767;18;889.00;0
1919;18;625362425;1919;212;2682;2682;9.48;0.58;211.51;3.50;763;18;890.00;0
1923;18;625362436;1923;216;2683;2683;9.52;0.58;211.40;3.50;760;18;891.00;0
1928;18;625362447;1928;222;2683;2683;9.46;0.58;211.50;3.50;755;18;892.00;0
1931;18;625362460;1931;224;2688;2689;9.42;0.57;211.66;3.50;757;18;893.00;1
1934;18;625362472;1934;228;2688;2689;9.35;0.57;211.55;3.50;754;18;894.00;1
1937;18;625362483;1937;230;2690;2690;9.21;0.56;211.84;3.50;753;18;895.00;0
1942;19;625362500;1942;230;2690;2690;9.03;0.55;211.91;3.50;748;19;896.00;0
1945;19;625362522;1945;219;2690;2690;8.91;0.54;212.16;3.50;745;19;897.00;0
1948;19;625362534;1948;213;2690;2690;8.86;0.54;212.43;3.50;742;19;898.00;0
1952;19;625362545;1952;208;2690;2690;8.81;0.54;212.86;3.50;738;19;899.00;0
1955;19;625362560;1955;216;2718;2736;8.79;0.54;213.16;3.46;763;19;900.00;18
1958;19;625362579;1958;206;2720;2736;8.83;0.54;213.40;3.46;762;19;901.00;16
1964;19;625362590;1964;201;2723;2736;8.97;0.55;213.43;3.46;759;19;902.00;13
1969;19;625362602;1969;201;2723;2736;9.06;0.56;213.88;3.46;754;19;903.00;13
1971;19;625362613;1971;204;2724;2736;9.13;0.56;213.95;3.46;753;19;904.00;12
1974;19;625362630;1974;200;2724;2736;9.18;0.56;213.99;3.46;750;19;905.00;12
1978;19;625362641;1978;188;2729;2740;9.18;0.56;214.00;3.45;751;19;906.00;11
1979;19;625362653;1979;183;2731;2740;9.18;0.56;214.16;3.46;752;19;907.00;9
1980;19;625362665;1980;176;2734;2744;9.20;0.56;214.27;3.46;754;19;908.00;10
1984;20;625362682;1984;172;2735;2745;9.30;0.57;214.37;3.46;751;20;909.00;10
1988;20;625362704;1988;174;2736;2745;9.36;0.57;214.40;3.46;748;20;910.00;9
1990;20;625362715;1990;173;2736;2745;9.43;0.58;214.48;3.46;746;20;911.00;9
1992;20;625362726;1992;177;2745;2758;9.45;0.58;214.63;3.45;753;20;912.00;13
1994;20;625362737;1994;176;2746;2758;9.46;0.58;214.73;3.45;752;20;913.00;12
1997;20;625362754;1997;174;2746;2758;9.46;0.58;214.80;3.45;749;20;914.00;12
2002;21;625362770;2002;175;2747;2759;9.45;0.58;214.88;3.45;745;21;915.00;12
2005;21;625362803;2005;183;2749;2760;9.42;0.58;215.09;3.45;744;21;916.00;11
2008;21;625362815;2008;179;2749;2760;9.51;0.58;215.18;3.45;741;21;917.00;11
2012;21;625362825;2012;178;2751;2763;9.53;0.58;215.11;3.45;739;21;918.00;12
2016;21;625362837;2016;178;2752;2763;9.47;0.58;215.15;3.46;736;21;919.00;11
2016;21;625362854;2016;173;2752;2763;9.52;0.58;215.15;3.46;736;21;920.00;11
2021;21;625362870;2021;167;2753;2763;9.48;0.58;215.36;3.46;732;21;921.00;10
2021;21;625362881;2021;164;2757;2769;9.49;0.58;215.36;3.46;736;21;922.00;12
2025;21;625362891;2025;159;2757;2769;9.48;0.58;215.30;3.46;732;21;923.00;12
2031;21;625362902;2031;159;2757;2769;9.46;0.58;215.38;3.46;726;21;924.00;12
2032;21;625362912;2032;159;2759;2769;9.50;0.58;215.47;3.47;727;21;925.00;10
2037;21;625362922;2037;161;2763;2773;9.42;0.57;215.32;3.47;726;21;926.00;10
2038;21;625362945;2038;165;2765;2774;9.48;0.58;215.34;3.47;727;21;927.00;9
2040;21;625362963;2040;168;2765;2774;9.53;0.58;215.28;3.47;725;21;928.00;9
2041;21;625362981;2041;169;2766;2775;9.56;0.58;215.35;3.47;725;21;929.00;9
2044;21;625362999;2044;175;2768;2775;9.51;0.58;215.23;3.49;724;21;930.00;7
2044;21;625363013;2044;182;2769;2775;9.45;0.57;215.23;3.49;725;21;931.00;6
2045;21;625363027;2045;187;2770;2775;9.34;0.57;215.23;3.50;725;21;932.00;5
2047;21;625363042;2047;192;2771;2775;9.30;0.56;215.27;3.50;724;21;933.00;4
2050;22;625363055;2050;203;2771;2775;9.22;0.56;215.15;3.50;721;22;934.00;4
2051;22;625363081;2051;207;2772;2775;9.22;0.56;215.18;3.50;721;22;935.00;3
2053;23;625363093;2053;229;2813;2845;8.99;0.55;215.23;3.45;760;23;936.00;32
2054;23;625363123;2054;227;2815;2846;8.97;0.55;215.21;3.46;761;23;937.00;31
2055;23;625363135;2055;227;2822;2846;9.00;0.55;215.20;3.46;767;23;938.00;24
2056;23;625363152;2056;234;2824;2846;8.96;0.55;215.19;3.46;768;23;939.00;22
2056;23;625363162;2056;233;2827;2846;8.92;0.54;215.19;3.46;771;23;940.00;19
2057;23;625363172;2057;235;2828;2846;8.87;0.54;215.19;3.46;771;23;941.00;18
2058;23;625363182;2058;240;2832;2846;8.88;0.54;215.26;3.46;774;23;942.00;14
2060;23;625363193;2060;239;2835;2846;8.88;0.54;215.22;3.46;775;23;943.00;11
2066;23;625363203;2066;236;2839;2847;8.88;0.54;215.08;3.47;773;23;944.00;8
2072;23;625363213;2072;235;2842;2849;8.84;0.54;215.37;3.47;770;23;945.00;7
2072;23;625363225;2072;231;2844;2849;8.89;0.54;215.37;3.47;772;23;946.00;5
2076;23;625363234;2076;224;2847;2853;8.74;0.53;215.40;3.47;771;23;947.00;6
2076;23;625363244;2076;223;2847;2853;8.70;0.53;215.40;3.47;771;23;948.00;6
2079;23;625363254;2079;214;2847;2853;8.57;0.52;215.34;3.47;768;23;949.00;6
2081;23;625363263;2081;213;2847;2853;8.48;0.52;215.35;3.47;766;23;950.00;6
2083;23;625363275;2083;210;2850;2859;8.40;0.52;215.29;3.47;767;23;951.00;9
2086;23;625363286;2086;199;2850;2859;8.33;0.51;215.44;3.47;764;23;952.00;9
2091;23;625363296;2091;194;2852;2859;8.24;0.51;215.60;3.48;761;23;953.00;7
2094;23;625363306;2094;189;2854;2862;8.29;0.51;215.49;3.48;760;23;954.00;8
2100;23;625363318;2100;195;2857;2862;8.24;0.51;215.54;3.48;757;23;955.00;5
2102;23;625363329;2102;190;2857;2862;8.21;0.50;215.51;3.48;755;23;956.00;5
2108;23;625363339;2108;193;2857;2863;8.20;0.50;215.43;3.48;749;23;957.00;6
2113;23;625363349;2113;199;2858;2864;8.23;0.50;215.30;3.48;745;23;958.00;6
2117;23;625363359;2117;196;2858;2864;8.33;0.51;215.43;3.48;741;23;959.00;6
2118;23;625363371;2118;197;2875;2890;8.37;0.51;215.34;3.46;757;23;960.00;15
2120;23;625363382;2120;193;2876;2890;8.44;0.52;215.26;3.46;756;23;961.00;14
2124;23;625363393;2124;193;2878;2890;8.50;0.52;215.33;3.46;754;23;962.00;12
2124;23;625363403;2124;198;2879;2891;8.58;0.52;215.33;3.46;755;23;963.00;12
2129;23;625363413;2129;200;2879;2891;8.64;0.53;215.26;3.46;750;23;964.00;12
2131;23;625363424;2131;199;2881;2895;8.72;0.53;215.12;3.46;750;23;965.00;14
2132;23;625363434;2132;203;2882;2895;8.75;0.53;215.14;3.46;750;23;966.00;13
2135;24;625363444;2135;207;2885;2899;8.74;0.53;214.99;3.45;750;24;967.00;14
2137;24;625363473;2137;210;2885;2899;8.75;0.53;214.97;3.45;748;24;968.00;14
2141;24;625363483;2141;216;2888;2899;8.71;0.53;214.85;3.48;747;24;969.00;11
2141;24;625363499;2141;215;2888;2899;8.70;0.53;214.85;3.48;747;24;970.00;11
2142;24;625363508;2142;222;2890;2899;8.69;0.53;214.76;3.50;748;24;971.00;9
2142;24;625363519;2142;218;2900;2911;8.75;0.53;214.76;3.49;758;24;972.00;11
2142;24;625363529;2142;227;2901;2911;8.74;0.53;214.76;3.49;759;24;973.00;10
2145;24;625363540;2145;227;2902;2911;8.70;0.53;214.78;3.50;757;24;974.00;9
2146;24;625363550;2146;226;2902;2911;8.66;0.53;214.80;3.50;756;24;975.00;9
2148;24;625363560;2148;229;2902;2911;8.65;0.53;214.75;3.50;754;24;976.00;9
2149;24;625363571;2149;232;2903;2911;8.61;0.53;214.71;3.50;754;24;977.00;8
2151;24;625363581;2151;237;2903;2912;8.54;0.52;214.69;3.50;752;24;978.00;9
2152;24;625363591;2152;230;2904;2912;8.55;0.52;214.71;3.51;752;24;979.00;8
2154;24;625363601;2154;231;2910;2918;8.61;0.53;214.94;3.52;756;24;980.00;8
2155;24;625363612;2155;228;2912;2919;8.69;0.53;214.96;3.52;757;24;981.00;7
2157;24;625363622;2157;227;2913;2919;8.70;0.53;215.00;3.52;756;24;982.00;6
2161;24;625363632;2161;223;2915;2919;8.71;0.53;214.88;3.54;754;24;983.00;4
2164;24;625363643;2164;223;2918;2923;8.77;0.53;214.87;3.53;754;24;984.00;5
2166;24;625363654;2166;221;2920;2923;8.84;0.54;214.87;3.54;754;24;985.00;3
2168;24;625363665;2168;217;2921;2923;8.94;0.54;214.77;3.54;753;24;986.00;2
2170;24;625363676;2170;214;2922;2924;9.04;0.55;214.67;3.54;752;24;987.00;2
2171;24;625363687;2171;214;2926;2928;9.06;0.55;214.64;3.54;755;24;988.00;2
2172;24;625363705;2172;214;2926;2928;9.10;0.55;214.55;3.54;754;24;989.00;2
2174;24;625363720;2174;213;2931;2934;9.19;0.56;214.49;3.54;757;24;990.00;3
2174;24;625363732;2174;219;2932;2934;9.28;0.56;214.49;3.54;758;24;991.00;2
2174;24;625363742;2174;217;2932;2934;9.26;0.56;214.49;3.54;758;24;992.00;2
2175;24;625363759;2175;216;2933;2934;9.27;0.57;214.45;3.54;758;24;993.00;1
2175;24;625363772;2175;219;2935;2938;9.27;0.57;214.45;3.54;760;24;994.00;3
2177;24;625363782;2177;219;2936;2938;9.17;0.56;214.55;3.54;759;24;995.00;2
2178;24;625363792;2178;216;2937;2938;9.08;0.56;214.55;3.54;759;24;996.00;1
2182;24;625363803;2182;219;2937;2938;9.01;0.55;214.66;3.54;755;24;997.00;1
2183;24;625363813;2183;226;2939;2939;8.91;0.54;214.62;3.54;756;24;998.00;0
2185;24;625363823;2185;224;2940;2940;8.78;0.54;214.60;3.53;755;24;999.00;0
2186;24;625363835;2186;221;2940;2940;8.70;0.53;214.53;3.53;754;24;1000.00;0
2187;25;625363850;2187;213;2941;2941;8.67;0.53;214.54;3.53;754;25;1001.00;0
2189;25;625363869;2189;212;2941;2941;8.63;0.53;214.63;3.53;752;25;1002.00;0
2190;25;625363879;2190;210;2941;2941;8.63;0.53;214.74;3.53;751;25;1003.00;0
2193;25;625363890;2193;213;2941;2941;8.62;0.53;214.87;3.53;748;25;1004.00;0
2198;25;625363905;2198;216;2941;2941;8.65;0.53;215.05;3.53;743;25;1005.00;0
2202;25;625363914;2202;214;2941;2941;8.67;0.53;215.19;3.53;739;25;1006.00;0
2203;25;625363924;2203;215;2941;2941;8.64;0.53;215.33;3.53;738;25;1007.00;0
2206;25;625363937;2206;241;3016;3068;8.77;0.54;215.43;3.45;810;25;1008.00;52
2208;25;625363957;2208;239;3019;3069;8.73;0.54;215.40;3.44;811;25;1009.00;50
2210;25;625363968;2210;228;3029;3069;8.82;0.55;215.69;3.44;819;25;1010.00;40
2216;25;625363978;2216;228;3033;3069;8.77;0.54;215.83;3.44;817;25;1011.00;36
2219;25;625363988;2219;232;3042;3069;8.75;0.54;216.15;3.44;823;25;1012.00;27
2222;25;625363997;2222;235;3045;3069;8.75;0.54;216.18;3.44;823;25;1013.00;24
2225;25;625364007;2225;234;3051;3069;8.77;0.54;216.27;3.45;826;25;1014.00;18
2232;25;625364017;2232;234;3054;3069;8.75;0.54;216.34;3.45;822;25;1015.00;15
2239;25;625364027;2239;244;3060;3070;8.66;0.53;216.51;3.46;821;25;1016.00;10
2240;25;625364037;2240;245;3060;3071;8.59;0.53;216.63;3.46;820;25;1017.00;11
2246;25;625364047;2246;247;3063;3071;8.46;0.52;216.83;3.46;817;25;1018.00;8
2248;25;625364062;2248;250;3064;3072;8.30;0.51;216.95;3.46;816;25;1019.00;8
2251;25;625364074;2251;239;3066;3072;8.20;0.50;217.35;3.47;815;25;1020.00;6
2257;25;625364083;2257;233;3067;3072;8.12;0.50;217.63;3.47;810;25;1021.00;5
2260;25;625364094;2260;225;3068;3072;8.08;0.50;217.73;3.47;808;25;1022.00;4
2264;25;625364104;2264;225;3072;3076;8.11;0.50;218.19;3.48;808;25;1023.00;4
2267;25;625364114;2267;227;3074;3076;8.10;0.50;218.19;3.49;807;25;1024.00;2
2271;25;625364125;2271;236;3075;3076;8.13;0.50;218.48;3.49;804;25;1025.00;1
2275;25;625364135;2275;233;3078;3079;8.15;0.50;218.72;3.48;803;25;1026.00;1
2279;25;625364146;2279;230;3078;3079;8.20;0.50;219.14;3.48;799;25;1027.00;1
2284;25;625364157;2284;218;3079;3079;8.25;0.50;219.44;3.48;795;25;1028.00;0
2288;25;625364168;2288;216;3083;3083;8.34;0.51;219.65;3.48;795;25;1029.00;0
2290;25;625364179;2290;212;3084;3084;8.54;0.52;219.87;3.48;794;25;1030.00;0
2293;25;625364190;2293;206;3084;3084;8.58;0.53;220.12;3.48;791;25;1031.00;0
2298;25;625364201;2298;206;3088;3088;8.69;0.53;220.13;3.47;790;25;1032.00;0
2303;25;625364211;2303;193;3088;3088;8.75;0.54;220.28;3.47;785;25;1033.00;0
2306;25;625364223;2306;191;3088;3088;8.85;0.54;220.40;3.47;782;25;1034.00;0
2309;25;625364234;2309;187;3090;3090;8.92;0.55;220.41;3.47;781;25;1035.00;0
2313;25;625364245;2313;189;3090;3090;8.99;0.55;220.68;3.47;777;25;1036.00;0
2317;25;625364257;2317;188;3095;3096;9.06;0.56;220.77;3.47;778;25;1037.00;1
2321;25;625364268;2321;181;3095;3096;9.09;0.56;221.05;3.47;774;25;1038.00;1
2324;25;625364280;2324;182;3097;3097;9.12;0.56;221.08;3.47;773;25;1039.00;0
2331;25;625364291;2331;176;3097;3097;9.14;0.56;221.25;3.47;766;25;1040.00;0
2333;25;625364302;2333;175;3097;3097;9.23;0.57;221.30;3.47;764;25;1041.00;0
2337;25;625364319;2337;175;3097;3097;9.24;0.57;221.31;3.47;760;25;1042.00;0
2343;25;625364330;2343;174;3097;3097;9.27;0.57;221.55;3.47;754;25;1043.00;0
2347;25;625364342;2347;175;3108;3109;9.37;0.57;221.66;3.46;761;25;1044.00;1
2355;25;625364354;2355;169;3108;3109;9.45;0.58;222.01;3.46;753;25;1045.00;1
2359;25;625364365;2359;166;3109;3109;9.57;0.58;222.06;3.45;750;25;1046.00;0
2362;25;625364377;2362;165;3109;3109;9.62;0.59;222.29;3.45;747;25;1047.00;0
2365;25;625364388;2365;168;3109;3109;9.68;0.59;222.30;3.45;744;25;1048.00;0
2370;25;625364399;2370;171;3109;3109;9.70;0.59;222.36;3.45;739;25;1049.00;0
2374;25;625364412;2374;172;3115;3115;9.79;0.60;222.52;3.45;741;25;1050.00;0
2379;25;625364424;2379;170;3115;3115;9.87;0.60;222.88;3.45;736;25;1051.00;0
2380;25;625364436;2380;174;3118;3119;9.95;0.61;222.84;3.45;738;25;1052.00;1
2383;25;625364447;2383;179;3120;3120;9.99;0.61;222.97;3.45;737;25;1053.00;0
2388;25;625364459;2388;181;3120;3120;9.98;0.61;223.16;3.45;732;25;1054.00;0
2398;25;625364471;2398;178;3120;3120;9.96;0.61;223.27;3.45;722;25;1055.00;0
2401;25;625364483;2401;180;3131;3133;10.03;0.61;223.23;3.43;730;25;1056.00;2
2409;25;625364495;2409;176;3131;3133;10.10;0.62;223.50;3.43;722;25;1057.00;2
2411;25;625364506;2411;177;3133;3133;10.11;0.62;223.55;3.43;722;25;1058.00;0
2415;25;625364517;2415;179;3134;3134;10.18;0.62;223.68;3.43;719;25;1059.00;0
2421;25;625364528;2421;181;3135;3135;10.17;0.62;223.74;3.43;714;25;1060.00;0
2424;25;625364540;2424;181;3135;3135;10.11;0.62;223.87;3.43;711;25;1061.00;0
2431;25;625364550;2431;183;3137;3138;10.04;0.61;224.04;3.43;706;25;1062.00;1
2434;25;625364568;2434;188;3137;3138;9.95;0.61;224.16;3.43;703;25;1063.00;1
2439;25;625364580;2439;190;3138;3138;9.85;0.60;224.06;3.43;699;25;1064.00;0
2442;25;625364591;2442;198;3138;3138;9.77;0.59;224.16;3.43;696;25;1065.00;0
2445;25;625364601;2445;203;3142;3144;9.69;0.59;224.05;3.43;697;25;1066.00;2
2447;25;625364613;2447;194;3143;3144;9.62;0.58;224.03;3.42;696;25;1067.00;1
2450;25;625364623;2450;191;3144;3144;9.57;0.58;224.05;3.42;694;25;1068.00;0
2453;25;625364634;2453;189;3144;3144;9.50;0.58;224.10;3.42;691;25;1069.00;0
2456;25;625364645;2456;186;3148;3148;9.45;0.57;224.04;3.42;692;25;1070.00;0
2458;25;625364656;2458;189;3149;3149;9.44;0.57;224.11;3.42;691;25;1071.00;0
2463;25;625364666;2463;192;3149;3149;9.40;0.57;224.06;3.42;686;25;1072.00;0
2465;25;625364677;2465;195;3150;3150;9.38;0.57;224.38;3.42;685;25;1073.00;0
2467;25;625364687;2467;196;3150;3150;9.35;0.57;224.31;3.42;683;25;1074.00;0
2469;25;625364698;2469;199;3150;3150;9.31;0.56;224.27;3.42;681;25;1075.00;0
2470;25;625364714;2470;189;3150;3150;9.32;0.56;224.32;3.42;680;25;1076.00;0
2472;25;625364724;2472;177;3150;3150;9.29;0.56;224.33;3.42;678;25;1077.00;0
2474;25;625364735;2474;169;3150;3150;9.30;0.56;224.32;3.42;676;25;1078.00;0
2477;25;625364745;2477;162;3150;3150;9.31;0.56;224.39;3.42;673;25;1079.00;0
2478;25;625364757;2478;194;3233;3275;9.07;0.56;224.33;3.33;755;25;1080.00;42
2479;25;625364782;2479;180;3236;3276;9.09;0.56;224.44;3.33;757;25;1081.00;40
2480;25;625364794;2480;160;3241;3276;9.17;0.56;224.40;3.33;761;25;1082.00;35
2482;25;625364804;2482;157;3247;3276;9.24;0.57;224.67;3.33;765;25;1083.00;29
2485;25;625364816;2485;150;3251;3276;9.25;0.57;224.84;3.33;766;25;1084.00;25
2487;25;625364832;2487;149;3254;3276;9.26;0.57;224.93;3.33;767;25;1085.00;22
2490;25;625364849;2490;154;3260;3276;9.26;0.57;225.16;3.33;770;25;1086.00;16
2492;25;625364859;2492;151;3261;3276;9.26;0.57;225.25;3.34;769;25;1087.00;15
2494;25;625364871;2494;157;3265;3277;9.24;0.57;225.27;3.34;771;25;1088.00;12
2499;25;625364881;2499;154;3265;3278;9.18;0.56;225.35;3.34;766;25;1089.00;13
2501;25;625364893;2501;154;3266;3278;9.10;0.56;225.46;3.34;765;25;1090.00;12
2505;25;625364904;2505;162;3272;3282;9.02;0.55;225.53;3.34;767;25;1091.00;10
2506;25;625364921;2506;165;3273;3282;8.96;0.55;225.56;3.34;767;25;1092.00;9
2508;25;625364933;2508;171;3274;3282;8.88;0.54;225.54;3.35;766;25;1093.00;8
2508;25;625364948;2508;182;3275;3282;8.83;0.54;225.54;3.35;767;25;1094.00;7
2510;25;625364966;2510;186;3280;3288;8.77;0.54;225.43;3.35;770;25;1095.00;8
2512;25;625364985;2512;186;3280;3288;8.73;0.53;225.39;3.35;768;25;1096.00;8
2514;25;625365002;2514;193;3281;3288;8.71;0.53;225.36;3.35;767;25;1097.00;7
2515;25;625365028;2515;201;3283;3291;8.78;0.54;225.35;3.35;768;25;1098.00;8
2517;25;625365041;2517;210;3284;3291;8.73;0.53;225.31;3.35;767;25;1099.00;7
2518;25;625365056;2518;214;3285;3291;8.67;0.53;225.29;3.35;767;25;1100.00;6
2519;25;625365073;2519;217;3286;3292;8.62;0.53;225.40;3.35;767;25;1101.00;6
2521;25;625365086;2521;224;3287;3293;8.61;0.53;225.43;3.35;766;25;1102.00;6
2524;25;625365097;2524;231;3287;3293;8.57;0.52;225.27;3.35;763;25;1103.00;6
2527;25;625365108;2527;242;3297;3306;8.44;0.52;225.14;3.34;770;25;1104.00;9
2528;25;625365120;2528;249;3297;3306;8.40;0.51;225.09;3.34;769;25;1105.00;9
2532;25;625365130;2532;254;3297;3306;8.37;0.51;224.99;3.34;765;25;1106.00;9
2532;25;625365144;2532;262;3298;3307;8.33;0.51;224.99;3.34;766;25;1107.00;9
2534;25;625365158;2534;268;3298;3307;8.36;0.51;224.90;3.34;764;25;1108.00;9
2534;25;625365169;2534;273;3301;3311;8.42;0.52;224.90;3.33;767;25;1109.00;10
2539;25;625365181;2539;270;3302;3311;8.36;0.51;224.73;3.33;763;25;1110.00;9
2540;25;625365191;2540;258;3305;3315;8.35;0.51;224.68;3.33;765;25;1111.00;10
2544;25;625365202;2544;256;3305;3315;8.37;0.51;224.53;3.33;761;25;1112.00;10
2547;25;625365214;2547;254;3305;3315;8.39;0.51;224.46;3.33;758;25;1113.00;10
2549;25;625365225;2549;251;3305;3315;8.37;0.51;224.47;3.33;756;25;1114.00;10
2550;25;625365241;2550;249;3305;3315;8.33;0.51;224.42;3.33;755;25;1115.00;10
2550;25;625365254;2550;245;3315;3327;8.36;0.51;224.42;3.32;765;25;1116.00;12
2554;25;625365270;2554;245;3315;3327;8.29;0.51;224.36;3.32;761;25;1117.00;12
2558;25;625365285;2558;241;3316;3327;8.24;0.50;224.22;3.32;758;25;1118.00;11
2559;25;625365298;2559;234;3316;3327;8.22;0.50;224.23;3.32;757;25;1119.00;11
2561;25;625365309;2561;232;3316;3327;8.17;0.50;224.26;3.32;755;25;1120.00;11
2564;25;625365319;2564;229;3316;3327;8.09;0.49;224.29;3.32;752;25;1121.00;11
2564;25;625365329;2564;231;3317;3328;8.03;0.49;224.29;3.33;753;25;1122.00;11
2566;25;625365338;2566;233;3318;3328;7.95;0.49;224.37;3.34;752;25;1123.00;10
2570;25;625365347;2570;234;3322;3334;7.95;0.49;224.53;3.33;752;25;1124.00;12
2573;25;625365357;2573;228;3326;3336;7.95;0.48;224.47;3.34;753;25;1125.00;10
2578;25;625365367;2578;228;3327;3336;7.95;0.48;224.37;3.34;749;25;1126.00;9
2578;25;625365377;2578;235;3327;3336;7.93;0.48;224.37;3.34;749;25;1127.00;9
2580;25;625365386;2580;228;3331;3340;7.93;0.48;224.40;3.35;751;25;1128.00;9
2582;25;625365396;2582;227;3331;3340;7.92;0.48;224.36;3.35;749;25;1129.00;9
2584;25;625365405;2584;225;3331;3340;7.94;0.48;224.32;3.35;747;25;1130.00;9
2584;25;625365414;2584;210;3333;3341;8.07;0.49;224.32;3.37;749;25;1131.00;8
2584;25;625365430;2584;204;3336;3345;8.26;0.50;224.32;3.36;752;25;1132.00;9
2584;25;625365440;2584;196;3337;3345;8.45;0.51;224.32;3.38;753;25;1133.00;8
2585;25;625365449;2585;188;3339;3348;8.64;0.52;224.32;3.38;754;25;1134.00;9
2587;25;625365460;2587;186;3340;3348;8.75;0.53;224.20;3.38;753;25;1135.00;8
2589;25;625365472;2589;174;3341;3348;8.89;0.54;224.15;3.39;752;25;1136.00;7
2591;25;625365482;2591;172;3341;3348;8.98;0.54;224.08;3.39;750;25;1137.00;7
2593;25;625365499;2593;169;3344;3352;9.13;0.55;223.98;3.39;751;25;1138.00;8
2596;26;625365509;2596;165;3344;3352;9.23;0.56;223.89;3.39;748;26;1139.00;8
2596;26;625365534;2596;160;3345;3352;9.39;0.57;223.89;3.39;749;26;1140.00;7
2598;26;625365544;2598;154;3345;3352;9.44;0.57;223.88;3.39;747;26;1141.00;7
2599;26;625365555;2599;155;3345;3353;9.53;0.58;223.92;3.39;746;26;1142.00;8
2600;26;625365565;2600;154;3346;3354;9.60;0.58;223.93;3.39;746;26;1143.00;8
2601;26;625365575;2601;154;3346;3354;9.66;0.59;223.95;3.39;745;26;1144.00;8
2603;26;625365586;2603;157;3347;3355;9.74;0.59;223.90;3.39;744;26;1145.00;8
2604;26;625365603;2604;156;3347;3355;9.81;0.60;223.92;3.39;743;26;1146.00;8
2606;26;625365613;2606;156;3347;3355;9.82;0.60;223.86;3.39;741;26;1147.00;8
2608;26;625365625;2608;155;3347;3355;9.83;0.60;223.83;3.39;739;26;1148.00;8
2608;26;625365635;2608;160;3347;3355;9.88;0.60;223.83;3.39;739;26;1149.00;8
2610;26;625365646;2610;162;3348;3355;9.90;0.60;223.80;3.40;738;26;1150.00;7
2611;26;625365657;2611;161;3349;3355;9.95;0.60;223.77;3.41;738;26;1151.00;6
2612;26;625365667;2612;181;3417;3482;9.93;0.61;223.77;3.35;805;26;1152.00;65
2615;26;625365688;2615;176;3419;3483;9.94;0.61;223.89;3.36;804;26;1153.00;64
2616;26;625365700;2616;171;3428;3483;10.04;0.62;224.03;3.35;812;26;1154.00;55
2623;26;625365712;2623;171;3435;3483;9.98;0.61;224.05;3.36;812;26;1155.00;48
2624;26;625365723;2624;170;3442;3483;10.01;0.62;224.14;3.36;818;26;1156.00;41
2625;26;625365734;2625;168;3448;3483;10.00;0.62;224.31;3.37;823;26;1157.00;35
2628;26;625365745;2628;164;3452;3483;9.91;0.61;224.33;3.38;824;26;1158.00;31
2628;26;625365763;2628;169;3455;3483;9.90;0.61;224.33;3.38;827;26;1159.00;28
2630;26;625365775;2630;175;3462;3484;9.92;0.61;224.54;3.39;832;26;1160.00;22
2634;26;625365787;2634;176;3463;3485;9.91;0.61;224.45;3.39;829;26;1161.00;22
2635;26;625365799;2635;177;3468;3485;9.89;0.61;224.40;3.40;833;26;1162.00;17
2639;26;625365810;2639;183;3470;3486;9.78;0.60;224.45;3.40;831;26;1163.00;16
2641;26;625365823;2641;190;3472;3486;9.62;0.59;224.58;3.41;831;26;1164.00;14
2643;26;625365834;2643;194;3473;3486;9.48;0.58;224.66;3.41;830;26;1165.00;13
2645;26;625365846;2645;203;3476;3486;9.38;0.58;224.81;3.42;831;26;1166.00;10
2648;26;625365857;2648;211;3479;3490;9.26;0.57;224.85;3.42;831;26;1167.00;11
2648;26;625365870;2648;223;3483;3490;9.14;0.56;224.85;3.43;835;26;1168.00;7
2654;26;625365881;2654;220;3483;3490;8.96;0.55;224.83;3.43;829;26;1169.00;7
2656;26;625365895;2656;224;3487;3496;8.89;0.55;224.94;3.44;831;26;1170.00;9
2659;26;625365908;2659;228;3488;3496;8.85;0.54;224.99;3.44;829;26;1171.00;8
2661;26;625365920;2661;230;3489;3496;8.79;0.54;225.05;3.44;828;26;1172.00;7
2666;26;625365934;2666;231;3493;3500;8.67;0.53;225.29;3.43;827;26;1173.00;7
2669;26;625365947;2669;235;3495;3501;8.61;0.53;225.38;3.43;826;26;1174.00;6
2672;26;625365959;2672;233;3495;3501;8.61;0.53;225.60;3.43;823;26;1175.00;6
2675;26;625365972;2675;234;3500;3505;8.61;0.53;225.61;3.43;825;26;1176.00;5
2678;26;625365985;2678;232;3501;3505;8.62;0.53;225.85;3.43;823;26;1177.00;4
2681;26;625365998;2681;234;3501;3505;8.58;0.52;225.91;3.43;820;26;1178.00;4
2685;26;625366008;2685;229;3503;3506;8.57;0.52;226.13;3.43;818;26;1179.00;3
2687;26;625366020;2687;233;3503;3506;8.49;0.52;226.17;3.43;816;26;1180.00;3
2691;26;625366031;2691;237;3508;3512;8.43;0.51;226.31;3.43;817;26;1181.00;4
2695;26;625366043;2695;240;3508;3512;8.34;0.51;226.32;3.43;813;26;1182.00;4
2697;26;625366054;2697;249;3510;3513;8.28;0.50;226.29;3.43;813;26;1183.00;3
2700;26;625366065;2700;247;3510;3513;8.20;0.50;226.25;3.43;810;26;1184.00;3
2702;26;625366076;2702;251;3510;3513;8.20;0.50;226.21;3.43;808;26;1185.00;3
2706;26;625366087;2706;243;3510;3513;8.04;0.49;226.39;3.43;804;26;1186.00;3
2711;26;625366105;2711;245;3510;3513;7.93;0.48;226.40;3.43;799;26;1187.00;3
2715;26;625366120;2715;250;3521;3525;7.86;0.48;226.60;3.42;806;26;1188.00;4
2716;26;625366131;2716;248;3521;3525;7.82;0.48;226.74;3.42;805;26;1189.00;4
2722;26;625366141;2722;239;3522;3525;7.72;0.47;227.04;3.42;800;26;1190.00;3
2726;26;625366151;2726;230;3522;3525;7.72;0.47;227.10;3.42;796;26;1191.00;3
2728;26;625366161;2728;229;3522;3525;7.82;0.48;227.23;3.42;794;26;1192.00;3
2733;26;625366170;2733;229;3522;3525;7.81;0.48;227.66;3.42;789;26;1193.00;3
2735;26;625366185;2735;227;3526;3529;7.83;0.48;227.79;3.41;791;26;1194.00;3
2740;26;625366196;2740;227;3526;3529;7.87;0.48;228.01;3.41;786;26;1195.00;3
2742;26;625366205;2742;229;3529;3533;7.97;0.49;228.13;3.41;787;26;1196.00;4
2746;26;625366216;2746;223;3531;3534;8.06;0.49;228.19;3.41;785;26;1197.00;3
2750;26;625366226;2750;213;3531;3534;8.10;0.50;228.23;3.41;781;26;1198.00;3
2751;26;625366236;2751;210;3531;3534;8.26;0.51;228.30;3.41;780;26;1199.00;3
2759;26;625366248;2759;197;3552;3575;8.21;0.50;228.54;3.39;793;26;1200.00;23
2761;26;625366267;2761;192;3554;3575;8.24;0.51;228.54;3.39;793;26;1201.00;21
2765;26;625366278;2765;191;3557;3575;8.29;0.51;228.62;3.39;792;26;1202.00;18
2768;26;625366288;2768;190;3559;3576;8.40;0.51;228.69;3.39;791;26;1203.00;17
2771;26;625366298;2771;188;3563;3577;8.45;0.52;228.60;3.39;792;26;1204.00;14
2774;26;625366309;2774;185;3563;3577;8.58;0.53;228.68;3.39;789;26;1205.00;14
2779;26;625366319;2779;189;3567;3580;8.61;0.53;228.67;3.39;788;26;1206.00;13
2782;26;625366330;2782;182;3568;3580;8.65;0.53;228.84;3.39;786;26;1207.00;12
2785;26;625366341;2785;185;3569;3580;8.67;0.53;228.85;3.39;784;26;1208.00;11
2792;26;625366351;2792;179;3569;3580;8.69;0.53;228.98;3.39;777;26;1209.00;11
2795;26;625366362;2795;180;3575;3586;8.70;0.53;229.08;3.39;780;26;1210.00;11
2798;26;625366374;2798;182;3576;3586;8.75;0.54;229.20;3.39;778;26;1211.00;10
2801;26;625366385;2801;180;3577;3586;8.82;0.54;229.41;3.39;776;26;1212.00;9
2804;26;625366396;2804;184;3577;3586;8.93;0.55;229.33;3.39;773;26;1213.00;9
2809;26;625366407;2809;182;3581;3590;8.93;0.55;229.36;3.39;772;26;1214.00;9
2813;26;625366418;2813;182;3583;3592;9.02;0.55;229.52;3.38;770;26;1215.00;9
2820;26;625366429;2820;185;3583;3592;9.15;0.56;229.61;3.38;763;26;1216.00;9
2826;26;625366440;2826;184;3584;3593;9.21;0.56;229.85;3.38;758;26;1217.00;9
2830;26;625366451;2830;190;3585;3593;9.22;0.57;229.98;3.39;755;26;1218.00;8
2839;26;625366462;2839;186;3586;3593;9.26;0.57;230.31;3.43;747;26;1219.00;7
2843;26;625366480;2843;185;3586;3593;9.36;0.57;230.32;3.43;743;26;1220.00;7
2850;26;625366491;2850;190;3586;3593;9.36;0.57;230.72;3.43;736;26;1221.00;7
2854;26;625366502;2854;196;3586;3593;9.36;0.57;230.74;3.43;732;26;1222.00;7
2862;26;625366513;2862;197;3586;3593;9.28;0.57;230.97;3.43;724;26;1223.00;7
2868;26;625366524;2868;215;3626;3663;9.03;0.55;231.07;3.39;758;26;1224.00;37
2873;26;625366544;2873;214;3628;3664;8.97;0.55;231.32;3.39;755;26;1225.00;36
2879;26;625366556;2879;214;3632;3664;9.03;0.55;231.60;3.39;753;26;1226.00;32
2885;26;625366567;2885;218;3635;3664;9.00;0.55;231.87;3.39;750;26;1227.00;29
2888;26;625366578;2888;217;3637;3666;9.03;0.55;231.84;3.39;749;26;1228.00;29
2893;26;625366594;2893;223;3639;3666;8.99;0.55;231.92;3.39;746;26;1229.00;27
2898;26;625366606;2898;228;3644;3666;8.93;0.54;232.02;3.40;746;26;1230.00;22
2899;26;625366616;2899;231;3646;3666;8.92;0.54;232.13;3.40;747;26;1231.00;20
2902;26;625366626;2902;236;3650;3667;8.89;0.54;232.23;3.41;748;26;1232.00;17
2908;26;625366638;2908;245;3653;3668;8.68;0.53;232.24;3.43;745;26;1233.00;15
2909;26;625366648;2909;258;3655;3668;8.58;0.52;232.31;3.43;746;26;1234.00;13
2912;26;625366664;2912;267;3662;3672;8.43;0.52;232.14;3.44;750;26;1235.00;10
2914;26;625366675;2914;278;3666;3672;8.29;0.51;232.22;3.45;752;26;1236.00;6
2918;26;625366685;2918;270;3666;3672;8.15;0.50;232.22;3.45;748;26;1237.00;6
2920;26;625366696;2920;271;3667;3672;8.17;0.50;232.25;3.45;747;26;1238.00;5
2922;26;625366706;2922;265;3673;3678;8.18;0.50;232.22;3.45;751;26;1239.00;5
2923;26;625366717;2923;267;3673;3678;8.24;0.50;232.15;3.45;750;26;1240.00;5
2927;26;625366728;2927;265;3673;3678;8.25;0.50;232.21;3.45;746;26;1241.00;5
2929;26;625366738;2929;263;3677;3681;8.34;0.51;232.38;3.45;748;26;1242.00;4
2933;26;625366749;2933;267;3677;3681;8.38;0.51;232.38;3.45;744;26;1243.00;4
2935;26;625366760;2935;271;3677;3681;8.41;0.51;232.43;3.45;742;26;1244.00;4
2937;26;625366776;2937;272;3678;3682;8.37;0.51;232.72;3.45;741;26;1245.00;4
2939;26;625366787;2939;262;3679;3683;8.32;0.51;232.65;3.45;740;26;1246.00;4
2943;26;625366798;2943;256;3679;3683;8.27;0.50;232.68;3.45;736;26;1247.00;4
2946;26;625366809;2946;245;3692;3696;8.37;0.51;232.64;3.44;746;26;1248.00;4
2950;26;625366820;2950;240;3692;3696;8.34;0.51;232.60;3.44;742;26;1249.00;4
2952;26;625366831;2952;233;3693;3696;8.32;0.51;232.55;3.46;741;26;1250.00;3
2953;26;625366842;2953;227;3694;3697;8.35;0.51;232.63;3.46;741;26;1251.00;3
2954;26;625366852;2954;234;3694;3697;8.34;0.51;232.65;3.46;740;26;1252.00;3
2957;26;625366863;2957;226;3697;3701;8.32;0.51;232.66;3.46;740;26;1253.00;4
2957;26;625366873;2957;230;3697;3701;8.32;0.51;232.66;3.46;740;26;1254.00;4
2960;26;625366895;2960;242;3702;3705;8.29;0.50;232.72;3.46;742;26;1255.00;3
2960;26;625366905;2960;239;3702;3705;8.32;0.51;232.72;3.46;742;26;1256.00;3
2962;26;625366916;2962;234;3702;3705;8.37;0.51;232.62;3.46;740;26;1257.00;3
2964;26;625366926;2964;230;3702;3705;8.37;0.51;232.52;3.46;738;26;1258.00;3
2965;26;625366937;2965;235;3702;3705;8.40;0.51;232.49;3.46;737;26;1259.00;3
2967;26;625366956;2967;239;3726;3739;8.45;0.52;232.46;3.43;759;26;1260.00;13
2968;26;625366985;2968;230;3726;3739;8.53;0.52;232.42;3.43;758;26;1261.00;13
2972;26;625367000;2972;231;3727;3739;8.58;0.53;232.43;3.43;755;26;1262.00;12
2973;26;625367017;2973;233;3727;3739;8.58;0.52;232.39;3.43;754;26;1263.00;12
2976;26;625367039;2976;229;3728;3739;8.55;0.52;232.36;3.43;752;26;1264.00;11
2978;26;625367054;2978;238;3728;3739;8.55;0.52;232.29;3.43;750;26;1265.00;11
2980;26;625367065;2980;247;3729;3740;8.53;0.52;232.26;3.44;749;26;1266.00;11
2984;26;625367077;2984;250;3729;3740;8.45;0.51;232.07;3.44;745;26;1267.00;11
2985;26;625367087;2985;245;3734;3746;8.37;0.51;232.06;3.45;749;26;1268.00;12
2990;26;625367108;2990;246;3736;3747;8.36;0.51;231.92;3.45;746;26;1269.00;11
2992;26;625367118;2992;250;3736;3747;8.28;0.50;231.82;3.45;744;26;1270.00;11
2995;26;625367129;2995;257;3737;3747;8.17;0.50;231.82;3.45;742;26;1271.00;10
2997;26;625367139;2997;260;3739;3751;8.05;0.49;231.85;3.45;742;26;1272.00;12
2998;26;625367160;2998;262;3739;3751;7.98;0.48;231.78;3.45;741;26;1273.00;12
2999;26;625367170;2999;267;3739;3751;7.86;0.48;231.76;3.45;740;26;1274.00;12
3002;26;625367180;3002;271;3740;3752;7.80;0.48;231.71;3.45;738;26;1275.00;12
3002;26;625367190;3002;284;3743;3756;7.81;0.48;231.71;3.45;741;26;1276.00;13
3003;26;625367200;3003;287;3743;3756;7.71;0.47;231.72;3.45;740;26;1277.00;13
3003;26;625367210;3003;293;3745;3759;7.68;0.47;231.72;3.44;742;26;1278.00;14
3004;26;625367220;3004;297;3746;3759;7.61;0.47;231.65;3.44;742;26;1279.00;13
3007;26;625367229;3007;296;3746;3759;7.56;0.46;231.65;3.44;739;26;1280.00;13
3009;26;625367238;3009;288;3746;3759;7.57;0.46;231.80;3.44;737;26;1281.00;13
3014;26;625367248;3014;281;3749;3763;7.53;0.46;231.76;3.44;735;26;1282.00;14
3016;26;625367258;3016;260;3749;3763;7.52;0.46;231.77;3.44;733;26;1283.00;14
3017;26;625367267;3017;244;3751;3763;7.58;0.46;231.75;3.46;734;26;1284.00;12
3019;26;625367277;3019;235;3751;3763;7.66;0.47;231.77;3.46;732;26;1285.00;12
3020;26;625367287;3020;222;3751;3764;7.78;0.47;231.75;3.46;731;26;1286.00;13
3022;26;625367296;3022;211;3752;3765;7.82;0.48;231.73;3.46;730;26;1287.00;13
3023;26;625367314;3023;206;3753;3765;7.95;0.49;231.72;3.48;730;26;1288.00;12
3023;26;625367324;3023;197;3754;3766;8.12;0.50;231.72;3.48;731;26;1289.00;12
3024;26;625367336;3024;188;3754;3766;8.33;0.51;231.71;3.48;730;26;1290.00;12
3026;26;625367346;3026;179;3754;3766;8.47;0.52;231.68;3.48;728;26;1291.00;12
3028;26;625367356;3028;173;3754;3766;8.60;0.52;231.63;3.48;726;26;1292.00;12
3030;26;625367366;3030;163;3755;3766;8.73;0.53;231.58;3.49;725;26;1293.00;11
3033;26;625367382;3033;158;3756;3766;8.82;0.54;231.51;3.49;723;26;1294.00;10
3035;26;625367406;3035;155;3757;3766;8.88;0.54;231.46;3.50;722;26;1295.00;9
3036;26;625367415;3036;169;3822;3893;8.96;0.55;231.43;3.44;786;26;1296.00;71
3036;26;625367436;3036;158;3822;3894;9.05;0.56;231.43;3.44;786;26;1297.00;72
3039;26;625367447;3039;151;3830;3894;9.21;0.57;231.35;3.45;791;26;1298.00;64
3041;26;625367457;3041;142;3835;3894;9.33;0.58;231.30;3.45;794;26;1299.00;59
3042;26;625367470;3042;135;3842;3894;9.47;0.58;231.23;3.46;800;26;1300.00;52
3043;26;625367486;3043;137;3848;3894;9.56;0.59;231.23;3.46;805;26;1301.00;46
3046;26;625367497;3046;136;3852;3894;9.70;0.60;231.16;3.46;806;26;1302.00;42
3049;27;625367508;3049;138;3855;3894;9.88;0.61;231.10;3.47;806;27;1303.00;39
3052;27;625367531;3052;131;3859;3895;9.96;0.61;231.09;3.48;807;27;1304.00;36
3056;27;625367543;3056;132;3862;3897;10.01;0.61;231.13;3.48;806;27;1305.00;35
3058;27;625367554;3058;134;3864;3897;10.09;0.62;231.21;3.48;806;27;1306.00;33
3059;27;625367565;3059;134;3866;3898;10.16;0.62;231.26;3.50;807;27;1307.00;32
3062;27;625367577;3062;135;3867;3898;10.09;0.62;231.19;3.50;805;27;1308.00;31
3065;27;625367588;3065;137;3870;3898;10.04;0.61;231.15;3.51;805;27;1309.00;28
3068;27;625367599;3068;139;3872;3898;10.01;0.61;231.09;3.51;804;27;1310.00;26
3071;27;625367610;3071;143;3875;3902;9.95;0.61;231.26;3.52;804;27;1311.00;27
3074;27;625367621;3074;140;3878;3902;9.82;0.60;231.33;3.53;804;27;1312.00;24
3076;27;625367633;3076;144;3881;3902;9.75;0.60;231.30;3.54;805;27;1313.00;21
3079;27;625367644;3079;152;3884;3905;9.73;0.59;231.36;3.54;805;27;1314.00;21
3082;27;625367656;3082;158;3888;3905;9.66;0.59;231.40;3.56;806;27;1315.00;17
3082;27;625367667;3082;160;3890;3905;9.66;0.59;231.40;3.57;808;27;1316.00;15
3087;27;625367678;3087;166;3895;3909;9.64;0.59;231.55;3.57;808;27;1317.00;14
3089;27;625367690;3089;166;3896;3910;9.65;0.59;231.70;3.57;807;27;1318.00;14
3091;27;625367701;3091;175;3900;3910;9.63;0.59;231.81;3.59;809;27;1319.00;10
3094;27;625367713;3094;181;3904;3915;9.70;0.59;231.93;3.59;810;27;1320.00;11
3099;27;625367726;3099;186;3904;3915;9.69;0.59;232.01;3.59;805;27;1321.00;11
3100;27;625367737;3100;187;3905;3915;9.67;0.59;231.99;3.60;805;27;1322.00;10
3103;27;625367755;3103;188;3907;3916;9.59;0.58;232.13;3.60;804;27;1323.00;9
3104;27;625367783;3104;196;3908;3916;9.55;0.58;232.13;3.61;804;27;1324.00;8
3105;27;625367795;3105;195;3913;3922;9.51;0.58;232.23;3.61;808;27;1325.00;9
3108;27;625367810;3108;197;3915;3922;9.49;0.58;232.26;3.62;807;27;1326.00;7
3109;27;625367823;3109;196;3915;3923;9.47;0.58;232.26;3.62;806;27;1327.00;8
3112;27;625367835;3112;196;3916;3923;9.41;0.57;232.39;3.62;804;27;1328.00;7
3115;27;625367847;3115;198;3917;3923;9.37;0.57;232.48;3.63;802;27;1329.00;6
3117;27;625367859;3117;200;3918;3923;9.31;0.57;232.45;3.64;801;27;1330.00;5
3121;27;625367873;3121;201;3918;3923;9.27;0.56;232.48;3.64;797;27;1331.00;5
3124;27;625367885;3124;199;3930;3935;9.34;0.57;232.49;3.64;806;27;1332.00;5
3125;27;625367898;3125;199;3931;3935;9.34;0.57;232.56;3.65;806;27;1333.00;4
3128;27;625367910;3128;203;3933;3935;9.31;0.57;232.70;3.65;805;27;1334.00;2
3129;27;625367928;3129;204;3934;3935;9.27;0.56;232.66;3.65;805;27;1335.00;1
3131;27;625367941;3131;205;3934;3935;9.18;0.56;232.85;3.65;803;27;1336.00;1
3133;27;625367952;3133;208;3934;3935;9.06;0.55;233.10;3.65;801;27;1337.00;1
3136;27;625367963;3136;208;3939;3939;8.88;0.54;233.23;3.65;803;27;1338.00;0
3139;27;625367975;3139;207;3939;3939;8.81;0.54;233.38;3.65;800;27;1339.00;0
3141;27;625367987;3141;207;3942;3943;8.80;0.54;233.44;3.65;801;27;1340.00;1
3144;27;625367998;3144;208;3943;3944;8.79;0.54;233.50;3.65;799;27;1341.00;1
3148;27;625368009;3148;211;3944;3944;8.81;0.54;233.62;3.65;796;27;1342.00;0
3151;27;625368020;3151;212;3944;3944;8.74;0.53;233.74;3.65;793;27;1343.00;0
3154;27;625368031;3154;210;3956;3957;8.71;0.53;233.79;3.63;802;27;1344.00;1
3159;27;625368044;3159;207;3956;3957;8.70;0.53;233.86;3.63;797;27;1345.00;1
3161;27;625368055;3161;208;3957;3957;8.75;0.53;233.91;3.63;796;27;1346.00;0
3164;27;625368066;3164;209;3958;3958;8.83;0.54;233.84;3.63;794;27;1347.00;0
3168;28;625368078;3168;209;3959;3959;8.85;0.54;234.09;3.63;791;28;1348.00;0
3173;28;625368106;3173;210;3959;3959;8.86;0.54;234.15;3.63;786;28;1349.00;0
3177;28;625368118;3177;212;3962;3968;8.92;0.54;234.33;3.63;785;28;1350.00;6
3181;28;625368130;3181;213;3963;3968;8.89;0.54;234.44;3.63;782;28;1351.00;5
3185;28;625368143;3185;220;3964;3968;8.87;0.54;234.59;3.63;779;28;1352.00;4
3188;28;625368157;3188;222;3964;3968;8.84;0.54;234.73;3.63;776;28;1353.00;4
3193;28;625368171;3193;219;3969;3974;8.81;0.54;234.83;3.63;776;28;1354.00;5
3197;28;625368182;3197;225;3969;3974;8.72;0.53;234.94;3.63;772;28;1355.00;5
3200;28;625368192;3200;223;3970;3974;8.66;0.53;235.03;3.63;770;28;1356.00;4
3206;28;625368202;3206;223;3970;3974;8.58;0.53;235.32;3.63;764;28;1357.00;4
3208;28;625368211;3208;223;3976;3978;8.52;0.52;235.46;3.63;768;28;1358.00;2
3214;28;625368222;3214;230;3977;3979;8.48;0.52;235.49;3.62;763;28;1359.00;2
3219;28;625368235;3219;223;3978;3979;8.42;0.51;235.50;3.63;759;28;1360.00;1
3222;28;625368248;3222;214;3979;3980;8.40;0.51;235.57;3.62;757;28;1361.00;1
3225;28;625368258;3225;208;3979;3980;8.35;0.51;235.68;3.62;754;28;1362.00;1
3226;28;625368269;3226;204;3979;3980;8.33;0.51;235.67;3.62;753;28;1363.00;1
3231;28;625368278;3231;204;3979;3980;8.26;0.50;235.64;3.62;748;28;1364.00;1
3234;28;625368288;3234;206;3979;3980;8.26;0.50;235.72;3.62;745;28;1365.00;1
3236;28;625368302;3236;208;3979;3980;8.35;0.51;235.61;3.62;743;28;1366.00;1
3242;28;625368318;3242;202;3979;3980;8.34;0.51;235.66;3.62;737;28;1367.00;1
3248;28;625368335;3248;197;4019;4050;8.43;0.52;235.62;3.59;771;28;1368.00;31
3249;28;625368355;3249;190;4024;4051;8.46;0.52;235.68;3.59;775;28;1369.00;27
3255;28;625368367;3255;186;4032;4051;8.59;0.52;235.68;3.58;777;28;1370.00;19
3259;28;625368378;3259;188;4032;4051;8.66;0.53;235.87;3.58;773;28;1371.00;19
3262;28;625368390;3262;185;4037;4051;8.76;0.54;235.94;3.58;775;28;1372.00;14
3264;28;625368402;3264;191;4041;4051;8.85;0.54;235.92;3.58;777;28;1373.00;10
3270;28;625368413;3270;195;4046;4051;8.82;0.54;235.90;3.59;776;28;1374.00;5
3273;28;625368430;3273;192;4046;4051;8.75;0.53;235.90;3.59;773;28;1375.00;5
3276;28;625368441;3276;198;4048;4052;8.69;0.53;235.92;3.59;772;28;1376.00;4
3280;28;625368451;3280;199;4049;4053;8.63;0.52;236.02;3.59;769;28;1377.00;4
3283;28;625368462;3283;198;4050;4053;8.65;0.53;235.99;3.59;767;28;1378.00;3
3287;28;625368472;3287;201;4053;4057;8.65;0.53;236.09;3.59;766;28;1379.00;4
3291;28;625368485;3291;205;4053;4057;8.60;0.52;236.34;3.59;762;28;1380.00;4
3295;28;625368496;3295;202;4053;4057;8.61;0.52;236.47;3.59;758;28;1381.00;4
3299;28;625368506;3299;207;4053;4057;8.63;0.52;236.52;3.59;754;28;1382.00;4
3302;28;625368518;3302;209;4058;4063;8.67;0.53;236.57;3.58;756;28;1383.00;5
3306;28;625368529;3306;214;4059;4063;8.67;0.53;236.64;3.58;753;28;1384.00;4
3311;28;625368540;3311;216;4060;4063;8.71;0.53;236.76;3.58;749;28;1385.00;3
3317;28;625368550;3317;213;4062;4066;8.64;0.53;236.81;3.58;745;28;1386.00;4
3319;28;625368561;3319;214;4063;4066;8.73;0.54;236.89;3.58;744;28;1387.00;3
3324;28;625368572;3324;215;4063;4066;8.65;0.53;236.84;3.58;739;28;1388.00;3
3325;28;625368582;3325;221;4064;4067;8.59;0.53;237.01;3.58;739;28;1389.00;3
3330;28;625368592;3330;218;4065;4068;8.50;0.52;237.00;3.58;735;28;1390.00;3
3332;28;625368604;3332;230;4066;4068;8.39;0.52;237.03;3.59;734;28;1391.00;2
3337;28;625368622;3337;235;4079;4081;8.31;0.51;237.12;3.58;742;28;1392.00;2
3340;28;625368634;3340;240;4080;4081;8.24;0.50;237.06;3.58;740;28;1393.00;1
3342;28;625368649;3342;243;4080;4081;8.10;0.50;237.11;3.58;738;28;1394.00;1
3345;28;625368662;3345;246;4082;4083;8.02;0.49;237.03;3.58;737;28;1395.00;1
3346;28;625368673;3346;253;4082;4083;8.00;0.49;237.03;3.58;736;28;1396.00;1
3348;28;625368684;3348;260;4085;4087;7.99;0.49;237.16;3.58;737;28;1397.00;2
3354;28;625368699;3354;269;4085;4087;7.93;0.49;237.01;3.58;731;28;1398.00;2
3358;28;625368714;3358;275;4090;4091;7.87;0.48;237.03;3.58;732;28;1399.00;1
3361;28;625368727;3361;279;4090;4091;7.78;0.48;237.06;3.58;729;28;1400.00;1
3364;28;625368749;3364;286;4090;4091;7.69;0.47;237.08;3.58;726;28;1401.00;1
3367;28;625368760;3367;291;4091;4091;7.67;0.47;237.06;3.58;724;28;1402.00;0
3372;28;625368770;3372;295;4091;4091;7.61;0.46;237.09;3.58;719;28;1403.00;0
3375;28;625368780;3375;308;4102;4103;7.66;0.47;237.04;3.57;727;28;1404.00;1
3379;28;625368791;3379;309;4102;4103;7.57;0.46;236.93;3.57;723;28;1405.00;1
3381;28;625368801;3381;312;4103;4103;7.56;0.46;236.96;3.57;722;28;1406.00;0
3383;29;625368811;3383;304;4103;4103;7.53;0.46;236.89;3.57;720;29;1407.00;0
3384;29;625368832;3384;305;4103;4103;7.54;0.46;236.90;3.57;719;29;1408.00;0
3389;29;625368842;3389;300;4103;4103;7.55;0.46;236.93;3.57;714;29;1409.00;0
3389;29;625368854;3389;297;4104;4104;7.52;0.46;236.93;3.57;715;29;1410.00;0
3391;29;625368864;3391;299;4104;4104;7.47;0.46;236.93;3.57;713;29;1411.00;0
3393;29;625368873;3393;304;4109;4110;7.50;0.46;236.84;3.57;716;29;1412.00;1
3397;29;625368884;3397;305;4110;4111;7.46;0.45;236.88;3.57;713;29;1413.00;1
3399;29;625368894;3399;304;4111;4111;7.50;0.46;236.85;3.57;712;29;1414.00;0
3401;29;625368906;3401;308;4111;4111;7.49;0.46;236.88;3.57;710;29;1415.00;0
3403;29;625368916;3403;294;4115;4115;7.53;0.46;236.83;3.57;712;29;1416.00;0
3406;29;625368926;3406;286;4115;4115;7.56;0.46;236.77;3.57;709;29;1417.00;0
3408;29;625368936;3408;282;4115;4115;7.60;0.46;236.72;3.57;707;29;1418.00;0
3409;29;625368951;3409;268;4116;4116;7.64;0.46;236.75;3.57;707;29;1419.00;0
3412;29;625368970;3412;273;4120;4120;7.67;0.47;236.71;3.56;708;29;1420.00;0
3414;29;625368989;3414;267;4120;4120;7.72;0.47;236.70;3.56;706;29;1421.00;0
3417;29;625369017;3417;257;4122;4123;7.81;0.47;236.56;3.56;705;29;1422.00;1
3419;29;625369033;3419;255;4122;4123;7.90;0.48;236.51;3.56;703;29;1423.00;1
3420;29;625369049;3420;250;4123;4123;7.95;0.48;236.48;3.56;703;29;1424.00;0
3422;29;625369074;3422;251;4123;4123;8.01;0.49;236.51;3.56;701;29;1425.00;0
3423;29;625369086;3423;251;4126;4127;8.08;0.49;236.46;3.56;703;29;1426.00;1
3424;29;625369097;3424;248;4126;4127;8.10;0.49;236.44;3.56;702;29;1427.00;1
3426;29;625369108;3426;250;4127;4127;8.12;0.49;236.41;3.56;701;29;1428.00;0
3427;29;625369119;3427;246;4127;4127;8.10;0.49;236.40;3.56;700;29;1429.00;0
3428;29;625369130;3428;243;4128;4128;8.05;0.49;236.38;3.56;700;29;1430.00;0
3429;29;625369143;3429;244;4129;4129;7.98;0.49;236.37;3.56;700;29;1431.00;0
3431;29;625369157;3431;247;4129;4129;7.91;0.48;236.32;3.56;698;29;1432.00;0
3431;29;625369168;3431;250;4130;4130;7.92;0.48;236.32;3.56;699;29;1433.00;0
3431;29;625369179;3431;254;4130;4130;7.93;0.48;236.32;3.56;699;29;1434.00;0
3432;29;625369189;3432;243;4130;4130;7.97;0.49;236.28;3.56;698;29;1435.00;0
3432;29;625369200;3432;235;4130;4130;8.04;0.49;236.28;3.56;698;29;1436.00;0
3433;30;625369211;3433;227;4130;4130;8.11;0.50;236.24;3.56;697;30;1437.00;0
3436;30;625369235;3436;225;4130;4130;8.18;0.50;236.25;3.56;694;30;1438.00;0
3438;30;625369247;3438;228;4130;4130;8.22;0.50;236.17;3.56;692;30;1439.00;0
3439;30;625369262;3439;269;4250;4360;8.32;0.52;236.18;3.46;811;30;1440.00;110
3442;30;625369297;3442;253;4253;4361;8.38;0.53;236.17;3.45;811;30;1441.00;108
3442;30;625369317;3442;237;4263;4361;8.52;0.53;236.17;3.45;821;30;1442.00;98
3443;31;625369330;3443;230;4270;4361;8.62;0.54;236.14;3.45;827;31;1443.00;91
3445;31;625369355;3445;229;4277;4361;8.70;0.54;236.14;3.45;832;31;1444.00;84
3447;31;625369367;3447;231;4282;4361;8.73;0.54;236.15;3.45;835;31;1445.00;79
3447;31;625369386;3447;230;4287;4361;8.79;0.55;236.15;3.46;840;31;1446.00;74
3448;31;625369405;3448;235;4290;4361;8.80;0.55;236.14;3.46;842;31;1447.00;71
3449;31;625369418;3449;239;4293;4362;8.79;0.55;236.11;3.46;844;31;1448.00;69
3452;31;625369437;3452;240;4297;4363;8.76;0.54;236.03;3.47;845;31;1449.00;66
3452;31;625369449;3452;240;4302;4363;8.75;0.54;236.03;3.47;850;31;1450.00;61
3454;31;625369469;3454;240;4306;4364;8.69;0.54;236.05;3.48;852;31;1451.00;58
3457;31;625369483;3457;243;4308;4364;8.63;0.53;236.02;3.48;851;31;1452.00;56
3460;31;625369502;3460;244;4310;4364;8.56;0.53;236.01;3.49;850;31;1453.00;54
3462;31;625369515;3462;249;4312;4364;8.58;0.53;236.03;3.49;850;31;1454.00;52
3465;31;625369535;3465;250;4317;4368;8.52;0.53;235.94;3.50;852;31;1455.00;51
3468;31;625369550;3468;252;4319;4368;8.51;0.52;235.96;3.51;851;31;1456.00;49
3470;31;625369571;3470;251;4319;4368;8.51;0.52;235.98;3.51;849;31;1457.00;49
3472;31;625369585;3472;247;4322;4371;8.58;0.53;235.92;3.51;850;31;1458.00;49
3477;31;625369603;3477;239;4325;4371;8.64;0.53;235.90;3.52;848;31;1459.00;46
3480;31;625369619;3480;241;4326;4371;8.73;0.53;235.94;3.53;846;31;1460.00;45
3486;31;625369635;3486;237;4332;4375;8.76;0.54;235.95;3.54;846;31;1461.00;43
3491;31;625369650;3491;219;4334;4376;8.79;0.54;236.02;3.54;843;31;1462.00;42
3492;31;625369666;3492;218;4335;4376;8.87;0.54;236.07;3.55;843;31;1463.00;41
3495;31;625369680;3495;210;4338;4380;8.97;0.55;236.06;3.55;843;31;1464.00;42
3498;31;625369693;3498;206;4340;4380;8.97;0.55;236.21;3.56;842;31;1465.00;40
3499;31;625369707;3499;197;4340;4380;9.07;0.55;236.23;3.56;841;31;1466.00;40
3501;31;625369719;3501;197;4344;4381;9.14;0.56;236.30;3.57;843;31;1467.00;37
3505;31;625369732;3505;192;4344;4381;9.20;0.56;236.45;3.57;839;31;1468.00;37
3507;31;625369744;3507;188;4347;4387;9.28;0.56;236.38;3.57;840;31;1469.00;40
3510;31;625369760;3510;184;4349;4387;9.33;0.57;236.51;3.58;839;31;1470.00;38
3512;31;625369781;3512;177;4349;4388;9.35;0.57;236.45;3.58;837;31;1471.00;39
3515;31;625369803;3515;173;4349;4388;9.32;0.57;236.54;3.58;834;31;1472.00;39
3516;31;625369825;3516;170;4351;4388;9.39;0.57;236.63;3.59;835;31;1473.00;37
3518;31;625369839;3518;171;4352;4388;9.46;0.57;236.71;3.59;834;31;1474.00;36
3521;31;625369851;3521;172;4354;4388;9.54;0.58;236.74;3.60;833;31;1475.00;34
3523;31;625369864;3523;173;4366;4400;9.60;0.58;236.84;3.59;843;31;1476.00;34
3527;31;625369882;3527;173;4367;4400;9.67;0.59;236.89;3.60;840;31;1477.00;33
3528;31;625369900;3528;169;4367;4400;9.81;0.59;236.98;3.60;839;31;1478.00;33
3531;31;625369913;3531;174;4369;4400;9.86;0.60;237.01;3.61;838;31;1479.00;31
3534;31;625369927;3534;175;4370;4400;9.81;0.59;237.12;3.62;836;31;1480.00;30
3538;31;625369941;3538;174;4370;4400;9.78;0.59;237.28;3.62;832;31;1481.00;30
3538;31;625369955;3538;178;4375;4404;9.76;0.59;237.28;3.64;837;31;1482.00;29
3539;31;625369970;3539;179;4375;4404;9.75;0.59;237.36;3.64;836;31;1483.00;29
3540;31;625369983;3540;181;4379;4408;9.78;0.59;237.35;3.64;839;31;1484.00;29
3542;31;625370002;3542;185;4382;4410;9.81;0.59;237.39;3.64;840;31;1485.00;28
3545;31;625370014;3545;185;4383;4410;9.81;0.59;237.43;3.65;838;31;1486.00;27
3546;31;625370026;3546;185;4383;4410;9.83;0.60;237.50;3.65;837;31;1487.00;27
3546;31;625370038;3546;190;4393;4423;9.78;0.59;237.50;3.65;847;31;1488.00;30
3547;31;625370051;3547;193;4393;4423;9.77;0.59;237.56;3.65;846;31;1489.00;30
3549;31;625370063;3549;199;4395;4423;9.81;0.60;237.63;3.67;846;31;1490.00;28
3553;31;625370078;3553;200;4397;4424;9.86;0.60;237.63;3.68;844;31;1491.00;27
3557;31;625370092;3557;208;4398;4425;9.83;0.60;237.69;3.70;841;31;1492.00;27
3558;31;625370105;3558;209;4400;4425;9.86;0.60;237.67;3.72;842;31;1493.00;25
3561;31;625370117;3561;214;4403;4428;9.90;0.60;237.70;3.73;842;31;1494.00;25
3564;31;625370130;3564;215;4406;4428;9.85;0.60;237.78;3.76;842;31;1495.00;22
3567;31;625370143;3567;219;4409;4428;9.90;0.60;237.88;3.78;842;31;1496.00;19
3571;31;625370156;3571;221;4409;4428;9.91;0.60;237.93;3.78;838;31;1497.00;19
3575;31;625370169;3575;224;4416;4434;9.94;0.61;237.93;3.80;841;31;1498.00;18
3578;31;625370182;3578;225;4417;4434;9.90;0.60;237.98;3.80;839;31;1499.00;17
3582;31;625370197;3582;230;4422;4453;9.81;0.60;238.16;3.81;840;31;1500.00;31
3583;31;625370219;3583;229;4424;4453;9.72;0.59;238.17;3.82;841;31;1501.00;29
3586;31;625370239;3586;229;4428;4457;9.57;0.58;238.13;3.83;842;31;1502.00;29
3588;31;625370251;3588;228;4430;4458;9.46;0.58;238.13;3.83;842;31;1503.00;28
3589;31;625370265;3589;232;4432;4458;9.42;0.58;238.21;3.85;843;31;1504.00;26
3592;31;625370277;3592;236;4434;4459;9.41;0.57;238.33;3.86;842;31;1505.00;25
3596;31;625370289;3596;244;4435;4459;9.36;0.57;238.39;3.86;839;31;1506.00;24
3600;31;625370301;3600;244;4440;4459;9.30;0.57;238.29;3.89;840;31;1507.00;19
3604;31;625370313;3604;249;4442;4459;9.23;0.56;238.51;3.90;838;31;1508.00;17
3608;31;625370329;3608;248;4442;4459;9.21;0.56;238.59;3.90;834;31;1509.00;17
3610;31;625370341;3610;251;4444;4459;9.20;0.56;238.57;3.91;834;31;1510.00;15
3611;31;625370353;3611;250;4444;4459;9.20;0.56;238.59;3.91;833;31;1511.00;15
3614;31;625370373;3614;253;4475;4529;9.14;0.56;238.61;3.88;861;31;1512.00;54
3615;31;625370389;3615;251;4480;4530;9.16;0.56;238.65;3.88;865;31;1513.00;50
3616;31;625370402;3616;247;4487;4530;9.20;0.56;238.64;3.88;871;31;1514.00;43
3621;31;625370414;3621;250;4489;4530;9.22;0.56;238.65;3.88;868;31;1515.00;41
3623;31;625370427;3623;248;4495;4530;9.24;0.56;238.69;3.88;872;31;1516.00;35
3625;31;625370440;3625;253;4497;4530;9.27;0.56;238.84;3.88;872;31;1517.00;33
3628;31;625370455;3628;259;4504;4530;9.21;0.56;238.90;3.89;876;31;1518.00;26
3631;31;625370468;3631;263;4505;4530;9.18;0.56;238.95;3.89;874;31;1519.00;25
3635;31;625370481;3635;265;4508;4531;9.09;0.55;238.84;3.89;873;31;1520.00;23
3638;31;625370494;3638;272;4510;4532;9.02;0.55;238.71;3.89;872;31;1521.00;22
3641;31;625370510;3641;273;4511;4532;8.93;0.54;238.62;3.89;870;31;1522.00;21
3647;31;625370525;3647;277;4515;4536;8.81;0.54;238.84;3.90;868;31;1523.00;21
3648;31;625370537;3648;279;4515;4536;8.77;0.54;238.87;3.90;867;31;1524.00;21
3652;31;625370548;3652;278;4515;4536;8.75;0.53;239.04;3.90;863;31;1525.00;21
3658;31;625370561;3658;282;4515;4536;8.66;0.53;239.03;3.90;857;31;1526.00;21
3663;31;625370573;3663;286;4519;4542;8.57;0.52;239.29;3.89;856;31;1527.00;23
3665;31;625370585;3665;295;4519;4542;8.42;0.51;239.39;3.89;854;31;1528.00;23
3670;31;625370596;3670;303;4521;4542;8.15;0.50;239.50;3.90;851;31;1529.00;21
3674;31;625370609;3674;287;4524;4548;7.99;0.49;239.64;3.90;850;31;1530.00;24
3678;31;625370621;3678;279;4524;4548;7.90;0.48;239.71;3.90;846;31;1531.00;24
3685;31;625370633;3685;272;4524;4548;7.84;0.48;239.66;3.90;839;31;1532.00;24
3691;31;625370645;3691;269;4525;4549;7.78;0.48;239.75;3.90;834;31;1533.00;24
3698;31;625370657;3698;263;4526;4550;7.73;0.47;239.89;3.90;828;31;1534.00;24
3701;31;625370669;3701;263;4527;4550;7.76;0.47;240.02;3.91;826;31;1535.00;23
3706;31;625370682;3706;263;4541;4563;7.72;0.47;240.06;3.91;835;31;1536.00;22
3709;31;625370694;3709;255;4541;4563;7.77;0.47;240.12;3.91;832;31;1537.00;22
3711;31;625370712;3711;256;4541;4563;7.86;0.48;240.29;3.91;830;31;1538.00;22
3714;31;625370723;3714;251;4544;4564;7.95;0.49;240.33;3.92;830;31;1539.00;20
3720;31;625370735;3720;248;4544;4564;8.00;0.49;240.52;3.92;824;31;1540.00;20
3723;31;625370746;3723;243;4548;4568;8.09;0.50;240.59;3.93;825;31;1541.00;20
3725;31;625370759;3725;234;4549;4568;8.09;0.50;240.70;3.94;824;31;1542.00;19
3730;31;625370771;3730;234;4554;4572;8.07;0.49;240.77;3.94;824;31;1543.00;18
3731;31;625370786;3731;234;4554;4572;8.14;0.50;240.80;3.94;823;31;1544.00;18
3736;31;625370798;3736;231;4554;4572;8.21;0.50;240.81;3.94;818;31;1545.00;18
3740;31;625370810;3740;232;4554;4572;8.20;0.50;240.89;3.94;814;31;1546.00;18
3746;31;625370824;3746;234;4554;4572;8.12;0.50;241.13;3.94;808;31;1547.00;18
3749;31;625370837;3749;235;4566;4584;8.14;0.50;241.14;3.94;817;31;1548.00;18
3756;31;625370851;3756;246;4566;4584;8.07;0.49;240.98;3.94;810;31;1549.00;18
3762;31;625370862;3762;245;4568;4584;8.01;0.49;241.02;3.95;806;31;1550.00;16
3767;31;625370881;3767;253;4568;4584;7.86;0.48;241.15;3.95;801;31;1551.00;16
3770;31;625370894;3770;261;4568;4584;7.76;0.47;241.16;3.95;798;31;1552.00;16
3774;31;625370914;3774;266;4569;4584;7.74;0.47;241.24;3.96;795;31;1553.00;15
3779;31;625370927;3779;274;4571;4585;7.57;0.46;241.27;3.97;792;31;1554.00;14
3784;31;625370942;3784;280;4572;4587;7.48;0.46;241.32;3.97;788;31;1555.00;15
3788;31;625370960;3788;285;4577;4593;7.42;0.45;241.25;3.98;789;31;1556.00;16
3793;31;625370982;3793;292;4579;4594;7.30;0.45;241.22;3.98;786;31;1557.00;15
3794;31;625371002;3794;298;4579;4594;7.22;0.44;241.22;3.98;785;31;1558.00;15
3798;31;625371020;3798;301;4580;4594;7.12;0.44;241.20;3.99;782;31;1559.00;14
3801;31;625371037;3801;303;4586;4599;7.01;0.43;241.12;3.99;785;31;1560.00;13
3809;31;625371068;3809;305;4587;4599;6.89;0.42;240.94;4.00;778;31;1561.00;12
3812;31;625371081;3812;306;4587;4599;6.88;0.42;240.86;4.00;775;31;1562.00;12
3818;31;625371093;3818;316;4590;4600;6.79;0.41;240.82;4.01;772;31;1563.00;10
3819;31;625371104;3819;321;4595;4604;6.84;0.42;240.86;4.01;776;31;1564.00;9
3821;31;625371119;3821;327;4596;4604;6.82;0.42;240.90;4.02;775;31;1565.00;8
3823;31;625371138;3823;333;4598;4607;6.84;0.42;240.79;4.02;775;31;1566.00;9
3825;31;625371150;3825;338;4599;4607;6.83;0.42;240.78;4.02;774;31;1567.00;8
3829;31;625371161;3829;341;4599;4607;6.83;0.42;240.64;4.02;770;31;1568.00;8
3830;31;625371172;3830;349;4600;4607;6.81;0.42;240.58;4.02;770;31;1569.00;7
3831;31;625371183;3831;355;4602;4611;6.81;0.42;240.65;4.02;771;31;1570.00;9
3834;31;625371193;3834;357;4602;4611;6.73;0.41;240.51;4.02;768;31;1571.00;9
3836;31;625371203;3836;369;4602;4611;6.68;0.41;240.55;4.02;766;31;1572.00;9
3840;31;625371213;3840;379;4604;4611;6.57;0.40;240.68;4.03;764;31;1573.00;7
3842;31;625371224;3842;385;4605;4612;6.49;0.40;240.70;4.03;763;31;1574.00;7
3844;31;625371234;3844;391;4609;4614;6.44;0.40;240.64;4.03;765;31;1575.00;5
3848;31;625371244;3848;394;4609;4614;6.36;0.39;240.70;4.03;761;31;1576.00;5
3851;31;625371254;3851;388;4612;4615;6.32;0.39;240.67;4.03;761;31;1577.00;3
3853;31;625371265;3853;387;4612;4615;6.31;0.39;240.75;4.03;759;31;1578.00;3
3855;31;625371275;3855;376;4613;4615;6.31;0.39;240.78;4.06;758;31;1579.00;2
3858;31;625371287;3858;370;4613;4615;6.41;0.39;240.93;4.06;755;31;1580.00;2
3859;31;625371296;3859;372;4613;4615;6.48;0.40;240.96;4.06;754;31;1581.00;2
3863;31;625371306;3863;366;4613;4615;6.51;0.40;241.04;4.06;750;31;1582.00;2
3867;31;625371317;3867;363;4613;4615;6.54;0.40;241.01;4.06;746;31;1583.00;2
3869;31;625371327;3869;381;4688;4742;6.90;0.43;241.00;4.00;819;31;1584.00;54
3871;31;625371348;3871;370;4690;4743;6.96;0.43;240.96;4.00;819;31;1585.00;53
3871;31;625371365;3871;350;4699;4743;7.11;0.44;240.96;3.99;828;31;1586.00;44
3871;31;625371382;3871;321;4705;4743;7.29;0.45;240.96;3.99;834;31;1587.00;38
3871;31;625371400;3871;297;4710;4743;7.42;0.46;240.96;3.99;839;31;1588.00;33
3872;31;625371411;3872;278;4715;4743;7.56;0.47;240.94;3.99;843;31;1589.00;28
3873;31;625371424;3873;269;4718;4743;7.74;0.48;240.92;3.99;845;31;1590.00;25
3874;31;625371437;3874;256;4722;4743;7.95;0.49;240.90;4.00;848;31;1591.00;21
3877;31;625371449;3877;259;4725;4744;8.05;0.49;240.81;4.00;848;31;1592.00;19
3877;31;625371470;3877;253;4729;4745;8.21;0.50;240.81;4.00;852;31;1593.00;16
3879;31;625371490;3879;252;4730;4745;8.34;0.51;240.85;4.00;851;31;1594.00;15
3880;31;625371503;3880;248;4732;4746;8.44;0.52;240.85;4.01;852;31;1595.00;14
3882;31;625371516;3882;241;4732;4746;8.55;0.52;240.83;4.01;850;31;1596.00;14
3883;31;625371529;3883;235;4733;4746;8.72;0.53;240.81;4.01;850;31;1597.00;13
3885;31;625371542;3885;238;4734;4746;8.86;0.54;240.78;4.01;849;31;1598.00;12
3886;31;625371554;3886;231;4738;4750;8.96;0.55;240.74;4.01;852;31;1599.00;12
3886;31;625371569;3886;227;4739;4750;8.97;0.55;240.74;4.01;853;31;1600.00;11
3887;31;625371586;3887;221;4740;4750;8.97;0.55;240.71;4.01;853;31;1601.00;10
3888;31;625371602;3888;219;4742;4753;8.98;0.55;240.69;4.01;854;31;1602.00;11
3888;31;625371618;3888;223;4743;4753;9.02;0.55;240.69;4.01;855;31;1603.00;10
3890;31;625371633;3890;224;4744;4753;9.12;0.56;240.72;4.02;854;31;1604.00;9
3893;31;625371647;3893;224;4748;4757;9.14;0.56;240.69;4.02;855;31;1605.00;9
3896;31;625371662;3896;222;4750;4758;9.20;0.56;240.68;4.02;854;31;1606.00;8
3898;31;625371687;3898;225;4750;4758;9.21;0.56;240.63;4.02;852;31;1607.00;8
3899;32;625371704;3899;218;4753;4762;9.20;0.56;240.70;4.01;854;32;1608.00;9
3900;32;625371747;3900;227;4753;4762;9.14;0.55;240.73;4.01;853;32;1609.00;9
3903;32;625371767;3903;222;4753;4762;9.11;0.55;240.82;4.01;850;32;1610.00;9
3907;32;625371779;3907;223;4754;4763;9.07;0.55;240.89;4.01;847;32;1611.00;9
3908;32;625371792;3908;228;4754;4763;9.11;0.55;240.86;4.01;846;32;1612.00;9
3911;32;625371804;3911;231;4758;4769;9.07;0.55;240.96;4.01;847;32;1613.00;11
3914;32;625371818;3914;233;4758;4769;9.09;0.55;241.08;4.01;844;32;1614.00;11
3916;32;625371831;3916;237;4759;4770;9.07;0.55;241.05;4.01;843;32;1615.00;11
3918;32;625371849;3918;235;4759;4770;9.04;0.55;241.13;4.01;841;32;1616.00;11
3921;32;625371861;3921;238;4759;4770;8.97;0.54;241.12;4.01;838;32;1617.00;11
3924;32;625371873;3924;243;4759;4770;8.96;0.54;241.27;4.01;835;32;1618.00;11
3927;32;625371886;3927;250;4760;4770;8.93;0.54;241.39;4.05;833;32;1619.00;10
3930;32;625371900;3930;244;4781;4806;8.93;0.55;241.40;4.03;851;32;1620.00;25
3934;32;625371918;3934;238;4782;4806;8.91;0.54;241.59;4.03;848;32;1621.00;24
3938;32;625371931;3938;233;4785;4806;8.91;0.54;241.64;4.03;847;32;1622.00;21
3940;32;625371944;3940;227;4785;4806;8.97;0.55;241.70;4.03;845;32;1623.00;21
3942;32;625371956;3942;220;4786;4806;9.02;0.55;241.80;4.03;844;32;1624.00;20
3946;32;625371978;3946;219;4786;4806;9.08;0.55;241.78;4.03;840;32;1625.00;20
3950;32;625371990;3950;210;4790;4810;9.13;0.55;241.76;4.03;840;32;1626.00;20
3955;32;625372001;3955;207;4790;4810;9.18;0.56;241.82;4.03;835;32;1627.00;20
3960;32;625372012;3960;203;4794;4814;9.26;0.56;242.01;4.02;834;32;1628.00;20
3962;32;625372024;3962;200;4795;4815;9.32;0.57;241.99;4.02;833;32;1629.00;20
3969;32;625372035;3969;191;4796;4815;9.28;0.57;242.02;4.02;827;32;1630.00;19
3969;32;625372046;3969;184;4796;4815;9.30;0.57;242.02;4.02;827;32;1631.00;19
3972;32;625372057;3972;174;4805;4828;9.26;0.56;242.07;4.02;833;32;1632.00;23
3973;32;625372069;3973;172;4805;4828;9.22;0.56;242.04;4.02;832;32;1633.00;23
3977;32;625372081;3977;164;4805;4828;9.17;0.56;242.02;4.02;828;32;1634.00;23
3981;32;625372092;3981;159;4807;4829;9.14;0.56;242.08;4.03;826;32;1635.00;22
3983;32;625372104;3983;154;4807;4830;9.16;0.56;242.08;4.03;824;32;1636.00;23
3987;32;625372114;3987;152;4807;4830;9.27;0.56;242.11;4.03;820;32;1637.00;23
3993;32;625372125;3993;147;4809;4833;9.36;0.57;242.09;4.02;816;32;1638.00;24
3995;32;625372136;3995;144;4809;4833;9.43;0.58;242.14;4.02;814;32;1639.00;24
3998;32;625372147;3998;142;4810;4833;9.49;0.58;242.28;4.02;812;32;1640.00;23
4001;32;625372157;4001;135;4810;4833;9.54;0.58;242.35;4.02;809;32;1641.00;23
4005;32;625372168;4005;136;4814;4839;9.63;0.59;242.31;4.02;809;32;1642.00;25
4011;32;625372180;4011;140;4815;4839;9.70;0.59;242.44;4.02;804;32;1643.00;24
4013;32;625372191;4013;136;4815;4839;9.73;0.59;242.48;4.02;802;32;1644.00;24
4016;32;625372202;4016;129;4815;4839;9.78;0.60;242.47;4.02;799;32;1645.00;24
4018;32;625372213;4018;129;4819;4843;9.81;0.60;242.49;4.02;801;32;1646.00;24
4020;32;625372224;4020;128;4820;4844;9.81;0.60;242.55;4.02;800;32;1647.00;24
4023;32;625372235;4023;127;4820;4844;9.80;0.60;242.67;4.02;797;32;1648.00;24
4025;32;625372246;4025;132;4822;4845;9.92;0.60;242.76;4.03;797;32;1649.00;23
4028;32;625372258;4028;129;4823;4845;9.98;0.61;242.83;4.04;795;32;1650.00;22
4031;32;625372270;4031;139;4823;4845;10.03;0.61;242.98;4.04;792;32;1651.00;22
4035;32;625372280;4035;141;4825;4845;10.10;0.61;242.99;4.05;790;32;1652.00;20
4037;32;625372291;4037;141;4826;4845;10.20;0.62;243.12;4.05;789;32;1653.00;19
4040;32;625372302;4040;142;4826;4845;10.37;0.63;243.12;4.05;786;32;1654.00;19
4041;32;625372314;4041;147;4826;4845;10.46;0.64;243.12;4.05;785;32;1655.00;19
4043;32;625372325;4043;158;4865;4915;10.50;0.64;243.17;4.03;822;32;1656.00;50
4048;32;625372342;4048;153;4867;4916;10.47;0.64;243.28;4.03;819;32;1657.00;49
4050;32;625372354;4050;153;4877;4916;10.54;0.64;243.39;4.02;827;32;1658.00;39
4053;32;625372366;4053;153;4880;4916;10.59;0.65;243.41;4.02;827;32;1659.00;36
4056;32;625372377;4056;155;4887;4916;10.59;0.65;243.41;4.03;831;32;1660.00;29
4060;32;625372390;4060;155;4890;4916;10.60;0.65;243.51;4.04;830;32;1661.00;26
4064;32;625372402;4064;155;4893;4916;10.53;0.64;243.54;4.05;829;32;1662.00;23
4066;33;625372414;4066;150;4893;4916;10.54;0.64;243.54;4.05;827;33;1663.00;23
4069;33;625372435;4069;152;4896;4917;10.57;0.64;243.57;4.06;827;33;1664.00;21
4071;33;625372448;4071;157;4900;4919;10.46;0.64;243.61;4.07;829;33;1665.00;19
4076;33;625372464;4076;162;4901;4919;10.42;0.64;243.55;4.08;825;33;1666.00;18
4076;33;625372478;4076;164;4903;4923;10.34;0.63;243.55;4.08;827;33;1667.00;20
4078;33;625372490;4078;164;4905;4923;10.24;0.62;243.62;4.09;827;33;1668.00;18
4084;33;625372501;4084;169;4906;4923;10.08;0.61;243.76;4.10;822;33;1669.00;17
4084;33;625372513;4084;175;4907;4923;9.96;0.61;243.76;4.10;823;33;1670.00;16
4088;33;625372524;4088;187;4912;4929;9.91;0.61;243.79;4.11;824;33;1671.00;17
4092;33;625372536;4092;194;4913;4929;9.81;0.60;243.96;4.11;821;33;1672.00;16
4095;33;625372547;4095;193;4914;4929;9.76;0.60;243.95;4.11;819;33;1673.00;15
4097;33;625372559;4097;203;4917;4932;9.77;0.60;244.00;4.12;820;33;1674.00;15
4100;33;625372570;4100;214;4918;4932;9.71;0.59;243.95;4.12;818;33;1675.00;14
4101;33;625372581;4101;219;4918;4932;9.67;0.59;243.98;4.12;817;33;1676.00;14
4104;33;625372594;4104;221;4921;4933;9.57;0.59;243.99;4.13;817;33;1677.00;12
4105;33;625372605;4105;229;4923;4934;9.49;0.58;243.97;4.13;818;33;1678.00;11
4110;33;625372616;4110;226;4923;4934;9.35;0.57;244.09;4.13;813;33;1679.00;11
4116;33;625372628;4116;229;4941;4960;9.20;0.56;243.95;4.13;825;33;1680.00;19
4121;33;625372640;4121;227;4941;4960;9.18;0.56;243.93;4.13;820;33;1681.00;19
4122;33;625372651;4122;228;4945;4960;9.28;0.57;243.93;4.13;823;33;1682.00;15
4125;33;625372661;4125;230;4948;4961;9.35;0.57;243.93;4.13;823;33;1683.00;13
4128;33;625372671;4128;232;4949;4961;9.36;0.57;243.87;4.13;821;33;1684.00;12
4131;33;625372682;4131;234;4952;4965;9.40;0.57;243.83;4.12;821;33;1685.00;13
4137;33;625372693;4137;235;4952;4965;9.36;0.57;243.76;4.12;815;33;1686.00;13
4139;33;625372704;4139;242;4956;4969;9.32;0.57;243.75;4.12;817;33;1687.00;13
4141;33;625372714;4141;245;4957;4969;9.25;0.56;243.75;4.13;816;33;1688.00;12
4145;33;625372725;4145;249;4958;4969;9.14;0.56;243.91;4.13;813;33;1689.00;11
4147;33;625372735;4147;253;4958;4969;9.06;0.55;243.93;4.13;811;33;1690.00;11
4152;33;625372744;4152;263;4960;4969;8.93;0.54;243.96;4.13;808;33;1691.00;9
4154;33;625372754;4154;266;4970;4981;8.79;0.54;243.96;4.12;816;33;1692.00;11
4157;33;625372765;4157;274;4970;4981;8.60;0.52;243.94;4.12;813;33;1693.00;11
4160;33;625372775;4160;278;4973;4981;8.44;0.52;243.91;4.13;813;33;1694.00;8
4166;33;625372784;4166;288;4973;4981;8.22;0.50;243.88;4.13;807;33;1695.00;8
4168;33;625372794;4168;289;4973;4981;8.06;0.49;243.87;4.13;805;33;1696.00;8
4172;33;625372803;4172;292;4973;4981;7.85;0.48;243.99;4.13;801;33;1697.00;8
4172;33;625372813;4172;296;4974;4982;7.68;0.47;243.99;4.12;802;33;1698.00;8
4175;33;625372822;4175;298;4974;4982;7.42;0.46;244.06;4.12;799;33;1699.00;8
4180;33;625372832;4180;292;4979;4988;7.30;0.45;244.22;4.12;799;33;1700.00;9
4182;33;625372846;4182;289;4980;4989;7.19;0.44;244.18;4.12;798;33;1701.00;9
4184;33;625372855;4184;289;4981;4989;7.12;0.44;244.23;4.12;797;33;1702.00;8
4187;33;625372864;4187;282;4981;4989;7.06;0.43;244.30;4.12;794;33;1703.00;8
4193;33;625372873;4193;286;4985;4993;6.97;0.43;244.37;4.12;792;33;1704.00;8
4196;33;625372882;4196;294;4985;4993;6.97;0.43;244.47;4.12;789;33;1705.00;8
4200;33;625372891;4200;297;4985;4993;6.93;0.42;244.57;4.12;785;33;1706.00;8
4204;33;625372900;4204;290;4986;4994;6.92;0.42;244.63;4.12;782;33;1707.00;8
4207;33;625372910;4207;290;4990;4998;6.92;0.42;244.61;4.11;783;33;1708.00;8
4210;33;625372919;4210;284;4990;4998;7.01;0.43;244.58;4.11;780;33;1709.00;8
4210;33;625372930;4210;293;4993;5004;7.08;0.43;244.58;4.11;783;33;1710.00;11
4214;33;625372940;4214;293;4993;5004;7.08;0.43;244.50;4.11;779;33;1711.00;11
4215;33;625372955;4215;298;4994;5004;7.12;0.44;244.56;4.11;779;33;1712.00;10
4217;33;625372968;4217;298;4994;5004;7.14;0.44;244.60;4.11;777;33;1713.00;10
4222;33;625372985;4222;301;4997;5008;7.12;0.44;244.52;4.11;775;33;1714.00;11
4223;33;625373002;4223;305;4997;5008;7.11;0.44;244.48;4.11;774;33;1715.00;11
4226;33;625373016;4226;300;4998;5008;7.12;0.44;244.44;4.11;772;33;1716.00;10
4230;33;625373029;4230;298;4999;5008;7.06;0.43;244.47;4.11;769;33;1717.00;9
4233;33;625373043;4233;296;5000;5009;7.00;0.43;244.39;4.11;767;33;1718.00;9
4236;33;625373056;4236;299;5002;5010;7.01;0.43;244.36;4.11;766;33;1719.00;8
4242;33;625373068;4242;299;5002;5010;6.97;0.43;244.35;4.11;760;33;1720.00;8
4245;33;625373078;4245;301;5003;5011;7.06;0.43;244.25;4.11;758;33;1721.00;8
4247;33;625373089;4247;299;5003;5011;7.09;0.44;244.23;4.11;756;33;1722.00;8
4251;33;625373100;4251;301;5003;5011;7.10;0.44;244.14;4.11;752;33;1723.00;8
4253;33;625373110;4253;308;5003;5011;7.13;0.44;244.20;4.11;750;33;1724.00;8
4259;33;625373121;4259;306;5003;5011;7.13;0.44;244.05;4.11;744;33;1725.00;8
4263;33;625373131;4263;306;5003;5011;7.14;0.44;244.03;4.11;740;33;1726.00;8
4267;33;625373142;4267;303;5003;5011;7.10;0.44;243.96;4.11;736;33;1727.00;8
4273;33;625373153;4273;314;5077;5138;7.32;0.46;243.95;4.05;804;33;1728.00;61
4276;33;625373174;4276;309;5080;5139;7.26;0.45;243.96;4.05;804;33;1729.00;59
4277;33;625373186;4277;311;5090;5139;7.31;0.45;243.97;4.04;813;33;1730.00;49
4281;33;625373196;4281;315;5096;5139;7.32;0.45;243.94;4.04;815;33;1731.00;43
4283;33;625373207;4283;316;5101;5139;7.33;0.45;243.95;4.04;818;33;1732.00;38
4290;33;625373219;4290;320;5108;5139;7.35;0.46;243.84;4.09;818;33;1733.00;31
4294;33;625373230;4294;330;5112;5139;7.35;0.46;244.00;4.09;818;33;1734.00;27
4297;33;625373241;4297;338;5116;5139;7.40;0.46;243.94;4.09;819;33;1735.00;23
4300;33;625373253;4300;339;5119;5140;7.36;0.45;243.90;4.09;819;33;1736.00;21
4302;33;625373266;4302;345;5120;5141;7.32;0.45;243.91;4.09;818;33;1737.00;21
4302;33;625373277;4302;345;5122;5141;7.28;0.45;243.91;4.09;820;33;1738.00;19
4305;33;625373288;4305;338;5124;5142;7.18;0.44;243.95;4.09;819;33;1739.00;18
4306;33;625373301;4306;336;5126;5142;7.21;0.44;244.01;4.10;820;33;1740.00;16
4311;33;625373312;4311;338;5127;5142;7.18;0.44;243.98;4.10;816;33;1741.00;15
4312;33;625373323;4312;341;5128;5142;7.19;0.44;243.97;4.10;816;33;1742.00;14
4316;33;625373335;4316;339;5132;5146;7.27;0.45;244.06;4.10;816;33;1743.00;14
4318;33;625373347;4318;333;5133;5146;7.32;0.45;244.08;4.11;815;33;1744.00;13
4322;33;625373358;4322;332;5134;5146;7.34;0.45;244.03;4.11;812;33;1745.00;12
4322;33;625373376;4322;329;5137;5149;7.47;0.46;244.03;4.11;815;33;1746.00;12
4324;33;625373389;4324;314;5137;5149;7.54;0.46;243.98;4.11;813;33;1747.00;12
4324;33;625373400;4324;303;5138;5149;7.59;0.47;243.98;4.11;814;33;1748.00;11
4327;33;625373419;4327;292;5142;5153;7.67;0.47;243.98;4.11;815;33;1749.00;11
4331;33;625373431;4331;284;5144;5154;7.74;0.47;244.10;4.11;813;33;1750.00;10
4334;33;625373443;4334;275;5144;5154;7.83;0.48;244.17;4.11;810;33;1751.00;10
4336;33;625373455;4336;269;5149;5158;7.91;0.48;244.10;4.10;813;33;1752.00;9
4338;33;625373469;4338;261;5149;5158;8.02;0.49;244.12;4.10;811;33;1753.00;9
4340;33;625373484;4340;261;5149;5158;8.14;0.49;244.17;4.10;809;33;1754.00;9
4343;33;625373495;4343;264;5151;5160;8.24;0.50;244.05;4.10;808;33;1755.00;9
4343;33;625373508;4343;250;5151;5160;8.35;0.51;244.05;4.10;808;33;1756.00;9
4345;33;625373521;4345;245;5155;5166;8.43;0.51;244.00;4.10;810;33;1757.00;11
4349;33;625373535;4349;241;5156;5166;8.51;0.51;244.01;4.10;807;33;1758.00;10
4349;33;625373547;4349;238;5157;5167;8.59;0.52;244.01;4.10;808;33;1759.00;10
4351;33;625373560;4351;230;5157;5167;8.65;0.52;244.00;4.10;806;33;1760.00;10
4353;33;625373574;4353;224;5157;5167;8.67;0.53;244.06;4.10;804;33;1761.00;10
4356;33;625373587;4356;223;5157;5167;8.75;0.53;244.06;4.10;801;33;1762.00;10
4358;33;625373600;4358;229;5157;5167;8.81;0.53;244.05;4.10;799;33;1763.00;10
4360;33;625373613;4360;222;5167;5179;8.96;0.54;244.13;4.09;807;33;1764.00;12
4361;33;625373628;4361;226;5168;5179;9.10;0.55;244.11;4.09;807;33;1765.00;11
4362;33;625373640;4362;224;5168;5179;9.13;0.56;244.13;4.09;806;33;1766.00;11
4364;33;625373653;4364;225;5168;5179;9.20;0.56;244.12;4.09;804;33;1767.00;11
4367;33;625373666;4367;225;5168;5179;9.22;0.56;244.20;4.09;801;33;1768.00;11
4369;33;625373678;4369;229;5168;5179;9.24;0.56;244.25;4.09;799;33;1769.00;11
4371;33;625373693;4371;226;5171;5183;9.26;0.56;244.34;4.09;800;33;1770.00;12
4375;33;625373705;4375;224;5171;5183;9.30;0.57;244.44;4.09;796;33;1771.00;12
4378;33;625373718;4378;222;5174;5187;9.41;0.57;244.43;4.09;796;33;1772.00;13
4382;33;625373731;4382;215;5176;5188;9.49;0.58;244.52;4.09;794;33;1773.00;12
4386;33;625373743;4386;215;5176;5188;9.54;0.58;244.76;4.09;790;33;1774.00;12
4387;33;625373756;4387;216;5176;5188;9.52;0.58;244.78;4.09;789;33;1775.00;12
4389;33;625373768;4389;222;5187;5201;9.61;0.58;244.83;4.08;798;33;1776.00;14
4390;33;625373781;4390;216;5187;5201;9.59;0.58;244.85;4.08;797;33;1777.00;14
4393;33;625373799;4393;221;5187;5201;9.64;0.59;244.87;4.08;794;33;1778.00;14
4395;34;625373818;4395;223;5188;5202;9.66;0.59;244.93;4.08;793;34;1779.00;14
4399;34;625373850;4399;228;5188;5203;9.61;0.58;244.88;4.08;789;34;1780.00;15
4403;34;625373869;4403;228;5188;5203;9.60;0.58;244.96;4.08;785;34;1781.00;15
4405;34;625373881;4405;235;5190;5206;9.62;0.59;245.06;4.07;785;34;1782.00;16
4407;34;625373893;4407;234;5190;5206;9.60;0.59;245.04;4.07;783;34;1783.00;16
4411;34;625373904;4411;237;5191;5206;9.58;0.58;245.13;4.07;780;34;1784.00;15
4415;34;625373916;4415;236;5191;5206;9.53;0.58;245.18;4.07;776;34;1785.00;15
4417;34;625373927;4417;243;5195;5212;9.49;0.58;245.15;4.07;778;34;1786.00;17
4423;34;625373939;4423;249;5195;5212;9.42;0.57;245.33;4.07;772;34;1787.00;17
4424;34;625373954;4424;248;5196;5212;9.39;0.57;245.37;4.07;772;34;1788.00;16
4427;34;625373966;4427;245;5196;5212;9.31;0.57;245.42;4.07;769;34;1789.00;16
4428;34;625373977;4428;237;5199;5216;9.30;0.57;245.44;4.07;771;34;1790.00;17
4431;34;625373990;4431;231;5200;5217;9.34;0.57;245.52;4.07;769;34;1791.00;17
4434;34;625374001;4434;220;5200;5217;9.40;0.57;245.57;4.07;766;34;1792.00;17
4438;34;625374012;4438;216;5201;5218;9.46;0.58;245.61;4.07;763;34;1793.00;17
4439;34;625374023;4439;208;5201;5218;9.50;0.58;245.60;4.07;762;34;1794.00;17
4441;34;625374034;4441;201;5201;5218;9.58;0.58;245.62;4.07;760;34;1795.00;17
4444;34;625374044;4444;197;5201;5218;9.67;0.59;245.62;4.07;757;34;1796.00;17
4448;34;625374054;4448;195;5201;5218;9.73;0.59;245.63;4.07;753;34;1797.00;17
4449;34;625374065;4449;188;5201;5218;9.75;0.59;245.60;4.07;752;34;1798.00;17
4453;34;625374075;4453;181;5201;5218;9.77;0.60;245.66;4.07;748;34;1799.00;17
4456;34;625374088;4456;190;5264;5356;9.63;0.59;245.78;4.02;808;34;1800.00;92
4460;34;625374114;4460;175;5264;5357;9.63;0.59;245.84;4.02;804;34;1801.00;93
4466;34;625374125;4466;159;5274;5357;9.61;0.59;245.98;4.02;808;34;1802.00;83
4467;34;625374136;4467;149;5277;5357;9.69;0.60;246.03;4.02;810;34;1803.00;80
4469;34;625374147;4469;147;5281;5357;9.75;0.60;246.13;4.02;812;34;1804.00;76
4473;34;625374157;4473;140;5287;5357;9.77;0.60;246.31;4.03;814;34;1805.00;70
4478;34;625374175;4478;141;5291;5357;9.73;0.60;246.33;4.03;813;34;1806.00;66
4484;34;625374186;4484;143;5294;5357;9.72;0.60;246.29;4.03;810;34;1807.00;63
4488;34;625374197;4488;140;5298;5358;9.71;0.60;246.44;4.04;810;34;1808.00;60
4491;34;625374209;4491;138;5300;5359;9.69;0.59;246.44;4.04;809;34;1809.00;59
4496;34;625374220;4496;143;5304;5359;9.64;0.59;246.54;4.08;808;34;1810.00;55
4500;34;625374232;4500;137;5308;5363;9.63;0.59;246.56;4.08;808;34;1811.00;55
4502;34;625374243;4502;136;5309;5363;9.62;0.59;246.53;4.08;807;34;1812.00;54
4506;34;625374255;4506;138;5309;5363;9.63;0.59;246.60;4.08;803;34;1813.00;54
4510;34;625374267;4510;137;5311;5363;9.60;0.59;246.58;4.13;801;34;1814.00;52
4512;34;625374278;4512;135;5313;5369;9.59;0.59;246.55;4.13;801;34;1815.00;56
4519;34;625374290;4519;134;5315;5369;9.56;0.58;246.62;4.13;796;34;1816.00;54
4522;34;625374301;4522;135;5317;5369;9.61;0.59;246.62;4.17;795;34;1817.00;52
4523;34;625374313;4523;138;5320;5372;9.67;0.59;246.67;4.17;797;34;1818.00;52
4526;34;625374324;4526;141;5321;5372;9.74;0.59;246.75;4.17;795;34;1819.00;51
4529;34;625374336;4529;143;5323;5372;9.75;0.60;246.83;4.21;794;34;1820.00;49
4533;34;625374347;4533;143;5324;5373;9.79;0.60;246.82;4.21;791;34;1821.00;49
4536;34;625374358;4536;143;5327;5374;9.84;0.60;246.99;4.22;791;34;1822.00;47
4540;34;625374369;4540;142;5327;5374;9.86;0.60;246.93;4.22;787;34;1823.00;47
4542;34;625374380;4542;143;5333;5387;9.95;0.61;246.97;4.21;791;34;1824.00;54
4543;34;625374393;4543;141;5334;5387;10.03;0.61;246.94;4.21;791;34;1825.00;53
4546;34;625374404;4546;145;5337;5387;10.07;0.61;247.03;4.23;791;34;1826.00;50
4550;34;625374415;4550;152;5340;5388;10.16;0.62;247.01;4.23;790;34;1827.00;48
4551;34;625374428;4551;157;5341;5388;10.22;0.62;247.05;4.23;790;34;1828.00;47
4555;34;625374439;4555;164;5344;5392;10.15;0.62;247.11;4.23;789;34;1829.00;48
4556;34;625374454;4556;166;5347;5392;10.07;0.61;247.13;4.26;791;34;1830.00;45
4560;34;625374465;4560;174;5351;5396;9.95;0.61;247.18;4.26;791;34;1831.00;45
4562;34;625374478;4562;177;5353;5396;9.87;0.60;247.22;4.27;791;34;1832.00;43
4565;34;625374489;4565;180;5354;5396;9.89;0.60;247.28;4.27;789;34;1833.00;42
4566;34;625374500;4566;186;5356;5396;9.90;0.60;247.25;4.29;790;34;1834.00;40
4569;34;625374511;4569;192;5358;5396;9.81;0.60;247.29;4.30;789;34;1835.00;38
4572;34;625374522;4572;192;5369;5408;9.85;0.60;247.25;4.30;797;34;1836.00;39
4575;34;625374534;4575;190;5371;5408;9.85;0.60;247.33;4.30;796;34;1837.00;37
4577;34;625374545;4577;188;5374;5408;9.90;0.61;247.34;4.32;797;34;1838.00;34
4580;34;625374556;4580;188;5377;5408;9.91;0.61;247.40;4.33;797;34;1839.00;31
4583;34;625374567;4583;188;5378;5408;9.83;0.60;247.47;4.33;795;34;1840.00;30
4585;34;625374578;4585;197;5378;5408;9.84;0.60;247.47;4.33;793;34;1841.00;30
4588;34;625374588;4588;199;5379;5409;9.86;0.60;247.50;4.34;791;34;1842.00;30
4591;34;625374599;4591;201;5380;5409;9.86;0.60;247.57;4.34;789;34;1843.00;29
4594;34;625374610;4594;207;5385;5415;9.84;0.60;247.58;4.35;791;34;1844.00;30
4599;34;625374621;4599;214;5389;5417;9.72;0.59;247.50;4.35;790;34;1845.00;28
4602;34;625374632;4602;224;5390;5417;9.56;0.58;247.48;4.35;788;34;1846.00;27
4607;34;625374642;4607;226;5391;5417;9.40;0.57;247.56;4.36;784;34;1847.00;26
4608;34;625374653;4608;234;5395;5421;9.31;0.57;247.59;4.36;787;34;1848.00;26
4611;34;625374663;4611;234;5395;5421;9.18;0.56;247.56;4.36;784;34;1849.00;26
4614;34;625374674;4614;237;5396;5421;9.09;0.55;247.57;4.36;782;34;1850.00;25
4616;34;625374690;4616;240;5398;5422;9.00;0.55;247.59;4.37;782;34;1851.00;24
4617;34;625374699;4617;247;5402;5426;8.89;0.54;247.58;4.37;785;34;1852.00;24
4619;34;625374710;4619;244;5404;5426;8.80;0.54;247.60;4.38;785;34;1853.00;22
4622;34;625374719;4622;244;5406;5429;8.76;0.53;247.58;4.38;784;34;1854.00;23
4624;34;625374729;4624;244;5408;5429;8.78;0.53;247.56;4.38;784;34;1855.00;21
4626;34;625374738;4626;243;5409;5429;8.79;0.54;247.51;4.38;783;34;1856.00;20
4628;34;625374748;4628;238;5410;5429;8.80;0.54;247.49;4.38;782;34;1857.00;19
4630;34;625374757;4630;240;5413;5433;8.85;0.54;247.43;4.38;783;34;1858.00;20
4632;34;625374773;4632;245;5413;5433;8.78;0.54;247.46;4.38;781;34;1859.00;20
4635;34;625374784;4635;249;5414;5433;8.67;0.53;247.49;4.38;779;34;1860.00;19
4638;34;625374794;4638;252;5414;5433;8.49;0.52;247.59;4.38;776;34;1861.00;19
4642;34;625374803;4642;259;5415;5434;8.33;0.51;247.55;4.38;773;34;1862.00;19
4645;34;625374812;4645;268;5416;5435;8.15;0.50;247.57;4.38;771;34;1863.00;19
4647;34;625374821;4647;272;5416;5435;8.07;0.50;247.58;4.38;769;34;1864.00;19
4651;34;625374830;4651;278;5417;5436;7.94;0.49;247.53;4.38;766;34;1865.00;19
4656;34;625374840;4656;287;5417;5436;7.76;0.48;247.48;4.38;761;34;1866.00;19
4657;34;625374848;4657;289;5417;5436;7.59;0.47;247.52;4.38;760;34;1867.00;19
4661;34;625374857;4661;296;5417;5436;7.34;0.45;247.43;4.38;756;34;1868.00;19
4665;34;625374865;4665;299;5417;5436;7.08;0.44;247.30;4.38;752;34;1869.00;19
4670;34;625374873;4670;293;5417;5436;6.94;0.43;247.22;4.38;747;34;1870.00;19
4671;34;625374881;4671;296;5417;5436;6.85;0.42;247.19;4.38;746;34;1871.00;19
4672;34;625374890;4672;314;5489;5563;7.09;0.45;247.17;4.32;817;34;1872.00;74
4676;34;625374913;4676;311;5494;5564;6.96;0.44;247.35;4.32;818;34;1873.00;70
4680;34;625374922;4680;305;5503;5564;6.99;0.44;247.35;4.32;823;34;1874.00;61
4682;34;625374931;4682;304;5506;5564;6.91;0.43;247.39;4.31;824;34;1875.00;58
4685;34;625374940;4685;308;5511;5564;6.93;0.43;247.43;4.31;826;34;1876.00;53
4689;34;625374951;4689;307;5517;5564;6.90;0.43;247.46;4.31;828;34;1877.00;47
4691;34;625374965;4691;306;5522;5564;6.93;0.43;247.58;4.32;831;34;1878.00;42
4695;34;625374986;4695;305;5525;5564;6.88;0.43;247.58;4.32;830;34;1879.00;39
4696;34;625375001;4696;310;5530;5565;6.96;0.43;247.59;4.32;834;34;1880.00;35
4700;34;625375018;4700;319;5532;5566;6.91;0.43;247.62;4.32;832;34;1881.00;34
4703;34;625375033;4703;328;5536;5568;6.89;0.43;247.68;4.33;833;34;1882.00;32
4705;34;625375047;4705;330;5538;5569;6.91;0.43;247.68;4.33;833;34;1883.00;31
4708;34;625375062;4708;329;5541;5569;6.87;0.42;247.70;4.33;833;34;1884.00;28
4712;34;625375075;4712;338;5542;5569;6.84;0.42;247.68;4.33;830;34;1885.00;27
4715;34;625375086;4715;340;5544;5569;6.79;0.42;247.62;4.33;829;34;1886.00;25
4718;34;625375098;4718;345;5547;5573;6.69;0.41;247.67;4.33;829;34;1887.00;26
4720;34;625375108;4720;353;5549;5573;6.60;0.41;247.59;4.34;829;34;1888.00;24
4722;34;625375119;4722;351;5551;5573;6.56;0.40;247.64;4.34;829;34;1889.00;22
4723;34;625375131;4723;356;5554;5579;6.51;0.40;247.65;4.34;831;34;1890.00;25
4726;34;625375142;4726;347;5556;5579;6.52;0.40;247.63;4.33;830;34;1891.00;23
4729;34;625375154;4729;338;5556;5579;6.51;0.40;247.57;4.33;827;34;1892.00;23
4733;34;625375165;4733;337;5561;5583;6.51;0.40;247.65;4.33;828;34;1893.00;22
4736;34;625375176;4736;333;5563;5584;6.61;0.40;247.63;4.33;827;34;1894.00;21
4739;34;625375188;4739;330;5563;5584;6.69;0.41;247.58;4.33;824;34;1895.00;21
4741;34;625375198;4741;330;5567;5588;6.78;0.42;247.65;4.33;826;34;1896.00;21
4743;34;625375209;4743;325;5567;5588;6.91;0.42;247.85;4.33;824;34;1897.00;21
4749;34;625375240;4749;326;5567;5588;6.96;0.43;247.69;4.33;818;34;1898.00;21
4752;34;625375258;4752;330;5568;5589;7.07;0.43;247.73;4.33;816;34;1899.00;21
4753;34;625375270;4753;328;5568;5589;7.18;0.44;247.74;4.33;815;34;1900.00;21
4756;34;625375284;4756;337;5573;5595;7.23;0.44;247.87;4.32;817;34;1901.00;22
4759;34;625375296;4759;334;5573;5595;7.26;0.44;247.86;4.32;814;34;1902.00;22
4763;34;625375308;4763;330;5575;5596;7.30;0.45;247.71;4.32;812;34;1903.00;21
4765;34;625375320;4765;328;5575;5596;7.35;0.45;247.72;4.32;810;34;1904.00;21
4767;34;625375332;4767;324;5575;5596;7.38;0.45;247.75;4.32;808;34;1905.00;21
4771;34;625375349;4771;324;5575;5596;7.44;0.45;247.78;4.32;804;34;1906.00;21
4773;34;625375360;4773;327;5575;5596;7.47;0.46;247.73;4.32;802;34;1907.00;21
4776;35;625375371;4776;329;5585;5608;7.59;0.46;247.78;4.32;809;35;1908.00;23
4780;35;625375391;4780;332;5586;5608;7.57;0.46;247.73;4.32;806;35;1909.00;22
4782;35;625375403;4782;337;5587;5608;7.56;0.46;247.74;4.32;805;35;1910.00;21
4785;35;625375419;4785;339;5587;5608;7.57;0.46;247.78;4.32;802;35;1911.00;21
4787;35;625375430;4787;340;5587;5608;7.54;0.46;247.80;4.32;800;35;1912.00;21
4792;35;625375442;4792;338;5587;5608;7.51;0.46;247.74;4.32;795;35;1913.00;21
4793;35;625375454;4793;344;5590;5612;7.48;0.46;247.71;4.31;797;35;1914.00;22
4796;35;625375466;4796;345;5590;5612;7.44;0.45;247.72;4.31;794;35;1915.00;22
4799;35;625375478;4799;341;5593;5616;7.38;0.45;247.66;4.31;794;35;1916.00;23
4802;35;625375491;4802;331;5594;5617;7.39;0.45;247.72;4.31;792;35;1917.00;23
4804;35;625375502;4804;327;5595;5617;7.40;0.45;247.75;4.31;791;35;1918.00;22
4806;35;625375514;4806;322;5596;5617;7.40;0.45;247.77;4.36;790;35;1919.00;21
4811;35;625375528;4811;324;5616;5646;7.52;0.46;247.93;4.34;805;35;1920.00;30
4811;35;625375542;4811;320;5616;5646;7.61;0.47;247.93;4.34;805;35;1921.00;30
4817;35;625375554;4817;319;5619;5646;7.67;0.47;247.90;4.34;802;35;1922.00;27
4820;35;625375567;4820;311;5621;5647;7.72;0.47;247.95;4.34;801;35;1923.00;26
4824;35;625375579;4824;311;5622;5648;7.77;0.47;248.03;4.34;798;35;1924.00;26
4829;35;625375590;4829;310;5622;5648;7.74;0.47;248.11;4.34;793;35;1925.00;26
4834;35;625375602;4834;295;5625;5651;7.72;0.47;248.32;4.34;791;35;1926.00;26
4837;35;625375615;4837;278;5625;5651;7.75;0.47;248.27;4.34;788;35;1927.00;26
4839;35;625375628;4839;261;5625;5651;7.80;0.47;248.24;4.34;786;35;1928.00;26
4841;35;625375640;4841;253;5625;5651;7.88;0.48;248.23;4.34;784;35;1929.00;26
4844;35;625375652;4844;250;5629;5657;8.01;0.49;248.21;4.33;785;35;1930.00;28
4845;35;625375674;4845;246;5629;5657;8.11;0.49;248.23;4.33;784;35;1931.00;28
4847;35;625375687;4847;244;5630;5657;8.15;0.50;248.26;4.33;783;35;1932.00;27
4849;35;625375698;4849;245;5630;5657;8.23;0.50;248.30;4.33;781;35;1933.00;27
4850;35;625375710;4850;250;5633;5661;8.23;0.50;248.29;4.33;783;35;1934.00;28
4854;35;625375728;4854;249;5636;5663;8.26;0.50;248.32;4.38;782;35;1935.00;27
4857;35;625375740;4857;251;5636;5663;8.27;0.50;248.36;4.38;779;35;1936.00;27
4860;35;625375753;4860;244;5637;5664;8.29;0.50;248.36;4.37;777;35;1937.00;27
4862;35;625375767;4862;241;5637;5664;8.35;0.51;248.39;4.37;775;35;1938.00;27
4864;35;625375779;4864;238;5637;5664;8.36;0.51;248.43;4.37;773;35;1939.00;27
4867;35;625375791;4867;238;5637;5664;8.35;0.51;248.47;4.37;770;35;1940.00;27
4868;35;625375802;4868;229;5637;5664;8.44;0.51;248.50;4.37;769;35;1941.00;27
4870;35;625375814;4870;228;5637;5664;8.50;0.52;248.52;4.37;767;35;1942.00;27
4871;35;625375826;4871;231;5637;5664;8.59;0.52;248.51;4.37;766;35;1943.00;27
4873;35;625375839;4873;247;5680;5734;8.51;0.52;248.54;4.39;807;35;1944.00;54
4874;35;625375856;4874;241;5680;5735;8.63;0.53;248.55;4.39;806;35;1945.00;55
4877;35;625375868;4877;234;5685;5735;8.83;0.54;248.55;4.39;808;35;1946.00;50
4882;35;625375879;4882;223;5685;5735;8.87;0.54;248.50;4.39;803;35;1947.00;50
4885;35;625375891;4885;221;5688;5735;8.93;0.55;248.59;4.39;803;35;1948.00;47
4889;35;625375902;4889;218;5690;5735;8.93;0.54;248.59;4.39;801;35;1949.00;45
4892;35;625375916;4892;222;5693;5737;8.98;0.55;248.66;4.39;801;35;1950.00;44
4894;35;625375929;4894;222;5693;5737;9.02;0.55;248.74;4.39;799;35;1951.00;44
4894;35;625375941;4894;229;5696;5738;9.04;0.55;248.74;4.39;802;35;1952.00;42
4898;35;625375960;4898;229;5699;5739;9.06;0.55;248.84;4.39;801;35;1953.00;40
4899;35;625375973;4899;228;5702;5739;9.11;0.56;248.82;4.43;803;35;1954.00;37
4901;35;625375986;4901;236;5707;5743;9.05;0.55;248.79;4.43;806;35;1955.00;36
4902;35;625376009;4902;237;5708;5743;9.09;0.56;248.80;4.43;806;35;1956.00;35
4907;35;625376020;4907;248;5709;5743;9.06;0.55;248.83;4.43;802;35;1957.00;34
4907;35;625376030;4907;247;5710;5743;9.09;0.56;248.83;4.43;803;35;1958.00;33
4907;35;625376041;4907;249;5715;5749;9.01;0.55;248.83;4.43;808;35;1959.00;34
4910;35;625376052;4910;248;5716;5749;9.03;0.55;248.82;4.43;806;35;1960.00;33
4912;35;625376065;4912;246;5717;5749;9.01;0.55;248.80;4.43;805;35;1961.00;32
4915;35;625376076;4915;248;5721;5752;9.03;0.55;248.82;4.47;806;35;1962.00;31
4916;35;625376087;4916;244;5721;5752;9.08;0.55;248.83;4.47;805;35;1963.00;31
4919;35;625376105;4919;238;5721;5752;9.13;0.55;248.83;4.47;802;35;1964.00;31
4924;35;625376116;4924;233;5721;5753;9.14;0.55;248.89;4.47;797;35;1965.00;32
4926;35;625376127;4926;232;5722;5754;9.14;0.55;248.89;4.47;796;35;1966.00;32
4929;35;625376144;4929;224;5723;5754;9.15;0.55;248.86;4.50;794;35;1967.00;31
4931;35;625376155;4931;228;5732;5767;9.14;0.55;248.87;4.49;801;35;1968.00;35
4934;35;625376167;4934;220;5732;5767;9.17;0.56;248.89;4.49;798;35;1969.00;35
4937;35;625376178;4937;210;5732;5767;9.23;0.56;248.94;4.49;795;35;1970.00;35
4940;35;625376189;4940;208;5734;5768;9.24;0.56;249.00;4.52;794;35;1971.00;34
4942;35;625376199;4942;192;5734;5768;9.23;0.56;249.10;4.52;792;35;1972.00;34
4944;35;625376211;4944;180;5737;5772;9.30;0.56;249.11;4.52;793;35;1973.00;35
4947;35;625376222;4947;165;5738;5772;9.34;0.57;249.26;4.53;791;35;1974.00;34
4951;35;625376238;4951;157;5743;5776;9.35;0.57;249.31;4.54;792;35;1975.00;33
4954;35;625376250;4954;153;5743;5776;9.44;0.57;249.30;4.54;789;35;1976.00;33
4958;35;625376260;4958;151;5743;5776;9.50;0.58;249.42;4.54;785;35;1977.00;33
4965;35;625376271;4965;144;5743;5776;9.50;0.58;249.43;4.54;778;35;1978.00;33
4966;35;625376281;4966;141;5743;5776;9.62;0.58;249.40;4.54;777;35;1979.00;33
4969;35;625376293;4969;141;5762;5810;9.66;0.59;249.55;4.52;793;35;1980.00;48
4971;35;625376307;4971;140;5763;5810;9.62;0.58;249.66;4.52;792;35;1981.00;47
4974;35;625376317;4974;132;5764;5810;9.59;0.58;249.63;4.52;790;35;1982.00;46
4977;35;625376328;4977;127;5766;5810;9.50;0.58;249.72;4.55;789;35;1983.00;44
4978;35;625376338;4978;130;5766;5810;9.40;0.57;249.77;4.55;788;35;1984.00;44
4982;35;625376355;4982;131;5767;5810;9.36;0.57;249.77;4.55;785;35;1985.00;43
4983;35;625376365;4983;136;5767;5811;9.39;0.57;249.81;4.55;784;35;1986.00;44
4985;35;625376375;4985;142;5770;5811;9.39;0.57;249.88;4.58;785;35;1987.00;41
4990;35;625376385;4990;145;5772;5817;9.38;0.57;249.79;4.58;782;35;1988.00;45
4992;35;625376396;4992;145;5776;5818;9.45;0.57;249.86;4.58;784;35;1989.00;42
4996;35;625376406;4996;146;5776;5818;9.52;0.58;249.85;4.58;780;35;1990.00;42
4998;35;625376417;4998;149;5778;5818;9.56;0.58;249.89;4.62;780;35;1991.00;40
5002;35;625376427;5002;148;5781;5822;9.56;0.58;249.89;4.62;779;35;1992.00;41
5007;35;625376438;5007;150;5781;5822;9.59;0.58;249.99;4.62;774;35;1993.00;41
5009;35;625376449;5009;157;5782;5822;9.61;0.58;249.98;4.63;773;35;1994.00;40
5011;35;625376460;5011;161;5784;5823;9.65;0.59;250.00;4.63;773;35;1995.00;39
5015;35;625376471;5015;169;5787;5827;9.60;0.58;250.13;4.63;772;35;1996.00;40
5016;35;625376481;5016;172;5788;5827;9.51;0.58;250.16;4.64;772;35;1997.00;39
5019;35;625376497;5019;174;5790;5830;9.46;0.57;250.24;4.64;771;35;1998.00;40
5019;35;625376508;5019;182;5793;5830;9.49;0.58;250.24;4.65;774;35;1999.00;37
5019;35;625376519;5019;184;5795;5830;9.46;0.58;250.24;4.66;776;35;2000.00;35
5020;35;625376533;5020;191;5796;5830;9.39;0.57;250.27;4.66;776;35;2001.00;34
5023;35;625376544;5023;191;5800;5834;9.39;0.57;250.29;4.67;777;35;2002.00;34
5024;35;625376555;5024;197;5803;5834;9.39;0.57;250.29;4.68;779;35;2003.00;31
5028;35;625376565;5028;204;5803;5834;9.32;0.57;250.38;4.68;775;35;2004.00;31
5029;35;625376576;5029;206;5805;5834;9.34;0.57;250.42;4.70;776;35;2005.00;29
5030;35;625376586;5030;207;5805;5835;9.33;0.57;250.44;4.70;775;35;2006.00;30
5034;35;625376597;5034;210;5808;5836;9.29;0.57;250.47;4.71;774;35;2007.00;28
5037;35;625376607;5037;208;5810;5836;9.24;0.56;250.48;4.72;773;35;2008.00;26
5038;35;625376617;5038;213;5811;5837;9.22;0.56;250.45;4.72;773;35;2009.00;26
5040;35;625376629;5040;218;5812;5837;9.12;0.56;250.39;4.73;772;35;2010.00;25
5040;35;625376639;5040;223;5813;5837;9.10;0.56;250.39;4.74;773;35;2011.00;24
5041;35;625376649;5041;224;5813;5837;9.04;0.55;250.37;4.74;772;35;2012.00;24
5046;35;625376658;5046;230;5814;5837;8.90;0.54;250.38;4.74;768;35;2013.00;23
5048;35;625376668;5048;234;5814;5837;8.80;0.54;250.33;4.74;766;35;2014.00;23
5053;35;625376678;5053;242;5815;5837;8.68;0.53;250.34;4.75;762;35;2015.00;22
5054;35;625376687;5054;265;5877;5964;8.70;0.54;250.45;4.71;823;35;2016.00;87
5056;35;625376706;5056;264;5879;5965;8.59;0.53;250.44;4.71;823;35;2017.00;86
5059;35;625376716;5059;266;5891;5965;8.60;0.53;250.33;4.71;832;35;2018.00;74
5063;35;625376726;5063;267;5899;5965;8.55;0.53;250.29;4.71;836;35;2019.00;66
5063;35;625376735;5063;263;5907;5965;8.53;0.53;250.29;4.71;844;35;2020.00;58
5064;35;625376745;5064;266;5914;5965;8.48;0.52;250.25;4.71;850;35;2021.00;51
5065;35;625376755;5065;263;5920;5965;8.39;0.52;250.23;4.72;855;35;2022.00;45
5066;35;625376764;5066;264;5924;5965;8.30;0.51;250.24;4.72;858;35;2023.00;41
5067;35;625376774;5067;265;5928;5966;8.28;0.51;250.21;4.72;861;35;2024.00;38
5073;35;625376784;5073;268;5934;5968;8.18;0.50;250.06;4.73;861;35;2025.00;34
5075;35;625376794;5075;272;5936;5968;8.22;0.51;250.03;4.73;861;35;2026.00;32
5078;35;625376804;5078;278;5937;5969;8.24;0.51;249.96;4.73;859;35;2027.00;32
5080;35;625376815;5080;284;5939;5969;8.19;0.50;249.92;4.73;859;35;2028.00;30
5080;35;625376826;5080;289;5941;5969;8.13;0.50;249.92;4.73;861;35;2029.00;28
5081;35;625376836;5081;298;5945;5969;7.98;0.49;249.93;4.74;864;35;2030.00;24
5082;35;625376846;5082;310;5948;5973;7.80;0.48;249.93;4.74;866;35;2031.00;25
5085;35;625376856;5085;317;5950;5973;7.64;0.47;249.91;4.74;865;35;2032.00;23
5089;35;625376865;5089;327;5950;5973;7.44;0.46;249.88;4.74;861;35;2033.00;23
5090;35;625376875;5090;339;5953;5976;7.36;0.45;249.88;4.75;863;35;2034.00;23
5092;35;625376884;5092;343;5954;5976;7.21;0.44;249.84;4.75;862;35;2035.00;22
5095;35;625376894;5095;351;5955;5976;7.07;0.43;249.77;4.75;860;35;2036.00;21
5098;35;625376903;5098;354;5960;5980;6.92;0.42;249.75;4.74;862;35;2037.00;20
5101;35;625376913;5101;365;5962;5981;6.78;0.42;249.76;4.74;861;35;2038.00;19
5108;35;625376922;5108;370;5962;5981;6.58;0.40;249.68;4.74;854;35;2039.00;19
5109;35;625376933;5109;364;5968;5986;6.54;0.40;249.71;4.74;859;35;2040.00;18
5111;35;625376943;5111;358;5968;5986;6.43;0.40;249.73;4.74;857;35;2041.00;18
5112;35;625376955;5112;356;5968;5986;6.38;0.39;249.76;4.74;856;35;2042.00;18
5116;35;625376969;5116;342;5969;5987;6.36;0.39;249.74;4.74;853;35;2043.00;18
5117;35;625376984;5117;331;5969;5987;6.38;0.39;249.77;4.74;852;35;2044.00;18
5123;35;625377000;5123;324;5974;5993;6.42;0.39;249.71;4.74;851;35;2045.00;19
5125;35;625377020;5125;315;5974;5993;6.48;0.40;249.78;4.74;849;35;2046.00;19
5126;35;625377034;5126;307;5976;5994;6.56;0.40;249.83;4.74;850;35;2047.00;18
5129;36;625377049;5129;302;5976;5994;6.65;0.41;249.75;4.74;847;36;2048.00;18
5131;36;625377078;5131;293;5976;5994;6.77;0.42;249.78;4.74;845;36;2049.00;18
5133;36;625377096;5133;285;5976;5994;6.90;0.42;249.74;4.74;843;36;2050.00;18
5136;36;625377115;5136;282;5976;5994;6.94;0.43;249.78;4.74;840;36;2051.00;18
5139;36;625377134;5139;282;5987;6006;6.98;0.43;249.80;4.73;848;36;2052.00;19
5141;36;625377146;5141;272;5987;6006;7.01;0.43;249.76;4.73;846;36;2053.00;19
5146;36;625377158;5146;274;5988;6006;7.04;0.43;249.74;4.73;842;36;2054.00;18
5146;36;625377170;5146;271;5988;6006;7.14;0.44;249.74;4.73;842;36;2055.00;18
5149;36;625377182;5149;266;5988;6006;7.21;0.44;249.74;4.73;839;36;2056.00;18
5150;36;625377195;5150;265;5988;6006;7.30;0.45;249.78;4.73;838;36;2057.00;18
5152;36;625377206;5152;260;5992;6010;7.39;0.45;249.76;4.72;840;36;2058.00;18
5155;36;625377217;5155;252;5992;6010;7.43;0.45;249.77;4.72;837;36;2059.00;18
5157;36;625377229;5157;249;5995;6014;7.55;0.46;249.73;4.72;838;36;2060.00;19
5161;36;625377240;5161;245;5996;6015;7.54;0.46;249.84;4.72;835;36;2061.00;19
5164;36;625377252;5164;245;5997;6015;7.55;0.46;249.81;4.72;833;36;2062.00;18
5166;36;625377264;5166;250;5997;6015;7.54;0.46;249.82;4.72;831;36;2063.00;18
5168;36;625377275;5168;253;6009;6028;7.61;0.47;249.85;4.71;841;36;2064.00;19
5173;36;625377288;5173;257;6009;6028;7.63;0.47;249.88;4.71;836;36;2065.00;19
5178;36;625377300;5178;258;6010;6028;7.66;0.47;249.98;4.71;832;36;2066.00;18
5181;36;625377320;5181;254;6011;6029;7.73;0.47;250.01;4.71;830;36;2067.00;18
5189;36;625377338;5189;264;6012;6030;7.72;0.47;250.12;4.71;823;36;2068.00;18
5192;36;625377350;5192;269;6012;6030;7.77;0.47;250.27;4.71;820;36;2069.00;18
5195;36;625377364;5195;266;6015;6036;7.81;0.48;250.40;4.71;820;36;2070.00;21
5200;36;625377377;5200;268;6015;6036;7.81;0.48;250.49;4.71;815;36;2071.00;21
5204;36;625377389;5204;265;6016;6036;7.84;0.48;250.53;4.71;812;36;2072.00;20
5207;36;625377401;5207;269;6016;6036;7.88;0.48;250.50;4.71;809;36;2073.00;20
5210;36;625377413;5210;269;6021;6042;8.02;0.49;250.52;4.71;811;36;2074.00;21
5214;36;625377425;5214;272;6021;6042;8.07;0.49;250.52;4.71;807;36;2075.00;21
5221;36;625377438;5221;263;6023;6042;8.05;0.49;250.54;4.75;802;36;2076.00;19
5226;36;625377450;5226;263;6023;6042;8.03;0.49;250.66;4.75;797;36;2077.00;19
5228;36;625377461;5228;262;6028;6046;8.07;0.49;250.69;4.75;800;36;2078.00;18
5232;36;625377475;5232;264;6029;6047;8.08;0.49;250.78;4.75;797;36;2079.00;18
5235;36;625377487;5235;262;6030;6047;8.06;0.49;250.82;4.75;795;36;2080.00;17
5238;36;625377499;5238;266;6031;6048;8.05;0.49;250.92;4.75;793;36;2081.00;17
5241;36;625377512;5241;271;6031;6048;8.07;0.49;250.98;4.75;790;36;2082.00;17
5246;36;625377523;5246;276;6031;6048;8.01;0.49;251.02;4.75;785;36;2083.00;17
5250;36;625377536;5250;281;6031;6048;7.93;0.48;251.11;4.75;781;36;2084.00;17
5254;36;625377548;5254;287;6031;6048;7.91;0.48;251.18;4.75;777;36;2085.00;17
5255;36;625377559;5255;287;6031;6048;7.88;0.48;251.21;4.75;776;36;2086.00;17
5259;36;625377571;5259;279;6031;6048;7.82;0.48;251.32;4.75;772;36;2087.00;17
5262;36;625377583;5262;288;6076;6118;7.89;0.48;251.37;4.71;814;36;2088.00;42
5266;36;625377602;5266;281;6077;6119;7.90;0.48;251.44;4.71;811;36;2089.00;42
5270;36;625377614;5270;272;6082;6119;8.00;0.49;251.55;4.71;812;36;2090.00;37
5274;36;625377626;5274;264;6084;6119;8.11;0.49;251.57;4.71;810;36;2091.00;35
5277;36;625377638;5277;271;6088;6119;8.24;0.50;251.59;4.71;811;36;2092.00;31
5281;36;625377651;5281;270;6092;6119;8.35;0.51;251.68;4.71;811;36;2093.00;27
5284;36;625377663;5284;272;6097;6119;8.44;0.52;251.73;4.71;813;36;2094.00;22
5289;36;625377675;5289;268;6097;6119;8.42;0.51;251.70;4.71;808;36;2095.00;22
5293;36;625377688;5293;259;6099;6120;8.43;0.51;251.74;4.71;806;36;2096.00;21
5297;36;625377701;5297;250;6100;6121;8.47;0.51;251.69;4.71;803;36;2097.00;21
5299;36;625377714;5299;235;6101;6121;8.54;0.52;251.66;4.71;802;36;2098.00;20
5301;36;625377727;5301;234;6105;6125;8.57;0.52;251.68;4.76;804;36;2099.00;20
5303;36;625377744;5303;236;6109;6140;8.62;0.52;251.70;4.75;806;36;2100.00;31
5307;36;625377771;5307;236;6109;6140;8.71;0.53;251.68;4.75;802;36;2101.00;31
5308;36;625377785;5308;233;6109;6140;8.82;0.54;251.69;4.75;801;36;2102.00;31
5309;36;625377797;5309;230;6112;6146;8.91;0.54;251.71;4.75;803;36;2103.00;34
5313;36;625377811;5313;225;6112;6146;8.93;0.54;251.73;4.75;799;36;2104.00;34
5315;36;625377824;5315;221;6112;6146;8.93;0.54;251.80;4.75;797;36;2105.00;34
5317;36;625377844;5317;225;6116;6149;8.96;0.55;251.79;4.75;799;36;2106.00;33
5319;36;625377856;5319;218;6116;6149;8.93;0.55;251.79;4.75;797;36;2107.00;33
5322;36;625377876;5322;210;6116;6149;8.96;0.55;251.78;4.75;794;36;2108.00;33
5323;36;625377890;5323;206;6116;6150;9.05;0.55;251.85;4.75;793;36;2109.00;34
5325;36;625377903;5325;201;6117;6151;9.10;0.56;251.85;4.75;792;36;2110.00;34
5327;36;625377915;5327;193;6118;6151;9.15;0.56;251.84;4.75;791;36;2111.00;33
5331;36;625377928;5331;197;6127;6164;9.12;0.56;251.74;4.74;796;36;2112.00;37
5332;36;625377943;5332;194;6128;6164;9.17;0.56;251.75;4.74;796;36;2113.00;36
5337;36;625377961;5337;196;6128;6164;9.17;0.56;251.80;4.74;791;36;2114.00;36
5339;36;625377975;5339;190;6130;6166;9.26;0.56;251.79;4.74;791;36;2115.00;36
5342;36;625377987;5342;191;6131;6166;9.28;0.57;251.83;4.74;789;36;2116.00;35
5345;36;625378006;5345;189;6133;6170;9.31;0.57;251.79;4.74;788;36;2117.00;37
5345;36;625378018;5345;192;6134;6170;9.37;0.57;251.79;4.75;789;36;2118.00;36
5347;36;625378029;5347;200;6137;6174;9.37;0.57;251.82;4.74;790;36;2119.00;37
5348;36;625378040;5348;202;6137;6174;9.40;0.57;251.81;4.74;789;36;2120.00;37
5348;36;625378051;5348;207;6137;6174;9.42;0.57;251.81;4.74;789;36;2121.00;37
5350;36;625378063;5350;208;6138;6174;9.40;0.57;251.83;4.75;788;36;2122.00;36
5352;36;625378074;5352;212;6138;6174;9.43;0.57;251.83;4.75;786;36;2123.00;36
5354;36;625378085;5354;212;6149;6186;9.44;0.58;251.86;4.75;795;36;2124.00;37
5356;36;625378103;5356;212;6149;6186;9.50;0.58;251.87;4.75;793;36;2125.00;37
5359;36;625378114;5359;215;6150;6186;9.57;0.58;251.85;4.75;791;36;2126.00;36
5360;36;625378124;5360;215;6152;6186;9.57;0.58;251.84;4.80;792;36;2127.00;34
5362;36;625378141;5362;225;6153;6186;9.59;0.58;251.87;4.81;791;36;2128.00;33
5363;36;625378152;5363;223;6155;6186;9.61;0.58;251.85;4.81;792;36;2129.00;31
5364;36;625378165;5364;215;6156;6187;9.55;0.58;251.82;4.81;792;36;2130.00;31
5368;36;625378182;5368;208;6157;6187;9.52;0.58;251.82;4.81;789;36;2131.00;30
5372;36;625378199;5372;206;6161;6193;9.47;0.57;251.77;4.81;789;36;2132.00;32
5374;36;625378211;5374;207;6163;6194;9.44;0.57;251.76;4.81;789;36;2133.00;31
5377;36;625378222;5377;201;6164;6194;9.40;0.57;251.72;4.81;787;36;2134.00;30
5380;36;625378233;5380;198;6165;6194;9.33;0.56;251.73;4.81;785;36;2135.00;29
5383;36;625378244;5383;196;6168;6198;9.26;0.56;251.72;4.81;785;36;2136.00;30
5386;36;625378255;5386;194;6168;6198;9.19;0.55;251.73;4.81;782;36;2137.00;30
5389;36;625378265;5389;191;6168;6198;9.12;0.55;251.83;4.81;779;36;2138.00;30
5391;36;625378275;5391;195;6169;6199;9.16;0.55;251.97;4.81;778;36;2139.00;30
5392;36;625378286;5392;194;6172;6203;9.15;0.55;251.95;4.81;780;36;2140.00;31
5396;36;625378296;5396;188;6172;6203;9.11;0.55;251.98;4.81;776;36;2141.00;31
5399;36;625378306;5399;182;6174;6206;9.12;0.55;251.95;4.81;775;36;2142.00;32
5402;36;625378317;5402;184;6174;6206;9.08;0.55;252.01;4.81;772;36;2143.00;32
5404;36;625378327;5404;177;6175;6206;9.02;0.55;251.97;4.81;771;36;2144.00;31
5411;36;625378343;5411;179;6178;6206;8.93;0.54;251.95;4.88;767;36;2145.00;28
5416;36;625378354;5416;177;6181;6210;8.91;0.54;252.02;4.88;765;36;2146.00;29
5418;36;625378364;5418;177;6181;6210;8.84;0.54;252.03;4.88;763;36;2147.00;29
5422;36;625378373;5422;174;6182;6210;8.81;0.53;252.14;4.88;760;36;2148.00;28
5424;36;625378383;5424;172;6182;6210;8.82;0.53;252.18;4.88;758;36;2149.00;28
5427;36;625378394;5427;173;6182;6211;8.71;0.53;252.17;4.88;755;36;2150.00;29
5429;36;625378404;5429;170;6183;6212;8.63;0.52;252.11;4.87;754;36;2151.00;29
5431;36;625378414;5431;170;6183;6212;8.61;0.52;252.15;4.87;752;36;2152.00;29
5432;36;625378423;5432;171;6184;6213;8.70;0.53;252.17;4.87;752;36;2153.00;29
5436;36;625378433;5436;177;6184;6213;8.70;0.53;252.12;4.87;748;36;2154.00;29
5437;36;625378443;5437;179;6184;6213;8.67;0.53;252.08;4.87;747;36;2155.00;29
5439;36;625378453;5439;184;6184;6213;8.66;0.53;252.11;4.87;745;36;2156.00;29
5441;36;625378462;5441;185;6184;6213;8.73;0.53;252.08;4.87;743;36;2157.00;29
5445;36;625378472;5445;185;6184;6213;8.72;0.53;252.06;4.87;739;36;2158.00;29
5447;36;625378482;5447;186;6184;6213;8.76;0.53;252.07;4.87;737;36;2159.00;29
5449;36;625378492;5449;222;6281;6443;8.83;0.55;252.08;4.80;832;36;2160.00;162
5451;37;625378520;5451;221;6285;6444;8.85;0.55;252.18;4.80;834;37;2161.00;159
5452;37;625378543;5452;215;6296;6444;8.88;0.55;252.15;4.79;844;37;2162.00;148
5453;38;625378553;5453;209;6301;6444;8.84;0.55;252.13;4.79;848;38;2163.00;143
5454;38;625378575;5454;213;6307;6444;8.84;0.55;252.10;4.79;853;38;2164.00;137
5456;38;625378585;5456;220;6313;6444;8.88;0.55;252.07;4.79;857;38;2165.00;131
5457;38;625378596;5457;221;6321;6444;8.82;0.55;252.05;4.79;864;38;2166.00;123
5458;38;625378624;5458;223;6326;6444;8.86;0.55;252.07;4.79;868;38;2167.00;118
5460;38;625378635;5460;224;6334;6445;8.88;0.55;252.05;4.80;874;38;2168.00;111
5465;38;625378652;5465;226;6339;6446;8.81;0.55;252.02;4.80;874;38;2169.00;107
5468;38;625378664;5468;233;6343;6446;8.86;0.55;252.04;4.81;875;38;2170.00;103
5472;38;625378675;5472;231;6346;6447;8.85;0.55;251.96;4.82;874;38;2171.00;101
5475;38;625378687;5475;236;6350;6447;8.90;0.55;251.91;4.83;875;38;2172.00;97
5478;38;625378698;5478;239;6355;6447;8.88;0.55;251.87;4.84;877;38;2173.00;92
5479;38;625378709;5479;242;6357;6447;8.80;0.54;251.88;4.85;878;38;2174.00;90
5480;38;625378727;5480;244;6362;6451;8.70;0.54;251.85;4.86;882;38;2175.00;89
5481;38;625378739;5481;251;6366;6451;8.69;0.54;251.85;4.87;885;38;2176.00;85
5481;38;625378750;5481;256;6368;6451;8.62;0.53;251.85;4.88;887;38;2177.00;83
5482;38;625378762;5482;265;6374;6454;8.57;0.53;251.82;4.91;892;38;2178.00;80
5482;38;625378774;5482;264;6378;6454;8.49;0.52;251.82;4.93;896;38;2179.00;76
5484;38;625378785;5484;273;6381;6454;8.42;0.52;251.77;4.94;897;38;2180.00;73
5487;38;625378796;5487;277;6386;6458;8.35;0.51;251.68;4.95;899;38;2181.00;72
5488;38;625378808;5488;283;6392;6459;8.25;0.51;251.67;4.96;904;38;2182.00;67
5489;38;625378820;5489;292;6395;6459;8.15;0.50;251.71;4.97;906;38;2183.00;64
5491;38;625378832;5491;297;6398;6463;8.05;0.50;251.72;4.98;907;38;2184.00;65
5495;38;625378849;5495;306;6402;6463;8.00;0.49;251.73;4.98;907;38;2185.00;61
5498;38;625378860;5498;315;6405;6463;7.86;0.48;251.66;4.99;907;38;2186.00;58
5499;38;625378877;5499;323;6408;6464;7.83;0.48;251.64;5.00;909;38;2187.00;56
5504;38;625378888;5504;332;6409;6464;7.65;0.47;251.52;5.00;905;38;2188.00;55
5506;38;625378900;5506;328;6414;6470;7.56;0.46;251.46;5.01;908;38;2189.00;56
5506;38;625378918;5506;332;6415;6470;7.49;0.46;251.46;5.01;909;38;2190.00;55
5507;38;625378929;5507;325;6417;6471;7.35;0.45;251.43;5.02;910;38;2191.00;54
5509;38;625378939;5509;330;6420;6471;7.22;0.44;251.39;5.03;911;38;2192.00;51
5511;38;625378950;5511;335;6422;6471;7.13;0.44;251.32;5.04;911;38;2193.00;49
5515;38;625378965;5515;340;6425;6471;7.02;0.43;251.32;5.05;910;38;2194.00;46
5515;38;625378984;5515;337;6427;6471;7.03;0.43;251.32;5.05;912;38;2195.00;44
5515;38;625379000;5515;331;6439;6483;7.09;0.43;251.32;5.06;924;38;2196.00;44
5517;38;625379020;5517;332;6441;6483;7.12;0.44;251.31;5.06;924;38;2197.00;42
5519;38;625379036;5519;326;6443;6483;7.14;0.44;251.26;5.06;924;38;2198.00;40
5521;38;625379057;5521;323;6445;6483;7.18;0.44;251.24;5.07;924;38;2199.00;38
5521;38;625379073;5521;323;6445;6483;7.15;0.44;251.24;5.07;924;38;2200.00;38
5521;38;625379091;5521;326;6447;6483;7.10;0.44;251.24;5.08;926;38;2201.00;36
5523;38;625379103;5523;328;6451;6487;7.07;0.43;251.19;5.08;928;38;2202.00;36
5528;38;625379115;5528;333;6453;6487;6.98;0.43;251.12;5.09;925;38;2203.00;34
5532;39;625379134;5532;333;6457;6491;7.00;0.43;251.10;5.08;925;39;2204.00;34
5535;40;625379161;5535;329;6459;6493;6.96;0.43;251.12;5.08;924;40;2205.00;34
5540;40;625379192;5540;333;6459;6493;6.94;0.42;251.10;5.08;919;40;2206.00;34
5541;40;625379203;5541;332;6460;6493;6.90;0.42;251.13;5.09;919;40;2207.00;33
5542;40;625379222;5542;333;6470;6506;6.85;0.42;251.17;5.08;928;40;2208.00;36
5544;40;625379233;5544;329;6472;6506;6.79;0.42;251.25;5.08;928;40;2209.00;34
5545;40;625379244;5545;317;6473;6508;6.78;0.42;251.26;5.08;928;40;2210.00;35
5550;41;625379256;5550;319;6475;6509;6.74;0.41;251.25;5.08;925;41;2211.00;34
5553;41;625379281;5553;311;6476;6510;6.74;0.41;251.34;5.08;923;41;2212.00;34
5554;41;625379292;5554;309;6477;6510;6.77;0.42;251.38;5.08;923;41;2213.00;33
5555;41;625379304;5555;313;6481;6513;6.81;0.42;251.40;5.08;926;41;2214.00;32
5558;41;625379316;5558;309;6481;6513;6.84;0.42;251.43;5.08;923;41;2215.00;32
5560;41;625379328;5560;309;6481;6513;6.86;0.42;251.42;5.08;921;41;2216.00;32
5563;41;625379339;5563;304;6481;6513;6.88;0.42;251.51;5.08;918;41;2217.00;32
5567;41;625379351;5567;295;6485;6519;6.92;0.42;251.65;5.07;918;41;2218.00;34
5572;41;625379364;5572;288;6486;6519;6.91;0.42;251.70;5.07;914;41;2219.00;33
5575;41;625379378;5575;283;6486;6519;6.99;0.43;251.84;5.07;911;41;2220.00;33
5578;41;625379390;5578;275;6488;6519;7.04;0.43;251.82;5.07;910;41;2221.00;31
5582;41;625379402;5582;273;6492;6523;7.11;0.44;251.95;5.07;910;41;2222.00;31
5584;41;625379415;5584;273;6493;6524;7.11;0.44;252.02;5.07;909;41;2223.00;31
5589;41;625379427;5589;270;6493;6524;7.16;0.44;252.13;5.07;904;41;2224.00;31
5594;41;625379439;5594;268;6494;6525;7.21;0.44;252.12;5.07;900;41;2225.00;31
5601;41;625379451;5601;272;6494;6525;7.24;0.44;252.12;5.07;893;41;2226.00;31
5603;41;625379463;5603;268;6494;6525;7.34;0.45;252.14;5.07;891;41;2227.00;31
5604;41;625379476;5604;273;6494;6525;7.43;0.45;252.17;5.07;890;41;2228.00;31
5605;41;625379488;5605;272;6494;6525;7.52;0.46;252.14;5.07;889;41;2229.00;31
5609;41;625379500;5609;277;6494;6525;7.55;0.46;252.25;5.07;885;41;2230.00;31
5615;41;625379512;5615;277;6494;6525;7.56;0.46;252.30;5.07;879;41;2231.00;31
5618;41;625379524;5618;286;6533;6595;7.70;0.47;252.27;5.04;915;41;2232.00;62
5622;41;625379543;5622;269;6535;6596;7.71;0.47;252.37;5.04;913;41;2233.00;61
5626;41;625379555;5626;267;6541;6596;7.79;0.47;252.35;5.03;915;41;2234.00;55
5630;41;625379569;5630;265;6546;6596;7.86;0.48;252.41;5.03;916;41;2235.00;50
5633;41;625379582;5633;264;6550;6596;7.87;0.48;252.50;5.03;917;41;2236.00;46
5637;41;625379595;5637;264;6552;6596;7.96;0.48;252.60;5.03;915;41;2237.00;44
5640;41;625379609;5640;267;6556;6596;8.03;0.49;252.62;5.03;916;41;2238.00;40
5645;41;625379622;5645;272;6558;6596;8.04;0.49;252.65;5.03;913;41;2239.00;38
5649;41;625379636;5649;268;6561;6597;8.08;0.49;252.75;5.03;912;41;2240.00;36
5653;41;625379651;5653;267;6563;6598;8.05;0.49;252.82;5.04;910;41;2241.00;35
5655;41;625379665;5655;276;6565;6598;8.08;0.49;252.93;5.03;910;41;2242.00;33
5656;41;625379678;5656;269;6568;6602;8.11;0.50;252.96;5.03;912;41;2243.00;34
5662;41;625379693;5662;270;6568;6602;8.09;0.49;253.04;5.03;906;41;2244.00;34
5666;41;625379706;5666;276;6568;6602;8.11;0.49;253.05;5.03;902;41;2245.00;34
5670;41;625379720;5670;282;6568;6602;8.12;0.50;253.19;5.03;898;41;2246.00;34
5674;41;625379734;5674;287;6572;6608;8.20;0.50;253.37;5.03;898;41;2247.00;36
5677;41;625379748;5677;287;6573;6608;8.20;0.50;253.48;5.03;896;41;2248.00;35
5683;41;625379761;5683;284;6573;6608;8.24;0.50;253.41;5.03;890;41;2249.00;35
5687;41;625379777;5687;283;6576;6614;8.27;0.50;253.42;5.03;889;41;2250.00;38
5692;41;625379791;5692;285;6576;6614;8.22;0.50;253.45;5.03;884;41;2251.00;38
5698;41;625379804;5698;291;6577;6614;8.19;0.50;253.61;5.03;879;41;2252.00;37
5701;41;625379817;5701;301;6578;6615;8.13;0.50;253.73;5.03;877;41;2253.00;37
5705;41;625379831;5705;300;6579;6616;8.09;0.49;253.73;5.03;874;41;2254.00;37
5709;42;625379846;5709;306;6580;6616;8.05;0.49;253.69;5.03;871;42;2255.00;36
5712;42;625379873;5712;311;6590;6629;8.14;0.50;253.68;5.02;878;42;2256.00;39
5716;42;625379892;5716;307;6591;6629;8.10;0.49;253.79;5.02;875;42;2257.00;38
5720;42;625379925;5720;301;6591;6629;8.09;0.49;253.80;5.02;871;42;2258.00;38
5724;42;625379946;5724;300;6592;6630;8.12;0.50;253.88;5.02;868;42;2259.00;38
5728;42;625379960;5728;292;6592;6630;8.11;0.49;254.00;5.02;864;42;2260.00;38
5733;42;625379974;5733;292;6595;6634;8.06;0.49;254.01;5.02;862;42;2261.00;39
5733;42;625379988;5733;288;6595;6634;8.08;0.49;254.01;5.02;862;42;2262.00;39
5740;42;625380005;5740;289;6599;6638;8.01;0.49;254.12;5.01;859;42;2263.00;39
5743;42;625380023;5743;287;6599;6638;8.04;0.49;254.14;5.01;856;42;2264.00;39
5747;42;625380041;5747;288;6599;6638;8.02;0.49;254.21;5.01;852;42;2265.00;39
5752;42;625380060;5752;277;6599;6638;8.02;0.49;254.29;5.01;847;42;2266.00;39
5757;42;625380074;5757;264;6599;6638;8.04;0.49;254.25;5.01;842;42;2267.00;39
5758;42;625380088;5758;252;6608;6650;8.15;0.49;254.32;5.01;850;42;2268.00;42
5765;42;625380101;5765;248;6608;6650;8.24;0.50;254.36;5.01;843;42;2269.00;42
5767;42;625380117;5767;247;6610;6650;8.40;0.51;254.35;5.01;843;42;2270.00;40
5771;42;625380137;5771;247;6610;6650;8.48;0.51;254.31;5.01;839;42;2271.00;40
5774;42;625380152;5774;245;6610;6650;8.57;0.52;254.35;5.01;836;42;2272.00;40
5775;42;625380166;5775;241;6610;6650;8.55;0.52;254.36;5.01;835;42;2273.00;40
5778;42;625380179;5778;243;6610;6651;8.54;0.52;254.35;5.01;832;42;2274.00;41
5781;42;625380192;5781;241;6610;6651;8.53;0.52;254.38;5.01;829;42;2275.00;41
5782;42;625380204;5782;239;6614;6657;8.56;0.52;254.39;5.00;832;42;2276.00;43
5785;42;625380217;5785;236;6615;6658;8.57;0.52;254.38;5.00;830;42;2277.00;43
5788;42;625380230;5788;235;6616;6658;8.60;0.52;254.42;5.00;828;42;2278.00;42
5788;42;625380242;5788;226;6616;6658;8.64;0.52;254.42;5.00;828;42;2279.00;42
5791;42;625380256;5791;222;6620;6663;8.64;0.52;254.38;5.00;829;42;2280.00;43
5792;42;625380269;5792;218;6620;6663;8.69;0.53;254.45;5.00;828;42;2281.00;43
5793;42;625380281;5793;218;6620;6663;8.74;0.53;254.43;5.00;827;42;2282.00;43
5799;42;625380293;5799;210;6621;6664;8.74;0.53;254.49;5.00;822;42;2283.00;43
5805;42;625380304;5805;220;6624;6668;8.72;0.53;254.57;5.00;819;42;2284.00;44
5806;42;625380317;5806;218;6625;6668;8.73;0.53;254.55;5.07;819;42;2285.00;43
5811;42;625380329;5811;213;6627;6671;8.74;0.53;254.59;5.07;816;42;2286.00;44
5812;42;625380341;5812;208;6627;6671;8.74;0.53;254.56;5.07;815;42;2287.00;44
5813;42;625380352;5813;204;6628;6671;8.70;0.53;254.65;5.07;815;42;2288.00;43
5813;42;625380363;5813;201;6628;6671;8.68;0.53;254.65;5.07;815;42;2289.00;43
5814;42;625380374;5814;193;6631;6675;8.75;0.53;254.70;5.07;817;42;2290.00;44
5817;42;625380385;5817;190;6631;6675;8.71;0.53;254.69;5.07;814;42;2291.00;44
5818;43;625380396;5818;185;6632;6675;8.72;0.53;254.69;5.07;814;43;2292.00;43
5821;43;625380423;5821;188;6632;6675;8.74;0.53;254.64;5.07;811;43;2293.00;43
5823;44;625380434;5823;198;6632;6676;8.75;0.53;254.59;5.07;809;44;2294.00;44
5824;44;625380462;5824;203;6634;6678;8.69;0.53;254.61;5.06;810;44;2295.00;44
5825;45;625380474;5825;200;6634;6678;8.65;0.53;254.71;5.06;809;45;2296.00;44
5826;45;625380495;5826;204;6635;6679;8.58;0.52;254.70;5.06;809;45;2297.00;44
5828;45;625380505;5828;208;6635;6679;8.50;0.52;254.73;5.06;807;45;2298.00;44
5828;45;625380521;5828;208;6635;6679;8.46;0.52;254.73;5.06;807;45;2299.00;44
5829;45;625380532;5829;203;6635;6679;8.39;0.51;254.83;5.06;806;45;2300.00;44
5832;45;625380546;5832;203;6635;6679;8.36;0.51;254.77;5.06;803;45;2301.00;44
5833;45;625380556;5833;203;6635;6679;8.32;0.51;254.77;5.06;802;45;2302.00;44
5835;45;625380566;5835;203;6635;6679;8.33;0.51;254.81;5.06;800;45;2303.00;44
5837;45;625380576;5837;234;6707;6806;8.29;0.51;254.82;5.01;870;45;2304.00;99
5838;45;625380596;5838;223;6707;6807;8.31;0.51;254.81;5.01;869;45;2305.00;100
5840;45;625380607;5840;212;6713;6807;8.44;0.52;254.82;5.01;873;45;2306.00;94
5841;45;625380618;5841;208;6718;6807;8.54;0.53;254.84;5.00;877;45;2307.00;89
5844;45;625380628;5844;203;6723;6807;8.58;0.53;254.85;5.00;879;45;2308.00;84
5848;45;625380638;5848;201;6729;6807;8.64;0.53;254.88;5.00;881;45;2309.00;78
5850;45;625380651;5850;197;6735;6807;8.64;0.53;254.83;5.08;885;45;2310.00;72
5854;46;625380662;5854;197;6737;6807;8.54;0.53;254.90;5.08;883;46;2311.00;70
5857;46;625380679;5857;202;6741;6808;8.51;0.52;254.99;5.08;884;46;2312.00;67
5859;46;625380691;5859;203;6744;6809;8.48;0.52;254.99;5.08;885;46;2313.00;65
5863;46;625380702;5863;206;6746;6809;8.39;0.51;254.96;5.08;883;46;2314.00;63
5865;46;625380717;5865;203;6748;6810;8.32;0.51;254.98;5.10;883;46;2315.00;62
5867;46;625380728;5867;204;6751;6810;8.28;0.51;254.97;5.17;884;46;2316.00;59
5868;46;625380739;5868;208;6752;6810;8.17;0.50;254.96;5.18;884;46;2317.00;58
5873;46;625380750;5873;207;6755;6810;8.01;0.49;254.89;5.19;882;46;2318.00;55
5876;46;625380760;5876;205;6757;6814;7.92;0.49;254.87;5.19;881;46;2319.00;57
5877;46;625380772;5877;213;6758;6814;7.83;0.48;254.84;5.19;881;46;2320.00;56
5881;46;625380782;5881;208;6759;6814;7.69;0.47;254.81;5.27;878;46;2321.00;55
5884;46;625380793;5884;209;6762;6817;7.66;0.47;254.78;5.27;878;46;2322.00;55
5887;46;625380804;5887;209;6762;6817;7.60;0.47;254.73;5.27;875;46;2323.00;55
5888;46;625380815;5888;216;6763;6817;7.59;0.47;254.70;5.27;875;46;2324.00;54
5890;46;625380826;5890;216;6767;6821;7.59;0.47;254.70;5.27;877;46;2325.00;54
5893;46;625380837;5893;223;6769;6822;7.60;0.47;254.65;5.27;876;46;2326.00;53
5894;46;625380848;5894;223;6770;6822;7.60;0.47;254.66;5.27;876;46;2327.00;52
5897;46;625380858;5897;225;6773;6826;7.58;0.46;254.60;5.27;876;46;2328.00;53
5901;46;625380869;5901;228;6773;6826;7.47;0.46;254.59;5.27;872;46;2329.00;53
5901;46;625380880;5901;238;6774;6826;7.41;0.45;254.59;5.26;873;46;2330.00;52
5906;46;625380891;5906;244;6775;6827;7.34;0.45;254.57;5.26;869;46;2331.00;52
5907;46;625380902;5907;247;6775;6827;7.32;0.45;254.53;5.26;868;46;2332.00;52
5910;46;625380912;5910;255;6779;6833;7.34;0.45;254.47;5.26;869;46;2333.00;54
5914;46;625380923;5914;260;6780;6833;7.32;0.44;254.40;5.26;866;46;2334.00;53
5915;46;625380937;5915;269;6780;6834;7.32;0.44;254.36;5.26;865;46;2335.00;54
5915;46;625380948;5915;272;6780;6834;7.30;0.44;254.36;5.26;865;46;2336.00;54
5919;46;625380962;5919;280;6780;6834;7.23;0.44;254.39;5.26;861;46;2337.00;54
5920;46;625380980;5920;284;6781;6834;7.17;0.43;254.38;5.27;861;46;2338.00;53
5921;46;625380998;5921;289;6781;6834;7.17;0.43;254.38;5.27;860;46;2339.00;53
5922;46;625381018;5922;298;6802;6870;7.24;0.44;254.37;5.26;880;46;2340.00;68
5924;46;625381039;5924;294;6806;6870;7.19;0.44;254.38;5.28;882;46;2341.00;64
5925;46;625381056;5925;295;6809;6870;7.16;0.44;254.37;5.28;884;46;2342.00;61
5927;46;625381071;5927;301;6812;6870;7.10;0.43;254.36;5.29;885;46;2343.00;58
5928;46;625381084;5928;307;6813;6870;7.10;0.43;254.34;5.29;885;46;2344.00;57
5928;46;625381096;5928;312;6815;6870;7.08;0.43;254.34;5.31;887;46;2345.00;55
5928;46;625381108;5928;313;6819;6874;7.05;0.43;254.34;5.31;891;46;2346.00;55
5928;46;625381123;5928;306;6821;6874;7.04;0.43;254.34;5.32;893;46;2347.00;53
5928;46;625381135;5928;300;6826;6878;7.10;0.43;254.34;5.32;898;46;2348.00;52
5930;46;625381148;5930;289;6828;6879;7.15;0.44;254.30;5.34;898;46;2349.00;51
5932;46;625381160;5932;287;6829;6879;7.11;0.43;254.26;5.33;897;46;2350.00;50
5932;46;625381172;5932;277;6831;6879;7.11;0.43;254.26;5.35;899;46;2351.00;48
5934;46;625381184;5934;273;6843;6892;7.09;0.43;254.21;5.35;909;46;2352.00;49
5936;46;625381196;5936;273;6844;6892;7.12;0.43;254.18;5.35;908;46;2353.00;48
5938;46;625381207;5938;270;6845;6892;7.11;0.43;254.24;5.36;907;46;2354.00;47
5939;46;625381219;5939;279;6847;6893;7.15;0.44;254.23;5.36;908;46;2355.00;46
5939;47;625381230;5939;282;6848;6894;7.21;0.44;254.23;5.36;909;47;2356.00;46
5940;47;625381250;5940;283;6848;6894;7.24;0.44;254.24;5.36;908;47;2357.00;46
5940;47;625381262;5940;287;6852;6897;7.31;0.45;254.24;5.37;912;47;2358.00;45
5942;47;625381279;5942;285;6852;6897;7.36;0.45;254.22;5.37;910;47;2359.00;45
5945;47;625381290;5945;278;6853;6897;7.45;0.46;254.15;5.37;908;47;2360.00;44
5947;47;625381308;5947;273;6854;6897;7.48;0.46;254.16;5.38;907;47;2361.00;43
5948;47;625381320;5948;273;6858;6903;7.50;0.46;254.14;5.38;910;47;2362.00;45
5950;47;625381333;5950;277;6863;6903;7.49;0.46;254.08;5.40;913;47;2363.00;40
5951;47;625381344;5951;274;6863;6903;7.46;0.45;254.09;5.40;912;47;2364.00;40
5951;47;625381355;5951;273;6863;6903;7.39;0.45;254.09;5.40;912;47;2365.00;40
5951;47;625381366;5951;273;6867;6907;7.37;0.45;254.09;5.41;916;47;2366.00;40
5953;47;625381378;5953;273;6868;6908;7.43;0.45;254.07;5.41;915;47;2367.00;40
5957;47;625381389;5957;277;6869;6908;7.43;0.45;254.00;5.41;912;47;2368.00;39
5962;47;625381401;5962;281;6870;6909;7.45;0.45;253.94;5.41;908;47;2369.00;39
5963;47;625381414;5963;284;6873;6909;7.43;0.45;253.94;5.42;910;47;2370.00;36
5965;47;625381425;5965;284;6873;6909;7.43;0.45;253.99;5.42;908;47;2371.00;36
5969;47;625381436;5969;286;6874;6909;7.34;0.45;254.04;5.43;905;47;2372.00;35
5973;47;625381447;5973;285;6874;6909;7.31;0.44;254.16;5.43;901;47;2373.00;35
5977;47;625381458;5977;289;6876;6909;7.22;0.44;254.24;5.43;899;47;2374.00;33
5980;47;625381470;5980;286;6876;6909;7.23;0.44;254.18;5.43;896;47;2375.00;33
5984;47;625381480;5984;291;6913;6979;7.32;0.45;254.24;5.40;929;47;2376.00;66
5987;47;625381497;5987;286;6914;6980;7.23;0.44;254.27;5.40;927;47;2377.00;66
5992;47;625381508;5992;286;6923;6980;7.21;0.44;254.32;5.40;931;47;2378.00;57
5996;47;625381520;5996;291;6931;6980;7.16;0.44;254.40;5.40;935;47;2379.00;49
5998;47;625381530;5998;285;6938;6980;7.18;0.44;254.41;5.39;940;47;2380.00;42
6003;47;625381542;6003;277;6941;6980;7.11;0.44;254.52;5.39;938;47;2381.00;39
6007;47;625381554;6007;273;6945;6980;7.08;0.43;254.61;5.39;938;47;2382.00;35
6012;47;625381565;6012;277;6946;6980;7.03;0.43;254.65;5.39;934;47;2383.00;34
6015;47;625381576;6015;274;6948;6981;7.08;0.43;254.74;5.39;933;47;2384.00;33
6019;47;625381595;6019;276;6950;6983;7.11;0.43;254.74;5.39;931;47;2385.00;33
6023;47;625381608;6023;286;6950;6983;7.11;0.43;254.82;5.39;927;47;2386.00;33
6025;47;625381620;6025;290;6954;6987;7.14;0.44;254.90;5.39;929;47;2387.00;33
6029;47;625381632;6029;289;6954;6987;7.22;0.44;255.01;5.39;925;47;2388.00;33
6031;47;625381646;6031;293;6954;6987;7.29;0.45;255.11;5.39;923;47;2389.00;33
6035;47;625381658;6035;294;6954;6987;7.34;0.45;255.24;5.39;919;47;2390.00;33
6039;47;625381671;6039;298;6959;6993;7.39;0.45;255.40;5.39;920;47;2391.00;34
6042;47;625381685;6042;294;6960;6993;7.44;0.46;255.46;5.39;918;47;2392.00;33
6046;47;625381697;6046;297;6960;6993;7.45;0.46;255.54;5.39;914;47;2393.00;33
6049;47;625381709;6049;299;6963;6996;7.51;0.46;255.66;5.38;914;47;2394.00;33
6053;47;625381724;6053;297;6963;6996;7.56;0.46;255.69;5.38;910;47;2395.00;33
6057;47;625381736;6057;301;6963;6996;7.61;0.47;255.76;5.38;906;47;2396.00;33
6067;47;625381748;6067;295;6964;6997;7.63;0.47;255.69;5.38;897;47;2397.00;33
6072;47;625381761;6072;291;6965;6998;7.69;0.47;255.73;5.38;893;47;2398.00;33
6079;47;625381775;6079;289;6965;6998;7.75;0.47;255.76;5.38;886;47;2399.00;33
6082;47;625381790;6082;288;6991;7057;7.77;0.47;255.84;5.36;909;47;2400.00;66
6086;48;625381814;6086;277;6993;7057;7.81;0.48;255.84;5.36;907;48;2401.00;64
6091;48;625381841;6091;270;6995;7057;7.83;0.48;255.90;5.36;904;48;2402.00;62
6098;48;625381854;6098;268;6996;7058;7.86;0.48;255.95;5.36;898;48;2403.00;62
6101;48;625381874;6101;266;6998;7058;7.83;0.48;256.02;5.36;897;48;2404.00;60
6108;48;625381888;6108;263;7001;7062;7.81;0.47;256.11;5.36;893;48;2405.00;61
6112;49;625381908;6112;263;7002;7062;7.79;0.47;256.13;5.36;890;49;2406.00;60
6117;49;625381936;6117;267;7006;7066;7.82;0.47;256.18;5.36;889;49;2407.00;60
6125;49;625381955;6125;270;7007;7066;7.79;0.47;256.35;5.36;882;49;2408.00;59
6126;49;625381971;6126;271;7007;7066;7.84;0.48;256.45;5.36;881;49;2409.00;59
6131;49;625381983;6131;276;7008;7066;7.85;0.48;256.57;5.36;877;49;2410.00;58
6137;49;625381996;6137;277;7009;7066;7.79;0.47;256.66;5.36;872;49;2411.00;57
6140;49;625382010;6140;280;7016;7078;7.83;0.48;256.70;5.35;876;49;2412.00;62
6143;49;625382024;6143;282;7017;7078;7.84;0.48;256.81;5.35;874;49;2413.00;61
6146;49;625382036;6146;285;7019;7078;7.90;0.48;256.79;5.36;873;49;2414.00;59
6148;49;625382049;6148;288;7020;7078;7.93;0.49;256.84;5.43;872;49;2415.00;58
6152;49;625382062;6152;292;7021;7078;7.95;0.49;256.96;5.43;869;49;2416.00;57
6153;49;625382075;6153;298;7021;7078;7.97;0.49;257.00;5.43;868;49;2417.00;57
6158;49;625382087;6158;302;7022;7079;7.89;0.48;257.05;5.44;864;49;2418.00;57
6163;49;625382099;6163;300;7022;7079;7.92;0.48;257.15;5.44;859;49;2419.00;57
6166;49;625382112;6166;306;7027;7085;7.89;0.48;257.15;5.44;861;49;2420.00;58
6171;49;625382124;6171;311;7028;7086;7.91;0.48;257.25;5.43;857;49;2421.00;58
6178;49;625382143;6178;315;7029;7086;7.85;0.48;257.38;5.44;851;49;2422.00;57
6179;49;625382155;6179;314;7030;7086;7.81;0.47;257.38;5.44;851;49;2423.00;56
6183;49;625382167;6183;318;7032;7090;7.76;0.47;257.50;5.44;849;49;2424.00;58
6186;49;625382180;6186;323;7032;7090;7.75;0.47;257.56;5.44;846;49;2425.00;58
6187;49;625382197;6187;325;7033;7090;7.74;0.47;257.56;5.44;846;49;2426.00;57
6192;49;625382210;6192;316;7037;7091;7.72;0.47;257.63;5.45;845;49;2427.00;54
6193;49;625382222;6193;313;7040;7095;7.71;0.47;257.68;5.45;847;49;2428.00;55
6194;49;625382234;6194;308;7041;7095;7.77;0.47;257.71;5.45;847;49;2429.00;54
6197;49;625382248;6197;310;7044;7101;7.77;0.47;257.71;5.44;847;49;2430.00;57
6200;49;625382260;6200;313;7045;7101;7.73;0.47;257.69;5.44;845;49;2431.00;56
6203;49;625382273;6203;317;7048;7101;7.68;0.47;257.90;5.45;845;49;2432.00;53
6208;49;625382285;6208;314;7048;7101;7.66;0.46;257.99;5.45;840;49;2433.00;53
6210;49;625382297;6210;314;7051;7105;7.67;0.47;258.00;5.45;841;49;2434.00;54
6213;49;625382310;6213;314;7051;7105;7.69;0.47;258.07;5.45;838;49;2435.00;54
6216;49;625382322;6216;297;7052;7105;7.69;0.47;258.11;5.45;836;49;2436.00;53
6216;49;625382334;6216;282;7052;7105;7.72;0.47;258.11;5.45;836;49;2437.00;53
6218;49;625382346;6218;272;7054;7106;7.73;0.47;258.12;5.45;836;49;2438.00;52
6219;49;625382358;6219;263;7055;7107;7.82;0.48;258.12;5.45;836;49;2439.00;52
6224;49;625382376;6224;255;7055;7107;7.84;0.48;258.25;5.45;831;49;2440.00;52
6226;49;625382388;6226;245;7056;7108;7.95;0.48;258.21;5.45;830;49;2441.00;52
6230;49;625382402;6230;229;7056;7108;8.06;0.49;258.22;5.45;826;49;2442.00;52
6236;49;625382415;6236;224;7057;7108;8.13;0.49;258.30;5.45;821;49;2443.00;51
6239;49;625382433;6239;221;7057;7108;8.27;0.50;258.36;5.45;818;49;2444.00;51
6244;49;625382445;6244;226;7057;7108;8.31;0.50;258.33;5.45;813;49;2445.00;51
6245;49;625382457;6245;220;7057;7108;8.42;0.51;258.35;5.45;812;49;2446.00;51
6249;49;625382469;6249;210;7057;7108;8.48;0.51;258.38;5.45;808;49;2447.00;51
6251;49;625382480;6251;218;7120;7235;8.74;0.54;258.43;5.41;869;49;2448.00;115
6256;49;625382502;6256;208;7125;7236;8.81;0.54;258.55;5.41;869;49;2449.00;111
6259;49;625382514;6259;195;7132;7236;8.97;0.55;258.55;5.41;873;49;2450.00;104
6263;49;625382527;6263;196;7135;7236;9.02;0.55;258.57;5.41;872;49;2451.00;101
6266;49;625382545;6266;199;7138;7236;9.08;0.56;258.63;5.41;872;49;2452.00;98
6268;49;625382557;6268;203;7140;7236;9.17;0.56;258.61;5.41;872;49;2453.00;96
6272;49;625382576;6272;204;7144;7236;9.23;0.57;258.77;5.41;872;49;2454.00;92
6275;49;625382588;6275;208;7147;7236;9.23;0.57;258.90;5.42;872;49;2455.00;89
6277;49;625382605;6277;209;7150;7237;9.19;0.56;258.95;5.42;873;49;2456.00;87
6280;49;625382617;6280;210;7153;7238;9.09;0.56;258.98;5.42;873;49;2457.00;85
6281;49;625382629;6281;220;7156;7238;9.03;0.55;258.98;5.42;875;49;2458.00;82
6283;49;625382641;6283;224;7158;7239;8.98;0.55;259.00;5.42;875;49;2459.00;81
6286;49;625382655;6286;229;7162;7239;8.90;0.54;259.03;5.43;876;49;2460.00;77
6288;49;625382673;6288;240;7164;7239;8.83;0.54;259.01;5.43;876;49;2461.00;75
6291;49;625382689;6291;243;7168;7239;8.71;0.53;259.04;5.52;877;49;2462.00;71
6293;49;625382701;6293;254;7171;7243;8.64;0.53;259.04;5.52;878;49;2463.00;72
6294;49;625382713;6294;262;7173;7243;8.60;0.53;259.02;5.52;879;49;2464.00;70
6294;49;625382725;6294;258;7175;7243;8.52;0.52;259.02;5.53;881;49;2465.00;68
6296;49;625382735;6296;269;7180;7246;8.38;0.51;259.02;5.54;884;49;2466.00;66
6296;49;625382746;6296;267;7182;7246;8.25;0.50;259.02;5.55;886;49;2467.00;64
6298;49;625382758;6298;269;7186;7246;8.13;0.50;259.01;5.55;888;49;2468.00;60
6299;49;625382769;6299;267;7191;7250;8.03;0.49;258.99;5.55;892;49;2469.00;59
6302;49;625382780;6302;262;7192;7251;7.93;0.48;258.94;5.55;890;49;2470.00;59
6304;49;625382792;6304;257;7192;7251;7.87;0.48;258.89;5.55;888;49;2471.00;59
6305;49;625382802;6305;256;7193;7255;7.82;0.48;258.86;5.54;888;49;2472.00;62
6306;49;625382814;6306;256;7194;7255;7.79;0.48;258.85;5.54;888;49;2473.00;61
6308;49;625382824;6308;251;7194;7255;7.72;0.47;258.78;5.54;886;49;2474.00;61
6311;49;625382835;6311;252;7196;7257;7.72;0.47;258.79;5.54;885;49;2475.00;61
6313;49;625382847;6313;251;7196;7257;7.67;0.47;258.76;5.54;883;49;2476.00;61
6315;49;625382858;6315;253;7199;7263;7.66;0.47;258.77;5.54;884;49;2477.00;64
6317;49;625382869;6317;247;7200;7263;7.55;0.46;258.76;5.54;883;49;2478.00;63
6318;49;625382879;6318;250;7201;7264;7.48;0.46;258.76;5.63;883;49;2479.00;63
6323;49;625382889;6323;243;7201;7264;7.36;0.45;258.73;5.63;878;49;2480.00;63
6326;49;625382899;6326;236;7202;7264;7.23;0.44;258.69;5.71;876;49;2481.00;62
6329;49;625382909;6329;231;7202;7264;7.12;0.44;258.63;5.71;873;49;2482.00;62
6333;49;625382919;6333;228;7202;7264;7.05;0.43;258.72;5.71;869;49;2483.00;62
6336;49;625382929;6336;225;7214;7276;7.05;0.43;258.69;5.78;878;49;2484.00;62
6343;49;625382940;6343;223;7217;7276;6.98;0.43;258.65;5.80;874;49;2485.00;59
6345;49;625382951;6345;222;7217;7276;6.94;0.42;258.64;5.80;872;49;2486.00;59
6348;49;625382966;6348;223;7218;7276;6.95;0.43;258.67;5.87;870;49;2487.00;58
6354;49;625382982;6354;234;7218;7276;6.91;0.42;258.67;5.87;864;49;2488.00;58
6357;49;625382998;6357;240;7218;7276;6.96;0.42;258.63;5.87;861;49;2489.00;58
6358;49;625383017;6358;237;7222;7280;6.95;0.42;258.60;5.94;864;49;2490.00;58
6359;49;625383033;6359;239;7222;7280;6.93;0.42;258.61;5.94;863;49;2491.00;58
6362;49;625383048;6362;236;7224;7284;6.91;0.42;258.64;5.94;862;49;2492.00;60
6365;49;625383064;6365;244;7228;7285;6.94;0.42;258.60;6.01;863;49;2493.00;57
6368;49;625383078;6368;244;7228;7285;6.96;0.42;258.63;6.01;860;49;2494.00;57
6369;49;625383089;6369;243;7229;7285;7.03;0.43;258.61;6.07;860;49;2495.00;56
6371;49;625383101;6371;245;7239;7298;7.11;0.43;258.61;6.08;868;49;2496.00;59
6373;49;625383114;6373;249;7239;7298;7.16;0.44;258.61;6.08;866;49;2497.00;59
6376;49;625383125;6376;250;7239;7298;7.19;0.44;258.54;6.08;863;49;2498.00;59
6379;49;625383138;6379;234;7240;7299;7.20;0.44;258.54;6.08;861;49;2499.00;59
6380;49;625383151;6380;226;7240;7300;7.29;0.44;258.52;6.08;860;49;2500.00;60
6381;49;625383167;6381;213;7240;7300;7.37;0.45;258.49;6.08;859;49;2501.00;60
6383;49;625383179;6383;212;7243;7303;7.47;0.45;258.45;6.09;860;49;2502.00;60
6385;49;625383193;6385;206;7244;7303;7.56;0.46;258.50;6.09;859;49;2503.00;59
6387;49;625383205;6387;201;7244;7303;7.62;0.46;258.48;6.09;857;49;2504.00;59
6387;49;625383217;6387;195;7244;7303;7.75;0.47;258.48;6.09;857;49;2505.00;59
6390;49;625383228;6390;190;7248;7309;7.85;0.48;258.45;6.09;858;49;2506.00;61
6390;49;625383240;6390;191;7248;7309;7.92;0.48;258.45;6.09;858;49;2507.00;61
6390;49;625383252;6390;187;7251;7309;7.97;0.48;258.45;6.11;861;49;2508.00;58
6390;49;625383270;6390;183;7251;7309;7.99;0.49;258.45;6.11;861;49;2509.00;58
6393;49;625383283;6393;183;7255;7313;8.00;0.49;258.46;6.11;862;49;2510.00;58
6395;49;625383295;6395;180;7257;7314;8.05;0.49;258.46;6.12;862;49;2511.00;57
6396;49;625383307;6396;182;7258;7314;8.10;0.49;258.45;6.13;862;49;2512.00;56
6396;49;625383320;6396;182;7262;7315;8.16;0.49;258.45;6.16;866;49;2513.00;53
6397;49;625383332;6397;183;7263;7315;8.19;0.50;258.44;6.16;866;49;2514.00;52
6398;49;625383345;6398;191;7266;7315;8.16;0.50;258.44;6.19;868;49;2515.00;49
6400;49;625383357;6400;187;7267;7315;8.10;0.49;258.47;6.20;867;49;2516.00;48
6400;49;625383368;6400;190;7268;7315;8.07;0.49;258.47;6.21;868;49;2517.00;47
6402;49;625383380;6402;194;7270;7315;8.09;0.49;258.50;6.22;868;49;2518.00;45
6403;49;625383393;6403;197;7271;7315;8.08;0.49;258.50;6.23;868;49;2519.00;44
6404;49;625383407;6404;206;7329;7440;8.23;0.51;258.47;6.19;925;49;2520.00;111
6406;49;625383434;6406;203;7332;7441;8.18;0.50;258.46;6.19;926;49;2521.00;109
6408;49;625383446;6408;203;7345;7441;8.21;0.50;258.40;6.19;937;49;2522.00;96
6411;49;625383459;6411;204;7351;7441;8.17;0.50;258.50;6.19;940;49;2523.00;90
6414;49;625383471;6414;211;7357;7441;8.09;0.50;258.52;6.20;943;49;2524.00;84
6418;49;625383483;6418;208;7363;7441;8.05;0.49;258.54;6.20;945;49;2525.00;78
6420;49;625383495;6420;211;7369;7441;8.02;0.49;258.58;6.20;949;49;2526.00;72
6422;49;625383507;6422;214;7372;7441;7.97;0.49;258.59;6.21;950;49;2527.00;69
6423;49;625383520;6423;221;7375;7442;7.99;0.49;258.56;6.21;952;49;2528.00;67
6426;49;625383534;6426;219;7378;7443;7.96;0.49;258.57;6.21;952;49;2529.00;65
6427;49;625383546;6427;214;7381;7443;7.95;0.49;258.55;6.22;954;49;2530.00;62
6431;49;625383558;6431;219;7386;7447;7.91;0.49;258.61;6.22;955;49;2531.00;61
6433;49;625383571;6433;218;7389;7447;7.80;0.48;258.65;6.22;956;49;2532.00;58
6435;49;625383583;6435;219;7391;7447;7.72;0.47;258.59;6.23;956;49;2533.00;56
6438;49;625383602;6438;220;7392;7447;7.67;0.47;258.58;6.23;954;49;2534.00;55
6441;49;625383615;6441;222;7399;7453;7.62;0.47;258.64;6.24;958;49;2535.00;54
6444;49;625383628;6444;230;7399;7453;7.60;0.46;258.67;6.24;955;49;2536.00;54
6446;49;625383641;6446;237;7400;7455;7.61;0.46;258.74;6.24;954;49;2537.00;55
6449;49;625383654;6449;246;7405;7458;7.64;0.47;258.77;6.25;956;49;2538.00;53
6451;49;625383667;6451;257;7405;7458;7.63;0.47;258.77;6.25;954;49;2539.00;53
6453;49;625383680;6453;255;7405;7458;7.58;0.46;258.85;6.25;952;49;2540.00;53
6456;49;625383693;6456;251;7406;7459;7.49;0.46;258.87;6.26;950;49;2541.00;53
6460;49;625383705;6460;253;7407;7460;7.45;0.45;258.93;6.25;947;49;2542.00;53
6465;49;625383718;6465;258;7407;7460;7.36;0.45;259.00;6.25;942;49;2543.00;53
6468;49;625383730;6468;269;7419;7473;7.26;0.44;259.05;6.25;951;49;2544.00;54
6472;49;625383743;6472;267;7420;7473;7.25;0.44;259.02;6.25;948;49;2545.00;53
6475;49;625383756;6475;272;7422;7473;7.20;0.44;259.02;6.26;947;49;2546.00;51
6478;49;625383769;6478;272;7425;7474;7.10;0.43;259.06;6.27;947;49;2547.00;49
6483;49;625383781;6483;282;7425;7474;7.02;0.43;259.06;6.27;942;49;2548.00;49
6485;49;625383793;6485;284;7428;7478;6.96;0.43;259.05;6.27;943;49;2549.00;50
6489;49;625383806;6489;278;7431;7481;6.87;0.42;259.14;6.27;942;49;2550.00;50
6491;49;625383819;6491;271;7436;7485;6.83;0.42;259.12;6.27;945;49;2551.00;49
6498;49;625383833;6498;258;7438;7485;6.76;0.41;259.24;6.28;940;49;2552.00;47
6502;49;625383846;6502;263;7440;7485;6.70;0.41;259.31;6.28;938;49;2553.00;45
6506;49;625383858;6506;257;7440;7485;6.69;0.41;259.44;6.28;934;49;2554.00;45
6508;49;625383870;6508;261;7441;7485;6.71;0.41;259.46;6.28;933;49;2555.00;44
6512;49;625383883;6512;260;7451;7497;6.77;0.42;259.57;6.28;939;49;2556.00;46
6515;49;625383897;6515;258;7453;7497;6.82;0.42;259.55;6.28;938;49;2557.00;44
6518;49;625383910;6518;254;7454;7497;6.89;0.42;259.65;6.28;936;49;2558.00;43
6520;49;625383922;6520;254;7455;7497;6.96;0.43;259.71;6.28;935;49;2559.00;42
6522;49;625383934;6522;251;7455;7497;7.10;0.44;259.77;6.28;933;49;2560.00;42
6527;49;625383945;6527;255;7455;7497;7.16;0.44;259.83;6.28;928;49;2561.00;42
6531;49;625383958;6531;247;7455;7498;7.24;0.44;259.85;6.28;924;49;2562.00;43
6534;49;625383972;6534;247;7455;7498;7.29;0.45;259.94;6.28;921;49;2563.00;43
6537;49;625383985;6537;249;7459;7504;7.45;0.46;259.92;6.27;922;49;2564.00;45
6540;49;625383999;6540;245;7462;7506;7.56;0.47;259.99;6.27;922;49;2565.00;44
6545;49;625384012;6545;240;7462;7506;7.62;0.47;260.11;6.27;917;49;2566.00;44
6550;49;625384025;6550;232;7462;7506;7.70;0.48;260.09;6.27;912;49;2567.00;44
6554;49;625384037;6554;232;7465;7510;7.85;0.48;260.08;6.27;911;49;2568.00;45
6557;49;625384050;6557;235;7465;7510;7.94;0.49;260.11;6.27;908;49;2569.00;45
6562;49;625384062;6562;230;7465;7510;8.05;0.50;260.17;6.27;903;49;2570.00;45
6568;49;625384075;6568;229;7466;7511;8.17;0.50;260.23;6.27;898;49;2571.00;45
6571;49;625384093;6571;224;7469;7515;8.31;0.51;260.31;6.27;898;49;2572.00;46
6575;49;625384105;6575;222;7469;7515;8.40;0.52;260.32;6.27;894;49;2573.00;46
6583;49;625384117;6583;220;7471;7518;8.44;0.52;260.48;6.26;888;49;2574.00;47
6586;49;625384130;6586;217;7472;7518;8.50;0.52;260.55;6.26;886;49;2575.00;46
6593;49;625384143;6593;213;7472;7518;8.49;0.52;260.66;6.26;879;49;2576.00;46
6597;49;625384155;6597;215;7472;7518;8.51;0.52;260.66;6.26;875;49;2577.00;46
6603;49;625384168;6603;208;7475;7522;8.49;0.52;260.73;6.26;872;49;2578.00;47
6606;49;625384185;6606;207;7475;7522;8.49;0.52;260.82;6.26;869;49;2579.00;47
6612;49;625384200;6612;209;7476;7522;8.49;0.52;260.86;6.26;864;49;2580.00;46
6616;49;625384215;6616;212;7476;7522;8.46;0.52;260.93;6.26;860;49;2581.00;46
6623;49;625384229;6623;212;7476;7523;8.41;0.51;261.00;6.26;853;49;2582.00;47
6629;49;625384242;6629;213;7477;7524;8.37;0.51;261.05;6.26;848;49;2583.00;47
6631;49;625384256;6631;216;7477;7524;8.35;0.51;261.08;6.26;846;49;2584.00;47
6635;49;625384268;6635;221;7478;7525;8.33;0.51;261.11;6.26;843;49;2585.00;47
6639;49;625384282;6639;223;7478;7525;8.32;0.51;261.08;6.26;839;49;2586.00;47
6643;49;625384294;6643;231;7478;7525;8.29;0.50;261.07;6.26;835;49;2587.00;47
6647;49;625384306;6647;236;7478;7525;8.22;0.50;261.13;6.26;831;49;2588.00;47
6650;49;625384318;6650;243;7478;7525;8.10;0.49;261.13;6.26;828;49;2589.00;47
6655;49;625384332;6655;246;7479;7525;7.97;0.48;261.19;6.33;824;49;2590.00;46
6658;49;625384344;6658;251;7479;7525;7.87;0.48;261.21;6.33;821;49;2591.00;46
6660;49;625384355;6660;268;7546;7652;8.06;0.50;261.26;6.28;886;49;2592.00;106
6665;49;625384376;6665;269;7549;7653;7.95;0.49;261.31;6.28;884;49;2593.00;104
6666;49;625384388;6666;277;7557;7653;7.97;0.49;261.36;6.27;891;49;2594.00;96
6671;49;625384399;6671;271;7561;7653;7.94;0.49;261.36;6.27;890;49;2595.00;92
6675;49;625384410;6675;274;7566;7653;7.86;0.48;261.47;6.27;891;49;2596.00;87
6677;49;625384422;6677;275;7570;7653;7.85;0.48;261.52;6.27;893;49;2597.00;83
6682;49;625384434;6682;273;7574;7653;7.79;0.48;261.53;6.27;892;49;2598.00;79
6684;49;625384446;6684;278;7577;7653;7.80;0.48;261.58;6.27;893;49;2599.00;76
6686;50;625384459;6686;279;7581;7654;7.79;0.48;261.59;6.27;895;50;2600.00;73
6690;50;625384484;6690;278;7586;7655;7.84;0.48;261.72;6.27;896;50;2601.00;69
6692;50;625384502;6692;276;7587;7655;7.83;0.48;261.72;6.27;895;50;2602.00;68
6696;50;625384515;6696;277;7590;7656;7.80;0.48;261.78;6.27;894;50;2603.00;66
6698;50;625384528;6698;273;7592;7656;7.77;0.48;261.74;6.27;894;50;2604.00;64
6700;50;625384540;6700;270;7593;7656;7.74;0.48;261.77;6.27;893;50;2605.00;63
6703;50;625384563;6703;259;7595;7656;7.76;0.48;261.76;6.28;892;50;2606.00;61
6706;50;625384582;6706;257;7598;7660;7.84;0.48;261.81;6.28;892;50;2607.00;62
6707;51;625384596;6707;247;7599;7660;7.93;0.49;261.82;6.28;892;51;2608.00;61
6711;51;625384625;6711;238;7600;7660;8.00;0.49;261.90;6.28;889;51;2609.00;60
6713;51;625384648;6713;234;7604;7666;8.10;0.49;261.90;6.28;891;51;2610.00;62
6716;51;625384662;6716;233;7604;7666;8.17;0.50;261.89;6.28;888;51;2611.00;62
6720;51;625384675;6720;231;7605;7666;8.26;0.50;261.94;6.28;885;51;2612.00;61
6721;51;625384688;6721;236;7609;7670;8.36;0.51;261.97;6.28;888;51;2613.00;61
6727;51;625384701;6727;231;7610;7671;8.43;0.51;261.94;6.27;883;51;2614.00;61
6728;51;625384715;6728;240;7611;7671;8.48;0.52;261.90;6.27;883;51;2615.00;60
6733;51;625384733;6733;238;7614;7675;8.48;0.52;261.94;6.27;881;51;2616.00;61
6734;51;625384747;6734;236;7615;7675;8.47;0.52;261.96;6.27;881;51;2617.00;60
6735;51;625384759;6735;234;7616;7675;8.48;0.52;261.95;6.27;881;51;2618.00;59
6736;51;625384771;6736;235;7617;7676;8.44;0.51;261.95;6.27;881;51;2619.00;59
6738;51;625384783;6738;238;7617;7676;8.41;0.51;261.93;6.27;879;51;2620.00;59
6741;51;625384795;6741;242;7621;7682;8.37;0.51;261.96;6.27;880;51;2621.00;61
6743;51;625384808;6743;244;7622;7682;8.44;0.51;261.93;6.27;879;51;2622.00;60
6744;51;625384820;6744;249;7622;7683;8.42;0.51;261.91;6.27;878;51;2623.00;61
6744;51;625384832;6744;248;7622;7683;8.43;0.51;261.91;6.27;878;51;2624.00;61
6749;51;625384845;6749;250;7622;7683;8.38;0.51;261.82;6.27;873;51;2625.00;61
6749;51;625384858;6749;249;7622;7683;8.42;0.51;261.82;6.27;873;51;2626.00;61
6750;51;625384869;6750;247;7622;7683;8.45;0.51;261.83;6.27;872;51;2627.00;61
6750;51;625384880;6750;256;7631;7695;8.49;0.52;261.83;6.26;881;51;2628.00;64
6752;51;625384893;6752;259;7632;7695;8.43;0.51;261.80;6.26;880;51;2629.00;63
6753;51;625384904;6753;263;7633;7695;8.39;0.51;261.80;6.26;880;51;2630.00;62
6757;51;625384915;6757;267;7633;7695;8.29;0.50;261.71;6.26;876;51;2631.00;62
6760;51;625384926;6760;271;7633;7695;8.17;0.50;261.70;6.26;873;51;2632.00;62
6762;51;625384938;6762;281;7633;7695;8.07;0.49;261.71;6.26;871;51;2633.00;62
6763;51;625384949;6763;285;7636;7699;7.97;0.48;261.67;6.26;873;51;2634.00;63
6766;51;625384961;6766;288;7636;7699;7.91;0.48;261.64;6.26;870;51;2635.00;63
6771;51;625384977;6771;292;7639;7703;7.81;0.47;261.59;6.26;868;51;2636.00;64
6772;51;625384998;6772;297;7640;7704;7.73;0.47;261.56;6.25;868;51;2637.00;64
6774;51;625385013;6774;303;7641;7704;7.65;0.46;261.56;6.25;867;51;2638.00;63
6774;51;625385031;6774;306;7641;7704;7.55;0.46;261.56;6.25;867;51;2639.00;63
6776;51;625385051;6776;309;7661;7733;7.50;0.46;261.52;6.24;885;51;2640.00;72
6777;51;625385071;6777;301;7662;7733;7.43;0.45;261.49;6.24;885;51;2641.00;71
6778;51;625385086;6778;306;7665;7733;7.42;0.45;261.61;6.24;887;51;2642.00;68
6781;51;625385099;6781;309;7667;7734;7.40;0.45;261.61;6.23;886;51;2643.00;67
6782;51;625385110;6782;306;7667;7735;7.40;0.45;261.59;6.23;885;51;2644.00;68
6782;51;625385122;6782;312;7667;7735;7.39;0.45;261.59;6.23;885;51;2645.00;68
6783;51;625385134;6783;314;7670;7738;7.33;0.45;261.58;6.23;887;51;2646.00;68
6784;51;625385145;6784;312;7670;7738;7.26;0.44;261.56;6.23;886;51;2647.00;68
6785;51;625385157;6785;314;7670;7738;7.21;0.44;261.54;6.23;885;51;2648.00;68
6786;51;625385168;6786;309;7670;7738;7.10;0.43;261.50;6.23;884;51;2649.00;68
6786;51;625385180;6786;319;7674;7744;6.98;0.42;261.50;6.23;888;51;2650.00;70
6788;51;625385191;6788;302;7674;7744;6.87;0.42;261.56;6.23;886;51;2651.00;70
6788;51;625385202;6788;291;7675;7744;6.80;0.41;261.56;6.23;887;51;2652.00;69
6789;51;625385213;6789;279;7675;7744;6.72;0.41;261.58;6.23;886;51;2653.00;69
6794;51;625385227;6794;269;7679;7748;6.66;0.40;261.60;6.24;885;51;2654.00;69
6796;51;625385240;6796;265;7682;7750;6.69;0.41;261.65;6.25;886;51;2655.00;68
6796;51;625385252;6796;258;7682;7750;6.79;0.41;261.65;6.25;886;51;2656.00;68
6797;51;625385263;6797;246;7683;7751;6.92;0.42;261.67;6.25;886;51;2657.00;68
6800;51;625385274;6800;240;7683;7751;7.01;0.42;261.70;6.25;883;51;2658.00;68
6806;51;625385286;6806;231;7683;7751;7.10;0.43;261.67;6.25;877;51;2659.00;68
6807;51;625385297;6807;221;7683;7751;7.23;0.44;261.64;6.25;876;51;2660.00;68
6807;51;625385309;6807;219;7683;7751;7.40;0.45;261.64;6.25;876;51;2661.00;68
6810;51;625385325;6810;211;7683;7751;7.48;0.45;261.62;6.25;873;51;2662.00;68
6810;51;625385343;6810;206;7683;7751;7.57;0.46;261.62;6.25;873;51;2663.00;68
6814;51;625385356;6814;210;7721;7821;7.78;0.47;261.57;6.22;907;51;2664.00;100
6815;51;625385374;6815;206;7724;7822;7.77;0.47;261.55;6.22;909;51;2665.00;98
6818;51;625385386;6818;206;7729;7822;7.82;0.47;261.47;6.21;911;51;2666.00;93
6818;51;625385398;6818;202;7732;7822;7.83;0.48;261.47;6.21;914;51;2667.00;90
6819;51;625385409;6819;202;7734;7822;7.89;0.48;261.45;6.21;915;51;2668.00;88
6820;51;625385421;6820;194;7737;7822;7.96;0.48;261.43;6.21;917;51;2669.00;85
6820;51;625385440;6820;199;7740;7822;8.03;0.49;261.43;6.21;920;51;2670.00;82
6821;52;625385452;6821;204;7744;7822;8.05;0.49;261.42;6.21;923;52;2671.00;78
6824;52;625385477;6824;204;7745;7823;8.05;0.49;261.38;6.21;921;52;2672.00;78
6824;52;625385489;6824;207;7749;7824;8.14;0.49;261.38;6.21;925;52;2673.00;75
6826;52;625385502;6826;207;7751;7824;8.15;0.50;261.37;6.21;925;52;2674.00;73
6829;52;625385516;6829;209;7754;7828;8.01;0.49;261.37;6.21;925;52;2675.00;74
6832;52;625385529;6832;214;7755;7828;8.02;0.49;261.41;6.22;923;52;2676.00;73
6834;52;625385542;6834;211;7755;7828;8.03;0.49;261.44;6.22;921;52;2677.00;73
6838;52;625385554;6838;216;7755;7828;8.05;0.49;261.44;6.22;917;52;2678.00;73
6840;52;625385567;6840;221;7759;7834;8.21;0.50;261.41;6.22;919;52;2679.00;75
6843;52;625385580;6843;223;7761;7834;8.25;0.50;261.51;6.24;918;52;2680.00;73
6846;52;625385593;6846;214;7762;7834;8.28;0.50;261.56;6.24;916;52;2681.00;72
6846;52;625385606;6846;221;7764;7837;8.36;0.51;261.56;6.24;918;52;2682.00;73
6849;52;625385619;6849;224;7766;7837;8.39;0.51;261.61;6.27;917;52;2683.00;71
6853;52;625385631;6853;233;7767;7837;8.44;0.51;261.64;6.27;914;52;2684.00;70
6856;52;625385644;6856;233;7768;7838;8.46;0.51;261.61;6.28;912;52;2685.00;70
6862;52;625385657;6862;231;7770;7839;8.42;0.51;261.52;6.29;908;52;2686.00;69
6866;52;625385669;6866;226;7771;7839;8.35;0.51;261.58;6.30;905;52;2687.00;68
6868;52;625385682;6868;231;7782;7852;8.29;0.50;261.59;6.29;914;52;2688.00;70
6871;52;625385695;6871;234;7783;7852;8.26;0.50;261.61;6.30;912;52;2689.00;69
6872;52;625385708;6872;239;7783;7852;8.27;0.50;261.63;6.30;911;52;2690.00;69
6874;52;625385720;6874;242;7784;7853;8.25;0.50;261.64;6.30;910;52;2691.00;69
6876;52;625385733;6876;240;7786;7853;8.18;0.50;261.63;6.32;910;52;2692.00;67
6877;52;625385745;6877;240;7790;7857;8.19;0.50;261.63;6.32;913;52;2693.00;67
6881;52;625385758;6881;245;7792;7857;8.10;0.49;261.67;6.34;911;52;2694.00;65
6884;52;625385771;6884;244;7797;7861;8.01;0.49;261.68;6.33;913;52;2695.00;64
6885;52;625385783;6885;248;7799;7861;7.98;0.49;261.70;6.35;914;52;2696.00;62
6888;52;625385795;6888;251;7800;7861;7.91;0.48;261.72;6.36;912;52;2697.00;61
6891;52;625385814;6891;255;7800;7861;7.78;0.47;261.77;6.36;909;52;2698.00;61
6892;52;625385826;6892;250;7800;7861;7.68;0.47;261.79;6.36;908;52;2699.00;61
6896;52;625385841;6896;253;7824;7910;7.70;0.47;261.82;6.35;928;52;2700.00;86
6898;52;625385862;6898;254;7826;7910;7.66;0.47;261.85;6.35;928;52;2701.00;84
6900;52;625385880;6900;253;7830;7910;7.67;0.47;261.90;6.36;930;52;2702.00;80
6902;52;625385893;6902;249;7831;7910;7.64;0.47;261.92;6.36;929;52;2703.00;79
6905;52;625385904;6905;253;7835;7910;7.58;0.46;261.95;6.37;930;52;2704.00;75
6907;52;625385916;6907;252;7836;7910;7.57;0.46;261.92;6.37;929;52;2705.00;74
6910;52;625385928;6910;255;7840;7911;7.57;0.46;261.98;6.40;930;52;2706.00;71
6910;52;625385940;6910;252;7841;7911;7.58;0.46;261.98;6.40;931;52;2707.00;70
6911;52;625385952;6911;250;7845;7917;7.63;0.47;262.02;6.39;934;52;2708.00;72
6913;52;625385965;6913;255;7847;7918;7.63;0.47;262.08;6.40;934;52;2709.00;71
6915;52;625385978;6915;261;7848;7918;7.58;0.46;262.09;6.40;933;52;2710.00;70
6919;52;625385990;6919;268;7850;7918;7.50;0.46;262.18;6.41;931;52;2711.00;68
6924;52;625386002;6924;273;7853;7922;7.46;0.45;262.32;6.41;929;52;2712.00;69
6928;52;625386014;6928;279;7854;7922;7.39;0.45;262.33;6.41;926;52;2713.00;68
6934;52;625386026;6934;280;7857;7922;7.27;0.44;262.41;6.43;923;52;2714.00;65
6937;52;625386037;6937;280;7858;7923;7.23;0.44;262.51;6.43;921;52;2715.00;65
6941;52;625386048;6941;282;7862;7927;7.16;0.44;262.63;6.42;921;52;2716.00;65
6946;52;625386065;6946;283;7863;7927;7.04;0.43;262.73;6.43;917;52;2717.00;64
6950;52;625386076;6950;290;7866;7930;7.03;0.43;262.72;6.43;916;52;2718.00;64
6955;52;625386088;6955;291;7867;7930;6.98;0.42;262.78;6.44;912;52;2719.00;63
6961;52;625386099;6961;279;7868;7930;6.91;0.42;262.87;6.44;907;52;2720.00;62
6962;52;625386110;6962;273;7869;7930;6.92;0.42;262.86;6.44;907;52;2721.00;61
6965;52;625386120;6965;263;7873;7934;6.94;0.42;262.93;6.45;908;52;2722.00;61
6970;52;625386131;6970;258;7873;7934;6.94;0.42;263.05;6.45;903;52;2723.00;61
6974;52;625386142;6974;256;7876;7934;6.91;0.42;263.16;6.45;902;52;2724.00;58
6980;52;625386153;6980;247;7876;7934;6.84;0.42;263.20;6.45;896;52;2725.00;58
6982;52;625386164;6982;247;7876;7935;6.81;0.41;263.26;6.45;894;52;2726.00;59
6983;52;625386175;6983;239;7880;7936;6.84;0.42;263.27;6.46;897;52;2727.00;56
6986;52;625386186;6986;233;7880;7936;6.89;0.42;263.29;6.46;894;52;2728.00;56
6989;52;625386198;6989;232;7882;7937;7.00;0.43;263.32;6.45;893;52;2729.00;55
6992;52;625386211;6992;236;7883;7937;7.06;0.43;263.43;6.46;891;52;2730.00;54
6997;52;625386222;6997;240;7883;7937;7.14;0.44;263.44;6.46;886;52;2731.00;54
7000;52;625386234;7000;243;7885;7937;7.18;0.44;263.56;6.46;885;52;2732.00;52
7004;52;625386245;7004;247;7886;7937;7.27;0.44;263.65;6.47;882;52;2733.00;51
7007;52;625386257;7007;245;7887;7937;7.34;0.45;263.73;6.47;880;52;2734.00;50
7012;52;625386268;7012;244;7888;7937;7.41;0.45;263.71;6.47;876;52;2735.00;49
7016;52;625386280;7016;253;7958;8064;7.66;0.48;263.77;6.41;942;52;2736.00;106
7020;52;625386301;7020;245;7962;8065;7.65;0.47;263.74;6.41;942;52;2737.00;103
7025;52;625386313;7025;252;7966;8065;7.70;0.48;263.80;6.41;941;52;2738.00;99
7030;52;625386326;7030;251;7971;8065;7.68;0.48;263.82;6.41;941;52;2739.00;94
7034;52;625386338;7034;248;7976;8065;7.69;0.48;263.94;6.41;942;52;2740.00;89
7040;52;625386350;7040;254;7978;8065;7.66;0.47;263.96;6.41;938;52;2741.00;87
7046;52;625386362;7046;248;7980;8065;7.62;0.47;264.07;6.41;934;52;2742.00;85
7049;52;625386373;7049;255;7982;8065;7.60;0.47;264.10;6.41;933;52;2743.00;83
7053;52;625386385;7053;256;7984;8066;7.59;0.47;264.22;6.41;931;52;2744.00;82
7058;52;625386398;7058;261;7990;8068;7.59;0.47;264.38;6.41;932;52;2745.00;78
7066;52;625386410;7066;269;7992;8068;7.56;0.47;264.39;6.41;926;52;2746.00;76
7068;52;625386422;7068;270;7994;8069;7.61;0.47;264.43;6.41;926;52;2747.00;75
7074;52;625386434;7074;269;7996;8069;7.61;0.47;264.46;6.41;922;52;2748.00;73
7078;52;625386446;7078;265;7998;8069;7.60;0.47;264.47;6.41;920;52;2749.00;71
7083;52;625386459;7083;269;8001;8069;7.57;0.47;264.49;6.42;918;52;2750.00;68
7087;52;625386471;7087;266;8004;8073;7.55;0.47;264.46;6.42;917;52;2751.00;69
7093;52;625386484;7093;271;8011;8073;7.53;0.47;264.49;6.42;918;52;2752.00;62
7097;52;625386496;7097;270;8011;8073;7.50;0.46;264.42;6.42;914;52;2753.00;62
7104;52;625386508;7104;277;8016;8076;7.45;0.46;264.38;6.43;912;52;2754.00;60
7109;52;625386521;7109;286;8019;8076;7.39;0.46;264.38;6.43;910;52;2755.00;57
7115;52;625386533;7115;289;8020;8076;7.38;0.45;264.34;6.43;905;52;2756.00;56
7121;52;625386545;7121;295;8023;8080;7.36;0.45;264.48;6.43;902;52;2757.00;57
7127;52;625386557;7127;300;8024;8081;7.31;0.45;264.51;6.42;897;52;2758.00;57
7131;52;625386570;7131;311;8024;8081;7.26;0.45;264.53;6.42;893;52;2759.00;57
7136;52;625386588;7136;314;8029;8086;7.17;0.44;264.50;6.50;893;52;2760.00;57
7138;52;625386602;7138;316;8029;8086;7.15;0.44;264.49;6.50;891;52;2761.00;57
7144;52;625386614;7144;318;8029;8086;7.07;0.43;264.49;6.50;885;52;2762.00;57
7149;52;625386626;7149;324;8030;8087;7.01;0.43;264.48;6.50;881;52;2763.00;57
7152;52;625386638;7152;331;8030;8087;6.92;0.42;264.50;6.50;878;52;2764.00;57
7153;52;625386650;7153;340;8034;8093;6.87;0.42;264.57;6.50;881;52;2765.00;59
7156;52;625386662;7156;345;8034;8093;6.83;0.42;264.63;6.50;878;52;2766.00;59
7158;52;625386674;7158;335;8035;8094;6.85;0.42;264.61;6.50;877;52;2767.00;59
7161;52;625386686;7161;327;8035;8094;6.86;0.42;264.76;6.50;874;52;2768.00;59
7163;52;625386698;7163;320;8035;8094;6.91;0.42;264.75;6.50;872;52;2769.00;59
7166;52;625386710;7166;313;8035;8094;6.97;0.43;264.79;6.50;869;52;2770.00;59
7169;52;625386740;7169;307;8035;8094;7.04;0.43;264.82;6.50;866;52;2771.00;59
7171;52;625386752;7171;306;8044;8106;7.16;0.44;264.83;6.49;873;52;2772.00;62
7178;52;625386764;7178;311;8044;8106;7.25;0.44;264.81;6.49;866;52;2773.00;62
7179;52;625386782;7179;313;8046;8106;7.37;0.45;264.87;6.49;867;52;2774.00;60
7182;52;625386800;7182;311;8046;8106;7.39;0.45;264.85;6.49;864;52;2775.00;60
7185;52;625386818;7185;298;8047;8106;7.37;0.45;264.86;6.57;862;52;2776.00;59
7189;52;625386831;7189;288;8047;8106;7.42;0.45;264.80;6.57;858;52;2777.00;59
7195;52;625386843;7195;283;8050;8110;7.46;0.45;264.79;6.57;855;52;2778.00;60
7198;52;625386855;7198;274;8050;8110;7.50;0.46;264.81;6.57;852;52;2779.00;60
7199;52;625386867;7199;276;8054;8114;7.56;0.46;264.79;6.64;855;52;2780.00;60
7201;52;625386880;7201;268;8056;8115;7.58;0.46;264.77;6.64;855;52;2781.00;59
7202;52;625386892;7202;266;8056;8115;7.63;0.46;264.74;6.64;854;52;2782.00;59
7204;52;625386904;7204;268;8056;8115;7.70;0.47;264.80;6.64;852;52;2783.00;59
7206;52;625386922;7206;269;8066;8128;7.79;0.47;264.77;6.63;860;52;2784.00;62
7206;52;625386935;7206;271;8066;8128;7.80;0.47;264.77;6.63;860;52;2785.00;62
7208;52;625386947;7208;277;8067;8128;7.81;0.47;264.77;6.63;859;52;2786.00;61
7209;52;625386959;7209;274;8068;8129;7.88;0.48;264.78;6.63;859;52;2787.00;61
7210;52;625386979;7210;275;8068;8130;7.91;0.48;264.74;6.63;858;52;2788.00;62
7211;52;625386998;7211;272;8068;8130;8.00;0.49;264.74;6.63;857;52;2789.00;62
7212;52;625387028;7212;271;8071;8136;7.99;0.49;264.73;6.63;859;52;2790.00;65
7214;52;625387047;7214;273;8072;8136;7.96;0.48;264.71;6.63;858;52;2791.00;64
7217;52;625387065;7217;277;8072;8136;7.91;0.48;264.78;6.63;855;52;2792.00;64
7218;52;625387082;7218;282;8073;8136;7.82;0.47;264.77;6.63;855;52;2793.00;63
7219;52;625387095;7219;286;8076;8142;7.74;0.47;264.76;6.62;857;52;2794.00;66
7220;52;625387108;7220;282;8078;8142;7.65;0.46;264.76;6.70;858;52;2795.00;64
7222;52;625387121;7222;289;8078;8142;7.48;0.45;264.72;6.70;856;52;2796.00;64
7224;52;625387133;7224;293;8079;8142;7.42;0.45;264.71;6.70;855;52;2797.00;63
7227;52;625387145;7227;300;8082;8146;7.31;0.44;264.69;6.70;855;52;2798.00;64
7228;52;625387158;7228;308;8084;8147;7.31;0.44;264.70;6.70;856;52;2799.00;63
7231;52;625387171;7231;310;8084;8147;7.27;0.44;264.66;6.70;853;52;2800.00;63
7231;52;625387188;7231;321;8085;8148;7.22;0.44;264.66;6.70;854;52;2801.00;63
7232;52;625387199;7232;326;8085;8148;7.17;0.43;264.67;6.70;853;52;2802.00;63
7232;52;625387211;7232;321;8085;8148;7.18;0.44;264.67;6.70;853;52;2803.00;63
7233;52;625387223;7233;308;8085;8148;7.19;0.44;264.73;6.70;852;52;2804.00;63
7236;52;625387235;7236;305;8085;8148;7.20;0.44;264.81;6.70;849;52;2805.00;63
7238;52;625387247;7238;304;8085;8148;7.23;0.44;264.80;6.70;847;52;2806.00;63
7239;52;625387259;7239;301;8085;8148;7.21;0.44;264.79;6.70;846;52;2807.00;63
7241;52;625387271;7241;307;8128;8218;7.22;0.44;264.75;6.66;887;52;2808.00;90
7242;52;625387289;7242;294;8128;8219;7.24;0.44;264.74;6.66;886;52;2809.00;91
7244;52;625387307;7244;278;8134;8219;7.32;0.45;264.74;6.66;890;52;2810.00;85
7246;52;625387320;7246;264;8140;8219;7.47;0.46;264.74;6.73;894;52;2811.00;79
7246;52;625387332;7246;251;8145;8219;7.62;0.46;264.74;6.73;899;52;2812.00;74
7247;52;625387343;7247;243;8148;8219;7.70;0.47;264.72;6.73;901;52;2813.00;71
7247;52;625387355;7247;241;8151;8219;7.80;0.48;264.72;6.81;904;52;2814.00;68
7249;52;625387368;7249;241;8151;8219;7.81;0.48;264.71;6.81;902;52;2815.00;68
7250;52;625387379;7250;236;8153;8220;7.91;0.48;264.70;6.81;903;52;2816.00;67
7251;52;625387398;7251;230;8154;8221;7.91;0.48;264.70;6.81;903;52;2817.00;67
7252;52;625387410;7252;234;8155;8221;7.92;0.48;264.69;6.81;903;52;2818.00;66
7255;52;625387422;7255;237;8158;8225;7.88;0.48;264.68;6.81;903;52;2819.00;67
7258;52;625387436;7258;232;8158;8225;7.79;0.47;264.68;6.81;900;52;2820.00;67
7261;52;625387448;7261;233;8158;8225;7.65;0.47;264.66;6.81;897;52;2821.00;67
7263;52;625387460;7263;221;8158;8225;7.54;0.46;264.67;6.81;895;52;2822.00;67
7264;52;625387473;7264;215;8163;8231;7.47;0.46;264.68;6.89;899;52;2823.00;68
7267;52;625387485;7267;217;8164;8231;7.45;0.45;264.66;6.89;897;52;2824.00;67
7268;52;625387497;7268;208;8165;8231;7.49;0.46;264.65;6.90;897;52;2825.00;66
7271;52;625387510;7271;204;8168;8234;7.54;0.46;264.61;6.97;897;52;2826.00;66
7272;52;625387523;7272;199;8168;8234;7.55;0.46;264.69;6.97;896;52;2827.00;66
7276;52;625387535;7276;191;8169;8234;7.57;0.46;264.72;6.97;893;52;2828.00;65
7282;52;625387546;7282;194;8170;8235;7.60;0.46;264.70;7.05;888;52;2829.00;65
7285;52;625387558;7285;187;8171;8236;7.64;0.47;264.67;7.05;886;52;2830.00;65
7288;52;625387570;7288;182;8172;8236;7.66;0.47;264.69;7.14;884;52;2831.00;64
7296;52;625387582;7296;177;8181;8249;7.62;0.46;264.62;7.13;885;52;2832.00;68
7298;52;625387595;7298;173;8181;8249;7.66;0.46;264.63;7.13;883;52;2833.00;68
7300;52;625387608;7300;179;8183;8249;7.67;0.47;264.58;7.21;883;52;2834.00;66
7302;52;625387625;7302;179;8185;8251;7.75;0.47;264.52;7.21;883;52;2835.00;66
7304;52;625387637;7304;173;8185;8251;7.88;0.48;264.61;7.21;881;52;2836.00;66
7305;52;625387649;7305;174;8190;8255;8.01;0.49;264.62;7.29;885;52;2837.00;65
7309;52;625387661;7309;173;8191;8255;8.06;0.49;264.65;7.29;882;52;2838.00;64
7310;52;625387672;7310;176;8194;8259;8.08;0.49;264.70;7.28;884;52;2839.00;65
7313;52;625387685;7313;167;8195;8259;8.08;0.49;264.75;7.36;882;52;2840.00;64
7315;52;625387697;7315;165;8195;8259;8.10;0.49;264.81;7.36;880;52;2841.00;64
7315;52;625387709;7315;160;8196;8259;8.12;0.49;264.81;7.45;881;52;2842.00;63
7317;52;625387721;7317;166;8196;8259;8.16;0.50;264.85;7.45;879;52;2843.00;63
7321;52;625387734;7321;166;8205;8271;8.26;0.50;264.95;7.44;884;52;2844.00;66
7326;52;625387747;7326;165;8207;8271;8.29;0.50;264.99;7.52;881;52;2845.00;64
7328;52;625387760;7328;163;8208;8271;8.34;0.50;265.02;7.52;880;52;2846.00;63
7331;52;625387772;7331;172;8208;8271;8.35;0.51;265.11;7.52;877;52;2847.00;63
7333;52;625387784;7333;173;8208;8271;8.44;0.51;265.16;7.52;875;52;2848.00;63
7333;52;625387798;7333;180;8208;8271;8.52;0.52;265.16;7.52;875;52;2849.00;63
7335;52;625387812;7335;179;8212;8274;8.48;0.51;265.19;7.54;877;52;2850.00;62
7336;52;625387825;7336;177;8212;8274;8.46;0.51;265.22;7.54;876;52;2851.00;62
7341;52;625387838;7341;178;8216;8280;8.51;0.52;265.29;7.54;875;52;2852.00;64
7343;52;625387852;7343;174;8219;8281;8.52;0.52;265.27;7.55;876;52;2853.00;62
7345;52;625387864;7345;183;8220;8281;8.59;0.52;265.28;7.57;875;52;2854.00;61
7349;52;625387876;7349;188;8221;8281;8.62;0.53;265.24;7.58;872;52;2855.00;60
7353;52;625387889;7353;186;8225;8285;8.67;0.53;265.29;7.59;872;52;2856.00;60
7358;52;625387903;7358;187;8227;8285;8.62;0.52;265.38;7.61;869;52;2857.00;58
7361;52;625387916;7361;190;8227;8285;8.59;0.52;265.41;7.61;866;52;2858.00;58
7363;52;625387928;7363;192;8230;8286;8.59;0.52;265.42;7.63;867;52;2859.00;56
7365;52;625387940;7365;194;8233;8290;8.54;0.52;265.43;7.63;868;52;2860.00;57
7367;52;625387953;7367;200;8234;8290;8.49;0.52;265.50;7.64;867;52;2861.00;56
7369;52;625387968;7369;200;8237;8293;8.52;0.52;265.57;7.65;868;52;2862.00;56
7372;52;625387981;7372;200;8239;8293;8.52;0.52;265.60;7.65;867;52;2863.00;54
7377;52;625387993;7377;204;8243;8295;8.40;0.51;265.65;7.67;866;52;2864.00;52
7378;52;625388006;7378;205;8243;8295;8.37;0.51;265.68;7.67;865;52;2865.00;52
7381;52;625388018;7381;202;8247;8299;8.42;0.51;265.66;7.67;866;52;2866.00;52
7383;52;625388029;7383;205;8249;8299;8.36;0.51;265.69;7.68;866;52;2867.00;50
7388;52;625388041;7388;208;8249;8299;8.27;0.50;265.80;7.68;861;52;2868.00;50
7390;52;625388052;7390;202;8251;8299;8.21;0.50;265.85;7.69;861;52;2869.00;48
7392;52;625388062;7392;206;8251;8300;8.12;0.50;265.91;7.69;859;52;2870.00;49
7395;52;625388073;7395;204;8253;8301;8.08;0.49;265.96;7.70;858;52;2871.00;48
7399;52;625388084;7399;204;8254;8301;8.07;0.49;265.98;7.70;855;52;2872.00;47
7402;52;625388095;7402;200;8255;8302;8.09;0.49;265.98;7.70;853;52;2873.00;47
7403;52;625388106;7403;199;8257;8302;8.08;0.49;265.96;7.71;854;52;2874.00;45
7407;52;625388117;7407;204;8257;8302;8.01;0.49;266.04;7.71;850;52;2875.00;45
7409;52;625388127;7409;200;8257;8302;8.06;0.49;266.00;7.71;848;52;2876.00;45
7412;52;625388138;7412;203;8258;8302;8.10;0.49;266.09;7.72;846;52;2877.00;44
7414;52;625388149;7414;209;8258;8302;8.11;0.49;266.09;7.72;844;52;2878.00;44
7417;52;625388159;7417;213;8258;8302;8.12;0.49;266.14;7.72;841;52;2879.00;44
7420;52;625388177;7420;257;8359;8532;8.12;0.51;266.18;7.65;939;52;2880.00;173
7422;52;625388206;7422;246;8360;8533;8.11;0.51;266.17;7.64;938;52;2881.00;173
7427;52;625388218;7427;238;8371;8533;8.14;0.51;266.20;7.64;944;52;2882.00;162
7430;52;625388229;7430;235;8377;8533;8.08;0.50;266.20;7.64;947;52;2883.00;156
7434;52;625388240;7434;232;8383;8533;8.05;0.50;266.28;7.64;949;52;2884.00;150
7437;52;625388252;7437;233;8393;8533;7.98;0.50;266.27;7.64;956;52;2885.00;140
7440;52;625388263;7440;233;8400;8533;7.94;0.49;266.25;7.64;960;52;2886.00;133
7445;52;625388274;7445;241;8405;8533;7.80;0.48;266.31;7.64;960;52;2887.00;128
7450;52;625388291;7450;247;8413;8534;7.63;0.47;266.30;7.64;963;52;2888.00;121
7454;52;625388303;7454;255;8416;8535;7.50;0.46;266.39;7.64;962;52;2889.00;119
7455;52;625388316;7455;251;8424;8535;7.41;0.46;266.38;7.65;969;52;2890.00;111
7459;52;625388329;7459;254;8428;8536;7.31;0.45;266.49;7.65;969;52;2891.00;108
7462;52;625388341;7462;254;8433;8536;7.20;0.45;266.57;7.65;971;52;2892.00;103
7464;52;625388359;7464;260;8436;8536;7.12;0.44;266.68;7.65;972;52;2893.00;100
7469;52;625388370;7469;263;8441;8536;6.97;0.43;266.76;7.66;972;52;2894.00;95
7472;52;625388384;7472;274;8445;8540;6.90;0.43;266.88;7.66;973;52;2895.00;95
7476;52;625388398;7476;283;8449;8540;6.77;0.42;267.06;7.66;973;52;2896.00;91
7480;52;625388410;7480;278;8451;8540;6.74;0.42;267.11;7.66;971;52;2897.00;89
7485;52;625388422;7485;279;8456;8543;6.75;0.42;267.18;7.67;971;52;2898.00;87
7489;52;625388435;7489;272;8459;8543;6.80;0.42;267.19;7.67;970;52;2899.00;84
7492;52;625388448;7492;270;8462;8543;6.86;0.42;267.27;7.68;970;52;2900.00;81
7497;52;625388466;7497;272;8464;8547;6.95;0.43;267.28;7.68;967;52;2901.00;83
7502;52;625388480;7502;266;8466;8548;6.93;0.43;267.38;7.68;964;52;2902.00;82
7505;52;625388493;7505;266;8469;8548;6.97;0.43;267.44;7.68;964;52;2903.00;79
7507;52;625388506;7507;272;8474;8552;7.07;0.43;267.51;7.68;967;52;2904.00;78
7515;52;625388519;7515;273;8477;8552;7.03;0.43;267.55;7.69;962;52;2905.00;75
7519;52;625388531;7519;280;8478;8552;7.05;0.43;267.60;7.69;959;52;2906.00;74
7523;52;625388544;7523;280;8482;8553;7.05;0.43;267.60;7.69;959;52;2907.00;71
7528;52;625388556;7528;288;8482;8553;6.97;0.43;267.66;7.69;954;52;2908.00;71
7530;52;625388569;7530;291;8486;8559;6.91;0.42;267.69;7.69;956;52;2909.00;73
7533;52;625388583;7533;296;8491;8559;6.86;0.42;267.71;7.70;958;52;2910.00;68
7537;53;625388595;7537;299;8491;8560;6.78;0.42;267.76;7.70;954;53;2911.00;69
7538;53;625388629;7538;312;8493;8560;6.77;0.42;267.74;7.71;955;53;2912.00;67
7542;53;625388642;7542;318;8495;8560;6.74;0.41;267.82;7.71;953;53;2913.00;65
7546;53;625388654;7546;325;8495;8560;6.67;0.41;267.90;7.71;949;53;2914.00;65
7547;53;625388665;7547;325;8498;8560;6.62;0.41;267.90;7.72;951;53;2915.00;62
7552;53;625388677;7552;332;8509;8572;6.66;0.41;267.94;7.71;957;53;2916.00;63
7556;53;625388691;7556;341;8509;8572;6.60;0.41;267.95;7.71;953;53;2917.00;63
7563;53;625388702;7563;341;8510;8572;6.53;0.40;267.89;7.71;947;53;2918.00;62
7568;53;625388717;7568;346;8510;8572;6.50;0.40;267.94;7.71;942;53;2919.00;62
7572;53;625388732;7572;353;8511;8572;6.42;0.39;267.92;7.71;939;53;2920.00;61
7574;53;625388746;7574;359;8511;8572;6.52;0.40;267.92;7.71;937;53;2921.00;61
7577;53;625388758;7577;360;8515;8576;6.55;0.40;267.97;7.71;938;53;2922.00;61
7579;53;625388771;7579;359;8515;8576;6.57;0.40;268.00;7.71;936;53;2923.00;61
7581;53;625388783;7581;360;8518;8580;6.57;0.40;268.03;7.71;937;53;2924.00;62
7583;53;625388795;7583;364;8522;8582;6.60;0.40;268.01;7.80;939;53;2925.00;60
7584;53;625388808;7584;366;8522;8582;6.57;0.40;267.99;7.80;938;53;2926.00;60
7584;53;625388820;7584;376;8522;8582;6.58;0.40;267.99;7.80;938;53;2927.00;60
7588;53;625388833;7588;368;8531;8595;6.66;0.41;268.07;7.79;943;53;2928.00;64
7591;53;625388846;7591;375;8531;8595;6.66;0.41;268.07;7.79;940;53;2929.00;64
7592;53;625388857;7592;381;8532;8595;6.69;0.41;268.05;7.79;940;53;2930.00;63
7596;53;625388868;7596;385;8533;8596;6.68;0.41;268.06;7.79;937;53;2931.00;63
7599;53;625388880;7599;390;8533;8597;6.65;0.41;268.06;7.79;934;53;2932.00;64
7601;53;625388892;7601;394;8533;8597;6.57;0.40;268.04;7.79;932;53;2933.00;64
7604;53;625388903;7604;402;8535;8600;6.53;0.40;267.98;7.79;931;53;2934.00;65
7609;53;625388915;7609;409;8536;8600;6.47;0.39;267.87;7.78;927;53;2935.00;64
7611;53;625388926;7611;407;8536;8600;6.42;0.39;267.84;7.78;925;53;2936.00;64
7612;53;625388938;7612;402;8536;8600;6.41;0.39;267.81;7.78;924;53;2937.00;64
7615;53;625388949;7615;399;8540;8606;6.41;0.39;267.81;7.78;925;53;2938.00;66
7618;53;625388962;7618;395;8540;8606;6.40;0.39;267.75;7.78;922;53;2939.00;66
7621;53;625388980;7621;385;8541;8606;6.41;0.39;267.72;7.78;920;53;2940.00;65
7623;53;625389000;7623;382;8541;8606;6.40;0.39;267.67;7.78;918;53;2941.00;65
7624;53;625389018;7624;382;8544;8610;6.47;0.40;267.66;7.78;920;53;2942.00;66
7626;53;625389037;7626;380;8545;8611;6.50;0.40;267.62;7.78;919;53;2943.00;66
7631;53;625389055;7631;378;8545;8611;6.47;0.39;267.61;7.78;914;53;2944.00;66
7631;53;625389071;7631;378;8546;8612;6.54;0.40;267.61;7.78;915;53;2945.00;66
7635;54;625389089;7635;366;8546;8612;6.56;0.40;267.51;7.78;911;54;2946.00;66
7636;54;625389115;7636;358;8547;8612;6.60;0.40;267.52;7.87;911;54;2947.00;65
7637;54;625389128;7637;347;8547;8612;6.68;0.41;267.49;7.87;910;54;2948.00;65
7640;54;625389141;7640;338;8547;8612;6.70;0.41;267.44;7.87;907;54;2949.00;65
7641;54;625389160;7641;334;8547;8612;6.72;0.41;267.45;7.87;906;54;2950.00;65
7643;54;625389174;7643;328;8548;8612;6.77;0.41;267.44;7.95;905;54;2951.00;64
7644;54;625389188;7644;330;8580;8682;7.01;0.43;267.48;7.92;936;54;2952.00;102
7646;54;625389207;7646;333;8581;8683;7.04;0.43;267.46;7.92;935;54;2953.00;102
7647;54;625389220;7647;334;8589;8683;7.16;0.44;267.46;7.92;942;54;2954.00;94
7649;54;625389234;7649;321;8592;8683;7.21;0.44;267.46;7.99;943;54;2955.00;91
7651;54;625389254;7651;310;8595;8683;7.27;0.44;267.45;7.99;944;54;2956.00;88
7651;54;625389268;7651;304;8598;8683;7.34;0.45;267.45;7.99;947;54;2957.00;85
7652;54;625389280;7652;300;8601;8683;7.42;0.45;267.45;7.99;949;54;2958.00;82
7652;54;625389294;7652;299;8603;8683;7.49;0.46;267.45;7.99;951;54;2959.00;80
7653;54;625389307;7653;287;8606;8684;7.59;0.46;267.44;7.99;953;54;2960.00;78
7655;54;625389320;7655;284;8609;8685;7.68;0.47;267.45;7.99;954;54;2961.00;76
7655;54;625389337;7655;279;8610;8685;7.78;0.47;267.45;7.98;955;54;2962.00;75
7657;54;625389351;7657;275;8613;8689;7.90;0.48;267.42;7.98;956;54;2963.00;76
7661;54;625389364;7661;271;8613;8689;7.98;0.48;267.49;7.98;952;54;2964.00;76
7662;54;625389378;7662;273;8613;8689;8.01;0.49;267.50;7.98;951;54;2965.00;76
7664;54;625389391;7664;275;8613;8689;7.98;0.49;267.46;7.98;949;54;2966.00;76
7664;54;625389404;7664;267;8616;8695;7.93;0.48;267.46;7.98;952;54;2967.00;79
7664;54;625389424;7664;273;8616;8695;7.84;0.48;267.46;7.98;952;54;2968.00;79
7665;54;625389437;7665;272;8617;8695;7.87;0.48;267.46;7.98;952;54;2969.00;78
7666;54;625389458;7666;278;8620;8701;7.88;0.48;267.45;7.98;954;54;2970.00;81
7667;54;625389473;7667;280;8621;8701;7.90;0.48;267.45;7.98;954;54;2971.00;80
7668;54;625389486;7668;275;8621;8701;7.90;0.48;267.45;7.98;953;54;2972.00;80
7669;54;625389499;7669;279;8622;8702;7.89;0.48;267.44;7.97;953;54;2973.00;80
7672;54;625389513;7672;284;8623;8703;7.83;0.48;267.42;7.97;951;54;2974.00;80
7673;54;625389526;7673;282;8624;8703;7.86;0.48;267.41;7.97;951;54;2975.00;79
7673;54;625389539;7673;286;8633;8716;7.90;0.48;267.41;8.04;960;54;2976.00;83
7676;54;625389554;7676;294;8634;8716;7.91;0.48;267.44;8.04;958;54;2977.00;82
7677;54;625389567;7677;300;8634;8716;7.93;0.48;267.44;8.04;957;54;2978.00;82
7680;54;625389580;7680;298;8635;8717;7.96;0.49;267.51;8.04;955;54;2979.00;82
7685;54;625389593;7685;299;8635;8717;7.93;0.48;267.54;8.04;950;54;2980.00;82
7690;54;625389606;7690;295;8637;8721;7.91;0.48;267.59;8.04;947;54;2981.00;84
7693;54;625389620;7693;294;8637;8721;7.85;0.48;267.55;8.04;944;54;2982.00;84
7696;54;625389634;7696;287;8641;8725;7.79;0.47;267.58;8.04;945;54;2983.00;84
7698;54;625389647;7698;283;8641;8725;7.75;0.47;267.58;8.04;943;54;2984.00;84
7702;54;625389660;7702;281;8641;8725;7.68;0.47;267.60;8.04;939;54;2985.00;84
7703;54;625389673;7703;273;8641;8725;7.69;0.47;267.61;8.04;938;54;2986.00;84
7708;54;625389686;7708;272;8641;8725;7.67;0.47;267.58;8.04;933;54;2987.00;84
7711;54;625389699;7711;268;8650;8737;7.74;0.47;267.72;8.03;939;54;2988.00;87
7714;54;625389712;7714;269;8651;8737;7.75;0.47;267.79;8.03;937;54;2989.00;86
7719;54;625389725;7719;265;8653;8737;7.71;0.47;267.84;8.03;934;54;2990.00;84
7723;54;625389737;7723;260;8653;8737;7.70;0.47;267.84;8.03;930;54;2991.00;84
7730;54;625389749;7730;251;8653;8737;7.67;0.46;267.93;8.03;923;54;2992.00;84
7733;54;625389762;7733;238;8653;8737;7.73;0.47;267.96;8.03;920;54;2993.00;84
7737;55;625389775;7737;235;8655;8738;7.72;0.47;267.94;8.04;918;55;2994.00;83
7740;55;625389795;7740;229;8657;8738;7.69;0.47;267.94;8.06;917;55;2995.00;81
7745;55;625389808;7745;230;8660;8744;7.69;0.46;268.00;8.06;915;55;2996.00;84
7747;55;625389827;7747;226;8661;8745;7.73;0.47;267.99;8.06;914;55;2997.00;84
7749;55;625389840;7749;223;8662;8745;7.81;0.47;267.95;8.06;913;55;2998.00;83
7750;55;625389852;7750;219;8662;8745;7.88;0.48;267.95;8.06;912;55;2999.00;83
7752;55;625389867;7752;224;8666;8765;7.95;0.48;267.98;8.06;914;55;3000.00;99
7754;55;625389886;7754;219;8667;8765;7.98;0.48;267.99;8.05;913;55;3001.00;98
7758;55;625389899;7758;220;8669;8765;8.04;0.49;268.02;8.21;911;55;3002.00;96
7761;55;625389912;7761;215;8670;8766;8.11;0.49;268.07;8.20;909;55;3003.00;96
7763;55;625389925;7763;215;8673;8770;8.17;0.49;268.08;8.20;910;55;3004.00;97
7769;55;625389938;7769;205;8673;8770;8.17;0.49;268.17;8.20;904;55;3005.00;97
7773;55;625389952;7773;210;8676;8773;8.19;0.49;268.14;8.20;903;55;3006.00;97
7773;55;625389965;7773;213;8677;8773;8.25;0.50;268.14;8.20;904;55;3007.00;96
7775;55;625389979;7775;209;8680;8773;8.22;0.50;268.21;8.22;905;55;3008.00;93
7779;55;625389992;7779;205;8681;8773;8.30;0.50;268.24;8.22;902;55;3009.00;92
7780;55;625390004;7780;209;8684;8777;8.43;0.51;268.32;8.23;904;55;3010.00;93
7784;55;625390017;7784;201;8684;8777;8.52;0.52;268.34;8.23;900;55;3011.00;93
7789;55;625390030;7789;202;8688;8777;8.54;0.52;268.39;8.24;899;55;3012.00;89
7790;55;625390042;7790;198;8690;8777;8.60;0.52;268.41;8.24;900;55;3013.00;87
7792;55;625390060;7792;197;8690;8778;8.63;0.52;268.48;8.24;898;55;3014.00;88
7796;55;625390072;7796;196;8695;8780;8.67;0.53;268.66;8.24;899;55;3015.00;85
7797;55;625390085;7797;193;8695;8780;8.70;0.53;268.64;8.24;898;55;3016.00;85
7802;55;625390097;7802;194;8697;8781;8.71;0.53;268.71;8.24;895;55;3017.00;84
7806;55;625390110;7806;193;8698;8781;8.73;0.53;268.74;8.24;892;55;3018.00;83
7807;55;625390123;7807;194;8700;8781;8.82;0.53;268.76;8.26;893;55;3019.00;81
7810;55;625390135;7810;200;8701;8781;8.84;0.54;268.80;8.27;891;55;3020.00;80
7813;55;625390147;7813;201;8702;8781;8.89;0.54;268.84;8.27;889;55;3021.00;79
7815;55;625390160;7815;202;8703;8781;8.94;0.54;268.86;8.29;888;55;3022.00;78
7818;55;625390172;7818;210;8704;8781;8.97;0.54;268.92;8.30;886;55;3023.00;77
7819;55;625390184;7819;230;8768;8908;8.95;0.55;268.92;8.25;949;55;3024.00;140
7821;55;625390207;7821;220;8773;8909;9.01;0.55;268.94;8.27;952;55;3025.00;136
7826;55;625390221;7826;211;8779;8909;9.08;0.56;269.01;8.26;953;55;3026.00;130
7828;55;625390234;7828;208;8781;8909;9.09;0.56;269.03;8.26;953;55;3027.00;128
7831;55;625390248;7831;208;8788;8909;9.18;0.56;269.06;8.29;957;55;3028.00;121
7833;55;625390262;7833;206;8790;8909;9.18;0.56;269.09;8.29;957;55;3029.00;119
7836;55;625390277;7836;203;8795;8909;9.18;0.56;269.11;8.30;959;55;3030.00;114
7837;55;625390290;7837;207;8802;8909;9.11;0.56;269.13;8.32;965;55;3031.00;107
7840;55;625390302;7840;210;8805;8910;9.12;0.56;269.16;8.33;965;55;3032.00;105
7842;55;625390315;7842;214;8808;8911;9.08;0.56;269.10;8.33;966;55;3033.00;103
7847;55;625390328;7847;220;8814;8911;9.04;0.55;269.19;8.34;967;55;3034.00;97
7850;55;625390342;7850;224;8816;8912;9.02;0.55;269.23;8.34;966;55;3035.00;96
7850;55;625390355;7850;226;8821;8912;8.94;0.55;269.23;8.35;971;55;3036.00;91
7853;55;625390368;7853;241;8826;8912;8.81;0.54;269.28;8.36;973;55;3037.00;86
7857;55;625390381;7857;242;8831;8912;8.68;0.53;269.32;8.38;974;55;3038.00;81
7859;55;625390394;7859;240;8837;8916;8.64;0.53;269.45;8.38;978;55;3039.00;79
7861;55;625390407;7861;248;8841;8916;8.54;0.53;269.46;8.39;980;55;3040.00;75
7865;55;625390420;7865;251;8844;8916;8.45;0.52;269.47;8.39;979;55;3041.00;72
7870;55;625390433;7870;259;8848;8919;8.35;0.51;269.45;8.40;978;55;3042.00;71
7872;55;625390446;7872;257;8850;8919;8.34;0.51;269.44;8.40;978;55;3043.00;69
7876;55;625390458;7876;259;8852;8919;8.27;0.51;269.50;8.41;976;55;3044.00;67
7880;55;625390478;7880;266;8856;8923;8.14;0.50;269.56;8.41;976;55;3045.00;67
7883;55;625390491;7883;265;8859;8924;8.07;0.50;269.57;8.42;976;55;3046.00;65
7885;55;625390504;7885;264;8861;8924;8.01;0.49;269.55;8.43;976;55;3047.00;63
7889;55;625390516;7889;264;8863;8928;7.91;0.48;269.51;8.43;974;55;3048.00;65
7892;55;625390529;7892;271;8864;8928;7.90;0.48;269.51;8.43;972;55;3049.00;64
7894;55;625390542;7894;271;8865;8928;7.86;0.48;269.56;8.43;971;55;3050.00;63
7896;55;625390554;7896;273;8867;8929;7.81;0.48;269.54;8.44;971;55;3051.00;62
7901;55;625390566;7901;277;8867;8929;7.67;0.47;269.56;8.44;966;55;3052.00;62
7903;55;625390578;7903;281;8873;8935;7.53;0.46;269.60;8.44;970;55;3053.00;62
7906;55;625390590;7906;293;8873;8935;7.41;0.45;269.59;8.44;967;55;3054.00;62
7912;55;625390601;7912;299;8874;8936;7.30;0.45;269.64;8.44;962;55;3055.00;62
7919;55;625390613;7919;304;8876;8936;7.14;0.44;269.70;8.45;957;55;3056.00;60
7922;55;625390625;7922;311;8878;8936;7.01;0.43;269.75;8.46;956;55;3057.00;58
7927;55;625390635;7927;313;8879;8936;6.85;0.42;269.79;8.46;952;55;3058.00;57
7931;55;625390648;7931;322;8880;8936;6.66;0.41;269.88;8.46;949;55;3059.00;56
7934;55;625390661;7934;318;8903;8972;6.59;0.41;269.89;8.44;969;55;3060.00;69
7939;55;625390675;7939;317;8905;8972;6.49;0.40;270.00;8.44;966;55;3061.00;67
7945;55;625390686;7945;318;8909;8972;6.41;0.40;270.13;8.44;964;55;3062.00;63
7949;55;625390697;7949;320;8911;8972;6.37;0.39;270.17;8.44;962;55;3063.00;61
7954;55;625390707;7954;331;8912;8972;6.33;0.39;270.21;8.44;958;55;3064.00;60
7958;55;625390719;7958;335;8912;8972;6.35;0.39;270.23;8.44;954;55;3065.00;60
7959;55;625390729;7959;339;8917;8976;6.39;0.39;270.24;8.44;958;55;3066.00;59
7964;55;625390740;7964;333;8917;8976;6.41;0.39;270.23;8.44;953;55;3067.00;59
7967;55;625390752;7967;327;8920;8980;6.49;0.40;270.26;8.44;953;55;3068.00;60
7969;55;625390763;7969;334;8921;8981;6.51;0.40;270.23;8.44;952;55;3069.00;60
7975;55;625390774;7975;331;8922;8981;6.41;0.39;270.33;8.44;947;55;3070.00;59
7976;55;625390786;7976;326;8923;8981;6.36;0.39;270.32;8.44;947;55;3071.00;58
7978;56;625390797;7978;326;8934;8994;6.39;0.39;270.34;8.43;956;56;3072.00;60
7981;56;625390826;7981;326;8935;8994;6.36;0.39;270.37;8.43;954;56;3073.00;59
7983;56;625390838;7983;322;8935;8994;6.42;0.40;270.39;8.43;952;56;3074.00;59
7986;56;625390850;7986;318;8936;8995;6.49;0.40;270.38;8.43;950;56;3075.00;59
7990;56;625390862;7990;322;8936;8996;6.50;0.40;270.36;8.43;946;56;3076.00;60
7992;56;625390873;7992;316;8936;8996;6.53;0.40;270.33;8.43;944;56;3077.00;60
8000;56;625390884;8000;315;8938;8999;6.47;0.40;270.24;8.43;938;56;3078.00;61
8005;56;625390896;8005;314;8938;8999;6.43;0.39;270.23;8.43;933;56;3079.00;61
8009;56;625390906;8009;312;8939;8999;6.36;0.39;270.24;8.43;930;56;3080.00;60
8012;56;625390918;8012;318;8939;8999;6.30;0.39;270.25;8.43;927;56;3081.00;60
8013;56;625390929;8013;325;8943;9005;6.38;0.39;270.23;8.42;930;56;3082.00;62
8017;56;625390941;8017;331;8943;9005;6.37;0.39;270.16;8.42;926;56;3083.00;62
8019;56;625390952;8019;328;8944;9005;6.37;0.39;270.19;8.42;925;56;3084.00;61
8024;56;625390962;8024;331;8944;9005;6.30;0.39;270.21;8.42;920;56;3085.00;61
8028;56;625390980;8028;339;8947;9009;6.29;0.39;270.29;8.42;919;56;3086.00;62
8033;56;625391003;8033;340;8949;9010;6.28;0.39;270.24;8.50;916;56;3087.00;61
8041;56;625391023;8041;343;8949;9010;6.23;0.38;270.17;8.50;908;56;3088.00;61
8045;56;625391040;8045;351;8950;9011;6.20;0.38;270.19;8.50;905;56;3089.00;61
8046;56;625391058;8046;359;8950;9011;6.20;0.38;270.20;8.50;904;56;3090.00;61
8049;56;625391073;8049;356;8950;9011;6.15;0.38;270.18;8.50;901;56;3091.00;61
8053;56;625391088;8053;364;8950;9011;6.12;0.38;270.16;8.50;897;56;3092.00;61
8058;56;625391100;8058;359;8950;9011;6.11;0.37;270.12;8.50;892;56;3093.00;61
8063;56;625391112;8063;367;8950;9011;6.14;0.38;270.17;8.50;887;56;3094.00;61
8064;56;625391124;8064;375;8950;9011;6.18;0.38;270.15;8.50;886;56;3095.00;61
8067;56;625391136;8067;380;8991;9081;6.43;0.39;270.20;8.46;924;56;3096.00;90
8068;56;625391155;8068;377;8993;9082;6.44;0.39;270.18;8.46;925;56;3097.00;89
8073;56;625391167;8073;372;8999;9082;6.49;0.40;270.20;8.45;926;56;3098.00;83
8074;56;625391180;8074;378;9002;9082;6.56;0.40;270.21;8.45;928;56;3099.00;80
8077;56;625391194;8077;379;9006;9082;6.63;0.40;270.18;8.45;929;56;3100.00;76
8081;56;625391211;8081;377;9007;9082;6.60;0.40;270.15;8.45;926;56;3101.00;75
8083;56;625391223;8083;385;9012;9082;6.62;0.40;270.12;8.45;929;56;3102.00;70
8085;56;625391234;8085;388;9012;9082;6.52;0.40;270.12;8.45;927;56;3103.00;70
8087;56;625391254;8087;394;9016;9083;6.49;0.40;270.09;8.44;929;56;3104.00;67
8087;56;625391266;8087;398;9018;9085;6.46;0.40;270.09;8.44;931;56;3105.00;67
8091;56;625391278;8091;409;9019;9085;6.38;0.39;270.07;8.44;928;56;3106.00;66
8094;56;625391290;8094;393;9022;9089;6.34;0.39;270.08;8.44;928;56;3107.00;67
8096;56;625391303;8096;375;9022;9089;6.36;0.39;270.10;8.44;926;56;3108.00;67
8097;56;625391316;8097;363;9022;9089;6.40;0.39;270.13;8.44;925;56;3109.00;67
8098;56;625391334;8098;352;9022;9089;6.46;0.40;270.11;8.44;924;56;3110.00;67
8103;56;625391347;8103;349;9026;9095;6.54;0.40;270.22;8.44;923;56;3111.00;69
8104;56;625391361;8104;342;9026;9095;6.63;0.41;270.31;8.44;922;56;3112.00;69
8104;56;625391374;8104;331;9027;9095;6.76;0.42;270.31;8.44;923;56;3113.00;68
8107;56;625391386;8107;334;9029;9098;6.89;0.42;270.30;8.43;922;56;3114.00;69
8108;56;625391400;8108;326;9030;9098;7.06;0.43;270.29;8.43;922;56;3115.00;68
8111;56;625391413;8111;308;9030;9098;7.19;0.44;270.28;8.43;919;56;3116.00;68
8111;56;625391433;8111;295;9030;9099;7.32;0.45;270.28;8.43;919;56;3117.00;69
8116;56;625391455;8116;279;9031;9100;7.43;0.45;270.25;8.43;915;56;3118.00;69
8117;56;625391475;8117;263;9031;9100;7.54;0.46;270.24;8.43;914;56;3119.00;69
8120;56;625391489;8120;259;9051;9126;7.70;0.47;270.19;8.41;931;56;3120.00;75
8120;56;625391514;8120;254;9052;9126;7.78;0.48;270.19;8.41;932;56;3121.00;74
8122;56;625391527;8122;240;9053;9126;7.87;0.48;270.15;8.41;931;56;3122.00;73
8124;56;625391540;8124;239;9054;9127;8.01;0.49;270.14;8.41;930;56;3123.00;73
8125;56;625391554;8125;241;9054;9127;8.15;0.50;270.14;8.41;929;56;3124.00;73
8126;56;625391567;8126;246;9057;9131;8.27;0.51;270.12;8.41;931;56;3125.00;74
8128;56;625391581;8128;241;9057;9131;8.35;0.51;270.14;8.41;929;56;3126.00;74
8130;56;625391595;8130;234;9061;9135;8.40;0.51;270.14;8.41;931;56;3127.00;74
8134;56;625391609;8134;229;9061;9135;8.40;0.51;270.14;8.41;927;56;3128.00;74
8139;56;625391622;8139;227;9061;9135;8.42;0.51;270.08;8.41;922;56;3129.00;74
8143;56;625391636;8143;229;9061;9135;8.40;0.51;270.08;8.41;918;56;3130.00;74
8145;56;625391650;8145;223;9061;9135;8.43;0.51;270.11;8.41;916;56;3131.00;74
8146;56;625391663;8146;226;9071;9147;8.47;0.52;270.15;8.40;925;56;3132.00;76
8149;56;625391677;8149;226;9071;9147;8.51;0.52;270.14;8.40;922;56;3133.00;76
8153;56;625391690;8153;228;9072;9147;8.51;0.52;270.10;8.40;919;56;3134.00;75
8155;56;625391703;8155;230;9072;9147;8.48;0.52;270.12;8.40;917;56;3135.00;75
8158;56;625391717;8158;233;9072;9147;8.51;0.52;270.24;8.40;914;56;3136.00;75
8161;56;625391730;8161;238;9072;9147;8.59;0.52;270.33;8.40;911;56;3137.00;75
8164;56;625391743;8164;237;9072;9148;8.65;0.53;270.31;8.40;908;56;3138.00;76
8167;56;625391755;8167;242;9072;9148;8.64;0.53;270.33;8.40;905;56;3139.00;76
8172;56;625391769;8172;242;9077;9154;8.63;0.53;270.39;8.47;905;56;3140.00;77
8174;56;625391782;8174;249;9078;9155;8.63;0.53;270.42;8.47;904;56;3141.00;77
8178;56;625391795;8178;250;9079;9155;8.55;0.52;270.44;8.47;901;56;3142.00;76
8180;56;625391808;8180;246;9079;9155;8.46;0.52;270.47;8.47;899;56;3143.00;76
8182;56;625391820;8182;252;9082;9159;8.42;0.51;270.44;8.47;900;56;3144.00;77
8188;56;625391833;8188;252;9082;9159;8.31;0.51;270.52;8.47;894;56;3145.00;77
8192;56;625391846;8192;256;9082;9159;8.24;0.50;270.57;8.47;890;56;3146.00;77
8193;56;625391859;8193;268;9083;9160;8.18;0.50;270.57;8.47;890;56;3147.00;77
8196;56;625391871;8196;275;9086;9164;8.05;0.49;270.54;8.47;890;56;3148.00;78
8200;56;625391883;8200;277;9086;9164;7.95;0.48;270.57;8.47;886;56;3149.00;78
8200;56;625391897;8200;277;9089;9170;7.92;0.48;270.57;8.46;889;56;3150.00;81
8203;56;625391909;8203;271;9089;9170;7.88;0.48;270.58;8.46;886;56;3151.00;81
8205;56;625391921;8205;273;9090;9170;7.91;0.48;270.58;8.46;885;56;3152.00;80
8206;56;625391933;8206;270;9090;9170;7.91;0.48;270.61;8.46;884;56;3153.00;80
8209;56;625391945;8209;265;9093;9174;7.88;0.48;270.64;8.46;884;56;3154.00;81
8215;56;625391959;8215;259;9093;9174;7.80;0.47;270.71;8.46;878;56;3155.00;81
8217;56;625391975;8217;259;9094;9174;7.82;0.47;270.78;8.46;877;56;3156.00;80
8221;56;625391986;8221;262;9094;9174;7.82;0.47;270.81;8.46;873;56;3157.00;80
8223;56;625392005;8223;257;9095;9175;7.86;0.48;270.83;8.46;872;56;3158.00;80
8227;56;625392017;8227;257;9096;9176;7.87;0.48;270.90;8.46;869;56;3159.00;80
8227;56;625392028;8227;250;9097;9176;7.88;0.48;270.90;8.46;870;56;3160.00;79
8230;56;625392039;8230;240;9098;9177;7.87;0.48;270.86;8.46;868;56;3161.00;79
8232;56;625392050;8232;229;9098;9177;7.85;0.48;270.89;8.46;866;56;3162.00;79
8236;56;625392061;8236;221;9098;9177;7.80;0.47;270.92;8.46;862;56;3163.00;79
8237;56;625392072;8237;212;9099;9177;7.85;0.48;270.90;8.47;862;56;3164.00;78
8244;56;625392085;8244;211;9099;9177;7.83;0.48;270.92;8.47;855;56;3165.00;78
8245;56;625392097;8245;202;9100;9177;7.88;0.48;270.90;8.49;855;56;3166.00;77
8250;56;625392108;8250;194;9100;9177;7.89;0.48;270.92;8.49;850;56;3167.00;77
8253;56;625392119;8253;207;9167;9304;7.91;0.49;270.96;8.42;914;56;3168.00;137
8258;56;625392140;8258;194;9168;9305;8.00;0.49;270.99;8.42;910;56;3169.00;137
8261;56;625392152;8261;185;9175;9305;8.13;0.50;271.04;8.42;914;56;3170.00;130
8269;56;625392164;8269;181;9177;9305;8.22;0.50;270.97;8.42;908;56;3171.00;128
8272;56;625392177;8272;174;9180;9305;8.35;0.51;270.96;8.42;908;56;3172.00;125
8275;56;625392189;8275;182;9184;9305;8.54;0.52;271.04;8.41;909;56;3173.00;121
8280;56;625392201;8280;170;9189;9305;8.70;0.53;271.08;8.41;909;56;3174.00;116
8283;57;625392213;8283;165;9192;9305;8.80;0.54;271.15;8.41;909;57;3175.00;113
8287;57;625392232;8287;165;9196;9306;8.96;0.55;271.08;8.41;909;57;3176.00;110
8290;57;625392249;8290;165;9201;9307;9.07;0.55;271.08;8.43;911;57;3177.00;106
8296;57;625392262;8296;166;9205;9307;9.13;0.55;271.17;8.43;909;57;3178.00;102
8299;57;625392274;8299;171;9209;9308;9.12;0.55;271.23;8.43;910;57;3179.00;99
8301;57;625392288;8301;173;9211;9308;9.08;0.55;271.27;8.43;910;57;3180.00;97
8304;57;625392300;8304;179;9212;9308;9.03;0.55;271.30;8.43;908;57;3181.00;96
8306;57;625392313;8306;182;9215;9308;8.99;0.55;271.39;8.43;909;57;3182.00;93
8307;57;625392331;8307;179;9218;9312;9.04;0.55;271.46;8.43;911;57;3183.00;94
8310;57;625392344;8310;185;9219;9312;9.01;0.55;271.50;8.43;909;57;3184.00;93
8312;57;625392355;8312;189;9221;9312;8.97;0.55;271.54;8.43;909;57;3185.00;91
8313;57;625392374;8313;192;9225;9315;9.01;0.55;271.51;8.45;912;57;3186.00;90
8316;57;625392387;8316;205;9226;9315;9.02;0.55;271.52;8.45;910;57;3187.00;89
8317;57;625392400;8317;206;9227;9315;9.07;0.55;271.52;8.45;910;57;3188.00;88
8319;57;625392413;8319;209;9232;9319;9.09;0.55;271.55;8.45;913;57;3189.00;87
8321;57;625392428;8321;213;9233;9320;9.14;0.56;271.58;8.45;912;57;3190.00;87
8324;57;625392441;8324;221;9236;9322;9.11;0.55;271.64;8.47;912;57;3191.00;86
8330;57;625392454;8330;219;9241;9326;9.12;0.56;271.71;8.47;911;57;3192.00;85
8334;57;625392468;8334;223;9242;9326;9.14;0.56;271.77;8.49;908;57;3193.00;84
8339;57;625392482;8339;223;9242;9326;9.17;0.56;271.78;8.49;903;57;3194.00;84
8344;57;625392495;8344;227;9245;9328;9.14;0.56;271.77;8.50;901;57;3195.00;83
8344;57;625392509;8344;230;9245;9328;9.13;0.56;271.77;8.50;901;57;3196.00;83
8348;57;625392521;8348;228;9251;9334;9.11;0.55;271.96;8.51;903;57;3197.00;83
8350;58;625392535;8350;229;9252;9334;9.00;0.55;272.01;8.51;902;58;3198.00;82
8351;58;625392553;8351;228;9254;9335;8.89;0.54;272.00;8.53;903;58;3199.00;81
8354;58;625392575;8354;231;9254;9335;8.77;0.54;272.07;8.53;900;58;3200.00;81
8357;58;625392591;8357;237;9256;9335;8.71;0.53;272.14;8.55;899;58;3201.00;79
8358;58;625392604;8358;242;9257;9335;8.62;0.53;272.13;8.56;899;58;3202.00;78
8363;58;625392616;8363;248;9258;9335;8.56;0.52;272.18;8.57;895;58;3203.00;77
8366;58;625392628;8366;260;9269;9347;8.53;0.52;272.21;8.57;903;58;3204.00;78
8368;58;625392641;8368;264;9270;9347;8.54;0.52;272.19;8.57;902;58;3205.00;77
8372;58;625392652;8372;263;9271;9347;8.47;0.52;272.23;8.57;899;58;3206.00;76
8372;58;625392664;8372;269;9273;9347;8.43;0.52;272.23;8.59;901;58;3207.00;74
8374;58;625392675;8374;272;9273;9347;8.34;0.51;272.29;8.59;899;58;3208.00;74
8376;58;625392687;8376;267;9275;9347;8.28;0.51;272.29;8.60;899;58;3209.00;72
8378;58;625392699;8378;263;9278;9351;8.17;0.50;272.33;8.59;900;58;3210.00;73
8379;58;625392710;8379;265;9279;9351;8.12;0.50;272.36;8.61;900;58;3211.00;72
8380;58;625392721;8380;273;9282;9355;8.09;0.50;272.38;8.60;902;58;3212.00;73
8381;58;625392732;8381;279;9283;9356;8.11;0.50;272.41;8.60;902;58;3213.00;73
8385;58;625392743;8385;279;9287;9356;8.07;0.50;272.50;8.63;902;58;3214.00;69
8385;58;625392760;8385;277;9287;9356;8.10;0.50;272.50;8.63;902;58;3215.00;69
8390;58;625392776;8390;288;9299;9369;7.99;0.49;272.48;8.63;909;58;3216.00;70
8393;58;625392788;8393;281;9299;9369;7.98;0.49;272.44;8.63;906;58;3217.00;70
8396;58;625392799;8396;284;9300;9369;7.95;0.49;272.49;8.63;904;58;3218.00;69
8399;58;625392810;8399;293;9302;9370;7.91;0.48;272.52;8.63;903;58;3219.00;68
8401;58;625392821;8401;288;9302;9371;7.79;0.48;272.51;8.63;901;58;3220.00;69
8404;58;625392832;8404;296;9303;9371;7.73;0.47;272.49;8.64;899;58;3221.00;68
8408;58;625392843;8408;297;9306;9374;7.70;0.47;272.56;8.65;898;58;3222.00;68
8412;58;625392853;8412;301;9306;9374;7.67;0.47;272.55;8.65;894;58;3223.00;68
8419;58;625392863;8419;305;9310;9374;7.60;0.46;272.68;8.66;891;58;3224.00;64
8422;58;625392873;8422;313;9310;9374;7.60;0.46;272.68;8.66;888;58;3225.00;64
8427;58;625392885;8427;310;9316;9380;7.56;0.46;272.67;8.66;889;58;3226.00;64
8429;58;625392896;8429;314;9316;9380;7.43;0.45;272.62;8.66;887;58;3227.00;64
8432;58;625392906;8432;319;9317;9380;7.22;0.44;272.66;8.66;885;58;3228.00;63
8436;58;625392915;8436;320;9318;9380;6.97;0.42;272.65;8.67;882;58;3229.00;62
8438;58;625392925;8438;312;9321;9384;6.81;0.41;272.63;8.66;883;58;3230.00;63
8440;58;625392936;8440;314;9325;9385;6.72;0.41;272.65;8.68;885;58;3231.00;60
8444;58;625392946;8444;320;9325;9385;6.61;0.40;272.69;8.68;881;58;3232.00;60
8447;58;625392956;8447;320;9327;9386;6.55;0.40;272.67;8.68;880;58;3233.00;59
8449;58;625392967;8449;324;9327;9386;6.54;0.40;272.67;8.68;878;58;3234.00;59
8452;58;625392984;8452;329;9327;9386;6.51;0.40;272.66;8.68;875;58;3235.00;59
8454;58;625393001;8454;328;9330;9386;6.40;0.39;272.67;8.69;876;58;3236.00;56
8455;58;625393016;8455;325;9330;9386;6.36;0.39;272.65;8.69;875;58;3237.00;56
8462;58;625393032;8462;321;9330;9386;6.30;0.38;272.57;8.69;868;58;3238.00;56
8464;58;625393047;8464;322;9331;9386;6.32;0.39;272.57;8.69;867;58;3239.00;55
8467;58;625393063;8467;325;9384;9511;6.61;0.41;272.55;8.64;917;58;3240.00;127
8471;58;625393090;8471;332;9386;9512;6.55;0.41;272.51;8.64;915;58;3241.00;126
8473;58;625393103;8473;338;9399;9512;6.61;0.41;272.52;8.63;926;58;3242.00;113
8475;58;625393113;8475;340;9404;9512;6.59;0.41;272.49;8.63;929;58;3243.00;108
8480;58;625393125;8480;345;9412;9512;6.54;0.40;272.49;8.62;932;58;3244.00;100
8482;58;625393137;8482;348;9415;9512;6.54;0.40;272.52;8.62;933;58;3245.00;97
8486;58;625393149;8486;347;9422;9512;6.55;0.40;272.57;8.62;936;58;3246.00;90
8489;58;625393160;8489;351;9423;9512;6.55;0.40;272.55;8.62;934;58;3247.00;89
8492;58;625393171;8492;352;9425;9513;6.50;0.40;272.53;8.62;933;58;3248.00;88
8494;58;625393184;8494;355;9431;9514;6.50;0.40;272.50;8.71;937;58;3249.00;83
8496;58;625393197;8496;354;9432;9514;6.48;0.40;272.50;8.71;936;58;3250.00;82
8500;58;625393208;8500;356;9437;9518;6.52;0.40;272.54;8.71;937;58;3251.00;81
8501;58;625393220;8501;359;9439;9518;6.53;0.40;272.52;8.71;938;58;3252.00;79
8506;58;625393232;8506;363;9441;9518;6.54;0.40;272.53;8.71;935;58;3253.00;77
8509;58;625393243;8509;365;9441;9518;6.48;0.40;272.56;8.71;932;58;3254.00;77
8510;58;625393257;8510;367;9445;9524;6.47;0.40;272.55;8.70;935;58;3255.00;79
8514;58;625393269;8514;369;9447;9524;6.45;0.40;272.56;8.70;933;58;3256.00;77
8518;58;625393281;8518;368;9447;9524;6.38;0.39;272.55;8.70;929;58;3257.00;77
8521;58;625393292;8521;374;9450;9527;6.35;0.39;272.57;8.70;929;58;3258.00;77
8525;58;625393303;8525;366;9450;9527;6.35;0.39;272.55;8.70;925;58;3259.00;77
8526;58;625393316;8526;361;9450;9527;6.33;0.39;272.57;8.70;924;58;3260.00;77
8530;58;625393328;8530;355;9450;9528;6.30;0.39;272.62;8.70;920;58;3261.00;78
8534;58;625393340;8534;350;9451;9529;6.29;0.39;272.63;8.70;917;58;3262.00;78
8536;58;625393352;8536;343;9451;9529;6.33;0.39;272.65;8.70;915;58;3263.00;78
8542;58;625393364;8542;342;9462;9542;6.46;0.40;272.64;8.69;920;58;3264.00;80
8546;58;625393377;8546;342;9462;9542;6.45;0.40;272.66;8.69;916;58;3265.00;80
8549;58;625393403;8549;339;9462;9542;6.49;0.40;272.60;8.69;913;58;3266.00;80
8554;58;625393414;8554;339;9463;9543;6.50;0.40;272.59;8.69;909;58;3267.00;80
8556;58;625393429;8556;340;9463;9543;6.56;0.40;272.62;8.69;907;58;3268.00;80
8561;58;625393441;8561;341;9467;9547;6.60;0.40;272.73;8.77;906;58;3269.00;80
8565;58;625393456;8565;338;9467;9547;6.59;0.40;272.75;8.77;902;58;3270.00;80
8567;58;625393469;8567;339;9471;9551;6.64;0.41;272.76;8.77;904;58;3271.00;80
8570;58;625393480;8570;338;9471;9551;6.65;0.41;272.72;8.77;901;58;3272.00;80
8571;58;625393492;8571;347;9471;9551;6.68;0.41;272.71;8.77;900;58;3273.00;80
8575;58;625393505;8575;351;9471;9551;6.67;0.41;272.64;8.77;896;58;3274.00;80
8576;58;625393517;8576;359;9471;9551;6.67;0.41;272.64;8.77;895;58;3275.00;80
8578;58;625393528;8578;372;9481;9563;6.76;0.41;272.61;8.76;903;58;3276.00;82
8578;58;625393543;8578;360;9482;9563;6.74;0.41;272.61;8.85;904;58;3277.00;81
8579;58;625393556;8579;355;9483;9563;6.77;0.41;272.60;8.85;904;58;3278.00;80
8579;58;625393568;8579;356;9483;9563;6.83;0.42;272.60;8.85;904;58;3279.00;80
8581;58;625393580;8581;355;9483;9563;6.87;0.42;272.64;8.85;902;58;3280.00;80
8583;58;625393593;8583;350;9483;9563;6.94;0.42;272.65;8.85;900;58;3281.00;80
8586;58;625393605;8586;351;9483;9564;7.00;0.43;272.68;8.85;897;58;3282.00;81
8587;58;625393619;8587;353;9484;9564;7.07;0.43;272.67;8.93;897;58;3283.00;80
8590;58;625393631;8590;359;9488;9570;7.11;0.43;272.66;8.92;898;58;3284.00;82
8590;58;625393644;8590;358;9490;9572;7.17;0.44;272.66;8.92;900;58;3285.00;82
8593;58;625393656;8593;349;9491;9572;7.24;0.44;272.64;8.92;898;58;3286.00;81
8596;58;625393669;8596;333;9491;9572;7.31;0.44;272.71;8.92;895;58;3287.00;81
8597;58;625393682;8597;329;9494;9576;7.43;0.45;272.74;8.92;897;58;3288.00;82
8600;58;625393695;8600;320;9494;9576;7.49;0.45;272.73;8.92;894;58;3289.00;82
8601;58;625393709;8601;312;9494;9576;7.61;0.46;272.73;8.92;893;58;3290.00;82
8603;58;625393721;8603;308;9495;9577;7.67;0.47;272.79;8.92;892;58;3291.00;82
8605;59;625393734;8605;299;9498;9581;7.68;0.47;272.82;8.91;893;59;3292.00;83
8606;59;625393767;8606;301;9498;9581;7.73;0.47;272.86;8.91;892;59;3293.00;83
8607;59;625393780;8607;302;9500;9584;7.76;0.47;272.85;8.91;893;59;3294.00;84
8611;59;625393794;8611;294;9500;9584;7.82;0.47;272.87;8.91;889;59;3295.00;84
8615;59;625393806;8615;301;9501;9584;7.86;0.48;272.95;8.91;886;59;3296.00;83
8617;59;625393819;8617;297;9501;9584;7.95;0.48;273.00;8.91;884;59;3297.00;83
8619;59;625393834;8619;295;9504;9588;8.01;0.49;273.01;8.91;885;59;3298.00;84
8623;59;625393848;8623;297;9504;9588;8.02;0.49;273.08;8.91;881;59;3299.00;84
8625;59;625393863;8625;293;9508;9607;8.02;0.49;273.07;8.91;883;59;3300.00;99
8627;59;625393882;8627;296;9508;9607;8.07;0.49;273.10;8.91;881;59;3301.00;99
8628;60;625393895;8628;294;9509;9608;8.06;0.49;273.09;8.90;881;60;3302.00;99
8633;60;625393925;8633;294;9510;9609;8.02;0.49;273.12;8.90;877;60;3303.00;99
8635;60;625393939;8635;295;9510;9609;8.02;0.49;273.12;8.90;875;60;3304.00;99
8637;60;625393950;8637;295;9511;9610;8.04;0.49;273.14;8.90;874;60;3305.00;99
8639;60;625393963;8639;299;9512;9610;7.99;0.49;273.14;8.90;873;60;3306.00;98
8642;60;625393981;8642;296;9512;9610;7.98;0.49;273.18;8.90;870;60;3307.00;98
8647;60;625393994;8647;298;9513;9610;7.93;0.48;273.21;8.90;866;60;3308.00;97
8648;60;625394007;8648;299;9513;9610;7.93;0.48;273.25;8.90;865;60;3309.00;97
8652;60;625394019;8652;294;9513;9610;7.89;0.48;273.27;8.90;861;60;3310.00;97
8655;60;625394031;8655;295;9514;9610;7.88;0.48;273.33;8.90;859;60;3311.00;96
8658;60;625394042;8658;318;9582;9737;7.89;0.49;273.35;8.84;924;60;3312.00;155
8660;60;625394063;8660;311;9587;9738;7.82;0.48;273.39;8.84;927;60;3313.00;151
8662;60;625394076;8662;298;9591;9738;7.85;0.48;273.40;8.83;929;60;3314.00;147
8667;60;625394087;8667;303;9593;9738;7.89;0.49;273.42;8.83;926;60;3315.00;145
8670;60;625394099;8670;304;9596;9738;7.89;0.49;273.51;8.83;926;60;3316.00;142
8672;60;625394111;8672;308;9598;9738;7.91;0.49;273.50;8.83;926;60;3317.00;140
8676;60;625394122;8676;307;9601;9738;7.95;0.49;273.52;8.83;925;60;3318.00;137
8677;60;625394134;8677;311;9605;9738;8.02;0.49;273.54;8.83;928;60;3319.00;133
8678;60;625394146;8678;304;9608;9739;8.12;0.50;273.52;8.83;930;60;3320.00;131
8679;60;625394158;8679;303;9610;9740;8.14;0.50;273.55;8.83;931;60;3321.00;130
8684;60;625394170;8684;297;9613;9740;8.17;0.50;273.59;8.83;929;60;3322.00;127
8685;60;625394183;8685;301;9614;9741;8.14;0.50;273.61;8.83;929;60;3323.00;127
8689;60;625394195;8689;301;9617;9741;8.13;0.50;273.66;8.83;928;60;3324.00;124
8694;60;625394207;8694;296;9619;9741;8.08;0.49;273.63;8.84;925;60;3325.00;122
8700;60;625394219;8700;298;9621;9741;8.04;0.49;273.67;8.84;921;60;3326.00;120
8702;60;625394231;8702;296;9624;9745;8.03;0.49;273.68;8.84;922;60;3327.00;121
8702;60;625394246;8702;293;9626;9745;8.02;0.49;273.68;8.84;924;60;3328.00;119
8706;60;625394258;8706;292;9627;9745;7.98;0.49;273.68;8.84;921;60;3329.00;118
8708;60;625394272;8708;291;9631;9751;7.92;0.48;273.66;8.84;923;60;3330.00;120
8710;60;625394284;8710;282;9631;9751;7.90;0.48;273.65;8.84;921;60;3331.00;120
8715;60;625394296;8715;270;9631;9751;7.84;0.48;273.73;8.84;916;60;3332.00;120
8716;60;625394307;8716;270;9636;9755;7.79;0.47;273.72;8.84;920;60;3333.00;119
8718;60;625394319;8718;266;9640;9756;7.80;0.47;273.74;8.93;922;60;3334.00;116
8721;60;625394336;8721;261;9643;9756;7.78;0.47;273.77;8.95;922;60;3335.00;113
8725;60;625394350;8725;254;9645;9760;7.82;0.47;273.71;8.95;920;60;3336.00;115
8727;60;625394363;8727;250;9645;9760;7.81;0.47;273.70;8.95;918;60;3337.00;115
8731;60;625394374;8731;250;9646;9760;7.77;0.47;273.72;8.95;915;60;3338.00;114
8736;60;625394386;8736;249;9650;9761;7.76;0.47;273.76;9.12;914;60;3339.00;111
8738;60;625394397;8738;243;9652;9761;7.79;0.47;273.78;9.12;914;60;3340.00;109
8741;60;625394410;8741;243;9656;9767;7.79;0.47;273.81;9.21;915;60;3341.00;111
8746;60;625394423;8746;241;9657;9767;7.80;0.47;273.82;9.21;911;60;3342.00;110
8747;60;625394436;8747;243;9659;9768;7.83;0.47;273.81;9.30;912;60;3343.00;109
8751;60;625394448;8751;239;9660;9768;7.82;0.47;273.86;9.30;909;60;3344.00;108
8753;60;625394460;8753;240;9660;9768;7.90;0.48;273.85;9.30;907;60;3345.00;108
8755;60;625394472;8755;237;9660;9768;7.96;0.48;273.81;9.30;905;60;3346.00;108
8760;60;625394485;8760;236;9661;9768;8.01;0.48;273.84;9.30;901;60;3347.00;107
8760;60;625394496;8760;240;9672;9780;8.04;0.49;273.84;9.37;912;60;3348.00;108
8762;60;625394509;8762;243;9676;9780;7.99;0.48;273.83;9.38;914;60;3349.00;104
8764;60;625394521;8764;240;9676;9780;8.02;0.49;273.86;9.38;912;60;3350.00;104
8768;60;625394533;8768;246;9680;9780;8.02;0.49;273.84;9.39;912;60;3351.00;100
8770;60;625394545;8770;248;9681;9780;8.02;0.49;273.82;9.39;911;60;3352.00;99
8772;60;625394557;8772;250;9683;9780;8.03;0.49;273.83;9.48;911;60;3353.00;97
8774;60;625394569;8774;257;9688;9784;8.04;0.49;273.89;9.48;914;60;3354.00;96
8775;60;625394582;8775;248;9688;9784;8.10;0.49;273.89;9.48;913;60;3355.00;96
8778;60;625394594;8778;246;9691;9788;8.20;0.50;273.91;9.48;913;60;3356.00;97
8780;60;625394606;8780;251;9693;9789;8.21;0.50;273.90;9.48;913;60;3357.00;96
8783;60;625394618;8783;257;9694;9789;8.25;0.50;273.90;9.47;911;60;3358.00;95
8785;60;625394631;8785;256;9695;9789;8.25;0.50;273.91;9.47;910;60;3359.00;94
8786;60;625394645;8786;268;9714;9818;8.21;0.50;273.89;9.48;928;60;3360.00;104
8789;60;625394659;8789;273;9717;9818;8.15;0.49;273.96;9.48;928;60;3361.00;101
8791;60;625394671;8791;274;9720;9818;8.10;0.49;273.99;9.49;929;60;3362.00;98
8793;60;625394682;8793;287;9723;9819;8.09;0.49;274.04;9.49;930;60;3363.00;96
8795;60;625394695;8795;287;9725;9820;8.02;0.49;274.08;9.50;930;60;3364.00;95
8797;60;625394713;8797;290;9726;9820;7.95;0.48;274.11;9.51;929;60;3365.00;94
8800;60;625394725;8800;302;9730;9823;7.92;0.48;274.18;9.52;930;60;3366.00;93
8804;60;625394737;8804;307;9732;9823;7.87;0.48;274.28;9.54;928;60;3367.00;91
8804;60;625394749;8804;320;9732;9823;7.86;0.48;274.28;9.54;928;60;3368.00;91
8806;60;625394761;8806;321;9734;9823;7.85;0.48;274.29;9.56;928;60;3369.00;89
8811;60;625394772;8811;328;9738;9829;7.84;0.48;274.38;9.56;927;60;3370.00;91
8814;60;625394785;8814;327;9739;9829;7.73;0.47;274.37;9.56;925;60;3371.00;90
8815;60;625394796;8815;330;9741;9829;7.60;0.47;274.38;9.58;926;60;3372.00;88
8818;60;625394807;8818;330;9741;9829;7.48;0.46;274.39;9.58;923;60;3373.00;88
8821;60;625394819;8821;333;9745;9833;7.33;0.45;274.37;9.59;924;60;3374.00;88
8822;60;625394831;8822;335;9750;9835;7.26;0.45;274.35;9.61;928;60;3375.00;85
8824;60;625394842;8824;338;9750;9835;7.20;0.44;274.34;9.61;926;60;3376.00;85
8828;60;625394853;8828;342;9751;9836;7.16;0.44;274.31;9.61;923;60;3377.00;85
8828;60;625394864;8828;348;9753;9836;7.10;0.44;274.31;9.63;925;60;3378.00;83
8830;60;625394875;8830;348;9753;9836;7.02;0.43;274.29;9.63;923;60;3379.00;83
8831;60;625394886;8831;347;9754;9836;7.00;0.43;274.27;9.64;923;60;3380.00;82
8832;60;625394897;8832;345;9754;9836;6.99;0.43;274.25;9.64;922;60;3381.00;82
8837;60;625394908;8837;343;9754;9836;6.89;0.42;274.14;9.64;917;60;3382.00;82
8837;60;625394919;8837;346;9754;9836;6.83;0.42;274.14;9.64;917;60;3383.00;82
8839;60;625394930;8839;352;9788;9906;6.94;0.43;274.09;9.62;949;60;3384.00;118
8843;60;625394946;8843;346;9789;9907;6.87;0.42;274.10;9.63;946;60;3385.00;118
8845;60;625394958;8845;349;9802;9907;6.92;0.43;274.06;9.63;957;60;3386.00;105
8847;60;625394969;8847;350;9809;9907;6.92;0.42;274.01;9.62;962;60;3387.00;98
8848;60;625394985;8848;353;9815;9907;6.90;0.42;274.02;9.62;967;60;3388.00;92
8850;60;625395004;8850;362;9820;9907;6.87;0.42;273.98;9.61;970;60;3389.00;87
8850;60;625395024;8850;368;9829;9907;6.72;0.41;273.98;9.66;979;60;3390.00;78
8851;60;625395039;8851;373;9830;9907;6.65;0.41;273.97;9.66;979;60;3391.00;77
8856;60;625395056;8856;379;9835;9908;6.52;0.40;274.05;9.66;979;60;3392.00;73
8861;60;625395073;8861;390;9836;9909;6.40;0.39;273.98;9.66;975;60;3393.00;73
8868;60;625395089;8868;388;9836;9909;6.27;0.38;273.92;9.66;968;60;3394.00;73
8872;60;625395101;8872;391;9840;9913;6.16;0.38;273.91;9.67;968;60;3395.00;73
8875;60;625395114;8875;398;9840;9913;6.04;0.37;273.90;9.67;965;60;3396.00;73
8879;60;625395125;8879;403;9841;9913;5.93;0.36;273.86;9.67;962;60;3397.00;72
8882;60;625395137;8882;411;9841;9913;5.79;0.35;273.83;9.67;959;60;3398.00;72
8882;60;625395151;8882;414;9848;9919;5.68;0.35;273.83;9.67;966;60;3399.00;71
8885;60;625395165;8885;404;9848;9919;5.60;0.34;273.84;9.67;963;60;3400.00;71
8888;60;625395180;8888;402;9848;9919;5.50;0.34;273.86;9.67;960;60;3401.00;71
8890;60;625395194;8890;400;9852;9922;5.49;0.34;273.86;9.68;962;60;3402.00;70
8892;60;625395207;8892;406;9852;9922;5.42;0.33;273.89;9.68;960;60;3403.00;70
8894;60;625395217;8894;415;9852;9922;5.39;0.33;273.90;9.68;958;60;3404.00;70
8897;60;625395228;8897;419;9854;9923;5.36;0.33;273.82;9.69;957;60;3405.00;69
8900;60;625395239;8900;427;9855;9924;5.39;0.33;273.83;9.69;955;60;3406.00;69
8901;60;625395250;8901;426;9855;9924;5.43;0.33;273.84;9.69;954;60;3407.00;69
8905;60;625395261;8905;421;9866;9937;5.51;0.34;273.80;9.68;961;60;3408.00;71
8908;60;625395274;8908;426;9866;9937;5.56;0.34;273.81;9.68;958;60;3409.00;71
8908;60;625395285;8908;420;9866;9937;5.63;0.34;273.81;9.68;958;60;3410.00;71
8909;60;625395296;8909;401;9867;9938;5.74;0.35;273.82;9.67;958;60;3411.00;71
8912;60;625395307;8912;379;9867;9938;5.83;0.36;273.84;9.67;955;60;3412.00;71
8916;60;625395319;8916;370;9870;9942;5.92;0.36;273.79;9.67;954;60;3413.00;72
8917;60;625395331;8917;367;9870;9942;6.03;0.37;273.82;9.67;953;60;3414.00;72
8920;60;625395344;8920;361;9874;9946;6.13;0.37;273.83;9.67;954;60;3415.00;72
8925;60;625395356;8925;352;9874;9946;6.20;0.38;273.89;9.67;949;60;3416.00;72
8928;60;625395368;8928;350;9874;9946;6.24;0.38;273.86;9.67;946;60;3417.00;72
8930;60;625395380;8930;338;9874;9946;6.30;0.38;273.80;9.67;944;60;3418.00;72
8932;60;625395392;8932;329;9874;9946;6.35;0.39;273.81;9.67;942;60;3419.00;72
8935;60;625395411;8935;327;9899;9980;6.54;0.40;273.83;9.64;964;60;3420.00;81
8935;60;625395426;8935;331;9899;9980;6.58;0.40;273.83;9.64;964;60;3421.00;81
8939;60;625395439;8939;321;9900;9980;6.60;0.40;273.86;9.64;961;60;3422.00;80
8942;60;625395450;8942;315;9900;9980;6.62;0.41;273.86;9.64;958;60;3423.00;80
8944;60;625395463;8944;313;9901;9980;6.72;0.41;273.84;9.64;957;60;3424.00;79
8946;60;625395477;8946;308;9901;9980;6.80;0.42;273.81;9.64;955;60;3425.00;79
8948;60;625395490;8948;306;9902;9981;6.92;0.42;273.80;9.64;954;60;3426.00;79
8953;60;625395503;8953;313;9903;9981;6.92;0.42;273.84;9.73;950;60;3427.00;78
8955;60;625395518;8955;315;9907;9987;7.00;0.43;273.87;9.73;952;60;3428.00;80
8957;60;625395531;8957;317;9908;9988;7.09;0.43;273.91;9.73;951;60;3429.00;80
8961;60;625395544;8961;316;9909;9988;7.14;0.44;273.93;9.73;948;60;3430.00;79
8965;60;625395556;8965;313;9909;9988;7.18;0.44;273.93;9.73;944;60;3431.00;79
8968;60;625395570;8968;317;9913;9992;7.23;0.44;273.97;9.73;945;60;3432.00;79
8975;60;625395583;8975;316;9913;9992;7.23;0.44;274.07;9.73;938;60;3433.00;79
8980;60;625395596;8980;314;9913;9992;7.21;0.44;274.03;9.73;933;60;3434.00;79
8983;60;625395611;8983;316;9914;9993;7.22;0.44;274.03;9.72;931;60;3435.00;79
8985;60;625395624;8985;311;9917;9997;7.25;0.44;274.04;9.72;932;60;3436.00;80
8989;60;625395636;8989;318;9917;9997;7.25;0.44;274.12;9.72;928;60;3437.00;80
8991;60;625395649;8991;320;9919;10000;7.34;0.45;274.18;9.72;928;60;3438.00;81
8994;60;625395662;8994;320;9920;10000;7.39;0.45;274.18;9.72;926;60;3439.00;80
8994;60;625395674;8994;319;9920;10000;7.40;0.45;274.18;9.72;926;60;3440.00;80
8998;60;625395687;8998;318;9920;10000;7.37;0.45;274.26;9.72;922;60;3441.00;80
8999;60;625395700;8999;324;9923;10004;7.38;0.45;274.30;9.72;924;60;3442.00;81
9005;60;625395713;9005;324;9924;10004;7.25;0.44;274.38;9.72;919;60;3443.00;80
9011;60;625395725;9011;335;9924;10004;7.17;0.44;274.43;9.72;913;60;3444.00;80
9012;60;625395737;9012;339;9924;10004;7.09;0.43;274.46;9.72;912;60;3445.00;80
9015;60;625395749;9015;345;9924;10005;7.01;0.43;274.49;9.72;909;60;3446.00;81
9020;60;625395761;9020;335;9925;10006;6.98;0.43;274.53;9.71;905;60;3447.00;81
9023;60;625395774;9023;338;9925;10006;6.98;0.43;274.56;9.71;902;60;3448.00;81
9025;60;625395787;9025;329;9926;10007;6.98;0.43;274.59;9.71;901;60;3449.00;81
9032;60;625395801;9032;323;9927;10007;6.97;0.43;274.64;9.81;895;60;3450.00;80
9037;60;625395820;9037;318;9927;10007;7.00;0.43;274.72;9.81;890;60;3451.00;80
9040;60;625395833;9040;315;9927;10007;7.03;0.43;274.82;9.81;887;60;3452.00;80
9041;60;625395846;9041;313;9927;10007;7.07;0.43;274.85;9.81;886;60;3453.00;80
9044;60;625395858;9044;305;9927;10007;7.12;0.44;274.93;9.81;883;60;3454.00;80
9047;60;625395871;9047;305;9927;10007;7.20;0.44;274.90;9.81;880;60;3455.00;80
9049;60;625395883;9049;309;10001;10134;7.50;0.47;274.94;9.73;952;60;3456.00;133
9052;60;625395907;9052;286;10003;10135;7.65;0.48;274.96;9.73;951;60;3457.00;132
9056;60;625395920;9056;267;10010;10135;7.87;0.49;274.95;9.73;954;60;3458.00;125
9058;60;625395934;9058;256;10015;10135;8.04;0.50;274.96;9.72;957;60;3459.00;120
9060;60;625395953;9060;244;10020;10135;8.14;0.50;274.96;9.72;960;60;3460.00;115
9065;60;625395968;9065;236;10024;10135;8.20;0.51;275.09;9.72;959;60;3461.00;111
9069;60;625395982;9069;232;10029;10135;8.25;0.51;275.10;9.72;960;60;3462.00;106
9072;60;625395996;9072;228;10031;10135;8.32;0.51;275.15;9.72;959;60;3463.00;104
9076;60;625396010;9076;231;10034;10136;8.29;0.51;275.20;9.71;958;60;3464.00;102
9081;60;625396026;9081;240;10038;10138;8.23;0.51;275.26;9.81;957;60;3465.00;100
9083;60;625396039;9083;247;10039;10138;8.17;0.50;275.26;9.81;956;60;3466.00;99
9089;60;625396053;9089;252;10040;10139;8.07;0.49;275.27;9.81;951;60;3467.00;99
9092;60;625396067;9092;254;10041;10139;8.02;0.49;275.31;9.81;949;60;3468.00;98
9093;60;625396080;9093;256;10043;10139;8.00;0.49;275.33;9.81;950;60;3469.00;96
9094;60;625396094;9094;256;10044;10139;7.98;0.49;275.34;9.81;950;60;3470.00;95
9094;60;625396107;9094;256;10048;10143;7.96;0.49;275.34;9.81;954;60;3471.00;95
9097;60;625396120;9097;254;10049;10143;7.94;0.49;275.38;9.81;952;60;3472.00;94
9099;60;625396133;9099;255;10049;10143;7.96;0.49;275.42;9.81;950;60;3473.00;94
9101;60;625396145;9101;255;10052;10146;8.04;0.49;275.51;9.81;951;60;3474.00;94
9106;60;625396159;9106;255;10052;10146;8.03;0.49;275.60;9.81;946;60;3475.00;94
9108;60;625396172;9108;255;10053;10146;8.04;0.49;275.67;9.81;945;60;3476.00;93
9111;60;625396185;9111;262;10057;10150;8.09;0.50;275.73;9.80;946;60;3477.00;93
9113;60;625396198;9113;263;10058;10151;8.12;0.50;275.72;9.80;945;60;3478.00;93
9116;60;625396211;9116;261;10059;10151;8.07;0.49;275.73;9.80;943;60;3479.00;92
9119;60;625396226;9119;265;10063;10156;8.04;0.49;275.80;9.80;944;60;3480.00;93
9125;60;625396239;9125;266;10064;10156;8.00;0.49;275.83;9.80;939;60;3481.00;92
9125;60;625396252;9125;263;10064;10156;8.02;0.49;275.83;9.80;939;60;3482.00;92
9127;60;625396264;9127;268;10065;10157;7.99;0.49;275.81;9.80;938;60;3483.00;92
9129;60;625396277;9129;274;10065;10157;7.95;0.48;275.83;9.80;936;60;3484.00;92
9130;60;625396289;9130;279;10069;10163;7.98;0.49;275.81;9.79;939;60;3485.00;94
9133;60;625396301;9133;284;10070;10163;8.02;0.49;275.81;9.79;937;60;3486.00;93
9134;60;625396314;9134;281;10070;10164;8.02;0.49;275.80;9.79;936;60;3487.00;94
9135;60;625396325;9135;278;10070;10164;8.01;0.49;275.78;9.79;935;60;3488.00;94
9136;60;625396338;9136;285;10070;10164;8.00;0.49;275.76;9.79;934;60;3489.00;94
9137;60;625396350;9137;283;10070;10164;8.01;0.49;275.77;9.79;933;60;3490.00;94
9139;60;625396362;9139;283;10070;10164;8.03;0.49;275.80;9.79;931;60;3491.00;94
9139;60;625396374;9139;273;10080;10176;8.09;0.49;275.80;9.78;941;60;3492.00;96
9143;60;625396388;9143;263;10081;10176;8.12;0.49;275.79;9.78;938;60;3493.00;95
9147;60;625396400;9147;255;10081;10176;8.09;0.49;275.81;9.78;934;60;3494.00;95
9149;60;625396413;9149;248;10082;10176;8.15;0.49;275.78;9.88;933;60;3495.00;94
9151;60;625396426;9151;249;10082;10176;8.22;0.50;275.84;9.88;931;60;3496.00;94
9155;60;625396438;9155;242;10082;10176;8.22;0.50;275.91;9.88;927;60;3497.00;94
9159;60;625396450;9159;234;10085;10180;8.22;0.50;275.96;9.88;926;60;3498.00;95
9163;60;625396462;9163;228;10085;10180;8.22;0.50;276.09;9.88;922;60;3499.00;95
9169;60;625396475;9169;221;10088;10184;8.19;0.50;276.17;9.87;919;60;3500.00;96
9173;60;625396492;9173;215;10090;10185;8.15;0.49;276.18;9.87;917;60;3501.00;95
9177;60;625396504;9177;211;10090;10185;8.06;0.49;276.24;9.87;913;60;3502.00;95
9179;60;625396516;9179;211;10090;10185;7.98;0.48;276.26;9.87;911;60;3503.00;95
9183;60;625396530;9183;211;10100;10198;7.91;0.48;276.29;9.86;917;60;3504.00;98
9186;60;625396543;9186;201;10101;10198;7.80;0.47;276.34;9.88;915;60;3505.00;97
9190;60;625396557;9190;205;10102;10198;7.77;0.47;276.36;9.89;912;60;3506.00;96
9192;60;625396569;9192;201;10103;10199;7.80;0.47;276.41;9.89;911;60;3507.00;96
9195;60;625396581;9195;200;10103;10200;7.83;0.48;276.42;9.89;908;60;3508.00;97
9198;60;625396594;9198;195;10103;10200;7.87;0.48;276.41;9.89;905;60;3509.00;97
9202;60;625396607;9202;196;10106;10206;7.88;0.48;276.39;9.89;904;60;3510.00;100
9203;60;625396619;9203;190;10108;10206;7.91;0.48;276.38;9.98;905;60;3511.00;98
9207;60;625396630;9207;193;10109;10206;7.92;0.48;276.39;9.98;902;60;3512.00;97
9209;60;625396642;9209;195;10109;10206;8.03;0.49;276.50;9.98;900;60;3513.00;97
9211;60;625396654;9211;198;10113;10212;8.13;0.49;276.53;9.98;902;60;3514.00;99
9212;60;625396666;9212;202;10113;10212;8.15;0.50;276.54;9.98;901;60;3515.00;99
9216;60;625396677;9216;200;10114;10212;8.14;0.49;276.55;9.98;898;60;3516.00;98
9218;60;625396691;9218;207;10114;10212;8.07;0.49;276.56;9.98;896;60;3517.00;98
9219;60;625396703;9219;210;10119;10216;8.05;0.49;276.56;9.97;900;60;3518.00;97
9222;60;625396730;9222;208;10121;10219;7.96;0.48;276.65;9.97;899;60;3519.00;98
9224;60;625396759;9224;212;10122;10219;7.88;0.48;276.69;9.97;898;60;3520.00;97
9230;60;625396787;9230;222;10123;10220;7.79;0.47;276.68;9.97;893;60;3521.00;97
9230;60;625396801;9230;230;10124;10220;7.77;0.47;276.68;9.98;894;60;3522.00;96
9231;60;625396815;9231;233;10124;10220;7.71;0.47;276.69;9.98;893;60;3523.00;96
9232;60;625396828;9232;236;10124;10220;7.67;0.46;276.69;9.98;892;60;3524.00;96
9234;60;625396844;9234;243;10124;10220;7.58;0.46;276.70;9.98;890;60;3525.00;96
9235;60;625396858;9235;248;10124;10220;7.56;0.46;276.68;9.98;889;60;3526.00;96
9238;60;625396873;9238;253;10124;10220;7.54;0.46;276.66;9.98;886;60;3527.00;96
9242;60;625396885;9242;255;10158;10290;7.67;0.47;276.66;9.96;916;60;3528.00;132
9243;60;625396905;9243;256;10159;10291;7.65;0.47;276.69;9.97;916;60;3529.00;132
9244;60;625396921;9244;259;10169;10291;7.72;0.47;276.69;9.98;925;60;3530.00;122
9247;60;625396939;9247;259;10175;10291;7.75;0.47;276.69;9.97;928;60;3531.00;116
9249;60;625396952;9249;263;10180;10291;7.81;0.48;276.70;9.98;931;60;3532.00;111
9250;60;625396970;9250;272;10182;10291;7.76;0.47;276.68;9.99;932;60;3533.00;109
9253;60;625396991;9253;274;10189;10291;7.76;0.47;276.63;10.00;936;60;3534.00;102
9256;60;625397012;9256;277;10190;10291;7.69;0.47;276.59;10.01;934;60;3535.00;101
9260;60;625397034;9260;278;10194;10292;7.61;0.46;276.61;10.01;934;60;3536.00;98
9264;60;625397052;9264;280;10200;10293;7.58;0.46;276.60;10.03;936;60;3537.00;93
9266;60;625397082;9266;290;10202;10293;7.53;0.46;276.57;10.04;936;60;3538.00;91
9267;60;625397108;9267;300;10206;10297;7.51;0.46;276.56;10.05;939;60;3539.00;91
9269;60;625397127;9269;298;10206;10297;7.41;0.45;276.52;10.05;937;60;3540.00;91
9273;61;625397142;9273;308;10208;10297;7.27;0.44;276.52;10.07;935;61;3541.00;89
9274;61;625397180;9274;309;10208;10297;7.17;0.44;276.50;10.07;934;61;3542.00;89
9274;61;625397194;9274;315;10214;10303;7.16;0.44;276.50;10.08;940;61;3543.00;89
9276;61;625397214;9276;321;10215;10303;7.05;0.43;276.47;10.09;939;61;3544.00;88
9277;61;625397228;9277;326;10217;10303;6.96;0.42;276.53;10.09;940;61;3545.00;86
9278;61;625397240;9278;338;10220;10306;6.85;0.42;276.52;10.10;942;61;3546.00;86
9280;61;625397253;9280;340;10221;10306;6.66;0.41;276.48;10.10;941;61;3547.00;85
9283;61;625397269;9283;337;10223;10306;6.51;0.40;276.43;10.11;940;61;3548.00;83
9284;61;625397284;9284;346;10224;10307;6.43;0.39;276.40;10.11;940;61;3549.00;83
9285;61;625397298;9285;346;10226;10308;6.31;0.39;276.41;10.12;941;61;3550.00;82
9286;61;625397310;9286;349;10226;10308;6.22;0.38;276.39;10.12;940;61;3551.00;82
9289;61;625397323;9289;354;10238;10321;6.15;0.38;276.34;10.12;949;61;3552.00;83
9290;61;625397340;9290;349;10238;10321;6.10;0.37;276.33;10.12;948;61;3553.00;83
9291;61;625397352;9291;355;10239;10321;6.03;0.37;276.30;10.12;948;61;3554.00;82
9293;61;625397367;9293;355;10242;10323;6.00;0.37;276.30;10.13;949;61;3555.00;81
9295;61;625397380;9295;355;10242;10323;5.98;0.37;276.26;10.13;947;61;3556.00;81
9298;61;625397394;9298;366;10245;10327;5.99;0.37;276.22;10.13;947;61;3557.00;82
9300;61;625397407;9300;361;10248;10327;5.95;0.36;276.19;10.16;948;61;3558.00;79
9303;61;625397420;9303;359;10252;10331;5.93;0.36;276.25;10.15;949;61;3559.00;79
9305;61;625397438;9305;365;10253;10331;5.88;0.36;276.26;10.16;948;61;3560.00;78
9306;61;625397451;9306;372;10253;10331;5.81;0.35;276.24;10.16;947;61;3561.00;78
9311;61;625397463;9311;384;10256;10331;5.64;0.34;276.16;10.19;945;61;3562.00;75
9314;61;625397477;9314;371;10256;10331;5.57;0.34;276.13;10.19;942;61;3563.00;75
9317;61;625397489;9317;358;10266;10343;5.60;0.34;276.09;10.18;949;61;3564.00;77
9320;61;625397503;9320;354;10267;10343;5.57;0.34;276.09;10.19;947;61;3565.00;76
9323;61;625397518;9323;350;10271;10343;5.52;0.34;276.09;10.21;948;61;3566.00;72
9325;61;625397531;9325;346;10271;10343;5.48;0.33;276.07;10.21;946;61;3567.00;72
9328;61;625397543;9328;344;10272;10343;5.46;0.33;276.04;10.21;944;61;3568.00;71
9329;61;625397557;9329;345;10272;10343;5.44;0.33;276.04;10.21;943;61;3569.00;71
9331;62;625397578;9331;332;10272;10344;5.41;0.33;276.02;10.21;941;62;3570.00;72
9332;62;625397605;9332;320;10273;10344;5.40;0.33;276.03;10.22;941;62;3571.00;71
9334;62;625397620;9334;315;10279;10350;5.46;0.33;276.06;10.22;945;62;3572.00;71
9334;62;625397635;9334;314;10281;10351;5.51;0.34;276.06;10.22;947;62;3573.00;70
9336;62;625397649;9336;313;10282;10351;5.52;0.34;276.09;10.22;946;62;3574.00;69
9337;62;625397670;9337;318;10282;10351;5.62;0.34;276.09;10.22;945;62;3575.00;69
9338;62;625397683;9338;318;10287;10355;5.69;0.35;276.09;10.23;949;62;3576.00;68
9339;62;625397704;9339;313;10287;10355;5.79;0.35;276.11;10.23;948;62;3577.00;68
9341;62;625397719;9341;304;10287;10355;5.89;0.36;276.11;10.23;946;62;3578.00;68
9344;62;625397732;9344;305;10288;10356;6.01;0.37;276.06;10.23;944;62;3579.00;68
9345;62;625397747;9345;301;10291;10360;6.14;0.37;276.04;10.22;946;62;3580.00;69
9349;62;625397760;9349;303;10291;10360;6.22;0.38;276.05;10.22;942;62;3581.00;69
9351;62;625397776;9351;299;10293;10363;6.29;0.38;276.07;10.22;942;62;3582.00;70
9352;62;625397793;9352;305;10294;10363;6.34;0.39;276.07;10.22;942;62;3583.00;69
9355;62;625397808;9355;294;10294;10363;6.39;0.39;276.09;10.22;939;62;3584.00;69
9358;62;625397824;9358;292;10294;10363;6.44;0.39;276.08;10.22;936;62;3585.00;69
9363;62;625397839;9363;298;10297;10367;6.53;0.40;276.14;10.22;934;62;3586.00;70
9364;62;625397855;9364;296;10297;10367;6.65;0.41;276.14;10.22;933;62;3587.00;70
9369;62;625397871;9369;294;10298;10367;6.72;0.41;276.19;10.22;929;62;3588.00;69
9373;62;625397886;9373;284;10298;10367;6.75;0.41;276.20;10.22;925;62;3589.00;69
9374;62;625397901;9374;279;10298;10368;6.80;0.41;276.21;10.22;924;62;3590.00;70
9379;62;625397919;9379;283;10299;10369;6.84;0.42;276.24;10.22;920;62;3591.00;70
9384;62;625397933;9384;274;10299;10369;6.87;0.42;276.19;10.22;915;62;3592.00;70
9389;62;625397950;9389;277;10300;10370;6.95;0.42;276.20;10.22;911;62;3593.00;70
9392;62;625397965;9392;274;10300;10370;6.99;0.43;276.27;10.22;908;62;3594.00;70
9395;62;625397981;9395;275;10300;10370;7.03;0.43;276.29;10.22;905;62;3595.00;70
9400;62;625397999;9400;279;10300;10370;7.08;0.43;276.38;10.22;900;62;3596.00;70
9404;62;625398018;9404;279;10300;10370;7.13;0.44;276.39;10.22;896;62;3597.00;70
9410;62;625398034;9410;281;10300;10370;7.19;0.44;276.48;10.22;890;62;3598.00;70
9415;62;625398047;9415;283;10300;10370;7.20;0.44;276.51;10.22;885;62;3599.00;70
9418;62;625398067;9418;317;10413;10623;7.49;0.47;276.52;10.20;995;62;3600.00;210
9420;62;625398108;9420;313;10419;10624;7.49;0.47;276.60;10.20;999;62;3601.00;205
9427;62;625398124;9427;302;10430;10624;7.54;0.47;276.63;10.19;1003;62;3602.00;194
9430;62;625398140;9430;298;10438;10624;7.59;0.48;276.60;10.18;1008;62;3603.00;186
9433;62;625398157;9433;297;10445;10624;7.65;0.48;276.63;10.18;1012;62;3604.00;179
9438;62;625398173;9438;295;10452;10624;7.66;0.48;276.72;10.17;1014;62;3605.00;172
9441;62;625398189;9441;297;10461;10624;7.66;0.48;276.79;10.17;1020;62;3606.00;163
9447;62;625398204;9447;300;10466;10624;7.66;0.48;276.81;10.17;1019;62;3607.00;158
9451;62;625398220;9451;300;10473;10625;7.69;0.48;276.87;10.17;1022;62;3608.00;152
9456;62;625398235;9456;299;10473;10626;7.71;0.48;276.94;10.17;1017;62;3609.00;153
9462;62;625398252;9462;302;10477;10626;7.73;0.48;276.97;10.17;1015;62;3610.00;149
9466;62;625398268;9466;308;10484;10627;7.66;0.48;277.04;10.17;1018;62;3611.00;143
9471;62;625398289;9471;307;10489;10627;7.62;0.47;277.06;10.17;1018;62;3612.00;138
9474;62;625398305;9474;311;10489;10627;7.62;0.47;277.03;10.17;1015;62;3613.00;138
9482;62;625398328;9482;320;10492;10627;7.58;0.47;277.13;10.17;1010;62;3614.00;135
9485;62;625398345;9485;328;10498;10631;7.58;0.47;277.23;10.17;1013;62;3615.00;133
9486;62;625398360;9486;332;10498;10631;7.54;0.46;277.26;10.17;1012;62;3616.00;133
9489;62;625398377;9489;327;10501;10631;7.42;0.46;277.35;10.17;1012;62;3617.00;130
9492;62;625398401;9492;319;10504;10634;7.36;0.45;277.41;10.17;1012;62;3618.00;130
9494;62;625398423;9494;321;10504;10634;7.43;0.46;277.43;10.17;1010;62;3619.00;130
9498;62;625398438;9498;323;10507;10634;7.52;0.46;277.49;10.18;1009;62;3620.00;127
9502;62;625398454;9502;320;10511;10638;7.51;0.46;277.51;10.17;1009;62;3621.00;127
9506;62;625398472;9506;323;10514;10639;7.57;0.46;277.51;10.17;1008;62;3622.00;125
9512;62;625398490;9512;323;10517;10639;7.59;0.46;277.56;10.18;1005;62;3623.00;122
9514;62;625398507;9514;323;10520;10643;7.66;0.47;277.58;10.18;1006;62;3624.00;123
9515;62;625398524;9515;325;10522;10643;7.69;0.47;277.56;10.28;1007;62;3625.00;121
9517;62;625398541;9517;311;10523;10643;7.67;0.47;277.60;10.28;1006;62;3626.00;120
9517;62;625398558;9517;301;10526;10644;7.70;0.47;277.60;10.28;1009;62;3627.00;118
9519;62;625398582;9519;298;10527;10644;7.70;0.47;277.66;10.28;1008;62;3628.00;117
9526;62;625398598;9526;287;10532;10650;7.64;0.46;277.77;10.28;1006;62;3629.00;118
9528;62;625398617;9528;286;10533;10650;7.61;0.46;277.78;10.28;1005;62;3630.00;117
9531;62;625398635;9531;285;10534;10651;7.61;0.46;277.80;10.27;1003;62;3631.00;117
9534;62;625398653;9534;287;10535;10651;7.59;0.46;277.79;10.27;1001;62;3632.00;116
9535;62;625398670;9535;285;10536;10651;7.56;0.46;277.82;10.28;1001;62;3633.00;115
9538;62;625398686;9538;287;10536;10651;7.56;0.46;277.83;10.28;998;62;3634.00;115
9539;62;625398708;9539;287;10536;10651;7.55;0.46;277.82;10.28;997;62;3635.00;115
9544;62;625398723;9544;293;10546;10663;7.54;0.46;277.83;10.27;1002;62;3636.00;117
9548;62;625398740;9548;289;10546;10663;7.48;0.45;277.87;10.27;998;62;3637.00;117
9550;62;625398754;9550;285;10546;10663;7.47;0.45;277.90;10.27;996;62;3638.00;117
9553;62;625398769;9553;288;10547;10663;7.48;0.45;277.96;10.27;994;62;3639.00;116
9554;62;625398785;9554;287;10547;10663;7.54;0.46;278.01;10.27;993;62;3640.00;116
9559;62;625398801;9559;283;10547;10663;7.52;0.46;278.04;10.27;988;62;3641.00;116
9562;62;625398817;9562;285;10550;10667;7.48;0.45;278.04;10.27;988;62;3642.00;117
9563;62;625398847;9563;280;10550;10667;7.46;0.45;278.03;10.27;987;62;3643.00;117
9564;62;625398869;9564;285;10555;10671;7.51;0.46;278.01;10.27;991;62;3644.00;116
9567;62;625398884;9567;288;10557;10673;7.52;0.46;278.12;10.27;990;62;3645.00;116
9567;62;625398900;9567;288;10558;10673;7.53;0.46;278.12;10.26;991;62;3646.00;115
9569;62;625398918;9569;289;10558;10673;7.52;0.46;278.09;10.26;989;62;3647.00;115
9571;62;625398934;9571;298;10567;10686;7.61;0.46;278.08;10.26;996;62;3648.00;119
9572;62;625398949;9572;302;10567;10686;7.62;0.46;278.06;10.26;995;62;3649.00;119
9575;62;625398964;9575;310;10567;10686;7.62;0.46;278.06;10.26;992;62;3650.00;119
9577;62;625398982;9577;311;10568;10687;7.59;0.46;278.13;10.25;991;62;3651.00;119
9579;62;625399003;9579;313;10568;10688;7.61;0.46;278.12;10.25;989;62;3652.00;120
9582;62;625399023;9582;317;10568;10688;7.55;0.46;278.13;10.25;986;62;3653.00;120
9583;62;625399048;9583;313;10571;10691;7.51;0.46;278.12;10.35;988;62;3654.00;120
9584;62;625399076;9584;306;10571;10691;7.44;0.45;278.14;10.35;987;62;3655.00;120
9586;62;625399095;9586;308;10572;10691;7.43;0.45;278.12;10.35;986;62;3656.00;119
9588;62;625399114;9588;311;10572;10691;7.37;0.45;278.16;10.35;984;62;3657.00;119
9589;62;625399130;9589;312;10576;10697;7.31;0.45;278.14;10.34;987;62;3658.00;121
9592;62;625399147;9592;310;10576;10697;7.20;0.44;278.09;10.34;984;62;3659.00;121
9594;62;625399168;9594;309;10577;10697;7.15;0.44;278.10;10.34;983;62;3660.00;120
9597;62;625399188;9597;304;10577;10697;7.07;0.43;278.10;10.34;980;62;3661.00;120
9598;62;625399205;9598;292;10580;10701;7.01;0.43;278.10;10.34;982;62;3662.00;121
9600;62;625399224;9600;293;10581;10702;6.97;0.42;278.07;10.34;981;62;3663.00;121
9602;62;625399242;9602;285;10581;10702;6.96;0.42;278.05;10.34;979;62;3664.00;121
9603;62;625399259;9603;286;10582;10703;6.94;0.42;278.04;10.34;979;62;3665.00;121
9606;62;625399275;9606;284;10582;10703;6.88;0.42;278.06;10.34;976;62;3666.00;121
9609;62;625399290;9609;287;10583;10703;6.85;0.42;278.10;10.34;974;62;3667.00;120
9610;62;625399305;9610;284;10584;10703;6.84;0.42;278.09;10.44;974;62;3668.00;119
9611;62;625399320;9611;283;10584;10703;6.84;0.42;278.10;10.44;973;62;3669.00;119
9615;62;625399337;9615;279;10584;10703;6.81;0.42;278.15;10.44;969;62;3670.00;119
9616;62;625399355;9616;274;10584;10703;6.77;0.41;278.18;10.44;968;62;3671.00;119
9619;62;625399369;9619;277;10614;10773;6.78;0.41;278.20;10.51;995;62;3672.00;159
9621;62;625399396;9621;268;10616;10774;6.74;0.41;278.19;10.51;995;62;3673.00;158
9622;62;625399412;9622;258;10624;10774;6.87;0.42;278.17;10.50;1002;63;3674.00;150
9625;62;625399436;9625;251;10628;10774;6.85;0.42;278.20;10.62;1003;63;3675.00;146
9627;62;625399455;9627;248;10633;10774;6.89;0.42;278.21;10.62;1006;63;3676.00;141
9629;62;625399472;9629;245;10636;10774;6.91;0.42;278.18;10.71;1007;63;3677.00;138
9632;62;625399495;9632;244;10640;10774;6.90;0.42;278.19;10.70;1008;63;3678.00;134
9637;62;625399512;9637;235;10641;10774;6.84;0.42;278.12;10.70;1004;63;3679.00;133
9640;62;625399538;9640;236;10645;10775;6.87;0.42;278.08;10.79;1005;63;3680.00;130
9641;62;625399564;9641;239;10647;10776;6.96;0.42;278.08;10.79;1006;63;3681.00;129
9642;62;625399583;9642;239;10649;10776;6.95;0.42;278.05;10.79;1007;63;3682.00;127
9642;62;625399600;9642;238;10652;10780;6.91;0.42;278.05;10.79;1010;63;3683.00;128
9643;62;625399619;9643;236;10653;10780;6.86;0.42;278.06;10.87;1010;63;3684.00;127
9644;62;625399634;9644;241;10653;10780;6.84;0.42;278.05;10.87;1009;63;3685.00;127
9646;62;625399652;9646;244;10654;10780;6.80;0.42;278.02;10.95;1008;63;3686.00;126
9648;62;625399669;9648;248;10658;10786;6.78;0.41;277.99;10.96;1010;63;3687.00;128
9650;62;625399687;9650;259;10659;10786;6.78;0.41;277.95;10.96;1009;63;3688.00;127
9654;62;625399702;9654;261;10660;10786;6.73;0.41;277.87;11.03;1006;63;3689.00;126
9655;62;625399720;9655;264;10664;10792;6.74;0.41;277.85;11.04;1009;63;3690.00;128
9659;62;625399737;9659;266;10666;10792;6.64;0.40;277.90;11.04;1007;63;3691.00;126
9661;62;625399764;9661;272;10669;10792;6.55;0.40;277.88;11.05;1008;63;3692.00;123
9665;62;625399782;9665;271;10671;10793;6.52;0.40;277.83;11.12;1006;63;3693.00;122
9667;62;625399799;9667;275;10674;10794;6.56;0.40;277.79;11.13;1007;63;3694.00;120
9669;62;625399815;9669;284;10678;10794;6.51;0.40;277.75;11.14;1009;63;3695.00;116
9671;62;625399833;9671;287;10687;10807;6.51;0.40;277.72;11.13;1016;63;3696.00;120
9673;62;625399852;9673;294;10688;10807;6.43;0.39;277.77;11.14;1015;63;3697.00;119
9675;62;625399868;9675;312;10689;10807;6.41;0.39;277.85;11.14;1014;63;3698.00;118
9676;62;625399884;9676;313;10691;10808;6.40;0.39;277.85;11.14;1015;63;3699.00;117
9677;62;625399901;9677;319;10693;10808;6.42;0.39;277.84;11.15;1016;63;3700.00;115
9679;62;625399930;9679;321;10697;10812;6.46;0.39;277.86;11.17;1018;63;3701.00;115
9683;62;625399950;9683;327;10698;10812;6.39;0.39;277.77;11.17;1015;63;3702.00;114
9685;62;625399967;9685;336;10702;10816;6.41;0.39;277.75;11.18;1017;63;3703.00;114
9686;62;625399992;9686;337;10705;10816;6.43;0.39;277.76;11.19;1019;63;3704.00;111
9688;62;625400008;9688;343;10705;10816;6.45;0.39;277.72;11.19;1017;63;3705.00;111
9692;62;625400026;9692;339;10707;10816;6.45;0.39;277.68;11.21;1015;63;3706.00;109
9695;62;625400039;9695;348;10707;10816;6.42;0.39;277.66;11.21;1012;63;3707.00;109
9696;62;625400054;9696;360;10718;10828;6.43;0.39;277.63;11.21;1022;63;3708.00;110
9697;62;625400070;9697;354;10720;10828;6.37;0.39;277.63;11.22;1023;63;3709.00;108
9697;62;625400084;9697;359;10722;10828;6.35;0.39;277.63;11.24;1025;63;3710.00;106
9699;62;625400098;9699;358;10723;10828;6.29;0.39;277.63;11.25;1024;63;3711.00;105
9703;62;625400113;9703;367;10725;10828;6.22;0.38;277.60;11.27;1022;63;3712.00;103
9706;62;625400128;9706;369;10727;10828;6.17;0.38;277.60;11.27;1021;63;3713.00;101
9707;62;625400142;9707;377;10729;10829;6.16;0.38;277.63;11.29;1022;63;3714.00;100
9710;62;625400159;9710;360;10730;10829;6.12;0.38;277.69;11.29;1020;63;3715.00;99
9712;62;625400174;9712;355;10735;10835;6.16;0.38;277.69;11.29;1023;63;3716.00;100
9714;62;625400189;9714;352;10738;10836;6.12;0.37;277.67;11.31;1024;63;3717.00;98
9715;62;625400203;9715;347;10739;10836;6.11;0.37;277.65;11.31;1024;63;3718.00;97
9720;62;625400220;9720;339;10741;10836;6.08;0.37;277.59;11.33;1021;63;3719.00;95
9721;63;625400237;9721;332;10745;10841;6.20;0.38;277.70;11.33;1024;64;3720.00;96
9722;63;625400268;9722;325;10747;10841;6.22;0.38;277.68;11.35;1025;64;3721.00;94
9723;63;625400284;9723;325;10747;10841;6.26;0.38;277.67;11.35;1024;64;3722.00;94
9724;63;625400299;9724;320;10749;10842;6.32;0.39;277.66;11.36;1025;64;3723.00;93
9726;63;625400313;9726;325;10753;10846;6.36;0.39;277.62;11.36;1027;64;3724.00;93
9727;64;625400328;9727;317;10753;10846;6.47;0.40;277.61;11.36;1026;65;3725.00;93
9728;65;625400365;9728;317;10757;10849;6.59;0.40;277.62;11.38;1029;66;3726.00;92
9730;65;625400389;9730;314;10758;10849;6.65;0.41;277.62;11.38;1028;66;3727.00;91
9730;65;625400413;9730;315;10758;10849;6.72;0.41;277.62;11.38;1028;66;3728.00;91
9731;65;625400426;9731;313;10758;10849;6.74;0.41;277.59;11.38;1027;66;3729.00;91
9734;65;625400447;9734;322;10763;10853;6.77;0.41;277.55;11.40;1029;66;3730.00;90
9734;65;625400460;9734;321;10765;10853;6.76;0.41;277.55;11.40;1031;66;3731.00;88
9737;65;625400472;9737;325;10768;10853;6.70;0.41;277.51;11.43;1031;66;3732.00;85
9738;65;625400484;9738;331;10768;10853;6.63;0.41;277.50;11.43;1030;66;3733.00;85
9739;65;625400494;9739;334;10768;10854;6.57;0.40;277.50;11.43;1029;66;3734.00;86
9744;65;625400512;9744;337;10773;10856;6.51;0.40;277.45;11.44;1029;66;3735.00;83
9747;65;625400524;9747;334;10773;10856;6.47;0.40;277.47;11.44;1026;66;3736.00;83
9753;65;625400535;9753;333;10774;10857;6.39;0.39;277.53;11.44;1021;66;3737.00;83
9757;65;625400547;9757;345;10776;10857;6.29;0.38;277.55;11.45;1019;66;3738.00;81
9759;65;625400561;9759;341;10776;10857;6.23;0.38;277.60;11.45;1017;66;3739.00;81
9766;65;625400572;9766;336;10777;10857;6.11;0.37;277.68;11.46;1011;66;3740.00;80
9771;65;625400588;9771;322;10778;10857;6.05;0.37;277.70;11.46;1007;66;3741.00;79
9774;65;625400604;9774;322;10778;10857;6.05;0.37;277.77;11.46;1004;66;3742.00;79
9777;65;625400617;9777;318;10780;10857;6.05;0.37;277.78;11.47;1003;66;3743.00;77
9779;65;625400633;9779;329;10845;10984;6.36;0.40;277.84;11.40;1066;66;3744.00;139
9782;65;625400655;9782;329;10847;10985;6.38;0.40;277.98;11.40;1065;66;3745.00;138
9785;65;625400668;9785;322;10856;10985;6.45;0.40;278.02;11.40;1071;66;3746.00;129
9788;65;625400680;9788;316;10863;10985;6.54;0.41;278.06;11.39;1075;66;3747.00;122
9790;65;625400694;9790;308;10871;10985;6.64;0.41;278.12;11.40;1081;66;3748.00;114
9796;65;625400707;9796;302;10875;10985;6.67;0.41;278.21;11.39;1079;66;3749.00;110
9799;65;625400722;9799;295;10879;10990;6.74;0.42;278.21;11.39;1080;66;3750.00;111
9802;65;625400736;9802;295;10883;10990;6.78;0.42;278.26;11.47;1081;66;3751.00;107
9806;65;625400749;9806;298;10887;10991;6.81;0.42;278.31;11.47;1081;66;3752.00;104
9812;65;625400762;9812;300;10890;10992;6.82;0.42;278.31;11.47;1078;66;3753.00;102
9816;65;625400776;9816;306;10893;10992;6.82;0.42;278.39;11.47;1077;66;3754.00;99
9820;65;625400789;9820;303;10896;10993;6.84;0.42;278.45;11.47;1076;66;3755.00;97
9822;65;625400803;9822;309;10898;10993;6.91;0.42;278.52;11.47;1076;66;3756.00;95
9825;65;625400817;9825;309;10900;10993;6.93;0.43;278.62;11.47;1075;66;3757.00;93
9832;65;625400832;9832;311;10901;10993;6.97;0.43;278.60;11.47;1069;66;3758.00;92
9835;65;625400847;9835;312;10904;10997;6.97;0.43;278.64;11.46;1069;66;3759.00;93
9839;65;625400861;9839;314;10906;10997;6.98;0.43;278.68;11.46;1067;66;3760.00;91
9845;65;625400875;9845;306;10906;10997;6.97;0.43;278.76;11.46;1061;66;3761.00;91
9849;65;625400889;9849;306;10909;11000;7.02;0.43;278.81;11.46;1060;66;3762.00;91
9852;65;625400903;9852;302;10910;11000;7.01;0.43;278.85;11.46;1058;66;3763.00;90
9856;65;625400917;9856;300;10911;11000;7.03;0.43;278.93;11.46;1055;66;3764.00;89
9859;65;625400932;9859;303;10915;11004;7.01;0.43;279.00;11.46;1056;66;3765.00;89
9863;65;625400947;9863;303;10916;11005;7.00;0.43;279.03;11.46;1053;66;3766.00;89
9870;65;625400962;9870;310;10916;11005;6.98;0.43;279.15;11.46;1046;66;3767.00;89
9876;65;625400976;9876;312;10919;11009;6.97;0.42;279.17;11.46;1043;66;3768.00;90
9879;65;625400997;9879;306;10919;11009;6.95;0.42;279.18;11.46;1040;66;3769.00;90
9884;65;625401022;9884;313;10919;11009;6.92;0.42;279.24;11.46;1035;66;3770.00;90
9887;65;625401044;9887;313;10921;11010;6.91;0.42;279.27;11.46;1034;66;3771.00;89
9890;65;625401066;9890;311;10921;11010;6.94;0.42;279.25;11.46;1031;66;3772.00;89
9895;65;625401086;9895;311;10926;11016;6.87;0.42;279.34;11.45;1031;66;3773.00;90
9896;65;625401105;9896;310;10926;11016;6.87;0.42;279.32;11.45;1030;66;3774.00;90
9898;65;625401120;9898;315;10926;11017;6.86;0.42;279.34;11.45;1028;66;3775.00;91
9903;65;625401135;9903;320;10928;11017;6.78;0.41;279.33;11.54;1025;66;3776.00;89
9906;65;625401151;9906;316;10929;11017;6.78;0.41;279.35;11.54;1023;66;3777.00;88
9907;65;625401166;9907;312;10929;11017;6.82;0.42;279.35;11.54;1022;66;3778.00;88
9913;65;625401182;9913;311;10930;11017;6.83;0.42;279.42;11.53;1017;66;3779.00;87
9920;65;625401198;9920;316;10955;11053;6.88;0.42;279.47;11.51;1035;66;3780.00;98
9921;65;625401217;9921;317;10956;11053;6.91;0.42;279.47;11.51;1035;66;3781.00;97
9927;65;625401231;9927;316;10958;11053;6.85;0.42;279.45;11.51;1031;66;3782.00;95
9928;65;625401246;9928;319;10959;11053;6.81;0.42;279.48;11.51;1031;66;3783.00;94
9930;65;625401262;9930;318;10959;11053;6.79;0.41;279.51;11.51;1029;66;3784.00;94
9933;65;625401277;9933;318;10960;11053;6.71;0.41;279.56;11.50;1027;66;3785.00;93
9933;65;625401292;9933;321;10963;11057;6.68;0.41;279.56;11.50;1030;66;3786.00;94
9935;65;625401306;9935;317;10963;11057;6.71;0.41;279.56;11.50;1028;66;3787.00;94
9937;65;625401321;9937;305;10965;11061;6.72;0.41;279.58;11.50;1028;66;3788.00;96
9939;65;625401336;9939;311;10967;11062;6.77;0.41;279.54;11.50;1028;66;3789.00;95
9940;65;625401351;9940;308;10967;11062;6.83;0.42;279.56;11.50;1027;66;3790.00;95
9945;65;625401366;9945;307;10969;11062;6.87;0.42;279.57;11.50;1024;66;3791.00;93
9948;65;625401380;9948;311;10979;11075;7.00;0.43;279.56;11.49;1031;66;3792.00;96
9954;65;625401396;9954;316;10980;11075;7.05;0.43;279.64;11.49;1026;66;3793.00;95
9958;65;625401411;9958;318;10980;11075;7.06;0.43;279.75;11.49;1022;66;3794.00;95
9961;65;625401426;9961;318;10981;11076;7.13;0.44;279.80;11.48;1020;66;3795.00;95
9968;65;625401440;9968;299;10981;11077;7.11;0.43;279.94;11.48;1013;66;3796.00;96
9972;65;625401456;9972;291;10981;11077;7.18;0.44;279.96;11.48;1009;66;3797.00;96
9976;65;625401471;9976;280;10983;11080;7.23;0.44;280.08;11.48;1007;66;3798.00;97
9981;65;625401487;9981;279;10984;11080;7.33;0.45;280.13;11.48;1003;66;3799.00;96
9982;65;625401502;9982;269;10984;11080;7.41;0.45;280.15;11.48;1002;66;3800.00;96
9987;65;625401529;9987;268;10984;11080;7.44;0.45;280.27;11.48;997;66;3801.00;96
9987;65;625401559;9987;267;10988;11086;7.55;0.46;280.27;11.48;1001;66;3802.00;98
9992;65;625401574;9992;262;10988;11086;7.64;0.47;280.37;11.48;996;66;3803.00;98
9996;65;625401589;9996;261;10989;11086;7.65;0.47;280.43;11.48;993;66;3804.00;97
10000;65;625401612;10000;259;10989;11086;7.70;0.47;280.42;11.48;989;66;3805.00;97
10003;65;625401627;10003;270;10992;11090;7.66;0.47;280.43;11.47;989;66;3806.00;98
10006;65;625401641;10006;268;10993;11091;7.72;0.47;280.45;11.47;987;66;3807.00;98
10007;65;625401656;10007;269;10993;11091;7.76;0.47;280.47;11.47;986;66;3808.00;98
10010;65;625401670;10010;257;10994;11092;7.80;0.47;280.51;11.47;984;66;3809.00;98
10016;65;625401694;10016;248;10994;11092;7.75;0.47;280.54;11.47;978;66;3810.00;98
10018;65;625401718;10018;247;10994;11092;7.73;0.47;280.50;11.47;976;66;3811.00;98
10024;65;625401741;10024;244;10994;11092;7.71;0.47;280.56;11.47;970;66;3812.00;98
10024;65;625401755;10024;241;10994;11092;7.74;0.47;280.56;11.47;970;66;3813.00;98
10028;65;625401769;10028;239;10994;11092;7.68;0.46;280.63;11.47;966;66;3814.00;98
10033;65;625401783;10033;240;10994;11092;7.65;0.46;280.70;11.47;961;66;3815.00;98
10034;65;625401797;10034;257;11030;11162;7.63;0.46;280.70;11.43;996;66;3816.00;132
10038;65;625401817;10038;250;11032;11163;7.64;0.46;280.68;11.43;994;66;3817.00;131
10039;66;625401831;10039;253;11039;11163;7.72;0.47;280.72;11.43;1000;67;3818.00;124
10039;66;625401853;10039;256;11039;11163;7.68;0.47;280.72;11.43;1000;67;3819.00;124
10039;66;625401866;10039;258;11045;11163;7.68;0.47;280.72;11.42;1006;67;3820.00;118
10040;66;625401894;10040;267;11047;11163;7.68;0.47;280.74;11.42;1007;67;3821.00;116
10041;66;625401909;10041;261;11049;11163;7.67;0.47;280.72;11.42;1008;67;3822.00;114
10043;66;625401922;10043;274;11052;11163;7.68;0.47;280.79;11.42;1009;67;3823.00;111
10044;66;625401936;10044;279;11053;11164;7.66;0.47;280.79;11.42;1009;67;3824.00;111
10046;66;625401949;10046;284;11058;11166;7.60;0.46;280.83;11.42;1012;67;3825.00;108
10046;66;625401963;10046;291;11062;11166;7.54;0.46;280.83;11.50;1016;67;3826.00;104
10048;66;625401978;10048;297;11065;11170;7.40;0.45;280.88;11.50;1017;67;3827.00;105
10050;66;625401992;10050;305;11065;11170;7.23;0.44;280.87;11.50;1015;67;3828.00;105
10052;66;625402004;10052;304;11065;11170;7.13;0.44;280.84;11.50;1013;67;3829.00;105
10054;66;625402018;10054;305;11065;11170;6.98;0.43;280.89;11.50;1011;67;3830.00;105
10059;66;625402031;10059;310;11068;11176;6.89;0.42;280.90;11.49;1009;67;3831.00;108
10059;66;625402045;10059;317;11068;11176;6.85;0.42;280.90;11.49;1009;67;3832.00;108
10062;66;625402056;10062;321;11069;11176;6.79;0.41;280.93;11.49;1007;67;3833.00;107
10065;66;625402068;10065;316;11071;11179;6.71;0.41;280.91;11.49;1006;67;3834.00;108
10069;66;625402080;10069;325;11072;11179;6.61;0.40;280.94;11.49;1003;67;3835.00;107
10071;66;625402092;10071;323;11072;11179;6.54;0.40;280.96;11.49;1001;67;3836.00;107
10074;66;625402104;10074;320;11072;11180;6.45;0.39;281.00;11.49;998;67;3837.00;108
10076;66;625402115;10076;321;11073;11181;6.38;0.39;280.98;11.49;997;67;3838.00;108
10078;66;625402127;10078;318;11073;11181;6.32;0.39;280.95;11.49;995;67;3839.00;108
10080;66;625402140;10080;313;11088;11207;6.24;0.38;280.94;11.47;1008;67;3840.00;119
10085;66;625402152;10085;312;11088;11207;6.09;0.37;280.90;11.47;1003;67;3841.00;119
10090;66;625402163;10090;309;11090;11207;6.03;0.37;280.84;11.47;1000;67;3842.00;117
10094;66;625402174;10094;307;11093;11208;5.99;0.37;280.82;11.47;999;67;3843.00;115
10096;66;625402186;10096;297;11094;11208;5.97;0.36;280.88;11.49;998;67;3844.00;114
10100;66;625402199;10100;300;11097;11212;5.97;0.36;280.85;11.50;997;67;3845.00;115
10103;66;625402211;10103;305;11100;11214;5.93;0.36;280.83;11.58;997;67;3846.00;114
10105;66;625402223;10105;300;11103;11218;5.95;0.36;280.84;11.58;998;67;3847.00;115
10111;66;625402234;10111;304;11104;11218;5.92;0.36;280.78;11.58;993;67;3848.00;114
10116;66;625402246;10116;295;11104;11218;5.90;0.36;280.73;11.58;988;67;3849.00;114
10117;66;625402257;10117;302;11104;11218;5.93;0.36;280.72;11.58;987;67;3850.00;114
10118;66;625402268;10118;296;11104;11218;5.96;0.36;280.72;11.58;986;67;3851.00;114
10124;66;625402278;10124;301;11115;11230;5.99;0.36;280.62;11.57;991;67;3852.00;115
10126;66;625402291;10126;296;11115;11230;5.97;0.36;280.57;11.57;989;67;3853.00;115
10127;66;625402301;10127;296;11116;11230;5.95;0.36;280.57;11.58;989;67;3854.00;114
10131;66;625402312;10131;302;11116;11230;5.92;0.36;280.53;11.58;985;67;3855.00;114
10133;66;625402324;10133;305;11116;11230;5.93;0.36;280.49;11.58;983;67;3856.00;114
10135;66;625402334;10135;303;11117;11230;5.89;0.36;280.50;11.58;982;67;3857.00;113
10136;66;625402345;10136;308;11117;11231;5.88;0.36;280.49;11.58;981;67;3858.00;114
10137;66;625402356;10137;308;11117;11231;5.88;0.36;280.48;11.58;980;67;3859.00;114
10139;66;625402366;10139;315;11123;11237;5.95;0.36;280.48;11.58;984;67;3860.00;114
10141;66;625402383;10141;320;11125;11238;5.96;0.36;280.48;11.58;984;67;3861.00;113
10143;66;625402395;10143;326;11126;11238;5.93;0.36;280.53;11.58;983;67;3862.00;112
10144;66;625402405;10144;324;11126;11238;5.89;0.36;280.53;11.58;982;67;3863.00;112
10146;66;625402416;10146;327;11128;11242;5.87;0.36;280.50;11.57;982;67;3864.00;114
10148;66;625402427;10148;333;11129;11242;5.82;0.35;280.49;11.58;981;67;3865.00;113
10148;66;625402438;10148;339;11130;11242;5.85;0.35;280.49;11.58;982;67;3866.00;112
10149;66;625402448;10149;340;11132;11243;5.87;0.36;280.49;11.59;983;67;3867.00;111
10152;66;625402459;10152;333;11136;11247;5.89;0.36;280.42;11.58;984;67;3868.00;111
10153;66;625402471;10153;329;11136;11247;5.97;0.36;280.42;11.58;983;67;3869.00;111
10155;66;625402484;10155;330;11142;11253;6.03;0.37;280.41;11.60;987;67;3870.00;111
10157;66;625402497;10157;322;11143;11253;6.11;0.37;280.37;11.60;986;67;3871.00;110
10158;66;625402508;10158;314;11145;11253;6.17;0.37;280.41;11.62;987;67;3872.00;108
10159;66;625402520;10159;308;11145;11253;6.22;0.38;280.40;11.62;986;67;3873.00;108
10160;66;625402531;10160;297;11149;11257;6.33;0.38;280.40;11.62;989;67;3874.00;108
10160;66;625402543;10160;297;11150;11257;6.37;0.39;280.40;11.64;990;67;3875.00;107
10162;66;625402555;10162;293;11152;11257;6.42;0.39;280.37;11.64;990;67;3876.00;105
10164;66;625402567;10164;294;11154;11257;6.48;0.39;280.37;11.66;990;67;3877.00;103
10164;66;625402578;10164;293;11155;11258;6.51;0.40;280.37;11.66;991;67;3878.00;103
10167;66;625402590;10167;294;11157;11259;6.54;0.40;280.35;11.68;990;67;3879.00;102
10167;66;625402603;10167;291;11158;11259;6.55;0.40;280.35;11.69;991;67;3880.00;101
10168;66;625402615;10168;291;11160;11260;6.50;0.39;280.35;11.69;992;67;3881.00;100
10169;66;625402627;10169;291;11160;11260;6.51;0.40;280.34;11.69;991;67;3882.00;100
10170;66;625402639;10170;296;11161;11260;6.54;0.40;280.32;11.71;991;67;3883.00;99
10170;66;625402650;10170;299;11162;11260;6.57;0.40;280.32;11.71;992;67;3884.00;98
10172;66;625402661;10172;299;11162;11260;6.56;0.40;280.32;11.71;990;67;3885.00;98
10173;66;625402678;10173;303;11162;11260;6.54;0.40;280.32;11.71;989;67;3886.00;98
10174;66;625402690;10174;304;11164;11260;6.50;0.40;280.32;11.74;990;67;3887.00;96
10176;66;625402701;10176;333;11229;11387;6.67;0.41;280.36;11.67;1053;67;3888.00;158
10177;66;625402722;10177;320;11232;11388;6.67;0.41;280.40;11.69;1055;67;3889.00;156
10179;66;625402735;10179;310;11243;11388;6.76;0.42;280.39;11.69;1064;67;3890.00;145
10181;66;625402747;10181;312;11251;11388;6.77;0.42;280.43;11.70;1070;67;3891.00;137
10181;66;625402759;10181;310;11257;11388;6.80;0.42;280.43;11.70;1076;67;3892.00;131
10181;66;625402771;10181;301;11261;11388;6.78;0.42;280.43;11.69;1080;67;3893.00;127
10184;66;625402783;10184;301;11267;11388;6.74;0.41;280.51;11.71;1083;67;3894.00;121
10185;66;625402796;10185;302;11270;11388;6.75;0.41;280.49;11.71;1085;67;3895.00;118
10189;66;625402808;10189;302;11275;11389;6.77;0.42;280.52;11.71;1086;67;3896.00;114
10194;66;625402821;10194;314;11280;11390;6.80;0.42;280.62;11.73;1086;67;3897.00;110
10195;66;625402834;10195;313;11283;11390;6.90;0.42;280.60;11.73;1088;67;3898.00;107
10196;66;625402846;10196;314;11286;11391;6.88;0.42;280.64;11.75;1090;67;3899.00;105
10198;66;625402862;10198;325;11292;11406;6.81;0.42;280.67;11.74;1094;67;3900.00;114
10200;66;625402880;10200;326;11292;11406;6.75;0.42;280.70;11.74;1092;67;3901.00;114
10202;66;625402893;10202;328;11296;11406;6.67;0.41;280.75;11.76;1094;67;3902.00;110
10205;66;625402906;10205;330;11299;11410;6.65;0.41;280.71;11.76;1094;67;3903.00;111
10207;66;625402919;10207;335;11303;11410;6.62;0.41;280.71;11.78;1096;67;3904.00;107
10209;66;625402932;10209;340;11303;11410;6.59;0.40;280.74;11.78;1094;67;3905.00;107
10213;66;625402950;10213;351;11307;11413;6.50;0.40;280.70;11.77;1094;67;3906.00;106
10218;66;625402963;10218;356;11309;11413;6.40;0.39;280.78;11.79;1091;67;3907.00;104
10221;66;625402977;10221;363;11310;11413;6.29;0.39;280.79;11.79;1089;67;3908.00;103
10227;66;625402994;10227;367;11315;11417;6.20;0.38;280.82;11.80;1088;67;3909.00;102
10232;66;625403021;10232;357;11316;11418;6.17;0.38;280.86;11.79;1084;67;3910.00;102
10236;66;625403043;10236;358;11316;11418;6.13;0.38;280.87;11.79;1080;67;3911.00;102
10240;66;625403064;10240;347;11321;11422;6.15;0.38;280.88;11.80;1081;67;3912.00;101
10245;66;625403085;10245;348;11323;11422;6.16;0.38;280.93;11.80;1078;67;3913.00;99
10248;66;625403103;10248;345;11323;11422;6.22;0.38;280.95;11.80;1075;67;3914.00;99
10250;67;625403117;10250;346;11327;11424;6.23;0.38;281.01;11.81;1077;68;3915.00;97
10255;67;625403146;10255;343;11327;11424;6.18;0.38;281.10;11.81;1072;68;3916.00;97
10257;67;625403160;10257;334;11332;11430;6.20;0.38;281.16;11.82;1075;68;3917.00;98
10263;67;625403182;10263;330;11333;11430;6.19;0.38;281.19;11.82;1070;68;3918.00;97
10269;67;625403196;10269;329;11334;11431;6.22;0.38;281.29;11.82;1065;68;3919.00;97
10270;67;625403215;10270;325;11336;11431;6.28;0.38;281.30;11.83;1066;68;3920.00;95
10276;67;625403229;10276;330;11336;11431;6.30;0.39;281.48;11.83;1060;68;3921.00;95
10279;67;625403242;10279;325;11336;11431;6.35;0.39;281.53;11.83;1057;68;3922.00;95
10282;67;625403256;10282;329;11336;11431;6.39;0.39;281.54;11.83;1054;68;3923.00;95
10286;67;625403269;10286;333;11346;11443;6.43;0.39;281.58;11.82;1060;68;3924.00;97
10293;67;625403290;10293;339;11347;11443;6.40;0.39;281.67;11.82;1054;68;3925.00;96
10296;67;625403304;10296;339;11347;11443;6.45;0.39;281.65;11.82;1051;68;3926.00;96
10300;67;625403317;10300;336;11347;11443;6.50;0.40;281.71;11.82;1047;68;3927.00;96
10303;67;625403331;10303;338;11347;11443;6.63;0.41;281.79;11.82;1044;68;3928.00;96
10306;67;625403345;10306;331;11347;11443;6.67;0.41;281.79;11.82;1041;68;3929.00;96
10309;67;625403360;10309;328;11352;11447;6.64;0.41;281.88;11.82;1043;68;3930.00;95
10312;67;625403374;10312;332;11353;11447;6.65;0.41;281.89;11.82;1041;68;3931.00;94
10317;67;625403389;10317;331;11355;11451;6.66;0.41;281.89;11.82;1038;68;3932.00;96
10323;67;625403404;10323;331;11358;11452;6.65;0.41;281.97;11.82;1035;68;3933.00;94
10328;67;625403417;10328;328;11358;11452;6.65;0.41;281.98;11.82;1030;68;3934.00;94
10332;67;625403431;10332;335;11358;11452;6.61;0.40;281.98;11.82;1026;68;3935.00;94
10338;67;625403445;10338;334;11368;11465;6.55;0.40;282.03;11.81;1030;68;3936.00;97
10342;67;625403461;10342;337;11369;11465;6.55;0.40;281.98;11.81;1027;68;3937.00;96
10343;67;625403475;10343;339;11369;11465;6.58;0.40;282.00;11.81;1026;68;3938.00;96
10345;67;625403487;10345;333;11371;11466;6.67;0.41;282.01;11.81;1026;68;3939.00;95
10347;67;625403501;10347;331;11372;11467;6.76;0.41;281.97;11.81;1025;68;3940.00;95
10350;67;625403515;10350;326;11373;11467;6.77;0.41;282.05;11.81;1023;68;3941.00;94
10354;67;625403532;10354;324;11376;11470;6.85;0.42;282.11;11.81;1022;68;3942.00;94
10355;67;625403547;10355;323;11377;11470;6.86;0.42;282.11;11.81;1022;68;3943.00;93
10361;67;625403562;10361;324;11378;11470;6.86;0.42;282.32;11.81;1017;68;3944.00;92
10365;67;625403576;10365;328;11378;11470;6.82;0.42;282.41;11.81;1013;68;3945.00;92
10370;67;625403591;10370;332;11382;11476;6.87;0.42;282.47;11.81;1012;68;3946.00;94
10377;67;625403606;10377;339;11382;11476;6.85;0.42;282.55;11.81;1005;68;3947.00;94
10382;67;625403620;10382;345;11383;11476;6.88;0.42;282.65;11.81;1001;68;3948.00;93
10386;67;625403634;10386;350;11383;11476;6.89;0.42;282.71;11.81;997;68;3949.00;93
10390;67;625403647;10390;356;11387;11480;6.90;0.42;282.72;11.80;997;68;3950.00;93
10392;67;625403662;10392;353;11388;11481;6.88;0.42;282.74;11.80;996;68;3951.00;93
10394;67;625403675;10394;353;11388;11481;6.82;0.42;282.74;11.80;994;68;3952.00;93
10400;67;625403689;10400;355;11389;11482;6.73;0.41;282.83;11.80;989;68;3953.00;93
10406;67;625403703;10406;361;11389;11482;6.62;0.40;282.89;11.80;983;68;3954.00;93
10406;67;625403717;10406;365;11389;11482;6.56;0.40;282.89;11.80;983;68;3955.00;93
10410;67;625403729;10410;375;11389;11482;6.46;0.39;282.92;11.80;979;68;3956.00;93
10412;67;625403744;10412;363;11389;11482;6.43;0.39;282.92;11.80;977;68;3957.00;93
10420;67;625403756;10420;359;11389;11482;6.32;0.39;283.06;11.80;969;68;3958.00;93
10423;67;625403770;10423;358;11389;11482;6.26;0.38;283.11;11.80;966;68;3959.00;93
10427;67;625403785;10427;380;11461;11607;6.35;0.39;283.06;11.73;1034;68;3960.00;146
10431;67;625403808;10431;368;11463;11608;6.36;0.39;283.11;11.73;1032;68;3961.00;145
10433;67;625403822;10433;353;11467;11608;6.42;0.40;283.11;11.72;1034;68;3962.00;141
10439;67;625403837;10439;347;11472;11608;6.49;0.40;283.17;11.72;1033;68;3963.00;136
10440;67;625403850;10440;342;11476;11608;6.55;0.40;283.24;11.72;1036;68;3964.00;132
10442;67;625403870;10442;338;11480;11608;6.63;0.41;283.33;11.71;1038;68;3965.00;128
10445;67;625403883;10445;328;11483;11608;6.71;0.41;283.38;11.71;1038;68;3966.00;125
10448;67;625403900;10448;317;11484;11608;6.77;0.42;283.38;11.71;1036;68;3967.00;124
10450;67;625403915;10450;312;11488;11609;6.82;0.42;283.45;11.71;1038;68;3968.00;121
10451;67;625403929;10451;308;11488;11610;6.87;0.42;283.47;11.71;1037;68;3969.00;122
10453;67;625403949;10453;307;11490;11610;6.87;0.42;283.52;11.71;1037;68;3970.00;120
10457;67;625403964;10457;302;11495;11614;6.89;0.42;283.56;11.71;1038;68;3971.00;119
10460;67;625403979;10460;299;11497;11614;6.90;0.43;283.62;11.71;1037;68;3972.00;117
10466;67;625403996;10466;303;11498;11614;6.87;0.42;283.65;11.71;1032;68;3973.00;116
10469;67;625404017;10469;303;11499;11614;6.89;0.42;283.66;11.71;1030;68;3974.00;115
10472;67;625404038;10472;305;11504;11620;6.90;0.42;283.70;11.70;1032;68;3975.00;116
10477;67;625404052;10477;307;11504;11620;6.88;0.42;283.75;11.70;1027;68;3976.00;116
10479;67;625404066;10479;296;11504;11620;6.91;0.42;283.77;11.70;1025;68;3977.00;116
10482;67;625404080;10482;290;11507;11623;6.94;0.42;283.82;11.70;1025;68;3978.00;116
10486;67;625404094;10486;291;11507;11623;7.01;0.43;283.85;11.70;1021;68;3979.00;116
10490;67;625404107;10490;296;11507;11623;7.03;0.43;283.88;11.70;1017;68;3980.00;116
10492;67;625404121;10492;290;11507;11624;7.09;0.43;283.86;11.70;1015;68;3981.00;117
10492;67;625404134;10492;287;11508;11625;7.19;0.44;283.86;11.70;1016;68;3982.00;117
10494;68;625404147;10494;281;11508;11625;7.27;0.44;283.85;11.70;1014;69;3983.00;117
10498;68;625404171;10498;280;11518;11638;7.25;0.44;283.89;11.69;1020;69;3984.00;120
10502;68;625404186;10502;285;11518;11638;7.24;0.44;283.89;11.69;1016;69;3985.00;120
10506;68;625404199;10506;290;11518;11638;7.17;0.44;283.86;11.69;1012;69;3986.00;120
10507;68;625404212;10507;285;11519;11639;7.12;0.43;283.88;11.69;1012;69;3987.00;120
10508;68;625404225;10508;286;11519;11639;7.03;0.43;283.87;11.69;1011;69;3988.00;120
10508;68;625404238;10508;288;11522;11643;7.04;0.43;283.87;11.68;1014;69;3989.00;121
10509;68;625404253;10509;295;11522;11643;7.04;0.43;283.86;11.68;1013;69;3990.00;121
10513;68;625404266;10513;295;11526;11647;6.95;0.42;283.83;11.68;1013;69;3991.00;121
10514;68;625404279;10514;290;11526;11647;6.90;0.42;283.84;11.68;1012;69;3992.00;121
10515;68;625404291;10515;292;11526;11647;6.90;0.42;283.83;11.68;1011;69;3993.00;121
10517;68;625404303;10517;299;11526;11647;6.90;0.42;283.80;11.68;1009;69;3994.00;121
10518;68;625404316;10518;301;11526;11647;6.86;0.42;283.80;11.68;1008;69;3995.00;121
10519;68;625404328;10519;306;11536;11659;6.81;0.42;283.77;11.67;1017;69;3996.00;123
10521;68;625404341;10521;311;11536;11659;6.71;0.41;283.75;11.67;1015;69;3997.00;123
10521;68;625404353;10521;312;11537;11659;6.63;0.41;283.75;11.67;1016;69;3998.00;122
10523;68;625404364;10523;318;11537;11659;6.51;0.40;283.71;11.67;1014;69;3999.00;122
10528;68;625404376;10528;315;11537;11659;6.42;0.39;283.84;11.67;1009;69;4000.00;122
10532;68;625404392;10532;316;11537;11659;6.33;0.39;283.82;11.67;1005;69;4001.00;122
10533;68;625404404;10533;321;11537;11660;6.31;0.39;283.80;11.67;1004;69;4002.00;123
10537;68;625404415;10537;313;11537;11660;6.25;0.38;283.75;11.67;1000;69;4003.00;123
10543;68;625404429;10543;313;11541;11666;6.15;0.38;283.72;11.66;998;69;4004.00;125
10545;68;625404441;10545;310;11544;11668;6.09;0.37;283.70;11.66;999;69;4005.00;124
10548;68;625404453;10548;310;11544;11668;6.07;0.37;283.67;11.66;996;69;4006.00;124
10550;68;625404464;10550;299;11544;11668;6.06;0.37;283.69;11.66;994;69;4007.00;124
10554;68;625404476;10554;300;11547;11672;6.06;0.37;283.68;11.66;993;69;4008.00;125
10557;68;625404487;10557;300;11547;11672;6.05;0.37;283.67;11.66;990;69;4009.00;125
10559;68;625404498;10559;302;11547;11672;6.01;0.37;283.67;11.66;988;69;4010.00;125
10563;68;625404509;10563;309;11548;11673;5.92;0.36;283.62;11.66;985;69;4011.00;125
10564;68;625404520;10564;305;11551;11677;5.94;0.36;283.60;11.66;987;69;4012.00;126
10564;68;625404531;10564;302;11551;11677;5.93;0.36;283.60;11.66;987;69;4013.00;126
10565;68;625404541;10565;295;11553;11680;5.96;0.36;283.61;11.65;988;69;4014.00;127
10567;68;625404552;10567;294;11557;11680;5.94;0.36;283.64;11.77;990;69;4015.00;123
10569;68;625404564;10569;291;11557;11680;5.93;0.36;283.63;11.77;988;69;4016.00;123
10570;68;625404574;10570;296;11557;11680;5.87;0.36;283.64;11.77;987;69;4017.00;123
10573;68;625404584;10573;296;11561;11684;5.87;0.36;283.63;11.87;988;69;4018.00;123
10577;68;625404596;10577;282;11561;11684;5.87;0.36;283.62;11.87;984;69;4019.00;123
10579;68;625404608;10579;267;11563;11684;5.92;0.36;283.58;11.96;984;69;4020.00;121
10582;68;625404620;10582;260;11563;11684;5.92;0.36;283.59;11.96;981;69;4021.00;121
10585;68;625404631;10585;257;11563;11685;5.93;0.36;283.66;11.96;978;69;4022.00;122
10585;68;625404643;10585;245;11564;11686;6.01;0.36;283.66;11.96;979;69;4023.00;122
10587;68;625404653;10587;242;11565;11686;6.02;0.37;283.66;12.06;978;69;4024.00;121
10587;69;625404664;10587;244;11566;11687;6.12;0.37;283.66;12.06;979;70;4025.00;121
10587;69;625404693;10587;242;11567;11687;6.19;0.38;283.66;12.16;980;70;4026.00;120
10591;69;625404705;10591;243;11568;11687;6.17;0.37;283.66;12.16;977;70;4027.00;119
10592;69;625404722;10592;233;11569;11687;6.19;0.38;283.65;12.26;977;70;4028.00;118
10593;69;625404736;10593;232;11569;11687;6.25;0.38;283.66;12.26;976;70;4029.00;118
10594;69;625404748;10594;227;11569;11687;6.33;0.38;283.65;12.26;975;70;4030.00;118
10595;69;625404759;10595;222;11570;11687;6.36;0.38;283.64;12.36;975;70;4031.00;117
10595;69;625404772;10595;235;11636;11814;6.68;0.41;283.64;12.29;1041;70;4032.00;178
10596;69;625404796;10596;237;11638;11815;6.76;0.41;283.64;12.28;1042;70;4033.00;177
10598;69;625404815;10598;228;11647;11815;6.84;0.42;283.62;12.28;1049;70;4034.00;168
10600;69;625404828;10600;228;11652;11815;6.89;0.42;283.61;12.27;1052;70;4035.00;163
10601;69;625404840;10601;228;11656;11815;6.97;0.43;283.62;12.27;1055;70;4036.00;159
10603;69;625404853;10603;234;11659;11815;6.98;0.43;283.61;12.27;1056;70;4037.00;156
10604;69;625404866;10604;232;11663;11815;7.04;0.43;283.62;12.27;1059;70;4038.00;152
10605;69;625404879;10605;230;11665;11815;7.14;0.44;283.60;12.27;1060;70;4039.00;150
10606;69;625404892;10606;224;11670;11816;7.21;0.44;283.63;12.29;1064;70;4040.00;146
10609;69;625404905;10609;227;11673;11817;7.23;0.44;283.63;12.29;1064;70;4041.00;144
10613;69;625404918;10613;233;11676;11817;7.25;0.44;283.69;12.30;1063;70;4042.00;141
10614;69;625404931;10614;231;11681;11818;7.25;0.44;283.68;12.31;1067;70;4043.00;137
10614;69;625404945;10614;235;11683;11818;7.26;0.44;283.68;12.31;1069;70;4044.00;135
10616;69;625404959;10616;241;11687;11818;7.29;0.45;283.73;12.31;1071;70;4045.00;131
10617;69;625404973;10617;249;11692;11818;7.24;0.44;283.78;12.35;1075;70;4046.00;126
10619;69;625404986;10619;252;11696;11822;7.20;0.44;283.81;12.35;1077;70;4047.00;126
10623;69;625405009;10623;255;11697;11822;7.13;0.44;283.98;12.35;1074;70;4048.00;125
10624;69;625405032;10624;261;11699;11822;7.06;0.43;284.02;12.37;1075;70;4049.00;123
10626;69;625405054;10626;264;11703;11828;7.03;0.43;284.08;12.37;1077;70;4050.00;125
10630;69;625405076;10630;264;11704;11828;7.00;0.43;284.12;12.38;1074;70;4051.00;124
10633;69;625405097;10633;271;11706;11828;6.97;0.42;284.16;12.39;1073;70;4052.00;122
10635;69;625405113;10635;279;11711;11832;6.93;0.42;284.19;12.41;1076;70;4053.00;121
10638;69;625405128;10638;284;11714;11833;6.85;0.42;284.24;12.42;1076;70;4054.00;119
10641;69;625405142;10641;289;11715;11833;6.81;0.42;284.22;12.43;1074;70;4055.00;118
10643;69;625405156;10643;290;11719;11837;6.79;0.42;284.28;12.43;1076;70;4056.00;118
10647;69;625405171;10647;299;11722;11837;6.66;0.41;284.31;12.45;1075;70;4057.00;115
10648;69;625405185;10648;308;11724;11837;6.54;0.40;284.32;12.46;1076;70;4058.00;113
10652;69;625405199;10652;317;11727;11838;6.45;0.39;284.43;12.47;1075;70;4059.00;111
10655;69;625405213;10655;318;11729;11838;6.33;0.39;284.43;12.48;1074;70;4060.00;109
10656;69;625405226;10656;324;11734;11844;6.29;0.38;284.42;12.49;1078;70;4061.00;110
10658;69;625405239;10658;330;11734;11844;6.23;0.38;284.48;12.49;1076;70;4062.00;110
10662;69;625405253;10662;325;11736;11845;6.22;0.38;284.54;12.50;1074;70;4063.00;109
10664;69;625405267;10664;324;11737;11845;6.18;0.38;284.56;12.51;1073;70;4064.00;108
10668;69;625405279;10668;337;11739;11845;6.13;0.37;284.59;12.51;1071;70;4065.00;106
10670;69;625405292;10670;333;11740;11845;6.11;0.37;284.60;12.52;1070;70;4066.00;105
10673;69;625405305;10673;332;11740;11845;6.06;0.37;284.61;12.52;1067;70;4067.00;105
10675;69;625405319;10675;330;11750;11857;6.14;0.38;284.62;12.51;1075;70;4068.00;107
10676;69;625405332;10676;329;11753;11857;6.14;0.38;284.67;12.53;1077;70;4069.00;104
10679;69;625405346;10679;327;11754;11857;6.11;0.37;284.69;12.53;1075;70;4070.00;103
10684;69;625405358;10684;325;11756;11857;6.07;0.37;284.69;12.54;1072;70;4071.00;101
10687;69;625405370;10687;321;11757;11857;6.05;0.37;284.73;12.55;1070;70;4072.00;100
10690;69;625405383;10690;320;11758;11857;6.00;0.37;284.83;12.55;1068;70;4073.00;99
10690;69;625405395;10690;314;11762;11861;5.93;0.36;284.83;12.55;1072;70;4074.00;99
10694;69;625405408;10694;314;11762;11861;5.86;0.36;284.93;12.55;1068;70;4075.00;99
10698;69;625405420;10698;316;11767;11865;5.85;0.36;284.94;12.56;1069;70;4076.00;98
10700;69;625405434;10700;325;11768;11866;5.86;0.36;284.97;12.56;1068;70;4077.00;98
10706;69;625405446;10706;329;11769;11866;5.79;0.36;284.96;12.56;1063;70;4078.00;97
10711;69;625405458;10711;330;11771;11866;5.69;0.35;284.98;12.57;1060;70;4079.00;95
10715;69;625405473;10715;326;11791;11895;5.62;0.35;285.06;12.54;1076;70;4080.00;104
10717;69;625405488;10717;318;11792;11895;5.61;0.35;285.09;12.55;1075;70;4081.00;103
10724;69;625405500;10724;324;11796;11895;5.65;0.35;285.07;12.55;1072;70;4082.00;99
10729;69;625405512;10729;323;11799;11896;5.70;0.35;285.20;12.55;1070;70;4083.00;97
10735;69;625405526;10735;325;11800;11897;5.70;0.35;285.27;12.55;1065;70;4084.00;97
10739;69;625405539;10739;331;11800;11897;5.77;0.35;285.24;12.55;1061;70;4085.00;97
10742;69;625405551;10742;331;11803;11900;5.84;0.36;285.24;12.55;1061;70;4086.00;97
10747;69;625405564;10747;327;11803;11900;5.87;0.36;285.26;12.55;1056;70;4087.00;97
10751;69;625405576;10751;329;11803;11900;5.93;0.36;285.27;12.55;1052;70;4088.00;97
10754;69;625405596;10754;317;11803;11900;5.99;0.37;285.28;12.55;1049;70;4089.00;97
10758;69;625405609;10758;314;11808;11906;6.09;0.37;285.31;12.54;1050;70;4090.00;98
10763;69;625405622;10763;313;11808;11906;6.14;0.37;285.34;12.54;1045;70;4091.00;98
10766;69;625405635;10766;315;11808;11906;6.20;0.38;285.37;12.54;1042;70;4092.00;98
10770;69;625405648;10770;316;11808;11906;6.23;0.38;285.38;12.54;1038;70;4093.00;98
10773;69;625405667;10773;311;11811;11910;6.29;0.38;285.49;12.54;1038;70;4094.00;99
10777;69;625405680;10777;310;11813;11912;6.38;0.39;285.59;12.54;1036;70;4095.00;99
10781;69;625405694;10781;303;11813;11912;6.43;0.39;285.65;12.54;1032;70;4096.00;99
10786;69;625405708;10786;297;11814;11913;6.52;0.40;285.63;12.54;1028;70;4097.00;99
10790;69;625405721;10790;299;11814;11913;6.60;0.40;285.69;12.54;1024;70;4098.00;99
10795;69;625405734;10795;309;11814;11913;6.62;0.40;285.72;12.54;1019;70;4099.00;99
10798;69;625405748;10798;315;11814;11913;6.69;0.41;285.75;12.54;1016;70;4100.00;99
10804;69;625405766;10804;313;11814;11913;6.72;0.41;285.79;12.54;1010;70;4101.00;99
10806;69;625405786;10806;314;11814;11913;6.80;0.42;285.80;12.54;1008;70;4102.00;99
10811;69;625405799;10811;310;11814;11913;6.81;0.42;285.83;12.54;1003;70;4103.00;99
10817;69;625405825;10817;316;11856;11983;6.86;0.42;285.91;12.49;1039;70;4104.00;127
10819;69;625405845;10819;313;11856;11984;6.94;0.42;285.95;12.49;1037;70;4105.00;128
10822;69;625405859;10822;303;11860;11984;7.06;0.43;285.99;12.49;1038;70;4106.00;124
10827;69;625405873;10827;301;11861;11984;7.14;0.44;286.05;12.49;1034;70;4107.00;123
10831;69;625405887;10831;301;11864;11984;7.27;0.45;286.06;12.49;1033;70;4108.00;120
10836;69;625405901;10836;304;11866;11984;7.35;0.45;286.10;12.49;1030;70;4109.00;118
10841;69;625405917;10841;311;11869;11984;7.41;0.45;286.13;12.48;1028;70;4110.00;115
10845;69;625405931;10845;310;11872;11984;7.44;0.45;286.16;12.48;1027;70;4111.00;112
10850;69;625405945;10850;304;11873;11985;7.49;0.46;286.26;12.48;1023;70;4112.00;112
10854;69;625405959;10854;306;11876;11986;7.52;0.46;286.28;12.48;1022;70;4113.00;110
10859;69;625405974;10859;302;11879;11986;7.52;0.46;286.30;12.58;1020;70;4114.00;107
10864;69;625405990;10864;308;11882;11990;7.49;0.46;286.33;12.58;1018;70;4115.00;108
10871;69;625406005;10871;305;11882;11990;7.44;0.45;286.41;12.58;1011;70;4116.00;108
10879;69;625406020;10879;319;11882;11990;7.36;0.45;286.52;12.58;1003;70;4117.00;108
10882;69;625406035;10882;322;11882;11990;7.33;0.45;286.54;12.58;1000;70;4118.00;108
10885;70;625406053;10885;328;11886;11996;7.33;0.45;286.55;12.58;1001;71;4119.00;110
10891;70;625406078;10891;335;11887;11996;7.29;0.44;286.66;12.58;996;71;4120.00;109
10894;70;625406093;10894;334;11889;11996;7.26;0.44;286.69;12.58;995;71;4121.00;107
10895;70;625406106;10895;338;11891;11999;7.24;0.44;286.71;12.57;996;71;4122.00;108
10898;70;625406119;10898;345;11892;11999;7.13;0.43;286.77;12.57;994;71;4123.00;107
10901;70;625406132;10901;352;11893;11999;7.00;0.42;286.79;12.57;992;71;4124.00;106
10905;70;625406146;10905;356;11894;12000;6.87;0.42;286.81;12.57;989;71;4125.00;106
10907;70;625406158;10907;362;11895;12001;6.80;0.41;286.83;12.57;988;71;4126.00;106
10910;70;625406171;10910;356;11895;12001;6.73;0.41;286.85;12.57;985;71;4127.00;106
10913;70;625406186;10913;358;11906;12014;6.75;0.41;286.88;12.56;993;71;4128.00;108
10915;70;625406200;10915;356;11906;12014;6.72;0.41;286.86;12.56;991;71;4129.00;108
10918;70;625406213;10918;354;11906;12014;6.68;0.41;286.84;12.56;988;71;4130.00;108
10920;70;625406226;10920;351;11908;12015;6.64;0.40;286.82;12.66;988;71;4131.00;107
10922;70;625406240;10922;351;11908;12015;6.65;0.40;286.82;12.66;986;71;4132.00;107
10925;70;625406253;10925;357;11911;12019;6.61;0.40;286.89;12.66;986;71;4133.00;108
10928;70;625406267;10928;356;11911;12019;6.57;0.40;286.90;12.66;983;71;4134.00;108
10932;70;625406279;10932;366;11915;12023;6.57;0.40;286.87;12.66;983;71;4135.00;108
10935;70;625406293;10935;352;11915;12023;6.60;0.40;286.93;12.66;980;71;4136.00;108
10938;70;625406305;10938;340;11915;12023;6.62;0.40;286.95;12.66;977;71;4137.00;108
10943;70;625406318;10943;336;11915;12023;6.59;0.40;287.00;12.66;972;71;4138.00;108
10948;70;625406331;10948;333;11915;12023;6.57;0.40;287.04;12.66;967;71;4139.00;108
10950;70;625406346;10950;332;11938;12057;6.58;0.40;287.06;12.63;988;71;4140.00;119
10953;70;625406361;10953;323;11939;12057;6.59;0.40;287.10;12.63;986;71;4141.00;118
10955;70;625406374;10955;319;11941;12057;6.61;0.41;287.09;12.63;986;71;4142.00;116
10956;70;625406386;10956;317;11941;12057;6.65;0.41;287.14;12.63;985;71;4143.00;116
10958;70;625406404;10958;324;11942;12057;6.68;0.41;287.14;12.63;984;71;4144.00;115
10962;70;625406417;10962;323;11942;12057;6.70;0.41;287.18;12.63;980;71;4145.00;115
10963;70;625406429;10963;332;11943;12058;6.78;0.42;287.21;12.63;980;71;4146.00;115
10966;70;625406441;10966;325;11943;12058;6.77;0.41;287.19;12.63;977;71;4147.00;115
10967;70;625406453;10967;322;11947;12064;6.77;0.41;287.17;12.63;980;71;4148.00;117
10969;70;625406466;10969;314;11948;12065;6.76;0.41;287.13;12.62;979;71;4149.00;117
10972;70;625406485;10972;317;11949;12065;6.73;0.41;287.09;12.62;977;71;4150.00;116
10977;70;625406497;10977;313;11949;12065;6.67;0.41;287.02;12.62;972;71;4151.00;116
10980;70;625406510;10980;311;11953;12069;6.63;0.41;286.97;12.62;973;71;4152.00;116
10981;70;625406522;10981;313;11953;12069;6.58;0.40;286.96;12.62;972;71;4153.00;116
10983;70;625406539;10983;312;11953;12069;6.53;0.40;287.01;12.62;970;71;4154.00;116
10985;70;625406551;10985;314;11954;12070;6.47;0.40;286.97;12.62;969;71;4155.00;116
10986;70;625406564;10986;309;11957;12074;6.38;0.39;286.96;12.62;971;71;4156.00;117
10990;70;625406581;10990;320;11957;12074;6.27;0.38;286.92;12.62;967;71;4157.00;117
10991;70;625406593;10991;332;11959;12077;6.25;0.38;286.90;12.61;968;71;4158.00;118
10993;70;625406605;10993;324;11959;12077;6.22;0.38;286.87;12.61;966;71;4159.00;118
10994;70;625406616;10994;327;11960;12077;6.21;0.38;286.88;12.61;966;71;4160.00;117
10995;70;625406628;10995;325;11960;12077;6.20;0.38;286.93;12.61;965;71;4161.00;117
10997;70;625406639;10997;323;11963;12081;6.17;0.38;286.92;12.61;966;71;4162.00;118
10997;70;625406651;10997;327;11963;12081;6.11;0.37;286.92;12.61;966;71;4163.00;118
10998;70;625406662;10998;327;11964;12081;6.06;0.37;286.92;12.61;966;71;4164.00;117
11002;70;625406673;11002;330;11964;12081;5.99;0.37;286.87;12.61;962;71;4165.00;117
11003;70;625406689;11003;338;11964;12082;5.94;0.36;286.87;12.61;961;71;4166.00;118
11004;70;625406699;11004;342;11965;12083;5.91;0.36;286.87;12.61;961;71;4167.00;118
11005;70;625406710;11005;346;11965;12083;5.90;0.36;286.86;12.61;960;71;4168.00;118
11006;70;625406720;11006;344;11967;12084;5.80;0.35;286.85;12.71;961;71;4169.00;117
11008;70;625406733;11008;335;11967;12084;5.71;0.35;286.88;12.71;959;71;4170.00;117
11009;70;625406743;11009;318;11967;12084;5.69;0.35;286.87;12.71;958;71;4171.00;117
11009;70;625406754;11009;308;11967;12084;5.71;0.35;286.87;12.71;958;71;4172.00;117
11010;70;625406764;11010;294;11969;12086;5.69;0.35;286.86;12.71;959;71;4173.00;117
11012;70;625406775;11012;280;11969;12086;5.74;0.35;286.88;12.71;957;71;4174.00;117
11013;70;625406792;11013;269;11969;12086;5.78;0.35;286.87;12.71;956;71;4175.00;117
11015;70;625406803;11015;286;12039;12213;5.93;0.37;286.85;12.64;1024;71;4176.00;174
11016;70;625406824;11016;260;12040;12214;5.97;0.37;286.86;12.64;1024;71;4177.00;174
11020;70;625406835;11020;252;12046;12214;6.03;0.37;286.89;12.63;1026;71;4178.00;168
11021;71;625406852;11021;235;12048;12214;6.13;0.38;286.88;12.63;1027;72;4179.00;166
11025;71;625406875;11025;231;12051;12214;6.15;0.38;286.90;12.63;1026;72;4180.00;163
11027;72;625406886;11027;228;12055;12214;6.21;0.38;286.88;12.63;1028;73;4181.00;159
11028;72;625406908;11028;216;12057;12214;6.32;0.39;286.88;12.62;1029;73;4182.00;157
11029;72;625406919;11029;215;12060;12214;6.45;0.40;286.93;12.62;1031;73;4183.00;154
11030;72;625406936;11030;210;12063;12215;6.53;0.40;286.91;12.62;1033;73;4184.00;152
11031;72;625406948;11031;211;12071;12217;6.64;0.41;286.91;12.73;1040;73;4185.00;146
11033;72;625406961;11033;207;12076;12217;6.69;0.41;286.91;12.73;1043;73;4186.00;141
11035;72;625406974;11035;208;12078;12218;6.71;0.41;286.90;12.73;1043;73;4187.00;140
11038;72;625406986;11038;201;12080;12218;6.78;0.42;286.88;12.73;1042;73;4188.00;138
11039;72;625407004;11039;197;12082;12218;6.85;0.42;286.86;12.73;1043;73;4189.00;136
11042;72;625407033;11042;196;12083;12218;6.88;0.42;286.89;12.73;1041;73;4190.00;135
11044;72;625407054;11044;190;12085;12222;6.94;0.43;286.88;12.73;1041;73;4191.00;137
11047;72;625407072;11047;192;12087;12222;6.93;0.43;286.89;12.73;1040;73;4192.00;135
11051;72;625407091;11051;197;12089;12222;6.96;0.43;286.82;12.73;1038;73;4193.00;133
11052;72;625407109;11052;198;12091;12225;6.99;0.43;286.81;12.73;1039;73;4194.00;134
11056;72;625407123;11056;200;12093;12225;7.00;0.43;286.84;12.73;1037;73;4195.00;132
11056;72;625407137;11056;202;12093;12225;7.03;0.43;286.84;12.73;1037;73;4196.00;132
11057;72;625407152;11057;203;12097;12229;7.09;0.43;286.82;12.73;1040;73;4197.00;132
11061;72;625407167;11061;207;12098;12230;7.12;0.44;286.86;12.72;1037;73;4198.00;132
11062;72;625407190;11062;209;12098;12230;7.15;0.44;286.85;12.72;1036;73;4199.00;132
11067;72;625407206;11067;214;12110;12264;7.10;0.43;286.85;12.81;1043;73;4200.00;154
11069;72;625407229;11069;210;12112;12264;7.10;0.43;286.87;12.81;1043;73;4201.00;152
11070;72;625407243;11070;206;12113;12264;7.12;0.44;286.85;12.91;1043;73;4202.00;151
11074;72;625407257;11074;203;12115;12265;7.13;0.44;286.93;12.91;1041;73;4203.00;150
11078;72;625407278;11078;207;12115;12265;7.13;0.44;286.97;12.91;1037;73;4204.00;150
11082;72;625407293;11082;210;12120;12271;7.24;0.44;286.98;12.91;1038;73;4205.00;151
11084;72;625407308;11084;223;12123;12271;7.24;0.44;286.99;12.91;1039;73;4206.00;148
11088;72;625407323;11088;221;12125;12272;7.23;0.44;287.04;12.91;1037;73;4207.00;147
11090;72;625407337;11090;225;12125;12272;7.29;0.44;287.05;12.91;1035;73;4208.00;147
11095;72;625407351;11095;231;12126;12272;7.32;0.44;287.12;12.93;1031;73;4209.00;146
11097;72;625407366;11097;239;12128;12272;7.36;0.45;287.10;12.94;1031;73;4210.00;144
11099;72;625407381;11099;242;12128;12272;7.44;0.45;287.10;12.94;1029;73;4211.00;144
11104;72;625407395;11104;242;12142;12284;7.49;0.45;287.21;12.96;1038;73;4212.00;142
11107;72;625407410;11107;236;12142;12284;7.55;0.46;287.27;12.96;1035;73;4213.00;142
11107;72;625407431;11107;237;12143;12284;7.62;0.46;287.27;12.97;1036;73;4214.00;141
11112;72;625407446;11112;238;12145;12284;7.66;0.46;287.33;12.98;1033;73;4215.00;139
11115;72;625407461;11115;236;12146;12284;7.69;0.47;287.32;12.99;1031;73;4216.00;138
11116;72;625407476;11116;241;12147;12284;7.70;0.47;287.33;13.00;1031;73;4217.00;137
11119;72;625407490;11119;239;12153;12288;7.68;0.47;287.37;13.01;1034;73;4218.00;135
11121;72;625407505;11121;233;12153;12288;7.67;0.47;287.38;13.01;1032;73;4219.00;135
11123;72;625407520;11123;241;12157;12292;7.68;0.47;287.41;13.02;1034;73;4220.00;135
11126;72;625407534;11126;238;12160;12293;7.67;0.47;287.40;13.05;1034;73;4221.00;133
11130;73;625407549;11130;242;12161;12293;7.60;0.46;287.48;13.06;1031;74;4222.00;132
11132;73;625407575;11132;248;12162;12293;7.57;0.46;287.47;13.07;1030;74;4223.00;131
11136;73;625407589;11136;258;12171;12306;7.49;0.46;287.50;13.08;1035;74;4224.00;135
11140;73;625407605;11140;257;12174;12306;7.44;0.45;287.52;13.08;1034;74;4225.00;132
11142;73;625407619;11142;264;12174;12306;7.39;0.45;287.54;13.08;1032;74;4226.00;132
11144;73;625407633;11144;267;12178;12307;7.38;0.45;287.59;13.10;1034;74;4227.00;129
11147;73;625407648;11147;270;12178;12308;7.35;0.45;287.64;13.10;1031;74;4228.00;130
11148;73;625407662;11148;271;12181;12308;7.28;0.44;287.67;13.11;1033;74;4229.00;127
11151;73;625407678;11151;264;12184;12314;7.24;0.44;287.74;13.11;1033;74;4230.00;130
11154;73;625407693;11154;257;12186;12314;7.20;0.44;287.79;13.13;1032;74;4231.00;128
11157;73;625407708;11157;253;12186;12314;7.19;0.44;287.85;13.13;1029;74;4232.00;128
11160;73;625407722;11160;259;12188;12314;7.19;0.44;287.85;13.14;1028;74;4233.00;126
11163;73;625407735;11163;260;12192;12320;7.16;0.44;287.90;13.14;1029;74;4234.00;128
11166;73;625407749;11166;258;12193;12320;7.17;0.44;287.91;13.15;1027;74;4235.00;127
11167;73;625407762;11167;258;12193;12320;7.16;0.44;287.97;13.15;1026;74;4236.00;127
11169;73;625407775;11169;265;12193;12320;7.14;0.44;288.01;13.15;1024;74;4237.00;127
11171;73;625407788;11171;268;12198;12324;7.08;0.43;288.04;13.16;1027;74;4238.00;126
11174;73;625407802;11174;266;12199;12325;7.05;0.43;288.08;13.16;1025;74;4239.00;126
11177;73;625407816;11177;277;12203;12325;6.94;0.43;288.11;13.17;1026;74;4240.00;122
11178;73;625407829;11178;274;12204;12326;6.93;0.43;288.09;13.17;1026;74;4241.00;122
11185;73;625407841;11185;275;12204;12326;6.84;0.42;288.12;13.17;1019;74;4242.00;122
11188;73;625407854;11188;279;12206;12326;6.77;0.42;288.16;13.18;1018;74;4243.00;120
11192;73;625407867;11192;282;12207;12326;6.70;0.41;288.15;13.19;1015;74;4244.00;119
11196;73;625407880;11196;284;12208;12326;6.62;0.41;288.13;13.19;1012;74;4245.00;118
11202;73;625407893;11202;295;12209;12326;6.46;0.40;288.05;13.20;1007;74;4246.00;117
11205;73;625407905;11205;300;12209;12326;6.31;0.39;288.05;13.20;1004;74;4247.00;117
11210;73;625407917;11210;307;12244;12396;6.23;0.38;288.08;13.17;1034;74;4248.00;152
11214;73;625407936;11214;315;12244;12397;6.08;0.38;288.07;13.17;1030;74;4249.00;153
11216;73;625407949;11216;306;12251;12397;6.08;0.38;288.12;13.18;1035;74;4250.00;146
11222;73;625407961;11222;301;12258;12397;6.01;0.37;288.25;13.18;1036;74;4251.00;139
11224;73;625407975;11224;307;12262;12397;6.03;0.37;288.28;13.18;1038;74;4252.00;135
11227;73;625407988;11227;305;12267;12397;6.00;0.37;288.24;13.19;1040;74;4253.00;130
11231;73;625408001;11231;303;12269;12397;6.01;0.37;288.28;13.19;1038;74;4254.00;128
11235;73;625408014;11235;306;12273;12397;6.00;0.37;288.35;13.20;1038;74;4255.00;124
11238;73;625408028;11238;314;12277;12398;5.95;0.36;288.33;13.21;1039;74;4256.00;121
11241;73;625408042;11241;320;12279;12399;5.95;0.36;288.38;13.21;1038;74;4257.00;120
11245;73;625408055;11245;321;12282;12399;5.95;0.36;288.48;13.22;1037;74;4258.00;117
11249;73;625408067;11249;324;12289;12403;6.01;0.37;288.55;13.22;1040;74;4259.00;114
11253;73;625408081;11253;326;12290;12403;6.07;0.37;288.59;13.22;1037;74;4260.00;113
11255;73;625408094;11255;333;12292;12403;6.11;0.37;288.60;13.23;1037;74;4261.00;111
11260;73;625408107;11260;342;12293;12403;6.11;0.37;288.74;13.33;1033;74;4262.00;110
11265;73;625408120;11265;342;12297;12409;6.11;0.37;288.78;13.33;1032;74;4263.00;112
11271;73;625408133;11271;337;12298;12409;6.16;0.38;288.85;13.33;1027;74;4264.00;111
11274;73;625408146;11274;343;12298;12409;6.16;0.38;288.88;13.33;1024;74;4265.00;111
11280;73;625408158;11280;342;12301;12412;6.16;0.38;288.87;13.33;1021;74;4266.00;111
11283;73;625408171;11283;344;12301;12412;6.14;0.38;288.88;13.33;1018;74;4267.00;111
11290;73;625408183;11290;344;12301;12412;6.10;0.37;288.89;13.33;1011;74;4268.00;111
11294;73;625408195;11294;337;12302;12413;6.13;0.37;288.98;13.33;1008;74;4269.00;111
11298;73;625408207;11298;334;12305;12414;6.12;0.37;288.96;13.33;1007;74;4270.00;109
11301;73;625408219;11301;330;12306;12414;6.11;0.37;288.97;13.33;1005;74;4271.00;108
11303;73;625408238;11303;327;12317;12427;6.12;0.37;288.95;13.32;1014;74;4272.00;110
11307;73;625408259;11307;324;12318;12427;6.12;0.37;288.97;13.32;1011;74;4273.00;109
11313;73;625408271;11313;327;12319;12427;6.14;0.38;288.98;13.33;1006;74;4274.00;108
11316;73;625408283;11316;331;12322;12429;6.17;0.38;289.02;13.32;1006;74;4275.00;107
11324;73;625408295;11324;336;12322;12429;6.17;0.38;289.02;13.32;998;74;4276.00;107
11327;73;625408308;11327;336;12326;12433;6.24;0.38;289.11;13.32;999;74;4277.00;107
11330;73;625408321;11330;337;12327;12433;6.29;0.39;289.20;13.32;997;74;4278.00;106
11336;73;625408334;11336;330;12331;12437;6.34;0.39;289.19;13.32;995;74;4279.00;106
11339;73;625408347;11339;330;12333;12437;6.38;0.39;289.20;13.42;994;74;4280.00;104
11342;73;625408359;11342;328;12334;12437;6.39;0.39;289.26;13.42;992;74;4281.00;103
11346;73;625408378;11346;331;12334;12437;6.41;0.39;289.28;13.42;988;74;4282.00;103
11351;73;625408391;11351;336;12334;12437;6.40;0.39;289.31;13.42;983;74;4283.00;103
11354;73;625408410;11354;329;12344;12449;6.40;0.39;289.33;13.40;990;74;4284.00;105
11356;73;625408423;11356;323;12344;12449;6.40;0.39;289.45;13.40;988;74;4285.00;105
11360;73;625408435;11360;332;12345;12449;6.38;0.39;289.47;13.40;985;74;4286.00;104
11363;73;625408448;11363;340;12345;12449;6.40;0.39;289.45;13.40;982;74;4287.00;104
11363;73;625408461;11363;343;12345;12449;6.41;0.39;289.45;13.40;982;74;4288.00;104
11365;73;625408473;11365;349;12345;12449;6.42;0.39;289.45;13.40;980;74;4289.00;104
11368;73;625408488;11368;353;12345;12450;6.44;0.39;289.45;13.40;977;74;4290.00;105
11371;73;625408500;11371;356;12345;12450;6.43;0.39;289.45;13.40;974;74;4291.00;105
11373;73;625408512;11373;368;12349;12456;6.39;0.39;289.44;13.40;976;74;4292.00;107
11376;73;625408525;11376;378;12351;12457;6.35;0.39;289.44;13.40;975;74;4293.00;106
11377;73;625408537;11377;385;12352;12457;6.31;0.38;289.43;13.50;975;74;4294.00;105
11377;73;625408549;11377;388;12352;12457;6.24;0.38;289.43;13.50;975;74;4295.00;105
11384;73;625408561;11384;400;12355;12461;6.15;0.37;289.41;13.49;971;74;4296.00;106
11388;73;625408574;11388;396;12355;12461;6.04;0.37;289.41;13.49;967;74;4297.00;106
11390;73;625408587;11390;392;12355;12461;6.02;0.37;289.38;13.49;965;74;4298.00;106
11392;73;625408599;11392;391;12356;12462;6.04;0.37;289.33;13.49;964;74;4299.00;106
11395;73;625408612;11395;394;12360;12466;6.03;0.37;289.40;13.59;965;74;4300.00;106
11397;73;625408628;11397;393;12360;12466;6.06;0.37;289.36;13.59;963;74;4301.00;106
11402;73;625408641;11402;397;12362;12469;6.08;0.37;289.32;13.58;960;74;4302.00;107
11404;73;625408653;11404;400;12363;12469;6.10;0.38;289.30;13.58;959;74;4303.00;106
11408;73;625408665;11408;400;12363;12469;6.13;0.38;289.25;13.58;955;74;4304.00;106
11408;73;625408677;11408;405;12363;12469;6.10;0.37;289.25;13.58;955;75;4305.00;106
11412;73;625408698;11412;392;12366;12473;6.10;0.37;289.24;13.58;954;75;4306.00;107
11414;73;625408717;11414;376;12366;12473;6.09;0.37;289.21;13.58;952;75;4307.00;107
11416;73;625408729;11416;363;12367;12473;6.12;0.38;289.19;13.58;951;75;4308.00;106
11420;73;625408741;11420;352;12367;12473;6.13;0.38;289.19;13.58;947;75;4309.00;106
11420;73;625408754;11420;344;12367;12474;6.23;0.38;289.19;13.58;947;75;4310.00;107
11422;73;625408766;11422;330;12368;12475;6.31;0.39;289.17;13.58;946;75;4311.00;107
11427;73;625408779;11427;320;12368;12475;6.35;0.39;289.21;13.58;941;75;4312.00;107
11429;73;625408792;11429;318;12369;12476;6.39;0.39;289.21;13.58;940;75;4313.00;107
11431;73;625408805;11431;313;12369;12476;6.42;0.39;289.22;13.58;938;75;4314.00;107
11432;73;625408819;11432;318;12369;12476;6.45;0.39;289.22;13.58;937;75;4315.00;107
11434;73;625408834;11434;321;12369;12476;6.45;0.39;289.21;13.58;935;75;4316.00;107
11436;73;625408846;11436;315;12369;12476;6.50;0.40;289.20;13.58;933;75;4317.00;107
11437;73;625408859;11437;313;12369;12476;6.50;0.40;289.19;13.58;932;75;4318.00;107
11439;73;625408871;11439;308;12369;12476;6.49;0.39;289.19;13.58;930;75;4319.00;107
11440;73;625408885;11440;355;12480;12706;6.69;0.42;289.20;13.46;1040;75;4320.00;226
11443;73;625408916;11443;342;12483;12707;6.65;0.41;289.18;13.45;1040;75;4321.00;224
11445;73;625408929;11445;331;12493;12707;6.70;0.42;289.17;13.44;1048;75;4322.00;214
11448;73;625408942;11448;313;12498;12707;6.71;0.42;289.20;13.44;1050;75;4323.00;209
11450;73;625408955;11450;304;12504;12707;6.75;0.42;289.20;13.44;1054;75;4324.00;203
11451;73;625408969;11451;293;12510;12707;6.77;0.42;289.20;13.43;1059;75;4325.00;197
11452;73;625408987;11452;286;12515;12707;6.77;0.42;289.22;13.43;1063;75;4326.00;192
11452;73;625409016;11452;280;12520;12707;6.79;0.42;289.22;13.43;1068;75;4327.00;187
11455;73;625409037;11455;275;12525;12708;6.77;0.42;289.21;13.42;1070;75;4328.00;183
11455;73;625409060;11455;274;12528;12709;6.73;0.42;289.21;13.42;1073;75;4329.00;181
11455;73;625409081;11455;273;12533;12709;6.71;0.41;289.21;13.42;1078;75;4330.00;176
11455;73;625409117;11455;283;12534;12710;6.68;0.41;289.21;13.42;1079;75;4331.00;176
11457;73;625409133;11457;288;12539;12710;6.60;0.41;289.20;13.52;1082;75;4332.00;171
11457;73;625409150;11457;282;12543;12710;6.55;0.40;289.20;13.52;1086;75;4333.00;167
11457;73;625409166;11457;288;12544;12710;6.50;0.40;289.20;13.52;1087;75;4334.00;166
11458;73;625409181;11458;296;12549;12714;6.50;0.40;289.28;13.51;1091;75;4335.00;165
11458;73;625409197;11458;298;12549;12714;6.46;0.40;289.28;13.51;1091;75;4336.00;165
11461;73;625409212;11461;304;12552;12714;6.41;0.39;289.28;13.51;1091;75;4337.00;162
11462;73;625409226;11462;307;12555;12717;6.36;0.39;289.28;13.51;1093;75;4338.00;162
11462;73;625409241;11462;314;12556;12717;6.32;0.39;289.28;13.51;1094;75;4339.00;161
11463;73;625409256;11463;315;12556;12717;6.27;0.39;289.26;13.51;1093;75;4340.00;161
11465;73;625409270;11465;312;12559;12721;6.23;0.38;289.25;13.51;1094;75;4341.00;162
11467;73;625409285;11467;315;12560;12722;6.24;0.38;289.25;13.51;1093;75;4342.00;162
11472;73;625409299;11472;308;12562;12722;6.24;0.38;289.25;13.51;1090;75;4343.00;160
11476;73;625409313;11476;313;12564;12726;6.23;0.38;289.32;13.51;1088;75;4344.00;162
11480;73;625409327;11480;310;12565;12726;6.24;0.38;289.30;13.51;1085;75;4345.00;161
11483;73;625409341;11483;305;12565;12726;6.25;0.38;289.29;13.51;1082;75;4346.00;161
11485;73;625409355;11485;305;12567;12727;6.22;0.38;289.39;13.61;1082;75;4347.00;160
11485;73;625409369;11485;306;12568;12727;6.26;0.38;289.39;13.61;1083;75;4348.00;159
11489;73;625409383;11489;301;12571;12733;6.24;0.38;289.38;13.60;1082;75;4349.00;162
11489;73;625409399;11489;291;12573;12733;6.21;0.38;289.38;13.60;1084;75;4350.00;160
11494;73;625409413;11494;285;12573;12734;6.18;0.38;289.40;13.60;1079;75;4351.00;161
11496;73;625409427;11496;278;12574;12734;6.15;0.38;289.43;13.70;1078;75;4352.00;160
11499;73;625409440;11499;277;12575;12734;6.15;0.38;289.46;13.70;1076;75;4353.00;159
11502;73;625409453;11502;271;12576;12734;6.10;0.37;289.45;13.71;1074;75;4354.00;158
11506;73;625409469;11506;263;12577;12734;6.08;0.37;289.54;13.71;1071;75;4355.00;157
11510;73;625409483;11510;258;12587;12746;6.11;0.37;289.56;13.72;1077;75;4356.00;159
11514;73;625409497;11514;259;12588;12746;6.12;0.37;289.54;13.72;1074;75;4357.00;158
11517;73;625409510;11517;254;12590;12746;6.17;0.38;289.61;13.72;1073;75;4358.00;156
11522;73;625409523;11522;241;12591;12746;6.26;0.38;289.66;13.81;1069;75;4359.00;155
11524;73;625409538;11524;239;12592;12746;6.34;0.39;289.71;13.81;1068;75;4360.00;154
11527;73;625409552;11527;236;12593;12746;6.41;0.39;289.72;13.81;1066;75;4361.00;153
11529;73;625409566;11529;232;12598;12750;6.44;0.39;289.70;13.90;1069;75;4362.00;152
11531;73;625409581;11531;228;12598;12750;6.47;0.39;289.71;13.90;1067;75;4363.00;152
11534;73;625409595;11534;222;12601;12754;6.51;0.39;289.72;13.98;1067;75;4364.00;153
11536;73;625409609;11536;221;12605;12756;6.54;0.40;289.75;13.98;1069;75;4365.00;151
11538;73;625409623;11538;221;12605;12756;6.60;0.40;289.79;13.98;1067;75;4366.00;151
11542;73;625409638;11542;229;12605;12756;6.65;0.40;289.85;13.98;1063;75;4367.00;151
11542;73;625409652;11542;234;12616;12769;6.75;0.41;289.85;14.06;1074;75;4368.00;153
11544;73;625409667;11544;233;12616;12769;6.81;0.41;289.85;14.06;1072;75;4369.00;153
11547;73;625409681;11547;239;12617;12769;6.87;0.42;289.83;14.06;1070;75;4370.00;152
11550;73;625409696;11550;239;12618;12770;6.95;0.42;289.88;14.06;1068;75;4371.00;152
11553;73;625409710;11553;246;12618;12771;7.00;0.42;289.95;14.06;1065;75;4372.00;153
11555;73;625409724;11555;252;12619;12771;7.00;0.42;289.95;14.06;1064;75;4373.00;152
11557;73;625409739;11557;247;12621;12774;6.98;0.42;289.96;14.06;1064;75;4374.00;153
11558;73;625409753;11558;255;12621;12774;7.01;0.42;289.96;14.06;1063;75;4375.00;153
11560;73;625409767;11560;263;12624;12774;7.04;0.43;289.95;14.07;1064;75;4376.00;150
11562;73;625409782;11562;258;12625;12774;7.08;0.43;289.95;14.07;1063;75;4377.00;149
11565;73;625409797;11565;266;12629;12780;7.12;0.43;290.01;14.07;1064;75;4378.00;151
11566;73;625409812;11566;263;12630;12780;7.13;0.43;290.06;14.07;1064;75;4379.00;150
11567;73;625409829;11567;265;12633;12780;7.15;0.43;290.08;14.09;1066;75;4380.00;147
11571;73;625409845;11571;260;12634;12780;7.13;0.43;290.12;14.10;1063;75;4381.00;146
11574;73;625409859;11574;261;12638;12784;7.15;0.43;290.07;14.11;1064;75;4382.00;146
11578;73;625409874;11578;268;12642;12785;7.21;0.44;290.07;14.13;1064;75;4383.00;143
11580;73;625409890;11580;265;12643;12785;7.25;0.44;290.13;14.14;1063;75;4384.00;142
11582;73;625409904;11582;265;12646;12786;7.30;0.44;290.14;14.15;1064;75;4385.00;140
11585;73;625409920;11585;270;12650;12786;7.29;0.44;290.18;14.17;1065;75;4386.00;136
11588;73;625409935;11588;273;12650;12786;7.32;0.44;290.24;14.17;1062;75;4387.00;136
11592;73;625409949;11592;274;12652;12786;7.34;0.45;290.25;14.18;1060;75;4388.00;134
11595;73;625409963;11595;274;12653;12786;7.32;0.45;290.31;14.20;1058;75;4389.00;133
11596;73;625409979;11596;272;12653;12786;7.30;0.45;290.34;14.20;1057;75;4390.00;133
11598;73;625409999;11598;281;12655;12786;7.32;0.45;290.37;14.21;1057;75;4391.00;131
11600;73;625410018;11600;288;12691;12856;7.35;0.45;290.42;14.19;1091;75;4392.00;165
11602;73;625410042;11602;296;12694;12857;7.40;0.45;290.45;14.21;1092;75;4393.00;163
11605;73;625410058;11605;289;12705;12857;7.41;0.45;290.47;14.20;1100;75;4394.00;152
11606;73;625410071;11606;299;12706;12857;7.36;0.45;290.49;14.22;1100;75;4395.00;151
11608;73;625410086;11608;306;12713;12857;7.37;0.45;290.51;14.22;1105;75;4396.00;144
11614;73;625410099;11614;308;12719;12857;7.29;0.45;290.54;14.22;1105;75;4397.00;138
11617;73;625410113;11617;309;12727;12857;7.30;0.45;290.51;14.24;1110;75;4398.00;130
11619;73;625410127;11619;306;12729;12857;7.26;0.44;290.53;14.23;1110;75;4399.00;128
11622;73;625410141;11622;305;12732;12858;7.27;0.44;290.53;14.25;1110;75;4400.00;126
11624;73;625410158;11624;304;12734;12859;7.28;0.44;290.53;14.25;1110;75;4401.00;125
11631;73;625410173;11631;303;12735;12859;7.26;0.44;290.47;14.26;1104;75;4402.00;124
11633;73;625410192;11633;300;12739;12863;7.25;0.44;290.51;14.26;1106;75;4403.00;124
11636;73;625410213;11636;301;12740;12863;7.24;0.44;290.53;14.27;1104;75;4404.00;123
11640;73;625410227;11640;301;12741;12863;7.22;0.44;290.54;14.27;1101;75;4405.00;122
11642;73;625410241;11642;300;12741;12863;7.28;0.44;290.56;14.27;1099;75;4406.00;122
11643;73;625410255;11643;302;12747;12869;7.31;0.45;290.58;14.26;1104;75;4407.00;122
11645;73;625410269;11645;305;12748;12869;7.27;0.45;290.60;14.28;1103;75;4408.00;121
11648;73;625410283;11648;308;12749;12869;7.29;0.45;290.68;14.29;1101;75;4409.00;120
11649;73;625410304;11649;312;12755;12875;7.24;0.44;290.68;14.29;1106;75;4410.00;120
11651;73;625410319;11651;317;12755;12875;7.14;0.44;290.73;14.29;1104;75;4411.00;120
11657;73;625410332;11657;324;12758;12875;6.99;0.43;290.80;14.33;1101;75;4412.00;117
11661;73;625410345;11661;334;12759;12876;6.82;0.42;290.88;14.33;1098;75;4413.00;117
11663;73;625410359;11663;337;12761;12877;6.69;0.41;290.91;14.34;1098;75;4414.00;116
11669;73;625410372;11669;348;12761;12877;6.53;0.40;290.92;14.34;1092;75;4415.00;116
11674;73;625410385;11674;358;12772;12890;6.43;0.39;290.91;14.32;1098;75;4416.00;118
11678;73;625410398;11678;360;12773;12890;6.29;0.38;290.94;14.33;1095;75;4417.00;117
11680;73;625410411;11680;370;12773;12890;6.21;0.38;291.01;14.33;1093;75;4418.00;117
11685;73;625410423;11685;380;12776;12891;6.02;0.37;291.04;14.35;1091;75;4419.00;115
11689;73;625410435;11689;363;12777;12891;5.89;0.36;291.10;14.35;1088;75;4420.00;114
11691;73;625410448;11691;355;12780;12895;5.88;0.36;291.10;14.35;1089;75;4421.00;115
11697;73;625410461;11697;359;12782;12895;5.79;0.35;291.15;14.36;1085;75;4422.00;113
11703;73;625410474;11703;358;12784;12899;5.75;0.35;291.21;14.36;1081;75;4423.00;115
11705;73;625410486;11705;367;12787;12899;5.76;0.35;291.23;14.38;1082;75;4424.00;112
11708;73;625410498;11708;363;12788;12899;5.77;0.35;291.30;14.38;1080;75;4425.00;111
11713;73;625410516;11713;362;12788;12899;5.75;0.35;291.40;14.38;1075;75;4426.00;111
11715;73;625410529;11715;358;12788;12899;5.78;0.35;291.46;14.38;1073;75;4427.00;111
11718;73;625410545;11718;356;12802;12911;5.87;0.36;291.49;14.37;1084;75;4428.00;109
11725;73;625410558;11725;347;12802;12911;5.81;0.36;291.60;14.37;1077;75;4429.00;109
11727;73;625410571;11727;343;12802;12911;5.86;0.36;291.59;14.37;1075;75;4430.00;109
11730;73;625410583;11730;339;12804;12911;5.87;0.36;291.60;14.46;1074;75;4431.00;107
11737;73;625410596;11737;326;12804;12911;5.92;0.36;291.63;14.46;1067;75;4432.00;107
11740;73;625410608;11740;329;12804;12911;5.93;0.36;291.66;14.46;1064;75;4433.00;107
11741;73;625410621;11741;333;12804;12912;6.00;0.37;291.68;14.46;1063;75;4434.00;108
11745;73;625410634;11745;338;12804;12912;6.04;0.37;291.71;14.46;1059;75;4435.00;108
11748;73;625410647;11748;336;12808;12918;6.11;0.38;291.77;14.46;1060;75;4436.00;110
11754;73;625410661;11754;345;12810;12919;6.17;0.38;291.81;14.45;1056;75;4437.00;109
11756;73;625410674;11756;346;12810;12919;6.24;0.38;291.81;14.45;1054;75;4438.00;109
11761;73;625410687;11761;356;12810;12919;6.25;0.38;291.83;14.45;1049;75;4439.00;109
11761;73;625410702;11761;358;12814;12924;6.34;0.39;291.83;14.45;1053;75;4440.00;110
11766;73;625410715;11766;365;12814;12924;6.30;0.39;291.81;14.45;1048;75;4441.00;110
11768;73;625410729;11768;365;12814;12924;6.31;0.39;291.78;14.45;1046;75;4442.00;110
11773;73;625410741;11773;370;12815;12925;6.28;0.39;291.77;14.45;1042;75;4443.00;110
11777;73;625410754;11777;374;12818;12929;6.26;0.39;291.73;14.44;1041;75;4444.00;111
11781;73;625410767;11781;378;12818;12929;6.24;0.38;291.76;14.44;1037;75;4445.00;111
11785;73;625410780;11785;377;12820;12932;6.28;0.38;291.72;14.44;1035;75;4446.00;112
11787;73;625410794;11787;383;12821;12932;6.34;0.39;291.72;14.44;1034;75;4447.00;111
11791;73;625410807;11791;387;12821;12932;6.34;0.39;291.72;14.44;1030;75;4448.00;111
11794;73;625410821;11794;388;12821;12932;6.38;0.39;291.70;14.44;1027;75;4449.00;111
11800;73;625410835;11800;391;12824;12936;6.41;0.39;291.64;14.44;1024;75;4450.00;112
11804;73;625410848;11804;393;12824;12936;6.37;0.39;291.65;14.44;1020;75;4451.00;112
11810;73;625410861;11810;393;12825;12936;6.31;0.39;291.60;14.44;1015;75;4452.00;111
11814;73;625410874;11814;396;12825;12936;6.26;0.38;291.65;14.44;1011;75;4453.00;111
11821;73;625410887;11821;403;12825;12937;6.13;0.37;291.60;14.44;1004;75;4454.00;112
11823;73;625410900;11823;406;12827;12939;6.11;0.37;291.58;14.44;1004;75;4455.00;112
11827;73;625410912;11827;399;12827;12939;6.02;0.37;291.55;14.44;1000;75;4456.00;112
11831;73;625410925;11831;403;12828;12940;6.00;0.37;291.50;14.43;997;75;4457.00;112
11835;73;625410938;11835;401;12828;12940;5.98;0.37;291.43;14.43;993;75;4458.00;112
11838;73;625410950;11838;406;12828;12940;5.98;0.36;291.44;14.43;990;75;4459.00;112
11842;73;625410961;11842;409;12828;12940;5.93;0.36;291.40;14.43;986;75;4460.00;112
11845;73;625410974;11845;410;12828;12940;5.93;0.36;291.38;14.43;983;75;4461.00;112
11846;73;625410985;11846;412;12828;12940;5.91;0.36;291.37;14.43;982;75;4462.00;112
11847;73;625410999;11847;411;12828;12940;5.80;0.35;291.37;14.43;981;75;4463.00;112
11848;73;625411018;11848;431;12894;13067;6.20;0.38;291.36;14.36;1046;75;4464.00;173
11853;73;625411055;11853;423;12896;13068;6.12;0.38;291.32;14.36;1043;75;4465.00;172
11857;73;625411073;11857;425;12906;13068;6.19;0.38;291.33;14.35;1049;75;4466.00;162
11859;73;625411094;11859;419;12910;13068;6.23;0.38;291.30;14.35;1051;75;4467.00;158
11861;73;625411111;11861;417;12916;13068;6.32;0.39;291.28;14.34;1055;75;4468.00;152
11861;73;625411126;11861;413;12920;13068;6.34;0.39;291.28;14.34;1059;75;4469.00;148
11863;73;625411142;11863;416;12926;13068;6.31;0.39;291.29;14.33;1063;75;4470.00;142
11863;73;625411157;11863;416;12929;13068;6.28;0.39;291.29;14.33;1066;75;4471.00;139
11863;73;625411172;11863;411;12934;13069;6.22;0.38;291.29;14.42;1071;75;4472.00;135
11863;73;625411187;11863;419;12935;13070;6.18;0.38;291.29;14.42;1072;75;4473.00;135
11864;73;625411202;11864;425;12938;13070;6.16;0.38;291.29;14.42;1074;75;4474.00;132
11864;73;625411217;11864;422;12939;13071;6.14;0.38;291.29;14.42;1075;75;4475.00;132
11866;73;625411238;11866;403;12941;13071;6.12;0.38;291.33;14.42;1075;75;4476.00;130
11868;73;625411254;11868;394;12942;13071;6.14;0.38;291.31;14.42;1074;75;4477.00;129
11868;73;625411270;11868;376;12943;13071;6.25;0.39;291.31;14.42;1075;75;4478.00;128
11869;73;625411284;11869;360;12947;13075;6.35;0.39;291.31;14.42;1078;75;4479.00;128
11869;73;625411299;11869;351;12948;13075;6.43;0.40;291.31;14.42;1079;75;4480.00;127
11870;73;625411316;11870;344;12950;13075;6.50;0.40;291.30;14.42;1080;75;4481.00;125
11872;73;625411337;11872;334;12952;13078;6.60;0.41;291.29;14.42;1080;75;4482.00;126
11873;73;625411352;11873;327;12953;13078;6.74;0.41;291.29;14.42;1080;75;4483.00;125
11874;73;625411368;11874;321;12954;13078;6.85;0.42;291.28;14.42;1080;75;4484.00;124
11875;73;625411397;11875;314;12957;13082;6.93;0.42;291.26;14.41;1082;75;4485.00;125
11879;73;625411412;11879;302;12959;13083;6.99;0.43;291.24;14.41;1080;75;4486.00;124
11881;73;625411434;11881;291;12959;13083;7.02;0.43;291.20;14.41;1078;75;4487.00;124
11882;73;625411450;11882;290;12963;13087;7.13;0.44;291.20;14.41;1081;75;4488.00;124
11885;73;625411468;11885;278;12963;13087;7.21;0.44;291.17;14.41;1078;75;4489.00;124
11888;73;625411484;11888;270;12963;13087;7.22;0.44;291.14;14.41;1075;75;4490.00;124
11890;73;625411500;11890;268;12964;13088;7.25;0.44;291.13;14.41;1074;75;4491.00;124
11891;73;625411516;11891;263;12964;13088;7.27;0.44;291.13;14.41;1073;75;4492.00;124
11892;73;625411531;11892;261;12968;13094;7.33;0.45;291.12;14.40;1076;75;4493.00;126
11894;73;625411549;11894;266;12968;13094;7.32;0.44;291.10;14.40;1074;75;4494.00;126
11897;73;625411564;11897;271;12969;13095;7.27;0.44;291.14;14.40;1072;75;4495.00;126
11902;73;625411580;11902;270;12970;13095;7.18;0.44;291.16;14.50;1068;75;4496.00;125
11903;73;625411596;11903;269;12970;13095;7.14;0.43;291.17;14.50;1067;75;4497.00;125
11907;73;625411611;11907;272;12970;13095;7.12;0.43;291.22;14.50;1063;75;4498.00;125
11910;73;625411632;11910;281;12970;13095;7.07;0.43;291.27;14.50;1060;75;4499.00;125
11915;73;625411650;11915;279;12993;13145;7.03;0.43;291.24;14.47;1078;75;4500.00;152
11918;73;625411674;11918;279;12994;13147;6.99;0.42;291.30;14.47;1076;75;4501.00;153
11919;73;625411690;11919;285;12996;13147;7.05;0.43;291.29;14.47;1077;75;4502.00;151
11923;73;625411704;11923;282;12996;13147;7.06;0.43;291.28;14.47;1073;75;4503.00;151
11925;73;625411718;11925;285;12997;13147;7.09;0.43;291.32;14.47;1072;75;4504.00;150
11927;73;625411733;11927;291;12998;13147;7.13;0.43;291.37;14.47;1071;75;4505.00;149
11928;73;625411747;11928;293;13003;13151;7.15;0.43;291.40;14.46;1075;75;4506.00;148
11928;73;625411762;11928;303;13004;13151;7.13;0.43;291.40;14.46;1076;75;4507.00;147
11930;73;625411777;11930;300;13008;13155;7.09;0.43;291.45;14.46;1078;75;4508.00;147
11934;73;625411792;11934;299;13010;13156;7.07;0.43;291.50;14.46;1076;75;4509.00;146
11935;73;625411807;11935;301;13010;13156;7.03;0.43;291.49;14.46;1075;75;4510.00;146
11938;73;625411823;11938;294;13010;13156;6.98;0.42;291.58;14.46;1072;75;4511.00;146
11941;73;625411837;11941;284;13017;13169;6.89;0.42;291.62;14.45;1076;75;4512.00;152
11944;73;625411853;11944;290;13018;13169;6.81;0.41;291.59;14.45;1074;75;4513.00;151
11947;73;625411874;11947;288;13018;13169;6.78;0.41;291.64;14.45;1071;75;4514.00;151
11949;73;625411889;11949;281;13020;13170;6.80;0.41;291.68;14.45;1071;75;4515.00;150
11950;73;625411903;11950;284;13020;13171;6.84;0.42;291.67;14.45;1070;75;4516.00;151
11954;73;625411918;11954;284;13020;13171;6.87;0.42;291.73;14.45;1066;75;4517.00;151
11957;73;625411932;11957;281;13022;13174;6.88;0.42;291.77;14.45;1065;75;4518.00;152
11962;73;625411947;11962;278;13023;13174;6.84;0.42;291.81;14.45;1061;75;4519.00;151
11965;73;625411961;11965;269;13023;13174;6.88;0.42;291.77;14.45;1058;75;4520.00;151
11970;73;625411976;11970;267;13024;13174;6.84;0.42;291.78;14.45;1054;75;4521.00;150
11975;73;625411989;11975;255;13027;13180;6.78;0.41;291.75;14.44;1052;75;4522.00;153
11978;73;625412005;11978;251;13027;13180;6.77;0.41;291.83;14.44;1049;75;4523.00;153
11983;73;625412019;11983;246;13027;13180;6.76;0.41;291.81;14.44;1044;75;4524.00;153
11988;73;625412033;11988;239;13029;13180;6.66;0.40;291.88;14.46;1041;75;4525.00;151
11994;74;625412048;11994;231;13033;13184;6.58;0.40;291.92;14.47;1039;76;4526.00;151
11996;74;625412073;11996;227;13035;13185;6.59;0.40;291.91;14.47;1039;76;4527.00;150
12001;74;625412086;12001;231;13036;13185;6.60;0.40;291.94;14.57;1035;76;4528.00;149
12005;74;625412100;12005;221;13037;13186;6.71;0.41;291.98;14.57;1032;76;4529.00;149
12006;74;625412121;12006;213;13037;13186;6.82;0.41;292.01;14.57;1031;76;4530.00;149
12009;74;625412134;12009;212;13038;13186;6.87;0.42;292.01;14.57;1029;76;4531.00;148
12009;74;625412147;12009;212;13038;13186;6.95;0.42;292.01;14.57;1029;76;4532.00;148
12013;74;625412160;12013;212;13039;13186;7.01;0.42;292.07;14.57;1026;76;4533.00;147
12015;74;625412172;12015;213;13039;13186;7.06;0.43;292.10;14.57;1024;76;4534.00;147
12017;74;625412186;12017;216;13040;13186;7.17;0.43;292.10;14.57;1023;76;4535.00;146
12017;74;625412199;12017;215;13075;13256;7.23;0.44;292.10;14.53;1058;76;4536.00;181
12019;74;625412219;12019;211;13079;13257;7.26;0.44;292.13;14.54;1060;76;4537.00;178
12022;74;625412232;12022;209;13085;13257;7.31;0.44;292.10;14.53;1063;76;4538.00;172
12024;74;625412246;12024;207;13086;13257;7.28;0.44;292.15;14.53;1062;76;4539.00;171
12029;74;625412260;12029;210;13089;13257;7.31;0.44;292.12;14.53;1060;76;4540.00;168
12030;74;625412274;12030;216;13090;13257;7.35;0.45;292.15;14.53;1060;76;4541.00;167
12034;74;625412288;12034;215;13094;13257;7.42;0.45;292.18;14.53;1060;76;4542.00;163
12038;74;625412301;12038;213;13098;13257;7.42;0.45;292.20;14.53;1060;76;4543.00;159
12043;74;625412315;12043;215;13100;13258;7.42;0.45;292.25;14.53;1057;76;4544.00;158
12043;74;625412329;12043;214;13105;13260;7.53;0.46;292.25;14.53;1062;76;4545.00;155
12047;74;625412343;12047;222;13106;13260;7.54;0.46;292.27;14.53;1059;76;4546.00;154
12050;74;625412358;12050;216;13111;13264;7.53;0.46;292.27;14.53;1061;76;4547.00;153
12051;74;625412372;12051;220;13112;13264;7.55;0.46;292.28;14.53;1061;76;4548.00;152
12054;74;625412386;12054;221;13114;13264;7.58;0.46;292.32;14.54;1060;76;4549.00;150
12056;74;625412400;12056;227;13118;13264;7.59;0.46;292.33;14.55;1062;76;4550.00;146
12059;74;625412415;12059;228;13123;13270;7.62;0.46;292.34;14.55;1064;76;4551.00;147
12062;74;625412429;12062;235;13125;13270;7.59;0.46;292.40;14.56;1063;76;4552.00;145
12064;74;625412443;12064;239;13127;13270;7.62;0.46;292.40;14.57;1063;76;4553.00;143
12067;74;625412457;12067;241;13129;13273;7.70;0.47;292.43;14.57;1062;76;4554.00;144
12071;74;625412472;12071;242;13130;13273;7.71;0.47;292.47;14.57;1059;76;4555.00;143
12073;74;625412486;12073;245;13132;13273;7.71;0.47;292.58;14.59;1059;76;4556.00;141
12074;74;625412500;12074;249;13133;13274;7.68;0.47;292.63;14.59;1059;76;4557.00;141
12077;74;625412514;12077;253;13136;13275;7.66;0.46;292.62;14.61;1059;76;4558.00;139
12080;74;625412528;12080;258;13138;13275;7.61;0.46;292.61;14.62;1058;76;4559.00;137
12082;74;625412544;12082;267;13156;13301;7.53;0.46;292.64;14.60;1074;76;4560.00;145
12085;74;625412559;12085;269;13160;13301;7.56;0.46;292.65;14.62;1075;76;4561.00;141
12089;74;625412573;12089;272;13161;13301;7.56;0.46;292.68;14.62;1072;76;4562.00;140
12091;74;625412587;12091;270;13164;13302;7.60;0.46;292.74;14.63;1073;76;4563.00;138
12094;74;625412600;12094;277;13167;13302;7.55;0.46;292.74;14.66;1073;76;4564.00;135
12098;74;625412614;12098;289;13169;13306;7.49;0.45;292.76;14.66;1071;76;4565.00;137
12099;74;625412629;12099;295;13171;13306;7.42;0.45;292.75;14.66;1072;76;4566.00;135
12102;74;625412642;12102;302;13175;13310;7.31;0.44;292.78;14.67;1073;76;4567.00;135
12104;74;625412655;12104;307;13176;13310;7.23;0.44;292.79;14.67;1072;76;4568.00;134
12106;74;625412668;12106;309;13178;13310;7.14;0.43;292.81;14.70;1072;76;4569.00;132
12107;74;625412681;12107;306;13179;13310;7.08;0.43;292.84;14.70;1072;76;4570.00;131
12113;74;625412694;12113;316;13179;13310;6.95;0.42;292.93;14.70;1066;76;4571.00;131
12115;74;625412707;12115;317;13190;13322;6.96;0.42;292.92;14.69;1075;76;4572.00;132
12118;74;625412720;12118;312;13194;13322;6.83;0.42;292.95;14.74;1076;76;4573.00;128
12120;74;625412733;12120;309;13195;13322;6.76;0.41;292.96;14.73;1075;76;4574.00;127
12122;74;625412745;12122;314;13197;13322;6.70;0.41;292.99;14.76;1075;76;4575.00;125
12123;74;625412758;12123;314;13197;13322;6.72;0.41;293.01;14.76;1074;76;4576.00;125
12124;74;625412771;12124;310;13199;13322;6.72;0.41;293.00;14.78;1075;76;4577.00;123
12125;74;625412784;12125;316;13200;13323;6.73;0.41;293.02;14.78;1075;76;4578.00;123
12128;74;625412796;12128;330;13200;13323;6.71;0.41;293.09;14.78;1072;76;4579.00;123
12128;74;625412809;12128;338;13206;13329;6.70;0.41;293.09;14.79;1078;76;4580.00;123
12133;74;625412821;12133;344;13207;13330;6.59;0.40;293.23;14.79;1074;76;4581.00;123
12137;74;625412834;12137;355;13210;13330;6.43;0.39;293.20;14.81;1073;76;4582.00;120
12141;74;625412846;12141;360;13210;13330;6.28;0.38;293.24;14.81;1069;76;4583.00;120
12148;74;625412858;12148;363;13213;13334;6.20;0.38;293.32;14.81;1065;76;4584.00;121
12152;74;625412870;12152;368;13215;13334;6.03;0.37;293.33;14.82;1063;76;4585.00;119
12155;74;625412882;12155;371;13215;13334;5.88;0.36;293.35;14.82;1060;76;4586.00;119
12162;74;625412893;12162;381;13216;13335;5.71;0.35;293.40;14.82;1054;76;4587.00;119
12163;74;625412905;12163;393;13221;13339;5.56;0.34;293.39;14.83;1058;76;4588.00;118
12167;74;625412917;12167;400;13221;13339;5.42;0.33;293.48;14.83;1054;76;4589.00;118
12169;74;625412931;12169;395;13224;13345;5.39;0.33;293.54;14.83;1055;76;4590.00;121
12171;74;625412944;12171;401;13226;13345;5.34;0.33;293.61;14.85;1055;76;4591.00;119
12174;74;625412955;12174;402;13227;13345;5.35;0.33;293.64;14.85;1053;76;4592.00;118
12177;74;625412966;12177;408;13227;13345;5.35;0.33;293.60;14.85;1050;76;4593.00;118
12181;74;625412977;12181;413;13230;13349;5.36;0.33;293.65;14.84;1049;76;4594.00;119
12185;74;625412989;12185;411;13234;13349;5.35;0.33;293.68;14.87;1049;76;4595.00;115
12189;74;625413004;12189;418;13235;13349;5.38;0.33;293.63;14.87;1046;76;4596.00;114
12194;74;625413022;12194;411;13235;13349;5.33;0.33;293.64;14.87;1041;76;4597.00;114
12197;74;625413047;12197;404;13236;13350;5.30;0.33;293.63;14.87;1039;76;4598.00;114
12200;74;625413066;12200;406;13237;13351;5.30;0.32;293.69;14.87;1037;76;4599.00;114
12201;74;625413086;12201;408;13238;13351;5.30;0.32;293.70;14.87;1037;76;4600.00;113
12204;74;625413113;12204;410;13239;13352;5.26;0.32;293.69;14.87;1035;76;4601.00;113
12208;74;625413126;12208;412;13239;13352;5.21;0.32;293.73;14.87;1031;76;4602.00;113
12210;74;625413139;12210;414;13239;13352;5.17;0.32;293.73;14.87;1029;76;4603.00;113
12214;74;625413152;12214;411;13239;13352;5.16;0.32;293.70;14.87;1025;76;4604.00;113
12219;74;625413165;12219;411;13239;13352;5.13;0.31;293.65;14.87;1020;76;4605.00;113
12225;74;625413178;12225;409;13239;13352;5.12;0.31;293.60;14.87;1014;77;4606.00;113
12227;74;625413200;12227;406;13239;13352;5.16;0.32;293.59;14.87;1012;77;4607.00;113
12233;74;625413212;12233;412;13303;13479;5.53;0.34;293.54;14.79;1070;77;4608.00;176
12234;74;625413237;12234;414;13307;13480;5.56;0.35;293.52;14.79;1073;77;4609.00;173
12239;74;625413249;12239;411;13315;13480;5.63;0.35;293.51;14.78;1076;77;4610.00;165
12241;74;625413262;12241;415;13317;13480;5.64;0.35;293.50;14.78;1076;77;4611.00;163
12242;74;625413280;12242;413;13324;13480;5.69;0.35;293.51;14.77;1082;77;4612.00;156
12245;74;625413293;12245;418;13326;13480;5.67;0.35;293.51;14.77;1081;77;4613.00;154
12248;74;625413306;12248;416;13332;13480;5.73;0.36;293.45;14.77;1084;77;4614.00;148
12252;75;625413319;12252;420;13333;13480;5.69;0.35;293.45;14.77;1081;78;4615.00;147
12257;75;625413344;12257;427;13338;13481;5.69;0.35;293.46;14.77;1081;78;4616.00;143
12260;75;625413357;12260;427;13343;13482;5.72;0.36;293.42;14.87;1083;78;4617.00;139
12265;75;625413383;12265;422;13347;13482;5.72;0.36;293.46;14.87;1082;78;4618.00;135
12268;75;625413399;12268;428;13349;13483;5.71;0.35;293.43;14.86;1081;78;4619.00;134
12270;75;625413415;12270;435;13354;13483;5.74;0.36;293.51;14.86;1084;78;4620.00;129
12274;75;625413428;12274;439;13355;13483;5.74;0.36;293.53;14.86;1081;78;4621.00;128
12276;75;625413442;12276;443;13357;13483;5.75;0.36;293.53;14.86;1081;78;4622.00;126
12280;75;625413456;12280;447;13362;13487;5.78;0.36;293.50;14.86;1082;78;4623.00;125
12285;75;625413471;12285;448;13362;13487;5.76;0.36;293.54;14.86;1077;78;4624.00;125
12289;75;625413485;12289;455;13363;13487;5.77;0.36;293.61;14.86;1074;78;4625.00;124
12293;75;625413499;12293;449;13365;13490;5.76;0.35;293.61;14.86;1072;78;4626.00;125
12295;75;625413512;12295;437;13366;13490;5.75;0.35;293.59;14.86;1071;78;4627.00;124
12300;75;625413532;12300;429;13367;13490;5.73;0.35;293.60;14.86;1067;78;4628.00;123
12302;75;625413547;12302;417;13370;13494;5.79;0.35;293.58;14.85;1068;78;4629.00;124
12304;75;625413567;12304;418;13371;13495;5.86;0.36;293.56;14.85;1067;78;4630.00;124
12306;75;625413582;12306;414;13371;13495;5.90;0.36;293.55;14.85;1065;78;4631.00;124
12309;75;625413596;12309;412;13374;13499;5.99;0.37;293.52;14.85;1065;78;4632.00;125
12310;75;625413611;12310;411;13375;13499;6.02;0.37;293.50;14.95;1065;78;4633.00;124
12312;76;625413635;12312;407;13375;13499;6.09;0.37;293.50;14.95;1063;79;4634.00;124
12315;76;625413662;12315;398;13377;13501;6.14;0.38;293.49;14.95;1062;79;4635.00;124
12317;76;625413677;12317;397;13377;13501;6.13;0.38;293.49;14.95;1060;79;4636.00;124
12319;76;625413691;12319;390;13381;13507;6.21;0.38;293.44;14.94;1062;79;4637.00;126
12324;76;625413706;12324;379;13381;13507;6.23;0.38;293.38;14.94;1057;79;4638.00;126
12326;76;625413727;12326;379;13383;13508;6.27;0.38;293.41;15.05;1057;79;4639.00;125
12328;76;625413741;12328;371;13383;13508;6.32;0.39;293.41;15.05;1055;79;4640.00;125
12330;76;625413755;12330;362;13383;13508;6.39;0.39;293.41;15.05;1053;79;4641.00;125
12330;76;625413771;12330;356;13383;13508;6.46;0.39;293.41;15.05;1053;79;4642.00;125
12332;76;625413785;12332;354;13383;13508;6.57;0.40;293.40;15.05;1051;79;4643.00;125
12334;76;625413800;12334;355;13392;13520;6.77;0.41;293.41;15.04;1058;79;4644.00;128
12334;76;625413816;12334;371;13393;13520;6.83;0.42;293.41;15.04;1059;79;4645.00;127
12337;76;625413833;12337;356;13394;13520;6.95;0.42;293.43;15.03;1057;79;4646.00;126
12341;76;625413848;12341;344;13394;13520;7.01;0.43;293.43;15.03;1053;79;4647.00;126
12342;76;625413864;12342;331;13394;13520;7.14;0.43;293.45;15.03;1052;79;4648.00;126
12342;76;625413879;12342;325;13394;13520;7.27;0.44;293.45;15.03;1052;79;4649.00;126
12346;76;625413896;12346;325;13399;13526;7.34;0.45;293.52;15.03;1053;79;4650.00;127
12347;76;625413912;12347;315;13399;13526;7.44;0.45;293.52;15.03;1052;79;4651.00;127
12354;76;625413928;12354;311;13404;13530;7.41;0.45;293.57;15.13;1050;79;4652.00;126
12357;76;625413945;12357;318;13405;13531;7.35;0.45;293.57;15.13;1048;79;4653.00;126
12360;76;625413960;12360;310;13405;13531;7.33;0.45;293.61;15.13;1045;79;4654.00;126
12360;76;625413982;12360;318;13405;13531;7.35;0.45;293.61;15.13;1045;79;4655.00;126
12363;76;625413997;12363;321;13416;13544;7.38;0.45;293.67;15.12;1053;79;4656.00;128
12364;76;625414015;12364;317;13416;13544;7.41;0.45;293.66;15.12;1052;79;4657.00;128
12367;76;625414030;12367;311;13416;13544;7.42;0.45;293.68;15.12;1049;79;4658.00;128
12369;76;625414046;12369;308;13417;13545;7.47;0.45;293.69;15.11;1048;79;4659.00;128
12374;76;625414061;12374;302;13417;13546;7.45;0.45;293.70;15.11;1043;79;4660.00;129
12378;76;625414076;12378;299;13417;13546;7.44;0.45;293.73;15.11;1039;79;4661.00;129
12384;76;625414090;12384;290;13419;13549;7.43;0.45;293.75;15.11;1035;79;4662.00;130
12385;76;625414106;12385;292;13420;13549;7.42;0.45;293.77;15.11;1035;79;4663.00;129
12388;76;625414119;12388;291;13420;13549;7.39;0.45;293.77;15.11;1032;79;4664.00;129
12390;76;625414133;12390;294;13420;13549;7.39;0.45;293.82;15.11;1030;79;4665.00;129
12393;76;625414146;12393;299;13424;13555;7.40;0.45;293.79;15.11;1031;79;4666.00;131
12397;76;625414160;12397;299;13424;13555;7.32;0.44;293.85;15.11;1027;79;4667.00;131
12401;76;625414174;12401;302;13425;13555;7.25;0.44;293.94;15.11;1024;79;4668.00;130
12403;76;625414188;12403;310;13425;13555;7.17;0.43;293.98;15.11;1022;79;4669.00;130
12405;76;625414201;12405;310;13428;13559;7.08;0.43;294.03;15.10;1023;79;4670.00;131
12407;76;625414215;12407;316;13429;13560;7.04;0.43;294.04;15.10;1022;79;4671.00;131
12409;76;625414228;12409;322;13429;13560;6.97;0.42;294.06;15.10;1020;79;4672.00;131
12410;76;625414241;12410;322;13430;13561;6.94;0.42;294.09;15.10;1020;79;4673.00;131
12412;76;625414254;12412;328;13430;13561;6.88;0.42;294.14;15.10;1018;79;4674.00;131
12413;76;625414268;12413;334;13430;13561;6.80;0.41;294.15;15.10;1017;79;4675.00;131
12419;76;625414281;12419;333;13430;13561;6.69;0.41;294.20;15.10;1011;79;4676.00;131
12420;76;625414300;12420;332;13430;13561;6.65;0.40;294.24;15.10;1010;79;4677.00;131
12423;76;625414313;12423;334;13430;13561;6.58;0.40;294.38;15.10;1007;79;4678.00;131
12425;76;625414327;12425;331;13431;13561;6.59;0.40;294.40;15.21;1006;79;4679.00;130
12427;76;625414342;12427;350;13495;13686;6.61;0.41;294.47;15.14;1068;79;4680.00;191
12429;76;625414370;12429;337;13497;13687;6.63;0.41;294.50;15.13;1068;79;4681.00;190
12429;76;625414386;12429;318;13505;13687;6.71;0.41;294.50;15.13;1076;79;4682.00;182
12430;76;625414400;12430;312;13507;13687;6.74;0.41;294.50;15.12;1077;79;4683.00;180
12433;76;625414415;12433;299;13509;13687;6.77;0.41;294.54;15.12;1076;79;4684.00;178
12436;76;625414429;12436;294;13513;13687;6.80;0.42;294.60;15.12;1077;79;4685.00;174
12438;76;625414443;12438;295;13519;13687;6.84;0.42;294.62;15.11;1081;79;4686.00;168
12442;76;625414457;12442;301;13523;13687;6.79;0.42;294.70;15.11;1081;79;4687.00;164
12444;76;625414470;12444;300;13526;13688;6.81;0.42;294.71;15.11;1082;79;4688.00;162
12446;76;625414484;12446;294;13528;13689;6.76;0.41;294.74;15.11;1082;79;4689.00;161
12450;76;625414497;12450;290;13529;13689;6.68;0.41;294.82;15.11;1079;79;4690.00;160
12452;76;625414510;12452;300;13533;13693;6.62;0.41;294.83;15.10;1081;79;4691.00;160
12454;76;625414524;12454;297;13534;13693;6.58;0.40;294.89;15.10;1080;79;4692.00;159
12458;76;625414537;12458;286;13534;13693;6.49;0.40;294.94;15.10;1076;79;4693.00;159
12459;76;625414550;12459;282;13536;13693;6.44;0.39;294.94;15.21;1077;79;4694.00;157
12463;76;625414568;12463;280;13541;13699;6.35;0.39;295.02;15.23;1078;79;4695.00;158
12467;76;625414584;12467;279;13541;13699;6.32;0.39;295.04;15.23;1074;79;4696.00;158
12471;76;625414597;12471;276;13542;13699;6.29;0.38;295.08;15.23;1071;79;4697.00;157
12474;76;625414610;12474;270;13545;13702;6.35;0.39;295.07;15.23;1071;79;4698.00;157
12476;76;625414624;12476;274;13546;13702;6.43;0.39;295.07;15.23;1070;79;4699.00;156
12480;76;625414638;12480;277;13546;13702;6.44;0.39;295.20;15.23;1066;79;4700.00;156
12482;76;625414655;12482;277;13546;13703;6.48;0.40;295.28;15.23;1064;79;4701.00;157
12487;76;625414669;12487;279;13548;13704;6.52;0.40;295.35;15.33;1061;79;4702.00;156
12490;76;625414683;12490;275;13548;13704;6.54;0.40;295.36;15.33;1058;79;4703.00;156
12496;76;625414696;12496;277;13557;13717;6.55;0.40;295.32;15.32;1061;79;4704.00;160
12497;76;625414712;12497;279;13558;13717;6.62;0.40;295.34;15.42;1061;79;4705.00;159
12499;76;625414725;12499;273;13558;13717;6.71;0.41;295.37;15.42;1059;79;4706.00;159
12505;76;625414738;12505;275;13561;13718;6.75;0.41;295.42;15.42;1056;79;4707.00;157
12506;76;625414752;12506;267;13562;13718;6.81;0.41;295.44;15.52;1056;79;4708.00;156
12512;76;625414766;12512;270;13565;13722;6.82;0.41;295.47;15.52;1053;79;4709.00;157
12515;76;625414782;12515;278;13565;13722;6.85;0.42;295.51;15.52;1050;79;4710.00;157
12517;76;625414796;12517;269;13569;13726;6.86;0.42;295.48;15.51;1052;79;4711.00;157
12519;76;625414810;12519;267;13569;13726;6.98;0.42;295.52;15.51;1050;79;4712.00;157
12520;76;625414824;12520;265;13571;13726;7.08;0.43;295.51;15.51;1051;79;4713.00;155
12520;76;625414838;12520;269;13571;13726;7.17;0.44;295.51;15.51;1051;79;4714.00;155
12521;76;625414851;12521;268;13572;13726;7.20;0.44;295.53;15.52;1051;79;4715.00;154
12523;76;625414865;12523;272;13584;13738;7.26;0.44;295.55;15.50;1061;79;4716.00;154
12525;76;625414879;12525;275;13584;13738;7.20;0.44;295.56;15.50;1059;79;4717.00;154
12530;76;625414893;12530;277;13585;13738;7.12;0.43;295.54;15.50;1055;79;4718.00;153
12533;76;625414906;12533;278;13585;13738;7.06;0.43;295.58;15.50;1052;79;4719.00;153
12536;76;625414920;12536;281;13585;13738;7.03;0.43;295.61;15.50;1049;79;4720.00;153
12538;76;625414934;12538;287;13585;13738;7.01;0.43;295.63;15.50;1047;79;4721.00;153
12542;76;625414947;12542;294;13588;13739;6.94;0.42;295.67;15.53;1046;79;4722.00;151
12542;76;625414961;12542;293;13589;13739;6.94;0.42;295.67;15.55;1047;79;4723.00;150
12544;76;625414979;12544;294;13595;13745;7.02;0.43;295.75;15.57;1051;79;4724.00;150
12548;76;625414993;12548;297;13599;13747;7.00;0.43;295.78;15.58;1051;79;4725.00;148
12548;76;625415010;12548;309;13599;13747;7.05;0.43;295.78;15.58;1051;79;4726.00;148
12552;76;625415029;12552;309;13602;13747;7.01;0.43;295.83;15.62;1050;79;4727.00;145
12554;76;625415051;12554;315;13605;13751;7.01;0.43;295.84;15.61;1051;79;4728.00;146
12555;76;625415083;12555;321;13606;13751;7.01;0.43;295.88;15.63;1051;79;4729.00;145
12557;76;625415102;12557;322;13607;13751;6.97;0.43;295.91;15.64;1050;79;4730.00;144
12560;76;625415119;12560;327;13609;13752;6.94;0.42;295.96;15.65;1049;79;4731.00;143
12562;76;625415134;12562;328;13614;13756;6.90;0.42;296.01;15.67;1052;79;4732.00;142
12563;76;625415150;12563;329;13614;13756;6.91;0.42;295.99;15.67;1051;79;4733.00;142
12565;76;625415164;12565;326;13619;13759;6.91;0.42;296.02;15.69;1054;79;4734.00;140
12566;76;625415180;12566;330;13619;13759;6.89;0.42;296.07;15.69;1053;79;4735.00;140
12568;76;625415193;12568;334;13622;13759;6.92;0.42;296.04;15.71;1054;79;4736.00;137
12569;76;625415208;12569;337;13622;13759;6.89;0.42;296.03;15.71;1053;79;4737.00;137
12573;76;625415221;12573;337;13626;13763;6.84;0.42;296.05;15.72;1053;79;4738.00;137
12573;76;625415235;12573;335;13627;13763;6.82;0.42;296.05;15.73;1054;79;4739.00;136
12579;76;625415251;12579;331;13628;13763;6.77;0.41;296.07;15.73;1049;79;4740.00;135
12582;76;625415265;12582;330;13629;13763;6.71;0.41;296.17;15.74;1047;79;4741.00;134
12585;76;625415278;12585;336;13629;13764;6.67;0.41;296.20;15.74;1044;79;4742.00;135
12589;76;625415301;12589;329;13633;13765;6.61;0.40;296.18;15.77;1044;79;4743.00;132
12591;76;625415315;12591;332;13633;13765;6.60;0.40;296.23;15.77;1042;79;4744.00;132
12594;76;625415328;12594;332;13635;13766;6.59;0.40;296.24;15.77;1041;79;4745.00;131
12595;76;625415343;12595;340;13636;13766;6.61;0.41;296.22;15.78;1041;79;4746.00;130
12599;76;625415356;12599;345;13636;13766;6.63;0.41;296.28;15.78;1037;79;4747.00;130
12602;76;625415370;12602;342;13637;13766;6.66;0.41;296.30;15.78;1035;79;4748.00;129
12604;76;625415384;12604;343;13638;13766;6.68;0.41;296.35;15.79;1034;79;4749.00;128
12606;76;625415398;12606;348;13639;13766;6.65;0.41;296.41;15.80;1033;79;4750.00;127
12609;76;625415411;12609;352;13639;13766;6.64;0.41;296.43;15.80;1030;79;4751.00;127
12613;76;625415425;12613;373;13707;13893;6.83;0.42;296.45;15.74;1094;79;4752.00;186
12615;76;625415451;12615;370;13711;13894;6.78;0.42;296.42;15.73;1096;79;4753.00;183
12619;76;625415465;12619;374;13721;13894;6.74;0.42;296.41;15.74;1102;79;4754.00;173
12620;76;625415480;12620;379;13726;13894;6.73;0.42;296.42;15.73;1106;79;4755.00;168
12626;76;625415493;12626;380;13733;13894;6.62;0.41;296.34;15.73;1107;79;4756.00;161
12631;76;625415506;12631;388;13739;13894;6.48;0.40;296.26;15.74;1108;79;4757.00;155
12634;76;625415520;12634;397;13746;13894;6.35;0.39;296.29;15.73;1112;79;4758.00;148
12638;76;625415533;12638;408;13750;13894;6.22;0.39;296.27;15.74;1112;79;4759.00;144
12642;76;625415548;12642;396;13754;13895;6.12;0.38;296.22;15.74;1112;79;4760.00;141
12644;76;625415563;12644;396;13755;13896;6.02;0.37;296.20;15.74;1111;79;4761.00;141
12648;76;625415584;12648;398;13757;13896;5.92;0.37;296.22;15.75;1109;79;4762.00;139
12652;76;625415598;12652;407;13760;13897;5.87;0.36;296.21;15.75;1108;79;4763.00;137
12655;76;625415612;12655;415;13762;13897;5.82;0.36;296.21;15.76;1107;79;4764.00;135
12657;76;625415627;12657;426;13764;13897;5.78;0.36;296.17;15.76;1107;79;4765.00;133
12660;76;625415641;12660;434;13767;13897;5.72;0.35;296.18;15.77;1107;79;4766.00;130
12664;76;625415654;12664;435;13770;13901;5.66;0.35;296.16;15.77;1106;79;4767.00;131
12667;76;625415667;12667;449;13772;13901;5.61;0.34;296.17;15.77;1105;79;4768.00;129
12669;76;625415680;12669;445;13773;13901;5.59;0.34;296.18;15.77;1104;79;4769.00;128
12669;76;625415694;12669;459;13776;13907;5.59;0.34;296.18;15.77;1107;79;4770.00;131
12674;76;625415708;12674;459;13777;13907;5.56;0.34;296.18;15.77;1103;79;4771.00;130
12677;76;625415721;12677;470;13778;13907;5.54;0.34;296.19;15.77;1101;79;4772.00;129
12681;76;625415734;12681;472;13780;13911;5.52;0.34;296.15;15.76;1099;79;4773.00;131
12687;76;625415747;12687;474;13783;13912;5.45;0.33;296.13;15.76;1096;79;4774.00;129
12688;76;625415760;12688;481;13783;13912;5.41;0.33;296.13;15.76;1095;79;4775.00;129
12690;76;625415773;12690;489;13787;13916;5.43;0.33;296.12;15.76;1097;79;4776.00;129
12693;76;625415786;12693;488;13787;13916;5.39;0.33;296.13;15.76;1094;79;4777.00;129
12694;76;625415798;12694;494;13788;13916;5.38;0.33;296.12;15.76;1094;79;4778.00;128
12696;76;625415810;12696;480;13789;13917;5.39;0.33;296.14;15.75;1093;79;4779.00;128
12699;76;625415823;12699;477;13790;13917;5.43;0.33;296.09;15.75;1091;79;4780.00;127
12703;76;625415836;12703;478;13793;13923;5.43;0.33;296.06;15.75;1090;79;4781.00;130
12706;76;625415849;12706;469;13794;13923;5.47;0.33;296.04;15.75;1088;79;4782.00;129
12709;76;625415862;12709;462;13794;13924;5.50;0.34;296.02;15.75;1085;79;4783.00;130
12713;76;625415876;12713;451;13795;13924;5.56;0.34;296.02;15.75;1082;79;4784.00;129
12715;76;625415889;12715;448;13795;13924;5.62;0.34;296.00;15.75;1080;79;4785.00;129
12718;76;625415902;12718;450;13795;13924;5.64;0.34;295.98;15.75;1077;79;4786.00;129
12720;76;625415917;12720;455;13795;13924;5.73;0.35;295.98;15.75;1075;79;4787.00;129
12723;76;625415930;12723;451;13804;13936;5.86;0.36;295.96;15.74;1081;79;4788.00;132
12727;76;625415954;12727;457;13804;13936;5.92;0.36;295.94;15.74;1077;79;4789.00;132
12730;76;625415967;12730;446;13806;13936;5.98;0.36;295.93;15.74;1076;79;4790.00;130
12732;76;625415989;12732;453;13806;13936;6.03;0.37;295.94;15.74;1074;79;4791.00;130
12732;76;625416004;12732;460;13806;13936;6.08;0.37;295.94;15.74;1074;79;4792.00;130
12734;76;625416024;12734;453;13807;13936;6.09;0.37;295.93;15.84;1073;79;4793.00;129
12739;76;625416039;12739;457;13810;13940;6.15;0.38;295.93;15.84;1071;79;4794.00;130
12741;76;625416054;12741;461;13810;13940;6.18;0.38;295.91;15.84;1069;79;4795.00;130
12741;76;625416067;12741;465;13813;13944;6.20;0.38;295.91;15.83;1072;79;4796.00;131
12744;76;625416081;12744;464;13814;13945;6.16;0.38;295.94;15.83;1070;79;4797.00;131
12748;76;625416095;12748;469;13815;13945;6.13;0.37;295.93;15.83;1067;79;4798.00;130
12751;76;625416108;12751;476;13815;13945;6.05;0.37;295.93;15.83;1064;79;4799.00;130
12751;76;625416124;12751;488;13836;13986;6.10;0.37;295.93;15.81;1085;79;4800.00;150
12753;76;625416144;12753;483;13837;13986;6.04;0.37;295.91;15.81;1084;79;4801.00;149
12756;76;625416158;12756;482;13839;13986;5.95;0.36;295.93;15.80;1083;79;4802.00;147
12761;76;625416171;12761;480;13841;13987;5.87;0.36;295.96;15.80;1080;79;4803.00;146
12763;76;625416185;12763;483;13842;13988;5.84;0.36;296.02;15.80;1079;79;4804.00;146
12767;76;625416198;12767;488;13842;13988;5.80;0.36;296.08;15.80;1075;79;4805.00;146
12770;76;625416212;12770;493;13846;13991;5.80;0.36;296.13;15.80;1076;79;4806.00;145
12774;76;625416226;12774;481;13847;13991;5.78;0.36;296.15;15.80;1073;79;4807.00;144
12776;76;625416240;12776;473;13848;13991;5.80;0.36;296.15;15.80;1072;79;4808.00;143
12781;76;625416254;12781;469;13850;13991;5.77;0.35;296.14;15.90;1069;79;4809.00;141
12783;76;625416268;12783;463;13855;13997;5.78;0.35;296.14;15.89;1072;79;4810.00;142
12786;76;625416288;12786;458;13856;13997;5.82;0.36;296.12;15.89;1070;79;4811.00;141
12786;76;625416302;12786;453;13857;13997;5.94;0.36;296.12;15.89;1071;79;4812.00;140
12790;76;625416316;12790;460;13857;13997;6.01;0.37;296.11;15.89;1067;79;4813.00;140
12791;76;625416329;12791;455;13860;14001;6.11;0.37;296.09;15.89;1069;79;4814.00;141
12794;76;625416343;12794;459;13862;14003;6.23;0.38;296.14;15.89;1068;79;4815.00;141
12796;76;625416357;12796;446;13862;14003;6.35;0.39;296.16;15.89;1066;79;4816.00;141
12802;76;625416377;12802;430;13865;14004;6.40;0.39;296.26;15.98;1063;79;4817.00;139
12807;76;625416392;12807;416;13865;14004;6.40;0.39;296.23;15.98;1058;79;4818.00;139
12811;76;625416406;12811;406;13865;14004;6.44;0.39;296.30;15.98;1054;79;4819.00;139
12814;76;625416420;12814;397;13865;14004;6.42;0.39;296.29;15.98;1051;79;4820.00;139
12820;76;625416434;12820;391;13865;14004;6.36;0.39;296.32;15.98;1045;79;4821.00;139
12822;76;625416448;12822;393;13865;14004;6.35;0.39;296.33;15.98;1043;79;4822.00;139
12827;77;625416462;12827;391;13867;14004;6.34;0.38;296.38;16.08;1040;80;4823.00;137
12828;77;625416498;12828;401;13910;14074;6.34;0.39;296.37;16.04;1082;80;4824.00;164
12832;77;625416518;12832;392;13910;14075;6.34;0.38;296.44;16.04;1078;80;4825.00;165
12833;77;625416532;12833;384;13915;14075;6.41;0.39;296.46;16.03;1082;80;4826.00;160
12837;77;625416545;12837;378;13917;14075;6.46;0.39;296.51;16.03;1080;80;4827.00;158
12838;77;625416559;12838;376;13921;14077;6.49;0.39;296.55;16.12;1083;80;4828.00;156
12843;77;625416574;12843;375;13924;14077;6.48;0.39;296.57;16.12;1081;80;4829.00;153
12843;77;625416589;12843;372;13927;14077;6.53;0.40;296.57;16.12;1084;80;4830.00;150
12845;77;625416603;12845;362;13929;14077;6.52;0.40;296.64;16.12;1084;80;4831.00;148
12847;77;625416617;12847;358;13931;14078;6.51;0.40;296.67;16.12;1084;80;4832.00;147
12850;77;625416631;12850;356;13934;14079;6.52;0.40;296.69;16.21;1084;80;4833.00;145
12853;77;625416645;12853;358;13937;14079;6.54;0.40;296.74;16.21;1084;80;4834.00;142
12857;77;625416658;12857;360;13943;14083;6.53;0.40;296.78;16.21;1086;80;4835.00;140
12859;77;625416672;12859;351;13943;14083;6.56;0.40;296.77;16.21;1084;80;4836.00;140
12862;77;625416686;12862;344;13943;14083;6.54;0.40;296.76;16.21;1081;80;4837.00;140
12866;77;625416700;12866;355;13943;14083;6.58;0.40;296.84;16.21;1077;80;4838.00;140
12870;77;625416715;12870;349;13948;14089;6.63;0.40;296.84;16.20;1078;80;4839.00;141
12874;77;625416729;12874;350;13949;14089;6.62;0.40;297.03;16.20;1075;80;4840.00;140
12875;77;625416742;12875;349;13949;14089;6.68;0.41;297.02;16.20;1074;80;4841.00;140
12879;77;625416755;12879;348;13952;14092;6.74;0.41;297.07;16.20;1073;80;4842.00;140
12882;77;625416769;12882;346;13952;14092;6.75;0.41;297.13;16.20;1070;80;4843.00;140
12884;77;625416782;12884;347;13952;14092;6.76;0.41;297.17;16.20;1068;80;4844.00;140
12886;77;625416796;12886;349;13952;14093;6.75;0.41;297.20;16.20;1066;80;4845.00;141
12888;77;625416809;12888;344;13953;14094;6.74;0.41;297.18;16.20;1065;80;4846.00;141
12890;77;625416822;12890;345;13953;14094;6.71;0.41;297.20;16.20;1063;80;4847.00;141
12890;77;625416835;12890;351;13964;14107;6.72;0.41;297.20;16.19;1074;80;4848.00;143
12892;77;625416849;12892;348;13964;14107;6.70;0.41;297.21;16.19;1072;80;4849.00;143
12893;77;625416863;12893;342;13965;14107;6.74;0.41;297.21;16.28;1072;80;4850.00;142
12895;77;625416876;12895;339;13966;14108;6.75;0.41;297.26;16.28;1071;80;4851.00;142
12898;77;625416890;12898;329;13966;14108;6.72;0.41;297.28;16.28;1068;80;4852.00;142
12899;77;625416903;12899;320;13969;14112;6.75;0.41;297.28;16.27;1070;80;4853.00;143
12901;77;625416917;12901;313;13970;14112;6.70;0.41;297.28;16.36;1069;80;4854.00;142
12904;77;625416930;12904;303;13974;14116;6.67;0.41;297.31;16.36;1070;80;4855.00;142
12908;77;625416943;12908;295;13974;14116;6.66;0.40;297.29;16.36;1066;80;4856.00;142
12909;77;625416957;12909;288;13975;14116;6.64;0.40;297.27;16.45;1066;80;4857.00;141
12914;77;625416970;12914;280;13975;14116;6.59;0.40;297.34;16.45;1061;80;4858.00;141
12916;77;625416984;12916;274;13976;14116;6.60;0.40;297.38;16.54;1060;80;4859.00;140
12920;77;625416998;12920;272;13996;14150;6.67;0.41;297.38;16.51;1076;80;4860.00;154
12922;77;625417023;12922;261;13996;14150;6.72;0.41;297.42;16.51;1074;80;4861.00;154
12925;77;625417049;12925;252;13998;14150;6.75;0.41;297.48;16.60;1073;80;4862.00;152
12930;77;625417071;12930;242;13999;14150;6.78;0.41;297.51;16.60;1069;80;4863.00;151
12932;77;625417091;12932;231;14000;14150;6.82;0.42;297.53;16.69;1068;80;4864.00;150
12935;77;625417113;12935;230;14002;14150;6.82;0.42;297.55;16.70;1067;80;4865.00;148
12938;77;625417134;12938;225;14002;14151;6.87;0.42;297.64;16.70;1064;80;4866.00;149
12942;77;625417150;12942;221;14003;14151;6.86;0.42;297.75;16.70;1061;80;4867.00;148
12948;77;625417165;12948;218;14006;14157;6.80;0.41;297.83;16.70;1058;80;4868.00;151
12950;77;625417180;12950;222;14008;14158;6.74;0.41;297.85;16.70;1058;80;4869.00;150
12952;77;625417195;12952;216;14009;14158;6.58;0.40;297.89;16.79;1057;80;4870.00;149
12954;77;625417209;12954;221;14010;14158;6.46;0.39;297.99;16.79;1056;80;4871.00;148
12956;77;625417223;12956;215;14013;14162;6.41;0.39;298.00;16.87;1057;80;4872.00;149
12959;77;625417237;12959;218;14014;14162;6.42;0.39;298.02;16.87;1055;80;4873.00;148
12963;77;625417251;12963;219;14016;14162;6.41;0.39;298.05;16.96;1053;80;4874.00;146
12967;77;625417265;12967;225;14017;14163;6.42;0.39;298.08;16.96;1050;80;4875.00;146
12970;77;625417278;12970;227;14020;14167;6.41;0.39;298.10;16.96;1050;80;4876.00;147
12972;77;625417291;12972;235;14022;14167;6.45;0.39;298.08;17.05;1050;80;4877.00;145
12974;77;625417304;12974;227;14025;14170;6.50;0.40;298.10;17.04;1051;80;4878.00;145
12982;77;625417318;12982;233;14026;14170;6.51;0.40;298.11;17.04;1044;80;4879.00;144
12983;77;625417332;12983;234;14028;14170;6.50;0.39;298.14;17.13;1045;80;4880.00;142
12984;77;625417345;12984;235;14028;14170;6.51;0.40;298.18;17.13;1044;80;4881.00;142
12986;77;625417358;12986;231;14031;14174;6.58;0.40;298.20;17.13;1045;80;4882.00;143
12988;77;625417372;12988;235;14032;14174;6.57;0.40;298.27;17.13;1044;80;4883.00;142
12993;77;625417385;12993;236;14033;14174;6.56;0.40;298.24;17.13;1040;80;4884.00;141
12999;77;625417399;12999;237;14033;14174;6.53;0.40;298.33;17.13;1034;80;4885.00;141
13001;77;625417413;13001;246;14033;14175;6.54;0.40;298.35;17.13;1032;80;4886.00;142
13002;77;625417427;13002;256;14035;14176;6.56;0.40;298.35;17.14;1033;80;4887.00;141
13005;77;625417441;13005;261;14035;14176;6.53;0.40;298.45;17.14;1030;80;4888.00;141
13011;77;625417456;13011;271;14036;14177;6.52;0.40;298.49;17.14;1025;80;4889.00;141
13013;77;625417471;13013;271;14037;14177;6.48;0.39;298.51;17.15;1024;80;4890.00;140
13013;77;625417484;13013;279;14038;14177;6.47;0.39;298.51;17.16;1025;80;4891.00;139
13016;77;625417497;13016;289;14039;14177;6.41;0.39;298.53;17.18;1023;80;4892.00;138
13018;77;625417510;13018;292;14039;14177;6.33;0.38;298.61;17.18;1021;80;4893.00;138
13020;77;625417523;13020;306;14041;14177;6.27;0.38;298.63;17.20;1021;80;4894.00;136
13022;77;625417535;13022;304;14041;14177;6.20;0.38;298.67;17.20;1019;80;4895.00;136
13023;77;625417548;13023;328;14106;14304;6.46;0.40;298.66;17.14;1083;80;4896.00;198
13026;77;625417571;13026;324;14109;14305;6.40;0.39;298.67;17.15;1083;80;4897.00;196
13028;77;625417585;13028;328;14117;14305;6.38;0.39;298.65;17.15;1089;80;4898.00;188
13030;77;625417598;13030;328;14121;14305;6.36;0.39;298.62;17.15;1091;80;4899.00;184
13030;77;625417612;13030;323;14130;14305;6.41;0.40;298.62;17.16;1100;80;4900.00;175
13032;77;625417630;13032;318;14135;14305;6.41;0.39;298.61;17.17;1103;80;4901.00;170
13033;77;625417644;13033;322;14140;14305;6.40;0.39;298.63;17.18;1107;80;4902.00;165
13036;77;625417657;13036;321;14143;14305;6.37;0.39;298.61;17.20;1107;80;4903.00;162
13038;77;625417670;13038;340;14146;14306;6.33;0.39;298.58;17.20;1108;80;4904.00;160
13044;77;625417683;13044;341;14152;14308;6.28;0.39;298.48;17.21;1108;80;4905.00;156
13046;77;625417696;13046;348;14155;14308;6.22;0.38;298.46;17.22;1109;80;4906.00;153
13049;77;625417709;13049;364;14160;14309;6.13;0.38;298.42;17.23;1111;80;4907.00;149
13050;77;625417722;13050;364;14166;14309;6.11;0.38;298.40;17.24;1116;80;4908.00;143
13055;77;625417735;13055;364;14169;14309;6.02;0.37;298.33;17.25;1114;80;4909.00;140
13055;77;625417749;13055;366;14171;14309;6.00;0.37;298.33;17.25;1116;80;4910.00;138
13058;77;625417761;13058;369;14175;14313;5.92;0.36;298.32;17.26;1117;80;4911.00;138
13059;77;625417775;13059;374;14178;14313;5.86;0.36;298.40;17.26;1119;80;4912.00;135
13059;77;625417789;13059;383;14180;14313;5.82;0.36;298.40;17.28;1121;80;4913.00;133
13060;77;625417801;13060;390;14184;14316;5.77;0.35;298.40;17.29;1124;80;4914.00;132
13060;77;625417815;13060;404;14185;14316;5.75;0.35;298.40;17.29;1125;80;4915.00;131
13060;77;625417828;13060;399;14187;14316;5.78;0.35;298.40;17.29;1127;80;4916.00;129
13061;77;625417840;13061;412;14192;14320;5.73;0.35;298.38;17.29;1131;80;4917.00;128
13062;77;625417853;13062;417;14195;14321;5.71;0.35;298.39;17.30;1133;80;4918.00;126
13063;77;625417866;13063;423;14196;14321;5.66;0.35;298.38;17.30;1133;80;4919.00;125
13064;77;625417881;13064;428;14203;14326;5.63;0.34;298.37;17.30;1139;80;4920.00;123
13065;77;625417894;13065;428;14203;14326;5.57;0.34;298.35;17.30;1138;80;4921.00;123
13068;77;625417906;13068;439;14204;14326;5.46;0.33;298.40;17.31;1136;80;4922.00;122
13069;77;625417918;13069;437;14206;14327;5.38;0.33;298.40;17.31;1137;80;4923.00;121
13073;77;625417930;13073;441;14206;14327;5.28;0.32;298.39;17.31;1133;80;4924.00;121
13076;77;625417943;13076;443;14210;14333;5.21;0.32;298.36;17.31;1134;80;4925.00;123
13081;78;625417961;13081;454;14213;14333;5.07;0.31;298.31;17.33;1132;81;4926.00;120
13085;78;625417990;13085;454;14214;14334;4.92;0.30;298.31;17.33;1129;81;4927.00;120
13088;78;625418002;13088;466;14215;14334;4.81;0.30;298.28;17.34;1127;81;4928.00;119
13091;78;625418018;13091;463;14216;14334;4.71;0.29;298.25;17.34;1125;81;4929.00;118
13095;78;625418029;13095;451;14217;14334;4.62;0.28;298.23;17.35;1122;81;4930.00;117
13097;78;625418041;13097;438;14217;14334;4.57;0.28;298.21;17.35;1120;81;4931.00;117
13100;78;625418053;13100;423;14228;14346;4.63;0.28;298.19;17.34;1128;81;4932.00;118
13101;78;625418066;13101;423;14229;14346;4.64;0.28;298.18;17.35;1128;81;4933.00;117
13102;78;625418092;13102;422;14229;14346;4.67;0.29;298.18;17.35;1127;81;4934.00;117
13104;78;625418104;13104;423;14229;14346;4.74;0.29;298.19;17.35;1125;81;4935.00;117
13105;78;625418116;13105;416;14229;14346;4.84;0.30;298.20;17.35;1124;81;4936.00;117
13107;78;625418133;13107;421;14229;14346;4.95;0.30;298.19;17.35;1122;81;4937.00;117
13109;78;625418150;13109;422;14232;14350;5.11;0.31;298.20;17.34;1123;81;4938.00;118
13110;78;625418163;13110;406;14232;14350;5.23;0.32;298.21;17.34;1122;81;4939.00;118
13111;78;625418181;13111;398;14235;14354;5.36;0.33;298.21;17.34;1124;81;4940.00;119
13116;78;625418194;13116;395;14236;14355;5.43;0.33;298.18;17.34;1120;81;4941.00;119
13118;78;625418208;13118;383;14237;14355;5.46;0.33;298.19;17.34;1119;81;4942.00;118
13120;78;625418222;13120;380;14237;14355;5.47;0.33;298.17;17.34;1117;81;4943.00;118
13124;78;625418236;13124;381;14248;14368;5.60;0.34;298.16;17.33;1124;81;4944.00;120
13126;78;625418250;13126;376;14248;14368;5.63;0.34;298.14;17.33;1122;81;4945.00;120
13129;78;625418263;13129;373;14248;14368;5.68;0.35;298.13;17.33;1119;81;4946.00;120
13132;78;625418276;13132;375;14249;14369;5.68;0.35;298.10;17.32;1117;81;4947.00;120
13135;78;625418295;13135;378;14249;14370;5.72;0.35;298.11;17.32;1114;81;4948.00;121
13137;78;625418308;13137;385;14249;14370;5.78;0.35;298.12;17.32;1112;81;4949.00;121
13140;78;625418323;13140;380;14253;14379;5.84;0.35;298.10;17.32;1113;81;4950.00;126
13143;78;625418337;13143;372;14254;14379;5.84;0.35;298.10;17.32;1111;81;4951.00;125
13147;78;625418356;13147;369;14255;14379;5.87;0.36;298.10;17.32;1108;81;4952.00;124
13152;78;625418369;13152;363;14256;14379;5.84;0.35;298.18;17.32;1104;81;4953.00;123
13154;78;625418383;13154;356;14259;14385;5.89;0.36;298.17;17.31;1105;81;4954.00;126
13158;78;625418397;13158;360;14260;14385;5.93;0.36;298.22;17.31;1102;81;4955.00;125
13162;78;625418411;13162;365;14260;14385;5.98;0.36;298.20;17.31;1098;81;4956.00;125
13166;78;625418425;13166;368;14261;14385;5.97;0.36;298.27;17.31;1095;81;4957.00;124
13170;78;625418439;13170;371;14265;14389;6.08;0.37;298.34;17.31;1095;81;4958.00;124
13174;78;625418453;13174;377;14266;14390;6.12;0.37;298.38;17.31;1092;81;4959.00;124
13177;78;625418467;13177;381;14267;14390;6.12;0.37;298.42;17.31;1090;81;4960.00;123
13181;78;625418481;13181;381;14268;14391;6.14;0.37;298.50;17.30;1087;81;4961.00;123
13186;78;625418495;13186;385;14268;14391;6.10;0.37;298.49;17.30;1082;81;4962.00;123
13189;78;625418509;13189;389;14268;14391;6.13;0.37;298.51;17.30;1079;81;4963.00;123
13194;78;625418522;13194;396;14268;14391;6.14;0.37;298.49;17.30;1074;81;4964.00;123
13198;78;625418537;13198;392;14268;14391;6.15;0.37;298.52;17.30;1070;81;4965.00;123
13204;78;625418551;13204;393;14268;14391;6.14;0.37;298.49;17.30;1064;81;4966.00;123
13207;78;625418565;13207;395;14268;14391;6.19;0.38;298.52;17.30;1061;81;4967.00;123
13211;78;625418579;13211;401;14311;14461;6.38;0.39;298.52;17.25;1100;81;4968.00;150
13213;78;625418602;13213;395;14312;14462;6.44;0.39;298.52;17.25;1099;81;4969.00;150
13216;78;625418617;13216;397;14319;14462;6.54;0.40;298.55;17.24;1103;81;4970.00;143
13217;78;625418631;13217;391;14319;14462;6.55;0.40;298.62;17.24;1102;81;4971.00;143
13221;78;625418646;13221;397;14323;14462;6.61;0.40;298.69;17.24;1102;81;4972.00;139
13224;78;625418660;13224;396;14325;14462;6.65;0.41;298.77;17.24;1101;81;4973.00;137
13226;78;625418674;13226;405;14329;14462;6.66;0.41;298.83;17.24;1103;81;4974.00;133
13228;78;625418689;13228;411;14330;14462;6.63;0.41;298.90;17.23;1102;81;4975.00;132
13232;78;625418702;13232;419;14333;14463;6.57;0.40;298.95;17.23;1101;81;4976.00;130
13234;78;625418717;13234;412;14335;14464;6.54;0.40;298.97;17.23;1101;81;4977.00;129
13238;78;625418731;13238;412;14336;14464;6.47;0.40;299.03;17.23;1098;81;4978.00;128
13239;78;625418745;13239;405;14339;14468;6.45;0.40;299.05;17.23;1100;81;4979.00;129
13244;78;625418761;13244;413;14339;14468;6.42;0.39;299.08;17.23;1095;81;4980.00;129
13250;78;625418778;13250;405;14339;14468;6.39;0.39;299.18;17.23;1089;81;4981.00;129
13253;78;625418793;13253;411;14339;14468;6.41;0.39;299.18;17.23;1086;81;4982.00;129
13254;78;625418806;13254;410;14343;14474;6.42;0.39;299.22;17.22;1089;81;4983.00;131
13260;78;625418821;13260;412;14344;14474;6.42;0.39;299.25;17.22;1084;81;4984.00;130
13261;78;625418836;13261;406;14344;14474;6.41;0.39;299.27;17.22;1083;81;4985.00;130
13268;78;625418855;13268;390;14346;14477;6.44;0.39;299.33;17.22;1078;81;4986.00;131
13273;78;625418871;13273;383;14346;14477;6.46;0.39;299.32;17.22;1073;81;4987.00;131
13277;78;625418891;13277;375;14347;14477;6.57;0.40;299.39;17.22;1070;81;4988.00;130
13280;78;625418906;13280;362;14348;14478;6.65;0.41;299.42;17.31;1068;81;4989.00;130
13285;78;625418927;13285;350;14349;14479;6.66;0.41;299.49;17.31;1064;81;4990.00;130
13290;78;625418941;13290;351;14349;14479;6.58;0.40;299.54;17.31;1059;81;4991.00;130
13292;78;625418956;13292;339;14360;14492;6.64;0.41;299.55;17.30;1068;81;4992.00;132
13297;78;625418971;13297;338;14360;14492;6.53;0.40;299.55;17.30;1063;81;4993.00;132
13298;78;625418986;13298;348;14360;14492;6.54;0.40;299.55;17.30;1062;81;4994.00;132
13300;78;625419000;13300;344;14362;14494;6.54;0.40;299.55;17.30;1062;81;4995.00;132
13304;78;625419019;13304;351;14362;14494;6.52;0.40;299.56;17.30;1058;81;4996.00;132
13307;78;625419040;13307;348;14365;14498;6.49;0.40;299.61;17.29;1058;81;4997.00;133
13309;78;625419066;13309;335;14365;14498;6.43;0.39;299.60;17.29;1056;81;4998.00;133
13312;78;625419086;13312;337;14369;14502;6.36;0.39;299.66;17.29;1057;81;4999.00;133
13314;78;625419109;13314;331;14369;14502;6.36;0.39;299.73;17.29;1055;81;5000.00;133
13317;78;625419132;13317;325;14369;14502;6.32;0.39;299.79;17.29;1052;81;5001.00;133
13322;78;625419147;13322;321;14369;14502;6.25;0.38;299.84;17.29;1047;81;5002.00;133
13325;78;625419161;13325;316;14369;14502;6.18;0.38;299.83;17.29;1044;81;5003.00;133
13329;78;625419176;13329;315;14378;14514;6.18;0.38;299.82;17.28;1049;81;5004.00;136
13331;78;625419193;13331;310;14378;14514;6.22;0.38;299.87;17.28;1047;81;5005.00;136
13334;78;625419207;13334;313;14380;14514;6.25;0.38;299.92;17.28;1046;81;5006.00;134
13336;78;625419222;13336;317;14380;14514;6.28;0.38;299.90;17.28;1044;81;5007.00;134
13338;78;625419235;13338;313;14380;14514;6.27;0.38;299.89;17.28;1042;81;5008.00;134
13340;78;625419249;13340;314;14380;14514;6.30;0.38;299.88;17.28;1040;81;5009.00;134
13343;78;625419265;13343;307;14380;14515;6.35;0.39;299.90;17.28;1037;81;5010.00;135
13344;78;625419279;13344;314;14380;14515;6.38;0.39;299.88;17.28;1036;81;5011.00;135
13345;78;625419293;13345;306;14384;14521;6.41;0.39;299.87;17.27;1039;81;5012.00;137
13347;78;625419308;13347;307;14385;14522;6.45;0.39;299.86;17.27;1038;81;5013.00;137
13349;78;625419321;13349;310;14386;14522;6.49;0.39;299.87;17.27;1037;81;5014.00;136
13351;78;625419334;13351;305;14386;14522;6.46;0.39;299.88;17.27;1035;81;5015.00;136
13352;78;625419348;13352;316;14389;14526;6.46;0.39;299.87;17.27;1037;81;5016.00;137
13353;78;625419362;13353;316;14390;14526;6.44;0.39;299.87;17.36;1037;81;5017.00;136
13356;78;625419375;13356;322;14390;14526;6.37;0.39;299.84;17.36;1034;81;5018.00;136
13356;78;625419388;13356;319;14391;14527;6.35;0.38;299.84;17.36;1035;81;5019.00;136
13358;78;625419401;13358;319;14394;14531;6.28;0.38;299.85;17.36;1036;81;5020.00;137
13360;78;625419415;13360;318;14394;14531;6.23;0.38;299.86;17.36;1034;81;5021.00;137
13363;78;625419428;13363;309;14396;14534;6.21;0.38;299.85;17.36;1033;81;5022.00;138
13364;78;625419442;13364;306;14396;14534;6.12;0.37;299.84;17.36;1032;81;5023.00;138
13365;78;625419455;13365;306;14397;14534;6.05;0.37;299.83;17.35;1032;81;5024.00;137
13365;78;625419468;13365;303;14397;14534;5.99;0.36;299.83;17.35;1032;81;5025.00;137
13369;78;625419480;13369;298;14400;14538;5.95;0.36;299.87;17.35;1031;81;5026.00;138
13369;78;625419495;13369;300;14400;14538;5.97;0.36;299.87;17.35;1031;81;5027.00;138
13371;78;625419507;13371;296;14401;14538;5.95;0.36;299.87;17.35;1030;81;5028.00;137
13372;78;625419519;13372;288;14401;14538;5.96;0.36;299.86;17.35;1029;81;5029.00;137
13378;78;625419531;13378;283;14401;14539;5.86;0.36;299.92;17.35;1023;81;5030.00;138
13382;78;625419544;13382;270;14402;14540;5.78;0.35;299.98;17.35;1020;81;5031.00;138
13384;78;625419556;13384;272;14402;14540;5.72;0.35;300.01;17.35;1018;81;5032.00;138
13388;78;625419569;13388;264;14403;14541;5.65;0.34;300.05;17.35;1015;81;5033.00;138
13391;78;625419581;13391;250;14404;14541;5.56;0.34;300.07;17.36;1013;81;5034.00;137
13394;78;625419595;13394;245;14404;14541;5.57;0.34;300.07;17.36;1010;81;5035.00;137
13398;78;625419609;13398;238;14405;14541;5.53;0.34;300.11;17.38;1007;81;5036.00;136
13402;78;625419622;13402;237;14405;14541;5.56;0.34;300.09;17.38;1003;81;5037.00;136
13404;78;625419634;13404;232;14405;14541;5.60;0.34;300.11;17.38;1001;81;5038.00;136
13406;78;625419648;13406;227;14405;14541;5.65;0.34;300.13;17.38;999;81;5039.00;136
13409;78;625419661;13409;256;14504;14771;5.93;0.37;300.14;17.26;1095;81;5040.00;267
13411;78;625419694;13411;244;14509;14772;5.93;0.37;300.19;17.26;1098;81;5041.00;263
13412;78;625419707;13412;237;14516;14772;5.99;0.37;300.18;17.25;1104;81;5042.00;256
13415;78;625419721;13415;237;14521;14772;5.99;0.37;300.18;17.24;1106;81;5043.00;251
13416;78;625419735;13416;237;14527;14772;6.04;0.38;300.16;17.24;1111;81;5044.00;245
13419;78;625419748;13419;231;14535;14772;6.05;0.38;300.16;17.33;1116;81;5045.00;237
13419;78;625419760;13419;228;14541;14772;6.11;0.38;300.16;17.33;1122;81;5046.00;231
13421;78;625419773;13421;230;14545;14772;6.16;0.38;300.13;17.32;1124;81;5047.00;227
13424;78;625419786;13424;229;14551;14773;6.19;0.38;300.08;17.32;1127;81;5048.00;222
13426;78;625419801;13426;234;14554;14774;6.23;0.39;300.05;17.42;1128;81;5049.00;220
13427;78;625419816;13427;232;14559;14774;6.28;0.39;300.04;17.41;1132;81;5050.00;215
13428;78;625419829;13428;234;14564;14775;6.28;0.39;300.03;17.41;1136;81;5051.00;211
13430;78;625419843;13430;234;14568;14775;6.29;0.39;300.00;17.51;1138;81;5052.00;207
13432;78;625419856;13432;236;14571;14775;6.27;0.39;299.97;17.51;1139;81;5053.00;204
13433;78;625419870;13433;236;14575;14775;6.25;0.38;299.95;17.51;1142;81;5054.00;200
13435;78;625419885;13435;244;14580;14779;6.22;0.38;299.95;17.52;1145;81;5055.00;199
13437;78;625419899;13437;251;14583;14779;6.16;0.38;299.92;17.52;1146;81;5056.00;196
13438;78;625419913;13438;257;14586;14779;6.15;0.38;299.93;17.52;1148;81;5057.00;193
13442;78;625419928;13442;260;14592;14782;6.13;0.38;299.89;17.52;1150;81;5058.00;190
13445;78;625419943;13445;267;14595;14782;6.11;0.37;299.87;17.53;1150;81;5059.00;187
13446;78;625419957;13446;268;14599;14782;6.11;0.37;299.86;17.54;1153;81;5060.00;183
13447;78;625419978;13447;280;14606;14786;6.06;0.37;299.84;17.55;1159;81;5061.00;180
13448;78;625419993;13448;292;14610;14787;6.04;0.37;299.84;17.65;1162;81;5062.00;177
13449;78;625420008;13449;300;14613;14787;6.02;0.37;299.83;17.67;1164;81;5063.00;174
13452;78;625420023;13452;304;14618;14791;6.00;0.37;299.79;17.67;1166;81;5064.00;173
13453;78;625420038;13453;325;14619;14791;5.98;0.37;299.77;17.67;1166;81;5065.00;172
13455;78;625420053;13455;322;14623;14791;5.93;0.36;299.85;17.69;1168;81;5066.00;168
13460;78;625420067;13460;334;14625;14792;5.82;0.36;299.80;17.69;1165;81;5067.00;167
13461;78;625420082;13461;349;14628;14792;5.76;0.35;299.78;17.72;1167;81;5068.00;164
13463;78;625420096;13463;352;14634;14798;5.70;0.35;299.78;17.73;1171;81;5069.00;164
13466;78;625420111;13466;359;14635;14798;5.59;0.34;299.72;17.75;1169;81;5070.00;163
13468;78;625420126;13468;363;14636;14799;5.51;0.34;299.70;17.75;1168;81;5071.00;163
13469;78;625420139;13469;367;14639;14799;5.47;0.33;299.70;17.76;1170;81;5072.00;160
13469;78;625420151;13469;383;14641;14799;5.39;0.33;299.70;17.77;1172;81;5073.00;158
13470;78;625420165;13470;396;14643;14799;5.33;0.33;299.68;17.78;1173;81;5074.00;156
13472;78;625420177;13472;407;14644;14799;5.27;0.32;299.65;17.79;1172;81;5075.00;155
13474;78;625420190;13474;419;14658;14811;5.23;0.32;299.65;17.79;1184;81;5076.00;153
13476;78;625420205;13476;422;14658;14811;5.20;0.32;299.62;17.79;1182;81;5077.00;153
13477;78;625420217;13477;430;14664;14811;5.19;0.32;299.60;17.81;1187;81;5078.00;147
13478;78;625420230;13478;430;14665;14811;5.23;0.32;299.60;17.81;1187;81;5079.00;146
13480;78;625420243;13480;432;14666;14811;5.20;0.32;299.57;17.82;1186;81;5080.00;145
13481;78;625420256;13481;430;14668;14811;5.23;0.32;299.55;17.83;1187;81;5081.00;143
13483;78;625420268;13483;431;14672;14815;5.24;0.32;299.57;17.84;1189;81;5082.00;143
13484;78;625420281;13484;408;14672;14815;5.26;0.32;299.56;17.84;1188;81;5083.00;143
13485;78;625420295;13485;408;14677;14819;5.30;0.32;299.55;17.85;1192;81;5084.00;142
13485;78;625420308;13485;405;14679;14821;5.37;0.33;299.55;17.85;1194;81;5085.00;142
13487;78;625420322;13487;397;14681;14821;5.41;0.33;299.55;17.85;1194;81;5086.00;140
13490;78;625420335;13490;396;14682;14821;5.50;0.34;299.53;17.86;1192;81;5087.00;139
13493;78;625420348;13493;391;14693;14834;5.60;0.34;299.62;17.86;1200;81;5088.00;141
13496;78;625420363;13496;381;14695;14834;5.65;0.34;299.60;17.86;1199;81;5089.00;139
13496;78;625420383;13496;386;14696;14834;5.72;0.35;299.60;17.87;1200;81;5090.00;138
13496;78;625420402;13496;376;14698;14835;5.74;0.35;299.60;17.87;1202;81;5091.00;137
13498;79;625420415;13498;377;14698;14836;5.73;0.35;299.61;17.87;1200;82;5092.00;138
13501;79;625420439;13501;366;14700;14836;5.74;0.35;299.58;17.88;1199;82;5093.00;136
13502;79;625420453;13502;372;14702;14839;5.79;0.35;299.57;17.88;1200;82;5094.00;137
13504;79;625420473;13504;368;14703;14839;5.73;0.35;299.56;17.88;1199;82;5095.00;136
13507;79;625420487;13507;375;14704;14839;5.69;0.35;299.53;17.89;1197;82;5096.00;135
13511;79;625420500;13511;377;14704;14839;5.61;0.34;299.51;17.89;1193;82;5097.00;135
13513;79;625420513;13513;385;14711;14845;5.60;0.34;299.49;17.92;1198;82;5098.00;134
13516;79;625420527;13516;390;14711;14845;5.52;0.34;299.48;17.92;1195;82;5099.00;134
13519;79;625420543;13519;386;14718;14864;5.47;0.34;299.47;17.93;1199;82;5100.00;146
13520;79;625420562;13520;383;14718;14864;5.48;0.34;299.45;17.93;1198;82;5101.00;146
13523;79;625420575;13523;386;14722;14868;5.48;0.34;299.52;17.92;1199;82;5102.00;146
13525;79;625420589;13525;383;14724;14869;5.48;0.34;299.51;17.93;1199;82;5103.00;145
13527;79;625420602;13527;388;14724;14869;5.49;0.34;299.56;17.93;1197;82;5104.00;145
13530;79;625420616;13530;381;14727;14870;5.48;0.34;299.61;17.94;1197;82;5105.00;143
13532;79;625420630;13532;384;14729;14870;5.50;0.34;299.65;17.95;1197;82;5106.00;141
13536;79;625420643;13536;380;14729;14870;5.52;0.34;299.69;17.95;1193;82;5107.00;141
13539;79;625420663;13539;387;14730;14870;5.61;0.35;299.69;17.95;1191;82;5108.00;140
13543;79;625420677;13543;381;14730;14870;5.70;0.35;299.72;17.95;1187;82;5109.00;140
13545;79;625420691;13545;373;14730;14870;5.80;0.36;299.76;17.95;1185;82;5110.00;140
13551;79;625420704;13551;367;14730;14870;5.85;0.36;299.84;17.95;1179;82;5111.00;140
13552;79;625420718;13552;363;14764;14940;5.99;0.37;299.83;17.91;1212;82;5112.00;176
13556;79;625420738;13556;360;14766;14941;6.02;0.37;299.93;17.91;1210;82;5113.00;175
13563;79;625420752;13563;356;14773;14941;6.06;0.37;299.97;17.90;1210;82;5114.00;168
13565;79;625420766;13565;357;14775;14941;6.13;0.38;300.02;17.90;1210;82;5115.00;166
13571;79;625420780;13571;353;14778;14941;6.10;0.37;300.05;17.90;1207;82;5116.00;163
13578;79;625420796;13578;350;14780;14941;6.10;0.37;300.07;17.90;1202;82;5117.00;161
13579;79;625420811;13579;352;14783;14941;6.10;0.37;300.06;17.90;1204;82;5118.00;158
13582;79;625420825;13582;352;14784;14941;6.12;0.38;300.03;17.89;1202;82;5119.00;157
13585;79;625420840;13585;361;14786;14942;6.17;0.38;300.07;17.89;1201;82;5120.00;156
13589;79;625420855;13589;359;14788;14943;6.20;0.38;300.13;17.89;1199;82;5121.00;155
13595;79;625420870;13595;375;14789;14943;6.19;0.38;300.20;17.89;1194;82;5122.00;154
13600;79;625420885;13600;387;14793;14947;6.23;0.38;300.25;17.89;1193;82;5123.00;154
13606;79;625420900;13606;384;14795;14947;6.24;0.38;300.27;17.89;1189;82;5124.00;152
13611;79;625420915;13611;385;14796;14947;6.28;0.39;300.32;17.89;1185;82;5125.00;151
13615;79;625420931;13615;391;14798;14947;6.32;0.39;300.40;17.89;1183;82;5126.00;149
13621;79;625420946;13621;385;14801;14953;6.29;0.39;300.48;17.89;1180;82;5127.00;152
13626;79;625420962;13626;388;14802;14953;6.28;0.39;300.51;17.88;1176;82;5128.00;151
13628;79;625420977;13628;393;14803;14953;6.30;0.39;300.50;17.88;1175;82;5129.00;150
13630;79;625420994;13630;398;14807;14959;6.31;0.39;300.54;17.88;1177;82;5130.00;152
13638;79;625421019;13638;398;14807;14959;6.28;0.39;300.57;17.88;1169;82;5131.00;152
13640;79;625421041;13640;402;14808;14959;6.30;0.39;300.61;17.88;1168;82;5132.00;151
13646;79;625421064;13646;398;14808;14960;6.30;0.39;300.65;17.88;1162;82;5133.00;152
13652;79;625421088;13652;404;14809;14961;6.33;0.39;300.69;17.88;1157;82;5134.00;152
13658;79;625421108;13658;405;14811;14961;6.31;0.39;300.79;17.88;1153;82;5135.00;150
13663;79;625421130;13663;410;14821;14974;6.34;0.39;300.83;17.87;1158;82;5136.00;153
13670;79;625421149;13670;409;14822;14974;6.33;0.39;300.87;17.87;1152;82;5137.00;152
13674;79;625421167;13674;415;14822;14974;6.34;0.39;300.88;17.87;1148;82;5138.00;152
13680;79;625421184;13680;414;14823;14975;6.36;0.39;301.01;17.87;1143;82;5139.00;152
13682;79;625421203;13682;418;14824;14975;6.32;0.39;301.04;17.87;1142;82;5140.00;151
13688;79;625421221;13688;421;14826;14979;6.26;0.38;301.05;17.87;1138;82;5141.00;153
13690;79;625421237;13690;421;14830;14979;6.22;0.38;301.11;17.87;1140;82;5142.00;149
13694;79;625421256;13694;425;14833;14983;6.13;0.38;301.12;17.87;1139;82;5143.00;150
13695;79;625421273;13695;430;14834;14983;6.03;0.37;301.15;17.87;1139;82;5144.00;149
13701;79;625421288;13701;444;14834;14983;5.93;0.36;301.13;17.87;1133;82;5145.00;149
13704;79;625421302;13704;450;14836;14983;5.84;0.36;301.13;17.87;1132;82;5146.00;147
13707;79;625421317;13707;440;14837;14983;5.83;0.36;301.14;17.87;1130;82;5147.00;146
13712;79;625421332;13712;433;14848;14995;5.84;0.36;301.18;17.86;1136;82;5148.00;147
13716;79;625421349;13716;430;14849;14995;5.81;0.36;301.18;17.86;1133;82;5149.00;146
13720;79;625421363;13720;425;14850;14995;5.85;0.36;301.25;17.86;1130;82;5150.00;145
13725;79;625421378;13725;428;14851;14995;5.89;0.36;301.27;17.86;1126;82;5151.00;144
13727;79;625421393;13727;424;14853;14995;5.90;0.36;301.24;17.86;1126;82;5152.00;142
13731;79;625421408;13731;422;14853;14995;5.87;0.36;301.28;17.86;1122;82;5153.00;142
13734;79;625421424;13734;420;14853;14996;5.88;0.36;301.29;17.86;1119;82;5154.00;143
13738;79;625421445;13738;428;14855;14998;5.89;0.36;301.27;17.85;1117;82;5155.00;143
13742;79;625421467;13742;412;14859;15004;5.94;0.36;301.38;17.85;1117;82;5156.00;145
13747;79;625421483;13747;403;14861;15005;5.98;0.36;301.35;17.85;1114;82;5157.00;144
13749;79;625421499;13749;396;14861;15005;6.04;0.37;301.34;17.85;1112;82;5158.00;144
13754;79;625421516;13754;385;14861;15005;6.11;0.37;301.38;17.85;1107;82;5159.00;144
13759;79;625421533;13759;387;14865;15010;6.17;0.38;301.50;17.84;1106;82;5160.00;145
13761;79;625421549;13761;370;14865;15010;6.23;0.38;301.49;17.84;1104;82;5161.00;145
13764;79;625421566;13764;374;14865;15010;6.24;0.38;301.53;17.84;1101;82;5162.00;145
13767;79;625421581;13767;370;14866;15011;6.27;0.38;301.54;17.84;1099;82;5163.00;145
13770;79;625421602;13770;369;14869;15015;6.28;0.38;301.57;17.84;1099;82;5164.00;146
13774;79;625421624;13774;371;14869;15015;6.30;0.38;301.56;17.84;1095;82;5165.00;146
13776;79;625421639;13776;370;14871;15018;6.31;0.38;301.56;17.83;1095;82;5166.00;147
13780;79;625421654;13780;364;14871;15018;6.32;0.38;301.61;17.83;1091;82;5167.00;147
13781;79;625421669;13781;358;14872;15018;6.34;0.38;301.62;17.83;1091;82;5168.00;146
13783;79;625421683;13783;347;14872;15018;6.38;0.39;301.74;17.83;1089;82;5169.00;146
13786;79;625421698;13786;351;14875;15022;6.41;0.39;301.74;17.83;1089;82;5170.00;147
13789;79;625421714;13789;340;14875;15022;6.45;0.39;301.82;17.83;1086;82;5171.00;147
13795;79;625421729;13795;336;14876;15022;6.48;0.39;301.91;17.83;1081;82;5172.00;146
13795;79;625421744;13795;334;14876;15022;6.48;0.39;301.91;17.83;1081;82;5173.00;146
13799;79;625421757;13799;331;14876;15023;6.44;0.39;301.96;17.83;1077;82;5174.00;147
13800;79;625421771;13800;329;14878;15025;6.37;0.39;302.02;17.83;1078;82;5175.00;147
13801;79;625421788;13801;324;14878;15025;6.32;0.38;302.01;17.83;1077;82;5176.00;147
13803;79;625421801;13803;323;14879;15026;6.24;0.38;302.01;17.83;1076;82;5177.00;147
13804;79;625421816;13804;321;14879;15026;6.22;0.38;302.00;17.83;1075;82;5178.00;147
13804;79;625421830;13804;319;14879;15026;6.21;0.38;302.00;17.83;1075;82;5179.00;147
13805;79;625421843;13805;318;14879;15026;6.15;0.37;301.99;17.83;1074;82;5180.00;147
13808;79;625421857;13808;310;14879;15026;6.07;0.37;302.02;17.83;1071;82;5181.00;147
13808;79;625421870;13808;315;14880;15026;6.03;0.37;302.02;17.93;1072;82;5182.00;146
13808;79;625421884;13808;321;14880;15026;6.01;0.37;302.02;17.93;1072;82;5183.00;146
13808;79;625421899;13808;353;14951;15153;6.05;0.37;302.02;17.84;1143;82;5184.00;202
13809;79;625421924;13809;348;14952;15154;6.06;0.37;302.01;17.84;1143;82;5185.00;202
13810;79;625421937;13810;344;14959;15154;6.16;0.38;302.05;17.83;1149;82;5186.00;195
13812;79;625421951;13812;343;14963;15154;6.18;0.38;302.06;17.83;1151;82;5187.00;191
13813;79;625421964;13813;342;14969;15154;6.20;0.38;302.06;17.82;1156;82;5188.00;185
13814;79;625421978;13814;350;14973;15154;6.17;0.38;302.08;17.82;1159;82;5189.00;181
13815;79;625421993;13815;344;14978;15154;6.15;0.38;302.07;17.82;1163;82;5190.00;176
13819;79;625422007;13819;344;14981;15154;6.09;0.37;302.14;17.81;1162;82;5191.00;173
13821;79;625422024;13821;348;14985;15155;6.05;0.37;302.14;17.81;1164;82;5192.00;170
13823;79;625422038;13823;348;14987;15156;6.01;0.37;302.13;17.81;1164;82;5193.00;169
13825;79;625422059;13825;344;14988;15156;6.00;0.37;302.14;17.81;1163;82;5194.00;168
13826;79;625422073;13826;339;14989;15157;5.96;0.37;302.13;17.81;1163;82;5195.00;168
13829;79;625422086;13829;347;14991;15157;5.96;0.37;302.17;17.81;1162;82;5196.00;166
13830;79;625422100;13830;348;14992;15157;5.94;0.37;302.17;17.81;1162;82;5197.00;165
13833;79;625422119;13833;349;14994;15157;5.91;0.36;302.19;17.81;1161;82;5198.00;163
13835;79;625422132;13835;349;14996;15161;5.85;0.36;302.20;17.81;1161;82;5199.00;165
13840;79;625422147;13840;347;14998;15161;5.73;0.35;302.18;17.90;1158;82;5200.00;163
13844;79;625422163;13844;349;14999;15161;5.60;0.34;302.17;17.90;1155;82;5201.00;162
13848;79;625422176;13848;348;15001;15164;5.48;0.34;302.14;17.90;1153;82;5202.00;163
13849;79;625422189;13849;340;15002;15164;5.38;0.33;302.14;17.90;1153;82;5203.00;162
13854;79;625422202;13854;341;15003;15164;5.26;0.32;302.11;17.90;1149;82;5204.00;161
13856;79;625422215;13856;340;15008;15168;5.16;0.32;302.09;17.93;1152;82;5205.00;160
13860;79;625422230;13860;336;15010;15169;5.09;0.31;302.03;17.92;1150;82;5206.00;159
13863;79;625422243;13863;339;15011;15169;5.08;0.31;302.08;17.92;1148;82;5207.00;158
13867;79;625422255;13867;331;15013;15173;5.04;0.31;302.05;17.92;1146;82;5208.00;160
13869;79;625422269;13869;334;15013;15173;5.00;0.31;302.02;17.92;1144;82;5209.00;160
13870;79;625422281;13870;332;15013;15173;4.99;0.31;302.01;17.92;1143;82;5210.00;160
13872;79;625422294;13872;333;15014;15174;4.98;0.31;301.98;17.92;1142;82;5211.00;160
13873;79;625422307;13873;337;15016;15174;4.98;0.30;301.99;18.02;1143;82;5212.00;158
13877;79;625422319;13877;341;15019;15180;5.03;0.31;301.94;18.01;1142;82;5213.00;161
13878;79;625422333;13878;348;15019;15180;5.08;0.31;301.93;18.01;1141;82;5214.00;161
13882;79;625422345;13882;350;15021;15180;5.10;0.31;301.91;18.01;1139;82;5215.00;159
13884;79;625422357;13884;353;15021;15181;5.11;0.31;301.88;18.01;1137;82;5216.00;160
13886;79;625422370;13886;357;15022;15181;5.11;0.31;301.86;18.01;1136;82;5217.00;159
13889;79;625422383;13889;360;15022;15181;5.10;0.31;301.80;18.01;1133;82;5218.00;159
13893;79;625422395;13893;357;15022;15181;5.12;0.31;301.73;18.01;1129;82;5219.00;159
13895;79;625422409;13895;361;15043;15217;5.20;0.32;301.77;17.99;1148;82;5220.00;174
13899;79;625422425;13899;358;15046;15217;5.14;0.31;301.75;18.08;1147;82;5221.00;171
13899;79;625422438;13899;367;15048;15217;5.11;0.31;301.75;18.08;1149;82;5222.00;169
13900;79;625422451;13900;372;15048;15217;5.12;0.31;301.75;18.08;1148;82;5223.00;169
13900;79;625422463;13900;370;15050;15217;5.14;0.31;301.75;18.08;1150;82;5224.00;167
13901;79;625422477;13901;370;15052;15217;5.17;0.31;301.74;18.08;1151;82;5225.00;165
13902;79;625422489;13902;372;15055;15221;5.21;0.32;301.72;18.07;1153;82;5226.00;166
13903;79;625422502;13903;382;15056;15221;5.24;0.32;301.72;18.07;1153;82;5227.00;165
13905;79;625422515;13905;383;15061;15225;5.27;0.32;301.70;18.07;1156;82;5228.00;164
13906;79;625422528;13906;393;15062;15226;5.31;0.32;301.68;18.07;1156;82;5229.00;164
13906;79;625422542;13906;393;15065;15226;5.32;0.32;301.68;18.08;1159;82;5230.00;161
13908;79;625422554;13908;399;15065;15226;5.28;0.32;301.75;18.08;1157;82;5231.00;161
13909;79;625422567;13909;397;15076;15239;5.24;0.32;301.73;18.09;1167;82;5232.00;163
13910;79;625422581;13910;393;15076;15239;5.19;0.32;301.73;18.09;1166;82;5233.00;163
13910;79;625422594;13910;391;15079;15239;5.17;0.31;301.73;18.12;1169;82;5234.00;160
13912;79;625422613;13912;381;15081;15240;5.18;0.31;301.72;18.14;1169;82;5235.00;159
13913;79;625422626;13913;377;15082;15241;5.19;0.32;301.70;18.15;1169;82;5236.00;159
13914;79;625422640;13914;373;15083;15241;5.26;0.32;301.70;18.17;1169;82;5237.00;158
13914;79;625422653;13914;369;15086;15244;5.36;0.33;301.70;18.18;1172;82;5238.00;158
13915;79;625422667;13915;366;15087;15244;5.42;0.33;301.70;18.19;1172;82;5239.00;157
13915;79;625422681;13915;357;15088;15244;5.46;0.33;301.70;18.19;1173;82;5240.00;156
13916;79;625422695;13916;349;15089;15244;5.46;0.33;301.69;18.21;1173;82;5241.00;155
13916;79;625422709;13916;343;15094;15250;5.52;0.34;301.69;18.22;1178;82;5242.00;156
13917;80;625422724;13917;336;15096;15250;5.55;0.34;301.68;18.24;1179;83;5243.00;154
13918;81;625422749;13918;328;15098;15250;5.57;0.34;301.67;18.26;1180;84;5244.00;152
13920;82;625422770;13920;330;15099;15250;5.54;0.34;301.63;18.27;1179;85;5245.00;151
13920;82;625422795;13920;332;15102;15254;5.55;0.34;301.63;18.27;1182;85;5246.00;152
13920;82;625422818;13920;339;15103;15255;5.55;0.34;301.63;18.26;1183;85;5247.00;152
13922;82;625422831;13922;346;15106;15255;5.50;0.34;301.60;18.30;1184;85;5248.00;149
13923;82;625422850;13923;345;15108;15256;5.52;0.34;301.60;18.31;1185;85;5249.00;148
13927;82;625422865;13927;340;15110;15256;5.46;0.33;301.59;18.34;1183;85;5250.00;146
13927;82;625422878;13927;339;15111;15256;5.46;0.33;301.59;18.35;1184;85;5251.00;145
13927;82;625422891;13927;340;15112;15256;5.46;0.33;301.59;18.36;1185;85;5252.00;144
13928;82;625422904;13928;344;15112;15256;5.50;0.33;301.60;18.36;1184;85;5253.00;144
13928;82;625422917;13928;345;15115;15256;5.54;0.34;301.60;18.39;1187;85;5254.00;141
13929;82;625422930;13929;343;15115;15256;5.60;0.34;301.60;18.39;1186;85;5255.00;141
13931;82;625422943;13931;351;15153;15326;5.80;0.35;301.57;18.35;1222;85;5256.00;173
13932;82;625422962;13932;353;15153;15327;5.78;0.35;301.56;18.35;1221;85;5257.00;174
13932;82;625422982;13932;350;15164;15327;5.84;0.36;301.56;18.36;1232;85;5258.00;163
13934;83;625423001;13934;353;15172;15327;5.88;0.36;301.54;18.35;1238;86;5259.00;155
13935;83;625423044;13935;355;15179;15327;5.86;0.36;301.53;18.37;1244;86;5260.00;148
13937;83;625423065;13937;364;15184;15327;5.84;0.36;301.54;18.37;1247;86;5261.00;143
13942;83;625423089;13942;361;15186;15327;5.77;0.35;301.54;18.37;1244;86;5262.00;141
13943;83;625423111;13943;369;15187;15327;5.75;0.35;301.56;18.38;1244;86;5263.00;140
13947;83;625423132;13947;368;15190;15328;5.69;0.35;301.54;18.38;1243;86;5264.00;138
13950;83;625423151;13950;371;15192;15330;5.64;0.34;301.54;18.38;1242;86;5265.00;138
13957;83;625423167;13957;378;15193;15330;5.51;0.34;301.57;18.39;1236;86;5266.00;137
13961;83;625423183;13961;386;15197;15334;5.37;0.33;301.59;18.39;1236;86;5267.00;137
13969;83;625423199;13969;387;15198;15334;5.25;0.32;301.65;18.40;1229;86;5268.00;136
13972;83;625423215;13972;394;15199;15334;5.21;0.32;301.69;18.41;1227;86;5269.00;135
13976;83;625423230;13976;386;15199;15334;5.22;0.32;301.78;18.41;1223;86;5270.00;135
13980;83;625423246;13980;389;15205;15340;5.29;0.32;301.88;18.41;1225;86;5271.00;135
13984;83;625423262;13984;387;15205;15340;5.30;0.32;301.93;18.41;1221;86;5272.00;135
13986;83;625423277;13986;395;15207;15340;5.31;0.32;301.98;18.42;1221;86;5273.00;133
13992;83;625423300;13992;399;15209;15343;5.34;0.33;301.99;18.42;1217;86;5274.00;134
13996;83;625423316;13996;399;15209;15343;5.35;0.33;302.10;18.42;1213;86;5275.00;134
13998;83;625423337;13998;403;15209;15343;5.36;0.33;302.13;18.42;1211;86;5276.00;134
14001;83;625423352;14001;393;15211;15344;5.39;0.33;302.13;18.42;1210;86;5277.00;133
14005;83;625423367;14005;393;15212;15345;5.48;0.33;302.22;18.42;1207;86;5278.00;133
14008;83;625423382;14008;392;15212;15345;5.54;0.34;302.27;18.42;1204;86;5279.00;133
14014;83;625423400;14014;389;15232;15371;5.58;0.34;302.35;18.40;1218;86;5280.00;139
14017;83;625423419;14017;383;15233;15371;5.69;0.35;302.42;18.40;1216;86;5281.00;138
14020;83;625423434;14020;379;15234;15371;5.72;0.35;302.44;18.40;1214;86;5282.00;137
14024;83;625423450;14024;382;15235;15372;5.75;0.35;302.56;18.40;1211;86;5283.00;137
14030;83;625423466;14030;378;15235;15372;5.75;0.35;302.68;18.40;1205;86;5284.00;137
14035;83;625423484;14035;369;15239;15376;5.82;0.35;302.69;18.39;1204;86;5285.00;137
14038;83;625423500;14038;359;15239;15376;5.89;0.36;302.74;18.39;1201;86;5286.00;137
14043;84;625423515;14043;352;15242;15379;5.94;0.36;302.79;18.39;1199;87;5287.00;137
14047;84;625423539;14047;353;15242;15380;5.95;0.36;302.83;18.39;1195;87;5288.00;138
14054;84;625423556;14054;351;15242;15380;5.98;0.36;302.87;18.39;1188;87;5289.00;138
14057;84;625423577;14057;346;15242;15380;6.00;0.37;302.90;18.39;1185;87;5290.00;138
14062;84;625423593;14062;343;15242;15380;6.01;0.37;302.99;18.39;1180;87;5291.00;138
14067;84;625423609;14067;349;15252;15392;6.08;0.37;303.01;18.38;1185;87;5292.00;140
14072;85;625423625;14072;358;15253;15392;6.10;0.37;303.03;18.37;1181;88;5293.00;139
14077;85;625423660;14077;367;15253;15392;6.08;0.37;303.07;18.37;1176;88;5294.00;139
14079;85;625423676;14079;368;15253;15392;6.12;0.37;303.15;18.37;1174;88;5295.00;139
14084;85;625423693;14084;367;15253;15392;6.14;0.37;303.20;18.37;1169;88;5296.00;139
14088;85;625423711;14088;373;15253;15392;6.16;0.37;303.24;18.37;1165;88;5297.00;139
14091;85;625423727;14091;376;15253;15393;6.21;0.38;303.30;18.37;1162;88;5298.00;140
14096;85;625423743;14096;376;15253;15393;6.22;0.38;303.32;18.37;1157;88;5299.00;140
14099;85;625423759;14099;380;15257;15399;6.27;0.38;303.38;18.37;1158;88;5300.00;142
14103;85;625423781;14103;390;15259;15400;6.23;0.38;303.38;18.37;1156;88;5301.00;141
14104;85;625423797;14104;398;15259;15400;6.22;0.38;303.41;18.37;1155;88;5302.00;141
14108;85;625423813;14108;398;15259;15400;6.22;0.38;303.46;18.37;1151;88;5303.00;141
14113;85;625423829;14113;389;15262;15404;6.23;0.38;303.52;18.36;1149;88;5304.00;142
14120;85;625423853;14120;395;15262;15404;6.24;0.38;303.55;18.36;1142;88;5305.00;142
14123;85;625423868;14123;399;15262;15404;6.27;0.38;303.54;18.36;1139;88;5306.00;142
14125;85;625423892;14125;400;15263;15405;6.30;0.38;303.60;18.36;1138;88;5307.00;142
14128;85;625423908;14128;404;15266;15409;6.30;0.38;303.59;18.36;1138;88;5308.00;143
14132;85;625423924;14132;403;15266;15409;6.25;0.38;303.65;18.36;1134;88;5309.00;143
14133;85;625423943;14133;402;15269;15415;6.29;0.38;303.65;18.36;1136;88;5310.00;146
14135;85;625423960;14135;407;15269;15415;6.29;0.39;303.67;18.36;1134;88;5311.00;146
14141;85;625423976;14141;409;15270;15415;6.25;0.38;303.74;18.35;1129;88;5312.00;145
14141;85;625423992;14141;413;15270;15415;6.22;0.38;303.74;18.35;1129;88;5313.00;145
14145;85;625424008;14145;419;15273;15419;6.19;0.38;303.74;18.35;1128;88;5314.00;146
14149;85;625424026;14149;425;15273;15419;6.11;0.37;303.78;18.35;1124;88;5315.00;146
14152;85;625424042;14152;432;15274;15419;5.99;0.37;303.91;18.35;1122;88;5316.00;145
14156;85;625424056;14156;419;15274;15419;5.93;0.36;303.94;18.35;1118;88;5317.00;145
14160;85;625424072;14160;416;15275;15420;5.91;0.36;303.95;18.35;1115;88;5318.00;145
14162;85;625424086;14162;419;15276;15421;5.88;0.36;303.98;18.35;1114;88;5319.00;145
14168;85;625424101;14168;411;15277;15421;5.86;0.36;304.14;18.35;1109;88;5320.00;144
14172;85;625424115;14172;419;15278;15422;5.86;0.36;304.26;18.35;1106;88;5321.00;144
14178;85;625424130;14178;421;15278;15422;5.85;0.36;304.42;18.35;1100;88;5322.00;144
14183;85;625424144;14183;428;15278;15422;5.82;0.35;304.43;18.35;1095;88;5323.00;144
14187;85;625424164;14187;432;15278;15422;5.82;0.35;304.52;18.35;1091;88;5324.00;144
14190;85;625424178;14190;438;15279;15422;5.82;0.35;304.55;18.45;1089;88;5325.00;143
14193;85;625424200;14193;426;15279;15422;5.83;0.35;304.58;18.45;1086;88;5326.00;143
14196;85;625424213;14196;412;15279;15422;5.84;0.35;304.63;18.45;1083;88;5327.00;143
14199;85;625424228;14199;431;15349;15549;6.00;0.37;304.67;18.36;1150;88;5328.00;200
14202;85;625424253;14202;406;15351;15550;6.01;0.37;304.74;18.36;1149;88;5329.00;199
14205;85;625424268;14205;387;15358;15550;6.08;0.37;304.73;18.35;1153;88;5330.00;192
14206;85;625424283;14206;378;15362;15550;6.14;0.38;304.77;18.35;1156;88;5331.00;188
14209;85;625424298;14209;374;15367;15550;6.21;0.38;304.82;18.34;1158;88;5332.00;183
14211;85;625424313;14211;371;15371;15550;6.23;0.38;304.87;18.34;1160;88;5333.00;179
14215;85;625424327;14215;380;15376;15550;6.30;0.39;304.95;18.34;1161;88;5334.00;174
14216;85;625424343;14216;370;15378;15550;6.38;0.39;304.98;18.34;1162;88;5335.00;172
14217;85;625424357;14217;380;15383;15551;6.45;0.40;305.03;18.33;1166;88;5336.00;168
14222;85;625424372;14222;374;15386;15552;6.43;0.40;305.00;18.33;1164;88;5337.00;166
14225;85;625424393;14225;371;15388;15552;6.42;0.39;305.00;18.33;1163;88;5338.00;164
14228;85;625424408;14228;372;15389;15553;6.44;0.40;304.97;18.33;1161;88;5339.00;164
14229;85;625424425;14229;372;15392;15553;6.43;0.40;304.96;18.33;1163;88;5340.00;161
14232;85;625424440;14232;378;15393;15553;6.42;0.39;304.93;18.33;1161;88;5341.00;160
14235;85;625424455;14235;373;15396;15553;6.43;0.40;305.01;18.33;1161;88;5342.00;157
14238;85;625424470;14238;377;15398;15557;6.38;0.39;305.03;18.32;1160;88;5343.00;159
14242;85;625424485;14242;380;15400;15557;6.38;0.39;305.12;18.32;1158;88;5344.00;157
14244;85;625424500;14244;389;15401;15557;6.39;0.39;305.10;18.32;1157;88;5345.00;156
14244;85;625424515;14244;389;15404;15560;6.37;0.39;305.10;18.32;1160;88;5346.00;156
14245;85;625424535;14245;383;15405;15560;6.33;0.39;305.09;18.32;1160;88;5347.00;155
14247;85;625424550;14247;382;15406;15560;6.26;0.38;305.16;18.32;1159;88;5348.00;154
14248;85;625424569;14248;389;15409;15564;6.21;0.38;305.14;18.31;1161;88;5349.00;155
14252;85;625424584;14252;396;15410;15565;6.17;0.38;305.14;18.31;1158;88;5350.00;155
14254;85;625424599;14254;401;15410;15565;6.11;0.37;305.11;18.31;1156;88;5351.00;155
14257;85;625424612;14257;399;15413;15569;6.02;0.37;305.12;18.31;1156;88;5352.00;156
14259;85;625424626;14259;401;15413;15569;5.95;0.36;305.11;18.31;1154;88;5353.00;156
14263;85;625424640;14263;405;15413;15569;5.85;0.36;305.13;18.31;1150;88;5354.00;156
14268;85;625424654;14268;413;15415;15571;5.75;0.35;305.11;18.31;1147;88;5355.00;156
14269;85;625424668;14269;417;15415;15571;5.67;0.35;305.11;18.31;1146;88;5356.00;156
14269;85;625424681;14269;423;15419;15577;5.58;0.34;305.11;18.30;1150;88;5357.00;158
14270;85;625424695;14270;434;15419;15577;5.52;0.34;305.10;18.30;1149;88;5358.00;158
14271;85;625424708;14271;439;15420;15577;5.51;0.34;305.08;18.30;1149;88;5359.00;157
14273;85;625424721;14273;443;15420;15578;5.46;0.33;305.06;18.30;1147;88;5360.00;158
14275;85;625424734;14275;434;15420;15578;5.42;0.33;305.07;18.30;1145;88;5361.00;158
14279;85;625424746;14279;427;15421;15578;5.33;0.33;305.06;18.40;1142;88;5362.00;157
14280;85;625424761;14280;436;15421;15578;5.34;0.33;305.07;18.40;1141;88;5363.00;157
14285;85;625424777;14285;432;15431;15590;5.31;0.33;305.02;18.39;1146;88;5364.00;159
14289;85;625424797;14289;426;15431;15590;5.23;0.32;304.99;18.39;1142;88;5365.00;159
14291;85;625424812;14291;424;15432;15590;5.24;0.32;304.97;18.39;1141;88;5366.00;158
14294;85;625424825;14294;427;15432;15590;5.19;0.32;304.94;18.39;1138;88;5367.00;158
14298;85;625424837;14298;429;15432;15590;5.12;0.32;304.95;18.39;1134;88;5368.00;158
14299;85;625424850;14299;420;15432;15590;5.09;0.31;304.96;18.39;1133;88;5369.00;158
14302;85;625424863;14302;420;15435;15594;5.08;0.31;304.97;18.38;1133;88;5370.00;159
14307;85;625424879;14307;421;15435;15594;5.04;0.31;304.93;18.38;1128;88;5371.00;159
14311;85;625424895;14311;409;15438;15598;5.03;0.31;304.90;18.38;1127;88;5372.00;160
14315;85;625424909;14315;400;15440;15599;5.04;0.31;304.93;18.38;1125;88;5373.00;159
14319;85;625424923;14319;393;15440;15599;5.01;0.31;304.98;18.38;1121;88;5374.00;159
14320;85;625424942;14320;386;15441;15599;5.00;0.31;304.98;18.39;1121;88;5375.00;158
14324;85;625424963;14324;381;15451;15612;5.04;0.31;304.93;18.38;1127;88;5376.00;161
14329;85;625424981;14329;378;15452;15612;4.98;0.30;304.99;18.48;1123;88;5377.00;160
14331;85;625424996;14331;384;15453;15612;5.01;0.31;304.99;18.48;1122;88;5378.00;159
14334;85;625425010;14334;384;15454;15613;5.06;0.31;305.01;18.48;1120;88;5379.00;159
14335;85;625425029;14335;386;15455;15614;5.09;0.31;304.99;18.57;1120;88;5380.00;159
14337;85;625425056;14337;389;15455;15614;5.09;0.31;304.96;18.57;1118;88;5381.00;159
14338;85;625425077;14338;382;15457;15617;5.15;0.31;304.94;18.57;1119;88;5382.00;160
14340;85;625425104;14340;386;15458;15617;5.19;0.32;304.95;18.57;1118;88;5383.00;159
14341;85;625425125;14341;385;15458;15617;5.25;0.32;304.96;18.57;1117;88;5384.00;159
14343;85;625425142;14343;393;15458;15617;5.22;0.32;304.93;18.57;1115;88;5385.00;159
14344;85;625425157;14344;390;15462;15623;5.25;0.32;304.93;18.57;1118;88;5386.00;161
14344;85;625425171;14344;372;15463;15623;5.30;0.32;304.93;18.58;1119;88;5387.00;160
14346;85;625425185;14346;371;15464;15623;5.31;0.32;304.91;18.58;1118;88;5388.00;159
14347;85;625425199;14347;365;15464;15623;5.33;0.32;304.90;18.58;1117;88;5389.00;159
14349;85;625425214;14349;363;15467;15627;5.33;0.32;304.89;18.57;1118;88;5390.00;160
14351;85;625425232;14351;357;15468;15628;5.34;0.32;304.89;18.57;1117;88;5391.00;160
14353;86;625425248;14353;345;15468;15628;5.40;0.33;304.89;18.57;1115;89;5392.00;160
14355;86;625425278;14355;344;15469;15629;5.46;0.33;304.90;18.57;1114;89;5393.00;160
14357;86;625425295;14357;341;15469;15629;5.55;0.34;304.87;18.57;1112;89;5394.00;160
14358;86;625425311;14358;333;15469;15629;5.65;0.34;304.86;18.57;1111;89;5395.00;160
14358;86;625425325;14358;332;15470;15629;5.70;0.35;304.86;18.58;1112;89;5396.00;159
14359;86;625425354;14359;333;15470;15629;5.76;0.35;304.85;18.58;1111;89;5397.00;159
14361;86;625425368;14361;333;15471;15629;5.74;0.35;304.88;18.59;1110;89;5398.00;158
14362;86;625425389;14362;331;15471;15629;5.73;0.35;304.88;18.59;1109;89;5399.00;158
