step_arrived;step_collisions;step_duration;step_ended;step_halting;step_inserted;step_loaded;step_meanSpeed;step_meanSpeedRelative;step_meanTravelTime;step_meanWaitingTime;step_running;step_teleports;step_time;step_waiting
0;0;5679633;0;1;87;245;16.19;1.15;-1.00;0.00;87;0;0.00;158
0;0;5679656;0;1;103;245;15.14;1.05;-1.00;0.16;103;0;1.00;142
0;0;5679657;0;1;123;245;14.25;0.98;-1.00;0.46;123;0;2.00;122
0;0;5679658;0;1;136;245;13.20;0.90;-1.00;0.70;136;0;3.00;109
0;0;5679659;0;1;150;245;12.34;0.83;-1.00;1.01;150;0;4.00;95
0;0;5679660;0;5;156;245;11.49;0.77;-1.00;1.16;156;0;5.00;89
0;0;5679661;0;9;166;245;10.58;0.71;-1.00;1.45;166;0;6.00;79
0;0;5679663;0;13;175;245;10.14;0.68;-1.00;1.74;175;0;7.00;70
0;0;5679664;0;21;184;246;9.60;0.64;-1.00;2.04;184;0;8.00;62
0;0;5679666;0;25;188;247;9.35;0.62;-1.00;2.19;188;0;9.00;59
0;0;5679668;0;25;197;247;9.09;0.60;-1.00;2.55;197;0;10.00;50
0;0;5679670;0;30;200;248;8.99;0.59;-1.00;2.63;200;0;11.00;48
0;0;5679672;0;30;206;248;8.85;0.58;-1.00;2.90;206;0;12.00;42
1;0;5679674;1;32;211;248;8.71;0.57;13.00;3.14;210;0;13.00;37
2;0;5679676;2;40;212;248;8.76;0.57;13.50;3.19;210;0;14.00;36
2;0;5679679;2;44;221;252;8.51;0.55;13.50;3.54;219;0;15.00;31
2;0;5679681;2;48;225;252;8.41;0.54;13.50;3.76;223;0;16.00;27
2;0;5679684;2;56;228;252;8.26;0.52;13.50;3.91;226;0;17.00;24
2;0;5679686;2;55;233;255;8.16;0.52;13.50;4.15;231;0;18.00;22
2;0;5679689;2;59;235;255;8.27;0.52;13.50;4.14;233;0;19.00;20
2;0;5679691;2;64;236;255;8.33;0.53;13.50;4.21;234;0;20.00;19
4;0;5679694;4;72;243;259;8.49;0.54;17.25;4.36;239;0;21.00;16
5;0;5679696;5;74;246;260;8.57;0.54;18.20;4.42;241;0;22.00;14
6;0;5679700;6;77;248;260;8.62;0.54;18.83;4.57;242;0;23.00;12
6;0;5679702;6;81;253;264;8.70;0.55;18.83;4.67;247;0;24.00;11
6;0;5679705;6;83;255;264;8.84;0.55;18.83;4.73;249;0;25.00;9
6;0;5679708;6;83;257;264;8.95;0.56;18.83;4.90;251;0;26.00;7
6;0;5679711;6;84;258;265;8.96;0.56;18.83;4.98;252;0;27.00;7
6;0;5679714;6;86;259;265;8.97;0.56;18.83;5.07;253;0;28.00;6
6;0;5679717;6;90;265;271;8.89;0.55;18.83;5.05;259;0;29.00;6
6;0;5679722;6;92;266;271;8.80;0.54;18.83;5.04;260;0;30.00;5
7;0;5679725;7;94;268;272;8.70;0.54;20.14;5.06;261;0;31.00;4
8;0;5679728;8;96;269;272;8.63;0.53;21.63;5.06;261;0;32.00;3
10;0;5679731;10;98;269;272;8.64;0.53;23.90;5.06;259;0;33.00;3
10;0;5679733;10;101;269;272;8.72;0.54;23.90;5.06;259;0;34.00;3
11;0;5679736;11;104;269;272;8.72;0.54;24.36;5.06;258;0;35.00;3
11;0;5679739;11;107;280;284;9.04;0.56;24.36;4.86;269;0;36.00;4
11;0;5679743;11;109;280;284;9.01;0.55;24.36;4.86;269;0;37.00;4
13;0;5679746;13;111;281;284;8.91;0.55;25.92;4.85;268;0;38.00;3
13;0;5679748;13;113;281;284;8.79;0.54;25.92;4.85;268;0;39.00;3
13;0;5679751;13;118;281;284;8.69;0.54;25.92;4.85;268;0;40.00;3
14;0;5679754;14;119;281;284;8.55;0.53;26.86;4.85;267;0;41.00;3
14;0;5679757;14;122;285;288;8.51;0.53;26.86;4.79;271;0;42.00;3
16;0;5679760;16;124;285;288;8.23;0.51;27.25;4.79;269;0;43.00;3
17;0;5679762;17;126;289;292;8.13;0.50;28.24;4.74;272;0;44.00;3
17;0;5679765;17;131;291;294;7.98;0.50;28.24;4.71;274;0;45.00;3
17;0;5679768;17;134;291;294;7.84;0.49;28.24;4.71;274;0;46.00;3
17;0;5679771;17;134;291;294;7.76;0.48;28.24;4.71;274;0;47.00;3
18;0;5679773;18;141;302;307;7.96;0.50;28.78;4.54;284;0;48.00;5
18;0;5679777;18;141;302;307;7.84;0.49;28.78;4.54;284;0;49.00;5
18;0;5679779;18;143;302;307;7.67;0.48;28.78;4.54;284;0;50.00;5
18;0;5679782;18;144;303;308;7.57;0.47;28.78;4.52;285;0;51.00;5
19;0;5679785;19;148;304;309;7.45;0.47;29.63;4.51;285;0;52.00;5
20;0;5679788;20;151;304;309;7.35;0.46;29.00;4.51;284;0;53.00;5
20;0;5679790;20;152;306;312;7.41;0.46;29.00;4.48;286;0;54.00;6
22;0;5679793;22;154;306;312;7.33;0.46;31.36;4.48;284;0;55.00;6
23;0;5679796;23;142;307;312;7.28;0.45;32.39;4.48;284;0;56.00;5
25;0;5679799;25;137;307;312;7.14;0.44;34.24;4.48;282;0;57.00;5
26;0;5679801;26;138;313;318;7.13;0.44;35.15;4.41;287;0;58.00;5
28;0;5679804;28;141;313;318;7.09;0.44;35.96;4.41;285;0;59.00;5
29;0;5679808;29;146;313;318;7.11;0.43;35.86;4.41;284;0;60.00;5
29;0;5679811;29;149;313;318;7.15;0.44;35.86;4.41;284;0;61.00;5
29;0;5679814;29;152;317;322;7.22;0.44;35.86;4.37;288;0;62.00;5
29;0;5679817;29;155;318;323;7.43;0.45;35.86;4.35;289;0;63.00;5
31;0;5679820;31;157;318;323;7.46;0.45;36.10;4.35;287;0;64.00;5
32;0;5679823;32;157;319;324;7.53;0.46;37.00;4.34;287;0;65.00;5
33;0;5679825;33;159;319;324;7.55;0.46;37.76;4.34;286;0;66.00;5
34;0;5679828;34;146;319;324;7.58;0.46;38.62;4.34;285;0;67.00;5
35;0;5679831;35;143;319;324;7.72;0.47;39.31;4.34;284;0;68.00;5
35;0;5679834;35;136;319;324;7.85;0.47;39.31;4.34;284;0;69.00;5
35;0;5679837;35;133;319;324;7.97;0.48;39.31;4.34;284;0;70.00;5
35;0;5679839;35;129;319;324;8.14;0.49;39.31;4.34;284;0;71.00;5
35;0;5679842;35;135;353;394;8.49;0.52;39.31;3.92;318;0;72.00;41
35;0;5679851;35;128;354;395;8.66;0.53;39.31;3.92;319;0;73.00;41
35;0;5679854;35;121;361;395;8.97;0.55;39.31;3.88;326;0;74.00;34
35;0;5679858;35;120;363;395;9.12;0.56;39.31;3.87;328;0;75.00;32
35;0;5679862;35;116;365;395;9.36;0.57;39.31;3.87;330;0;76.00;30
35;0;5679866;35;114;366;395;9.48;0.58;39.31;3.88;331;0;77.00;29
36;0;5679870;36;115;370;395;9.58;0.58;39.81;3.90;334;0;78.00;25
36;0;5679873;36;119;371;395;9.57;0.58;39.81;3.91;335;0;79.00;24
37;0;5679876;37;119;373;396;9.58;0.58;40.89;3.93;336;0;80.00;23
38;0;5679885;38;120;376;397;9.57;0.58;41.39;3.97;338;0;81.00;21
39;0;5679888;39;122;379;397;9.46;0.57;42.44;4.02;340;0;82.00;18
40;0;5679892;40;125;386;401;9.26;0.56;43.45;4.00;346;0;83.00;15
40;0;5679895;40;130;386;401;9.18;0.56;43.45;4.00;346;0;84.00;15
40;0;5679899;40;132;386;401;9.15;0.56;43.45;4.00;346;0;85.00;15
40;0;5679902;40;130;386;401;9.03;0.55;43.45;4.00;346;0;86.00;15
42;0;5679905;42;135;391;407;8.90;0.54;45.50;3.96;349;0;87.00;16
43;0;5679909;43;137;391;407;8.78;0.54;46.49;3.96;348;0;88.00;16
43;0;5679912;43;137;391;407;8.72;0.53;46.49;3.96;348;0;89.00;16
44;0;5679917;44;137;395;413;8.79;0.54;47.48;3.92;351;0;90.00;18
45;0;5679921;45;136;396;413;8.82;0.54;48.44;3.91;351;0;91.00;17
48;0;5679925;48;136;397;413;8.69;0.53;50.90;3.91;349;0;92.00;16
49;0;5679928;49;133;398;414;8.55;0.52;51.76;3.90;349;0;93.00;16
51;0;5679932;51;131;399;415;8.42;0.51;53.41;3.89;348;0;94.00;16
53;0;5679936;53;126;399;415;8.30;0.51;53.62;3.89;346;0;95.00;16
54;0;5679940;54;126;410;428;8.21;0.50;54.28;3.79;356;0;96.00;18
55;0;5679944;55;116;410;428;8.22;0.50;55.05;3.79;355;0;97.00;18
56;0;5679948;56;113;410;428;8.34;0.51;55.82;3.79;354;0;98.00;18
58;0;5679952;58;106;413;429;8.46;0.52;57.28;3.89;355;0;99.00;16
60;0;5679959;60;103;413;429;8.65;0.53;58.58;3.89;353;0;100.00;16
62;0;5679966;62;99;416;433;8.90;0.54;59.95;3.87;354;0;101.00;17
62;0;5679971;62;98;416;433;9.12;0.56;59.95;3.87;354;0;102.00;17
63;0;5679975;63;95;420;437;9.23;0.56;60.62;3.85;357;0;103.00;17
63;0;5679979;63;89;420;437;9.53;0.58;60.62;3.85;357;0;104.00;17
65;0;5679983;65;84;420;437;9.66;0.59;61.92;3.85;355;0;105.00;17
65;0;5679987;65;77;420;437;9.86;0.60;61.92;3.85;355;0;106.00;17
66;0;5679991;66;74;420;437;10.00;0.61;62.58;3.85;354;0;107.00;17
67;0;5679995;67;70;431;449;10.12;0.62;63.21;3.75;364;0;108.00;18
68;0;5680000;68;69;432;449;10.19;0.62;63.88;3.74;364;0;109.00;17
68;0;5680005;68;67;432;449;10.26;0.63;63.88;3.74;364;0;110.00;17
68;0;5680009;68;71;432;449;10.33;0.63;63.88;3.74;364;0;111.00;17
69;0;5680013;69;70;433;449;10.39;0.64;64.06;3.99;364;0;112.00;16
69;0;5680018;69;73;435;449;10.42;0.64;64.06;4.16;366;0;113.00;14
69;0;5680022;69;74;436;450;10.46;0.64;64.06;4.15;367;0;114.00;14
69;0;5680027;69;76;439;450;10.46;0.64;64.06;4.58;370;0;115.00;11
70;0;5680032;70;78;444;456;10.55;0.65;64.80;4.54;374;0;116.00;12
73;0;5680037;73;77;445;457;10.60;0.65;66.89;4.53;372;0;117.00;12
74;0;5680042;74;78;448;457;10.65;0.65;67.55;4.97;374;0;118.00;9
74;0;5680047;74;82;448;457;10.82;0.66;67.55;4.97;374;0;119.00;9
77;0;5680053;77;83;454;462;10.95;0.67;69.35;5.14;377;0;120.00;8
78;0;5680059;78;86;455;462;11.20;0.68;69.99;5.17;377;0;121.00;7
80;0;5680064;80;84;457;462;11.35;0.69;71.20;5.33;377;0;122.00;5
81;0;5680075;81;83;458;463;11.49;0.70;71.40;5.32;377;0;123.00;5
82;0;5680080;82;83;463;467;11.53;0.70;72.01;5.38;381;0;124.00;4
83;0;5680086;83;84;464;467;11.67;0.71;72.61;5.48;381;0;125.00;3
84;0;5680091;84;84;466;470;11.82;0.72;73.25;5.46;382;0;126.00;4
84;0;5680097;84;87;468;470;11.88;0.72;73.25;5.51;384;0;127.00;2
86;0;5680103;86;90;468;470;11.98;0.73;73.13;5.51;382;0;128.00;2
86;0;5680109;86;92;468;470;12.11;0.74;73.13;5.51;382;0;129.00;2
86;0;5680115;86;91;473;474;12.23;0.75;73.13;5.53;387;0;130.00;1
88;0;5680122;88;89;473;474;12.31;0.75;74.17;5.53;385;0;131.00;1
88;0;5680128;88;90;473;474;12.35;0.75;74.17;5.53;385;0;132.00;1
89;0;5680133;89;90;474;474;12.30;0.75;74.02;5.54;385;0;133.00;0
89;0;5680139;89;91;475;475;12.21;0.75;74.02;5.53;386;0;134.00;0
90;0;5680145;90;92;477;477;12.10;0.74;73.50;5.51;387;0;135.00;0
93;0;5680150;93;94;477;477;11.87;0.73;75.38;5.51;384;0;136.00;0
93;0;5680156;93;98;478;478;11.76;0.72;75.38;5.50;385;0;137.00;0
95;0;5680162;95;98;478;478;11.53;0.71;76.68;5.50;383;0;138.00;0
96;0;5680167;96;103;478;478;11.30;0.69;77.33;5.50;382;0;139.00;0
97;0;5680173;97;107;478;478;11.05;0.68;77.24;5.50;381;0;140.00;0
99;0;5680178;99;108;478;478;10.87;0.67;78.53;5.50;379;0;141.00;0
99;0;5680183;99;105;478;478;10.75;0.66;78.53;5.50;379;0;142.00;0
102;0;5680188;102;107;478;478;10.70;0.66;79.96;5.50;376;0;143.00;0
104;0;5680194;104;125;550;605;10.59;0.67;81.13;4.79;446;0;144.00;55
104;0;5680209;104;118;557;606;10.68;0.68;81.13;4.74;453;0;145.00;49
106;0;5680214;106;116;568;606;10.80;0.68;82.01;4.69;462;0;146.00;38
110;0;5680220;110;115;571;606;10.79;0.68;84.16;4.68;461;0;147.00;35
114;0;5680225;114;120;576;606;10.68;0.67;86.11;4.67;462;0;148.00;30
118;0;5680231;118;118;577;606;10.58;0.66;86.60;4.67;459;0;149.00;29
118;0;5680238;118;121;581;611;10.34;0.65;86.60;4.66;463;0;150.00;30
119;0;5680245;119;119;584;611;10.25;0.64;87.08;4.67;465;0;151.00;27
122;0;5680251;122;119;586;612;10.23;0.64;88.30;4.68;464;0;152.00;26
122;0;5680257;122;121;590;613;10.29;0.64;88.30;4.71;468;0;153.00;23
124;0;5680263;124;124;593;613;10.33;0.64;89.31;4.74;469;0;154.00;20
127;0;5680269;127;128;597;614;10.14;0.63;89.28;4.76;470;0;155.00;17
128;0;5680275;128;126;600;614;9.93;0.62;89.66;4.78;472;0;156.00;14
129;0;5680280;129;129;602;614;9.81;0.61;90.14;4.81;473;0;157.00;12
131;0;5680286;131;134;605;614;9.65;0.60;90.61;4.84;474;0;158.00;9
133;0;5680292;133;131;608;618;9.58;0.60;90.50;4.82;475;0;159.00;10
134;0;5680297;134;131;610;618;9.50;0.59;91.02;4.86;476;0;160.00;8
138;0;5680303;138;135;611;618;9.30;0.58;92.30;4.88;473;0;161.00;7
141;0;5680308;141;135;614;621;9.17;0.57;93.03;4.92;473;0;162.00;7
143;0;5680325;143;141;616;621;9.05;0.56;93.95;4.94;473;0;163.00;5
147;0;5680331;147;144;616;621;8.93;0.55;94.61;4.94;469;0;164.00;5
148;0;5680336;148;136;620;625;8.80;0.54;94.98;4.95;472;0;165.00;5
149;0;5680343;149;133;622;626;8.80;0.54;95.37;4.95;473;0;166.00;4
149;0;5680348;149;134;622;626;8.79;0.54;95.37;4.95;473;0;167.00;4
150;0;5680354;150;131;626;630;8.78;0.54;95.85;4.93;476;0;168.00;4
151;0;5680360;151;130;627;630;8.78;0.54;96.19;4.92;476;0;169.00;3
152;0;5680368;152;132;629;630;8.85;0.55;95.73;4.95;477;0;170.00;1
152;0;5680375;152;125;631;631;8.92;0.55;95.73;4.95;479;0;171.00;0
153;0;5680385;153;123;631;631;8.96;0.55;95.44;4.95;478;0;172.00;0
153;0;5680392;153;121;637;637;9.16;0.57;95.44;4.91;484;0;173.00;0
154;0;5680398;154;118;637;637;9.19;0.57;95.47;4.91;483;0;174.00;0
156;0;5680406;156;119;638;638;9.22;0.57;95.85;4.90;482;0;175.00;0
157;0;5680417;157;117;638;638;9.25;0.57;95.97;4.90;481;0;176.00;0
158;0;5680425;158;118;638;638;9.30;0.57;96.47;4.90;480;0;177.00;0
158;0;5680431;158;120;638;638;9.30;0.57;96.47;4.90;480;0;178.00;0
158;0;5680437;158;127;638;638;9.36;0.57;96.47;4.90;480;0;179.00;0
161;0;5680446;161;133;668;672;9.48;0.58;96.94;4.68;507;0;180.00;4
164;0;5680455;164;136;669;672;9.48;0.58;96.96;4.68;505;0;181.00;3
164;0;5680462;164;145;671;672;9.53;0.59;96.96;4.67;507;0;182.00;1
166;0;5680467;166;145;672;672;9.52;0.58;97.55;4.67;506;0;183.00;0
167;0;5680473;167;150;672;672;9.44;0.58;97.50;4.67;505;0;184.00;0
169;0;5680479;169;150;672;672;9.35;0.57;98.05;4.67;503;0;185.00;0
171;0;5680486;171;151;676;676;9.26;0.57;98.35;4.65;505;0;186.00;0
171;0;5680492;171;159;676;676;9.16;0.57;98.35;4.65;505;0;187.00;0
177;0;5680498;177;162;680;680;9.02;0.56;98.28;4.63;503;0;188.00;0
179;0;5680505;179;164;681;681;8.88;0.55;98.44;4.62;502;0;189.00;0
181;0;5680512;181;174;681;681;8.72;0.54;98.66;4.62;500;0;190.00;0
184;0;5680518;184;182;681;681;8.55;0.53;98.34;4.62;497;0;191.00;0
186;0;5680524;186;185;694;694;8.59;0.53;98.95;4.53;508;0;192.00;0
186;0;5680531;186;194;694;694;8.46;0.52;98.95;4.53;508;0;193.00;0
190;0;5680536;190;191;694;694;8.37;0.51;98.72;4.53;504;0;194.00;0
191;0;5680542;191;195;695;695;8.24;0.51;98.47;4.53;504;0;195.00;0
191;0;5680548;191;202;696;696;8.11;0.50;98.47;4.52;505;0;196.00;0
193;0;5680554;193;207;696;696;8.02;0.49;97.85;4.52;503;0;197.00;0
194;0;5680560;194;212;698;699;8.08;0.50;97.62;4.51;504;0;198.00;1
196;0;5680566;196;215;698;699;7.98;0.49;98.12;4.51;502;0;199.00;1
200;0;5680572;200;218;699;699;7.90;0.49;98.20;4.51;499;0;200.00;0
200;0;5680582;200;220;699;699;7.79;0.48;98.20;4.51;499;0;201.00;0
202;0;5680588;202;224;704;705;7.74;0.48;98.15;4.48;502;0;202.00;1
205;0;5680594;205;225;705;705;7.63;0.47;98.07;4.48;500;0;203.00;0
206;0;5680599;206;231;705;705;7.52;0.46;98.56;4.48;499;0;204.00;0
207;0;5680604;207;233;705;705;7.45;0.46;98.71;4.48;498;0;205.00;0
208;0;5680610;208;237;709;709;7.34;0.45;99.04;4.46;501;0;206.00;0
209;0;5680615;209;245;710;710;7.25;0.45;99.52;4.45;501;0;207.00;0
210;0;5680621;210;250;710;710;7.15;0.44;99.77;4.45;500;0;208.00;0
210;0;5680626;210;256;711;711;7.11;0.44;99.77;4.45;501;0;209.00;0
211;0;5680633;211;259;711;711;6.98;0.43;100.19;4.45;500;0;210.00;0
211;0;5680638;211;267;711;711;6.81;0.42;100.19;4.45;500;0;211.00;0
213;0;5680643;213;264;711;711;6.63;0.41;100.17;4.45;498;0;212.00;0
215;0;5680648;215;263;711;711;6.54;0.40;99.66;4.45;496;0;213.00;0
217;0;5680655;217;244;711;711;6.51;0.40;100.66;4.45;494;0;214.00;0
218;0;5680660;218;234;711;711;6.56;0.40;101.17;4.45;493;0;215.00;0
220;0;5680665;220;235;753;781;6.84;0.42;101.93;4.20;533;0;216.00;28
220;0;5680677;220;229;755;782;6.98;0.43;101.93;4.19;535;0;217.00;27
221;0;5680683;221;222;762;782;7.21;0.45;102.02;4.17;541;0;218.00;20
222;0;5680689;222;221;763;782;7.39;0.46;102.17;4.17;541;0;219.00;19
223;0;5680695;223;219;767;782;7.58;0.47;102.35;4.17;544;0;220.00;15
224;0;5680702;224;207;767;782;7.74;0.48;102.88;4.17;543;0;221.00;15
226;0;5680708;226;202;769;782;7.87;0.48;103.19;4.17;543;0;222.00;13
228;0;5680714;228;195;771;782;7.95;0.49;104.21;4.18;543;0;223.00;11
230;0;5680727;230;190;773;783;8.02;0.49;104.80;4.19;543;0;224.00;10
231;0;5680743;231;184;778;785;8.11;0.50;105.32;4.20;547;0;225.00;7
232;0;5680750;232;183;779;785;8.16;0.50;105.80;4.20;547;0;226.00;6
235;0;5680756;235;181;784;789;8.20;0.50;106.57;4.20;549;0;227.00;5
238;0;5680763;238;179;785;789;8.24;0.50;106.59;4.21;547;0;228.00;4
238;0;5680770;238;182;786;789;8.29;0.51;106.59;4.22;548;0;229.00;3
239;0;5680777;239;176;787;789;8.47;0.52;106.91;4.23;548;0;230.00;2
241;0;5680783;241;176;793;795;8.59;0.53;107.33;4.22;552;0;231.00;2
242;0;5680790;242;169;794;795;8.77;0.54;107.67;4.23;552;0;232.00;1
242;0;5680797;242;158;795;795;8.91;0.55;107.67;4.23;553;0;233.00;0
245;0;5680803;245;148;797;798;9.04;0.55;108.30;4.22;552;0;234.00;1
249;0;5680810;249;140;797;798;9.12;0.56;108.78;4.22;548;0;235.00;1
251;0;5680816;251;141;798;798;9.24;0.57;109.02;4.21;547;0;236.00;0
252;0;5680822;252;136;799;799;9.31;0.57;109.52;4.21;547;0;237.00;0
256;0;5680829;256;130;800;800;9.46;0.58;110.80;4.21;544;0;238.00;0
260;0;5680835;260;130;800;800;9.47;0.58;112.40;4.21;540;0;239.00;0
261;0;5680843;261;134;825;826;9.52;0.58;112.65;4.08;564;0;240.00;1
264;1;5680851;264;126;825;826;9.62;0.59;113.35;4.08;561;1;241.00;1
267;1;5680868;267;124;826;826;9.78;0.60;113.18;4.08;559;1;242.00;0
270;1;5680875;270;123;827;827;9.96;0.61;113.50;4.07;557;1;243.00;0
270;1;5680881;270;121;827;827;10.12;0.62;113.50;4.07;557;1;244.00;0
271;1;5680887;271;117;831;831;10.13;0.62;113.72;4.06;560;1;245.00;0
274;1;5680894;274;118;831;831;10.14;0.62;114.52;4.06;557;1;246.00;0
275;1;5680901;275;124;835;835;10.11;0.62;114.48;4.04;560;1;247.00;0
275;1;5680908;275;128;835;835;10.16;0.62;114.48;4.04;560;1;248.00;0
276;1;5680914;276;131;835;835;10.17;0.62;114.92;4.04;559;1;249.00;0
278;1;5680921;278;135;835;835;10.19;0.62;115.49;4.04;557;1;250.00;0
278;1;5680927;278;139;835;835;10.22;0.62;115.49;4.04;557;1;251.00;0
280;1;5680933;280;139;845;847;10.23;0.62;115.76;3.99;565;1;252.00;2
280;1;5680940;280;142;845;847;10.27;0.62;115.76;3.99;565;1;253.00;2
281;1;5680946;281;146;847;847;10.33;0.63;115.74;3.99;566;1;254.00;0
285;1;5680952;285;142;847;847;10.33;0.63;116.43;3.99;562;1;255.00;0
286;1;5680959;286;140;847;847;10.27;0.62;116.29;3.99;561;1;256.00;0
286;1;5680965;286;139;847;847;10.25;0.62;116.29;3.99;561;1;257.00;0
287;1;5680971;287;138;848;848;10.27;0.62;116.78;3.99;561;1;258.00;0
288;1;5680977;288;134;848;848;10.22;0.62;116.78;3.99;560;1;259.00;0
292;1;5680983;292;128;854;854;10.24;0.62;117.53;3.96;562;1;260.00;0
294;1;5680990;294;123;855;855;10.26;0.62;118.02;3.96;561;1;261.00;0
298;1;5680996;298;115;855;855;10.24;0.62;118.97;3.96;557;1;262.00;0
298;1;5681003;298;115;855;855;10.39;0.63;118.97;3.96;557;1;263.00;0
299;1;5681009;299;110;859;859;10.50;0.64;118.91;3.94;560;1;264.00;0
301;1;5681015;301;106;859;859;10.63;0.64;119.54;3.94;558;1;265.00;0
304;1;5681021;304;104;859;859;10.67;0.65;120.11;3.94;555;1;266.00;0
307;1;5681027;307;100;860;860;10.76;0.65;120.32;3.94;553;1;267.00;0
307;1;5681034;307;100;864;864;10.77;0.65;120.32;3.92;557;1;268.00;0
310;1;5681041;310;95;864;864;10.87;0.66;120.13;3.92;554;1;269.00;0
311;1;5681050;311;92;868;870;11.00;0.66;119.92;3.91;557;1;270.00;2
317;1;5681057;317;91;869;870;11.02;0.66;120.22;3.90;552;1;271.00;1
321;1;5681064;321;94;870;870;11.03;0.66;120.32;3.90;549;1;272.00;0
325;1;5681070;325;94;870;870;11.09;0.67;120.10;3.90;545;1;273.00;0
327;1;5681077;327;91;874;874;11.18;0.67;120.16;3.89;547;1;274.00;0
328;1;5681085;328;92;874;874;11.13;0.67;120.61;3.89;546;1;275.00;0
330;1;5681091;330;89;874;874;11.17;0.67;120.90;3.89;544;1;276.00;0
330;1;5681098;330;88;874;874;11.23;0.68;120.90;3.89;544;1;277.00;0
330;1;5681105;330;83;875;875;11.28;0.68;120.90;3.88;545;1;278.00;0
331;1;5681112;331;82;876;876;11.32;0.68;120.94;3.88;545;1;279.00;0
331;1;5681119;331;82;876;876;11.31;0.69;120.94;3.88;545;1;280.00;0
332;1;5681126;332;81;877;877;11.34;0.69;120.88;3.88;545;1;281.00;0
333;1;5681132;333;88;877;877;11.35;0.69;120.93;3.88;544;1;282.00;0
333;1;5681139;333;86;877;877;11.30;0.69;120.93;3.88;544;1;283.00;0
333;1;5681147;333;83;877;877;11.37;0.69;120.93;3.88;544;1;284.00;0
334;1;5681153;334;86;877;877;11.35;0.69;121.37;3.88;543;1;285.00;0
335;1;5681160;335;86;877;877;11.35;0.69;121.14;3.88;542;1;286.00;0
336;1;5681166;336;86;877;877;11.32;0.69;121.14;3.88;541;1;287.00;0
336;1;5681174;336;107;948;1004;11.10;0.69;121.14;3.59;612;1;288.00;56
338;1;5681190;338;100;951;1005;11.05;0.69;121.55;3.58;613;1;289.00;54
338;1;5681198;338;94;959;1005;11.13;0.69;121.55;3.57;621;1;290.00;46
339;1;5681207;339;94;964;1005;11.07;0.69;122.04;3.57;625;1;291.00;41
341;1;5681214;341;96;969;1005;11.06;0.69;122.56;3.57;628;1;292.00;36
342;1;5681221;342;94;971;1005;11.03;0.68;123.04;3.57;629;1;293.00;34
343;1;5681229;343;93;973;1005;11.05;0.68;123.12;3.58;630;1;294.00;32
346;1;5681237;346;93;977;1005;11.04;0.68;123.49;3.59;631;1;295.00;28
348;1;5681244;348;95;980;1006;11.13;0.69;124.45;3.60;632;1;296.00;26
350;1;5681252;350;98;984;1007;11.18;0.69;125.17;3.63;634;1;297.00;23
351;1;5681261;351;97;987;1007;11.22;0.69;125.39;3.64;636;1;298.00;20
353;1;5681268;353;100;989;1008;11.18;0.69;125.58;3.66;636;1;299.00;19
357;1;5681278;357;105;996;1014;11.04;0.68;125.92;3.68;639;1;300.00;18
359;1;5681290;359;107;997;1014;10.91;0.67;126.45;3.69;638;1;301.00;17
360;1;5681298;360;110;999;1014;10.78;0.67;126.53;3.71;639;1;302.00;15
362;1;5681306;362;109;1003;1018;10.70;0.66;126.11;3.71;641;1;303.00;15
362;1;5681314;362;114;1004;1018;10.56;0.65;126.11;3.72;642;1;304.00;14
365;1;5681322;365;124;1008;1018;10.35;0.64;126.76;3.75;643;1;305.00;10
370;1;5681329;370;128;1009;1021;10.19;0.63;127.40;3.75;639;1;306.00;12
371;1;5681336;371;134;1011;1021;10.06;0.62;127.69;3.78;640;1;307.00;10
374;1;5681343;374;141;1011;1021;9.88;0.61;128.63;3.78;637;1;308.00;10
375;1;5681350;375;149;1016;1025;9.70;0.60;128.53;3.79;641;1;309.00;9
379;1;5681358;379;161;1018;1026;9.58;0.59;129.37;3.80;639;1;310.00;8
380;1;5681366;380;173;1024;1026;9.46;0.58;129.75;3.84;644;1;311.00;2
381;1;5681373;381;174;1028;1030;9.40;0.58;130.02;3.83;647;1;312.00;2
383;1;5681380;383;176;1029;1030;9.32;0.57;129.97;3.84;646;1;313.00;1
386;1;5681387;386;176;1029;1030;9.20;0.56;130.55;3.84;643;1;314.00;1
388;1;5681394;388;178;1032;1032;9.11;0.56;130.54;3.85;644;1;315.00;0
388;1;5681402;388;177;1032;1032;9.06;0.55;130.54;3.85;644;1;316.00;0
388;1;5681408;388;183;1038;1038;9.09;0.56;130.54;3.83;650;1;317.00;0
391;1;5681415;391;184;1038;1038;9.02;0.55;130.93;3.83;647;1;318.00;0
395;1;5681423;395;188;1039;1039;8.92;0.54;131.51;3.83;644;1;319.00;0
395;1;5681430;395;192;1039;1039;8.85;0.54;131.51;3.83;644;1;320.00;0
396;1;5681436;396;199;1039;1039;8.74;0.53;131.79;3.83;643;1;321.00;0
400;1;5681443;400;197;1039;1039;8.56;0.52;132.18;3.83;639;1;322.00;0
402;1;5681450;402;204;1039;1039;8.42;0.51;132.22;3.83;637;1;323.00;0
402;1;5681457;402;208;1051;1051;8.42;0.51;132.22;3.79;649;1;324.00;0
405;1;5681464;405;214;1051;1051;8.29;0.51;132.39;3.79;646;1;325.00;0
408;1;5681471;408;213;1051;1051;8.12;0.50;132.87;3.79;643;1;326.00;0
408;1;5681477;408;217;1051;1051;8.00;0.49;132.87;3.79;643;1;327.00;0
413;1;5681483;413;220;1051;1051;7.92;0.48;133.83;3.79;638;1;328.00;0
414;1;5681490;414;220;1051;1051;7.81;0.48;133.96;3.79;637;1;329.00;0
416;1;5681498;416;213;1055;1055;7.81;0.48;134.59;3.78;639;1;330.00;0
419;1;5681505;419;207;1055;1055;7.82;0.48;135.69;3.78;636;1;331.00;0
422;1;5681511;422;208;1059;1059;7.86;0.48;136.18;3.77;637;1;332.00;0
425;1;5681518;425;209;1060;1060;7.89;0.49;137.11;3.76;635;1;333.00;0
427;1;5681525;427;212;1060;1060;7.95;0.49;137.69;3.76;633;1;334.00;0
430;1;5681532;430;216;1060;1060;7.99;0.49;138.54;3.76;630;1;335.00;0
433;1;5681538;433;214;1072;1073;8.03;0.50;139.91;3.72;639;1;336.00;1
435;1;5681545;435;214;1072;1073;8.09;0.50;139.96;3.72;637;1;337.00;1
438;1;5681552;438;210;1073;1073;8.12;0.50;140.66;3.72;635;1;338.00;0
442;1;5681558;442;211;1074;1074;8.20;0.50;141.76;3.72;632;1;339.00;0
446;1;5681564;446;212;1075;1075;8.20;0.50;141.91;3.71;629;1;340.00;0
452;1;5681571;452;213;1075;1075;8.13;0.50;142.72;3.71;623;1;341.00;0
454;1;5681578;454;210;1077;1078;8.12;0.50;142.39;3.71;623;1;342.00;1
460;1;5681585;460;211;1077;1078;8.05;0.49;142.33;3.71;617;1;343.00;1
465;1;5681592;465;214;1078;1078;7.99;0.49;143.02;3.71;613;1;344.00;0
467;1;5681598;467;215;1078;1078;7.92;0.49;142.85;3.71;611;1;345.00;0
472;1;5681605;472;218;1083;1084;7.90;0.48;143.26;3.69;611;1;346.00;1
474;1;5681612;474;223;1083;1084;7.78;0.48;143.20;3.69;609;1;347.00;1
478;1;5681619;478;222;1084;1084;7.63;0.47;143.52;3.69;606;1;348.00;0
479;1;5681626;479;226;1084;1084;7.47;0.46;143.49;3.69;605;1;349.00;0
482;1;5681632;482;225;1088;1088;7.42;0.45;143.75;3.68;606;1;350.00;0
482;1;5681639;482;232;1089;1089;7.31;0.45;143.75;3.68;607;1;351.00;0
484;1;5681645;484;235;1089;1089;7.21;0.44;143.89;3.68;605;1;352.00;0
486;1;5681651;486;239;1090;1090;7.17;0.44;143.86;3.68;604;1;353.00;0
488;1;5681657;488;242;1090;1090;7.17;0.44;143.55;3.68;602;1;354.00;0
489;1;5681664;489;239;1090;1090;7.13;0.44;143.40;3.68;601;1;355.00;0
489;1;5681670;489;240;1090;1090;7.10;0.44;143.40;3.68;601;1;356.00;0
492;1;5681676;492;247;1090;1090;7.05;0.43;143.35;3.68;598;1;357.00;0
495;1;5681683;495;255;1090;1090;7.02;0.43;143.22;3.68;595;1;358.00;0
496;1;5681689;496;258;1090;1090;6.98;0.43;143.37;3.68;594;1;359.00;0
499;1;5681697;499;285;1167;1215;7.18;0.45;143.33;3.43;668;1;360.00;48
501;1;5681715;501;271;1172;1216;7.21;0.45;143.97;3.42;671;1;361.00;44
501;1;5681723;501;253;1181;1216;7.31;0.46;143.97;3.41;680;1;362.00;35
502;1;5681730;502;247;1183;1216;7.34;0.46;143.76;3.41;681;1;363.00;33
503;1;5681738;503;241;1187;1216;7.36;0.46;143.72;3.41;684;1;364.00;29
504;1;5681746;504;237;1188;1216;7.43;0.46;144.12;3.42;684;1;365.00;28
505;1;5681753;505;227;1194;1216;7.53;0.47;144.38;3.43;689;1;366.00;22
506;1;5681761;506;228;1195;1216;7.56;0.47;144.46;3.43;689;1;367.00;21
509;1;5681773;509;228;1199;1217;7.68;0.47;144.48;3.45;690;1;368.00;18
509;1;5681781;509;231;1206;1218;7.72;0.47;144.48;3.48;697;1;369.00;12
511;1;5681789;511;231;1208;1218;7.70;0.47;144.79;3.49;697;1;370.00;10
511;1;5681797;511;231;1215;1222;7.66;0.47;144.79;3.49;704;1;371.00;7
512;1;5681810;512;238;1217;1222;7.56;0.46;144.81;3.51;705;1;372.00;5
515;1;5681823;515;242;1219;1222;7.50;0.46;145.10;3.52;704;1;373.00;3
515;1;5681831;515;247;1220;1222;7.42;0.45;145.10;3.53;705;1;374.00;2
515;1;5681839;515;257;1227;1228;7.35;0.45;145.10;3.52;712;1;375.00;1
515;1;5681848;515;263;1227;1228;7.30;0.45;145.10;3.52;712;1;376.00;1
515;1;5681856;515;253;1227;1228;7.32;0.45;145.10;3.52;712;1;377.00;1
517;1;5681864;517;254;1231;1231;7.27;0.45;145.30;3.53;714;1;378.00;0
520;1;5681873;520;251;1231;1231;7.24;0.44;145.51;3.53;711;1;379.00;0
521;1;5681881;521;247;1231;1231;7.27;0.44;145.27;3.53;710;1;380.00;0
521;1;5681890;521;250;1232;1232;7.32;0.45;145.27;3.52;711;1;381.00;0
522;1;5681898;522;254;1233;1233;7.38;0.45;145.38;3.52;711;1;382.00;0
523;1;5681907;523;258;1233;1233;7.41;0.45;145.49;3.52;710;1;383.00;0
526;1;5681915;526;258;1245;1246;7.52;0.46;146.37;3.49;719;1;384.00;1
529;1;5681925;529;262;1246;1246;7.51;0.46;146.96;3.49;717;1;385.00;0
531;1;5681935;531;244;1246;1246;7.58;0.46;146.77;3.49;715;1;386.00;0
535;1;5681947;535;242;1247;1247;7.57;0.46;146.50;3.48;712;1;387.00;0
538;1;5681957;538;231;1247;1247;7.55;0.46;147.19;3.48;709;1;388.00;0
539;1;5681966;539;230;1251;1251;7.60;0.46;147.24;3.47;712;1;389.00;0
541;1;5681977;541;226;1251;1251;7.63;0.47;147.69;3.47;710;1;390.00;0
542;1;5681986;542;225;1255;1255;7.63;0.47;148.12;3.47;713;1;391.00;0
544;1;5681995;544;225;1255;1255;7.77;0.47;148.34;3.47;711;1;392.00;0
545;1;5682004;545;225;1255;1255;7.84;0.48;148.55;3.47;710;1;393.00;0
547;1;5682012;547;222;1255;1255;8.00;0.49;148.74;3.47;708;1;394.00;0
549;1;5682021;549;220;1255;1255;8.09;0.49;149.10;3.47;706;1;395.00;0
549;1;5682030;549;222;1265;1267;8.09;0.49;149.10;3.44;716;1;396.00;2
550;1;5682040;550;215;1265;1267;8.15;0.50;149.34;3.44;715;1;397.00;2
550;1;5682049;550;214;1267;1267;8.22;0.50;149.34;3.44;717;1;398.00;0
552;1;5682059;552;208;1267;1267;8.31;0.51;149.97;3.44;715;1;399.00;0
552;1;5682068;552;208;1267;1267;8.44;0.52;149.97;3.44;715;1;400.00;0
556;1;5682080;556;200;1267;1267;8.46;0.52;150.74;3.44;711;1;401.00;0
557;1;5682089;557;200;1268;1268;8.57;0.52;150.81;3.44;711;1;402.00;0
559;2;5682097;559;193;1268;1268;8.67;0.53;151.05;3.44;709;2;403.00;0
559;2;5682116;559;189;1274;1274;8.82;0.54;151.05;3.42;715;2;404.00;0
562;2;5682127;562;184;1276;1276;8.91;0.55;151.94;3.42;714;2;405.00;0
563;2;5682138;563;185;1276;1276;9.02;0.55;152.07;3.42;713;2;406.00;0
570;2;5682151;570;187;1276;1276;9.04;0.55;153.16;3.42;706;2;407.00;0
572;2;5682159;572;185;1280;1280;9.14;0.56;153.60;3.41;708;2;408.00;0
579;2;5682169;579;189;1280;1280;9.19;0.56;154.91;3.41;701;2;409.00;0
580;2;5682177;580;188;1280;1280;9.32;0.57;155.10;3.41;700;2;410.00;0
581;2;5682185;581;190;1281;1281;9.41;0.57;155.41;3.41;700;2;411.00;0
584;2;5682194;584;196;1285;1285;9.46;0.58;156.10;3.40;701;2;412.00;0
586;2;5682203;586;193;1285;1285;9.51;0.58;156.33;3.40;699;2;413.00;0
588;2;5682211;588;194;1287;1288;9.54;0.58;156.93;3.39;699;2;414.00;1
589;2;5682221;589;199;1287;1288;9.54;0.58;157.35;3.39;698;2;415.00;1
591;2;5682229;591;197;1288;1288;9.56;0.58;157.62;3.39;697;2;416.00;0
593;2;5682238;593;201;1288;1288;9.55;0.58;158.01;3.39;695;2;417.00;0
594;2;5682247;594;199;1292;1292;9.59;0.59;157.96;3.38;698;2;418.00;0
597;2;5682255;597;204;1292;1292;9.61;0.59;158.50;3.38;695;2;419.00;0
600;2;5682266;600;199;1292;1292;9.60;0.59;158.55;3.38;692;2;420.00;0
600;2;5682274;600;197;1292;1292;9.67;0.59;158.55;3.38;692;2;421.00;0
601;2;5682284;601;193;1293;1293;9.70;0.59;158.99;3.38;692;2;422.00;0
602;2;5682293;602;186;1294;1294;9.73;0.60;159.40;3.38;692;2;423.00;0
609;2;5682301;609;182;1294;1294;9.80;0.60;160.12;3.38;685;2;424.00;0
612;2;5682310;612;173;1295;1295;9.84;0.60;160.35;3.38;683;2;425.00;0
616;2;5682324;616;165;1295;1295;9.89;0.60;160.95;3.38;679;2;426.00;0
619;2;5682332;619;160;1295;1295;9.91;0.61;161.93;3.38;676;2;427.00;0
625;2;5682341;625;150;1295;1295;10.00;0.61;163.34;3.38;670;2;428.00;0
628;2;5682349;628;143;1295;1295;10.06;0.61;163.86;3.38;667;2;429.00;0
631;2;5682357;631;136;1295;1295;10.08;0.61;164.31;3.38;664;2;430.00;0
636;2;5682365;636;134;1295;1295;10.16;0.62;164.38;3.38;659;2;431.00;0
639;2;5682373;639;156;1370;1422;9.89;0.61;165.04;3.20;731;2;432.00;52
639;2;5682397;639;141;1372;1423;10.00;0.62;165.04;3.19;733;2;433.00;51
644;2;5682406;644;126;1378;1423;10.11;0.62;165.10;3.19;734;2;434.00;45
650;2;5682415;650;124;1382;1423;10.17;0.63;166.13;3.19;732;2;435.00;41
650;2;5682424;650;115;1387;1423;10.28;0.63;166.13;3.19;737;2;436.00;36
656;2;5682432;656;115;1388;1423;10.35;0.64;166.68;3.19;732;2;437.00;35
661;2;5682441;661;112;1393;1423;10.41;0.64;166.54;3.20;732;2;438.00;30
664;2;5682450;664;112;1396;1423;10.45;0.64;167.23;3.21;732;2;439.00;27
670;2;5682464;670;112;1398;1424;10.46;0.64;167.74;3.22;728;2;440.00;26
671;2;5682473;671;113;1402;1425;10.61;0.65;168.15;3.23;731;2;441.00;23
674;2;5682482;674;115;1408;1425;10.64;0.65;168.28;3.26;734;2;442.00;17
674;2;5682491;674;119;1410;1426;10.71;0.65;168.28;3.27;736;2;443.00;16
676;2;5682500;676;116;1412;1426;10.83;0.66;168.87;3.28;736;2;444.00;14
679;2;5682509;679;116;1415;1426;10.75;0.66;169.54;3.30;736;2;445.00;11
680;2;5682518;680;119;1418;1426;10.66;0.65;169.41;3.32;738;2;446.00;8
682;2;5682528;682;123;1421;1430;10.58;0.65;169.70;3.33;739;2;447.00;9
685;2;5682537;685;127;1423;1430;10.43;0.64;169.49;3.34;738;2;448.00;7
689;2;5682546;689;136;1424;1430;10.42;0.64;169.42;3.35;735;2;449.00;6
692;2;5682557;692;138;1429;1436;10.39;0.64;169.49;3.36;737;2;450.00;7
695;2;5682566;695;150;1431;1436;10.34;0.63;169.83;3.37;736;2;451.00;5
697;2;5682575;697;148;1433;1436;10.33;0.63;169.81;3.38;736;2;452.00;3
702;2;5682589;702;153;1435;1440;10.24;0.63;170.79;3.37;733;2;453.00;5
704;2;5682599;704;156;1438;1441;10.15;0.62;170.98;3.37;734;2;454.00;3
705;2;5682608;705;160;1439;1441;10.09;0.62;171.28;3.37;734;2;455.00;2
708;2;5682617;708;159;1442;1445;10.06;0.62;171.23;3.36;734;2;456.00;3
714;2;5682627;714;164;1442;1445;10.00;0.61;171.13;3.36;728;2;457.00;3
716;2;5682636;716;165;1442;1445;9.97;0.61;171.45;3.36;726;2;458.00;3
721;2;5682644;721;174;1443;1446;9.93;0.61;171.73;3.36;722;2;459.00;3
724;2;5682653;724;173;1444;1446;9.87;0.60;172.17;3.37;720;2;460.00;2
725;2;5682667;725;180;1450;1452;9.81;0.60;172.07;3.36;725;2;461.00;2
727;2;5682681;727;188;1450;1452;9.73;0.59;172.51;3.36;723;2;462.00;2
729;2;5682690;729;192;1451;1453;9.60;0.59;172.74;3.37;722;2;463.00;2
733;2;5682699;733;196;1452;1453;9.41;0.57;173.26;3.37;719;2;464.00;1
735;2;5682707;735;202;1452;1453;9.33;0.57;173.74;3.37;717;2;465.00;1
738;2;5682716;738;209;1453;1453;9.25;0.56;174.07;3.37;715;2;466.00;0
739;2;5682724;739;211;1453;1453;9.16;0.56;174.18;3.37;714;2;467.00;0
742;2;5682732;742;220;1464;1465;9.20;0.56;174.62;3.35;722;2;468.00;1
744;2;5682742;744;224;1464;1465;9.12;0.56;174.83;3.35;720;2;469.00;1
744;2;5682750;744;228;1465;1465;9.09;0.56;174.83;3.34;721;2;470.00;0
746;2;5682758;746;234;1465;1465;9.02;0.55;175.03;3.34;719;2;471.00;0
747;2;5682766;747;237;1465;1465;8.99;0.55;175.03;3.34;718;2;472.00;0
749;2;5682774;749;245;1465;1465;8.91;0.55;175.19;3.34;716;2;473.00;0
752;2;5682781;752;250;1469;1469;8.88;0.54;175.71;3.34;717;2;474.00;0
752;2;5682789;752;261;1469;1469;8.79;0.54;175.71;3.34;717;2;475.00;0
752;2;5682796;752;264;1473;1473;8.80;0.54;175.71;3.33;721;2;476.00;0
755;2;5682804;755;266;1474;1474;8.63;0.53;175.46;3.33;719;2;477.00;0
756;2;5682811;756;271;1474;1474;8.49;0.52;175.58;3.33;718;2;478.00;0
762;2;5682819;762;268;1474;1474;8.37;0.51;174.74;3.33;712;2;479.00;0
763;2;5682829;763;273;1496;1500;8.31;0.51;174.83;3.28;733;2;480.00;4
764;2;5682839;764;268;1496;1500;8.27;0.51;174.83;3.28;732;2;481.00;4
766;2;5682846;766;272;1499;1500;8.30;0.51;174.65;3.28;733;2;482.00;1
767;2;5682854;767;274;1501;1501;8.33;0.51;174.58;3.28;734;2;483.00;0
770;2;5682861;770;273;1502;1502;8.22;0.50;174.37;3.27;732;2;484.00;0
772;2;5682868;772;278;1502;1502;8.09;0.50;174.24;3.27;730;2;485.00;0
773;2;5682876;773;282;1504;1505;8.03;0.49;174.62;3.27;731;2;486.00;1
774;2;5682883;774;282;1504;1505;7.93;0.49;174.56;3.27;730;2;487.00;1
775;2;5682890;775;286;1505;1505;7.83;0.48;174.49;3.27;730;2;488.00;0
777;2;5682897;777;285;1505;1505;7.86;0.48;174.38;3.27;728;2;489.00;0
780;2;5682904;780;288;1511;1511;7.90;0.48;174.28;3.26;731;2;490.00;0
783;2;5682914;783;287;1511;1511;7.84;0.48;174.18;3.26;728;2;491.00;0
788;2;5682922;788;289;1511;1511;7.73;0.47;173.84;3.26;723;2;492.00;0
790;2;5682929;790;290;1511;1511;7.63;0.47;173.85;3.26;721;2;493.00;0
793;2;5682936;793;296;1515;1515;7.50;0.46;173.64;3.25;722;2;494.00;0
798;2;5682943;798;288;1517;1517;7.31;0.45;173.97;3.25;719;2;495.00;0
800;2;5682950;800;276;1517;1517;7.25;0.44;173.78;3.25;717;2;496.00;0
803;2;5682957;803;270;1518;1518;7.18;0.44;174.69;3.25;715;2;497.00;0
807;2;5682963;807;266;1518;1518;7.10;0.43;174.82;3.25;711;2;498.00;0
810;2;5682970;810;270;1518;1518;7.04;0.43;175.30;3.25;708;2;499.00;0
811;2;5682978;811;267;1518;1518;7.03;0.43;175.52;3.25;707;2;500.00;0
813;2;5682989;813;273;1518;1518;7.02;0.43;176.00;3.25;705;2;501.00;0
814;2;5682996;814;267;1518;1518;6.99;0.43;175.87;3.25;704;2;502.00;0
818;2;5683003;818;267;1518;1518;6.96;0.43;176.40;3.25;700;2;503.00;0
820;2;5683010;820;264;1556;1588;7.14;0.44;176.95;3.17;736;2;504.00;32
821;2;5683024;821;261;1560;1589;7.12;0.44;176.79;3.16;739;2;505.00;29
823;2;5683031;823;263;1569;1589;7.13;0.44;176.65;3.16;746;2;506.00;20
825;2;5683039;825;269;1570;1589;7.12;0.43;176.60;3.16;745;2;507.00;19
826;2;5683046;826;265;1574;1589;7.10;0.43;176.86;3.16;748;2;508.00;15
830;2;5683054;830;264;1576;1589;7.02;0.43;177.48;3.16;746;2;509.00;13
831;2;5683064;831;258;1579;1589;7.06;0.43;177.42;3.17;748;2;510.00;10
834;2;5683072;834;256;1582;1589;7.05;0.43;177.81;3.17;748;2;511.00;7
838;2;5683081;838;255;1585;1590;7.05;0.43;178.37;3.18;747;2;512.00;5
840;2;5683089;840;257;1588;1591;7.06;0.43;178.52;3.19;748;2;513.00;3
844;2;5683097;844;258;1590;1591;7.06;0.43;178.95;3.20;746;2;514.00;1
848;2;5683104;848;260;1594;1595;7.03;0.43;179.14;3.19;746;2;515.00;1
850;2;5683118;850;259;1595;1595;7.04;0.43;179.33;3.19;745;2;516.00;0
854;2;5683127;854;262;1595;1595;7.00;0.43;179.85;3.19;741;2;517.00;0
856;2;5683135;856;263;1595;1595;7.02;0.43;180.08;3.19;739;2;518.00;0
859;2;5683143;859;268;1601;1601;7.07;0.43;180.26;3.18;742;2;519.00;0
861;2;5683157;861;270;1601;1601;7.11;0.44;180.58;3.18;740;2;520.00;0
864;2;5683166;864;264;1601;1601;7.16;0.44;180.64;3.18;737;2;521.00;0
867;2;5683174;867;259;1603;1604;7.22;0.44;180.73;3.18;736;2;522.00;1
869;2;5683182;869;261;1603;1604;7.19;0.44;181.12;3.18;734;2;523.00;1
873;2;5683191;873;261;1604;1604;7.24;0.44;181.69;3.18;731;2;524.00;0
876;2;5683199;876;255;1605;1605;7.31;0.45;181.69;3.18;729;2;525.00;0
881;2;5683208;881;252;1606;1606;7.26;0.44;182.20;3.18;725;2;526.00;0
882;2;5683216;882;249;1606;1606;7.33;0.45;182.19;3.18;724;2;527.00;0
884;2;5683225;884;250;1619;1619;7.49;0.46;182.02;3.15;735;2;528.00;0
886;2;5683233;886;250;1619;1619;7.57;0.46;182.36;3.15;733;2;529.00;0
889;2;5683242;889;248;1619;1619;7.59;0.46;182.15;3.15;730;2;530.00;0
891;2;5683250;891;250;1620;1620;7.68;0.47;182.11;3.15;729;2;531.00;0
894;2;5683259;894;249;1620;1620;7.71;0.47;182.32;3.15;726;2;532.00;0
896;2;5683267;896;247;1624;1624;7.79;0.47;182.58;3.14;728;2;533.00;0
898;2;5683275;898;246;1624;1624;7.81;0.47;182.67;3.14;726;2;534.00;0
900;2;5683284;900;246;1628;1628;7.82;0.47;182.66;3.14;728;2;535.00;0
903;2;5683293;903;250;1628;1628;7.81;0.47;182.74;3.14;725;2;536.00;0
904;2;5683301;904;253;1628;1628;7.77;0.47;182.73;3.14;724;2;537.00;0
908;2;5683311;908;254;1628;1628;7.77;0.47;182.64;3.14;720;2;538.00;0
911;2;5683319;911;258;1628;1628;7.71;0.47;182.99;3.14;717;2;539.00;0
912;2;5683329;912;260;1657;1662;7.86;0.48;183.14;3.08;745;2;540.00;5
913;2;5683340;913;263;1658;1662;7.81;0.48;183.14;3.08;745;2;541.00;4
915;2;5683348;915;255;1661;1662;7.84;0.48;183.29;3.08;746;2;542.00;1
917;2;5683357;917;250;1661;1662;7.78;0.48;183.52;3.08;744;2;543.00;1
917;2;5683365;917;251;1662;1662;7.77;0.47;183.52;3.08;745;2;544.00;0
921;2;5683374;921;244;1662;1662;7.69;0.47;183.74;3.08;741;2;545.00;0
921;2;5683382;921;239;1663;1663;7.69;0.47;183.74;3.08;742;2;546.00;0
926;2;5683391;926;234;1663;1663;7.63;0.47;184.01;3.08;737;2;547.00;0
928;2;5683400;928;231;1669;1669;7.61;0.46;184.48;3.07;741;2;548.00;0
930;2;5683410;930;236;1670;1670;7.62;0.46;184.65;3.07;740;2;549.00;0
932;2;5683419;932;239;1670;1670;7.61;0.46;185.03;3.07;738;2;550.00;0
935;2;5683428;935;230;1670;1670;7.64;0.47;185.49;3.07;735;2;551.00;0
936;2;5683436;936;224;1674;1674;7.74;0.47;185.50;3.06;738;2;552.00;0
938;2;5683445;938;221;1674;1674;7.75;0.47;185.67;3.06;736;2;553.00;0
939;2;5683454;939;222;1674;1674;7.82;0.48;185.80;3.06;735;2;554.00;0
941;2;5683464;941;218;1675;1675;7.90;0.48;186.02;3.06;734;2;555.00;0
943;2;5683473;943;218;1679;1679;7.89;0.48;186.30;3.06;736;2;556.00;0
944;2;5683483;944;213;1679;1679;7.93;0.48;186.31;3.06;735;2;557.00;0
948;2;5683492;948;217;1681;1682;8.00;0.49;186.24;3.05;733;2;558.00;1
950;2;5683501;950;213;1681;1682;8.07;0.49;186.49;3.05;731;2;559.00;1
953;2;5683510;953;214;1682;1682;8.12;0.49;187.03;3.05;729;2;560.00;0
955;2;5683519;955;222;1682;1682;8.15;0.50;187.16;3.05;727;2;561.00;0
960;2;5683527;960;225;1686;1686;8.21;0.50;187.67;3.05;726;2;562.00;0
961;2;5683538;961;226;1686;1686;8.27;0.50;188.06;3.05;725;2;563.00;0
964;2;5683546;964;223;1686;1686;8.37;0.51;188.22;3.05;722;2;564.00;0
966;2;5683555;966;222;1686;1686;8.47;0.52;188.61;3.05;720;2;565.00;0
969;2;5683564;969;221;1687;1687;8.54;0.52;188.71;3.05;718;2;566.00;0
970;2;5683573;970;219;1688;1688;8.62;0.53;188.88;3.05;718;2;567.00;0
977;2;5683582;977;217;1688;1688;8.68;0.53;189.52;3.05;711;2;568.00;0
980;2;5683591;980;212;1689;1689;8.67;0.53;189.54;3.04;709;2;569.00;0
981;2;5683601;981;212;1689;1689;8.72;0.53;189.56;3.04;708;2;570.00;0
984;2;5683610;984;209;1689;1689;8.71;0.53;189.83;3.04;705;2;571.00;0
987;2;5683630;987;211;1689;1689;8.68;0.53;190.22;3.04;702;2;572.00;0
988;2;5683642;988;211;1689;1689;8.68;0.53;190.37;3.04;701;2;573.00;0
989;2;5683650;989;212;1689;1689;8.75;0.53;190.54;3.04;700;2;574.00;0
992;2;5683659;992;210;1689;1689;8.77;0.53;190.48;3.04;697;2;575.00;0
993;2;5683671;993;234;1765;1816;8.67;0.53;190.51;2.92;772;2;576.00;51
993;2;5683692;993;225;1771;1817;8.62;0.53;190.51;2.91;778;2;577.00;46
996;2;5683706;996;217;1776;1817;8.73;0.54;190.92;2.91;780;2;578.00;41
998;2;5683715;998;209;1777;1817;8.76;0.54;191.01;2.91;779;2;579.00;40
998;2;5683724;998;210;1781;1817;8.81;0.54;191.01;2.91;783;2;580.00;36
998;2;5683732;998;218;1781;1817;8.81;0.54;191.01;2.91;783;2;581.00;36
1001;2;5683742;1001;216;1783;1817;8.82;0.54;191.22;2.91;782;2;582.00;34
1002;2;5683751;1002;219;1787;1817;8.84;0.54;191.18;2.92;785;2;583.00;30
1005;2;5683768;1005;223;1789;1818;8.73;0.54;191.58;2.93;784;2;584.00;29
1007;2;5683785;1007;225;1795;1820;8.76;0.54;191.64;2.94;788;2;585.00;25
1008;2;5683795;1008;222;1796;1820;8.67;0.53;191.74;2.95;788;2;586.00;24
1009;2;5683805;1009;224;1800;1821;8.63;0.53;191.84;2.96;791;2;587.00;21
1010;2;5683814;1010;221;1801;1821;8.56;0.52;191.82;2.96;791;2;588.00;20
1013;2;5683822;1013;219;1804;1821;8.55;0.52;192.21;2.98;791;2;589.00;17
1017;2;5683833;1017;216;1806;1821;8.55;0.52;192.46;2.99;789;2;590.00;15
1017;2;5683844;1017;216;1810;1825;8.59;0.53;192.46;3.00;793;2;591.00;15
1020;2;5683854;1020;209;1813;1825;8.61;0.53;193.07;3.02;793;2;592.00;12
1023;2;5683864;1023;208;1817;1825;8.64;0.53;193.38;3.05;794;2;593.00;8
1027;2;5683874;1027;207;1818;1828;8.64;0.53;193.59;3.05;791;2;594.00;10
1029;2;5683885;1029;209;1821;1828;8.58;0.52;194.19;3.07;792;2;595.00;7
1033;2;5683895;1033;210;1822;1828;8.54;0.52;194.72;3.08;789;2;596.00;6
1037;2;5683904;1037;210;1827;1832;8.48;0.52;195.14;3.08;790;2;597.00;5
1037;2;5683914;1037;206;1828;1833;8.55;0.52;195.14;3.08;791;2;598.00;5
1038;2;5683922;1038;207;1830;1833;8.51;0.52;195.51;3.09;792;2;599.00;3
1043;2;5683936;1043;210;1843;1859;8.37;0.51;195.82;3.07;800;2;600.00;16
1043;2;5683960;1043;209;1844;1859;8.38;0.51;195.82;3.07;801;2;601.00;15
1049;2;5683971;1049;210;1844;1859;8.33;0.51;196.39;3.07;795;2;602.00;15
1053;2;5683980;1053;212;1846;1860;8.29;0.50;196.67;3.07;793;2;603.00;14
1055;2;5683989;1055;209;1846;1860;8.33;0.51;197.13;3.07;791;2;604.00;14
1057;2;5683998;1057;211;1852;1866;8.34;0.51;197.28;3.07;795;2;605.00;14
1059;2;5684008;1059;209;1852;1866;8.28;0.50;197.38;3.07;793;2;606.00;14
1062;2;5684017;1062;212;1853;1867;8.17;0.49;197.63;3.07;791;2;607.00;14
1063;2;5684025;1063;218;1856;1867;8.08;0.49;197.73;3.07;793;2;608.00;11
1065;2;5684034;1065;223;1856;1867;8.00;0.48;197.96;3.07;791;2;609.00;11
1065;2;5684043;1065;228;1856;1867;7.95;0.48;197.96;3.07;791;2;610.00;11
1069;2;5684052;1069;230;1859;1867;7.91;0.48;198.36;3.10;790;2;611.00;8
1070;2;5684061;1070;230;1868;1879;7.89;0.48;198.47;3.09;798;2;612.00;11
1072;3;5684071;1072;244;1870;1879;7.85;0.48;198.78;3.09;798;3;613.00;9
1072;3;5684095;1072;246;1873;1879;7.90;0.48;198.78;3.10;801;3;614.00;6
1075;3;5684104;1075;245;1873;1879;7.88;0.48;199.26;3.10;798;3;615.00;6
1076;3;5684114;1076;245;1873;1879;7.85;0.48;199.59;3.10;797;3;616.00;6
1078;3;5684122;1078;252;1874;1879;7.76;0.47;199.68;3.11;796;3;617.00;5
1079;3;5684131;1079;255;1877;1883;7.78;0.47;199.73;3.10;798;3;618.00;6
1080;3;5684141;1080;256;1877;1883;7.78;0.47;199.97;3.10;797;3;619.00;6
1080;3;5684149;1080;260;1882;1887;7.83;0.48;199.97;3.11;802;3;620.00;5
1082;3;5684158;1082;263;1883;1888;7.89;0.48;199.84;3.11;801;3;621.00;5
1086;3;5684168;1086;270;1883;1888;7.89;0.48;199.58;3.11;797;3;622.00;5
1086;3;5684177;1086;275;1884;1888;7.90;0.48;199.58;3.12;798;3;623.00;4
1088;3;5684187;1088;275;1892;1901;7.85;0.48;199.66;3.10;804;3;624.00;9
1092;3;5684196;1092;279;1893;1901;7.81;0.48;199.26;3.11;801;3;625.00;8
1095;3;5684206;1095;290;1895;1901;7.75;0.47;199.56;3.12;800;3;626.00;6
1097;3;5684215;1097;292;1896;1902;7.80;0.48;199.40;3.12;799;3;627.00;6
1097;3;5684223;1097;294;1899;1903;7.82;0.48;199.40;3.12;802;3;628.00;4
1099;3;5684232;1099;300;1901;1903;7.76;0.47;199.45;3.14;802;3;629.00;2
1100;3;5684242;1100;303;1905;1909;7.79;0.48;199.37;3.13;805;3;630.00;4
1102;3;5684251;1102;309;1907;1909;7.72;0.47;199.28;3.13;805;3;631.00;2
1104;3;5684259;1104;312;1909;1909;7.65;0.47;199.35;3.13;805;3;632.00;0
1106;3;5684268;1106;316;1909;1909;7.54;0.46;199.47;3.13;803;3;633.00;0
1108;3;5684276;1108;316;1915;1915;7.51;0.46;199.35;3.13;807;3;634.00;0
1111;3;5684284;1111;324;1915;1915;7.40;0.45;199.11;3.13;804;3;635.00;0
1113;3;5684292;1113;326;1915;1915;7.28;0.45;199.17;3.13;802;3;636.00;0
1115;3;5684301;1115;335;1915;1915;7.17;0.44;198.99;3.13;800;3;637.00;0
1117;3;5684309;1117;344;1919;1919;7.11;0.44;199.12;3.12;802;3;638.00;0
1121;3;5684317;1121;346;1920;1920;7.00;0.43;198.94;3.12;799;3;639.00;0
1121;3;5684324;1121;348;1920;1920;6.91;0.43;198.94;3.12;799;3;640.00;0
1123;3;5684332;1123;351;1921;1921;6.81;0.42;198.77;3.12;798;3;641.00;0
1127;3;5684339;1127;354;1921;1921;6.64;0.41;198.50;3.12;794;3;642.00;0
1129;3;5684346;1129;361;1921;1921;6.55;0.40;198.46;3.12;792;3;643.00;0
1130;3;5684353;1130;358;1921;1921;6.54;0.40;198.37;3.12;791;3;644.00;0
1130;3;5684360;1130;356;1921;1921;6.51;0.40;198.37;3.12;791;3;645.00;0
1132;3;5684368;1132;352;1921;1921;6.50;0.40;198.31;3.12;789;3;646.00;0
1135;3;5684376;1135;348;1921;1921;6.45;0.39;198.22;3.12;786;3;647.00;0
1136;3;5684383;1136;350;1959;1991;6.68;0.41;198.11;3.06;823;3;648.00;32
1137;3;5684397;1137;346;1960;1992;6.65;0.41;198.15;3.06;823;3;649.00;32
1139;3;5684404;1139;335;1967;1992;6.66;0.41;197.94;3.05;828;3;650.00;25
1141;3;5684412;1141;332;1973;1992;6.63;0.41;197.98;3.05;832;3;651.00;19
1142;3;5684420;1142;327;1978;1992;6.57;0.40;198.04;3.06;836;3;652.00;14
1144;3;5684427;1144;328;1979;1992;6.52;0.40;197.92;3.06;835;3;653.00;13
1146;3;5684435;1146;326;1982;1992;6.48;0.40;197.87;3.06;836;3;654.00;10
1147;3;5684442;1147;320;1986;1992;6.53;0.40;197.98;3.07;839;3;655.00;6
1147;3;5684450;1147;309;1989;1993;6.53;0.40;197.98;3.08;842;3;656.00;4
1153;3;5684457;1153;299;1992;1994;6.45;0.39;198.54;3.08;839;3;657.00;2
1155;3;5684466;1155;293;1993;1994;6.37;0.39;198.60;3.09;838;3;658.00;1
1156;3;5684473;1156;297;1998;1998;6.30;0.39;198.61;3.08;842;3;659.00;0
1159;3;5684483;1159;288;1998;1998;6.24;0.38;199.36;3.08;839;3;660.00;0
1161;3;5684492;1161;279;1998;1998;6.23;0.38;199.18;3.08;837;3;661.00;0
1167;3;5684501;1167;270;1998;1998;6.26;0.38;199.40;3.08;831;3;662.00;0
1169;3;5684509;1169;271;2004;2004;6.36;0.39;199.36;3.08;835;3;663.00;0
1172;3;5684524;1172;268;2004;2004;6.42;0.39;199.81;3.08;832;3;664.00;0
1175;3;5684532;1175;266;2004;2004;6.51;0.40;200.05;3.08;829;3;665.00;0
1176;3;5684541;1176;265;2007;2007;6.61;0.40;200.10;3.07;831;3;666.00;0
1179;3;5684550;1179;260;2007;2007;6.69;0.41;200.19;3.07;828;3;667.00;0
1184;3;5684559;1184;253;2007;2007;6.76;0.41;200.60;3.07;823;3;668.00;0
1188;3;5684569;1188;242;2008;2008;6.86;0.42;200.61;3.07;820;3;669.00;0
1190;3;5684578;1190;235;2009;2009;6.98;0.43;200.49;3.07;819;3;670.00;0
1192;3;5684587;1192;230;2009;2009;7.12;0.43;200.45;3.07;817;3;671.00;0
1196;3;5684596;1196;228;2020;2022;7.24;0.44;200.52;3.05;824;3;672.00;2
1198;3;5684606;1198;230;2021;2022;7.33;0.45;200.70;3.05;823;3;673.00;1
1200;3;5684615;1200;228;2022;2022;7.41;0.45;200.74;3.05;822;3;674.00;0
1204;3;5684624;1204;228;2024;2024;7.48;0.46;201.09;3.05;820;3;675.00;0
1207;3;5684635;1207;223;2024;2024;7.57;0.46;201.22;3.05;817;3;676.00;0
1211;3;5684644;1211;222;2028;2028;7.67;0.47;201.62;3.04;817;3;677.00;0
1214;3;5684654;1214;222;2028;2028;7.73;0.47;202.34;3.04;814;3;678.00;0
1220;3;5684664;1220;225;2032;2032;7.73;0.47;203.01;3.04;812;3;679.00;0
1222;3;5684674;1222;224;2032;2032;7.80;0.48;203.34;3.04;810;3;680.00;0
1226;3;5684683;1226;228;2032;2032;7.83;0.48;203.47;3.04;806;3;681.00;0
1232;3;5684692;1232;224;2032;2032;7.85;0.48;203.94;3.04;800;3;682.00;0
1237;3;5684702;1237;222;2032;2032;7.88;0.48;204.04;3.04;795;3;683.00;0
1239;3;5684713;1239;222;2043;2044;7.99;0.49;204.40;3.02;804;3;684.00;1
1246;3;5684723;1246;226;2044;2044;7.99;0.49;205.13;3.02;798;3;685.00;0
1251;3;5684734;1251;232;2044;2044;8.05;0.49;205.67;3.02;793;3;686.00;0
1253;3;5684744;1253;233;2044;2044;8.08;0.49;206.05;3.02;791;3;687.00;0
1256;3;5684753;1256;228;2044;2044;8.10;0.49;206.29;3.02;788;3;688.00;0
1261;3;5684763;1261;229;2044;2044;8.02;0.49;206.58;3.02;783;3;689.00;0
1265;3;5684774;1265;222;2045;2045;7.92;0.48;206.86;3.02;780;3;690.00;0
1268;3;5684784;1268;220;2045;2045;7.92;0.48;207.08;3.02;777;3;691.00;0
1269;3;5684793;1269;222;2051;2051;7.92;0.48;207.23;3.02;782;3;692.00;0
1273;3;5684804;1273;218;2051;2052;7.90;0.48;207.71;3.02;778;3;693.00;1
1275;3;5684814;1275;218;2052;2052;7.94;0.48;207.80;3.01;777;3;694.00;0
1280;3;5684823;1280;221;2052;2052;7.92;0.48;207.99;3.01;772;3;695.00;0
1286;3;5684834;1286;220;2056;2056;7.91;0.48;208.68;3.01;770;3;696.00;0
1290;3;5684844;1290;222;2056;2056;7.92;0.48;209.04;3.01;766;3;697.00;0
1291;3;5684853;1291;220;2056;2056;7.96;0.48;209.07;3.01;765;3;698.00;0
1297;3;5684862;1297;217;2057;2057;7.96;0.48;209.48;3.01;760;3;699.00;0
1300;3;5684874;1300;215;2061;2061;7.98;0.48;209.57;3.00;761;3;700.00;0
1302;3;5684888;1302;217;2061;2061;7.97;0.48;209.68;3.00;759;3;701.00;0
1305;3;5684897;1305;217;2063;2064;7.95;0.48;210.08;3.00;758;3;702.00;1
1306;3;5684907;1306;220;2063;2064;7.94;0.48;210.08;3.00;757;3;703.00;1
1308;3;5684916;1308;220;2064;2064;7.89;0.48;210.37;3.00;756;3;704.00;0
1311;3;5684926;1311;221;2064;2064;7.88;0.48;210.73;3.00;753;3;705.00;0
1313;3;5684935;1313;227;2068;2068;7.87;0.48;211.01;3.00;755;3;706.00;0
1316;3;5684945;1316;220;2068;2068;7.89;0.48;211.15;3.00;752;3;707.00;0
1319;3;5684954;1319;217;2068;2068;7.91;0.48;211.59;3.00;749;3;708.00;0
1322;3;5684964;1322;219;2068;2068;7.93;0.48;211.57;3.00;746;3;709.00;0
1326;3;5684973;1326;213;2069;2069;7.95;0.49;211.84;3.00;743;3;710.00;0
1327;3;5684982;1327;215;2070;2070;8.00;0.49;211.94;2.99;743;3;711.00;0
1330;3;5684992;1330;215;2070;2070;8.05;0.49;212.42;2.99;740;3;712.00;0
1331;3;5685002;1331;217;2071;2071;8.08;0.49;212.31;2.99;740;3;713.00;0
1336;3;5685010;1336;224;2071;2071;8.10;0.49;212.94;2.99;735;3;714.00;0
1339;3;5685021;1339;223;2071;2071;8.13;0.49;213.29;2.99;732;3;715.00;0
1340;3;5685036;1340;209;2071;2071;8.17;0.50;213.48;2.99;731;3;716.00;0
1342;3;5685045;1342;198;2071;2071;8.21;0.50;213.79;2.99;729;3;717.00;0
1346;3;5685053;1346;199;2071;2071;8.26;0.50;213.97;2.99;725;3;718.00;0
1348;3;5685063;1348;197;2071;2071;8.35;0.51;214.25;2.99;723;3;719.00;0
1352;3;5685073;1352;246;2200;2301;8.16;0.51;214.52;2.82;848;3;720.00;101
1353;3;5685100;1353;239;2209;2302;8.20;0.51;214.67;2.81;856;3;721.00;93
1359;3;5685111;1359;222;2218;2302;8.27;0.52;214.92;2.81;859;3;722.00;84
1361;3;5685121;1361;221;2227;2302;8.30;0.52;214.85;2.81;866;3;723.00;75
1364;3;5685132;1364;218;2234;2302;8.30;0.52;214.77;2.81;870;3;724.00;68
1366;3;5685142;1366;216;2238;2302;8.26;0.51;215.00;2.82;872;3;725.00;64
1368;3;5685158;1368;222;2244;2302;8.27;0.51;215.03;2.82;876;3;726.00;58
1372;3;5685168;1372;224;2249;2302;8.20;0.51;215.41;2.83;877;3;727.00;53
1375;3;5685178;1375;226;2256;2303;8.11;0.50;215.58;2.85;881;3;728.00;47
1377;3;5685189;1377;232;2258;2304;8.09;0.50;215.64;2.86;881;3;729.00;46
1379;3;5685199;1379;239;2266;2304;8.01;0.50;215.66;2.88;887;3;730.00;38
1382;3;5685215;1382;241;2269;2305;7.86;0.49;215.81;2.89;887;3;731.00;36
1383;3;5685231;1383;250;2273;2305;7.74;0.48;215.97;2.90;890;3;732.00;32
1385;3;5685242;1385;251;2274;2305;7.70;0.48;215.96;2.91;889;3;733.00;31
1386;3;5685252;1386;261;2276;2305;7.63;0.47;216.05;2.92;890;3;734.00;29
1387;3;5685261;1387;265;2278;2309;7.57;0.47;216.01;2.92;891;3;735.00;31
1388;3;5685277;1388;274;2279;2309;7.54;0.47;216.07;2.92;891;3;736.00;30
1389;3;5685286;1389;279;2281;2309;7.57;0.47;216.06;2.93;892;3;737.00;28
1391;3;5685296;1391;284;2282;2312;7.58;0.47;216.19;2.93;891;3;738.00;30
1392;3;5685311;1392;288;2283;2312;7.53;0.46;216.25;2.94;891;3;739.00;29
1394;3;5685321;1394;294;2286;2312;7.46;0.46;216.23;2.95;892;3;740.00;26
1396;3;5685330;1396;297;2291;2316;7.40;0.45;216.26;2.96;895;3;741.00;25
1397;3;5685340;1397;297;2292;2317;7.36;0.45;216.43;2.96;895;3;742.00;25
1399;3;5685350;1399;302;2293;2317;7.34;0.45;216.54;2.97;894;3;743.00;24
1400;3;5685359;1400;297;2297;2321;7.35;0.45;216.50;2.96;897;3;744.00;24
1401;3;5685369;1401;300;2297;2321;7.30;0.45;216.57;2.96;896;3;745.00;24
1402;3;5685378;1402;300;2298;2321;7.29;0.45;216.62;2.97;896;3;746.00;23
1407;3;5685389;1407;308;2298;2322;7.28;0.45;217.09;2.97;891;3;747.00;24
1409;3;5685399;1409;307;2298;2322;7.26;0.44;217.25;2.97;889;3;748.00;24
1411;3;5685409;1411;304;2303;2328;7.28;0.44;217.34;2.97;892;3;749.00;25
1412;3;5685420;1412;301;2305;2328;7.32;0.45;217.37;2.99;893;3;750.00;23
1413;3;5685430;1413;306;2307;2329;7.31;0.45;217.44;2.99;894;3;751.00;22
1414;3;5685439;1414;303;2308;2329;7.28;0.44;217.51;3.01;894;3;752.00;21
1414;3;5685449;1414;298;2309;2329;7.25;0.44;217.51;3.02;895;3;753.00;20
1416;3;5685458;1416;294;2310;2329;7.20;0.44;217.50;3.03;894;3;754.00;19
1418;3;5685467;1418;287;2311;2329;7.17;0.44;217.55;3.04;893;3;755.00;18
1421;3;5685477;1421;288;2321;2341;7.23;0.44;217.71;3.03;900;3;756.00;20
1422;3;5685487;1422;284;2322;2341;7.27;0.44;217.78;3.03;900;3;757.00;19
1423;3;5685496;1423;281;2323;2341;7.31;0.45;217.75;3.04;900;3;758.00;18
1425;3;5685506;1425;277;2324;2341;7.33;0.45;217.93;3.06;899;3;759.00;17
1427;3;5685515;1427;268;2324;2341;7.40;0.45;217.88;3.06;897;3;760.00;17
1431;3;5685524;1431;263;2327;2341;7.40;0.45;218.12;3.10;896;3;761.00;14
1434;3;5685533;1434;266;2331;2345;7.38;0.45;218.34;3.09;897;3;762.00;14
1438;3;5685543;1438;262;2331;2345;7.40;0.45;218.23;3.09;893;3;763.00;14
1439;3;5685552;1439;267;2336;2349;7.42;0.45;218.21;3.10;897;3;764.00;13
1441;3;5685562;1441;272;2337;2351;7.41;0.45;218.46;3.10;896;3;765.00;14
1442;3;5685571;1442;275;2339;2351;7.40;0.45;218.42;3.10;897;3;766.00;12
1447;3;5685580;1447;277;2339;2351;7.34;0.45;218.49;3.10;892;3;767.00;12
1449;3;5685590;1449;284;2349;2364;7.33;0.45;218.50;3.09;900;3;768.00;15
1450;3;5685601;1450;285;2349;2364;7.34;0.45;218.55;3.09;899;3;769.00;15
1453;3;5685610;1453;288;2350;2364;7.35;0.45;218.35;3.09;897;3;770.00;14
1454;3;5685619;1454;296;2352;2365;7.39;0.45;218.33;3.09;898;3;771.00;13
1455;3;5685628;1455;291;2353;2366;7.37;0.45;218.51;3.11;898;3;772.00;13
1456;3;5685638;1456;296;2353;2366;7.30;0.45;218.39;3.11;897;3;773.00;13
1457;3;5685647;1457;304;2356;2369;7.23;0.44;218.41;3.10;899;3;774.00;13
1457;3;5685657;1457;309;2357;2369;7.22;0.44;218.41;3.13;900;3;775.00;12
1459;3;5685665;1459;320;2358;2369;7.18;0.44;218.33;3.13;899;3;776.00;11
1461;3;5685675;1461;321;2359;2369;7.10;0.44;218.30;3.15;898;3;777.00;10
1461;3;5685684;1461;325;2364;2375;7.13;0.44;218.30;3.14;903;3;778.00;11
1464;3;5685694;1464;334;2364;2375;7.09;0.43;218.15;3.14;900;3;779.00;11
1464;3;5685705;1464;333;2365;2375;7.02;0.43;218.15;3.17;901;3;780.00;10
1466;3;5685716;1466;332;2366;2375;6.98;0.43;217.98;3.19;900;3;781.00;9
1467;3;5685725;1467;338;2370;2379;6.92;0.42;218.00;3.22;903;3;782.00;9
1467;3;5685735;1467;336;2372;2380;6.93;0.42;218.00;3.24;905;3;783.00;8
1472;3;5685745;1472;334;2374;2380;6.92;0.42;217.61;3.29;902;3;784.00;6
1475;3;5685754;1475;337;2375;2381;6.96;0.43;217.53;3.29;900;3;785.00;6
1477;3;5685763;1477;339;2376;2381;6.95;0.42;217.66;3.32;899;3;786.00;5
1480;3;5685773;1480;345;2376;2381;6.90;0.42;217.52;3.32;896;3;787.00;5
1483;3;5685782;1483;349;2377;2381;6.88;0.42;217.19;3.34;894;3;788.00;4
1486;3;5685791;1486;352;2377;2381;6.82;0.42;216.95;3.34;891;3;789.00;4
1487;3;5685800;1487;358;2380;2381;6.76;0.41;216.93;3.36;893;3;790.00;1
1488;3;5685809;1488;360;2380;2381;6.66;0.41;216.83;3.36;892;3;791.00;1
1490;3;5685817;1490;370;2418;2451;6.84;0.42;216.83;3.31;928;3;792.00;33
1491;3;5685833;1491;372;2420;2452;6.80;0.42;216.74;3.31;929;3;793.00;32
1494;3;5685842;1494;375;2431;2452;6.78;0.42;216.70;3.31;937;3;794.00;21
1498;3;5685851;1498;381;2435;2452;6.74;0.41;216.83;3.31;937;3;795.00;17
1498;3;5685861;1498;384;2439;2452;6.73;0.41;216.83;3.31;941;3;796.00;13
1498;3;5685869;1498;387;2441;2452;6.71;0.41;216.83;3.31;943;3;797.00;11
1498;3;5685878;1498;389;2444;2452;6.70;0.41;216.83;3.31;946;3;798.00;8
1501;3;5685888;1501;394;2445;2452;6.61;0.41;216.79;3.31;944;3;799.00;7
1504;3;5685898;1504;401;2447;2453;6.57;0.40;216.74;3.32;943;3;800.00;6
1507;3;5685911;1507;403;2450;2454;6.46;0.40;216.59;3.32;943;3;801.00;4
1507;3;5685920;1507;391;2453;2454;6.43;0.39;216.59;3.33;946;3;802.00;1
1508;3;5685929;1508;383;2458;2458;6.39;0.39;216.50;3.33;950;3;803.00;0
1510;3;5685939;1510;378;2458;2458;6.36;0.39;216.27;3.33;948;3;804.00;0
1510;3;5685948;1510;379;2458;2458;6.36;0.39;216.27;3.33;948;3;805.00;0
1510;3;5685957;1510;380;2458;2458;6.34;0.39;216.27;3.33;948;3;806.00;0
1512;3;5685966;1512;382;2464;2464;6.33;0.39;216.08;3.32;952;3;807.00;0
1515;3;5685976;1515;381;2464;2464;6.31;0.39;216.03;3.32;949;3;808.00;0
1515;3;5685991;1515;376;2464;2464;6.32;0.39;216.03;3.32;949;3;809.00;0
1516;3;5686002;1516;376;2468;2470;6.32;0.39;216.04;3.31;952;3;810.00;2
1516;3;5686012;1516;374;2469;2470;6.41;0.39;216.04;3.31;953;3;811.00;1
1516;3;5686021;1516;369;2470;2470;6.49;0.40;216.04;3.31;954;3;812.00;0
1517;3;5686031;1517;372;2471;2471;6.49;0.40;215.96;3.31;954;3;813.00;0
1519;3;5686040;1519;370;2472;2472;6.50;0.40;215.80;3.31;953;3;814.00;0
1520;3;5686050;1520;366;2472;2472;6.54;0.40;215.95;3.31;952;3;815.00;0
1524;3;5686059;1524;366;2484;2485;6.46;0.39;215.97;3.29;960;3;816.00;1
1526;3;5686070;1526;362;2484;2485;6.48;0.40;215.98;3.29;958;3;817.00;1
1528;3;5686079;1528;362;2485;2485;6.54;0.40;215.78;3.29;957;3;818.00;0
1531;3;5686088;1531;356;2486;2486;6.54;0.40;215.84;3.29;955;3;819.00;0
1533;3;5686098;1533;357;2486;2486;6.54;0.40;215.73;3.29;953;3;820.00;0
1534;3;5686108;1534;355;2490;2490;6.54;0.40;215.85;3.29;956;3;821.00;0
1536;3;5686118;1536;355;2490;2490;6.53;0.40;215.85;3.29;954;3;822.00;0
1539;3;5686128;1539;353;2494;2494;6.47;0.39;215.82;3.29;955;3;823.00;0
1546;3;5686138;1546;351;2494;2494;6.37;0.39;215.72;3.29;948;3;824.00;0
1548;3;5686148;1548;345;2494;2494;6.27;0.38;215.69;3.29;946;3;825.00;0
1551;3;5686157;1551;336;2494;2494;6.23;0.38;215.99;3.29;943;3;826.00;0
1555;3;5686167;1555;329;2494;2494;6.23;0.38;215.98;3.29;939;3;827.00;0
1558;3;5686176;1558;326;2505;2506;6.27;0.38;216.20;3.27;947;3;828.00;1
1562;3;5686187;1562;313;2505;2506;6.32;0.39;216.36;3.27;943;3;829.00;1
1565;3;5686196;1565;309;2505;2506;6.37;0.39;216.55;3.27;940;3;830.00;1
1568;3;5686206;1568;302;2505;2506;6.47;0.39;216.53;3.27;937;3;831.00;1
1570;3;5686216;1570;288;2506;2506;6.57;0.40;216.64;3.27;936;3;832.00;0
1576;3;5686225;1576;277;2506;2506;6.59;0.40;217.09;3.27;930;3;833.00;0
1577;3;5686236;1577;270;2507;2507;6.70;0.41;217.16;3.27;930;3;834.00;0
1582;4;5686246;1582;264;2507;2507;6.75;0.41;217.63;3.27;925;4;835.00;0
1585;4;5686266;1585;267;2513;2513;6.85;0.42;217.94;3.27;928;4;836.00;0
1588;4;5686277;1588;260;2514;2514;6.93;0.42;218.33;3.26;926;4;837.00;0
1592;4;5686292;1592;261;2514;2514;6.94;0.42;218.75;3.26;922;4;838.00;0
1594;4;5686307;1594;260;2514;2514;7.01;0.43;219.01;3.26;920;4;839.00;0
1599;4;5686319;1599;260;2519;2519;7.00;0.43;219.25;3.26;920;4;840.00;0
1602;4;5686329;1602;261;2519;2519;7.08;0.43;219.60;3.26;917;4;841.00;0
1607;4;5686340;1607;254;2519;2519;7.13;0.43;219.78;3.26;912;4;842.00;0
1611;4;5686350;1611;250;2520;2520;7.14;0.43;219.94;3.26;909;4;843.00;0
1614;4;5686360;1614;255;2524;2524;7.13;0.43;220.28;3.25;910;4;844.00;0
1617;4;5686372;1617;259;2524;2524;7.18;0.44;220.56;3.25;907;4;845.00;0
1622;4;5686382;1622;256;2526;2527;7.27;0.44;221.20;3.25;904;4;846.00;1
1625;4;5686393;1625;252;2527;2527;7.41;0.45;221.16;3.25;902;4;847.00;0
1630;4;5686403;1630;257;2527;2527;7.44;0.45;221.56;3.25;897;4;848.00;0
1632;4;5686414;1632;255;2527;2527;7.52;0.46;221.66;3.25;895;4;849.00;0
1635;4;5686424;1635;247;2531;2531;7.54;0.46;221.88;3.25;896;4;850.00;0
1640;4;5686435;1640;247;2531;2531;7.54;0.46;222.10;3.25;891;4;851.00;0
1646;4;5686446;1646;247;2531;2531;7.50;0.45;222.37;3.25;885;4;852.00;0
1650;4;5686457;1650;241;2531;2531;7.50;0.45;222.28;3.25;881;4;853.00;0
1653;4;5686467;1653;240;2532;2532;7.49;0.45;222.68;3.24;879;4;854.00;0
1660;4;5686478;1660;242;2534;2534;7.46;0.45;223.17;3.24;874;4;855.00;0
1663;4;5686489;1663;240;2534;2534;7.46;0.45;223.27;3.24;871;4;856.00;0
1667;4;5686500;1667;240;2534;2535;7.49;0.45;223.78;3.24;867;4;857.00;1
1673;4;5686510;1673;238;2534;2535;7.42;0.45;224.03;3.24;861;4;858.00;1
1677;4;5686521;1677;240;2534;2535;7.41;0.45;224.31;3.24;857;4;859.00;1
1680;4;5686531;1680;240;2534;2535;7.45;0.45;224.68;3.24;854;4;860.00;1
1682;4;5686541;1682;243;2534;2535;7.44;0.45;225.17;3.24;852;4;861.00;1
1683;4;5686551;1683;249;2534;2535;7.48;0.45;225.31;3.24;851;4;862.00;1
1685;4;5686561;1685;249;2534;2535;7.54;0.46;225.72;3.24;849;4;863.00;1
1687;4;5686572;1687;274;2611;2662;7.67;0.47;225.95;3.15;924;4;864.00;51
1689;4;5686591;1689;266;2616;2663;7.72;0.48;226.18;3.15;927;4;865.00;47
1691;4;5686602;1691;265;2622;2663;7.81;0.48;226.19;3.14;931;4;866.00;41
1693;4;5686613;1693;264;2624;2663;7.76;0.48;226.43;3.14;931;4;867.00;39
1695;4;5686623;1695;267;2627;2663;7.75;0.48;226.57;3.15;932;4;868.00;36
1700;4;5686634;1700;270;2628;2663;7.67;0.47;227.07;3.15;928;4;869.00;35
1704;4;5686646;1704;284;2629;2663;7.61;0.47;227.42;3.15;925;4;870.00;34
1705;4;5686657;1705;291;2631;2663;7.55;0.46;227.63;3.15;926;4;871.00;32
1707;4;5686669;1707;288;2633;2664;7.49;0.46;227.93;3.15;926;4;872.00;31
1710;4;5686680;1710;287;2637;2665;7.42;0.46;228.39;3.16;927;4;873.00;28
1711;4;5686692;1711;281;2639;2665;7.41;0.46;228.61;3.17;928;4;874.00;26
1713;4;5686703;1713;281;2641;2666;7.34;0.45;228.91;3.17;928;4;875.00;25
1719;4;5686714;1719;281;2642;2666;7.26;0.45;229.26;3.17;923;4;876.00;24
1722;4;5686726;1722;289;2644;2666;7.21;0.44;229.48;3.18;922;4;877.00;22
1726;4;5686738;1726;290;2644;2666;7.19;0.44;229.84;3.18;918;4;878.00;22
1732;4;5686750;1732;296;2652;2670;7.14;0.44;230.57;3.21;920;4;879.00;18
1735;4;5686761;1735;307;2653;2670;7.15;0.44;231.07;3.21;918;4;880.00;17
1737;4;5686778;1737;298;2655;2670;7.18;0.44;231.32;3.22;918;4;881.00;15
1741;4;5686790;1741;285;2656;2673;7.18;0.44;231.46;3.22;915;4;882.00;17
1746;4;5686807;1746;276;2658;2673;7.26;0.44;231.67;3.23;912;4;883.00;15
1749;4;5686818;1749;279;2659;2673;7.33;0.45;231.67;3.24;910;4;884.00;14
1753;4;5686830;1753;280;2666;2677;7.32;0.45;231.94;3.25;913;4;885.00;11
1759;4;5686841;1759;277;2668;2678;7.35;0.45;232.07;3.26;909;4;886.00;10
1761;4;5686853;1761;271;2670;2678;7.45;0.46;232.09;3.27;909;4;887.00;8
1764;4;5686865;1764;276;2673;2682;7.49;0.46;232.49;3.27;909;4;888.00;9
1768;4;5686877;1768;284;2673;2682;7.55;0.46;232.95;3.27;905;4;889.00;9
1771;4;5686889;1771;282;2675;2682;7.60;0.46;233.01;3.29;904;4;890.00;7
1773;4;5686900;1773;277;2676;2683;7.66;0.47;233.10;3.29;903;4;891.00;7
1779;4;5686911;1779;275;2677;2683;7.69;0.47;233.57;3.30;898;4;892.00;6
1783;4;5686923;1783;275;2683;2689;7.71;0.47;233.87;3.30;900;4;893.00;6
1784;4;5686934;1784;268;2684;2689;7.83;0.48;233.90;3.31;900;4;894.00;5
1788;4;5686946;1788;263;2686;2690;7.88;0.48;234.15;3.31;898;4;895.00;4
1789;4;5686962;1789;262;2686;2690;7.99;0.49;234.16;3.31;897;4;896.00;4
1791;4;5686977;1791;262;2688;2690;8.06;0.49;234.33;3.31;897;4;897.00;2
1795;4;5686996;1795;263;2689;2690;8.09;0.49;234.59;3.32;894;4;898.00;1
1798;4;5687015;1798;261;2690;2690;8.12;0.49;234.71;3.32;892;4;899.00;0
1804;4;5687037;1804;265;2720;2736;8.07;0.49;234.93;3.28;916;4;900.00;16
1806;4;5687072;1806;268;2722;2736;8.07;0.49;235.05;3.28;916;4;901.00;14
1807;4;5687085;1807;270;2725;2736;8.16;0.50;235.03;3.28;918;4;902.00;11
1808;4;5687099;1808;269;2725;2736;8.21;0.50;235.14;3.28;917;4;903.00;11
1811;4;5687113;1811;269;2727;2736;8.22;0.50;235.06;3.28;916;4;904.00;9
1811;4;5687126;1811;277;2727;2736;8.21;0.50;235.06;3.28;916;4;905.00;9
1816;4;5687138;1816;285;2733;2740;8.08;0.49;234.96;3.28;917;4;906.00;7
1818;4;5687150;1818;287;2734;2740;7.97;0.48;234.99;3.28;916;4;907.00;6
1818;4;5687170;1818;299;2737;2744;7.85;0.48;234.99;3.28;919;4;908.00;7
1819;4;5687182;1819;303;2738;2745;7.77;0.47;235.04;3.27;919;4;909.00;7
1819;4;5687195;1819;312;2738;2745;7.72;0.47;235.04;3.27;919;4;910.00;7
1820;4;5687207;1820;314;2738;2745;7.58;0.46;235.07;3.27;918;4;911.00;7
1822;4;5687219;1822;326;2751;2758;7.47;0.45;235.12;3.26;929;4;912.00;7
1824;4;5687231;1824;326;2752;2758;7.31;0.44;235.04;3.27;928;4;913.00;6
1824;4;5687241;1824;328;2752;2758;7.15;0.43;235.04;3.27;928;4;914.00;6
1825;4;5687251;1825;330;2753;2759;7.05;0.43;234.98;3.27;928;4;915.00;6
1827;4;5687262;1827;332;2754;2760;6.95;0.42;235.09;3.27;927;4;916.00;6
1830;4;5687274;1830;334;2754;2760;6.82;0.42;234.98;3.27;924;4;917.00;6
1832;4;5687284;1832;341;2758;2763;6.76;0.41;234.95;3.27;926;4;918.00;5
1833;4;5687296;1833;336;2758;2763;6.72;0.41;235.01;3.27;925;4;919.00;5
1837;4;5687312;1837;332;2759;2763;6.68;0.41;234.86;3.27;922;4;920.00;4
1839;4;5687324;1839;329;2759;2763;6.64;0.41;234.91;3.27;920;4;921.00;4
1842;4;5687336;1842;325;2764;2769;6.60;0.40;235.07;3.27;922;4;922.00;5
1845;4;5687349;1845;321;2764;2769;6.60;0.40;234.97;3.27;919;4;923.00;5
1847;4;5687366;1847;323;2767;2769;6.62;0.40;234.86;3.29;920;4;924.00;2
1849;4;5687384;1849;325;2767;2769;6.65;0.40;234.90;3.29;918;4;925.00;2
1853;4;5687406;1853;322;2773;2773;6.60;0.40;234.87;3.29;920;4;926.00;0
1853;4;5687428;1853;329;2774;2774;6.69;0.41;234.87;3.29;921;4;927.00;0
1858;4;5687444;1858;331;2774;2774;6.69;0.41;234.87;3.29;916;4;928.00;0
1860;4;5687462;1860;330;2775;2775;6.71;0.41;234.96;3.29;915;4;929.00;0
1862;4;5687483;1862;334;2775;2775;6.71;0.41;234.78;3.29;913;4;930.00;0
1865;4;5687501;1865;334;2775;2775;6.76;0.41;234.56;3.29;910;4;931.00;0
1867;4;5687516;1867;322;2775;2775;6.75;0.41;234.47;3.29;908;4;932.00;0
1873;4;5687531;1873;328;2775;2775;6.73;0.41;234.63;3.29;902;4;933.00;0
1875;4;5687545;1875;324;2775;2775;6.74;0.41;234.75;3.29;900;4;934.00;0
1876;4;5687555;1876;326;2775;2775;6.76;0.41;234.79;3.29;899;4;935.00;0
1877;4;5687565;1877;329;2813;2845;6.96;0.42;234.82;3.24;936;4;936.00;32
1877;4;5687581;1877;326;2815;2846;6.95;0.42;234.82;3.24;938;4;937.00;31
1877;4;5687592;1877;326;2823;2846;7.00;0.43;234.82;3.24;946;4;938.00;23
1879;4;5687602;1879;328;2826;2846;6.93;0.42;234.82;3.24;947;4;939.00;20
1879;4;5687612;1879;327;2830;2846;6.92;0.42;234.82;3.24;951;4;940.00;16
1883;4;5687623;1883;332;2833;2846;6.87;0.42;234.78;3.24;950;4;941.00;13
1883;4;5687633;1883;330;2835;2846;6.83;0.42;234.78;3.24;952;4;942.00;11
1884;4;5687644;1884;330;2837;2846;6.78;0.41;234.79;3.25;953;4;943.00;9
1886;4;5687654;1886;334;2839;2847;6.80;0.41;234.74;3.25;953;4;944.00;8
1888;4;5687664;1888;331;2842;2849;6.72;0.41;234.64;3.25;954;4;945.00;7
1892;4;5687675;1892;341;2844;2849;6.72;0.41;234.79;3.26;952;4;946.00;5
1893;4;5687685;1893;343;2849;2853;6.72;0.41;234.76;3.26;956;4;947.00;4
1894;4;5687699;1894;342;2850;2853;6.67;0.40;234.78;3.26;956;4;948.00;3
1895;4;5687711;1895;330;2851;2853;6.64;0.40;234.67;3.26;956;4;949.00;2
1896;4;5687721;1896;322;2852;2853;6.61;0.40;234.56;3.26;956;4;950.00;1
1897;4;5687732;1897;317;2857;2859;6.67;0.41;234.55;3.26;960;4;951.00;2
1897;4;5687744;1897;325;2857;2859;6.69;0.41;234.55;3.26;960;4;952.00;2
1897;4;5687756;1897;326;2857;2859;6.69;0.41;234.55;3.26;960;4;953.00;2
1899;4;5687767;1899;327;2860;2862;6.75;0.41;234.42;3.26;961;4;954.00;2
1901;4;5687778;1901;333;2862;2862;6.80;0.41;234.49;3.26;961;4;955.00;0
1902;4;5687794;1902;338;2862;2862;6.82;0.42;234.50;3.26;960;4;956.00;0
1902;4;5687805;1902;346;2863;2863;6.85;0.42;234.50;3.26;961;4;957.00;0
1904;4;5687816;1904;346;2864;2864;6.85;0.42;234.43;3.26;960;4;958.00;0
1905;4;5687827;1905;349;2864;2864;6.82;0.42;234.43;3.26;959;4;959.00;0
1908;4;5687839;1908;358;2883;2890;6.84;0.42;234.38;3.24;975;4;960.00;7
1911;4;5687852;1911;358;2883;2890;6.79;0.41;234.09;3.24;972;4;961.00;7
1911;4;5687863;1911;362;2888;2890;6.81;0.42;234.09;3.23;977;4;962.00;2
1912;4;5687873;1912;363;2890;2891;6.80;0.42;234.07;3.23;978;4;963.00;1
1914;4;5687884;1914;361;2891;2891;6.76;0.41;234.22;3.23;977;4;964.00;0
1915;4;5687894;1915;369;2895;2895;6.79;0.42;234.11;3.23;980;4;965.00;0
1916;4;5687905;1916;370;2895;2895;6.74;0.41;234.13;3.23;979;4;966.00;0
1916;4;5687915;1916;371;2899;2899;6.70;0.41;234.13;3.23;983;4;967.00;0
1917;4;5687926;1917;371;2899;2899;6.72;0.41;234.06;3.23;982;4;968.00;0
1918;4;5687936;1918;372;2899;2899;6.74;0.41;234.13;3.23;981;4;969.00;0
1922;4;5687946;1922;371;2899;2899;6.65;0.41;233.90;3.23;977;4;970.00;0
1924;4;5687956;1924;371;2899;2899;6.63;0.41;233.84;3.23;975;4;971.00;0
1928;4;5687966;1928;371;2910;2911;6.60;0.41;233.91;3.22;982;4;972.00;1
1931;4;5687977;1931;369;2910;2911;6.55;0.40;233.99;3.22;979;4;973.00;1
1934;4;5687987;1934;364;2911;2911;6.50;0.40;234.10;3.22;977;4;974.00;0
1938;4;5687997;1938;360;2911;2911;6.46;0.40;234.35;3.22;973;4;975.00;0
1941;4;5688007;1941;352;2911;2911;6.38;0.39;234.34;3.22;970;4;976.00;0
1942;4;5688016;1942;351;2911;2911;6.36;0.39;234.35;3.22;969;4;977.00;0
1944;4;5688026;1944;348;2912;2912;6.35;0.39;234.64;3.21;968;4;978.00;0
1945;4;5688036;1945;347;2912;2912;6.33;0.39;234.61;3.21;967;4;979.00;0
1947;4;5688045;1947;340;2918;2918;6.35;0.39;234.63;3.21;971;4;980.00;0
1948;4;5688055;1948;338;2919;2919;6.37;0.39;234.86;3.21;971;4;981.00;0
1949;4;5688064;1949;346;2919;2919;6.34;0.39;234.84;3.21;970;4;982.00;0
1952;4;5688073;1952;353;2919;2919;6.27;0.38;234.84;3.21;967;4;983.00;0
1958;4;5688083;1958;351;2923;2923;6.24;0.38;234.78;3.20;965;4;984.00;0
1959;4;5688093;1959;347;2923;2923;6.25;0.38;234.87;3.20;964;4;985.00;0
1959;4;5688102;1959;349;2923;2923;6.23;0.38;234.87;3.20;964;4;986.00;0
1963;4;5688113;1963;346;2924;2924;6.23;0.38;235.19;3.20;961;4;987.00;0
1968;4;5688122;1968;348;2928;2928;6.24;0.38;235.03;3.20;960;4;988.00;0
1969;4;5688132;1969;349;2928;2928;6.31;0.39;235.06;3.20;959;4;989.00;0
1976;4;5688143;1976;336;2932;2934;6.33;0.39;234.99;3.20;956;4;990.00;2
1977;4;5688153;1977;321;2932;2934;6.38;0.39;235.15;3.20;955;4;991.00;2
1980;4;5688163;1980;312;2934;2934;6.41;0.39;235.35;3.20;954;4;992.00;0
1988;4;5688173;1988;303;2934;2934;6.41;0.39;235.88;3.20;946;4;993.00;0
1991;4;5688183;1991;297;2938;2938;6.52;0.40;235.98;3.19;947;4;994.00;0
1995;4;5688193;1995;291;2938;2938;6.56;0.40;236.23;3.19;943;4;995.00;0
1999;4;5688203;1999;288;2938;2938;6.52;0.40;236.57;3.19;939;4;996.00;0
2002;4;5688213;2002;281;2938;2938;6.58;0.40;236.91;3.19;936;4;997.00;0
2003;4;5688224;2003;281;2939;2939;6.64;0.40;236.88;3.19;936;4;998.00;0
2006;4;5688234;2006;273;2940;2940;6.71;0.41;237.06;3.19;934;4;999.00;0
2011;4;5688245;2011;266;2940;2940;6.76;0.41;237.11;3.19;929;4;1000.00;0
2015;4;5688264;2015;259;2941;2941;6.81;0.42;237.20;3.19;926;4;1001.00;0
2020;4;5688274;2020;257;2941;2941;6.91;0.42;237.32;3.19;921;4;1002.00;0
2025;4;5688284;2025;258;2941;2941;6.98;0.42;237.56;3.19;916;4;1003.00;0
2028;4;5688295;2028;257;2941;2941;7.07;0.43;237.74;3.19;913;4;1004.00;0
2034;4;5688305;2034;261;2941;2941;7.07;0.43;237.82;3.19;907;4;1005.00;0
2036;4;5688316;2036;261;2941;2941;7.14;0.43;237.93;3.19;905;4;1006.00;0
2038;4;5688327;2038;270;2941;2941;7.17;0.44;238.16;3.19;903;4;1007.00;0
2041;4;5688338;2041;280;3025;3068;7.50;0.46;238.32;3.10;984;4;1008.00;43
2046;4;5688359;2046;278;3030;3069;7.51;0.46;238.54;3.10;984;4;1009.00;39
2049;4;5688371;2049;269;3035;3069;7.57;0.47;238.75;3.10;986;4;1010.00;34
2050;4;5688383;2050;270;3039;3069;7.62;0.47;238.71;3.10;989;4;1011.00;30
2055;4;5688394;2055;269;3043;3069;7.69;0.47;238.91;3.10;988;4;1012.00;26
2059;4;5688406;2059;267;3044;3069;7.63;0.47;239.23;3.10;985;4;1013.00;25
2063;4;5688418;2063;268;3046;3069;7.61;0.47;239.48;3.10;983;4;1014.00;23
2065;4;5688429;2065;273;3047;3069;7.56;0.47;239.63;3.10;982;4;1015.00;22
2068;4;5688441;2068;284;3049;3070;7.51;0.46;239.69;3.10;981;4;1016.00;21
2071;4;5688452;2071;286;3053;3071;7.45;0.46;239.90;3.11;982;4;1017.00;18
2078;4;5688464;2078;292;3055;3071;7.32;0.45;240.24;3.12;977;4;1018.00;16
2082;4;5688477;2082;299;3058;3072;7.21;0.44;240.45;3.12;976;4;1019.00;14
2085;4;5688490;2085;301;3059;3072;7.21;0.44;240.52;3.12;974;4;1020.00;13
2088;4;5688502;2088;306;3061;3072;7.19;0.44;240.66;3.13;973;4;1021.00;11
2094;4;5688513;2094;308;3064;3072;7.16;0.44;240.82;3.14;970;4;1022.00;8
2096;4;5688526;2096;315;3068;3076;7.21;0.44;241.08;3.15;972;4;1023.00;8
2103;5;5688538;2103;313;3069;3076;7.17;0.44;241.54;3.15;966;5;1024.00;7
2106;5;5688556;2106;315;3072;3076;7.18;0.44;241.57;3.16;966;5;1025.00;4
2111;5;5688571;2111;309;3073;3079;7.19;0.44;241.88;3.16;962;5;1026.00;6
2117;5;5688583;2117;314;3075;3079;7.20;0.44;242.28;3.17;958;5;1027.00;4
2119;5;5688594;2119;314;3076;3079;7.25;0.44;242.24;3.17;957;5;1028.00;3
2122;5;5688605;2122;311;3081;3083;7.30;0.45;242.49;3.17;959;5;1029.00;2
2124;5;5688617;2124;312;3083;3084;7.34;0.45;242.81;3.17;959;5;1030.00;1
2130;5;5688628;2130;313;3083;3084;7.32;0.45;242.96;3.17;953;5;1031.00;1
2135;5;5688640;2135;315;3087;3088;7.24;0.44;243.08;3.16;952;5;1032.00;1
2139;5;5688651;2139;319;3088;3088;7.11;0.43;243.55;3.17;949;5;1033.00;0
2142;5;5688662;2142;324;3088;3088;7.03;0.43;243.87;3.17;946;5;1034.00;0
2144;6;5688673;2144;327;3090;3090;6.91;0.42;244.13;3.16;946;6;1035.00;0
2148;6;5688700;2148;334;3090;3090;6.80;0.41;244.48;3.16;942;6;1036.00;0
2151;6;5688711;2151;327;3096;3096;6.73;0.41;244.68;3.16;945;6;1037.00;0
2154;6;5688723;2154;319;3096;3096;6.71;0.41;244.92;3.16;942;6;1038.00;0
2158;6;5688739;2158;321;3097;3097;6.68;0.41;245.30;3.16;939;6;1039.00;0
2162;6;5688750;2162;319;3097;3097;6.73;0.41;245.46;3.16;935;6;1040.00;0
2166;6;5688761;2166;320;3097;3097;6.80;0.41;245.67;3.16;931;6;1041.00;0
2168;6;5688771;2168;320;3097;3097;6.89;0.42;245.86;3.16;929;6;1042.00;0
2172;6;5688781;2172;324;3097;3097;6.92;0.42;246.23;3.16;925;6;1043.00;0
2174;6;5688792;2174;324;3108;3109;7.04;0.43;246.18;3.15;934;6;1044.00;1
2180;6;5688803;2180;330;3108;3109;6.99;0.42;246.26;3.15;928;6;1045.00;1
2184;6;5688819;2184;320;3109;3109;7.01;0.43;246.80;3.15;925;6;1046.00;0
2186;6;5688830;2186;317;3109;3109;7.08;0.43;246.94;3.15;923;6;1047.00;0
2187;6;5688840;2187;316;3109;3109;7.17;0.44;247.09;3.15;922;6;1048.00;0
2190;6;5688851;2190;318;3109;3109;7.28;0.44;247.20;3.15;919;6;1049.00;0
2193;6;5688869;2193;317;3115;3115;7.32;0.45;247.46;3.14;922;6;1050.00;0
2195;6;5688881;2195;317;3115;3115;7.34;0.45;247.78;3.14;920;6;1051.00;0
2197;6;5688892;2197;316;3119;3119;7.45;0.45;247.91;3.14;922;6;1052.00;0
2200;6;5688903;2200;317;3120;3120;7.42;0.45;248.18;3.14;920;6;1053.00;0
2201;6;5688914;2201;322;3120;3120;7.44;0.45;248.22;3.14;919;6;1054.00;0
2202;6;5688924;2202;324;3120;3120;7.45;0.45;248.29;3.14;918;6;1055.00;0
2204;6;5688935;2204;333;3133;3133;7.48;0.46;248.46;3.13;929;6;1056.00;0
2207;6;5688946;2207;330;3133;3133;7.43;0.45;248.55;3.13;926;6;1057.00;0
2212;6;5688957;2212;324;3133;3133;7.35;0.45;248.72;3.13;921;6;1058.00;0
2213;6;5688969;2213;323;3134;3134;7.34;0.45;248.76;3.13;921;6;1059.00;0
2216;6;5688981;2216;323;3135;3135;7.27;0.44;249.06;3.12;919;6;1060.00;0
2218;6;5688993;2218;321;3135;3135;7.25;0.44;249.04;3.12;917;6;1061.00;0
2218;6;5689004;2218;320;3137;3138;7.27;0.44;249.04;3.12;919;6;1062.00;1
2220;6;5689014;2220;313;3137;3138;7.25;0.44;248.91;3.12;917;6;1063.00;1
2223;6;5689025;2223;314;3138;3138;7.24;0.44;248.88;3.12;915;6;1064.00;0
2225;6;5689035;2225;319;3138;3138;7.28;0.44;249.02;3.12;913;6;1065.00;0
2226;6;5689046;2226;321;3143;3144;7.28;0.45;249.14;3.12;917;6;1066.00;1
2228;6;5689057;2228;322;3143;3144;7.26;0.44;249.11;3.12;915;6;1067.00;1
2232;6;5689068;2232;328;3143;3144;7.22;0.44;249.08;3.12;911;6;1068.00;1
2238;6;5689079;2238;327;3144;3144;7.15;0.44;248.93;3.12;906;6;1069.00;0
2241;6;5689091;2241;327;3148;3148;7.09;0.43;248.89;3.12;907;6;1070.00;0
2243;6;5689102;2243;326;3149;3149;7.01;0.43;248.88;3.12;906;6;1071.00;0
2247;6;5689113;2247;329;3149;3149;6.95;0.42;248.75;3.12;902;6;1072.00;0
2249;6;5689123;2249;334;3150;3150;6.90;0.42;248.64;3.11;901;6;1073.00;0
2251;6;5689133;2251;332;3150;3150;6.85;0.42;248.71;3.11;899;6;1074.00;0
2255;6;5689143;2255;325;3150;3150;6.75;0.41;248.55;3.11;895;6;1075.00;0
2257;6;5689153;2257;327;3150;3150;6.73;0.41;248.57;3.11;893;6;1076.00;0
2257;6;5689163;2257;327;3150;3150;6.72;0.41;248.57;3.11;893;6;1077.00;0
2258;6;5689173;2258;324;3150;3150;6.71;0.41;248.48;3.11;892;6;1078.00;0
2259;6;5689183;2259;334;3150;3150;6.71;0.41;248.52;3.11;891;6;1079.00;0
2259;6;5689195;2259;354;3221;3275;6.77;0.42;248.52;3.05;962;6;1080.00;54
2260;6;5689224;2260;340;3222;3276;6.77;0.42;248.55;3.05;962;6;1081.00;54
2262;6;5689236;2262;332;3231;3276;6.87;0.42;248.65;3.04;969;6;1082.00;45
2266;6;5689246;2266;328;3238;3276;6.89;0.42;248.86;3.04;972;6;1083.00;38
2268;6;5689256;2268;317;3243;3276;6.92;0.43;248.99;3.04;975;6;1084.00;33
2268;6;5689267;2268;315;3245;3276;6.87;0.42;248.99;3.04;977;6;1085.00;31
2270;6;5689283;2270;316;3250;3276;6.90;0.42;249.05;3.05;980;6;1086.00;26
2271;6;5689293;2271;315;3255;3276;6.91;0.42;249.10;3.06;984;6;1087.00;21
2273;6;5689303;2273;318;3262;3277;6.86;0.42;249.15;3.07;989;6;1088.00;15
2273;6;5689314;2273;327;3265;3278;6.84;0.42;249.15;3.07;992;6;1089.00;13
2275;6;5689330;2275;323;3268;3278;6.81;0.42;249.22;3.08;993;6;1090.00;10
2282;6;5689341;2282;325;3275;3282;6.72;0.41;249.68;3.08;993;6;1091.00;7
2285;6;5689352;2285;323;3275;3282;6.70;0.41;249.81;3.08;990;6;1092.00;7
2286;6;5689362;2286;322;3276;3282;6.70;0.41;249.86;3.08;990;6;1093.00;6
2289;6;5689371;2289;318;3276;3282;6.64;0.41;249.85;3.08;987;6;1094.00;6
2291;6;5689384;2291;313;3282;3288;6.58;0.40;249.91;3.08;991;6;1095.00;6
2294;6;5689400;2294;300;3282;3288;6.56;0.40;250.01;3.08;988;6;1096.00;6
2296;6;5689413;2296;288;3283;3288;6.56;0.40;249.85;3.09;987;6;1097.00;5
2299;6;5689425;2299;280;3285;3291;6.54;0.40;249.75;3.08;986;6;1098.00;6
2304;6;5689437;2304;286;3286;3291;6.54;0.40;249.69;3.09;982;6;1099.00;5
2305;6;5689449;2305;277;3286;3291;6.55;0.40;249.66;3.09;981;6;1100.00;5
2306;6;5689463;2306;275;3288;3292;6.59;0.40;249.64;3.09;982;6;1101.00;4
2307;6;5689474;2307;271;3289;3293;6.69;0.41;249.61;3.09;982;6;1102.00;4
2310;6;5689490;2310;268;3289;3293;6.76;0.41;249.56;3.09;979;6;1103.00;4
2312;6;5689501;2312;267;3301;3306;6.88;0.42;249.36;3.08;989;6;1104.00;5
2314;6;5689513;2314;265;3301;3306;6.98;0.42;249.28;3.08;987;6;1105.00;5
2317;6;5689525;2317;260;3303;3306;7.05;0.43;249.23;3.09;986;6;1106.00;3
2321;6;5689541;2321;262;3304;3307;7.14;0.43;249.39;3.09;983;6;1107.00;3
2324;6;5689554;2324;254;3307;3307;7.20;0.44;249.47;3.10;983;6;1108.00;0
2324;6;5689565;2324;250;3309;3311;7.31;0.44;249.47;3.10;985;6;1109.00;2
2325;6;5689585;2325;247;3309;3311;7.37;0.45;249.45;3.10;984;6;1110.00;2
2325;6;5689597;2325;249;3314;3315;7.42;0.45;249.45;3.10;989;6;1111.00;1
2325;6;5689608;2325;248;3314;3315;7.51;0.46;249.45;3.10;989;6;1112.00;1
2326;6;5689619;2326;250;3314;3315;7.55;0.46;249.36;3.10;988;6;1113.00;1
2327;6;5689630;2327;249;3314;3315;7.62;0.46;249.39;3.10;987;6;1114.00;1
2327;6;5689641;2327;242;3314;3315;7.69;0.47;249.39;3.10;987;6;1115.00;1
2327;6;5689652;2327;243;3323;3327;7.75;0.47;249.39;3.09;996;6;1116.00;4
2330;6;5689664;2330;238;3324;3327;7.80;0.47;249.51;3.09;994;6;1117.00;3
2331;6;5689674;2331;238;3325;3327;7.84;0.48;249.57;3.09;994;6;1118.00;2
2332;6;5689686;2332;244;3325;3327;7.83;0.48;249.71;3.09;993;6;1119.00;2
2334;6;5689702;2334;249;3326;3327;7.79;0.47;249.58;3.09;992;6;1120.00;1
2336;6;5689714;2336;248;3326;3327;7.74;0.47;249.76;3.09;990;6;1121.00;1
2338;6;5689726;2338;252;3328;3328;7.67;0.47;249.67;3.09;990;6;1122.00;0
2342;6;5689737;2342;252;3328;3328;7.63;0.46;249.98;3.09;986;6;1123.00;0
2343;6;5689748;2343;258;3334;3334;7.68;0.47;250.00;3.09;991;6;1124.00;0
2346;6;5689764;2346;268;3335;3336;7.62;0.46;250.04;3.09;989;6;1125.00;1
2348;6;5689777;2348;268;3336;3336;7.58;0.46;250.19;3.08;988;6;1126.00;0
2352;6;5689793;2352;266;3336;3336;7.52;0.46;250.43;3.08;984;6;1127.00;0
2355;6;5689804;2355;270;3340;3340;7.50;0.46;250.57;3.08;985;6;1128.00;0
2358;6;5689821;2358;273;3340;3340;7.45;0.45;250.81;3.08;982;6;1129.00;0
2360;6;5689831;2360;279;3340;3340;7.39;0.45;250.97;3.08;980;6;1130.00;0
2363;6;5689842;2363;278;3341;3341;7.36;0.45;251.02;3.08;978;6;1131.00;0
2368;6;5689852;2368;283;3345;3345;7.26;0.44;251.21;3.08;977;6;1132.00;0
2370;6;5689863;2370;288;3345;3345;7.30;0.45;251.25;3.08;975;7;1133.00;0
2373;6;5689880;2373;289;3347;3348;7.28;0.45;251.54;3.08;974;7;1134.00;1
2377;6;5689891;2377;292;3348;3348;7.23;0.44;251.51;3.08;971;7;1135.00;0
2380;6;5689901;2380;290;3348;3348;7.17;0.44;251.43;3.08;968;8;1136.00;0
2382;6;5689920;2382;293;3348;3348;7.14;0.44;251.41;3.08;966;8;1137.00;0
2384;6;5689930;2384;293;3352;3352;7.18;0.44;251.41;3.07;968;8;1138.00;0
2388;6;5689940;2388;285;3352;3352;7.10;0.43;251.62;3.07;964;8;1139.00;0
2391;6;5689952;2391;285;3352;3352;7.05;0.43;251.41;3.07;961;8;1140.00;0
2394;6;5689962;2394;280;3352;3352;7.02;0.43;251.51;3.07;958;8;1141.00;0
2396;6;5689972;2396;274;3353;3353;7.00;0.43;251.54;3.07;957;8;1142.00;0
2399;6;5689981;2399;269;3354;3354;6.98;0.43;251.64;3.07;955;8;1143.00;0
2401;6;5689992;2401;266;3354;3354;6.96;0.43;251.97;3.07;953;8;1144.00;0
2402;6;5690001;2402;272;3355;3355;7.01;0.43;251.96;3.07;953;8;1145.00;0
2403;6;5690011;2403;265;3355;3355;7.00;0.43;252.04;3.07;952;8;1146.00;0
2403;6;5690021;2403;266;3355;3355;7.05;0.43;252.04;3.07;952;8;1147.00;0
2406;6;5690030;2406;268;3355;3355;7.02;0.43;251.98;3.07;949;8;1148.00;0
2410;6;5690039;2410;268;3355;3355;6.98;0.43;252.02;3.07;945;8;1149.00;0
2411;6;5690048;2411;267;3355;3355;7.00;0.43;251.98;3.07;944;8;1150.00;0
2413;6;5690058;2413;271;3355;3355;7.03;0.43;251.83;3.07;942;8;1151.00;0
2416;6;5690068;2416;301;3432;3482;7.18;0.45;251.86;3.00;1016;8;1152.00;50
2419;6;5690088;2419;297;3434;3483;7.16;0.44;251.88;3.00;1015;8;1153.00;49
2422;6;5690105;2422;292;3441;3483;7.22;0.45;251.91;3.00;1019;8;1154.00;42
2428;6;5690117;2428;283;3444;3483;7.23;0.45;251.94;3.00;1016;8;1155.00;39
2435;6;5690128;2435;273;3450;3483;7.24;0.45;252.45;3.00;1015;8;1156.00;33
2438;6;5690139;2438;269;3453;3483;7.25;0.45;252.67;3.00;1015;8;1157.00;30
2443;6;5690149;2443;264;3455;3483;7.22;0.45;252.88;3.00;1012;8;1158.00;28
2446;6;5690160;2446;269;3457;3483;7.22;0.45;252.96;3.01;1011;8;1159.00;26
2452;6;5690171;2452;275;3460;3484;7.21;0.45;253.11;3.01;1008;8;1160.00;24
2458;6;5690185;2458;280;3465;3485;7.21;0.44;253.37;3.02;1007;8;1161.00;20
2460;6;5690197;2460;279;3467;3485;7.25;0.45;253.34;3.02;1007;8;1162.00;18
2464;6;5690209;2464;285;3471;3486;7.28;0.45;253.47;3.03;1007;8;1163.00;15
2466;6;5690226;2466;289;3473;3486;7.34;0.45;253.47;3.04;1007;8;1164.00;13
2468;6;5690237;2468;290;3475;3486;7.36;0.45;253.41;3.04;1007;8;1165.00;11
2474;6;5690250;2474;293;3477;3486;7.34;0.45;253.72;3.05;1003;8;1166.00;9
2477;6;5690261;2477;295;3483;3490;7.36;0.45;253.85;3.06;1006;8;1167.00;7
2482;6;5690273;2482;297;3484;3490;7.39;0.46;254.23;3.06;1002;8;1168.00;6
2488;6;5690285;2488;295;3486;3490;7.34;0.45;254.45;3.06;998;8;1169.00;4
2492;6;5690299;2492;300;3490;3496;7.34;0.45;254.57;3.06;998;8;1170.00;6
2497;6;5690311;2497;306;3491;3496;7.29;0.45;254.91;3.07;994;8;1171.00;5
2500;6;5690323;2500;307;3493;3496;7.27;0.45;255.13;3.07;993;8;1172.00;3
2502;7;5690337;2502;311;3498;3500;7.28;0.45;255.22;3.07;996;9;1173.00;2
2507;7;5690356;2507;308;3500;3501;7.23;0.44;255.32;3.07;993;9;1174.00;1
2513;7;5690368;2513;312;3500;3501;7.18;0.44;255.45;3.07;987;9;1175.00;1
2519;7;5690379;2519;305;3505;3505;7.13;0.44;255.50;3.07;986;9;1176.00;0
2522;7;5690391;2522;311;3505;3505;7.12;0.44;255.63;3.07;983;9;1177.00;0
2526;7;5690402;2526;312;3505;3505;7.15;0.44;255.68;3.07;979;9;1178.00;0
2530;7;5690414;2530;315;3506;3506;7.17;0.44;255.99;3.07;976;9;1179.00;0
2536;7;5690425;2536;317;3506;3506;7.07;0.43;256.36;3.07;970;9;1180.00;0
2539;7;5690436;2539;312;3512;3512;7.09;0.43;256.49;3.07;973;9;1181.00;0
2545;7;5690449;2545;315;3512;3512;7.03;0.43;256.79;3.07;967;9;1182.00;0
2550;7;5690463;2550;317;3513;3513;6.92;0.42;256.74;3.06;963;9;1183.00;0
2554;7;5690474;2554;317;3513;3513;6.86;0.42;257.08;3.06;959;9;1184.00;0
2560;7;5690485;2560;320;3513;3513;6.82;0.42;257.37;3.06;953;9;1185.00;0
2564;7;5690496;2564;324;3513;3513;6.78;0.42;257.63;3.06;949;9;1186.00;0
2567;7;5690506;2567;336;3513;3513;6.81;0.42;257.63;3.06;946;9;1187.00;0
2574;7;5690516;2574;339;3524;3525;6.86;0.42;257.92;3.06;950;9;1188.00;1
2578;7;5690528;2578;336;3524;3525;6.88;0.42;257.90;3.06;946;9;1189.00;1
2584;7;5690538;2584;339;3525;3525;6.87;0.42;258.15;3.05;941;9;1190.00;0
2587;7;5690550;2587;335;3525;3525;6.88;0.42;258.26;3.05;938;9;1191.00;0
2590;7;5690561;2590;340;3525;3525;6.88;0.42;258.42;3.05;935;9;1192.00;0
2596;7;5690571;2596;346;3525;3525;6.88;0.42;258.66;3.05;929;9;1193.00;0
2599;7;5690582;2599;348;3529;3529;6.90;0.43;258.87;3.05;930;9;1194.00;0
2603;7;5690592;2603;353;3529;3529;6.91;0.43;259.00;3.05;926;9;1195.00;0
2609;7;5690603;2609;355;3533;3533;6.84;0.42;259.17;3.05;924;9;1196.00;0
2612;7;5690614;2612;362;3534;3534;6.73;0.41;259.28;3.05;922;9;1197.00;0
2615;7;5690625;2615;367;3534;3534;6.56;0.40;259.50;3.05;919;9;1198.00;0
2618;7;5690636;2618;383;3534;3534;6.39;0.39;259.77;3.05;916;9;1199.00;0
2621;7;5690648;2621;395;3561;3575;6.44;0.39;259.71;3.03;940;9;1200.00;14
2624;7;5690667;2624;403;3562;3575;6.29;0.39;260.00;3.03;938;9;1201.00;13
2626;7;5690677;2626;394;3565;3575;6.27;0.39;259.99;3.02;939;9;1202.00;10
2627;7;5690688;2627;394;3567;3576;6.22;0.38;260.02;3.02;940;9;1203.00;9
2630;7;5690698;2630;398;3568;3577;6.15;0.38;259.93;3.02;938;9;1204.00;9
2631;7;5690709;2631;388;3569;3577;6.12;0.38;260.02;3.02;938;9;1205.00;8
2634;7;5690720;2634;388;3572;3580;6.12;0.37;259.94;3.02;938;9;1206.00;8
2635;7;5690731;2635;390;3573;3580;6.11;0.37;259.89;3.02;938;9;1207.00;7
2636;7;5690741;2636;393;3574;3580;6.07;0.37;259.98;3.02;938;9;1208.00;6
2640;7;5690751;2640;393;3575;3580;6.04;0.37;259.99;3.03;935;9;1209.00;5
2641;7;5690762;2641;395;3581;3586;6.08;0.37;259.98;3.02;940;9;1210.00;5
2643;7;5690773;2643;384;3581;3586;6.10;0.37;260.14;3.02;938;9;1211.00;5
2647;7;5690783;2647;373;3582;3586;6.14;0.38;260.10;3.02;935;9;1212.00;4
2649;7;5690794;2649;377;3582;3586;6.23;0.38;260.23;3.02;933;9;1213.00;4
2652;7;5690804;2652;366;3586;3590;6.31;0.39;260.15;3.02;934;9;1214.00;4
2656;7;5690815;2656;359;3589;3592;6.38;0.39;260.22;3.02;933;9;1215.00;3
2658;7;5690827;2658;355;3589;3592;6.43;0.39;260.06;3.02;931;9;1216.00;3
2663;7;5690837;2663;352;3590;3593;6.46;0.39;260.26;3.02;927;9;1217.00;3
2664;7;5690848;2664;353;3590;3593;6.50;0.40;260.21;3.02;926;9;1218.00;3
2667;7;5690859;2667;354;3590;3593;6.54;0.40;259.99;3.02;923;9;1219.00;3
2667;7;5690870;2667;354;3591;3593;6.57;0.40;259.99;3.03;924;9;1220.00;2
2670;7;5690880;2670;360;3591;3593;6.54;0.40;259.85;3.03;921;9;1221.00;2
2670;7;5690890;2670;357;3591;3593;6.57;0.40;259.85;3.03;921;9;1222.00;2
2672;7;5690901;2672;357;3591;3593;6.57;0.40;259.74;3.03;919;9;1223.00;2
2675;7;5690911;2675;363;3632;3663;6.59;0.40;259.64;2.99;957;9;1224.00;31
2679;7;5690928;2679;362;3634;3664;6.60;0.40;259.62;3.00;955;9;1225.00;30
2679;7;5690939;2679;355;3641;3664;6.72;0.41;259.62;3.00;962;9;1226.00;23
2680;7;5690951;2680;348;3643;3664;6.73;0.41;259.53;3.00;963;9;1227.00;21
2682;7;5690962;2682;349;3645;3666;6.74;0.41;259.63;3.00;963;9;1228.00;21
2684;7;5690973;2684;345;3648;3666;6.76;0.41;259.74;3.00;964;9;1229.00;18
2684;7;5690986;2684;347;3649;3666;6.85;0.42;259.74;3.00;965;9;1230.00;17
2685;7;5690997;2685;353;3654;3666;6.93;0.42;259.65;3.01;969;9;1231.00;12
2686;7;5691007;2686;354;3657;3667;6.98;0.43;259.61;3.02;971;9;1232.00;10
2687;7;5691018;2687;354;3659;3668;6.98;0.43;259.54;3.02;972;9;1233.00;9
2689;7;5691029;2689;359;3662;3668;7.01;0.43;259.57;3.03;973;9;1234.00;6
2691;7;5691040;2691;363;3668;3672;7.03;0.43;259.64;3.03;977;9;1235.00;4
2694;7;5691051;2694;366;3669;3672;6.97;0.43;259.58;3.03;975;9;1236.00;3
2697;7;5691062;2697;368;3670;3672;6.94;0.42;259.57;3.03;973;9;1237.00;2
2697;7;5691072;2697;372;3670;3672;6.89;0.42;259.57;3.03;973;9;1238.00;2
2698;7;5691083;2698;376;3675;3678;6.84;0.42;259.61;3.02;977;9;1239.00;3
2700;7;5691094;2700;381;3675;3678;6.78;0.41;259.58;3.02;975;9;1240.00;3
2702;7;5691104;2702;388;3675;3678;6.74;0.41;259.60;3.02;973;9;1241.00;3
2705;7;5691115;2705;391;3677;3681;6.71;0.41;259.71;3.02;972;9;1242.00;4
2707;7;5691126;2707;376;3677;3681;6.64;0.40;259.71;3.02;970;9;1243.00;4
2708;7;5691137;2708;364;3678;3681;6.61;0.40;259.65;3.02;970;9;1244.00;3
2708;7;5691147;2708;349;3679;3682;6.57;0.40;259.65;3.02;971;9;1245.00;3
2710;7;5691158;2710;340;3680;3683;6.59;0.40;259.63;3.02;970;9;1246.00;3
2711;7;5691169;2711;332;3680;3683;6.62;0.40;259.55;3.02;969;9;1247.00;3
2713;7;5691180;2713;327;3691;3696;6.63;0.40;259.59;3.01;978;9;1248.00;5
2717;7;5691192;2717;311;3691;3696;6.66;0.40;259.55;3.01;974;9;1249.00;5
2720;7;5691209;2720;302;3691;3696;6.74;0.41;259.63;3.01;971;9;1250.00;5
2722;7;5691221;2722;295;3692;3697;6.85;0.41;259.70;3.01;970;9;1251.00;5
2723;7;5691232;2723;281;3694;3697;6.92;0.42;259.79;3.02;971;9;1252.00;3
2724;7;5691248;2724;279;3697;3701;7.10;0.43;259.70;3.02;973;9;1253.00;4
2725;7;5691260;2725;266;3697;3701;7.16;0.43;259.70;3.02;972;9;1254.00;4
2728;7;5691270;2728;262;3701;3705;7.15;0.43;259.73;3.01;973;9;1255.00;4
2729;7;5691282;2729;254;3701;3705;7.22;0.44;259.85;3.01;972;9;1256.00;4
2731;7;5691292;2731;246;3701;3705;7.27;0.44;259.85;3.01;970;9;1257.00;4
2733;7;5691303;2733;242;3701;3705;7.28;0.44;260.03;3.01;968;9;1258.00;4
2736;7;5691314;2736;240;3701;3705;7.29;0.44;260.02;3.01;965;9;1259.00;4
2737;7;5691327;2737;239;3725;3739;7.35;0.45;260.14;3.00;988;9;1260.00;14
2741;7;5691340;2741;235;3726;3739;7.36;0.45;260.06;2.99;985;9;1261.00;13
2744;7;5691352;2744;230;3728;3739;7.36;0.45;260.12;2.99;984;9;1262.00;11
2746;7;5691363;2746;233;3730;3739;7.43;0.45;260.05;3.01;984;9;1263.00;9
2748;7;5691373;2748;231;3732;3739;7.48;0.45;260.30;3.01;984;9;1264.00;7
2750;7;5691384;2750;225;3732;3739;7.54;0.46;260.62;3.01;982;9;1265.00;7
2753;7;5691400;2753;220;3733;3740;7.54;0.46;260.61;3.01;980;9;1266.00;7
2755;7;5691412;2755;225;3734;3740;7.55;0.46;260.65;3.01;979;9;1267.00;6
2756;8;5691422;2756;221;3739;3746;7.63;0.46;260.60;3.02;983;10;1268.00;7
2758;8;5691444;2758;215;3740;3747;7.62;0.46;260.45;3.01;982;10;1269.00;7
2761;8;5691456;2761;215;3741;3747;7.59;0.46;260.43;3.02;980;10;1270.00;6
2764;8;5691467;2764;218;3742;3747;7.56;0.46;260.48;3.02;978;10;1271.00;5
2765;9;5691477;2765;220;3745;3751;7.59;0.46;260.43;3.02;980;11;1272.00;6
2770;9;5691508;2770;211;3747;3751;7.55;0.46;260.63;3.02;977;11;1273.00;4
2772;9;5691520;2772;216;3747;3751;7.55;0.46;260.74;3.02;975;11;1274.00;4
2772;9;5691532;2772;217;3748;3752;7.63;0.46;260.74;3.02;976;11;1275.00;4
2774;9;5691544;2774;217;3752;3756;7.70;0.47;260.89;3.02;978;11;1276.00;4
2776;9;5691556;2776;218;3752;3756;7.70;0.47;260.96;3.02;976;11;1277.00;4
2776;9;5691567;2776;220;3754;3759;7.80;0.47;260.96;3.02;978;11;1278.00;5
2777;9;5691578;2777;218;3755;3759;7.80;0.47;261.11;3.02;978;11;1279.00;4
2780;9;5691589;2780;215;3756;3759;7.80;0.47;261.27;3.02;976;11;1280.00;3
2785;9;5691601;2785;220;3756;3759;7.82;0.47;261.25;3.02;971;11;1281.00;3
2787;9;5691613;2787;219;3760;3763;7.87;0.48;261.38;3.02;973;11;1282.00;3
2788;9;5691625;2788;213;3760;3763;7.90;0.48;261.56;3.02;972;11;1283.00;3
2788;9;5691636;2788;219;3761;3763;7.93;0.48;261.56;3.02;973;11;1284.00;2
2789;9;5691647;2789;219;3762;3763;7.92;0.48;261.58;3.03;973;11;1285.00;1
2790;9;5691658;2790;221;3762;3764;7.92;0.48;261.56;3.03;972;11;1286.00;2
2794;9;5691670;2794;224;3763;3765;7.90;0.48;261.77;3.03;969;11;1287.00;2
2795;9;5691681;2795;228;3764;3765;7.86;0.48;261.93;3.03;969;11;1288.00;1
2795;9;5691692;2795;226;3765;3766;7.86;0.48;261.93;3.03;970;11;1289.00;1
2798;9;5691704;2798;226;3765;3766;7.77;0.47;261.94;3.03;967;11;1290.00;1
2800;9;5691716;2800;232;3766;3766;7.67;0.47;262.02;3.03;966;11;1291.00;0
2801;9;5691726;2801;233;3766;3766;7.62;0.46;262.13;3.03;965;11;1292.00;0
2803;9;5691737;2803;240;3766;3766;7.60;0.46;262.16;3.03;963;11;1293.00;0
2806;9;5691747;2806;243;3766;3766;7.56;0.46;262.49;3.03;960;11;1294.00;0
2810;9;5691758;2810;242;3766;3766;7.51;0.46;262.82;3.03;956;11;1295.00;0
2812;9;5691768;2812;269;3841;3893;7.69;0.47;262.97;2.97;1029;11;1296.00;52
2816;9;5691787;2816;263;3846;3894;7.74;0.48;263.38;2.97;1030;11;1297.00;48
2817;9;5691799;2817;253;3855;3894;7.76;0.48;263.56;2.97;1038;11;1298.00;39
2823;9;5691810;2823;255;3857;3894;7.75;0.48;263.76;2.97;1034;11;1299.00;37
2825;9;5691821;2825;252;3862;3894;7.78;0.48;263.74;2.97;1037;11;1300.00;32
2828;9;5691838;2828;249;3862;3894;7.72;0.48;263.82;2.97;1034;11;1301.00;32
2831;9;5691850;2831;254;3866;3894;7.66;0.47;263.99;2.97;1035;11;1302.00;28
2833;9;5691861;2833;258;3867;3894;7.64;0.47;264.10;2.97;1034;11;1303.00;27
2836;9;5691873;2836;258;3870;3895;7.58;0.46;264.12;2.98;1034;11;1304.00;25
2841;9;5691890;2841;262;3876;3897;7.52;0.46;264.30;2.98;1035;11;1305.00;21
2843;9;5691901;2843;253;3878;3897;7.51;0.46;264.58;2.99;1035;11;1306.00;19
2846;9;5691913;2846;250;3881;3898;7.47;0.46;264.54;2.99;1035;11;1307.00;17
2849;9;5691924;2849;253;3885;3898;7.47;0.46;264.58;3.00;1036;11;1308.00;13
2854;9;5691935;2854;252;3887;3898;7.44;0.46;264.84;3.00;1033;11;1309.00;11
2856;9;5691950;2856;257;3888;3898;7.44;0.46;264.98;3.01;1032;11;1310.00;10
2860;9;5691961;2860;263;3893;3902;7.41;0.45;264.97;3.01;1033;11;1311.00;9
2863;9;5691973;2863;267;3894;3902;7.39;0.45;265.01;3.02;1031;11;1312.00;8
2864;9;5691984;2864;272;3896;3902;7.35;0.45;264.98;3.02;1032;11;1313.00;6
2866;9;5691996;2866;281;3899;3905;7.30;0.45;264.97;3.02;1033;11;1314.00;6
2867;9;5692007;2867;286;3900;3905;7.20;0.44;265.03;3.03;1033;11;1315.00;5
2868;9;5692018;2868;295;3901;3905;7.12;0.44;265.05;3.03;1033;11;1316.00;4
2873;9;5692029;2873;300;3905;3909;6.97;0.43;265.36;3.03;1032;11;1317.00;4
2879;9;5692040;2879;296;3907;3910;6.86;0.42;265.71;3.03;1028;11;1318.00;3
2883;9;5692051;2883;302;3908;3910;6.72;0.41;265.89;3.04;1025;11;1319.00;2
2885;9;5692064;2885;295;3913;3915;6.71;0.41;265.97;3.03;1028;11;1320.00;2
2892;9;5692075;2892;287;3913;3915;6.63;0.41;266.23;3.03;1021;11;1321.00;2
2896;9;5692086;2896;282;3915;3915;6.59;0.40;266.21;3.04;1019;11;1322.00;0
2899;9;5692096;2899;282;3915;3916;6.60;0.40;266.47;3.04;1016;11;1323.00;1
2903;9;5692106;2903;282;3915;3916;6.58;0.40;266.59;3.04;1012;11;1324.00;1
2905;9;5692117;2905;282;3921;3922;6.62;0.40;266.78;3.03;1016;11;1325.00;1
2912;9;5692129;2912;284;3921;3922;6.60;0.40;266.81;3.03;1009;11;1326.00;1
2914;9;5692140;2914;282;3923;3923;6.62;0.40;266.92;3.03;1009;11;1327.00;0
2917;9;5692152;2917;277;3923;3923;6.59;0.40;267.08;3.03;1006;11;1328.00;0
2921;9;5692163;2921;275;3923;3923;6.54;0.40;267.38;3.03;1002;11;1329.00;0
2923;9;5692174;2923;272;3923;3923;6.50;0.40;267.33;3.03;1000;11;1330.00;0
2927;9;5692185;2927;275;3923;3923;6.44;0.39;267.60;3.03;996;11;1331.00;0
2930;9;5692195;2930;275;3935;3935;6.46;0.39;267.86;3.02;1005;11;1332.00;0
2935;9;5692207;2935;283;3935;3935;6.42;0.39;267.89;3.02;1000;11;1333.00;0
2938;9;5692217;2938;293;3935;3935;6.44;0.39;268.08;3.02;997;11;1334.00;0
2941;9;5692229;2941;298;3935;3935;6.42;0.39;267.98;3.02;994;11;1335.00;0
2945;9;5692239;2945;299;3935;3935;6.37;0.39;267.92;3.02;990;11;1336.00;0
2950;9;5692250;2950;304;3935;3935;6.32;0.39;267.99;3.02;985;11;1337.00;0
2952;9;5692260;2952;315;3939;3939;6.31;0.39;268.04;3.02;987;11;1338.00;0
2954;9;5692271;2954;324;3939;3939;6.32;0.39;268.18;3.02;985;11;1339.00;0
2959;9;5692281;2959;322;3943;3943;6.32;0.39;268.05;3.02;984;11;1340.00;0
2965;9;5692294;2965;318;3944;3944;6.26;0.38;268.08;3.02;979;11;1341.00;0
2968;9;5692306;2968;324;3944;3944;6.25;0.38;268.31;3.02;976;11;1342.00;0
2973;9;5692317;2973;328;3944;3944;6.24;0.38;268.42;3.02;971;11;1343.00;0
2976;9;5692327;2976;342;3957;3957;6.27;0.38;268.45;3.01;981;11;1344.00;0
2979;9;5692339;2979;340;3957;3957;6.26;0.38;268.51;3.01;978;11;1345.00;0
2983;9;5692350;2983;351;3957;3957;6.26;0.38;268.57;3.01;974;11;1346.00;0
2986;9;5692360;2986;353;3958;3958;6.25;0.38;268.75;3.01;972;11;1347.00;0
2991;9;5692371;2991;353;3959;3959;6.26;0.38;268.82;3.01;968;11;1348.00;0
2994;9;5692381;2994;352;3959;3959;6.30;0.38;269.13;3.01;965;11;1349.00;0
2998;9;5692394;2998;366;3965;3968;6.34;0.39;269.17;3.00;967;11;1350.00;3
3005;9;5692409;3005;369;3965;3968;6.28;0.38;269.21;3.00;960;11;1351.00;3
3008;9;5692423;3008;379;3967;3968;6.25;0.38;269.31;3.00;959;11;1352.00;1
3012;9;5692435;3012;387;3968;3968;6.19;0.38;269.39;3.00;956;11;1353.00;0
3016;9;5692446;3016;391;3972;3974;6.10;0.37;269.47;3.00;956;11;1354.00;2
3021;9;5692456;3021;394;3974;3974;6.01;0.36;269.69;3.00;953;11;1355.00;0
3023;9;5692468;3023;400;3974;3974;5.93;0.36;269.79;3.00;951;11;1356.00;0
3028;9;5692479;3028;403;3974;3974;5.75;0.35;270.16;3.00;946;11;1357.00;0
3031;9;5692490;3031;407;3978;3978;5.68;0.34;270.42;3.00;947;11;1358.00;0
3035;9;5692501;3035;413;3979;3979;5.56;0.34;270.48;3.00;944;11;1359.00;0
3037;9;5692511;3037;416;3979;3979;5.51;0.33;270.55;3.00;942;11;1360.00;0
3037;9;5692521;3037;422;3980;3980;5.49;0.33;270.55;3.00;943;11;1361.00;0
3041;9;5692530;3041;424;3980;3980;5.43;0.33;270.61;3.00;939;11;1362.00;0
3043;9;5692540;3043;423;3980;3980;5.37;0.33;270.61;3.00;937;11;1363.00;0
3048;9;5692550;3048;428;3980;3980;5.28;0.32;270.43;3.00;932;11;1364.00;0
3055;9;5692560;3055;428;3980;3980;5.15;0.31;270.43;3.00;925;11;1365.00;0
3055;9;5692569;3055;437;3980;3980;5.19;0.32;270.43;3.00;925;11;1366.00;0
3058;9;5692578;3058;434;3980;3980;5.24;0.32;270.53;3.00;922;11;1367.00;0
3061;9;5692588;3061;435;4022;4050;5.52;0.34;270.82;2.97;961;11;1368.00;28
3064;9;5692603;3064;426;4024;4051;5.57;0.34;270.78;2.96;960;11;1369.00;27
3067;9;5692613;3067;421;4031;4051;5.64;0.35;270.94;2.96;964;11;1370.00;20
3067;9;5692623;3067;416;4032;4051;5.75;0.35;270.94;2.96;965;11;1371.00;19
3070;9;5692633;3070;415;4034;4051;5.81;0.36;270.81;2.96;964;11;1372.00;17
3073;9;5692644;3073;417;4035;4051;5.89;0.36;270.78;2.96;962;11;1373.00;16
3075;9;5692655;3075;419;4037;4051;5.95;0.36;270.71;2.97;962;11;1374.00;14
3076;9;5692669;3076;417;4039;4051;6.01;0.37;270.78;2.97;963;11;1375.00;12
3080;9;5692680;3080;405;4039;4052;6.00;0.37;271.06;2.97;959;11;1376.00;13
3080;9;5692692;3080;396;4042;4053;6.09;0.37;271.06;2.97;962;11;1377.00;11
3081;9;5692709;3081;399;4043;4053;6.12;0.37;271.13;2.97;962;11;1378.00;10
3086;9;5692720;3086;397;4050;4057;6.13;0.37;271.30;2.98;964;11;1379.00;7
3090;9;5692733;3090;397;4053;4057;6.17;0.38;271.47;2.98;963;11;1380.00;4
3095;9;5692744;3095;394;4053;4057;6.16;0.37;271.50;2.98;958;11;1381.00;4
3098;9;5692761;3098;400;4054;4057;6.13;0.37;271.46;2.98;956;11;1382.00;3
3098;9;5692771;3098;403;4061;4063;6.21;0.38;271.46;2.99;963;11;1383.00;2
3099;9;5692782;3099;406;4063;4063;6.23;0.38;271.40;2.99;964;11;1384.00;0
3100;9;5692794;3100;408;4063;4063;6.29;0.38;271.52;2.99;963;11;1385.00;0
3102;9;5692808;3102;412;4065;4066;6.34;0.38;271.48;2.99;963;11;1386.00;1
3102;9;5692820;3102;406;4065;4066;6.39;0.39;271.48;2.99;963;11;1387.00;1
3102;9;5692831;3102;411;4066;4066;6.44;0.39;271.48;2.99;964;11;1388.00;0
3102;9;5692842;3102;411;4067;4067;6.47;0.39;271.48;2.99;965;11;1389.00;0
3102;9;5692854;3102;402;4068;4068;6.55;0.40;271.48;2.99;966;11;1390.00;0
3103;9;5692865;3103;389;4068;4068;6.56;0.40;271.40;2.99;965;11;1391.00;0
3107;9;5692876;3107;387;4081;4081;6.63;0.40;271.35;2.98;974;11;1392.00;0
3108;9;5692889;3108;377;4081;4081;6.67;0.41;271.27;2.98;973;11;1393.00;0
3110;9;5692900;3110;368;4081;4081;6.73;0.41;271.20;2.98;971;11;1394.00;0
3113;9;5692912;3113;364;4083;4083;6.81;0.41;271.18;2.98;970;11;1395.00;0
3115;9;5692923;3115;363;4083;4083;6.87;0.42;271.16;2.98;968;11;1396.00;0
3117;9;5692943;3117;360;4087;4087;6.89;0.42;271.18;2.97;970;11;1397.00;0
3118;9;5692955;3118;361;4087;4087;6.88;0.42;271.10;2.97;969;11;1398.00;0
3119;9;5692966;3119;355;4091;4091;6.86;0.42;271.14;2.97;972;11;1399.00;0
3121;9;5692978;3121;357;4091;4091;6.84;0.42;271.11;2.97;970;11;1400.00;0
3123;9;5692997;3123;351;4091;4091;6.86;0.42;271.16;2.97;968;11;1401.00;0
3125;9;5693008;3125;347;4091;4091;6.86;0.42;271.06;2.97;966;11;1402.00;0
3128;9;5693019;3128;349;4091;4091;6.84;0.42;271.12;2.97;963;11;1403.00;0
3128;9;5693030;3128;351;4102;4103;6.91;0.42;271.12;2.96;974;11;1404.00;1
3130;9;5693041;3130;351;4102;4103;6.87;0.42;271.15;2.96;972;11;1405.00;1
3130;9;5693052;3130;356;4103;4103;6.91;0.42;271.15;2.96;973;11;1406.00;0
3131;9;5693065;3131;362;4103;4103;6.94;0.42;271.16;2.96;972;11;1407.00;0
3133;9;5693076;3133;354;4103;4103;6.97;0.42;271.15;2.96;970;11;1408.00;0
3135;9;5693087;3135;356;4103;4103;6.99;0.43;271.10;2.96;968;11;1409.00;0
3137;9;5693100;3137;350;4104;4104;7.03;0.43;271.12;2.96;967;11;1410.00;0
3140;9;5693111;3140;343;4104;4104;7.04;0.43;271.20;2.96;964;11;1411.00;0
3145;9;5693127;3145;340;4110;4110;7.05;0.43;271.48;2.96;965;11;1412.00;0
3149;9;5693138;3149;330;4111;4111;7.02;0.43;271.68;2.96;962;11;1413.00;0
3150;9;5693150;3150;321;4111;4111;7.03;0.43;271.74;2.96;961;11;1414.00;0
3153;9;5693160;3153;314;4111;4111;7.05;0.43;271.96;2.96;958;11;1415.00;0
3156;9;5693171;3156;314;4115;4115;7.09;0.43;272.10;2.96;959;11;1416.00;0
3160;9;5693182;3160;307;4115;4115;7.11;0.43;272.31;2.96;955;11;1417.00;0
3162;9;5693198;3162;302;4115;4115;7.17;0.43;272.51;2.96;953;11;1418.00;0
3164;9;5693209;3164;300;4116;4116;7.21;0.44;272.59;2.96;952;11;1419.00;0
3168;9;5693220;3168;290;4120;4120;7.21;0.44;272.69;2.95;952;11;1420.00;0
3174;9;5693231;3174;283;4120;4120;7.24;0.44;272.75;2.95;946;11;1421.00;0
3178;9;5693241;3178;281;4122;4123;7.27;0.44;272.96;2.95;944;11;1422.00;1
3181;9;5693252;3181;286;4123;4123;7.35;0.44;273.22;2.95;942;11;1423.00;0
3188;10;5693262;3188;280;4123;4123;7.40;0.45;273.34;2.95;935;12;1424.00;0
3194;10;5693282;3194;280;4123;4123;7.41;0.45;273.50;2.95;929;12;1425.00;0
3198;10;5693293;3198;270;4127;4127;7.45;0.45;273.67;2.95;929;12;1426.00;0
3202;10;5693305;3202;262;4127;4127;7.43;0.45;273.71;2.95;925;12;1427.00;0
3204;10;5693317;3204;259;4127;4127;7.42;0.45;273.68;2.95;923;12;1428.00;0
3205;10;5693327;3205;260;4127;4127;7.39;0.45;273.75;2.95;922;12;1429.00;0
3209;10;5693337;3209;264;4128;4128;7.36;0.45;273.78;2.95;919;12;1430.00;0
3210;10;5693348;3210;261;4129;4129;7.40;0.45;273.78;2.95;919;12;1431.00;0
3210;10;5693358;3210;262;4129;4129;7.44;0.45;273.78;2.95;919;12;1432.00;0
3213;10;5693368;3213;261;4130;4130;7.49;0.45;273.70;2.95;917;12;1433.00;0
3213;10;5693378;3213;260;4130;4130;7.57;0.46;273.70;2.95;917;12;1434.00;0
3214;10;5693389;3214;255;4130;4130;7.65;0.46;273.83;2.95;916;12;1435.00;0
3218;10;5693399;3218;255;4130;4130;7.64;0.46;273.73;2.95;912;12;1436.00;0
3218;10;5693409;3218;256;4130;4130;7.72;0.47;273.73;2.95;912;12;1437.00;0
3223;10;5693420;3223;256;4130;4130;7.72;0.47;273.95;2.95;907;12;1438.00;0
3225;10;5693430;3225;251;4130;4130;7.69;0.46;274.06;2.95;905;12;1439.00;0
3226;10;5693441;3226;288;4239;4360;7.76;0.48;274.07;2.87;1013;12;1440.00;121
3230;10;5693469;3230;279;4244;4361;7.74;0.48;274.14;2.87;1014;12;1441.00;117
3231;10;5693481;3231;267;4256;4361;7.83;0.49;274.11;2.87;1025;12;1442.00;105
3233;10;5693492;3233;263;4263;4361;7.83;0.49;274.22;2.87;1030;12;1443.00;98
3237;10;5693502;3237;255;4270;4361;7.80;0.48;274.21;2.87;1033;12;1444.00;91
3238;10;5693519;3238;248;4276;4361;7.80;0.48;274.18;2.87;1038;12;1445.00;85
3240;10;5693530;3240;244;4282;4361;7.85;0.49;274.28;2.88;1042;12;1446.00;79
3240;10;5693542;3240;245;4288;4361;7.90;0.49;274.28;2.88;1048;12;1447.00;73
3244;10;5693553;3244;249;4296;4362;7.93;0.49;274.33;2.89;1052;12;1448.00;66
3246;10;5693565;3246;253;4301;4363;7.93;0.49;274.43;2.90;1055;12;1449.00;62
3247;10;5693578;3247;246;4308;4363;7.91;0.49;274.46;2.91;1061;12;1450.00;55
3252;10;5693591;3252;256;4311;4364;7.87;0.49;274.52;2.92;1059;12;1451.00;53
3252;10;5693604;3252;256;4318;4364;7.80;0.48;274.52;2.93;1066;12;1452.00;46
3254;10;5693617;3254;254;4323;4364;7.74;0.48;274.52;2.94;1069;12;1453.00;41
3255;10;5693630;3255;258;4326;4364;7.70;0.48;274.64;2.95;1071;12;1454.00;38
3257;10;5693642;3257;264;4333;4368;7.66;0.47;274.68;2.97;1076;12;1455.00;35
3259;10;5693654;3259;272;4337;4368;7.63;0.47;274.82;2.98;1078;12;1456.00;31
3262;10;5693666;3262;272;4339;4368;7.61;0.47;274.97;2.98;1077;12;1457.00;29
3264;10;5693677;3264;277;4344;4371;7.61;0.47;275.03;2.99;1080;12;1458.00;27
3267;10;5693692;3267;283;4347;4371;7.61;0.47;275.11;3.00;1080;12;1459.00;24
3271;10;5693704;3271;293;4352;4371;7.55;0.46;275.15;3.02;1081;12;1460.00;19
3273;10;5693717;3273;300;4357;4375;7.57;0.46;275.33;3.02;1084;12;1461.00;18
3278;10;5693730;3278;308;4361;4376;7.51;0.46;275.54;3.03;1083;12;1462.00;15
3282;10;5693743;3282;321;4363;4376;7.45;0.46;275.66;3.04;1081;12;1463.00;13
3284;10;5693756;3284;321;4366;4380;7.47;0.46;275.79;3.04;1082;12;1464.00;14
3286;10;5693770;3286;331;4367;4380;7.48;0.46;275.89;3.04;1081;12;1465.00;13
3291;10;5693783;3291;339;4369;4380;7.41;0.45;276.19;3.05;1078;12;1466.00;11
3295;10;5693796;3295;341;4370;4381;7.35;0.45;276.17;3.05;1075;12;1467.00;11
3299;10;5693809;3299;345;4371;4381;7.28;0.44;276.36;3.06;1072;12;1468.00;10
3302;10;5693827;3302;339;4376;4387;7.21;0.44;276.48;3.05;1074;12;1469.00;11
3303;10;5693841;3303;337;4376;4387;7.13;0.44;276.49;3.05;1073;12;1470.00;11
3304;10;5693853;3304;341;4380;4388;7.13;0.44;276.54;3.07;1076;12;1471.00;8
3306;10;5693866;3306;340;4381;4388;7.07;0.43;276.65;3.08;1075;12;1472.00;7
3309;10;5693878;3309;339;4381;4388;7.07;0.43;276.56;3.08;1072;12;1473.00;7
3312;10;5693890;3312;340;4383;4388;7.12;0.43;276.79;3.08;1071;12;1474.00;5
3314;10;5693902;3314;342;4384;4388;7.08;0.43;276.71;3.08;1070;12;1475.00;4
3318;10;5693913;3318;342;4395;4400;7.06;0.43;276.80;3.07;1077;12;1476.00;5
3321;10;5693926;3321;345;4395;4400;7.06;0.43;276.89;3.07;1074;13;1477.00;5
3322;10;5693945;3322;350;4396;4400;7.03;0.43;276.92;3.07;1074;13;1478.00;4
3325;10;5693956;3325;350;4396;4400;6.95;0.42;276.93;3.07;1071;13;1479.00;4
3326;10;5693968;3326;352;4396;4400;6.95;0.43;277.09;3.07;1070;13;1480.00;4
3331;10;5693978;3331;357;4396;4400;6.87;0.42;277.28;3.07;1065;13;1481.00;4
3333;10;5693990;3333;367;4400;4404;6.74;0.41;277.33;3.07;1067;13;1482.00;4
3337;10;5694000;3337;371;4400;4404;6.64;0.41;277.47;3.07;1063;13;1483.00;4
3343;10;5694011;3343;376;4404;4408;6.54;0.40;277.67;3.07;1061;13;1484.00;4
3347;10;5694022;3347;368;4405;4410;6.45;0.40;277.62;3.07;1058;13;1485.00;5
3352;10;5694033;3352;364;4406;4410;6.35;0.39;277.71;3.07;1054;13;1486.00;4
3357;10;5694043;3357;363;4406;4410;6.33;0.39;277.62;3.07;1049;13;1487.00;4
3360;10;5694054;3360;367;4419;4423;6.33;0.39;277.69;3.06;1059;13;1488.00;4
3364;10;5694066;3364;372;4419;4423;6.29;0.39;277.77;3.06;1055;13;1489.00;4
3366;10;5694078;3366;378;4419;4423;6.31;0.39;277.84;3.06;1053;13;1490.00;4
3370;10;5694088;3370;377;4420;4424;6.30;0.39;278.16;3.06;1050;13;1491.00;4
3373;10;5694100;3373;378;4421;4425;6.29;0.39;278.18;3.06;1048;13;1492.00;4
3378;10;5694112;3378;373;4421;4425;6.27;0.39;278.35;3.06;1043;13;1493.00;4
3380;10;5694123;3380;372;4424;4428;6.34;0.39;278.40;3.06;1044;13;1494.00;4
3385;10;5694134;3385;367;4424;4428;6.28;0.39;278.52;3.06;1039;13;1495.00;4
3388;10;5694145;3388;359;4425;4428;6.21;0.38;278.47;3.07;1037;13;1496.00;3
3394;10;5694160;3394;361;4425;4428;6.15;0.38;278.55;3.07;1031;13;1497.00;3
3398;10;5694172;3398;355;4431;4434;6.13;0.38;278.54;3.07;1033;14;1498.00;3
3402;10;5694191;3402;364;4431;4434;6.02;0.37;278.52;3.07;1029;14;1499.00;3
3403;10;5694205;3403;374;4436;4453;5.98;0.37;278.47;3.06;1033;14;1500.00;17
3408;10;5694223;3408;377;4436;4453;5.89;0.37;278.62;3.06;1028;14;1501.00;17
3410;10;5694233;3410;375;4441;4457;5.85;0.36;278.59;3.06;1031;14;1502.00;16
3415;10;5694244;3415;388;4442;4458;5.80;0.36;278.56;3.06;1027;14;1503.00;16
3419;10;5694255;3419;387;4442;4458;5.78;0.36;278.54;3.06;1023;14;1504.00;16
3424;10;5694266;3424;395;4445;4459;5.72;0.35;278.51;3.06;1021;14;1505.00;14
3427;10;5694277;3427;396;4446;4459;5.73;0.35;278.39;3.06;1019;14;1506.00;13
3433;10;5694288;3433;396;4446;4459;5.70;0.35;278.56;3.06;1013;14;1507.00;13
3438;10;5694299;3438;398;4446;4459;5.65;0.35;278.59;3.06;1008;14;1508.00;13
3438;10;5694309;3438;398;4446;4459;5.63;0.35;278.59;3.06;1008;14;1509.00;13
3446;10;5694320;3446;399;4447;4459;5.57;0.34;278.60;3.06;1001;14;1510.00;12
3452;10;5694330;3452;401;4448;4459;5.47;0.34;278.39;3.06;996;14;1511.00;11
3458;10;5694341;3458;406;4489;4529;5.57;0.35;278.43;3.05;1031;14;1512.00;40
3460;10;5694357;3460;410;4491;4530;5.60;0.35;278.54;3.05;1031;14;1513.00;39
3466;10;5694369;3466;413;4497;4530;5.65;0.35;278.38;3.05;1031;14;1514.00;33
3467;10;5694380;3467;412;4501;4530;5.71;0.35;278.33;3.05;1034;14;1515.00;29
3470;10;5694390;3470;425;4506;4530;5.67;0.35;278.35;3.06;1036;14;1516.00;24
3473;10;5694401;3473;427;4507;4530;5.66;0.35;278.26;3.06;1034;14;1517.00;23
3479;10;5694411;3479;426;4510;4530;5.60;0.35;278.17;3.06;1031;14;1518.00;20
3484;10;5694422;3484;431;4512;4530;5.58;0.34;278.33;3.06;1028;14;1519.00;18
3487;10;5694432;3487;437;4514;4531;5.55;0.34;278.44;3.06;1027;14;1520.00;17
3490;10;5694443;3490;437;4516;4532;5.45;0.34;278.38;3.07;1026;14;1521.00;16
3493;10;5694453;3493;439;4521;4532;5.38;0.33;278.26;3.08;1028;14;1522.00;11
3495;10;5694464;3495;443;4525;4536;5.38;0.33;278.34;3.07;1030;14;1523.00;11
3499;10;5694476;3499;453;4526;4536;5.34;0.33;278.32;3.07;1027;14;1524.00;10
3503;10;5694486;3503;456;4526;4536;5.29;0.33;278.19;3.07;1023;14;1525.00;10
3506;10;5694497;3506;458;4526;4536;5.29;0.33;278.23;3.07;1020;14;1526.00;10
3510;10;5694507;3510;466;4532;4542;5.26;0.32;278.22;3.09;1022;14;1527.00;10
3513;10;5694518;3513;473;4534;4542;5.23;0.32;278.13;3.10;1021;14;1528.00;8
3517;10;5694528;3517;474;4534;4542;5.20;0.32;278.02;3.10;1017;14;1529.00;8
3520;10;5694542;3520;480;4538;4548;5.26;0.32;278.13;3.10;1018;14;1530.00;10
3522;10;5694552;3522;489;4539;4548;5.25;0.32;278.12;3.10;1017;14;1531.00;9
3526;10;5694563;3526;476;4539;4548;5.25;0.32;278.18;3.10;1013;14;1532.00;9
3528;10;5694574;3528;471;4541;4549;5.25;0.32;278.32;3.11;1013;14;1533.00;8
3529;10;5694585;3529;470;4544;4550;5.30;0.33;278.35;3.11;1015;14;1534.00;6
3532;10;5694597;3532;471;4544;4550;5.29;0.32;278.48;3.11;1012;14;1535.00;6
3532;10;5694608;3532;477;4559;4563;5.44;0.33;278.48;3.13;1027;14;1536.00;4
3533;10;5694619;3533;453;4559;4563;5.50;0.34;278.50;3.13;1026;14;1537.00;4
3535;10;5694631;3535;444;4559;4563;5.50;0.34;278.56;3.13;1024;14;1538.00;4
3537;10;5694642;3537;436;4560;4564;5.52;0.34;278.48;3.13;1023;14;1539.00;4
3542;10;5694653;3542;434;4562;4564;5.51;0.34;278.51;3.14;1020;14;1540.00;2
3547;10;5694664;3547;424;4566;4568;5.55;0.34;278.37;3.14;1019;14;1541.00;2
3550;10;5694676;3550;411;4567;4568;5.58;0.34;278.39;3.14;1017;14;1542.00;1
3550;10;5694694;3550;395;4571;4572;5.66;0.34;278.39;3.14;1021;14;1543.00;1
3552;10;5694711;3552;375;4571;4572;5.78;0.35;278.36;3.14;1019;14;1544.00;1
3554;10;5694723;3554;365;4571;4572;5.86;0.36;278.25;3.14;1017;14;1545.00;1
3557;10;5694735;3557;362;4571;4572;5.90;0.36;278.32;3.14;1014;14;1546.00;1
3558;10;5694747;3558;356;4571;4572;6.00;0.36;278.32;3.14;1013;14;1547.00;1
3558;10;5694758;3558;342;4582;4584;6.16;0.37;278.32;3.13;1024;14;1548.00;2
3558;10;5694771;3558;348;4582;4584;6.29;0.38;278.32;3.13;1024;14;1549.00;2
3559;10;5694783;3559;347;4583;4584;6.40;0.39;278.34;3.13;1024;14;1550.00;1
3559;10;5694795;3559;345;4584;4584;6.52;0.40;278.34;3.14;1025;14;1551.00;0
3559;10;5694807;3559;340;4584;4584;6.59;0.40;278.34;3.14;1025;14;1552.00;0
3561;10;5694819;3561;336;4584;4584;6.60;0.40;278.27;3.14;1023;14;1553.00;0
3562;10;5694831;3562;330;4585;4585;6.64;0.40;278.30;3.14;1023;14;1554.00;0
3563;10;5694843;3563;326;4587;4587;6.74;0.41;278.31;3.14;1024;14;1555.00;0
3564;10;5694856;3564;327;4593;4593;6.83;0.42;278.31;3.13;1029;14;1556.00;0
3565;10;5694869;3565;324;4594;4594;6.90;0.42;278.26;3.13;1029;14;1557.00;0
3568;10;5694881;3568;325;4594;4594;6.95;0.42;278.20;3.13;1026;14;1558.00;0
3570;10;5694893;3570;313;4594;4594;6.96;0.42;278.37;3.13;1024;14;1559.00;0
3574;10;5694907;3574;313;4599;4599;6.93;0.42;278.55;3.13;1025;15;1560.00;0
3576;10;5694928;3576;310;4599;4599;6.95;0.42;278.72;3.13;1023;15;1561.00;0
3578;10;5694939;3578;305;4599;4599;7.05;0.43;278.65;3.13;1021;15;1562.00;0
3580;10;5694951;3580;305;4600;4600;7.16;0.43;278.65;3.13;1020;15;1563.00;0
3583;10;5694963;3583;311;4604;4604;7.25;0.44;278.76;3.13;1021;15;1564.00;0
3588;10;5694976;3588;310;4604;4604;7.30;0.44;279.03;3.13;1016;15;1565.00;0
3592;10;5694989;3592;311;4606;4607;7.32;0.44;279.03;3.13;1014;15;1566.00;1
3595;10;5695000;3595;317;4606;4607;7.32;0.44;279.31;3.13;1011;15;1567.00;1
3597;10;5695013;3597;311;4607;4607;7.30;0.44;279.29;3.12;1010;15;1568.00;0
3598;10;5695025;3598;319;4607;4607;7.27;0.44;279.39;3.12;1009;15;1569.00;0
3603;10;5695042;3603;324;4611;4611;7.23;0.44;279.47;3.12;1008;15;1570.00;0
3604;10;5695060;3604;330;4611;4611;7.15;0.43;279.59;3.12;1007;15;1571.00;0
3606;10;5695071;3606;333;4611;4611;7.16;0.43;279.56;3.12;1005;15;1572.00;0
3610;10;5695083;3610;338;4611;4611;7.10;0.43;279.76;3.12;1001;15;1573.00;0
3613;10;5695094;3613;337;4612;4612;7.08;0.43;279.91;3.12;999;15;1574.00;0
3614;10;5695106;3614;336;4614;4614;7.03;0.43;279.87;3.12;1000;15;1575.00;0
3618;10;5695118;3618;327;4614;4614;7.02;0.43;280.12;3.12;996;15;1576.00;0
3620;10;5695129;3620;322;4615;4615;7.00;0.43;280.20;3.12;995;15;1577.00;0
3622;10;5695140;3622;314;4615;4615;6.96;0.42;280.34;3.12;993;15;1578.00;0
3625;10;5695152;3625;306;4615;4615;6.88;0.42;280.38;3.12;990;15;1579.00;0
3629;10;5695163;3629;299;4615;4615;6.87;0.42;280.49;3.12;986;15;1580.00;0
3631;10;5695175;3631;292;4615;4615;6.86;0.42;280.41;3.12;984;15;1581.00;0
3634;10;5695185;3634;289;4615;4615;6.89;0.42;280.42;3.12;981;15;1582.00;0
3635;10;5695198;3635;278;4615;4615;6.99;0.42;280.47;3.12;980;15;1583.00;0
3636;10;5695209;3636;309;4692;4742;6.99;0.43;280.51;3.07;1056;15;1584.00;50
3637;10;5695232;3637;293;4692;4743;7.04;0.43;280.47;3.07;1055;15;1585.00;51
3639;10;5695244;3639;283;4697;4743;7.13;0.44;280.58;3.07;1058;15;1586.00;46
3644;10;5695255;3644;281;4699;4743;7.20;0.44;280.64;3.07;1055;15;1587.00;44
3645;10;5695267;3645;277;4703;4743;7.28;0.45;280.61;3.07;1058;15;1588.00;40
3648;10;5695278;3648;277;4705;4743;7.30;0.45;280.60;3.07;1057;15;1589.00;38
3650;10;5695292;3650;277;4709;4743;7.36;0.45;280.73;3.07;1059;15;1590.00;34
3654;10;5695309;3654;274;4712;4743;7.53;0.46;280.79;3.08;1058;15;1591.00;31
3656;11;5695321;3656;279;4715;4744;7.59;0.46;280.71;3.08;1059;16;1592.00;29
3658;11;5695338;3658;279;4720;4745;7.61;0.47;280.81;3.08;1062;16;1593.00;25
3660;11;5695350;3660;278;4723;4745;7.62;0.47;280.87;3.09;1063;16;1594.00;22
3665;11;5695362;3665;275;4726;4746;7.60;0.46;281.13;3.09;1061;16;1595.00;20
3666;11;5695379;3666;278;4728;4746;7.60;0.46;281.10;3.10;1062;16;1596.00;18
3668;11;5695390;3668;277;4732;4746;7.57;0.46;281.07;3.11;1064;16;1597.00;14
3670;11;5695402;3670;281;4732;4746;7.58;0.46;281.13;3.11;1062;16;1598.00;14
3674;11;5695413;3674;288;4739;4750;7.51;0.46;281.03;3.11;1065;16;1599.00;11
3678;11;5695429;3678;287;4739;4750;7.44;0.45;280.99;3.11;1061;16;1600.00;11
3679;11;5695445;3679;291;4741;4750;7.42;0.45;280.95;3.12;1062;16;1601.00;9
3682;11;5695457;3682;293;4744;4753;7.41;0.45;281.18;3.12;1062;16;1602.00;9
3685;11;5695469;3685;291;4744;4753;7.47;0.46;281.47;3.12;1059;16;1603.00;9
3688;11;5695481;3688;298;4744;4753;7.48;0.46;281.62;3.12;1056;16;1604.00;9
3692;11;5695497;3692;296;4747;4757;7.45;0.45;281.85;3.12;1055;16;1605.00;10
3696;11;5695510;3696;293;4751;4758;7.47;0.45;282.02;3.13;1055;16;1606.00;7
3697;11;5695522;3697;291;4752;4758;7.46;0.45;282.05;3.13;1055;16;1607.00;6
3700;11;5695534;3700;288;4755;4762;7.46;0.45;282.08;3.13;1055;16;1608.00;7
3705;11;5695546;3705;291;4756;4762;7.47;0.45;282.11;3.13;1051;16;1609.00;6
3706;11;5695558;3706;299;4756;4762;7.52;0.46;282.17;3.13;1050;16;1610.00;6
3711;11;5695570;3711;306;4758;4763;7.55;0.46;282.42;3.13;1047;16;1611.00;5
3713;11;5695582;3713;306;4758;4763;7.54;0.46;282.63;3.13;1045;16;1612.00;5
3715;11;5695594;3715;301;4763;4769;7.58;0.46;282.59;3.13;1048;16;1613.00;6
3719;11;5695606;3719;301;4763;4769;7.53;0.46;282.82;3.13;1044;16;1614.00;6
3722;11;5695619;3722;304;4765;4770;7.49;0.45;282.98;3.14;1043;16;1615.00;5
3722;11;5695633;3722;301;4765;4770;7.49;0.45;282.98;3.14;1043;16;1616.00;5
3723;11;5695646;3723;307;4765;4770;7.47;0.45;283.09;3.14;1042;16;1617.00;5
3724;11;5695658;3724;310;4766;4770;7.46;0.45;283.19;3.14;1042;16;1618.00;4
3724;11;5695670;3724;315;4766;4770;7.48;0.46;283.19;3.14;1042;16;1619.00;4
3727;11;5695683;3727;328;4796;4806;7.59;0.46;283.27;3.13;1069;16;1620.00;10
3732;11;5695699;3732;323;4798;4806;7.49;0.46;283.45;3.13;1066;16;1621.00;8
3734;11;5695711;3734;329;4802;4806;7.42;0.45;283.50;3.13;1068;16;1622.00;4
3736;11;5695724;3736;328;4802;4806;7.29;0.45;283.57;3.13;1066;16;1623.00;4
3738;11;5695735;3738;337;4804;4806;7.18;0.44;283.73;3.14;1066;16;1624.00;2
3739;11;5695747;3739;339;4804;4806;7.08;0.43;283.68;3.14;1065;16;1625.00;2
3742;11;5695758;3742;338;4809;4810;6.96;0.43;283.76;3.14;1067;16;1626.00;1
3743;11;5695770;3743;343;4810;4810;6.92;0.43;283.80;3.14;1067;16;1627.00;0
3746;11;5695780;3746;344;4814;4814;6.94;0.43;283.96;3.13;1068;16;1628.00;0
3748;11;5695791;3748;355;4815;4815;6.93;0.43;284.07;3.13;1067;16;1629.00;0
3753;11;5695804;3753;357;4815;4815;6.89;0.42;284.10;3.13;1062;16;1630.00;0
3754;11;5695814;3754;360;4815;4815;6.84;0.42;284.23;3.13;1061;16;1631.00;0
3760;11;5695825;3760;372;4828;4828;6.76;0.41;284.10;3.12;1068;16;1632.00;0
3763;11;5695837;3763;373;4828;4828;6.66;0.41;284.02;3.12;1065;16;1633.00;0
3764;11;5695850;3764;372;4828;4828;6.60;0.40;284.01;3.12;1064;16;1634.00;0
3768;11;5695862;3768;371;4829;4829;6.55;0.40;283.97;3.12;1061;16;1635.00;0
3771;11;5695873;3771;365;4830;4830;6.52;0.40;284.01;3.12;1059;16;1636.00;0
3775;11;5695885;3775;361;4830;4830;6.51;0.40;283.94;3.12;1055;16;1637.00;0
3782;11;5695896;3782;359;4833;4833;6.53;0.40;283.82;3.12;1051;16;1638.00;0
3783;11;5695908;3783;352;4833;4833;6.51;0.40;283.84;3.12;1050;16;1639.00;0
3787;11;5695919;3787;352;4833;4833;6.52;0.40;283.76;3.12;1046;16;1640.00;0
3790;11;5695935;3790;357;4833;4833;6.49;0.40;283.76;3.12;1043;16;1641.00;0
3791;11;5695945;3791;361;4839;4839;6.53;0.40;283.71;3.12;1048;16;1642.00;0
3793;11;5695957;3793;366;4839;4839;6.48;0.40;283.82;3.12;1046;16;1643.00;0
3796;11;5695967;3796;365;4839;4839;6.43;0.39;284.07;3.12;1043;16;1644.00;0
3798;11;5695977;3798;368;4839;4839;6.36;0.39;284.09;3.12;1041;16;1645.00;0
3800;11;5695987;3800;365;4843;4843;6.30;0.39;284.26;3.12;1043;16;1646.00;0
3804;11;5695997;3804;374;4844;4844;6.18;0.38;284.50;3.12;1040;16;1647.00;0
3811;11;5696007;3811;374;4844;4844;5.96;0.37;284.78;3.12;1033;16;1648.00;0
3816;11;5696016;3816;380;4845;4845;5.79;0.35;284.80;3.12;1029;16;1649.00;0
3822;11;5696028;3822;376;4845;4845;5.67;0.35;284.99;3.12;1023;16;1650.00;0
3826;11;5696040;3826;373;4845;4845;5.54;0.34;285.15;3.12;1019;16;1651.00;0
3829;11;5696049;3829;378;4845;4845;5.48;0.34;285.08;3.12;1016;16;1652.00;0
3834;11;5696058;3834;374;4845;4845;5.41;0.33;285.07;3.12;1011;16;1653.00;0
3840;11;5696068;3840;380;4845;4845;5.33;0.33;284.95;3.12;1005;16;1654.00;0
3843;11;5696077;3843;382;4845;4845;5.28;0.32;284.97;3.12;1002;16;1655.00;0
3845;11;5696087;3845;390;4885;4915;5.47;0.34;285.03;3.09;1040;16;1656.00;30
3849;11;5696102;3849;389;4889;4916;5.46;0.34;285.02;3.09;1040;16;1657.00;27
3849;11;5696113;3849;387;4898;4916;5.50;0.34;285.02;3.09;1049;16;1658.00;18
3852;11;5696123;3852;388;4900;4916;5.48;0.34;285.07;3.09;1048;16;1659.00;16
3854;11;5696133;3854;389;4903;4916;5.46;0.34;285.08;3.09;1049;16;1660.00;13
3858;11;5696143;3858;398;4903;4916;5.45;0.34;284.92;3.09;1045;16;1661.00;13
3860;11;5696154;3860;399;4906;4916;5.43;0.34;284.90;3.09;1046;16;1662.00;10
3865;11;5696164;3865;403;4908;4916;5.38;0.33;284.80;3.09;1043;16;1663.00;8
3867;11;5696174;3867;411;4911;4917;5.35;0.33;284.75;3.09;1044;16;1664.00;6
3871;11;5696185;3871;408;4915;4919;5.30;0.33;284.64;3.10;1044;16;1665.00;4
3875;11;5696195;3875;411;4916;4919;5.27;0.32;284.56;3.10;1041;16;1666.00;3
3878;11;5696205;3878;423;4921;4923;5.26;0.32;284.49;3.10;1043;16;1667.00;2
3884;11;5696215;3884;423;4922;4923;5.16;0.32;284.35;3.10;1038;16;1668.00;1
3887;11;5696226;3887;423;4923;4923;5.15;0.32;284.34;3.10;1036;16;1669.00;0
3893;11;5696237;3893;421;4923;4923;5.10;0.31;284.45;3.10;1030;16;1670.00;0
3895;11;5696247;3895;426;4929;4929;5.08;0.31;284.55;3.10;1034;16;1671.00;0
3897;11;5696257;3897;428;4929;4929;5.09;0.31;284.54;3.10;1032;16;1672.00;0
3901;11;5696268;3901;428;4929;4929;5.13;0.31;284.48;3.10;1028;16;1673.00;0
3905;11;5696278;3905;431;4932;4932;5.09;0.31;284.45;3.09;1027;16;1674.00;0
3907;11;5696289;3907;439;4932;4932;5.10;0.31;284.45;3.09;1025;16;1675.00;0
3910;11;5696299;3910;441;4932;4932;5.10;0.31;284.37;3.09;1022;16;1676.00;0
3911;11;5696310;3911;450;4933;4933;5.11;0.31;284.40;3.09;1022;16;1677.00;0
3914;11;5696320;3914;456;4934;4934;5.11;0.31;284.41;3.09;1020;16;1678.00;0
3916;11;5696331;3916;462;4934;4934;5.09;0.31;284.45;3.09;1018;16;1679.00;0
3918;11;5696342;3918;475;4956;4960;5.19;0.32;284.41;3.08;1038;16;1680.00;4
3923;11;5696356;3923;480;4956;4960;5.17;0.32;284.36;3.08;1033;16;1681.00;4
3926;11;5696368;3926;479;4958;4960;5.18;0.32;284.40;3.08;1032;16;1682.00;2
3927;11;5696378;3927;491;4959;4961;5.21;0.32;284.44;3.08;1032;16;1683.00;2
3933;11;5696388;3933;477;4959;4961;5.18;0.32;284.43;3.08;1026;16;1684.00;2
3933;11;5696399;3933;469;4964;4965;5.28;0.32;284.43;3.08;1031;16;1685.00;1
3938;11;5696410;3938;469;4964;4965;5.27;0.32;284.37;3.08;1026;16;1686.00;1
3941;11;5696421;3941;468;4968;4969;5.27;0.32;284.35;3.08;1027;16;1687.00;1
3943;11;5696432;3943;468;4968;4969;5.24;0.32;284.38;3.08;1025;16;1688.00;1
3944;11;5696443;3944;463;4968;4969;5.21;0.32;284.37;3.08;1024;16;1689.00;1
3947;11;5696465;3947;464;4968;4969;5.18;0.32;284.36;3.08;1021;16;1690.00;1
3948;11;5696480;3948;461;4968;4969;5.22;0.32;284.38;3.08;1020;16;1691.00;1
3953;11;5696492;3953;458;4979;4981;5.36;0.33;284.40;3.07;1026;16;1692.00;2
3954;11;5696504;3954;464;4980;4981;5.44;0.33;284.41;3.07;1026;16;1693.00;1
3959;11;5696515;3959;465;4980;4981;5.44;0.33;284.34;3.07;1021;16;1694.00;1
3962;11;5696526;3962;461;4980;4981;5.48;0.33;284.33;3.07;1018;16;1695.00;1
3964;11;5696537;3964;456;4980;4981;5.53;0.34;284.30;3.07;1016;16;1696.00;1
3968;11;5696548;3968;447;4980;4981;5.53;0.34;284.47;3.07;1012;16;1697.00;1
3972;11;5696565;3972;441;4981;4982;5.52;0.34;284.43;3.07;1009;16;1698.00;1
3972;11;5696577;3972;444;4981;4982;5.59;0.34;284.43;3.07;1009;16;1699.00;1
3974;11;5696588;3974;437;4987;4988;5.65;0.34;284.51;3.07;1013;16;1700.00;1
3978;11;5696604;3978;434;4988;4989;5.68;0.35;284.59;3.06;1010;16;1701.00;1
3978;11;5696615;3978;434;4988;4989;5.77;0.35;284.59;3.06;1010;16;1702.00;1
3979;11;5696626;3979;439;4988;4989;5.84;0.36;284.61;3.06;1009;16;1703.00;1
3980;11;5696638;3980;427;4993;4993;5.95;0.36;284.64;3.07;1013;16;1704.00;0
3984;11;5696649;3984;427;4993;4993;5.95;0.36;284.60;3.07;1009;16;1705.00;0
3986;11;5696661;3986;414;4993;4993;5.96;0.36;284.66;3.07;1007;16;1706.00;0
3988;11;5696673;3988;407;4994;4994;6.00;0.37;284.73;3.07;1006;16;1707.00;0
3989;11;5696684;3989;398;4998;4998;6.08;0.37;284.86;3.06;1009;16;1708.00;0
3994;11;5696697;3994;382;4998;4998;6.13;0.37;284.98;3.06;1004;16;1709.00;0
3996;11;5696711;3996;383;5002;5004;6.29;0.38;285.04;3.06;1006;16;1710.00;2
3998;11;5696723;3998;384;5002;5004;6.35;0.39;284.95;3.06;1004;16;1711.00;2
4000;11;5696735;4000;383;5004;5004;6.48;0.40;284.98;3.06;1004;16;1712.00;0
4003;11;5696746;4003;383;5004;5004;6.59;0.40;284.95;3.06;1001;16;1713.00;0
4004;11;5696758;4004;392;5008;5008;6.63;0.40;284.95;3.06;1004;16;1714.00;0
4007;11;5696770;4007;380;5008;5008;6.59;0.40;285.02;3.06;1001;16;1715.00;0
4009;11;5696781;4009;374;5008;5008;6.54;0.40;285.09;3.06;999;16;1716.00;0
4011;11;5696792;4011;369;5008;5008;6.55;0.40;285.21;3.06;997;16;1717.00;0
4012;11;5696808;4012;368;5009;5009;6.54;0.40;285.23;3.06;997;16;1718.00;0
4016;11;5696819;4016;366;5010;5010;6.55;0.40;285.24;3.06;994;16;1719.00;0
4019;11;5696831;4019;359;5010;5010;6.59;0.40;285.24;3.06;991;16;1720.00;0
4022;11;5696842;4022;357;5011;5011;6.58;0.40;285.51;3.06;989;16;1721.00;0
4026;12;5696853;4026;360;5011;5011;6.55;0.40;285.77;3.06;985;17;1722.00;0
4032;12;5696871;4032;366;5011;5011;6.59;0.40;285.80;3.06;979;17;1723.00;0
4033;12;5696886;4033;367;5011;5011;6.64;0.40;285.91;3.06;978;17;1724.00;0
4038;12;5696897;4038;371;5011;5011;6.68;0.41;286.04;3.06;973;17;1725.00;0
4039;12;5696908;4039;371;5011;5011;6.73;0.41;286.03;3.06;972;17;1726.00;0
4040;12;5696918;4040;377;5011;5011;6.83;0.41;286.07;3.06;971;17;1727.00;0
4041;12;5696928;4041;400;5091;5138;7.00;0.43;286.10;3.01;1050;17;1728.00;47
4045;12;5696948;4045;386;5094;5139;7.03;0.43;286.27;3.01;1049;17;1729.00;45
4049;12;5696960;4049;382;5102;5139;7.12;0.44;286.58;3.01;1053;17;1730.00;37
4050;12;5696973;4050;381;5103;5139;7.12;0.44;286.66;3.01;1053;17;1731.00;36
4054;12;5696984;4054;386;5108;5139;7.09;0.44;286.88;3.01;1054;17;1732.00;31
4055;12;5696996;4055;388;5110;5139;7.10;0.44;287.02;3.01;1055;17;1733.00;29
4057;12;5697008;4057;395;5114;5139;7.05;0.43;287.12;3.01;1057;17;1734.00;25
4061;12;5697021;4061;403;5117;5139;6.98;0.43;287.22;3.01;1056;17;1735.00;22
4062;12;5697038;4062;409;5119;5140;6.90;0.42;287.25;3.02;1057;17;1736.00;21
4065;12;5697056;4065;405;5122;5141;6.82;0.42;287.34;3.02;1057;17;1737.00;19
4067;12;5697067;4067;410;5124;5141;6.74;0.41;287.40;3.02;1057;17;1738.00;17
4069;12;5697079;4069;411;5126;5142;6.68;0.41;287.36;3.02;1057;17;1739.00;16
4071;12;5697092;4071;401;5129;5142;6.71;0.41;287.48;3.03;1058;17;1740.00;13
4073;12;5697103;4073;400;5129;5142;6.74;0.41;287.57;3.03;1056;17;1741.00;13
4075;12;5697115;4075;395;5132;5142;6.77;0.42;287.60;3.03;1057;17;1742.00;10
4077;12;5697126;4077;392;5135;5146;6.81;0.42;287.76;3.03;1058;17;1743.00;11
4078;12;5697138;4078;383;5137;5146;6.83;0.42;287.73;3.04;1059;17;1744.00;9
4081;12;5697149;4081;380;5137;5146;6.83;0.42;287.89;3.04;1056;17;1745.00;9
4086;12;5697161;4086;378;5142;5149;6.73;0.41;288.05;3.04;1056;17;1746.00;7
4090;12;5697173;4090;376;5143;5149;6.73;0.41;288.18;3.05;1053;17;1747.00;6
4095;12;5697185;4095;361;5143;5149;6.74;0.41;288.44;3.05;1048;17;1748.00;6
4098;12;5697197;4098;356;5146;5153;6.78;0.41;288.59;3.04;1048;17;1749.00;7
4102;12;5697210;4102;347;5148;5154;6.77;0.41;288.91;3.05;1046;17;1750.00;6
4107;12;5697222;4107;343;5148;5154;6.82;0.41;289.30;3.05;1041;17;1751.00;6
4111;12;5697233;4111;333;5151;5158;6.89;0.42;289.42;3.05;1040;17;1752.00;7
4115;12;5697245;4115;326;5151;5158;6.95;0.42;289.58;3.05;1036;17;1753.00;7
4119;13;5697257;4119;313;5153;5158;7.00;0.43;289.78;3.06;1034;18;1754.00;5
4121;13;5697279;4121;314;5156;5160;7.02;0.43;289.77;3.06;1035;18;1755.00;4
4122;13;5697290;4122;309;5156;5160;7.05;0.43;289.73;3.06;1034;18;1756.00;4
4126;13;5697302;4126;306;5162;5166;7.11;0.43;289.69;3.06;1036;18;1757.00;4
4128;13;5697315;4128;302;5163;5166;7.13;0.43;289.80;3.06;1035;18;1758.00;3
4133;13;5697326;4133;297;5164;5167;7.11;0.43;289.80;3.06;1031;18;1759.00;3
4134;13;5697338;4134;300;5164;5167;7.07;0.43;289.77;3.06;1030;18;1760.00;3
4139;13;5697349;4139;299;5165;5167;7.07;0.43;289.73;3.06;1026;18;1761.00;2
4141;13;5697360;4141;304;5165;5167;7.01;0.42;289.87;3.06;1024;18;1762.00;2
4142;13;5697371;4142;307;5165;5167;7.03;0.43;289.98;3.06;1023;18;1763.00;2
4145;13;5697383;4145;310;5175;5179;7.04;0.43;290.03;3.06;1030;18;1764.00;4
4151;13;5697396;4151;312;5175;5179;6.95;0.42;290.15;3.06;1024;18;1765.00;4
4153;13;5697422;4153;314;5176;5179;6.97;0.42;290.20;3.06;1023;18;1766.00;3
4154;13;5697440;4154;322;5176;5179;6.95;0.42;290.20;3.06;1022;18;1767.00;3
4156;13;5697456;4156;321;5176;5179;6.95;0.42;290.21;3.06;1020;18;1768.00;3
4158;13;5697467;4158;321;5176;5179;6.83;0.41;290.23;3.06;1018;18;1769.00;3
4160;13;5697480;4160;323;5179;5183;6.68;0.41;290.30;3.06;1019;18;1770.00;4
4162;13;5697496;4162;319;5179;5183;6.62;0.40;290.31;3.06;1017;18;1771.00;4
4164;13;5697507;4164;321;5183;5187;6.67;0.40;290.33;3.06;1019;18;1772.00;4
4166;13;5697518;4166;321;5183;5188;6.71;0.41;290.35;3.06;1017;18;1773.00;5
4170;13;5697529;4170;317;5184;5188;6.78;0.41;290.32;3.06;1014;18;1774.00;4
4173;13;5697540;4173;324;5184;5188;6.82;0.41;290.22;3.06;1011;18;1775.00;4
4173;13;5697551;4173;323;5195;5201;6.87;0.42;290.22;3.05;1022;18;1776.00;6
4178;13;5697563;4178;326;5195;5201;6.81;0.41;290.77;3.05;1017;18;1777.00;6
4179;13;5697575;4179;331;5195;5201;6.80;0.41;290.75;3.05;1016;18;1778.00;6
4180;13;5697586;4180;327;5197;5202;6.82;0.41;290.73;3.05;1017;18;1779.00;5
4184;13;5697597;4184;327;5197;5203;6.79;0.41;290.95;3.05;1013;18;1780.00;6
4186;13;5697608;4186;331;5198;5203;6.81;0.41;290.97;3.06;1012;18;1781.00;5
4189;13;5697619;4189;336;5201;5206;6.81;0.41;291.02;3.06;1012;18;1782.00;5
4192;13;5697630;4192;341;5201;5206;6.81;0.41;291.18;3.06;1009;18;1783.00;5
4195;13;5697640;4195;345;5202;5206;6.80;0.41;291.32;3.06;1007;18;1784.00;4
4196;13;5697655;4196;352;5203;5206;6.77;0.41;291.37;3.06;1007;18;1785.00;3
4198;13;5697666;4198;350;5209;5212;6.79;0.41;291.55;3.06;1011;18;1786.00;3
4201;13;5697677;4201;356;5210;5212;6.72;0.41;291.59;3.06;1009;18;1787.00;2
4203;13;5697688;4203;360;5210;5212;6.65;0.40;291.58;3.06;1007;18;1788.00;2
4207;13;5697698;4207;363;5211;5212;6.53;0.40;291.71;3.06;1004;18;1789.00;1
4208;13;5697708;4208;374;5214;5216;6.46;0.39;291.76;3.06;1006;18;1790.00;2
4210;13;5697719;4210;381;5217;5217;6.41;0.39;291.71;3.06;1007;18;1791.00;0
4211;13;5697730;4211;393;5217;5217;6.38;0.39;291.68;3.06;1006;18;1792.00;0
4215;13;5697740;4215;397;5218;5218;6.29;0.38;291.56;3.06;1003;18;1793.00;0
4215;13;5697751;4215;406;5218;5218;6.21;0.38;291.56;3.06;1003;18;1794.00;0
4219;13;5697762;4219;409;5218;5218;6.12;0.37;291.59;3.06;999;18;1795.00;0
4220;13;5697773;4220;411;5218;5218;6.06;0.37;291.55;3.06;998;18;1796.00;0
4220;13;5697783;4220;419;5218;5218;5.99;0.37;291.55;3.06;998;18;1797.00;0
4224;13;5697792;4224;425;5218;5218;5.94;0.36;291.38;3.06;994;18;1798.00;0
4225;13;5697801;4225;423;5218;5218;5.93;0.36;291.44;3.06;993;18;1799.00;0
4229;13;5697814;4229;425;5280;5356;6.10;0.38;291.40;3.02;1051;18;1800.00;76
4231;13;5697838;4231;423;5285;5357;6.05;0.37;291.30;3.02;1054;18;1801.00;72
4235;13;5697848;4235;421;5301;5357;6.02;0.37;291.17;3.02;1066;18;1802.00;56
4239;13;5697859;4239;420;5305;5357;5.97;0.37;291.05;3.02;1066;18;1803.00;52
4241;13;5697869;4241;422;5312;5357;5.95;0.37;290.97;3.02;1071;18;1804.00;45
4241;13;5697878;4241;421;5313;5357;5.90;0.36;290.97;3.02;1072;18;1805.00;44
4244;13;5697888;4244;417;5319;5357;5.84;0.36;290.91;3.02;1075;18;1806.00;38
4245;13;5697899;4245;423;5324;5357;5.80;0.36;290.87;3.03;1079;18;1807.00;33
4248;13;5697909;4248;421;5327;5358;5.77;0.35;290.71;3.03;1079;18;1808.00;31
4250;13;5697919;4250;424;5331;5359;5.76;0.35;290.61;3.04;1081;18;1809.00;28
4250;13;5697929;4250;429;5332;5359;5.70;0.35;290.61;3.04;1082;18;1810.00;27
4252;13;5697945;4252;437;5340;5363;5.63;0.35;290.50;3.04;1088;18;1811.00;23
4253;13;5697956;4253;440;5342;5363;5.57;0.34;290.51;3.04;1089;18;1812.00;21
4257;13;5697968;4257;454;5344;5363;5.46;0.33;290.41;3.05;1087;18;1813.00;19
4259;13;5697979;4259;459;5347;5363;5.34;0.33;290.32;3.05;1088;18;1814.00;16
4261;13;5697989;4261;445;5352;5369;5.27;0.32;290.28;3.05;1091;18;1815.00;17
4263;13;5698005;4263;449;5353;5369;5.24;0.32;290.25;3.05;1090;18;1816.00;16
4266;13;5698017;4266;453;5353;5369;5.20;0.32;290.53;3.05;1087;18;1817.00;16
4270;13;5698028;4270;452;5354;5372;5.16;0.32;290.42;3.05;1084;18;1818.00;18
4274;13;5698038;4274;459;5354;5372;5.10;0.31;290.45;3.05;1080;18;1819.00;18
4276;13;5698049;4276;470;5356;5372;5.03;0.31;290.42;3.05;1080;18;1820.00;16
4278;13;5698059;4278;472;5357;5373;4.99;0.30;290.50;3.05;1079;18;1821.00;16
4283;13;5698069;4283;464;5358;5374;4.97;0.30;290.41;3.05;1075;18;1822.00;16
4286;13;5698080;4286;468;5359;5374;4.92;0.30;290.44;3.06;1073;18;1823.00;15
4287;13;5698091;4287;466;5371;5387;4.91;0.30;290.42;3.05;1084;18;1824.00;16
4289;13;5698102;4289;466;5371;5387;4.86;0.30;290.42;3.05;1082;18;1825.00;16
4293;13;5698112;4293;467;5371;5387;4.80;0.29;290.33;3.05;1078;18;1826.00;16
4296;13;5698124;4296;480;5373;5388;4.73;0.29;290.24;3.05;1077;18;1827.00;15
4298;13;5698136;4298;485;5373;5388;4.76;0.29;290.22;3.05;1075;18;1828.00;15
4300;13;5698147;4300;493;5376;5392;4.77;0.29;290.28;3.05;1076;18;1829.00;16
4301;13;5698159;4301;493;5377;5392;4.77;0.29;290.30;3.05;1076;18;1830.00;15
4306;13;5698170;4306;479;5381;5396;4.81;0.29;290.28;3.05;1075;18;1831.00;15
4307;13;5698181;4307;472;5381;5396;4.90;0.30;290.32;3.05;1074;18;1832.00;15
4309;13;5698191;4309;468;5382;5396;4.93;0.30;290.33;3.05;1073;18;1833.00;14
4311;13;5698202;4311;471;5382;5396;4.99;0.31;290.31;3.05;1071;18;1834.00;14
4314;13;5698213;4314;467;5383;5396;5.01;0.31;290.28;3.05;1069;18;1835.00;13
4317;13;5698224;4317;463;5395;5408;5.08;0.31;290.23;3.05;1078;18;1836.00;13
4320;13;5698236;4320;464;5395;5408;5.09;0.31;290.27;3.05;1075;18;1837.00;13
4322;13;5698257;4322;467;5395;5408;5.15;0.32;290.17;3.05;1073;18;1838.00;13
4324;13;5698270;4324;467;5395;5408;5.24;0.32;290.19;3.05;1071;18;1839.00;13
4328;13;5698282;4328;465;5395;5408;5.29;0.32;290.41;3.05;1067;18;1840.00;13
4329;13;5698294;4329;468;5395;5408;5.35;0.33;290.43;3.05;1066;18;1841.00;13
4331;13;5698306;4331;461;5396;5409;5.37;0.33;290.49;3.05;1065;18;1842.00;13
4334;13;5698318;4334;458;5396;5409;5.37;0.33;290.49;3.05;1062;18;1843.00;13
4336;13;5698334;4336;462;5401;5415;5.37;0.33;290.59;3.04;1065;18;1844.00;14
4338;13;5698346;4338;458;5403;5417;5.36;0.33;290.56;3.04;1065;18;1845.00;14
4343;13;5698357;4343;454;5404;5417;5.36;0.33;290.59;3.04;1061;18;1846.00;13
4347;13;5698368;4347;449;5404;5417;5.38;0.33;290.66;3.04;1057;18;1847.00;13
4350;13;5698380;4350;450;5408;5421;5.44;0.33;290.70;3.04;1058;18;1848.00;13
4354;13;5698391;4354;447;5408;5421;5.50;0.34;290.71;3.04;1054;18;1849.00;13
4356;13;5698403;4356;444;5408;5421;5.57;0.34;290.67;3.04;1052;18;1850.00;13
4364;13;5698414;4364;444;5409;5422;5.57;0.34;290.59;3.04;1045;18;1851.00;13
4369;13;5698426;4369;440;5413;5426;5.65;0.35;290.57;3.04;1044;18;1852.00;13
4373;13;5698438;4373;439;5413;5426;5.68;0.35;290.59;3.04;1040;18;1853.00;13
4378;13;5698449;4378;435;5416;5429;5.70;0.35;290.67;3.04;1038;18;1854.00;13
4384;13;5698461;4384;436;5416;5429;5.72;0.35;290.59;3.04;1032;18;1855.00;13
4386;13;5698471;4386;430;5416;5429;5.78;0.35;290.59;3.04;1030;18;1856.00;13
4389;13;5698486;4389;436;5417;5429;5.76;0.35;290.59;3.05;1028;18;1857.00;12
4392;13;5698497;4392;441;5421;5433;5.77;0.35;290.50;3.05;1029;18;1858.00;12
4395;13;5698508;4395;446;5421;5433;5.76;0.35;290.51;3.05;1026;18;1859.00;12
4397;13;5698520;4397;448;5421;5433;5.72;0.35;290.71;3.05;1024;18;1860.00;12
4401;13;5698531;4401;451;5421;5433;5.66;0.35;290.97;3.05;1020;18;1861.00;12
4402;13;5698542;4402;432;5423;5434;5.67;0.35;290.96;3.06;1021;18;1862.00;11
4407;13;5698552;4407;427;5424;5435;5.61;0.34;291.29;3.05;1017;18;1863.00;11
4411;13;5698563;4411;417;5424;5435;5.59;0.34;291.42;3.05;1013;18;1864.00;11
4411;13;5698574;4411;413;5425;5436;5.60;0.34;291.42;3.05;1014;18;1865.00;11
4414;13;5698585;4414;414;5425;5436;5.59;0.34;291.66;3.05;1011;18;1866.00;11
4415;13;5698595;4415;411;5425;5436;5.62;0.34;291.61;3.05;1010;18;1867.00;11
4417;13;5698607;4417;416;5426;5436;5.63;0.34;291.70;3.07;1009;18;1868.00;10
4419;13;5698619;4419;415;5426;5436;5.62;0.34;291.74;3.07;1007;18;1869.00;10
4421;13;5698629;4421;419;5426;5436;5.61;0.34;291.85;3.07;1005;18;1870.00;10
4424;13;5698642;4424;402;5427;5436;5.63;0.34;291.90;3.08;1003;18;1871.00;9
4426;13;5698653;4426;421;5508;5563;5.92;0.37;292.01;3.03;1082;18;1872.00;55
4427;13;5698677;4427;401;5511;5564;6.00;0.37;292.08;3.05;1084;18;1873.00;53
4430;13;5698694;4430;388;5518;5564;6.08;0.38;292.24;3.04;1088;18;1874.00;46
4433;13;5698708;4433;380;5520;5564;6.18;0.38;292.36;3.06;1087;18;1875.00;44
4435;13;5698720;4435;370;5525;5564;6.27;0.39;292.40;3.06;1090;18;1876.00;39
4438;13;5698732;4438;365;5529;5564;6.28;0.39;292.51;3.06;1091;18;1877.00;35
4439;13;5698744;4439;369;5532;5564;6.31;0.39;292.55;3.07;1093;18;1878.00;32
4441;13;5698756;4441;378;5535;5564;6.27;0.39;292.59;3.08;1094;18;1879.00;29
4442;13;5698768;4442;383;5538;5565;6.23;0.38;292.58;3.08;1096;18;1880.00;27
4443;13;5698780;4443;388;5540;5566;6.22;0.38;292.71;3.08;1097;18;1881.00;26
4447;13;5698792;4447;390;5548;5568;6.16;0.38;292.78;3.10;1101;18;1882.00;20
4450;13;5698805;4450;384;5550;5569;6.09;0.38;292.82;3.12;1100;18;1883.00;19
4455;13;5698817;4455;380;5552;5569;6.01;0.37;293.02;3.12;1097;18;1884.00;17
4456;13;5698829;4456;389;5553;5569;5.97;0.37;293.05;3.13;1097;18;1885.00;16
4459;13;5698841;4459;390;5554;5569;5.98;0.37;293.19;3.14;1095;18;1886.00;15
4460;13;5698853;4460;398;5560;5573;6.03;0.37;293.20;3.15;1100;18;1887.00;13
4462;13;5698865;4462;400;5562;5573;6.00;0.37;293.19;3.17;1100;18;1888.00;11
4462;13;5698877;4462;409;5563;5573;6.01;0.37;293.19;3.17;1101;18;1889.00;10
4465;13;5698890;4465;402;5568;5579;6.00;0.37;293.23;3.18;1103;18;1890.00;11
4469;13;5698902;4469;402;5571;5579;6.02;0.37;293.29;3.18;1102;18;1891.00;8
4472;13;5698914;4472;410;5571;5579;6.01;0.37;293.31;3.18;1099;18;1892.00;8
4475;13;5698926;4475;413;5576;5583;5.98;0.37;293.43;3.20;1101;18;1893.00;7
4476;13;5698938;4476;416;5578;5584;5.97;0.37;293.44;3.20;1102;18;1894.00;6
4477;13;5698951;4477;413;5580;5584;5.96;0.37;293.45;3.20;1103;18;1895.00;4
4481;13;5698963;4481;411;5584;5588;5.98;0.37;293.40;3.20;1103;18;1896.00;4
4481;13;5698974;4481;423;5584;5588;5.98;0.37;293.40;3.20;1103;18;1897.00;4
4482;13;5698986;4482;425;5584;5588;5.99;0.37;293.39;3.20;1102;18;1898.00;4
4484;13;5698998;4484;424;5585;5589;5.94;0.36;293.42;3.20;1101;18;1899.00;4
4486;13;5699012;4486;429;5585;5589;5.90;0.36;293.43;3.20;1099;18;1900.00;4
4489;13;5699029;4489;424;5590;5595;5.91;0.36;293.49;3.20;1101;18;1901.00;5
4489;13;5699047;4489;429;5590;5595;5.91;0.36;293.49;3.20;1101;18;1902.00;5
4489;13;5699058;4489;429;5590;5596;5.94;0.36;293.49;3.20;1101;18;1903.00;6
4490;13;5699069;4490;432;5590;5596;5.90;0.36;293.50;3.20;1100;18;1904.00;6
4492;13;5699080;4492;428;5590;5596;5.88;0.36;293.52;3.20;1098;18;1905.00;6
4494;13;5699091;4494;425;5590;5596;5.91;0.36;293.56;3.20;1096;18;1906.00;6
4495;13;5699103;4495;418;5590;5596;5.88;0.36;293.66;3.20;1095;18;1907.00;6
4498;13;5699114;4498;411;5600;5608;5.91;0.36;293.63;3.19;1102;18;1908.00;8
4498;13;5699127;4498;407;5601;5608;5.95;0.36;293.63;3.19;1103;18;1909.00;7
4501;13;5699143;4501;397;5601;5608;5.92;0.36;293.68;3.19;1100;18;1910.00;7
4504;13;5699154;4504;393;5601;5608;5.86;0.36;293.75;3.19;1097;18;1911.00;7
4506;13;5699166;4506;392;5601;5608;5.77;0.35;293.76;3.19;1095;18;1912.00;7
4509;13;5699177;4509;387;5601;5608;5.78;0.35;293.77;3.19;1092;18;1913.00;7
4511;13;5699188;4511;381;5604;5612;5.80;0.35;293.87;3.19;1093;18;1914.00;8
4513;13;5699200;4513;386;5604;5612;5.81;0.35;293.92;3.19;1091;18;1915.00;8
4513;13;5699213;4513;378;5608;5616;5.87;0.36;293.92;3.19;1095;18;1916.00;8
4518;13;5699225;4518;367;5608;5617;5.80;0.35;294.04;3.19;1090;18;1917.00;9
4519;13;5699238;4519;375;5609;5617;5.78;0.35;294.05;3.19;1090;18;1918.00;8
4522;13;5699249;4522;359;5609;5617;5.73;0.35;294.13;3.19;1087;18;1919.00;8
4527;13;5699262;4527;360;5632;5646;5.74;0.35;294.45;3.19;1105;18;1920.00;14
4528;13;5699276;4528;350;5634;5646;5.79;0.35;294.46;3.19;1106;18;1921.00;12
4532;13;5699287;4532;346;5635;5646;5.76;0.35;294.63;3.19;1103;18;1922.00;11
4534;13;5699299;4534;351;5636;5647;5.81;0.35;294.72;3.19;1102;18;1923.00;11
4538;13;5699309;4538;355;5637;5648;5.85;0.36;294.72;3.19;1099;18;1924.00;11
4542;13;5699320;4542;354;5637;5648;5.86;0.36;294.70;3.19;1095;18;1925.00;11
4544;13;5699333;4544;356;5640;5651;5.90;0.36;294.78;3.18;1096;18;1926.00;11
4547;13;5699344;4547;351;5641;5651;5.89;0.36;294.75;3.18;1094;18;1927.00;10
4548;13;5699356;4548;353;5641;5651;5.91;0.36;294.81;3.18;1093;18;1928.00;10
4552;13;5699367;4552;352;5641;5651;5.86;0.36;294.74;3.18;1089;18;1929.00;10
4556;13;5699380;4556;351;5646;5657;5.86;0.36;294.84;3.18;1090;18;1930.00;11
4557;13;5699393;4557;353;5646;5657;5.86;0.36;294.96;3.18;1089;18;1931.00;11
4559;13;5699405;4559;356;5646;5657;5.82;0.35;295.15;3.18;1087;18;1932.00;11
4562;13;5699417;4562;354;5646;5657;5.76;0.35;295.15;3.18;1084;18;1933.00;11
4563;13;5699429;4563;354;5649;5661;5.72;0.35;295.21;3.18;1086;18;1934.00;12
4566;13;5699441;4566;360;5651;5663;5.64;0.34;295.40;3.18;1085;18;1935.00;12
4567;13;5699456;4567;359;5651;5663;5.59;0.34;295.52;3.18;1084;18;1936.00;12
4570;13;5699468;4570;356;5652;5664;5.57;0.34;295.62;3.18;1082;18;1937.00;12
4572;13;5699480;4572;359;5652;5664;5.58;0.34;295.75;3.18;1080;18;1938.00;12
4573;13;5699492;4573;363;5652;5664;5.58;0.34;295.83;3.18;1079;18;1939.00;12
4575;13;5699504;4575;364;5653;5664;5.60;0.34;295.75;3.19;1078;18;1940.00;11
4578;13;5699515;4578;366;5653;5664;5.60;0.34;295.63;3.19;1075;18;1941.00;11
4578;13;5699527;4578;368;5653;5664;5.59;0.34;295.63;3.19;1075;18;1942.00;11
4579;13;5699540;4579;366;5653;5664;5.55;0.34;295.64;3.19;1074;18;1943.00;11
4580;13;5699551;4580;371;5691;5734;5.77;0.35;295.59;3.16;1111;18;1944.00;43
4580;13;5699568;4580;375;5694;5735;5.78;0.35;295.59;3.17;1114;18;1945.00;41
4582;13;5699581;4582;375;5702;5735;5.78;0.35;295.52;3.17;1120;18;1946.00;33
4584;13;5699592;4584;378;5704;5735;5.79;0.35;295.52;3.18;1120;18;1947.00;31
4588;13;5699603;4588;384;5709;5735;5.76;0.35;295.45;3.19;1121;18;1948.00;26
4591;13;5699615;4591;390;5709;5735;5.71;0.35;295.38;3.19;1118;18;1949.00;26
4591;13;5699627;4591;396;5715;5737;5.70;0.35;295.38;3.20;1124;18;1950.00;22
4591;13;5699639;4591;393;5719;5737;5.72;0.35;295.38;3.21;1128;18;1951.00;18
4593;13;5699650;4593;396;5723;5738;5.66;0.35;295.27;3.22;1130;19;1952.00;15
4594;13;5699670;4594;402;5725;5739;5.64;0.35;295.21;3.22;1131;19;1953.00;14
4595;13;5699681;4595;408;5729;5739;5.60;0.34;295.21;3.23;1134;19;1954.00;10
4598;13;5699692;4598;413;5733;5743;5.56;0.34;295.09;3.23;1135;19;1955.00;10
4600;13;5699703;4600;420;5734;5743;5.45;0.33;295.04;3.23;1134;19;1956.00;9
4602;13;5699716;4602;422;5736;5743;5.37;0.33;294.94;3.24;1134;19;1957.00;7
4604;13;5699726;4604;439;5736;5743;5.28;0.32;294.86;3.24;1132;19;1958.00;7
4606;13;5699739;4606;438;5742;5749;5.26;0.32;294.80;3.24;1136;19;1959.00;7
4608;13;5699751;4608;439;5742;5749;5.17;0.32;294.71;3.24;1134;19;1960.00;7
4610;13;5699762;4610;449;5744;5749;5.05;0.31;294.67;3.25;1134;19;1961.00;5
4612;13;5699773;4612;455;5747;5752;4.97;0.30;294.66;3.25;1135;19;1962.00;5
4615;13;5699784;4615;459;5748;5752;4.83;0.29;294.68;3.25;1133;19;1963.00;4
4617;13;5699794;4617;463;5749;5752;4.72;0.29;294.58;3.25;1132;19;1964.00;3
4618;13;5699805;4618;467;5749;5753;4.68;0.29;294.55;3.25;1131;19;1965.00;4
4619;13;5699816;4619;472;5752;5754;4.66;0.28;294.51;3.26;1133;19;1966.00;2
4620;13;5699828;4620;475;5752;5754;4.62;0.28;294.48;3.26;1132;19;1967.00;2
4623;13;5699839;4623;474;5765;5767;4.66;0.28;294.32;3.25;1142;19;1968.00;2
4623;13;5699850;4623;470;5765;5767;4.70;0.29;294.32;3.25;1142;19;1969.00;2
4625;13;5699861;4625;477;5767;5767;4.68;0.28;294.30;3.25;1142;19;1970.00;0
4626;13;5699872;4626;481;5768;5768;4.70;0.29;294.32;3.25;1142;19;1971.00;0
4628;13;5699882;4628;479;5768;5768;4.68;0.28;294.28;3.25;1140;19;1972.00;0
4629;13;5699891;4629;483;5772;5772;4.69;0.29;294.26;3.25;1143;19;1973.00;0
4630;13;5699901;4630;482;5772;5772;4.66;0.28;294.23;3.25;1142;19;1974.00;0
4631;13;5699912;4631;491;5776;5776;4.60;0.28;294.21;3.25;1145;19;1975.00;0
4634;13;5699923;4634;485;5776;5776;4.49;0.27;294.18;3.25;1142;20;1976.00;0
4635;13;5699941;4635;492;5776;5776;4.39;0.27;294.17;3.25;1141;20;1977.00;0
4637;13;5699951;4637;485;5776;5776;4.27;0.26;294.07;3.25;1139;20;1978.00;0
4641;13;5699961;4641;477;5776;5776;4.16;0.25;293.95;3.25;1135;20;1979.00;0
4644;13;5699974;4644;458;5805;5810;4.29;0.26;294.00;3.23;1161;20;1980.00;5
4645;13;5699988;4645;445;5805;5810;4.31;0.26;294.02;3.23;1160;20;1981.00;5
4648;13;5699998;4648;430;5809;5810;4.35;0.27;294.09;3.23;1161;20;1982.00;1
4651;13;5700011;4651;431;5809;5810;4.38;0.27;294.19;3.23;1158;20;1983.00;1
4653;13;5700021;4653;428;5810;5810;4.42;0.27;294.19;3.23;1157;20;1984.00;0
4654;13;5700032;4654;417;5810;5810;4.46;0.27;294.24;3.23;1156;20;1985.00;0
4656;13;5700043;4656;415;5811;5811;4.47;0.27;294.26;3.23;1155;20;1986.00;0
4657;13;5700054;4657;413;5811;5811;4.54;0.28;294.26;3.23;1154;20;1987.00;0
4658;13;5700065;4658;418;5817;5817;4.65;0.29;294.20;3.23;1159;20;1988.00;0
4660;13;5700076;4660;410;5818;5818;4.70;0.29;294.27;3.23;1158;20;1989.00;0
4662;13;5700088;4662;408;5818;5818;4.70;0.29;294.30;3.23;1156;20;1990.00;0
4664;13;5700099;4664;398;5818;5818;4.70;0.29;294.29;3.23;1154;20;1991.00;0
4665;13;5700115;4665;397;5822;5822;4.75;0.29;294.34;3.22;1157;20;1992.00;0
4668;13;5700144;4668;391;5822;5822;4.82;0.29;294.42;3.22;1154;20;1993.00;0
4670;13;5700158;4670;384;5822;5822;4.88;0.30;294.46;3.22;1152;20;1994.00;0
4671;13;5700170;4671;380;5823;5823;4.96;0.30;294.42;3.22;1152;20;1995.00;0
4673;13;5700181;4673;384;5827;5827;5.05;0.31;294.43;3.22;1154;20;1996.00;0
4675;13;5700193;4675;388;5827;5827;5.14;0.31;294.46;3.22;1152;20;1997.00;0
4679;13;5700204;4679;397;5829;5830;5.22;0.32;294.37;3.22;1150;20;1998.00;1
4686;13;5700216;4686;406;5829;5830;5.25;0.32;294.62;3.22;1143;20;1999.00;1
4688;13;5700229;4688;397;5830;5830;5.32;0.33;294.65;3.22;1142;20;2000.00;0
4692;13;5700245;4692;388;5830;5830;5.36;0.33;294.77;3.22;1138;20;2001.00;0
4696;13;5700256;4696;385;5834;5834;5.46;0.33;294.74;3.22;1138;20;2002.00;0
4698;13;5700268;4698;379;5834;5834;5.54;0.34;294.78;3.22;1136;20;2003.00;0
4705;13;5700280;4705;373;5834;5834;5.56;0.34;295.04;3.22;1129;20;2004.00;0
4708;13;5700293;4708;373;5834;5834;5.64;0.35;295.02;3.22;1126;20;2005.00;0
4711;13;5700306;4711;372;5835;5835;5.74;0.35;295.01;3.22;1124;20;2006.00;0
4719;13;5700320;4719;373;5836;5836;5.78;0.35;295.18;3.22;1117;20;2007.00;0
4721;13;5700333;4721;370;5836;5836;5.85;0.36;295.25;3.22;1115;20;2008.00;0
4728;13;5700344;4728;372;5837;5837;5.83;0.36;295.51;3.22;1109;20;2009.00;0
4731;13;5700359;4731;368;5837;5837;5.82;0.36;295.64;3.22;1106;20;2010.00;0
4738;13;5700370;4738;368;5837;5837;5.78;0.35;295.88;3.22;1099;20;2011.00;0
4742;13;5700383;4742;376;5837;5837;5.78;0.35;296.01;3.22;1095;20;2012.00;0
4746;13;5700395;4746;372;5837;5837;5.79;0.35;296.13;3.22;1091;20;2013.00;0
4750;13;5700407;4750;378;5837;5837;5.82;0.35;296.22;3.22;1087;20;2014.00;0
4757;13;5700420;4757;374;5837;5837;5.83;0.36;296.35;3.22;1080;20;2015.00;0
4759;13;5700432;4759;393;5919;5964;6.07;0.38;296.45;3.17;1160;20;2016.00;45
4762;13;5700454;4762;378;5921;5965;6.14;0.38;296.53;3.17;1159;20;2017.00;44
4769;13;5700473;4769;376;5927;5965;6.18;0.38;296.55;3.17;1158;20;2018.00;38
4772;13;5700485;4772;375;5928;5965;6.16;0.38;296.62;3.17;1156;20;2019.00;37
4779;13;5700498;4779;371;5932;5965;6.20;0.38;296.68;3.17;1153;20;2020.00;33
4781;13;5700510;4781;375;5933;5965;6.21;0.38;296.70;3.17;1152;20;2021.00;32
4786;13;5700522;4786;379;5937;5965;6.16;0.38;296.69;3.18;1151;20;2022.00;28
4792;13;5700535;4792;389;5940;5965;6.12;0.38;296.83;3.18;1148;20;2023.00;25
4793;13;5700548;4793;392;5940;5966;6.10;0.37;296.80;3.18;1147;20;2024.00;26
4797;13;5700562;4797;398;5942;5968;6.02;0.37;296.93;3.18;1145;20;2025.00;26
4802;13;5700575;4802;409;5943;5968;5.95;0.36;297.07;3.18;1141;20;2026.00;25
4804;13;5700589;4804;409;5946;5969;5.91;0.36;297.07;3.18;1142;20;2027.00;23
4806;13;5700601;4806;407;5947;5969;5.89;0.36;297.16;3.18;1141;20;2028.00;22
4810;13;5700614;4810;405;5948;5969;5.86;0.36;297.18;3.19;1138;20;2029.00;21
4813;13;5700626;4813;411;5949;5969;5.82;0.36;297.19;3.19;1136;20;2030.00;20
4815;13;5700639;4815;408;5956;5973;5.80;0.35;297.27;3.19;1141;20;2031.00;17
4816;13;5700653;4816;411;5956;5973;5.77;0.35;297.36;3.19;1140;20;2032.00;17
4820;13;5700665;4820;408;5960;5973;5.70;0.35;297.43;3.20;1140;20;2033.00;13
4822;13;5700678;4822;415;5961;5976;5.67;0.35;297.63;3.20;1139;20;2034.00;15
4826;13;5700691;4826;424;5963;5976;5.64;0.34;297.87;3.20;1137;20;2035.00;13
4827;13;5700709;4827;412;5965;5976;5.65;0.35;297.90;3.21;1138;20;2036.00;11
4833;13;5700722;4833;408;5970;5980;5.62;0.34;298.25;3.21;1137;20;2037.00;10
4835;13;5700736;4835;407;5971;5981;5.63;0.34;298.21;3.22;1136;20;2038.00;10
4837;13;5700748;4837;396;5972;5981;5.65;0.34;298.45;3.22;1135;20;2039.00;9
4840;13;5700762;4840;392;5975;5986;5.64;0.34;298.59;3.22;1135;20;2040.00;11
4842;13;5700777;4842;389;5975;5986;5.70;0.35;298.58;3.22;1133;20;2041.00;11
4843;13;5700789;4843;397;5976;5986;5.74;0.35;298.58;3.22;1133;20;2042.00;10
4844;13;5700802;4844;400;5977;5987;5.80;0.35;298.57;3.22;1133;20;2043.00;10
4845;13;5700815;4845;403;5977;5987;5.80;0.35;298.63;3.22;1132;20;2044.00;10
4846;13;5700828;4846;412;5984;5993;5.76;0.35;298.66;3.22;1138;20;2045.00;9
4848;13;5700842;4848;419;5984;5993;5.70;0.35;298.80;3.22;1136;20;2046.00;9
4849;13;5700855;4849;417;5984;5994;5.72;0.35;298.93;3.22;1135;20;2047.00;10
4851;13;5700868;4851;417;5984;5994;5.74;0.35;298.99;3.22;1133;20;2048.00;10
4853;13;5700880;4853;417;5984;5994;5.76;0.35;298.94;3.22;1131;20;2049.00;10
4857;13;5700893;4857;413;5984;5994;5.71;0.35;299.20;3.22;1127;20;2050.00;10
4857;13;5700905;4857;416;5984;5994;5.75;0.35;299.20;3.22;1127;20;2051.00;10
4860;13;5700917;4860;424;5992;6006;5.75;0.35;299.32;3.21;1132;20;2052.00;14
4861;13;5700930;4861;409;5994;6006;5.77;0.35;299.43;3.21;1133;20;2053.00;12
4863;13;5700943;4863;406;5995;6006;5.79;0.35;299.52;3.21;1132;20;2054.00;11
4867;13;5700956;4867;406;5995;6006;5.80;0.35;299.69;3.21;1128;20;2055.00;11
4869;13;5700968;4869;405;5995;6006;5.78;0.35;299.81;3.21;1126;20;2056.00;11
4869;13;5700981;4869;400;5995;6006;5.79;0.35;299.81;3.21;1126;20;2057.00;11
4869;13;5700993;4869;401;5998;6010;5.76;0.35;299.81;3.21;1129;20;2058.00;12
4871;13;5701005;4871;403;5998;6010;5.77;0.35;299.83;3.21;1127;20;2059.00;12
4873;13;5701017;4873;406;6002;6014;5.82;0.35;299.83;3.21;1129;20;2060.00;12
4878;13;5701029;4878;404;6003;6015;5.76;0.35;300.08;3.21;1125;20;2061.00;12
4878;13;5701047;4878;399;6003;6015;5.77;0.35;300.08;3.21;1125;20;2062.00;12
4881;13;5701058;4881;403;6003;6015;5.68;0.34;300.18;3.21;1122;20;2063.00;12
4882;13;5701070;4882;410;6014;6028;5.68;0.35;300.19;3.20;1132;20;2064.00;14
4884;13;5701082;4884;414;6014;6028;5.64;0.34;300.25;3.20;1130;20;2065.00;14
4887;13;5701094;4887;410;6014;6028;5.61;0.34;300.22;3.20;1127;20;2066.00;14
4888;13;5701106;4888;418;6015;6029;5.56;0.34;300.20;3.20;1127;20;2067.00;14
4893;13;5701117;4893;433;6015;6030;5.50;0.33;300.58;3.20;1122;20;2068.00;15
4897;13;5701130;4897;428;6015;6030;5.46;0.33;300.55;3.20;1118;20;2069.00;15
4901;13;5701143;4901;423;6019;6036;5.45;0.33;300.61;3.20;1118;20;2070.00;17
4901;13;5701156;4901;416;6019;6036;5.38;0.33;300.61;3.20;1118;20;2071.00;17
4905;13;5701171;4905;412;6021;6036;5.37;0.33;300.88;3.20;1116;20;2072.00;15
4906;13;5701184;4906;409;6021;6036;5.34;0.32;300.87;3.20;1115;20;2073.00;15
4906;13;5701202;4906;406;6026;6042;5.36;0.33;300.87;3.20;1120;20;2074.00;16
4906;13;5701216;4906;399;6026;6042;5.37;0.33;300.87;3.20;1120;20;2075.00;16
4907;13;5701228;4907;402;6026;6042;5.36;0.33;300.98;3.20;1119;20;2076.00;16
4909;13;5701239;4909;398;6026;6042;5.37;0.33;301.08;3.20;1117;20;2077.00;16
4913;13;5701252;4913;395;6029;6046;5.35;0.33;301.22;3.20;1116;20;2078.00;17
4916;13;5701265;4916;396;6030;6047;5.37;0.33;301.32;3.19;1114;20;2079.00;17
4920;13;5701277;4920;398;6030;6047;5.32;0.32;301.53;3.19;1110;20;2080.00;17
4921;13;5701289;4921;391;6031;6048;5.30;0.32;301.56;3.19;1110;20;2081.00;17
4924;13;5701300;4924;389;6031;6048;5.25;0.32;301.60;3.19;1107;20;2082.00;17
4927;13;5701312;4927;389;6031;6048;5.19;0.31;301.72;3.19;1104;20;2083.00;17
4928;13;5701325;4928;392;6031;6048;5.21;0.32;301.77;3.19;1103;20;2084.00;17
4931;13;5701336;4931;398;6033;6048;5.18;0.31;301.72;3.22;1102;20;2085.00;15
4934;13;5701350;4934;401;6033;6048;5.15;0.31;301.83;3.22;1099;20;2086.00;15
4937;13;5701365;4937;403;6033;6048;5.12;0.31;301.84;3.22;1096;20;2087.00;15
4939;13;5701383;4939;406;6067;6118;5.30;0.32;301.81;3.20;1128;20;2088.00;51
4941;13;5701410;4941;406;6069;6119;5.35;0.33;301.79;3.21;1128;20;2089.00;50
4942;13;5701427;4942;401;6078;6119;5.42;0.33;301.76;3.21;1136;20;2090.00;41
4944;13;5701448;4944;399;6081;6119;5.41;0.33;301.95;3.21;1137;20;2091.00;38
4948;13;5701471;4948;393;6084;6119;5.39;0.33;301.81;3.21;1136;20;2092.00;35
4949;13;5701493;4949;400;6088;6119;5.36;0.33;301.79;3.21;1139;20;2093.00;31
4951;13;5701512;4951;406;6091;6119;5.31;0.32;301.70;3.21;1140;20;2094.00;28
4952;13;5701526;4952;408;6095;6119;5.29;0.32;301.70;3.21;1143;20;2095.00;24
4954;13;5701538;4954;407;6097;6120;5.27;0.32;301.73;3.21;1143;20;2096.00;23
4957;13;5701550;4957;400;6099;6121;5.27;0.32;301.64;3.22;1142;20;2097.00;22
4958;13;5701562;4958;398;6102;6121;5.29;0.32;301.59;3.22;1144;20;2098.00;19
4960;13;5701574;4960;402;6106;6125;5.33;0.32;301.51;3.22;1146;20;2099.00;19
4961;13;5701588;4961;411;6110;6140;5.29;0.32;301.45;3.22;1149;20;2100.00;30
4962;13;5701606;4962;405;6110;6140;5.25;0.32;301.44;3.22;1148;20;2101.00;30
4962;13;5701618;4962;406;6110;6140;5.25;0.32;301.44;3.22;1148;20;2102.00;30
4964;13;5701629;4964;401;6114;6146;5.30;0.32;301.42;3.21;1150;20;2103.00;32
4964;13;5701642;4964;407;6114;6146;5.27;0.32;301.42;3.21;1150;20;2104.00;32
4965;13;5701654;4965;409;6115;6146;5.23;0.32;301.38;3.21;1150;20;2105.00;31
4967;13;5701666;4967;415;6118;6149;5.22;0.32;301.33;3.21;1151;20;2106.00;31
4968;13;5701677;4968;415;6119;6149;5.18;0.32;301.32;3.21;1151;20;2107.00;30
4969;13;5701688;4969;419;6119;6149;5.14;0.31;301.27;3.21;1150;20;2108.00;30
4970;13;5701699;4970;430;6119;6150;5.11;0.31;301.22;3.21;1149;20;2109.00;31
4972;13;5701711;4972;436;6121;6151;5.09;0.31;301.17;3.23;1149;20;2110.00;30
4973;13;5701723;4973;450;6122;6151;5.03;0.31;301.13;3.23;1149;20;2111.00;29
4977;13;5701734;4977;453;6133;6164;5.00;0.31;300.99;3.24;1156;20;2112.00;31
4978;13;5701747;4978;452;6133;6164;4.97;0.30;300.99;3.24;1155;20;2113.00;31
4980;13;5701758;4980;455;6135;6164;4.95;0.30;300.94;3.25;1155;20;2114.00;29
4983;13;5701769;4983;458;6138;6166;4.90;0.30;300.96;3.27;1155;20;2115.00;28
4984;13;5701780;4984;466;6139;6166;4.83;0.30;300.93;3.27;1155;20;2116.00;27
4986;13;5701792;4986;467;6142;6170;4.77;0.29;300.86;3.27;1156;20;2117.00;28
4986;13;5701803;4986;476;6144;6170;4.70;0.29;300.86;3.28;1158;20;2118.00;26
4987;13;5701814;4987;477;6147;6174;4.68;0.29;300.83;3.28;1160;20;2119.00;27
4990;13;5701827;4990;485;6148;6174;4.63;0.28;300.69;3.29;1158;20;2120.00;26
4992;13;5701838;4992;489;6149;6174;4.58;0.28;300.62;3.29;1157;20;2121.00;25
4994;13;5701849;4994;488;6149;6174;4.54;0.28;300.58;3.29;1155;20;2122.00;25
4997;13;5701860;4997;492;6150;6174;4.49;0.27;300.50;3.31;1153;20;2123.00;24
4997;13;5701871;4997;504;6160;6186;4.50;0.28;300.50;3.31;1163;20;2124.00;26
5000;13;5701881;5000;492;6162;6186;4.49;0.27;300.55;3.32;1162;20;2125.00;24
5003;13;5701892;5003;482;6162;6186;4.51;0.27;300.47;3.32;1159;20;2126.00;24
5004;13;5701903;5004;484;6166;6186;4.52;0.27;300.46;3.33;1162;20;2127.00;20
5005;13;5701914;5005;480;6168;6186;4.50;0.27;300.46;3.35;1163;20;2128.00;18
5006;13;5701925;5006;471;6170;6186;4.52;0.27;300.43;3.36;1164;20;2129.00;16
5007;13;5701937;5007;460;6171;6187;4.51;0.27;300.43;3.37;1164;20;2130.00;16
5008;13;5701948;5008;460;6171;6187;4.52;0.28;300.42;3.37;1163;20;2131.00;16
5008;13;5701959;5008;456;6176;6193;4.61;0.28;300.42;3.37;1168;20;2132.00;17
5009;13;5701971;5009;451;6179;6194;4.62;0.28;300.40;3.38;1170;20;2133.00;15
5010;13;5701983;5010;448;6181;6194;4.63;0.28;300.36;3.40;1171;20;2134.00;13
5012;13;5701999;5012;446;6181;6194;4.65;0.28;300.31;3.40;1169;20;2135.00;13
5015;13;5702010;5015;447;6183;6198;4.67;0.28;300.42;3.40;1168;20;2136.00;15
5016;13;5702022;5016;449;6186;6198;4.66;0.28;300.39;3.41;1170;20;2137.00;12
5018;13;5702033;5018;452;6187;6198;4.65;0.28;300.40;3.42;1169;20;2138.00;11
5020;13;5702044;5020;452;6188;6199;4.63;0.28;300.34;3.41;1168;20;2139.00;11
5021;13;5702061;5021;453;6191;6203;4.61;0.28;300.35;3.41;1170;20;2140.00;12
5022;13;5702073;5022;447;6191;6203;4.57;0.28;300.37;3.41;1169;20;2141.00;12
5024;13;5702084;5024;451;6193;6206;4.55;0.27;300.32;3.41;1169;20;2142.00;13
5024;13;5702097;5024;454;6196;6206;4.53;0.27;300.32;3.43;1172;20;2143.00;10
5025;13;5702108;5025;454;6197;6206;4.57;0.28;300.30;3.43;1172;20;2144.00;9
5029;13;5702119;5029;437;6197;6206;4.52;0.27;300.41;3.43;1168;20;2145.00;9
5030;13;5702131;5030;432;6201;6210;4.59;0.28;300.41;3.43;1171;20;2146.00;9
5036;13;5702143;5036;426;6201;6210;4.55;0.28;300.52;3.43;1165;20;2147.00;9
5036;13;5702155;5036;426;6201;6210;4.58;0.28;300.52;3.43;1165;20;2148.00;9
5042;13;5702166;5042;429;6201;6210;4.60;0.28;300.58;3.43;1159;20;2149.00;9
5045;13;5702177;5045;429;6201;6211;4.63;0.28;300.56;3.43;1156;20;2150.00;10
5050;13;5702189;5050;431;6202;6212;4.64;0.28;300.57;3.43;1152;20;2151.00;10
5054;13;5702200;5054;421;6202;6212;4.68;0.28;300.56;3.43;1148;20;2152.00;10
5057;13;5702213;5057;414;6203;6213;4.72;0.29;300.59;3.43;1146;20;2153.00;10
5058;13;5702225;5058;412;6203;6213;4.79;0.29;300.56;3.43;1145;20;2154.00;10
5061;13;5702236;5061;410;6203;6213;4.82;0.29;300.74;3.43;1142;20;2155.00;10
5063;13;5702249;5063;400;6203;6213;4.88;0.30;300.87;3.43;1140;20;2156.00;10
5067;13;5702264;5067;392;6203;6213;4.91;0.30;300.96;3.43;1136;20;2157.00;10
5071;13;5702278;5071;384;6203;6213;4.96;0.30;300.90;3.43;1132;20;2158.00;10
5075;13;5702292;5075;377;6203;6213;5.00;0.30;301.19;3.43;1128;20;2159.00;10
5079;13;5702306;5079;399;6303;6443;5.53;0.35;301.11;3.37;1224;20;2160.00;140
5081;13;5702341;5081;386;6314;6444;5.62;0.35;301.11;3.37;1233;20;2161.00;130
5085;13;5702355;5085;385;6327;6444;5.73;0.36;301.29;3.37;1242;20;2162.00;117
5090;13;5702368;5090;383;6335;6444;5.70;0.35;301.34;3.36;1245;20;2163.00;109
5093;13;5702381;5093;382;6343;6444;5.75;0.36;301.53;3.37;1250;20;2164.00;101
5095;13;5702394;5095;379;6352;6444;5.71;0.35;301.60;3.37;1257;20;2165.00;92
5099;13;5702407;5099;371;6359;6444;5.69;0.35;301.79;3.37;1260;20;2166.00;85
5101;13;5702422;5101;376;6366;6444;5.66;0.35;301.90;3.37;1265;20;2167.00;78
5105;13;5702444;5105;383;6373;6445;5.59;0.34;301.97;3.38;1268;20;2168.00;72
5107;13;5702458;5107;390;6376;6446;5.61;0.35;302.10;3.38;1269;20;2169.00;70
5110;13;5702471;5110;392;6378;6446;5.58;0.34;302.29;3.38;1268;20;2170.00;68
5114;13;5702485;5114;403;6383;6447;5.53;0.34;302.39;3.39;1269;20;2171.00;64
5117;13;5702499;5117;409;6384;6447;5.47;0.34;302.55;3.39;1267;20;2172.00;63
5124;13;5702513;5124;414;6384;6447;5.40;0.33;302.54;3.39;1260;20;2173.00;63
5126;13;5702528;5126;422;6389;6447;5.34;0.33;302.71;3.40;1263;20;2174.00;58
5130;13;5702542;5130;429;6391;6451;5.29;0.32;302.81;3.40;1261;20;2175.00;60
5134;13;5702556;5134;432;6393;6451;5.21;0.32;303.00;3.40;1259;20;2176.00;58
5136;13;5702571;5136;438;6395;6451;5.15;0.32;303.18;3.41;1259;20;2177.00;56
5138;13;5702585;5138;451;6395;6454;5.14;0.32;303.22;3.41;1257;20;2178.00;59
5143;13;5702598;5143;451;6397;6454;5.13;0.31;303.36;3.41;1254;20;2179.00;57
5144;13;5702619;5144;451;6397;6454;5.14;0.32;303.51;3.41;1253;20;2180.00;57
5148;13;5702632;5148;450;6400;6458;5.25;0.32;303.59;3.41;1252;20;2181.00;58
5151;13;5702646;5151;444;6401;6459;5.29;0.32;303.61;3.41;1250;20;2182.00;58
5154;13;5702660;5154;449;6401;6459;5.33;0.33;303.82;3.41;1247;20;2183.00;58
5156;13;5702674;5156;452;6402;6463;5.34;0.33;303.84;3.42;1246;20;2184.00;61
5158;13;5702694;5158;454;6403;6463;5.35;0.33;303.94;3.42;1245;20;2185.00;60
5159;13;5702708;5159;461;6403;6463;5.36;0.33;303.94;3.42;1244;20;2186.00;60
5164;13;5702722;5164;462;6404;6464;5.30;0.32;304.10;3.42;1240;20;2187.00;60
5165;13;5702736;5165;466;6407;6464;5.26;0.32;304.07;3.43;1242;20;2188.00;57
5167;13;5702750;5167;467;6410;6470;5.20;0.32;304.08;3.43;1243;20;2189.00;60
5170;13;5702765;5170;467;6410;6470;5.16;0.32;304.21;3.43;1240;20;2190.00;60
5172;13;5702780;5172;474;6410;6471;5.17;0.32;304.21;3.43;1238;20;2191.00;61
5175;13;5702793;5175;472;6410;6471;5.19;0.32;304.41;3.43;1235;20;2192.00;61
5176;13;5702808;5176;466;6411;6471;5.22;0.32;304.42;3.44;1235;20;2193.00;60
5179;13;5702825;5179;462;6412;6471;5.21;0.32;304.71;3.44;1233;20;2194.00;59
5181;13;5702839;5181;466;6413;6471;5.26;0.32;304.84;3.44;1232;20;2195.00;58
5184;13;5702853;5184;467;6419;6483;5.29;0.32;304.94;3.44;1235;20;2196.00;64
5188;13;5702869;5188;470;6421;6483;5.32;0.33;305.24;3.45;1233;20;2197.00;62
5191;13;5702884;5191;472;6424;6483;5.37;0.33;305.30;3.46;1233;20;2198.00;59
5196;13;5702899;5196;473;6425;6483;5.41;0.33;305.46;3.46;1229;20;2199.00;58
5201;13;5702916;5201;480;6426;6483;5.39;0.33;305.57;3.47;1225;20;2200.00;57
5202;13;5702939;5202;474;6430;6483;5.41;0.33;305.55;3.48;1228;20;2201.00;53
5207;13;5702954;5207;464;6434;6487;5.39;0.33;305.65;3.48;1227;20;2202.00;53
5208;13;5702969;5208;458;6435;6487;5.44;0.33;305.72;3.48;1227;20;2203.00;52
5211;13;5702983;5211;460;6440;6491;5.43;0.33;305.79;3.50;1229;20;2204.00;51
5214;14;5702998;5214;461;6442;6493;5.45;0.33;305.84;3.50;1228;21;2205.00;51
5220;14;5703025;5220;470;6444;6493;5.38;0.33;306.44;3.51;1224;21;2206.00;49
5222;14;5703040;5222;476;6447;6493;5.38;0.33;306.43;3.51;1225;21;2207.00;46
5224;14;5703054;5224;481;6454;6506;5.44;0.33;306.50;3.51;1230;21;2208.00;52
5227;14;5703072;5227;485;6457;6506;5.45;0.33;306.65;3.51;1230;21;2209.00;49
5230;14;5703085;5230;495;6459;6508;5.44;0.33;306.70;3.51;1229;21;2210.00;49
5234;14;5703099;5234;498;6460;6509;5.46;0.33;306.84;3.51;1226;21;2211.00;49
5235;14;5703113;5235;497;6462;6510;5.49;0.34;306.91;3.51;1227;21;2212.00;48
5238;14;5703126;5238;503;6463;6510;5.47;0.33;307.00;3.51;1225;21;2213.00;47
5243;14;5703141;5243;487;6466;6513;5.47;0.33;307.18;3.52;1223;21;2214.00;47
5244;14;5703156;5244;484;6467;6513;5.50;0.34;307.25;3.51;1223;21;2215.00;46
5249;14;5703181;5249;482;6467;6513;5.56;0.34;307.43;3.51;1218;21;2216.00;46
5250;14;5703207;5250;486;6467;6513;5.60;0.34;307.44;3.51;1217;21;2217.00;46
5256;14;5703232;5256;480;6472;6519;5.55;0.34;307.57;3.51;1216;21;2218.00;47
5260;14;5703258;5260;482;6472;6519;5.55;0.34;307.69;3.51;1212;21;2219.00;47
5261;14;5703278;5261;475;6472;6519;5.56;0.34;307.72;3.51;1211;21;2220.00;47
5267;14;5703297;5267;482;6472;6519;5.54;0.34;307.94;3.51;1205;21;2221.00;47
5268;14;5703314;5268;482;6475;6523;5.51;0.33;307.89;3.51;1207;21;2222.00;48
5271;14;5703332;5271;490;6476;6524;5.51;0.33;307.89;3.51;1205;21;2223.00;48
5275;14;5703348;5275;495;6476;6524;5.45;0.33;307.94;3.51;1201;21;2224.00;48
5276;14;5703370;5276;494;6477;6525;5.43;0.33;307.99;3.51;1201;21;2225.00;48
5279;14;5703385;5279;489;6477;6525;5.32;0.32;308.03;3.51;1198;21;2226.00;48
5281;14;5703399;5281;492;6477;6525;5.22;0.32;308.00;3.51;1196;21;2227.00;48
5282;14;5703412;5282;496;6477;6525;5.20;0.32;308.06;3.51;1195;21;2228.00;48
5284;14;5703425;5284;495;6477;6525;5.15;0.31;308.20;3.51;1193;21;2229.00;48
5284;14;5703439;5284;506;6478;6525;5.10;0.31;308.20;3.52;1194;21;2230.00;47
5286;14;5703451;5286;511;6478;6525;5.06;0.31;308.24;3.52;1192;21;2231.00;47
5287;14;5703464;5287;515;6506;6595;5.10;0.31;308.27;3.51;1219;21;2232.00;89
5288;14;5703484;5288;516;6507;6596;5.07;0.31;308.25;3.51;1219;21;2233.00;89
5288;14;5703498;5288;522;6513;6596;5.11;0.31;308.25;3.50;1225;21;2234.00;83
5290;14;5703511;5290;523;6517;6596;5.11;0.31;308.30;3.50;1227;21;2235.00;79
5290;14;5703525;5290;524;6521;6596;5.09;0.31;308.30;3.52;1231;21;2236.00;75
5292;14;5703537;5292;520;6524;6596;5.05;0.31;308.30;3.52;1232;21;2237.00;72
5294;14;5703550;5294;525;6528;6596;5.04;0.31;308.28;3.53;1234;21;2238.00;68
5296;14;5703563;5296;521;6530;6596;5.00;0.31;308.29;3.53;1234;21;2239.00;66
5297;14;5703576;5297;517;6533;6597;5.00;0.31;308.26;3.53;1236;21;2240.00;64
5300;14;5703589;5300;511;6535;6598;4.95;0.30;308.24;3.54;1235;21;2241.00;63
5302;14;5703603;5302;510;6537;6598;4.96;0.30;308.29;3.55;1235;21;2242.00;61
5306;14;5703617;5306;508;6541;6602;4.94;0.30;308.29;3.55;1235;21;2243.00;61
5309;14;5703631;5309;508;6542;6602;4.90;0.30;308.41;3.55;1233;21;2244.00;60
5312;14;5703644;5312;510;6545;6602;4.85;0.30;308.45;3.56;1233;21;2245.00;57
5317;14;5703658;5317;502;6545;6602;4.77;0.29;308.48;3.56;1228;21;2246.00;57
5319;14;5703670;5319;495;6549;6608;4.83;0.29;308.40;3.56;1230;21;2247.00;59
5323;14;5703683;5323;495;6549;6608;4.81;0.29;308.39;3.56;1226;21;2248.00;59
5326;14;5703696;5326;490;6551;6608;4.77;0.29;308.39;3.59;1225;21;2249.00;57
5330;14;5703712;5330;485;6556;6614;4.77;0.29;308.33;3.61;1226;21;2250.00;58
5331;14;5703725;5331;482;6558;6614;4.79;0.29;308.32;3.61;1227;21;2251.00;56
5335;14;5703738;5335;484;6559;6614;4.79;0.29;308.30;3.61;1224;21;2252.00;55
5339;14;5703750;5339;480;6559;6615;4.79;0.29;308.20;3.61;1220;21;2253.00;56
5340;14;5703763;5340;481;6561;6616;4.85;0.30;308.24;3.63;1221;21;2254.00;55
5343;14;5703776;5343;477;6561;6616;4.86;0.30;308.21;3.63;1218;21;2255.00;55
5343;14;5703788;5343;485;6569;6629;4.93;0.30;308.21;3.62;1226;21;2256.00;60
5347;14;5703801;5347;485;6571;6629;4.85;0.30;308.12;3.64;1224;21;2257.00;58
5350;14;5703813;5350;481;6571;6629;4.82;0.29;308.15;3.64;1221;21;2258.00;58
5351;14;5703826;5351;487;6572;6630;4.80;0.29;308.10;3.64;1221;21;2259.00;58
5355;14;5703838;5355;493;6574;6630;4.71;0.29;308.02;3.65;1219;21;2260.00;56
5356;14;5703850;5356;492;6577;6634;4.70;0.29;308.14;3.65;1221;21;2261.00;57
5358;14;5703863;5358;494;6579;6634;4.67;0.28;308.12;3.67;1221;21;2262.00;55
5359;14;5703875;5359;503;6582;6638;4.62;0.28;308.17;3.67;1223;21;2263.00;56
5362;14;5703887;5362;504;6584;6638;4.59;0.28;308.16;3.69;1222;21;2264.00;54
5362;14;5703899;5362;504;6584;6638;4.57;0.28;308.16;3.69;1222;21;2265.00;54
5362;14;5703911;5362;501;6587;6638;4.56;0.28;308.16;3.72;1225;21;2266.00;51
5367;14;5703922;5367;503;6587;6638;4.50;0.27;308.03;3.72;1220;21;2267.00;51
5368;14;5703935;5368;508;6600;6650;4.55;0.28;308.06;3.72;1232;21;2268.00;50
5370;14;5703952;5370;509;6600;6650;4.54;0.28;308.03;3.72;1230;21;2269.00;50
5373;14;5703966;5373;513;6602;6650;4.56;0.28;307.99;3.73;1229;21;2270.00;48
5374;14;5703980;5374;507;6603;6650;4.56;0.28;307.97;3.74;1229;21;2271.00;47
5376;14;5703993;5376;494;6603;6650;4.56;0.28;307.96;3.74;1227;21;2272.00;47
5377;14;5704005;5377;502;6603;6650;4.56;0.28;307.94;3.74;1226;21;2273.00;47
5378;14;5704017;5378;494;6604;6651;4.58;0.28;307.95;3.74;1226;21;2274.00;47
5379;14;5704030;5379;492;6606;6651;4.56;0.28;307.93;3.79;1227;21;2275.00;45
5379;14;5704043;5379;489;6613;6657;4.63;0.28;307.93;3.79;1234;21;2276.00;44
5379;14;5704057;5379;484;6616;6658;4.67;0.28;307.93;3.84;1237;21;2277.00;42
5380;14;5704070;5380;478;6617;6658;4.68;0.29;307.87;3.85;1237;21;2278.00;41
5381;14;5704083;5381;482;6618;6658;4.72;0.29;307.86;3.88;1237;21;2279.00;40
5384;14;5704097;5384;480;6621;6663;4.75;0.29;307.91;3.87;1237;21;2280.00;42
5385;14;5704110;5385;487;6623;6663;4.80;0.29;307.93;3.89;1238;21;2281.00;40
5387;14;5704130;5387;490;6624;6663;4.83;0.30;308.00;3.91;1237;21;2282.00;39
5389;14;5704143;5389;482;6626;6664;4.82;0.29;307.97;3.93;1237;21;2283.00;38
5389;14;5704156;5389;481;6630;6668;4.83;0.30;307.97;3.95;1241;21;2284.00;38
5393;14;5704169;5393;479;6630;6668;4.82;0.29;308.00;3.95;1237;21;2285.00;38
5394;14;5704184;5394;484;6633;6671;4.85;0.30;308.14;3.97;1239;21;2286.00;38
5395;14;5704198;5395;481;6635;6671;4.84;0.30;308.11;3.99;1240;21;2287.00;36
5397;14;5704210;5397;485;6635;6671;4.86;0.30;308.04;3.99;1238;21;2288.00;36
5399;14;5704251;5399;489;6636;6671;4.83;0.30;308.00;4.01;1237;21;2289.00;35
5401;14;5704277;5401;489;6641;6675;4.87;0.30;307.94;4.02;1240;21;2290.00;34
5402;14;5704291;5402;497;6641;6675;4.88;0.30;307.92;4.02;1239;21;2291.00;34
5404;14;5704303;5404;492;6643;6675;4.91;0.30;307.87;4.06;1239;22;2292.00;32
5407;14;5704324;5407;496;6643;6675;4.87;0.30;307.76;4.06;1236;22;2293.00;32
5408;14;5704337;5408;488;6643;6676;4.92;0.30;307.76;4.06;1235;22;2294.00;33
5409;14;5704351;5409;484;6647;6678;4.95;0.30;307.87;4.10;1238;22;2295.00;31
5411;14;5704364;5411;478;6647;6678;4.95;0.30;307.93;4.10;1236;22;2296.00;31
5414;14;5704377;5414;474;6650;6679;4.95;0.30;308.20;4.13;1236;22;2297.00;29
5417;14;5704390;5417;466;6650;6679;5.00;0.31;308.22;4.13;1233;22;2298.00;29
5417;14;5704403;5417;459;6650;6679;5.03;0.31;308.22;4.13;1233;22;2299.00;29
5417;14;5704416;5417;455;6651;6679;5.05;0.31;308.22;4.15;1234;22;2300.00;28
5419;14;5704432;5419;460;6651;6679;5.06;0.31;308.27;4.15;1232;22;2301.00;28
5421;14;5704445;5421;459;6651;6679;5.05;0.31;308.35;4.15;1230;22;2302.00;28
5421;14;5704457;5421;458;6651;6679;5.06;0.31;308.35;4.15;1230;22;2303.00;28
5425;14;5704468;5425;481;6730;6806;5.25;0.33;308.49;4.10;1305;22;2304.00;76
5430;14;5704489;5430;474;6734;6807;5.23;0.32;308.67;4.10;1304;22;2305.00;73
5434;14;5704502;5434;478;6742;6807;5.21;0.32;308.83;4.09;1308;22;2306.00;65
5435;14;5704515;5435;464;6745;6807;5.19;0.32;308.97;4.09;1310;22;2307.00;62
5439;14;5704527;5439;461;6749;6807;5.15;0.32;308.99;4.09;1310;22;2308.00;58
5442;14;5704539;5442;452;6750;6807;5.07;0.31;309.06;4.09;1308;22;2309.00;57
5446;14;5704553;5446;438;6752;6807;4.96;0.31;309.07;4.09;1306;22;2310.00;55
5449;14;5704566;5449;439;6753;6807;4.89;0.30;309.16;4.10;1304;22;2311.00;54
5453;14;5704578;5453;431;6754;6808;4.85;0.30;309.23;4.10;1301;22;2312.00;54
5456;14;5704590;5456;429;6755;6809;4.83;0.30;309.33;4.10;1299;22;2313.00;54
5460;14;5704608;5460;432;6756;6809;4.85;0.30;309.46;4.10;1296;22;2314.00;53
5464;14;5704625;5464;429;6759;6810;4.85;0.30;309.51;4.10;1295;22;2315.00;51
5467;14;5704646;5467;438;6760;6810;4.92;0.30;309.74;4.10;1293;22;2316.00;50
5471;14;5704673;5471;435;6760;6810;4.96;0.31;309.81;4.10;1289;22;2317.00;50
5474;14;5704701;5474;438;6762;6810;5.00;0.31;309.82;4.10;1288;22;2318.00;48
5476;14;5704726;5476;422;6765;6814;5.07;0.31;309.83;4.11;1289;22;2319.00;49
5479;14;5704749;5479;415;6765;6814;5.10;0.31;309.92;4.11;1286;22;2320.00;49
5480;15;5704766;5480;406;6765;6814;5.16;0.32;309.91;4.11;1285;24;2321.00;49
5483;15;5704803;5483;400;6765;6817;5.20;0.32;310.02;4.11;1282;24;2322.00;52
5486;15;5704821;5486;393;6765;6817;5.24;0.32;310.14;4.11;1279;24;2323.00;52
5487;15;5704844;5487;397;6766;6817;5.33;0.33;310.10;4.11;1279;24;2324.00;51
5492;15;5704860;5492;390;6769;6821;5.37;0.33;310.24;4.11;1277;24;2325.00;52
5498;15;5704875;5498;386;6769;6822;5.42;0.33;310.22;4.11;1271;24;2326.00;53
5502;15;5704889;5502;385;6770;6822;5.47;0.34;310.34;4.11;1268;24;2327.00;52
5506;15;5704907;5506;377;6771;6826;5.50;0.34;310.42;4.11;1265;24;2328.00;55
5509;15;5704921;5509;377;6771;6826;5.58;0.34;310.46;4.11;1262;24;2329.00;55
5513;15;5704935;5513;371;6773;6826;5.60;0.34;310.57;4.11;1260;24;2330.00;53
5514;15;5704954;5514;374;6773;6827;5.63;0.35;310.60;4.11;1259;24;2331.00;54
5520;15;5704969;5520;373;6773;6827;5.64;0.35;310.68;4.11;1253;24;2332.00;54
5525;15;5704983;5525;373;6777;6833;5.67;0.35;310.87;4.12;1252;24;2333.00;56
5528;15;5704997;5528;373;6777;6833;5.75;0.35;311.05;4.12;1249;24;2334.00;56
5535;15;5705011;5535;372;6777;6834;5.74;0.35;311.17;4.12;1242;24;2335.00;57
5541;15;5705025;5541;372;6777;6834;5.73;0.35;311.31;4.12;1236;24;2336.00;57
5548;15;5705041;5548;368;6780;6834;5.70;0.35;311.34;4.13;1232;24;2337.00;54
5552;15;5705057;5552;375;6780;6834;5.71;0.35;311.43;4.13;1228;24;2338.00;54
5555;15;5705072;5555;375;6780;6834;5.72;0.35;311.37;4.13;1225;24;2339.00;54
5561;15;5705091;5561;373;6803;6870;5.80;0.36;311.37;4.12;1242;24;2340.00;67
5566;15;5705118;5566;378;6803;6870;5.78;0.36;311.57;4.12;1237;24;2341.00;67
5569;15;5705141;5569;380;6806;6870;5.81;0.36;311.52;4.12;1237;24;2342.00;64
5571;15;5705159;5571;384;6806;6870;5.81;0.36;311.57;4.12;1235;24;2343.00;64
5577;15;5705176;5577;380;6811;6870;5.76;0.35;311.54;4.13;1234;24;2344.00;59
5578;15;5705192;5578;381;6812;6870;5.77;0.35;311.58;4.13;1234;24;2345.00;58
5582;15;5705209;5582;392;6816;6874;5.78;0.35;311.66;4.13;1234;24;2346.00;58
5586;15;5705225;5586;388;6817;6874;5.80;0.36;311.63;4.13;1231;24;2347.00;57
5591;15;5705241;5591;389;6821;6878;5.78;0.35;311.77;4.13;1230;24;2348.00;57
5597;15;5705257;5597;400;6822;6879;5.75;0.35;311.99;4.13;1225;24;2349.00;57
5600;15;5705272;5600;399;6823;6879;5.74;0.35;312.24;4.13;1223;24;2350.00;56
5605;15;5705287;5605;399;6824;6879;5.72;0.35;312.36;4.13;1219;24;2351.00;55
5611;15;5705303;5611;413;6834;6892;5.65;0.35;312.55;4.13;1223;24;2352.00;58
5611;15;5705319;5611;417;6834;6892;5.67;0.35;312.55;4.13;1223;24;2353.00;58
5617;15;5705335;5617;425;6837;6892;5.63;0.34;312.70;4.13;1220;24;2354.00;55
5621;15;5705352;5621;430;6839;6893;5.62;0.34;312.85;4.15;1218;24;2355.00;54
5624;15;5705370;5624;440;6841;6894;5.60;0.34;312.99;4.15;1217;24;2356.00;53
5628;15;5705387;5628;431;6842;6894;5.55;0.34;313.16;4.16;1214;24;2357.00;52
5632;15;5705402;5632;432;6845;6897;5.50;0.34;313.30;4.15;1213;24;2358.00;52
5634;15;5705423;5634;431;6845;6897;5.49;0.34;313.30;4.15;1211;24;2359.00;52
5637;15;5705437;5637;433;6846;6897;5.45;0.33;313.39;4.15;1209;24;2360.00;51
5641;15;5705450;5641;437;6846;6897;5.42;0.33;313.65;4.15;1205;24;2361.00;51
5645;15;5705465;5645;443;6851;6903;5.43;0.33;313.62;4.15;1206;24;2362.00;52
5648;15;5705479;5648;446;6851;6903;5.42;0.33;313.68;4.15;1203;24;2363.00;52
5650;15;5705493;5650;449;6851;6903;5.43;0.33;313.82;4.15;1201;24;2364.00;52
5653;15;5705513;5653;460;6851;6903;5.43;0.33;313.88;4.15;1198;24;2365.00;52
5658;15;5705526;5658;449;6854;6907;5.42;0.33;314.02;4.15;1196;24;2366.00;53
5662;15;5705540;5662;442;6855;6908;5.38;0.33;314.15;4.15;1193;24;2367.00;53
5667;15;5705554;5667;440;6855;6908;5.34;0.32;314.39;4.15;1188;24;2368.00;53
5669;15;5705569;5669;442;6856;6909;5.38;0.33;314.35;4.15;1187;24;2369.00;53
5675;15;5705585;5675;444;6856;6909;5.32;0.32;314.40;4.15;1181;24;2370.00;53
5678;15;5705599;5678;447;6856;6909;5.32;0.32;314.53;4.15;1178;24;2371.00;53
5680;15;5705613;5680;453;6856;6909;5.35;0.32;314.62;4.15;1176;24;2372.00;53
5682;15;5705626;5682;454;6856;6909;5.34;0.32;314.82;4.15;1174;24;2373.00;53
5686;15;5705639;5686;462;6857;6909;5.32;0.32;314.92;4.16;1171;24;2374.00;52
5688;15;5705652;5688;462;6857;6909;5.30;0.32;314.94;4.16;1169;24;2375.00;52
5691;15;5705665;5691;476;6895;6979;5.33;0.32;314.98;4.14;1204;24;2376.00;84
5694;15;5705691;5694;473;6896;6980;5.30;0.32;315.15;4.14;1202;24;2377.00;84
5697;15;5705706;5697;466;6902;6980;5.31;0.32;315.17;4.13;1205;24;2378.00;78
5699;15;5705720;5699;464;6906;6980;5.27;0.32;315.29;4.13;1207;24;2379.00;74
5702;15;5705733;5702;464;6908;6980;5.22;0.32;315.41;4.13;1206;24;2380.00;72
5703;15;5705746;5703;463;6910;6980;5.21;0.32;315.53;4.13;1207;24;2381.00;70
5706;15;5705760;5706;467;6913;6980;5.21;0.32;315.52;4.13;1207;24;2382.00;67
5707;15;5705773;5707;469;6915;6980;5.24;0.32;315.57;4.14;1208;24;2383.00;65
5709;15;5705785;5709;470;6916;6981;5.30;0.32;315.68;4.14;1207;24;2384.00;65
5710;15;5705799;5710;465;6919;6983;5.37;0.33;315.73;4.14;1209;25;2385.00;64
5710;15;5705822;5710;465;6921;6983;5.40;0.33;315.73;4.14;1211;25;2386.00;62
5715;15;5705836;5715;465;6928;6987;5.36;0.33;315.74;4.14;1213;25;2387.00;59
5718;15;5705850;5718;467;6929;6987;5.33;0.33;315.78;4.14;1211;25;2388.00;58
5720;15;5705863;5720;478;6930;6987;5.31;0.32;315.82;4.15;1210;25;2389.00;57
5721;15;5705876;5721;476;6930;6987;5.31;0.32;315.79;4.15;1209;25;2390.00;57
5726;15;5705889;5726;484;6935;6993;5.30;0.32;315.79;4.15;1209;25;2391.00;58
5728;15;5705904;5728;485;6935;6993;5.28;0.32;315.91;4.15;1207;25;2392.00;58
5730;15;5705917;5730;493;6935;6993;5.27;0.32;315.99;4.15;1205;25;2393.00;58
5732;15;5705930;5732;495;6937;6996;5.25;0.32;315.93;4.15;1205;25;2394.00;59
5735;15;5705944;5735;495;6937;6996;5.25;0.32;315.90;4.15;1202;25;2395.00;59
5739;15;5705957;5739;503;6938;6996;5.24;0.32;315.85;4.15;1199;25;2396.00;58
5741;15;5705970;5741;503;6938;6997;5.22;0.32;315.98;4.15;1197;25;2397.00;59
5744;15;5705986;5744;514;6939;6998;5.14;0.31;315.90;4.15;1195;25;2398.00;59
5747;15;5706001;5747;521;6939;6998;5.03;0.31;315.98;4.15;1192;25;2399.00;59
5749;15;5706017;5749;530;6963;7057;4.96;0.30;315.92;4.13;1214;25;2400.00;94
5751;15;5706042;5751;524;6963;7057;4.94;0.30;315.84;4.13;1212;25;2401.00;94
5752;15;5706057;5752;523;6966;7057;5.00;0.31;315.92;4.13;1214;25;2402.00;91
5754;15;5706070;5754;523;6969;7058;4.98;0.30;315.94;4.14;1215;25;2403.00;89
5756;15;5706083;5756;517;6971;7058;5.01;0.31;315.97;4.14;1215;25;2404.00;87
5758;15;5706096;5758;509;6973;7062;5.06;0.31;316.00;4.14;1215;25;2405.00;89
5760;15;5706109;5760;511;6975;7062;5.06;0.31;316.02;4.14;1215;25;2406.00;87
5762;15;5706122;5762;498;6978;7066;5.13;0.31;315.98;4.14;1216;25;2407.00;88
5764;15;5706135;5764;491;6979;7066;5.13;0.31;315.88;4.14;1215;25;2408.00;87
5766;15;5706148;5766;488;6980;7066;5.15;0.31;315.86;4.14;1214;25;2409.00;86
5767;15;5706164;5767;491;6980;7066;5.18;0.32;315.85;4.14;1213;25;2410.00;86
5769;15;5706180;5769;491;6980;7066;5.16;0.31;315.84;4.14;1211;25;2411.00;86
5771;15;5706193;5771;494;6990;7078;5.20;0.32;315.91;4.14;1219;25;2412.00;88
5775;15;5706206;5775;484;6990;7078;5.15;0.31;315.86;4.14;1215;25;2413.00;88
5776;15;5706226;5776;490;6992;7078;5.13;0.31;315.87;4.17;1216;25;2414.00;86
5780;15;5706241;5780;498;6993;7078;5.09;0.31;315.93;4.17;1213;25;2415.00;85
5780;15;5706254;5780;493;6994;7078;5.07;0.31;315.93;4.21;1214;25;2416.00;84
5784;15;5706266;5784;498;6994;7078;5.02;0.31;315.89;4.21;1210;25;2417.00;84
5785;15;5706279;5785;501;6996;7079;5.03;0.31;315.88;4.21;1211;25;2418.00;83
5789;15;5706292;5789;487;6996;7079;5.02;0.31;315.83;4.21;1207;25;2419.00;83
5789;15;5706305;5789;477;7001;7085;5.06;0.31;315.83;4.21;1212;25;2420.00;84
5794;15;5706318;5794;472;7002;7086;5.07;0.31;315.78;4.21;1208;25;2421.00;84
5794;15;5706331;5794;475;7003;7086;5.11;0.31;315.78;4.21;1209;25;2422.00;83
5794;15;5706343;5794;465;7005;7086;5.13;0.31;315.78;4.22;1211;25;2423.00;81
5795;15;5706359;5795;462;7009;7090;5.19;0.32;315.75;4.25;1214;25;2424.00;81
5797;15;5706372;5797;459;7009;7090;5.25;0.32;315.70;4.25;1212;25;2425.00;81
5798;15;5706389;5798;460;7010;7090;5.29;0.32;315.65;4.25;1212;25;2426.00;80
5801;15;5706402;5801;465;7013;7091;5.31;0.32;315.55;4.25;1212;25;2427.00;78
5802;15;5706414;5802;468;7017;7095;5.34;0.33;315.55;4.25;1215;25;2428.00;78
5806;15;5706428;5806;461;7017;7095;5.34;0.33;315.52;4.25;1211;25;2429.00;78
5808;15;5706442;5808;464;7022;7101;5.36;0.33;315.49;4.25;1214;25;2430.00;79
5811;15;5706455;5811;466;7022;7101;5.37;0.33;315.53;4.25;1211;25;2431.00;79
5813;15;5706469;5813;471;7024;7101;5.36;0.33;315.51;4.25;1211;25;2432.00;77
5814;15;5706482;5814;464;7024;7101;5.34;0.32;315.54;4.25;1210;25;2433.00;77
5817;15;5706494;5817;451;7029;7105;5.34;0.32;315.53;4.26;1212;25;2434.00;76
5818;15;5706508;5818;451;7029;7105;5.36;0.33;315.52;4.26;1211;25;2435.00;76
5820;15;5706521;5820;446;7029;7105;5.39;0.33;315.45;4.26;1209;25;2436.00;76
5823;15;5706534;5823;446;7030;7105;5.37;0.33;315.43;4.29;1207;25;2437.00;75
5823;15;5706546;5823;445;7031;7106;5.37;0.33;315.43;4.30;1208;25;2438.00;75
5825;15;5706558;5825;447;7033;7107;5.37;0.33;315.41;4.30;1208;25;2439.00;74
5826;15;5706571;5826;448;7034;7107;5.36;0.33;315.47;4.34;1208;25;2440.00;73
5827;15;5706584;5827;444;7035;7108;5.41;0.33;315.44;4.34;1208;25;2441.00;73
5830;15;5706596;5830;444;7035;7108;5.39;0.33;315.55;4.34;1205;25;2442.00;73
5831;15;5706609;5831;440;7036;7108;5.36;0.33;315.53;4.37;1205;25;2443.00;72
5835;15;5706622;5835;453;7038;7108;5.30;0.32;315.73;4.41;1203;25;2444.00;70
5836;15;5706635;5836;452;7040;7108;5.31;0.32;315.71;4.42;1204;25;2445.00;68
5836;15;5706647;5836;455;7041;7108;5.29;0.32;315.71;4.46;1205;25;2446.00;67
5837;15;5706660;5837;454;7042;7108;5.28;0.32;315.76;4.49;1205;25;2447.00;66
5838;15;5706672;5838;467;7105;7235;5.49;0.34;315.80;4.45;1267;25;2448.00;130
5841;15;5706693;5841;468;7108;7236;5.48;0.34;315.87;4.45;1267;25;2449.00;128
5844;15;5706707;5844;464;7120;7236;5.49;0.34;315.82;4.48;1276;25;2450.00;116
5846;15;5706720;5846;462;7126;7236;5.47;0.34;315.91;4.52;1280;25;2451.00;110
5846;15;5706738;5846;460;7131;7236;5.52;0.34;315.91;4.52;1285;25;2452.00;105
5850;15;5706752;5850;461;7135;7236;5.49;0.34;315.96;4.55;1285;25;2453.00;101
5854;15;5706775;5854;462;7139;7236;5.45;0.33;316.08;4.58;1285;25;2454.00;97
5855;15;5706797;5855;454;7141;7236;5.44;0.33;316.06;4.58;1286;25;2455.00;95
5857;15;5706815;5857;458;7145;7237;5.42;0.33;316.14;4.62;1288;25;2456.00;92
5858;15;5706830;5858;450;7148;7238;5.41;0.33;316.24;4.62;1290;25;2457.00;90
5859;15;5706847;5859;453;7150;7238;5.42;0.33;316.20;4.62;1291;25;2458.00;88
5862;15;5706862;5862;452;7153;7239;5.41;0.33;316.34;4.65;1291;25;2459.00;86
5864;15;5706881;5864;439;7157;7239;5.39;0.33;316.26;4.66;1293;25;2460.00;82
5868;15;5706897;5868;446;7160;7239;5.36;0.33;316.37;4.69;1292;25;2461.00;79
5868;15;5706914;5868;448;7163;7239;5.36;0.33;316.37;4.70;1295;25;2462.00;76
5873;15;5706930;5873;450;7166;7243;5.35;0.33;316.49;4.70;1293;25;2463.00;77
5875;15;5706953;5875;452;7169;7243;5.35;0.33;316.53;4.73;1294;25;2464.00;74
5878;15;5706968;5878;460;7170;7243;5.37;0.33;316.59;4.73;1292;25;2465.00;73
5881;15;5706983;5881;460;7174;7246;5.38;0.33;316.71;4.76;1293;25;2466.00;72
5883;15;5706998;5883;465;7176;7246;5.35;0.33;316.66;4.78;1293;25;2467.00;70
5886;15;5707014;5886;466;7178;7246;5.33;0.32;316.97;4.78;1292;25;2468.00;68
5887;15;5707030;5887;465;7183;7250;5.29;0.32;317.02;4.81;1296;25;2469.00;67
5888;15;5707046;5888;473;7186;7251;5.24;0.32;317.03;4.82;1298;25;2470.00;65
5890;15;5707061;5890;478;7188;7251;5.20;0.32;317.04;4.87;1298;25;2471.00;63
5894;15;5707076;5894;481;7190;7255;5.11;0.31;317.05;4.87;1296;25;2472.00;65
5897;15;5707092;5897;482;7191;7255;5.10;0.31;317.20;4.87;1294;25;2473.00;64
5900;15;5707107;5900;481;7194;7255;5.05;0.31;317.25;4.93;1294;25;2474.00;61
5904;15;5707122;5904;468;7196;7257;5.07;0.31;317.26;4.93;1292;25;2475.00;61
5907;15;5707136;5907;469;7199;7257;5.07;0.31;317.40;4.98;1292;25;2476.00;58
5912;15;5707150;5912;457;7203;7263;5.06;0.31;317.44;4.98;1291;25;2477.00;60
5915;15;5707175;5915;450;7204;7263;5.03;0.31;317.43;4.98;1289;25;2478.00;59
5919;15;5707190;5919;450;7206;7264;5.00;0.31;317.56;5.03;1287;25;2479.00;58
5921;15;5707206;5921;450;7206;7264;4.97;0.30;317.55;5.03;1285;25;2480.00;58
5924;15;5707222;5924;447;7206;7264;4.97;0.30;317.59;5.03;1282;25;2481.00;58
5927;15;5707237;5927;448;7206;7264;4.96;0.30;317.61;5.03;1279;25;2482.00;58
5933;15;5707251;5933;442;7206;7264;4.99;0.30;317.73;5.03;1273;25;2483.00;58
5935;15;5707269;5935;448;7217;7276;5.10;0.31;317.76;5.02;1282;25;2484.00;59
5938;15;5707288;5938;436;7217;7276;5.16;0.32;317.87;5.02;1279;25;2485.00;59
5943;15;5707304;5943;433;7217;7276;5.16;0.32;317.98;5.02;1274;25;2486.00;59
5945;15;5707321;5945;425;7217;7276;5.22;0.32;318.11;5.02;1272;25;2487.00;59
5949;15;5707338;5949;420;7217;7276;5.22;0.32;318.12;5.02;1268;25;2488.00;59
5955;15;5707353;5955;422;7217;7276;5.21;0.32;318.20;5.02;1262;25;2489.00;59
5958;15;5707370;5958;418;7220;7280;5.24;0.32;318.33;5.02;1262;25;2490.00;60
5963;15;5707385;5963;428;7220;7280;5.23;0.32;318.33;5.02;1257;25;2491.00;60
5966;15;5707400;5966;423;7223;7284;5.32;0.32;318.43;5.02;1257;25;2492.00;61
5969;15;5707415;5969;434;7224;7285;5.36;0.33;318.46;5.02;1255;25;2493.00;61
5971;15;5707431;5971;430;7224;7285;5.40;0.33;318.58;5.02;1253;25;2494.00;61
5975;15;5707447;5975;429;7224;7285;5.47;0.33;318.78;5.02;1249;25;2495.00;61
5978;15;5707464;5978;427;7234;7298;5.58;0.34;318.74;5.01;1256;25;2496.00;64
5982;15;5707481;5982;420;7234;7298;5.58;0.34;318.79;5.01;1252;25;2497.00;64
5985;15;5707497;5985;424;7234;7298;5.60;0.34;318.91;5.01;1249;25;2498.00;64
5988;15;5707512;5988;419;7235;7299;5.60;0.34;319.00;5.01;1247;25;2499.00;64
5993;15;5707528;5993;427;7235;7300;5.60;0.34;318.95;5.01;1242;25;2500.00;65
5996;15;5707546;5996;420;7235;7300;5.65;0.34;318.93;5.01;1239;25;2501.00;65
6000;15;5707562;6000;420;7236;7303;5.68;0.35;319.01;5.01;1236;25;2502.00;67
6004;15;5707578;6004;422;7236;7303;5.68;0.35;319.22;5.01;1232;25;2503.00;67
6008;15;5707592;6008;419;7236;7303;5.65;0.34;319.37;5.01;1228;25;2504.00;67
6011;15;5707607;6011;415;7236;7303;5.63;0.34;319.38;5.01;1225;25;2505.00;67
6016;15;5707622;6016;417;7240;7309;5.60;0.34;319.42;5.01;1224;25;2506.00;69
6025;15;5707638;6025;412;7241;7309;5.57;0.34;319.53;5.01;1216;25;2507.00;68
6030;15;5707652;6030;411;7241;7309;5.55;0.34;319.63;5.01;1211;25;2508.00;68
6035;15;5707666;6035;417;7241;7309;5.49;0.33;319.74;5.01;1206;25;2509.00;68
6039;15;5707680;6039;425;7244;7313;5.49;0.33;319.89;5.01;1205;25;2510.00;69
6044;15;5707693;6044;423;7244;7314;5.49;0.33;319.91;5.01;1200;25;2511.00;70
6049;15;5707708;6049;439;7244;7314;5.44;0.33;320.23;5.01;1195;25;2512.00;70
6055;15;5707724;6055;444;7245;7315;5.41;0.33;320.34;5.01;1190;25;2513.00;70
6056;15;5707744;6056;449;7247;7315;5.43;0.33;320.38;5.01;1191;25;2514.00;68
6062;15;5707761;6062;448;7247;7315;5.40;0.33;320.33;5.01;1185;25;2515.00;68
6067;15;5707779;6067;449;7249;7315;5.37;0.33;320.50;5.03;1182;25;2516.00;66
6071;15;5707798;6071;453;7249;7315;5.37;0.33;320.71;5.03;1178;25;2517.00;66
6073;15;5707817;6073;458;7249;7315;5.32;0.32;320.76;5.03;1176;25;2518.00;66
6079;15;5707837;6079;470;7250;7315;5.26;0.32;320.91;5.04;1171;25;2519.00;65
6083;15;5707859;6083;496;7315;7440;5.47;0.34;321.12;4.99;1232;25;2520.00;125
6086;15;5707890;6086;499;7318;7441;5.41;0.33;321.19;4.99;1232;25;2521.00;123
6090;15;5707909;6090;494;7325;7441;5.35;0.33;321.43;4.99;1235;25;2522.00;116
6093;15;5707925;6093;489;7328;7441;5.32;0.33;321.57;4.99;1235;25;2523.00;113
6096;15;5707940;6096;491;7333;7441;5.29;0.33;321.54;4.99;1237;25;2524.00;108
6099;15;5707955;6099;482;7337;7441;5.32;0.33;321.54;4.99;1238;25;2525.00;104
6103;15;5707969;6103;480;7339;7441;5.27;0.32;321.53;4.99;1236;25;2526.00;102
6105;15;5707982;6105;485;7340;7441;5.20;0.32;321.60;4.99;1235;25;2527.00;101
6107;15;5707997;6107;479;7346;7442;5.17;0.32;321.65;4.99;1239;25;2528.00;96
6110;15;5708012;6110;490;7349;7443;5.12;0.31;321.72;4.99;1239;25;2529.00;94
6114;15;5708031;6114;495;7352;7443;5.03;0.31;321.82;4.99;1238;25;2530.00;91
6115;15;5708061;6115;498;7358;7447;5.02;0.31;321.78;5.01;1243;25;2531.00;89
6121;15;5708080;6121;496;7360;7447;5.00;0.31;322.05;5.02;1239;25;2532.00;87
6125;15;5708101;6125;503;7362;7447;4.99;0.31;322.07;5.02;1237;25;2533.00;85
6127;15;5708125;6127;505;7362;7447;4.99;0.31;322.03;5.02;1235;25;2534.00;85
6129;15;5708145;6129;503;7366;7453;5.00;0.31;322.09;5.01;1237;25;2535.00;87
6130;15;5708164;6130;514;7366;7453;5.00;0.31;322.05;5.01;1236;25;2536.00;87
6133;15;5708189;6133;514;7367;7455;4.95;0.30;322.05;5.01;1234;25;2537.00;88
6133;15;5708208;6133;510;7370;7458;4.99;0.30;322.05;5.01;1237;25;2538.00;88
6135;15;5708228;6135;512;7370;7458;5.00;0.31;322.02;5.01;1235;25;2539.00;88
6137;15;5708248;6137;507;7371;7458;5.02;0.31;322.01;5.01;1234;25;2540.00;87
6140;15;5708265;6140;504;7371;7459;5.05;0.31;322.10;5.01;1231;25;2541.00;88
6141;15;5708281;6141;503;7372;7460;5.10;0.31;322.11;5.01;1231;25;2542.00;88
6143;15;5708297;6143;511;7373;7460;5.12;0.31;322.15;5.01;1230;25;2543.00;87
6143;15;5708313;6143;523;7383;7473;5.12;0.31;322.15;5.00;1240;25;2544.00;90
6147;15;5708329;6147;511;7385;7473;5.10;0.31;322.14;5.02;1238;25;2545.00;88
6148;15;5708345;6148;513;7385;7473;5.07;0.31;322.10;5.02;1237;25;2546.00;88
6152;15;5708363;6152;516;7386;7474;5.04;0.31;322.19;5.02;1234;25;2547.00;88
6153;15;5708383;6153;525;7386;7474;5.04;0.31;322.15;5.02;1233;25;2548.00;88
6158;15;5708405;6158;519;7390;7478;4.97;0.30;322.00;5.02;1232;25;2549.00;88
6159;15;5708435;6159;520;7392;7481;4.90;0.30;322.02;5.02;1233;25;2550.00;89
6160;15;5708456;6160;525;7396;7485;4.84;0.30;322.02;5.02;1236;25;2551.00;89
6164;15;5708476;6164;529;7396;7485;4.77;0.29;322.05;5.02;1232;25;2552.00;89
6166;15;5708494;6166;539;7396;7485;4.69;0.29;322.08;5.02;1230;25;2553.00;89
6167;15;5708514;6167;537;7396;7485;4.64;0.28;322.15;5.02;1229;25;2554.00;89
6169;15;5708533;6169;539;7396;7485;4.59;0.28;322.14;5.02;1227;25;2555.00;89
6171;15;5708555;6171;559;7405;7497;4.56;0.28;322.04;5.01;1234;25;2556.00;92
6171;15;5708573;6171;549;7405;7497;4.51;0.28;322.04;5.01;1234;25;2557.00;92
6174;15;5708587;6174;550;7407;7497;4.46;0.27;321.92;5.01;1233;25;2558.00;90
6175;15;5708601;6175;551;7407;7497;4.48;0.27;321.91;5.01;1232;25;2559.00;90
6176;15;5708614;6176;559;7408;7497;4.45;0.27;321.93;5.03;1232;25;2560.00;89
6176;15;5708628;6176;564;7408;7497;4.45;0.27;321.93;5.03;1232;25;2561.00;89
6177;15;5708642;6177;573;7408;7498;4.41;0.27;321.93;5.03;1231;25;2562.00;90
6177;15;5708656;6177;573;7408;7498;4.35;0.27;321.93;5.03;1231;25;2563.00;90
6177;15;5708670;6177;575;7413;7504;4.36;0.27;321.93;5.03;1236;25;2564.00;91
6177;15;5708683;6177;571;7415;7506;4.33;0.26;321.93;5.03;1238;25;2565.00;91
6181;15;5708697;6181;548;7415;7506;4.29;0.26;321.98;5.03;1234;25;2566.00;91
6182;15;5708711;6182;541;7416;7506;4.30;0.26;321.99;5.04;1234;25;2567.00;90
6184;15;5708726;6184;530;7419;7510;4.34;0.26;322.02;5.04;1235;25;2568.00;91
6186;15;5708740;6186;520;7419;7510;4.33;0.26;322.05;5.04;1233;25;2569.00;91
6189;15;5708754;6189;504;7419;7510;4.37;0.27;322.20;5.04;1230;25;2570.00;91
6191;15;5708767;6191;493;7420;7511;4.46;0.27;322.19;5.04;1229;25;2571.00;91
6193;15;5708781;6193;484;7423;7515;4.52;0.28;322.23;5.04;1230;25;2572.00;92
6196;15;5708806;6196;473;7423;7515;4.59;0.28;322.27;5.04;1227;25;2573.00;92
6200;15;5708820;6200;465;7425;7518;4.66;0.28;322.25;5.04;1225;25;2574.00;93
6200;15;5708835;6200;459;7425;7518;4.74;0.29;322.25;5.04;1225;25;2575.00;93
6202;15;5708847;6202;450;7426;7518;4.78;0.29;322.30;5.04;1224;25;2576.00;92
6205;15;5708861;6205;448;7426;7518;4.78;0.29;322.43;5.04;1221;25;2577.00;92
6205;15;5708874;6205;443;7430;7522;4.88;0.30;322.43;5.03;1225;25;2578.00;92
6207;15;5708894;6207;444;7430;7522;4.92;0.30;322.42;5.03;1223;25;2579.00;92
6210;15;5708909;6210;443;7432;7522;4.94;0.30;322.42;5.11;1222;25;2580.00;90
6212;15;5708924;6212;438;7432;7522;4.99;0.30;322.45;5.11;1220;25;2581.00;90
6215;15;5708938;6215;436;7433;7523;5.00;0.30;322.46;5.12;1218;25;2582.00;90
6216;15;5708957;6216;439;7434;7524;5.07;0.31;322.47;5.12;1218;25;2583.00;90
6216;15;5708971;6216;435;7434;7524;5.12;0.31;322.47;5.12;1218;25;2584.00;90
6219;15;5708984;6219;433;7435;7525;5.15;0.31;322.45;5.12;1216;25;2585.00;90
6223;15;5708999;6223;430;7435;7525;5.18;0.31;322.61;5.12;1212;25;2586.00;90
6225;15;5709013;6225;433;7435;7525;5.22;0.32;322.67;5.12;1210;25;2587.00;90
6227;15;5709027;6227;433;7435;7525;5.22;0.32;322.70;5.12;1208;25;2588.00;90
6229;15;5709046;6229;440;7435;7525;5.27;0.32;322.63;5.12;1206;25;2589.00;90
6230;15;5709061;6230;449;7435;7525;5.32;0.32;322.66;5.12;1205;25;2590.00;90
6232;15;5709074;6232;449;7435;7525;5.35;0.32;322.61;5.12;1203;25;2591.00;90
6233;15;5709088;6233;462;7502;7652;5.55;0.34;322.58;5.08;1269;25;2592.00;150
6234;15;5709111;6234;457;7504;7653;5.57;0.34;322.60;5.08;1270;25;2593.00;149
6237;15;5709127;6237;450;7513;7653;5.59;0.34;322.61;5.07;1276;25;2594.00;140
6239;15;5709143;6239;447;7517;7653;5.52;0.34;322.70;5.07;1278;25;2595.00;136
6240;15;5709158;6240;442;7523;7653;5.50;0.34;322.67;5.07;1283;25;2596.00;130
6241;15;5709172;6241;433;7525;7653;5.51;0.34;322.65;5.07;1284;25;2597.00;128
6244;15;5709187;6244;436;7527;7653;5.49;0.34;322.72;5.07;1283;25;2598.00;126
6245;15;5709200;6245;445;7530;7653;5.53;0.34;322.77;5.07;1285;25;2599.00;123
6245;15;5709215;6245;447;7532;7654;5.54;0.34;322.77;5.07;1287;25;2600.00;122
6246;15;5709232;6246;446;7535;7655;5.52;0.34;322.77;5.07;1289;25;2601.00;120
6246;16;5709245;6246;452;7538;7655;5.54;0.34;322.77;5.08;1292;26;2602.00;117
6247;16;5709270;6247;452;7539;7656;5.47;0.33;322.84;5.08;1292;26;2603.00;117
6250;16;5709285;6250;463;7543;7656;5.38;0.33;322.76;5.08;1293;26;2604.00;113
6252;16;5709304;6252;465;7546;7656;5.29;0.32;322.78;5.12;1294;26;2605.00;110
6252;16;5709317;6252;466;7547;7656;5.26;0.32;322.78;5.12;1295;26;2606.00;109
6253;16;5709331;6253;470;7552;7660;5.27;0.32;322.76;5.12;1299;26;2607.00;108
6256;16;5709349;6256;477;7555;7660;5.20;0.32;322.80;5.16;1299;26;2608.00;105
6258;16;5709363;6258;486;7556;7660;5.11;0.31;322.90;5.16;1298;26;2609.00;104
6258;16;5709377;6258;492;7562;7666;5.09;0.31;322.90;5.21;1304;26;2610.00;104
6260;16;5709390;6260;493;7562;7666;5.07;0.31;323.00;5.21;1302;26;2611.00;104
6262;16;5709403;6262;499;7566;7666;5.07;0.31;323.01;5.25;1304;26;2612.00;100
6266;16;5709415;6266;511;7569;7670;5.00;0.31;323.09;5.25;1303;26;2613.00;101
6267;16;5709429;6267;512;7572;7671;4.94;0.30;323.06;5.29;1305;26;2614.00;99
6267;16;5709442;6267;528;7573;7671;4.92;0.30;323.06;5.29;1306;26;2615.00;98
6270;16;5709454;6270;525;7577;7675;4.89;0.30;323.28;5.29;1307;26;2616.00;98
6271;16;5709467;6271;529;7579;7675;4.86;0.30;323.27;5.37;1308;26;2617.00;96
6279;16;5709480;6279;534;7581;7675;4.82;0.30;323.58;5.44;1302;26;2618.00;94
6284;16;5709493;6284;533;7582;7676;4.80;0.29;323.73;5.44;1298;26;2619.00;94
6285;16;5709511;6285;526;7582;7676;4.83;0.30;323.74;5.44;1297;26;2620.00;94
6287;16;5709532;6287;536;7589;7682;4.89;0.30;323.72;5.51;1302;26;2621.00;93
6290;16;5709547;6290;535;7589;7682;4.85;0.30;323.73;5.51;1299;26;2622.00;93
6291;16;5709561;6291;534;7591;7683;4.82;0.29;323.73;5.58;1300;26;2623.00;92
6294;16;5709578;6294;539;7591;7683;4.78;0.29;324.01;5.58;1297;26;2624.00;92
6295;16;5709594;6295;540;7593;7683;4.83;0.29;323.98;5.66;1298;26;2625.00;90
6296;16;5709608;6296;538;7593;7683;4.87;0.30;323.94;5.66;1297;26;2626.00;90
6297;16;5709623;6297;529;7593;7683;4.97;0.30;323.92;5.66;1296;26;2627.00;90
6298;16;5709642;6298;531;7605;7695;5.11;0.31;323.92;5.72;1307;26;2628.00;90
6300;16;5709665;6300;525;7605;7695;5.17;0.32;323.96;5.72;1305;26;2629.00;90
6305;16;5709686;6305;529;7606;7695;5.19;0.32;324.04;5.72;1301;26;2630.00;89
6307;17;5709706;6307;525;7608;7695;5.21;0.32;324.01;5.79;1301;27;2631.00;87
6310;17;5709748;6310;528;7608;7695;5.23;0.32;324.02;5.79;1298;27;2632.00;87
6312;17;5709774;6312;532;7608;7695;5.28;0.32;324.04;5.79;1296;28;2633.00;87
6313;17;5709808;6313;533;7613;7699;5.31;0.32;324.17;5.86;1300;28;2634.00;86
6316;17;5709826;6316;537;7613;7699;5.31;0.32;324.22;5.86;1297;28;2635.00;86
6319;17;5709844;6319;542;7619;7703;5.30;0.32;324.17;5.92;1300;28;2636.00;84
6324;17;5709863;6324;540;7620;7704;5.22;0.32;324.18;5.92;1296;28;2637.00;84
6328;17;5709881;6328;544;7620;7704;5.21;0.32;324.18;5.92;1292;28;2638.00;84
6332;17;5709899;6332;546;7622;7704;5.13;0.31;324.20;5.99;1290;28;2639.00;82
6337;17;5709920;6337;541;7643;7733;5.12;0.31;324.23;5.97;1306;29;2640.00;90
6340;18;5709957;6340;529;7643;7733;5.12;0.31;324.19;5.97;1303;30;2641.00;90
6346;18;5709983;6346;520;7645;7733;5.11;0.31;324.17;5.97;1299;30;2642.00;88
6349;18;5710002;6349;519;7648;7734;5.13;0.31;324.21;5.97;1299;30;2643.00;86
6350;18;5710024;6350;523;7648;7735;5.17;0.32;324.19;5.97;1298;30;2644.00;87
6355;18;5710048;6355;514;7648;7735;5.19;0.32;324.39;5.97;1293;30;2645.00;87
6362;18;5710066;6362;516;7651;7738;5.20;0.32;324.63;5.97;1289;30;2646.00;87
6365;18;5710087;6365;508;7651;7738;5.19;0.32;324.69;5.97;1286;30;2647.00;87
6368;18;5710105;6368;506;7651;7738;5.19;0.32;324.79;5.97;1283;30;2648.00;87
6373;18;5710123;6373;499;7651;7738;5.19;0.32;325.04;5.97;1278;30;2649.00;87
6375;18;5710142;6375;490;7656;7744;5.20;0.32;325.06;5.96;1281;30;2650.00;88
6378;18;5710162;6378;488;7656;7744;5.16;0.32;325.17;5.96;1278;30;2651.00;88
6383;18;5710180;6383;478;7656;7744;5.14;0.32;325.53;5.96;1273;30;2652.00;88
6390;18;5710208;6390;474;7656;7744;5.11;0.31;325.82;5.96;1266;30;2653.00;88
6392;18;5710226;6392;480;7659;7748;5.13;0.32;325.90;5.96;1267;30;2654.00;89
6396;18;5710243;6396;489;7661;7750;5.14;0.32;325.92;5.96;1265;30;2655.00;89
6401;18;5710260;6401;490;7661;7750;5.07;0.31;326.12;5.96;1260;30;2656.00;89
6405;18;5710276;6405;498;7662;7751;5.05;0.31;326.28;5.96;1257;30;2657.00;89
6411;18;5710296;6411;508;7662;7751;5.02;0.31;326.35;5.96;1251;30;2658.00;89
6415;18;5710312;6415;505;7662;7751;4.99;0.31;326.47;5.96;1247;30;2659.00;89
6421;18;5710327;6421;504;7662;7751;4.96;0.30;326.65;5.96;1241;30;2660.00;89
6429;18;5710342;6429;510;7662;7751;4.90;0.30;326.67;5.96;1233;30;2661.00;89
6433;18;5710359;6433;506;7662;7751;4.86;0.30;326.71;5.96;1229;30;2662.00;89
6436;18;5710373;6436;501;7662;7751;4.84;0.30;326.82;5.96;1226;30;2663.00;89
6439;18;5710387;6439;514;7701;7821;4.90;0.30;326.84;5.93;1262;30;2664.00;120
6442;18;5710408;6442;503;7702;7822;4.93;0.30;327.01;5.93;1260;30;2665.00;120
6447;18;5710422;6447;502;7706;7822;4.93;0.30;327.06;5.93;1259;30;2666.00;116
6450;18;5710437;6450;501;7707;7822;4.90;0.30;327.06;5.93;1257;30;2667.00;115
6453;18;5710450;6453;498;7709;7822;4.91;0.30;327.18;5.92;1256;30;2668.00;113
6456;18;5710471;6456;502;7710;7822;4.89;0.30;327.15;5.92;1254;30;2669.00;112
6464;18;5710494;6464;499;7713;7822;4.86;0.30;327.25;5.92;1249;30;2670.00;109
6467;18;5710513;6467;501;7715;7822;4.83;0.30;327.25;5.92;1248;30;2671.00;107
6469;18;5710530;6469;510;7717;7823;4.79;0.29;327.27;5.93;1248;30;2672.00;106
6472;18;5710545;6472;516;7720;7824;4.75;0.29;327.31;5.93;1248;30;2673.00;104
6475;18;5710561;6475;520;7722;7824;4.72;0.29;327.40;5.93;1247;30;2674.00;102
6479;18;5710577;6479;529;7725;7828;4.73;0.29;327.48;5.92;1246;30;2675.00;103
6483;18;5710601;6483;538;7725;7828;4.74;0.29;327.50;5.92;1242;30;2676.00;103
6489;18;5710632;6489;546;7726;7828;4.68;0.29;327.59;5.93;1237;30;2677.00;102
6492;18;5710657;6492;541;7726;7828;4.65;0.29;327.57;5.93;1234;30;2678.00;102
6496;18;5710688;6496;558;7732;7834;4.61;0.28;327.57;5.93;1236;30;2679.00;102
6499;18;5710717;6499;558;7732;7834;4.58;0.28;327.60;5.93;1233;30;2680.00;102
6505;18;5710733;6505;557;7732;7834;4.48;0.27;327.74;5.93;1227;30;2681.00;102
6507;18;5710748;6507;562;7735;7837;4.45;0.27;327.73;5.93;1228;30;2682.00;102
6513;18;5710763;6513;568;7735;7837;4.36;0.27;327.69;5.93;1222;30;2683.00;102
6515;18;5710777;6515;576;7735;7837;4.32;0.26;327.67;5.93;1220;30;2684.00;102
6517;18;5710791;6517;577;7736;7838;4.29;0.26;327.59;5.93;1219;30;2685.00;102
6519;18;5710805;6519;578;7737;7839;4.26;0.26;327.53;5.93;1218;30;2686.00;102
6520;18;5710819;6520;572;7738;7839;4.24;0.26;327.52;5.93;1218;30;2687.00;101
6522;18;5710832;6522;567;7748;7852;4.31;0.26;327.44;5.93;1226;30;2688.00;104
6524;18;5710847;6524;571;7749;7852;4.32;0.26;327.47;5.93;1225;30;2689.00;103
6525;18;5710861;6525;569;7752;7852;4.31;0.26;327.44;5.95;1227;30;2690.00;100
6527;18;5710880;6527;569;7752;7853;4.31;0.26;327.46;5.95;1225;30;2691.00;101
6528;18;5710896;6528;571;7754;7853;4.34;0.27;327.46;5.95;1226;30;2692.00;99
6531;18;5710911;6531;577;7757;7857;4.33;0.27;327.41;5.95;1226;30;2693.00;100
6533;18;5710925;6533;578;7758;7857;4.31;0.26;327.34;5.95;1225;30;2694.00;99
6536;18;5710939;6536;573;7761;7861;4.29;0.26;327.32;5.94;1225;30;2695.00;100
6536;18;5710952;6536;556;7762;7861;4.31;0.26;327.32;5.94;1226;30;2696.00;99
6537;18;5710965;6537;555;7762;7861;4.33;0.27;327.30;5.94;1225;30;2697.00;99
6539;18;5710978;6539;548;7762;7861;4.37;0.27;327.33;5.94;1223;30;2698.00;99
6542;18;5710991;6542;540;7762;7861;4.41;0.27;327.25;5.94;1220;30;2699.00;99
6543;18;5711007;6543;542;7787;7910;4.54;0.28;327.30;5.92;1244;30;2700.00;123
6547;18;5711028;6547;538;7788;7910;4.57;0.28;327.23;5.92;1241;30;2701.00;122
6548;18;5711043;6548;540;7791;7910;4.63;0.28;327.22;5.92;1243;30;2702.00;119
6549;18;5711061;6549;535;7791;7910;4.63;0.28;327.23;5.92;1242;30;2703.00;119
6552;18;5711074;6552;542;7794;7910;4.65;0.28;327.19;5.92;1242;30;2704.00;116
6555;18;5711089;6555;538;7794;7910;4.68;0.29;327.19;5.92;1239;30;2705.00;116
6555;18;5711103;6555;543;7795;7911;4.76;0.29;327.19;5.92;1240;30;2706.00;116
6556;18;5711118;6556;545;7795;7911;4.75;0.29;327.21;5.92;1239;30;2707.00;116
6556;18;5711138;6556;546;7800;7917;4.79;0.29;327.21;5.92;1244;30;2708.00;117
6557;18;5711154;6557;552;7801;7918;4.82;0.29;327.26;5.92;1244;30;2709.00;117
6558;18;5711169;6558;550;7801;7918;4.79;0.29;327.28;5.92;1243;30;2710.00;117
6559;18;5711185;6559;552;7801;7918;4.75;0.29;327.27;5.92;1242;30;2711.00;117
6560;18;5711202;6560;551;7804;7922;4.76;0.29;327.28;5.92;1244;30;2712.00;118
6562;18;5711218;6562;532;7804;7922;4.72;0.29;327.28;5.92;1242;30;2713.00;118
6563;18;5711234;6563;513;7805;7922;4.78;0.29;327.26;5.92;1242;30;2714.00;117
6565;18;5711250;6565;515;7806;7923;4.81;0.29;327.28;5.92;1241;30;2715.00;117
6566;18;5711265;6566;511;7810;7927;4.88;0.30;327.26;5.94;1244;31;2716.00;117
6569;18;5711290;6569;507;7810;7927;4.95;0.30;327.23;5.94;1241;31;2717.00;117
6570;18;5711305;6570;504;7813;7930;5.02;0.30;327.32;5.94;1243;31;2718.00;117
6572;18;5711321;6572;496;7813;7930;5.05;0.30;327.42;5.94;1241;31;2719.00;117
6574;18;5711341;6574;497;7815;7930;5.10;0.31;327.53;5.94;1241;31;2720.00;115
6574;18;5711356;6574;490;7815;7930;5.16;0.31;327.53;5.94;1241;31;2721.00;115
6574;18;5711372;6574;492;7818;7934;5.22;0.32;327.53;5.94;1244;31;2722.00;116
6576;18;5711389;6576;488;7818;7934;5.24;0.32;327.60;5.94;1242;31;2723.00;116
6578;18;5711405;6578;482;7819;7934;5.24;0.32;327.58;5.94;1241;31;2724.00;115
6580;18;5711420;6580;489;7821;7934;5.24;0.32;327.67;5.95;1241;31;2725.00;113
6581;18;5711436;6581;482;7821;7935;5.29;0.32;327.69;5.95;1240;31;2726.00;114
6583;18;5711451;6583;485;7822;7936;5.33;0.32;327.65;5.94;1239;31;2727.00;114
6585;18;5711466;6585;486;7822;7936;5.34;0.32;327.69;5.94;1237;31;2728.00;114
6585;18;5711486;6585;483;7823;7937;5.36;0.32;327.69;5.94;1238;31;2729.00;114
6585;18;5711503;6585;476;7824;7937;5.36;0.32;327.69;5.95;1239;31;2730.00;113
6587;18;5711519;6587;469;7825;7937;5.38;0.33;327.67;5.95;1238;31;2731.00;112
6587;18;5711535;6587;469;7826;7937;5.39;0.33;327.67;5.98;1239;31;2732.00;111
6587;18;5711549;6587;461;7828;7937;5.37;0.33;327.67;5.98;1241;31;2733.00;109
6589;18;5711564;6589;458;7828;7937;5.39;0.33;327.77;5.98;1239;31;2734.00;109
6591;18;5711580;6591;455;7828;7937;5.40;0.33;327.77;5.98;1237;31;2735.00;109
6591;18;5711596;6591;472;7892;8064;5.52;0.34;327.77;5.94;1301;31;2736.00;172
6593;18;5711622;6593;452;7893;8065;5.57;0.34;327.75;5.94;1300;31;2737.00;172
6597;18;5711639;6597;441;7899;8065;5.64;0.35;327.80;5.93;1302;31;2738.00;166
6600;18;5711656;6600;436;7905;8065;5.68;0.35;327.76;5.96;1305;31;2739.00;160
6604;18;5711672;6604;425;7911;8065;5.76;0.35;327.78;5.96;1307;31;2740.00;154
6610;18;5711689;6610;423;7913;8065;5.74;0.35;328.05;5.96;1303;31;2741.00;152
6611;18;5711706;6611;423;7916;8065;5.79;0.35;328.12;5.96;1305;31;2742.00;149
6615;18;5711723;6615;422;7919;8065;5.80;0.35;328.14;5.96;1304;31;2743.00;146
6617;18;5711740;6617;416;7922;8066;5.87;0.36;328.18;5.96;1305;31;2744.00;144
6621;18;5711755;6621;411;7928;8068;5.95;0.36;328.37;6.05;1307;31;2745.00;140
6622;18;5711772;6622;421;7930;8068;6.00;0.37;328.42;6.05;1308;31;2746.00;138
6628;18;5711789;6628;419;7933;8069;6.00;0.37;328.56;6.05;1305;31;2747.00;136
6633;18;5711805;6633;421;7937;8069;5.98;0.36;328.59;6.05;1304;31;2748.00;132
6636;18;5711826;6636;428;7938;8069;5.98;0.36;328.59;6.05;1302;31;2749.00;131
6636;18;5711842;6636;421;7940;8069;6.00;0.37;328.59;6.05;1304;31;2750.00;129
6641;18;5711857;6641;430;7943;8073;5.97;0.36;328.55;6.05;1302;31;2751.00;130
6642;18;5711873;6642;432;7946;8073;5.92;0.36;328.51;6.06;1304;31;2752.00;127
6642;18;5711888;6642;435;7947;8073;5.92;0.36;328.51;6.06;1305;31;2753.00;126
6644;18;5711910;6644;438;7949;8076;5.92;0.36;328.51;6.06;1305;31;2754.00;127
6648;18;5711927;6648;437;7953;8076;5.93;0.36;328.60;6.07;1305;31;2755.00;123
6650;18;5711943;6650;442;7953;8076;5.92;0.36;328.65;6.07;1303;31;2756.00;123
6652;18;5711958;6652;442;7959;8080;5.92;0.36;328.70;6.07;1307;31;2757.00;121
6654;18;5711979;6654;447;7961;8081;5.92;0.36;328.79;6.07;1307;31;2758.00;120
6655;18;5711995;6655;448;7964;8081;5.92;0.36;328.76;6.07;1309;31;2759.00;117
6660;18;5712014;6660;454;7968;8086;5.94;0.36;328.89;6.07;1308;31;2760.00;118
6665;18;5712031;6665;455;7968;8086;5.91;0.36;329.11;6.07;1303;31;2761.00;118
6665;18;5712047;6665;462;7969;8086;5.90;0.36;329.11;6.07;1304;31;2762.00;117
6668;18;5712062;6668;464;7970;8087;5.87;0.36;329.24;6.07;1302;31;2763.00;117
6670;18;5712078;6670;468;7970;8087;5.86;0.36;329.34;6.07;1300;31;2764.00;117
6672;18;5712093;6672;472;7975;8093;5.89;0.36;329.53;6.07;1303;31;2765.00;118
6676;18;5712110;6676;467;7975;8093;5.91;0.36;329.54;6.07;1299;31;2766.00;118
6679;18;5712125;6679;465;7975;8094;5.91;0.36;329.60;6.07;1296;31;2767.00;119
6682;18;5712141;6682;468;7975;8094;5.91;0.36;329.82;6.07;1293;31;2768.00;119
6683;18;5712157;6683;474;7975;8094;5.88;0.36;329.80;6.07;1292;31;2769.00;119
6684;18;5712172;6684;472;7976;8094;5.84;0.35;329.82;6.11;1292;31;2770.00;118
6685;18;5712187;6685;473;7977;8094;5.84;0.35;329.88;6.16;1292;31;2771.00;117
6687;18;5712202;6687;480;7988;8106;5.85;0.36;330.04;6.20;1301;31;2772.00;118
6691;18;5712223;6691;479;7988;8106;5.80;0.35;330.14;6.20;1297;31;2773.00;118
6693;18;5712237;6693;486;7990;8106;5.81;0.35;330.27;6.24;1297;31;2774.00;116
6696;18;5712252;6696;493;7991;8106;5.80;0.35;330.38;6.29;1295;31;2775.00;115
6699;18;5712268;6699;497;7992;8106;5.82;0.35;330.58;6.33;1293;31;2776.00;114
6700;18;5712285;6700;498;7992;8106;5.86;0.36;330.57;6.33;1292;31;2777.00;114
6702;18;5712301;6702;497;7996;8110;5.84;0.36;330.77;6.37;1294;31;2778.00;114
6703;18;5712319;6703;494;7999;8110;5.82;0.35;330.82;6.50;1296;31;2779.00;111
6708;18;5712343;6708;500;8003;8114;5.82;0.35;331.02;6.50;1295;31;2780.00;111
6712;18;5712380;6712;504;8004;8115;5.79;0.35;331.07;6.50;1292;31;2781.00;111
6715;18;5712397;6715;503;8005;8115;5.74;0.35;331.25;6.54;1290;31;2782.00;110
6718;18;5712414;6718;505;8005;8115;5.68;0.35;331.28;6.54;1287;31;2783.00;110
6720;18;5712430;6720;514;8017;8128;5.66;0.34;331.28;6.57;1297;31;2784.00;111
6723;18;5712447;6723;509;8018;8128;5.62;0.34;331.36;6.61;1295;31;2785.00;110
6727;18;5712463;6727;509;8019;8128;5.57;0.34;331.36;6.65;1292;31;2786.00;109
6729;18;5712480;6729;514;8021;8129;5.53;0.34;331.46;6.69;1292;31;2787.00;108
6733;18;5712496;6733;516;8022;8130;5.46;0.33;331.49;6.74;1289;31;2788.00;108
6733;18;5712511;6733;511;8023;8130;5.42;0.33;331.49;6.78;1290;31;2789.00;107
6737;18;5712528;6737;518;8028;8136;5.45;0.33;331.62;6.77;1291;31;2790.00;108
6742;18;5712543;6742;514;8030;8136;5.47;0.33;331.59;6.85;1288;31;2791.00;106
6744;18;5712558;6744;508;8031;8136;5.51;0.34;331.71;6.85;1287;31;2792.00;105
6747;18;5712573;6747;508;8031;8136;5.58;0.34;331.97;6.85;1284;31;2793.00;105
6750;18;5712588;6750;501;8038;8142;5.63;0.34;332.00;6.93;1288;31;2794.00;104
6754;18;5712602;6754;498;8039;8142;5.62;0.34;332.07;6.96;1285;31;2795.00;103
6758;18;5712617;6758;504;8040;8142;5.59;0.34;332.14;7.00;1282;31;2796.00;102
6761;18;5712631;6761;510;8040;8142;5.57;0.34;332.11;7.00;1279;31;2797.00;102
6767;18;5712645;6767;517;8044;8146;5.45;0.33;332.09;7.04;1277;31;2798.00;102
6769;18;5712659;6769;521;8046;8147;5.42;0.33;332.16;7.07;1277;31;2799.00;101
6772;18;5712674;6772;525;8047;8147;5.39;0.33;332.42;7.11;1275;31;2800.00;100
6774;18;5712693;6774;532;8049;8148;5.31;0.32;332.45;7.15;1275;31;2801.00;99
6780;18;5712709;6780;539;8049;8148;5.21;0.32;332.69;7.15;1269;31;2802.00;99
6782;18;5712724;6782;544;8050;8148;5.10;0.31;332.67;7.18;1268;31;2803.00;98
6787;18;5712737;6787;549;8050;8148;4.97;0.30;332.80;7.18;1263;31;2804.00;98
6795;18;5712750;6795;540;8053;8148;4.86;0.30;332.89;7.30;1258;31;2805.00;95
6800;18;5712765;6800;528;8053;8148;4.80;0.29;332.89;7.30;1253;31;2806.00;95
6803;18;5712778;6803;524;8053;8148;4.76;0.29;333.02;7.30;1250;31;2807.00;95
6807;18;5712792;6807;524;8093;8218;4.90;0.30;333.07;7.29;1286;31;2808.00;125
6808;18;5712811;6808;525;8097;8219;4.92;0.30;333.08;7.32;1289;31;2809.00;122
6814;18;5712825;6814;532;8104;8219;4.89;0.30;333.29;7.32;1290;31;2810.00;115
6817;18;5712840;6817;531;8106;8219;4.90;0.30;333.34;7.31;1289;31;2811.00;113
6819;18;5712855;6819;533;8108;8219;4.89;0.30;333.28;7.31;1289;31;2812.00;111
6824;18;5712870;6824;527;8109;8219;4.85;0.30;333.50;7.31;1285;31;2813.00;110
6827;18;5712885;6827;528;8110;8219;4.81;0.29;333.59;7.31;1283;31;2814.00;109
6831;18;5712899;6831;535;8111;8219;4.80;0.29;333.70;7.31;1280;31;2815.00;108
6834;18;5712914;6834;531;8113;8220;4.78;0.29;333.73;7.31;1279;31;2816.00;107
6837;18;5712929;6837;531;8114;8221;4.77;0.29;333.70;7.31;1277;31;2817.00;107
6840;18;5712944;6840;540;8115;8221;4.77;0.29;333.71;7.31;1275;31;2818.00;106
6843;18;5712958;6843;543;8119;8225;4.79;0.29;333.65;7.31;1276;31;2819.00;106
6846;18;5712974;6846;545;8119;8225;4.75;0.29;333.69;7.31;1273;31;2820.00;106
6849;18;5712988;6849;556;8119;8225;4.71;0.29;333.80;7.31;1270;31;2821.00;106
6850;18;5713002;6850;561;8119;8225;4.70;0.28;333.77;7.31;1269;31;2822.00;106
6853;18;5713015;6853;556;8123;8231;4.60;0.28;333.78;7.31;1270;31;2823.00;108
6856;18;5713029;6856;563;8123;8231;4.58;0.28;333.83;7.31;1267;31;2824.00;108
6858;18;5713043;6858;562;8123;8231;4.55;0.28;333.78;7.31;1265;31;2825.00;108
6862;18;5713056;6862;567;8124;8234;4.51;0.27;333.75;7.31;1262;31;2826.00;110
6866;18;5713070;6866;566;8124;8234;4.45;0.27;333.73;7.31;1258;31;2827.00;110
6867;18;5713083;6867;566;8124;8234;4.46;0.27;333.77;7.31;1257;31;2828.00;110
6870;18;5713098;6870;570;8124;8235;4.40;0.27;333.78;7.31;1254;31;2829.00;111
6872;18;5713112;6872;572;8125;8236;4.40;0.27;333.82;7.31;1253;31;2830.00;111
6875;18;5713126;6875;584;8125;8236;4.35;0.26;333.81;7.31;1250;31;2831.00;111
6879;18;5713139;6879;594;8135;8249;4.35;0.26;333.86;7.30;1256;31;2832.00;114
6881;18;5713154;6881;592;8135;8249;4.27;0.26;333.80;7.30;1254;31;2833.00;114
6885;18;5713167;6885;597;8135;8249;4.15;0.25;333.75;7.30;1250;31;2834.00;114
6890;18;5713180;6890;599;8136;8251;4.12;0.25;333.79;7.30;1246;31;2835.00;115
6890;18;5713193;6890;599;8137;8251;4.09;0.25;333.79;7.30;1247;31;2836.00;114
6894;18;5713205;6894;599;8140;8255;4.07;0.25;333.89;7.30;1246;31;2837.00;115
6898;18;5713218;6898;602;8140;8255;4.05;0.25;334.02;7.30;1242;31;2838.00;115
6902;18;5713230;6902;604;8143;8259;4.09;0.25;334.06;7.29;1241;31;2839.00;116
6905;18;5713243;6905;610;8143;8259;4.07;0.25;334.05;7.29;1238;31;2840.00;116
6908;18;5713256;6908;609;8143;8259;4.05;0.25;334.09;7.29;1235;31;2841.00;116
6910;18;5713270;6910;613;8144;8259;4.03;0.25;334.10;7.30;1234;31;2842.00;115
6915;18;5713284;6915;616;8145;8259;3.99;0.24;334.00;7.30;1230;31;2843.00;114
6918;18;5713297;6918;616;8153;8271;4.07;0.25;334.00;7.29;1235;31;2844.00;118
6919;18;5713313;6919;621;8154;8271;4.05;0.25;334.00;7.30;1235;31;2845.00;117
6923;18;5713326;6923;621;8156;8271;4.01;0.25;333.95;7.30;1233;31;2846.00;115
6923;18;5713340;6923;625;8157;8271;4.03;0.25;333.95;7.30;1234;31;2847.00;114
6925;18;5713354;6925;621;8158;8271;4.02;0.25;333.89;7.31;1233;31;2848.00;113
6926;18;5713368;6926;628;8158;8271;4.01;0.25;333.90;7.31;1232;31;2849.00;113
6927;18;5713385;6927;641;8161;8274;3.99;0.24;333.92;7.31;1234;31;2850.00;113
6928;18;5713399;6928;641;8162;8274;3.98;0.24;333.89;7.31;1234;31;2851.00;112
6930;18;5713413;6930;639;8167;8280;3.98;0.24;333.89;7.31;1237;31;2852.00;113
6931;18;5713427;6931;634;8169;8281;3.96;0.24;333.89;7.31;1238;31;2853.00;112
6932;18;5713440;6932;625;8169;8281;3.92;0.24;333.89;7.31;1237;31;2854.00;112
6933;18;5713453;6933;616;8170;8281;3.89;0.24;333.85;7.31;1237;31;2855.00;111
6935;18;5713466;6935;611;8173;8285;3.90;0.24;333.86;7.31;1238;31;2856.00;112
6935;18;5713479;6935;613;8174;8285;3.93;0.24;333.86;7.31;1239;31;2857.00;111
6935;18;5713492;6935;607;8175;8285;4.00;0.24;333.86;7.31;1240;31;2858.00;110
6938;18;5713505;6938;606;8176;8286;4.05;0.25;333.90;7.31;1238;31;2859.00;110
6941;18;5713518;6941;598;8180;8290;4.07;0.25;333.96;7.31;1239;31;2860.00;110
6944;18;5713537;6944;582;8180;8290;4.10;0.25;334.07;7.31;1236;31;2861.00;110
6945;18;5713550;6945;557;8182;8293;4.18;0.26;334.02;7.31;1237;31;2862.00;111
6949;18;5713563;6949;538;8183;8293;4.28;0.26;334.14;7.31;1234;31;2863.00;110
6950;18;5713577;6950;521;8185;8295;4.43;0.27;334.14;7.31;1235;31;2864.00;110
6951;18;5713590;6951;506;8185;8295;4.56;0.28;334.14;7.31;1234;31;2865.00;110
6952;18;5713604;6952;499;8191;8299;4.75;0.29;334.15;7.34;1239;31;2866.00;108
6952;18;5713619;6952;493;8191;8299;4.89;0.30;334.15;7.34;1239;31;2867.00;108
6955;18;5713634;6955;487;8191;8299;5.01;0.31;334.25;7.34;1236;31;2868.00;108
6958;18;5713649;6958;479;8191;8299;5.16;0.31;334.23;7.34;1233;31;2869.00;108
6961;18;5713664;6961;478;8191;8300;5.26;0.32;334.22;7.34;1230;31;2870.00;109
6961;18;5713686;6961;479;8192;8301;5.38;0.33;334.22;7.34;1231;31;2871.00;109
6961;19;5713701;6961;471;8192;8301;5.47;0.33;334.22;7.34;1231;32;2872.00;109
6963;19;5713726;6963;464;8193;8302;5.50;0.33;334.20;7.34;1230;32;2873.00;109
6963;19;5713740;6963;462;8193;8302;5.54;0.34;334.20;7.34;1230;32;2874.00;109
6963;19;5713756;6963;457;8193;8302;5.55;0.34;334.20;7.34;1230;32;2875.00;109
6964;19;5713770;6964;450;8193;8302;5.58;0.34;334.22;7.34;1229;32;2876.00;109
6966;19;5713785;6966;443;8193;8302;5.59;0.34;334.24;7.34;1227;32;2877.00;109
6968;19;5713805;6968;441;8193;8302;5.61;0.34;334.20;7.34;1225;32;2878.00;109
6969;19;5713825;6969;438;8193;8302;5.64;0.34;334.21;7.34;1224;32;2879.00;109
6970;19;5713841;6970;477;8304;8532;5.86;0.37;334.23;7.25;1334;32;2880.00;228
6974;19;5713875;6974;463;8308;8533;5.87;0.37;334.45;7.24;1334;32;2881.00;225
6976;19;5713890;6976;439;8319;8533;5.97;0.37;334.45;7.24;1343;32;2882.00;214
6979;19;5713904;6979;434;8327;8533;6.02;0.37;334.54;7.27;1348;32;2883.00;206
6981;19;5713919;6981;426;8335;8533;6.02;0.37;334.51;7.27;1354;32;2884.00;198
6983;19;5713936;6983;431;8339;8533;6.06;0.38;334.48;7.27;1356;32;2885.00;194
6986;19;5713956;6986;432;8345;8533;6.09;0.38;334.53;7.27;1359;32;2886.00;188
6990;19;5713971;6990;438;8350;8533;6.06;0.37;334.56;7.27;1360;32;2887.00;183
6992;19;5713986;6992;440;8354;8534;6.05;0.37;334.58;7.27;1362;32;2888.00;180
6994;19;5714002;6994;459;8359;8535;6.01;0.37;334.54;7.27;1365;32;2889.00;176
6994;19;5714018;6994;460;8362;8535;5.95;0.37;334.54;7.27;1368;32;2890.00;173
6996;19;5714034;6996;464;8365;8536;5.91;0.37;334.62;7.27;1369;32;2891.00;171
6999;19;5714050;6999;472;8367;8536;5.86;0.36;334.75;7.27;1368;32;2892.00;169
7001;19;5714066;7001;492;8370;8536;5.77;0.36;334.82;7.28;1369;32;2893.00;166
7002;19;5714082;7002;502;8372;8536;5.73;0.35;334.85;7.28;1370;32;2894.00;164
7008;19;5714098;7008;505;8374;8540;5.65;0.35;334.99;7.28;1366;32;2895.00;166
7009;19;5714121;7009;503;8375;8540;5.60;0.34;335.05;7.28;1366;32;2896.00;165
7010;19;5714137;7010;509;8377;8540;5.60;0.34;335.09;7.28;1367;32;2897.00;163
7016;19;5714153;7016;507;8378;8543;5.57;0.34;335.18;7.28;1362;32;2898.00;165
7019;19;5714169;7019;502;8378;8543;5.59;0.34;335.23;7.28;1359;32;2899.00;165
7020;19;5714187;7020;490;8378;8543;5.63;0.34;335.20;7.28;1358;32;2900.00;165
7023;19;5714206;7023;486;8381;8547;5.63;0.34;335.32;7.27;1358;32;2901.00;166
7025;19;5714223;7025;475;8382;8548;5.70;0.35;335.29;7.27;1357;32;2902.00;166
7027;19;5714240;7027;474;8387;8548;5.72;0.35;335.33;7.28;1360;32;2903.00;161
7031;19;5714256;7031;470;8389;8552;5.76;0.35;335.60;7.28;1358;32;2904.00;163
7033;19;5714279;7033;469;8389;8552;5.80;0.35;335.71;7.28;1356;32;2905.00;163
7034;19;5714295;7034;470;8390;8552;5.81;0.35;335.75;7.28;1356;32;2906.00;162
7037;19;5714316;7037;461;8390;8553;5.77;0.35;335.88;7.28;1353;32;2907.00;163
7042;19;5714332;7042;458;8391;8553;5.72;0.35;335.92;7.28;1349;32;2908.00;162
7045;19;5714349;7045;449;8395;8559;5.72;0.35;336.10;7.28;1350;32;2909.00;164
7050;19;5714368;7050;431;8398;8559;5.72;0.35;336.19;7.33;1348;32;2910.00;161
7052;19;5714386;7052;431;8399;8560;5.71;0.35;336.20;7.34;1347;32;2911.00;161
7055;19;5714402;7055;430;8400;8560;5.70;0.35;336.14;7.34;1345;32;2912.00;160
7060;19;5714419;7060;424;8400;8560;5.76;0.35;336.20;7.34;1340;32;2913.00;160
7060;19;5714434;7060;436;8402;8560;5.81;0.35;336.20;7.34;1342;32;2914.00;158
7065;19;5714449;7065;445;8403;8560;5.78;0.35;336.34;7.34;1338;32;2915.00;157
7066;19;5714470;7066;443;8411;8572;5.84;0.36;336.39;7.33;1345;32;2916.00;161
7069;19;5714486;7069;439;8415;8572;5.84;0.36;336.39;7.38;1346;32;2917.00;157
7070;19;5714502;7070;440;8417;8572;5.86;0.36;336.36;7.43;1347;32;2918.00;155
7072;19;5714519;7072;443;8418;8572;5.86;0.36;336.35;7.43;1346;32;2919.00;154
7075;19;5714536;7075;443;8418;8572;5.85;0.36;336.39;7.43;1343;32;2920.00;154
7077;19;5714552;7077;451;8420;8572;5.88;0.36;336.41;7.44;1343;32;2921.00;152
7081;19;5714567;7081;446;8424;8576;5.88;0.36;336.58;7.44;1343;32;2922.00;152
7082;19;5714590;7082;452;8424;8576;5.88;0.36;336.55;7.44;1342;32;2923.00;152
7087;19;5714611;7087;450;8430;8580;5.81;0.35;336.64;7.45;1343;32;2924.00;150
7092;19;5714631;7092;456;8432;8582;5.76;0.35;336.92;7.45;1340;32;2925.00;150
7092;19;5714660;7092;450;8433;8582;5.70;0.35;336.92;7.44;1341;32;2926.00;149
7098;19;5714685;7098;459;8434;8582;5.58;0.34;337.04;7.45;1336;32;2927.00;148
7099;19;5714706;7099;460;8443;8595;5.57;0.34;337.03;7.44;1344;32;2928.00;152
7103;19;5714726;7103;451;8443;8595;5.52;0.34;337.26;7.44;1340;32;2929.00;152
7106;19;5714744;7106;449;8444;8595;5.46;0.33;337.36;7.45;1338;32;2930.00;151
7107;19;5714763;7107;450;8446;8596;5.47;0.33;337.43;7.49;1339;32;2931.00;150
7110;19;5714781;7110;456;8447;8597;5.44;0.33;337.43;7.50;1337;32;2932.00;150
7110;19;5714799;7110;464;8447;8597;5.43;0.33;337.43;7.50;1337;32;2933.00;150
7114;19;5714818;7114;467;8451;8600;5.41;0.33;337.42;7.55;1337;32;2934.00;149
7115;19;5714841;7115;474;8451;8600;5.42;0.33;337.44;7.55;1336;32;2935.00;149
7118;19;5714858;7118;474;8453;8600;5.45;0.33;337.47;7.56;1335;32;2936.00;147
7119;19;5714874;7119;479;8455;8600;5.49;0.34;337.43;7.61;1336;32;2937.00;145
7121;19;5714888;7121;485;8461;8606;5.54;0.34;337.36;7.61;1340;32;2938.00;145
7125;19;5714910;7125;491;8461;8606;5.50;0.34;337.47;7.61;1336;32;2939.00;145
7128;19;5714927;7128;494;8463;8606;5.45;0.33;337.67;7.67;1335;32;2940.00;143
7133;19;5714942;7133;493;8464;8606;5.41;0.33;337.66;7.67;1331;32;2941.00;142
7136;19;5714956;7136;492;8468;8610;5.41;0.33;337.70;7.67;1332;32;2942.00;142
7141;19;5714971;7141;492;8469;8611;5.38;0.33;337.83;7.67;1328;32;2943.00;142
7143;19;5714987;7143;504;8472;8611;5.39;0.33;337.90;7.76;1329;32;2944.00;139
7145;19;5715002;7145;509;8474;8612;5.41;0.33;338.00;7.81;1329;32;2945.00;138
7149;19;5715019;7149;511;8474;8612;5.37;0.33;338.04;7.81;1325;32;2946.00;138
7151;19;5715039;7151;516;8476;8612;5.32;0.33;338.25;7.90;1325;32;2947.00;136
7155;19;5715058;7155;521;8477;8612;5.25;0.32;338.33;7.95;1322;32;2948.00;135
7160;19;5715076;7160;517;8477;8612;5.19;0.32;338.57;7.95;1317;32;2949.00;135
7162;19;5715095;7162;530;8477;8612;5.15;0.31;338.55;7.95;1315;32;2950.00;135
7167;19;5715114;7167;527;8479;8612;5.08;0.31;338.49;8.04;1312;32;2951.00;133
7170;19;5715132;7170;534;8513;8682;5.22;0.32;338.58;8.05;1343;32;2952.00;169
7172;19;5715158;7172;525;8517;8683;5.23;0.32;338.66;8.10;1345;32;2953.00;166
7172;19;5715178;7172;528;8521;8683;5.28;0.32;338.66;8.09;1349;32;2954.00;162
7172;19;5715198;7172;527;8529;8683;5.33;0.33;338.66;8.18;1357;32;2955.00;154
7173;19;5715218;7173;518;8533;8683;5.37;0.33;338.78;8.17;1360;32;2956.00;150
7176;19;5715237;7176;521;8536;8683;5.39;0.33;338.73;8.17;1360;33;2957.00;147
7180;19;5715262;7180;512;8541;8683;5.39;0.33;338.87;8.26;1361;33;2958.00;142
7181;19;5715282;7181;509;8544;8683;5.42;0.33;338.91;8.26;1363;33;2959.00;139
7184;19;5715298;7184;508;8546;8684;5.36;0.33;338.82;8.26;1362;33;2960.00;138
7188;19;5715312;7188;511;8551;8685;5.32;0.32;338.88;8.34;1363;33;2961.00;134
7191;19;5715327;7191;516;8554;8685;5.24;0.32;338.78;8.34;1363;33;2962.00;131
7195;19;5715346;7195;520;8559;8689;5.18;0.32;338.90;8.42;1364;33;2963.00;130
7196;19;5715360;7196;524;8559;8689;5.15;0.31;338.97;8.42;1363;33;2964.00;130
7198;19;5715375;7198;527;8559;8689;5.12;0.31;339.04;8.42;1361;33;2965.00;130
7199;19;5715392;7199;528;8561;8689;5.11;0.31;339.06;8.51;1362;33;2966.00;128
7203;19;5715411;7203;529;8565;8695;5.06;0.31;339.30;8.50;1362;33;2967.00;130
7206;19;5715429;7206;548;8565;8695;4.99;0.30;339.44;8.50;1359;33;2968.00;130
7209;19;5715447;7209;549;8567;8695;4.86;0.30;339.57;8.58;1358;33;2969.00;128
7214;19;5715466;7214;545;8570;8701;4.74;0.29;339.69;8.58;1356;33;2970.00;131
7218;19;5715486;7218;540;8572;8701;4.68;0.29;339.75;8.66;1354;34;2971.00;129
7220;19;5715515;7220;541;8573;8701;4.63;0.28;339.84;8.66;1353;34;2972.00;128
7225;19;5715533;7225;529;8573;8702;4.58;0.28;340.15;8.66;1348;34;2973.00;129
7228;19;5715554;7228;536;8576;8703;4.58;0.28;340.09;8.74;1348;34;2974.00;127
7232;19;5715571;7232;531;8576;8703;4.52;0.28;340.21;8.74;1344;34;2975.00;127
7236;19;5715588;7236;538;8587;8716;4.51;0.28;340.35;8.76;1351;34;2976.00;129
7240;19;5715606;7240;534;8588;8716;4.48;0.28;340.20;8.80;1348;34;2977.00;128
7245;19;5715621;7245;534;8588;8716;4.43;0.27;340.22;8.80;1343;34;2978.00;128
7246;19;5715635;7246;530;8588;8717;4.43;0.27;340.19;8.80;1342;34;2979.00;129
7251;19;5715648;7251;522;8588;8717;4.38;0.27;340.12;8.80;1337;34;2980.00;129
7254;19;5715662;7254;530;8591;8721;4.35;0.27;340.08;8.80;1337;34;2981.00;130
7256;19;5715676;7256;534;8591;8721;4.33;0.27;340.00;8.80;1335;34;2982.00;130
7258;19;5715689;7258;541;8596;8725;4.30;0.26;339.94;8.80;1338;34;2983.00;129
7262;19;5715702;7262;551;8596;8725;4.26;0.26;339.90;8.80;1334;34;2984.00;129
7264;19;5715717;7264;556;8596;8725;4.24;0.26;339.84;8.80;1332;34;2985.00;129
7267;19;5715732;7267;559;8596;8725;4.22;0.26;339.83;8.80;1329;34;2986.00;129
7269;19;5715748;7269;568;8596;8725;4.21;0.26;339.79;8.80;1327;34;2987.00;129
7274;19;5715766;7274;574;8605;8737;4.26;0.26;339.68;8.79;1331;34;2988.00;132
7280;19;5715788;7280;582;8605;8737;4.24;0.26;339.62;8.79;1325;34;2989.00;132
7283;19;5715808;7283;584;8605;8737;4.23;0.26;339.61;8.79;1322;34;2990.00;132
7287;19;5715826;7287;576;8605;8737;4.19;0.26;339.56;8.79;1318;34;2991.00;132
7290;19;5715845;7290;569;8605;8737;4.18;0.26;339.53;8.79;1315;34;2992.00;132
7293;19;5715862;7293;564;8605;8737;4.13;0.25;339.49;8.79;1312;34;2993.00;132
7296;19;5715879;7296;564;8605;8738;4.11;0.25;339.49;8.79;1309;34;2994.00;133
7303;19;5715895;7303;564;8605;8738;4.02;0.25;339.44;8.79;1302;34;2995.00;133
7305;19;5715913;7305;561;8610;8744;4.00;0.25;339.42;8.79;1305;34;2996.00;134
7309;19;5715930;7309;565;8610;8745;3.93;0.24;339.45;8.79;1301;34;2997.00;135
7311;19;5715947;7311;570;8610;8745;3.87;0.24;339.48;8.79;1299;34;2998.00;135
7315;19;5715963;7315;578;8610;8745;3.83;0.23;339.45;8.79;1295;34;2999.00;135
7316;19;5715981;7316;584;8617;8765;3.84;0.24;339.48;8.78;1301;34;3000.00;148
7319;19;5716004;7319;587;8617;8765;3.83;0.23;339.49;8.78;1298;34;3001.00;148
7325;19;5716018;7325;594;8617;8765;3.78;0.23;339.50;8.78;1292;34;3002.00;148
7327;19;5716032;7327;600;8618;8766;3.81;0.23;339.59;8.78;1291;34;3003.00;148
7330;19;5716044;7330;602;8622;8770;3.84;0.24;339.69;8.78;1292;34;3004.00;148
7332;19;5716057;7332;610;8623;8770;3.81;0.23;339.70;8.78;1291;34;3005.00;147
7334;19;5716070;7334;615;8625;8773;3.84;0.24;339.69;8.78;1291;34;3006.00;148
7337;19;5716083;7337;602;8627;8773;3.82;0.23;339.70;8.78;1290;34;3007.00;146
7340;19;5716096;7340;594;8627;8773;3.83;0.23;339.67;8.78;1287;34;3008.00;146
7344;19;5716108;7344;592;8627;8773;3.86;0.24;339.63;8.78;1283;34;3009.00;146
7348;19;5716120;7348;585;8631;8777;3.86;0.24;339.72;8.78;1283;34;3010.00;146
7349;19;5716134;7349;574;8633;8777;3.90;0.24;339.74;8.78;1284;34;3011.00;144
7353;19;5716148;7353;572;8633;8777;3.92;0.24;339.72;8.78;1280;34;3012.00;144
7355;19;5716165;7355;566;8636;8777;3.93;0.24;339.78;8.79;1281;34;3013.00;141
7358;19;5716183;7358;558;8636;8778;3.97;0.24;339.78;8.79;1278;34;3014.00;142
7361;19;5716200;7361;559;8637;8780;4.01;0.24;339.81;8.79;1276;34;3015.00;143
7364;19;5716218;7364;556;8638;8780;4.02;0.24;339.81;8.79;1274;34;3016.00;142
7364;19;5716236;7364;545;8643;8781;4.05;0.25;339.81;8.79;1279;34;3017.00;138
7365;19;5716257;7365;536;8643;8781;4.05;0.25;339.83;8.79;1278;34;3018.00;138
7366;19;5716275;7366;535;8645;8781;4.12;0.25;339.83;8.79;1279;34;3019.00;136
7367;19;5716293;7367;527;8645;8781;4.19;0.26;339.83;8.79;1278;34;3020.00;136
7371;20;5716310;7371;524;8646;8781;4.22;0.26;339.90;8.79;1275;35;3021.00;135
7372;20;5716335;7372;527;8647;8781;4.29;0.26;339.90;8.79;1275;35;3022.00;134
7372;20;5716354;7372;521;8647;8781;4.35;0.27;339.90;8.79;1275;35;3023.00;134
7374;20;5716379;7374;543;8712;8908;4.70;0.29;339.95;8.73;1338;35;3024.00;196
7376;20;5716421;7376;542;8716;8909;4.73;0.29;340.04;8.72;1340;35;3025.00;193
7379;20;5716438;7379;526;8725;8909;4.77;0.29;340.06;8.72;1346;35;3026.00;184
7380;20;5716453;7380;516;8730;8909;4.85;0.30;340.08;8.71;1350;35;3027.00;179
7381;20;5716468;7381;495;8735;8909;4.93;0.30;340.08;8.71;1354;35;3028.00;174
7382;20;5716482;7382;491;8738;8909;4.99;0.31;340.08;8.71;1356;35;3029.00;171
7383;20;5716499;7383;489;8743;8909;5.03;0.31;340.15;8.77;1360;35;3030.00;166
7388;20;5716514;7388;484;8745;8909;5.06;0.31;340.28;8.77;1357;35;3031.00;164
7390;20;5716529;7390;479;8748;8910;5.08;0.31;340.27;8.77;1358;35;3032.00;162
7392;20;5716544;7392;486;8753;8911;5.09;0.31;340.35;8.77;1361;35;3033.00;158
7396;20;5716560;7396;483;8754;8911;5.11;0.31;340.27;8.77;1358;35;3034.00;157
7397;20;5716575;7397;491;8758;8912;5.13;0.31;340.39;8.77;1361;35;3035.00;154
7398;20;5716592;7398;488;8759;8912;5.09;0.31;340.51;8.77;1361;35;3036.00;153
7399;20;5716609;7399;484;8759;8912;5.09;0.31;340.51;8.77;1360;35;3037.00;153
7402;20;5716629;7402;481;8762;8912;5.07;0.31;340.57;8.77;1360;35;3038.00;150
7403;20;5716649;7403;482;8766;8916;5.11;0.31;340.57;8.77;1363;35;3039.00;150
7407;20;5716671;7407;477;8767;8916;5.14;0.31;340.65;8.77;1360;35;3040.00;149
7408;20;5716691;7408;471;8768;8916;5.18;0.32;340.70;8.77;1360;35;3041.00;148
7411;20;5716710;7411;468;8770;8919;5.21;0.32;340.84;8.77;1359;35;3042.00;149
7412;20;5716731;7412;469;8771;8919;5.23;0.32;340.84;8.77;1359;35;3043.00;148
7415;20;5716752;7415;469;8772;8919;5.24;0.32;340.85;8.78;1357;35;3044.00;147
7415;20;5716773;7415;471;8776;8923;5.25;0.32;340.85;8.77;1361;35;3045.00;147
7416;20;5716793;7416;466;8778;8924;5.33;0.32;340.83;8.77;1362;35;3046.00;146
7418;20;5716814;7418;478;8779;8924;5.37;0.33;340.91;8.77;1361;35;3047.00;145
7423;20;5716835;7423;479;8783;8928;5.40;0.33;341.01;8.77;1360;35;3048.00;145
7424;20;5716856;7424;482;8784;8928;5.39;0.33;341.11;8.77;1360;35;3049.00;144
7429;20;5716872;7429;489;8784;8928;5.34;0.32;341.42;8.77;1355;35;3050.00;144
7431;20;5716887;7431;493;8785;8929;5.32;0.32;341.46;8.77;1354;35;3051.00;144
7432;20;5716908;7432;495;8785;8929;5.27;0.32;341.46;8.77;1353;35;3052.00;144
7436;20;5716930;7436;501;8790;8935;5.26;0.32;341.56;8.76;1354;35;3053.00;145
7438;20;5716950;7438;503;8790;8935;5.23;0.32;341.56;8.76;1352;35;3054.00;145
7439;20;5716979;7439;502;8790;8936;5.24;0.32;341.59;8.76;1351;35;3055.00;146
7441;20;5717002;7441;505;8790;8936;5.24;0.32;341.74;8.76;1349;35;3056.00;146
7441;20;5717025;7441;499;8790;8936;5.21;0.32;341.74;8.76;1349;35;3057.00;146
7445;20;5717044;7445;495;8790;8936;5.19;0.32;341.86;8.76;1345;35;3058.00;146
7447;20;5717064;7447;492;8790;8936;5.18;0.31;341.96;8.76;1343;35;3059.00;146
7451;20;5717086;7451;492;8815;8972;5.26;0.32;342.06;8.74;1364;35;3060.00;157
7454;20;5717111;7454;487;8816;8972;5.27;0.32;342.16;8.74;1362;35;3061.00;156
7457;20;5717132;7457;485;8818;8972;5.27;0.32;342.19;8.74;1361;35;3062.00;154
7461;20;5717153;7461;482;8818;8972;5.31;0.32;342.22;8.74;1357;35;3063.00;154
7467;20;5717173;7467;472;8819;8972;5.31;0.32;342.22;8.74;1352;35;3064.00;153
7468;20;5717195;7468;466;8820;8972;5.33;0.32;342.33;8.74;1352;35;3065.00;152
7472;20;5717211;7472;458;8823;8976;5.33;0.32;342.45;8.73;1351;35;3066.00;153
7476;20;5717228;7476;457;8823;8976;5.39;0.33;342.50;8.73;1347;35;3067.00;153
7478;20;5717244;7478;446;8827;8980;5.49;0.33;342.58;8.73;1349;35;3068.00;153
7481;20;5717259;7481;440;8828;8981;5.56;0.34;342.69;8.73;1347;35;3069.00;153
7484;20;5717276;7484;435;8828;8981;5.56;0.34;342.74;8.73;1344;35;3070.00;153
7486;20;5717291;7486;435;8828;8981;5.60;0.34;342.75;8.73;1342;35;3071.00;153
7490;20;5717305;7490;429;8837;8994;5.62;0.34;342.88;8.72;1347;35;3072.00;157
7491;20;5717322;7491;425;8838;8994;5.68;0.35;342.90;8.72;1347;35;3073.00;156
7493;20;5717338;7493;430;8838;8994;5.71;0.35;342.97;8.72;1345;35;3074.00;156
7497;20;5717355;7497;430;8839;8995;5.73;0.35;343.02;8.72;1342;35;3075.00;156
7501;20;5717376;7501;428;8841;8996;5.73;0.35;343.15;8.82;1340;35;3076.00;155
7504;20;5717399;7504;429;8841;8996;5.76;0.35;343.17;8.82;1337;35;3077.00;155
7510;20;5717419;7510;426;8844;8999;5.76;0.35;343.35;8.81;1334;35;3078.00;155
7514;20;5717442;7514;427;8845;8999;5.83;0.35;343.50;8.81;1331;35;3079.00;154
7514;20;5717462;7514;435;8845;8999;5.87;0.36;343.50;8.81;1331;35;3080.00;154
7518;20;5717481;7518;431;8846;8999;5.83;0.35;343.44;8.81;1328;35;3081.00;153
7520;20;5717502;7520;437;8851;9005;5.87;0.36;343.40;8.81;1331;35;3082.00;154
7522;20;5717523;7522;440;8851;9005;5.84;0.36;343.50;8.81;1329;35;3083.00;154
7524;20;5717542;7524;451;8851;9005;5.80;0.35;343.46;8.81;1327;35;3084.00;154
7528;20;5717561;7528;449;8851;9005;5.71;0.35;343.49;8.81;1323;35;3085.00;154
7532;20;5717579;7532;458;8854;9009;5.62;0.34;343.54;8.81;1322;35;3086.00;155
7535;20;5717599;7535;458;8855;9010;5.55;0.34;343.55;8.81;1320;35;3087.00;155
7539;20;5717615;7539;463;8855;9010;5.48;0.33;343.62;8.81;1316;35;3088.00;155
7542;20;5717632;7542;465;8856;9011;5.41;0.33;343.73;8.80;1314;35;3089.00;155
7546;20;5717648;7546;467;8856;9011;5.36;0.33;343.72;8.80;1310;35;3090.00;155
7548;20;5717663;7548;464;8856;9011;5.30;0.32;343.76;8.80;1308;35;3091.00;155
7549;20;5717677;7549;473;8856;9011;5.28;0.32;343.81;8.80;1307;35;3092.00;155
7553;20;5717697;7553;466;8856;9011;5.19;0.32;343.94;8.80;1303;35;3093.00;155
7554;20;5717712;7554;468;8856;9011;5.11;0.31;343.94;8.80;1302;35;3094.00;155
7557;20;5717729;7557;475;8856;9011;5.07;0.31;344.02;8.80;1299;35;3095.00;155
7560;20;5717746;7560;481;8893;9081;5.23;0.32;344.06;8.77;1333;35;3096.00;188
7561;20;5717771;7561;472;8895;9082;5.25;0.32;344.05;8.77;1334;35;3097.00;187
7562;20;5717789;7562;475;8902;9082;5.31;0.32;344.15;8.76;1340;35;3098.00;180
7566;20;5717809;7566;484;8902;9082;5.32;0.32;344.25;8.76;1336;35;3099.00;180
7567;20;5717828;7567;487;8907;9082;5.38;0.33;344.30;8.81;1340;35;3100.00;175
7569;20;5717868;7569;491;8910;9082;5.44;0.33;344.39;8.81;1341;35;3101.00;172
7571;21;5717889;7571;492;8913;9082;5.48;0.33;344.40;8.81;1342;36;3102.00;169
7576;21;5717915;7576;507;8917;9082;5.54;0.34;344.49;8.85;1341;36;3103.00;165
7581;21;5717934;7581;508;8919;9083;5.49;0.33;344.47;8.85;1338;36;3104.00;164
7583;21;5717954;7583;517;8923;9085;5.48;0.33;344.55;8.90;1340;36;3105.00;162
7586;21;5717975;7586;523;8926;9085;5.45;0.33;344.61;8.90;1340;36;3106.00;159
7588;21;5717994;7588;522;8930;9089;5.39;0.33;344.54;8.90;1342;36;3107.00;159
7593;21;5718011;7593;530;8932;9089;5.31;0.32;344.87;8.95;1339;36;3108.00;157
7597;21;5718031;7597;544;8932;9089;5.24;0.32;344.99;8.95;1335;36;3109.00;157
7597;21;5718046;7597;551;8933;9089;5.20;0.32;344.99;8.99;1336;36;3110.00;156
7598;21;5718060;7598;567;8938;9095;5.21;0.32;345.05;8.99;1340;36;3111.00;157
7602;21;5718076;7602;569;8940;9095;5.12;0.31;345.06;9.09;1338;36;3112.00;155
7603;21;5718090;7603;581;8940;9095;5.04;0.31;345.19;9.09;1337;36;3113.00;155
7607;21;5718104;7607;593;8942;9098;4.96;0.30;345.27;9.08;1335;36;3114.00;156
7607;21;5718118;7607;596;8944;9098;4.90;0.30;345.27;9.18;1337;36;3115.00;154
7612;21;5718131;7612;603;8945;9098;4.83;0.29;345.28;9.18;1333;36;3116.00;153
7614;21;5718145;7614;619;8945;9099;4.76;0.29;345.32;9.18;1331;36;3117.00;154
7615;21;5718158;7615;621;8946;9100;4.74;0.29;345.33;9.18;1331;36;3118.00;154
7618;21;5718172;7618;626;8946;9100;4.69;0.29;345.49;9.18;1328;36;3119.00;154
7620;21;5718187;7620;631;8966;9126;4.75;0.29;345.42;9.25;1346;36;3120.00;160
7622;21;5718202;7622;627;8967;9126;4.75;0.29;345.37;9.25;1345;36;3121.00;159
7626;21;5718216;7626;625;8970;9126;4.74;0.29;345.46;9.25;1344;36;3122.00;156
7627;21;5718232;7627;622;8971;9127;4.77;0.29;345.45;9.25;1344;36;3123.00;156
7627;21;5718248;7627;619;8971;9127;4.77;0.29;345.45;9.25;1344;36;3124.00;156
7631;21;5718264;7631;624;8975;9131;4.73;0.29;345.54;9.24;1344;36;3125.00;156
7634;21;5718280;7634;625;8975;9131;4.66;0.28;345.67;9.24;1341;36;3126.00;156
7637;21;5718294;7637;630;8978;9135;4.63;0.28;345.70;9.24;1341;36;3127.00;157
7641;21;5718310;7641;633;8978;9135;4.57;0.28;345.68;9.24;1337;36;3128.00;157
7644;21;5718325;7644;642;8978;9135;4.53;0.28;345.67;9.24;1334;36;3129.00;157
7650;21;5718342;7650;643;8978;9135;4.50;0.27;345.68;9.24;1328;36;3130.00;157
7653;21;5718362;7653;643;8978;9135;4.44;0.27;345.67;9.24;1325;36;3131.00;157
7656;21;5718380;7656;648;8988;9147;4.44;0.27;345.68;9.23;1332;36;3132.00;159
7659;21;5718399;7659;649;8988;9147;4.36;0.27;345.64;9.23;1329;36;3133.00;159
7661;21;5718417;7661;658;8989;9147;4.26;0.26;345.63;9.23;1328;36;3134.00;158
7664;21;5718436;7664;651;8989;9147;4.16;0.25;345.67;9.23;1325;36;3135.00;158
7665;21;5718453;7665;653;8989;9147;4.09;0.25;345.65;9.23;1324;36;3136.00;158
7671;21;5718471;7671;644;8989;9147;3.98;0.24;345.56;9.23;1318;36;3137.00;158
7674;21;5718492;7674;645;8989;9148;3.93;0.24;345.59;9.23;1315;36;3138.00;159
7676;21;5718508;7676;648;8989;9148;3.91;0.24;345.58;9.23;1313;36;3139.00;159
7677;21;5718527;7677;659;8994;9154;3.98;0.24;345.61;9.22;1317;36;3140.00;160
7680;21;5718545;7680;656;8995;9155;3.99;0.24;345.57;9.22;1315;36;3141.00;160
7683;21;5718560;7683;658;8995;9155;3.95;0.24;345.56;9.22;1312;36;3142.00;160
7684;21;5718579;7684;657;8995;9155;3.93;0.24;345.58;9.22;1311;36;3143.00;160
7691;21;5718592;7691;656;8998;9159;3.93;0.24;345.51;9.22;1307;36;3144.00;161
7694;21;5718607;7694;655;8998;9159;3.89;0.24;345.51;9.22;1304;36;3145.00;161
7695;21;5718621;7695;655;8998;9159;3.87;0.24;345.51;9.22;1303;36;3146.00;161
7698;21;5718635;7698;652;8999;9160;3.82;0.23;345.48;9.22;1301;36;3147.00;161
7698;21;5718648;7698;651;9002;9164;3.85;0.23;345.48;9.22;1304;36;3148.00;162
7702;21;5718664;7702;659;9002;9164;3.80;0.23;345.58;9.22;1300;36;3149.00;162
7704;21;5718683;7704;662;9006;9170;3.84;0.23;345.53;9.21;1302;36;3150.00;164
7707;21;5718701;7707;655;9006;9170;3.82;0.23;345.49;9.21;1299;36;3151.00;164
7709;21;5718719;7709;650;9008;9170;3.83;0.23;345.48;9.21;1299;36;3152.00;162
7713;21;5718737;7713;657;9008;9170;3.82;0.23;345.45;9.21;1295;36;3153.00;162
7715;21;5718755;7715;644;9012;9174;3.88;0.24;345.42;9.21;1297;36;3154.00;162
7715;21;5718773;7715;648;9012;9174;3.94;0.24;345.42;9.21;1297;36;3155.00;162
7717;21;5718790;7717;636;9012;9174;3.93;0.24;345.41;9.21;1295;36;3156.00;162
7724;21;5718808;7724;626;9012;9174;3.89;0.24;345.27;9.21;1288;36;3157.00;162
7724;21;5718825;7724;620;9012;9175;3.91;0.24;345.27;9.21;1288;36;3158.00;163
7730;21;5718843;7730;613;9013;9176;3.88;0.24;345.35;9.21;1283;36;3159.00;163
7731;21;5718860;7731;612;9013;9176;3.94;0.24;345.38;9.21;1282;36;3160.00;163
7732;21;5718883;7732;600;9014;9177;4.02;0.24;345.38;9.21;1282;36;3161.00;163
7732;21;5718901;7732;590;9014;9177;4.09;0.25;345.38;9.21;1282;36;3162.00;163
7735;21;5718916;7735;593;9015;9177;4.12;0.25;345.38;9.28;1280;36;3163.00;162
7738;21;5718932;7738;591;9015;9177;4.15;0.25;345.41;9.28;1277;36;3164.00;162
7740;21;5718945;7740;580;9015;9177;4.17;0.25;345.44;9.28;1275;36;3165.00;162
7743;21;5718959;7743;584;9015;9177;4.20;0.26;345.44;9.28;1272;36;3166.00;162
7747;21;5718972;7747;581;9015;9177;4.23;0.26;345.44;9.28;1268;36;3167.00;162
7748;22;5718985;7748;591;9088;9304;4.60;0.28;345.49;9.20;1340;37;3168.00;216
7750;22;5719025;7750;582;9091;9305;4.69;0.29;345.53;9.20;1341;37;3169.00;214
7752;22;5719039;7752;579;9096;9305;4.78;0.30;345.52;9.20;1344;37;3170.00;209
7756;22;5719062;7756;581;9101;9305;4.78;0.30;345.56;9.19;1345;37;3171.00;204
7762;22;5719077;7762;575;9104;9305;4.77;0.29;345.68;9.19;1342;37;3172.00;201
7763;22;5719092;7763;568;9108;9305;4.80;0.30;345.69;9.19;1345;37;3173.00;197
7769;22;5719112;7769;565;9110;9305;4.77;0.29;345.69;9.19;1341;37;3174.00;195
7773;22;5719126;7773;570;9113;9305;4.78;0.29;345.66;9.19;1340;37;3175.00;192
7776;22;5719141;7776;568;9116;9306;4.81;0.30;345.81;9.19;1340;37;3176.00;190
7778;22;5719156;7778;567;9116;9307;4.79;0.29;345.80;9.19;1338;37;3177.00;191
7782;22;5719170;7782;573;9119;9307;4.74;0.29;345.88;9.19;1337;37;3178.00;188
7784;22;5719185;7784;573;9121;9308;4.73;0.29;345.94;9.19;1337;37;3179.00;187
7788;22;5719201;7788;576;9123;9308;4.71;0.29;345.94;9.19;1335;37;3180.00;185
7791;22;5719217;7791;580;9124;9308;4.70;0.29;345.95;9.26;1333;37;3181.00;184
7795;22;5719231;7795;576;9126;9308;4.68;0.29;346.07;9.26;1331;37;3182.00;182
7797;22;5719249;7797;577;9130;9312;4.69;0.29;346.09;9.26;1333;37;3183.00;182
7800;22;5719266;7800;582;9133;9312;4.69;0.29;346.22;9.26;1333;37;3184.00;179
7801;22;5719282;7801;576;9133;9312;4.72;0.29;346.18;9.26;1332;37;3185.00;179
7805;22;5719298;7805;581;9136;9315;4.77;0.29;346.35;9.26;1331;37;3186.00;179
7808;22;5719314;7808;586;9136;9315;4.76;0.29;346.49;9.26;1328;37;3187.00;179
7810;22;5719335;7810;583;9137;9315;4.74;0.29;346.56;9.26;1327;37;3188.00;178
7816;22;5719352;7816;578;9141;9319;4.71;0.29;346.71;9.26;1325;37;3189.00;178
7817;22;5719368;7817;581;9143;9320;4.73;0.29;346.66;9.26;1326;37;3190.00;177
7822;22;5719384;7822;566;9146;9322;4.76;0.29;346.74;9.26;1324;37;3191.00;176
7825;22;5719401;7825;556;9150;9326;4.83;0.30;346.99;9.26;1325;37;3192.00;176
7825;22;5719417;7825;547;9151;9326;4.88;0.30;346.99;9.26;1326;37;3193.00;175
7828;22;5719433;7828;541;9152;9326;4.88;0.30;347.15;9.26;1324;37;3194.00;174
7830;22;5719449;7830;527;9154;9328;4.88;0.30;347.24;9.25;1324;37;3195.00;174
7832;22;5719465;7832;522;9154;9328;4.89;0.30;347.25;9.25;1322;37;3196.00;174
7835;22;5719481;7835;526;9160;9334;4.88;0.30;347.52;9.32;1325;37;3197.00;174
7835;22;5719496;7835;535;9160;9334;4.90;0.30;347.52;9.32;1325;37;3198.00;174
7837;22;5719511;7837;532;9160;9335;4.86;0.30;347.74;9.32;1323;37;3199.00;175
7838;22;5719534;7838;538;9160;9335;4.88;0.30;347.86;9.32;1322;37;3200.00;175
7841;22;5719553;7841;533;9160;9335;4.90;0.30;347.94;9.32;1319;37;3201.00;175
7844;22;5719569;7844;528;9160;9335;4.92;0.30;347.95;9.32;1316;37;3202.00;175
7848;22;5719583;7848;532;9160;9335;4.93;0.30;347.98;9.32;1312;37;3203.00;175
7850;22;5719599;7850;525;9170;9347;5.06;0.31;348.14;9.31;1320;37;3204.00;177
7850;22;5719614;7850;523;9170;9347;5.07;0.31;348.14;9.31;1320;37;3205.00;177
7853;22;5719628;7853;523;9171;9347;5.07;0.31;348.15;9.31;1318;37;3206.00;176
7854;22;5719644;7854;521;9171;9347;5.07;0.31;348.16;9.31;1317;37;3207.00;176
7857;22;5719658;7857;515;9171;9347;5.04;0.31;348.18;9.31;1314;37;3208.00;176
7860;22;5719674;7860;513;9171;9347;5.01;0.31;348.25;9.31;1311;37;3209.00;176
7862;22;5719691;7862;521;9174;9351;5.02;0.31;348.33;9.31;1312;37;3210.00;177
7865;22;5719707;7865;524;9174;9351;5.01;0.31;348.55;9.31;1309;37;3211.00;177
7866;22;5719722;7866;530;9178;9355;5.10;0.31;348.53;9.31;1312;37;3212.00;177
7870;22;5719737;7870;523;9179;9356;5.15;0.31;348.54;9.30;1309;37;3213.00;177
7872;22;5719751;7872;523;9179;9356;5.15;0.31;348.59;9.30;1307;37;3214.00;177
7874;22;5719765;7874;529;9179;9356;5.15;0.31;348.64;9.30;1305;37;3215.00;177
7877;22;5719779;7877;535;9191;9369;5.27;0.32;348.62;9.37;1314;37;3216.00;178
7880;22;5719796;7880;530;9191;9369;5.29;0.32;348.66;9.37;1311;37;3217.00;178
7881;22;5719812;7881;523;9191;9369;5.25;0.32;348.64;9.37;1310;37;3218.00;178
7884;22;5719827;7884;525;9192;9370;5.29;0.32;348.75;9.37;1308;37;3219.00;178
7886;22;5719844;7886;520;9192;9371;5.33;0.32;348.86;9.37;1306;37;3220.00;179
7889;22;5719860;7889;514;9192;9371;5.31;0.32;348.86;9.37;1303;37;3221.00;179
7889;22;5719875;7889;514;9194;9374;5.30;0.32;348.86;9.36;1305;37;3222.00;180
7895;22;5719903;7895;505;9194;9374;5.25;0.32;349.05;9.36;1299;37;3223.00;180
7895;22;5719918;7895;501;9195;9374;5.23;0.32;349.05;9.36;1300;37;3224.00;179
7900;22;5719933;7900;493;9195;9374;5.23;0.32;349.08;9.36;1295;37;3225.00;179
7904;22;5719949;7904;492;9200;9380;5.23;0.32;349.02;9.36;1296;37;3226.00;180
7906;22;5719966;7906;485;9200;9380;5.15;0.31;349.01;9.36;1294;37;3227.00;180
7907;22;5719981;7907;477;9200;9380;5.11;0.31;348.97;9.36;1293;37;3228.00;180
7911;22;5719996;7911;471;9200;9380;5.10;0.31;348.96;9.36;1289;37;3229.00;180
7915;22;5720012;7915;466;9203;9384;5.08;0.31;349.02;9.36;1288;37;3230.00;181
7918;22;5720029;7918;466;9204;9385;5.08;0.31;349.08;9.36;1286;37;3231.00;181
7920;22;5720044;7920;460;9204;9385;5.07;0.31;349.11;9.36;1284;37;3232.00;181
7925;22;5720059;7925;453;9205;9386;5.08;0.31;349.25;9.35;1280;37;3233.00;181
7926;22;5720075;7926;440;9205;9386;5.12;0.31;349.26;9.35;1279;37;3234.00;181
7931;22;5720090;7931;440;9205;9386;5.12;0.31;349.48;9.35;1274;37;3235.00;181
7933;22;5720104;7933;420;9205;9386;5.16;0.31;349.51;9.35;1272;37;3236.00;181
7935;22;5720119;7935;412;9205;9386;5.18;0.31;349.57;9.35;1270;37;3237.00;181
7937;22;5720133;7937;410;9205;9386;5.21;0.32;349.57;9.35;1268;37;3238.00;181
7939;22;5720148;7939;407;9205;9386;5.23;0.32;349.56;9.35;1266;37;3239.00;181
7942;22;5720164;7942;413;9266;9511;5.40;0.33;349.64;9.41;1324;37;3240.00;245
7945;22;5720192;7945;410;9268;9512;5.39;0.33;349.67;9.41;1323;37;3241.00;244
7949;22;5720207;7949;410;9278;9512;5.42;0.33;349.71;9.40;1329;37;3242.00;234
7953;22;5720223;7953;413;9280;9512;5.43;0.33;349.80;9.40;1327;37;3243.00;232
7955;22;5720239;7955;423;9287;9512;5.46;0.33;349.75;9.39;1332;37;3244.00;225
7958;22;5720254;7958;419;9292;9512;5.44;0.33;349.94;9.39;1334;37;3245.00;220
7960;22;5720275;7960;417;9297;9512;5.45;0.33;349.95;9.39;1337;37;3246.00;215
7962;22;5720290;7962;427;9301;9512;5.46;0.33;349.90;9.39;1339;37;3247.00;211
7966;22;5720304;7966;433;9306;9513;5.42;0.33;349.95;9.39;1340;37;3248.00;207
7967;22;5720319;7967;437;9309;9514;5.41;0.33;350.05;9.39;1342;37;3249.00;205
7972;22;5720334;7972;436;9311;9514;5.37;0.33;350.10;9.39;1339;37;3250.00;203
7976;22;5720349;7976;440;9316;9518;5.24;0.32;350.27;9.38;1340;37;3251.00;202
7978;22;5720364;7978;444;9316;9518;5.15;0.31;350.33;9.38;1338;37;3252.00;202
7980;22;5720378;7980;451;9317;9518;5.09;0.31;350.31;9.38;1337;37;3253.00;201
7981;22;5720392;7981;451;9317;9518;5.06;0.31;350.31;9.38;1336;37;3254.00;201
7983;22;5720405;7983;454;9321;9524;5.06;0.31;350.44;9.38;1338;37;3255.00;203
7986;22;5720420;7986;450;9321;9524;5.03;0.31;350.52;9.38;1335;37;3256.00;203
7986;22;5720435;7986;454;9321;9524;5.01;0.31;350.52;9.38;1335;37;3257.00;203
7989;22;5720449;7989;457;9323;9527;5.01;0.31;350.69;9.38;1334;37;3258.00;204
7991;22;5720463;7991;462;9323;9527;4.97;0.30;350.68;9.38;1332;37;3259.00;204
7992;22;5720477;7992;467;9324;9527;4.95;0.30;350.69;9.38;1332;37;3260.00;203
7995;22;5720491;7995;466;9324;9528;4.87;0.30;350.70;9.38;1329;37;3261.00;204
8001;22;5720504;8001;467;9325;9529;4.78;0.29;350.80;9.38;1324;37;3262.00;204
8002;22;5720518;8002;475;9325;9529;4.74;0.29;350.77;9.38;1323;37;3263.00;204
8002;22;5720531;8002;482;9337;9542;4.75;0.29;350.77;9.37;1335;37;3264.00;205
8006;22;5720547;8006;490;9337;9542;4.68;0.29;350.92;9.37;1331;37;3265.00;205
8009;22;5720561;8009;499;9338;9542;4.67;0.29;350.83;9.43;1329;37;3266.00;204
8011;22;5720575;8011;497;9339;9543;4.65;0.28;350.79;9.42;1328;37;3267.00;204
8014;22;5720589;8014;509;9339;9543;4.65;0.29;350.88;9.42;1325;37;3268.00;204
8017;22;5720602;8017;511;9344;9547;4.68;0.29;350.86;9.48;1327;37;3269.00;203
8019;22;5720617;8019;522;9344;9547;4.66;0.28;350.81;9.48;1325;37;3270.00;203
8019;22;5720632;8019;521;9348;9551;4.64;0.28;350.81;9.54;1329;37;3271.00;203
8022;22;5720644;8022;527;9348;9551;4.60;0.28;350.75;9.54;1326;37;3272.00;203
8024;22;5720663;8024;536;9349;9551;4.58;0.28;350.69;9.60;1325;37;3273.00;202
8027;22;5720677;8027;534;9353;9551;4.48;0.27;350.65;9.83;1326;37;3274.00;198
8028;22;5720690;8028;542;9353;9551;4.42;0.27;350.63;9.83;1325;37;3275.00;198
8030;22;5720703;8030;550;9363;9563;4.44;0.27;350.57;9.82;1333;37;3276.00;200
8031;22;5720717;8031;552;9363;9563;4.38;0.27;350.53;9.82;1332;37;3277.00;200
8034;22;5720731;8034;564;9366;9563;4.33;0.27;350.44;9.93;1332;37;3278.00;197
8036;22;5720744;8036;580;9366;9563;4.29;0.26;350.41;9.93;1330;37;3279.00;197
8037;22;5720757;8037;585;9367;9563;4.26;0.26;350.38;9.99;1330;37;3280.00;196
8039;22;5720769;8039;587;9368;9563;4.18;0.26;350.41;10.04;1329;37;3281.00;195
8042;22;5720782;8042;593;9368;9564;4.09;0.25;350.31;10.04;1326;37;3282.00;196
8042;22;5720794;8042;606;9370;9564;4.04;0.25;350.31;10.16;1328;37;3283.00;194
8042;22;5720807;8042;605;9375;9570;4.03;0.25;350.31;10.15;1333;37;3284.00;195
8043;22;5720819;8043;608;9377;9572;4.01;0.25;350.32;10.15;1334;37;3285.00;195
8046;22;5720831;8046;606;9379;9572;3.95;0.24;350.31;10.26;1333;37;3286.00;193
8050;22;5720844;8050;607;9379;9572;3.91;0.24;350.20;10.26;1329;37;3287.00;193
8050;22;5720857;8050;603;9384;9576;3.94;0.24;350.20;10.37;1334;37;3288.00;192
8051;22;5720871;8051;607;9384;9576;3.91;0.24;350.28;10.37;1333;37;3289.00;192
8051;22;5720883;8051;614;9384;9576;3.89;0.24;350.28;10.37;1333;37;3290.00;192
8052;22;5720895;8052;621;9387;9577;3.88;0.24;350.24;10.48;1335;37;3291.00;190
8055;22;5720907;8055;628;9390;9581;3.84;0.24;350.21;10.47;1335;37;3292.00;191
8056;22;5720920;8056;631;9390;9581;3.86;0.24;350.18;10.47;1334;37;3293.00;191
8059;22;5720932;8059;632;9392;9584;3.82;0.23;350.13;10.47;1333;37;3294.00;192
8062;22;5720949;8062;631;9392;9584;3.76;0.23;350.05;10.47;1330;37;3295.00;192
8063;22;5720965;8063;633;9393;9584;3.71;0.23;350.02;10.47;1330;37;3296.00;191
8065;22;5720982;8065;637;9393;9584;3.67;0.22;350.04;10.47;1328;37;3297.00;191
8066;22;5720999;8066;637;9397;9588;3.70;0.23;350.10;10.47;1331;37;3298.00;191
8069;22;5721017;8069;645;9397;9588;3.62;0.22;350.13;10.47;1328;38;3299.00;191
8074;22;5721046;8074;636;9402;9607;3.54;0.22;350.15;10.46;1328;38;3300.00;205
8076;22;5721069;8076;608;9402;9607;3.54;0.22;350.19;10.46;1326;38;3301.00;205
8077;22;5721086;8077;584;9402;9608;3.55;0.22;350.15;10.46;1325;38;3302.00;206
8079;22;5721103;8079;565;9403;9609;3.59;0.22;350.18;10.46;1324;38;3303.00;206
8082;22;5721120;8082;540;9403;9609;3.62;0.22;350.12;10.46;1321;38;3304.00;206
8084;22;5721136;8084;539;9405;9610;3.68;0.23;350.16;10.46;1321;38;3305.00;205
8086;22;5721149;8086;536;9406;9610;3.74;0.23;350.13;10.46;1320;39;3306.00;204
8088;22;5721167;8088;527;9406;9610;3.81;0.23;350.13;10.46;1318;39;3307.00;204
8090;22;5721188;8090;517;9406;9610;3.84;0.23;350.12;10.46;1316;39;3308.00;204
8093;22;5721201;8093;505;9406;9610;3.86;0.24;350.13;10.46;1313;39;3309.00;204
8095;22;5721214;8095;495;9406;9610;3.90;0.24;350.13;10.46;1311;39;3310.00;204
8095;22;5721227;8095;506;9407;9610;3.96;0.24;350.13;10.46;1312;39;3311.00;203
8096;22;5721241;8096;491;9472;9737;4.36;0.27;350.15;10.39;1376;39;3312.00;265
8097;22;5721264;8097;488;9476;9738;4.43;0.27;350.11;10.38;1379;39;3313.00;262
8100;22;5721282;8100;483;9483;9738;4.53;0.28;350.07;10.38;1383;39;3314.00;255
8105;22;5721299;8105;480;9487;9738;4.53;0.28;350.04;10.37;1382;39;3315.00;251
8105;22;5721328;8105;481;9491;9738;4.58;0.28;350.04;10.37;1386;39;3316.00;247
8107;22;5721346;8107;471;9492;9738;4.65;0.29;350.02;10.37;1385;39;3317.00;246
8110;22;5721364;8110;473;9497;9738;4.66;0.29;350.01;10.37;1387;39;3318.00;241
8110;22;5721383;8110;474;9499;9738;4.70;0.29;350.01;10.37;1389;39;3319.00;239
8114;22;5721402;8114;469;9501;9739;4.73;0.29;349.92;10.37;1387;39;3320.00;238
8118;22;5721423;8118;466;9506;9740;4.71;0.29;349.92;10.45;1388;39;3321.00;234
8118;22;5721443;8118;470;9509;9740;4.70;0.29;349.92;10.45;1391;39;3322.00;231
8122;22;5721460;8122;475;9510;9741;4.65;0.29;349.97;10.45;1388;39;3323.00;231
8126;22;5721477;8126;471;9514;9741;4.59;0.28;349.90;10.46;1388;39;3324.00;227
8128;22;5721492;8128;470;9515;9741;4.57;0.28;349.90;10.46;1387;39;3325.00;226
8133;22;5721507;8133;468;9516;9741;4.50;0.28;349.95;10.46;1383;39;3326.00;225
8138;22;5721522;8138;469;9520;9745;4.47;0.28;349.97;10.46;1382;39;3327.00;225
8142;22;5721537;8142;473;9522;9745;4.45;0.28;350.03;10.46;1380;39;3328.00;223
8148;22;5721552;8148;473;9525;9745;4.40;0.27;350.30;10.46;1377;39;3329.00;220
8151;22;5721569;8151;475;9529;9751;4.41;0.27;350.34;10.46;1378;39;3330.00;222
8155;22;5721585;8155;487;9531;9751;4.43;0.27;350.33;10.46;1376;39;3331.00;220
8161;22;5721604;8161;489;9532;9751;4.42;0.27;350.59;10.46;1371;39;3332.00;219
8166;22;5721624;8166;492;9537;9755;4.48;0.27;350.70;10.46;1371;39;3333.00;218
8167;22;5721644;8167;490;9538;9756;4.52;0.28;350.70;10.46;1371;39;3334.00;218
8173;22;5721663;8173;498;9541;9756;4.52;0.28;350.79;10.46;1368;39;3335.00;215
8176;22;5721692;8176;508;9543;9760;4.59;0.28;350.86;10.46;1367;39;3336.00;217
8179;22;5721714;8179;507;9545;9760;4.60;0.28;350.94;10.46;1366;39;3337.00;215
8182;22;5721733;8182;515;9546;9760;4.63;0.28;351.07;10.46;1364;39;3338.00;214
8186;22;5721754;8186;519;9547;9761;4.61;0.28;351.06;10.46;1361;39;3339.00;214
8189;22;5721781;8189;526;9548;9761;4.62;0.28;351.15;10.46;1359;39;3340.00;213
8194;22;5721800;8194;525;9553;9767;4.54;0.28;351.09;10.46;1359;39;3341.00;214
8196;22;5721821;8196;521;9554;9767;4.53;0.28;351.20;10.46;1358;39;3342.00;213
8201;22;5721836;8201;518;9557;9768;4.47;0.27;351.37;10.47;1356;39;3343.00;211
8203;22;5721851;8203;531;9559;9768;4.47;0.28;351.53;10.47;1356;39;3344.00;209
8207;22;5721865;8207;535;9560;9768;4.45;0.27;351.56;10.47;1353;39;3345.00;208
8209;22;5721880;8209;534;9560;9768;4.45;0.27;351.62;10.47;1351;39;3346.00;208
8212;22;5721895;8212;538;9560;9768;4.47;0.27;351.75;10.47;1348;39;3347.00;208
8214;22;5721909;8214;524;9571;9780;4.51;0.28;351.73;10.45;1357;39;3348.00;209
8216;22;5721928;8216;524;9571;9780;4.54;0.28;351.93;10.45;1355;39;3349.00;209
8219;22;5721948;8219;518;9571;9780;4.56;0.28;352.03;10.45;1352;39;3350.00;209
8223;22;5721966;8223;515;9571;9780;4.54;0.28;352.02;10.45;1348;39;3351.00;209
8228;22;5721987;8228;515;9571;9780;4.53;0.28;352.21;10.45;1343;39;3352.00;209
8230;22;5722008;8230;513;9571;9780;4.52;0.28;352.28;10.45;1341;39;3353.00;209
8233;22;5722032;8233;511;9574;9784;4.54;0.28;352.44;10.45;1341;39;3354.00;210
8238;22;5722053;8238;513;9574;9784;4.52;0.27;352.44;10.45;1336;39;3355.00;210
8240;22;5722073;8240;503;9578;9788;4.56;0.28;352.46;10.45;1338;39;3356.00;210
8243;22;5722094;8243;487;9579;9789;4.57;0.28;352.49;10.45;1336;39;3357.00;210
8245;22;5722113;8245;481;9579;9789;4.59;0.28;352.54;10.45;1334;39;3358.00;210
8250;22;5722130;8250;470;9579;9789;4.60;0.28;352.61;10.45;1329;39;3359.00;210
8253;22;5722148;8253;480;9604;9818;4.65;0.28;352.71;10.42;1351;39;3360.00;214
8256;22;5722165;8256;466;9604;9818;4.68;0.29;352.80;10.42;1348;39;3361.00;214
8260;22;5722179;8260;465;9604;9818;4.70;0.29;353.04;10.42;1344;39;3362.00;214
8262;22;5722194;8262;472;9605;9819;4.77;0.29;353.10;10.42;1343;39;3363.00;214
8266;22;5722210;8266;478;9606;9820;4.76;0.29;353.34;10.50;1340;39;3364.00;214
8269;22;5722228;8269;485;9606;9820;4.73;0.29;353.40;10.50;1337;39;3365.00;214
8272;22;5722247;8272;494;9608;9823;4.71;0.29;353.42;10.50;1336;39;3366.00;215
8275;22;5722267;8275;487;9608;9823;4.68;0.29;353.55;10.50;1333;39;3367.00;215
8278;22;5722288;8278;486;9609;9823;4.64;0.28;353.66;10.49;1331;39;3368.00;214
8279;22;5722307;8279;479;9609;9823;4.61;0.28;353.70;10.49;1330;39;3369.00;214
8282;22;5722326;8282;486;9614;9829;4.60;0.28;353.78;10.49;1332;39;3370.00;215
8282;22;5722345;8282;484;9614;9829;4.57;0.28;353.78;10.49;1332;39;3371.00;215
8285;22;5722363;8285;485;9614;9829;4.54;0.28;353.82;10.49;1329;39;3372.00;215
8286;22;5722382;8286;478;9614;9829;4.55;0.28;353.89;10.49;1328;39;3373.00;215
8287;22;5722401;8287;480;9617;9833;4.54;0.28;353.94;10.49;1330;39;3374.00;216
8289;22;5722423;8289;481;9619;9835;4.55;0.28;353.98;10.48;1330;39;3375.00;216
8294;22;5722442;8294;482;9619;9835;4.55;0.28;354.13;10.48;1325;39;3376.00;216
8295;22;5722458;8295;470;9620;9836;4.60;0.28;354.10;10.48;1325;40;3377.00;216
8298;22;5722482;8298;475;9620;9836;4.62;0.28;354.10;10.48;1322;40;3378.00;216
8305;22;5722498;8305;468;9620;9836;4.60;0.28;354.15;10.48;1315;40;3379.00;216
8311;22;5722512;8311;468;9621;9836;4.63;0.28;354.19;10.56;1310;40;3380.00;215
8311;22;5722529;8311;468;9621;9836;4.65;0.28;354.19;10.56;1310;40;3381.00;215
8312;22;5722543;8312;471;9621;9836;4.69;0.29;354.20;10.56;1309;40;3382.00;215
8315;22;5722557;8315;474;9621;9836;4.72;0.29;354.28;10.56;1306;40;3383.00;215
8317;22;5722572;8317;479;9660;9906;4.82;0.29;354.39;10.52;1343;40;3384.00;246
8322;22;5722593;8322;480;9660;9907;4.85;0.30;354.41;10.52;1338;40;3385.00;247
8325;22;5722608;8325;472;9665;9907;4.93;0.30;354.50;10.52;1340;40;3386.00;242
8329;22;5722625;8329;476;9667;9907;4.92;0.30;354.67;10.52;1338;40;3387.00;240
8331;22;5722644;8331;475;9669;9907;4.88;0.30;354.69;10.51;1338;40;3388.00;238
8332;22;5722662;8332;483;9671;9907;4.88;0.30;354.68;10.51;1339;40;3389.00;236
8334;22;5722681;8334;477;9673;9907;4.92;0.30;354.71;10.51;1339;40;3390.00;234
8336;22;5722699;8336;481;9676;9907;4.98;0.30;354.73;10.51;1340;40;3391.00;231
8338;22;5722719;8338;485;9679;9908;5.05;0.31;354.71;10.51;1341;40;3392.00;229
8339;22;5722745;8339;481;9681;9909;5.07;0.31;354.71;10.59;1342;40;3393.00;228
8342;22;5722763;8342;482;9684;9909;5.07;0.31;354.90;10.59;1342;40;3394.00;225
8343;22;5722781;8343;468;9688;9913;5.13;0.31;354.91;10.58;1345;40;3395.00;225
8346;22;5722799;8346;466;9689;9913;5.16;0.31;354.94;10.58;1343;40;3396.00;224
8347;22;5722815;8347;458;9689;9913;5.18;0.31;354.92;10.58;1342;40;3397.00;224
8350;22;5722831;8350;448;9689;9913;5.14;0.31;354.99;10.58;1339;40;3398.00;224
8353;22;5722845;8353;448;9695;9919;5.16;0.31;355.17;10.58;1342;40;3399.00;224
8355;22;5722862;8355;450;9696;9919;5.11;0.31;355.31;10.58;1341;40;3400.00;223
8357;22;5722880;8357;450;9697;9919;5.06;0.31;355.31;10.58;1340;40;3401.00;222
8360;22;5722895;8360;450;9699;9922;5.05;0.31;355.46;10.58;1339;40;3402.00;223
8362;22;5722910;8362;451;9699;9922;5.00;0.30;355.45;10.58;1337;40;3403.00;223
8367;22;5722924;8367;454;9701;9922;4.94;0.30;355.65;10.66;1334;40;3404.00;221
8371;22;5722939;8371;457;9703;9923;4.87;0.30;355.84;10.78;1332;40;3405.00;220
8371;22;5722955;8371;455;9704;9924;4.86;0.30;355.84;10.78;1333;40;3406.00;220
8374;22;5722973;8374;458;9704;9924;4.82;0.29;355.82;10.78;1330;40;3407.00;220
8378;22;5722993;8378;469;9714;9937;4.84;0.30;355.95;10.77;1336;40;3408.00;223
8381;22;5723012;8381;468;9714;9937;4.80;0.29;355.99;10.77;1333;40;3409.00;223
8386;22;5723030;8386;468;9714;9937;4.75;0.29;355.99;10.77;1328;40;3410.00;223
8387;22;5723048;8387;467;9715;9938;4.77;0.29;356.02;10.77;1328;40;3411.00;223
8390;22;5723067;8390;463;9716;9938;4.78;0.29;356.06;10.77;1326;40;3412.00;222
8393;22;5723087;8393;470;9719;9942;4.83;0.30;356.04;10.76;1326;40;3413.00;223
8394;22;5723108;8394;476;9719;9942;4.81;0.29;356.01;10.76;1325;40;3414.00;223
8397;22;5723132;8397;479;9722;9946;4.78;0.29;355.98;10.76;1325;40;3415.00;224
8398;22;5723151;8398;481;9724;9946;4.78;0.29;356.07;10.76;1326;40;3416.00;222
8399;22;5723169;8399;488;9724;9946;4.75;0.29;356.04;10.76;1325;40;3417.00;222
8402;22;5723186;8402;478;9724;9946;4.72;0.29;356.11;10.76;1322;40;3418.00;222
8403;22;5723202;8403;481;9724;9946;4.71;0.29;356.07;10.76;1321;40;3419.00;222
8405;22;5723220;8405;483;9749;9980;4.80;0.30;356.07;10.80;1344;40;3420.00;231
8409;22;5723245;8409;476;9751;9980;4.77;0.29;356.02;10.80;1342;40;3421.00;229
8414;22;5723264;8414;487;9753;9980;4.74;0.29;355.95;10.80;1339;40;3422.00;227
8414;22;5723283;8414;490;9753;9980;4.73;0.29;355.95;10.80;1339;40;3423.00;227
8419;22;5723304;8419;501;9754;9980;4.69;0.29;355.91;10.80;1335;40;3424.00;226
8420;22;5723325;8420;509;9754;9980;4.65;0.29;355.95;10.80;1334;40;3425.00;226
8424;22;5723352;8424;501;9754;9981;4.58;0.28;355.85;10.80;1330;40;3426.00;227
8426;22;5723371;8426;505;9754;9981;4.52;0.28;355.78;10.80;1328;40;3427.00;227
8429;22;5723392;8429;510;9759;9987;4.51;0.28;355.70;10.79;1330;40;3428.00;228
8431;22;5723411;8431;525;9760;9988;4.43;0.27;355.74;10.79;1329;40;3429.00;228
8432;22;5723429;8432;527;9762;9988;4.32;0.27;355.73;10.92;1330;40;3430.00;226
8433;22;5723445;8433;538;9762;9988;4.26;0.26;355.69;10.92;1329;40;3431.00;226
8434;22;5723459;8434;545;9765;9992;4.20;0.26;355.65;10.98;1331;40;3432.00;227
8435;22;5723473;8435;545;9766;9992;4.16;0.26;355.67;10.98;1331;40;3433.00;226
8439;22;5723487;8439;552;9767;9992;4.13;0.25;355.78;11.04;1328;40;3434.00;225
8441;22;5723500;8441;557;9768;9993;4.07;0.25;355.75;11.04;1327;40;3435.00;225
8442;22;5723513;8442;561;9773;9997;4.01;0.25;355.71;11.16;1331;40;3436.00;224
8443;22;5723527;8443;575;9773;9997;3.99;0.24;355.76;11.16;1330;40;3437.00;224
8444;22;5723540;8444;575;9776;10000;4.00;0.24;355.75;11.22;1332;40;3438.00;224
8446;22;5723553;8446;587;9777;10000;3.92;0.24;355.79;11.22;1331;40;3439.00;223
8449;22;5723566;8449;597;9778;10000;3.85;0.24;355.78;11.29;1329;40;3440.00;222
8451;22;5723580;8451;603;9778;10000;3.80;0.23;355.72;11.29;1327;40;3441.00;222
8451;22;5723596;8451;607;9782;10004;3.80;0.23;355.72;11.28;1331;40;3442.00;222
8452;22;5723613;8452;609;9785;10004;3.76;0.23;355.73;11.47;1333;40;3443.00;219
8452;22;5723630;8452;614;9786;10004;3.74;0.23;355.73;11.53;1334;40;3444.00;218
8454;22;5723647;8454;625;9786;10004;3.69;0.23;355.70;11.53;1332;40;3445.00;218
8455;22;5723663;8455;637;9787;10005;3.63;0.22;355.68;11.59;1332;40;3446.00;218
8457;22;5723679;8457;640;9788;10006;3.61;0.22;355.66;11.59;1331;40;3447.00;218
8457;22;5723696;8457;629;9788;10006;3.55;0.22;355.66;11.59;1331;40;3448.00;218
8460;22;5723712;8460;624;9790;10007;3.53;0.21;355.63;11.65;1330;40;3449.00;217
8461;22;5723730;8461;611;9790;10007;3.52;0.21;355.60;11.65;1329;40;3450.00;217
8463;22;5723747;8463;596;9792;10007;3.54;0.22;355.57;11.77;1329;40;3451.00;215
8463;22;5723763;8463;594;9793;10007;3.55;0.22;355.57;11.83;1330;40;3452.00;214
8465;22;5723780;8465;588;9793;10007;3.58;0.22;355.54;11.83;1328;40;3453.00;214
8466;22;5723795;8466;584;9794;10007;3.62;0.22;355.52;11.89;1328;40;3454.00;213
8467;22;5723814;8467;582;9794;10007;3.65;0.22;355.49;11.89;1327;40;3455.00;213
8467;22;5723827;8467;589;9862;10134;4.00;0.25;355.49;11.92;1395;40;3456.00;272
8467;22;5723850;8467;579;9865;10135;4.01;0.25;355.49;11.92;1398;40;3457.00;270
8468;22;5723864;8468;571;9876;10135;4.08;0.25;355.45;12.03;1408;40;3458.00;259
8468;22;5723877;8468;571;9879;10135;4.08;0.25;355.45;12.02;1411;40;3459.00;256
8470;22;5723891;8470;565;9886;10135;4.11;0.25;355.40;12.02;1416;40;3460.00;249
8473;22;5723904;8473;568;9890;10135;4.03;0.25;355.35;12.13;1417;40;3461.00;245
8473;22;5723918;8473;567;9893;10135;4.00;0.24;355.35;12.13;1420;40;3462.00;242
8473;22;5723931;8473;573;9895;10135;4.00;0.24;355.35;12.13;1422;40;3463.00;240
8476;22;5723950;8476;583;9899;10136;3.93;0.24;355.31;12.24;1423;40;3464.00;237
8478;22;5723963;8478;574;9902;10138;3.94;0.24;355.28;12.24;1424;40;3465.00;236
8479;22;5723976;8479;570;9904;10138;3.96;0.24;355.29;12.24;1425;40;3466.00;234
8481;22;5723990;8481;574;9906;10139;3.96;0.24;355.28;12.24;1425;40;3467.00;233
8482;22;5724004;8482;569;9909;10139;3.97;0.24;355.27;12.24;1427;40;3468.00;230
8485;22;5724018;8485;566;9911;10139;3.96;0.24;355.31;12.24;1426;40;3469.00;228
8486;22;5724033;8486;567;9912;10139;3.96;0.24;355.42;12.24;1426;40;3470.00;227
8489;22;5724050;8489;577;9916;10143;3.95;0.24;355.54;12.24;1427;40;3471.00;227
8493;22;5724069;8493;563;9917;10143;3.96;0.24;355.46;12.24;1424;40;3472.00;226
8494;22;5724087;8494;566;9920;10143;3.98;0.24;355.44;12.24;1426;40;3473.00;223
8497;22;5724105;8497;557;9922;10146;3.98;0.24;355.55;12.24;1425;40;3474.00;224
8500;22;5724123;8500;560;9923;10146;3.97;0.24;355.48;12.24;1423;40;3475.00;223
8505;22;5724141;8505;554;9925;10146;3.94;0.24;355.48;12.32;1420;40;3476.00;221
8509;22;5724160;8509;559;9928;10150;3.97;0.24;355.67;12.32;1419;40;3477.00;222
8513;22;5724179;8513;556;9930;10151;3.97;0.24;355.77;12.32;1417;40;3478.00;221
8515;22;5724198;8515;545;9930;10151;4.00;0.24;355.81;12.32;1415;40;3479.00;221
8519;22;5724221;8519;543;9935;10156;4.05;0.25;355.77;12.31;1416;40;3480.00;221
8523;22;5724237;8523;539;9935;10156;4.09;0.25;355.84;12.31;1412;40;3481.00;221
8524;22;5724252;8524;538;9935;10156;4.21;0.26;355.85;12.31;1411;40;3482.00;221
8527;22;5724267;8527;534;9935;10157;4.24;0.26;355.91;12.31;1408;40;3483.00;222
8530;22;5724282;8530;528;9935;10157;4.27;0.26;355.95;12.31;1405;40;3484.00;222
8532;22;5724297;8532;524;9939;10163;4.31;0.26;356.05;12.31;1407;40;3485.00;224
8534;22;5724312;8534;521;9939;10163;4.32;0.26;356.22;12.31;1405;40;3486.00;224
8538;22;5724326;8538;532;9939;10164;4.34;0.26;356.24;12.31;1401;40;3487.00;225
8541;22;5724342;8541;530;9939;10164;4.35;0.26;356.38;12.31;1398;40;3488.00;225
8544;22;5724357;8544;526;9939;10164;4.37;0.27;356.50;12.31;1395;40;3489.00;225
8545;22;5724370;8545;523;9939;10164;4.39;0.27;356.51;12.31;1394;40;3490.00;225
8548;22;5724386;8548;523;9939;10164;4.38;0.27;356.55;12.31;1391;40;3491.00;225
8552;22;5724402;8552;521;9948;10176;4.40;0.27;356.69;12.30;1396;40;3492.00;228
8555;22;5724418;8555;521;9948;10176;4.40;0.27;356.76;12.30;1393;40;3493.00;228
8559;22;5724434;8559;505;9948;10176;4.43;0.27;356.93;12.30;1389;40;3494.00;228
8563;22;5724450;8563;499;9948;10176;4.47;0.27;357.07;12.30;1385;40;3495.00;228
8568;22;5724465;8568;492;9948;10176;4.48;0.27;357.16;12.30;1380;40;3496.00;228
8570;22;5724481;8570;483;9948;10176;4.46;0.27;357.28;12.30;1378;40;3497.00;228
8575;22;5724497;8575;482;9951;10180;4.46;0.27;357.52;12.29;1376;40;3498.00;229
8579;22;5724512;8579;484;9951;10180;4.47;0.27;357.56;12.29;1372;40;3499.00;229
8582;22;5724528;8582;484;9954;10184;4.48;0.27;357.65;12.29;1372;40;3500.00;230
8585;22;5724547;8585;479;9955;10185;4.45;0.27;357.70;12.29;1370;40;3501.00;230
8588;22;5724563;8588;476;9955;10185;4.42;0.27;357.75;12.29;1367;40;3502.00;230
8593;22;5724577;8593;471;9955;10185;4.42;0.27;358.00;12.29;1362;40;3503.00;230
8595;22;5724592;8595;472;9965;10198;4.47;0.27;358.01;12.28;1370;40;3504.00;233
8598;22;5724608;8598;475;9965;10198;4.52;0.27;358.15;12.28;1367;40;3505.00;233
8601;22;5724622;8601;474;9966;10198;4.56;0.28;358.24;12.28;1365;40;3506.00;232
8602;22;5724637;8602;483;9968;10199;4.56;0.28;358.21;12.28;1366;40;3507.00;231
8605;22;5724651;8605;474;9970;10200;4.55;0.28;358.18;12.36;1365;40;3508.00;230
8606;22;5724665;8606;486;9970;10200;4.53;0.28;358.16;12.36;1364;40;3509.00;230
8612;22;5724681;8612;491;9973;10206;4.50;0.27;358.21;12.36;1361;40;3510.00;233
8615;22;5724698;8615;486;9973;10206;4.47;0.27;358.23;12.36;1358;40;3511.00;233
8618;22;5724716;8618;483;9974;10206;4.45;0.27;358.30;12.36;1356;40;3512.00;232
8620;22;5724740;8620;482;9977;10206;4.45;0.27;358.32;12.37;1357;40;3513.00;229
8620;22;5724760;8620;482;9980;10212;4.44;0.27;358.32;12.36;1360;40;3514.00;232
8626;22;5724779;8626;486;9982;10212;4.43;0.27;358.53;12.36;1356;40;3515.00;230
8629;22;5724798;8629;474;9983;10212;4.44;0.27;358.64;12.36;1354;40;3516.00;229
8633;22;5724818;8633;479;9985;10212;4.44;0.27;358.78;12.36;1352;40;3517.00;227
8636;22;5724839;8636;475;9988;10216;4.46;0.27;358.84;12.36;1352;40;3518.00;228
8638;22;5724859;8638;482;9992;10219;4.52;0.27;358.88;12.36;1354;40;3519.00;227
8639;22;5724879;8639;480;9993;10219;4.53;0.28;358.89;12.36;1354;40;3520.00;226
8643;22;5724899;8643;476;9994;10220;4.57;0.28;358.96;12.35;1351;40;3521.00;226
8645;22;5724920;8645;461;9994;10220;4.62;0.28;359.07;12.35;1349;40;3522.00;226
8649;22;5724937;8649;461;9994;10220;4.65;0.28;359.10;12.35;1345;40;3523.00;226
8654;22;5724953;8654;451;9995;10220;4.69;0.29;359.10;12.35;1341;40;3524.00;225
8656;22;5724973;8656;458;9995;10220;4.72;0.29;359.13;12.35;1339;40;3525.00;225
8661;22;5724994;8661;457;9995;10220;4.72;0.29;359.13;12.35;1334;40;3526.00;225
8662;23;5725011;8662;452;9995;10220;4.75;0.29;359.14;12.35;1333;41;3527.00;225
8663;23;5725038;8663;473;10036;10290;4.74;0.29;359.11;12.39;1373;41;3528.00;254
8667;23;5725060;8667;456;10036;10291;4.73;0.29;359.26;12.39;1369;41;3529.00;255
8669;23;5725079;8669;459;10041;10291;4.79;0.29;359.31;12.38;1372;41;3530.00;250
8672;23;5725099;8672;456;10043;10291;4.85;0.30;359.42;12.38;1371;41;3531.00;248
8676;23;5725120;8676;455;10046;10291;4.93;0.30;359.56;12.38;1370;41;3532.00;245
8679;23;5725141;8679;451;10047;10291;4.98;0.30;359.66;12.38;1368;41;3533.00;244
8680;23;5725163;8680;443;10049;10291;5.05;0.31;359.78;12.37;1369;41;3534.00;242
8682;23;5725183;8682;450;10051;10291;5.08;0.31;359.79;12.37;1369;41;3535.00;240
8686;23;5725206;8686;446;10054;10292;5.07;0.31;359.76;12.37;1368;41;3536.00;238
8687;23;5725227;8687;449;10056;10293;5.09;0.31;359.87;12.37;1369;41;3537.00;237
8689;23;5725246;8689;443;10058;10293;5.09;0.31;359.86;12.37;1369;41;3538.00;235
8689;23;5725264;8689;436;10062;10297;5.09;0.31;359.86;12.37;1373;41;3539.00;235
8691;23;5725283;8691;437;10064;10297;5.08;0.31;359.99;12.37;1373;41;3540.00;233
8692;23;5725298;8692;451;10064;10297;5.04;0.31;360.04;12.37;1372;41;3541.00;233
8693;23;5725313;8693;455;10064;10297;4.98;0.30;360.16;12.37;1371;41;3542.00;233
8694;23;5725328;8694;460;10070;10303;4.96;0.30;360.16;12.36;1376;41;3543.00;233
8695;23;5725349;8695;456;10071;10303;4.91;0.30;360.29;12.36;1376;41;3544.00;232
8698;23;5725364;8698;464;10072;10303;4.87;0.30;360.40;12.36;1374;41;3545.00;231
8700;23;5725378;8700;466;10074;10306;4.84;0.29;360.57;12.36;1374;41;3546.00;232
8704;23;5725393;8704;466;10075;10306;4.83;0.29;360.52;12.44;1371;41;3547.00;231
8704;23;5725408;8704;472;10076;10306;4.84;0.29;360.52;12.44;1372;41;3548.00;230
8708;23;5725424;8708;472;10076;10307;4.80;0.29;360.69;12.44;1368;41;3549.00;231
8709;23;5725442;8709;482;10077;10308;4.80;0.29;360.76;12.44;1368;41;3550.00;231
8713;23;5725461;8713;490;10077;10308;4.74;0.29;360.95;12.44;1364;41;3551.00;231
8715;23;5725479;8715;491;10088;10321;4.74;0.29;360.98;12.42;1373;41;3552.00;233
8718;23;5725499;8718;491;10088;10321;4.70;0.29;360.97;12.42;1370;41;3553.00;233
8722;23;5725519;8722;497;10088;10321;4.64;0.28;361.08;12.42;1366;41;3554.00;233
8724;23;5725538;8724;486;10090;10323;4.58;0.28;361.09;12.42;1366;41;3555.00;233
8726;23;5725557;8726;493;10090;10323;4.57;0.28;361.18;12.42;1364;41;3556.00;233
8728;23;5725576;8728;499;10094;10327;4.57;0.28;361.23;12.42;1366;41;3557.00;233
8730;23;5725596;8730;501;10094;10327;4.57;0.28;361.22;12.42;1364;41;3558.00;233
8731;23;5725614;8731;499;10097;10331;4.58;0.28;361.27;12.41;1366;41;3559.00;234
8734;23;5725632;8734;500;10097;10331;4.57;0.28;361.35;12.41;1363;41;3560.00;234
8734;23;5725650;8734;491;10097;10331;4.58;0.28;361.35;12.41;1363;41;3561.00;234
8736;23;5725666;8736;485;10097;10331;4.60;0.28;361.44;12.41;1361;41;3562.00;234
8739;23;5725681;8739;482;10097;10331;4.66;0.28;361.49;12.41;1358;41;3563.00;234
8739;23;5725696;8739;474;10107;10343;4.78;0.29;361.49;12.40;1368;41;3564.00;236
8741;23;5725712;8741;476;10107;10343;4.81;0.29;361.47;12.40;1366;41;3565.00;236
8743;23;5725728;8743;478;10108;10343;4.85;0.30;361.50;12.40;1365;41;3566.00;235
8745;23;5725742;8745;488;10108;10343;4.87;0.30;361.50;12.40;1363;41;3567.00;235
8748;23;5725757;8748;485;10108;10343;4.82;0.30;361.46;12.40;1360;41;3568.00;235
8752;23;5725771;8752;494;10108;10343;4.78;0.29;361.45;12.40;1356;41;3569.00;235
8756;23;5725787;8756;499;10110;10344;4.76;0.29;361.41;12.53;1354;41;3570.00;234
8761;23;5725806;8761;499;10110;10344;4.67;0.28;361.45;12.53;1349;41;3571.00;234
8765;24;5725823;8765;502;10115;10350;4.66;0.28;361.38;12.53;1350;42;3572.00;235
8769;24;5725861;8769;510;10116;10351;4.63;0.28;361.41;12.52;1347;42;3573.00;235
8771;24;5725880;8771;515;10116;10351;4.58;0.28;361.39;12.52;1345;42;3574.00;235
8778;24;5725900;8778;517;10116;10351;4.47;0.27;361.35;12.52;1338;42;3575.00;235
8782;24;5725928;8782;526;10119;10355;4.42;0.27;361.37;12.52;1337;42;3576.00;236
8784;24;5725946;8784;533;10119;10355;4.34;0.26;361.34;12.52;1335;42;3577.00;236
8787;24;5725965;8787;536;10119;10355;4.23;0.26;361.28;12.52;1332;42;3578.00;236
8787;24;5725984;8787;539;10120;10356;4.23;0.26;361.28;12.52;1333;42;3579.00;236
8790;24;5726001;8790;545;10123;10360;4.19;0.26;361.21;12.52;1333;42;3580.00;237
8790;24;5726020;8790;543;10123;10360;4.16;0.25;361.21;12.52;1333;42;3581.00;237
8794;24;5726036;8794;542;10125;10363;4.14;0.25;361.29;12.51;1331;42;3582.00;238
8796;24;5726051;8796;549;10126;10363;4.12;0.25;361.27;12.51;1330;42;3583.00;237
8797;24;5726066;8797;551;10126;10363;4.06;0.25;361.23;12.51;1329;42;3584.00;237
8798;24;5726079;8798;559;10126;10363;4.04;0.25;361.32;12.51;1328;42;3585.00;237
8799;24;5726093;8799;551;10130;10367;4.09;0.25;361.37;12.51;1331;42;3586.00;237
8799;24;5726113;8799;557;10130;10367;4.11;0.25;361.37;12.51;1331;42;3587.00;237
8799;24;5726127;8799;560;10130;10367;4.10;0.25;361.37;12.51;1331;42;3588.00;237
8802;24;5726140;8802;561;10130;10367;4.01;0.25;361.33;12.51;1328;42;3589.00;237
8805;24;5726155;8805;565;10130;10368;3.98;0.24;361.43;12.51;1325;42;3590.00;238
8806;24;5726168;8806;575;10131;10369;3.96;0.24;361.44;12.51;1325;42;3591.00;238
8806;24;5726181;8806;578;10131;10369;3.92;0.24;361.44;12.51;1325;42;3592.00;238
8806;24;5726194;8806;581;10132;10370;3.92;0.24;361.44;12.51;1326;42;3593.00;238
8808;24;5726208;8808;584;10132;10370;3.88;0.24;361.53;12.51;1324;42;3594.00;238
8810;24;5726221;8810;574;10133;10370;3.82;0.23;361.53;12.58;1323;42;3595.00;237
8811;24;5726234;8811;575;10133;10370;3.82;0.23;361.50;12.58;1322;42;3596.00;237
8812;24;5726248;8812;569;10133;10370;3.83;0.24;361.49;12.58;1321;42;3597.00;237
8812;24;5726262;8812;564;10134;10370;3.82;0.23;361.49;12.64;1322;42;3598.00;236
8812;24;5726285;8812;564;10134;10370;3.84;0.24;361.49;12.64;1322;42;3599.00;236
8813;24;5726305;8813;594;10238;10623;4.24;0.27;361.50;12.52;1425;42;3600.00;385
8813;24;5726349;8813;589;10244;10624;4.30;0.27;361.50;12.58;1431;42;3601.00;380
8815;24;5726374;8815;578;10257;10624;4.38;0.28;361.46;12.57;1442;42;3602.00;367
8817;24;5726392;8817;581;10265;10624;4.41;0.28;361.44;12.63;1448;42;3603.00;359
8817;24;5726411;8817;575;10278;10624;4.43;0.28;361.44;12.89;1461;42;3604.00;346
8820;24;5726437;8820;577;10283;10624;4.39;0.28;361.44;12.88;1463;42;3605.00;341
8822;24;5726457;8822;565;10291;10624;4.43;0.28;361.41;12.95;1469;42;3606.00;333
8824;24;5726475;8824;564;10299;10624;4.45;0.28;361.42;12.94;1475;42;3607.00;325
8825;25;5726501;8825;569;10306;10625;4.44;0.28;361.41;12.94;1481;43;3608.00;319
8825;25;5726528;8825;570;10312;10626;4.46;0.28;361.41;13.07;1487;43;3609.00;314
8827;25;5726543;8827;572;10317;10626;4.46;0.28;361.39;13.07;1490;43;3610.00;309
8830;25;5726558;8830;572;10323;10627;4.47;0.28;361.34;13.06;1493;43;3611.00;304
8832;25;5726573;8832;582;10326;10627;4.49;0.28;361.36;13.06;1494;43;3612.00;301
8834;25;5726587;8834;592;10330;10627;4.48;0.28;361.31;13.19;1496;43;3613.00;297
8835;25;5726602;8835;590;10334;10627;4.49;0.28;361.40;13.19;1499;43;3614.00;293
8839;25;5726621;8839;590;10342;10631;4.44;0.27;361.30;13.32;1503;43;3615.00;289
8839;25;5726647;8839;597;10344;10631;4.44;0.27;361.30;13.32;1505;43;3616.00;287
8842;25;5726663;8842;600;10347;10631;4.39;0.27;361.23;13.38;1505;43;3617.00;284
8844;25;5726677;8844;601;10349;10634;4.33;0.27;361.17;13.38;1505;43;3618.00;285
8846;25;5726693;8846;604;10352;10634;4.27;0.26;361.21;13.45;1506;43;3619.00;282
8847;25;5726709;8847;606;10355;10634;4.24;0.26;361.18;13.45;1508;43;3620.00;279
8849;25;5726724;8849;619;10360;10638;4.21;0.26;361.22;13.44;1511;43;3621.00;278
8851;25;5726739;8851;624;10364;10639;4.23;0.26;361.23;13.44;1513;43;3622.00;275
8852;25;5726754;8852;632;10366;10639;4.24;0.26;361.28;13.45;1514;43;3623.00;273
8854;25;5726768;8854;636;10370;10643;4.23;0.26;361.30;13.45;1516;43;3624.00;273
8855;25;5726784;8855;647;10373;10643;4.24;0.26;361.28;13.45;1518;43;3625.00;270
8856;25;5726798;8856;647;10374;10643;4.21;0.26;361.29;13.45;1518;43;3626.00;269
8859;25;5726814;8859;653;10375;10644;4.21;0.26;361.30;13.45;1516;43;3627.00;269
8861;25;5726828;8861;656;10376;10644;4.18;0.25;361.35;13.45;1515;43;3628.00;268
8866;25;5726842;8866;658;10382;10650;4.17;0.25;361.34;13.45;1516;43;3629.00;268
8867;25;5726859;8867;655;10385;10650;4.12;0.25;361.38;13.45;1518;43;3630.00;265
8869;25;5726876;8869;651;10387;10651;4.10;0.25;361.55;13.46;1518;43;3631.00;264
8870;25;5726895;8870;647;10388;10651;4.10;0.25;361.53;13.46;1518;44;3632.00;263
8873;25;5726927;8873;651;10389;10651;4.08;0.25;361.56;13.46;1516;44;3633.00;262
8874;25;5726948;8874;655;10389;10651;4.08;0.25;361.55;13.46;1515;44;3634.00;262
8879;25;5726968;8879;657;10391;10651;4.04;0.25;361.66;13.46;1512;44;3635.00;260
8880;25;5726990;8880;653;10402;10663;4.06;0.25;361.65;13.45;1522;44;3636.00;261
8882;25;5727010;8882;653;10403;10663;4.08;0.25;361.61;13.45;1521;44;3637.00;260
8886;25;5727030;8886;649;10403;10663;4.09;0.25;361.70;13.45;1517;44;3638.00;260
8892;25;5727052;8892;649;10403;10663;4.09;0.25;361.72;13.45;1511;44;3639.00;260
8894;25;5727073;8894;640;10403;10663;4.13;0.25;361.68;13.45;1509;44;3640.00;260
8898;25;5727093;8898;631;10403;10663;4.15;0.25;361.67;13.45;1505;44;3641.00;260
8900;25;5727111;8900;620;10406;10667;4.20;0.26;361.70;13.44;1506;44;3642.00;261
8905;25;5727129;8905;620;10406;10667;4.24;0.26;361.74;13.44;1501;44;3643.00;261
8908;25;5727145;8908;621;10410;10671;4.29;0.26;361.79;13.44;1502;44;3644.00;261
8915;25;5727160;8915;622;10412;10673;4.31;0.26;361.90;13.44;1497;44;3645.00;261
8917;25;5727178;8917;619;10412;10673;4.34;0.27;361.93;13.44;1495;44;3646.00;261
8921;25;5727193;8921;616;10412;10673;4.39;0.27;362.11;13.44;1491;45;3647.00;261
8926;25;5727217;8926;604;10421;10686;4.39;0.27;362.19;13.43;1495;45;3648.00;265
8930;25;5727235;8930;587;10422;10686;4.40;0.27;362.29;13.42;1492;45;3649.00;264
8933;25;5727252;8933;582;10422;10686;4.43;0.27;362.30;13.42;1489;45;3650.00;264
8937;25;5727270;8937;580;10423;10687;4.46;0.27;362.29;13.42;1486;45;3651.00;264
8941;25;5727291;8941;578;10423;10688;4.48;0.28;362.35;13.42;1482;45;3652.00;265
8946;25;5727311;8946;570;10423;10688;4.49;0.27;362.46;13.42;1477;45;3653.00;265
8951;25;5727331;8951;572;10426;10691;4.48;0.27;362.56;13.42;1475;45;3654.00;265
8956;25;5727353;8956;572;10426;10691;4.51;0.28;362.73;13.42;1470;45;3655.00;265
8959;25;5727376;8959;570;10427;10691;4.52;0.28;362.85;13.42;1468;45;3656.00;264
8962;25;5727407;8962;571;10427;10691;4.54;0.28;362.89;13.42;1465;45;3657.00;264
8963;25;5727430;8963;575;10432;10697;4.55;0.28;362.90;13.42;1469;45;3658.00;265
8966;25;5727459;8966;568;10432;10697;4.53;0.28;362.91;13.42;1466;45;3659.00;265
8972;25;5727479;8972;570;10432;10697;4.52;0.28;363.11;13.42;1460;45;3660.00;265
8977;25;5727497;8977;568;10433;10697;4.47;0.27;363.12;13.42;1456;45;3661.00;264
8982;25;5727514;8982;565;10436;10701;4.47;0.27;363.21;13.42;1454;45;3662.00;265
8986;25;5727530;8986;567;10438;10702;4.41;0.27;363.24;13.41;1452;45;3663.00;264
8987;25;5727545;8987;569;10438;10702;4.41;0.27;363.27;13.41;1451;45;3664.00;264
8993;25;5727561;8993;570;10439;10703;4.36;0.27;363.39;13.41;1446;45;3665.00;264
8995;25;5727577;8995;563;10439;10703;4.38;0.27;363.52;13.41;1444;45;3666.00;264
8998;25;5727597;8998;565;10439;10703;4.37;0.27;363.50;13.41;1441;45;3667.00;264
9003;25;5727612;9003;572;10440;10703;4.36;0.27;363.65;13.50;1437;45;3668.00;263
9007;25;5727628;9007;572;10440;10703;4.37;0.27;363.65;13.50;1433;45;3669.00;263
9013;25;5727643;9013;570;10440;10703;4.30;0.26;363.92;13.50;1427;45;3670.00;263
9017;25;5727659;9017;574;10440;10703;4.22;0.26;363.89;13.50;1423;45;3671.00;263
9022;25;5727676;9022;584;10479;10773;4.21;0.26;364.03;13.45;1457;45;3672.00;294
9026;25;5727698;9026;577;10482;10774;4.15;0.25;364.15;13.45;1456;45;3673.00;292
9030;25;5727715;9030;574;10485;10774;4.11;0.25;364.26;13.44;1455;45;3674.00;289
9031;25;5727731;9031;583;10486;10774;4.11;0.25;364.30;13.44;1455;45;3675.00;288
9034;25;5727746;9034;587;10489;10774;4.08;0.25;364.54;13.44;1455;45;3676.00;285
9034;25;5727762;9034;583;10490;10774;4.11;0.25;364.54;13.44;1456;45;3677.00;284
9039;25;5727777;9039;577;10493;10774;4.10;0.25;364.64;13.44;1454;45;3678.00;281
9043;25;5727793;9043;580;10495;10774;4.11;0.25;364.78;13.44;1452;45;3679.00;279
9049;25;5727809;9049;583;10497;10775;4.04;0.25;364.82;13.43;1448;45;3680.00;278
9052;25;5727826;9052;579;10498;10776;3.95;0.24;364.84;13.43;1446;45;3681.00;278
9054;25;5727843;9054;581;10500;10776;3.89;0.24;364.84;13.52;1446;45;3682.00;276
9056;25;5727859;9056;591;10503;10780;3.80;0.23;364.87;13.51;1447;45;3683.00;277
9059;25;5727876;9059;596;10506;10780;3.69;0.23;364.90;13.51;1447;45;3684.00;274
9063;25;5727893;9063;598;10507;10780;3.60;0.22;365.01;13.51;1444;45;3685.00;273
9066;25;5727911;9066;593;10507;10780;3.56;0.22;365.17;13.51;1441;45;3686.00;273
9068;25;5727928;9068;586;10512;10786;3.58;0.22;365.31;13.51;1444;45;3687.00;274
9071;25;5727944;9071;582;10512;10786;3.56;0.22;365.42;13.51;1441;45;3688.00;274
9073;25;5727962;9073;589;10512;10786;3.57;0.22;365.47;13.51;1439;45;3689.00;274
9076;25;5727981;9076;586;10516;10792;3.57;0.22;365.47;13.50;1440;45;3690.00;276
9077;25;5728005;9077;586;10517;10792;3.58;0.22;365.48;13.50;1440;45;3691.00;275
9080;25;5728023;9080;590;10518;10792;3.59;0.22;365.54;13.50;1438;45;3692.00;274
9083;25;5728040;9083;594;10518;10793;3.59;0.22;365.68;13.50;1435;45;3693.00;275
9086;25;5728058;9086;608;10519;10794;3.61;0.22;365.72;13.50;1433;45;3694.00;275
9087;25;5728074;9087;612;10523;10794;3.64;0.22;365.77;13.58;1436;45;3695.00;271
9088;25;5728092;9088;621;10534;10807;3.65;0.22;365.77;13.57;1446;45;3696.00;273
9090;25;5728109;9090;615;10534;10807;3.67;0.22;365.82;13.57;1444;45;3697.00;273
9091;25;5728125;9091;618;10535;10807;3.71;0.23;365.92;13.57;1444;45;3698.00;272
9093;25;5728142;9093;622;10536;10808;3.74;0.23;365.97;13.57;1443;45;3699.00;272
9096;25;5728160;9096;624;10539;10808;3.80;0.23;365.95;13.58;1443;45;3700.00;269
9097;25;5728180;9097;621;10543;10812;3.90;0.24;365.92;13.57;1446;45;3701.00;269
9099;25;5728196;9099;621;10543;10812;3.94;0.24;365.90;13.57;1444;45;3702.00;269
9101;25;5728212;9101;617;10546;10816;3.95;0.24;365.91;13.57;1445;45;3703.00;270
9103;25;5728229;9103;614;10546;10816;3.99;0.24;365.93;13.57;1443;45;3704.00;270
9106;25;5728245;9106;607;10546;10816;4.02;0.25;366.05;13.57;1440;45;3705.00;270
9107;25;5728262;9107;608;10546;10816;4.05;0.25;366.11;13.57;1439;46;3706.00;270
9109;25;5728288;9109;605;10546;10816;4.06;0.25;366.22;13.57;1437;46;3707.00;270
9111;25;5728305;9111;601;10556;10828;4.14;0.25;366.25;13.56;1445;46;3708.00;272
9114;25;5728322;9114;607;10556;10828;4.17;0.25;366.27;13.56;1442;46;3709.00;272
9116;25;5728337;9116;600;10557;10828;4.19;0.26;366.34;13.56;1441;46;3710.00;271
9118;25;5728352;9118;596;10557;10828;4.20;0.26;366.35;13.56;1439;46;3711.00;271
9120;25;5728367;9120;596;10557;10828;4.20;0.26;366.35;13.56;1437;46;3712.00;271
9125;25;5728381;9125;593;10557;10828;4.20;0.26;366.35;13.56;1432;46;3713.00;271
9128;25;5728396;9128;599;10557;10829;4.20;0.26;366.37;13.56;1429;46;3714.00;272
9133;25;5728410;9133;609;10557;10829;4.17;0.25;366.38;13.56;1424;46;3715.00;272
9134;25;5728426;9134;614;10562;10835;4.19;0.26;366.40;13.55;1428;46;3716.00;273
9138;25;5728441;9138;614;10563;10836;4.17;0.25;366.43;13.55;1425;46;3717.00;273
9144;25;5728457;9144;610;10563;10836;4.09;0.25;366.40;13.55;1419;46;3718.00;273
9145;25;5728472;9145;603;10564;10836;4.11;0.25;366.37;13.63;1419;46;3719.00;272
9148;25;5728488;9148;605;10568;10841;4.12;0.25;366.42;13.62;1420;46;3720.00;273
9151;25;5728503;9151;601;10568;10841;4.10;0.25;366.37;13.62;1417;46;3721.00;273
9153;25;5728517;9153;596;10568;10841;4.09;0.25;366.41;13.62;1415;46;3722.00;273
9154;25;5728532;9154;599;10569;10842;4.14;0.25;366.38;13.62;1415;46;3723.00;273
9155;25;5728548;9155;599;10572;10846;4.19;0.26;366.35;13.62;1417;46;3724.00;274
9160;25;5728563;9160;594;10572;10846;4.22;0.26;366.18;13.62;1412;46;3725.00;274
9163;25;5728579;9163;596;10574;10849;4.24;0.26;366.10;13.61;1411;46;3726.00;275
9167;25;5728595;9167;591;10574;10849;4.23;0.26;366.08;13.61;1407;46;3727.00;275
9171;25;5728612;9171;587;10575;10849;4.22;0.26;366.24;13.61;1404;46;3728.00;274
9173;25;5728628;9173;582;10575;10849;4.22;0.26;366.21;13.61;1402;46;3729.00;274
9174;25;5728644;9174;584;10579;10853;4.27;0.26;366.22;13.61;1405;46;3730.00;274
9177;25;5728660;9177;588;10579;10853;4.28;0.26;366.24;13.61;1402;46;3731.00;274
9179;25;5728676;9179;583;10579;10853;4.29;0.26;366.34;13.61;1400;46;3732.00;274
9181;25;5728691;9181;584;10579;10853;4.26;0.26;366.27;13.61;1398;46;3733.00;274
9183;25;5728708;9183;581;10579;10854;4.23;0.26;366.24;13.61;1396;46;3734.00;275
9185;25;5728724;9185;585;10582;10856;4.25;0.26;366.22;13.68;1397;46;3735.00;274
9188;25;5728743;9188;585;10583;10856;4.22;0.26;366.21;13.75;1395;46;3736.00;273
9189;25;5728759;9189;600;10584;10857;4.21;0.25;366.22;13.75;1395;46;3737.00;273
9191;25;5728775;9191;595;10584;10857;4.18;0.25;366.28;13.75;1393;46;3738.00;273
9193;25;5728792;9193;599;10585;10857;4.14;0.25;366.30;13.83;1392;46;3739.00;272
9195;25;5728809;9195;598;10585;10857;4.11;0.25;366.38;13.83;1390;46;3740.00;272
9195;25;5728825;9195;591;10585;10857;4.12;0.25;366.38;13.83;1390;46;3741.00;272
9197;25;5728840;9197;578;10585;10857;4.11;0.25;366.40;13.83;1388;46;3742.00;272
9197;25;5728856;9197;569;10585;10857;4.15;0.25;366.40;13.83;1388;46;3743.00;272
9199;25;5728877;9199;575;10656;10984;4.44;0.27;366.41;13.74;1457;46;3744.00;328
9200;25;5728908;9200;567;10659;10985;4.49;0.28;366.39;13.73;1459;46;3745.00;326
9202;25;5728926;9202;560;10666;10985;4.60;0.28;366.40;13.73;1464;46;3746.00;319
9202;25;5728943;9202;557;10670;10985;4.67;0.29;366.40;13.72;1468;46;3747.00;315
9204;25;5728960;9204;550;10676;10985;4.75;0.29;366.52;13.72;1472;46;3748.00;309
9206;25;5728978;9206;555;10678;10985;4.77;0.29;366.53;13.72;1472;46;3749.00;307
9206;25;5728997;9206;550;10683;10990;4.78;0.29;366.53;13.71;1477;46;3750.00;307
9206;25;5729022;9206;547;10685;10990;4.80;0.29;366.53;13.71;1479;46;3751.00;305
9207;25;5729045;9207;556;10686;10991;4.78;0.29;366.54;13.71;1479;46;3752.00;305
9208;25;5729069;9208;568;10690;10992;4.78;0.29;366.64;13.71;1482;46;3753.00;302
9211;25;5729085;9211;561;10691;10992;4.78;0.29;366.62;13.71;1480;46;3754.00;301
9213;25;5729102;9213;569;10694;10993;4.79;0.29;366.71;13.71;1481;46;3755.00;299
9214;25;5729125;9214;581;10697;10993;4.75;0.29;366.70;13.70;1483;46;3756.00;296
9216;25;5729142;9216;576;10699;10993;4.75;0.29;366.66;13.70;1483;46;3757.00;294
9218;25;5729158;9218;591;10701;10993;4.69;0.29;366.63;13.70;1483;46;3758.00;292
9221;25;5729173;9221;592;10705;10997;4.64;0.28;366.57;13.70;1484;46;3759.00;292
9221;25;5729189;9221;599;10707;10997;4.59;0.28;366.57;13.77;1486;46;3760.00;290
9222;25;5729206;9222;607;10709;10997;4.54;0.28;366.56;13.85;1487;46;3761.00;288
9224;25;5729222;9224;606;10711;11000;4.50;0.27;366.56;13.84;1487;46;3762.00;289
9226;25;5729239;9226;602;10713;11000;4.44;0.27;366.78;13.92;1487;46;3763.00;287
9228;25;5729254;9228;609;10716;11000;4.43;0.27;366.85;14.06;1488;46;3764.00;284
9230;25;5729269;9230;607;10720;11004;4.36;0.27;366.90;14.13;1490;46;3765.00;284
9231;25;5729284;9231;612;10724;11005;4.32;0.26;367.03;14.20;1493;46;3766.00;281
9232;25;5729299;9232;617;10726;11005;4.33;0.26;367.00;14.34;1494;46;3767.00;279
9235;25;5729314;9235;622;10732;11009;4.33;0.26;366.99;14.41;1497;46;3768.00;277
9237;25;5729335;9237;628;10732;11009;4.31;0.26;366.94;14.41;1495;46;3769.00;277
9240;25;5729349;9240;631;10733;11009;4.31;0.26;366.97;14.41;1493;46;3770.00;276
9241;25;5729365;9241;638;10736;11010;4.31;0.26;366.95;14.55;1495;46;3771.00;274
9241;25;5729380;9241;645;10737;11010;4.33;0.26;366.95;14.55;1496;46;3772.00;273
9243;25;5729395;9243;644;10744;11016;4.31;0.26;367.18;14.75;1501;46;3773.00;272
9244;25;5729410;9244;650;10746;11016;4.32;0.26;367.18;14.82;1502;46;3774.00;270
9245;25;5729424;9245;643;10746;11017;4.31;0.26;367.29;14.82;1501;46;3775.00;271
9246;25;5729439;9246;658;10746;11017;4.24;0.26;367.34;14.82;1500;46;3776.00;271
9248;25;5729454;9248;656;10748;11017;4.17;0.25;367.32;14.95;1500;46;3777.00;269
9251;25;5729469;9251;667;10748;11017;4.13;0.25;367.49;14.95;1497;46;3778.00;269
9254;25;5729484;9254;659;10748;11017;4.09;0.25;367.61;14.95;1494;46;3779.00;269
9255;25;5729504;9255;663;10776;11053;4.15;0.26;367.67;15.05;1521;46;3780.00;277
9258;25;5729525;9258;656;10776;11053;4.10;0.25;367.65;15.05;1518;46;3781.00;277
9259;25;5729540;9259;660;10780;11053;4.09;0.25;367.69;15.12;1521;46;3782.00;273
9262;25;5729556;9262;659;10781;11053;4.07;0.25;367.63;15.19;1519;46;3783.00;272
9263;25;5729572;9263;664;10782;11053;4.07;0.25;367.73;15.19;1519;46;3784.00;271
9266;25;5729586;9266;668;10783;11053;4.05;0.25;367.86;15.25;1517;46;3785.00;270
9268;25;5729601;9268;662;10788;11057;4.03;0.25;367.81;15.32;1520;46;3786.00;269
9270;25;5729621;9270;661;10788;11057;4.03;0.25;367.86;15.32;1518;46;3787.00;269
9270;25;5729637;9270;656;10792;11061;4.10;0.25;367.86;15.31;1522;46;3788.00;269
9272;25;5729652;9272;655;10794;11062;4.12;0.25;367.90;15.38;1522;46;3789.00;268
9273;25;5729669;9273;647;10794;11062;4.14;0.25;367.94;15.38;1521;46;3790.00;268
9279;25;5729683;9279;647;10795;11062;4.05;0.25;368.02;15.44;1516;46;3791.00;267
9281;25;5729698;9281;649;10806;11075;4.00;0.24;367.99;15.43;1525;46;3792.00;269
9285;25;5729714;9285;651;10807;11075;3.91;0.24;368.07;15.50;1522;46;3793.00;268
9287;25;5729728;9287;662;10807;11075;3.86;0.24;368.13;15.50;1520;46;3794.00;268
9292;25;5729743;9292;666;10808;11076;3.82;0.23;368.12;15.49;1516;46;3795.00;268
9293;25;5729759;9293;661;10808;11077;3.83;0.23;368.17;15.49;1515;46;3796.00;269
9296;25;5729775;9296;670;10808;11077;3.85;0.24;368.20;15.49;1512;46;3797.00;269
9299;25;5729790;9299;666;10811;11080;3.87;0.24;368.16;15.49;1512;46;3798.00;269
9303;25;5729806;9303;671;10811;11080;3.87;0.24;368.18;15.49;1508;46;3799.00;269
9307;25;5729824;9307;671;10811;11080;3.87;0.24;368.29;15.49;1504;46;3800.00;269
9311;25;5729844;9311;678;10811;11080;3.89;0.24;368.28;15.49;1500;46;3801.00;269
9315;25;5729860;9315;676;10816;11086;3.93;0.24;368.35;15.48;1501;46;3802.00;270
9318;25;5729878;9318;673;10816;11086;3.92;0.24;368.35;15.48;1498;46;3803.00;270
9320;25;5729895;9320;665;10816;11086;3.95;0.24;368.37;15.48;1496;46;3804.00;270
9322;25;5729914;9322;666;10816;11086;3.93;0.24;368.35;15.48;1494;46;3805.00;270
9325;25;5729936;9325;659;10819;11090;3.90;0.24;368.37;15.48;1494;46;3806.00;271
9328;25;5729953;9328;661;10820;11091;3.86;0.24;368.38;15.48;1492;46;3807.00;271
9331;25;5729970;9331;665;10820;11091;3.83;0.23;368.45;15.48;1489;46;3808.00;271
9335;25;5729987;9335;658;10821;11092;3.84;0.23;368.42;15.48;1486;46;3809.00;271
9338;25;5730006;9338;650;10821;11092;3.87;0.24;368.50;15.48;1483;46;3810.00;271
9340;25;5730023;9340;655;10821;11092;3.91;0.24;368.62;15.48;1481;46;3811.00;271
9345;25;5730038;9345;653;10821;11092;3.91;0.24;368.75;15.48;1476;46;3812.00;271
9348;25;5730054;9348;642;10821;11092;3.95;0.24;368.71;15.48;1473;46;3813.00;271
9352;25;5730071;9352;642;10821;11092;3.97;0.24;368.81;15.48;1469;46;3814.00;271
9357;25;5730088;9357;635;10821;11092;3.98;0.24;368.84;15.48;1464;46;3815.00;271
9362;25;5730105;9362;633;10857;11162;4.18;0.25;368.82;15.42;1495;46;3816.00;305
9367;25;5730128;9367;623;10860;11163;4.20;0.25;368.91;15.42;1493;46;3817.00;303
9369;25;5730145;9369;631;10866;11163;4.24;0.26;368.98;15.41;1497;46;3818.00;297
9374;25;5730162;9374;622;10869;11163;4.22;0.26;369.20;15.41;1495;46;3819.00;294
9376;25;5730179;9376;620;10870;11163;4.20;0.26;369.19;15.41;1494;46;3820.00;293
9380;25;5730196;9380;621;10871;11163;4.20;0.25;369.35;15.41;1491;46;3821.00;292
9384;25;5730214;9384;622;10872;11163;4.17;0.25;369.43;15.41;1488;46;3822.00;291
9388;25;5730232;9388;625;10874;11163;4.20;0.26;369.52;15.41;1486;46;3823.00;289
9393;25;5730249;9393;629;10876;11164;4.18;0.25;369.48;15.40;1483;46;3824.00;288
9395;26;5730266;9395;632;10879;11166;4.21;0.26;369.47;15.40;1484;47;3825.00;287
9399;26;5730293;9399;629;10879;11166;4.18;0.25;369.48;15.40;1480;47;3826.00;287
9403;26;5730309;9403;633;10881;11170;4.11;0.25;369.51;15.40;1478;47;3827.00;289
9406;26;5730327;9406;632;10881;11170;4.07;0.25;369.49;15.40;1475;47;3828.00;289
9409;26;5730344;9409;644;10881;11170;4.02;0.25;369.59;15.40;1472;47;3829.00;289
9414;26;5730360;9414;639;10881;11170;3.98;0.24;369.74;15.40;1467;47;3830.00;289
9418;26;5730378;9418;639;10886;11176;3.93;0.24;369.81;15.39;1468;47;3831.00;290
9420;26;5730395;9420;640;10888;11176;3.99;0.24;369.79;15.39;1468;47;3832.00;288
9424;26;5730410;9424;634;10888;11176;3.94;0.24;369.80;15.39;1464;47;3833.00;288
9427;26;5730425;9427;637;10889;11179;3.96;0.24;369.76;15.39;1462;47;3834.00;290
9430;26;5730445;9430;636;10890;11179;3.94;0.24;369.96;15.39;1460;47;3835.00;289
9432;26;5730460;9432;640;10890;11179;3.95;0.24;370.04;15.39;1458;47;3836.00;289
9436;26;5730474;9436;646;10891;11180;3.89;0.24;370.10;15.39;1455;47;3837.00;289
9439;26;5730489;9439;646;10893;11181;3.88;0.24;370.24;15.39;1454;47;3838.00;288
9441;26;5730504;9441;656;10893;11181;3.83;0.23;370.22;15.39;1452;47;3839.00;288
9444;26;5730522;9444;660;10913;11207;3.86;0.23;370.24;15.37;1469;47;3840.00;294
9448;26;5730539;9448;675;10914;11207;3.81;0.23;370.41;15.37;1466;47;3841.00;293
9450;26;5730554;9450;672;10915;11207;3.80;0.23;370.45;15.37;1465;47;3842.00;292
9456;26;5730569;9456;671;10916;11208;3.79;0.23;370.48;15.37;1460;47;3843.00;292
9458;26;5730586;9458;670;10918;11208;3.78;0.23;370.58;15.37;1460;47;3844.00;290
9462;26;5730602;9462;668;10921;11212;3.81;0.23;370.57;15.36;1459;47;3845.00;291
9463;26;5730620;9463;673;10923;11214;3.82;0.23;370.62;15.36;1460;47;3846.00;291
9465;26;5730636;9465;674;10927;11218;3.84;0.23;370.59;15.36;1462;47;3847.00;291
9470;26;5730652;9470;678;10930;11218;3.80;0.23;370.77;15.36;1460;47;3848.00;288
9473;26;5730670;9473;688;10930;11218;3.82;0.23;370.82;15.36;1457;47;3849.00;288
9476;26;5730686;9476;686;10930;11218;3.79;0.23;370.75;15.36;1454;47;3850.00;288
9480;26;5730702;9480;681;10933;11218;3.76;0.23;370.92;15.36;1453;47;3851.00;285
9481;26;5730724;9481;673;10942;11230;3.78;0.23;370.91;15.34;1461;47;3852.00;288
9484;26;5730745;9484;678;10943;11230;3.77;0.23;371.00;15.34;1459;47;3853.00;287
9488;26;5730761;9488;674;10944;11230;3.77;0.23;371.08;15.34;1456;47;3854.00;286
9491;26;5730777;9491;683;10944;11230;3.77;0.23;371.27;15.34;1453;47;3855.00;286
9495;26;5730792;9495;686;10945;11230;3.76;0.23;371.29;15.34;1450;47;3856.00;285
9496;26;5730808;9496;682;10945;11230;3.82;0.23;371.34;15.34;1449;47;3857.00;285
9498;26;5730830;9498;690;10945;11231;3.83;0.23;371.47;15.34;1447;47;3858.00;286
9500;26;5730845;9500;691;10945;11231;3.85;0.24;371.43;15.34;1445;47;3859.00;286
9501;26;5730861;9501;698;10950;11237;3.88;0.24;371.41;15.33;1449;47;3860.00;287
9503;26;5730877;9503;705;10951;11238;3.90;0.24;371.48;15.33;1448;47;3861.00;287
9503;26;5730892;9503;700;10951;11238;3.92;0.24;371.48;15.33;1448;47;3862.00;287
9503;26;5730907;9503;688;10951;11238;3.91;0.24;371.48;15.33;1448;47;3863.00;287
9505;26;5730927;9505;687;10954;11242;3.97;0.24;371.52;15.33;1449;47;3864.00;288
9508;26;5730942;9508;681;10954;11242;3.97;0.24;371.47;15.33;1446;47;3865.00;288
9509;26;5730958;9509;683;10955;11242;3.98;0.24;371.52;15.42;1446;47;3866.00;287
9511;26;5730974;9511;688;10956;11243;4.01;0.24;371.54;15.42;1445;47;3867.00;287
9514;26;5730989;9514;681;10959;11247;4.02;0.24;371.62;15.41;1445;47;3868.00;288
9514;26;5731005;9514;673;10959;11247;4.01;0.24;371.62;15.41;1445;47;3869.00;288
9515;26;5731021;9515;672;10963;11253;3.99;0.24;371.61;15.41;1448;47;3870.00;290
9520;26;5731037;9520;672;10963;11253;3.89;0.24;371.57;15.41;1443;47;3871.00;290
9521;26;5731052;9521;681;10965;11253;3.86;0.23;371.57;15.40;1444;47;3872.00;288
9524;26;5731066;9524;680;10965;11253;3.79;0.23;371.46;15.40;1441;47;3873.00;288
9525;26;5731081;9525;683;10969;11257;3.82;0.23;371.43;15.40;1444;47;3874.00;288
9529;26;5731096;9529;685;10969;11257;3.78;0.23;371.35;15.40;1440;47;3875.00;288
9531;26;5731110;9531;676;10969;11257;3.77;0.23;371.29;15.40;1438;47;3876.00;288
9534;26;5731125;9534;680;10969;11257;3.73;0.23;371.22;15.40;1435;47;3877.00;288
9534;26;5731139;9534;677;10969;11258;3.72;0.23;371.22;15.40;1435;47;3878.00;289
9536;26;5731153;9536;687;10970;11259;3.69;0.22;371.18;15.40;1434;47;3879.00;289
9539;26;5731167;9539;680;10970;11259;3.61;0.22;371.25;15.40;1431;47;3880.00;289
9541;26;5731182;9541;688;10971;11260;3.56;0.22;371.25;15.40;1430;47;3881.00;289
9541;26;5731196;9541;688;10971;11260;3.53;0.21;371.25;15.40;1430;47;3882.00;289
9543;26;5731209;9543;686;10971;11260;3.51;0.21;371.23;15.40;1428;47;3883.00;289
9543;26;5731224;9543;691;10971;11260;3.45;0.21;371.23;15.40;1428;47;3884.00;289
9544;26;5731237;9544;687;10971;11260;3.46;0.21;371.22;15.40;1427;47;3885.00;289
9544;26;5731251;9544;684;10971;11260;3.47;0.21;371.22;15.40;1427;47;3886.00;289
9545;26;5731265;9545;679;10971;11260;3.50;0.21;371.22;15.40;1426;47;3887.00;289
9548;26;5731279;9548;705;11041;11387;3.67;0.23;371.29;15.30;1493;47;3888.00;346
9549;26;5731302;9549;675;11041;11388;3.72;0.23;371.28;15.30;1492;47;3889.00;347
9552;26;5731319;9552;646;11049;11388;3.83;0.24;371.21;15.29;1497;47;3890.00;339
9554;26;5731335;9554;626;11050;11388;3.90;0.24;371.29;15.29;1496;47;3891.00;338
9556;26;5731349;9556;616;11055;11388;3.97;0.25;371.27;15.28;1499;47;3892.00;333
9557;26;5731364;9557;616;11058;11388;4.04;0.25;371.24;15.28;1501;47;3893.00;330
9558;26;5731379;9558;604;11060;11388;4.09;0.25;371.23;15.28;1502;47;3894.00;328
9558;26;5731394;9558;605;11061;11388;4.13;0.25;371.23;15.28;1503;47;3895.00;327
9559;26;5731414;9559;601;11064;11389;4.22;0.26;371.24;15.28;1505;47;3896.00;325
9560;26;5731430;9560;596;11066;11390;4.31;0.26;371.23;15.27;1506;47;3897.00;324
9561;26;5731445;9561;586;11068;11390;4.33;0.27;371.22;15.27;1507;47;3898.00;322
9561;26;5731461;9561;587;11073;11391;4.37;0.27;371.22;15.35;1512;47;3899.00;318
9567;26;5731483;9567;578;11081;11406;4.37;0.27;371.16;15.41;1514;47;3900.00;325
9569;26;5731505;9569;581;11083;11406;4.42;0.27;371.13;15.41;1514;47;3901.00;323
9573;26;5731521;9573;574;11084;11406;4.43;0.27;371.08;15.41;1511;47;3902.00;322
9577;26;5731537;9577;577;11088;11410;4.43;0.27;371.08;15.41;1511;47;3903.00;322
9581;26;5731553;9581;572;11090;11410;4.42;0.27;370.99;15.41;1509;47;3904.00;320
9582;26;5731569;9582;570;11093;11410;4.41;0.27;370.99;15.41;1511;47;3905.00;317
9583;26;5731585;9583;575;11096;11413;4.46;0.27;371.03;15.41;1513;47;3906.00;317
9584;26;5731601;9584;578;11099;11413;4.49;0.28;370.99;15.41;1515;47;3907.00;314
9587;26;5731618;9587;588;11100;11413;4.49;0.28;370.96;15.41;1513;47;3908.00;313
9591;26;5731633;9591;598;11105;11417;4.45;0.27;371.11;15.41;1514;47;3909.00;312
9592;26;5731651;9592;611;11107;11418;4.45;0.27;371.14;15.40;1515;47;3910.00;311
9594;26;5731666;9594;608;11110;11418;4.46;0.27;371.31;15.40;1516;47;3911.00;308
9595;26;5731682;9595;615;11113;11422;4.48;0.27;371.33;15.40;1518;47;3912.00;309
9599;26;5731698;9599;614;11114;11422;4.45;0.27;371.45;15.40;1515;47;3913.00;308
9602;26;5731720;9602;611;11115;11422;4.44;0.27;371.57;15.40;1513;47;3914.00;307
9605;26;5731736;9605;614;11117;11424;4.40;0.27;371.53;15.39;1512;47;3915.00;307
9606;26;5731753;9606;618;11117;11424;4.35;0.26;371.52;15.39;1511;47;3916.00;307
9608;26;5731769;9608;602;11123;11430;4.36;0.26;371.49;15.39;1515;47;3917.00;307
9610;26;5731786;9610;613;11123;11430;4.36;0.26;371.58;15.39;1513;47;3918.00;307
9612;26;5731801;9612;611;11123;11431;4.34;0.26;371.61;15.39;1511;47;3919.00;308
9613;26;5731821;9613;616;11123;11431;4.28;0.26;371.71;15.39;1510;47;3920.00;308
9614;26;5731842;9614;619;11124;11431;4.27;0.26;371.81;15.47;1510;47;3921.00;307
9615;26;5731857;9615;625;11125;11431;4.25;0.26;371.86;15.47;1510;47;3922.00;306
9617;26;5731874;9617;636;11126;11431;4.20;0.26;371.95;15.47;1509;47;3923.00;305
9619;26;5731890;9619;631;11135;11443;4.25;0.26;372.13;15.45;1516;47;3924.00;308
9620;26;5731908;9620;647;11137;11443;4.27;0.26;372.15;15.60;1517;47;3925.00;306
9623;26;5731924;9623;654;11140;11443;4.25;0.26;372.31;15.60;1517;47;3926.00;303
9626;26;5731940;9626;664;11141;11443;4.25;0.26;372.45;15.68;1515;47;3927.00;302
9629;26;5731956;9629;656;11141;11443;4.24;0.26;372.48;15.68;1512;47;3928.00;302
9631;26;5731977;9631;661;11141;11443;4.20;0.25;372.51;15.68;1510;47;3929.00;302
9631;26;5731994;9631;663;11145;11447;4.17;0.25;372.51;15.75;1514;47;3930.00;302
9636;26;5732009;9636;661;11145;11447;4.13;0.25;372.67;15.75;1509;47;3931.00;302
9638;26;5732025;9638;660;11149;11451;4.16;0.25;372.68;15.74;1511;47;3932.00;302
9639;26;5732041;9639;655;11151;11452;4.16;0.25;372.74;15.82;1512;47;3933.00;301
9640;26;5732056;9640;664;11151;11452;4.13;0.25;372.85;15.82;1511;47;3934.00;301
9641;26;5732071;9641;675;11152;11452;4.11;0.25;372.83;15.89;1511;47;3935.00;300
9642;26;5732086;9642;678;11162;11465;4.12;0.25;372.79;15.88;1520;47;3936.00;303
9643;26;5732102;9643;683;11162;11465;4.11;0.25;372.83;15.88;1519;47;3937.00;303
9648;26;5732117;9648;681;11163;11465;4.08;0.25;372.95;15.95;1515;47;3938.00;302
9652;26;5732132;9652;679;11164;11466;4.07;0.25;373.19;15.95;1512;47;3939.00;302
9654;26;5732147;9654;679;11165;11467;4.07;0.25;373.16;15.95;1511;47;3940.00;302
9656;26;5732162;9656;678;11166;11467;4.08;0.25;373.24;16.03;1510;47;3941.00;301
9658;26;5732178;9658;678;11172;11470;4.07;0.25;373.27;16.24;1514;47;3942.00;298
9660;26;5732193;9660;686;11173;11470;4.07;0.25;373.43;16.32;1513;47;3943.00;297
9662;26;5732210;9662;675;11175;11470;4.08;0.25;373.43;16.39;1513;48;3944.00;295
9663;26;5732230;9663;674;11177;11470;4.07;0.25;373.47;16.46;1514;48;3945.00;293
9665;26;5732251;9665;666;11182;11476;4.11;0.25;373.46;16.45;1517;48;3946.00;294
9668;26;5732266;9668;664;11182;11476;4.11;0.25;373.43;16.45;1514;48;3947.00;294
9669;26;5732282;9669;667;11184;11476;4.07;0.25;373.48;16.60;1515;48;3948.00;292
9672;26;5732298;9672;663;11184;11476;4.08;0.25;373.44;16.60;1512;48;3949.00;292
9673;26;5732325;9673;674;11189;11480;4.04;0.25;373.41;16.73;1516;48;3950.00;291
9676;26;5732345;9676;666;11190;11481;3.99;0.24;373.55;16.73;1514;48;3951.00;291
9678;26;5732362;9678;669;11190;11481;4.00;0.24;373.59;16.73;1512;48;3952.00;291
9682;26;5732377;9682;675;11191;11482;3.97;0.24;373.55;16.73;1509;48;3953.00;291
9683;26;5732392;9683;680;11194;11482;3.93;0.24;373.52;16.94;1511;48;3954.00;288
9686;26;5732407;9686;691;11194;11482;3.91;0.24;373.61;16.94;1508;48;3955.00;288
9691;26;5732423;9691;690;11196;11482;3.84;0.23;373.68;17.08;1505;48;3956.00;286
9693;26;5732438;9693;688;11196;11482;3.84;0.23;373.64;17.08;1503;48;3957.00;286
9696;26;5732453;9696;691;11197;11482;3.84;0.23;373.69;17.15;1501;48;3958.00;285
9698;26;5732468;9698;702;11198;11482;3.80;0.23;373.70;17.22;1500;48;3959.00;284
9702;26;5732485;9702;706;11260;11607;3.98;0.25;373.63;17.19;1558;48;3960.00;347
9707;26;5732511;9707;695;11268;11608;4.00;0.25;373.63;17.25;1561;48;3961.00;340
9711;26;5732526;9711;689;11276;11608;4.02;0.25;373.72;17.24;1565;48;3962.00;332
9713;26;5732542;9713;691;11282;11608;4.03;0.25;373.68;17.30;1569;48;3963.00;326
9716;26;5732557;9716;693;11288;11608;4.00;0.25;373.67;17.49;1572;48;3964.00;320
9719;26;5732572;9719;692;11291;11608;3.99;0.25;373.74;17.49;1572;48;3965.00;317
9723;26;5732588;9723;698;11296;11608;3.99;0.25;373.85;17.62;1573;48;3966.00;312
9724;26;5732603;9724;694;11299;11608;3.98;0.24;373.90;17.62;1575;48;3967.00;309
9730;26;5732618;9730;698;11302;11609;3.95;0.24;374.18;17.61;1572;48;3968.00;307
9731;26;5732635;9731;704;11304;11610;3.92;0.24;374.17;17.61;1573;48;3969.00;306
9735;26;5732650;9735;698;11307;11610;3.87;0.24;374.31;17.68;1572;48;3970.00;303
9739;26;5732667;9739;699;11309;11614;3.82;0.23;374.44;17.68;1570;48;3971.00;305
9744;26;5732682;9744;701;11310;11614;3.79;0.23;374.47;17.68;1566;48;3972.00;304
9748;26;5732697;9748;706;11310;11614;3.75;0.23;374.75;17.68;1562;48;3973.00;304
9751;26;5732713;9751;702;11310;11614;3.70;0.23;374.77;17.68;1559;48;3974.00;304
9755;26;5732729;9755;710;11314;11620;3.64;0.22;375.00;17.67;1559;48;3975.00;306
9758;26;5732745;9758;718;11314;11620;3.57;0.22;375.02;17.67;1556;48;3976.00;306
9760;26;5732760;9760;722;11314;11620;3.56;0.22;375.06;17.67;1554;48;3977.00;306
9763;26;5732775;9763;715;11315;11623;3.52;0.21;375.13;17.67;1552;48;3978.00;308
9767;26;5732790;9767;722;11316;11623;3.50;0.21;375.24;17.67;1549;48;3979.00;307
9772;26;5732805;9772;715;11316;11623;3.48;0.21;375.35;17.67;1544;48;3980.00;307
9776;26;5732821;9776;718;11316;11624;3.49;0.21;375.53;17.67;1540;48;3981.00;308
9781;26;5732836;9781;715;11317;11625;3.46;0.21;375.70;17.67;1536;48;3982.00;308
9783;26;5732851;9783;724;11318;11625;3.44;0.21;375.70;17.76;1535;48;3983.00;307
9788;26;5732868;9788;721;11329;11638;3.42;0.21;376.02;17.75;1541;48;3984.00;309
9793;26;5732885;9793;722;11329;11638;3.36;0.21;376.09;17.75;1536;48;3985.00;309
9794;26;5732900;9794;722;11329;11638;3.36;0.21;376.10;17.75;1535;49;3986.00;309
9799;26;5732925;9799;727;11329;11639;3.36;0.21;376.18;17.75;1530;49;3987.00;310
9804;26;5732941;9804;722;11329;11639;3.30;0.20;376.43;17.75;1525;49;3988.00;310
9807;26;5732955;9807;716;11332;11643;3.29;0.20;376.49;17.74;1525;49;3989.00;311
9812;26;5732972;9812;716;11332;11643;3.27;0.20;376.79;17.74;1520;49;3990.00;311
9815;26;5732987;9815;722;11335;11647;3.27;0.20;376.83;17.74;1520;49;3991.00;312
9821;26;5733002;9821;717;11335;11647;3.25;0.20;376.92;17.74;1514;49;3992.00;312
9824;26;5733018;9824;714;11335;11647;3.24;0.20;376.97;17.74;1511;49;3993.00;312
9826;26;5733033;9826;717;11335;11647;3.22;0.20;377.00;17.74;1509;49;3994.00;312
9829;26;5733048;9829;712;11335;11647;3.18;0.20;377.08;17.74;1506;49;3995.00;312
9833;26;5733062;9833;705;11345;11659;3.24;0.20;377.38;17.72;1512;49;3996.00;314
9835;26;5733078;9835;715;11345;11659;3.24;0.20;377.38;17.72;1510;49;3997.00;314
9838;26;5733092;9838;707;11345;11659;3.23;0.20;377.43;17.72;1507;49;3998.00;314
9839;26;5733107;9839;707;11347;11659;3.24;0.20;377.40;17.82;1508;49;3999.00;312
9843;26;5733122;9843;707;11348;11659;3.23;0.20;377.36;17.82;1505;49;4000.00;311
9846;26;5733140;9846;703;11349;11659;3.20;0.20;377.26;17.83;1503;49;4001.00;310
9849;26;5733154;9849;707;11349;11660;3.17;0.20;377.32;17.83;1500;49;4002.00;311
9850;26;5733169;9850;702;11350;11660;3.14;0.19;377.33;17.83;1500;49;4003.00;310
9853;26;5733183;9853;700;11354;11666;3.08;0.19;377.32;17.82;1501;49;4004.00;312
9854;26;5733199;9854;705;11355;11668;3.07;0.19;377.31;17.82;1501;49;4005.00;313
9857;26;5733213;9857;709;11357;11668;3.02;0.19;377.25;17.92;1500;49;4006.00;311
9860;26;5733227;9860;704;11358;11668;3.01;0.19;377.25;17.92;1498;49;4007.00;310
9862;26;5733241;9862;706;11362;11672;3.05;0.19;377.26;17.92;1500;49;4008.00;310
9865;26;5733256;9865;699;11363;11672;3.08;0.19;377.23;17.92;1498;49;4009.00;309
9869;26;5733271;9869;701;11363;11672;3.09;0.19;377.26;17.92;1494;49;4010.00;309
9871;26;5733286;9871;700;11366;11673;3.12;0.19;377.25;17.92;1495;49;4011.00;307
9872;26;5733300;9872;707;11369;11677;3.15;0.19;377.22;17.91;1497;49;4012.00;308
9874;26;5733315;9874;700;11371;11677;3.18;0.20;377.16;18.01;1497;49;4013.00;306
9879;26;5733330;9879;698;11372;11680;3.15;0.19;377.13;18.01;1493;49;4014.00;308
9886;26;5733345;9886;699;11373;11680;3.10;0.19;377.15;18.01;1487;49;4015.00;307
9887;26;5733365;9887;682;11374;11680;3.09;0.19;377.13;18.01;1487;49;4016.00;306
9889;26;5733381;9889;670;11374;11680;3.10;0.19;377.16;18.01;1485;49;4017.00;306
9889;26;5733395;9889;670;11377;11684;3.18;0.19;377.16;18.00;1488;49;4018.00;307
9891;26;5733411;9891;662;11379;11684;3.19;0.19;377.15;18.00;1488;49;4019.00;305
9892;26;5733428;9892;652;11380;11684;3.21;0.20;377.12;18.10;1488;49;4020.00;304
9894;26;5733443;9894;652;11380;11684;3.25;0.20;377.09;18.10;1486;49;4021.00;304
9898;26;5733458;9898;654;11380;11685;3.28;0.20;377.18;18.10;1482;49;4022.00;305
9899;26;5733473;9899;649;11382;11686;3.34;0.20;377.18;18.10;1483;49;4023.00;304
9903;26;5733489;9903;656;11382;11686;3.37;0.21;377.17;18.10;1479;49;4024.00;304
9903;26;5733504;9903;654;11384;11687;3.45;0.21;377.17;18.10;1481;49;4025.00;303
9906;26;5733524;9906;645;11384;11687;3.48;0.21;377.10;18.10;1478;49;4026.00;303
9908;26;5733540;9908;655;11384;11687;3.49;0.21;377.16;18.10;1476;49;4027.00;303
9911;26;5733555;9911;654;11384;11687;3.50;0.21;377.25;18.10;1473;49;4028.00;303
9913;26;5733572;9913;649;11384;11687;3.52;0.22;377.26;18.10;1471;49;4029.00;303
9913;26;5733586;9913;653;11384;11687;3.53;0.22;377.26;18.10;1471;49;4030.00;303
9915;26;5733601;9915;655;11384;11687;3.54;0.22;377.27;18.10;1469;49;4031.00;303
9915;26;5733616;9915;671;11449;11814;3.85;0.24;377.27;17.99;1534;49;4032.00;365
9916;26;5733641;9916;662;11453;11815;3.86;0.24;377.28;17.99;1537;49;4033.00;362
9917;26;5733657;9917;657;11463;11815;3.92;0.24;377.32;17.97;1546;49;4034.00;352
9919;26;5733672;9919;664;11466;11815;3.92;0.24;377.37;17.97;1547;49;4035.00;349
9921;26;5733688;9921;652;11472;11815;3.93;0.24;377.40;17.96;1551;49;4036.00;343
9922;26;5733704;9922;653;11475;11815;3.91;0.24;377.47;17.96;1553;49;4037.00;340
9924;26;5733722;9924;653;11477;11815;3.87;0.24;377.57;17.96;1553;49;4038.00;338
9925;26;5733739;9925;649;11479;11815;3.87;0.24;377.58;17.96;1554;49;4039.00;336
9926;26;5733755;9926;644;11481;11816;3.89;0.24;377.63;17.95;1555;49;4040.00;335
9927;26;5733772;9927;640;11486;11817;3.86;0.24;377.62;17.95;1559;49;4041.00;331
9927;26;5733789;9927;637;11488;11817;3.87;0.24;377.62;17.95;1561;49;4042.00;329
9927;26;5733805;9927;652;11490;11818;3.88;0.24;377.62;17.95;1563;49;4043.00;328
9927;26;5733827;9927;652;11492;11818;3.88;0.24;377.62;17.95;1565;49;4044.00;326
9929;26;5733845;9929;646;11494;11818;3.88;0.24;377.66;17.95;1565;49;4045.00;324
9932;26;5733862;9932;646;11496;11818;3.91;0.24;377.76;17.94;1564;49;4046.00;322
9933;26;5733879;9933;647;11500;11822;3.95;0.24;377.83;17.94;1567;49;4047.00;322
9936;26;5733897;9936;643;11500;11822;3.96;0.24;377.92;17.94;1564;49;4048.00;322
9937;26;5733913;9937;639;11501;11822;3.97;0.24;377.93;17.94;1564;49;4049.00;321
9938;27;5733931;9938;636;11506;11828;3.97;0.24;377.92;18.04;1568;50;4050.00;322
9941;27;5733961;9941;619;11506;11828;3.97;0.24;377.90;18.04;1565;50;4051.00;322
9941;27;5733978;9941;609;11508;11828;4.01;0.25;377.90;18.03;1567;50;4052.00;320
9942;27;5733995;9942;605;11512;11832;4.05;0.25;377.93;18.03;1570;50;4053.00;320
9944;27;5734012;9944;595;11513;11833;4.08;0.25;378.05;18.03;1569;50;4054.00;320
9944;27;5734033;9944;589;11515;11833;4.11;0.25;378.05;18.03;1571;50;4055.00;318
9945;27;5734049;9945;593;11519;11837;4.15;0.25;378.04;18.02;1574;50;4056.00;318
9950;27;5734066;9950;573;11519;11837;4.14;0.25;378.04;18.02;1569;50;4057.00;318
9952;27;5734083;9952;563;11519;11837;4.18;0.25;378.02;18.02;1567;50;4058.00;318
9953;27;5734100;9953;558;11520;11838;4.21;0.26;378.04;18.02;1567;50;4059.00;318
9955;27;5734117;9955;557;11520;11838;4.26;0.26;378.16;18.02;1565;50;4060.00;318
9958;27;5734134;9958;553;11524;11844;4.29;0.26;378.15;18.01;1566;50;4061.00;320
9960;27;5734151;9960;542;11524;11844;4.29;0.26;378.18;18.01;1564;50;4062.00;320
9964;27;5734167;9964;537;11524;11845;4.29;0.26;378.24;18.01;1560;50;4063.00;321
9967;27;5734183;9967;532;11524;11845;4.31;0.26;378.20;18.01;1557;50;4064.00;321
9973;27;5734200;9973;538;11524;11845;4.28;0.26;378.33;18.01;1551;50;4065.00;321
9974;27;5734219;9974;543;11524;11845;4.27;0.26;378.37;18.01;1550;50;4066.00;321
9976;27;5734236;9976;549;11524;11845;4.28;0.26;378.32;18.01;1548;50;4067.00;321
9980;27;5734261;9980;554;11534;11857;4.30;0.26;378.36;18.00;1554;50;4068.00;323
9980;27;5734282;9980;547;11534;11857;4.34;0.26;378.36;18.00;1554;50;4069.00;323
9982;27;5734300;9982;559;11535;11857;4.38;0.27;378.49;18.00;1553;50;4070.00;322
9986;27;5734320;9986;556;11535;11857;4.39;0.27;378.49;18.00;1549;50;4071.00;322
9989;27;5734338;9989;564;11535;11857;4.39;0.27;378.58;18.00;1546;50;4072.00;322
9994;27;5734356;9994;566;11535;11857;4.36;0.26;378.64;18.00;1541;50;4073.00;322
9996;27;5734374;9996;568;11538;11861;4.31;0.26;378.69;17.99;1542;50;4074.00;323
9999;27;5734402;9999;580;11538;11861;4.31;0.26;378.73;17.99;1539;50;4075.00;323
10001;27;5734429;10001;598;11543;11865;4.31;0.26;378.76;17.99;1542;50;4076.00;322
10003;27;5734448;10003;598;11544;11866;4.28;0.26;378.89;17.99;1541;50;4077.00;322
10003;27;5734471;10003;613;11544;11866;4.27;0.26;378.89;17.99;1541;50;4078.00;322
10005;27;5734491;10005;624;11546;11866;4.22;0.26;379.01;17.99;1541;50;4079.00;320
10008;27;5734512;10008;637;11567;11895;4.20;0.26;379.14;17.96;1559;50;4080.00;328
10010;27;5734533;10010;637;11567;11895;4.17;0.25;379.29;17.96;1557;50;4081.00;328
10012;27;5734553;10012;648;11570;11895;4.20;0.26;379.35;17.96;1558;50;4082.00;325
10012;27;5734573;10012;650;11572;11896;4.21;0.26;379.35;17.95;1560;50;4083.00;324
10014;27;5734592;10014;646;11573;11897;4.20;0.26;379.47;17.95;1559;50;4084.00;324
10015;27;5734610;10015;650;11573;11897;4.21;0.26;379.60;17.95;1558;50;4085.00;324
10018;27;5734630;10018;656;11576;11900;4.24;0.26;379.74;17.95;1558;50;4086.00;324
10019;27;5734649;10019;659;11576;11900;4.25;0.26;379.78;17.95;1557;50;4087.00;324
10023;27;5734668;10023;670;11576;11900;4.29;0.26;379.99;17.95;1553;50;4088.00;324
10028;27;5734687;10028;686;11576;11900;4.27;0.26;380.19;17.95;1548;50;4089.00;324
10030;27;5734706;10030;686;11581;11906;4.27;0.26;380.14;17.94;1551;50;4090.00;325
10032;27;5734725;10032;692;11581;11906;4.28;0.26;380.27;17.94;1549;50;4091.00;325
10034;27;5734743;10034;697;11581;11906;4.24;0.26;380.42;17.94;1547;50;4092.00;325
10036;27;5734761;10036;701;11581;11906;4.21;0.26;380.45;17.94;1545;50;4093.00;325
10038;27;5734787;10038;706;11584;11910;4.17;0.25;380.50;17.94;1546;50;4094.00;326
10039;27;5734805;10039;706;11586;11912;4.12;0.25;380.62;17.93;1547;50;4095.00;326
10039;27;5734822;10039;713;11586;11912;4.14;0.25;380.62;17.93;1547;50;4096.00;326
10042;27;5734841;10042;717;11587;11913;4.15;0.25;380.69;17.93;1545;50;4097.00;326
10043;27;5734866;10043;719;11587;11913;4.13;0.25;380.68;17.93;1544;50;4098.00;326
10047;27;5734884;10047;731;11587;11913;4.10;0.25;380.81;17.93;1540;50;4099.00;326
10049;27;5734904;10049;735;11587;11913;4.09;0.25;380.82;17.93;1538;50;4100.00;326
10051;27;5734925;10051;729;11587;11913;4.07;0.25;380.81;17.93;1536;50;4101.00;326
10053;27;5734943;10053;732;11587;11913;4.05;0.25;380.85;17.93;1534;50;4102.00;326
10055;27;5734961;10055;726;11587;11913;4.01;0.25;380.85;17.93;1532;50;4103.00;326
10060;27;5734978;10060;734;11619;11983;4.11;0.25;380.76;17.88;1559;50;4104.00;364
10062;27;5735002;10062;719;11621;11984;4.11;0.25;380.78;17.88;1559;50;4105.00;363
10063;27;5735019;10063;711;11626;11984;4.12;0.25;380.76;17.87;1563;50;4106.00;358
10066;27;5735038;10066;708;11628;11984;4.15;0.26;380.75;17.87;1562;50;4107.00;356
10072;27;5735056;10072;702;11629;11984;4.17;0.26;380.63;17.87;1557;51;4108.00;355
10077;27;5735084;10077;700;11630;11984;4.15;0.25;380.80;17.87;1553;51;4109.00;354
10080;27;5735105;10080;691;11632;11984;4.17;0.26;380.84;17.87;1552;51;4110.00;352
10082;27;5735123;10082;685;11634;11984;4.14;0.25;380.80;17.86;1552;51;4111.00;350
10085;27;5735159;10085;678;11636;11985;4.15;0.25;380.82;17.86;1551;51;4112.00;349
10090;27;5735200;10090;680;11637;11986;4.09;0.25;380.93;17.86;1547;51;4113.00;349
10092;27;5735243;10092;674;11638;11986;4.10;0.25;380.87;17.86;1546;51;4114.00;348
10092;27;5735275;10092;681;11641;11990;4.13;0.25;380.87;17.86;1549;51;4115.00;349
10095;27;5735303;10095;679;11641;11990;4.07;0.25;380.98;17.86;1546;51;4116.00;349
10098;27;5735335;10098;683;11641;11990;4.06;0.25;381.05;17.86;1543;51;4117.00;349
10100;27;5735366;10100;691;11641;11990;4.05;0.25;381.12;17.86;1541;51;4118.00;349
10101;27;5735392;10101;690;11645;11996;4.09;0.25;381.09;17.85;1544;51;4119.00;351
10104;27;5735422;10104;689;11645;11996;4.07;0.25;381.28;17.85;1541;51;4120.00;351
10104;27;5735443;10104;698;11645;11996;4.04;0.25;381.28;17.85;1541;51;4121.00;351
10108;27;5735461;10108;702;11646;11999;3.99;0.24;381.29;17.85;1538;51;4122.00;353
10112;27;5735482;10112;702;11646;11999;3.89;0.24;381.26;17.85;1534;51;4123.00;353
10115;27;5735506;10115;713;11646;11999;3.81;0.23;381.28;17.85;1531;51;4124.00;353
10119;27;5735532;10119;699;11646;12000;3.72;0.23;381.41;17.85;1527;51;4125.00;354
10121;27;5735558;10121;692;11647;12001;3.66;0.22;381.53;17.85;1526;51;4126.00;354
10122;27;5735590;10122;690;11647;12001;3.64;0.22;381.61;17.85;1525;51;4127.00;354
10125;27;5735617;10125;687;11656;12014;3.61;0.22;381.61;17.83;1531;51;4128.00;358
10128;27;5735641;10128;680;11657;12014;3.57;0.22;381.68;17.83;1529;51;4129.00;357
10130;27;5735667;10130;680;11658;12014;3.57;0.22;381.67;17.83;1528;51;4130.00;356
10134;27;5735689;10134;677;11658;12015;3.53;0.22;381.72;17.83;1524;51;4131.00;357
10137;27;5735713;10137;672;11658;12015;3.55;0.22;381.69;17.83;1521;51;4132.00;357
10143;27;5735737;10143;678;11661;12019;3.57;0.22;381.69;17.83;1518;51;4133.00;358
10145;27;5735756;10145;673;11661;12019;3.57;0.22;381.71;17.83;1516;51;4134.00;358
10148;27;5735773;10148;659;11663;12023;3.54;0.22;381.73;17.83;1515;51;4135.00;360
10152;27;5735790;10152;660;11663;12023;3.51;0.21;381.83;17.83;1511;51;4136.00;360
10154;27;5735806;10154;658;11664;12023;3.51;0.21;381.84;17.83;1510;51;4137.00;359
10159;27;5735822;10159;664;11664;12023;3.47;0.21;381.91;17.83;1505;51;4138.00;359
10165;27;5735839;10165;663;11664;12023;3.44;0.21;382.13;17.83;1499;51;4139.00;359
10167;27;5735857;10167;674;11688;12057;3.56;0.22;382.11;17.79;1521;51;4140.00;369
10172;27;5735876;10172;675;11690;12057;3.56;0.22;382.30;17.79;1518;51;4141.00;367
10173;27;5735892;10173;680;11693;12057;3.59;0.22;382.30;17.79;1520;51;4142.00;364
10180;27;5735908;10180;681;11694;12057;3.56;0.22;382.37;17.79;1514;51;4143.00;363
10182;27;5735925;10182;682;11695;12057;3.59;0.22;382.39;17.79;1513;51;4144.00;362
10188;28;5735941;10188;683;11695;12057;3.58;0.22;382.43;17.79;1507;52;4145.00;362
10192;28;5735972;10192;687;11695;12058;3.51;0.21;382.40;17.79;1503;52;4146.00;363
10195;28;5735988;10195;692;11695;12058;3.44;0.21;382.46;17.79;1500;52;4147.00;363
10199;28;5736004;10199;692;11699;12064;3.41;0.21;382.42;17.78;1500;52;4148.00;365
10203;28;5736020;10203;698;11699;12065;3.33;0.20;382.52;17.78;1496;52;4149.00;366
10206;28;5736035;10206;693;11699;12065;3.27;0.20;382.61;17.78;1493;52;4150.00;366
10207;28;5736052;10207;709;11699;12065;3.26;0.20;382.62;17.78;1492;52;4151.00;366
10209;28;5736067;10209;708;11703;12069;3.24;0.20;382.62;17.89;1494;52;4152.00;366
10210;28;5736083;10210;715;11703;12069;3.24;0.20;382.62;17.89;1493;52;4153.00;366
10215;28;5736098;10215;719;11703;12069;3.19;0.19;382.67;17.89;1488;52;4154.00;366
10218;28;5736115;10218;726;11704;12070;3.18;0.19;382.77;17.89;1486;52;4155.00;366
10222;28;5736130;10222;722;11707;12074;3.18;0.19;382.73;17.88;1485;52;4156.00;367
10226;28;5736145;10226;723;11707;12074;3.17;0.19;382.81;17.88;1481;52;4157.00;367
10229;28;5736160;10229;718;11708;12077;3.18;0.19;382.82;17.88;1479;52;4158.00;369
10233;28;5736176;10233;719;11708;12077;3.13;0.19;382.88;17.88;1475;52;4159.00;369
10236;28;5736191;10236;726;11708;12077;3.12;0.19;382.92;17.88;1472;52;4160.00;369
10238;28;5736206;10238;734;11708;12077;3.11;0.19;382.92;17.88;1470;52;4161.00;369
10243;28;5736220;10243;721;11711;12081;3.09;0.19;382.91;17.88;1468;52;4162.00;370
10247;28;5736236;10247;720;11711;12081;3.03;0.19;383.01;17.88;1464;52;4163.00;370
10249;28;5736252;10249;724;11711;12081;2.98;0.18;383.04;17.88;1462;52;4164.00;370
10254;28;5736268;10254;719;11711;12081;2.90;0.18;383.02;17.88;1457;52;4165.00;370
10256;28;5736282;10256;725;11711;12082;2.87;0.18;383.04;17.88;1455;52;4166.00;371
10261;28;5736296;10261;720;11711;12083;2.86;0.18;383.07;17.88;1450;52;4167.00;372
10263;28;5736310;10263;727;11711;12083;2.85;0.17;383.03;17.88;1448;52;4168.00;372
10264;28;5736323;10264;732;11713;12084;2.84;0.17;383.04;17.88;1449;52;4169.00;371
10267;28;5736347;10267;740;11713;12084;2.83;0.17;383.08;17.88;1446;52;4170.00;371
10267;28;5736362;10267;737;11713;12084;2.86;0.17;383.08;17.88;1446;52;4171.00;371
10268;28;5736376;10268;721;11713;12084;2.87;0.18;383.09;17.88;1445;52;4172.00;371
10271;28;5736389;10271;728;11715;12086;2.86;0.17;383.05;17.87;1444;52;4173.00;371
10272;28;5736404;10272;715;11715;12086;2.86;0.17;383.06;17.87;1443;52;4174.00;371
10274;28;5736418;10274;719;11716;12086;2.89;0.18;383.03;17.88;1442;52;4175.00;370
10276;28;5736432;10276;735;11784;12213;3.16;0.20;382.97;17.78;1508;52;4176.00;429
10278;28;5736459;10278;730;11787;12214;3.21;0.20;382.96;17.77;1509;52;4177.00;427
10279;28;5736484;10279;727;11794;12214;3.28;0.20;382.92;17.77;1515;52;4178.00;420
10282;28;5736507;10282;729;11799;12214;3.33;0.21;382.89;17.77;1517;52;4179.00;415
10284;28;5736528;10284;724;11802;12214;3.36;0.21;382.90;17.77;1518;52;4180.00;412
10285;28;5736547;10285;717;11805;12214;3.40;0.21;382.91;17.77;1520;52;4181.00;409
10286;28;5736566;10286;707;11809;12214;3.45;0.21;382.97;17.78;1523;52;4182.00;405
10287;28;5736586;10287;683;11811;12214;3.49;0.22;382.98;17.78;1524;52;4183.00;403
10288;28;5736610;10288;670;11814;12215;3.54;0.22;382.98;17.78;1526;52;4184.00;401
10289;28;5736636;10289;655;11816;12217;3.60;0.22;382.99;17.79;1527;52;4185.00;401
10289;28;5736660;10289;650;11818;12217;3.66;0.23;382.99;17.79;1529;52;4186.00;399
10290;28;5736683;10290;640;11819;12218;3.71;0.23;383.06;17.79;1529;52;4187.00;399
10292;28;5736709;10292;638;11822;12218;3.78;0.23;383.05;17.80;1530;52;4188.00;396
10292;28;5736729;10292;631;11823;12218;3.88;0.24;383.05;17.91;1531;52;4189.00;395
10294;28;5736746;10294;627;11827;12218;3.98;0.25;383.03;17.91;1533;52;4190.00;391
10296;28;5736765;10296;620;11830;12222;4.07;0.25;383.08;17.91;1534;52;4191.00;392
10298;28;5736786;10298;616;11831;12222;4.09;0.25;383.08;17.91;1533;52;4192.00;391
10299;28;5736811;10299;615;11831;12222;4.13;0.25;383.14;17.91;1532;52;4193.00;391
10302;28;5736839;10302;609;11833;12225;4.17;0.26;383.24;17.91;1531;52;4194.00;392
10302;28;5736862;10302;608;11833;12225;4.22;0.26;383.24;17.91;1531;52;4195.00;392
10302;28;5736879;10302;600;11833;12225;4.26;0.26;383.24;17.91;1531;52;4196.00;392
10302;28;5736898;10302;600;11837;12229;4.28;0.26;383.24;17.91;1535;52;4197.00;392
10304;28;5736917;10304;601;11838;12230;4.26;0.26;383.29;17.91;1534;52;4198.00;392
10305;28;5736943;10305;601;11839;12230;4.29;0.26;383.32;17.91;1534;52;4199.00;391
10309;28;5736974;10309;607;11849;12264;4.28;0.26;383.28;17.90;1540;52;4200.00;415
10310;28;5737011;10310;589;11850;12264;4.31;0.26;383.25;17.90;1540;53;4201.00;414
10312;28;5737049;10312;596;11852;12264;4.35;0.26;383.30;17.90;1540;53;4202.00;412
10312;28;5737078;10312;593;11852;12265;4.36;0.27;383.30;17.90;1540;53;4203.00;413
10312;28;5737099;10312;588;11854;12265;4.38;0.27;383.30;17.90;1542;53;4204.00;411
10316;28;5737121;10316;584;11858;12271;4.39;0.27;383.37;17.90;1542;53;4205.00;413
10317;28;5737149;10317;582;11859;12271;4.41;0.27;383.46;17.90;1542;53;4206.00;412
10320;28;5737170;10320;582;11860;12272;4.37;0.27;383.51;17.90;1540;53;4207.00;412
10321;28;5737189;10321;592;11863;12272;4.37;0.27;383.53;18.01;1542;53;4208.00;409
10324;28;5737207;10324;587;11863;12272;4.36;0.26;383.56;18.01;1539;53;4209.00;409
10326;28;5737225;10326;581;11863;12272;4.34;0.26;383.62;18.01;1537;53;4210.00;409
10329;28;5737243;10329;592;11866;12272;4.33;0.26;383.67;18.02;1537;53;4211.00;406
10330;28;5737264;10330;591;11874;12284;4.36;0.27;383.69;18.01;1544;53;4212.00;410
10334;28;5737292;10334;598;11874;12284;4.30;0.26;383.79;18.01;1540;53;4213.00;410
10334;28;5737328;10334;599;11876;12284;4.30;0.26;383.79;18.01;1542;53;4214.00;408
10337;28;5737351;10337;591;11876;12284;4.34;0.26;383.82;18.01;1539;53;4215.00;408
10343;28;5737374;10343;593;11877;12284;4.35;0.26;384.01;18.01;1534;53;4216.00;407
10347;28;5737392;10347;593;11879;12284;4.36;0.26;384.10;18.01;1532;53;4217.00;405
10348;28;5737410;10348;594;11883;12288;4.39;0.27;384.08;18.01;1535;53;4218.00;405
10350;28;5737429;10350;577;11884;12288;4.44;0.27;384.23;18.01;1534;53;4219.00;404
10352;28;5737450;10352;578;11886;12292;4.52;0.27;384.33;18.01;1534;53;4220.00;406
10353;28;5737468;10353;578;11887;12293;4.61;0.28;384.37;18.01;1534;53;4221.00;406
10356;28;5737486;10356;566;11888;12293;4.67;0.28;384.48;18.01;1532;53;4222.00;405
10360;28;5737507;10360;561;11889;12293;4.72;0.29;384.74;18.01;1529;53;4223.00;404
10363;28;5737531;10363;560;11898;12306;4.78;0.29;384.86;18.12;1535;53;4224.00;408
10366;28;5737555;10366;554;11899;12306;4.82;0.29;384.88;18.12;1533;53;4225.00;407
10369;28;5737577;10369;548;11899;12306;4.89;0.30;384.98;18.12;1530;53;4226.00;407
10375;28;5737598;10375;553;11902;12307;4.88;0.29;385.21;18.12;1527;53;4227.00;405
10377;28;5737616;10377;552;11902;12308;4.92;0.30;385.30;18.12;1525;53;4228.00;406
10383;28;5737634;10383;550;11905;12308;4.88;0.29;385.48;18.12;1522;53;4229.00;403
10389;28;5737654;10389;557;11909;12314;4.93;0.30;385.63;18.12;1520;53;4230.00;405
10392;28;5737671;10392;565;11909;12314;4.92;0.30;385.72;18.12;1517;53;4231.00;405
10397;28;5737696;10397;576;11910;12314;4.91;0.30;385.97;18.12;1513;53;4232.00;404
10399;28;5737717;10399;576;11910;12314;4.90;0.30;386.01;18.12;1511;53;4233.00;404
10403;28;5737737;10403;577;11914;12320;4.88;0.30;386.12;18.11;1511;53;4234.00;406
10405;28;5737761;10405;585;11915;12320;4.86;0.29;386.24;18.11;1510;53;4235.00;405
10408;28;5737779;10408;582;11915;12320;4.84;0.29;386.39;18.11;1507;53;4236.00;405
10413;28;5737796;10413;585;11916;12320;4.76;0.29;386.52;18.12;1503;53;4237.00;404
10416;28;5737813;10416;583;11919;12324;4.70;0.28;386.58;18.11;1503;53;4238.00;405
10419;28;5737830;10419;588;11919;12325;4.66;0.28;386.55;18.11;1500;53;4239.00;406
10424;28;5737847;10424;589;11920;12325;4.60;0.28;386.81;18.11;1496;53;4240.00;405
10424;28;5737863;10424;590;11921;12326;4.62;0.28;386.81;18.11;1497;53;4241.00;405
10428;28;5737880;10428;587;11922;12326;4.64;0.28;387.03;18.22;1494;53;4242.00;404
10434;28;5737899;10434;585;11926;12326;4.62;0.28;387.19;18.49;1492;54;4243.00;400
10435;28;5737931;10435;585;11926;12326;4.65;0.28;387.20;18.49;1491;55;4244.00;400
10439;28;5737955;10439;577;11926;12326;4.64;0.28;387.25;18.49;1487;55;4245.00;400
10443;28;5737976;10443;583;11927;12326;4.61;0.28;387.34;18.49;1484;55;4246.00;399
10447;28;5737996;10447;582;11927;12326;4.58;0.28;387.46;18.49;1480;55;4247.00;399
10450;28;5738015;10450;601;11964;12396;4.65;0.28;387.55;18.44;1514;55;4248.00;432
10452;28;5738040;10452;598;11966;12397;4.65;0.28;387.57;18.43;1514;55;4249.00;431
10456;28;5738057;10456;600;11972;12397;4.66;0.28;387.60;18.43;1516;55;4250.00;425
10459;28;5738074;10459;605;11973;12397;4.65;0.28;387.63;18.43;1514;55;4251.00;424
10460;28;5738091;10460;606;11976;12397;4.64;0.28;387.61;18.43;1516;55;4252.00;421
10463;28;5738108;10463;607;11978;12397;4.64;0.28;387.60;18.43;1515;55;4253.00;419
10465;28;5738125;10465;605;11980;12397;4.66;0.28;387.68;18.43;1515;55;4254.00;417
10466;28;5738144;10466;611;11982;12397;4.68;0.29;387.69;18.43;1516;55;4255.00;415
10469;28;5738165;10469;610;11984;12398;4.65;0.28;387.69;18.42;1515;55;4256.00;414
10472;28;5738190;10472;615;11985;12399;4.66;0.28;387.72;18.42;1513;55;4257.00;414
10473;28;5738206;10473;610;11987;12399;4.64;0.28;387.73;18.42;1514;55;4258.00;412
10476;28;5738223;10476;622;11991;12403;4.62;0.28;387.92;18.42;1515;55;4259.00;412
10477;28;5738246;10477;627;11992;12403;4.56;0.28;387.91;18.42;1515;55;4260.00;411
10478;28;5738263;10478;628;11992;12403;4.49;0.28;387.87;18.42;1514;55;4261.00;411
10481;28;5738279;10481;634;11992;12403;4.43;0.27;388.02;18.42;1511;55;4262.00;411
10483;28;5738297;10483;633;11996;12409;4.46;0.27;388.07;18.41;1513;55;4263.00;413
10485;28;5738315;10485;637;11996;12409;4.45;0.27;388.17;18.41;1511;55;4264.00;413
10486;28;5738332;10486;647;11996;12409;4.47;0.27;388.18;18.41;1510;55;4265.00;413
10488;28;5738348;10488;640;11997;12412;4.49;0.28;388.38;18.41;1509;55;4266.00;415
10492;28;5738366;10492;640;11997;12412;4.45;0.27;388.42;18.41;1505;55;4267.00;415
10493;28;5738381;10493;645;11997;12412;4.39;0.27;388.39;18.41;1504;55;4268.00;415
10494;28;5738397;10494;645;11997;12413;4.32;0.27;388.42;18.41;1503;55;4269.00;416
10498;28;5738412;10498;645;11998;12414;4.23;0.26;388.38;18.41;1500;55;4270.00;416
10501;28;5738427;10501;653;11998;12414;4.19;0.26;388.40;18.41;1497;55;4271.00;416
10505;28;5738442;10505;658;12008;12427;4.14;0.25;388.52;18.39;1503;55;4272.00;419
10509;28;5738459;10509;664;12008;12427;4.14;0.25;388.47;18.39;1499;55;4273.00;419
10512;28;5738475;10512;664;12008;12427;4.12;0.25;388.51;18.39;1496;55;4274.00;419
10514;28;5738491;10514;653;12009;12429;4.09;0.25;388.60;18.39;1495;55;4275.00;420
10519;28;5738507;10519;651;12009;12429;4.06;0.25;388.49;18.39;1490;55;4276.00;420
10523;28;5738524;10523;646;12012;12433;4.04;0.25;388.64;18.39;1489;55;4277.00;421
10527;28;5738542;10527;649;12012;12433;3.99;0.24;388.62;18.39;1485;55;4278.00;421
10531;28;5738557;10531;645;12014;12437;3.97;0.24;388.66;18.38;1483;55;4279.00;423
10533;28;5738575;10533;644;12015;12437;3.97;0.24;388.73;18.38;1482;55;4280.00;422
10535;28;5738590;10535;644;12015;12437;3.94;0.24;388.86;18.38;1480;55;4281.00;422
10536;28;5738606;10536;650;12015;12437;3.92;0.24;388.86;18.38;1479;55;4282.00;422
10538;28;5738621;10538;651;12015;12437;3.90;0.24;388.92;18.38;1477;55;4283.00;422
10540;28;5738637;10540;653;12024;12449;3.94;0.24;388.93;18.37;1484;55;4284.00;425
10542;28;5738655;10542;658;12024;12449;3.90;0.24;388.92;18.37;1482;55;4285.00;425
10543;28;5738671;10543;664;12024;12449;3.83;0.24;389.05;18.37;1481;55;4286.00;425
10549;28;5738690;10549;666;12024;12449;3.75;0.23;389.08;18.37;1475;55;4287.00;425
10554;28;5738706;10554;681;12024;12449;3.65;0.22;389.23;18.37;1470;55;4288.00;425
10558;28;5738724;10558;686;12024;12449;3.56;0.22;389.26;18.37;1466;55;4289.00;425
10561;28;5738747;10561;673;12024;12450;3.47;0.21;389.29;18.37;1463;55;4290.00;426
10567;28;5738765;10567;668;12024;12450;3.37;0.21;389.32;18.37;1457;55;4291.00;426
10570;28;5738781;10570;664;12028;12456;3.35;0.21;389.28;18.36;1458;55;4292.00;428
10571;28;5738797;10571;666;12028;12457;3.31;0.20;389.29;18.36;1457;55;4293.00;429
10574;28;5738811;10574;663;12028;12457;3.29;0.20;389.35;18.36;1454;55;4294.00;429
10578;28;5738826;10578;662;12028;12457;3.27;0.20;389.39;18.36;1450;55;4295.00;429
10583;28;5738841;10583;666;12031;12461;3.26;0.20;389.35;18.36;1448;55;4296.00;430
10587;28;5738857;10587;662;12031;12461;3.26;0.20;389.37;18.36;1444;55;4297.00;430
10590;28;5738876;10590;668;12031;12461;3.30;0.20;389.35;18.36;1441;55;4298.00;430
10594;28;5738897;10594;660;12032;12462;3.28;0.20;389.28;18.36;1438;55;4299.00;430
10597;28;5738914;10597;663;12034;12466;3.27;0.20;389.25;18.35;1437;55;4300.00;432
10598;28;5738933;10598;654;12035;12466;3.25;0.20;389.31;18.35;1437;55;4301.00;431
10601;28;5738948;10601;648;12036;12469;3.23;0.20;389.28;18.35;1435;55;4302.00;433
10604;28;5738963;10604;654;12036;12469;3.19;0.19;389.23;18.35;1432;55;4303.00;433
10606;28;5738981;10606;658;12036;12469;3.20;0.19;389.19;18.35;1430;55;4304.00;433
10608;28;5738998;10608;658;12036;12469;3.19;0.19;389.17;18.35;1428;55;4305.00;433
10610;28;5739014;10610;656;12039;12473;3.22;0.20;389.13;18.35;1429;55;4306.00;434
10612;28;5739033;10612;663;12039;12473;3.22;0.20;389.07;18.35;1427;55;4307.00;434
10616;28;5739051;10616;667;12039;12473;3.23;0.20;389.01;18.35;1423;55;4308.00;434
10618;28;5739067;10618;670;12039;12473;3.24;0.20;388.95;18.35;1421;55;4309.00;434
10621;28;5739083;10621;665;12039;12474;3.24;0.20;388.95;18.35;1418;55;4310.00;435
10625;28;5739098;10625;665;12039;12475;3.22;0.20;389.00;18.35;1414;55;4311.00;436
10626;28;5739114;10626;657;12039;12475;3.22;0.20;388.96;18.35;1413;55;4312.00;436
10633;28;5739129;10633;657;12040;12476;3.19;0.19;388.89;18.34;1407;55;4313.00;436
10637;28;5739144;10637;649;12040;12476;3.20;0.19;388.94;18.34;1403;55;4314.00;436
10640;28;5739159;10640;650;12040;12476;3.19;0.19;388.91;18.34;1400;55;4315.00;436
10645;28;5739174;10645;650;12040;12476;3.16;0.19;388.92;18.34;1395;55;4316.00;436
10649;28;5739193;10649;649;12040;12476;3.14;0.19;388.88;18.34;1391;55;4317.00;436
10652;28;5739210;10652;644;12040;12476;3.16;0.19;388.92;18.34;1388;55;4318.00;436
10653;28;5739225;10653;651;12040;12476;3.19;0.19;388.93;18.34;1387;55;4319.00;436
10658;28;5739240;10658;670;12143;12706;3.54;0.22;388.96;18.19;1485;55;4320.00;563
10658;28;5739277;10658;657;12148;12707;3.57;0.23;388.96;18.18;1490;55;4321.00;559
10663;28;5739295;10663;647;12155;12707;3.63;0.23;389.02;18.17;1492;55;4322.00;552
10665;28;5739313;10665;643;12166;12707;3.70;0.23;389.00;18.16;1501;55;4323.00;541
10667;28;5739328;10667;634;12169;12707;3.74;0.24;388.98;18.16;1502;55;4324.00;538
10668;28;5739342;10668;641;12175;12707;3.77;0.24;388.99;18.15;1507;55;4325.00;532
10671;28;5739357;10671;643;12179;12707;3.75;0.23;389.00;18.15;1508;55;4326.00;528
10673;28;5739377;10673;641;12182;12707;3.75;0.23;389.03;18.14;1509;55;4327.00;525
10674;28;5739392;10674;644;12187;12708;3.76;0.23;389.04;18.14;1513;55;4328.00;521
10678;28;5739411;10678;653;12192;12709;3.68;0.23;389.09;18.13;1514;55;4329.00;517
10679;28;5739433;10679;643;12197;12709;3.66;0.23;389.14;18.13;1518;55;4330.00;512
10682;28;5739452;10682;637;12201;12710;3.62;0.23;389.12;18.13;1519;55;4331.00;509
10685;28;5739469;10685;631;12202;12710;3.59;0.22;389.16;18.25;1517;55;4332.00;508
10685;28;5739487;10685;636;12206;12710;3.60;0.22;389.16;18.26;1521;55;4333.00;504
10687;28;5739502;10687;628;12208;12710;3.58;0.22;389.18;18.27;1521;55;4334.00;502
10688;28;5739517;10688;629;12211;12714;3.59;0.22;389.16;18.27;1523;55;4335.00;503
10689;28;5739534;10689;626;12212;12714;3.62;0.22;389.16;18.27;1523;55;4336.00;502
10691;28;5739555;10691;615;12213;12714;3.66;0.23;389.16;18.26;1522;55;4337.00;501
10692;28;5739570;10692;608;12217;12717;3.70;0.23;389.16;18.29;1525;55;4338.00;500
10693;28;5739587;10693;612;12217;12717;3.68;0.23;389.12;18.29;1524;55;4339.00;500
10695;28;5739602;10695;604;12218;12717;3.70;0.23;389.18;18.30;1523;55;4340.00;499
10697;28;5739618;10697;607;12221;12721;3.73;0.23;389.16;18.30;1524;55;4341.00;500
10702;28;5739639;10702;608;12223;12722;3.73;0.23;389.38;18.29;1521;55;4342.00;499
10705;28;5739656;10705;607;12224;12722;3.75;0.23;389.43;18.31;1519;55;4343.00;498
10707;28;5739671;10707;612;12227;12726;3.75;0.23;389.40;18.30;1520;55;4344.00;499
10708;28;5739688;10708;609;12230;12726;3.75;0.23;389.48;18.33;1522;55;4345.00;496
10710;28;5739703;10710;602;12231;12726;3.75;0.23;389.46;18.34;1521;55;4346.00;495
10714;28;5739719;10714;602;12231;12727;3.74;0.23;389.52;18.34;1517;55;4347.00;496
10715;28;5739745;10715;591;12232;12727;3.73;0.23;389.51;18.35;1517;55;4348.00;495
10717;28;5739767;10717;594;12236;12733;3.71;0.23;389.55;18.46;1519;55;4349.00;497
10723;28;5739786;10723;591;12237;12733;3.67;0.22;389.46;18.47;1514;55;4350.00;496
10725;28;5739805;10725;586;12238;12734;3.68;0.22;389.56;18.49;1513;55;4351.00;496
10726;28;5739823;10726;586;12238;12734;3.73;0.23;389.54;18.49;1512;55;4352.00;496
10727;28;5739845;10727;585;12240;12734;3.74;0.23;389.54;18.51;1513;55;4353.00;494
10728;28;5739862;10728;588;12240;12734;3.78;0.23;389.54;18.51;1512;55;4354.00;494
10729;28;5739878;10729;584;12240;12734;3.79;0.23;389.52;18.51;1511;55;4355.00;494
10733;28;5739894;10733;580;12248;12746;3.84;0.23;389.60;18.50;1515;55;4356.00;498
10736;28;5739912;10736;570;12250;12746;3.88;0.24;389.64;18.51;1514;55;4357.00;496
10739;28;5739928;10739;564;12251;12746;3.95;0.24;389.66;18.51;1512;55;4358.00;495
10742;28;5739947;10742;559;12252;12746;4.01;0.24;389.69;18.52;1510;55;4359.00;494
10744;28;5739964;10744;546;12252;12746;4.09;0.25;389.65;18.52;1508;55;4360.00;494
10748;28;5739980;10748;540;12253;12746;4.13;0.25;389.87;18.63;1505;55;4361.00;493
10754;28;5739997;10754;536;12257;12750;4.12;0.25;389.96;18.64;1503;55;4362.00;493
10754;28;5740014;10754;532;12257;12750;4.16;0.25;389.96;18.64;1503;55;4363.00;493
10757;28;5740031;10757;527;12261;12754;4.22;0.26;389.99;18.65;1504;55;4364.00;493
10758;28;5740048;10758;521;12262;12756;4.26;0.26;389.97;18.65;1504;55;4365.00;494
10760;28;5740066;10760;522;12262;12756;4.31;0.26;390.11;18.65;1502;55;4366.00;494
10763;28;5740087;10763;523;12264;12756;4.34;0.26;390.24;18.66;1501;55;4367.00;492
10764;28;5740108;10764;523;12272;12769;4.38;0.26;390.27;18.65;1508;55;4368.00;497
10766;28;5740127;10766;530;12274;12769;4.40;0.27;390.30;18.67;1508;55;4369.00;495
10767;28;5740160;10767;537;12274;12769;4.44;0.27;390.34;18.67;1507;55;4370.00;495
10767;28;5740182;10767;540;12275;12770;4.51;0.27;390.34;18.67;1508;55;4371.00;495
10769;28;5740206;10769;537;12276;12771;4.52;0.27;390.46;18.68;1507;55;4372.00;495
10772;28;5740232;10772;538;12276;12771;4.52;0.27;390.62;18.68;1504;55;4373.00;495
10772;28;5740255;10772;539;12279;12774;4.55;0.28;390.62;18.80;1507;55;4374.00;495
10775;28;5740275;10775;548;12280;12774;4.54;0.28;390.83;18.81;1505;55;4375.00;494
10778;28;5740292;10778;554;12281;12774;4.50;0.27;390.96;18.82;1503;55;4376.00;493
10781;28;5740308;10781;564;12281;12774;4.49;0.27;391.04;18.82;1500;55;4377.00;493
10784;28;5740331;10784;568;12286;12780;4.48;0.27;391.12;18.83;1502;55;4378.00;494
10785;28;5740349;10785;569;12287;12780;4.45;0.27;391.10;18.84;1502;55;4379.00;493
10787;28;5740369;10787;565;12287;12780;4.45;0.27;391.26;18.84;1500;55;4380.00;493
10788;28;5740386;10788;568;12287;12780;4.42;0.27;391.32;18.84;1499;55;4381.00;493
10790;28;5740406;10790;563;12292;12784;4.39;0.27;391.34;18.85;1502;55;4382.00;492
10794;28;5740424;10794;563;12292;12785;4.36;0.26;391.50;18.85;1498;55;4383.00;493
10797;28;5740443;10797;560;12292;12785;4.36;0.26;391.53;18.85;1495;55;4384.00;493
10799;28;5740468;10799;563;12294;12786;4.39;0.27;391.54;18.86;1495;55;4385.00;492
10801;28;5740488;10801;556;12295;12786;4.43;0.27;391.57;18.87;1494;55;4386.00;491
10804;28;5740504;10804;545;12295;12786;4.45;0.27;391.65;18.87;1491;55;4387.00;491
10808;28;5740520;10808;542;12297;12786;4.51;0.27;391.81;18.99;1489;55;4388.00;489
10810;28;5740537;10810;541;12299;12786;4.52;0.27;391.87;19.01;1489;55;4389.00;487
10814;28;5740554;10814;531;12299;12786;4.52;0.27;391.92;19.01;1485;55;4390.00;487
10819;28;5740573;10819;527;12300;12786;4.51;0.27;392.04;19.02;1481;55;4391.00;486
10824;28;5740596;10824;531;12333;12856;4.51;0.28;392.23;18.97;1509;55;4392.00;523
10825;28;5740620;10825;525;12334;12857;4.55;0.28;392.21;18.98;1509;55;4393.00;523
10830;28;5740639;10830;517;12339;12857;4.52;0.28;392.30;18.97;1509;55;4394.00;518
10834;28;5740655;10834;519;12342;12857;4.55;0.28;392.34;18.97;1508;55;4395.00;515
10838;28;5740674;10838;515;12344;12857;4.60;0.28;392.31;18.98;1506;55;4396.00;513
10840;28;5740692;10840;517;12346;12857;4.61;0.28;392.34;18.99;1506;55;4397.00;511
10844;28;5740713;10844;515;12348;12857;4.64;0.28;392.48;18.99;1504;55;4398.00;509
10847;28;5740733;10847;521;12351;12857;4.65;0.28;392.57;18.99;1504;55;4399.00;506
10850;28;5740755;10850;519;12352;12858;4.68;0.29;392.56;18.99;1502;55;4400.00;506
10851;28;5740776;10851;523;12355;12859;4.69;0.29;392.55;19.10;1504;55;4401.00;504
10855;28;5740805;10855;519;12361;12859;4.69;0.29;392.60;19.12;1506;55;4402.00;498
10859;28;5740822;10859;518;12364;12863;4.65;0.28;392.73;19.13;1505;55;4403.00;499
10861;28;5740839;10861;523;12364;12863;4.63;0.28;392.72;19.13;1503;55;4404.00;499
10862;28;5740856;10862;527;12365;12863;4.61;0.28;392.73;19.13;1503;55;4405.00;498
10865;28;5740875;10865;532;12366;12863;4.56;0.28;392.78;19.14;1501;55;4406.00;497
10867;28;5740895;10867;540;12371;12869;4.53;0.28;392.77;19.15;1504;55;4407.00;498
10868;28;5740913;10868;543;12372;12869;4.54;0.28;392.81;19.14;1504;55;4408.00;497
10869;28;5740929;10869;553;12372;12869;4.55;0.28;392.79;19.14;1503;55;4409.00;497
10872;28;5740948;10872;556;12376;12875;4.57;0.28;392.83;19.15;1504;55;4410.00;499
10874;28;5740965;10874;568;12377;12875;4.59;0.28;392.90;19.14;1503;55;4411.00;498
10878;28;5740983;10878;570;12379;12875;4.55;0.28;393.21;19.15;1501;55;4412.00;496
10880;28;5741000;10880;577;12379;12876;4.57;0.28;393.31;19.15;1499;55;4413.00;497
10882;28;5741017;10882;586;12381;12877;4.56;0.28;393.31;19.15;1499;55;4414.00;496
10885;28;5741034;10885;591;12381;12877;4.50;0.28;393.40;19.15;1496;55;4415.00;496
10891;28;5741050;10891;595;12388;12890;4.47;0.27;393.54;19.14;1497;55;4416.00;502
10893;28;5741068;10893;599;12391;12890;4.44;0.27;393.52;19.15;1498;55;4417.00;499
10896;28;5741085;10896;612;12391;12890;4.38;0.27;393.48;19.15;1495;55;4418.00;499
10901;28;5741100;10901;609;12392;12891;4.36;0.26;393.52;19.16;1491;55;4419.00;499
10903;28;5741117;10903;608;12393;12891;4.33;0.26;393.60;19.16;1490;55;4420.00;498
10907;28;5741136;10907;619;12396;12895;4.30;0.26;393.63;19.16;1489;55;4421.00;499
10908;28;5741157;10908;615;12397;12895;4.31;0.26;393.69;19.16;1489;55;4422.00;498
10911;28;5741175;10911;611;12399;12899;4.31;0.26;393.85;19.16;1488;55;4423.00;500
10912;28;5741193;10912;617;12400;12899;4.31;0.26;393.86;19.16;1488;55;4424.00;499
10913;28;5741213;10913;621;12401;12899;4.30;0.26;393.96;19.16;1488;55;4425.00;498
10915;28;5741234;10915;620;12402;12899;4.35;0.27;393.93;19.16;1487;55;4426.00;497
10916;28;5741254;10916;624;12403;12899;4.34;0.27;393.91;19.26;1487;56;4427.00;496
10919;28;5741280;10919;626;12414;12911;4.32;0.26;393.97;19.24;1495;56;4428.00;497
10922;28;5741298;10922;632;12414;12911;4.28;0.26;393.96;19.24;1492;57;4429.00;497
10924;28;5741323;10924;634;12415;12911;4.27;0.26;394.04;19.24;1491;57;4430.00;496
10927;28;5741339;10927;636;12415;12911;4.23;0.26;394.21;19.24;1488;57;4431.00;496
10930;28;5741355;10930;642;12415;12911;4.18;0.26;394.31;19.24;1485;57;4432.00;496
10931;28;5741371;10931;644;12415;12911;4.17;0.26;394.28;19.24;1484;57;4433.00;496
10936;28;5741392;10936;650;12415;12912;4.09;0.25;394.30;19.24;1479;57;4434.00;497
10942;28;5741411;10942;655;12415;12912;3.99;0.24;394.26;19.24;1473;57;4435.00;497
10943;28;5741429;10943;661;12419;12918;4.00;0.24;394.25;19.24;1476;57;4436.00;499
10946;28;5741455;10946;663;12419;12919;3.93;0.24;394.30;19.24;1473;57;4437.00;500
10947;28;5741470;10947;666;12419;12919;3.89;0.24;394.36;19.24;1472;57;4438.00;500
10949;28;5741488;10949;666;12419;12919;3.86;0.24;394.37;19.24;1470;57;4439.00;500
10952;28;5741511;10952;680;12423;12924;3.90;0.24;394.37;19.23;1471;57;4440.00;501
10952;28;5741530;10952;675;12423;12924;3.91;0.24;394.37;19.23;1471;57;4441.00;501
10953;28;5741545;10953;681;12423;12924;3.93;0.24;394.37;19.23;1470;57;4442.00;501
10956;28;5741560;10956;680;12424;12925;3.90;0.24;394.43;19.23;1468;57;4443.00;501
10956;28;5741576;10956;687;12427;12929;3.92;0.24;394.43;19.22;1471;57;4444.00;502
10962;28;5741590;10962;689;12427;12929;3.87;0.24;394.44;19.22;1465;57;4445.00;502
10964;28;5741605;10964;689;12428;12932;3.87;0.24;394.40;19.22;1464;57;4446.00;504
10964;28;5741620;10964;686;12428;12932;3.84;0.24;394.40;19.22;1464;57;4447.00;504
10970;28;5741634;10970;686;12428;12932;3.80;0.23;394.44;19.22;1458;57;4448.00;504
10972;28;5741657;10972;689;12428;12932;3.83;0.23;394.46;19.22;1456;57;4449.00;504
10974;28;5741676;10974;703;12431;12936;3.85;0.24;394.50;19.22;1457;57;4450.00;505
10978;28;5741696;10978;692;12431;12936;3.78;0.23;394.60;19.22;1453;57;4451.00;505
10982;28;5741711;10982;698;12431;12936;3.72;0.23;394.57;19.22;1449;57;4452.00;505
10984;28;5741727;10984;694;12431;12936;3.69;0.23;394.53;19.22;1447;57;4453.00;505
10989;28;5741740;10989;700;12431;12937;3.62;0.22;394.53;19.22;1442;57;4454.00;506
10993;28;5741755;10993;688;12432;12939;3.59;0.22;394.46;19.22;1439;57;4455.00;507
10995;28;5741770;10995;685;12432;12939;3.55;0.22;394.49;19.22;1437;57;4456.00;507
11002;28;5741787;11002;686;12433;12940;3.53;0.22;394.36;19.21;1431;57;4457.00;507
11004;28;5741804;11004;688;12433;12940;3.56;0.22;394.34;19.21;1429;57;4458.00;507
11007;28;5741820;11007;685;12433;12940;3.54;0.22;394.38;19.21;1426;57;4459.00;507
11008;28;5741835;11008;684;12433;12940;3.55;0.22;394.40;19.21;1425;57;4460.00;507
11010;28;5741849;11010;698;12433;12940;3.53;0.22;394.44;19.21;1423;57;4461.00;507
11012;28;5741863;11012;691;12433;12940;3.54;0.22;394.42;19.21;1421;57;4462.00;507
11016;28;5741877;11016;696;12433;12940;3.50;0.21;394.41;19.21;1417;57;4463.00;507
11016;28;5741895;11016;702;12495;13067;3.87;0.24;394.41;19.12;1479;57;4464.00;572
11020;28;5741922;11020;690;12497;13068;3.81;0.24;394.38;19.12;1477;57;4465.00;571
11025;28;5741937;11025;689;12504;13068;3.81;0.24;394.34;19.11;1479;57;4466.00;564
11027;28;5741952;11027;685;12508;13068;3.78;0.23;394.36;19.10;1481;57;4467.00;560
11031;28;5741966;11031;681;12512;13068;3.74;0.23;394.33;19.10;1481;57;4468.00;556
11033;28;5741980;11033;683;12513;13068;3.69;0.23;394.29;19.10;1480;57;4469.00;555
11036;28;5741997;11036;679;12516;13068;3.68;0.23;394.21;19.09;1480;57;4470.00;552
11038;28;5742011;11038;675;12517;13068;3.64;0.23;394.18;19.09;1479;57;4471.00;551
11041;28;5742026;11041;668;12519;13069;3.62;0.22;394.15;19.09;1478;57;4472.00;550
11044;28;5742040;11044;674;12521;13070;3.61;0.22;394.11;19.09;1477;57;4473.00;549
11046;28;5742056;11046;681;12523;13070;3.61;0.22;394.10;19.09;1477;57;4474.00;547
11050;28;5742077;11050;689;12525;13071;3.61;0.22;394.06;19.09;1475;57;4475.00;546
11053;28;5742095;11053;693;12527;13071;3.64;0.22;394.08;19.08;1474;57;4476.00;544
11056;28;5742112;11056;673;12529;13071;3.69;0.23;394.17;19.08;1473;57;4477.00;542
11057;28;5742128;11057;660;12530;13071;3.72;0.23;394.17;19.08;1473;57;4478.00;541
11058;28;5742143;11058;649;12533;13075;3.83;0.24;394.18;19.08;1475;57;4479.00;542
11061;28;5742160;11061;639;12533;13075;3.87;0.24;394.19;19.08;1472;57;4480.00;542
11062;28;5742176;11062;632;12533;13075;3.88;0.24;394.17;19.08;1471;57;4481.00;542
11066;28;5742191;11066;635;12535;13078;3.87;0.24;394.12;19.19;1469;57;4482.00;543
11068;28;5742208;11068;632;12535;13078;3.86;0.24;394.15;19.19;1467;57;4483.00;543
11070;28;5742223;11070;630;12535;13078;3.89;0.24;394.11;19.19;1465;57;4484.00;543
11072;28;5742240;11072;627;12538;13082;3.88;0.24;394.13;19.18;1466;57;4485.00;544
11077;28;5742266;11077;631;12539;13083;3.88;0.24;394.07;19.18;1462;57;4486.00;544
11078;28;5742285;11078;627;12539;13083;3.89;0.24;394.08;19.18;1461;57;4487.00;544
11083;28;5742300;11083;625;12542;13087;3.90;0.24;394.15;19.18;1459;57;4488.00;545
11084;28;5742316;11084;623;12542;13087;3.89;0.24;394.16;19.18;1458;57;4489.00;545
11088;28;5742332;11088;625;12542;13087;3.85;0.24;394.16;19.18;1454;57;4490.00;545
11091;28;5742360;11091;614;12543;13088;3.85;0.24;394.18;19.20;1452;57;4491.00;545
11092;28;5742378;11092;614;12543;13088;3.86;0.24;394.19;19.20;1451;57;4492.00;545
11094;28;5742394;11094;620;12547;13094;3.93;0.24;394.16;19.19;1453;57;4493.00;547
11098;28;5742413;11098;623;12547;13094;3.91;0.24;394.24;19.19;1449;57;4494.00;547
11102;28;5742429;11102;614;12548;13095;3.86;0.24;394.28;19.21;1446;57;4495.00;547
11105;28;5742446;11105;612;12548;13095;3.89;0.24;394.28;19.21;1443;57;4496.00;547
11108;28;5742463;11108;624;12548;13095;3.88;0.24;394.38;19.21;1440;57;4497.00;547
11112;28;5742480;11112;618;12549;13095;3.86;0.23;394.38;19.22;1437;57;4498.00;546
11116;28;5742495;11116;629;12549;13095;3.79;0.23;394.38;19.22;1433;57;4499.00;546
11117;28;5742517;11117;635;12574;13145;3.92;0.24;394.38;19.20;1457;57;4500.00;571
11120;28;5742545;11120;636;12574;13147;3.87;0.24;394.44;19.20;1454;57;4501.00;573
11124;28;5742562;11124;634;12580;13147;3.87;0.24;394.51;19.21;1456;57;4502.00;567
11125;28;5742581;11125;628;12581;13147;3.90;0.24;394.53;19.23;1456;57;4503.00;566
11130;28;5742599;11130;628;12583;13147;3.88;0.24;394.47;19.22;1453;57;4504.00;564
11131;28;5742616;11131;621;12584;13147;3.88;0.24;394.51;19.24;1453;57;4505.00;563
11134;28;5742633;11134;621;12590;13151;3.87;0.24;394.56;19.26;1456;57;4506.00;561
11136;28;5742649;11136;617;12591;13151;3.86;0.24;394.64;19.26;1455;57;4507.00;560
11137;28;5742665;11137;620;12593;13155;3.87;0.24;394.67;19.26;1456;57;4508.00;562
11140;28;5742681;11140;624;12595;13156;3.88;0.24;394.74;19.29;1455;57;4509.00;561
11141;28;5742697;11141;620;12595;13156;3.91;0.24;394.77;19.29;1454;57;4510.00;561
11146;28;5742712;11146;609;12596;13156;3.91;0.24;394.81;19.30;1450;57;4511.00;560
11148;28;5742733;11148;585;12607;13169;3.95;0.24;394.90;19.30;1459;57;4512.00;562
11149;28;5742754;11149;582;12608;13169;3.95;0.24;395.01;19.30;1459;57;4513.00;561
11151;28;5742771;11151;574;12608;13169;4.01;0.25;395.09;19.30;1457;57;4514.00;561
11153;28;5742787;11153;566;12610;13170;4.07;0.25;395.07;19.32;1457;57;4515.00;560
11154;28;5742804;11154;561;12611;13171;4.13;0.25;395.14;19.33;1457;57;4516.00;560
11156;28;5742820;11156;560;12612;13171;4.17;0.26;395.11;19.33;1456;57;4517.00;559
11159;28;5742836;11159;550;12614;13174;4.19;0.26;395.31;19.33;1455;57;4518.00;560
11160;28;5742853;11160;550;12614;13174;4.21;0.26;395.41;19.33;1454;57;4519.00;560
11161;28;5742871;11161;552;12615;13174;4.24;0.26;395.48;19.34;1454;57;4520.00;559
11162;28;5742895;11162;545;12615;13174;4.21;0.26;395.57;19.34;1453;57;4521.00;559
11165;28;5742915;11165;538;12620;13180;4.20;0.26;395.68;19.37;1455;57;4522.00;560
11169;28;5742932;11169;542;12622;13180;4.21;0.26;395.62;19.38;1453;57;4523.00;558
11174;28;5742950;11174;536;12623;13180;4.17;0.25;395.89;19.38;1449;57;4524.00;557
11176;28;5742967;11176;537;12623;13180;4.17;0.25;396.00;19.38;1447;57;4525.00;557
11177;28;5742983;11177;528;12628;13184;4.18;0.26;396.11;19.41;1451;57;4526.00;556
11180;28;5743000;11180;527;12629;13185;4.16;0.25;396.12;19.42;1449;57;4527.00;556
11185;28;5743020;11185;525;12629;13185;4.18;0.25;396.21;19.42;1444;57;4528.00;556
11189;28;5743041;11189;540;12633;13186;4.18;0.25;396.24;19.45;1444;57;4529.00;553
11190;28;5743061;11190;531;12634;13186;4.23;0.26;396.32;19.45;1444;57;4530.00;552
11194;28;5743077;11194;529;12634;13186;4.24;0.26;396.35;19.45;1440;57;4531.00;552
11197;28;5743093;11197;537;12636;13186;4.29;0.26;396.40;19.58;1439;57;4532.00;550
11199;28;5743109;11199;540;12637;13186;4.34;0.26;396.42;19.59;1438;57;4533.00;549
11199;28;5743126;11199;536;12639;13186;4.42;0.27;396.42;19.61;1440;57;4534.00;547
11200;28;5743142;11200;542;12640;13186;4.45;0.27;396.42;19.63;1440;57;4535.00;546
11202;28;5743158;11202;553;12675;13256;4.48;0.27;396.46;19.58;1473;57;4536.00;581
11206;28;5743181;11206;550;12677;13257;4.51;0.27;396.50;19.59;1471;57;4537.00;580
11207;28;5743201;11207;540;12678;13257;4.55;0.28;396.58;19.59;1471;57;4538.00;579
11210;28;5743223;11210;547;12680;13257;4.56;0.28;396.59;19.60;1470;57;4539.00;577
11211;28;5743243;11211;541;12682;13257;4.60;0.28;396.64;19.62;1471;57;4540.00;575
11211;28;5743260;11211;544;12682;13257;4.62;0.28;396.64;19.62;1471;57;4541.00;575
11214;28;5743277;11214;553;12688;13257;4.64;0.28;396.76;19.63;1474;57;4542.00;569
11215;28;5743294;11215;556;12690;13257;4.64;0.28;396.78;19.65;1475;57;4543.00;567
11218;28;5743313;11218;550;12695;13258;4.63;0.28;396.82;19.68;1477;57;4544.00;563
11220;28;5743335;11220;551;12700;13260;4.63;0.28;396.85;19.69;1480;57;4545.00;560
11223;28;5743352;11223;548;12702;13260;4.61;0.28;396.94;19.71;1479;57;4546.00;558
11225;28;5743370;11225;543;12710;13264;4.62;0.28;397.04;20.01;1485;58;4547.00;554
11227;28;5743395;11227;543;12713;13264;4.63;0.28;397.12;20.04;1486;58;4548.00;551
11232;28;5743413;11232;539;12714;13264;4.63;0.28;397.26;20.04;1482;58;4549.00;550
11234;28;5743430;11234;529;12714;13264;4.64;0.28;397.26;20.04;1480;58;4550.00;550
11236;28;5743447;11236;526;12719;13270;4.68;0.29;397.27;20.06;1483;58;4551.00;551
11241;28;5743465;11241;525;12719;13270;4.72;0.29;397.37;20.06;1478;58;4552.00;551
11244;28;5743483;11244;519;12719;13270;4.78;0.29;397.45;20.06;1475;58;4553.00;551
11248;28;5743505;11248;524;12723;13273;4.84;0.30;397.54;20.10;1475;58;4554.00;550
11251;28;5743527;11251;524;12726;13273;4.83;0.29;397.52;20.12;1475;58;4555.00;547
11253;28;5743548;11253;524;12726;13273;4.85;0.30;397.49;20.12;1473;58;4556.00;547
11255;28;5743565;11255;524;12729;13274;4.86;0.30;397.53;20.27;1474;58;4557.00;545
11257;28;5743582;11257;526;12730;13275;4.86;0.30;397.48;20.26;1473;58;4558.00;545
11263;28;5743599;11263;519;12731;13275;4.78;0.29;397.61;20.38;1468;58;4559.00;544
11263;28;5743617;11263;527;12748;13301;4.83;0.29;397.61;20.36;1485;58;4560.00;553
11268;28;5743636;11268;525;12748;13301;4.80;0.29;397.56;20.36;1480;58;4561.00;553
11270;28;5743653;11270;522;12750;13301;4.77;0.29;397.55;20.47;1480;58;4562.00;551
11277;28;5743671;11277;527;12751;13302;4.71;0.29;397.63;20.49;1474;58;4563.00;551
11280;28;5743689;11280;533;12753;13302;4.62;0.28;397.64;20.50;1473;58;4564.00;549
11283;28;5743709;11283;537;12755;13306;4.57;0.28;397.61;20.50;1472;58;4565.00;551
11286;28;5743731;11286;538;12755;13306;4.51;0.27;397.73;20.50;1469;58;4566.00;551
11288;28;5743749;11288;541;12759;13310;4.48;0.27;397.80;20.49;1471;58;4567.00;551
11289;28;5743766;11289;548;12759;13310;4.46;0.27;397.84;20.49;1470;58;4568.00;551
11290;28;5743782;11290;556;12759;13310;4.46;0.27;397.86;20.49;1469;58;4569.00;551
11293;28;5743797;11293;559;12760;13310;4.42;0.27;397.98;20.49;1467;58;4570.00;550
11295;28;5743813;11295;562;12762;13310;4.38;0.27;398.04;20.49;1467;58;4571.00;548
11297;29;5743828;11297;563;12771;13322;4.41;0.27;398.04;20.48;1474;59;4572.00;551
11299;29;5743856;11299;568;12773;13322;4.40;0.27;398.05;20.48;1474;59;4573.00;549
11301;29;5743876;11301;570;12775;13322;4.39;0.27;398.03;20.48;1474;59;4574.00;547
11304;29;5743893;11304;572;12775;13322;4.40;0.27;398.13;20.48;1471;59;4575.00;547
11305;29;5743910;11305;573;12775;13322;4.39;0.27;398.12;20.48;1470;59;4576.00;547
11308;29;5743928;11308;582;12775;13322;4.38;0.27;398.24;20.48;1467;59;4577.00;547
11312;29;5743945;11312;586;12775;13323;4.38;0.27;398.23;20.48;1463;59;4578.00;548
11316;29;5743961;11316;599;12775;13323;4.31;0.26;398.31;20.48;1459;59;4579.00;548
11322;29;5743977;11322;606;12779;13329;4.28;0.26;398.33;20.47;1457;59;4580.00;550
11325;29;5743993;11325;614;12779;13330;4.26;0.26;398.29;20.47;1454;59;4581.00;551
11328;29;5744009;11328;620;12779;13330;4.19;0.26;398.39;20.47;1451;59;4582.00;551
11332;29;5744024;11332;624;12779;13330;4.11;0.25;398.44;20.47;1447;59;4583.00;551
11334;29;5744039;11334;635;12782;13334;4.14;0.25;398.41;20.47;1448;59;4584.00;552
11337;29;5744056;11337;631;12782;13334;4.12;0.25;398.43;20.47;1445;59;4585.00;552
11340;29;5744072;11340;626;12782;13334;4.10;0.25;398.52;20.47;1442;59;4586.00;552
11342;29;5744090;11342;640;12783;13335;4.11;0.25;398.57;20.46;1441;59;4587.00;552
11345;29;5744106;11345;642;12786;13339;4.11;0.25;398.60;20.46;1441;59;4588.00;553
11347;29;5744121;11347;651;12786;13339;4.08;0.25;398.64;20.46;1439;59;4589.00;553
11349;29;5744138;11349;652;12790;13345;4.03;0.25;398.62;20.45;1441;59;4590.00;555
11354;29;5744154;11354;661;12790;13345;3.96;0.24;398.55;20.45;1436;59;4591.00;555
11355;29;5744169;11355;664;12790;13345;3.91;0.24;398.60;20.45;1435;59;4592.00;555
11356;29;5744185;11356;670;12790;13345;3.89;0.24;398.57;20.45;1434;59;4593.00;555
11358;29;5744200;11358;672;12793;13349;3.88;0.24;398.54;20.45;1435;59;4594.00;556
11358;29;5744215;11358;669;12793;13349;3.88;0.24;398.54;20.45;1435;59;4595.00;556
11360;29;5744233;11360;675;12793;13349;3.85;0.24;398.50;20.45;1433;59;4596.00;556
11360;29;5744250;11360;676;12793;13349;3.80;0.23;398.50;20.45;1433;59;4597.00;556
11361;29;5744265;11361;672;12793;13350;3.75;0.23;398.47;20.45;1432;59;4598.00;557
11362;29;5744279;11362;678;12793;13351;3.69;0.23;398.47;20.45;1431;59;4599.00;558
11365;29;5744300;11365;682;12793;13351;3.60;0.22;398.47;20.45;1428;59;4600.00;558
11366;29;5744319;11366;679;12794;13352;3.59;0.22;398.47;20.45;1428;59;4601.00;558
11367;29;5744332;11367;681;12794;13352;3.55;0.22;398.45;20.45;1427;59;4602.00;558
11369;29;5744345;11369;688;12794;13352;3.51;0.21;398.42;20.45;1425;59;4603.00;558
11370;29;5744358;11370;682;12794;13352;3.45;0.21;398.41;20.45;1424;59;4604.00;558
11372;29;5744372;11372;678;12794;13352;3.43;0.21;398.37;20.45;1422;59;4605.00;558
11373;29;5744394;11373;678;12794;13352;3.41;0.21;398.35;20.45;1421;59;4606.00;558
11374;29;5744409;11374;681;12794;13352;3.40;0.21;398.32;20.45;1420;59;4607.00;558
11376;29;5744423;11376;700;12854;13479;3.68;0.23;398.31;20.35;1478;59;4608.00;625
11378;29;5744445;11378;692;12856;13480;3.68;0.23;398.25;20.35;1478;59;4609.00;624
11379;29;5744460;11379;690;12862;13480;3.71;0.23;398.22;20.34;1483;59;4610.00;618
11381;29;5744477;11381;693;12865;13480;3.71;0.23;398.19;20.34;1484;59;4611.00;615
11384;29;5744494;11384;693;12869;13480;3.70;0.23;398.14;20.33;1485;59;4612.00;611
11384;29;5744509;11384;694;12873;13480;3.68;0.23;398.14;20.33;1489;59;4613.00;607
11386;29;5744523;11386;696;12873;13480;3.67;0.23;398.13;20.33;1487;59;4614.00;607
11386;29;5744538;11386;693;12875;13480;3.69;0.23;398.13;20.32;1489;59;4615.00;605
11386;29;5744552;11386;694;12875;13481;3.68;0.23;398.13;20.32;1489;59;4616.00;606
11390;29;5744565;11390;697;12877;13482;3.62;0.22;398.08;20.32;1487;59;4617.00;605
11392;29;5744579;11392;696;12879;13482;3.54;0.22;398.09;20.32;1487;59;4618.00;603
11394;29;5744593;11394;700;12881;13483;3.45;0.21;398.06;20.32;1487;59;4619.00;602
11400;29;5744613;11400;694;12884;13483;3.33;0.20;397.96;20.32;1484;59;4620.00;599
11404;29;5744627;11404;693;12886;13483;3.26;0.20;397.91;20.32;1482;59;4621.00;597
11405;29;5744642;11405;693;12887;13483;3.20;0.20;397.92;20.32;1482;59;4622.00;596
11411;29;5744660;11411;708;12890;13487;3.13;0.19;397.92;20.31;1479;59;4623.00;597
11411;29;5744676;11411;691;12891;13487;3.12;0.19;397.92;20.31;1480;59;4624.00;596
11413;29;5744691;11413;685;12891;13487;3.12;0.19;397.93;20.31;1478;59;4625.00;596
11415;29;5744705;11415;680;12892;13490;3.14;0.19;397.98;20.31;1477;59;4626.00;598
11418;29;5744721;11418;675;12893;13490;3.17;0.19;397.90;20.31;1475;59;4627.00;597
11420;29;5744735;11420;661;12893;13490;3.18;0.19;397.87;20.31;1473;59;4628.00;597
11421;29;5744750;11421;656;12896;13494;3.23;0.20;397.91;20.31;1475;59;4629.00;598
11425;29;5744771;11425;640;12897;13495;3.24;0.20;397.93;20.30;1472;59;4630.00;598
11426;29;5744788;11426;638;12897;13495;3.28;0.20;397.92;20.30;1471;59;4631.00;598
11427;29;5744803;11427;636;12900;13499;3.38;0.21;397.92;20.30;1473;59;4632.00;599
11429;29;5744823;11429;631;12900;13499;3.43;0.21;397.90;20.30;1471;59;4633.00;599
11431;29;5744838;11431;617;12900;13499;3.50;0.21;397.89;20.30;1469;59;4634.00;599
11434;29;5744859;11434;618;12901;13501;3.58;0.22;397.85;20.30;1467;59;4635.00;600
11439;29;5744875;11439;616;12901;13501;3.61;0.22;397.86;20.30;1462;59;4636.00;600
11440;29;5744891;11440;609;12904;13507;3.70;0.23;397.85;20.29;1464;59;4637.00;603
11445;29;5744908;11445;607;12904;13507;3.72;0.23;397.72;20.29;1459;59;4638.00;603
11446;29;5744927;11446;606;12904;13508;3.79;0.23;397.79;20.29;1458;59;4639.00;604
11450;29;5744944;11450;601;12905;13508;3.80;0.23;397.78;20.29;1455;59;4640.00;603
11453;29;5744960;11453;597;12905;13508;3.81;0.23;397.71;20.29;1452;59;4641.00;603
11454;29;5744976;11454;590;12905;13508;3.83;0.23;397.69;20.29;1451;59;4642.00;603
11457;29;5744991;11457;582;12905;13508;3.86;0.23;397.71;20.29;1448;59;4643.00;603
11459;29;5745007;11459;583;12914;13520;3.92;0.24;397.81;20.28;1455;59;4644.00;606
11461;29;5745024;11461;590;12914;13520;3.91;0.24;397.78;20.28;1453;59;4645.00;606
11466;29;5745040;11466;584;12914;13520;3.89;0.24;397.85;20.28;1448;59;4646.00;606
11470;29;5745055;11470;590;12915;13520;3.86;0.23;397.88;20.28;1445;59;4647.00;605
11472;29;5745071;11472;592;12915;13520;3.88;0.24;397.82;20.28;1443;59;4648.00;605
11478;29;5745086;11478;589;12915;13520;3.84;0.23;397.93;20.28;1437;59;4649.00;605
11481;29;5745103;11481;586;12920;13526;3.84;0.23;397.88;20.27;1439;59;4650.00;606
11485;29;5745119;11485;584;12920;13526;3.83;0.23;397.98;20.27;1435;59;4651.00;606
11489;29;5745133;11489;582;12922;13530;3.83;0.23;398.01;20.27;1433;59;4652.00;608
11492;29;5745155;11492;578;12922;13531;3.86;0.23;398.17;20.27;1430;59;4653.00;609
11496;29;5745172;11496;583;12922;13531;3.83;0.23;398.28;20.27;1426;59;4654.00;609
11500;29;5745188;11500;582;12922;13531;3.78;0.23;398.24;20.27;1422;59;4655.00;609
11503;29;5745204;11503;580;12932;13544;3.79;0.23;398.33;20.25;1429;59;4656.00;612
11507;29;5745221;11507;575;12934;13544;3.78;0.23;398.29;20.29;1427;59;4657.00;610
11511;29;5745236;11511;581;12934;13544;3.78;0.23;398.32;20.29;1423;59;4658.00;610
11513;29;5745252;11513;590;12935;13545;3.77;0.23;398.52;20.29;1422;59;4659.00;610
11516;29;5745267;11516;587;12935;13546;3.76;0.23;398.50;20.29;1419;59;4660.00;611
11518;29;5745287;11518;588;12935;13546;3.77;0.23;398.60;20.29;1417;59;4661.00;611
11521;29;5745304;11521;588;12936;13549;3.80;0.23;398.60;20.29;1415;59;4662.00;613
11524;29;5745320;11524;591;12938;13549;3.82;0.23;398.79;20.33;1414;59;4663.00;611
11530;29;5745336;11530;592;12938;13549;3.82;0.23;398.86;20.33;1408;59;4664.00;611
11531;29;5745350;11531;589;12938;13549;3.83;0.23;398.86;20.33;1407;59;4665.00;611
11534;29;5745365;11534;589;12943;13555;3.82;0.23;398.89;20.36;1409;59;4666.00;612
11537;29;5745380;11537;580;12943;13555;3.80;0.23;398.93;20.36;1406;59;4667.00;612
11540;29;5745398;11540;574;12944;13555;3.82;0.23;398.94;20.48;1404;59;4668.00;611
11542;29;5745415;11542;575;12946;13555;3.82;0.23;399.04;20.52;1404;59;4669.00;609
11542;29;5745434;11542;569;12949;13559;3.84;0.23;399.04;20.51;1407;59;4670.00;610
11548;29;5745450;11548;568;12952;13560;3.82;0.23;399.27;20.55;1404;59;4671.00;608
11553;29;5745467;11553;570;12952;13560;3.79;0.23;399.24;20.55;1399;59;4672.00;608
11557;29;5745482;11557;560;12955;13561;3.78;0.23;399.39;20.57;1398;59;4673.00;606
11560;29;5745501;11560;555;12956;13561;3.80;0.23;399.54;20.59;1396;59;4674.00;605
11565;29;5745517;11565;555;12957;13561;3.80;0.23;399.49;20.61;1392;59;4675.00;604
11566;29;5745533;11566;541;12957;13561;3.84;0.23;399.53;20.61;1391;59;4676.00;604
11567;29;5745548;11567;536;12959;13561;3.89;0.24;399.54;20.65;1392;59;4677.00;602
11570;29;5745564;11570;524;12959;13561;3.90;0.24;399.63;20.65;1389;59;4678.00;602
11573;29;5745580;11573;523;12961;13561;3.91;0.24;399.76;20.67;1388;59;4679.00;600
11574;29;5745597;11574;536;13039;13686;4.13;0.25;399.86;20.57;1465;59;4680.00;647
11578;29;5745621;11578;524;13040;13687;4.16;0.26;399.88;20.58;1462;59;4681.00;647
11581;29;5745638;11581;515;13042;13687;4.23;0.26;399.91;20.58;1461;59;4682.00;645
11584;29;5745656;11584;515;13045;13687;4.31;0.26;400.02;20.62;1461;59;4683.00;642
11586;29;5745672;11586;516;13046;13687;4.36;0.27;400.12;20.73;1460;59;4684.00;641
11588;29;5745688;11588;508;13047;13687;4.42;0.27;400.20;20.75;1459;59;4685.00;640
11590;29;5745704;11590;514;13049;13687;4.45;0.27;400.28;20.75;1459;59;4686.00;638
11592;29;5745721;11592;508;13050;13687;4.48;0.28;400.38;20.76;1458;59;4687.00;637
11596;29;5745737;11596;503;13051;13688;4.47;0.28;400.60;20.78;1455;59;4688.00;637
11599;29;5745755;11599;500;13053;13689;4.48;0.28;400.70;20.78;1454;59;4689.00;636
11602;29;5745771;11602;499;13056;13689;4.45;0.27;400.86;20.80;1454;59;4690.00;633
11606;29;5745788;11606;499;13061;13693;4.46;0.27;400.89;20.81;1455;59;4691.00;632
11608;29;5745808;11608;501;13063;13693;4.48;0.27;400.93;20.82;1455;59;4692.00;630
11609;29;5745825;11609;510;13063;13693;4.49;0.27;400.92;20.82;1454;59;4693.00;630
11609;29;5745847;11609;519;13066;13693;4.54;0.28;400.92;20.86;1457;59;4694.00;627
11614;29;5745863;11614;525;13069;13699;4.56;0.28;401.14;20.85;1455;59;4695.00;630
11616;29;5745880;11616;524;13072;13699;4.58;0.28;401.21;20.88;1456;59;4696.00;627
11619;29;5745897;11619;526;13073;13699;4.61;0.28;401.33;20.99;1454;59;4697.00;626
11619;29;5745914;11619;529;13076;13702;4.65;0.28;401.33;20.99;1457;59;4698.00;626
11626;29;5745930;11626;533;13078;13702;4.63;0.28;401.53;21.02;1452;59;4699.00;624
11628;29;5745947;11628;533;13079;13702;4.64;0.28;401.59;21.02;1451;59;4700.00;623
11630;29;5745968;11630;541;13081;13703;4.64;0.28;401.62;21.06;1451;59;4701.00;622
11633;29;5745984;11633;534;13082;13704;4.62;0.28;401.75;21.06;1449;59;4702.00;622
11635;29;5746004;11635;539;13085;13704;4.61;0.28;401.76;21.18;1450;59;4703.00;619
11636;29;5746023;11636;543;13096;13717;4.62;0.28;401.82;21.18;1460;59;4704.00;621
11638;29;5746040;11638;544;13096;13717;4.63;0.28;401.93;21.18;1458;59;4705.00;621
11642;29;5746056;11642;544;13097;13717;4.58;0.28;402.04;21.20;1455;59;4706.00;620
11642;29;5746072;11642;547;13098;13718;4.58;0.28;402.04;21.22;1456;60;4707.00;620
11643;29;5746093;11643;548;13098;13718;4.53;0.28;402.03;21.22;1455;60;4708.00;620
11645;29;5746109;11645;553;13101;13722;4.50;0.27;402.14;21.21;1456;60;4709.00;621
11648;29;5746127;11648;554;13101;13722;4.44;0.27;402.14;21.21;1453;60;4710.00;621
11649;29;5746143;11649;560;13105;13726;4.39;0.27;402.12;21.22;1456;60;4711.00;621
11651;29;5746159;11651;561;13106;13726;4.35;0.26;402.11;21.24;1455;60;4712.00;620
11655;29;5746179;11655;569;13106;13726;4.34;0.26;402.19;21.24;1451;60;4713.00;620
11656;29;5746199;11656;574;13106;13726;4.35;0.26;402.18;21.24;1450;60;4714.00;620
11657;29;5746219;11657;573;13107;13726;4.35;0.26;402.18;21.26;1450;60;4715.00;619
11661;29;5746240;11661;565;13116;13738;4.41;0.27;402.43;21.24;1455;60;4716.00;622
11666;29;5746262;11666;550;13116;13738;4.37;0.27;402.50;21.24;1450;60;4717.00;622
11668;29;5746285;11668;542;13117;13738;4.42;0.27;402.58;21.26;1449;60;4718.00;621
11672;29;5746310;11672;544;13118;13738;4.40;0.27;402.62;21.37;1446;60;4719.00;620
11672;29;5746341;11672;547;13118;13738;4.39;0.27;402.62;21.37;1446;60;4720.00;620
11673;29;5746374;11673;541;13119;13738;4.39;0.27;402.63;21.39;1446;60;4721.00;619
11674;29;5746405;11674;533;13119;13739;4.43;0.27;402.62;21.39;1445;60;4722.00;620
11678;29;5746432;11678;543;13119;13739;4.41;0.27;402.66;21.39;1441;60;4723.00;620
11681;29;5746462;11681;538;13123;13745;4.43;0.27;402.63;21.38;1442;60;4724.00;622
11683;29;5746493;11683;542;13125;13747;4.44;0.27;402.64;21.40;1442;61;4725.00;622
11688;29;5746516;11688;536;13126;13747;4.39;0.27;402.81;21.42;1438;61;4726.00;621
11693;29;5746537;11693;532;13127;13747;4.34;0.27;402.82;21.44;1434;61;4727.00;620
11698;29;5746560;11698;529;13131;13751;4.32;0.26;402.89;21.45;1433;61;4728.00;620
11701;29;5746588;11701;533;13132;13751;4.24;0.26;402.86;21.47;1431;61;4729.00;619
11706;29;5746610;11706;544;13132;13751;4.14;0.25;403.05;21.47;1426;61;4730.00;619
11708;29;5746634;11708;554;13134;13752;4.09;0.25;403.10;21.49;1426;61;4731.00;618
11713;29;5746655;11713;564;13138;13756;4.05;0.25;403.14;21.50;1425;61;4732.00;618
11716;29;5746677;11716;568;13139;13756;4.03;0.25;403.12;21.52;1423;61;4733.00;617
11718;29;5746695;11718;576;13142;13759;4.01;0.25;403.13;21.65;1424;61;4734.00;617
11720;29;5746713;11720;584;13143;13759;3.99;0.25;403.16;21.66;1423;61;4735.00;616
11721;29;5746731;11721;585;13143;13759;3.96;0.24;403.20;21.66;1422;61;4736.00;616
11723;29;5746750;11723;589;13143;13759;3.90;0.24;403.19;21.66;1420;61;4737.00;616
11725;29;5746769;11725;595;13146;13763;3.87;0.24;403.23;21.66;1421;61;4738.00;617
11727;29;5746785;11727;601;13146;13763;3.83;0.24;403.24;21.66;1419;61;4739.00;617
11729;29;5746804;11729;602;13146;13763;3.75;0.23;403.34;21.66;1417;61;4740.00;617
11735;29;5746823;11735;617;13147;13763;3.71;0.23;403.43;21.68;1412;61;4741.00;616
11737;29;5746840;11737;622;13147;13764;3.68;0.23;403.38;21.68;1410;61;4742.00;617
11742;29;5746856;11742;625;13147;13765;3.62;0.22;403.42;21.68;1405;61;4743.00;618
11747;29;5746874;11747;632;13147;13765;3.52;0.22;403.51;21.68;1400;61;4744.00;618
11747;29;5746891;11747;636;13148;13766;3.52;0.22;403.51;21.67;1401;61;4745.00;618
11748;29;5746906;11748;643;13148;13766;3.50;0.22;403.53;21.67;1400;61;4746.00;618
11753;29;5746922;11753;656;13148;13766;3.45;0.21;403.59;21.67;1395;61;4747.00;618
11755;29;5746939;11755;651;13148;13766;3.43;0.21;403.61;21.67;1393;61;4748.00;618
11758;29;5746956;11758;657;13148;13766;3.40;0.21;403.61;21.67;1390;61;4749.00;618
11760;29;5746972;11760;675;13149;13766;3.35;0.21;403.63;21.79;1389;61;4750.00;617
11761;29;5746987;11761;680;13149;13766;3.32;0.20;403.60;21.79;1388;61;4751.00;617
11764;29;5747002;11764;707;13210;13893;3.58;0.22;403.59;21.69;1446;61;4752.00;683
11765;29;5747028;11765;704;13211;13894;3.55;0.22;403.56;21.69;1446;61;4753.00;683
11769;29;5747045;11769;701;13219;13894;3.54;0.22;403.49;21.79;1450;61;4754.00;675
11769;29;5747061;11769;707;13223;13894;3.50;0.22;403.49;21.78;1454;61;4755.00;671
11771;29;5747077;11771;713;13227;13894;3.48;0.22;403.48;21.78;1456;61;4756.00;667
11771;29;5747093;11771;715;13229;13894;3.43;0.21;403.48;21.78;1458;61;4757.00;665
11771;29;5747109;11771;725;13232;13894;3.40;0.21;403.48;22.00;1461;61;4758.00;662
11771;29;5747124;11771;725;13234;13894;3.39;0.21;403.48;22.00;1463;61;4759.00;660
11773;29;5747146;11773;728;13234;13895;3.35;0.21;403.56;22.00;1461;61;4760.00;661
11773;29;5747165;11773;732;13236;13896;3.39;0.21;403.56;22.00;1463;61;4761.00;660
11776;29;5747181;11776;734;13236;13896;3.37;0.21;403.50;22.00;1460;61;4762.00;660
11778;29;5747197;11778;734;13238;13897;3.38;0.21;403.44;21.99;1460;61;4763.00;659
11778;29;5747214;11778;733;13240;13897;3.35;0.21;403.44;21.99;1462;61;4764.00;657
11779;29;5747239;11779;734;13242;13897;3.35;0.21;403.44;21.99;1463;61;4765.00;655
11781;29;5747266;11781;738;13244;13897;3.30;0.20;403.46;21.99;1463;61;4766.00;653
11784;29;5747292;11784;741;13248;13901;3.28;0.20;403.40;21.99;1464;61;4767.00;653
11784;29;5747315;11784;746;13250;13901;3.26;0.20;403.40;21.99;1466;61;4768.00;651
11786;29;5747337;11786;740;13251;13901;3.23;0.20;403.37;21.98;1465;61;4769.00;650
11788;29;5747359;11788;744;13255;13907;3.19;0.20;403.33;21.98;1467;61;4770.00;652
11788;29;5747383;11788;726;13255;13907;3.23;0.20;403.33;21.98;1467;61;4771.00;652
11789;29;5747405;11789;719;13256;13907;3.25;0.20;403.31;21.98;1467;61;4772.00;651
11789;29;5747428;11789;702;13259;13911;3.32;0.20;403.31;21.97;1470;61;4773.00;652
11791;29;5747449;11791;694;13260;13912;3.36;0.21;403.26;21.97;1469;61;4774.00;652
11791;29;5747473;11791;696;13260;13912;3.43;0.21;403.26;21.97;1469;61;4775.00;652
11794;29;5747500;11794;683;13263;13916;3.43;0.21;403.25;21.97;1469;61;4776.00;653
11795;29;5747522;11795;682;13263;13916;3.44;0.21;403.23;21.97;1468;61;4777.00;653
11796;29;5747544;11796;679;13263;13916;3.45;0.21;403.20;21.97;1467;61;4778.00;653
11796;29;5747562;11796;690;13263;13917;3.46;0.21;403.20;21.97;1467;61;4779.00;654
11796;29;5747580;11796;683;13263;13917;3.49;0.21;403.20;21.97;1467;61;4780.00;654
11801;29;5747603;11801;683;13267;13923;3.51;0.21;403.16;21.96;1466;61;4781.00;656
11804;29;5747624;11804;680;13267;13923;3.49;0.21;403.15;21.96;1463;61;4782.00;656
11805;29;5747653;11805;691;13267;13924;3.47;0.21;403.11;21.96;1462;61;4783.00;657
11808;29;5747673;11808;698;13267;13924;3.44;0.21;403.15;21.96;1459;61;4784.00;657
11812;29;5747697;11812;686;13267;13924;3.41;0.21;403.07;21.96;1455;61;4785.00;657
11813;29;5747714;11813;676;13267;13924;3.42;0.21;403.06;21.96;1454;61;4786.00;657
11820;29;5747732;11820;674;13267;13924;3.41;0.21;403.00;21.96;1447;61;4787.00;657
11821;29;5747749;11821;670;13276;13936;3.43;0.21;402.99;21.94;1455;61;4788.00;660
11824;29;5747769;11824;661;13276;13936;3.46;0.21;402.98;21.94;1452;61;4789.00;660
11827;29;5747791;11827;654;13276;13936;3.49;0.21;403.01;21.94;1449;61;4790.00;660
11828;29;5747813;11828;659;13276;13936;3.50;0.21;402.99;21.94;1448;61;4791.00;660
11830;29;5747840;11830;650;13276;13936;3.53;0.21;402.98;21.94;1446;61;4792.00;660
11834;29;5747863;11834;638;13276;13936;3.52;0.21;403.02;21.94;1442;61;4793.00;660
11838;29;5747884;11838;625;13279;13940;3.54;0.21;403.07;21.94;1441;61;4794.00;661
11839;29;5747910;11839;622;13279;13940;3.59;0.22;403.06;21.94;1440;61;4795.00;661
11841;29;5747930;11841;621;13282;13944;3.62;0.22;403.04;21.93;1441;61;4796.00;662
11842;29;5747952;11842;621;13283;13945;3.66;0.22;403.05;22.05;1441;61;4797.00;662
11846;29;5747983;11846;611;13283;13945;3.68;0.22;403.10;22.05;1437;61;4798.00;662
11847;29;5748001;11847;603;13283;13945;3.73;0.23;403.15;22.05;1436;61;4799.00;662
11850;29;5748023;11850;607;13303;13986;3.78;0.23;403.13;22.02;1453;61;4800.00;683
11850;29;5748052;11850;596;13304;13986;3.86;0.23;403.13;22.02;1454;61;4801.00;682
11853;29;5748073;11853;595;13307;13986;3.91;0.24;403.12;22.01;1454;61;4802.00;679
11859;29;5748097;11859;585;13307;13987;3.94;0.24;403.17;22.01;1448;61;4803.00;680
11860;29;5748116;11860;584;13308;13988;4.00;0.24;403.14;22.01;1448;61;4804.00;680
11865;29;5748136;11865;584;13308;13988;4.03;0.24;403.29;22.01;1443;61;4805.00;680
11871;29;5748157;11871;568;13309;13991;4.03;0.24;403.31;22.01;1438;61;4806.00;682
11873;29;5748176;11873;561;13310;13991;4.06;0.25;403.39;22.01;1437;61;4807.00;681
11877;29;5748194;11877;562;13311;13991;4.05;0.25;403.43;22.01;1434;61;4808.00;680
11879;29;5748213;11879;554;13311;13991;4.10;0.25;403.42;22.01;1432;61;4809.00;680
11880;29;5748234;11880;554;13315;13997;4.10;0.25;403.45;22.00;1435;61;4810.00;682
11881;29;5748254;11881;546;13315;13997;4.12;0.25;403.45;22.00;1434;61;4811.00;682
11882;29;5748281;11882;549;13316;13997;4.17;0.25;403.47;22.00;1434;61;4812.00;681
11887;29;5748306;11887;544;13316;13997;4.17;0.25;403.53;22.00;1429;61;4813.00;681
11891;29;5748326;11891;540;13319;14001;4.20;0.26;403.60;22.00;1428;61;4814.00;682
11892;29;5748348;11892;539;13320;14003;4.25;0.26;403.57;21.99;1428;61;4815.00;683
11898;29;5748374;11898;536;13321;14003;4.27;0.26;403.70;21.99;1423;61;4816.00;682
11900;29;5748401;11900;531;13321;14004;4.32;0.26;403.71;21.99;1421;61;4817.00;683
11906;29;5748423;11906;522;13321;14004;4.32;0.26;403.76;21.99;1415;61;4818.00;683
11911;29;5748445;11911;521;13321;14004;4.31;0.26;403.98;21.99;1410;61;4819.00;683
11913;29;5748465;11913;517;13321;14004;4.32;0.26;404.04;21.99;1408;61;4820.00;683
11920;29;5748483;11920;519;13323;14004;4.29;0.26;404.09;22.13;1403;61;4821.00;681
11924;29;5748504;11924;516;13323;14004;4.32;0.26;404.12;22.13;1399;61;4822.00;681
11928;29;5748524;11928;513;13323;14004;4.37;0.27;404.11;22.13;1395;61;4823.00;681
11932;29;5748541;11932;534;13360;14074;4.41;0.27;404.39;22.07;1428;61;4824.00;714
11933;29;5748565;11933;515;13361;14075;4.43;0.27;404.40;22.09;1428;61;4825.00;714
11936;29;5748580;11936;507;13362;14075;4.49;0.27;404.54;22.09;1426;61;4826.00;713
11939;29;5748596;11939;507;13363;14075;4.51;0.27;404.58;22.12;1424;61;4827.00;712
11941;29;5748614;11941;510;13364;14077;4.55;0.28;404.61;22.11;1423;61;4828.00;713
11943;29;5748633;11943;509;13365;14077;4.57;0.28;404.59;22.11;1422;61;4829.00;712
11947;29;5748654;11947;522;13367;14077;4.56;0.28;404.65;22.16;1420;61;4830.00;710
11952;29;5748671;11952;523;13367;14077;4.52;0.27;404.73;22.16;1415;61;4831.00;710
11953;29;5748689;11953;519;13367;14078;4.50;0.27;404.75;22.16;1414;61;4832.00;711
11958;29;5748708;11958;524;13371;14079;4.45;0.27;404.94;22.20;1413;61;4833.00;708
11959;29;5748728;11959;528;13371;14079;4.42;0.27;405.04;22.20;1412;61;4834.00;708
11962;29;5748745;11962;532;13375;14083;4.41;0.27;405.02;22.20;1413;61;4835.00;708
11964;29;5748764;11964;533;13376;14083;4.41;0.27;405.20;22.32;1412;61;4836.00;707
11966;29;5748782;11966;538;13381;14083;4.42;0.27;405.21;22.38;1415;61;4837.00;702
11968;29;5748802;11968;537;13382;14083;4.42;0.27;405.40;22.41;1414;61;4838.00;701
11973;29;5748821;11973;533;13386;14089;4.41;0.27;405.60;22.42;1413;61;4839.00;703
11973;29;5748839;11973;543;13389;14089;4.43;0.27;405.60;22.42;1416;61;4840.00;700
11975;29;5748856;11975;524;13391;14089;4.38;0.27;405.64;22.44;1416;61;4841.00;698
11978;29;5748875;11978;527;13394;14092;4.34;0.26;405.66;22.49;1416;61;4842.00;698
11980;29;5748892;11980;516;13397;14092;4.31;0.26;405.64;22.53;1417;61;4843.00;695
11986;29;5748916;11986;515;13398;14092;4.27;0.26;405.80;22.55;1412;61;4844.00;694
11987;29;5748936;11987;506;13399;14093;4.31;0.26;405.85;22.55;1412;61;4845.00;694
11991;29;5748955;11991;511;13403;14094;4.28;0.26;405.88;22.57;1412;61;4846.00;691
11991;29;5748974;11991;502;13406;14094;4.30;0.26;405.88;22.61;1415;61;4847.00;688
11993;29;5748991;11993;506;13415;14107;4.34;0.26;405.99;22.60;1422;61;4848.00;692
11995;29;5749011;11995;510;13417;14107;4.34;0.26;406.02;22.74;1422;61;4849.00;690
11997;29;5749028;11997;519;13419;14107;4.31;0.26;406.18;22.78;1422;61;4850.00;688
11998;29;5749045;11998;518;13422;14108;4.33;0.26;406.20;22.82;1424;61;4851.00;686
12000;29;5749063;12000;516;13423;14108;4.31;0.26;406.34;22.84;1423;61;4852.00;685
12002;29;5749080;12002;514;13427;14112;4.28;0.26;406.39;22.86;1425;61;4853.00;685
12005;29;5749098;12005;518;13430;14112;4.25;0.26;406.52;23.00;1425;61;4854.00;682
12009;29;5749116;12009;509;13435;14116;4.22;0.26;406.55;23.01;1426;61;4855.00;681
12011;29;5749133;12011;512;13435;14116;4.24;0.26;406.51;23.01;1424;61;4856.00;681
12013;29;5749151;12013;509;13439;14116;4.24;0.26;406.54;23.03;1426;61;4857.00;677
12016;29;5749167;12016;499;13439;14116;4.27;0.26;406.67;23.03;1423;61;4858.00;677
12016;29;5749184;12016;503;13442;14116;4.30;0.26;406.67;23.07;1426;61;4859.00;674
12020;29;5749203;12020;508;13464;14150;4.34;0.26;406.73;23.03;1444;61;4860.00;686
12022;29;5749223;12022;500;13465;14150;4.36;0.27;406.72;23.03;1443;62;4861.00;685
12025;29;5749250;12025;496;13468;14150;4.39;0.27;406.75;23.05;1443;62;4862.00;682
12028;29;5749270;12028;489;13470;14150;4.39;0.27;406.92;23.07;1442;62;4863.00;680
12028;29;5749287;12028;495;13473;14150;4.46;0.27;406.92;23.09;1445;62;4864.00;677
12029;29;5749304;12029;498;13476;14150;4.48;0.27;406.99;23.22;1447;62;4865.00;674
12033;29;5749319;12033;499;13478;14151;4.45;0.27;407.04;23.24;1445;62;4866.00;673
12034;29;5749336;12034;507;13481;14151;4.48;0.27;407.10;23.25;1447;62;4867.00;670
12036;29;5749361;12036;515;13486;14157;4.47;0.27;407.09;23.27;1450;62;4868.00;671
12039;29;5749380;12039;519;13487;14158;4.43;0.27;407.18;23.26;1448;62;4869.00;671
12041;29;5749397;12041;520;13489;14158;4.38;0.27;407.24;23.28;1448;62;4870.00;669
12044;29;5749414;12044;528;13489;14158;4.37;0.27;407.34;23.28;1445;62;4871.00;669
12046;29;5749431;12046;529;13490;14162;4.33;0.26;407.39;23.28;1444;62;4872.00;672
12046;29;5749449;12046;542;13493;14162;4.29;0.26;407.39;23.31;1447;62;4873.00;669
12047;29;5749466;12047;558;13493;14162;4.24;0.26;407.42;23.31;1446;62;4874.00;669
12048;29;5749482;12048;552;13495;14163;4.20;0.26;407.47;23.33;1447;62;4875.00;668
12049;29;5749499;12049;557;13498;14167;4.13;0.25;407.45;23.32;1449;62;4876.00;669
12052;29;5749517;12052;557;13498;14167;4.09;0.25;407.38;23.32;1446;62;4877.00;669
12055;29;5749534;12055;556;13501;14170;4.02;0.24;407.36;23.36;1446;62;4878.00;669
12055;29;5749551;12055;558;13501;14170;3.97;0.24;407.36;23.36;1446;62;4879.00;669
12055;29;5749568;12055;558;13501;14170;3.95;0.24;407.36;23.36;1446;62;4880.00;669
12055;29;5749583;12055;557;13501;14170;3.96;0.24;407.36;23.36;1446;62;4881.00;669
12059;29;5749598;12059;557;13506;14174;3.98;0.24;407.40;23.37;1447;62;4882.00;668
12060;29;5749614;12060;554;13506;14174;4.01;0.24;407.38;23.37;1446;62;4883.00;668
12062;29;5749630;12062;558;13507;14174;4.02;0.24;407.45;23.39;1445;62;4884.00;667
12065;29;5749646;12065;554;13507;14174;4.02;0.25;407.40;23.39;1442;62;4885.00;667
12066;29;5749661;12066;560;13507;14175;4.05;0.25;407.39;23.39;1441;62;4886.00;668
12068;29;5749676;12068;563;13508;14176;4.07;0.25;407.35;23.41;1440;62;4887.00;668
12073;29;5749693;12073;568;13508;14176;4.09;0.25;407.32;23.41;1435;62;4888.00;668
12075;29;5749709;12075;569;13509;14177;4.13;0.25;407.35;23.41;1434;62;4889.00;668
12076;29;5749728;12076;570;13509;14177;4.14;0.25;407.39;23.41;1433;62;4890.00;668
12078;29;5749745;12078;570;13510;14177;4.14;0.25;407.43;23.43;1432;62;4891.00;667
12081;29;5749761;12081;574;13511;14177;4.09;0.25;407.44;23.55;1430;62;4892.00;666
12085;29;5749782;12085;587;13512;14177;4.08;0.25;407.44;23.57;1427;62;4893.00;665
12090;29;5749798;12090;584;13512;14177;4.05;0.25;407.36;23.57;1422;62;4894.00;665
12095;29;5749813;12095;597;13513;14177;3.98;0.24;407.46;23.59;1418;62;4895.00;664
12096;29;5749828;12096;619;13572;14304;4.21;0.26;407.47;23.48;1476;62;4896.00;732
12099;29;5749854;12099;614;13576;14305;4.18;0.26;407.40;23.50;1477;62;4897.00;729
12103;29;5749869;12103;610;13583;14305;4.18;0.26;407.42;23.51;1480;62;4898.00;722
12103;29;5749886;12103;608;13583;14305;4.15;0.26;407.42;23.51;1480;62;4899.00;722
12105;29;5749903;12105;608;13589;14305;4.13;0.26;407.38;23.50;1484;62;4900.00;716
12106;29;5749924;12106;615;13591;14305;4.10;0.25;407.37;23.50;1485;62;4901.00;714
12107;29;5749946;12107;626;13596;14305;4.12;0.25;407.34;23.49;1489;62;4902.00;709
12108;29;5749963;12108;633;13597;14305;4.10;0.25;407.33;23.49;1489;62;4903.00;708
12108;29;5749979;12108;631;13601;14306;4.09;0.25;407.33;23.51;1493;62;4904.00;705
12110;29;5749996;12110;634;13605;14308;4.12;0.25;407.34;23.50;1495;62;4905.00;703
12113;29;5750013;12113;634;13607;14308;4.08;0.25;407.29;23.50;1494;62;4906.00;701
12113;29;5750030;12113;644;13609;14309;4.04;0.25;407.29;23.50;1496;62;4907.00;700
12113;29;5750046;12113;643;13611;14309;4.00;0.25;407.29;23.50;1498;62;4908.00;698
12115;29;5750067;12115;651;13613;14309;3.92;0.24;407.29;23.52;1498;62;4909.00;696
12119;29;5750085;12119;664;13614;14309;3.82;0.24;407.25;23.52;1495;62;4910.00;695
12122;29;5750102;12122;668;13617;14313;3.78;0.23;407.20;23.51;1495;62;4911.00;696
12122;29;5750120;12122;683;13618;14313;3.76;0.23;407.20;23.51;1496;62;4912.00;695
12123;29;5750138;12123;698;13618;14313;3.73;0.23;407.19;23.51;1495;62;4913.00;695
12124;29;5750195;12124;703;13619;14316;3.74;0.23;407.17;23.51;1495;62;4914.00;697
12124;29;5750216;12124;705;13619;14316;3.71;0.23;407.17;23.51;1495;62;4915.00;697
12126;29;5750233;12126;715;13620;14316;3.67;0.23;407.23;23.63;1494;62;4916.00;696
12128;29;5750249;12128;717;13623;14320;3.63;0.22;407.31;23.62;1495;62;4917.00;697
12131;29;5750266;12131;712;13624;14321;3.58;0.22;407.30;23.62;1493;62;4918.00;697
12133;29;5750283;12133;707;13624;14321;3.57;0.22;407.25;23.62;1491;63;4919.00;697
12134;29;5750310;12134;700;13628;14326;3.59;0.22;407.26;23.62;1494;63;4920.00;698
12134;29;5750328;12134;699;13628;14326;3.62;0.22;407.26;23.62;1494;64;4921.00;698
12135;29;5750355;12135;701;13628;14326;3.66;0.23;407.32;23.62;1493;64;4922.00;698
12135;29;5750372;12135;694;13628;14327;3.69;0.23;407.32;23.62;1493;64;4923.00;699
12138;29;5750388;12138;685;13628;14327;3.71;0.23;407.37;23.62;1490;64;4924.00;699
12140;29;5750410;12140;682;13632;14333;3.80;0.23;407.35;23.61;1492;64;4925.00;701
12145;29;5750426;12145;686;13632;14333;3.78;0.23;407.40;23.61;1487;64;4926.00;701
12146;29;5750442;12146;691;13632;14334;3.78;0.23;407.39;23.61;1486;64;4927.00;702
12146;29;5750466;12146;687;13632;14334;3.83;0.24;407.39;23.61;1486;64;4928.00;702
12152;29;5750482;12152;696;13632;14334;3.79;0.23;407.30;23.61;1480;64;4929.00;702
12154;29;5750497;12154;697;13632;14334;3.76;0.23;407.38;23.61;1478;64;4930.00;702
12155;29;5750515;12155;701;13632;14334;3.74;0.23;407.43;23.61;1477;64;4931.00;702
12156;29;5750529;12156;707;13641;14346;3.75;0.23;407.42;23.59;1485;64;4932.00;705
12159;29;5750546;12159;709;13641;14346;3.72;0.23;407.39;23.59;1482;64;4933.00;705
12159;29;5750564;12159;711;13641;14346;3.71;0.23;407.39;23.59;1482;64;4934.00;705
12161;29;5750580;12161;707;13641;14346;3.70;0.23;407.42;23.59;1480;64;4935.00;705
12161;29;5750596;12161;697;13641;14346;3.71;0.23;407.42;23.59;1480;64;4936.00;705
12163;29;5750611;12163;700;13641;14346;3.71;0.23;407.45;23.59;1478;64;4937.00;705
12164;29;5750627;12164;700;13644;14350;3.72;0.23;407.44;23.59;1480;64;4938.00;706
12167;29;5750644;12167;692;13644;14350;3.69;0.23;407.44;23.59;1477;64;4939.00;706
12170;29;5750659;12170;690;13647;14354;3.71;0.23;407.42;23.58;1477;64;4940.00;707
12174;29;5750675;12174;686;13647;14355;3.68;0.22;407.44;23.58;1473;64;4941.00;708
12176;29;5750691;12176;691;13647;14355;3.64;0.22;407.45;23.58;1471;64;4942.00;708
12177;29;5750706;12177;687;13647;14355;3.59;0.22;407.51;23.58;1470;64;4943.00;708
12178;29;5750721;12178;692;13656;14368;3.58;0.22;407.52;23.57;1478;64;4944.00;712
12178;29;5750737;12178;687;13656;14368;3.59;0.22;407.52;23.57;1478;64;4945.00;712
12182;29;5750752;12182;682;13657;14368;3.58;0.22;407.65;23.57;1475;64;4946.00;711
12185;29;5750768;12185;684;13658;14369;3.55;0.21;407.62;23.56;1473;64;4947.00;711
12186;29;5750783;12186;684;13658;14370;3.59;0.22;407.60;23.56;1472;64;4948.00;712
12188;29;5750799;12188;684;13658;14370;3.57;0.22;407.64;23.56;1470;64;4949.00;712
12189;29;5750823;12189;675;13663;14379;3.58;0.22;407.61;23.56;1474;64;4950.00;716
12191;29;5750839;12191;659;13663;14379;3.63;0.22;407.72;23.56;1472;64;4951.00;716
12193;29;5750855;12193;659;13664;14379;3.66;0.22;407.81;23.55;1471;64;4952.00;715
12197;29;5750871;12197;653;13664;14379;3.67;0.22;407.97;23.55;1467;64;4953.00;715
12198;29;5750887;12198;654;13668;14385;3.71;0.23;407.96;23.55;1470;64;4954.00;717
12203;29;5750903;12203;656;13669;14385;3.70;0.22;408.10;23.55;1466;64;4955.00;716
12205;29;5750919;12205;640;13669;14385;3.75;0.23;408.06;23.55;1464;64;4956.00;716
12207;29;5750935;12207;641;13669;14385;3.79;0.23;408.09;23.55;1462;64;4957.00;716
12208;29;5750951;12208;632;13672;14389;3.82;0.23;408.08;23.54;1464;64;4958.00;717
12210;29;5750966;12210;627;13672;14390;3.83;0.23;408.12;23.54;1462;64;4959.00;718
12213;29;5750982;12213;612;13672;14390;3.85;0.24;408.14;23.54;1459;64;4960.00;718
12215;29;5750997;12215;601;13673;14391;3.89;0.24;408.16;23.54;1458;64;4961.00;718
12216;29;5751012;12216;601;13673;14391;3.94;0.24;408.17;23.54;1457;64;4962.00;718
12220;29;5751027;12220;598;13674;14391;3.97;0.24;408.19;23.56;1454;64;4963.00;717
12222;29;5751045;12222;595;13674;14391;4.05;0.25;408.19;23.56;1452;64;4964.00;717
12225;29;5751061;12225;592;13674;14391;4.13;0.25;408.16;23.56;1449;64;4965.00;717
12229;29;5751078;12229;588;13674;14391;4.19;0.26;408.17;23.56;1445;64;4966.00;717
12235;29;5751095;12235;577;13674;14391;4.26;0.26;408.12;23.56;1439;64;4967.00;717
12241;29;5751111;12241;574;13708;14461;4.40;0.27;408.22;23.51;1467;64;4968.00;753
12245;29;5751134;12245;557;13712;14462;4.44;0.27;408.19;23.62;1467;64;4969.00;750
12250;29;5751152;12250;541;13714;14462;4.49;0.28;408.24;23.62;1464;64;4970.00;748
12254;29;5751169;12254;529;13716;14462;4.51;0.28;408.22;23.62;1462;64;4971.00;746
12259;29;5751185;12259;519;13716;14462;4.53;0.28;408.34;23.62;1457;64;4972.00;746
12261;29;5751202;12261;517;13716;14462;4.57;0.28;408.34;23.62;1455;64;4973.00;746
12265;29;5751219;12265;515;13716;14462;4.59;0.28;408.56;23.62;1451;64;4974.00;746
12269;29;5751235;12269;509;13716;14462;4.59;0.28;408.63;23.62;1447;64;4975.00;746
12274;29;5751252;12274;505;13716;14463;4.59;0.28;408.62;23.62;1442;64;4976.00;747
12276;29;5751272;12276;504;13716;14464;4.61;0.28;408.63;23.62;1440;64;4977.00;748
12279;29;5751291;12279;508;13716;14464;4.60;0.28;408.65;23.62;1437;64;4978.00;748
12283;29;5751307;12283;501;13720;14468;4.64;0.28;408.69;23.61;1437;64;4979.00;748
12286;29;5751324;12286;507;13720;14468;4.64;0.28;408.72;23.61;1434;64;4980.00;748
12290;29;5751342;12290;504;13720;14468;4.63;0.28;408.81;23.61;1430;64;4981.00;748
12295;29;5751357;12295;514;13721;14468;4.59;0.28;408.98;23.61;1426;64;4982.00;747
12299;29;5751380;12299;510;13725;14474;4.57;0.28;409.08;23.61;1426;64;4983.00;749
12301;29;5751403;12301;509;13726;14474;4.54;0.28;409.08;23.61;1425;64;4984.00;748
12305;29;5751420;12305;506;13727;14474;4.50;0.27;409.14;23.61;1422;64;4985.00;747
12311;29;5751438;12311;511;13728;14477;4.45;0.27;409.34;23.73;1417;64;4986.00;749
12314;29;5751455;12314;516;13731;14477;4.43;0.27;409.33;23.76;1417;64;4987.00;746
12318;29;5751473;12318;509;13732;14477;4.41;0.27;409.45;23.78;1414;64;4988.00;745
12322;29;5751491;12322;513;13733;14478;4.43;0.27;409.54;23.78;1411;64;4989.00;745
12326;29;5751513;12326;513;13734;14479;4.41;0.27;409.59;23.78;1408;64;4990.00;745
12329;29;5751531;12329;509;13737;14479;4.40;0.27;409.67;23.83;1408;64;4991.00;742
12333;29;5751548;12333;511;13745;14492;4.39;0.27;409.90;23.82;1412;64;4992.00;747
12335;29;5751565;12335;518;13746;14492;4.41;0.27;409.91;23.82;1411;64;4993.00;746
12339;29;5751581;12339;515;13749;14492;4.39;0.27;410.06;23.87;1410;64;4994.00;743
12342;29;5751597;12342;511;13751;14494;4.37;0.27;410.11;23.87;1409;64;4995.00;743
12346;29;5751614;12346;511;13752;14494;4.40;0.27;410.20;23.89;1406;64;4996.00;742
12348;29;5751629;12348;505;13756;14498;4.42;0.27;410.22;23.91;1408;64;4997.00;742
12351;29;5751645;12351;496;13758;14498;4.44;0.27;410.38;23.93;1407;64;4998.00;740
12353;29;5751663;12353;493;13761;14502;4.46;0.27;410.43;23.93;1408;64;4999.00;741
12358;29;5751680;12358;493;13763;14502;4.44;0.27;410.65;23.93;1405;64;5000.00;739
12363;29;5751710;12363;489;13765;14502;4.46;0.27;410.85;23.97;1402;64;5001.00;737
12366;29;5751735;12366;493;13768;14502;4.46;0.27;410.85;24.02;1402;64;5002.00;734
12368;29;5751756;12368;494;13770;14502;4.46;0.27;411.00;24.04;1402;64;5003.00;732
12371;29;5751775;12371;499;13778;14514;4.48;0.27;411.06;24.18;1407;64;5004.00;736
12373;29;5751796;12373;503;13780;14514;4.44;0.27;411.10;24.20;1407;64;5005.00;734
12376;29;5751814;12376;503;13782;14514;4.38;0.27;411.09;24.22;1406;64;5006.00;732
12380;29;5751831;12380;499;13783;14514;4.33;0.26;411.12;24.25;1403;64;5007.00;731
12384;29;5751855;12384;498;13786;14514;4.33;0.26;411.24;24.27;1402;64;5008.00;728
12388;29;5751880;12388;496;13787;14514;4.30;0.26;411.26;24.29;1399;64;5009.00;727
12391;29;5751902;12391;498;13788;14515;4.29;0.26;411.29;24.29;1397;64;5010.00;727
12395;29;5751924;12395;504;13790;14515;4.30;0.26;411.31;24.33;1395;64;5011.00;725
12398;29;5751944;12398;506;13795;14521;4.31;0.26;411.29;24.35;1397;64;5012.00;726
12400;29;5751964;12400;511;13796;14522;4.24;0.26;411.33;24.37;1396;64;5013.00;726
12403;29;5751987;12403;515;13796;14522;4.21;0.26;411.44;24.37;1393;64;5014.00;726
12406;29;5752010;12406;515;13798;14522;4.19;0.25;411.49;24.41;1392;64;5015.00;724
12407;29;5752029;12407;524;13800;14526;4.16;0.25;411.47;24.41;1393;64;5016.00;726
12410;29;5752048;12410;520;13802;14526;4.17;0.25;411.63;24.43;1392;64;5017.00;724
12413;29;5752068;12413;513;13803;14526;4.16;0.25;411.65;24.45;1390;64;5018.00;723
12415;29;5752085;12415;507;13806;14527;4.19;0.25;411.76;24.60;1391;64;5019.00;721
12416;29;5752103;12416;498;13809;14531;4.25;0.26;411.80;24.59;1393;64;5020.00;722
12420;29;5752120;12420;491;13811;14531;4.25;0.26;411.88;24.64;1391;64;5021.00;720
12425;29;5752136;12425;490;13813;14534;4.27;0.26;411.97;24.66;1388;64;5022.00;721
12425;29;5752154;12425;491;13815;14534;4.30;0.26;411.97;24.70;1390;64;5023.00;719
12425;29;5752170;12425;486;13816;14534;4.34;0.26;411.97;24.72;1391;64;5024.00;718
12427;29;5752186;12427;493;13817;14534;4.39;0.27;411.94;24.74;1390;64;5025.00;717
12432;29;5752202;12432;495;13820;14538;4.39;0.27;412.02;24.74;1388;64;5026.00;718
12435;29;5752220;12435;489;13822;14538;4.40;0.27;412.08;24.78;1387;64;5027.00;716
12439;29;5752236;12439;491;13822;14538;4.39;0.27;412.13;24.78;1383;64;5028.00;716
12440;29;5752252;12440;496;13826;14538;4.39;0.27;412.11;25.28;1386;65;5029.00;712
12441;29;5752280;12441;498;13827;14539;4.40;0.27;412.10;25.30;1386;65;5030.00;712
12444;29;5752295;12444;504;13830;14540;4.40;0.27;412.10;25.36;1386;65;5031.00;710
12449;29;5752311;12449;507;13830;14540;4.37;0.27;412.23;25.36;1381;65;5032.00;710
12454;29;5752327;12454;513;13833;14541;4.33;0.26;412.32;25.39;1379;65;5033.00;708
12457;29;5752342;12457;521;13835;14541;4.30;0.26;412.36;25.53;1378;65;5034.00;706
12459;29;5752360;12459;532;13836;14541;4.31;0.26;412.37;25.55;1377;65;5035.00;705
12461;29;5752376;12461;529;13836;14541;4.26;0.26;412.44;25.55;1375;65;5036.00;705
12464;29;5752391;12464;539;13838;14541;4.25;0.26;412.47;25.59;1374;65;5037.00;703
12466;29;5752406;12466;548;13840;14541;4.24;0.26;412.49;25.63;1374;65;5038.00;701
12468;29;5752421;12468;556;13840;14541;4.22;0.26;412.63;25.63;1372;65;5039.00;701
12470;29;5752438;12470;616;13962;14771;4.39;0.28;412.66;25.56;1492;65;5040.00;809
12472;29;5752472;12472;603;13965;14772;4.41;0.28;412.65;25.56;1493;65;5041.00;807
12475;29;5752489;12475;583;13969;14772;4.44;0.28;412.65;25.55;1494;65;5042.00;803
12477;29;5752505;12477;580;13972;14772;4.47;0.28;412.64;25.55;1495;65;5043.00;800
12482;29;5752520;12482;575;13976;14772;4.50;0.28;412.59;25.54;1494;65;5044.00;796
12485;29;5752537;12485;569;13981;14772;4.55;0.28;412.57;25.56;1496;65;5045.00;791
12486;29;5752553;12486;557;13988;14772;4.61;0.29;412.57;25.61;1502;65;5046.00;784
12490;29;5752569;12490;558;13991;14772;4.63;0.29;412.64;25.62;1501;65;5047.00;781
12491;29;5752585;12491;558;13996;14773;4.70;0.29;412.64;25.62;1505;65;5048.00;777
12492;29;5752601;12492;566;14002;14774;4.70;0.29;412.74;25.65;1510;65;5049.00;772
12498;29;5752623;12498;569;14004;14774;4.65;0.29;412.73;25.65;1506;65;5050.00;770
12502;29;5752638;12502;570;14006;14775;4.61;0.29;412.76;25.67;1504;65;5051.00;769
12502;29;5752654;12502;575;14008;14775;4.60;0.29;412.76;25.68;1506;65;5052.00;767
12505;29;5752670;12505;584;14009;14775;4.56;0.28;412.75;25.68;1504;65;5053.00;766
12507;29;5752686;12507;579;14011;14775;4.53;0.28;412.81;25.70;1504;65;5054.00;764
12511;29;5752702;12511;579;14013;14779;4.43;0.27;412.78;25.70;1502;65;5055.00;766
12514;29;5752723;12514;587;14016;14779;4.38;0.27;412.78;25.70;1502;65;5056.00;763
12516;29;5752744;12516;586;14018;14779;4.32;0.27;412.75;25.70;1502;65;5057.00;761
12521;29;5752760;12521;594;14020;14782;4.27;0.26;412.77;25.71;1499;65;5058.00;762
12523;29;5752777;12523;600;14021;14782;4.24;0.26;412.76;25.71;1498;65;5059.00;761
12524;29;5752793;12524;610;14023;14782;4.20;0.26;412.79;25.73;1499;65;5060.00;759
12528;29;5752809;12528;620;14026;14786;4.19;0.26;412.74;25.73;1498;65;5061.00;760
12529;29;5752825;12529;632;14028;14787;4.14;0.25;412.74;25.72;1499;65;5062.00;759
12532;29;5752841;12532;639;14028;14787;4.09;0.25;412.71;25.72;1496;65;5063.00;759
12532;29;5752858;12532;648;14033;14791;4.08;0.25;412.71;25.76;1501;65;5064.00;758
12533;29;5752874;12533;637;14033;14791;4.06;0.25;412.74;25.76;1500;65;5065.00;758
12534;29;5752890;12534;637;14035;14791;4.05;0.25;412.71;25.76;1501;65;5066.00;756
12535;29;5752907;12535;637;14036;14792;4.03;0.25;412.71;25.78;1501;65;5067.00;756
12535;29;5752924;12535;644;14039;14792;4.03;0.25;412.71;25.78;1504;65;5068.00;753
12535;29;5752940;12535;646;14043;14798;4.03;0.25;412.71;25.77;1508;65;5069.00;755
12538;29;5752957;12538;645;14044;14798;4.02;0.25;412.76;25.77;1506;65;5070.00;754
12539;29;5752973;12539;646;14044;14799;4.01;0.25;412.79;25.77;1505;65;5071.00;755
12539;29;5753000;12539;658;14046;14799;4.02;0.25;412.79;25.80;1507;65;5072.00;753
12540;29;5753017;12540;650;14046;14799;4.00;0.25;412.82;25.80;1506;65;5073.00;753
12543;29;5753032;12543;652;14047;14799;4.01;0.25;412.86;25.80;1504;65;5074.00;752
12545;29;5753048;12545;652;14048;14799;4.03;0.25;412.84;25.80;1503;65;5075.00;751
12548;29;5753063;12548;653;14057;14811;4.05;0.25;412.78;25.78;1509;65;5076.00;754
12549;29;5753081;12549;657;14058;14811;4.09;0.25;412.75;25.78;1509;65;5077.00;753
12551;29;5753096;12551;662;14058;14811;4.10;0.25;412.70;25.78;1507;65;5078.00;753
12555;30;5753112;12555;659;14058;14811;4.09;0.25;412.73;25.78;1503;66;5079.00;753
12556;30;5753134;12556;665;14059;14811;4.09;0.25;412.73;25.78;1503;66;5080.00;752
12557;30;5753155;12557;668;14059;14811;4.09;0.25;412.70;25.78;1502;66;5081.00;752
12557;30;5753176;12557;670;14065;14815;4.15;0.26;412.70;25.78;1508;66;5082.00;750
12559;30;5753197;12559;663;14065;14815;4.15;0.26;412.72;25.78;1506;66;5083.00;750
12561;30;5753212;12561;668;14069;14819;4.14;0.25;412.66;25.78;1508;66;5084.00;750
12562;30;5753230;12562;663;14070;14821;4.10;0.25;412.71;25.77;1508;66;5085.00;751
12565;30;5753245;12565;668;14070;14821;4.06;0.25;412.72;25.77;1505;66;5086.00;751
12565;30;5753260;12565;667;14070;14821;4.06;0.25;412.72;25.77;1505;66;5087.00;751
12568;30;5753276;12568;663;14079;14834;4.03;0.25;412.78;25.76;1511;66;5088.00;755
12571;30;5753293;12571;666;14080;14834;4.01;0.25;412.91;25.76;1509;66;5089.00;754
12573;30;5753308;12573;674;14080;14834;4.00;0.24;413.00;25.76;1507;66;5090.00;754
12579;30;5753325;12579;676;14081;14835;3.97;0.24;412.93;25.75;1502;66;5091.00;754
12582;30;5753341;12582;676;14081;14836;3.98;0.24;412.97;25.75;1499;66;5092.00;755
12583;30;5753357;12583;672;14081;14836;4.02;0.25;413.00;25.75;1498;66;5093.00;755
12586;30;5753373;12586;673;14082;14839;4.03;0.25;412.96;25.75;1496;66;5094.00;757
12588;30;5753390;12588;667;14082;14839;4.08;0.25;412.98;25.75;1494;66;5095.00;757
12589;30;5753405;12589;669;14082;14839;4.12;0.25;412.95;25.75;1493;66;5096.00;757
12590;30;5753420;12590;671;14082;14839;4.14;0.25;412.95;25.75;1492;66;5097.00;757
12590;30;5753435;12590;665;14086;14845;4.17;0.25;412.95;25.74;1496;66;5098.00;759
12595;30;5753451;12595;670;14086;14845;4.15;0.25;412.88;25.74;1491;66;5099.00;759
12598;30;5753468;12598;670;14091;14864;4.09;0.25;413.07;25.74;1493;66;5100.00;773
12599;30;5753489;12599;666;14091;14864;4.08;0.25;413.04;25.74;1492;66;5101.00;773
12602;30;5753504;12602;663;14094;14868;4.03;0.25;413.23;25.73;1492;66;5102.00;774
12604;30;5753520;12604;660;14094;14869;4.02;0.24;413.22;25.73;1490;66;5103.00;775
12608;30;5753535;12608;654;14094;14869;4.00;0.24;413.27;25.73;1486;66;5104.00;775
12610;30;5753550;12610;651;14096;14870;4.02;0.24;413.24;25.73;1486;66;5105.00;774
12614;30;5753565;12614;649;14098;14870;4.00;0.24;413.17;25.72;1484;66;5106.00;772
12615;30;5753580;12615;651;14098;14870;4.05;0.25;413.18;25.72;1483;66;5107.00;772
12617;30;5753599;12617;648;14098;14870;4.06;0.25;413.17;25.72;1481;66;5108.00;772
12619;30;5753614;12619;646;14098;14870;4.10;0.25;413.15;25.72;1479;66;5109.00;772
12621;30;5753630;12621;646;14098;14870;4.11;0.25;413.18;25.72;1477;66;5110.00;772
12624;30;5753645;12624;644;14099;14870;4.12;0.25;413.13;25.72;1475;66;5111.00;771
12626;30;5753660;12626;654;14138;14940;4.20;0.26;413.13;25.65;1512;66;5112.00;802
12632;30;5753679;12632;646;14141;14941;4.20;0.26;413.07;25.65;1509;66;5113.00;800
12634;30;5753695;12634;649;14144;14941;4.20;0.26;413.09;25.64;1510;66;5114.00;797
12636;30;5753710;12636;632;14144;14941;4.20;0.26;413.06;25.64;1508;66;5115.00;797
12638;30;5753728;12638;630;14144;14941;4.25;0.26;413.04;25.64;1506;66;5116.00;797
12642;30;5753743;12642;625;14145;14941;4.24;0.26;413.11;25.64;1503;66;5117.00;796
12643;30;5753759;12643;615;14146;14941;4.25;0.26;413.09;25.64;1503;66;5118.00;795
12647;30;5753775;12647;611;14147;14941;4.26;0.26;413.13;25.64;1500;66;5119.00;794
12651;30;5753791;12651;611;14147;14942;4.26;0.26;413.24;25.64;1496;66;5120.00;795
12653;30;5753807;12653;609;14147;14943;4.24;0.26;413.32;25.64;1494;66;5121.00;796
12656;30;5753822;12656;607;14147;14943;4.24;0.26;413.38;25.64;1491;66;5122.00;796
12659;30;5753838;12659;617;14151;14947;4.26;0.26;413.43;25.64;1492;66;5123.00;796
12663;30;5753854;12663;616;14152;14947;4.24;0.26;413.41;25.63;1489;66;5124.00;795
12666;30;5753870;12666;614;14152;14947;4.25;0.26;413.52;25.63;1486;66;5125.00;795
12668;30;5753885;12668;618;14153;14947;4.25;0.26;413.51;25.63;1485;66;5126.00;794
12672;30;5753902;12672;613;14156;14953;4.27;0.26;413.56;25.63;1484;66;5127.00;797
12676;30;5753919;12676;610;14156;14953;4.29;0.26;413.59;25.63;1480;66;5128.00;797
12681;30;5753935;12681;614;14160;14953;4.27;0.26;413.71;25.63;1479;66;5129.00;793
12686;30;5753954;12686;607;14161;14959;4.27;0.26;413.86;25.63;1475;66;5130.00;798
12688;30;5753970;12688;601;14162;14959;4.32;0.26;413.91;25.63;1474;66;5131.00;797
12693;30;5753987;12693;602;14164;14959;4.32;0.26;413.93;25.63;1471;66;5132.00;795
12696;30;5754004;12696;597;14164;14960;4.30;0.26;414.12;25.63;1468;66;5133.00;796
12700;30;5754020;12700;594;14166;14961;4.30;0.26;414.38;25.62;1466;66;5134.00;795
12705;30;5754036;12705;600;14169;14961;4.29;0.26;414.44;25.62;1464;66;5135.00;792
12710;30;5754057;12710;596;14177;14974;4.25;0.26;414.54;25.61;1467;66;5136.00;797
12714;30;5754074;12714;597;14178;14974;4.25;0.26;414.56;25.61;1464;66;5137.00;796
12717;30;5754091;12717;596;14179;14974;4.26;0.26;414.69;25.61;1462;66;5138.00;795
12723;30;5754107;12723;597;14180;14975;4.26;0.26;414.80;25.61;1457;66;5139.00;795
12725;30;5754123;12725;599;14180;14975;4.27;0.26;414.75;25.61;1455;66;5140.00;795
12728;30;5754138;12728;595;14183;14979;4.27;0.26;414.87;25.60;1455;66;5141.00;796
12732;30;5754155;12732;591;14184;14979;4.26;0.26;414.90;25.60;1452;66;5142.00;795
12736;30;5754170;12736;591;14191;14983;4.24;0.26;414.90;25.59;1455;66;5143.00;792
12737;30;5754187;12737;591;14192;14983;4.29;0.26;414.97;25.59;1455;66;5144.00;791
12741;30;5754203;12741;594;14192;14983;4.29;0.26;415.11;25.59;1451;66;5145.00;791
12744;30;5754219;12744;589;14192;14983;4.30;0.26;415.13;25.59;1448;66;5146.00;791
12748;30;5754235;12748;583;14192;14983;4.28;0.26;415.28;25.59;1444;66;5147.00;791
12754;30;5754252;12754;583;14201;14995;4.25;0.26;415.45;25.58;1447;66;5148.00;794
12755;30;5754276;12755;583;14202;14995;4.25;0.26;415.42;25.60;1447;66;5149.00;793
12761;30;5754291;12761;586;14202;14995;4.17;0.25;415.60;25.60;1441;66;5150.00;793
12765;30;5754307;12765;580;14202;14995;4.12;0.25;415.67;25.60;1437;66;5151.00;793
12767;30;5754324;12767;581;14202;14995;4.08;0.25;415.67;25.60;1435;66;5152.00;793
12769;30;5754339;12769;596;14202;14995;4.05;0.25;415.71;25.60;1433;66;5153.00;793
12774;30;5754354;12774;596;14202;14996;3.98;0.24;415.82;25.60;1428;66;5154.00;794
12776;30;5754370;12776;607;14204;14998;3.96;0.24;415.86;25.60;1428;66;5155.00;794
12780;30;5754384;12780;609;14210;15004;3.92;0.24;415.98;25.64;1430;66;5156.00;794
12782;30;5754401;12782;612;14210;15005;3.92;0.24;415.95;25.64;1428;66;5157.00;795
12784;30;5754416;12784;625;14212;15005;3.88;0.24;416.04;25.69;1428;66;5158.00;793
12788;30;5754432;12788;626;14212;15005;3.83;0.23;416.03;25.69;1424;66;5159.00;793
12789;30;5754448;12789;629;14217;15010;3.82;0.23;416.15;25.71;1428;66;5160.00;793
12793;30;5754464;12793;634;14218;15010;3.79;0.23;416.14;25.73;1425;66;5161.00;792
12796;30;5754479;12796;634;14219;15010;3.78;0.23;416.19;25.76;1423;66;5162.00;791
12799;30;5754494;12799;629;14220;15011;3.79;0.23;416.13;25.75;1421;66;5163.00;791
12802;30;5754509;12802;630;14225;15015;3.82;0.23;416.36;25.80;1423;66;5164.00;790
12803;30;5754525;12803;625;14226;15015;3.85;0.23;416.47;25.82;1423;66;5165.00;789
12804;30;5754540;12804;637;14227;15018;3.88;0.24;416.58;25.82;1423;66;5166.00;791
12807;30;5754555;12807;638;14229;15018;3.89;0.24;416.58;25.86;1422;66;5167.00;789
12809;30;5754571;12809;647;14230;15018;3.91;0.24;416.71;25.89;1421;66;5168.00;788
12811;30;5754587;12811;645;14232;15018;3.92;0.24;416.85;25.93;1421;66;5169.00;786
12813;30;5754602;12813;646;14235;15022;3.92;0.24;416.85;25.93;1422;66;5170.00;787
12814;30;5754623;12814;635;14236;15022;3.91;0.24;416.88;25.95;1422;66;5171.00;786
12820;30;5754638;12820;629;14237;15022;3.87;0.24;416.91;25.97;1417;66;5172.00;785
12821;30;5754653;12821;628;14238;15022;3.84;0.23;416.88;25.99;1417;66;5173.00;784
12824;30;5754670;12824;624;14239;15023;3.85;0.23;416.91;26.02;1415;66;5174.00;784
12825;31;5754690;12825;617;14241;15025;3.84;0.23;416.92;26.04;1416;67;5175.00;784
12828;31;5754721;12828;619;14243;15025;3.81;0.23;416.90;26.08;1415;67;5176.00;782
12830;31;5754737;12830;620;14245;15026;3.82;0.23;416.86;26.10;1415;67;5177.00;781
12832;31;5754753;12832;617;14246;15026;3.86;0.23;416.92;26.13;1414;67;5178.00;780
12833;31;5754769;12833;613;14246;15026;3.90;0.24;416.94;26.13;1413;67;5179.00;780
12835;31;5754784;12835;602;14247;15026;3.90;0.24;417.09;26.15;1412;67;5180.00;779
12836;31;5754799;12836;606;14248;15026;3.91;0.24;417.10;26.17;1412;67;5181.00;778
12838;31;5754815;12838;603;14249;15026;3.93;0.24;417.12;26.19;1411;67;5182.00;777
12839;31;5754831;12839;601;14249;15026;3.95;0.24;417.26;26.19;1410;67;5183.00;777
12840;31;5754846;12840;623;14319;15153;4.18;0.26;417.32;26.09;1479;67;5184.00;834
12842;31;5754871;12842;609;14321;15154;4.14;0.25;417.44;26.11;1479;67;5185.00;833
12845;31;5754889;12845;602;14329;15154;4.19;0.26;417.51;26.12;1484;67;5186.00;825
12847;31;5754905;12847;593;14330;15154;4.24;0.26;417.55;26.14;1483;67;5187.00;824
12851;31;5754921;12851;587;14334;15154;4.27;0.26;417.58;26.13;1483;67;5188.00;820
12852;31;5754937;12852;586;14338;15154;4.25;0.26;417.55;26.17;1486;67;5189.00;816
12854;31;5754955;12854;593;14341;15154;4.27;0.26;417.52;26.19;1487;67;5190.00;813
12856;31;5754972;12856;603;14343;15154;4.25;0.26;417.47;26.19;1487;67;5191.00;811
12858;31;5754987;12858;603;14344;15155;4.23;0.26;417.45;26.18;1486;68;5192.00;811
12862;31;5755015;12862;609;14346;15156;4.21;0.26;417.49;26.20;1484;68;5193.00;810
12862;31;5755031;12862;615;14348;15156;4.21;0.26;417.49;26.20;1486;68;5194.00;808
12866;31;5755049;12866;620;14349;15157;4.16;0.25;417.44;26.20;1483;68;5195.00;808
12868;31;5755069;12868;627;14351;15157;4.12;0.25;417.50;26.22;1483;68;5196.00;806
12869;31;5755090;12869;638;14353;15157;4.04;0.25;417.49;26.24;1484;69;5197.00;804
12869;31;5755117;12869;640;14354;15157;4.01;0.25;417.49;26.24;1485;69;5198.00;803
12871;31;5755143;12871;646;14358;15161;3.99;0.24;417.51;26.23;1487;69;5199.00;803
12874;31;5755165;12874;647;14361;15161;3.95;0.24;417.49;26.27;1487;69;5200.00;800
12874;31;5755191;12874;649;14361;15161;3.90;0.24;417.49;26.27;1487;69;5201.00;800
12877;31;5755210;12877;653;14362;15164;3.87;0.24;417.48;26.27;1485;69;5202.00;802
12877;31;5755230;12877;654;14363;15164;3.83;0.23;417.48;26.29;1486;69;5203.00;801
12878;31;5755249;12878;671;14363;15164;3.84;0.23;417.46;26.29;1485;69;5204.00;801
12881;31;5755266;12881;665;14369;15168;3.83;0.23;417.41;26.34;1488;69;5205.00;799
12883;31;5755283;12883;659;14372;15169;3.83;0.23;417.36;26.38;1489;69;5206.00;797
12884;31;5755299;12884;653;14373;15169;3.86;0.24;417.33;26.40;1489;69;5207.00;796
12885;31;5755315;12885;646;14376;15173;3.87;0.24;417.34;26.42;1491;69;5208.00;797
12885;31;5755331;12885;638;14376;15173;3.89;0.24;417.34;26.42;1491;69;5209.00;797
12889;31;5755347;12889;629;14379;15173;3.91;0.24;417.29;26.48;1490;69;5210.00;794
12890;31;5755363;12890;628;14380;15174;3.94;0.24;417.29;26.50;1490;69;5211.00;794
12893;31;5755380;12893;609;14381;15174;4.01;0.24;417.33;26.52;1488;69;5212.00;793
12895;31;5755397;12895;595;14388;15180;4.09;0.25;417.30;26.55;1493;69;5213.00;792
12897;31;5755415;12897;584;14388;15180;4.19;0.25;417.27;26.55;1491;69;5214.00;792
12899;31;5755431;12899;576;14388;15180;4.23;0.26;417.23;26.55;1489;69;5215.00;792
12900;31;5755447;12900;569;14390;15181;4.32;0.26;417.32;26.59;1490;69;5216.00;791
12904;31;5755464;12904;567;14392;15181;4.37;0.26;417.39;26.63;1488;69;5217.00;789
12904;31;5755480;12904;557;14393;15181;4.44;0.27;417.39;26.65;1489;69;5218.00;788
12908;31;5755501;12908;547;14394;15181;4.43;0.27;417.36;26.67;1486;70;5219.00;787
12909;31;5755538;12909;548;14416;15217;4.53;0.28;417.34;26.77;1507;70;5220.00;801
12909;31;5755560;12909;542;14420;15217;4.57;0.28;417.34;26.80;1511;70;5221.00;797
12910;31;5755583;12910;545;14422;15217;4.60;0.28;417.32;26.82;1512;70;5222.00;795
12913;31;5755602;12913;548;14423;15217;4.64;0.28;417.30;26.84;1510;70;5223.00;794
12914;31;5755621;12914;549;14424;15217;4.63;0.28;417.27;26.84;1510;70;5224.00;793
12916;31;5755639;12916;537;14427;15217;4.63;0.28;417.36;26.90;1511;70;5225.00;790
12917;31;5755658;12917;547;14431;15221;4.62;0.28;417.34;26.89;1514;70;5226.00;790
12919;31;5755676;12919;542;14432;15221;4.64;0.28;417.45;26.91;1513;70;5227.00;789
12922;31;5755696;12922;547;14438;15225;4.61;0.28;417.40;26.94;1516;70;5228.00;787
12924;31;5755715;12924;548;14439;15226;4.57;0.28;417.41;27.07;1515;70;5229.00;787
12924;31;5755734;12924;549;14440;15226;4.55;0.28;417.41;27.09;1516;70;5230.00;786
12926;31;5755754;12926;555;14442;15226;4.50;0.27;417.36;27.11;1516;70;5231.00;784
12927;32;5755775;12927;553;14452;15239;4.47;0.27;417.46;27.09;1525;71;5232.00;787
12931;32;5755828;12931;541;14455;15239;4.42;0.27;417.51;27.12;1524;71;5233.00;784
12933;32;5755854;12933;550;14455;15239;4.39;0.27;417.49;27.12;1522;71;5234.00;784
12934;32;5755876;12934;558;14457;15240;4.39;0.27;417.49;27.14;1523;71;5235.00;783
12936;32;5755895;12936;559;14458;15241;4.34;0.26;417.57;27.15;1522;71;5236.00;783
12940;32;5755914;12940;559;14459;15241;4.28;0.26;417.58;27.17;1519;71;5237.00;782
12940;32;5755933;12940;559;14461;15244;4.27;0.26;417.58;27.19;1521;71;5238.00;783
12943;32;5755952;12943;559;14462;15244;4.27;0.26;417.63;27.20;1519;71;5239.00;782
12944;32;5755972;12944;557;14463;15244;4.31;0.26;417.70;27.22;1519;71;5240.00;781
12947;32;5755990;12947;566;14464;15244;4.33;0.26;417.69;27.24;1517;71;5241.00;780
12948;32;5756011;12948;576;14468;15250;4.39;0.27;417.69;27.23;1520;71;5242.00;782
12950;32;5756030;12950;580;14469;15250;4.38;0.27;417.77;27.36;1519;71;5243.00;781
12952;32;5756055;12952;570;14470;15250;4.33;0.26;417.86;27.38;1518;71;5244.00;780
12953;32;5756074;12953;576;14470;15250;4.33;0.26;417.84;27.38;1517;71;5245.00;780
12955;32;5756092;12955;594;14474;15254;4.33;0.26;417.94;27.51;1519;71;5246.00;780
12956;32;5756112;12956;593;14474;15255;4.33;0.26;418.04;27.51;1518;71;5247.00;781
12958;32;5756130;12958;598;14474;15255;4.30;0.26;418.11;27.51;1516;71;5248.00;781
12961;32;5756149;12961;597;14477;15256;4.31;0.26;418.07;27.78;1516;71;5249.00;779
12962;32;5756169;12962;592;14477;15256;4.28;0.26;418.19;27.78;1515;71;5250.00;779
12963;32;5756191;12963;591;14478;15256;4.29;0.26;418.16;27.91;1515;71;5251.00;778
12964;32;5756210;12964;591;14478;15256;4.27;0.26;418.26;27.91;1514;71;5252.00;778
12965;32;5756229;12965;596;14478;15256;4.26;0.26;418.29;27.91;1513;71;5253.00;778
12966;32;5756247;12966;596;14479;15256;4.25;0.26;418.32;28.05;1513;71;5254.00;777
12968;32;5756264;12968;602;14479;15256;4.21;0.26;418.37;28.05;1511;71;5255.00;777
12969;32;5756281;12969;617;14524;15326;4.26;0.26;418.35;28.23;1555;71;5256.00;802
12971;32;5756305;12971;611;14524;15327;4.26;0.26;418.38;28.23;1553;71;5257.00;803
12976;32;5756323;12976;615;14529;15327;4.21;0.26;418.51;28.22;1553;71;5258.00;798
12977;32;5756341;12977;616;14533;15327;4.22;0.26;418.49;28.21;1556;71;5259.00;794
12979;32;5756359;12979;614;14534;15327;4.21;0.26;418.49;28.21;1555;71;5260.00;793
12980;32;5756380;12980;613;14537;15327;4.20;0.26;418.52;28.61;1557;71;5261.00;790
12981;32;5756398;12981;618;14537;15327;4.21;0.26;418.57;28.61;1556;71;5262.00;790
12984;32;5756417;12984;620;14538;15327;4.22;0.26;418.55;28.61;1554;71;5263.00;789
12985;32;5756435;12985;623;14539;15328;4.24;0.26;418.52;28.60;1554;71;5264.00;789
12988;32;5756452;12988;617;14542;15330;4.22;0.26;418.60;28.87;1554;71;5265.00;788
12989;32;5756471;12989;611;14543;15330;4.20;0.26;418.64;29.00;1554;71;5266.00;787
12991;32;5756489;12991;613;14547;15334;4.19;0.26;418.77;28.99;1556;71;5267.00;787
12994;32;5756507;12994;605;14549;15334;4.15;0.25;418.72;29.26;1555;71;5268.00;785
12995;32;5756524;12995;611;14549;15334;4.17;0.25;418.74;29.26;1554;71;5269.00;785
12997;32;5756547;12997;616;14549;15334;4.13;0.25;418.84;29.26;1552;71;5270.00;785
13000;32;5756565;13000;623;14555;15340;4.13;0.25;418.82;29.52;1555;71;5271.00;785
13004;32;5756583;13004;631;14555;15340;4.09;0.25;419.04;29.52;1551;71;5272.00;785
13005;32;5756601;13005;642;14555;15340;4.07;0.25;419.06;29.52;1550;71;5273.00;785
13009;32;5756621;13009;638;14557;15343;4.06;0.25;419.05;29.65;1548;71;5274.00;786
13010;32;5756644;13010;643;14557;15343;4.06;0.25;419.06;29.65;1547;71;5275.00;786
13014;32;5756666;13014;647;14557;15343;4.03;0.24;419.18;29.65;1543;71;5276.00;786
13017;32;5756687;13017;653;14557;15344;3.99;0.24;419.21;29.65;1540;71;5277.00;787
13020;32;5756706;13020;653;14558;15345;3.95;0.24;419.23;29.64;1538;71;5278.00;787
13024;32;5756723;13024;654;14558;15345;3.91;0.24;419.23;29.64;1534;71;5279.00;787
13028;32;5756744;13028;653;14576;15371;3.91;0.24;419.24;29.61;1548;71;5280.00;795
13031;32;5756764;13031;645;14577;15371;3.87;0.23;419.34;29.60;1546;71;5281.00;794
13036;32;5756781;13036;646;14579;15371;3.83;0.23;419.33;29.60;1543;71;5282.00;792
13039;32;5756797;13039;644;14579;15372;3.84;0.23;419.38;29.60;1540;71;5283.00;793
13041;32;5756814;13041;643;14579;15372;3.82;0.23;419.37;29.60;1538;71;5284.00;793
13044;32;5756833;13044;645;14582;15376;3.82;0.23;419.38;29.60;1538;71;5285.00;794
13047;32;5756851;13047;639;14582;15376;3.85;0.23;419.36;29.60;1535;71;5286.00;794
13051;32;5756869;13051;644;14585;15379;3.82;0.23;419.43;29.59;1534;71;5287.00;794
13052;32;5756886;13052;637;14585;15380;3.83;0.23;419.42;29.59;1533;71;5288.00;795
13057;32;5756903;13057;640;14585;15380;3.81;0.23;419.44;29.59;1528;71;5289.00;795
13057;32;5756920;13057;643;14585;15380;3.84;0.23;419.44;29.59;1528;71;5290.00;795
13060;32;5756937;13060;639;14585;15380;3.86;0.23;419.41;29.59;1525;71;5291.00;795
13064;32;5756955;13064;635;14594;15392;3.91;0.24;419.42;29.57;1530;71;5292.00;798
13065;32;5756974;13065;638;14594;15392;3.95;0.24;419.41;29.57;1529;71;5293.00;798
13071;32;5756992;13071;640;14594;15392;3.92;0.24;419.47;29.57;1523;71;5294.00;798
13075;32;5757009;13075;641;14594;15392;3.89;0.24;419.55;29.57;1519;71;5295.00;798
13080;32;5757027;13080;647;14594;15392;3.84;0.23;419.56;29.57;1514;71;5296.00;798
13084;32;5757044;13084;652;14594;15392;3.78;0.23;419.59;29.57;1510;71;5297.00;798
13087;32;5757062;13087;664;14594;15393;3.75;0.23;419.72;29.57;1507;71;5298.00;799
13090;32;5757078;13090;668;14594;15393;3.70;0.23;419.74;29.57;1504;71;5299.00;799
13096;32;5757096;13096;678;14598;15399;3.64;0.22;419.87;29.56;1502;71;5300.00;801
13102;32;5757117;13102;686;14598;15400;3.61;0.22;419.87;29.56;1496;71;5301.00;802
13104;32;5757136;13104;689;14598;15400;3.58;0.22;419.92;29.56;1494;71;5302.00;802
13111;32;5757153;13111;688;14598;15400;3.54;0.22;419.96;29.56;1487;71;5303.00;802
13115;32;5757169;13115;686;14601;15404;3.54;0.22;419.95;29.56;1486;71;5304.00;803
13117;32;5757187;13117;692;14601;15404;3.55;0.22;419.94;29.56;1484;71;5305.00;803
13120;32;5757203;13120;685;14601;15404;3.55;0.22;420.05;29.56;1481;71;5306.00;803
13127;32;5757220;13127;684;14602;15405;3.52;0.22;420.10;29.56;1475;71;5307.00;803
13129;32;5757237;13129;685;14605;15409;3.51;0.21;420.06;29.55;1476;71;5308.00;804
13135;32;5757254;13135;685;14605;15409;3.44;0.21;420.22;29.55;1470;71;5309.00;804
13137;32;5757272;13137;686;14609;15415;3.40;0.21;420.20;29.54;1472;71;5310.00;806
13140;32;5757291;13140;680;14609;15415;3.36;0.20;420.30;29.54;1469;71;5311.00;806
13144;32;5757308;13144;690;14609;15415;3.33;0.20;420.29;29.54;1465;71;5312.00;806
13146;32;5757325;13146;697;14609;15415;3.27;0.20;420.29;29.54;1463;71;5313.00;806
13149;32;5757341;13149;702;14613;15419;3.22;0.20;420.30;29.56;1464;71;5314.00;806
13151;32;5757358;13151;711;14613;15419;3.19;0.20;420.42;29.56;1462;71;5315.00;806
13155;32;5757375;13155;712;14613;15419;3.15;0.19;420.50;29.56;1458;71;5316.00;806
13159;32;5757395;13159;711;14613;15419;3.17;0.19;420.46;29.56;1454;71;5317.00;806
13165;32;5757413;13165;716;14613;15420;3.14;0.19;420.49;29.56;1448;71;5318.00;807
13168;32;5757431;13168;717;14613;15421;3.17;0.19;420.43;29.56;1445;71;5319.00;808
13172;32;5757448;13172;724;14613;15421;3.19;0.20;420.53;29.56;1441;71;5320.00;808
13176;32;5757464;13176;731;14615;15422;3.20;0.20;420.69;29.58;1439;71;5321.00;807
13178;32;5757481;13178;729;14615;15422;3.23;0.20;420.79;29.58;1437;71;5322.00;807
13181;32;5757497;13181;737;14616;15422;3.22;0.20;420.82;29.60;1435;71;5323.00;806
13183;32;5757513;13183;747;14616;15422;3.22;0.20;420.82;29.60;1433;71;5324.00;806
13187;32;5757529;13187;748;14616;15422;3.21;0.20;420.82;29.60;1429;71;5325.00;806
13189;32;5757545;13189;760;14616;15422;3.18;0.19;420.82;29.60;1427;71;5326.00;806
13192;32;5757567;13192;768;14617;15422;3.12;0.19;420.95;29.62;1425;71;5327.00;805
13192;32;5757583;13192;779;14682;15549;3.50;0.22;420.95;29.52;1490;71;5328.00;867
13194;32;5757610;13194;769;14685;15550;3.52;0.22;421.08;29.51;1491;71;5329.00;865
13195;32;5757627;13195;765;14693;15550;3.58;0.22;421.13;29.52;1498;71;5330.00;857
13197;32;5757643;13197;767;14695;15550;3.57;0.22;421.10;29.54;1498;71;5331.00;855
13198;32;5757659;13198;764;14699;15550;3.61;0.22;421.08;29.53;1501;71;5332.00;851
13199;32;5757675;13199;763;14700;15550;3.61;0.22;421.05;29.53;1501;71;5333.00;850
13202;32;5757691;13202;769;14704;15550;3.63;0.23;421.01;29.57;1502;71;5334.00;846
13205;32;5757708;13205;771;14709;15550;3.65;0.23;421.02;29.61;1504;71;5335.00;841
13206;32;5757732;13206;759;14711;15551;3.66;0.23;421.01;29.60;1505;71;5336.00;840
13211;32;5757750;13211;742;14714;15552;3.59;0.22;420.90;29.64;1503;71;5337.00;838
13213;32;5757768;13213;738;14715;15552;3.54;0.22;420.86;29.64;1502;71;5338.00;837
13213;32;5757787;13213;725;14716;15553;3.56;0.22;420.86;29.64;1503;71;5339.00;837
13215;32;5757805;13215;724;14720;15553;3.59;0.22;420.81;29.68;1505;71;5340.00;833
13216;32;5757822;13216;724;14722;15553;3.62;0.22;420.78;29.70;1506;71;5341.00;831
13217;32;5757839;13217;726;14724;15553;3.63;0.22;420.79;29.72;1507;71;5342.00;829
13219;32;5757855;13219;729;14729;15557;3.68;0.23;420.79;29.73;1510;71;5343.00;828
13221;32;5757873;13221;727;14731;15557;3.72;0.23;420.87;29.75;1510;71;5344.00;826
13222;32;5757890;13222;721;14732;15557;3.72;0.23;420.89;29.74;1510;71;5345.00;825
13225;32;5757907;13225;731;14735;15560;3.76;0.23;420.82;29.78;1510;71;5346.00;825
13228;32;5757924;13228;725;14735;15560;3.78;0.23;420.88;29.78;1507;71;5347.00;825
13230;32;5757946;13230;734;14737;15560;3.76;0.23;420.86;29.82;1507;71;5348.00;823
13231;32;5757965;13231;733;14740;15564;3.78;0.23;420.87;29.81;1509;71;5349.00;824
13231;32;5757983;13231;734;14742;15565;3.84;0.23;420.87;29.83;1511;71;5350.00;823
13231;32;5758000;13231;730;14744;15565;3.88;0.24;420.87;29.87;1513;71;5351.00;821
13232;32;5758016;13232;739;14748;15569;3.92;0.24;420.84;29.88;1516;71;5352.00;821
13233;32;5758033;13233;747;14749;15569;3.97;0.24;420.81;29.90;1516;71;5353.00;820
13233;32;5758049;13233;745;14749;15569;4.01;0.25;420.81;29.90;1516;71;5354.00;820
13233;32;5758066;13233;750;14752;15571;4.04;0.25;420.81;29.94;1519;71;5355.00;819
13235;32;5758082;13235;740;14752;15571;4.08;0.25;420.78;29.94;1517;71;5356.00;819
13239;32;5758099;13239;734;14757;15577;4.08;0.25;420.75;29.95;1518;71;5357.00;820
13240;32;5758119;13240;744;14758;15577;4.05;0.25;420.75;29.97;1518;71;5358.00;819
13242;32;5758136;13242;732;14759;15577;4.03;0.25;420.71;29.99;1517;71;5359.00;818
13245;32;5758153;13245;722;14760;15578;4.01;0.24;420.78;30.01;1515;71;5360.00;818
13246;32;5758169;13246;718;14760;15578;3.97;0.24;420.77;30.01;1514;71;5361.00;818
13248;32;5758186;13248;713;14761;15578;3.94;0.24;420.73;30.03;1513;71;5362.00;817
13248;32;5758203;13248;704;14762;15578;3.97;0.24;420.73;30.05;1514;71;5363.00;816
13248;33;5758221;13248;699;14772;15590;4.03;0.25;420.73;30.05;1524;72;5364.00;818
13248;33;5758250;13248;690;14772;15590;4.06;0.25;420.73;30.05;1524;72;5365.00;818
13249;33;5758274;13249;690;14773;15590;4.10;0.25;420.77;30.07;1524;72;5366.00;817
13249;33;5758297;13249;681;14774;15590;4.15;0.25;420.77;30.09;1525;72;5367.00;816
13252;33;5758315;13252;687;14775;15590;4.18;0.25;420.80;30.11;1523;72;5368.00;815
13252;33;5758334;13252;688;14776;15590;4.22;0.26;420.80;30.13;1524;72;5369.00;814
13257;33;5758353;13257;684;14780;15594;4.25;0.26;420.87;30.14;1523;72;5370.00;814
13257;33;5758374;13257;672;14781;15594;4.30;0.26;420.87;30.16;1524;72;5371.00;813
13260;33;5758392;13260;672;14785;15598;4.32;0.26;420.84;30.17;1525;72;5372.00;813
13262;33;5758411;13262;660;14785;15599;4.35;0.26;420.83;30.17;1523;72;5373.00;814
13263;33;5758429;13263;648;14786;15599;4.40;0.27;420.84;30.19;1523;72;5374.00;813
13264;33;5758446;13264;641;14788;15599;4.39;0.27;420.81;30.24;1524;72;5375.00;811
13265;33;5758464;13265;630;14799;15612;4.43;0.27;420.84;30.23;1534;72;5376.00;813
13268;33;5758483;13268;622;14801;15612;4.42;0.27;420.83;30.27;1533;72;5377.00;811
13268;33;5758503;13268;622;14802;15612;4.48;0.27;420.83;30.29;1534;72;5378.00;810
13269;33;5758521;13269;618;14803;15613;4.51;0.27;420.84;30.29;1534;72;5379.00;810
13274;33;5758541;13274;612;14805;15614;4.50;0.27;420.91;30.32;1531;72;5380.00;809
13274;33;5758559;13274;603;14805;15614;4.52;0.27;420.91;30.32;1531;72;5381.00;809
13278;33;5758577;13278;598;14806;15617;4.54;0.28;421.11;30.32;1528;72;5382.00;811
13281;33;5758596;13281;596;14807;15617;4.54;0.28;421.09;30.34;1526;72;5383.00;810
13284;33;5758616;13284;592;14810;15617;4.54;0.28;421.11;30.39;1526;72;5384.00;807
13286;33;5758638;13286;589;14811;15617;4.56;0.28;421.09;30.53;1525;72;5385.00;806
13290;33;5758665;13290;581;14816;15623;4.57;0.28;421.14;30.66;1526;72;5386.00;807
13293;33;5758688;13293;588;14819;15623;4.60;0.28;421.12;30.71;1526;72;5387.00;804
13294;33;5758710;13294;584;14821;15623;4.58;0.28;421.25;30.74;1527;72;5388.00;802
13296;33;5758732;13296;593;14822;15623;4.55;0.28;421.25;30.76;1526;72;5389.00;801
13296;33;5758757;13296;584;14825;15627;4.58;0.28;421.25;30.75;1529;72;5390.00;802
13299;33;5758777;13299;581;14827;15628;4.55;0.28;421.27;30.78;1528;72;5391.00;801
13299;33;5758797;13299;579;14828;15628;4.55;0.28;421.27;30.80;1529;72;5392.00;800
13302;33;5758815;13302;581;14831;15629;4.55;0.28;421.42;30.83;1529;72;5393.00;798
13303;33;5758833;13303;588;14831;15629;4.54;0.28;421.39;30.83;1528;72;5394.00;798
13303;33;5758850;13303;587;14833;15629;4.54;0.28;421.39;30.87;1530;72;5395.00;796
13306;33;5758869;13306;603;14833;15629;4.50;0.27;421.50;30.87;1527;72;5396.00;796
13307;33;5758885;13307;598;14835;15629;4.49;0.27;421.48;30.90;1528;72;5397.00;794
13310;33;5758904;13310;605;14835;15629;4.45;0.27;421.56;30.90;1525;72;5398.00;794
13310;33;5758921;13310;607;14835;15629;4.44;0.27;421.56;30.90;1525;72;5399.00;794
