step_arrived;step_collisions;step_duration;step_ended;step_halting;step_inserted;step_loaded;step_meanSpeed;step_meanSpeedRelative;step_meanTravelTime;step_meanWaitingTime;step_running;step_teleports;step_time;step_waiting
0;0;628220784;0;1;82;245;16.53;1.18;-1.00;0.00;82;0;0.00;163
0;0;628220812;0;0;93;245;15.80;1.11;-1.00;0.12;93;0;1.00;152
0;0;628220813;0;2;115;245;15.06;1.03;-1.00;0.48;115;0;2.00;130
0;0;628220814;0;2;130;245;14.07;0.95;-1.00;0.77;130;0;3.00;115
0;0;628220816;0;1;142;245;13.12;0.88;-1.00;1.04;142;0;4.00;103
0;0;628220817;0;5;151;245;12.17;0.82;-1.00;1.28;151;0;5.00;94
0;0;628220819;0;6;162;245;11.08;0.74;-1.00;1.60;162;0;6.00;83
0;0;628220820;0;8;166;245;10.59;0.71;-1.00;1.73;166;0;7.00;79
0;0;628220822;0;14;175;246;9.87;0.66;-1.00;2.05;175;0;8.00;71
0;0;628220824;0;16;179;247;9.62;0.64;-1.00;2.21;179;0;9.00;68
0;0;628220826;0;17;185;247;9.47;0.63;-1.00;2.46;185;0;10.00;62
0;0;628220828;0;21;189;248;9.36;0.62;-1.00;2.59;189;0;11.00;59
1;0;628220830;1;24;194;248;9.32;0.61;12.00;2.83;193;0;12.00;54
1;0;628220832;1;29;200;248;9.22;0.60;12.00;3.13;199;0;13.00;48
1;0;628220835;1;35;206;248;9.11;0.59;12.00;3.45;205;0;14.00;42
1;0;628220837;1;36;209;252;9.15;0.59;12.00;3.55;208;0;15.00;43
1;0;628220840;1;39;214;252;9.18;0.59;12.00;3.81;213;0;16.00;38
1;0;628220843;1;41;219;252;9.03;0.58;12.00;4.05;218;0;17.00;33
1;0;628220846;1;47;223;255;9.13;0.58;12.00;4.15;222;0;18.00;32
2;0;628220849;2;52;227;255;9.24;0.59;15.50;4.35;225;0;19.00;28
3;0;628220851;3;55;227;255;9.43;0.60;17.00;4.35;224;0;20.00;28
3;0;628220854;3;61;237;259;9.55;0.60;17.00;4.72;234;0;21.00;22
4;0;628220858;4;64;239;260;9.56;0.60;18.25;4.77;235;0;22.00;21
4;0;628220861;4;64;241;260;9.71;0.61;18.25;4.93;237;0;23.00;19
6;0;628220864;6;68;246;264;9.62;0.60;19.83;5.04;240;0;24.00;18
6;0;628220868;6;72;250;264;9.51;0.59;19.83;5.27;244;0;25.00;14
6;0;628220871;6;78;254;264;9.46;0.59;19.83;5.56;248;0;26.00;10
6;0;628220874;6;79;256;265;9.44;0.59;19.83;5.66;250;0;27.00;9
6;0;628220877;6;83;257;265;9.49;0.59;19.83;5.64;251;0;28.00;8
6;0;628220880;6;85;263;271;9.38;0.58;19.83;5.64;257;0;29.00;8
6;0;628220886;6;89;263;271;9.34;0.58;19.83;5.64;257;0;30.00;8
8;0;628220889;8;92;266;272;9.08;0.56;22.25;5.62;258;0;31.00;6
8;0;628220893;8;96;267;272;8.87;0.55;22.25;5.72;259;0;32.00;5
8;0;628220896;8;98;267;272;8.79;0.54;22.25;5.72;259;0;33.00;5
9;0;628220899;9;103;267;272;8.69;0.54;23.11;5.72;258;0;34.00;5
9;0;628220903;9;109;267;272;8.76;0.54;23.11;5.72;258;0;35.00;5
10;0;628220906;10;112;279;284;9.04;0.56;23.80;5.47;269;0;36.00;5
10;0;628220910;10;116;279;284;8.95;0.55;23.80;5.47;269;0;37.00;5
10;0;628220914;10;120;279;284;8.86;0.55;23.80;5.47;269;0;38.00;5
12;0;628220918;12;122;279;284;8.65;0.53;26.08;5.47;267;0;39.00;5
12;0;628220921;12;124;279;284;8.52;0.53;26.08;5.47;267;0;40.00;5
13;0;628220924;13;127;279;284;8.34;0.52;27.08;5.47;266;0;41.00;5
14;0;628220927;14;130;283;288;8.27;0.51;27.79;5.41;269;0;42.00;5
15;0;628220932;15;132;283;288;8.08;0.50;27.40;5.41;268;0;43.00;5
17;0;628220935;17;136;286;292;7.95;0.49;28.88;5.36;269;0;44.00;6
18;0;628220939;18;137;288;294;7.79;0.48;29.44;5.32;270;0;45.00;6
18;0;628220942;18;140;289;294;7.72;0.48;29.44;5.31;271;0;46.00;5
18;0;628220945;18;140;289;294;7.63;0.47;29.44;5.31;271;0;47.00;5
18;0;628220948;18;141;300;307;7.86;0.49;29.44;5.12;282;0;48.00;7
19;0;628220952;19;142;300;307;7.82;0.49;30.47;5.12;281;0;49.00;7
19;0;628220956;19;144;300;307;7.68;0.48;30.47;5.12;281;0;50.00;7
19;0;628220958;19;143;301;308;7.68;0.48;30.47;5.11;282;0;51.00;7
19;0;628220962;19;146;302;309;7.65;0.47;30.47;5.09;283;0;52.00;7
19;0;628220965;19;149;302;309;7.59;0.47;30.47;5.09;283;0;53.00;7
21;0;628220970;21;152;304;312;7.52;0.46;30.95;5.06;283;0;54.00;8
22;0;628220974;22;155;304;312;7.38;0.45;31.05;5.06;282;0;55.00;8
22;0;628220985;22;144;305;312;7.37;0.45;31.05;5.05;283;0;56.00;7
24;0;628220989;24;139;305;312;7.31;0.45;33.04;5.05;281;0;57.00;7
26;0;628220993;26;139;310;318;7.26;0.45;33.96;4.98;284;0;58.00;8
27;0;628220996;27;139;310;318;7.22;0.44;34.89;4.98;283;0;59.00;8
28;0;628221005;28;138;311;318;7.31;0.45;35.71;4.98;283;0;60.00;7
28;0;628221011;28;142;311;318;7.46;0.46;35.71;4.98;283;0;61.00;7
29;0;628221017;29;144;315;322;7.58;0.47;36.62;4.93;286;0;62.00;7
29;0;628221022;29;147;316;323;7.77;0.48;36.62;4.91;287;0;63.00;7
30;0;628221027;30;146;316;323;7.95;0.49;37.40;4.91;286;0;64.00;7
30;0;628221032;30;146;317;324;8.06;0.50;37.40;4.90;287;0;65.00;7
31;0;628221035;31;147;317;324;8.03;0.49;36.97;4.90;286;0;66.00;7
32;0;628221039;32;139;317;324;8.07;0.50;37.91;4.90;285;0;67.00;7
35;0;628221043;35;136;317;324;8.06;0.49;39.74;4.90;282;0;68.00;7
35;0;628221052;35;134;317;324;8.15;0.50;39.74;4.90;282;0;69.00;7
36;0;628221055;36;130;317;324;8.18;0.50;40.39;4.90;281;0;70.00;7
36;0;628221058;36;127;317;324;8.31;0.51;40.39;4.90;281;0;71.00;7
36;1;628221061;36;133;353;394;8.38;0.51;40.39;4.40;317;1;72.00;41
36;1;628221084;36;123;354;395;8.61;0.53;40.39;4.39;318;1;73.00;41
36;1;628221088;36;117;359;395;9.02;0.55;40.39;4.36;323;1;74.00;36
36;1;628221099;36;112;361;395;9.30;0.57;40.39;4.35;325;1;75.00;34
36;1;628221102;36;107;364;395;9.66;0.59;40.39;4.35;328;1;76.00;31
37;1;628221112;37;105;367;395;9.81;0.60;41.38;4.35;330;1;77.00;28
38;1;628221116;38;106;369;395;9.89;0.60;42.34;4.36;331;1;78.00;26
39;1;628221119;39;109;372;395;9.88;0.60;43.28;4.38;333;1;79.00;23
41;1;628221123;41;107;373;396;9.80;0.59;44.54;4.39;332;1;80.00;23
41;2;628221127;41;109;376;397;9.89;0.60;44.54;4.40;335;2;81.00;21
42;2;628221138;42;111;378;397;9.93;0.60;45.43;4.43;336;2;82.00;19
42;2;628221147;42;117;383;401;9.94;0.60;45.43;4.42;341;2;83.00;18
43;2;628221160;43;117;385;401;10.04;0.61;46.33;4.44;342;2;84.00;16
43;2;628221163;43;119;385;401;9.99;0.61;46.33;4.44;342;2;85.00;16
43;2;628221167;43;118;385;401;9.89;0.60;46.33;4.44;342;2;86.00;16
43;2;628221171;43;119;389;407;9.79;0.59;46.33;4.40;346;2;87.00;18
43;2;628221175;43;121;389;407;9.72;0.59;46.33;4.40;346;2;88.00;18
44;2;628221179;44;125;390;407;9.70;0.59;47.07;4.40;346;2;89.00;17
47;2;628221185;47;126;393;413;9.63;0.58;49.81;4.36;346;2;90.00;20
48;2;628221190;48;130;394;413;9.64;0.59;50.54;4.36;346;2;91.00;19
49;2;628221194;49;133;394;413;9.53;0.58;51.39;4.36;345;2;92.00;19
53;2;628221198;53;134;396;414;9.45;0.58;53.09;4.34;343;2;93.00;18
53;2;628221202;53;133;398;415;9.57;0.58;53.09;4.33;345;2;94.00;17
56;2;628221206;56;131;398;415;9.51;0.58;55.34;4.33;342;2;95.00;17
59;2;628221210;59;133;409;428;9.38;0.57;57.34;4.22;350;2;96.00;19
64;2;628221215;64;132;409;428;9.42;0.57;60.31;4.22;345;2;97.00;19
64;2;628221220;64;133;409;428;9.50;0.58;60.31;4.22;345;2;98.00;19
65;2;628221224;65;132;410;429;9.53;0.58;60.91;4.21;345;2;99.00;19
65;2;628221229;65;129;410;429;9.52;0.58;60.91;4.21;345;2;100.00;19
65;2;628221237;65;126;412;433;9.51;0.58;60.91;4.19;347;2;101.00;21
66;2;628221242;66;121;413;433;9.63;0.59;61.21;4.19;347;2;102.00;20
67;2;628221246;67;118;417;437;9.47;0.58;61.82;4.16;350;2;103.00;20
67;2;628221257;67;110;417;437;9.57;0.58;61.82;4.16;350;2;104.00;20
67;2;628221261;67;105;417;437;9.73;0.59;61.82;4.16;350;2;105.00;20
67;2;628221266;67;99;417;437;9.85;0.60;61.82;4.16;350;2;106.00;20
68;2;628221271;68;93;417;437;9.88;0.60;62.46;4.16;349;2;107.00;20
68;2;628221275;68;86;427;449;10.02;0.61;62.46;4.06;359;2;108.00;22
69;2;628221281;69;80;428;449;10.12;0.62;63.13;4.05;359;2;109.00;21
69;2;628221286;69;83;429;449;10.31;0.63;63.13;4.05;360;2;110.00;20
69;2;628221291;69;76;429;449;10.43;0.64;63.13;4.05;360;2;111.00;20
69;2;628221296;69;75;429;449;10.64;0.65;63.13;4.05;360;2;112.00;20
70;2;628221302;70;74;429;449;10.83;0.66;63.80;4.05;359;2;113.00;20
70;2;628221307;70;75;430;450;10.96;0.67;63.80;4.04;360;2;114.00;20
73;2;628221313;73;72;430;450;11.07;0.68;65.22;4.04;357;2;115.00;20
75;2;628221318;75;71;434;456;11.21;0.68;66.53;4.01;359;2;116.00;22
75;2;628221325;75;73;437;457;11.40;0.70;66.53;4.26;362;2;117.00;20
76;2;628221331;76;72;437;457;11.34;0.69;67.05;4.26;361;2;118.00;20
77;2;628221336;77;72;437;457;11.34;0.69;67.73;4.26;360;2;119.00;20
77;2;628221344;77;75;442;462;11.41;0.70;67.73;4.48;365;2;120.00;20
78;2;628221350;78;78;444;462;11.45;0.70;68.40;4.68;366;2;121.00;18
80;2;628221356;80;81;445;462;11.49;0.70;69.55;4.94;365;2;122.00;17
81;2;628221362;81;84;448;463;11.60;0.71;70.14;5.14;367;2;123.00;15
84;2;628221368;84;82;453;467;11.41;0.70;71.82;5.37;369;2;124.00;14
84;2;628221375;84;86;453;467;11.35;0.69;71.82;5.37;369;2;125.00;14
86;2;628221381;86;90;458;470;11.36;0.69;73.02;5.82;372;2;126.00;12
87;2;628221387;87;91;459;470;11.47;0.70;73.37;5.81;372;2;127.00;11
87;2;628221394;87;93;462;470;11.47;0.70;73.37;6.16;375;2;128.00;8
87;2;628221405;87;99;462;470;11.54;0.70;73.37;6.16;375;2;129.00;8
91;2;628221411;91;97;466;474;11.57;0.70;75.12;6.35;375;2;130.00;8
94;2;628221418;94;98;467;474;11.53;0.70;76.80;6.37;373;2;131.00;7
96;2;628221424;96;96;470;474;11.54;0.70;77.75;6.47;374;2;132.00;4
96;2;628221431;96;96;471;474;11.53;0.70;77.75;6.58;375;2;133.00;3
99;2;628221438;99;97;472;475;11.51;0.70;78.56;6.57;373;2;134.00;3
101;2;628221444;101;99;474;477;11.53;0.70;78.60;6.54;373;2;135.00;3
101;2;628221451;101;102;475;477;11.46;0.70;78.60;6.61;374;2;136.00;2
103;2;628221457;103;103;476;478;11.48;0.70;79.31;6.60;373;2;137.00;2
105;2;628221463;105;106;477;478;11.41;0.70;79.74;6.68;372;2;138.00;1
106;2;628221471;106;108;477;478;11.40;0.70;80.30;6.68;371;2;139.00;1
108;2;628221480;108;108;477;478;11.38;0.70;81.27;6.68;369;2;140.00;1
110;2;628221491;110;110;478;478;11.43;0.70;81.83;6.71;368;2;141.00;0
111;2;628221500;111;112;478;478;11.45;0.70;82.24;6.71;367;2;142.00;0
111;2;628221511;111;114;478;478;11.52;0.71;82.24;6.71;367;2;143.00;0
112;2;628221521;112;132;551;605;11.15;0.70;82.15;5.82;439;2;144.00;54
112;2;628221549;112;126;558;606;11.07;0.70;82.15;5.76;446;2;145.00;48
114;2;628221564;114;123;565;606;11.01;0.69;83.24;5.72;451;2;146.00;41
115;2;628221573;115;124;570;606;10.98;0.69;82.96;5.69;455;2;147.00;36
117;2;628221583;117;124;576;606;10.94;0.69;83.96;5.68;459;2;148.00;30
119;2;628221592;119;123;579;606;10.96;0.69;84.29;5.67;460;2;149.00;27
121;2;628221604;121;126;582;611;10.98;0.69;85.21;5.66;461;2;150.00;29
121;2;628221614;121;123;585;611;11.02;0.69;85.21;5.67;464;2;151.00;26
123;2;628221621;123;121;588;612;11.09;0.69;85.97;5.68;465;2;152.00;24
124;2;628221629;124;122;590;613;11.14;0.69;86.48;5.69;466;2;153.00;23
127;2;628221638;127;123;594;613;11.13;0.69;86.75;5.72;467;2;154.00;19
128;2;628221646;128;125;598;614;11.03;0.69;87.00;5.74;470;2;155.00;16
129;2;628221654;129;127;600;614;10.92;0.68;87.53;5.75;471;2;156.00;14
132;2;628221665;132;131;601;614;10.82;0.67;87.58;5.76;469;2;157.00;13
133;2;628221672;133;136;604;614;10.79;0.67;88.03;5.79;471;2;158.00;10
134;2;628221679;134;138;606;618;10.77;0.67;88.38;5.78;472;2;159.00;12
134;2;628221687;134;141;608;618;10.71;0.66;88.38;5.81;474;2;160.00;10
135;2;628221695;135;142;609;618;10.60;0.66;88.81;5.83;474;2;161.00;9
137;2;628221702;137;142;611;621;10.45;0.65;89.31;5.84;474;2;162.00;10
140;2;628221709;140;142;612;621;10.30;0.64;90.40;5.85;472;2;163.00;9
141;2;628221722;141;142;613;621;10.27;0.64;90.89;5.86;472;2;164.00;8
142;2;628221728;142;148;617;625;10.19;0.63;91.41;5.83;475;2;165.00;8
143;2;628221735;143;144;618;626;10.12;0.63;90.92;5.82;475;2;166.00;8
145;2;628221742;145;138;618;626;10.04;0.62;91.10;5.82;473;2;167.00;8
148;2;628221748;148;143;624;630;9.87;0.61;92.47;5.81;476;2;168.00;6
149;2;628221754;149;145;625;630;9.66;0.60;92.95;5.83;476;2;169.00;5
153;2;628221760;153;138;625;630;9.56;0.59;93.40;5.83;472;2;170.00;5
155;2;628221767;155;138;629;631;9.40;0.58;94.04;5.88;474;2;171.00;2
156;2;628221773;156;135;629;631;9.34;0.58;94.37;5.88;473;2;172.00;2
160;2;628221780;160;131;633;637;9.40;0.58;96.04;5.85;473;2;173.00;4
161;2;628221787;161;131;634;637;9.44;0.58;96.39;5.86;473;2;174.00;3
162;2;628221794;162;131;636;638;9.59;0.59;96.85;5.85;474;2;175.00;2
163;2;628221801;163;130;637;638;9.68;0.59;97.19;5.88;474;2;176.00;1
163;2;628221807;163;122;638;638;9.76;0.60;97.19;5.88;475;2;177.00;0
163;2;628221814;163;120;638;638;9.87;0.61;97.19;5.88;475;2;178.00;0
165;2;628221820;165;123;638;638;9.93;0.61;96.97;5.88;473;2;179.00;0
165;2;628221828;165;126;670;672;9.97;0.62;96.97;5.60;505;2;180.00;2
165;2;628221837;165;118;671;672;10.06;0.62;96.97;5.59;506;2;181.00;1
167;2;628221843;167;118;671;672;10.07;0.62;97.46;5.59;504;2;182.00;1
168;2;628221850;168;120;672;672;10.10;0.62;97.24;5.59;504;2;183.00;0
168;2;628221856;168;126;672;672;10.06;0.62;97.24;5.59;504;2;184.00;0
169;2;628221863;169;131;672;672;10.03;0.62;97.34;5.59;503;2;185.00;0
171;2;628221869;171;132;676;676;10.09;0.62;98.37;5.56;505;2;186.00;0
173;2;628221877;173;137;676;676;10.00;0.62;98.76;5.56;503;2;187.00;0
173;2;628221884;173;140;679;680;10.13;0.62;98.76;5.54;506;2;188.00;1
175;2;628221890;175;148;680;681;10.05;0.62;98.91;5.53;505;2;189.00;1
177;2;628221896;177;155;681;681;9.95;0.61;98.96;5.53;504;2;190.00;0
179;2;628221903;179;164;681;681;9.87;0.61;98.84;5.53;502;2;191.00;0
182;2;628221910;182;168;694;694;9.80;0.60;99.18;5.42;512;2;192.00;0
184;2;628221917;184;168;694;694;9.64;0.59;99.35;5.42;510;2;193.00;0
189;2;628221924;189;173;694;694;9.46;0.58;100.29;5.42;505;2;194.00;0
191;2;628221931;191;179;695;695;9.31;0.57;99.81;5.42;504;2;195.00;0
193;2;628221945;193;185;696;696;9.09;0.56;100.05;5.41;503;2;196.00;0
196;2;628221952;196;194;696;696;8.86;0.55;100.15;5.41;500;2;197.00;0
198;2;628221964;198;196;698;699;8.77;0.54;99.68;5.40;500;2;198.00;1
201;2;628221972;201;198;699;699;8.62;0.53;99.49;5.39;498;2;199.00;0
204;2;628221979;204;201;699;699;8.44;0.52;98.97;5.39;495;2;200.00;0
208;2;628221990;208;204;699;699;8.28;0.51;98.70;5.39;491;2;201.00;0
210;2;628221996;210;207;704;705;8.14;0.50;98.07;5.36;494;2;202.00;1
212;2;628222004;212;207;704;705;8.04;0.49;99.03;5.36;492;2;203.00;1
213;2;628222017;213;215;705;705;7.99;0.49;99.44;5.35;492;2;204.00;0
216;2;628222023;216;220;705;705;7.86;0.48;99.05;5.35;489;2;205.00;0
217;2;628222030;217;226;709;709;7.76;0.48;99.18;5.33;492;2;206.00;0
219;2;628222037;219;228;710;710;7.69;0.47;100.11;5.32;491;2;207.00;0
221;2;628222044;221;232;710;710;7.61;0.47;101.03;5.32;489;2;208.00;0
221;2;628222049;221;236;711;711;7.56;0.46;101.03;5.32;490;2;209.00;0
222;2;628222058;222;244;711;711;7.49;0.46;101.51;5.32;489;2;210.00;0
223;2;628222064;223;248;711;711;7.41;0.45;101.76;5.32;488;2;211.00;0
226;2;628222071;226;254;711;711;7.34;0.45;101.58;5.32;485;2;212.00;0
228;2;628222077;228;257;711;711;7.29;0.45;101.08;5.32;483;2;213.00;0
229;2;628222083;229;261;711;711;7.28;0.45;101.57;5.32;482;2;214.00;0
230;2;628222091;230;264;711;711;7.22;0.44;101.88;5.32;481;2;215.00;0
230;2;628222097;230;278;755;781;7.43;0.46;101.88;5.01;525;2;216.00;26
231;2;628222109;231;264;758;782;7.46;0.46;102.11;4.99;527;2;217.00;24
232;2;628222116;232;257;764;782;7.59;0.47;102.45;4.97;532;2;218.00;18
232;2;628222122;232;236;767;782;7.73;0.48;102.45;4.96;535;2;219.00;15
233;2;628222129;233;220;770;782;7.84;0.48;102.94;4.96;537;2;220.00;12
234;2;628222135;234;212;772;782;8.01;0.49;103.42;4.96;538;2;221.00;10
235;2;628222142;235;200;774;782;8.23;0.51;103.31;4.96;539;2;222.00;8
235;2;628222149;235;194;777;782;8.47;0.52;103.31;4.97;542;2;223.00;5
235;2;628222158;235;187;779;783;8.62;0.53;103.31;4.97;544;2;224.00;4
236;2;628222174;236;183;784;785;8.77;0.54;103.82;4.97;548;2;225.00;1
237;2;628222188;237;168;785;785;8.86;0.54;104.32;4.97;548;2;226.00;0
237;2;628222197;237;158;789;789;8.93;0.55;104.32;4.95;552;2;227.00;0
239;2;628222213;239;149;789;789;9.05;0.56;105.00;4.95;550;2;228.00;0
239;2;628222233;239;140;789;789;9.27;0.57;105.00;4.95;550;2;229.00;0
241;2;628222242;241;136;789;789;9.40;0.58;104.59;4.95;548;2;230.00;0
242;2;628222257;242;132;794;795;9.60;0.59;104.38;4.93;552;2;231.00;1
244;2;628222266;244;123;794;795;9.80;0.60;104.97;4.93;550;2;232.00;1
246;2;628222274;246;110;795;795;10.06;0.62;105.79;4.93;549;2;233.00;0
250;2;628222283;250;102;797;798;10.35;0.63;106.97;4.91;547;2;234.00;1
254;2;628222292;254;99;798;798;10.58;0.65;108.35;4.91;544;2;235.00;0
256;2;628222300;256;93;798;798;10.79;0.66;108.78;4.91;542;2;236.00;0
257;2;628222309;257;93;799;799;10.96;0.67;109.24;4.90;542;2;237.00;0
260;2;628222317;260;91;800;800;11.15;0.68;109.17;4.90;540;2;238.00;0
260;2;628222325;260;90;800;800;11.28;0.69;109.17;4.90;540;2;239.00;0
263;2;628222334;263;96;823;826;11.14;0.68;110.57;4.76;560;2;240.00;3
265;2;628222344;265;91;823;826;11.26;0.69;110.58;4.76;558;2;241.00;3
267;2;628222353;267;89;824;826;11.44;0.69;110.91;4.76;557;2;242.00;2
268;3;628222360;268;90;826;827;11.54;0.70;110.87;4.75;558;3;243.00;1
270;3;628222380;270;88;827;827;11.63;0.71;111.06;4.75;557;3;244.00;0
273;3;628222390;273;90;830;831;11.75;0.71;112.21;4.74;557;3;245.00;1
277;3;628222398;277;94;830;831;11.85;0.72;113.18;4.74;553;3;246.00;1
279;4;628222406;279;95;835;835;11.86;0.72;114.14;4.72;556;4;247.00;0
282;4;628222426;282;98;835;835;11.94;0.72;114.95;4.72;553;4;248.00;0
286;4;628222434;286;99;835;835;11.99;0.73;115.74;4.72;549;4;249.00;0
288;4;628222447;288;102;835;835;12.09;0.73;116.18;4.72;547;4;250.00;0
291;4;628222455;291;98;835;835;12.15;0.74;116.57;4.72;544;4;251.00;0
292;4;628222463;292;101;846;847;12.18;0.74;116.79;4.66;554;4;252.00;1
293;4;628222474;293;103;846;847;12.20;0.74;116.76;4.66;553;4;253.00;1
295;4;628222483;295;102;847;847;12.18;0.74;116.91;4.65;552;4;254.00;0
297;4;628222492;297;103;847;847;12.21;0.74;117.43;4.65;550;4;255.00;0
300;4;628222500;300;104;847;847;12.24;0.74;117.53;4.65;547;4;256.00;0
303;4;628222508;303;107;847;847;12.27;0.74;118.26;4.65;544;4;257.00;0
304;4;628222516;304;109;848;848;12.31;0.75;118.69;4.65;544;4;258.00;0
307;4;628222524;307;111;848;848;12.31;0.75;118.82;4.65;541;4;259.00;0
309;4;628222537;309;111;853;854;12.26;0.74;118.69;4.63;544;4;260.00;1
310;5;628222545;310;109;854;855;12.26;0.74;118.68;4.62;544;5;261.00;1
313;5;628222564;313;111;855;855;12.34;0.75;119.06;4.62;542;5;262.00;0
313;5;628222573;313;113;855;855;12.29;0.74;119.06;4.62;542;5;263.00;0
314;5;628222580;314;114;859;859;12.31;0.75;118.95;4.60;545;5;264.00;0
316;5;628222588;316;115;859;859;12.30;0.75;119.35;4.60;543;5;265.00;0
317;5;628222595;317;117;859;859;12.30;0.75;119.36;4.60;542;5;266.00;0
322;5;628222602;322;119;860;860;12.28;0.74;120.22;4.59;538;5;267.00;0
323;5;628222610;323;123;864;864;12.27;0.75;120.46;4.58;541;5;268.00;0
329;5;628222617;329;122;864;864;12.21;0.74;121.10;4.58;535;5;269.00;0
332;5;628222627;332;119;867;870;12.28;0.74;121.96;4.56;535;5;270.00;3
336;5;628222635;336;116;868;870;12.22;0.74;123.30;4.56;532;5;271.00;2
338;5;628222642;338;110;868;870;12.25;0.74;123.58;4.56;530;5;272.00;2
342;5;628222650;342;108;869;870;12.28;0.74;124.05;4.56;527;5;273.00;1
343;5;628222656;343;104;871;874;12.34;0.75;124.24;4.55;528;5;274.00;3
345;5;628222664;345;101;872;874;12.45;0.76;124.48;4.55;527;5;275.00;2
348;5;628222672;348;98;873;874;12.63;0.77;124.55;4.55;525;5;276.00;1
349;5;628222679;349;94;873;874;12.76;0.77;124.71;4.55;524;5;277.00;1
352;5;628222687;352;89;875;875;12.84;0.78;125.27;4.54;523;5;278.00;0
353;5;628222694;353;82;876;876;12.94;0.78;125.60;4.54;523;5;279.00;0
355;5;628222702;355;79;876;876;12.95;0.79;125.64;4.54;521;5;280.00;0
358;5;628222710;358;76;877;877;12.93;0.78;125.84;4.53;519;5;281.00;0
359;5;628222718;359;74;877;877;12.94;0.79;125.67;4.53;518;5;282.00;0
360;5;628222730;360;75;877;877;13.05;0.80;125.41;4.53;517;5;283.00;0
362;5;628222739;362;74;877;877;13.07;0.80;125.48;4.53;515;5;284.00;0
365;5;628222746;365;79;877;877;13.17;0.80;125.68;4.53;512;5;285.00;0
365;5;628222754;365;78;877;877;13.17;0.80;125.68;4.53;512;5;286.00;0
366;5;628222761;366;77;877;877;13.14;0.80;125.87;4.53;511;5;287.00;0
366;5;628222769;366;100;945;1004;12.48;0.77;125.87;4.21;579;5;288.00;59
367;5;628222787;367;89;950;1005;12.38;0.77;126.10;4.19;583;5;289.00;55
368;5;628222796;368;87;957;1005;12.38;0.77;126.15;4.18;589;5;290.00;48
369;5;628222805;369;91;961;1005;12.42;0.77;126.30;4.17;592;5;291.00;44
372;5;628222814;372;91;966;1005;12.45;0.77;127.11;4.17;594;5;292.00;39
376;5;628222822;376;93;971;1005;12.46;0.77;127.58;4.18;595;5;293.00;34
376;5;628222831;376;93;975;1005;12.42;0.77;127.58;4.18;599;5;294.00;30
377;6;628222839;377;95;980;1005;12.41;0.77;127.84;4.20;603;6;295.00;25
380;6;628222857;380;98;984;1006;12.47;0.77;129.05;4.21;604;6;296.00;22
382;6;628222866;382;100;988;1007;12.38;0.76;128.55;4.23;606;6;297.00;19
384;7;628222875;384;105;990;1007;12.31;0.76;128.06;4.24;606;7;298.00;17
384;7;628222895;384;104;991;1008;12.16;0.75;128.06;4.24;607;7;299.00;17
385;7;628222905;385;113;994;1014;12.00;0.74;128.22;4.27;609;7;300.00;20
389;7;628222919;389;116;995;1014;11.74;0.73;128.63;4.28;606;7;301.00;19
390;7;628222933;390;125;999;1014;11.53;0.71;129.00;4.30;609;7;302.00;15
394;7;628222942;394;135;1002;1018;11.43;0.71;129.03;4.31;608;7;303.00;16
398;7;628222951;398;143;1003;1018;11.35;0.70;130.06;4.32;605;7;304.00;15
400;7;628222959;400;149;1004;1018;11.27;0.70;130.26;4.33;604;7;305.00;14
404;7;628222969;404;161;1008;1021;11.13;0.69;131.68;4.36;604;7;306.00;13
405;7;628222983;405;169;1010;1021;11.00;0.68;131.52;4.36;605;7;307.00;11
407;7;628222991;407;176;1012;1021;10.77;0.66;131.78;4.37;605;7;308.00;9
412;7;628222999;412;179;1015;1025;10.44;0.64;132.43;4.36;603;7;309.00;10
415;7;628223013;415;183;1016;1026;10.23;0.63;131.82;4.35;601;7;310.00;10
416;7;628223027;416;188;1016;1026;10.09;0.62;132.15;4.35;600;7;311.00;10
419;7;628223035;419;200;1020;1030;9.93;0.61;132.36;4.34;601;7;312.00;10
419;7;628223043;419;202;1020;1030;9.90;0.61;132.36;4.34;601;7;313.00;10
421;7;628223051;421;212;1022;1030;9.83;0.61;132.79;4.36;601;7;314.00;8
421;7;628223059;421;210;1024;1032;9.76;0.61;132.79;4.35;603;7;315.00;8
423;7;628223066;423;214;1024;1032;9.63;0.60;133.18;4.35;601;7;316.00;8
426;7;628223074;426;218;1028;1038;9.46;0.59;133.71;4.33;602;7;317.00;10
427;7;628223082;427;223;1028;1038;9.30;0.58;133.74;4.33;601;7;318.00;10
433;7;628223089;433;215;1029;1039;9.15;0.57;134.44;4.33;596;7;319.00;10
436;7;628223097;436;219;1031;1039;9.08;0.56;134.93;4.37;595;7;320.00;8
440;7;628223105;440;215;1032;1039;9.08;0.56;134.97;4.38;592;7;321.00;7
442;7;628223112;442;212;1033;1039;9.07;0.56;135.12;4.40;591;7;322.00;6
447;7;628223120;447;214;1035;1039;9.00;0.55;135.17;4.44;588;7;323.00;4
449;7;628223132;449;221;1048;1051;9.01;0.55;135.71;4.41;599;7;324.00;3
449;7;628223141;449;221;1049;1051;8.98;0.55;135.71;4.44;600;7;325.00;2
453;7;628223148;453;221;1050;1051;8.96;0.55;135.87;4.45;597;7;326.00;1
457;7;628223157;457;219;1051;1051;8.96;0.55;136.82;4.45;594;7;327.00;0
460;7;628223164;460;217;1051;1051;8.98;0.55;136.88;4.45;591;7;328.00;0
462;7;628223172;462;226;1051;1051;9.01;0.55;136.91;4.45;589;7;329.00;0
463;7;628223180;463;225;1055;1055;9.03;0.55;136.86;4.43;592;7;330.00;0
464;7;628223188;464;226;1055;1055;8.99;0.55;136.81;4.43;591;7;331.00;0
465;7;628223194;465;228;1058;1059;9.02;0.55;136.86;4.42;593;7;332.00;1
468;7;628223202;468;229;1059;1060;8.97;0.55;138.10;4.42;591;7;333.00;1
469;7;628223209;469;227;1060;1060;8.85;0.54;138.21;4.42;591;7;334.00;0
473;7;628223216;473;228;1060;1060;8.67;0.53;138.68;4.42;587;7;335.00;0
476;7;628223223;476;236;1073;1073;8.49;0.52;139.35;4.37;597;7;336.00;0
480;7;628223231;480;236;1073;1073;8.32;0.51;139.40;4.37;593;7;337.00;0
484;7;628223238;484;241;1073;1073;8.10;0.50;140.55;4.37;589;7;338.00;0
486;7;628223244;486;245;1074;1074;7.88;0.48;140.95;4.36;588;7;339.00;0
492;7;628223250;492;244;1075;1075;7.69;0.47;142.40;4.36;583;7;340.00;0
495;7;628223257;495;242;1075;1075;7.55;0.46;143.08;4.36;580;7;341.00;0
499;7;628223263;499;242;1077;1078;7.37;0.45;143.44;4.35;578;7;342.00;1
500;7;628223269;500;244;1078;1078;7.38;0.45;143.84;4.35;578;7;343.00;0
502;7;628223275;502;245;1078;1078;7.36;0.45;144.11;4.35;576;7;344.00;0
504;7;628223282;504;247;1078;1078;7.29;0.45;144.81;4.35;574;7;345.00;0
511;7;628223288;511;240;1083;1084;7.31;0.45;144.88;4.33;572;7;346.00;1
513;7;628223295;513;233;1083;1084;7.29;0.45;145.50;4.33;570;7;347.00;1
514;7;628223301;514;232;1084;1084;7.29;0.45;145.86;4.33;570;7;348.00;0
517;7;628223308;517;232;1084;1084;7.27;0.45;146.33;4.33;567;7;349.00;0
519;7;628223316;519;234;1088;1088;7.24;0.45;145.93;4.32;569;7;350.00;0
520;7;628223329;520;233;1089;1089;7.33;0.45;145.91;4.31;569;7;351.00;0
525;7;628223337;525;231;1089;1089;7.31;0.45;145.46;4.31;564;7;352.00;0
527;7;628223345;527;233;1090;1090;7.37;0.45;145.41;4.31;563;7;353.00;0
527;7;628223358;527;233;1090;1090;7.44;0.46;145.41;4.31;563;7;354.00;0
531;7;628223365;531;241;1090;1090;7.40;0.45;145.09;4.31;559;7;355.00;0
538;7;628223371;538;235;1090;1090;7.40;0.45;144.78;4.31;552;7;356.00;0
540;7;628223379;540;233;1090;1090;7.40;0.45;144.59;4.31;550;7;357.00;0
541;7;628223385;541;236;1090;1090;7.38;0.45;144.45;4.31;549;7;358.00;0
542;7;628223392;542;242;1090;1090;7.37;0.45;144.44;4.31;548;7;359.00;0
543;7;628223400;543;255;1159;1215;7.76;0.48;144.31;4.06;616;7;360.00;56
544;7;628223417;544;253;1164;1216;7.79;0.49;144.24;4.04;620;7;361.00;52
545;8;628223424;545;249;1176;1216;7.94;0.49;144.28;4.02;631;8;362.00;40
546;8;628223448;546;239;1184;1216;7.99;0.50;144.15;4.01;638;8;363.00;32
546;8;628223456;546;235;1190;1216;7.98;0.50;144.15;4.01;644;8;364.00;26
547;8;628223463;547;238;1195;1216;7.97;0.50;144.38;4.02;648;8;365.00;21
548;8;628223471;548;239;1200;1216;7.99;0.50;144.65;4.03;652;8;366.00;16
548;8;628223479;548;243;1201;1216;7.92;0.49;144.65;4.03;653;8;367.00;15
550;8;628223492;550;245;1206;1217;7.81;0.48;144.80;4.04;656;8;368.00;11
554;8;628223505;554;255;1206;1218;7.65;0.47;144.71;4.04;652;8;369.00;12
559;8;628223520;559;264;1207;1218;7.50;0.46;144.98;4.04;648;8;370.00;11
563;8;628223543;563;259;1214;1222;7.34;0.45;145.23;4.04;651;8;371.00;8
565;8;628223565;565;250;1215;1222;7.29;0.45;145.33;4.05;650;8;372.00;7
567;8;628223577;567;245;1215;1222;7.31;0.45;145.32;4.05;648;8;373.00;7
567;8;628223590;567;244;1217;1222;7.36;0.45;145.32;4.07;650;8;374.00;5
568;8;628223602;568;241;1222;1228;7.40;0.45;145.30;4.07;654;8;375.00;6
569;8;628223613;569;242;1223;1228;7.50;0.46;145.28;4.08;654;8;376.00;5
569;8;628223623;569;237;1224;1228;7.64;0.47;145.28;4.09;655;8;377.00;4
570;8;628223633;570;236;1226;1231;7.80;0.48;145.19;4.08;656;8;378.00;5
571;8;628223642;571;236;1227;1231;7.96;0.49;145.28;4.08;656;8;379.00;4
571;9;628223652;571;237;1229;1231;8.08;0.49;145.28;4.10;658;9;380.00;2
572;9;628223674;572;234;1230;1232;8.21;0.50;145.11;4.09;658;9;381.00;2
574;9;628223683;574;233;1233;1233;8.26;0.50;145.17;4.10;659;9;382.00;0
575;9;628223700;575;231;1233;1233;8.29;0.51;145.08;4.10;658;9;383.00;0
576;9;628223716;576;233;1245;1246;8.46;0.52;145.10;4.07;669;9;384.00;1
577;9;628223726;577;231;1245;1246;8.55;0.52;145.01;4.07;668;9;385.00;1
580;9;628223735;580;222;1246;1246;8.62;0.52;144.96;4.06;666;9;386.00;0
583;9;628223744;583;210;1247;1247;8.62;0.52;144.67;4.06;664;9;387.00;0
584;9;628223754;584;206;1247;1247;8.75;0.53;144.84;4.06;663;9;388.00;0
585;9;628223765;585;199;1251;1251;8.85;0.54;144.92;4.05;666;9;389.00;0
586;9;628223777;586;194;1251;1251;8.96;0.54;144.73;4.05;665;9;390.00;0
586;9;628223787;586;187;1255;1255;9.09;0.55;144.73;4.04;669;9;391.00;0
588;9;628223797;588;187;1255;1255;9.19;0.56;145.11;4.04;667;9;392.00;0
592;9;628223806;592;185;1255;1255;9.34;0.57;145.74;4.04;663;9;393.00;0
594;9;628223817;594;184;1255;1255;9.50;0.58;145.87;4.04;661;9;394.00;0
595;9;628223827;595;179;1255;1255;9.63;0.59;145.81;4.04;660;9;395.00;0
597;9;628223838;597;163;1266;1267;9.79;0.60;146.38;4.01;669;9;396.00;1
600;9;628223849;600;148;1267;1267;10.05;0.61;146.61;4.00;667;9;397.00;0
602;9;628223859;602;135;1267;1267;10.26;0.62;146.61;4.00;665;9;398.00;0
604;9;628223870;604;124;1267;1267;10.51;0.64;147.08;4.00;663;9;399.00;0
608;9;628223881;608;118;1267;1267;10.72;0.65;147.17;4.00;659;9;400.00;0
610;9;628223897;610;110;1267;1267;10.96;0.67;147.82;4.00;657;9;401.00;0
612;9;628223908;612;104;1268;1268;11.13;0.68;147.82;4.00;656;9;402.00;0
614;9;628223918;614;101;1268;1268;11.40;0.70;148.07;4.00;654;9;403.00;0
617;9;628223929;617;98;1273;1274;11.63;0.71;148.35;3.99;656;9;404.00;1
620;9;628223941;620;92;1276;1276;11.83;0.72;148.74;3.98;656;9;405.00;0
623;9;628223953;623;90;1276;1276;11.97;0.73;149.03;3.98;653;9;406.00;0
626;9;628223963;626;87;1276;1276;12.09;0.74;149.38;3.98;650;9;407.00;0
629;10;628223977;629;87;1280;1280;12.18;0.74;150.17;3.97;651;10;408.00;0
634;10;628223996;634;88;1280;1280;12.26;0.75;150.99;3.97;646;10;409.00;0
635;10;628224010;635;90;1280;1280;12.30;0.75;151.37;3.97;645;10;410.00;0
638;10;628224027;638;90;1281;1281;12.33;0.75;152.15;3.97;643;10;411.00;0
640;10;628224038;640;95;1285;1285;12.32;0.75;152.61;3.96;645;10;412.00;0
643;10;628224050;643;95;1285;1285;12.37;0.75;153.12;3.96;642;10;413.00;0
648;10;628224061;648;93;1287;1288;12.46;0.76;153.96;3.95;639;10;414.00;1
649;11;628224073;649;90;1287;1288;12.62;0.77;154.09;3.95;638;11;415.00;1
652;11;628224095;652;90;1288;1288;12.74;0.78;154.23;3.95;636;11;416.00;0
656;11;628224106;656;94;1288;1288;12.75;0.78;154.45;3.95;632;11;417.00;0
659;11;628224116;659;92;1291;1292;12.76;0.78;154.64;3.94;632;11;418.00;1
663;11;628224127;663;93;1291;1292;12.74;0.78;155.68;3.94;628;11;419.00;1
665;11;628224139;665;94;1292;1292;12.79;0.78;155.98;3.94;627;11;420.00;0
667;11;628224155;667;96;1292;1292;12.87;0.79;156.54;3.94;625;11;421.00;0
670;11;628224165;670;98;1293;1293;12.89;0.79;157.09;3.94;623;11;422.00;0
673;11;628224175;673;99;1294;1294;12.88;0.79;157.33;3.94;621;11;423.00;0
675;11;628224186;675;95;1294;1294;12.88;0.79;157.86;3.94;619;11;424.00;0
677;11;628224195;677;95;1295;1295;12.89;0.79;158.12;3.93;618;11;425.00;0
679;11;628224205;679;97;1295;1295;12.82;0.79;158.34;3.93;616;11;426.00;0
684;11;628224215;684;98;1295;1295;12.83;0.79;158.68;3.93;611;11;427.00;0
688;11;628224225;688;101;1295;1295;12.92;0.79;158.98;3.93;607;11;428.00;0
695;11;628224234;695;98;1295;1295;12.99;0.79;159.45;3.93;600;11;429.00;0
698;11;628224244;698;96;1295;1295;13.00;0.79;159.66;3.93;597;11;430.00;0
702;11;628224254;702;97;1295;1295;13.04;0.79;159.86;3.93;593;11;431.00;0
703;11;628224264;703;130;1374;1422;12.24;0.76;160.04;3.71;671;11;432.00;48
710;11;628224297;710;117;1374;1423;12.26;0.75;160.84;3.71;664;11;433.00;49
714;11;628224307;714;106;1379;1423;12.46;0.77;161.41;3.70;665;11;434.00;44
716;11;628224318;716;103;1383;1423;12.54;0.77;161.44;3.70;667;11;435.00;40
718;11;628224329;718;101;1388;1423;12.65;0.78;161.69;3.70;670;11;436.00;35
721;11;628224339;721;99;1391;1423;12.73;0.78;161.96;3.71;670;11;437.00;32
725;11;628224348;725;105;1395;1423;12.74;0.78;161.84;3.71;670;11;438.00;28
729;12;628224358;729;109;1398;1423;12.73;0.78;162.33;3.72;669;12;439.00;25
730;12;628224383;730;113;1401;1424;12.73;0.78;162.32;3.73;671;12;440.00;23
733;13;628224394;733;109;1405;1425;12.76;0.78;162.41;3.74;672;13;441.00;20
737;13;628224411;737;108;1408;1425;12.81;0.78;162.68;3.76;671;13;442.00;17
741;13;628224421;741;104;1411;1426;12.82;0.78;162.99;3.77;670;13;443.00;15
746;13;628224432;746;102;1413;1426;12.73;0.78;163.29;3.78;667;13;444.00;13
749;13;628224442;749;103;1416;1426;12.54;0.77;163.52;3.79;667;13;445.00;10
752;13;628224453;752;102;1418;1426;12.42;0.76;163.85;3.81;666;13;446.00;8
753;13;628224477;753;103;1420;1430;12.30;0.75;164.02;3.81;667;13;447.00;10
755;13;628224493;755;107;1421;1430;12.25;0.75;163.95;3.82;666;13;448.00;9
756;13;628224504;756;110;1422;1430;12.27;0.75;163.88;3.82;666;13;449.00;8
760;13;628224525;760;111;1426;1436;12.31;0.75;164.11;3.82;666;13;450.00;10
763;13;628224537;763;113;1426;1436;12.42;0.76;164.39;3.82;663;13;451.00;10
765;13;628224546;765;114;1427;1436;12.48;0.76;164.39;3.82;662;13;452.00;9
769;13;628224556;769;112;1430;1440;12.47;0.76;164.92;3.81;661;13;453.00;10
771;13;628224566;771;113;1432;1441;12.58;0.77;164.64;3.81;661;13;454.00;9
774;13;628224576;774;115;1433;1441;12.59;0.77;164.73;3.81;659;13;455.00;8
777;13;628224586;777;120;1436;1445;12.59;0.77;164.76;3.81;659;13;456.00;9
780;13;628224596;780;121;1437;1445;12.58;0.77;164.71;3.82;657;13;457.00;8
783;13;628224606;783;123;1437;1445;12.57;0.77;164.74;3.82;654;13;458.00;8
784;13;628224616;784;128;1438;1446;12.61;0.77;165.02;3.82;654;13;459.00;8
787;13;628224625;787;130;1441;1446;12.53;0.76;164.86;3.86;654;13;460.00;5
787;13;628224635;787;135;1444;1452;12.54;0.76;164.86;3.85;657;13;461.00;8
789;14;628224646;789;134;1444;1452;12.36;0.75;164.98;3.85;655;14;462.00;8
790;15;628224665;790;135;1447;1453;12.17;0.74;164.81;3.87;657;15;463.00;6
793;15;628224684;793;139;1447;1453;12.03;0.73;164.74;3.87;654;15;464.00;6
795;15;628224698;795;139;1447;1453;11.96;0.73;164.71;3.87;652;15;465.00;6
797;15;628224707;797;141;1448;1453;11.82;0.72;164.62;3.88;651;15;466.00;5
800;15;628224716;800;142;1448;1453;11.75;0.72;165.16;3.88;648;15;467.00;5
805;15;628224726;805;145;1457;1465;11.68;0.71;165.36;3.85;652;15;468.00;8
805;15;628224736;805;147;1457;1465;11.64;0.71;165.36;3.85;652;15;469.00;8
812;15;628224744;812;148;1461;1465;11.58;0.70;165.11;3.88;649;15;470.00;4
814;15;628224754;814;155;1461;1465;11.54;0.70;165.23;3.88;647;15;471.00;4
818;15;628224763;818;158;1463;1465;11.45;0.69;165.06;3.90;645;15;472.00;2
818;15;628224772;818;165;1463;1465;11.37;0.69;165.06;3.90;645;15;473.00;2
820;15;628224781;820;175;1466;1469;11.19;0.68;165.11;3.89;646;15;474.00;3
822;15;628224791;822;180;1467;1469;11.00;0.67;165.16;3.90;645;15;475.00;2
824;15;628224800;824;184;1470;1473;10.94;0.66;165.10;3.89;646;15;476.00;3
825;15;628224815;825;191;1473;1474;10.80;0.66;165.07;3.89;648;15;477.00;1
828;15;628224823;828;196;1474;1474;10.63;0.65;165.12;3.89;646;15;478.00;0
830;15;628224832;830;204;1474;1474;10.47;0.64;164.88;3.89;644;15;479.00;0
831;15;628224847;831;213;1494;1500;10.24;0.62;164.92;3.84;663;15;480.00;6
832;15;628224863;832;215;1495;1500;10.13;0.62;164.86;3.84;663;15;481.00;5
833;15;628224871;833;217;1498;1500;10.01;0.61;164.80;3.83;665;15;482.00;2
835;15;628224879;835;223;1500;1501;9.84;0.60;164.72;3.83;665;15;483.00;1
836;15;628224888;836;230;1502;1502;9.69;0.59;164.75;3.83;666;15;484.00;0
838;15;628224896;838;236;1502;1502;9.45;0.58;164.75;3.83;664;15;485.00;0
840;15;628224904;840;242;1504;1505;9.33;0.57;164.61;3.82;664;15;486.00;1
840;15;628224913;840;252;1504;1505;9.18;0.57;164.61;3.82;664;15;487.00;1
842;15;628224920;842;255;1505;1505;9.06;0.56;164.48;3.82;663;15;488.00;0
844;15;628224928;844;256;1505;1505;8.95;0.55;164.39;3.82;661;15;489.00;0
846;15;628224937;846;254;1510;1511;8.85;0.54;164.34;3.81;664;15;490.00;1
846;15;628224946;846;254;1510;1511;8.75;0.54;164.34;3.81;664;15;491.00;1
847;15;628224954;847;254;1511;1511;8.67;0.53;164.29;3.81;664;15;492.00;0
851;15;628224962;851;255;1511;1511;8.57;0.53;164.25;3.81;660;15;493.00;0
854;15;628224971;854;256;1515;1515;8.42;0.52;164.09;3.80;661;15;494.00;0
855;15;628224980;855;257;1517;1517;8.35;0.51;163.97;3.80;662;15;495.00;0
858;15;628224988;858;262;1517;1517;8.27;0.51;164.18;3.80;659;15;496.00;0
861;15;628224996;861;265;1518;1518;8.25;0.51;164.25;3.80;657;15;497.00;0
865;15;628225004;865;266;1518;1518;8.23;0.50;163.86;3.80;653;15;498.00;0
865;15;628225011;865;268;1518;1518;8.22;0.51;163.86;3.80;653;15;499.00;0
868;15;628225020;868;269;1518;1518;8.12;0.50;163.69;3.80;650;15;500.00;0
869;15;628225032;869;276;1518;1518;8.03;0.49;163.58;3.80;649;15;501.00;0
874;15;628225038;874;277;1518;1518;7.94;0.49;163.34;3.80;644;15;502.00;0
879;15;628225046;879;277;1518;1518;7.80;0.48;163.89;3.80;639;15;503.00;0
880;15;628225053;880;279;1559;1588;8.01;0.49;163.74;3.70;679;15;504.00;29
884;15;628225065;884;280;1563;1589;7.84;0.48;164.47;3.69;679;15;505.00;26
888;15;628225073;888;280;1572;1589;7.79;0.48;164.99;3.68;684;15;506.00;17
890;15;628225080;890;274;1574;1589;7.71;0.47;165.15;3.68;684;15;507.00;15
891;15;628225088;891;275;1577;1589;7.62;0.47;165.43;3.68;686;15;508.00;12
897;15;628225095;897;281;1579;1589;7.47;0.46;165.95;3.68;682;15;509.00;10
899;15;628225104;899;275;1583;1589;7.43;0.46;166.54;3.69;684;15;510.00;6
904;15;628225111;904;270;1585;1589;7.35;0.45;166.87;3.69;681;15;511.00;4
909;15;628225118;909;265;1588;1590;7.24;0.44;167.45;3.70;679;15;512.00;2
912;15;628225126;912;263;1590;1591;7.21;0.44;167.75;3.70;678;15;513.00;1
914;15;628225134;914;265;1591;1591;7.14;0.44;168.37;3.70;677;15;514.00;0
918;15;628225142;918;270;1595;1595;7.11;0.44;168.87;3.69;677;15;515.00;0
920;15;628225150;920;274;1595;1595;7.12;0.44;168.97;3.69;675;15;516.00;0
921;15;628225158;921;268;1595;1595;7.15;0.44;169.33;3.69;674;15;517.00;0
923;15;628225165;923;264;1595;1595;7.25;0.45;169.55;3.69;672;15;518.00;0
924;15;628225173;924;268;1600;1601;7.38;0.46;169.77;3.69;676;15;519.00;1
928;15;628225181;928;268;1601;1601;7.52;0.46;169.94;3.69;673;15;520.00;0
930;15;628225189;930;262;1601;1601;7.64;0.47;170.48;3.69;671;15;521.00;0
937;15;628225197;937;261;1604;1604;7.70;0.48;171.39;3.68;667;15;522.00;0
941;15;628225205;941;251;1604;1604;7.77;0.48;171.34;3.68;663;15;523.00;0
944;15;628225213;944;239;1604;1604;7.79;0.48;172.08;3.68;660;15;524.00;0
949;15;628225226;949;237;1605;1605;7.83;0.48;172.26;3.68;656;15;525.00;0
951;15;628225234;951;233;1606;1606;7.93;0.49;172.32;3.67;655;15;526.00;0
956;15;628225243;956;221;1606;1606;7.96;0.49;172.68;3.67;650;15;527.00;0
957;15;628225252;957;213;1619;1619;8.12;0.50;172.52;3.65;662;15;528.00;0
963;15;628225261;963;205;1619;1619;8.22;0.50;172.71;3.65;656;15;529.00;0
969;15;628225270;969;202;1619;1619;8.30;0.51;172.93;3.65;650;15;530.00;0
973;15;628225278;973;198;1620;1620;8.42;0.51;173.03;3.64;647;15;531.00;0
978;15;628225287;978;200;1620;1620;8.44;0.51;173.17;3.64;642;15;532.00;0
982;15;628225301;982;199;1623;1624;8.48;0.52;173.38;3.64;641;15;533.00;1
985;15;628225310;985;195;1623;1624;8.53;0.52;173.50;3.64;638;15;534.00;1
987;15;628225319;987;191;1628;1628;8.64;0.53;173.79;3.63;641;15;535.00;0
992;15;628225328;992;190;1628;1628;8.57;0.52;173.81;3.63;636;15;536.00;0
998;15;628225337;998;192;1628;1628;8.56;0.52;174.07;3.63;630;15;537.00;0
1001;15;628225347;1001;189;1628;1628;8.60;0.52;173.93;3.63;627;15;538.00;0
1004;15;628225355;1004;187;1628;1628;8.62;0.52;173.89;3.63;624;15;539.00;0
1006;15;628225365;1006;195;1658;1662;8.68;0.53;173.76;3.57;652;15;540.00;4
1009;15;628225377;1009;190;1658;1662;8.68;0.53;173.90;3.57;649;15;541.00;4
1010;15;628225386;1010;191;1659;1662;8.73;0.53;173.84;3.56;649;15;542.00;3
1012;15;628225395;1012;191;1659;1662;8.80;0.54;173.86;3.56;647;15;543.00;3
1014;15;628225404;1014;187;1660;1662;8.87;0.54;173.66;3.57;646;15;544.00;2
1015;15;628225413;1015;187;1660;1662;8.93;0.55;173.51;3.57;645;15;545.00;2
1016;15;628225421;1016;185;1662;1663;9.02;0.55;173.59;3.56;646;15;546.00;1
1018;15;628225431;1018;182;1662;1663;9.08;0.55;173.60;3.56;644;15;547.00;1
1021;15;628225440;1021;188;1667;1669;9.09;0.55;173.86;3.56;646;15;548.00;2
1025;15;628225450;1025;188;1668;1670;9.14;0.56;173.93;3.56;643;15;549.00;2
1025;15;628225459;1025;192;1669;1670;9.22;0.56;173.93;3.56;644;15;550.00;1
1028;15;628225469;1028;189;1669;1670;9.20;0.56;173.93;3.56;641;15;551.00;1
1030;15;628225478;1030;191;1674;1674;9.26;0.56;174.17;3.55;644;15;552.00;0
1032;15;628225491;1032;194;1674;1674;9.26;0.56;174.34;3.55;642;15;553.00;0
1033;15;628225504;1033;192;1674;1674;9.26;0.57;174.69;3.55;641;15;554.00;0
1036;15;628225519;1036;196;1675;1675;9.32;0.57;175.21;3.55;639;15;555.00;0
1039;15;628225535;1039;196;1679;1679;9.43;0.57;175.79;3.54;640;15;556.00;0
1039;15;628225550;1039;185;1679;1679;9.52;0.58;175.79;3.54;640;15;557.00;0
1043;15;628225563;1043;176;1681;1682;9.62;0.59;176.32;3.54;638;15;558.00;1
1045;15;628225577;1045;170;1681;1682;9.71;0.59;176.83;3.54;636;15;559.00;1
1048;15;628225591;1048;169;1682;1682;9.85;0.60;176.97;3.54;634;15;560.00;0
1053;16;628225603;1053;168;1682;1682;9.91;0.60;177.06;3.54;629;16;561.00;0
1057;16;628225622;1057;171;1685;1686;9.95;0.61;177.95;3.53;628;16;562.00;1
1060;16;628225633;1060;166;1685;1686;10.04;0.61;178.08;3.53;625;16;563.00;1
1063;16;628225644;1063;165;1686;1686;10.17;0.62;178.53;3.53;623;16;564.00;0
1065;16;628225656;1065;161;1686;1686;10.30;0.62;178.72;3.53;621;16;565.00;0
1067;16;628225667;1067;145;1687;1687;10.46;0.63;178.80;3.53;620;16;566.00;0
1071;16;628225682;1071;132;1688;1688;10.60;0.64;179.20;3.53;617;16;567.00;0
1072;16;628225694;1072;117;1688;1688;10.76;0.65;179.14;3.53;616;16;568.00;0
1077;16;628225704;1077;112;1689;1689;10.93;0.66;179.65;3.53;612;16;569.00;0
1079;16;628225718;1079;105;1689;1689;11.13;0.67;179.82;3.53;610;16;570.00;0
1080;16;628225729;1080;97;1689;1689;11.27;0.68;179.84;3.53;609;16;571.00;0
1082;16;628225740;1082;90;1689;1689;11.51;0.70;180.21;3.53;607;16;572.00;0
1084;16;628225750;1084;89;1689;1689;11.65;0.71;180.24;3.53;605;16;573.00;0
1087;16;628225760;1087;79;1689;1689;11.86;0.72;180.52;3.53;602;16;574.00;0
1090;16;628225771;1090;78;1689;1689;12.10;0.73;180.69;3.53;599;16;575.00;0
1091;16;628225783;1091;108;1769;1816;11.79;0.72;180.85;3.37;678;16;576.00;47
1093;16;628225805;1093;98;1772;1817;11.93;0.73;180.73;3.37;679;16;577.00;45
1096;16;628225816;1096;83;1779;1817;12.08;0.74;181.20;3.36;683;16;578.00;38
1099;16;628225828;1099;71;1782;1817;12.18;0.75;181.29;3.36;683;16;579.00;35
1105;16;628225838;1105;72;1786;1817;12.28;0.75;181.64;3.36;681;16;580.00;31
1107;16;628225850;1107;73;1787;1817;12.34;0.76;181.97;3.36;680;16;581.00;30
1112;16;628225860;1112;81;1792;1817;12.44;0.76;182.22;3.37;680;16;582.00;25
1114;16;628225872;1114;86;1793;1817;12.33;0.75;182.39;3.37;679;16;583.00;24
1117;16;628225883;1117;92;1797;1818;12.31;0.75;182.71;3.38;680;16;584.00;21
1120;16;628225894;1120;96;1800;1820;12.26;0.75;182.95;3.39;680;16;585.00;20
1123;16;628225906;1123;107;1804;1820;12.26;0.75;183.06;3.40;681;16;586.00;16
1124;17;628225927;1124;111;1806;1821;12.27;0.75;183.23;3.40;682;17;587.00;15
1126;17;628225952;1126;114;1810;1821;12.34;0.76;183.49;3.42;684;17;588.00;11
1127;17;628225963;1127;120;1812;1821;12.41;0.76;183.37;3.43;685;17;589.00;9
1130;17;628225974;1130;123;1815;1821;12.48;0.77;183.79;3.45;685;17;590.00;6
1133;17;628225985;1133;128;1818;1825;12.49;0.77;184.06;3.46;685;17;591.00;7
1138;17;628226001;1138;127;1821;1825;12.52;0.77;184.01;3.47;683;17;592.00;4
1142;17;628226012;1142;131;1821;1825;12.57;0.77;184.51;3.47;679;17;593.00;4
1148;17;628226025;1148;130;1824;1828;12.57;0.77;184.69;3.47;676;17;594.00;4
1150;17;628226042;1150;126;1824;1828;12.58;0.77;185.04;3.47;674;17;595.00;4
1156;17;628226053;1156;126;1825;1828;12.60;0.77;185.17;3.48;669;17;596.00;3
1159;17;628226069;1159;128;1829;1832;12.55;0.76;185.24;3.48;670;17;597.00;3
1161;17;628226099;1161;128;1831;1833;12.65;0.77;185.39;3.48;670;17;598.00;2
1165;17;628226109;1165;127;1831;1833;12.62;0.77;185.42;3.48;666;17;599.00;2
1168;17;628226122;1168;130;1841;1859;12.57;0.76;185.57;3.46;673;17;600.00;18
1172;17;628226140;1172;127;1842;1859;12.65;0.77;185.62;3.46;670;17;601.00;17
1177;17;628226152;1177;130;1844;1859;12.70;0.77;185.52;3.46;667;17;602.00;15
1179;17;628226164;1179;131;1846;1860;12.74;0.77;185.91;3.46;667;17;603.00;14
1183;17;628226175;1183;131;1848;1860;12.70;0.77;186.08;3.46;665;17;604.00;12
1185;17;628226185;1185;131;1851;1866;12.72;0.77;186.12;3.46;666;17;605.00;15
1188;17;628226196;1188;130;1851;1866;12.64;0.77;186.38;3.46;663;17;606.00;15
1193;17;628226206;1193;134;1853;1867;12.65;0.77;186.64;3.46;660;17;607.00;14
1194;17;628226216;1194;134;1854;1867;12.61;0.76;186.86;3.46;660;17;608.00;13
1198;17;628226226;1198;132;1855;1867;12.58;0.76;186.99;3.46;657;17;609.00;12
1199;17;628226237;1199;128;1855;1867;12.63;0.77;186.98;3.46;656;17;610.00;12
1202;17;628226245;1202;126;1855;1867;12.62;0.77;187.53;3.46;653;17;611.00;12
1203;17;628226261;1203;121;1864;1879;12.60;0.76;187.46;3.46;661;17;612.00;15
1205;17;628226278;1205;121;1866;1879;12.50;0.76;187.49;3.46;661;17;613.00;13
1205;17;628226295;1205;119;1869;1879;12.44;0.75;187.49;3.46;664;17;614.00;10
1211;17;628226304;1211;114;1870;1879;12.41;0.75;187.52;3.46;659;17;615.00;9
1212;17;628226320;1212;117;1871;1879;12.47;0.76;187.40;3.47;659;17;616.00;8
1215;17;628226330;1215;112;1871;1879;12.52;0.76;187.42;3.47;656;17;617.00;8
1219;17;628226339;1219;109;1875;1883;12.54;0.76;187.51;3.47;656;17;618.00;8
1220;17;628226355;1220;102;1875;1883;12.74;0.77;187.50;3.47;655;17;619.00;8
1226;17;628226365;1226;98;1878;1887;12.82;0.78;187.73;3.47;652;17;620.00;9
1227;17;628226374;1227;91;1879;1888;12.87;0.78;187.95;3.47;652;17;621.00;9
1231;17;628226385;1231;92;1880;1888;12.91;0.78;187.86;3.47;649;17;622.00;8
1232;17;628226395;1232;97;1881;1888;12.86;0.78;187.78;3.48;649;17;623.00;7
1234;17;628226404;1234;99;1889;1901;12.67;0.77;187.90;3.46;655;17;624.00;12
1238;17;628226421;1238;100;1889;1901;12.62;0.76;187.97;3.46;651;17;625.00;12
1241;17;628226431;1241;105;1889;1901;12.54;0.76;188.33;3.46;648;17;626.00;12
1242;17;628226440;1242;108;1890;1902;12.41;0.75;188.26;3.46;648;17;627.00;12
1242;17;628226450;1242;109;1892;1903;12.29;0.74;188.26;3.48;650;17;628.00;11
1242;17;628226460;1242;110;1893;1903;12.25;0.74;188.26;3.49;651;17;629.00;10
1243;17;628226472;1243;116;1897;1909;12.29;0.75;188.47;3.49;654;17;630.00;12
1245;17;628226486;1245;122;1898;1909;12.26;0.74;188.71;3.49;653;17;631.00;11
1246;17;628226507;1246;128;1899;1909;12.22;0.74;188.58;3.49;653;17;632.00;10
1248;17;628226517;1248;132;1899;1909;12.22;0.74;188.42;3.49;651;17;633.00;10
1248;17;628226527;1248;136;1903;1915;12.20;0.74;188.42;3.48;655;17;634.00;12
1253;17;628226538;1253;138;1904;1915;12.18;0.74;188.61;3.50;651;17;635.00;11
1256;17;628226548;1256;140;1905;1915;12.13;0.74;188.69;3.50;649;17;636.00;10
1261;17;628226558;1261;139;1905;1915;12.02;0.73;188.88;3.50;644;17;637.00;10
1262;17;628226568;1262;140;1909;1919;11.92;0.72;188.84;3.50;647;17;638.00;10
1265;17;628226578;1265;145;1910;1920;11.77;0.71;188.74;3.49;645;17;639.00;10
1266;17;628226587;1266;154;1912;1920;11.64;0.71;188.97;3.51;646;17;640.00;8
1266;17;628226603;1266;164;1914;1921;11.61;0.70;188.97;3.53;648;17;641.00;7
1268;17;628226612;1268;169;1914;1921;11.48;0.70;188.95;3.53;646;17;642.00;7
1269;17;628226621;1269;172;1915;1921;11.23;0.68;188.83;3.53;646;17;643.00;6
1270;17;628226630;1270;181;1916;1921;11.06;0.67;188.85;3.54;646;17;644.00;5
1272;17;628226639;1272;187;1916;1921;10.96;0.67;188.84;3.54;644;17;645.00;5
1274;17;628226647;1274;195;1919;1921;10.70;0.65;188.65;3.58;645;17;646.00;2
1275;17;628226655;1275;200;1919;1921;10.48;0.64;188.59;3.58;644;17;647.00;2
1277;17;628226664;1277;212;1957;1991;10.40;0.64;188.39;3.53;680;17;648.00;34
1279;17;628226678;1279;220;1961;1992;10.24;0.63;188.38;3.52;682;17;649.00;31
1282;17;628226686;1282;223;1972;1992;10.19;0.63;188.29;3.52;690;17;650.00;20
1283;17;628226695;1283;224;1975;1992;10.00;0.61;188.17;3.51;692;17;651.00;17
1284;17;628226703;1284;236;1981;1992;9.96;0.61;188.08;3.52;697;17;652.00;11
1288;17;628226711;1288;234;1982;1992;9.85;0.61;187.89;3.52;694;17;653.00;10
1289;17;628226720;1289;238;1986;1992;9.79;0.60;187.94;3.52;697;17;654.00;6
1291;17;628226727;1291;245;1987;1992;9.58;0.59;187.88;3.52;696;17;655.00;5
1294;17;628226736;1294;244;1990;1993;9.37;0.58;187.63;3.53;696;17;656.00;3
1298;17;628226745;1298;246;1992;1994;9.24;0.57;187.66;3.53;694;17;657.00;2
1300;17;628226753;1300;255;1994;1994;9.02;0.55;187.62;3.53;694;17;658.00;0
1302;17;628226762;1302;254;1998;1998;8.84;0.54;187.52;3.53;696;17;659.00;0
1305;17;628226772;1305;255;1998;1998;8.68;0.53;187.48;3.53;693;17;660.00;0
1308;18;628226782;1308;260;1998;1998;8.49;0.52;187.41;3.53;690;18;661.00;0
1308;18;628226803;1308;265;1998;1998;8.28;0.51;187.41;3.53;690;18;662.00;0
1310;18;628226811;1310;274;2003;2004;8.16;0.50;187.27;3.52;693;18;663.00;1
1310;18;628226819;1310;281;2003;2004;8.08;0.50;187.27;3.52;693;18;664.00;1
1311;18;628226827;1311;287;2004;2004;7.96;0.49;187.28;3.52;693;18;665.00;0
1314;18;628226835;1314;295;2006;2007;7.92;0.48;187.36;3.52;692;18;666.00;1
1315;18;628226844;1315;301;2007;2007;7.89;0.48;187.31;3.52;692;18;667.00;0
1315;18;628226852;1315;306;2007;2007;7.81;0.48;187.31;3.52;692;18;668.00;0
1315;18;628226859;1315;308;2008;2008;7.70;0.47;187.31;3.52;693;18;669.00;0
1318;18;628226867;1318;307;2009;2009;7.59;0.46;187.20;3.52;691;18;670.00;0
1319;18;628226875;1319;310;2009;2009;7.47;0.46;187.16;3.52;690;18;671.00;0
1321;18;628226882;1321;318;2022;2022;7.37;0.45;187.40;3.49;701;18;672.00;0
1324;18;628226891;1324;324;2022;2022;7.24;0.44;187.27;3.49;698;18;673.00;0
1326;18;628226899;1326;322;2022;2022;7.16;0.44;187.30;3.49;696;18;674.00;0
1333;18;628226907;1333;310;2024;2024;7.07;0.43;187.24;3.49;691;18;675.00;0
1336;18;628226920;1336;295;2024;2024;7.04;0.43;187.25;3.49;688;18;676.00;0
1339;18;628226928;1339;288;2027;2028;7.02;0.43;187.41;3.49;688;18;677.00;1
1341;18;628226936;1341;286;2028;2028;6.98;0.43;187.52;3.49;687;18;678.00;0
1345;18;628226944;1345;276;2032;2032;6.94;0.42;187.94;3.48;687;18;679.00;0
1348;18;628226952;1348;259;2032;2032;6.98;0.43;187.91;3.48;684;18;680.00;0
1350;18;628226960;1350;249;2032;2032;7.07;0.43;188.11;3.48;682;18;681.00;0
1354;18;628226968;1354;229;2032;2032;7.12;0.44;188.39;3.48;678;18;682.00;0
1357;18;628226976;1357;222;2032;2032;7.18;0.44;188.73;3.48;675;18;683.00;0
1361;18;628226984;1361;212;2042;2044;7.35;0.45;188.76;3.46;681;18;684.00;2
1364;18;628226998;1364;211;2042;2044;7.48;0.46;189.20;3.46;678;18;685.00;2
1368;18;628227006;1368;209;2044;2044;7.64;0.47;189.47;3.46;676;18;686.00;0
1368;18;628227015;1368;196;2044;2044;7.81;0.48;189.47;3.46;676;18;687.00;0
1369;18;628227023;1369;188;2044;2044;7.95;0.49;189.68;3.46;675;18;688.00;0
1370;18;628227037;1370;180;2044;2044;8.19;0.50;189.83;3.46;674;18;689.00;0
1372;18;628227047;1372;179;2045;2045;8.35;0.51;190.17;3.46;673;18;690.00;0
1374;18;628227056;1374;177;2045;2045;8.50;0.52;190.31;3.46;671;18;691.00;0
1377;18;628227064;1377;173;2050;2051;8.68;0.53;190.71;3.45;673;18;692.00;1
1378;18;628227074;1378;169;2052;2052;8.85;0.54;190.86;3.45;674;18;693.00;0
1381;18;628227082;1381;161;2052;2052;8.99;0.55;191.14;3.45;671;18;694.00;0
1386;18;628227091;1386;155;2052;2052;9.07;0.56;191.32;3.45;666;18;695.00;0
1388;18;628227100;1388;156;2056;2056;9.20;0.57;191.58;3.45;668;18;696.00;0
1393;18;628227110;1393;163;2056;2056;9.30;0.57;191.36;3.45;663;18;697.00;0
1401;18;628227118;1401;162;2056;2056;9.30;0.57;191.52;3.45;655;18;698.00;0
1405;18;628227127;1405;156;2057;2057;9.35;0.57;191.61;3.44;652;18;699.00;0
1415;18;628227137;1415;151;2061;2061;9.29;0.57;191.56;3.44;646;18;700.00;0
1422;18;628227150;1422;148;2061;2061;9.33;0.57;191.83;3.44;639;18;701.00;0
1426;18;628227160;1426;144;2063;2064;9.42;0.57;192.15;3.44;637;18;702.00;1
1428;18;628227169;1428;141;2063;2064;9.44;0.58;192.34;3.44;635;18;703.00;1
1432;18;628227177;1432;138;2064;2064;9.45;0.58;192.65;3.44;632;18;704.00;0
1438;18;628227187;1438;136;2064;2064;9.39;0.57;192.87;3.44;626;18;705.00;0
1441;18;628227196;1441;132;2067;2068;9.47;0.58;193.01;3.43;626;18;706.00;1
1449;18;628227205;1449;130;2067;2068;9.54;0.58;193.24;3.43;618;18;707.00;1
1453;18;628227214;1453;134;2068;2068;9.55;0.58;193.32;3.43;615;18;708.00;0
1458;18;628227223;1458;133;2068;2068;9.53;0.58;193.34;3.43;610;18;709.00;0
1464;18;628227232;1464;134;2069;2069;9.59;0.59;193.40;3.43;605;18;710.00;0
1470;18;628227242;1470;135;2070;2070;9.59;0.58;193.54;3.43;600;18;711.00;0
1477;18;628227252;1477;135;2070;2070;9.58;0.58;193.64;3.43;593;18;712.00;0
1484;18;628227261;1484;137;2071;2071;9.57;0.58;193.88;3.43;587;18;713.00;0
1487;18;628227270;1487;139;2071;2071;9.60;0.58;193.95;3.43;584;18;714.00;0
1493;18;628227279;1493;146;2071;2071;9.55;0.58;194.49;3.43;578;18;715.00;0
1494;18;628227288;1494;146;2071;2071;9.66;0.58;194.51;3.43;577;18;716.00;0
1498;18;628227296;1498;142;2071;2071;9.78;0.59;194.64;3.43;573;18;717.00;0
1503;18;628227305;1503;142;2071;2071;9.87;0.60;195.06;3.43;568;18;718.00;0
1504;19;628227314;1504;143;2071;2071;10.00;0.60;194.96;3.43;567;19;719.00;0
1506;19;628227339;1506;186;2198;2301;9.89;0.62;195.19;3.23;692;19;720.00;103
1509;19;628227366;1509;176;2207;2302;9.93;0.62;195.37;3.22;698;19;721.00;95
1510;19;628227376;1510;165;2217;2302;10.09;0.63;195.43;3.22;707;19;722.00;85
1513;19;628227386;1513;163;2226;2302;10.08;0.63;195.63;3.22;713;19;723.00;76
1515;19;628227396;1515;160;2231;2302;10.15;0.63;195.82;3.22;716;19;724.00;71
1516;19;628227406;1516;162;2237;2302;10.13;0.63;195.79;3.22;721;19;725.00;65
1518;19;628227416;1518;161;2244;2302;10.05;0.62;195.90;3.23;726;19;726.00;58
1520;19;628227427;1520;155;2249;2302;10.00;0.62;196.31;3.24;729;19;727.00;53
1521;19;628227438;1521;152;2254;2303;9.98;0.62;196.45;3.25;733;19;728.00;49
1523;19;628227449;1523;156;2256;2304;9.97;0.62;196.52;3.25;733;19;729.00;48
1527;19;628227459;1527;158;2260;2304;9.96;0.62;196.70;3.27;733;19;730.00;44
1529;19;628227471;1529;164;2265;2305;9.96;0.62;196.70;3.28;736;19;731.00;40
1532;19;628227482;1532;169;2272;2305;9.86;0.61;196.84;3.30;740;19;732.00;33
1535;19;628227497;1535;176;2273;2305;9.80;0.60;196.92;3.31;738;19;733.00;32
1538;19;628227515;1538;179;2276;2305;9.69;0.60;197.10;3.32;738;19;734.00;29
1540;19;628227533;1540;181;2279;2309;9.62;0.59;197.35;3.32;739;19;735.00;30
1542;19;628227552;1542;172;2280;2309;9.69;0.60;197.46;3.33;738;19;736.00;29
1546;19;628227569;1546;170;2283;2309;9.72;0.60;197.73;3.35;737;19;737.00;26
1548;19;628227586;1548;167;2285;2312;9.86;0.61;197.55;3.35;737;19;738.00;27
1553;19;628227603;1553;167;2286;2312;9.91;0.61;197.80;3.36;733;19;739.00;26
1556;19;628227617;1556;161;2286;2312;9.97;0.61;198.20;3.36;730;19;740.00;26
1560;19;628227629;1560;163;2291;2316;10.03;0.62;198.65;3.36;731;19;741.00;25
1562;19;628227643;1562;160;2294;2317;10.17;0.62;198.79;3.38;732;19;742.00;23
1564;19;628227657;1564;160;2294;2317;10.38;0.64;199.00;3.38;730;19;743.00;23
1566;19;628227669;1566;164;2298;2321;10.54;0.65;198.99;3.39;732;19;744.00;23
1569;19;628227682;1569;159;2300;2321;10.77;0.66;199.33;3.40;731;19;745.00;21
1573;19;628227695;1573;157;2301;2321;10.90;0.67;199.49;3.41;728;19;746.00;20
1575;19;628227708;1575;149;2302;2322;11.10;0.68;199.60;3.41;727;19;747.00;20
1579;19;628227720;1579;149;2303;2322;11.15;0.68;200.02;3.41;724;19;748.00;19
1582;19;628227737;1582;152;2308;2328;11.25;0.69;200.25;3.42;726;19;749.00;20
1584;20;628227752;1584;153;2309;2328;11.34;0.69;200.30;3.42;725;20;750.00;19
1588;20;628227776;1588;154;2311;2329;11.46;0.70;200.63;3.42;723;20;751.00;18
1591;20;628227788;1591;151;2311;2329;11.60;0.71;200.67;3.42;720;20;752.00;18
1596;20;628227800;1596;152;2311;2329;11.70;0.71;200.69;3.42;715;20;753.00;18
1599;20;628227812;1599;152;2312;2329;11.73;0.71;200.99;3.43;713;20;754.00;17
1601;20;628227824;1601;156;2313;2329;11.71;0.71;200.95;3.44;712;20;755.00;16
1605;20;628227840;1605;156;2325;2341;11.68;0.71;201.23;3.42;720;20;756.00;16
1610;20;628227859;1610;155;2326;2341;11.74;0.71;201.16;3.42;716;20;757.00;15
1612;20;628227870;1612;155;2326;2341;11.79;0.72;201.31;3.42;714;20;758.00;15
1615;20;628227888;1615;158;2327;2341;11.87;0.72;201.28;3.42;712;20;759.00;14
1618;21;628227899;1618;160;2327;2341;11.87;0.72;201.60;3.42;709;21;760.00;14
1621;21;628227922;1621;160;2327;2341;11.93;0.73;201.58;3.42;706;21;761.00;14
1623;21;628227933;1623;162;2331;2345;11.93;0.73;201.65;3.42;708;21;762.00;14
1627;21;628227945;1627;163;2331;2345;12.02;0.73;201.73;3.42;704;21;763.00;14
1632;21;628227955;1632;166;2334;2349;12.06;0.73;202.04;3.42;702;21;764.00;15
1634;21;628227966;1634;164;2336;2351;12.11;0.74;202.18;3.41;702;21;765.00;15
1637;21;628227979;1637;164;2337;2351;12.07;0.73;202.11;3.41;700;21;766.00;14
1642;21;628227989;1642;166;2337;2351;12.01;0.73;202.16;3.41;695;21;767.00;14
1644;21;628228000;1644;170;2346;2364;12.08;0.73;202.12;3.40;702;21;768.00;18
1646;21;628228012;1646;171;2346;2364;12.05;0.73;202.05;3.40;700;21;769.00;18
1648;21;628228023;1648;172;2346;2364;12.11;0.74;202.20;3.40;698;21;770.00;18
1651;21;628228036;1651;175;2347;2365;12.10;0.74;202.32;3.40;696;21;771.00;18
1653;21;628228046;1653;175;2347;2366;12.14;0.74;202.32;3.40;694;21;772.00;19
1654;21;628228056;1654;175;2347;2366;12.14;0.74;202.35;3.40;693;21;773.00;19
1656;21;628228067;1656;174;2349;2369;12.16;0.74;202.38;3.40;693;21;774.00;20
1662;21;628228077;1662;171;2350;2369;12.09;0.74;202.27;3.42;688;21;775.00;19
1664;21;628228089;1664;165;2351;2369;12.06;0.74;202.27;3.42;687;21;776.00;18
1668;21;628228100;1668;171;2351;2369;12.03;0.73;202.16;3.42;683;21;777.00;18
1670;21;628228114;1670;173;2355;2375;12.03;0.73;202.30;3.41;685;21;778.00;20
1672;21;628228124;1672;167;2355;2375;12.06;0.73;202.32;3.41;683;21;779.00;20
1677;21;628228137;1677;164;2356;2375;12.05;0.73;202.34;3.41;679;21;780.00;19
1682;21;628228148;1682;157;2356;2375;12.01;0.73;202.39;3.41;674;21;781.00;19
1686;21;628228165;1686;155;2359;2379;11.93;0.72;202.53;3.41;673;21;782.00;20
1688;21;628228176;1688;151;2360;2380;11.83;0.72;202.61;3.41;672;21;783.00;20
1692;21;628228193;1692;143;2360;2380;11.81;0.72;202.63;3.41;668;21;784.00;20
1694;21;628228202;1694;139;2363;2381;11.77;0.72;202.59;3.42;669;21;785.00;18
1699;21;628228213;1699;135;2363;2381;11.78;0.72;202.50;3.42;664;21;786.00;18
1703;21;628228223;1703;134;2363;2381;11.81;0.72;202.65;3.42;660;21;787.00;18
1704;21;628228233;1704;135;2363;2381;11.90;0.72;202.76;3.42;659;21;788.00;18
1706;21;628228243;1706;134;2364;2381;11.93;0.72;202.62;3.45;658;21;789.00;17
1709;21;628228253;1709;129;2364;2381;11.99;0.73;202.62;3.45;655;21;790.00;17
1712;21;628228263;1712;124;2364;2381;11.96;0.73;202.72;3.45;652;21;791.00;17
1712;21;628228273;1712;130;2397;2451;11.85;0.72;202.72;3.43;685;21;792.00;54
1714;21;628228289;1714;130;2397;2452;11.73;0.72;202.63;3.43;683;21;793.00;55
1716;21;628228300;1716;131;2405;2452;11.72;0.72;202.77;3.42;689;21;794.00;47
1718;21;628228310;1718;134;2410;2452;11.66;0.71;202.70;3.45;692;21;795.00;42
1718;21;628228320;1718;134;2414;2452;11.63;0.71;202.70;3.45;696;21;796.00;38
1720;21;628228330;1720;136;2418;2452;11.61;0.71;202.70;3.49;698;21;797.00;34
1722;21;628228340;1722;144;2423;2452;11.57;0.71;202.61;3.52;701;21;798.00;29
1725;21;628228351;1725;145;2427;2452;11.43;0.70;202.58;3.56;702;21;799.00;25
1728;22;628228362;1728;145;2430;2453;11.30;0.69;202.41;3.59;702;22;800.00;23
1731;22;628228390;1731;147;2433;2454;11.21;0.68;202.48;3.62;702;22;801.00;21
1734;22;628228401;1734;150;2437;2454;11.12;0.68;202.36;3.66;703;22;802.00;17
1735;22;628228412;1735;156;2440;2458;10.97;0.67;202.34;3.66;705;22;803.00;18
1736;22;628228422;1736;162;2442;2458;10.78;0.66;202.26;3.69;706;22;804.00;16
1739;22;628228433;1739;167;2443;2458;10.68;0.65;202.15;3.70;704;22;805.00;15
1740;22;628228443;1740;178;2444;2458;10.54;0.64;202.17;3.73;704;22;806.00;14
1743;22;628228458;1743;183;2448;2464;10.45;0.64;202.01;3.73;705;22;807.00;16
1746;22;628228469;1746;192;2450;2464;10.33;0.63;201.78;3.76;704;22;808.00;14
1749;22;628228480;1749;200;2450;2464;10.16;0.62;201.61;3.76;701;22;809.00;14
1751;22;628228495;1751;208;2455;2470;10.02;0.61;201.56;3.78;704;22;810.00;15
1756;22;628228507;1756;215;2456;2470;9.87;0.60;201.43;3.82;700;22;811.00;14
1757;22;628228520;1757;224;2458;2470;9.80;0.60;201.36;3.83;701;22;812.00;12
1761;22;628228531;1761;232;2461;2471;9.68;0.59;201.19;3.85;700;22;813.00;10
1762;22;628228542;1762;234;2463;2472;9.52;0.58;201.21;3.85;701;22;814.00;9
1764;22;628228552;1764;237;2465;2472;9.32;0.57;201.15;3.87;701;22;815.00;7
1765;22;628228563;1765;251;2476;2485;9.12;0.56;201.05;3.87;711;22;816.00;9
1768;22;628228573;1768;254;2476;2485;9.01;0.55;200.93;3.87;708;22;817.00;9
1769;22;628228583;1769;265;2479;2485;8.85;0.54;200.83;3.89;710;22;818.00;6
1770;22;628228591;1770;272;2480;2486;8.69;0.53;200.93;3.89;710;22;819.00;6
1771;22;628228601;1771;275;2482;2486;8.53;0.52;200.91;3.90;711;22;820.00;4
1772;22;628228609;1772;280;2486;2490;8.41;0.52;200.86;3.90;714;22;821.00;4
1774;22;628228618;1774;291;2490;2490;8.27;0.51;200.75;3.90;716;22;822.00;0
1778;22;628228626;1778;298;2493;2494;8.17;0.50;200.69;3.90;715;22;823.00;1
1780;22;628228635;1780;309;2494;2494;8.10;0.50;200.89;3.90;714;22;824.00;0
1780;22;628228644;1780;317;2494;2494;7.97;0.49;200.89;3.90;714;22;825.00;0
1784;22;628228652;1784;323;2494;2494;7.81;0.48;200.67;3.90;710;22;826.00;0
1786;22;628228659;1786;316;2494;2494;7.71;0.47;200.53;3.90;708;22;827.00;0
1789;22;628228668;1789;312;2505;2506;7.69;0.47;200.58;3.88;716;22;828.00;1
1791;22;628228677;1791;304;2506;2506;7.70;0.47;200.62;3.88;715;22;829.00;0
1792;22;628228685;1792;302;2506;2506;7.76;0.48;200.59;3.88;714;22;830.00;0
1793;22;628228693;1793;296;2506;2506;7.77;0.48;200.60;3.88;713;22;831.00;0
1794;22;628228707;1794;290;2506;2506;7.78;0.48;200.55;3.88;712;22;832.00;0
1797;22;628228715;1797;284;2506;2506;7.82;0.48;200.44;3.88;709;22;833.00;0
1798;22;628228729;1798;279;2507;2507;7.87;0.48;200.39;3.88;709;22;834.00;0
1798;23;628228744;1798;271;2507;2507;8.01;0.49;200.39;3.88;709;23;835.00;0
1799;23;628228762;1799;272;2512;2513;8.20;0.50;200.34;3.88;713;23;836.00;1
1800;23;628228772;1800;272;2514;2514;8.35;0.51;200.29;3.87;714;23;837.00;0
1801;23;628228781;1801;270;2514;2514;8.40;0.51;200.27;3.87;713;23;838.00;0
1802;24;628228790;1802;262;2514;2514;8.45;0.52;200.22;3.87;712;24;839.00;0
1802;24;628228811;1802;266;2519;2519;8.53;0.52;200.22;3.87;717;24;840.00;0
1807;24;628228820;1807;265;2519;2519;8.51;0.52;200.13;3.87;712;24;841.00;0
1810;24;628228834;1810;266;2519;2519;8.49;0.52;200.27;3.87;709;24;842.00;0
1811;24;628228842;1811;264;2520;2520;8.47;0.52;200.34;3.86;709;24;843.00;0
1814;24;628228851;1814;259;2524;2524;8.42;0.52;200.46;3.86;710;24;844.00;0
1816;24;628228865;1816;251;2524;2524;8.39;0.51;200.54;3.86;708;24;845.00;0
1821;24;628228873;1821;245;2526;2527;8.41;0.52;200.64;3.86;705;24;846.00;1
1823;24;628228882;1823;247;2527;2527;8.42;0.52;200.72;3.86;704;24;847.00;0
1827;24;628228891;1827;241;2527;2527;8.38;0.51;200.99;3.86;700;24;848.00;0
1832;24;628228899;1832;239;2527;2527;8.38;0.51;201.20;3.86;695;24;849.00;0
1834;24;628228908;1834;225;2530;2531;8.53;0.52;201.24;3.85;696;24;850.00;1
1836;24;628228917;1836;214;2530;2531;8.63;0.53;201.55;3.85;694;24;851.00;1
1844;24;628228925;1844;212;2531;2531;8.70;0.53;201.45;3.85;687;24;852.00;0
1848;24;628228935;1848;204;2531;2531;8.68;0.53;201.56;3.85;683;24;853.00;0
1851;24;628228943;1851;194;2532;2532;8.74;0.54;201.69;3.85;681;24;854.00;0
1857;24;628228952;1857;192;2534;2534;8.78;0.54;201.72;3.85;677;24;855.00;0
1862;24;628228962;1862;189;2534;2534;8.79;0.54;201.85;3.85;672;24;856.00;0
1864;24;628228971;1864;177;2535;2535;8.83;0.54;202.04;3.85;671;24;857.00;0
1867;24;628228980;1867;169;2535;2535;8.85;0.54;202.05;3.85;668;24;858.00;0
1870;24;628228989;1870;163;2535;2535;8.92;0.55;202.12;3.85;665;24;859.00;0
1872;25;628228998;1872;158;2535;2535;8.99;0.55;202.26;3.85;663;25;860.00;0
1876;25;628229020;1876;154;2535;2535;9.02;0.55;202.17;3.85;659;25;861.00;0
1878;25;628229029;1878;153;2535;2535;9.10;0.56;202.16;3.85;657;25;862.00;0
1882;25;628229038;1882;148;2535;2535;9.16;0.56;202.41;3.85;653;25;863.00;0
1888;25;628229047;1888;164;2613;2662;9.21;0.57;202.40;3.73;725;25;864.00;49
1892;25;628229065;1892;163;2615;2663;9.21;0.57;202.49;3.73;723;25;865.00;48
1895;25;628229075;1895;160;2621;2663;9.32;0.58;202.50;3.73;726;25;866.00;42
1897;25;628229085;1897;160;2628;2663;9.43;0.58;202.58;3.72;731;25;867.00;35
1905;25;628229094;1905;160;2634;2663;9.45;0.58;202.42;3.73;729;25;868.00;29
1910;25;628229104;1910;152;2639;2663;9.45;0.58;202.56;3.73;729;25;869.00;24
1913;25;628229115;1913;154;2644;2663;9.46;0.58;202.64;3.73;731;25;870.00;19
1919;25;628229130;1919;159;2647;2663;9.36;0.57;202.65;3.74;728;25;871.00;16
1922;25;628229140;1922;158;2650;2664;9.32;0.57;202.99;3.74;728;25;872.00;14
1926;25;628229150;1926;163;2654;2665;9.37;0.58;203.19;3.75;728;25;873.00;11
1930;25;628229161;1930;172;2655;2665;9.32;0.57;203.42;3.75;725;25;874.00;10
1935;25;628229171;1935;175;2657;2666;9.22;0.57;203.79;3.75;722;25;875.00;9
1938;25;628229187;1938;182;2659;2666;9.24;0.57;203.92;3.76;721;25;876.00;7
1944;26;628229197;1944;189;2660;2666;9.21;0.57;204.12;3.76;716;26;877.00;6
1946;26;628229218;1946;198;2661;2666;9.24;0.57;204.34;3.76;715;26;878.00;5
1951;26;628229229;1951;195;2664;2670;9.28;0.57;204.30;3.77;713;26;879.00;6
1958;26;628229239;1958;191;2666;2670;9.29;0.57;204.26;3.77;708;26;880.00;4
1963;26;628229250;1963;189;2667;2670;9.32;0.57;204.56;3.78;704;26;881.00;3
1969;26;628229261;1969;186;2669;2673;9.43;0.57;204.77;3.78;700;26;882.00;4
1973;26;628229272;1973;191;2670;2673;9.50;0.58;204.97;3.78;697;26;883.00;3
1974;26;628229282;1974;189;2671;2673;9.60;0.58;204.99;3.78;697;26;884.00;2
1978;26;628229292;1978;193;2675;2677;9.65;0.59;205.30;3.78;697;26;885.00;2
1982;26;628229303;1982;194;2677;2678;9.68;0.59;205.32;3.78;695;26;886.00;1
1986;26;628229314;1986;195;2677;2678;9.77;0.60;205.33;3.78;691;26;887.00;1
1991;26;628229324;1991;198;2682;2682;9.79;0.60;205.33;3.77;691;26;888.00;0
1996;26;628229335;1996;200;2682;2682;9.81;0.60;205.48;3.77;686;26;889.00;0
1999;26;628229346;1999;205;2682;2682;9.86;0.60;205.80;3.77;683;26;890.00;0
2002;26;628229356;2002;203;2683;2683;9.86;0.60;205.91;3.77;681;26;891.00;0
2006;27;628229366;2006;205;2683;2683;9.83;0.60;206.06;3.77;677;27;892.00;0
2009;27;628229386;2009;206;2688;2689;9.80;0.60;206.23;3.76;679;27;893.00;1
2012;27;628229397;2012;208;2688;2689;9.80;0.60;206.34;3.76;676;27;894.00;1
2013;27;628229407;2013;209;2690;2690;9.82;0.60;206.39;3.76;677;27;895.00;0
2016;27;628229417;2016;210;2690;2690;9.82;0.60;206.52;3.76;674;27;896.00;0
2017;28;628229427;2017;202;2690;2690;9.89;0.60;206.57;3.76;673;28;897.00;0
2019;28;628229444;2019;196;2690;2690;9.86;0.60;206.62;3.76;671;28;898.00;0
2021;28;628229455;2021;190;2690;2690;9.87;0.60;206.74;3.76;669;28;899.00;0
2024;28;628229471;2024;188;2719;2736;9.77;0.60;206.77;3.72;695;28;900.00;17
2026;28;628229493;2026;177;2719;2736;9.78;0.60;206.77;3.72;693;28;901.00;17
2030;28;628229508;2030;167;2721;2736;9.85;0.60;206.97;3.72;691;28;902.00;15
2033;28;628229533;2033;166;2721;2736;9.98;0.61;207.00;3.72;688;28;903.00;15
2037;28;628229551;2037;166;2722;2736;10.07;0.62;207.24;3.72;685;28;904.00;14
2040;28;628229567;2040;161;2722;2736;10.09;0.62;207.40;3.72;682;28;905.00;14
2042;28;628229583;2042;150;2728;2740;10.04;0.61;207.35;3.72;686;28;906.00;12
2043;28;628229607;2043;139;2730;2740;10.11;0.62;207.34;3.72;687;28;907.00;10
2047;28;628229619;2047;129;2733;2744;10.23;0.62;207.53;3.72;686;28;908.00;11
2051;28;628229631;2051;124;2734;2745;10.35;0.63;207.49;3.72;683;28;909.00;11
2054;28;628229644;2054;120;2735;2745;10.43;0.64;207.52;3.72;681;28;910.00;10
2058;28;628229656;2058;117;2735;2745;10.49;0.64;207.62;3.72;677;28;911.00;10
2059;28;628229668;2059;111;2744;2758;10.64;0.65;207.75;3.71;685;28;912.00;14
2064;28;628229681;2064;115;2745;2758;10.66;0.65;207.77;3.71;681;28;913.00;13
2066;28;628229698;2066;110;2745;2758;10.75;0.65;207.84;3.71;679;28;914.00;13
2069;28;628229710;2069;115;2746;2759;10.89;0.66;207.78;3.71;677;28;915.00;13
2070;28;628229723;2070;117;2748;2760;10.90;0.66;207.83;3.72;678;28;916.00;12
2073;28;628229736;2073;115;2748;2760;10.94;0.67;207.88;3.72;675;28;917.00;12
2075;28;628229747;2075;117;2751;2763;11.03;0.67;208.01;3.72;676;28;918.00;12
2076;28;628229758;2076;120;2751;2763;11.01;0.67;208.00;3.72;675;28;919.00;12
2078;28;628229769;2078;126;2751;2763;11.02;0.67;208.18;3.72;673;28;920.00;12
2080;28;628229780;2080;127;2752;2763;11.03;0.67;208.11;3.73;672;28;921.00;11
2081;28;628229790;2081;128;2756;2769;11.05;0.67;208.21;3.72;675;28;922.00;13
2085;28;628229801;2085;132;2756;2769;11.10;0.68;208.12;3.72;671;28;923.00;13
2087;28;628229813;2087;133;2758;2769;11.16;0.68;208.23;3.73;671;28;924.00;11
2090;28;628229823;2090;134;2758;2769;11.14;0.68;208.12;3.73;668;28;925.00;11
2092;28;628229833;2092;133;2762;2773;11.09;0.68;208.12;3.73;670;28;926.00;11
2096;28;628229845;2096;137;2764;2774;11.06;0.68;208.02;3.73;668;28;927.00;10
2100;28;628229855;2100;140;2764;2774;11.04;0.67;208.11;3.73;664;28;928.00;10
2103;28;628229865;2103;144;2767;2775;11.13;0.68;207.98;3.75;664;28;929.00;8
2108;28;628229877;2108;145;2767;2775;11.16;0.68;207.93;3.75;659;28;930.00;8
2111;28;628229888;2111;146;2768;2775;11.22;0.68;207.89;3.75;657;28;931.00;7
2113;28;628229898;2113;143;2769;2775;11.29;0.69;207.92;3.76;656;28;932.00;6
2114;28;628229909;2114;147;2770;2775;11.35;0.69;207.93;3.76;656;28;933.00;5
2117;28;628229919;2117;151;2770;2775;11.41;0.69;207.99;3.76;653;28;934.00;5
2120;28;628229941;2120;149;2771;2775;11.38;0.69;208.08;3.76;651;28;935.00;4
2122;28;628229951;2122;164;2812;2845;11.14;0.68;208.33;3.71;690;28;936.00;33
2126;28;628229969;2126;155;2813;2846;11.27;0.69;208.42;3.72;687;28;937.00;33
2126;28;628229980;2126;158;2819;2846;11.37;0.69;208.42;3.71;693;28;938.00;27
2133;28;628229990;2133;160;2826;2846;11.44;0.70;208.55;3.71;693;28;939.00;20
2136;28;628230000;2136;159;2829;2846;11.49;0.70;208.69;3.71;693;28;940.00;17
2139;28;628230015;2139;158;2832;2846;11.45;0.70;208.53;3.71;693;28;941.00;14
2142;28;628230031;2142;164;2835;2846;11.56;0.70;208.74;3.71;693;28;942.00;11
2146;28;628230044;2146;170;2837;2846;11.61;0.71;208.77;3.72;691;28;943.00;9
2150;28;628230054;2150;168;2838;2847;11.61;0.71;208.87;3.72;688;28;944.00;9
2153;28;628230064;2153;172;2841;2849;11.56;0.70;208.87;3.71;688;28;945.00;8
2154;28;628230074;2154;171;2841;2849;11.55;0.70;208.91;3.71;687;28;946.00;8
2156;28;628230084;2156;173;2844;2853;11.46;0.70;208.94;3.71;688;28;947.00;9
2157;28;628230095;2157;177;2844;2853;11.44;0.70;208.88;3.71;687;28;948.00;9
2159;28;628230104;2159;177;2844;2853;11.41;0.70;208.84;3.71;685;28;949.00;9
2164;28;628230113;2164;173;2844;2853;11.30;0.69;208.84;3.71;680;28;950.00;9
2170;28;628230123;2170;177;2847;2859;11.16;0.68;208.92;3.71;677;28;951.00;12
2171;28;628230132;2171;172;2848;2859;11.08;0.67;208.86;3.71;677;28;952.00;11
2173;28;628230141;2173;169;2850;2859;11.01;0.67;208.87;3.74;677;28;953.00;9
2175;28;628230150;2175;169;2852;2862;10.97;0.67;208.81;3.74;677;28;954.00;10
2179;28;628230160;2179;169;2854;2862;10.93;0.67;208.74;3.74;675;28;955.00;8
2183;28;628230169;2183;165;2854;2862;10.97;0.67;208.54;3.74;671;28;956.00;8
2189;28;628230179;2189;159;2854;2863;10.95;0.67;208.29;3.74;665;28;957.00;9
2191;28;628230189;2191;164;2855;2864;11.01;0.67;208.25;3.74;664;28;958.00;9
2196;28;628230198;2196;165;2855;2864;11.00;0.67;208.02;3.74;659;28;959.00;9
2203;28;628230209;2203;158;2870;2890;10.92;0.66;207.95;3.72;667;28;960.00;20
2203;28;628230221;2203;154;2870;2890;10.97;0.67;207.95;3.72;667;28;961.00;20
2206;28;628230229;2206;153;2872;2890;11.01;0.67;207.82;3.72;666;28;962.00;18
2207;28;628230244;2207;156;2874;2891;11.02;0.67;207.73;3.72;667;28;963.00;17
2209;28;628230256;2209;158;2874;2891;11.06;0.67;207.63;3.72;665;28;964.00;17
2211;28;628230265;2211;156;2876;2895;11.12;0.68;207.61;3.72;665;28;965.00;19
2216;28;628230274;2216;157;2877;2895;11.12;0.68;207.49;3.71;661;28;966.00;18
2217;28;628230283;2217;159;2880;2899;11.09;0.68;207.45;3.71;663;28;967.00;19
2218;29;628230292;2218;162;2881;2899;11.05;0.67;207.42;3.72;663;29;968.00;18
2219;29;628230323;2219;166;2881;2899;11.06;0.67;207.47;3.72;662;29;969.00;18
2219;29;628230331;2219;167;2884;2899;10.95;0.67;207.47;3.75;665;29;970.00;15
2219;29;628230339;2219;169;2885;2899;10.83;0.66;207.47;3.75;666;29;971.00;14
2223;29;628230348;2223;175;2897;2911;10.75;0.65;207.41;3.76;674;29;972.00;14
2223;29;628230363;2223;178;2898;2911;10.64;0.65;207.41;3.76;675;29;973.00;13
2224;29;628230372;2224;182;2899;2911;10.53;0.64;207.43;3.77;675;29;974.00;12
2227;29;628230380;2227;186;2901;2911;10.43;0.64;207.33;3.77;674;29;975.00;10
2231;29;628230389;2231;195;2901;2911;10.32;0.63;207.38;3.77;670;29;976.00;10
2233;29;628230398;2233;202;2901;2911;10.17;0.62;207.48;3.77;668;29;977.00;10
2234;29;628230406;2234;210;2902;2912;10.07;0.62;207.47;3.78;668;29;978.00;10
2236;29;628230415;2236;204;2902;2912;9.98;0.61;207.50;3.78;666;29;979.00;10
2237;29;628230424;2237;201;2907;2918;9.94;0.61;207.52;3.78;670;29;980.00;11
2239;29;628230433;2239;199;2910;2919;9.91;0.60;207.53;3.80;671;29;981.00;9
2241;29;628230443;2241;199;2912;2919;9.94;0.61;207.47;3.81;671;29;982.00;7
2242;30;628230452;2242;197;2913;2919;9.91;0.61;207.49;3.82;671;30;983.00;6
2243;30;628230473;2243;192;2917;2923;9.90;0.60;207.45;3.82;674;30;984.00;6
2246;30;628230484;2246;193;2918;2923;9.81;0.60;207.32;3.82;672;30;985.00;5
2248;30;628230501;2248;193;2918;2923;9.78;0.60;207.37;3.82;670;30;986.00;5
2251;30;628230516;2251;190;2920;2924;9.70;0.59;207.30;3.83;669;30;987.00;4
2253;30;628230526;2253;197;2924;2928;9.61;0.58;207.31;3.84;671;30;988.00;4
2257;30;628230535;2257;196;2924;2928;9.54;0.58;207.13;3.84;667;30;989.00;4
2258;30;628230546;2258;197;2929;2934;9.52;0.58;207.14;3.84;671;30;990.00;5
2259;30;628230556;2259;198;2929;2934;9.54;0.58;207.14;3.84;670;30;991.00;5
2260;30;628230564;2260;200;2931;2934;9.56;0.58;207.16;3.84;671;30;992.00;3
2260;30;628230573;2260;198;2933;2934;9.56;0.58;207.16;3.84;673;30;993.00;1
2261;30;628230581;2261;202;2935;2938;9.61;0.59;207.19;3.84;674;30;994.00;3
2262;30;628230595;2262;206;2936;2938;9.57;0.58;207.16;3.84;674;30;995.00;2
2262;30;628230604;2262;212;2936;2938;9.48;0.58;207.16;3.84;674;30;996.00;2
2263;30;628230613;2263;213;2937;2938;9.39;0.57;207.13;3.84;674;30;997.00;1
2263;30;628230621;2263;220;2938;2939;9.23;0.56;207.13;3.84;675;30;998.00;1
2264;30;628230629;2264;216;2940;2940;9.05;0.55;207.08;3.84;676;30;999.00;0
2267;30;628230640;2267;218;2940;2940;8.90;0.54;207.08;3.84;673;30;1000.00;0
2268;30;628230657;2268;221;2941;2941;8.76;0.54;207.09;3.84;673;30;1001.00;0
2271;30;628230667;2271;213;2941;2941;8.64;0.53;207.33;3.84;670;30;1002.00;0
2274;30;628230677;2274;216;2941;2941;8.51;0.52;207.22;3.84;667;30;1003.00;0
2277;30;628230688;2277;213;2941;2941;8.40;0.51;207.17;3.84;664;30;1004.00;0
2280;30;628230698;2280;212;2941;2941;8.37;0.51;207.20;3.84;661;30;1005.00;0
2281;30;628230707;2281;214;2941;2941;8.26;0.51;207.17;3.84;660;30;1006.00;0
2283;30;628230715;2283;215;2941;2941;8.24;0.50;207.15;3.84;658;30;1007.00;0
2284;30;628230724;2284;235;3013;3068;8.39;0.52;207.12;3.75;729;30;1008.00;55
2286;30;628230742;2286;228;3016;3069;8.36;0.52;207.06;3.74;730;30;1009.00;53
2288;30;628230751;2288;219;3024;3069;8.46;0.53;207.00;3.74;736;30;1010.00;45
2291;30;628230766;2291;215;3031;3069;8.48;0.53;207.01;3.74;740;30;1011.00;38
2294;30;628230775;2294;216;3037;3069;8.49;0.53;207.06;3.74;743;30;1012.00;32
2298;30;628230783;2298;214;3042;3069;8.49;0.53;206.98;3.74;744;30;1013.00;27
2305;30;628230792;2305;214;3044;3069;8.49;0.53;207.27;3.74;739;30;1014.00;25
2311;30;628230801;2311;215;3046;3069;8.51;0.53;207.47;3.74;735;30;1015.00;23
2315;30;628230811;2315;216;3052;3070;8.65;0.54;207.56;3.75;737;30;1016.00;18
2321;30;628230820;2321;212;3053;3071;8.69;0.54;207.42;3.75;732;30;1017.00;18
2327;30;628230829;2327;212;3058;3071;8.64;0.53;207.39;3.76;731;30;1018.00;13
2332;30;628230838;2332;214;3060;3072;8.56;0.53;207.68;3.76;728;30;1019.00;12
2335;30;628230849;2335;214;3063;3072;8.50;0.53;207.63;3.77;728;30;1020.00;9
2339;30;628230858;2339;212;3063;3072;8.44;0.52;207.75;3.77;724;30;1021.00;9
2343;30;628230868;2343;211;3066;3072;8.37;0.52;207.83;3.78;723;30;1022.00;6
2346;30;628230877;2346;215;3068;3076;8.35;0.52;207.99;3.78;722;30;1023.00;8
2352;30;628230887;2352;212;3070;3076;8.34;0.51;208.04;3.78;718;30;1024.00;6
2357;30;628230897;2357;210;3071;3076;8.34;0.51;208.02;3.79;714;30;1025.00;5
2362;30;628230913;2362;211;3074;3079;8.41;0.52;208.15;3.79;712;30;1026.00;5
2366;30;628230923;2366;209;3074;3079;8.46;0.52;208.29;3.79;708;30;1027.00;5
2369;30;628230934;2369;201;3075;3079;8.54;0.52;208.41;3.79;706;30;1028.00;4
2372;30;628230944;2372;198;3080;3083;8.64;0.53;208.63;3.79;708;30;1029.00;3
2374;30;628230954;2374;199;3082;3084;8.79;0.54;208.65;3.79;708;30;1030.00;2
2379;30;628230964;2379;188;3082;3084;8.93;0.55;208.98;3.79;703;30;1031.00;2
2383;30;628230975;2383;186;3086;3088;9.07;0.56;209.06;3.78;703;30;1032.00;2
2387;30;628230986;2387;182;3086;3088;9.15;0.56;209.23;3.78;699;30;1033.00;2
2392;30;628230997;2392;181;3086;3088;9.14;0.56;209.36;3.78;694;30;1034.00;2
2396;30;628231007;2396;175;3088;3090;9.22;0.57;209.59;3.78;692;30;1035.00;2
2401;30;628231018;2401;166;3088;3090;9.31;0.57;209.62;3.78;687;30;1036.00;2
2405;30;628231029;2405;161;3093;3096;9.44;0.58;209.84;3.78;688;30;1037.00;3
2410;30;628231040;2410;158;3094;3096;9.47;0.58;210.01;3.78;684;30;1038.00;2
2418;30;628231050;2418;158;3095;3097;9.50;0.58;210.26;3.77;677;30;1039.00;2
2421;30;628231060;2421;162;3095;3097;9.65;0.59;210.27;3.77;674;30;1040.00;2
2428;31;628231070;2428;161;3095;3097;9.67;0.59;210.48;3.77;667;31;1041.00;2
2433;31;628231098;2433;160;3095;3097;9.81;0.60;210.61;3.77;662;31;1042.00;2
2435;31;628231108;2435;163;3095;3097;9.97;0.61;210.62;3.77;660;31;1043.00;2
2439;31;628231118;2439;160;3106;3109;10.06;0.61;210.71;3.76;667;31;1044.00;3
2444;31;628231130;2444;153;3107;3109;10.15;0.62;210.91;3.76;663;31;1045.00;2
2446;31;628231141;2446;152;3107;3109;10.18;0.62;210.85;3.76;661;31;1046.00;2
2449;31;628231152;2449;159;3107;3109;10.22;0.62;210.92;3.76;658;31;1047.00;2
2456;31;628231162;2456;157;3107;3109;10.15;0.62;211.03;3.76;651;31;1048.00;2
2459;31;628231172;2459;163;3107;3109;10.21;0.62;211.31;3.76;648;31;1049.00;2
2462;31;628231184;2462;164;3113;3115;10.21;0.62;211.48;3.75;651;31;1050.00;2
2467;31;628231195;2467;167;3113;3115;10.18;0.62;211.76;3.75;646;31;1051.00;2
2469;31;628231206;2469;166;3116;3119;10.25;0.62;211.75;3.75;647;31;1052.00;3
2471;31;628231217;2471;173;3118;3120;10.28;0.63;211.92;3.75;647;31;1053.00;2
2477;31;628231227;2477;175;3118;3120;10.25;0.62;212.00;3.75;641;31;1054.00;2
2480;31;628231237;2480;179;3118;3120;10.22;0.62;211.98;3.75;638;31;1055.00;2
2484;31;628231247;2484;182;3131;3133;10.17;0.62;212.17;3.73;647;31;1056.00;2
2489;31;628231258;2489;180;3131;3133;10.11;0.62;212.38;3.73;642;31;1057.00;2
2492;31;628231269;2492;173;3132;3133;10.05;0.61;212.34;3.75;640;31;1058.00;1
2493;31;628231280;2493;175;3133;3134;10.10;0.62;212.39;3.75;640;31;1059.00;1
2495;31;628231290;2495;178;3134;3135;10.05;0.61;212.37;3.75;639;31;1060.00;1
2497;31;628231299;2497;176;3134;3135;9.97;0.61;212.50;3.75;637;31;1061.00;1
2501;31;628231310;2501;180;3136;3138;9.95;0.61;212.60;3.74;635;31;1062.00;2
2502;31;628231320;2502;183;3136;3138;9.91;0.60;212.66;3.74;634;31;1063.00;2
2503;31;628231331;2503;187;3137;3138;9.90;0.60;212.61;3.74;634;31;1064.00;1
2505;31;628231341;2505;193;3137;3138;9.84;0.60;212.75;3.74;632;31;1065.00;1
2509;31;628231351;2509;196;3142;3144;9.83;0.60;212.80;3.74;633;31;1066.00;2
2514;31;628231361;2514;193;3142;3144;9.80;0.60;213.11;3.74;628;31;1067.00;2
2517;31;628231372;2517;184;3143;3144;9.77;0.59;213.24;3.74;626;31;1068.00;1
2520;31;628231381;2520;184;3143;3144;9.69;0.59;213.31;3.74;623;31;1069.00;1
2522;31;628231391;2522;182;3147;3148;9.68;0.59;213.34;3.74;625;31;1070.00;1
2528;31;628231401;2528;184;3148;3149;9.65;0.59;213.81;3.73;620;31;1071.00;1
2531;31;628231411;2531;184;3148;3149;9.61;0.59;213.82;3.73;617;31;1072.00;1
2534;31;628231420;2534;181;3149;3150;9.58;0.58;213.94;3.73;615;31;1073.00;1
2537;31;628231430;2537;185;3149;3150;9.52;0.58;213.94;3.73;612;31;1074.00;1
2539;31;628231440;2539;185;3149;3150;9.56;0.58;213.94;3.73;610;31;1075.00;1
2543;31;628231450;2543;176;3149;3150;9.60;0.59;214.00;3.73;606;31;1076.00;1
2545;31;628231460;2545;164;3149;3150;9.66;0.59;214.04;3.73;604;31;1077.00;1
2546;31;628231476;2546;159;3149;3150;9.75;0.60;214.13;3.73;603;31;1078.00;1
2549;31;628231485;2549;153;3149;3150;9.82;0.60;214.23;3.73;600;31;1079.00;1
2551;31;628231502;2551;163;3224;3275;9.77;0.60;214.23;3.65;673;31;1080.00;51
2553;31;628231531;2553;148;3229;3276;9.88;0.61;214.36;3.64;676;31;1081.00;47
2556;31;628231546;2556;135;3233;3276;10.13;0.62;214.42;3.64;677;31;1082.00;43
2558;31;628231562;2558;135;3236;3276;10.21;0.63;214.38;3.64;678;31;1083.00;40
2562;31;628231577;2562;126;3238;3276;10.24;0.63;214.58;3.64;676;31;1084.00;38
2568;31;628231605;2568;123;3240;3276;10.27;0.63;214.73;3.64;672;31;1085.00;36
2571;31;628231621;2571;119;3243;3276;10.33;0.63;214.79;3.64;672;31;1086.00;33
2575;31;628231633;2575;123;3244;3276;10.33;0.64;214.75;3.64;669;31;1087.00;32
2577;31;628231644;2577;123;3249;3277;10.30;0.63;214.77;3.65;672;31;1088.00;28
2583;31;628231662;2583;121;3250;3278;10.22;0.63;214.75;3.65;667;31;1089.00;28
2583;31;628231673;2583;130;3254;3278;10.17;0.62;214.75;3.66;671;31;1090.00;24
2585;31;628231683;2585;129;3260;3282;10.09;0.62;214.65;3.66;675;31;1091.00;22
2587;31;628231702;2587;138;3264;3282;10.12;0.62;214.54;3.67;677;31;1092.00;18
2588;31;628231712;2588;140;3266;3282;10.09;0.62;214.63;3.67;678;31;1093.00;16
2589;31;628231723;2589;151;3266;3282;10.14;0.62;214.60;3.67;677;31;1094.00;16
2589;31;628231733;2589;157;3270;3288;10.17;0.62;214.60;3.67;681;31;1095.00;18
2590;31;628231743;2590;157;3271;3288;10.14;0.62;214.58;3.67;681;31;1096.00;17
2594;31;628231759;2594;166;3271;3288;10.15;0.62;214.47;3.67;677;31;1097.00;17
2594;31;628231775;2594;166;3274;3291;10.19;0.62;214.47;3.67;680;31;1098.00;17
2596;31;628231785;2596;166;3274;3291;10.22;0.62;214.48;3.67;678;31;1099.00;17
2601;31;628231795;2601;170;3275;3291;10.25;0.62;214.41;3.70;674;31;1100.00;16
2602;31;628231810;2602;168;3275;3292;10.28;0.63;214.39;3.70;673;31;1101.00;17
2603;31;628231821;2603;171;3277;3293;10.34;0.63;214.33;3.70;674;31;1102.00;16
2605;31;628231830;2605;172;3277;3293;10.38;0.63;214.22;3.70;672;31;1103.00;16
2605;31;628231839;2605;179;3286;3306;10.33;0.63;214.22;3.69;681;31;1104.00;20
2607;31;628231850;2607;182;3287;3306;10.31;0.63;214.26;3.69;680;31;1105.00;19
2609;31;628231859;2609;185;3287;3306;10.31;0.63;214.20;3.69;678;31;1106.00;19
2612;31;628231875;2612;182;3288;3307;10.35;0.63;214.17;3.69;676;31;1107.00;19
2614;31;628231886;2614;183;3288;3307;10.45;0.64;214.36;3.69;674;31;1108.00;19
2616;31;628231899;2616;180;3291;3311;10.53;0.65;214.33;3.68;675;31;1109.00;20
2617;31;628231914;2617;180;3292;3311;10.63;0.65;214.28;3.68;675;31;1110.00;19
2620;31;628231923;2620;181;3295;3315;10.67;0.65;214.17;3.68;675;31;1111.00;20
2621;31;628231933;2621;179;3295;3315;10.78;0.66;214.11;3.68;674;31;1112.00;20
2625;31;628231948;2625;179;3295;3315;10.92;0.67;214.21;3.68;670;31;1113.00;20
2627;31;628231957;2627;180;3295;3315;10.88;0.67;214.18;3.68;668;31;1114.00;20
2631;31;628231967;2631;177;3296;3315;10.85;0.66;214.05;3.69;665;31;1115.00;19
2636;31;628231976;2636;183;3306;3327;10.92;0.67;213.93;3.68;670;31;1116.00;21
2640;31;628231986;2640;182;3306;3327;10.85;0.66;213.80;3.68;666;31;1117.00;21
2644;31;628232001;2644;182;3308;3327;10.84;0.66;213.72;3.69;664;31;1118.00;19
2646;31;628232022;2646;181;3308;3327;10.87;0.66;213.71;3.69;662;31;1119.00;19
2646;31;628232038;2646;188;3309;3327;10.84;0.66;213.71;3.70;663;31;1120.00;18
2647;31;628232057;2647;186;3309;3327;10.86;0.66;213.66;3.70;662;31;1121.00;18
2649;31;628232068;2649;185;3310;3328;10.92;0.66;213.63;3.71;661;31;1122.00;18
2649;31;628232081;2649;178;3310;3328;11.01;0.67;213.63;3.71;661;31;1123.00;18
2651;31;628232098;2651;174;3315;3334;11.05;0.67;213.59;3.72;664;31;1124.00;19
2655;31;628232110;2655;174;3320;3336;11.04;0.67;213.49;3.73;665;31;1125.00;16
2659;31;628232128;2659;174;3321;3336;11.02;0.67;213.39;3.74;662;31;1126.00;15
2660;31;628232144;2660;174;3321;3336;11.07;0.67;213.36;3.74;661;31;1127.00;15
2661;31;628232163;2661;175;3323;3340;11.06;0.67;213.32;3.74;662;31;1128.00;17
2662;31;628232188;2662;170;3323;3340;11.08;0.67;213.37;3.74;661;31;1129.00;17
2664;31;628232207;2664;172;3324;3340;11.03;0.67;213.27;3.76;660;31;1130.00;16
2664;31;628232225;2664;159;3325;3341;11.09;0.67;213.27;3.76;661;31;1131.00;16
2665;31;628232245;2665;150;3329;3345;11.11;0.67;213.20;3.77;664;31;1132.00;16
2667;31;628232259;2667;143;3329;3345;11.20;0.68;213.25;3.77;662;31;1133.00;16
2667;31;628232271;2667;133;3332;3348;11.32;0.69;213.25;3.78;665;31;1134.00;16
2668;31;628232283;2668;127;3333;3348;11.45;0.70;213.48;3.78;665;31;1135.00;15
2671;31;628232294;2671;120;3334;3348;11.56;0.70;213.49;3.79;663;31;1136.00;14
2674;31;628232305;2674;114;3335;3348;11.67;0.71;213.41;3.81;661;31;1137.00;13
2675;31;628232321;2675;114;3338;3352;11.79;0.71;213.35;3.81;663;31;1138.00;14
2676;31;628232336;2676;111;3339;3352;11.98;0.73;213.28;3.82;663;31;1139.00;13
2677;31;628232348;2677;111;3341;3352;12.08;0.73;213.30;3.83;664;31;1140.00;11
2679;31;628232371;2679;109;3342;3352;12.14;0.73;213.35;3.85;663;31;1141.00;10
2681;31;628232382;2681;109;3343;3353;12.10;0.73;213.26;3.85;662;31;1142.00;10
2682;32;628232392;2682;106;3344;3354;11.97;0.72;213.26;3.85;662;32;1143.00;10
2683;32;628232413;2683;111;3344;3354;11.83;0.72;213.28;3.85;661;32;1144.00;10
2684;32;628232423;2684;116;3345;3355;11.70;0.71;213.26;3.85;661;32;1145.00;10
2686;32;628232439;2686;118;3345;3355;11.57;0.70;213.26;3.85;659;32;1146.00;10
2689;32;628232449;2689;123;3345;3355;11.51;0.70;213.24;3.85;656;32;1147.00;10
2690;32;628232459;2690;130;3345;3355;11.45;0.69;213.26;3.85;655;32;1148.00;10
2690;32;628232469;2690;133;3346;3355;11.40;0.69;213.26;3.86;656;32;1149.00;9
2691;32;628232480;2691;145;3347;3355;11.37;0.69;213.23;3.88;656;32;1150.00;8
2693;32;628232489;2693;148;3347;3355;11.34;0.69;213.27;3.88;654;32;1151.00;8
2694;32;628232501;2694;169;3412;3482;11.20;0.69;213.42;3.81;718;32;1152.00;70
2696;32;628232522;2696;167;3415;3483;11.14;0.69;213.42;3.82;719;32;1153.00;68
2700;32;628232533;2700;170;3425;3483;11.15;0.69;213.58;3.82;725;32;1154.00;58
2702;32;628232543;2702;169;3433;3483;11.04;0.68;213.61;3.83;731;32;1155.00;50
2703;32;628232553;2703;170;3440;3483;11.08;0.68;213.61;3.84;737;32;1156.00;43
2706;32;628232563;2706;169;3443;3483;11.03;0.68;213.59;3.84;737;32;1157.00;40
2708;32;628232572;2708;172;3450;3483;10.92;0.67;213.65;3.85;742;32;1158.00;33
2709;32;628232582;2709;180;3453;3483;10.82;0.67;213.74;3.86;744;32;1159.00;30
2715;32;628232593;2715;180;3457;3484;10.68;0.66;213.64;3.86;742;32;1160.00;27
2719;32;628232609;2719;191;3461;3485;10.57;0.65;213.62;3.87;742;32;1161.00;24
2721;32;628232620;2721;196;3466;3485;10.46;0.64;213.63;3.88;745;32;1162.00;19
2724;32;628232630;2724;204;3470;3486;10.27;0.63;213.64;3.89;746;32;1163.00;16
2726;32;628232641;2726;211;3474;3486;10.06;0.62;213.77;3.89;748;32;1164.00;12
2728;32;628232651;2728;219;3474;3486;9.91;0.61;213.73;3.89;746;32;1165.00;12
2733;32;628232661;2733;223;3476;3486;9.70;0.60;213.67;3.90;743;32;1166.00;10
2734;32;628232671;2734;232;3480;3490;9.56;0.59;213.66;3.91;746;32;1167.00;10
2737;32;628232681;2737;245;3482;3490;9.35;0.58;213.72;3.91;745;32;1168.00;8
2740;32;628232691;2740;243;3484;3490;9.18;0.57;213.60;3.92;744;32;1169.00;6
2744;32;628232703;2744;253;3489;3496;9.02;0.56;213.50;3.91;745;32;1170.00;7
2746;32;628232713;2746;257;3489;3496;8.86;0.55;213.52;3.91;743;32;1171.00;7
2749;32;628232724;2749;258;3490;3496;8.73;0.54;213.50;3.92;741;32;1172.00;6
2754;32;628232733;2754;258;3494;3500;8.58;0.53;213.45;3.91;740;32;1173.00;6
2757;32;628232743;2757;258;3496;3501;8.58;0.53;213.43;3.91;739;32;1174.00;5
2758;32;628232753;2758;260;3496;3501;8.61;0.53;213.42;3.91;738;32;1175.00;5
2759;32;628232763;2759;257;3501;3505;8.68;0.53;213.40;3.91;742;32;1176.00;4
2762;32;628232772;2762;254;3501;3505;8.69;0.53;213.45;3.91;739;32;1177.00;4
2764;32;628232782;2764;254;3502;3505;8.69;0.53;213.45;3.91;738;32;1178.00;3
2768;32;628232791;2768;255;3503;3506;8.73;0.54;213.43;3.91;735;32;1179.00;3
2770;32;628232800;2770;252;3503;3506;8.79;0.54;213.40;3.91;733;32;1180.00;3
2774;32;628232810;2774;252;3508;3512;8.79;0.54;213.42;3.90;734;32;1181.00;4
2776;32;628232820;2776;245;3508;3512;8.76;0.54;213.43;3.90;732;32;1182.00;4
2783;32;628232830;2783;247;3510;3513;8.70;0.53;213.40;3.90;727;32;1183.00;3
2788;33;628232839;2788;245;3510;3513;8.70;0.53;213.48;3.90;722;33;1184.00;3
2792;33;628232859;2792;247;3510;3513;8.70;0.53;213.57;3.90;718;33;1185.00;3
2796;33;628232869;2796;244;3510;3513;8.62;0.53;213.74;3.90;714;33;1186.00;3
2801;33;628232878;2801;242;3510;3513;8.56;0.52;213.70;3.90;709;33;1187.00;3
2805;33;628232886;2805;245;3521;3525;8.51;0.52;213.81;3.89;716;33;1188.00;4
2809;33;628232896;2809;241;3521;3525;8.49;0.52;213.95;3.89;712;33;1189.00;4
2814;33;628232905;2814;235;3522;3525;8.45;0.52;214.16;3.89;708;33;1190.00;3
2817;33;628232914;2817;227;3522;3525;8.40;0.52;214.31;3.89;705;33;1191.00;3
2820;33;628232923;2820;228;3522;3525;8.45;0.52;214.37;3.89;702;33;1192.00;3
2824;33;628232935;2824;222;3522;3525;8.52;0.52;214.53;3.89;698;33;1193.00;3
2828;33;628232945;2828;219;3526;3529;8.59;0.53;214.68;3.89;698;33;1194.00;3
2831;33;628232955;2831;215;3526;3529;8.75;0.54;214.79;3.89;695;33;1195.00;3
2836;33;628232964;2836;208;3529;3533;8.91;0.55;214.95;3.88;693;33;1196.00;4
2840;33;628232975;2840;198;3530;3534;9.06;0.56;215.01;3.88;690;33;1197.00;4
2844;33;628232985;2844;193;3531;3534;9.24;0.57;215.12;3.88;687;33;1198.00;3
2854;33;628232994;2854;185;3531;3534;9.33;0.57;215.21;3.88;677;33;1199.00;3
2856;33;628233007;2856;181;3553;3575;9.39;0.57;215.32;3.86;697;33;1200.00;22
2864;33;628233025;2864;178;3556;3575;9.42;0.57;215.53;3.86;692;33;1201.00;19
2866;33;628233035;2866;174;3558;3575;9.56;0.58;215.66;3.85;692;33;1202.00;17
2870;34;628233044;2870;170;3561;3576;9.64;0.59;215.74;3.85;691;34;1203.00;15
2874;34;628233060;2874;174;3564;3577;9.69;0.59;215.91;3.85;690;34;1204.00;13
2878;34;628233070;2878;172;3565;3577;9.80;0.60;216.09;3.85;687;34;1205.00;12
2882;34;628233079;2882;172;3567;3580;9.92;0.60;216.11;3.85;685;34;1206.00;13
2888;34;628233089;2888;171;3568;3580;9.95;0.61;216.34;3.85;680;34;1207.00;12
2893;34;628233099;2893;168;3569;3580;9.98;0.61;216.39;3.85;676;34;1208.00;11
2895;34;628233109;2895;168;3569;3580;10.04;0.61;216.38;3.85;674;34;1209.00;11
2901;34;628233118;2901;168;3576;3586;9.92;0.61;216.51;3.85;675;34;1210.00;10
2905;34;628233129;2905;172;3577;3586;9.86;0.60;216.64;3.85;672;34;1211.00;9
2910;34;628233138;2910;170;3577;3586;9.78;0.60;216.55;3.85;667;34;1212.00;9
2914;35;628233148;2914;171;3577;3586;9.65;0.59;216.64;3.85;663;35;1213.00;9
2921;35;628233173;2921;167;3581;3590;9.61;0.59;216.64;3.85;660;35;1214.00;9
2922;35;628233183;2922;168;3584;3592;9.60;0.59;216.66;3.85;662;35;1215.00;8
2930;35;628233194;2930;172;3584;3592;9.51;0.58;216.83;3.85;654;35;1216.00;8
2934;35;628233203;2934;175;3585;3593;9.47;0.58;216.98;3.85;651;35;1217.00;8
2934;35;628233212;2934;175;3586;3593;9.47;0.58;216.98;3.88;652;35;1218.00;7
2938;35;628233222;2938;181;3586;3593;9.41;0.57;217.05;3.88;648;35;1219.00;7
2942;35;628233231;2942;185;3586;3593;9.42;0.58;217.11;3.88;644;35;1220.00;7
2945;35;628233244;2945;192;3587;3593;9.40;0.57;217.04;3.89;642;35;1221.00;6
2950;35;628233255;2950;198;3587;3593;9.37;0.57;216.97;3.89;637;35;1222.00;6
2953;36;628233265;2953;204;3587;3593;9.34;0.57;217.14;3.89;634;36;1223.00;6
2957;36;628233284;2957;218;3627;3663;9.14;0.56;217.09;3.85;670;36;1224.00;36
2960;36;628233299;2960;214;3628;3664;9.13;0.56;217.06;3.85;668;36;1225.00;36
2964;36;628233309;2964;213;3633;3664;9.25;0.56;217.11;3.84;669;36;1226.00;31
2967;36;628233319;2967;220;3634;3664;9.26;0.56;217.22;3.85;667;36;1227.00;30
2968;36;628233329;2968;220;3638;3666;9.35;0.57;217.26;3.85;670;36;1228.00;28
2971;36;628233339;2971;217;3641;3666;9.33;0.57;217.34;3.85;670;36;1229.00;25
2974;36;628233350;2974;220;3645;3666;9.37;0.57;217.22;3.85;671;36;1230.00;21
2975;36;628233359;2975;226;3647;3666;9.39;0.57;217.27;3.85;672;36;1231.00;19
2981;36;628233368;2981;233;3650;3667;9.35;0.57;217.35;3.86;669;36;1232.00;17
2985;36;628233378;2985;240;3657;3668;9.24;0.56;217.52;3.87;672;36;1233.00;11
2988;36;628233389;2988;248;3659;3668;9.11;0.55;217.60;3.87;671;36;1234.00;9
2990;36;628233403;2990;257;3663;3672;8.91;0.54;217.62;3.87;673;36;1235.00;9
2991;36;628233413;2991;266;3665;3672;8.84;0.54;217.65;3.87;674;36;1236.00;7
2994;36;628233422;2994;258;3666;3672;8.77;0.54;217.75;3.88;672;36;1237.00;6
2996;36;628233431;2996;254;3667;3672;8.71;0.53;217.84;3.88;671;36;1238.00;5
2997;36;628233440;2997;251;3672;3678;8.68;0.53;217.84;3.87;675;36;1239.00;6
3000;36;628233450;3000;244;3673;3678;8.71;0.53;217.96;3.87;673;36;1240.00;5
3005;36;628233459;3005;244;3673;3678;8.71;0.53;218.04;3.87;668;36;1241.00;5
3006;36;628233470;3006;242;3676;3681;8.84;0.54;218.10;3.87;670;36;1242.00;5
3009;37;628233479;3009;240;3676;3681;8.89;0.54;218.28;3.87;667;37;1243.00;5
3014;37;628233504;3014;235;3676;3681;8.92;0.54;218.28;3.87;662;37;1244.00;5
3018;37;628233517;3018;239;3677;3682;8.88;0.54;218.29;3.87;659;37;1245.00;5
3019;37;628233533;3019;226;3678;3683;8.99;0.55;218.24;3.87;659;37;1246.00;5
3025;37;628233551;3025;212;3678;3683;9.02;0.55;218.26;3.87;653;37;1247.00;5
3026;37;628233565;3026;203;3691;3696;9.13;0.55;218.20;3.86;665;37;1248.00;5
3030;37;628233582;3030;196;3691;3696;9.19;0.56;218.30;3.86;661;37;1249.00;5
3032;37;628233597;3032;191;3691;3696;9.27;0.56;218.30;3.86;659;37;1250.00;5
3033;37;628233620;3033;186;3692;3697;9.34;0.57;218.23;3.85;659;37;1251.00;5
3033;37;628233631;3033;185;3692;3697;9.37;0.57;218.23;3.85;659;37;1252.00;5
3036;37;628233642;3036;179;3695;3701;9.35;0.57;218.14;3.85;659;37;1253.00;6
3036;37;628233653;3036;176;3695;3701;9.45;0.57;218.14;3.85;659;37;1254.00;6
3040;37;628233669;3040;172;3700;3705;9.42;0.57;218.17;3.85;660;37;1255.00;5
3041;37;628233681;3041;174;3700;3705;9.49;0.58;218.15;3.85;659;37;1256.00;5
3044;38;628233691;3044;174;3700;3705;9.53;0.58;218.21;3.85;656;38;1257.00;5
3045;38;628233713;3045;180;3700;3705;9.54;0.58;218.15;3.85;655;38;1258.00;5
3047;38;628233723;3047;178;3700;3705;9.57;0.58;218.12;3.85;653;38;1259.00;5
3050;38;628233734;3050;180;3721;3739;9.50;0.58;218.08;3.83;671;38;1260.00;18
3052;38;628233747;3052;176;3722;3739;9.52;0.58;217.98;3.83;670;38;1261.00;17
3053;38;628233756;3053;179;3723;3739;9.54;0.58;217.94;3.83;670;38;1262.00;16
3056;38;628233766;3056;177;3724;3739;9.57;0.59;217.85;3.83;668;38;1263.00;15
3058;38;628233776;3058;178;3724;3739;9.64;0.59;217.77;3.83;666;38;1264.00;15
3058;38;628233785;3058;176;3725;3739;9.70;0.59;217.77;3.83;667;38;1265.00;14
3063;38;628233795;3063;180;3725;3740;9.72;0.59;217.58;3.83;662;38;1266.00;15
3063;38;628233804;3063;179;3726;3740;9.77;0.60;217.58;3.83;663;38;1267.00;14
3064;38;628233814;3064;179;3729;3746;9.84;0.60;217.55;3.82;665;38;1268.00;17
3067;38;628233824;3067;183;3731;3747;9.92;0.60;217.51;3.82;664;38;1269.00;16
3069;38;628233833;3069;183;3731;3747;9.96;0.61;217.51;3.82;662;38;1270.00;16
3070;38;628233843;3070;183;3732;3747;9.99;0.61;217.52;3.82;662;38;1271.00;15
3073;38;628233852;3073;184;3734;3751;9.96;0.61;217.42;3.82;661;38;1272.00;17
3074;38;628233867;3074;190;3734;3751;9.87;0.60;217.36;3.82;660;38;1273.00;17
3074;38;628233876;3074;187;3734;3751;9.84;0.60;217.36;3.82;660;38;1274.00;17
3076;38;628233884;3076;195;3735;3752;9.87;0.60;217.52;3.82;659;38;1275.00;17
3078;38;628233893;3078;198;3738;3756;9.92;0.60;217.42;3.82;660;38;1276.00;18
3078;38;628233902;3078;200;3738;3756;10.01;0.61;217.42;3.82;660;38;1277.00;18
3080;38;628233911;3080;204;3740;3759;10.06;0.61;217.35;3.82;660;38;1278.00;19
3081;38;628233920;3081;208;3740;3759;10.10;0.62;217.33;3.82;659;38;1279.00;19
3081;39;628233935;3081;208;3741;3759;10.14;0.62;217.33;3.82;660;39;1280.00;18
3081;39;628233954;3081;205;3741;3759;10.20;0.62;217.33;3.82;660;39;1281.00;18
3086;39;628233963;3086;204;3744;3763;10.23;0.62;217.25;3.81;658;39;1282.00;19
3087;39;628233973;3087;190;3744;3763;10.26;0.62;217.23;3.81;657;39;1283.00;19
3088;39;628233983;3088;181;3745;3763;10.32;0.63;217.25;3.81;657;39;1284.00;18
3091;39;628233991;3091;174;3745;3763;10.43;0.63;217.25;3.81;654;39;1285.00;18
3094;39;628234001;3094;166;3745;3764;10.44;0.63;217.24;3.81;651;39;1286.00;19
3096;39;628234009;3096;159;3746;3765;10.49;0.64;217.20;3.81;650;39;1287.00;19
3096;39;628234019;3096;156;3746;3765;10.55;0.64;217.20;3.81;650;39;1288.00;19
3099;39;628234028;3099;145;3747;3766;10.60;0.64;217.20;3.81;648;39;1289.00;19
3102;39;628234048;3102;138;3748;3766;10.65;0.65;217.16;3.85;646;39;1290.00;18
3106;39;628234060;3106;133;3748;3766;10.78;0.65;217.14;3.85;642;39;1291.00;18
3106;40;628234072;3106;121;3748;3766;10.90;0.66;217.14;3.85;642;40;1292.00;18
3109;40;628234097;3109;112;3748;3766;11.03;0.67;217.08;3.85;639;40;1293.00;18
3113;40;628234108;3113;103;3749;3766;11.22;0.68;217.07;3.86;636;40;1294.00;17
3115;40;628234127;3115;97;3750;3766;11.42;0.69;217.02;3.86;635;40;1295.00;16
3115;40;628234144;3115;110;3814;3893;11.37;0.70;217.02;3.80;699;40;1296.00;79
3116;40;628234164;3116;104;3814;3894;11.51;0.71;216.98;3.80;698;40;1297.00;80
3118;40;628234174;3118;93;3822;3894;11.70;0.72;216.92;3.79;704;40;1298.00;72
3120;40;628234184;3120;89;3825;3894;11.84;0.72;216.87;3.79;705;40;1299.00;69
3122;40;628234195;3122;86;3829;3894;11.97;0.73;216.86;3.79;707;40;1300.00;65
3123;40;628234210;3123;84;3834;3894;12.03;0.74;216.82;3.80;711;40;1301.00;60
3123;40;628234220;3123;80;3839;3894;12.16;0.74;216.82;3.80;716;40;1302.00;55
3123;40;628234230;3123;84;3841;3894;12.21;0.75;216.82;3.81;718;40;1303.00;53
3125;40;628234240;3125;85;3846;3895;12.24;0.75;216.74;3.82;721;40;1304.00;49
3128;40;628234258;3128;89;3850;3897;12.19;0.75;216.70;3.82;722;40;1305.00;47
3129;40;628234269;3129;93;3853;3897;12.23;0.75;216.77;3.82;724;40;1306.00;44
3130;40;628234280;3130;93;3856;3898;12.18;0.75;216.73;3.87;726;40;1307.00;42
3136;40;628234290;3136;97;3859;3898;12.08;0.74;216.85;3.88;723;40;1308.00;39
3139;40;628234301;3139;101;3860;3898;11.94;0.73;216.86;3.88;721;40;1309.00;38
3142;40;628234312;3142;105;3862;3898;11.77;0.72;216.87;3.90;720;40;1310.00;36
3146;40;628234322;3146;108;3864;3902;11.68;0.72;216.88;3.90;718;40;1311.00;38
3151;40;628234333;3151;116;3869;3902;11.55;0.71;216.97;3.92;718;40;1312.00;33
3154;40;628234356;3154;120;3870;3902;11.56;0.71;216.97;3.92;716;40;1313.00;32
3156;40;628234367;3156;129;3873;3905;11.48;0.70;216.96;3.93;717;40;1314.00;32
3158;40;628234379;3158;133;3877;3905;11.31;0.69;217.05;3.94;719;40;1315.00;28
3165;40;628234396;3165;138;3880;3905;11.16;0.68;217.07;3.96;715;40;1316.00;25
3167;40;628234407;3167;149;3884;3909;11.01;0.67;217.16;3.96;717;40;1317.00;25
3168;40;628234418;3168;150;3886;3910;10.95;0.67;217.17;3.97;718;40;1318.00;24
3171;40;628234429;3171;156;3888;3910;10.91;0.66;217.21;3.98;717;40;1319.00;22
3177;40;628234442;3177;160;3894;3915;10.90;0.66;217.23;4.00;717;40;1320.00;21
3179;40;628234459;3179;160;3895;3915;10.84;0.66;217.29;4.00;716;40;1321.00;20
3180;40;628234478;3180;168;3896;3915;10.74;0.65;217.30;4.00;716;40;1322.00;19
3183;40;628234489;3183;173;3898;3916;10.65;0.64;217.43;4.01;715;40;1323.00;18
3184;40;628234503;3184;181;3898;3916;10.56;0.64;217.44;4.01;714;40;1324.00;18
3187;40;628234514;3187;185;3904;3922;10.43;0.63;217.61;4.02;717;40;1325.00;18
3188;40;628234526;3188;191;3904;3922;10.29;0.62;217.72;4.02;716;40;1326.00;18
3191;40;628234537;3191;191;3906;3923;10.15;0.62;217.83;4.03;715;40;1327.00;17
3193;40;628234549;3193;192;3907;3923;10.09;0.61;217.80;4.04;714;40;1328.00;16
3193;40;628234559;3193;192;3909;3923;10.05;0.61;217.80;4.05;716;40;1329.00;14
3198;40;628234569;3198;201;3910;3923;10.01;0.61;217.82;4.05;712;40;1330.00;13
3200;40;628234584;3200;202;3910;3923;9.99;0.61;217.79;4.05;710;40;1331.00;13
3201;40;628234594;3201;209;3921;3935;9.98;0.61;217.80;4.05;720;40;1332.00;14
3205;40;628234604;3205;209;3923;3935;9.92;0.60;217.73;4.06;718;40;1333.00;12
3207;40;628234614;3207;213;3923;3935;9.93;0.61;217.73;4.06;716;40;1334.00;12
3210;40;628234623;3210;217;3923;3935;9.88;0.60;217.67;4.06;713;40;1335.00;12
3212;40;628234633;3212;229;3923;3935;9.82;0.60;217.68;4.06;711;40;1336.00;12
3214;40;628234643;3214;232;3927;3935;9.73;0.59;217.64;4.07;713;40;1337.00;8
3216;40;628234652;3216;234;3930;3939;9.63;0.59;217.59;4.07;714;40;1338.00;9
3219;40;628234662;3219;230;3932;3939;9.58;0.58;217.59;4.07;713;40;1339.00;7
3222;40;628234671;3222;228;3935;3943;9.58;0.58;217.55;4.07;713;40;1340.00;8
3224;40;628234681;3224;226;3937;3944;9.55;0.58;217.56;4.07;713;40;1341.00;7
3226;40;628234691;3226;226;3937;3944;9.49;0.58;217.54;4.07;711;40;1342.00;7
3230;40;628234701;3230;229;3937;3944;9.35;0.57;217.57;4.07;707;40;1343.00;7
3233;40;628234710;3233;231;3949;3957;9.24;0.56;217.64;4.06;716;40;1344.00;8
3238;40;628234727;3238;224;3949;3957;9.07;0.56;217.48;4.06;711;40;1345.00;8
3239;40;628234737;3239;227;3950;3957;9.06;0.56;217.49;4.06;711;40;1346.00;7
3242;40;628234746;3242;232;3951;3958;9.06;0.55;217.46;4.05;709;40;1347.00;7
3243;40;628234756;3243;237;3952;3959;9.05;0.56;217.54;4.05;709;40;1348.00;7
3246;40;628234765;3246;238;3952;3959;9.03;0.55;217.58;4.05;706;40;1349.00;7
3248;40;628234775;3248;238;3955;3968;9.03;0.55;217.61;4.05;707;40;1350.00;13
3251;40;628234791;3251;243;3956;3968;9.02;0.55;217.60;4.05;705;40;1351.00;12
3255;40;628234800;3255;239;3957;3968;8.98;0.55;217.77;4.05;702;40;1352.00;11
3257;40;628234809;3257;238;3957;3968;8.97;0.55;217.82;4.05;700;40;1353.00;11
3266;40;628234818;3266;239;3962;3974;8.95;0.55;217.85;4.05;696;40;1354.00;12
3269;40;628234828;3269;243;3962;3974;8.86;0.54;217.94;4.05;693;40;1355.00;12
3274;40;628234837;3274;244;3963;3974;8.73;0.54;218.22;4.05;689;40;1356.00;11
3278;40;628234846;3278;248;3963;3974;8.61;0.53;218.31;4.05;685;40;1357.00;11
3284;40;628234854;3284;254;3968;3978;8.39;0.51;218.37;4.05;684;40;1358.00;10
3288;40;628234863;3288;254;3970;3979;8.26;0.51;218.66;4.04;682;40;1359.00;9
3291;40;628234871;3291;249;3971;3979;8.19;0.50;218.84;4.05;680;40;1360.00;8
3293;40;628234879;3293;245;3972;3980;8.18;0.50;218.95;4.04;679;40;1361.00;8
3298;40;628234888;3298;243;3972;3980;8.17;0.50;219.09;4.04;674;40;1362.00;8
3301;40;628234896;3301;240;3972;3980;8.22;0.51;219.21;4.04;671;40;1363.00;8
3307;40;628234904;3307;241;3972;3980;8.22;0.51;219.49;4.04;665;40;1364.00;8
3313;40;628234912;3313;237;3972;3980;8.21;0.50;219.57;4.04;659;40;1365.00;8
3320;40;628234921;3320;236;3972;3980;8.17;0.50;219.68;4.04;652;40;1366.00;8
3325;40;628234929;3325;233;3972;3980;8.16;0.50;219.78;4.04;647;40;1367.00;8
3327;40;628234939;3327;236;4012;4050;8.24;0.51;219.77;4.00;685;40;1368.00;38
3331;40;628234952;3331;226;4017;4051;8.24;0.51;219.88;4.00;686;40;1369.00;34
3334;40;628234961;3334;226;4023;4051;8.42;0.52;219.92;4.00;689;40;1370.00;28
3338;40;628234969;3338;228;4026;4051;8.43;0.52;219.98;4.04;688;40;1371.00;25
3342;40;628234978;3342;228;4030;4051;8.53;0.52;219.99;4.04;688;40;1372.00;21
3348;40;628234986;3348;227;4034;4051;8.50;0.52;220.12;4.04;686;40;1373.00;17
3351;40;628234995;3351;225;4039;4051;8.51;0.52;220.16;4.04;688;40;1374.00;12
3352;40;628235004;3352;226;4040;4051;8.46;0.52;220.18;4.04;688;40;1375.00;11
3354;40;628235012;3354;230;4042;4052;8.38;0.51;220.20;4.04;688;40;1376.00;10
3358;40;628235020;3358;234;4043;4053;8.34;0.51;220.20;4.04;685;40;1377.00;10
3364;40;628235029;3364;233;4044;4053;8.32;0.51;220.21;4.04;680;40;1378.00;9
3367;40;628235037;3367;232;4047;4057;8.38;0.51;220.23;4.04;680;40;1379.00;10
3372;40;628235048;3372;232;4047;4057;8.36;0.51;220.28;4.04;675;40;1380.00;10
3373;40;628235056;3373;235;4047;4057;8.41;0.51;220.31;4.04;674;40;1381.00;10
3374;40;628235065;3374;233;4047;4057;8.40;0.51;220.25;4.04;673;40;1382.00;10
3377;40;628235078;3377;229;4052;4063;8.43;0.52;220.33;4.04;675;40;1383.00;11
3382;41;628235087;3382;225;4052;4063;8.45;0.52;220.33;4.04;670;41;1384.00;11
3386;41;628235106;3386;222;4053;4063;8.52;0.52;220.58;4.04;667;41;1385.00;10
3393;41;628235115;3393;215;4055;4066;8.49;0.52;220.72;4.04;662;41;1386.00;11
3398;41;628235124;3398;218;4057;4066;8.42;0.52;220.84;4.04;659;41;1387.00;9
3406;41;628235133;3406;222;4058;4066;8.37;0.51;220.91;4.04;652;41;1388.00;8
3409;41;628235142;3409;216;4060;4067;8.35;0.51;220.90;4.05;651;41;1389.00;7
3417;41;628235151;3417;220;4061;4068;8.25;0.50;220.92;4.05;644;41;1390.00;7
3418;41;628235160;3418;222;4061;4068;8.27;0.50;220.97;4.05;643;41;1391.00;7
3422;42;628235168;3422;227;4074;4081;8.25;0.50;221.03;4.03;652;42;1392.00;7
3428;42;628235185;3428;234;4074;4081;8.21;0.50;221.11;4.03;646;42;1393.00;7
3430;42;628235193;3430;235;4075;4081;8.23;0.50;221.10;4.08;645;42;1394.00;6
3433;42;628235206;3433;234;4077;4083;8.32;0.51;221.14;4.08;644;42;1395.00;6
3435;42;628235215;3435;239;4077;4083;8.28;0.50;221.14;4.08;642;42;1396.00;6
3439;42;628235224;3439;245;4080;4087;8.19;0.50;221.31;4.08;641;42;1397.00;7
3442;42;628235233;3442;248;4080;4087;8.11;0.50;221.31;4.08;638;42;1398.00;7
3445;42;628235241;3445;257;4085;4091;8.12;0.50;221.23;4.07;640;42;1399.00;6
3450;42;628235251;3450;261;4085;4091;8.13;0.50;221.17;4.07;635;42;1400.00;6
3453;42;628235263;3453;265;4085;4091;8.10;0.49;221.24;4.07;632;42;1401.00;6
3454;42;628235272;3454;267;4085;4091;8.11;0.49;221.22;4.07;631;42;1402.00;6
3457;42;628235280;3457;274;4085;4091;8.02;0.49;221.16;4.07;628;42;1403.00;6
3461;42;628235289;3461;281;4095;4103;7.98;0.49;221.29;4.06;634;42;1404.00;8
3461;42;628235298;3461;285;4095;4103;7.88;0.48;221.29;4.06;634;42;1405.00;8
3465;42;628235306;3465;288;4097;4103;7.78;0.47;221.20;4.06;632;42;1406.00;6
3467;43;628235316;3467;283;4097;4103;7.79;0.48;221.11;4.06;630;43;1407.00;6
3468;43;628235338;3468;281;4097;4103;7.83;0.48;221.08;4.06;629;43;1408.00;6
3470;43;628235347;3470;274;4097;4103;7.83;0.48;221.03;4.06;627;43;1409.00;6
3471;43;628235357;3471;269;4099;4104;7.81;0.48;221.00;4.11;628;43;1410.00;5
3473;43;628235366;3473;267;4099;4104;7.77;0.48;220.89;4.11;626;43;1411.00;5
3473;43;628235374;3473;267;4104;4110;7.78;0.48;220.89;4.10;631;43;1412.00;6
3476;43;628235382;3476;266;4105;4111;7.84;0.48;220.83;4.10;629;43;1413.00;6
3479;43;628235391;3479;263;4106;4111;7.88;0.48;220.74;4.10;627;43;1414.00;5
3480;43;628235399;3480;264;4106;4111;7.92;0.48;220.71;4.10;626;43;1415.00;5
3481;43;628235407;3481;247;4110;4115;7.97;0.49;220.66;4.10;629;43;1416.00;5
3485;43;628235416;3485;234;4110;4115;7.94;0.48;220.64;4.10;625;43;1417.00;5
3485;43;628235430;3485;229;4110;4115;7.94;0.48;220.64;4.10;625;43;1418.00;5
3486;43;628235438;3486;222;4111;4116;8.03;0.49;220.61;4.10;625;43;1419.00;5
3486;43;628235447;3486;215;4115;4120;8.11;0.50;220.61;4.09;629;43;1420.00;5
3488;43;628235456;3488;208;4115;4120;8.22;0.50;220.59;4.09;627;43;1421.00;5
3491;43;628235465;3491;206;4117;4123;8.34;0.51;220.52;4.09;626;43;1422.00;6
3492;43;628235474;3492;200;4117;4123;8.45;0.52;220.48;4.09;625;43;1423.00;6
3493;43;628235483;3493;202;4118;4123;8.57;0.52;220.43;4.09;625;43;1424.00;5
3496;43;628235492;3496;201;4118;4123;8.66;0.53;220.39;4.09;622;43;1425.00;5
3497;43;628235503;3497;192;4121;4127;8.80;0.53;220.38;4.09;624;43;1426.00;6
3500;43;628235516;3500;189;4122;4127;8.91;0.54;220.40;4.13;622;43;1427.00;5
3501;43;628235532;3501;191;4123;4127;9.00;0.55;220.41;4.13;622;43;1428.00;4
3502;43;628235545;3502;187;4123;4127;9.06;0.55;220.43;4.13;621;43;1429.00;4
3503;43;628235557;3503;181;4124;4128;9.10;0.55;220.43;4.13;621;43;1430.00;4
3504;43;628235571;3504;178;4125;4129;9.15;0.56;220.43;4.13;621;43;1431.00;4
3505;44;628235582;3505;180;4125;4129;9.21;0.56;220.39;4.13;620;44;1432.00;4
3506;44;628235613;3506;177;4126;4130;9.32;0.57;220.38;4.12;620;44;1433.00;4
3507;44;628235623;3507;174;4126;4130;9.38;0.57;220.41;4.12;619;44;1434.00;4
3507;44;628235638;3507;160;4126;4130;9.50;0.58;220.41;4.12;619;44;1435.00;4
3507;44;628235647;3507;148;4126;4130;9.64;0.59;220.41;4.12;619;44;1436.00;4
3508;44;628235664;3508;138;4126;4130;9.79;0.60;220.43;4.12;618;44;1437.00;4
3509;44;628235673;3509;131;4126;4130;9.94;0.61;220.43;4.12;617;44;1438.00;4
3512;44;628235689;3512;126;4126;4130;10.22;0.62;220.42;4.12;614;44;1439.00;4
3514;44;628235702;3514;161;4239;4360;10.06;0.63;220.39;4.02;725;44;1440.00;121
3516;44;628235732;3516;145;4242;4361;10.25;0.64;220.34;4.01;726;44;1441.00;119
3517;44;628235749;3517;129;4251;4361;10.48;0.65;220.30;4.01;734;44;1442.00;110
3519;44;628235760;3519;122;4260;4361;10.68;0.67;220.35;4.01;741;44;1443.00;101
3521;44;628235770;3521;111;4267;4361;10.82;0.67;220.36;4.01;746;44;1444.00;94
3523;44;628235780;3523;108;4273;4361;10.92;0.68;220.35;4.05;750;44;1445.00;88
3524;44;628235790;3524;112;4279;4361;11.01;0.68;220.30;4.05;755;44;1446.00;82
3526;44;628235799;3526;114;4282;4361;11.16;0.69;220.30;4.06;756;44;1447.00;79
3530;44;628235816;3530;116;4289;4362;11.18;0.69;220.31;4.06;759;44;1448.00;73
3532;44;628235832;3532;117;4291;4363;11.16;0.69;220.28;4.06;759;44;1449.00;72
3532;44;628235843;3532;123;4293;4363;11.12;0.69;220.28;4.06;761;44;1450.00;70
3533;44;628235854;3533;131;4295;4364;11.13;0.69;220.25;4.07;762;44;1451.00;69
3536;44;628235864;3536;137;4299;4364;11.00;0.68;220.25;4.08;763;44;1452.00;65
3537;44;628235875;3537;145;4300;4364;11.01;0.68;220.23;4.08;763;44;1453.00;64
3539;44;628235885;3539;142;4302;4364;10.98;0.68;220.37;4.08;763;44;1454.00;62
3540;44;628235896;3540;149;4307;4368;11.01;0.68;220.34;4.12;767;44;1455.00;61
3542;44;628235906;3542;156;4309;4368;11.01;0.68;220.31;4.13;767;44;1456.00;59
3547;44;628235923;3547;162;4312;4368;10.98;0.67;220.44;4.14;765;44;1457.00;56
3549;44;628235942;3549;161;4315;4371;11.04;0.68;220.44;4.18;766;44;1458.00;56
3550;44;628235952;3550;167;4316;4371;11.10;0.68;220.47;4.18;766;44;1459.00;55
3553;44;628235963;3553;165;4316;4371;11.11;0.68;220.42;4.18;763;44;1460.00;55
3560;44;628235975;3560;167;4321;4375;11.09;0.68;220.43;4.20;761;44;1461.00;54
3562;44;628235986;3562;164;4323;4376;11.18;0.68;220.46;4.20;761;44;1462.00;53
3567;44;628235997;3567;163;4323;4376;11.20;0.68;220.43;4.20;756;44;1463.00;53
3572;44;628236007;3572;155;4327;4380;11.23;0.68;220.49;4.21;755;44;1464.00;53
3575;44;628236019;3575;154;4329;4380;11.22;0.68;220.53;4.22;754;44;1465.00;51
3577;44;628236036;3577;154;4331;4380;11.23;0.68;220.67;4.23;754;44;1466.00;49
3580;44;628236047;3580;152;4331;4381;11.34;0.69;220.83;4.23;751;44;1467.00;50
3582;44;628236058;3582;147;4333;4381;11.39;0.69;220.84;4.24;751;44;1468.00;48
3585;44;628236070;3585;141;4337;4387;11.41;0.69;220.96;4.24;752;44;1469.00;50
3588;44;628236084;3588;137;4337;4387;11.50;0.70;221.03;4.24;749;44;1470.00;50
3589;44;628236097;3589;129;4339;4388;11.60;0.70;221.11;4.25;750;44;1471.00;49
3592;44;628236109;3592;129;4339;4388;11.54;0.70;221.22;4.25;747;44;1472.00;49
3595;44;628236120;3595;122;4340;4388;11.50;0.70;221.21;4.26;745;44;1473.00;48
3598;44;628236131;3598;128;4341;4388;11.50;0.70;221.23;4.26;743;44;1474.00;47
3601;44;628236143;3601;127;4342;4388;11.44;0.69;221.22;4.27;741;44;1475.00;46
3604;44;628236155;3604;132;4354;4400;11.35;0.69;221.23;4.27;750;44;1476.00;46
3604;44;628236167;3604;131;4355;4400;11.32;0.69;221.23;4.27;751;44;1477.00;45
3608;44;628236177;3608;136;4355;4400;11.17;0.68;221.16;4.27;747;44;1478.00;45
3609;44;628236189;3609;139;4358;4400;11.13;0.68;221.11;4.28;749;44;1479.00;42
3613;44;628236200;3613;135;4358;4400;11.04;0.67;221.16;4.28;745;44;1480.00;42
3616;44;628236211;3616;140;4359;4400;11.01;0.67;221.12;4.28;743;44;1481.00;41
3617;44;628236222;3617;149;4363;4404;10.95;0.67;221.11;4.29;746;44;1482.00;41
3618;44;628236233;3618;150;4363;4404;10.96;0.67;221.21;4.29;745;44;1483.00;41
3620;44;628236244;3620;154;4368;4408;10.93;0.67;221.28;4.30;748;44;1484.00;40
3625;44;628236256;3625;160;4372;4410;10.88;0.66;221.44;4.31;747;44;1485.00;38
3629;44;628236268;3629;161;4372;4410;10.83;0.66;221.53;4.31;743;44;1486.00;38
3632;44;628236281;3632;169;4373;4410;10.77;0.66;221.56;4.32;741;44;1487.00;37
3634;44;628236293;3634;178;4383;4423;10.79;0.66;221.50;4.32;749;44;1488.00;40
3637;44;628236308;3637;185;4383;4423;10.75;0.66;221.51;4.32;746;44;1489.00;40
3639;44;628236322;3639;186;4385;4423;10.69;0.65;221.56;4.34;746;44;1490.00;38
3639;44;628236334;3639;196;4387;4424;10.64;0.65;221.56;4.35;748;44;1491.00;37
3643;45;628236345;3643;204;4388;4425;10.55;0.64;221.48;4.36;745;45;1492.00;37
3645;45;628236376;3645;204;4390;4425;10.48;0.64;221.44;4.38;745;45;1493.00;35
3646;45;628236388;3646;212;4393;4428;10.46;0.64;221.46;4.39;747;45;1494.00;35
3647;45;628236400;3647;219;4395;4428;10.38;0.63;221.42;4.42;748;45;1495.00;33
3653;45;628236410;3653;228;4397;4428;10.34;0.63;221.36;4.43;744;45;1496.00;31
3655;45;628236420;3655;237;4397;4428;10.27;0.63;221.31;4.43;742;45;1497.00;31
3657;45;628236431;3657;244;4403;4434;10.28;0.63;221.32;4.45;746;45;1498.00;31
3661;45;628236441;3661;248;4404;4434;10.15;0.62;221.28;4.46;743;45;1499.00;30
3664;45;628236454;3664;251;4409;4453;10.02;0.61;221.24;4.47;745;45;1500.00;44
3667;45;628236474;3667;255;4413;4453;9.89;0.60;221.31;4.50;746;45;1501.00;40
3670;45;628236485;3670;257;4417;4457;9.83;0.60;221.31;4.51;747;45;1502.00;40
3671;45;628236496;3671;259;4420;4458;9.78;0.59;221.31;4.52;749;45;1503.00;38
3673;45;628236507;3673;267;4420;4458;9.79;0.59;221.26;4.52;747;45;1504.00;38
3675;45;628236517;3675;271;4425;4459;9.65;0.59;221.34;4.56;750;45;1505.00;34
3676;45;628236528;3676;274;4427;4459;9.57;0.58;221.34;4.57;751;45;1506.00;32
3677;45;628236538;3677;278;4429;4459;9.43;0.57;221.31;4.58;752;45;1507.00;30
3680;45;628236549;3680;283;4432;4459;9.28;0.57;221.32;4.60;752;45;1508.00;27
3681;45;628236559;3681;283;4433;4459;9.19;0.56;221.31;4.60;752;45;1509.00;26
3682;45;628236568;3682;276;4433;4459;9.12;0.56;221.31;4.60;751;45;1510.00;26
3685;45;628236578;3685;281;4437;4459;9.00;0.55;221.33;4.61;752;45;1511.00;22
3686;45;628236588;3686;283;4470;4529;8.96;0.55;221.34;4.58;784;45;1512.00;59
3689;45;628236603;3689;279;4475;4530;8.91;0.55;221.29;4.58;786;45;1513.00;55
3692;45;628236614;3692;281;4482;4530;8.93;0.55;221.27;4.58;790;45;1514.00;48
3697;45;628236624;3697;282;4482;4530;8.92;0.55;221.34;4.58;785;45;1515.00;48
3699;45;628236635;3699;284;4487;4530;9.01;0.55;221.30;4.58;788;45;1516.00;43
3703;45;628236645;3703;280;4490;4530;9.03;0.55;221.23;4.58;787;45;1517.00;40
3705;45;628236658;3705;281;4496;4530;9.01;0.55;221.19;4.59;791;45;1518.00;34
3707;45;628236669;3707;279;4497;4530;9.07;0.55;221.17;4.59;790;45;1519.00;33
3711;45;628236680;3711;282;4500;4531;9.05;0.55;221.28;4.59;789;45;1520.00;31
3713;45;628236692;3713;282;4503;4532;9.04;0.55;221.24;4.59;790;45;1521.00;29
3715;45;628236702;3715;275;4505;4532;8.98;0.55;221.29;4.59;790;45;1522.00;27
3720;45;628236712;3720;278;4509;4536;8.76;0.53;221.35;4.60;789;45;1523.00;27
3723;45;628236723;3723;277;4509;4536;8.61;0.53;221.46;4.60;786;45;1524.00;27
3728;45;628236733;3728;278;4509;4536;8.45;0.52;221.55;4.60;781;45;1525.00;27
3734;45;628236743;3734;278;4509;4536;8.25;0.50;221.68;4.60;775;45;1526.00;27
3742;45;628236754;3742;273;4513;4542;8.04;0.49;221.70;4.59;771;45;1527.00;29
3744;45;628236765;3744;281;4514;4542;7.85;0.48;221.81;4.60;770;45;1528.00;28
3748;45;628236775;3748;282;4514;4542;7.68;0.47;221.88;4.60;766;45;1529.00;28
3752;45;628236787;3752;276;4517;4548;7.59;0.47;222.03;4.59;765;45;1530.00;31
3755;45;628236797;3755;274;4517;4548;7.54;0.46;222.09;4.59;762;45;1531.00;31
3760;45;628236807;3760;274;4518;4548;7.53;0.46;222.14;4.60;758;45;1532.00;30
3765;45;628236817;3765;271;4519;4549;7.47;0.46;222.28;4.60;754;45;1533.00;30
3768;45;628236826;3768;269;4521;4550;7.44;0.46;222.35;4.60;753;45;1534.00;29
3772;45;628236836;3772;259;4521;4550;7.46;0.46;222.36;4.60;749;45;1535.00;29
3777;45;628236846;3777;260;4533;4563;7.46;0.46;222.38;4.60;756;45;1536.00;30
3781;45;628236857;3781;254;4534;4563;7.53;0.46;222.45;4.60;753;45;1537.00;29
3784;45;628236867;3784;241;4534;4563;7.63;0.47;222.38;4.60;750;45;1538.00;29
3787;45;628236876;3787;242;4536;4564;7.75;0.47;222.44;4.61;749;45;1539.00;28
3792;45;628236886;3792;239;4540;4564;7.82;0.48;222.49;4.63;748;45;1540.00;24
3796;45;628236896;3796;235;4542;4568;7.81;0.48;222.47;4.63;746;45;1541.00;26
3799;45;628236906;3799;237;4543;4568;7.76;0.48;222.52;4.63;744;45;1542.00;25
3803;45;628236915;3803;234;4547;4572;7.75;0.47;222.47;4.63;744;45;1543.00;25
3805;45;628236925;3805;237;4547;4572;7.76;0.48;222.55;4.63;742;45;1544.00;25
3807;45;628236935;3807;235;4548;4572;7.83;0.48;222.48;4.63;741;45;1545.00;24
3812;45;628236945;3812;232;4548;4572;7.88;0.48;222.45;4.63;736;45;1546.00;24
3815;45;628236954;3815;227;4549;4572;7.89;0.48;222.42;4.64;734;45;1547.00;23
3819;45;628236964;3819;231;4561;4584;7.91;0.48;222.39;4.64;742;45;1548.00;23
3822;45;628236981;3822;232;4561;4584;7.88;0.48;222.40;4.64;739;45;1549.00;23
3827;45;628236991;3827;235;4562;4584;7.85;0.48;222.43;4.64;735;45;1550.00;22
3828;45;628237001;3828;235;4562;4584;7.86;0.48;222.43;4.64;734;45;1551.00;22
3830;45;628237010;3830;241;4562;4584;7.84;0.48;222.40;4.64;732;45;1552.00;22
3834;45;628237020;3834;241;4563;4584;7.75;0.47;222.53;4.65;729;45;1553.00;21
3836;45;628237029;3836;244;4565;4585;7.76;0.47;222.65;4.66;729;45;1554.00;20
3841;45;628237039;3841;248;4566;4587;7.67;0.47;222.60;4.66;725;45;1555.00;21
3844;45;628237049;3844;251;4571;4593;7.72;0.47;222.55;4.66;727;45;1556.00;22
3847;45;628237059;3847;252;4572;4594;7.70;0.47;222.58;4.66;725;45;1557.00;22
3853;45;628237072;3853;251;4573;4594;7.69;0.47;222.65;4.67;720;45;1558.00;21
3856;45;628237082;3856;258;4573;4594;7.66;0.47;222.61;4.67;717;45;1559.00;21
3859;45;628237099;3859;258;4579;4599;7.62;0.47;222.61;4.67;720;45;1560.00;20
3863;45;628237109;3863;260;4579;4599;7.52;0.46;222.60;4.67;716;45;1561.00;20
3866;45;628237118;3866;269;4580;4599;7.44;0.46;222.57;4.68;714;45;1562.00;19
3871;45;628237127;3871;273;4582;4600;7.32;0.45;222.54;4.68;711;45;1563.00;18
3873;45;628237147;3873;279;4587;4604;7.26;0.44;222.48;4.68;714;45;1564.00;17
3875;45;628237158;3875;284;4587;4604;7.26;0.45;222.56;4.68;712;45;1565.00;17
3877;45;628237166;3877;289;4589;4607;7.26;0.45;222.52;4.68;712;45;1566.00;18
3883;45;628237176;3883;296;4589;4607;7.20;0.44;222.28;4.68;706;45;1567.00;18
3886;45;628237185;3886;300;4590;4607;7.14;0.44;222.24;4.69;704;45;1568.00;17
3888;45;628237195;3888;309;4590;4607;7.07;0.43;222.21;4.69;702;45;1569.00;17
3893;45;628237203;3893;313;4593;4611;7.00;0.43;222.14;4.69;700;45;1570.00;18
3893;45;628237212;3893;321;4594;4611;6.96;0.43;222.14;4.70;701;45;1571.00;17
3896;45;628237221;3896;328;4594;4611;6.95;0.43;222.22;4.70;698;45;1572.00;17
3901;45;628237229;3901;331;4595;4611;6.86;0.42;222.27;4.70;694;45;1573.00;16
3906;45;628237238;3906;337;4596;4612;6.72;0.41;222.17;4.70;690;45;1574.00;16
3908;45;628237246;3908;344;4600;4614;6.68;0.41;222.27;4.71;692;45;1575.00;14
3908;45;628237255;3908;345;4600;4614;6.66;0.41;222.27;4.71;692;45;1576.00;14
3910;45;628237264;3910;336;4603;4615;6.67;0.41;222.22;4.71;693;45;1577.00;12
3911;45;628237274;3911;329;4603;4615;6.73;0.41;222.34;4.71;692;45;1578.00;12
3914;45;628237283;3914;326;4604;4615;6.72;0.41;222.39;4.71;690;45;1579.00;11
3916;45;628237291;3916;330;4605;4615;6.75;0.41;222.51;4.71;689;45;1580.00;10
3918;45;628237300;3918;327;4605;4615;6.77;0.41;222.56;4.71;687;45;1581.00;10
3921;45;628237309;3921;329;4605;4615;6.75;0.41;222.66;4.71;684;45;1582.00;10
3924;45;628237317;3924;328;4605;4615;6.79;0.41;222.74;4.71;681;45;1583.00;10
3925;45;628237326;3925;343;4673;4742;7.12;0.44;222.72;4.65;748;45;1584.00;69
3928;45;628237345;3928;332;4676;4743;7.17;0.45;222.85;4.64;748;45;1585.00;67
3929;45;628237355;3929;304;4684;4743;7.37;0.46;222.86;4.64;755;45;1586.00;59
3929;45;628237364;3929;277;4689;4743;7.54;0.47;222.86;4.64;760;45;1587.00;54
3933;45;628237374;3933;252;4692;4743;7.63;0.47;222.91;4.64;759;45;1588.00;51
3934;45;628237390;3934;234;4696;4743;7.77;0.48;222.86;4.64;762;45;1589.00;47
3935;45;628237402;3935;224;4697;4743;7.90;0.49;222.84;4.64;762;45;1590.00;46
3937;45;628237413;3937;215;4702;4743;8.04;0.49;222.84;4.64;765;45;1591.00;41
3938;45;628237424;3938;202;4703;4744;8.23;0.51;222.82;4.64;765;45;1592.00;41
3938;45;628237435;3938;189;4708;4745;8.47;0.52;222.82;4.65;770;45;1593.00;37
3940;45;628237452;3940;180;4708;4745;8.67;0.53;222.79;4.65;768;45;1594.00;37
3942;46;628237463;3942;174;4712;4746;8.89;0.54;222.85;4.65;770;46;1595.00;34
3945;46;628237487;3945;174;4712;4746;9.04;0.55;222.89;4.65;767;46;1596.00;34
3946;46;628237499;3946;170;4720;4746;9.23;0.57;222.87;4.66;774;46;1597.00;26
3947;46;628237522;3947;171;4724;4746;9.46;0.58;222.85;4.67;777;46;1598.00;22
3947;46;628237540;3947;171;4729;4750;9.58;0.59;222.85;4.67;782;46;1599.00;21
3949;46;628237562;3949;164;4730;4750;9.61;0.59;222.80;4.68;781;46;1600.00;20
3950;46;628237584;3950;167;4730;4750;9.77;0.60;222.79;4.68;780;46;1601.00;20
3951;46;628237602;3951;164;4732;4753;9.89;0.60;222.77;4.67;781;46;1602.00;21
3954;46;628237620;3954;158;4734;4753;10.00;0.61;222.71;4.67;780;46;1603.00;19
3955;46;628237635;3955;162;4734;4753;10.16;0.62;222.73;4.67;779;46;1604.00;19
3956;46;628237648;3956;159;4738;4757;10.26;0.62;222.67;4.67;782;46;1605.00;19
3957;46;628237660;3957;157;4739;4758;10.44;0.63;222.63;4.67;782;46;1606.00;19
3960;46;628237674;3960;155;4739;4758;10.57;0.64;222.68;4.67;779;46;1607.00;19
3961;46;628237687;3961;157;4742;4762;10.74;0.65;222.72;4.67;781;46;1608.00;20
3963;46;628237700;3963;151;4742;4762;10.83;0.66;222.77;4.67;779;46;1609.00;20
3964;46;628237718;3964;147;4742;4762;10.94;0.66;222.76;4.67;778;46;1610.00;20
3966;46;628237730;3966;148;4743;4763;10.97;0.66;222.81;4.67;777;46;1611.00;20
3966;46;628237749;3966;142;4743;4763;11.04;0.67;222.81;4.67;777;46;1612.00;20
3970;46;628237761;3970;145;4747;4769;11.04;0.67;222.86;4.66;777;46;1613.00;22
3973;46;628237774;3973;143;4747;4769;11.05;0.67;222.92;4.66;774;46;1614.00;22
3978;46;628237787;3978;147;4748;4770;11.09;0.67;222.98;4.66;770;46;1615.00;22
3980;46;628237799;3980;149;4748;4770;11.17;0.68;222.97;4.66;768;46;1616.00;22
3982;46;628237811;3982;145;4748;4770;11.21;0.68;223.06;4.66;766;46;1617.00;22
3986;46;628237823;3986;148;4748;4770;11.31;0.69;223.19;4.66;762;46;1618.00;22
3987;47;628237835;3987;147;4748;4770;11.39;0.69;223.18;4.66;761;47;1619.00;22
3990;47;628237860;3990;150;4769;4806;11.40;0.69;223.29;4.64;779;47;1620.00;37
3993;47;628237875;3993;152;4770;4806;11.46;0.70;223.39;4.64;777;47;1621.00;36
3994;48;628237887;3994;151;4772;4806;11.58;0.71;223.36;4.64;778;48;1622.00;34
3997;48;628237907;3997;147;4772;4806;11.68;0.71;223.38;4.64;775;48;1623.00;34
4002;48;628237918;4002;144;4773;4806;11.76;0.72;223.42;4.64;771;48;1624.00;33
4005;48;628237936;4005;142;4774;4806;11.79;0.72;223.55;4.64;769;48;1625.00;32
4007;48;628237947;4007;146;4777;4810;11.81;0.72;223.64;4.64;770;48;1626.00;33
4010;48;628237962;4010;141;4778;4810;11.85;0.72;223.78;4.64;768;48;1627.00;32
4014;48;628237979;4014;146;4781;4814;11.87;0.72;223.90;4.64;767;48;1628.00;33
4016;48;628237991;4016;135;4783;4815;11.97;0.73;223.88;4.64;767;48;1629.00;32
4022;48;628238002;4022;136;4783;4815;11.97;0.73;224.04;4.64;761;48;1630.00;32
4026;48;628238015;4026;137;4784;4815;12.03;0.73;223.99;4.64;758;48;1631.00;31
4031;48;628238026;4031;135;4793;4828;12.01;0.73;223.99;4.63;762;48;1632.00;35
4032;48;628238039;4032;131;4793;4828;12.00;0.73;223.97;4.63;761;48;1633.00;35
4035;48;628238051;4035;124;4793;4828;11.95;0.73;223.99;4.63;758;48;1634.00;35
4040;48;628238062;4040;123;4795;4829;11.85;0.72;223.98;4.64;755;48;1635.00;34
4045;49;628238073;4045;118;4795;4830;11.80;0.72;224.02;4.64;750;49;1636.00;35
4048;49;628238101;4048;123;4795;4830;11.84;0.72;224.05;4.64;747;49;1637.00;35
4051;49;628238112;4051;123;4797;4833;11.97;0.73;224.03;4.64;746;49;1638.00;36
4055;49;628238125;4055;123;4797;4833;12.03;0.73;224.04;4.64;742;49;1639.00;36
4058;49;628238136;4058;126;4798;4833;12.03;0.73;224.04;4.64;740;49;1640.00;35
4060;49;628238148;4060;120;4798;4833;12.10;0.74;223.96;4.64;738;49;1641.00;35
4063;49;628238159;4063;122;4802;4839;12.11;0.74;224.01;4.63;739;49;1642.00;37
4067;49;628238170;4067;124;4802;4839;12.11;0.74;224.13;4.63;735;49;1643.00;37
4070;49;628238182;4070;126;4803;4839;12.07;0.74;224.09;4.63;733;49;1644.00;36
4073;49;628238194;4073;125;4803;4839;11.97;0.73;224.07;4.63;730;49;1645.00;36
4078;49;628238204;4078;127;4806;4843;11.87;0.72;224.06;4.63;728;49;1646.00;37
4080;49;628238215;4080;134;4808;4844;11.86;0.72;224.04;4.63;728;49;1647.00;36
4082;49;628238226;4082;138;4808;4844;11.84;0.72;224.03;4.63;726;49;1648.00;36
4085;50;628238237;4085;143;4809;4845;11.79;0.72;224.05;4.63;724;50;1649.00;36
4090;50;628238264;4090;142;4810;4845;11.70;0.71;224.06;4.64;720;50;1650.00;35
4090;50;628238279;4090;149;4810;4845;11.65;0.71;224.06;4.64;720;50;1651.00;35
4095;50;628238291;4095;147;4811;4845;11.63;0.71;224.07;4.64;716;50;1652.00;34
4097;50;628238302;4097;143;4811;4845;11.59;0.71;224.04;4.64;714;50;1653.00;34
4101;50;628238313;4101;145;4812;4845;11.57;0.70;224.24;4.65;711;50;1654.00;33
4104;50;628238324;4104;145;4812;4845;11.50;0.70;224.16;4.65;708;50;1655.00;33
4105;50;628238341;4105;154;4848;4915;11.41;0.70;224.13;4.62;743;50;1656.00;67
4106;50;628238358;4106;155;4851;4916;11.41;0.70;224.11;4.63;745;50;1657.00;65
4108;50;628238370;4108;158;4858;4916;11.44;0.70;224.10;4.63;750;50;1658.00;58
4112;50;628238381;4112;163;4861;4916;11.40;0.70;224.16;4.64;749;50;1659.00;55
4114;50;628238394;4114;172;4867;4916;11.41;0.70;224.14;4.65;753;50;1660.00;49
4117;50;628238405;4117;174;4868;4916;11.34;0.69;224.24;4.65;751;50;1661.00;48
4117;50;628238416;4117;175;4873;4916;11.29;0.69;224.24;4.66;756;50;1662.00;43
4122;50;628238428;4122;180;4876;4916;11.19;0.68;224.27;4.67;754;50;1663.00;40
4126;50;628238440;4126;183;4879;4917;11.06;0.68;224.24;4.68;753;50;1664.00;38
4131;50;628238451;4131;190;4885;4919;10.90;0.66;224.28;4.70;754;50;1665.00;34
4135;50;628238462;4135;193;4887;4919;10.77;0.66;224.22;4.70;752;50;1666.00;32
4139;50;628238474;4139;195;4892;4923;10.60;0.65;224.20;4.72;753;50;1667.00;31
4141;50;628238491;4141;204;4892;4923;10.45;0.64;224.14;4.72;751;50;1668.00;31
4142;50;628238502;4142;213;4894;4923;10.35;0.63;224.12;4.74;752;50;1669.00;29
4143;51;628238514;4143;218;4894;4923;10.32;0.63;224.11;4.74;751;51;1670.00;29
4144;51;628238537;4144;225;4900;4929;10.36;0.63;224.18;4.75;756;51;1671.00;29
4147;51;628238549;4147;230;4902;4929;10.26;0.63;224.23;4.76;755;51;1672.00;27
4150;51;628238559;4150;230;4903;4929;10.22;0.62;224.16;4.76;753;51;1673.00;26
4152;51;628238570;4152;233;4905;4932;10.16;0.62;224.15;4.76;753;51;1674.00;27
4155;51;628238581;4155;235;4907;4932;9.97;0.61;224.10;4.78;752;51;1675.00;25
4156;51;628238591;4156;240;4908;4932;9.87;0.60;224.10;4.77;752;51;1676.00;24
4157;51;628238601;4157;243;4911;4933;9.76;0.60;224.07;4.80;754;51;1677.00;22
4161;51;628238611;4161;247;4912;4934;9.61;0.59;224.00;4.80;751;51;1678.00;22
4164;51;628238620;4164;246;4913;4934;9.45;0.58;223.97;4.80;749;51;1679.00;21
4169;51;628238632;4169;246;4930;4960;9.31;0.57;223.92;4.78;761;51;1680.00;30
4170;51;628238644;4170;244;4933;4960;9.18;0.56;223.93;4.78;763;51;1681.00;27
4171;51;628238653;4171;246;4937;4960;9.11;0.56;223.92;4.79;766;51;1682.00;23
4174;51;628238663;4174;244;4938;4961;9.09;0.55;223.86;4.79;764;51;1683.00;23
4176;51;628238673;4176;247;4938;4961;8.97;0.55;223.81;4.79;762;51;1684.00;23
4177;51;628238682;4177;245;4943;4965;8.95;0.55;223.81;4.79;766;51;1685.00;22
4179;51;628238693;4179;246;4943;4965;8.86;0.54;223.78;4.79;764;51;1686.00;22
4182;51;628238708;4182;257;4946;4969;8.75;0.54;223.78;4.79;764;51;1687.00;23
4185;51;628238718;4185;258;4949;4969;8.62;0.53;223.72;4.79;764;51;1688.00;20
4190;51;628238727;4190;263;4949;4969;8.56;0.52;223.79;4.79;759;51;1689.00;20
4193;51;628238737;4193;264;4949;4969;8.46;0.52;223.77;4.79;756;51;1690.00;20
4196;51;628238752;4196;273;4951;4969;8.38;0.51;223.80;4.80;755;51;1691.00;18
4199;51;628238761;4199;277;4962;4981;8.30;0.51;223.89;4.79;763;51;1692.00;19
4200;51;628238771;4200;283;4962;4981;8.19;0.50;223.86;4.79;762;51;1693.00;19
4205;51;628238779;4205;289;4964;4981;8.05;0.49;223.88;4.79;759;51;1694.00;17
4207;51;628238788;4207;288;4964;4981;7.91;0.48;223.90;4.79;757;51;1695.00;17
4210;51;628238796;4210;297;4964;4981;7.72;0.47;223.92;4.79;754;51;1696.00;17
4213;51;628238805;4213;295;4964;4981;7.47;0.46;224.00;4.79;751;51;1697.00;17
4215;51;628238813;4215;300;4965;4982;7.30;0.45;224.07;4.79;750;51;1698.00;17
4216;51;628238821;4216;304;4965;4982;7.14;0.44;224.12;4.79;749;51;1699.00;17
4219;51;628238830;4219;301;4970;4988;7.03;0.44;224.24;4.78;751;51;1700.00;18
4225;51;628238843;4225;303;4971;4989;6.94;0.43;224.31;4.78;746;51;1701.00;18
4230;51;628238852;4230;301;4972;4989;6.84;0.42;224.32;4.78;742;51;1702.00;17
4232;51;628238860;4232;301;4972;4989;6.84;0.42;224.34;4.78;740;51;1703.00;17
4233;51;628238869;4233;294;4976;4993;6.92;0.43;224.39;4.78;743;51;1704.00;17
4238;51;628238878;4238;293;4976;4993;6.93;0.43;224.43;4.78;738;51;1705.00;17
4240;51;628238886;4240;290;4976;4993;6.99;0.43;224.47;4.78;736;51;1706.00;17
4243;51;628238895;4243;290;4977;4994;7.02;0.43;224.45;4.78;734;51;1707.00;17
4248;51;628238903;4248;285;4981;4998;7.00;0.43;224.43;4.77;733;51;1708.00;17
4249;51;628238912;4249;284;4981;4998;7.02;0.43;224.41;4.77;732;51;1709.00;17
4254;51;628238922;4254;289;4984;5004;6.99;0.43;224.40;4.77;730;51;1710.00;20
4255;51;628238931;4255;285;4985;5004;7.03;0.43;224.40;4.77;730;51;1711.00;19
4259;51;628238939;4259;282;4985;5004;7.06;0.43;224.38;4.77;726;51;1712.00;19
4262;51;628238947;4262;279;4986;5004;7.08;0.43;224.41;4.77;724;51;1713.00;18
4267;51;628238956;4267;279;4988;5008;7.13;0.44;224.36;4.77;721;51;1714.00;20
4274;51;628238965;4274;285;4989;5008;7.12;0.44;224.42;4.77;715;51;1715.00;19
4278;51;628238974;4278;280;4989;5008;7.14;0.44;224.39;4.77;711;51;1716.00;19
4281;51;628238982;4281;278;4990;5008;7.18;0.44;224.37;4.77;709;51;1717.00;18
4285;51;628238991;4285;278;4991;5009;7.13;0.44;224.39;4.77;706;51;1718.00;18
4289;51;628238999;4289;280;4993;5010;7.08;0.43;224.33;4.77;704;51;1719.00;17
4292;51;628239008;4292;280;4993;5010;7.03;0.43;224.27;4.77;701;51;1720.00;17
4295;51;628239017;4295;277;4994;5011;6.99;0.43;224.25;4.77;699;51;1721.00;17
4300;51;628239026;4300;278;4994;5011;6.91;0.42;224.23;4.77;694;51;1722.00;17
4302;51;628239035;4302;280;4994;5011;6.89;0.42;224.23;4.77;692;51;1723.00;17
4304;51;628239043;4304;275;4994;5011;6.89;0.42;224.20;4.77;690;51;1724.00;17
4306;51;628239051;4306;273;4994;5011;6.86;0.42;224.28;4.77;688;51;1725.00;17
4312;51;628239059;4312;278;4994;5011;6.88;0.42;224.24;4.77;682;51;1726.00;17
4315;51;628239068;4315;271;4994;5011;6.94;0.42;224.20;4.77;679;51;1727.00;17
4319;51;628239076;4319;282;5068;5138;7.41;0.46;224.22;4.70;749;51;1728.00;70
4322;51;628239095;4322;277;5071;5139;7.41;0.46;224.19;4.69;749;51;1729.00;68
4325;51;628239104;4325;279;5081;5139;7.53;0.47;224.16;4.69;756;51;1730.00;58
4328;51;628239113;4328;279;5085;5139;7.54;0.47;224.21;4.69;757;51;1731.00;54
4334;51;628239123;4334;282;5091;5139;7.58;0.47;224.01;4.69;757;51;1732.00;48
4336;51;628239133;4336;285;5095;5139;7.66;0.47;224.02;4.69;759;51;1733.00;44
4337;51;628239142;4337;290;5100;5139;7.74;0.48;224.03;4.69;763;51;1734.00;39
4337;51;628239151;4337;288;5102;5139;7.78;0.48;224.03;4.69;765;51;1735.00;37
4341;51;628239161;4341;293;5104;5140;7.80;0.48;224.02;4.69;763;51;1736.00;36
4343;51;628239171;4343;297;5109;5141;7.85;0.48;224.17;4.69;766;51;1737.00;32
4345;51;628239187;4345;304;5110;5141;7.82;0.48;224.23;4.69;765;51;1738.00;31
4346;51;628239196;4346;300;5114;5142;7.87;0.48;224.23;4.70;768;51;1739.00;28
4348;51;628239209;4348;290;5114;5142;7.84;0.48;224.30;4.70;766;51;1740.00;28
4350;51;628239219;4350;292;5117;5142;7.91;0.49;224.27;4.70;767;51;1741.00;25
4355;51;628239229;4355;294;5117;5142;7.90;0.48;224.29;4.70;762;51;1742.00;25
4358;51;628239240;4358;292;5120;5146;7.94;0.49;224.36;4.70;762;51;1743.00;26
4360;52;628239251;4360;295;5122;5146;7.98;0.49;224.39;4.71;762;52;1744.00;24
4362;52;628239273;4362;291;5123;5146;7.94;0.49;224.38;4.71;761;52;1745.00;23
4364;52;628239288;4364;288;5126;5149;7.93;0.48;224.41;4.71;762;52;1746.00;23
4368;52;628239304;4368;278;5126;5149;7.90;0.48;224.38;4.71;758;52;1747.00;23
4368;52;628239316;4368;268;5127;5149;7.97;0.49;224.38;4.71;759;52;1748.00;22
4370;52;628239326;4370;259;5131;5153;8.07;0.49;224.39;4.71;761;52;1749.00;22
4371;52;628239337;4371;250;5133;5154;8.20;0.50;224.53;4.71;762;52;1750.00;21
4375;52;628239348;4375;246;5133;5154;8.33;0.51;224.62;4.71;758;52;1751.00;21
4378;52;628239364;4378;243;5137;5158;8.49;0.52;224.58;4.71;759;52;1752.00;21
4382;52;628239375;4382;240;5137;5158;8.66;0.53;224.58;4.71;755;52;1753.00;21
4383;52;628239386;4383;236;5137;5158;8.78;0.54;224.65;4.71;754;52;1754.00;21
4386;52;628239397;4386;234;5139;5160;8.87;0.54;224.74;4.71;753;52;1755.00;21
4391;52;628239408;4391;219;5139;5160;8.99;0.55;224.68;4.71;748;52;1756.00;21
4395;52;628239419;4395;202;5143;5166;9.09;0.55;224.74;4.70;748;52;1757.00;23
4396;52;628239436;4396;191;5144;5166;9.25;0.56;224.72;4.70;748;52;1758.00;22
4397;52;628239452;4397;178;5144;5167;9.42;0.57;224.71;4.70;747;52;1759.00;23
4400;52;628239468;4400;163;5144;5167;9.61;0.58;224.71;4.70;744;52;1760.00;23
4404;52;628239480;4404;153;5144;5167;9.84;0.60;224.73;4.70;740;52;1761.00;23
4405;52;628239491;4405;146;5144;5167;10.10;0.61;224.71;4.70;739;52;1762.00;23
4408;52;628239505;4408;143;5144;5167;10.25;0.62;224.70;4.70;736;52;1763.00;23
4412;52;628239535;4412;139;5154;5179;10.45;0.63;224.68;4.69;742;52;1764.00;25
4412;52;628239556;4412;135;5155;5179;10.64;0.64;224.68;4.69;743;52;1765.00;24
4415;52;628239577;4415;131;5155;5179;10.77;0.65;224.70;4.69;740;52;1766.00;24
4416;52;628239595;4416;132;5155;5179;10.89;0.66;224.69;4.69;739;52;1767.00;24
4419;52;628239627;4419;130;5155;5179;10.99;0.66;224.75;4.69;736;52;1768.00;24
4421;52;628239645;4421;127;5155;5179;11.08;0.67;224.80;4.69;734;52;1769.00;24
4423;52;628239662;4423;129;5158;5183;11.15;0.68;224.81;4.69;735;52;1770.00;25
4426;52;628239680;4426;128;5158;5183;11.25;0.68;224.96;4.69;732;52;1771.00;25
4428;52;628239702;4428;124;5161;5187;11.33;0.69;225.06;4.69;733;52;1772.00;26
4433;52;628239725;4433;125;5163;5188;11.44;0.69;225.26;4.69;730;52;1773.00;25
4435;52;628239751;4435;128;5163;5188;11.50;0.70;225.31;4.69;728;52;1774.00;25
4439;52;628239767;4439;129;5163;5188;11.61;0.70;225.48;4.69;724;52;1775.00;25
4440;52;628239782;4440;130;5173;5201;11.81;0.72;225.53;4.68;733;52;1776.00;28
4441;53;628239801;4441;130;5173;5201;11.92;0.72;225.49;4.68;732;53;1777.00;28
4444;53;628239826;4444;128;5174;5201;11.94;0.72;225.54;4.68;730;53;1778.00;27
4447;53;628239839;4447;126;5175;5202;11.94;0.73;225.66;4.68;728;53;1779.00;27
4449;53;628239851;4449;126;5175;5203;11.96;0.73;225.64;4.68;726;53;1780.00;28
4452;53;628239863;4452;126;5175;5203;12.02;0.73;225.71;4.68;723;53;1781.00;28
4457;53;628239875;4457;129;5177;5206;12.05;0.73;225.85;4.67;720;53;1782.00;29
4459;54;628239887;4459;127;5177;5206;12.05;0.73;225.79;4.67;718;54;1783.00;29
4467;54;628239907;4467;127;5178;5206;12.06;0.73;225.93;4.67;711;54;1784.00;28
4472;54;628239919;4472;124;5178;5206;12.07;0.73;226.04;4.67;706;54;1785.00;28
4472;54;628239935;4472;121;5182;5212;12.17;0.74;226.04;4.67;710;54;1786.00;30
4474;54;628239947;4474;118;5182;5212;12.19;0.74;226.15;4.67;708;54;1787.00;30
4475;54;628239958;4475;114;5183;5212;12.28;0.75;226.20;4.67;708;54;1788.00;29
4478;54;628239971;4478;116;5183;5212;12.30;0.75;226.24;4.67;705;54;1789.00;29
4481;54;628239983;4481;118;5186;5216;12.28;0.75;226.33;4.67;705;54;1790.00;30
4486;54;628239994;4486;117;5187;5217;12.30;0.75;226.39;4.67;701;54;1791.00;30
4487;54;628240006;4487;114;5187;5217;12.39;0.75;226.37;4.67;700;54;1792.00;30
4489;54;628240017;4489;113;5189;5218;12.43;0.76;226.44;4.73;700;54;1793.00;29
4493;54;628240030;4493;114;5189;5218;12.46;0.76;226.48;4.73;696;54;1794.00;29
4495;54;628240042;4495;116;5189;5218;12.48;0.76;226.58;4.73;694;54;1795.00;29
4498;54;628240053;4498;116;5189;5218;12.52;0.76;226.59;4.73;691;54;1796.00;29
4504;54;628240065;4504;118;5189;5218;12.53;0.76;226.76;4.73;685;54;1797.00;29
4508;54;628240076;4508;118;5189;5218;12.45;0.76;226.73;4.73;681;54;1798.00;29
4511;54;628240087;4511;117;5189;5218;12.50;0.76;226.74;4.73;678;54;1799.00;29
4515;54;628240100;4515;137;5252;5356;11.92;0.73;226.73;4.68;737;54;1800.00;104
4517;54;628240127;4517;126;5252;5357;11.91;0.73;226.71;4.68;735;54;1801.00;105
4521;54;628240138;4521;118;5260;5357;11.93;0.74;226.70;4.67;739;54;1802.00;97
4523;54;628240149;4523;112;5265;5357;12.06;0.74;226.76;4.67;742;54;1803.00;92
4529;54;628240160;4529;109;5268;5357;12.07;0.74;226.73;4.67;739;54;1804.00;89
4533;54;628240181;4533;110;5275;5357;11.99;0.74;226.88;4.69;742;54;1805.00;82
4537;54;628240195;4537;109;5281;5357;12.09;0.74;226.89;4.69;744;54;1806.00;76
4543;54;628240206;4543;113;5283;5357;12.12;0.74;226.89;4.76;740;54;1807.00;74
4549;54;628240219;4549;119;5287;5358;12.16;0.74;226.89;4.76;738;54;1808.00;71
4551;54;628240231;4551;119;5291;5359;12.30;0.75;226.91;4.76;740;54;1809.00;68
4555;54;628240243;4555;117;5293;5359;12.30;0.75;226.92;4.83;738;54;1810.00;66
4557;54;628240261;4557;112;5298;5363;12.24;0.75;226.92;4.83;741;54;1811.00;65
4559;55;628240274;4559;104;5298;5363;12.27;0.75;226.89;4.83;739;55;1812.00;65
4563;55;628240300;4563;101;5301;5363;12.24;0.75;227.00;4.91;738;55;1813.00;62
4564;55;628240321;4564;104;5302;5363;12.19;0.75;227.00;4.91;738;55;1814.00;61
4570;55;628240333;4570;107;5305;5369;12.14;0.74;227.08;4.98;735;55;1815.00;64
4573;55;628240347;4573;112;5305;5369;12.11;0.74;227.12;4.98;732;55;1816.00;64
4576;55;628240359;4576;113;5308;5369;12.06;0.74;227.12;5.05;732;55;1817.00;61
4578;55;628240376;4578;115;5310;5372;12.06;0.74;227.24;5.05;732;55;1818.00;62
4581;55;628240389;4581;121;5311;5372;11.98;0.73;227.23;5.05;730;55;1819.00;61
4583;55;628240403;4583;122;5312;5372;11.88;0.72;227.26;5.05;729;55;1820.00;60
4585;55;628240415;4585;125;5313;5373;11.77;0.72;227.21;5.05;728;55;1821.00;60
4589;55;628240427;4589;129;5316;5374;11.73;0.72;227.29;5.06;727;55;1822.00;58
4591;55;628240439;4591;135;5317;5374;11.69;0.71;227.28;5.06;726;55;1823.00;57
4596;55;628240451;4596;136;5323;5387;11.60;0.71;227.29;5.06;727;55;1824.00;64
4600;55;628240466;4600;145;5326;5387;11.56;0.70;227.31;5.06;726;55;1825.00;61
4602;55;628240480;4602;151;5327;5387;11.58;0.70;227.35;5.07;725;55;1826.00;60
4605;55;628240494;4605;155;5330;5388;11.56;0.70;227.30;5.07;725;55;1827.00;58
4607;55;628240509;4607;162;5332;5388;11.50;0.70;227.31;5.07;725;55;1828.00;56
4609;55;628240526;4609;166;5337;5392;11.35;0.69;227.28;5.08;728;55;1829.00;55
4610;55;628240540;4610;170;5337;5392;11.36;0.69;227.25;5.08;727;55;1830.00;55
4613;55;628240552;4613;177;5343;5396;11.24;0.68;227.20;5.10;730;55;1831.00;53
4617;55;628240564;4617;185;5343;5396;11.16;0.68;227.24;5.10;726;55;1832.00;53
4619;55;628240575;4619;187;5346;5396;11.09;0.67;227.26;5.12;727;55;1833.00;50
4624;55;628240585;4624;188;5348;5396;10.99;0.67;227.20;5.13;724;55;1834.00;48
4626;55;628240596;4626;189;5349;5396;10.84;0.66;227.20;5.14;723;55;1835.00;47
4626;55;628240606;4626;194;5362;5408;10.73;0.65;227.20;5.14;736;55;1836.00;46
4631;55;628240617;4631;195;5363;5408;10.61;0.65;227.17;5.15;732;55;1837.00;45
4631;55;628240627;4631;209;5365;5408;10.50;0.64;227.17;5.17;734;55;1838.00;43
4633;55;628240643;4633;212;5365;5408;10.30;0.63;227.17;5.17;732;55;1839.00;43
4637;55;628240654;4637;222;5366;5408;10.20;0.62;227.25;5.18;729;55;1840.00;42
4641;55;628240666;4641;226;5367;5408;10.09;0.62;227.23;5.18;726;55;1841.00;41
4644;55;628240679;4644;227;5368;5409;10.08;0.62;227.34;5.19;724;55;1842.00;41
4645;55;628240691;4645;229;5368;5409;9.99;0.61;227.33;5.19;723;55;1843.00;41
4647;55;628240701;4647;233;5374;5415;9.98;0.61;227.38;5.20;727;55;1844.00;41
4650;55;628240711;4650;238;5377;5417;9.88;0.60;227.47;5.20;727;55;1845.00;40
4653;55;628240722;4653;243;5378;5417;9.69;0.59;227.54;5.21;725;55;1846.00;39
4656;55;628240732;4656;253;5379;5417;9.51;0.58;227.52;5.21;723;55;1847.00;38
4659;55;628240741;4659;263;5383;5421;9.33;0.57;227.58;5.22;724;55;1848.00;38
4662;55;628240751;4662;266;5384;5421;9.16;0.56;227.54;5.22;722;55;1849.00;37
4664;55;628240760;4664;268;5385;5421;9.05;0.55;227.55;5.23;721;55;1850.00;36
4668;55;628240770;4668;269;5386;5422;8.95;0.55;227.57;5.23;718;55;1851.00;36
4670;55;628240780;4670;264;5389;5426;8.77;0.54;227.64;5.23;719;55;1852.00;37
4673;55;628240790;4673;265;5391;5426;8.65;0.53;227.60;5.24;718;55;1853.00;35
4673;55;628240799;4673;266;5393;5429;8.62;0.53;227.60;5.24;720;55;1854.00;36
4674;55;628240808;4674;271;5396;5429;8.52;0.52;227.67;5.25;722;55;1855.00;33
4677;55;628240817;4677;271;5397;5429;8.50;0.52;227.66;5.25;720;55;1856.00;32
4682;55;628240826;4682;269;5398;5429;8.44;0.52;227.74;5.25;716;55;1857.00;31
4683;55;628240835;4683;269;5402;5433;8.43;0.52;227.78;5.25;719;55;1858.00;31
4685;55;628240845;4685;273;5402;5433;8.35;0.51;227.74;5.25;717;55;1859.00;31
4689;55;628240855;4689;271;5404;5433;8.22;0.50;227.69;5.26;715;55;1860.00;29
4693;55;628240864;4693;274;5404;5433;8.09;0.50;227.61;5.26;711;55;1861.00;29
4697;55;628240872;4697;278;5405;5434;7.92;0.48;227.72;5.26;708;55;1862.00;29
4697;55;628240881;4697;279;5406;5435;7.82;0.48;227.72;5.26;709;55;1863.00;29
4700;55;628240890;4700;274;5406;5435;7.61;0.47;227.65;5.26;706;55;1864.00;29
4701;55;628240903;4701;281;5408;5436;7.45;0.46;227.64;5.26;707;55;1865.00;28
4708;55;628240912;4708;284;5409;5436;7.20;0.44;227.49;5.26;701;55;1866.00;27
4712;55;628240920;4712;288;5409;5436;7.05;0.43;227.63;5.26;697;55;1867.00;27
4714;55;628240929;4714;294;5409;5436;6.83;0.42;227.63;5.26;695;55;1868.00;27
4716;55;628240937;4716;305;5409;5436;6.63;0.41;227.57;5.26;693;55;1869.00;27
4719;55;628240944;4719;300;5409;5436;6.46;0.40;227.50;5.26;690;55;1870.00;27
4720;55;628240952;4720;305;5409;5436;6.35;0.39;227.47;5.26;689;55;1871.00;27
4722;55;628240958;4722;319;5477;5563;6.67;0.42;227.49;5.19;755;55;1872.00;86
4724;55;628240977;4724;314;5479;5564;6.60;0.42;227.50;5.19;755;55;1873.00;85
4727;55;628240986;4727;310;5488;5564;6.67;0.42;227.59;5.19;761;55;1874.00;76
4728;55;628240994;4728;312;5494;5564;6.69;0.42;227.64;5.18;766;55;1875.00;70
4730;55;628241003;4730;308;5500;5564;6.66;0.42;227.65;5.18;770;55;1876.00;64
4735;55;628241011;4735;310;5503;5564;6.57;0.41;227.65;5.18;768;55;1877.00;61
4736;55;628241020;4736;308;5511;5564;6.61;0.42;227.69;5.18;775;55;1878.00;53
4737;55;628241029;4737;312;5512;5564;6.63;0.42;227.68;5.18;775;55;1879.00;52
4739;55;628241037;4739;315;5516;5565;6.70;0.42;227.77;5.19;777;55;1880.00;49
4747;55;628241046;4747;321;5521;5566;6.73;0.42;227.77;5.19;774;55;1881.00;45
4749;55;628241055;4749;325;5525;5568;6.83;0.43;227.70;5.19;776;55;1882.00;43
4754;55;628241065;4754;327;5530;5569;6.83;0.42;227.69;5.20;776;55;1883.00;39
4758;55;628241074;4758;327;5532;5569;6.75;0.42;227.72;5.20;774;55;1884.00;37
4760;55;628241083;4760;327;5534;5569;6.78;0.42;227.67;5.20;774;55;1885.00;35
4767;55;628241094;4767;336;5535;5569;6.70;0.41;227.63;5.20;768;55;1886.00;34
4767;55;628241103;4767;334;5539;5573;6.70;0.41;227.63;5.20;772;55;1887.00;34
4769;55;628241113;4769;334;5540;5573;6.69;0.41;227.71;5.20;771;55;1888.00;33
4772;55;628241121;4772;332;5540;5573;6.73;0.41;227.67;5.20;768;55;1889.00;33
4774;55;628241133;4774;328;5544;5579;6.78;0.41;227.73;5.20;770;55;1890.00;35
4779;55;628241144;4779;312;5544;5579;6.80;0.41;227.64;5.20;765;55;1891.00;35
4783;55;628241155;4783;304;5546;5579;6.85;0.42;227.76;5.20;763;55;1892.00;33
4784;55;628241166;4784;295;5550;5583;7.02;0.43;227.79;5.20;766;55;1893.00;33
4786;55;628241177;4786;285;5553;5584;7.16;0.44;227.81;5.20;767;55;1894.00;31
4791;55;628241188;4791;279;5554;5584;7.20;0.44;227.69;5.20;763;55;1895.00;30
4794;55;628241198;4794;277;5559;5588;7.30;0.45;227.74;5.28;765;55;1896.00;29
4796;56;628241209;4796;279;5560;5588;7.40;0.45;227.77;5.28;764;56;1897.00;28
4797;56;628241245;4797;275;5560;5588;7.49;0.46;227.77;5.28;763;56;1898.00;28
4801;57;628241257;4801;275;5561;5589;7.56;0.46;227.86;5.28;760;57;1899.00;28
4802;57;628241280;4802;271;5561;5589;7.64;0.46;227.83;5.28;759;57;1900.00;28
4807;57;628241295;4807;273;5565;5595;7.66;0.46;227.88;5.27;758;57;1901.00;30
4810;57;628241307;4810;267;5565;5595;7.75;0.47;227.90;5.27;755;57;1902.00;30
4811;57;628241318;4811;265;5566;5596;7.83;0.48;227.90;5.27;755;57;1903.00;30
4816;57;628241335;4816;270;5566;5596;7.86;0.48;227.87;5.27;750;57;1904.00;30
4819;57;628241346;4819;265;5566;5596;7.93;0.48;227.84;5.27;747;57;1905.00;30
4822;57;628241357;4822;263;5566;5596;8.02;0.49;227.90;5.27;744;57;1906.00;30
4826;57;628241368;4826;262;5566;5596;8.02;0.49;227.93;5.27;740;57;1907.00;30
4829;57;628241379;4829;265;5576;5608;8.20;0.50;227.90;5.26;747;57;1908.00;32
4830;57;628241390;4830;262;5577;5608;8.28;0.50;227.86;5.26;747;57;1909.00;31
4833;57;628241401;4833;266;5577;5608;8.36;0.51;227.94;5.26;744;57;1910.00;31
4833;57;628241412;4833;268;5577;5608;8.47;0.51;227.94;5.26;744;57;1911.00;31
4835;57;628241423;4835;269;5577;5608;8.49;0.52;227.92;5.26;742;57;1912.00;31
4838;57;628241434;4838;269;5577;5608;8.46;0.52;228.01;5.26;739;57;1913.00;31
4840;57;628241445;4840;273;5580;5612;8.55;0.52;228.05;5.26;740;57;1914.00;32
4843;57;628241456;4843;276;5580;5612;8.52;0.52;228.09;5.26;737;57;1915.00;32
4846;57;628241467;4846;275;5583;5616;8.52;0.52;228.25;5.26;737;57;1916.00;33
4848;57;628241480;4848;263;5584;5617;8.53;0.52;228.27;5.26;736;57;1917.00;33
4851;57;628241491;4851;257;5585;5617;8.48;0.52;228.31;5.26;734;57;1918.00;32
4853;57;628241502;4853;245;5585;5617;8.48;0.52;228.32;5.26;732;57;1919.00;32
4856;57;628241523;4856;247;5606;5646;8.57;0.52;228.36;5.24;750;57;1920.00;40
4859;57;628241543;4859;239;5606;5646;8.64;0.53;228.37;5.24;747;57;1921.00;40
4865;57;628241560;4865;239;5608;5646;8.72;0.53;228.50;5.24;743;57;1922.00;38
4867;57;628241578;4867;233;5609;5647;8.84;0.54;228.63;5.24;742;57;1923.00;38
4870;57;628241594;4870;233;5610;5648;8.94;0.54;228.69;5.24;740;57;1924.00;38
4875;57;628241612;4875;224;5611;5648;8.95;0.54;228.82;5.24;736;57;1925.00;37
4878;57;628241626;4878;206;5614;5651;9.09;0.55;228.91;5.23;736;57;1926.00;37
4880;57;628241640;4880;190;5614;5651;9.24;0.56;228.90;5.23;734;57;1927.00;37
4882;57;628241653;4882;176;5614;5651;9.35;0.57;228.96;5.23;732;57;1928.00;37
4884;57;628241675;4884;168;5614;5651;9.50;0.58;229.02;5.23;730;57;1929.00;37
4887;57;628241689;4887;158;5618;5657;9.69;0.59;229.05;5.23;731;57;1930.00;39
4891;57;628241705;4891;150;5618;5657;9.80;0.59;229.09;5.23;727;57;1931.00;39
4893;57;628241718;4893;146;5619;5657;9.98;0.61;229.13;5.23;726;57;1932.00;38
4895;57;628241731;4895;145;5619;5657;10.04;0.61;229.16;5.23;724;57;1933.00;38
4898;57;628241744;4898;145;5622;5661;10.12;0.61;229.20;5.23;724;57;1934.00;39
4900;57;628241757;4900;142;5624;5663;10.19;0.62;229.15;5.22;724;57;1935.00;39
4901;57;628241770;4901;139;5624;5663;10.37;0.63;229.19;5.22;723;57;1936.00;39
4905;57;628241784;4905;134;5625;5664;10.46;0.64;229.30;5.22;720;57;1937.00;39
4908;57;628241797;4908;128;5625;5664;10.56;0.64;229.25;5.22;717;57;1938.00;39
4911;57;628241809;4911;129;5625;5664;10.68;0.65;229.38;5.22;714;57;1939.00;39
4916;57;628241821;4916;126;5625;5664;10.81;0.65;229.35;5.22;709;57;1940.00;39
4917;57;628241833;4917;124;5625;5664;10.93;0.66;229.40;5.22;708;57;1941.00;39
4919;57;628241845;4919;122;5625;5664;11.02;0.67;229.42;5.22;706;57;1942.00;39
4921;57;628241856;4921;118;5625;5664;11.10;0.67;229.44;5.22;704;57;1943.00;39
4923;57;628241868;4923;136;5667;5734;10.81;0.66;229.50;5.19;744;57;1944.00;67
4924;57;628241886;4924;130;5667;5735;10.92;0.66;229.55;5.19;743;57;1945.00;68
4925;57;628241897;4925;124;5673;5735;11.10;0.67;229.54;5.18;748;57;1946.00;62
4927;57;628241910;4927;126;5674;5735;11.19;0.68;229.57;5.18;747;57;1947.00;61
4930;57;628241928;4930;127;5677;5735;11.32;0.69;229.56;5.18;747;57;1948.00;58
4933;57;628241940;4933;129;5679;5735;11.42;0.69;229.60;5.18;746;57;1949.00;56
4937;57;628241953;4937;128;5682;5737;11.52;0.70;229.64;5.18;745;57;1950.00;55
4940;57;628241966;4940;133;5685;5737;11.65;0.71;229.67;5.18;745;57;1951.00;52
4941;57;628241988;4941;136;5687;5738;11.71;0.71;229.67;5.18;746;57;1952.00;51
4948;57;628242007;4948;137;5690;5739;11.84;0.72;229.71;5.18;742;57;1953.00;49
4950;57;628242020;4950;142;5691;5739;11.83;0.72;229.70;5.18;741;57;1954.00;48
4953;57;628242032;4953;141;5697;5743;11.82;0.72;229.73;5.18;744;57;1955.00;46
4955;57;628242044;4955;137;5698;5743;11.79;0.72;229.84;5.18;743;57;1956.00;45
4957;57;628242056;4957;134;5698;5743;11.82;0.72;229.88;5.18;741;57;1957.00;45
4960;57;628242067;4960;135;5698;5743;11.82;0.72;229.96;5.18;738;57;1958.00;45
4965;57;628242078;4965;136;5703;5749;11.75;0.72;230.00;5.18;738;57;1959.00;46
4968;57;628242099;4968;141;5703;5749;11.78;0.72;230.05;5.18;735;57;1960.00;46
4971;57;628242111;4971;140;5703;5749;11.76;0.72;230.12;5.18;732;57;1961.00;46
4974;57;628242122;4974;145;5706;5752;11.76;0.72;230.35;5.18;732;57;1962.00;46
4974;57;628242133;4974;145;5706;5752;11.78;0.72;230.35;5.18;732;57;1963.00;46
4979;57;628242144;4979;152;5706;5752;11.75;0.72;230.36;5.18;727;57;1964.00;46
4982;57;628242155;4982;154;5706;5753;11.78;0.72;230.38;5.18;724;57;1965.00;47
4987;57;628242166;4987;155;5707;5754;11.77;0.72;230.33;5.18;720;57;1966.00;47
4991;57;628242176;4991;157;5707;5754;11.77;0.72;230.40;5.18;716;57;1967.00;47
4994;57;628242188;4994;159;5716;5767;11.73;0.71;230.44;5.17;722;57;1968.00;51
4999;57;628242200;4999;156;5716;5767;11.74;0.72;230.55;5.17;717;57;1969.00;51
5004;57;628242212;5004;152;5716;5767;11.76;0.72;230.54;5.17;712;57;1970.00;51
5006;57;628242222;5006;151;5717;5768;11.85;0.72;230.55;5.17;711;57;1971.00;51
5009;57;628242232;5009;143;5717;5768;11.91;0.72;230.57;5.17;708;57;1972.00;51
5017;57;628242242;5017;137;5720;5772;11.91;0.72;230.63;5.17;703;57;1973.00;52
5020;57;628242259;5020;137;5722;5772;11.92;0.73;230.64;5.27;702;57;1974.00;50
5022;57;628242275;5022;132;5727;5776;11.92;0.73;230.63;5.28;705;57;1975.00;49
5026;57;628242285;5026;130;5727;5776;12.03;0.73;230.66;5.28;701;57;1976.00;49
5032;57;628242295;5032;127;5727;5776;12.19;0.74;230.57;5.28;695;57;1977.00;49
5039;57;628242306;5039;117;5727;5776;12.25;0.74;230.50;5.28;688;57;1978.00;49
5042;57;628242316;5042;114;5727;5776;12.26;0.74;230.47;5.28;685;57;1979.00;49
5048;57;628242327;5048;112;5747;5810;12.18;0.74;230.47;5.26;699;57;1980.00;63
5050;57;628242340;5050;116;5748;5810;12.13;0.74;230.57;5.26;698;57;1981.00;62
5051;57;628242350;5051;115;5749;5810;12.13;0.74;230.53;5.26;698;57;1982.00;61
5053;57;628242360;5053;111;5749;5810;12.13;0.74;230.65;5.26;696;57;1983.00;61
5055;57;628242370;5055;111;5750;5810;12.17;0.74;230.70;5.26;695;57;1984.00;60
5056;57;628242379;5056;110;5750;5810;12.23;0.75;230.69;5.26;694;57;1985.00;60
5058;57;628242389;5058;114;5751;5811;12.34;0.75;230.77;5.26;693;57;1986.00;60
5062;57;628242399;5062;118;5751;5811;12.32;0.75;230.76;5.26;689;57;1987.00;60
5065;57;628242409;5065;117;5755;5817;12.44;0.76;230.72;5.26;690;57;1988.00;62
5069;57;628242419;5069;114;5757;5818;12.45;0.76;230.65;5.26;688;57;1989.00;61
5076;57;628242429;5076;113;5757;5818;12.41;0.75;230.54;5.26;681;57;1990.00;61
5077;57;628242440;5077;117;5760;5818;12.33;0.75;230.51;5.27;683;57;1991.00;58
5080;57;628242449;5080;117;5762;5822;12.27;0.75;230.52;5.27;682;57;1992.00;60
5082;57;628242459;5082;124;5763;5822;12.20;0.74;230.49;5.27;681;57;1993.00;59
5086;57;628242469;5086;127;5763;5822;12.10;0.74;230.49;5.27;677;57;1994.00;59
5088;57;628242479;5088;129;5765;5823;11.97;0.73;230.48;5.27;677;57;1995.00;58
5090;57;628242489;5090;135;5769;5827;11.84;0.72;230.51;5.28;679;57;1996.00;58
5094;57;628242509;5094;142;5770;5827;11.79;0.71;230.53;5.28;676;57;1997.00;57
5099;57;628242522;5099;145;5772;5830;11.76;0.71;230.51;5.28;673;57;1998.00;58
5101;57;628242533;5101;152;5774;5830;11.65;0.71;230.51;5.28;673;57;1999.00;56
5103;57;628242543;5103;159;5776;5830;11.51;0.70;230.54;5.31;673;57;2000.00;54
5104;57;628242558;5104;161;5777;5830;11.40;0.69;230.54;5.31;673;57;2001.00;53
5107;57;628242568;5107;173;5781;5834;11.38;0.69;230.55;5.31;674;57;2002.00;53
5109;57;628242578;5109;178;5784;5834;11.31;0.69;230.58;5.33;675;57;2003.00;50
5113;57;628242588;5113;181;5784;5834;11.17;0.68;230.64;5.33;671;57;2004.00;50
5115;57;628242597;5115;188;5786;5834;11.01;0.67;230.67;5.35;671;57;2005.00;48
5117;57;628242606;5117;188;5786;5835;10.77;0.66;230.71;5.35;669;57;2006.00;49
5118;57;628242621;5118;191;5788;5836;10.58;0.64;230.69;5.36;670;57;2007.00;48
5120;57;628242630;5120;197;5789;5836;10.30;0.63;230.84;5.37;669;57;2008.00;47
5120;57;628242645;5120;209;5791;5837;10.17;0.62;230.84;5.38;671;57;2009.00;46
5122;57;628242656;5122;217;5792;5837;10.03;0.61;230.86;5.39;670;57;2010.00;45
5122;57;628242664;5122;226;5793;5837;9.89;0.61;230.86;5.40;671;57;2011.00;44
5125;57;628242672;5125;231;5794;5837;9.76;0.60;230.87;5.41;669;57;2012.00;43
5129;57;628242681;5129;240;5795;5837;9.66;0.59;230.82;5.42;666;57;2013.00;42
5130;57;628242690;5130;245;5796;5837;9.53;0.58;230.88;5.43;666;57;2014.00;41
5134;57;628242698;5134;252;5797;5837;9.38;0.57;230.79;5.43;663;57;2015.00;40
5136;57;628242706;5136;273;5861;5964;9.40;0.58;230.83;5.38;725;57;2016.00;103
5139;57;628242725;5139;274;5863;5965;9.25;0.57;230.77;5.39;724;57;2017.00;102
5141;57;628242734;5141;269;5874;5965;9.28;0.57;230.72;5.38;733;57;2018.00;91
5144;57;628242743;5144;268;5882;5965;9.14;0.56;230.64;5.39;738;57;2019.00;83
5145;57;628242752;5145;268;5889;5965;9.04;0.56;230.64;5.39;744;57;2020.00;76
5147;57;628242761;5147;268;5894;5965;8.89;0.55;230.57;5.39;747;57;2021.00;71
5149;57;628242769;5149;268;5902;5965;8.79;0.54;230.51;5.40;753;57;2022.00;63
5151;57;628242778;5151;267;5907;5965;8.71;0.54;230.46;5.40;756;57;2023.00;58
5153;57;628242787;5153;271;5913;5966;8.67;0.53;230.43;5.40;760;57;2024.00;53
5157;57;628242796;5157;271;5915;5968;8.58;0.53;230.32;5.40;758;57;2025.00;53
5158;57;628242805;5158;274;5917;5968;8.44;0.52;230.33;5.40;759;57;2026.00;51
5159;57;628242814;5159;278;5920;5969;8.40;0.51;230.31;5.41;761;57;2027.00;49
5160;57;628242823;5160;280;5922;5969;8.27;0.51;230.29;5.41;762;57;2028.00;47
5161;57;628242832;5161;294;5924;5969;8.11;0.50;230.28;5.41;763;57;2029.00;45
5162;57;628242841;5162;297;5926;5969;7.99;0.49;230.26;5.41;764;57;2030.00;43
5165;57;628242850;5165;300;5929;5973;7.83;0.48;230.26;5.41;764;57;2031.00;44
5167;57;628242860;5167;310;5933;5973;7.65;0.47;230.26;5.42;766;57;2032.00;40
5169;57;628242869;5169;320;5933;5973;7.46;0.46;230.26;5.42;764;57;2033.00;40
5171;57;628242877;5171;324;5938;5976;7.27;0.45;230.27;5.43;767;57;2034.00;38
5173;57;628242893;5173;331;5939;5976;7.09;0.44;230.27;5.43;766;57;2035.00;37
5174;57;628242901;5174;337;5940;5976;6.90;0.42;230.29;5.43;766;57;2036.00;36
5177;57;628242910;5177;350;5944;5980;6.70;0.41;230.35;5.42;767;57;2037.00;36
5179;57;628242919;5179;353;5946;5981;6.56;0.41;230.35;5.42;767;57;2038.00;35
5181;57;628242927;5181;357;5947;5981;6.41;0.40;230.34;5.42;766;57;2039.00;34
5184;57;628242937;5184;356;5952;5986;6.31;0.39;230.38;5.42;768;57;2040.00;34
5189;57;628242946;5189;359;5952;5986;6.14;0.38;230.30;5.42;763;57;2041.00;34
5191;57;628242954;5191;366;5952;5986;6.11;0.38;230.42;5.42;761;57;2042.00;34
5194;57;628242962;5194;354;5953;5987;6.09;0.38;230.40;5.42;759;57;2043.00;34
5196;57;628242970;5196;346;5953;5987;6.18;0.38;230.42;5.42;757;57;2044.00;34
5200;57;628242979;5200;340;5958;5993;6.30;0.39;230.39;5.41;758;57;2045.00;35
5203;57;628242988;5203;333;5959;5993;6.34;0.39;230.41;5.41;756;57;2046.00;34
5205;57;628242998;5205;320;5960;5994;6.42;0.40;230.34;5.41;755;57;2047.00;34
5208;57;628243006;5208;305;5960;5994;6.50;0.40;230.38;5.41;752;57;2048.00;34
5209;57;628243016;5209;298;5960;5994;6.61;0.41;230.35;5.41;751;57;2049.00;34
5211;57;628243025;5211;290;5960;5994;6.71;0.41;230.40;5.41;749;57;2050.00;34
5213;58;628243035;5213;283;5961;5994;6.76;0.42;230.44;5.51;748;58;2051.00;33
5216;58;628243059;5216;268;5971;6006;6.87;0.42;230.44;5.50;755;58;2052.00;35
5216;58;628243069;5216;268;5971;6006;6.99;0.43;230.44;5.50;755;58;2053.00;35
5219;58;628243086;5219;268;5973;6006;7.11;0.44;230.43;5.50;754;58;2054.00;33
5221;58;628243096;5221;264;5973;6006;7.22;0.44;230.45;5.50;752;58;2055.00;33
5224;58;628243105;5224;261;5973;6006;7.33;0.45;230.44;5.50;749;58;2056.00;33
5227;58;628243116;5227;259;5973;6006;7.52;0.46;230.45;5.50;746;58;2057.00;33
5227;58;628243126;5227;255;5977;6010;7.70;0.47;230.45;5.50;750;58;2058.00;33
5229;58;628243141;5229;253;5977;6010;7.81;0.48;230.45;5.50;748;58;2059.00;33
5232;58;628243157;5232;251;5980;6014;7.95;0.48;230.41;5.50;748;58;2060.00;34
5234;58;628243167;5234;246;5981;6015;8.06;0.49;230.43;5.50;747;58;2061.00;34
5236;58;628243184;5236;245;5982;6015;8.12;0.50;230.48;5.50;746;58;2062.00;33
5240;58;628243199;5240;238;5982;6015;8.13;0.49;230.48;5.50;742;58;2063.00;33
5244;58;628243209;5244;236;5995;6028;8.15;0.50;230.50;5.48;751;58;2064.00;33
5248;58;628243220;5248;236;5995;6028;8.30;0.51;230.52;5.48;747;58;2065.00;33
5250;58;628243231;5250;228;5995;6028;8.42;0.52;230.50;5.48;745;58;2066.00;33
5257;58;628243241;5257;218;5996;6029;8.51;0.52;230.66;5.48;739;58;2067.00;33
5263;58;628243251;5263;210;5997;6030;8.57;0.52;230.65;5.48;734;58;2068.00;33
5267;58;628243261;5267;208;5998;6030;8.65;0.53;230.70;5.58;731;58;2069.00;32
5270;58;628243273;5270;207;6001;6036;8.78;0.54;230.71;5.57;731;58;2070.00;35
5273;58;628243284;5273;207;6001;6036;8.83;0.54;230.69;5.57;728;58;2071.00;35
5279;58;628243294;5279;203;6002;6036;8.83;0.54;230.75;5.57;723;58;2072.00;34
5288;58;628243304;5288;205;6002;6036;8.83;0.54;230.75;5.57;714;58;2073.00;34
5292;58;628243315;5292;205;6006;6042;8.91;0.54;230.84;5.57;714;58;2074.00;36
5299;58;628243325;5299;206;6006;6042;8.82;0.54;230.85;5.57;707;58;2075.00;36
5305;58;628243335;5305;203;6007;6042;8.81;0.54;230.92;5.57;702;58;2076.00;35
5308;58;628243345;5308;210;6007;6042;8.75;0.53;230.95;5.57;699;58;2077.00;35
5313;58;628243355;5313;207;6012;6046;8.65;0.53;231.06;5.57;699;58;2078.00;34
5318;58;628243366;5318;209;6013;6047;8.68;0.53;231.14;5.57;695;58;2079.00;34
5319;58;628243376;5319;210;6014;6047;8.75;0.54;231.11;5.57;695;58;2080.00;33
5325;58;628243386;5325;210;6015;6048;8.73;0.53;231.28;5.56;690;58;2081.00;33
5330;58;628243397;5330;215;6015;6048;8.74;0.53;231.41;5.56;685;58;2082.00;33
5337;58;628243407;5337;222;6015;6048;8.73;0.53;231.40;5.56;678;58;2083.00;33
5341;58;628243417;5341;230;6015;6048;8.72;0.53;231.48;5.56;674;58;2084.00;33
5345;58;628243427;5345;231;6015;6048;8.77;0.53;231.47;5.56;670;58;2085.00;33
5347;58;628243437;5347;233;6015;6048;8.85;0.54;231.50;5.56;668;58;2086.00;33
5352;58;628243447;5352;224;6015;6048;8.84;0.54;231.53;5.56;663;58;2087.00;33
5354;58;628243457;5354;227;6059;6118;9.02;0.55;231.54;5.52;705;58;2088.00;59
5357;58;628243472;5357;210;6061;6119;9.13;0.56;231.54;5.52;704;58;2089.00;58
5360;58;628243483;5360;197;6065;6119;9.30;0.57;231.61;5.52;705;58;2090.00;54
5362;58;628243494;5362;186;6069;6119;9.52;0.58;231.61;5.52;707;58;2091.00;50
5363;58;628243505;5363;178;6073;6119;9.79;0.60;231.64;5.52;710;58;2092.00;46
5366;58;628243522;5366;177;6075;6119;10.00;0.61;231.74;5.52;709;58;2093.00;44
5368;58;628243540;5368;171;6080;6119;10.09;0.62;231.72;5.60;712;58;2094.00;39
5372;58;628243556;5372;165;6080;6119;10.13;0.62;231.70;5.60;708;58;2095.00;39
5377;58;628243575;5377;152;6082;6120;10.15;0.62;231.77;5.60;705;58;2096.00;38
5379;58;628243594;5379;142;6083;6121;10.23;0.62;231.87;5.60;704;58;2097.00;38
5381;58;628243612;5381;130;6084;6121;10.34;0.63;231.90;5.60;703;58;2098.00;37
5384;58;628243629;5384;123;6087;6125;10.34;0.63;231.92;5.60;703;58;2099.00;38
5385;58;628243655;5385;128;6091;6140;10.37;0.63;231.92;5.59;706;58;2100.00;49
5388;58;628243675;5388;122;6091;6140;10.50;0.64;231.94;5.59;703;58;2101.00;49
5391;58;628243689;5391;120;6091;6140;10.63;0.65;232.07;5.59;700;58;2102.00;49
5393;58;628243702;5393;119;6094;6146;10.78;0.66;232.06;5.59;701;58;2103.00;52
5396;58;628243716;5396;119;6094;6146;10.98;0.67;232.12;5.59;698;58;2104.00;52
5399;58;628243729;5399;118;6095;6146;11.19;0.68;232.13;5.59;696;58;2105.00;51
5399;58;628243742;5399;117;6098;6149;11.45;0.70;232.13;5.59;699;58;2106.00;51
5403;58;628243754;5403;117;6098;6149;11.58;0.71;232.09;5.59;695;58;2107.00;51
5406;58;628243766;5406;117;6098;6149;11.65;0.71;232.17;5.59;692;58;2108.00;51
5407;58;628243778;5407;119;6098;6150;11.71;0.71;232.14;5.59;691;58;2109.00;52
5411;58;628243790;5411;119;6099;6151;11.84;0.72;232.15;5.59;688;58;2110.00;52
5413;58;628243802;5413;122;6100;6151;11.91;0.73;232.15;5.59;687;58;2111.00;51
5420;58;628243815;5420;125;6110;6164;11.85;0.72;232.23;5.58;690;58;2112.00;54
5424;58;628243828;5424;122;6110;6164;11.85;0.72;232.21;5.58;686;58;2113.00;54
5426;58;628243842;5426;124;6110;6164;11.91;0.72;232.21;5.58;684;58;2114.00;54
5428;58;628243853;5428;128;6112;6166;11.95;0.73;232.29;5.58;684;58;2115.00;54
5430;58;628243865;5430;128;6113;6166;11.97;0.73;232.30;5.58;683;58;2116.00;53
5432;58;628243876;5432;130;6115;6170;11.98;0.73;232.32;5.58;683;58;2117.00;55
5436;58;628243888;5436;130;6116;6170;12.01;0.73;232.29;5.58;680;58;2118.00;54
5436;58;628243900;5436;131;6119;6174;12.02;0.73;232.29;5.58;683;58;2119.00;55
5438;58;628243911;5438;131;6119;6174;12.02;0.73;232.30;5.58;681;58;2120.00;55
5443;58;628243922;5443;126;6119;6174;11.94;0.73;232.45;5.58;676;58;2121.00;55
5446;58;628243940;5446;128;6120;6174;11.89;0.72;232.55;5.58;674;58;2122.00;54
5448;58;628243951;5448;127;6120;6174;11.84;0.72;232.55;5.58;672;58;2123.00;54
5452;58;628243968;5452;130;6129;6186;11.79;0.72;232.58;5.58;677;58;2124.00;57
5453;58;628243979;5453;128;6131;6186;11.80;0.72;232.65;5.59;678;58;2125.00;55
5458;58;628243990;5458;131;6132;6186;11.86;0.72;232.69;5.58;674;58;2126.00;54
5461;58;628244000;5461;132;6133;6186;11.95;0.73;232.73;5.59;672;58;2127.00;53
5465;58;628244010;5465;130;6134;6186;12.00;0.73;232.73;5.59;669;58;2128.00;52
5468;58;628244021;5468;127;6136;6186;11.98;0.73;232.78;5.68;668;58;2129.00;50
5472;58;628244034;5472;128;6138;6187;11.95;0.73;232.82;5.68;666;58;2130.00;49
5476;58;628244044;5476;125;6140;6187;11.96;0.73;232.78;5.69;664;58;2131.00;47
5479;58;628244054;5479;128;6143;6193;11.94;0.73;232.82;5.68;664;58;2132.00;50
5484;58;628244067;5484;127;6145;6194;11.98;0.73;232.84;5.68;661;58;2133.00;49
5488;58;628244077;5488;133;6145;6194;12.02;0.73;232.83;5.68;657;58;2134.00;49
5492;58;628244087;5492;137;6146;6194;11.98;0.73;232.89;5.68;654;58;2135.00;48
5495;58;628244097;5495;139;6149;6198;11.99;0.73;232.90;5.68;654;58;2136.00;49
5499;58;628244107;5499;136;6150;6198;11.99;0.73;232.85;5.68;651;58;2137.00;48
5504;58;628244117;5504;135;6150;6198;12.04;0.73;232.90;5.68;646;58;2138.00;48
5506;58;628244127;5506;134;6151;6199;12.10;0.74;232.95;5.68;645;58;2139.00;48
5511;58;628244136;5511;132;6154;6203;12.00;0.73;232.88;5.68;643;58;2140.00;49
5516;58;628244146;5516;130;6154;6203;11.95;0.73;232.89;5.68;638;58;2141.00;49
5520;58;628244156;5520;124;6156;6206;11.96;0.73;232.98;5.68;636;58;2142.00;50
5522;58;628244165;5522;126;6156;6206;11.99;0.73;232.95;5.68;634;58;2143.00;50
5525;58;628244175;5525;124;6158;6206;11.99;0.73;232.93;5.76;633;58;2144.00;48
5531;58;628244185;5531;121;6160;6206;11.96;0.72;233.01;5.78;629;58;2145.00;46
5533;59;628244195;5533;121;6164;6210;12.01;0.73;232.98;5.86;631;59;2146.00;46
5539;59;628244212;5539;117;6164;6210;11.98;0.73;232.97;5.86;625;59;2147.00;46
5540;59;628244222;5540;118;6165;6210;12.05;0.73;232.95;5.86;625;59;2148.00;45
5542;59;628244242;5542;114;6166;6210;12.06;0.73;232.92;5.94;624;59;2149.00;44
5546;59;628244252;5546;118;6166;6211;12.09;0.73;232.91;5.94;620;59;2150.00;45
5546;59;628244262;5546;117;6167;6212;12.14;0.74;232.91;5.94;621;59;2151.00;45
5548;59;628244271;5548;119;6168;6212;12.02;0.73;232.96;6.01;620;59;2152.00;44
5550;59;628244282;5550;118;6169;6213;12.00;0.73;232.97;6.01;619;59;2153.00;44
5552;59;628244291;5552;122;6169;6213;11.87;0.72;232.91;6.01;617;59;2154.00;44
5557;59;628244300;5557;127;6169;6213;11.73;0.71;232.89;6.01;612;59;2155.00;44
5560;59;628244309;5560;127;6169;6213;11.57;0.70;232.93;6.01;609;59;2156.00;44
5561;59;628244318;5561;131;6169;6213;11.53;0.70;232.94;6.01;608;59;2157.00;44
5565;59;628244327;5565;133;6169;6213;11.56;0.70;233.01;6.01;604;59;2158.00;44
5569;59;628244337;5569;138;6169;6213;11.57;0.70;233.08;6.01;600;59;2159.00;44
5570;59;628244348;5570;174;6265;6443;11.25;0.70;233.06;5.92;695;59;2160.00;178
5573;59;628244376;5573;171;6269;6444;11.11;0.69;233.04;5.92;696;59;2161.00;175
5574;59;628244386;5574;160;6278;6444;11.08;0.69;233.06;5.91;704;59;2162.00;166
5574;59;628244396;5574;160;6287;6444;11.00;0.69;233.06;5.91;713;59;2163.00;157
5575;59;628244405;5575;161;6294;6444;10.90;0.68;233.06;5.91;719;59;2164.00;150
5577;59;628244420;5577;160;6301;6444;10.76;0.67;233.04;5.90;724;59;2165.00;143
5577;59;628244436;5577;162;6308;6444;10.65;0.66;233.04;5.90;731;59;2166.00;136
5577;59;628244451;5577;167;6313;6444;10.64;0.66;233.04;5.91;736;59;2167.00;131
5584;59;628244461;5584;175;6318;6445;10.64;0.66;233.02;5.91;734;59;2168.00;127
5589;59;628244473;5589;184;6324;6446;10.61;0.66;232.95;5.91;735;59;2169.00;122
5589;59;628244485;5589;185;6328;6446;10.55;0.65;232.95;5.93;739;59;2170.00;118
5590;59;628244496;5590;190;6331;6447;10.52;0.65;232.92;5.94;741;59;2171.00;116
5592;59;628244509;5592;196;6334;6447;10.40;0.64;233.00;5.94;742;59;2172.00;113
5594;59;628244520;5594;201;6338;6447;10.26;0.63;232.95;5.94;744;59;2173.00;109
5596;59;628244531;5596;208;6343;6447;10.08;0.62;232.91;5.97;747;59;2174.00;104
5597;59;628244541;5597;217;6348;6451;9.92;0.61;232.89;5.97;751;59;2175.00;103
5598;59;628244553;5598;224;6353;6451;9.73;0.60;232.89;5.99;755;59;2176.00;98
5601;59;628244565;5601;229;6356;6451;9.59;0.59;232.87;6.01;755;59;2177.00;95
5602;59;628244575;5602;230;6360;6454;9.47;0.58;232.86;6.02;758;59;2178.00;94
5603;59;628244585;5603;237;6364;6454;9.25;0.57;232.86;6.02;761;59;2179.00;90
5604;59;628244594;5604;250;6366;6454;9.11;0.56;232.84;6.03;762;59;2180.00;88
5605;59;628244604;5605;260;6373;6458;9.00;0.55;232.82;6.05;768;59;2181.00;85
5606;59;628244614;5606;269;6378;6459;8.90;0.55;232.78;6.05;772;59;2182.00;81
5607;59;628244624;5607;279;6385;6459;8.78;0.54;232.75;6.10;778;59;2183.00;74
5610;59;628244633;5610;286;6390;6463;8.67;0.53;232.76;6.11;780;59;2184.00;73
5611;59;628244644;5611;292;6393;6463;8.49;0.52;232.74;6.13;782;59;2185.00;70
5611;59;628244653;5611;306;6399;6463;8.34;0.51;232.74;6.15;788;59;2186.00;64
5612;59;628244662;5612;314;6402;6464;8.15;0.50;232.83;6.16;790;59;2187.00;62
5615;59;628244671;5615;325;6405;6464;7.96;0.49;232.80;6.16;790;59;2188.00;59
5617;59;628244680;5617;331;6410;6470;7.83;0.48;232.74;6.16;793;59;2189.00;60
5619;59;628244692;5619;334;6411;6470;7.60;0.47;232.74;6.17;792;59;2190.00;59
5623;59;628244701;5623;337;6412;6471;7.37;0.45;232.64;6.17;789;59;2191.00;59
5626;59;628244710;5626;338;6416;6471;7.19;0.44;232.54;6.18;790;59;2192.00;55
5626;59;628244720;5626;351;6416;6471;7.05;0.43;232.54;6.18;790;59;2193.00;55
5626;59;628244730;5626;363;6418;6471;6.94;0.43;232.54;6.18;792;59;2194.00;53
5626;59;628244739;5626;350;6419;6471;6.87;0.42;232.54;6.19;793;59;2195.00;52
5626;59;628244749;5626;344;6430;6483;6.95;0.43;232.54;6.18;804;59;2196.00;53
5629;59;628244759;5629;341;6432;6483;6.90;0.42;232.51;6.19;803;59;2197.00;51
5630;59;628244769;5630;334;6432;6483;6.91;0.42;232.50;6.19;802;59;2198.00;51
5630;59;628244779;5630;335;6434;6483;6.93;0.42;232.50;6.20;804;59;2199.00;49
5632;60;628244789;5632;334;6434;6483;6.93;0.42;232.47;6.20;802;60;2200.00;49
5636;60;628244817;5636;336;6434;6483;6.92;0.42;232.40;6.20;798;60;2201.00;49
5638;60;628244827;5638;332;6439;6487;6.87;0.42;232.37;6.20;801;60;2202.00;48
5642;60;628244837;5642;324;6439;6487;6.86;0.42;232.36;6.20;797;60;2203.00;48
5644;60;628244847;5644;324;6444;6491;6.85;0.42;232.35;6.20;800;60;2204.00;47
5646;60;628244862;5646;318;6446;6493;6.81;0.42;232.39;6.20;800;60;2205.00;47
5649;60;628244871;5649;311;6448;6493;6.79;0.42;232.40;6.20;799;60;2206.00;45
5652;60;628244881;5652;307;6449;6493;6.77;0.42;232.52;6.20;797;60;2207.00;44
5658;60;628244891;5658;306;6461;6506;6.73;0.41;232.53;6.19;803;60;2208.00;45
5660;60;628244901;5660;301;6462;6506;6.76;0.42;232.54;6.19;802;60;2209.00;44
5662;60;628244910;5662;289;6463;6508;6.77;0.42;232.56;6.19;801;60;2210.00;45
5664;60;628244920;5664;280;6464;6509;6.75;0.42;232.61;6.19;800;60;2211.00;45
5667;60;628244934;5667;271;6465;6510;6.74;0.42;232.66;6.19;798;60;2212.00;45
5668;60;628244944;5668;262;6466;6510;6.78;0.42;232.68;6.19;798;60;2213.00;44
5673;60;628244953;5673;260;6469;6513;6.82;0.42;232.68;6.19;796;60;2214.00;44
5674;60;628244963;5674;256;6469;6513;6.89;0.42;232.71;6.19;795;60;2215.00;44
5678;60;628244978;5678;264;6470;6513;6.92;0.43;232.75;6.19;792;60;2216.00;43
5680;60;628244988;5680;260;6470;6513;7.05;0.43;232.81;6.19;790;60;2217.00;43
5683;60;628244997;5683;248;6474;6519;7.24;0.44;232.83;6.18;791;60;2218.00;45
5686;61;628245007;5686;241;6475;6519;7.31;0.45;232.91;6.18;789;61;2219.00;44
5687;61;628245029;5687;236;6475;6519;7.46;0.46;232.92;6.18;788;61;2220.00;44
5693;61;628245038;5693;232;6475;6519;7.53;0.46;232.94;6.18;782;61;2221.00;44
5698;61;628245048;5698;227;6479;6523;7.62;0.47;232.99;6.18;781;61;2222.00;44
5700;61;628245058;5700;217;6480;6524;7.78;0.48;232.96;6.18;780;61;2223.00;44
5703;61;628245068;5703;219;6480;6524;7.85;0.48;232.98;6.18;777;61;2224.00;44
5711;61;628245077;5711;211;6481;6525;7.88;0.48;232.91;6.18;770;61;2225.00;44
5716;61;628245088;5716;211;6481;6525;7.94;0.49;232.91;6.18;765;61;2226.00;44
5721;61;628245097;5721;211;6481;6525;8.05;0.49;232.91;6.18;760;61;2227.00;44
5725;61;628245113;5725;215;6481;6525;8.11;0.50;232.89;6.18;756;61;2228.00;44
5730;61;628245123;5730;208;6481;6525;8.15;0.50;232.91;6.18;751;61;2229.00;44
5735;61;628245133;5735;208;6481;6525;8.19;0.50;232.90;6.18;746;61;2230.00;44
5739;61;628245143;5739;201;6481;6525;8.31;0.51;232.87;6.18;742;61;2231.00;44
5747;61;628245153;5747;201;6519;6595;8.49;0.52;232.90;6.14;772;61;2232.00;76
5749;61;628245174;5749;190;6520;6596;8.59;0.53;232.89;6.14;771;61;2233.00;76
5753;61;628245185;5753;177;6528;6596;8.78;0.54;232.83;6.22;775;61;2234.00;68
5756;61;628245198;5756;175;6534;6596;8.86;0.54;232.92;6.22;778;61;2235.00;62
5761;61;628245213;5761;168;6539;6596;8.94;0.55;232.94;6.22;778;61;2236.00;57
5765;61;628245224;5765;169;6542;6596;9.04;0.55;232.89;6.21;777;61;2237.00;54
5769;61;628245235;5769;163;6545;6596;9.03;0.55;233.00;6.21;776;61;2238.00;51
5775;61;628245247;5775;162;6546;6596;9.01;0.55;232.98;6.21;771;61;2239.00;50
5779;61;628245259;5779;171;6549;6597;9.05;0.55;232.99;6.21;770;61;2240.00;48
5783;61;628245270;5783;175;6549;6598;9.13;0.56;233.13;6.21;766;61;2241.00;49
5789;61;628245281;5789;181;6550;6598;9.18;0.56;233.17;6.21;761;61;2242.00;48
5794;61;628245292;5794;190;6553;6602;9.31;0.57;233.16;6.21;759;61;2243.00;49
5797;61;628245304;5797;196;6553;6602;9.36;0.57;233.19;6.21;756;61;2244.00;49
5799;61;628245315;5799;197;6553;6602;9.44;0.57;233.25;6.21;754;61;2245.00;49
5802;61;628245326;5802;200;6553;6602;9.50;0.58;233.26;6.21;751;61;2246.00;49
5804;61;628245338;5804;202;6557;6608;9.53;0.58;233.32;6.21;753;61;2247.00;51
5808;61;628245349;5808;208;6558;6608;9.55;0.58;233.39;6.21;750;61;2248.00;50
5809;61;628245360;5809;210;6558;6608;9.60;0.58;233.36;6.21;749;61;2249.00;50
5813;61;628245373;5813;209;6561;6614;9.66;0.59;233.40;6.20;748;61;2250.00;53
5818;61;628245384;5818;210;6561;6614;9.70;0.59;233.45;6.20;743;61;2251.00;53
5823;61;628245395;5823;209;6562;6614;9.69;0.59;233.45;6.20;739;61;2252.00;52
5825;61;628245406;5825;209;6562;6615;9.71;0.59;233.46;6.20;737;61;2253.00;53
5831;61;628245417;5831;208;6564;6616;9.69;0.59;233.54;6.20;733;61;2254.00;52
5834;61;628245428;5834;209;6564;6616;9.62;0.59;233.56;6.20;730;61;2255.00;52
5837;61;628245439;5837;214;6575;6629;9.73;0.59;233.58;6.19;738;61;2256.00;54
5843;61;628245450;5843;204;6575;6629;9.71;0.59;233.68;6.19;732;61;2257.00;54
5845;61;628245461;5845;196;6576;6629;9.71;0.59;233.71;6.19;731;61;2258.00;53
5851;61;628245479;5851;193;6577;6630;9.72;0.59;233.71;6.19;726;61;2259.00;53
5855;61;628245491;5855;189;6577;6630;9.73;0.59;233.76;6.19;722;61;2260.00;53
5855;61;628245502;5855;187;6580;6634;9.81;0.60;233.76;6.19;725;61;2261.00;54
5858;61;628245519;5858;195;6580;6634;9.83;0.60;233.78;6.19;722;61;2262.00;54
5861;61;628245535;5861;197;6584;6638;9.84;0.60;233.74;6.19;723;61;2263.00;54
5863;61;628245566;5863;198;6584;6638;9.88;0.60;233.84;6.19;721;61;2264.00;54
5866;61;628245590;5866;200;6584;6638;9.95;0.61;233.88;6.19;718;61;2265.00;54
5870;61;628245610;5870;184;6584;6638;10.02;0.61;233.89;6.19;714;61;2266.00;54
5873;61;628245629;5873;172;6584;6638;10.03;0.61;233.90;6.19;711;61;2267.00;54
5876;61;628245656;5876;166;6593;6650;10.03;0.61;233.98;6.18;717;61;2268.00;57
5879;61;628245681;5879;160;6594;6650;10.15;0.62;234.05;6.18;715;61;2269.00;56
5880;61;628245696;5880;156;6595;6650;10.32;0.63;234.02;6.18;715;61;2270.00;55
5883;61;628245710;5883;150;6595;6650;10.37;0.63;234.07;6.18;712;61;2271.00;55
5886;61;628245723;5886;148;6595;6650;10.40;0.63;234.13;6.18;709;61;2272.00;55
5892;61;628245737;5892;150;6595;6650;10.60;0.64;234.07;6.18;703;61;2273.00;55
5894;61;628245755;5894;143;6595;6651;10.72;0.65;234.10;6.18;701;61;2274.00;56
5897;61;628245769;5897;145;6595;6651;10.82;0.66;234.06;6.18;698;61;2275.00;56
5900;61;628245781;5900;139;6599;6657;10.95;0.67;234.10;6.17;699;61;2276.00;58
5901;62;628245795;5901;135;6600;6658;11.06;0.67;234.12;6.17;699;62;2277.00;58
5903;62;628245839;5903;128;6601;6658;11.17;0.68;234.16;6.17;698;62;2278.00;57
5905;62;628245861;5905;119;6601;6658;11.19;0.68;234.15;6.17;696;62;2279.00;57
5906;63;628245886;5906;111;6605;6663;11.28;0.69;234.15;6.17;699;63;2280.00;58
5908;63;628245933;5908;105;6605;6663;11.35;0.69;234.15;6.17;697;63;2281.00;58
5913;63;628245949;5913;105;6605;6663;11.38;0.69;234.15;6.17;692;63;2282.00;58
5917;63;628245963;5917;107;6606;6664;11.41;0.69;234.29;6.17;689;63;2283.00;58
5922;63;628245978;5922;104;6609;6668;11.34;0.69;234.25;6.17;687;63;2284.00;59
5923;63;628245992;5923;103;6609;6668;11.33;0.69;234.26;6.17;686;63;2285.00;59
5925;63;628246005;5925;112;6611;6671;11.37;0.69;234.35;6.16;686;63;2286.00;60
5929;63;628246017;5929;116;6611;6671;11.32;0.69;234.41;6.16;682;63;2287.00;60
5931;63;628246029;5931;119;6612;6671;11.36;0.69;234.47;6.16;681;63;2288.00;59
5935;63;628246040;5935;122;6612;6671;11.39;0.69;234.43;6.16;677;63;2289.00;59
5936;63;628246052;5936;126;6615;6675;11.46;0.69;234.41;6.16;679;63;2290.00;60
5938;63;628246065;5938;131;6615;6675;11.52;0.70;234.42;6.16;677;63;2291.00;60
5939;63;628246076;5939;133;6616;6675;11.53;0.70;234.42;6.16;677;63;2292.00;59
5943;63;628246087;5943;129;6616;6675;11.55;0.70;234.46;6.16;673;63;2293.00;59
5944;63;628246098;5944;131;6616;6676;11.60;0.70;234.46;6.16;672;63;2294.00;60
5947;63;628246109;5947;134;6618;6678;11.63;0.71;234.49;6.16;671;63;2295.00;60
5951;63;628246120;5951;137;6618;6678;11.60;0.70;234.47;6.16;667;63;2296.00;60
5954;63;628246133;5954;139;6619;6679;11.63;0.71;234.46;6.16;665;63;2297.00;60
5955;63;628246144;5955;140;6619;6679;11.56;0.70;234.51;6.16;664;63;2298.00;60
5958;63;628246154;5958;143;6619;6679;11.45;0.70;234.52;6.16;661;63;2299.00;60
5960;63;628246166;5960;148;6619;6679;11.41;0.69;234.55;6.16;659;63;2300.00;60
5961;63;628246187;5961;150;6619;6679;11.36;0.69;234.55;6.16;658;63;2301.00;60
5964;63;628246197;5964;144;6619;6679;11.29;0.69;234.52;6.16;655;63;2302.00;60
5967;63;628246208;5967;144;6619;6679;11.21;0.68;234.55;6.16;652;63;2303.00;60
5968;63;628246219;5968;168;6692;6806;10.80;0.67;234.61;6.09;724;63;2304.00;114
5973;63;628246240;5973;159;6692;6807;10.79;0.67;234.52;6.09;719;63;2305.00;115
5979;63;628246252;5979;155;6700;6807;10.97;0.68;234.55;6.09;721;63;2306.00;107
5985;63;628246264;5985;148;6702;6807;11.04;0.68;234.54;6.09;717;63;2307.00;105
5985;63;628246274;5985;152;6707;6807;11.16;0.69;234.54;6.08;722;63;2308.00;100
5987;63;628246285;5987;142;6712;6807;11.17;0.69;234.56;6.08;725;63;2309.00;95
5990;63;628246303;5990;140;6717;6807;11.19;0.69;234.51;6.08;727;63;2310.00;90
5996;63;628246314;5996;143;6719;6807;11.19;0.69;234.55;6.08;723;63;2311.00;88
5999;63;628246325;5999;142;6724;6808;11.34;0.69;234.51;6.08;725;63;2312.00;84
6004;63;628246344;6004;141;6728;6809;11.34;0.69;234.59;6.09;724;63;2313.00;81
6008;63;628246355;6008;141;6730;6809;11.32;0.69;234.58;6.09;722;63;2314.00;79
6012;63;628246366;6012;142;6731;6810;11.28;0.69;234.50;6.10;719;63;2315.00;79
6016;63;628246377;6016;142;6734;6810;11.19;0.69;234.48;6.11;718;63;2316.00;76
6018;63;628246388;6018;136;6735;6810;11.10;0.68;234.48;6.11;717;63;2317.00;75
6022;63;628246399;6022;137;6736;6810;11.06;0.68;234.43;6.12;714;63;2318.00;74
6025;63;628246409;6025;135;6740;6814;10.97;0.67;234.45;6.20;715;63;2319.00;74
6028;63;628246421;6028;138;6742;6814;10.91;0.67;234.42;6.20;714;63;2320.00;72
6031;63;628246432;6031;137;6743;6814;10.93;0.67;234.36;6.21;712;63;2321.00;71
6033;63;628246442;6033;142;6745;6817;10.93;0.67;234.30;6.21;712;63;2322.00;72
6034;63;628246454;6034;149;6746;6817;10.88;0.66;234.27;6.21;712;63;2323.00;71
6036;63;628246464;6036;153;6747;6817;10.82;0.66;234.28;6.21;711;63;2324.00;70
6037;63;628246476;6037;162;6750;6821;10.76;0.66;234.26;6.20;713;63;2325.00;71
6039;63;628246486;6039;168;6752;6822;10.80;0.66;234.24;6.20;713;63;2326.00;70
6041;63;628246498;6041;175;6753;6822;10.80;0.66;234.37;6.20;712;63;2327.00;69
6045;63;628246508;6045;177;6756;6826;10.75;0.66;234.27;6.20;711;63;2328.00;70
6050;63;628246520;6050;182;6756;6826;10.68;0.65;234.20;6.20;706;63;2329.00;70
6051;63;628246531;6051;189;6756;6826;10.59;0.65;234.18;6.20;705;63;2330.00;70
6056;63;628246541;6056;192;6757;6827;10.54;0.64;234.15;6.20;701;63;2331.00;70
6058;63;628246553;6058;192;6757;6827;10.47;0.64;234.10;6.20;699;63;2332.00;70
6059;63;628246564;6059;197;6761;6833;10.37;0.63;234.06;6.20;702;63;2333.00;72
6061;63;628246573;6061;203;6762;6833;10.27;0.63;234.02;6.19;701;63;2334.00;71
6063;63;628246583;6063;212;6762;6834;10.16;0.62;233.98;6.19;699;63;2335.00;72
6064;63;628246593;6064;212;6763;6834;9.99;0.61;233.97;6.21;699;63;2336.00;71
6066;63;628246603;6066;217;6763;6834;9.79;0.60;233.96;6.21;697;63;2337.00;71
6066;63;628246615;6066;226;6763;6834;9.64;0.59;233.96;6.21;697;63;2338.00;71
6070;63;628246624;6070;232;6764;6834;9.46;0.58;233.95;6.22;694;63;2339.00;70
6070;63;628246641;6070;234;6786;6870;9.37;0.57;233.95;6.22;716;63;2340.00;84
6071;63;628246654;6071;246;6788;6870;9.29;0.57;233.94;6.23;717;63;2341.00;82
6073;63;628246663;6073;253;6791;6870;9.27;0.57;233.92;6.23;718;63;2342.00;79
6074;63;628246672;6074;263;6794;6870;9.19;0.56;233.90;6.24;720;63;2343.00;76
6075;63;628246681;6075;266;6796;6870;9.07;0.55;233.89;6.25;721;63;2344.00;74
6076;63;628246690;6076;271;6799;6870;8.92;0.55;233.87;6.27;723;63;2345.00;71
6077;63;628246699;6077;279;6802;6874;8.82;0.54;233.86;6.27;725;63;2346.00;72
6080;63;628246708;6080;271;6805;6874;8.73;0.53;233.81;6.29;725;63;2347.00;69
6081;63;628246718;6081;267;6807;6878;8.73;0.53;233.82;6.28;726;63;2348.00;71
6083;63;628246728;6083;270;6812;6879;8.64;0.53;233.80;6.30;729;63;2349.00;67
6084;63;628246736;6084;270;6813;6879;8.57;0.52;233.78;6.30;729;63;2350.00;66
6086;63;628246745;6086;265;6815;6879;8.46;0.52;233.79;6.31;729;63;2351.00;64
6087;63;628246754;6087;262;6826;6892;8.40;0.51;233.75;6.30;739;63;2352.00;66
6088;63;628246765;6088;262;6827;6892;8.36;0.51;233.73;6.32;739;63;2353.00;65
6089;63;628246774;6089;259;6828;6892;8.32;0.51;233.73;6.32;739;63;2354.00;64
6090;63;628246783;6090;264;6830;6893;8.27;0.51;233.71;6.33;740;63;2355.00;63
6092;63;628246792;6092;268;6831;6894;8.16;0.50;233.68;6.34;739;63;2356.00;63
6095;63;628246801;6095;266;6832;6894;8.06;0.49;233.65;6.34;737;63;2357.00;62
6095;63;628246811;6095;270;6835;6897;8.03;0.49;233.65;6.35;740;63;2358.00;62
6096;63;628246820;6096;265;6836;6897;7.97;0.49;233.61;6.35;740;63;2359.00;61
6099;63;628246829;6099;262;6837;6897;7.91;0.48;233.61;6.35;738;63;2360.00;60
6099;63;628246851;6099;260;6837;6897;7.91;0.48;233.61;6.35;738;63;2361.00;60
6101;63;628246860;6101;263;6844;6903;7.93;0.48;233.60;6.36;743;63;2362.00;59
6104;63;628246869;6104;256;6844;6903;7.88;0.48;233.57;6.36;740;63;2363.00;59
6105;63;628246879;6105;262;6846;6903;7.89;0.48;233.56;6.37;741;63;2364.00;57
6105;63;628246887;6105;258;6846;6903;7.83;0.48;233.56;6.37;741;63;2365.00;57
6107;63;628246897;6107;259;6852;6907;7.75;0.47;233.54;6.39;745;63;2366.00;55
6108;63;628246906;6108;257;6853;6908;7.80;0.48;233.54;6.39;745;63;2367.00;55
6108;63;628246915;6108;261;6853;6908;7.82;0.48;233.54;6.39;745;63;2368.00;55
6110;63;628246924;6110;261;6855;6909;7.91;0.48;233.51;6.39;745;63;2369.00;54
6111;63;628246936;6111;263;6855;6909;7.93;0.48;233.50;6.39;744;63;2370.00;54
6114;63;628246946;6114;264;6856;6909;7.94;0.49;233.51;6.40;742;63;2371.00;53
6117;63;628246955;6117;266;6857;6909;7.85;0.48;233.53;6.41;740;63;2372.00;52
6119;63;628246965;6119;266;6857;6909;7.83;0.48;233.51;6.41;738;63;2373.00;52
6123;63;628246974;6123;261;6860;6909;7.79;0.48;233.58;6.42;737;63;2374.00;49
6125;63;628246983;6125;250;6860;6909;7.71;0.47;233.63;6.42;735;63;2375.00;49
6131;63;628246992;6131;258;6903;6979;7.79;0.48;233.69;6.38;772;63;2376.00;76
6138;63;628247008;6138;252;6906;6980;7.76;0.48;233.71;6.38;768;63;2377.00;74
6139;63;628247018;6139;250;6913;6980;7.82;0.48;233.74;6.38;774;63;2378.00;67
6144;63;628247027;6144;256;6913;6980;7.78;0.48;233.79;6.38;769;63;2379.00;67
6144;63;628247036;6144;243;6920;6980;7.93;0.49;233.79;6.38;776;63;2380.00;60
6150;63;628247045;6150;239;6923;6980;7.92;0.48;233.77;6.38;773;63;2381.00;57
6154;63;628247055;6154;235;6926;6980;7.95;0.49;233.81;6.38;772;63;2382.00;54
6158;63;628247064;6158;229;6928;6980;7.98;0.49;233.89;6.38;770;63;2383.00;52
6162;63;628247078;6162;230;6931;6981;8.02;0.49;233.95;6.38;769;63;2384.00;50
6167;63;628247089;6167;237;6936;6983;8.19;0.50;233.91;6.38;769;63;2385.00;47
6171;63;628247100;6171;234;6936;6983;8.21;0.50;233.92;6.38;765;63;2386.00;47
6174;63;628247116;6174;234;6940;6987;8.24;0.50;233.93;6.37;766;63;2387.00;47
6177;63;628247127;6177;227;6940;6987;8.26;0.51;233.93;6.37;763;63;2388.00;47
6181;63;628247137;6181;220;6940;6987;8.36;0.51;233.96;6.37;759;63;2389.00;47
6184;63;628247149;6184;212;6940;6987;8.46;0.52;233.92;6.37;756;63;2390.00;47
6191;63;628247159;6191;211;6944;6993;8.58;0.53;233.93;6.37;753;63;2391.00;49
6194;63;628247172;6194;206;6945;6993;8.69;0.53;233.97;6.37;751;63;2392.00;48
6198;63;628247183;6198;199;6945;6993;8.83;0.54;233.98;6.37;747;63;2393.00;48
6204;63;628247195;6204;197;6948;6996;8.92;0.55;233.93;6.37;744;63;2394.00;48
6207;63;628247206;6207;198;6948;6996;9.02;0.55;233.96;6.37;741;63;2395.00;48
6211;63;628247217;6211;198;6948;6996;9.07;0.56;233.95;6.37;737;63;2396.00;48
6220;63;628247228;6220;196;6949;6997;9.12;0.56;233.94;6.37;729;63;2397.00;48
6222;63;628247239;6222;195;6950;6998;9.26;0.57;233.94;6.36;728;63;2398.00;48
6228;63;628247250;6228;193;6950;6998;9.33;0.57;233.96;6.36;722;63;2399.00;48
6229;63;628247265;6229;191;6974;7057;9.33;0.57;233.96;6.34;745;63;2400.00;83
6234;63;628247286;6234;180;6975;7057;9.34;0.57;233.99;6.34;741;63;2401.00;82
6237;63;628247297;6237;181;6978;7057;9.34;0.57;234.00;6.34;741;63;2402.00;79
6243;63;628247308;6243;180;6979;7058;9.41;0.58;234.11;6.34;736;63;2403.00;79
6250;63;628247320;6250;182;6981;7058;9.41;0.58;234.13;6.34;731;63;2404.00;77
6257;63;628247332;6257;180;6983;7062;9.50;0.58;234.13;6.34;726;63;2405.00;79
6263;63;628247346;6263;183;6985;7062;9.52;0.58;234.34;6.34;722;63;2406.00;77
6268;63;628247357;6268;184;6988;7066;9.55;0.58;234.33;6.33;720;63;2407.00;78
6271;63;628247369;6271;189;6990;7066;9.56;0.58;234.40;6.33;719;63;2408.00;76
6276;63;628247380;6276;192;6990;7066;9.56;0.58;234.45;6.33;714;63;2409.00;76
6280;63;628247392;6280;192;6991;7066;9.57;0.58;234.49;6.34;711;63;2410.00;75
6284;63;628247406;6284;196;6992;7066;9.55;0.58;234.55;6.34;708;63;2411.00;74
6288;63;628247419;6288;199;7000;7078;9.61;0.58;234.52;6.33;712;63;2412.00;78
6290;63;628247431;6290;198;7000;7078;9.66;0.59;234.53;6.33;710;63;2413.00;78
6292;63;628247443;6292;206;7002;7078;9.67;0.59;234.58;6.33;710;63;2414.00;76
6298;63;628247454;6298;209;7002;7078;9.72;0.59;234.61;6.33;704;63;2415.00;76
6301;63;628247471;6301;213;7003;7078;9.70;0.59;234.58;6.33;702;63;2416.00;75
6307;63;628247481;6307;217;7003;7078;9.65;0.59;234.61;6.33;696;63;2417.00;75
6310;63;628247492;6310;220;7003;7079;9.59;0.58;234.59;6.33;693;63;2418.00;76
6314;63;628247505;6314;227;7003;7079;9.57;0.58;234.61;6.33;689;63;2419.00;76
6315;63;628247527;6315;233;7009;7085;9.48;0.58;234.59;6.33;694;63;2420.00;76
6318;63;628247553;6318;234;7010;7086;9.44;0.57;234.64;6.33;692;63;2421.00;76
6320;63;628247572;6320;239;7011;7086;9.43;0.57;234.65;6.34;691;63;2422.00;75
6323;63;628247589;6323;237;7011;7086;9.39;0.57;234.62;6.34;688;63;2423.00;75
6326;63;628247605;6326;236;7013;7090;9.43;0.57;234.62;6.33;687;63;2424.00;77
6328;63;628247620;6328;237;7013;7090;9.40;0.57;234.61;6.33;685;63;2425.00;77
6331;63;628247633;6331;244;7014;7090;9.35;0.57;234.66;6.34;683;63;2426.00;76
6333;63;628247646;6333;232;7015;7091;9.31;0.57;234.70;6.34;682;63;2427.00;76
6335;63;628247658;6335;226;7021;7095;9.26;0.56;234.73;6.34;686;63;2428.00;74
6341;63;628247670;6341;222;7021;7095;9.18;0.56;234.90;6.34;680;63;2429.00;74
6344;63;628247683;6344;217;7026;7101;9.14;0.56;234.92;6.34;682;63;2430.00;75
6348;63;628247695;6348;215;7027;7101;9.06;0.55;234.95;6.34;679;63;2431.00;74
6351;63;628247706;6351;216;7028;7101;9.04;0.55;235.01;6.34;677;63;2432.00;73
6354;63;628247718;6354;218;7028;7101;9.04;0.55;235.01;6.34;674;63;2433.00;73
6357;63;628247729;6357;222;7032;7105;9.06;0.55;235.02;6.34;675;63;2434.00;73
6359;63;628247741;6359;222;7033;7105;9.09;0.56;235.08;6.34;674;63;2435.00;72
6363;63;628247752;6363;210;7033;7105;9.14;0.56;235.06;6.34;670;63;2436.00;72
6363;63;628247770;6363;196;7035;7105;9.22;0.56;235.06;6.34;672;63;2437.00;70
6368;63;628247782;6368;193;7035;7106;9.27;0.57;235.15;6.34;667;63;2438.00;71
6370;63;628247794;6370;189;7037;7107;9.36;0.57;235.18;6.35;667;63;2439.00;70
6376;63;628247805;6376;182;7037;7107;9.33;0.57;235.22;6.35;661;63;2440.00;70
6377;63;628247822;6377;173;7038;7108;9.40;0.57;235.25;6.35;661;63;2441.00;70
6381;63;628247833;6381;165;7038;7108;9.48;0.58;235.19;6.35;657;63;2442.00;70
6384;63;628247845;6384;160;7038;7108;9.60;0.58;235.14;6.35;654;63;2443.00;70
6387;63;628247856;6387;155;7038;7108;9.62;0.58;235.17;6.35;651;63;2444.00;70
6392;63;628247872;6392;153;7039;7108;9.72;0.59;235.19;6.35;647;63;2445.00;69
6392;63;628247883;6392;148;7039;7108;9.83;0.60;235.19;6.35;647;63;2446.00;69
6396;63;628247893;6396;145;7039;7108;9.90;0.60;235.27;6.35;643;63;2447.00;69
6396;63;628247903;6396;157;7102;7235;10.12;0.62;235.27;6.30;706;63;2448.00;133
6402;63;628247923;6402;152;7106;7236;10.15;0.62;235.38;6.29;704;63;2449.00;130
6405;63;628247935;6405;147;7112;7236;10.35;0.64;235.42;6.29;707;63;2450.00;124
6410;63;628247946;6410;146;7115;7236;10.31;0.63;235.41;6.29;705;63;2451.00;121
6413;63;628247962;6413;144;7120;7236;10.47;0.64;235.44;6.29;707;63;2452.00;116
6415;63;628247976;6415;142;7120;7236;10.48;0.64;235.45;6.29;705;63;2453.00;116
6416;63;628247988;6416;148;7127;7236;10.48;0.64;235.47;6.30;711;63;2454.00;109
6420;63;628248009;6420;152;7130;7236;10.50;0.64;235.49;6.30;710;63;2455.00;106
6420;63;628248020;6420;151;7136;7237;10.48;0.64;235.49;6.30;716;63;2456.00;101
6421;63;628248030;6421;152;7139;7238;10.42;0.64;235.50;6.30;718;63;2457.00;99
6426;63;628248042;6426;159;7143;7238;10.31;0.63;235.48;6.31;717;63;2458.00;95
6427;63;628248052;6427;163;7145;7239;10.31;0.63;235.58;6.31;718;63;2459.00;94
6428;63;628248067;6428;166;7148;7239;10.24;0.63;235.56;6.41;720;63;2460.00;91
6430;63;628248078;6430;169;7153;7239;10.21;0.62;235.55;6.42;723;63;2461.00;86
6432;63;628248089;6432;180;7155;7239;10.23;0.63;235.54;6.42;723;63;2462.00;84
6434;63;628248099;6434;183;7159;7243;10.28;0.63;235.53;6.42;725;63;2463.00;84
6437;63;628248110;6437;186;7159;7243;10.30;0.63;235.47;6.42;722;63;2464.00;84
6438;63;628248126;6438;193;7161;7243;10.30;0.63;235.49;6.43;723;63;2465.00;82
6441;63;628248137;6441;192;7163;7246;10.38;0.63;235.46;6.42;722;63;2466.00;83
6441;63;628248150;6441;193;7166;7246;10.40;0.63;235.46;6.44;725;63;2467.00;80
6441;63;628248161;6441;196;7166;7246;10.43;0.64;235.46;6.44;725;63;2468.00;80
6441;63;628248171;6441;192;7172;7250;10.37;0.63;235.46;6.44;731;63;2469.00;78
6443;63;628248181;6443;195;7174;7251;10.33;0.63;235.42;6.44;731;63;2470.00;77
6443;63;628248192;6443;197;7174;7251;10.35;0.63;235.42;6.44;731;63;2471.00;77
6446;63;628248207;6446;202;7175;7255;10.36;0.63;235.40;6.44;729;63;2472.00;80
6449;63;628248218;6449;205;7177;7255;10.39;0.63;235.36;6.53;728;63;2473.00;78
6452;63;628248228;6452;203;7177;7255;10.37;0.63;235.31;6.53;725;63;2474.00;78
6456;63;628248238;6456;205;7179;7257;10.34;0.63;235.23;6.53;723;63;2475.00;78
6458;63;628248249;6458;206;7179;7257;10.35;0.63;235.19;6.53;721;63;2476.00;78
6460;63;628248259;6460;206;7183;7263;10.35;0.63;235.17;6.53;723;63;2477.00;80
6460;63;628248269;6460;209;7185;7263;10.32;0.63;235.17;6.62;725;63;2478.00;78
6462;63;628248278;6462;206;7185;7264;10.39;0.63;235.16;6.62;723;63;2479.00;79
6464;63;628248289;6464;205;7185;7264;10.38;0.63;235.13;6.62;721;63;2480.00;79
6467;63;628248299;6467;200;7186;7264;10.35;0.63;235.20;6.71;719;63;2481.00;78
6471;63;628248308;6471;195;7186;7264;10.31;0.63;235.16;6.71;715;63;2482.00;78
6475;63;628248324;6475;190;7186;7264;10.30;0.63;235.12;6.71;711;63;2483.00;78
6479;63;628248334;6479;191;7195;7276;10.25;0.62;235.08;6.71;716;63;2484.00;81
6480;63;628248345;6480;188;7199;7276;10.23;0.62;235.05;6.82;719;63;2485.00;77
6485;63;628248355;6485;190;7200;7276;10.16;0.62;235.18;6.82;715;63;2486.00;76
6488;63;628248366;6488;189;7200;7276;10.16;0.62;235.12;6.82;712;63;2487.00;76
6490;63;628248376;6490;191;7200;7276;10.14;0.61;235.11;6.82;710;63;2488.00;76
6492;63;628248386;6492;191;7200;7276;10.13;0.61;235.07;6.82;708;63;2489.00;76
6492;63;628248398;6492;194;7203;7280;10.13;0.61;235.07;6.82;711;63;2490.00;77
6493;63;628248408;6493;193;7204;7280;10.18;0.62;235.05;6.91;711;63;2491.00;76
6493;63;628248417;6493;194;7207;7284;10.21;0.62;235.05;6.91;714;63;2492.00;77
6493;63;628248427;6493;197;7209;7285;10.26;0.62;235.05;6.91;716;63;2493.00;76
6495;63;628248437;6495;201;7209;7285;10.21;0.62;235.04;6.91;714;63;2494.00;76
6496;63;628248447;6496;204;7209;7285;10.21;0.62;235.03;6.91;713;63;2495.00;76
6497;63;628248457;6497;211;7218;7298;10.23;0.62;235.04;6.90;721;63;2496.00;80
6502;63;628248467;6502;211;7219;7298;10.16;0.62;235.01;6.91;717;63;2497.00;79
6505;63;628248478;6505;209;7219;7298;10.11;0.62;234.97;6.91;714;63;2498.00;79
6506;63;628248487;6506;202;7220;7299;10.10;0.62;234.98;6.91;714;63;2499.00;79
6510;63;628248498;6510;195;7220;7300;10.03;0.61;234.93;6.91;710;63;2500.00;80
6514;63;628248513;6514;188;7220;7300;10.06;0.61;234.86;6.91;706;63;2501.00;80
6517;63;628248524;6517;181;7222;7303;10.15;0.62;234.87;6.91;705;63;2502.00;81
6519;63;628248535;6519;177;7224;7303;10.25;0.62;234.83;6.92;705;63;2503.00;79
6521;63;628248545;6521;174;7224;7303;10.31;0.62;234.80;6.92;703;63;2504.00;79
6521;63;628248557;6521;172;7224;7303;10.41;0.63;234.80;6.92;703;63;2505.00;79
6523;63;628248573;6523;168;7228;7309;10.58;0.64;234.80;6.92;705;63;2506.00;81
6524;63;628248584;6524;162;7228;7309;10.64;0.64;234.81;6.92;704;63;2507.00;81
6526;63;628248607;6526;161;7229;7309;10.66;0.64;234.80;6.92;703;63;2508.00;80
6526;63;628248618;6526;161;7231;7309;10.57;0.64;234.80;6.94;705;63;2509.00;78
6529;63;628248628;6529;162;7236;7313;10.50;0.63;234.79;6.97;707;63;2510.00;77
6530;63;628248639;6530;167;7238;7314;10.46;0.63;234.80;6.97;708;63;2511.00;76
6530;63;628248649;6530;173;7239;7314;10.39;0.63;234.80;6.98;709;63;2512.00;75
6531;63;628248661;6531;175;7240;7315;10.32;0.62;234.79;6.98;709;63;2513.00;75
6532;63;628248671;6532;181;7241;7315;10.26;0.62;234.76;6.98;709;63;2514.00;74
6532;63;628248680;6532;184;7244;7315;10.19;0.62;234.76;7.01;712;63;2515.00;71
6533;63;628248690;6533;188;7245;7315;10.09;0.61;234.77;7.03;712;63;2516.00;70
6534;63;628248699;6534;189;7249;7315;9.97;0.60;234.77;7.06;715;63;2517.00;66
6534;63;628248708;6534;192;7249;7315;9.92;0.60;234.77;7.06;715;63;2518.00;66
6534;63;628248718;6534;198;7250;7315;9.89;0.60;234.77;7.07;716;63;2519.00;65
6534;63;628248729;6534;207;7307;7440;9.90;0.61;234.77;7.04;773;63;2520.00;133
6538;63;628248748;6538;204;7311;7441;9.78;0.60;234.74;7.05;773;63;2521.00;130
6541;63;628248757;6541;203;7320;7441;9.69;0.60;234.74;7.04;779;63;2522.00;121
6542;63;628248767;6542;211;7327;7441;9.61;0.59;234.78;7.05;785;63;2523.00;114
6544;63;628248777;6544;211;7332;7441;9.56;0.59;234.80;7.05;788;63;2524.00;109
6548;63;628248786;6548;216;7336;7441;9.40;0.58;234.84;7.06;788;63;2525.00;105
6550;63;628248797;6550;216;7343;7441;9.25;0.57;234.92;7.07;793;63;2526.00;98
6551;63;628248806;6551;220;7346;7441;9.10;0.56;234.91;7.07;795;63;2527.00;95
6554;63;628248816;6554;220;7352;7442;8.99;0.55;234.90;7.08;798;63;2528.00;90
6557;63;628248826;6557;217;7357;7443;8.95;0.55;234.95;7.08;800;63;2529.00;86
6559;63;628248837;6559;216;7362;7443;8.81;0.54;234.96;7.09;803;63;2530.00;81
6561;63;628248847;6561;215;7366;7447;8.69;0.53;234.99;7.09;805;63;2531.00;81
6562;63;628248863;6562;220;7368;7447;8.59;0.53;234.95;7.10;806;63;2532.00;79
6565;63;628248873;6565;219;7370;7447;8.50;0.52;234.99;7.10;805;63;2533.00;77
6567;63;628248884;6567;221;7371;7447;8.50;0.52;234.97;7.10;804;63;2534.00;76
6571;63;628248894;6571;223;7378;7453;8.47;0.52;235.02;7.11;807;63;2535.00;75
6572;63;628248906;6572;229;7379;7453;8.40;0.51;235.02;7.11;807;63;2536.00;74
6573;63;628248916;6573;239;7382;7455;8.45;0.52;235.02;7.12;809;63;2537.00;73
6576;63;628248932;6576;242;7387;7458;8.47;0.52;234.99;7.13;811;63;2538.00;71
6579;63;628248943;6579;249;7387;7458;8.45;0.52;235.04;7.13;808;63;2539.00;71
6583;63;628248953;6583;251;7388;7458;8.42;0.52;235.07;7.13;805;63;2540.00;70
6585;63;628248963;6585;248;7389;7459;8.44;0.52;235.04;7.14;804;63;2541.00;70
6588;63;628248975;6588;258;7391;7460;8.41;0.52;235.02;7.14;803;63;2542.00;69
6592;63;628248990;6592;265;7393;7460;8.36;0.51;235.00;7.15;801;63;2543.00;67
6596;63;628249001;6596;269;7404;7473;8.28;0.51;234.99;7.14;808;63;2544.00;69
6601;63;628249012;6601;274;7405;7473;8.23;0.50;235.03;7.14;804;63;2545.00;68
6604;63;628249023;6604;269;7407;7473;8.17;0.50;235.06;7.15;803;63;2546.00;66
6608;63;628249033;6608;273;7408;7474;8.10;0.49;235.04;7.14;800;63;2547.00;66
6610;63;628249044;6610;271;7410;7474;7.99;0.49;235.09;7.15;800;63;2548.00;64
6619;63;628249054;6619;275;7413;7478;7.82;0.48;235.17;7.15;794;63;2549.00;65
6622;63;628249067;6622;266;7417;7481;7.75;0.47;235.16;7.15;795;63;2550.00;64
6627;63;628249078;6627;264;7421;7485;7.68;0.47;235.15;7.14;794;63;2551.00;64
6631;63;628249088;6631;259;7421;7485;7.64;0.47;235.12;7.14;790;63;2552.00;64
6632;63;628249099;6632;249;7423;7485;7.69;0.47;235.13;7.15;791;63;2553.00;62
6638;63;628249108;6638;250;7423;7485;7.75;0.47;235.13;7.15;785;63;2554.00;62
6641;63;628249119;6641;246;7424;7485;7.77;0.48;235.18;7.15;783;63;2555.00;61
6642;63;628249129;6642;246;7436;7497;7.89;0.48;235.20;7.14;794;63;2556.00;61
6648;63;628249141;6648;242;7436;7497;7.93;0.49;235.35;7.14;788;63;2557.00;61
6651;63;628249151;6651;231;7436;7497;8.00;0.49;235.46;7.14;785;63;2558.00;61
6654;63;628249162;6654;221;7436;7497;8.16;0.50;235.45;7.14;782;63;2559.00;61
6659;63;628249172;6659;221;7436;7497;8.24;0.51;235.51;7.14;777;63;2560.00;61
6661;63;628249183;6661;221;7436;7497;8.35;0.51;235.58;7.14;775;63;2561.00;61
6664;63;628249194;6664;225;7436;7498;8.46;0.52;235.66;7.14;772;63;2562.00;62
6669;63;628249204;6669;222;7436;7498;8.48;0.52;235.68;7.14;767;63;2563.00;62
6675;63;628249215;6675;220;7440;7504;8.58;0.53;235.70;7.14;765;63;2564.00;64
6679;63;628249227;6679;218;7443;7506;8.76;0.54;235.69;7.13;764;63;2565.00;63
6683;63;628249237;6683;219;7443;7506;8.86;0.55;235.71;7.13;760;63;2566.00;63
6689;63;628249248;6689;221;7443;7506;8.93;0.55;235.76;7.13;754;63;2567.00;63
6693;63;628249259;6693;214;7446;7510;9.07;0.56;235.74;7.13;753;63;2568.00;64
6697;63;628249270;6697;212;7446;7510;9.05;0.56;235.80;7.13;749;63;2569.00;64
6702;63;628249281;6702;207;7446;7510;9.07;0.56;235.86;7.13;744;63;2570.00;64
6706;63;628249292;6706;208;7447;7511;9.08;0.56;235.91;7.13;741;63;2571.00;64
6709;63;628249302;6709;206;7450;7515;9.10;0.56;235.92;7.13;741;63;2572.00;65
6713;63;628249319;6713;206;7450;7515;9.15;0.57;235.89;7.13;737;63;2573.00;65
6718;63;628249330;6718;208;7452;7518;9.16;0.57;235.93;7.13;734;63;2574.00;66
6722;63;628249343;6722;203;7452;7518;9.29;0.58;235.98;7.13;730;63;2575.00;66
6728;63;628249354;6728;200;7453;7518;9.41;0.58;236.02;7.12;725;63;2576.00;65
6735;63;628249364;6735;198;7453;7518;9.44;0.58;236.14;7.12;718;63;2577.00;65
6740;63;628249375;6740;195;7456;7522;9.50;0.58;236.11;7.12;716;63;2578.00;66
6745;63;628249386;6745;197;7456;7522;9.43;0.58;236.23;7.12;711;63;2579.00;66
6751;63;628249398;6751;193;7457;7522;9.35;0.57;236.31;7.12;706;63;2580.00;65
6756;63;628249409;6756;195;7457;7522;9.30;0.57;236.34;7.12;701;63;2581.00;65
6761;63;628249420;6761;191;7457;7523;9.33;0.57;236.31;7.12;696;63;2582.00;66
6766;63;628249430;6766;194;7459;7524;9.26;0.57;236.31;7.22;693;63;2583.00;65
6771;63;628249442;6771;194;7459;7524;9.22;0.56;236.29;7.22;688;63;2584.00;65
6776;63;628249453;6776;198;7460;7525;9.20;0.56;236.41;7.22;684;63;2585.00;65
6779;63;628249464;6779;200;7460;7525;9.16;0.56;236.47;7.22;681;63;2586.00;65
6782;63;628249474;6782;204;7460;7525;9.18;0.56;236.51;7.22;678;63;2587.00;65
6787;63;628249485;6787;205;7460;7525;9.10;0.56;236.50;7.22;673;63;2588.00;65
6791;63;628249494;6791;206;7460;7525;8.96;0.55;236.57;7.22;669;63;2589.00;65
6793;63;628249504;6793;213;7460;7525;8.86;0.54;236.62;7.22;667;63;2590.00;65
6796;63;628249515;6796;219;7460;7525;8.81;0.54;236.67;7.22;664;63;2591.00;65
6800;63;628249528;6800;238;7527;7652;8.87;0.55;236.67;7.16;727;63;2592.00;125
6804;63;628249561;6804;233;7530;7653;8.81;0.55;236.66;7.16;726;63;2593.00;123
6808;63;628249578;6808;232;7538;7653;8.81;0.54;236.61;7.15;730;63;2594.00;115
6813;63;628249594;6813;238;7542;7653;8.76;0.54;236.64;7.15;729;63;2595.00;111
6815;63;628249611;6815;248;7544;7653;8.77;0.54;236.66;7.15;729;63;2596.00;109
6819;63;628249626;6819;240;7546;7653;8.77;0.54;236.70;7.15;727;63;2597.00;107
6822;63;628249640;6822;236;7550;7653;8.82;0.54;236.71;7.15;728;63;2598.00;103
6825;63;628249653;6825;232;7553;7653;8.82;0.54;236.72;7.15;728;63;2599.00;100
6828;63;628249667;6828;233;7559;7654;8.81;0.54;236.71;7.15;731;63;2600.00;95
6831;63;628249692;6831;232;7561;7655;8.77;0.54;236.74;7.15;730;63;2601.00;94
6832;63;628249704;6832;236;7565;7655;8.79;0.54;236.75;7.15;733;63;2602.00;90
6835;63;628249716;6835;236;7566;7656;8.74;0.54;236.71;7.15;731;63;2603.00;90
6836;63;628249728;6836;241;7570;7656;8.74;0.54;236.79;7.15;734;63;2604.00;86
6839;63;628249740;6839;243;7572;7656;8.75;0.54;236.86;7.16;733;63;2605.00;84
6844;63;628249751;6844;232;7574;7656;8.76;0.54;236.87;7.16;730;63;2606.00;82
6845;63;628249763;6845;217;7577;7660;8.84;0.54;236.89;7.16;732;63;2607.00;83
6848;63;628249776;6848;212;7579;7660;8.93;0.55;236.98;7.16;731;63;2608.00;81
6850;63;628249788;6850;201;7579;7660;9.01;0.55;236.98;7.16;729;63;2609.00;81
6852;63;628249812;6852;199;7584;7666;9.10;0.56;237.02;7.16;732;63;2610.00;82
6854;63;628249833;6854;187;7584;7666;9.16;0.56;237.03;7.16;730;63;2611.00;82
6858;63;628249846;6858;192;7585;7666;9.22;0.56;237.01;7.16;727;63;2612.00;81
6860;63;628249857;6860;192;7590;7670;9.31;0.57;237.01;7.26;730;63;2613.00;80
6861;63;628249870;6861;185;7592;7671;9.50;0.58;237.00;7.26;731;63;2614.00;79
6863;63;628249881;6863;185;7592;7671;9.60;0.59;236.97;7.26;729;63;2615.00;79
6866;63;628249893;6866;183;7596;7675;9.64;0.59;236.97;7.26;730;63;2616.00;79
6867;63;628249905;6867;181;7596;7675;9.63;0.59;236.98;7.26;729;63;2617.00;79
6867;63;628249917;6867;177;7597;7675;9.70;0.59;236.98;7.26;730;63;2618.00;78
6870;63;628249927;6870;171;7599;7676;9.74;0.59;237.01;7.26;729;63;2619.00;77
6871;63;628249939;6871;171;7599;7676;9.72;0.59;236.99;7.26;728;63;2620.00;77
6874;63;628249950;6874;175;7603;7682;9.74;0.59;236.97;7.25;729;63;2621.00;79
6877;63;628249962;6877;178;7603;7682;9.70;0.59;236.95;7.25;726;63;2622.00;79
6879;63;628249981;6879;182;7604;7683;9.66;0.59;236.98;7.25;725;63;2623.00;79
6881;63;628249992;6881;186;7604;7683;9.70;0.59;236.94;7.25;723;63;2624.00;79
6885;63;628250002;6885;186;7604;7683;9.83;0.60;236.94;7.25;719;63;2625.00;79
6889;63;628250013;6889;190;7604;7683;9.87;0.60;236.91;7.25;715;63;2626.00;79
6889;63;628250025;6889;192;7604;7683;9.91;0.60;236.91;7.25;715;63;2627.00;79
6890;63;628250036;6890;199;7613;7695;9.98;0.61;236.91;7.25;723;63;2628.00;82
6893;63;628250047;6893;198;7614;7695;10.05;0.61;236.87;7.24;721;63;2629.00;81
6896;63;628250059;6896;203;7615;7695;10.12;0.62;236.83;7.24;719;63;2630.00;80
6901;63;628250070;6901;206;7615;7695;10.14;0.62;236.82;7.24;714;63;2631.00;80
6903;63;628250080;6903;204;7615;7695;10.16;0.62;236.90;7.24;712;63;2632.00;80
6905;63;628250092;6905;206;7615;7695;10.25;0.63;236.95;7.24;710;63;2633.00;80
6909;63;628250103;6909;208;7618;7699;10.25;0.62;236.95;7.24;709;63;2634.00;81
6910;63;628250113;6910;206;7618;7699;10.34;0.63;236.94;7.24;708;63;2635.00;81
6915;63;628250123;6915;203;7621;7703;10.40;0.63;236.83;7.24;706;63;2636.00;82
6917;63;628250135;6917;204;7623;7704;10.42;0.63;236.82;7.24;706;63;2637.00;81
6918;63;628250154;6918;209;7623;7704;10.42;0.63;236.80;7.24;705;63;2638.00;81
6922;63;628250165;6922;205;7623;7704;10.42;0.63;236.85;7.24;701;63;2639.00;81
6924;63;628250178;6924;209;7642;7733;10.29;0.63;236.81;7.22;718;63;2640.00;91
6925;63;628250191;6925;206;7644;7733;10.27;0.62;236.78;7.22;719;63;2641.00;89
6927;63;628250201;6927;210;7646;7733;10.29;0.63;236.74;7.22;719;63;2642.00;87
6928;63;628250219;6928;214;7648;7734;10.39;0.63;236.75;7.21;720;63;2643.00;86
6928;63;628250228;6928;217;7649;7735;10.45;0.63;236.75;7.21;721;63;2644.00;86
6930;63;628250238;6930;219;7649;7735;10.43;0.63;236.71;7.21;719;63;2645.00;86
6931;63;628250258;6931;221;7652;7738;10.42;0.63;236.70;7.21;721;63;2646.00;86
6933;63;628250267;6933;224;7652;7738;10.30;0.63;236.68;7.21;719;63;2647.00;86
6934;63;628250277;6934;226;7652;7738;10.20;0.62;236.68;7.21;718;63;2648.00;86
6936;63;628250287;6936;223;7652;7738;10.22;0.62;236.68;7.21;716;63;2649.00;86
6938;63;628250296;6938;227;7656;7744;10.23;0.62;236.67;7.21;718;63;2650.00;88
6940;63;628250306;6940;214;7656;7744;10.21;0.62;236.64;7.21;716;63;2651.00;88
6941;63;628250317;6941;200;7657;7744;10.31;0.63;236.62;7.21;716;63;2652.00;87
6941;63;628250327;6941;190;7657;7744;10.31;0.63;236.62;7.21;716;63;2653.00;87
6945;63;628250336;6945;176;7661;7748;10.34;0.63;236.60;7.22;716;63;2654.00;87
6946;63;628250348;6946;163;7664;7750;10.41;0.63;236.57;7.23;718;63;2655.00;86
6948;64;628250359;6948;152;7664;7750;10.53;0.64;236.68;7.23;716;64;2656.00;86
6952;64;628250385;6952;144;7665;7751;10.70;0.65;236.65;7.23;713;64;2657.00;86
6954;64;628250396;6954;132;7666;7751;10.85;0.66;236.67;7.24;712;64;2658.00;85
6958;64;628250407;6958;129;7666;7751;10.97;0.67;236.61;7.24;708;64;2659.00;85
6959;64;628250425;6959;120;7666;7751;11.09;0.67;236.59;7.24;707;64;2660.00;85
6962;64;628250435;6962;120;7666;7751;11.19;0.68;236.56;7.24;704;64;2661.00;85
6968;64;628250445;6968;120;7666;7751;11.39;0.69;236.47;7.24;698;64;2662.00;85
6970;64;628250456;6970;119;7666;7751;11.49;0.70;236.55;7.24;696;64;2663.00;85
6973;64;628250467;6973;120;7704;7821;11.56;0.70;236.49;7.21;731;64;2664.00;117
6974;64;628250483;6974;114;7706;7822;11.59;0.70;236.49;7.20;732;64;2665.00;116
6978;64;628250503;6978;115;7714;7822;11.68;0.71;236.40;7.20;736;64;2666.00;108
6978;64;628250526;6978;114;7716;7822;11.67;0.71;236.40;7.20;738;64;2667.00;106
6978;64;628250538;6978;116;7721;7822;11.71;0.71;236.40;7.20;743;64;2668.00;101
6979;64;628250548;6979;118;7724;7822;11.74;0.71;236.38;7.19;745;64;2669.00;98
6980;64;628250561;6980;121;7728;7822;11.78;0.72;236.35;7.19;748;64;2670.00;94
6982;64;628250572;6982;120;7729;7822;11.68;0.71;236.31;7.19;747;64;2671.00;93
6984;64;628250582;6984;120;7731;7823;11.60;0.70;236.34;7.19;747;64;2672.00;92
6987;64;628250593;6987;124;7734;7824;11.52;0.70;236.40;7.19;747;64;2673.00;90
6989;64;628250609;6989;126;7734;7824;11.48;0.70;236.36;7.19;745;64;2674.00;90
6990;64;628250624;6990;133;7737;7828;11.31;0.69;236.33;7.19;747;64;2675.00;91
6992;64;628250635;6992;130;7737;7828;11.23;0.68;236.31;7.19;745;64;2676.00;91
6994;64;628250646;6994;133;7738;7828;11.11;0.68;236.29;7.20;744;64;2677.00;90
6997;64;628250659;6997;144;7738;7828;10.96;0.67;236.48;7.20;741;64;2678.00;90
6999;64;628250671;6999;151;7742;7834;10.88;0.66;236.48;7.20;743;64;2679.00;92
7001;64;628250682;7001;160;7744;7834;10.89;0.66;236.55;7.21;743;64;2680.00;90
7003;64;628250693;7003;162;7745;7834;10.80;0.66;236.54;7.23;742;64;2681.00;89
7007;64;628250703;7007;168;7747;7837;10.68;0.65;236.54;7.22;740;64;2682.00;90
7010;64;628250714;7010;169;7748;7837;10.63;0.65;236.53;7.24;738;64;2683.00;89
7014;64;628250725;7014;175;7749;7837;10.55;0.64;236.50;7.24;735;64;2684.00;88
7015;64;628250735;7015;179;7751;7838;10.45;0.63;236.49;7.26;736;64;2685.00;87
7017;64;628250745;7017;181;7753;7839;10.36;0.63;236.52;7.27;736;64;2686.00;86
7022;64;628250756;7022;181;7754;7839;10.30;0.62;236.47;7.28;732;64;2687.00;85
7024;64;628250766;7024;181;7765;7852;10.22;0.62;236.49;7.27;741;64;2688.00;87
7028;64;628250777;7028;197;7767;7852;10.16;0.62;236.52;7.29;739;64;2689.00;85
7030;64;628250787;7030;202;7767;7852;10.07;0.61;236.55;7.29;737;64;2690.00;85
7033;64;628250797;7033;205;7770;7853;9.94;0.60;236.58;7.31;737;64;2691.00;83
7035;64;628250808;7035;209;7770;7853;9.84;0.60;236.61;7.31;735;64;2692.00;83
7036;64;628250818;7036;218;7775;7857;9.79;0.59;236.59;7.32;739;64;2693.00;82
7039;64;628250829;7039;219;7775;7857;9.64;0.59;236.64;7.32;736;64;2694.00;82
7041;64;628250839;7041;214;7781;7861;9.46;0.57;236.62;7.34;740;64;2695.00;80
7044;64;628250850;7044;219;7782;7861;9.33;0.57;236.73;7.34;738;64;2696.00;79
7045;64;628250859;7045;218;7782;7861;9.28;0.56;236.72;7.34;737;64;2697.00;79
7047;64;628250869;7047;224;7783;7861;9.22;0.56;236.74;7.35;736;64;2698.00;78
7049;64;628250880;7049;219;7784;7861;9.11;0.55;236.72;7.35;735;64;2699.00;77
7052;64;628250892;7052;219;7806;7910;9.09;0.56;236.72;7.34;754;64;2700.00;104
7053;64;628250911;7053;220;7807;7910;9.05;0.55;236.76;7.34;754;64;2701.00;103
7055;64;628250921;7055;222;7811;7910;9.07;0.55;236.76;7.35;756;64;2702.00;99
7057;64;628250931;7057;224;7814;7910;9.03;0.55;236.74;7.35;757;64;2703.00;96
7058;64;628250941;7058;224;7817;7910;8.90;0.54;236.74;7.36;759;64;2704.00;93
7060;64;628250951;7060;223;7819;7910;8.80;0.54;236.72;7.36;759;64;2705.00;91
7064;64;628250960;7064;223;7820;7911;8.81;0.54;236.74;7.36;756;64;2706.00;91
7066;64;628250971;7066;229;7823;7911;8.72;0.54;236.77;7.37;757;64;2707.00;88
7072;64;628250986;7072;226;7828;7917;8.67;0.53;236.77;7.36;756;64;2708.00;89
7075;64;628250997;7075;228;7829;7918;8.61;0.53;236.80;7.36;754;64;2709.00;89
7077;64;628251008;7077;229;7830;7918;8.58;0.53;236.77;7.37;753;64;2710.00;88
7082;64;628251020;7082;232;7830;7918;8.53;0.52;236.74;7.37;748;64;2711.00;88
7088;64;628251030;7088;236;7835;7922;8.44;0.52;236.73;7.40;747;64;2712.00;87
7092;64;628251040;7092;246;7838;7922;8.40;0.51;236.74;7.40;746;64;2713.00;84
7098;64;628251049;7098;246;7840;7922;8.34;0.51;236.79;7.40;742;64;2714.00;82
7102;64;628251059;7102;247;7841;7923;8.31;0.51;236.79;7.40;739;64;2715.00;82
7106;64;628251068;7106;253;7847;7927;8.27;0.51;236.84;7.42;741;64;2716.00;80
7112;64;628251077;7112;258;7847;7927;8.23;0.50;236.77;7.42;735;64;2717.00;80
7117;64;628251087;7117;258;7849;7930;8.21;0.50;236.78;7.42;732;64;2718.00;81
7124;64;628251096;7124;264;7851;7930;8.07;0.49;236.77;7.42;727;64;2719.00;79
7128;64;628251106;7128;258;7852;7930;7.92;0.48;236.79;7.42;724;64;2720.00;78
7129;64;628251115;7129;250;7852;7930;7.87;0.48;236.81;7.42;723;64;2721.00;78
7132;64;628251124;7132;240;7857;7934;7.88;0.48;236.89;7.43;725;64;2722.00;77
7137;64;628251134;7137;235;7857;7934;7.86;0.48;236.95;7.43;720;64;2723.00;77
7139;64;628251143;7139;233;7858;7934;7.85;0.48;236.94;7.44;719;64;2724.00;76
7144;64;628251151;7144;232;7859;7934;7.78;0.48;237.02;7.44;715;64;2725.00;75
7147;64;628251160;7147;232;7860;7935;7.85;0.48;237.04;7.44;713;64;2726.00;75
7149;64;628251170;7149;233;7864;7936;7.92;0.48;237.03;7.44;715;64;2727.00;72
7153;64;628251179;7153;219;7864;7936;8.01;0.49;237.08;7.44;711;64;2728.00;72
7158;64;628251188;7158;223;7865;7937;8.14;0.49;237.10;7.44;707;64;2729.00;72
7160;64;628251199;7160;219;7866;7937;8.16;0.50;237.15;7.44;706;64;2730.00;71
7162;64;628251207;7162;216;7867;7937;8.24;0.50;237.19;7.44;705;64;2731.00;70
7164;64;628251216;7164;215;7868;7937;8.31;0.51;237.23;7.45;704;64;2732.00;69
7170;64;628251225;7170;219;7870;7937;8.27;0.50;237.30;7.45;700;64;2733.00;67
7174;64;628251235;7174;226;7871;7937;8.32;0.51;237.44;7.45;697;64;2734.00;66
7177;64;628251244;7177;227;7871;7937;8.34;0.51;237.44;7.45;694;64;2735.00;66
7182;64;628251253;7182;237;7937;8064;8.49;0.53;237.46;7.39;755;64;2736.00;127
7186;64;628251272;7186;226;7940;8065;8.54;0.53;237.46;7.39;754;64;2737.00;125
7191;64;628251282;7191;226;7946;8065;8.49;0.53;237.48;7.39;755;64;2738.00;119
7196;64;628251291;7196;220;7950;8065;8.44;0.53;237.51;7.39;754;64;2739.00;115
7199;64;628251301;7199;221;7954;8065;8.44;0.53;237.50;7.39;755;64;2740.00;111
7203;64;628251310;7203;226;7955;8065;8.40;0.52;237.47;7.39;752;64;2741.00;110
7207;64;628251319;7207;227;7959;8065;8.44;0.52;237.47;7.39;752;64;2742.00;106
7210;64;628251341;7210;222;7960;8065;8.43;0.52;237.49;7.39;750;64;2743.00;105
7214;64;628251350;7214;220;7965;8066;8.39;0.52;237.55;7.39;751;64;2744.00;101
7220;64;628251360;7220;217;7968;8068;8.33;0.51;237.55;7.39;748;64;2745.00;100
7223;64;628251370;7223;223;7972;8068;8.38;0.52;237.58;7.39;749;64;2746.00;96
7226;64;628251380;7226;228;7977;8069;8.39;0.52;237.65;7.39;751;64;2747.00;92
7230;64;628251390;7230;228;7981;8069;8.40;0.52;237.67;7.39;751;64;2748.00;88
7234;64;628251400;7234;229;7983;8069;8.38;0.52;237.71;7.40;749;64;2749.00;86
7239;64;628251410;7239;226;7986;8069;8.41;0.52;237.79;7.40;747;64;2750.00;83
7245;64;628251420;7245;230;7988;8073;8.42;0.52;237.81;7.40;743;64;2751.00;85
7249;65;628251431;7249;233;7992;8073;8.43;0.52;237.81;7.40;743;65;2752.00;81
7253;65;628251452;7253;240;7994;8073;8.51;0.53;237.82;7.40;741;65;2753.00;79
7258;65;628251462;7258;239;7997;8076;8.50;0.53;237.91;7.40;739;65;2754.00;79
7262;65;628251479;7262;239;7999;8076;8.51;0.53;237.86;7.40;737;65;2755.00;77
7266;65;628251489;7266;248;8000;8076;8.55;0.53;237.90;7.40;734;65;2756.00;76
7270;65;628251499;7270;255;8005;8080;8.53;0.53;237.92;7.40;735;65;2757.00;75
7275;65;628251510;7275;254;8006;8081;8.53;0.52;237.91;7.40;731;65;2758.00;75
7279;66;628251524;7279;261;8006;8081;8.49;0.52;237.92;7.40;727;66;2759.00;75
7285;66;628251567;7285;269;8010;8086;8.39;0.51;237.95;7.40;725;66;2760.00;76
7287;66;628251593;7287;274;8010;8086;8.30;0.51;237.94;7.40;723;66;2761.00;76
7292;66;628251609;7292;281;8010;8086;8.21;0.50;237.93;7.40;718;66;2762.00;76
7294;66;628251624;7294;291;8011;8087;8.15;0.50;237.94;7.39;717;66;2763.00;76
7296;66;628251637;7296;294;8011;8087;8.14;0.50;237.94;7.39;715;66;2764.00;76
7298;66;628251648;7298;299;8015;8093;8.09;0.49;237.96;7.39;717;66;2765.00;78
7299;66;628251666;7299;301;8015;8093;8.05;0.49;237.96;7.39;716;66;2766.00;78
7302;66;628251677;7302;290;8016;8094;8.01;0.49;237.97;7.39;714;66;2767.00;78
7303;66;628251689;7303;286;8016;8094;7.94;0.49;237.98;7.39;713;66;2768.00;78
7305;66;628251700;7305;288;8016;8094;7.86;0.48;237.99;7.39;711;66;2769.00;78
7310;66;628251710;7310;288;8016;8094;7.76;0.47;238.00;7.39;706;66;2770.00;78
7311;66;628251721;7311;294;8016;8094;7.74;0.47;238.00;7.39;705;66;2771.00;78
7313;66;628251732;7313;292;8025;8106;7.83;0.48;238.00;7.38;712;66;2772.00;81
7314;66;628251744;7314;289;8025;8106;7.83;0.48;237.99;7.38;711;66;2773.00;81
7317;66;628251755;7317;289;8027;8106;7.96;0.49;237.95;7.38;710;66;2774.00;79
7318;66;628251765;7318;286;8027;8106;8.02;0.49;238.01;7.38;709;66;2775.00;79
7321;66;628251775;7321;265;8027;8106;8.13;0.50;237.97;7.38;706;66;2776.00;79
7323;66;628251786;7323;249;8027;8106;8.23;0.50;237.97;7.38;704;66;2777.00;79
7326;66;628251807;7326;236;8030;8110;8.35;0.51;237.95;7.38;704;66;2778.00;80
7328;66;628251818;7328;227;8030;8110;8.51;0.52;237.99;7.38;702;66;2779.00;80
7332;66;628251829;7332;223;8033;8114;8.61;0.52;237.92;7.38;701;66;2780.00;81
7334;66;628251841;7334;215;8035;8115;8.73;0.53;238.02;7.37;701;66;2781.00;80
7337;66;628251853;7337;211;8035;8115;8.74;0.53;238.00;7.37;698;66;2782.00;80
7338;66;628251863;7338;210;8035;8115;8.80;0.54;237.98;7.37;697;66;2783.00;80
7341;66;628251874;7341;211;8046;8128;8.88;0.54;237.94;7.36;705;66;2784.00;82
7346;66;628251886;7346;212;8046;8128;8.88;0.54;237.86;7.36;700;66;2785.00;82
7347;66;628251897;7347;213;8046;8128;8.94;0.54;237.85;7.36;699;66;2786.00;82
7348;66;628251907;7348;217;8047;8129;8.98;0.55;237.84;7.36;699;66;2787.00;82
7348;66;628251918;7348;219;8047;8130;9.00;0.55;237.84;7.36;699;66;2788.00;83
7349;66;628251929;7349;218;8047;8130;8.96;0.55;237.84;7.36;698;66;2789.00;83
7350;66;628251940;7350;217;8050;8136;8.98;0.55;237.85;7.36;700;66;2790.00;86
7352;66;628251951;7352;219;8051;8136;8.97;0.55;237.82;7.36;699;66;2791.00;85
7353;66;628251960;7353;223;8051;8136;8.96;0.54;237.82;7.36;698;66;2792.00;85
7355;66;628251971;7355;225;8052;8136;8.96;0.54;237.83;7.36;697;66;2793.00;84
7359;66;628251982;7359;230;8055;8142;8.88;0.54;237.80;7.36;696;66;2794.00;87
7360;66;628251993;7360;226;8056;8142;8.86;0.54;237.78;7.36;696;66;2795.00;86
7362;66;628252002;7362;226;8056;8142;8.86;0.54;237.78;7.36;694;66;2796.00;86
7364;66;628252012;7364;233;8057;8142;8.87;0.54;237.78;7.36;693;66;2797.00;85
7366;66;628252021;7366;237;8060;8146;8.87;0.54;237.77;7.35;694;66;2798.00;86
7367;66;628252031;7367;239;8062;8147;8.99;0.55;237.74;7.35;695;66;2799.00;85
7371;66;628252041;7371;242;8062;8147;9.00;0.55;237.71;7.35;691;66;2800.00;85
7373;66;628252056;7373;244;8063;8148;9.08;0.55;237.69;7.35;690;66;2801.00;85
7375;66;628252066;7375;243;8063;8148;9.19;0.56;237.69;7.35;688;66;2802.00;85
7376;66;628252076;7376;234;8063;8148;9.24;0.56;237.68;7.35;687;66;2803.00;85
7376;66;628252085;7376;219;8064;8148;9.36;0.57;237.68;7.48;688;66;2804.00;84
7376;66;628252096;7376;207;8064;8148;9.49;0.58;237.68;7.48;688;66;2805.00;84
7378;66;628252105;7378;195;8064;8148;9.62;0.58;237.68;7.48;686;66;2806.00;84
7380;66;628252115;7380;187;8064;8148;9.70;0.59;237.67;7.48;684;66;2807.00;84
7380;67;628252130;7380;196;8104;8218;9.69;0.59;237.67;7.44;724;67;2808.00;114
7381;67;628252158;7381;179;8104;8219;9.88;0.60;237.65;7.44;723;67;2809.00;115
7383;67;628252169;7383;166;8109;8219;10.13;0.62;237.62;7.44;726;67;2810.00;110
7385;67;628252179;7385;161;8113;8219;10.36;0.63;237.62;7.43;728;67;2811.00;106
7385;67;628252190;7385;157;8116;8219;10.51;0.64;237.62;7.43;731;67;2812.00;103
7385;67;628252200;7385;153;8120;8219;10.70;0.65;237.62;7.43;735;67;2813.00;99
7385;67;628252212;7385;154;8124;8219;10.83;0.66;237.62;7.43;739;67;2814.00;95
7386;67;628252230;7386;153;8126;8219;10.96;0.67;237.62;7.43;740;67;2815.00;93
7387;67;628252247;7387;155;8130;8220;11.05;0.67;237.61;7.43;743;67;2816.00;90
7390;67;628252258;7390;156;8131;8221;11.08;0.67;237.59;7.43;741;67;2817.00;90
7391;67;628252270;7391;153;8133;8221;11.10;0.68;237.58;7.55;742;67;2818.00;88
7393;67;628252281;7393;143;8136;8225;11.01;0.67;237.57;7.55;743;67;2819.00;89
7394;67;628252300;7394;147;8136;8225;11.01;0.67;237.57;7.55;742;67;2820.00;89
7396;67;628252310;7396;144;8136;8225;10.99;0.67;237.55;7.55;740;67;2821.00;89
7398;67;628252320;7398;140;8136;8225;11.03;0.67;237.56;7.55;738;67;2822.00;89
7402;67;628252331;7402;135;8140;8231;11.01;0.67;237.52;7.67;738;67;2823.00;91
7405;67;628252343;7405;130;8141;8231;11.03;0.67;237.54;7.67;736;67;2824.00;90
7411;67;628252354;7411;123;8143;8231;11.02;0.67;237.58;7.69;732;67;2825.00;88
7413;67;628252366;7413;122;8146;8234;11.03;0.67;237.57;7.82;733;67;2826.00;88
7417;67;628252378;7417;118;8146;8234;11.05;0.67;237.59;7.82;729;67;2827.00;88
7421;67;628252388;7421;115;8147;8234;11.09;0.68;237.55;7.82;726;67;2828.00;87
7423;67;628252398;7423;114;8148;8235;11.19;0.68;237.53;7.94;725;67;2829.00;87
7432;67;628252410;7432;111;8149;8236;11.26;0.68;237.50;7.94;717;67;2830.00;87
7433;67;628252421;7433;113;8149;8236;11.42;0.69;237.50;7.94;716;67;2831.00;87
7436;67;628252432;7436;111;8160;8249;11.40;0.69;237.53;8.06;724;67;2832.00;89
7438;67;628252443;7438;111;8160;8249;11.48;0.70;237.55;8.06;722;67;2833.00;89
7440;67;628252454;7440;114;8160;8249;11.55;0.70;237.56;8.06;720;67;2834.00;89
7442;67;628252465;7442;111;8162;8251;11.53;0.70;237.61;8.05;720;67;2835.00;89
7446;67;628252484;7446;117;8162;8251;11.50;0.70;237.54;8.05;716;67;2836.00;89
7449;67;628252495;7449;116;8165;8255;11.55;0.70;237.64;8.05;716;67;2837.00;90
7451;67;628252507;7451;123;8167;8255;11.66;0.71;237.64;8.05;716;67;2838.00;88
7453;67;628252519;7453;126;8170;8259;11.73;0.71;237.66;8.05;717;67;2839.00;89
7455;67;628252531;7455;132;8171;8259;11.76;0.71;237.71;8.05;716;67;2840.00;88
7457;67;628252542;7457;131;8171;8259;11.84;0.72;237.70;8.05;714;67;2841.00;88
7460;67;628252552;7460;138;8171;8259;11.84;0.72;237.73;8.05;711;67;2842.00;88
7464;67;628252564;7464;142;8171;8259;11.79;0.71;237.77;8.05;707;67;2843.00;88
7467;67;628252576;7467;143;8181;8271;11.75;0.71;237.78;8.04;714;67;2844.00;90
7469;67;628252587;7469;147;8182;8271;11.65;0.71;237.86;8.04;713;67;2845.00;89
7472;67;628252599;7472;148;8182;8271;11.58;0.70;237.88;8.04;710;67;2846.00;89
7474;67;628252609;7474;149;8182;8271;11.49;0.70;237.89;8.04;708;67;2847.00;89
7476;67;628252620;7476;153;8182;8271;11.47;0.70;237.93;8.04;706;67;2848.00;89
7479;67;628252631;7479;157;8182;8271;11.36;0.69;238.01;8.04;703;67;2849.00;89
7481;67;628252643;7481;159;8186;8274;11.20;0.68;238.00;8.06;705;67;2850.00;88
7484;67;628252654;7484;159;8186;8274;11.15;0.68;238.05;8.06;702;67;2851.00;88
7486;67;628252666;7486;163;8190;8280;11.17;0.68;238.08;8.06;704;67;2852.00;90
7489;67;628252678;7489;163;8193;8281;11.10;0.68;238.11;8.07;704;67;2853.00;88
7494;67;628252689;7494;160;8194;8281;11.01;0.67;238.07;8.08;700;67;2854.00;87
7495;67;628252702;7495;168;8194;8281;11.01;0.67;238.08;8.08;699;67;2855.00;87
7497;67;628252713;7497;167;8199;8285;10.85;0.66;238.15;8.11;702;67;2856.00;86
7501;67;628252725;7501;170;8199;8285;10.72;0.65;238.18;8.11;698;67;2857.00;86
7501;67;628252735;7501;171;8201;8285;10.58;0.64;238.18;8.13;700;67;2858.00;84
7504;67;628252745;7504;179;8202;8286;10.56;0.64;238.19;8.13;698;67;2859.00;84
7507;67;628252756;7507;185;8207;8290;10.43;0.64;238.22;8.15;700;67;2860.00;83
7510;67;628252767;7510;192;8207;8290;10.39;0.63;238.27;8.15;697;67;2861.00;83
7514;67;628252777;7514;195;8209;8293;10.37;0.63;238.32;8.15;695;67;2862.00;84
7515;67;628252787;7515;196;8211;8293;10.28;0.63;238.32;8.17;696;67;2863.00;82
7516;67;628252797;7516;207;8213;8295;10.19;0.62;238.32;8.17;697;67;2864.00;82
7519;67;628252807;7519;211;8216;8295;10.10;0.62;238.29;8.18;697;67;2865.00;79
7521;67;628252817;7521;217;8220;8299;10.05;0.61;238.28;8.19;699;67;2866.00;79
7522;67;628252826;7522;222;8223;8299;10.02;0.61;238.29;8.21;701;67;2867.00;76
7523;67;628252836;7523;228;8223;8299;9.94;0.61;238.29;8.21;700;67;2868.00;76
7525;67;628252845;7525;225;8225;8299;9.84;0.60;238.26;8.22;700;67;2869.00;74
7526;67;628252854;7526;225;8225;8300;9.77;0.60;238.25;8.22;699;67;2870.00;75
7530;67;628252864;7530;224;8228;8301;9.63;0.59;238.26;8.23;698;67;2871.00;73
7533;67;628252874;7533;224;8229;8301;9.52;0.58;238.24;8.24;696;67;2872.00;72
7534;67;628252883;7534;228;8230;8302;9.45;0.58;238.24;8.24;696;67;2873.00;72
7537;67;628252893;7537;223;8231;8302;9.33;0.57;238.19;8.25;694;67;2874.00;71
7541;67;628252902;7541;218;8231;8302;9.24;0.57;238.16;8.25;690;67;2875.00;71
7544;67;628252911;7544;215;8233;8302;9.17;0.56;238.18;8.26;689;67;2876.00;69
7550;67;628252921;7550;217;8233;8302;9.15;0.56;238.16;8.26;683;67;2877.00;69
7552;67;628252930;7552;215;8235;8302;9.17;0.56;238.17;8.27;683;67;2878.00;67
7559;67;628252939;7559;214;8235;8302;9.10;0.55;238.15;8.27;676;67;2879.00;67
7561;67;628252950;7561;250;8335;8532;8.88;0.56;238.20;8.17;774;67;2880.00;197
7563;67;628252989;7563;245;8341;8533;8.83;0.55;238.18;8.17;778;67;2881.00;192
7567;67;628252998;7567;234;8351;8533;8.87;0.55;238.18;8.16;784;67;2882.00;182
7571;67;628253008;7571;230;8357;8533;8.79;0.55;238.18;8.17;786;67;2883.00;176
7572;67;628253018;7572;227;8363;8533;8.82;0.55;238.17;8.16;791;67;2884.00;170
7579;67;628253027;7579;223;8368;8533;8.81;0.55;238.17;8.16;789;67;2885.00;165
7582;67;628253043;7582;222;8375;8533;8.74;0.54;238.19;8.17;793;67;2886.00;158
7588;67;628253052;7588;229;8384;8533;8.65;0.54;238.18;8.17;796;67;2887.00;149
7594;67;628253062;7594;234;8389;8534;8.52;0.53;238.21;8.17;795;67;2888.00;145
7598;67;628253071;7598;240;8396;8535;8.41;0.52;238.18;8.17;798;67;2889.00;139
7604;67;628253081;7604;242;8399;8535;8.29;0.52;238.29;8.17;795;67;2890.00;136
7607;67;628253091;7607;251;8403;8536;8.23;0.51;238.28;8.17;796;67;2891.00;133
7613;67;628253101;7613;251;8410;8536;8.12;0.50;238.32;8.17;797;67;2892.00;126
7617;67;628253111;7617;251;8414;8536;7.98;0.50;238.35;8.17;797;67;2893.00;122
7621;67;628253121;7621;257;8417;8536;7.89;0.49;238.33;8.18;796;67;2894.00;119
7623;67;628253131;7623;268;8421;8540;7.78;0.48;238.37;8.17;798;67;2895.00;119
7628;67;628253140;7628;278;8425;8540;7.58;0.47;238.50;8.18;797;67;2896.00;115
7630;67;628253150;7630;270;8427;8540;7.38;0.46;238.48;8.18;797;67;2897.00;113
7634;67;628253161;7634;267;8430;8543;7.32;0.45;238.56;8.18;796;67;2898.00;113
7637;67;628253171;7637;272;8431;8543;7.26;0.45;238.59;8.18;794;67;2899.00;112
7640;67;628253182;7640;271;8433;8543;7.25;0.45;238.59;8.19;793;67;2900.00;110
7646;67;628253195;7646;278;8437;8547;7.27;0.45;238.64;8.19;791;67;2901.00;110
7650;67;628253206;7650;280;8438;8548;7.30;0.45;238.64;8.19;788;67;2902.00;110
7653;67;628253217;7653;275;8439;8548;7.33;0.45;238.67;8.19;786;67;2903.00;109
7659;67;628253227;7659;279;8443;8552;7.31;0.45;238.68;8.19;784;67;2904.00;109
7664;67;628253243;7664;280;8444;8552;7.30;0.45;238.66;8.19;780;67;2905.00;108
7667;67;628253254;7667;275;8447;8552;7.33;0.45;238.67;8.20;780;67;2906.00;105
7672;67;628253263;7672;274;8449;8553;7.30;0.45;238.70;8.20;777;67;2907.00;104
7675;67;628253278;7675;269;8452;8553;7.25;0.45;238.70;8.21;777;67;2908.00;101
7678;67;628253288;7678;269;8458;8559;7.31;0.45;238.70;8.21;780;67;2909.00;101
7683;67;628253301;7683;265;8460;8559;7.32;0.45;238.76;8.34;777;67;2910.00;99
7688;67;628253313;7688;270;8461;8560;7.34;0.45;238.74;8.34;773;67;2911.00;99
7690;67;628253323;7690;278;8465;8560;7.31;0.45;238.73;8.34;775;67;2912.00;95
7691;67;628253340;7691;283;8465;8560;7.34;0.45;238.75;8.34;774;67;2913.00;95
7697;67;628253350;7697;288;8465;8560;7.33;0.45;238.76;8.34;768;67;2914.00;95
7698;67;628253360;7698;288;8468;8560;7.32;0.45;238.78;8.35;770;67;2915.00;92
7700;67;628253370;7700;290;8479;8572;7.37;0.45;238.77;8.35;779;67;2916.00;93
7704;67;628253381;7704;293;8480;8572;7.29;0.45;238.82;8.35;776;67;2917.00;92
7708;67;628253391;7708;301;8482;8572;7.23;0.44;238.85;8.35;774;67;2918.00;90
7711;67;628253401;7711;308;8484;8572;7.16;0.44;238.85;8.36;773;67;2919.00;88
7713;67;628253411;7713;314;8484;8572;7.09;0.43;238.88;8.36;771;67;2920.00;88
7715;67;628253421;7715;314;8484;8572;7.02;0.43;238.90;8.36;769;67;2921.00;88
7716;67;628253430;7716;321;8488;8576;7.03;0.43;238.88;8.35;772;67;2922.00;88
7717;67;628253447;7717;331;8488;8576;7.02;0.43;238.89;8.35;771;67;2923.00;88
7719;67;628253457;7719;339;8491;8580;7.05;0.43;239.00;8.35;772;67;2924.00;89
7719;67;628253467;7719;337;8493;8582;7.11;0.44;239.00;8.35;774;67;2925.00;89
7723;67;628253477;7723;337;8494;8582;7.10;0.43;239.03;8.35;771;67;2926.00;88
7724;67;628253486;7724;339;8494;8582;7.10;0.43;239.05;8.35;770;67;2927.00;88
7727;67;628253496;7727;343;8504;8595;7.17;0.44;239.04;8.34;777;67;2928.00;91
7731;67;628253506;7731;348;8504;8595;7.17;0.44;239.04;8.34;773;67;2929.00;91
7733;67;628253517;7733;350;8506;8595;7.22;0.44;239.05;8.34;773;67;2930.00;89
7736;67;628253541;7736;353;8508;8596;7.29;0.45;239.05;8.34;772;67;2931.00;88
7737;67;628253560;7737;353;8508;8597;7.36;0.45;239.04;8.34;771;67;2932.00;89
7742;67;628253578;7742;354;8508;8597;7.39;0.45;239.01;8.34;766;67;2933.00;89
7745;67;628253604;7745;361;8511;8600;7.42;0.45;238.97;8.34;766;67;2934.00;89
7748;67;628253620;7748;366;8511;8600;7.32;0.45;238.99;8.34;763;67;2935.00;89
7750;67;628253635;7750;372;8511;8600;7.31;0.45;239.02;8.34;761;67;2936.00;89
7756;67;628253648;7756;365;8511;8600;7.24;0.44;238.93;8.34;755;67;2937.00;89
7757;67;628253659;7757;360;8515;8606;7.19;0.44;238.92;8.33;758;67;2938.00;91
7758;67;628253672;7758;356;8515;8606;7.15;0.44;238.95;8.33;757;67;2939.00;91
7760;67;628253684;7760;357;8516;8606;7.15;0.44;238.91;8.33;756;67;2940.00;90
7763;67;628253695;7763;348;8516;8606;7.11;0.43;238.85;8.33;753;67;2941.00;90
7764;67;628253709;7764;352;8519;8610;7.15;0.44;238.85;8.33;755;67;2942.00;91
7767;67;628253721;7767;350;8521;8611;7.14;0.44;238.83;8.45;754;67;2943.00;90
7772;67;628253732;7772;353;8521;8611;7.06;0.43;238.94;8.45;749;67;2944.00;90
7776;67;628253743;7776;355;8522;8612;7.05;0.43;238.90;8.45;746;67;2945.00;90
7778;67;628253754;7778;341;8522;8612;7.02;0.43;238.94;8.45;744;67;2946.00;90
7780;67;628253764;7780;330;8522;8612;7.11;0.43;238.89;8.45;742;67;2947.00;90
7782;67;628253773;7782;317;8522;8612;7.19;0.44;238.87;8.45;740;67;2948.00;90
7785;67;628253784;7785;311;8522;8612;7.27;0.44;238.80;8.45;737;67;2949.00;90
7786;67;628253794;7786;301;8522;8612;7.36;0.45;238.79;8.45;736;67;2950.00;90
7787;67;628253804;7787;294;8522;8612;7.50;0.46;238.76;8.45;735;67;2951.00;90
7787;67;628253815;7787;291;8559;8682;7.78;0.47;238.76;8.42;772;67;2952.00;123
7788;67;628253831;7788;280;8559;8683;7.90;0.48;238.74;8.42;771;67;2953.00;124
7789;67;628253843;7789;270;8568;8683;8.10;0.49;238.76;8.41;779;67;2954.00;115
7790;67;628253854;7790;259;8572;8683;8.23;0.50;238.76;8.41;782;67;2955.00;111
7791;67;628253865;7791;254;8577;8683;8.41;0.51;238.79;8.41;786;67;2956.00;106
7792;67;628253877;7792;241;8579;8683;8.54;0.52;238.78;8.40;787;67;2957.00;104
7793;67;628253889;7793;234;8581;8683;8.68;0.53;238.77;8.40;788;67;2958.00;102
7795;67;628253900;7795;224;8581;8683;8.79;0.53;238.76;8.40;786;67;2959.00;102
7797;67;628253912;7797;219;8583;8684;8.90;0.54;238.74;8.40;786;67;2960.00;101
7797;67;628253924;7797;216;8584;8685;8.96;0.54;238.74;8.40;787;67;2961.00;101
7799;67;628253936;7799;213;8585;8685;9.04;0.55;238.74;8.40;786;67;2962.00;100
7801;67;628253947;7801;209;8588;8689;9.09;0.55;238.72;8.40;787;67;2963.00;101
7801;67;628253959;7801;200;8588;8689;9.21;0.56;238.72;8.40;787;67;2964.00;101
7803;67;628253983;7803;197;8588;8689;9.26;0.56;238.78;8.40;785;67;2965.00;101
7804;67;628253995;7804;191;8588;8689;9.32;0.57;238.79;8.40;784;67;2966.00;101
7805;67;628254007;7805;187;8591;8695;9.48;0.58;238.77;8.40;786;67;2967.00;104
7806;67;628254020;7806;187;8591;8695;9.59;0.58;238.78;8.40;785;67;2968.00;104
7806;67;628254038;7806;186;8592;8695;9.68;0.59;238.78;8.40;786;67;2969.00;103
7807;67;628254050;7807;183;8595;8701;9.79;0.59;238.77;8.39;788;67;2970.00;106
7808;67;628254063;7808;186;8596;8701;9.92;0.60;238.77;8.39;788;67;2971.00;105
7809;67;628254074;7809;183;8596;8701;10.01;0.61;238.76;8.39;787;67;2972.00;105
7811;67;628254086;7811;177;8597;8702;10.10;0.61;238.73;8.39;786;67;2973.00;105
7814;67;628254098;7814;174;8598;8703;10.26;0.62;238.73;8.39;784;67;2974.00;105
7815;67;628254111;7815;173;8599;8703;10.39;0.63;238.74;8.39;784;67;2975.00;104
7820;67;628254122;7820;169;8607;8716;10.43;0.63;238.76;8.38;787;67;2976.00;109
7821;67;628254136;7821;167;8608;8716;10.52;0.64;238.75;8.38;787;67;2977.00;108
7823;67;628254147;7823;159;8609;8716;10.50;0.64;238.79;8.50;786;67;2978.00;107
7827;67;628254161;7827;161;8610;8717;10.54;0.64;238.76;8.50;783;67;2979.00;107
7829;67;628254173;7829;153;8610;8717;10.63;0.65;238.72;8.50;781;67;2980.00;107
7831;67;628254185;7831;152;8612;8721;10.72;0.65;238.69;8.50;781;67;2981.00;109
7832;67;628254196;7832;152;8612;8721;10.71;0.65;238.71;8.50;780;67;2982.00;109
7833;67;628254207;7833;151;8616;8725;10.67;0.65;238.69;8.50;783;67;2983.00;109
7834;67;628254219;7834;150;8616;8725;10.70;0.65;238.67;8.50;782;67;2984.00;109
7836;67;628254230;7836;154;8616;8725;10.77;0.65;238.68;8.50;780;67;2985.00;109
7841;67;628254243;7841;157;8616;8725;10.84;0.66;238.70;8.50;775;67;2986.00;109
7844;67;628254255;7844;154;8616;8725;10.91;0.66;238.71;8.50;772;67;2987.00;109
7846;67;628254266;7846;161;8625;8737;10.93;0.66;238.75;8.49;779;67;2988.00;112
7848;67;628254279;7848;158;8626;8737;10.93;0.67;238.76;8.50;778;67;2989.00;111
7851;67;628254290;7851;157;8628;8737;11.01;0.67;238.79;8.50;777;67;2990.00;109
7854;67;628254307;7854;157;8628;8737;11.04;0.67;238.80;8.50;774;67;2991.00;109
7857;67;628254318;7857;154;8628;8737;11.08;0.68;238.84;8.50;771;67;2992.00;109
7861;67;628254330;7861;155;8629;8737;11.12;0.68;238.89;8.50;768;67;2993.00;108
7863;67;628254341;7863;154;8631;8738;11.15;0.68;238.88;8.51;768;67;2994.00;107
7868;67;628254358;7868;151;8633;8738;11.17;0.68;238.98;8.53;765;67;2995.00;105
7871;67;628254370;7871;152;8636;8744;11.26;0.69;238.95;8.53;765;67;2996.00;108
7876;67;628254382;7876;154;8638;8745;11.24;0.69;238.94;8.53;762;67;2997.00;107
7881;67;628254394;7881;149;8638;8745;11.24;0.68;238.92;8.53;757;67;2998.00;107
7885;67;628254405;7885;145;8639;8745;11.24;0.68;238.93;8.67;754;67;2999.00;106
7888;67;628254419;7888;137;8643;8765;11.30;0.69;238.93;8.66;755;67;3000.00;122
7891;67;628254436;7891;134;8645;8765;11.35;0.69;238.94;8.79;754;67;3001.00;120
7895;67;628254448;7895;126;8645;8765;11.44;0.69;238.96;8.79;750;67;3002.00;120
7899;67;628254459;7899;118;8646;8766;11.50;0.70;238.95;8.79;747;67;3003.00;120
7902;67;628254472;7902;116;8650;8770;11.53;0.70;238.93;8.90;748;67;3004.00;120
7905;67;628254490;7905;112;8650;8770;11.57;0.70;238.92;8.90;745;67;3005.00;120
7909;67;628254502;7909;113;8653;8773;11.72;0.71;238.93;8.90;744;67;3006.00;120
7911;67;628254514;7911;112;8657;8773;11.73;0.71;238.98;8.91;746;67;3007.00;116
7916;67;628254526;7916;119;8657;8773;11.76;0.72;238.99;8.91;741;67;3008.00;116
7917;67;628254537;7917;120;8658;8773;11.79;0.72;239.01;8.91;741;67;3009.00;115
7921;67;628254548;7921;122;8659;8777;11.76;0.72;239.02;8.91;738;67;3010.00;118
7926;67;628254561;7926;122;8661;8777;11.66;0.71;239.02;8.92;735;67;3011.00;116
7930;67;628254573;7930;127;8663;8777;11.52;0.70;239.03;8.92;733;67;3012.00;114
7932;67;628254589;7932;130;8665;8777;11.44;0.70;239.04;8.93;733;67;3013.00;112
7936;67;628254601;7936;131;8665;8778;11.41;0.70;239.03;8.93;729;67;3014.00;113
7936;67;628254612;7936;135;8672;8780;11.42;0.70;239.03;8.94;736;67;3015.00;108
7940;67;628254623;7940;139;8673;8780;11.38;0.70;239.00;8.94;733;67;3016.00;107
7942;67;628254634;7942;143;8674;8781;11.35;0.69;239.01;8.94;732;67;3017.00;107
7945;67;628254645;7945;145;8674;8781;11.31;0.69;239.14;8.94;729;67;3018.00;107
7945;67;628254656;7945;152;8675;8781;11.27;0.69;239.14;8.94;730;67;3019.00;106
7949;67;628254666;7949;152;8677;8781;11.17;0.68;239.11;8.96;728;67;3020.00;104
7951;67;628254677;7951;158;8678;8781;11.06;0.68;239.17;8.97;727;67;3021.00;103
7954;67;628254687;7954;158;8678;8781;11.04;0.67;239.16;8.97;724;67;3022.00;103
7957;67;628254698;7957;165;8680;8781;10.96;0.67;239.17;8.99;723;67;3023.00;101
7959;67;628254709;7959;187;8746;8908;10.67;0.66;239.24;8.93;787;67;3024.00;162
7963;67;628254729;7963;179;8751;8909;10.66;0.66;239.24;8.95;788;67;3025.00;158
7965;67;628254741;7965;174;8756;8909;10.69;0.66;239.21;8.95;791;67;3026.00;153
7967;67;628254752;7967;175;8766;8909;10.62;0.65;239.26;8.96;799;67;3027.00;143
7968;67;628254762;7968;178;8768;8909;10.63;0.66;239.25;8.96;800;67;3028.00;141
7970;67;628254773;7970;186;8774;8909;10.57;0.65;239.27;8.98;804;67;3029.00;135
7973;67;628254786;7973;188;8778;8909;10.59;0.65;239.32;8.98;805;67;3030.00;131
7978;67;628254797;7978;191;8782;8909;10.57;0.65;239.29;9.00;804;67;3031.00;127
7979;67;628254814;7979;195;8788;8910;10.59;0.65;239.30;9.02;809;67;3032.00;122
7986;67;628254826;7986;201;8790;8911;10.56;0.65;239.31;9.02;804;67;3033.00;121
7988;67;628254838;7988;208;8795;8911;10.47;0.64;239.29;9.03;807;67;3034.00;116
7990;67;628254849;7990;209;8797;8912;10.39;0.64;239.36;9.03;807;67;3035.00;115
7994;67;628254860;7994;222;8802;8912;10.23;0.63;239.41;9.03;808;67;3036.00;110
7997;67;628254872;7997;228;8807;8912;10.06;0.62;239.40;9.05;810;67;3037.00;105
7999;67;628254884;7999;238;8811;8912;9.85;0.61;239.36;9.05;812;67;3038.00;101
8002;67;628254895;8002;235;8815;8916;9.67;0.60;239.34;9.06;813;67;3039.00;101
8006;67;628254907;8006;240;8817;8916;9.62;0.59;239.37;9.06;811;67;3040.00;99
8008;67;628254918;8008;240;8821;8916;9.57;0.59;239.35;9.07;813;67;3041.00;95
8010;67;628254930;8010;240;8823;8919;9.46;0.58;239.34;9.07;813;67;3042.00;96
8012;67;628254941;8012;246;8824;8919;9.41;0.58;239.32;9.07;812;67;3043.00;95
8014;67;628254953;8014;251;8827;8919;9.28;0.57;239.29;9.08;813;67;3044.00;92
8016;67;628254963;8016;252;8830;8923;9.12;0.56;239.28;9.08;814;67;3045.00;93
8018;67;628254975;8018;252;8835;8924;9.02;0.56;239.26;9.09;817;67;3046.00;89
8020;67;628254986;8020;258;8835;8924;8.90;0.55;239.24;9.09;815;67;3047.00;89
8023;67;628254997;8023;262;8837;8928;8.75;0.54;239.22;9.09;814;67;3048.00;91
8026;67;628255008;8026;259;8838;8928;8.64;0.53;239.19;9.10;812;67;3049.00;90
8030;67;628255019;8030;268;8839;8928;8.50;0.52;239.15;9.10;809;67;3050.00;89
8034;67;628255029;8034;268;8841;8929;8.38;0.51;239.09;9.10;807;67;3051.00;88
8039;67;628255040;8039;274;8842;8929;8.22;0.50;239.06;9.10;803;67;3052.00;87
8046;67;628255050;8046;281;8848;8935;8.19;0.50;238.99;9.10;802;67;3053.00;87
8048;67;628255061;8048;284;8849;8935;8.06;0.49;238.97;9.11;801;67;3054.00;86
8054;67;628255071;8054;288;8850;8936;7.82;0.48;238.97;9.11;796;67;3055.00;86
8058;67;628255080;8058;299;8852;8936;7.66;0.47;238.97;9.11;794;67;3056.00;84
8061;67;628255090;8061;305;8853;8936;7.45;0.46;239.02;9.11;792;67;3057.00;83
8064;67;628255100;8064;306;8853;8936;7.24;0.44;239.12;9.11;789;67;3058.00;83
8069;67;628255114;8069;313;8856;8936;6.98;0.43;239.22;9.12;787;67;3059.00;80
8072;67;628255124;8072;317;8876;8972;7.00;0.43;239.20;9.10;804;67;3060.00;96
8076;67;628255136;8076;319;8876;8972;6.97;0.43;239.26;9.10;800;67;3061.00;96
8080;67;628255145;8080;319;8880;8972;6.92;0.43;239.42;9.10;800;67;3062.00;92
8087;67;628255154;8087;326;8881;8972;6.79;0.42;239.44;9.10;794;67;3063.00;91
8091;67;628255163;8091;335;8884;8972;6.72;0.41;239.56;9.10;793;67;3064.00;88
8096;67;628255172;8096;331;8886;8972;6.68;0.41;239.54;9.10;790;67;3065.00;86
8098;67;628255182;8098;331;8890;8976;6.67;0.41;239.61;9.10;792;67;3066.00;86
8099;67;628255191;8099;323;8890;8976;6.66;0.41;239.59;9.10;791;67;3067.00;86
8101;67;628255199;8101;322;8893;8980;6.68;0.41;239.61;9.09;792;67;3068.00;87
8102;67;628255208;8102;314;8895;8981;6.73;0.41;239.59;9.10;793;67;3069.00;86
8103;67;628255218;8103;318;8896;8981;6.75;0.42;239.62;9.10;793;67;3070.00;85
8106;67;628255227;8106;320;8897;8981;6.75;0.42;239.57;9.10;791;67;3071.00;84
8108;67;628255236;8108;319;8910;8994;6.79;0.42;239.62;9.21;802;67;3072.00;84
8110;67;628255247;8110;319;8910;8994;6.81;0.42;239.60;9.21;800;67;3073.00;84
8115;67;628255258;8115;319;8910;8994;6.77;0.42;239.62;9.21;795;67;3074.00;84
8120;67;628255267;8120;318;8911;8995;6.71;0.41;239.65;9.21;791;67;3075.00;84
8124;67;628255276;8124;315;8911;8996;6.68;0.41;239.60;9.21;787;67;3076.00;85
8128;67;628255286;8128;319;8911;8996;6.68;0.41;239.60;9.21;783;67;3077.00;85
8130;67;628255294;8130;324;8914;8999;6.67;0.41;239.56;9.20;784;67;3078.00;85
8135;67;628255304;8135;323;8914;8999;6.64;0.41;239.55;9.20;779;67;3079.00;85
8138;67;628255314;8138;318;8914;8999;6.57;0.40;239.57;9.20;776;67;3080.00;85
8141;67;628255322;8141;321;8914;8999;6.50;0.40;239.51;9.20;773;67;3081.00;85
8146;67;628255331;8146;316;8918;9005;6.42;0.39;239.55;9.20;772;67;3082.00;87
8149;67;628255341;8149;310;8918;9005;6.38;0.39;239.59;9.20;769;67;3083.00;87
8151;67;628255350;8151;310;8919;9005;6.32;0.39;239.55;9.20;768;67;3084.00;86
8156;67;628255359;8156;309;8919;9005;6.19;0.38;239.54;9.20;763;67;3085.00;86
8159;67;628255368;8159;311;8922;9009;6.25;0.38;239.63;9.20;763;67;3086.00;87
8161;67;628255378;8161;315;8923;9010;6.22;0.38;239.61;9.19;762;67;3087.00;87
8164;67;628255386;8164;327;8923;9010;6.14;0.37;239.65;9.19;759;67;3088.00;87
8170;67;628255396;8170;321;8924;9011;6.09;0.37;239.74;9.19;754;67;3089.00;87
8171;67;628255407;8171;326;8924;9011;6.10;0.37;239.76;9.19;753;67;3090.00;87
8177;67;628255415;8177;336;8924;9011;6.02;0.37;239.69;9.19;747;67;3091.00;87
8182;67;628255424;8182;341;8924;9011;6.00;0.37;239.66;9.19;742;67;3092.00;87
8185;67;628255433;8185;346;8924;9011;6.01;0.37;239.61;9.19;739;67;3093.00;87
8188;67;628255442;8188;347;8924;9011;6.06;0.37;239.59;9.19;736;67;3094.00;87
8189;67;628255452;8189;349;8924;9011;6.06;0.37;239.58;9.19;735;67;3095.00;87
8191;67;628255460;8191;361;8964;9081;6.34;0.39;239.62;9.15;773;67;3096.00;117
8193;67;628255476;8193;355;8965;9082;6.39;0.39;239.60;9.15;772;67;3097.00;117
8194;67;628255485;8194;352;8973;9082;6.55;0.40;239.62;9.14;779;67;3098.00;109
8196;67;628255495;8196;351;8977;9082;6.56;0.40;239.61;9.14;781;67;3099.00;105
8196;67;628255504;8196;357;8983;9082;6.64;0.41;239.61;9.14;787;67;3100.00;99
8200;67;628255518;8200;365;8986;9082;6.67;0.41;239.59;9.14;786;67;3101.00;96
8200;67;628255531;8200;366;8987;9082;6.71;0.41;239.59;9.14;787;67;3102.00;95
8203;67;628255544;8203;371;8988;9082;6.65;0.41;239.61;9.14;785;67;3103.00;94
8205;67;628255560;8205;376;8990;9083;6.60;0.41;239.64;9.14;785;67;3104.00;93
8207;67;628255578;8207;386;8992;9085;6.52;0.40;239.62;9.13;785;67;3105.00;93
8211;67;628255595;8211;379;8993;9085;6.42;0.39;239.61;9.13;782;67;3106.00;92
8212;67;628255610;8212;363;8996;9089;6.43;0.39;239.59;9.13;784;67;3107.00;93
8214;67;628255625;8214;349;8996;9089;6.47;0.40;239.58;9.13;782;67;3108.00;93
8215;67;628255637;8215;346;8996;9089;6.47;0.40;239.61;9.13;781;67;3109.00;93
8217;67;628255650;8217;336;8996;9089;6.58;0.41;239.67;9.13;779;67;3110.00;93
8219;67;628255663;8219;330;9000;9095;6.70;0.41;239.69;9.13;781;67;3111.00;95
8220;67;628255675;8220;322;9000;9095;6.80;0.42;239.67;9.13;780;67;3112.00;95
8221;67;628255686;8221;311;9001;9095;7.00;0.43;239.66;9.13;780;67;3113.00;94
8223;67;628255702;8223;301;9003;9098;7.18;0.44;239.76;9.12;780;67;3114.00;95
8225;67;628255713;8225;292;9004;9098;7.34;0.45;239.75;9.12;779;67;3115.00;94
8228;67;628255725;8228;271;9004;9098;7.48;0.46;239.78;9.12;776;67;3116.00;94
8230;67;628255737;8230;256;9004;9099;7.72;0.47;239.81;9.12;774;67;3117.00;95
8231;67;628255750;8231;237;9005;9100;7.91;0.49;239.78;9.12;774;67;3118.00;95
8236;67;628255761;8236;219;9006;9100;8.10;0.49;239.73;9.25;770;67;3119.00;94
8240;67;628255775;8240;210;9026;9126;8.40;0.51;239.71;9.23;786;67;3120.00;100
8242;67;628255789;8242;197;9027;9126;8.60;0.53;239.70;9.23;785;67;3121.00;99
8243;67;628255801;8243;186;9028;9126;8.79;0.54;239.71;9.23;785;67;3122.00;98
8244;67;628255820;8244;178;9029;9127;9.00;0.55;239.68;9.23;785;67;3123.00;98
8246;67;628255832;8246;170;9029;9127;9.19;0.56;239.69;9.23;783;67;3124.00;98
8247;67;628255845;8247;166;9032;9131;9.41;0.57;239.69;9.22;785;67;3125.00;99
8248;67;628255863;8248;161;9032;9131;9.62;0.59;239.72;9.22;784;67;3126.00;99
8251;67;628255875;8251;155;9036;9135;9.76;0.60;239.73;9.22;785;67;3127.00;99
8254;67;628255888;8254;156;9036;9135;9.89;0.60;239.71;9.22;782;67;3128.00;99
8258;67;628255900;8258;155;9036;9135;10.00;0.61;239.68;9.22;778;67;3129.00;99
8258;67;628255913;8258;152;9036;9135;10.15;0.62;239.68;9.22;778;67;3130.00;99
8262;67;628255931;8262;147;9036;9135;10.34;0.63;239.67;9.22;774;67;3131.00;99
8266;67;628255943;8266;151;9046;9147;10.49;0.64;239.68;9.21;780;67;3132.00;101
8270;67;628255956;8270;147;9046;9147;10.60;0.64;239.77;9.21;776;67;3133.00;101
8272;67;628255970;8272;145;9048;9147;10.77;0.65;239.75;9.33;776;67;3134.00;99
8275;67;628255983;8275;147;9048;9147;10.93;0.66;239.81;9.33;773;67;3135.00;99
8277;67;628256001;8277;136;9048;9147;11.03;0.67;239.86;9.33;771;67;3136.00;99
8279;67;628256013;8279;135;9048;9147;11.17;0.68;239.87;9.33;769;67;3137.00;99
8283;67;628256027;8283;137;9048;9148;11.27;0.68;239.98;9.33;765;67;3138.00;100
8286;67;628256039;8286;132;9048;9148;11.29;0.69;240.04;9.33;762;67;3139.00;100
8289;67;628256051;8289;134;9052;9154;11.33;0.69;240.07;9.33;763;67;3140.00;102
8294;67;628256063;8294;133;9053;9155;11.36;0.69;240.15;9.33;759;67;3141.00;102
8296;67;628256075;8296;128;9054;9155;11.41;0.69;240.15;9.33;758;67;3142.00;101
8300;67;628256088;8300;125;9054;9155;11.38;0.69;240.18;9.33;754;67;3143.00;101
8302;67;628256100;8302;131;9057;9159;11.49;0.70;240.22;9.32;755;67;3144.00;102
8303;67;628256112;8303;132;9057;9159;11.48;0.70;240.21;9.32;754;67;3145.00;102
8305;67;628256123;8305;139;9057;9159;11.46;0.70;240.21;9.32;752;67;3146.00;102
8309;67;628256135;8309;140;9058;9160;11.44;0.69;240.25;9.32;749;67;3147.00;102
8310;67;628256146;8310;142;9061;9164;11.46;0.70;240.23;9.32;751;67;3148.00;103
8315;67;628256158;8315;146;9061;9164;11.49;0.70;240.34;9.32;746;67;3149.00;103
8317;67;628256172;8317;148;9064;9170;11.55;0.70;240.37;9.32;747;67;3150.00;106
8321;67;628256184;8321;151;9064;9170;11.61;0.71;240.42;9.32;743;67;3151.00;106
8324;67;628256196;8324;149;9065;9170;11.61;0.71;240.48;9.31;741;67;3152.00;105
8327;67;628256208;8327;144;9065;9170;11.65;0.71;240.50;9.31;738;67;3153.00;105
8329;67;628256220;8329;139;9069;9174;11.70;0.71;240.52;9.44;740;67;3154.00;105
8335;67;628256232;8335;137;9069;9174;11.73;0.71;240.55;9.44;734;67;3155.00;105
8338;67;628256244;8338;137;9070;9174;11.78;0.71;240.54;9.44;732;67;3156.00;104
8340;67;628256257;8340;134;9070;9174;11.80;0.71;240.53;9.44;730;67;3157.00;104
8343;67;628256268;8343;133;9071;9175;11.89;0.72;240.52;9.44;728;67;3158.00;104
8348;67;628256279;8348;129;9072;9176;11.85;0.72;240.51;9.43;724;67;3159.00;104
8352;67;628256290;8352;125;9073;9176;11.94;0.72;240.52;9.43;721;67;3160.00;103
8355;67;628256302;8355;124;9074;9177;11.94;0.72;240.52;9.43;719;67;3161.00;103
8357;67;628256313;8357;119;9074;9177;11.97;0.72;240.52;9.43;717;67;3162.00;103
8359;67;628256324;8359;120;9074;9177;12.02;0.73;240.57;9.43;715;67;3163.00;103
8364;67;628256335;8364;117;9075;9177;12.03;0.73;240.67;9.45;711;67;3164.00;102
8368;67;628256348;8368;109;9075;9177;12.03;0.73;240.68;9.45;707;67;3165.00;102
8374;67;628256359;8374;107;9076;9177;11.96;0.72;240.67;9.46;702;67;3166.00;101
8377;67;628256370;8377;104;9076;9177;11.93;0.72;240.77;9.46;699;67;3167.00;101
8380;67;628256386;8380;123;9142;9304;11.65;0.71;240.75;9.39;762;67;3168.00;162
8385;67;628256414;8385;116;9144;9305;11.60;0.71;240.81;9.51;759;67;3169.00;161
8387;67;628256426;8387;109;9149;9305;11.58;0.71;240.81;9.50;762;67;3170.00;156
8391;67;628256444;8391;104;9152;9305;11.58;0.71;240.78;9.50;761;67;3171.00;153
8395;67;628256455;8395;105;9157;9305;11.63;0.71;240.78;9.50;762;67;3172.00;148
8397;67;628256466;8397;106;9161;9305;11.68;0.72;240.78;9.49;764;67;3173.00;144
8399;67;628256479;8399;107;9164;9305;11.64;0.71;240.76;9.49;765;67;3174.00;141
8402;67;628256490;8402;103;9167;9305;11.64;0.71;240.79;9.49;765;67;3175.00;138
8406;67;628256501;8406;113;9171;9306;11.65;0.71;240.74;9.49;765;67;3176.00;135
8409;67;628256514;8409;110;9175;9307;11.60;0.71;240.80;9.49;766;67;3177.00;132
8411;67;628256526;8411;112;9178;9307;11.57;0.70;240.86;9.49;767;67;3178.00;129
8412;67;628256544;8412;119;9181;9308;11.57;0.70;240.85;9.49;769;67;3179.00;127
8415;67;628256563;8415;123;9188;9308;11.50;0.70;240.94;9.49;773;67;3180.00;120
8417;67;628256574;8417;122;9189;9308;11.47;0.70;240.96;9.49;772;67;3181.00;119
8418;67;628256585;8418;126;9192;9308;11.33;0.69;240.96;9.50;774;67;3182.00;116
8421;67;628256603;8421;136;9194;9312;11.17;0.68;241.00;9.49;773;67;3183.00;118
8422;67;628256614;8422;144;9197;9312;11.08;0.67;241.00;9.50;775;67;3184.00;115
8425;67;628256625;8425;150;9198;9312;11.03;0.67;241.02;9.50;773;67;3185.00;114
8426;67;628256637;8426;158;9201;9315;11.02;0.67;241.00;9.51;775;67;3186.00;114
8430;67;628256648;8430;162;9202;9315;10.98;0.67;241.05;9.51;772;67;3187.00;113
8432;67;628256665;8432;167;9203;9315;10.97;0.67;241.05;9.51;771;67;3188.00;112
8434;67;628256677;8434;170;9207;9319;10.93;0.66;241.03;9.50;773;67;3189.00;112
8435;67;628256688;8435;175;9210;9320;10.92;0.66;241.02;9.53;775;67;3190.00;110
8438;67;628256699;8438;181;9212;9322;10.93;0.66;241.00;9.53;774;67;3191.00;110
8441;67;628256711;8441;188;9217;9326;10.86;0.66;240.98;9.55;776;67;3192.00;109
8443;67;628256728;8443;189;9218;9326;10.79;0.66;240.98;9.55;775;67;3193.00;108
8445;67;628256740;8445;197;9218;9326;10.74;0.65;240.97;9.55;773;67;3194.00;108
8449;67;628256752;8449;205;9222;9328;10.67;0.65;241.04;9.57;773;67;3195.00;106
8450;67;628256764;8450;209;9222;9328;10.66;0.65;241.03;9.57;772;67;3196.00;106
8453;67;628256775;8453;217;9227;9334;10.57;0.65;241.08;9.58;774;67;3197.00;107
8455;67;628256788;8455;225;9229;9334;10.45;0.64;241.06;9.59;774;67;3198.00;105
8458;67;628256800;8458;228;9230;9335;10.27;0.63;241.07;9.60;772;67;3199.00;105
8460;67;628256820;8460;232;9231;9335;10.06;0.61;241.04;9.61;771;67;3200.00;104
8462;67;628256834;8462;242;9231;9335;9.94;0.61;241.08;9.61;769;67;3201.00;104
8464;67;628256846;8464;245;9233;9335;9.85;0.60;241.07;9.63;769;67;3202.00;102
8464;67;628256857;8464;245;9233;9335;9.82;0.60;241.07;9.63;769;67;3203.00;102
8470;67;628256868;8470;249;9244;9347;9.80;0.60;241.07;9.63;774;67;3204.00;103
8470;67;628256879;8470;249;9247;9347;9.74;0.60;241.07;9.65;777;67;3205.00;100
8474;67;628256889;8474;255;9247;9347;9.61;0.59;241.09;9.65;773;67;3206.00;100
8476;67;628256899;8476;261;9249;9347;9.46;0.58;241.07;9.67;773;67;3207.00;98
8479;67;628256908;8479;264;9249;9347;9.27;0.57;241.06;9.67;770;67;3208.00;98
8482;67;628256918;8482;267;9249;9347;9.11;0.56;241.04;9.67;767;67;3209.00;98
8485;67;628256930;8485;269;9254;9351;8.88;0.54;241.03;9.68;769;67;3210.00;97
8487;67;628256940;8487;262;9254;9351;8.75;0.54;241.04;9.68;767;67;3211.00;97
8489;67;628256950;8489;262;9261;9355;8.75;0.54;241.02;9.71;772;67;3212.00;94
8492;67;628256966;8492;267;9262;9356;8.69;0.53;241.01;9.71;770;67;3213.00;94
8494;67;628256976;8494;266;9263;9356;8.65;0.53;240.99;9.71;769;67;3214.00;93
8498;67;628256985;8498;268;9265;9356;8.58;0.53;240.97;9.72;767;67;3215.00;91
8501;67;628257000;8501;267;9276;9369;8.55;0.53;240.99;9.71;775;67;3216.00;93
8505;67;628257010;8505;269;9276;9369;8.51;0.52;240.93;9.71;771;67;3217.00;93
8508;67;628257020;8508;269;9278;9369;8.46;0.52;240.99;9.72;770;67;3218.00;91
8512;67;628257030;8512;264;9279;9370;8.37;0.51;241.00;9.71;767;67;3219.00;91
8516;67;628257039;8516;269;9279;9371;8.31;0.51;240.99;9.71;763;67;3220.00;92
8517;67;628257048;8517;265;9281;9371;8.24;0.51;240.99;9.72;764;67;3221.00;90
8524;67;628257057;8524;266;9283;9374;8.11;0.50;240.98;9.72;759;67;3222.00;91
8528;67;628257066;8528;275;9285;9374;8.01;0.49;241.01;9.73;757;67;3223.00;89
8531;67;628257075;8531;279;9286;9374;7.90;0.49;241.03;9.73;755;67;3224.00;88
8538;67;628257084;8538;286;9286;9374;7.76;0.48;240.98;9.73;748;67;3225.00;88
8544;67;628257093;8544;290;9292;9380;7.59;0.47;241.01;9.74;748;67;3226.00;88
8547;67;628257102;8547;292;9292;9380;7.49;0.46;240.97;9.74;745;67;3227.00;88
8553;67;628257110;8553;294;9293;9380;7.29;0.45;240.97;9.74;740;67;3228.00;87
8555;67;628257119;8555;303;9295;9380;7.14;0.44;240.96;9.74;740;67;3229.00;85
8558;67;628257126;8558;299;9298;9384;7.02;0.43;240.99;9.74;740;67;3230.00;86
8560;67;628257134;8560;301;9299;9385;6.94;0.43;240.99;9.74;739;67;3231.00;86
8561;67;628257142;8561;298;9301;9385;6.89;0.42;240.97;9.75;740;67;3232.00;84
8565;67;628257150;8565;302;9302;9386;6.78;0.42;240.98;9.75;737;67;3233.00;84
8568;67;628257158;8568;300;9302;9386;6.73;0.41;240.96;9.75;734;67;3234.00;84
8570;67;628257167;8570;305;9304;9386;6.73;0.41;240.96;9.75;734;67;3235.00;82
8575;67;628257180;8575;305;9304;9386;6.67;0.41;240.96;9.75;729;67;3236.00;82
8577;67;628257189;8577;300;9306;9386;6.70;0.41;240.92;9.75;729;67;3237.00;80
8580;67;628257196;8580;299;9306;9386;6.71;0.41;240.93;9.75;726;67;3238.00;80
8582;67;628257204;8582;297;9306;9386;6.71;0.41;240.93;9.75;724;67;3239.00;80
8586;67;628257213;8586;295;9358;9511;7.04;0.44;240.95;9.70;772;67;3240.00;153
8589;67;628257230;8589;302;9361;9512;7.06;0.44;240.95;9.70;772;67;3241.00;151
8591;67;628257239;8591;300;9373;9512;7.20;0.45;240.97;9.69;782;67;3242.00;139
8597;67;628257247;8597;307;9380;9512;7.16;0.44;241.06;9.69;783;67;3243.00;132
8597;67;628257257;8597;312;9386;9512;7.19;0.44;241.06;9.68;789;67;3244.00;126
8603;67;628257265;8603;308;9390;9512;7.15;0.44;241.13;9.68;787;67;3245.00;122
8605;67;628257274;8605;311;9396;9512;7.16;0.44;241.12;9.68;791;67;3246.00;116
8606;67;628257283;8606;307;9398;9512;7.08;0.44;241.14;9.68;792;67;3247.00;114
8609;67;628257297;8609;303;9403;9513;7.01;0.43;241.13;9.68;794;67;3248.00;110
8613;67;628257306;8613;302;9406;9514;7.02;0.43;241.08;9.68;793;67;3249.00;108
8615;67;628257315;8615;312;9409;9514;6.99;0.43;241.08;9.68;794;67;3250.00;105
8619;67;628257324;8619;313;9414;9518;6.95;0.43;241.08;9.67;795;67;3251.00;104
8621;67;628257334;8621;316;9416;9518;6.92;0.42;241.07;9.79;795;67;3252.00;102
8623;67;628257345;8623;322;9417;9518;6.92;0.42;241.08;9.79;794;67;3253.00;101
8627;67;628257355;8627;324;9418;9518;6.88;0.42;241.10;9.79;791;67;3254.00;100
8631;67;628257364;8631;330;9422;9524;6.86;0.42;241.05;9.79;791;67;3255.00;102
8633;67;628257374;8633;326;9422;9524;6.90;0.42;241.05;9.79;789;67;3256.00;102
8635;67;628257384;8635;325;9424;9524;6.90;0.42;241.09;9.79;789;67;3257.00;100
8639;67;628257394;8639;324;9427;9527;6.91;0.42;241.16;9.78;788;67;3258.00;100
8640;67;628257403;8640;313;9427;9527;6.90;0.42;241.17;9.78;787;67;3259.00;100
8641;67;628257418;8641;297;9427;9527;6.98;0.43;241.17;9.78;786;67;3260.00;100
8644;67;628257428;8644;300;9427;9528;7.03;0.43;241.17;9.78;783;67;3261.00;101
8649;67;628257437;8649;297;9428;9529;7.05;0.43;241.21;9.78;779;67;3262.00;101
8651;67;628257453;8651;295;9428;9529;7.13;0.43;241.24;9.78;777;67;3263.00;101
8654;68;628257463;8654;294;9439;9542;7.35;0.45;241.25;9.77;785;68;3264.00;103
8658;68;628257485;8658;291;9439;9542;7.43;0.45;241.29;9.77;781;68;3265.00;103
8661;68;628257495;8661;296;9439;9542;7.50;0.46;241.25;9.77;778;68;3266.00;103
8665;68;628257506;8665;296;9440;9543;7.64;0.47;241.27;9.77;775;68;3267.00;103
8666;68;628257517;8666;298;9440;9543;7.76;0.47;241.29;9.77;774;68;3268.00;103
8668;68;628257528;8668;300;9443;9547;7.86;0.48;241.31;9.77;775;68;3269.00;104
8671;69;628257547;8671;299;9443;9547;7.87;0.48;241.30;9.77;772;69;3270.00;104
8673;69;628257608;8673;303;9447;9551;7.96;0.49;241.29;9.76;774;69;3271.00;104
8675;69;628257625;8675;303;9447;9551;7.99;0.49;241.27;9.76;772;69;3272.00;104
8676;69;628257650;8676;301;9447;9551;7.97;0.49;241.26;9.76;771;69;3273.00;104
8679;69;628257669;8679;301;9447;9551;7.93;0.48;241.21;9.76;768;69;3274.00;104
8680;69;628257681;8680;298;9447;9551;7.92;0.48;241.20;9.76;767;69;3275.00;104
8684;69;628257692;8684;301;9457;9563;8.05;0.49;241.15;9.75;773;69;3276.00;106
8685;69;628257705;8685;285;9457;9563;8.11;0.49;241.16;9.75;772;69;3277.00;106
8686;69;628257717;8686;278;9458;9563;8.20;0.50;241.14;9.75;772;69;3278.00;105
8689;69;628257729;8689;273;9458;9563;8.21;0.50;241.16;9.75;769;69;3279.00;105
8691;69;628257741;8691;267;9458;9563;8.30;0.51;241.14;9.75;767;70;3280.00;105
8691;69;628257762;8691;263;9458;9563;8.41;0.51;241.14;9.75;767;70;3281.00;105
8692;69;628257774;8692;256;9458;9564;8.56;0.52;241.11;9.75;766;70;3282.00;106
8696;69;628257786;8696;252;9458;9564;8.66;0.53;241.16;9.75;762;70;3283.00;106
8698;69;628257797;8698;252;9462;9570;8.82;0.54;241.20;9.75;764;70;3284.00;108
8703;69;628257810;8703;249;9464;9572;8.85;0.54;241.23;9.75;761;70;3285.00;108
8705;69;628257828;8705;234;9465;9572;8.97;0.54;241.24;9.75;760;70;3286.00;107
8706;69;628257847;8706;211;9465;9572;9.12;0.55;241.28;9.75;759;70;3287.00;107
8708;69;628257859;8708;197;9468;9576;9.30;0.57;241.32;9.74;760;70;3288.00;108
8710;69;628257872;8710;186;9468;9576;9.42;0.57;241.30;9.74;758;70;3289.00;108
8711;69;628257884;8711;177;9468;9576;9.57;0.58;241.34;9.74;757;70;3290.00;108
8714;69;628257896;8714;177;9469;9577;9.71;0.59;241.39;9.74;755;70;3291.00;108
8720;69;628257908;8720;169;9472;9581;9.78;0.59;241.42;9.74;752;70;3292.00;109
8722;69;628257927;8722;162;9472;9581;9.90;0.60;241.44;9.74;750;70;3293.00;109
8724;69;628257941;8724;165;9474;9584;10.01;0.61;241.50;9.74;750;70;3294.00;110
8726;69;628257954;8726;163;9474;9584;10.11;0.61;241.50;9.74;748;70;3295.00;110
8727;69;628257967;8727;158;9475;9584;10.31;0.63;241.52;9.74;748;70;3296.00;109
8729;69;628257979;8729;155;9475;9584;10.40;0.63;241.52;9.74;746;70;3297.00;109
8733;69;628257991;8733;154;9478;9588;10.50;0.64;241.52;9.73;745;70;3298.00;110
8735;69;628258004;8735;149;9478;9588;10.61;0.65;241.53;9.73;743;70;3299.00;110
8739;69;628258019;8739;152;9482;9607;10.67;0.65;241.53;9.73;743;70;3300.00;125
8740;69;628258037;8740;149;9483;9607;10.69;0.65;241.52;9.73;743;70;3301.00;124
8743;69;628258050;8743;146;9483;9608;10.69;0.65;241.55;9.73;740;70;3302.00;125
8746;69;628258063;8746;146;9484;9609;10.75;0.65;241.54;9.73;738;70;3303.00;125
8748;69;628258078;8748;147;9484;9609;10.77;0.66;241.57;9.73;736;70;3304.00;125
8750;69;628258096;8750;148;9485;9610;10.87;0.66;241.61;9.73;735;70;3305.00;125
8754;69;628258115;8754;146;9486;9610;10.95;0.67;241.65;9.73;732;70;3306.00;124
8755;69;628258129;8755;140;9487;9610;10.95;0.67;241.67;9.73;732;70;3307.00;123
8759;69;628258160;8759;134;9487;9610;11.04;0.67;241.68;9.73;728;70;3308.00;123
8762;69;628258179;8762;133;9487;9610;11.14;0.68;241.68;9.73;725;70;3309.00;123
8767;69;628258194;8767;126;9487;9610;11.27;0.69;241.71;9.73;720;70;3310.00;123
8769;69;628258208;8769;126;9488;9610;11.35;0.69;241.73;9.73;719;70;3311.00;122
8772;69;628258230;8772;143;9555;9737;11.14;0.69;241.75;9.66;783;70;3312.00;182
8774;69;628258260;8774;130;9560;9738;11.21;0.69;241.76;9.65;786;70;3313.00;178
8778;69;628258272;8778;125;9563;9738;11.31;0.69;241.81;9.65;785;70;3314.00;175
8783;69;628258285;8783;122;9564;9738;11.41;0.70;241.81;9.65;781;70;3315.00;174
8786;69;628258297;8786;124;9568;9738;11.48;0.70;241.81;9.65;782;70;3316.00;170
8788;69;628258309;8788;127;9570;9738;11.49;0.70;241.83;9.65;782;70;3317.00;168
8792;69;628258321;8792;134;9573;9738;11.49;0.70;241.85;9.65;781;70;3318.00;165
8794;69;628258338;8794;137;9576;9738;11.48;0.70;241.96;9.65;782;70;3319.00;162
8798;69;628258350;8798;140;9579;9739;11.42;0.70;242.01;9.65;781;70;3320.00;160
8799;69;628258362;8799;143;9581;9740;11.43;0.70;242.04;9.65;782;70;3321.00;159
8805;69;628258374;8805;151;9585;9740;11.37;0.69;242.05;9.77;780;70;3322.00;155
8810;69;628258387;8810;157;9588;9741;11.36;0.69;242.05;9.77;778;70;3323.00;153
8812;69;628258400;8812;161;9591;9741;11.32;0.69;242.07;9.77;779;70;3324.00;150
8815;69;628258412;8815;161;9595;9741;11.26;0.69;242.13;9.89;780;70;3325.00;146
8817;69;628258424;8817;164;9596;9741;11.24;0.69;242.14;9.89;779;70;3326.00;145
8820;69;628258442;8820;164;9598;9745;11.17;0.68;242.16;9.89;778;70;3327.00;147
8825;69;628258454;8825;169;9600;9745;11.13;0.68;242.12;10.01;775;70;3328.00;145
8828;69;628258467;8828;172;9602;9745;11.05;0.67;242.14;10.02;774;70;3329.00;143
8832;69;628258481;8832;171;9605;9751;10.94;0.67;242.16;10.02;773;70;3330.00;146
8834;69;628258493;8834;167;9606;9751;10.98;0.67;242.18;10.02;772;70;3331.00;145
8838;69;628258504;8838;164;9608;9751;11.01;0.67;242.21;10.14;770;70;3332.00;143
8841;69;628258520;8841;156;9615;9755;11.06;0.67;242.22;10.14;774;70;3333.00;140
8846;69;628258538;8846;156;9616;9756;11.09;0.67;242.28;10.14;770;70;3334.00;140
8847;69;628258552;8847;154;9620;9756;11.11;0.68;242.27;10.16;773;70;3335.00;136
8853;69;628258565;8853;149;9622;9760;11.13;0.68;242.28;10.16;769;70;3336.00;138
8857;69;628258578;8857;148;9623;9760;11.17;0.68;242.28;10.28;766;70;3337.00;137
8861;69;628258590;8861;144;9624;9760;11.16;0.68;242.25;10.28;763;70;3338.00;136
8865;69;628258603;8865;141;9625;9761;11.24;0.68;242.23;10.28;760;70;3339.00;136
8867;69;628258615;8867;139;9625;9761;11.29;0.69;242.25;10.28;758;70;3340.00;136
8871;69;628258629;8871;139;9630;9767;11.27;0.68;242.24;10.29;759;70;3341.00;137
8876;69;628258646;8876;138;9631;9767;11.27;0.68;242.27;10.29;755;70;3342.00;136
8879;69;628258659;8879;140;9633;9768;11.36;0.69;242.31;10.29;754;70;3343.00;135
8882;69;628258673;8882;136;9634;9768;11.44;0.69;242.33;10.30;752;70;3344.00;134
8885;69;628258689;8885;134;9636;9768;11.48;0.69;242.32;10.30;751;70;3345.00;132
8887;69;628258704;8887;135;9637;9768;11.55;0.70;242.35;10.30;750;70;3346.00;131
8891;69;628258719;8891;130;9637;9768;11.64;0.70;242.41;10.30;746;70;3347.00;131
8892;69;628258731;8892;129;9649;9780;11.68;0.71;242.40;10.29;757;70;3348.00;131
8896;69;628258744;8896;139;9652;9780;11.61;0.70;242.42;10.30;756;70;3349.00;128
8899;69;628258755;8899;140;9653;9780;11.53;0.70;242.41;10.30;754;70;3350.00;127
8900;69;628258766;8900;151;9656;9780;11.40;0.69;242.41;10.30;756;70;3351.00;124
8906;70;628258777;8906;154;9657;9780;11.25;0.68;242.43;10.30;751;71;3352.00;123
8907;70;628258803;8907;159;9657;9780;11.21;0.68;242.48;10.30;750;71;3353.00;123
8909;70;628258820;8909;158;9662;9784;11.02;0.67;242.48;10.30;753;71;3354.00;122
8911;70;628258833;8911;163;9662;9784;10.91;0.66;242.51;10.30;751;71;3355.00;122
8915;70;628258844;8915;171;9665;9788;10.74;0.65;242.49;10.30;750;71;3356.00;123
8917;70;628258855;8917;179;9667;9789;10.68;0.64;242.49;10.30;750;71;3357.00;122
8918;70;628258866;8918;183;9667;9789;10.60;0.64;242.50;10.30;749;71;3358.00;122
8919;70;628258878;8919;193;9667;9789;10.54;0.64;242.51;10.30;748;71;3359.00;122
8921;70;628258890;8921;207;9687;9818;10.34;0.62;242.48;10.29;766;71;3360.00;131
8923;70;628258903;8923;206;9690;9818;10.26;0.62;242.49;10.30;767;71;3361.00;128
8927;70;628258914;8927;213;9691;9818;10.21;0.62;242.49;10.30;764;71;3362.00;127
8930;70;628258925;8930;221;9696;9819;10.10;0.61;242.46;10.30;766;71;3363.00;123
8932;70;628258936;8932;224;9697;9820;9.99;0.61;242.48;10.32;765;71;3364.00;123
8936;70;628258946;8936;230;9698;9820;9.87;0.60;242.46;10.33;762;71;3365.00;122
8938;70;628258957;8938;236;9702;9823;9.78;0.59;242.43;10.34;764;71;3366.00;121
8940;70;628258968;8940;240;9702;9823;9.72;0.59;242.47;10.34;762;71;3367.00;121
8945;70;628258978;8945;251;9704;9823;9.56;0.58;242.47;10.36;759;71;3368.00;119
8946;70;628258989;8946;255;9704;9823;9.48;0.58;242.47;10.36;758;71;3369.00;119
8947;70;628258999;8947;266;9710;9829;9.37;0.57;242.51;10.36;763;71;3370.00;119
8948;70;628259009;8948;270;9711;9829;9.31;0.57;242.50;10.38;763;71;3371.00;118
8949;70;628259019;8949;267;9712;9829;9.19;0.56;242.58;10.39;763;71;3372.00;117
8949;70;628259030;8949;272;9713;9829;9.11;0.56;242.58;10.40;764;71;3373.00;116
8951;70;628259039;8951;277;9716;9833;8.96;0.55;242.60;10.40;765;71;3374.00;117
8953;70;628259049;8953;281;9719;9835;8.83;0.54;242.64;10.40;766;71;3375.00;116
8956;70;628259061;8956;290;9721;9835;8.67;0.53;242.69;10.42;765;71;3376.00;114
8958;70;628259071;8958;295;9723;9836;8.52;0.52;242.65;10.43;765;71;3377.00;113
8962;70;628259081;8962;297;9724;9836;8.33;0.51;242.65;10.44;762;71;3378.00;112
8962;70;628259091;8962;299;9724;9836;8.28;0.51;242.65;10.44;762;71;3379.00;112
8962;70;628259100;8962;305;9725;9836;8.26;0.51;242.65;10.45;763;71;3380.00;111
8967;70;628259110;8967;305;9726;9836;8.09;0.50;242.61;10.45;759;71;3381.00;110
8968;70;628259120;8968;304;9727;9836;8.01;0.49;242.59;10.46;759;71;3382.00;109
8973;70;628259129;8973;305;9727;9836;7.90;0.49;242.56;10.46;754;71;3383.00;109
8974;70;628259138;8974;312;9763;9906;7.96;0.49;242.54;10.43;789;71;3384.00;143
8978;70;628259158;8978;316;9767;9907;7.86;0.48;242.48;10.43;789;71;3385.00;140
8979;70;628259168;8979;315;9779;9907;7.77;0.48;242.47;10.45;800;71;3386.00;128
8980;70;628259177;8980;321;9784;9907;7.74;0.48;242.45;10.45;804;71;3387.00;123
8982;70;628259187;8982;331;9791;9907;7.71;0.47;242.43;10.45;809;71;3388.00;116
8984;70;628259196;8984;335;9796;9907;7.69;0.47;242.39;10.45;812;71;3389.00;111
8985;70;628259208;8985;335;9798;9907;7.65;0.47;242.39;10.45;813;71;3390.00;109
8987;70;628259217;8987;339;9801;9907;7.52;0.46;242.41;10.46;814;71;3391.00;106
8992;70;628259227;8992;337;9803;9908;7.34;0.45;242.38;10.46;811;71;3392.00;105
8995;70;628259236;8995;339;9804;9909;7.24;0.45;242.37;10.46;809;71;3393.00;105
8999;70;628259246;8999;344;9806;9909;7.12;0.44;242.37;10.47;807;71;3394.00;103
9003;70;628259256;9003;344;9809;9913;7.05;0.43;242.36;10.47;806;71;3395.00;104
9010;70;628259266;9010;348;9811;9913;6.89;0.42;242.36;10.48;801;71;3396.00;102
9016;70;628259276;9016;353;9812;9913;6.73;0.41;242.33;10.48;796;71;3397.00;101
9020;70;628259285;9020;360;9812;9913;6.56;0.40;242.36;10.48;792;71;3398.00;101
9021;70;628259294;9021;369;9817;9919;6.45;0.40;242.34;10.48;796;71;3399.00;102
9022;70;628259304;9022;358;9818;9919;6.31;0.39;242.32;10.48;796;71;3400.00;101
9024;70;628259317;9024;352;9818;9919;6.18;0.38;242.32;10.48;794;71;3401.00;101
9028;70;628259326;9028;351;9821;9922;6.08;0.37;242.34;10.48;793;71;3402.00;101
9030;70;628259335;9030;344;9821;9922;6.06;0.37;242.35;10.48;791;71;3403.00;101
9032;70;628259344;9032;342;9822;9922;6.04;0.37;242.35;10.49;790;71;3404.00;100
9035;70;628259353;9035;347;9823;9923;6.03;0.37;242.35;10.49;788;71;3405.00;100
9038;70;628259362;9038;351;9824;9924;6.09;0.38;242.33;10.49;786;71;3406.00;100
9043;70;628259371;9043;345;9825;9924;6.08;0.37;242.34;10.49;782;71;3407.00;99
9045;70;628259382;9045;342;9834;9937;6.22;0.38;242.34;10.48;789;71;3408.00;103
9048;70;628259392;9048;334;9834;9937;6.23;0.38;242.36;10.48;786;71;3409.00;103
9050;70;628259402;9050;333;9836;9937;6.29;0.39;242.36;10.48;786;71;3410.00;101
9053;70;628259411;9053;318;9837;9938;6.37;0.39;242.38;10.48;784;71;3411.00;101
9057;70;628259421;9057;311;9838;9938;6.46;0.40;242.39;10.48;781;71;3412.00;100
9060;70;628259431;9060;305;9840;9942;6.55;0.40;242.37;10.48;780;71;3413.00;102
9064;70;628259446;9064;297;9841;9942;6.60;0.41;242.36;10.48;777;71;3414.00;101
9067;70;628259461;9067;302;9845;9946;6.80;0.42;242.35;10.47;778;71;3415.00;101
9070;70;628259475;9070;293;9845;9946;6.88;0.42;242.33;10.47;775;71;3416.00;101
9075;70;628259497;9075;289;9845;9946;6.97;0.43;242.44;10.47;770;71;3417.00;101
9078;70;628259510;9078;280;9845;9946;7.10;0.43;242.43;10.47;767;71;3418.00;101
9081;70;628259522;9081;268;9845;9946;7.24;0.44;242.46;10.47;764;71;3419.00;101
9084;70;628259541;9084;265;9871;9980;7.55;0.46;242.48;10.45;787;71;3420.00;109
9085;70;628259570;9085;263;9871;9980;7.66;0.47;242.49;10.45;786;71;3421.00;109
9087;70;628259598;9087;258;9872;9980;7.78;0.48;242.50;10.45;785;71;3422.00;108
9091;70;628259614;9091;249;9873;9980;7.84;0.48;242.52;10.44;782;71;3423.00;107
9097;70;628259640;9097;246;9874;9980;7.85;0.48;242.52;10.44;777;71;3424.00;106
9100;70;628259657;9100;242;9874;9980;7.91;0.48;242.48;10.44;774;71;3425.00;106
9101;70;628259669;9101;242;9874;9981;7.96;0.49;242.49;10.44;773;71;3426.00;107
9104;70;628259680;9104;238;9874;9981;8.00;0.49;242.48;10.44;770;71;3427.00;107
9107;70;628259694;9107;241;9878;9987;8.04;0.49;242.47;10.44;771;71;3428.00;109
9111;70;628259707;9111;245;9879;9988;8.08;0.49;242.52;10.44;768;71;3429.00;109
9114;70;628259721;9114;249;9880;9988;8.09;0.49;242.54;10.44;766;71;3430.00;108
9119;70;628259734;9119;251;9880;9988;8.16;0.50;242.57;10.44;761;71;3431.00;108
9122;70;628259747;9122;254;9883;9992;8.26;0.50;242.56;10.44;761;71;3432.00;109
9124;70;628259759;9124;253;9883;9992;8.35;0.51;242.58;10.44;759;71;3433.00;109
9126;70;628259771;9126;247;9883;9992;8.43;0.51;242.56;10.44;757;71;3434.00;109
9130;70;628259782;9130;244;9884;9993;8.48;0.52;242.56;10.43;754;71;3435.00;109
9132;70;628259796;9132;245;9887;9997;8.57;0.52;242.56;10.43;755;71;3436.00;110
9135;70;628259812;9135;239;9887;9997;8.58;0.53;242.58;10.43;752;71;3437.00;110
9138;70;628259828;9138;237;9889;10000;8.67;0.53;242.60;10.43;751;71;3438.00;111
9143;70;628259843;9143;241;9890;10000;8.69;0.53;242.63;10.43;747;71;3439.00;110
9146;70;628259856;9146;240;9890;10000;8.72;0.53;242.63;10.43;744;71;3440.00;110
9152;70;628259869;9152;238;9890;10000;8.72;0.53;242.72;10.43;738;71;3441.00;110
9157;70;628259881;9157;236;9893;10004;8.76;0.53;242.69;10.43;736;71;3442.00;111
9164;70;628259893;9164;238;9893;10004;8.72;0.53;242.67;10.43;729;71;3443.00;111
9166;70;628259904;9166;234;9894;10004;8.74;0.53;242.68;10.42;728;71;3444.00;110
9172;70;628259916;9172;235;9894;10004;8.71;0.53;242.66;10.42;722;71;3445.00;110
9176;70;628259927;9176;239;9894;10005;8.70;0.53;242.67;10.42;718;71;3446.00;111
9179;70;628259938;9179;227;9895;10006;8.62;0.52;242.71;10.42;716;71;3447.00;111
9182;70;628259951;9182;215;9895;10006;8.60;0.52;242.68;10.42;713;71;3448.00;111
9185;70;628259963;9185;210;9896;10007;8.65;0.52;242.71;10.42;711;71;3449.00;111
9189;70;628259977;9189;202;9896;10007;8.69;0.53;242.76;10.42;707;71;3450.00;111
9193;70;628259991;9193;201;9896;10007;8.81;0.53;242.83;10.42;703;71;3451.00;111
9196;70;628260009;9196;195;9896;10007;8.91;0.54;242.98;10.42;700;71;3452.00;111
9199;70;628260026;9199;198;9896;10007;9.09;0.55;243.01;10.42;697;71;3453.00;111
9203;70;628260042;9203;195;9896;10007;9.18;0.56;243.09;10.42;693;71;3454.00;111
9205;70;628260056;9205;195;9896;10007;9.23;0.56;243.12;10.42;691;71;3455.00;111
9207;70;628260069;9207;198;9967;10134;9.44;0.58;243.13;10.35;760;71;3456.00;167
9210;70;628260092;9210;174;9969;10135;9.59;0.59;243.15;10.35;759;71;3457.00;166
9213;70;628260106;9213;157;9976;10135;9.77;0.60;243.17;10.34;763;71;3458.00;159
9213;70;628260119;9213;148;9978;10135;9.93;0.61;243.17;10.34;765;71;3459.00;157
9216;70;628260132;9216;139;9982;10135;10.09;0.62;243.21;10.34;766;71;3460.00;153
9217;70;628260146;9217;137;9987;10135;10.26;0.63;243.24;10.33;770;71;3461.00;148
9221;70;628260160;9221;125;9991;10135;10.36;0.64;243.30;10.33;770;71;3462.00;144
9224;70;628260179;9224;124;9995;10135;10.44;0.64;243.30;10.33;771;71;3463.00;140
9226;70;628260196;9226;123;10000;10136;10.44;0.64;243.34;10.33;774;71;3464.00;136
9231;70;628260231;9231;126;10003;10138;10.49;0.64;243.37;10.33;772;71;3465.00;135
9234;70;628260249;9234;125;10006;10138;10.50;0.64;243.40;10.33;772;71;3466.00;132
9236;70;628260264;9236;129;10007;10139;10.58;0.65;243.39;10.33;771;71;3467.00;132
9239;70;628260281;9239;135;10009;10139;10.61;0.65;243.39;10.33;770;71;3468.00;130
9243;70;628260298;9243;132;10010;10139;10.72;0.66;243.41;10.33;767;71;3469.00;129
9244;70;628260313;9244;135;10012;10139;10.82;0.66;243.43;10.33;768;71;3470.00;127
9247;70;628260328;9247;142;10015;10143;10.86;0.66;243.48;10.33;768;71;3471.00;128
9248;70;628260341;9248;141;10017;10143;10.96;0.67;243.49;10.33;769;71;3472.00;126
9249;71;628260356;9249;141;10017;10143;11.00;0.67;243.49;10.33;768;72;3473.00;126
9254;71;628260378;9254;146;10019;10146;11.06;0.68;243.49;10.33;765;72;3474.00;127
9255;71;628260402;9255;149;10021;10146;11.11;0.68;243.56;10.33;766;72;3475.00;125
9261;71;628260425;9261;151;10022;10146;11.11;0.68;243.65;10.33;761;72;3476.00;124
9263;71;628260442;9263;148;10026;10150;11.17;0.68;243.68;10.32;763;72;3477.00;124
9267;71;628260459;9267;152;10027;10151;11.34;0.69;243.71;10.32;760;72;3478.00;124
9271;71;628260477;9271;156;10028;10151;11.43;0.69;243.74;10.32;757;72;3479.00;123
9273;71;628260497;9273;160;10032;10156;11.46;0.70;243.80;10.32;759;72;3480.00;124
9277;72;628260512;9277;160;10032;10156;11.51;0.70;243.82;10.32;755;73;3481.00;124
9279;72;628260545;9279;162;10032;10156;11.53;0.70;243.83;10.32;753;73;3482.00;124
9281;72;628260560;9281;162;10033;10157;11.57;0.70;243.84;10.32;752;73;3483.00;124
9284;72;628260584;9284;163;10033;10157;11.57;0.70;243.85;10.32;749;73;3484.00;124
9285;72;628260597;9285;164;10037;10163;11.58;0.70;243.89;10.31;752;73;3485.00;126
9289;72;628260609;9289;162;10037;10163;11.58;0.70;243.89;10.31;748;73;3486.00;126
9293;72;628260622;9293;160;10038;10164;11.65;0.71;243.91;10.31;745;73;3487.00;126
9298;72;628260640;9298;161;10038;10164;11.62;0.71;243.91;10.31;740;73;3488.00;126
9302;72;628260653;9302;160;10038;10164;11.58;0.70;243.99;10.31;736;73;3489.00;126
9303;72;628260665;9303;161;10038;10164;11.59;0.70;243.97;10.31;735;73;3490.00;126
9305;72;628260678;9305;160;10038;10164;11.55;0.70;244.00;10.31;733;73;3491.00;126
9308;72;628260690;9308;160;10047;10176;11.54;0.70;244.05;10.30;739;73;3492.00;129
9310;72;628260702;9310;154;10047;10176;11.52;0.70;244.12;10.30;737;73;3493.00;129
9313;72;628260714;9313;156;10049;10176;11.58;0.70;244.11;10.30;736;73;3494.00;127
9317;72;628260727;9317;156;10049;10176;11.68;0.71;244.10;10.30;732;73;3495.00;127
9321;72;628260740;9321;154;10049;10176;11.63;0.71;244.12;10.30;728;73;3496.00;127
9325;72;628260755;9325;153;10050;10176;11.63;0.70;244.08;10.43;725;73;3497.00;126
9326;72;628260769;9326;150;10053;10180;11.61;0.70;244.11;10.43;727;73;3498.00;127
9330;72;628260781;9330;148;10053;10180;11.63;0.70;244.15;10.43;723;73;3499.00;127
9332;72;628260795;9332;150;10056;10184;11.64;0.70;244.13;10.43;724;73;3500.00;128
9335;72;628260814;9335;148;10058;10185;11.62;0.70;244.13;10.43;723;73;3501.00;127
9341;72;628260827;9341;142;10058;10185;11.51;0.70;244.14;10.43;717;73;3502.00;127
9344;72;628260839;9344;142;10058;10185;11.49;0.70;244.12;10.43;714;73;3503.00;127
9348;72;628260850;9348;146;10067;10198;11.42;0.69;244.09;10.42;719;73;3504.00;131
9350;72;628260864;9350;137;10068;10198;11.39;0.69;244.11;10.43;718;73;3505.00;130
9354;72;628260877;9354;135;10070;10198;11.41;0.69;244.17;10.45;716;73;3506.00;128
9357;72;628260889;9357;131;10071;10199;11.42;0.69;244.23;10.44;714;73;3507.00;128
9359;72;628260904;9359;127;10071;10200;11.48;0.69;244.26;10.44;712;73;3508.00;129
9360;72;628260915;9360;124;10071;10200;11.55;0.70;244.28;10.44;711;73;3509.00;129
9363;72;628260928;9363;122;10074;10206;11.59;0.70;244.27;10.44;711;73;3510.00;132
9365;72;628260940;9365;125;10075;10206;11.61;0.70;244.25;10.44;710;73;3511.00;131
9369;72;628260959;9369;127;10076;10206;11.70;0.71;244.23;10.44;707;73;3512.00;130
9371;72;628260971;9371;122;10077;10206;11.66;0.71;244.24;10.57;706;73;3513.00;129
9374;72;628260982;9374;126;10081;10212;11.61;0.70;244.23;10.57;707;73;3514.00;131
9377;72;628260996;9377;129;10081;10212;11.52;0.70;244.18;10.57;704;73;3515.00;131
9378;72;628261009;9378;134;10082;10212;11.43;0.69;244.17;10.57;704;73;3516.00;130
9380;72;628261021;9380;134;10084;10212;11.36;0.69;244.22;10.57;704;73;3517.00;128
9382;72;628261031;9382;141;10087;10216;11.29;0.69;244.24;10.57;705;73;3518.00;129
9385;72;628261042;9385;142;10090;10219;11.19;0.68;244.25;10.56;705;73;3519.00;129
9389;72;628261059;9389;146;10090;10219;11.15;0.68;244.29;10.56;701;73;3520.00;129
9392;72;628261069;9392;154;10091;10220;11.11;0.68;244.26;10.56;699;73;3521.00;129
9393;72;628261080;9393;161;10091;10220;11.04;0.67;244.25;10.56;698;73;3522.00;129
9395;72;628261090;9395;158;10092;10220;10.95;0.67;244.31;10.70;697;73;3523.00;128
9395;72;628261100;9395;163;10092;10220;10.95;0.67;244.31;10.70;697;73;3524.00;128
9397;72;628261110;9397;167;10092;10220;10.94;0.67;244.31;10.70;695;73;3525.00;128
9401;72;628261120;9401;172;10093;10220;10.97;0.67;244.30;10.71;692;73;3526.00;127
9406;72;628261130;9406;176;10093;10220;10.97;0.67;244.33;10.71;687;73;3527.00;127
9409;72;628261140;9409;185;10126;10290;11.02;0.67;244.31;10.67;717;73;3528.00;164
9411;72;628261156;9411;190;10129;10291;10.94;0.67;244.31;10.70;718;73;3529.00;162
9414;72;628261165;9414;193;10136;10291;10.91;0.67;244.35;10.69;722;73;3530.00;155
9417;72;628261176;9417;197;10143;10291;10.88;0.67;244.40;10.70;726;73;3531.00;148
9419;72;628261185;9419;205;10148;10291;10.79;0.66;244.40;10.71;729;73;3532.00;143
9423;72;628261200;9423;208;10151;10291;10.73;0.66;244.36;10.71;728;73;3533.00;140
9423;72;628261215;9423;214;10153;10291;10.68;0.66;244.36;10.71;730;73;3534.00;138
9426;72;628261225;9426;215;10159;10291;10.53;0.64;244.33;10.72;733;73;3535.00;132
9428;72;628261234;9428;217;10164;10292;10.43;0.64;244.28;10.73;736;73;3536.00;128
9429;72;628261244;9429;222;10167;10293;10.38;0.64;244.27;10.73;738;73;3537.00;126
9431;72;628261253;9431;224;10170;10293;10.25;0.63;244.25;10.75;739;73;3538.00;123
9433;72;628261263;9433;234;10173;10297;10.11;0.62;244.22;10.75;740;73;3539.00;124
9437;72;628261274;9437;235;10175;10297;9.92;0.61;244.20;10.77;738;73;3540.00;122
9437;72;628261283;9437;237;10176;10297;9.78;0.60;244.20;10.79;739;73;3541.00;121
9438;72;628261292;9438;244;10177;10297;9.65;0.59;244.18;10.79;739;73;3542.00;120
9441;72;628261301;9441;253;10183;10303;9.63;0.59;244.16;10.80;742;73;3543.00;120
9442;72;628261312;9442;261;10184;10303;9.56;0.59;244.14;10.80;742;73;3544.00;119
9446;72;628261321;9446;264;10186;10303;9.37;0.58;244.12;10.82;740;73;3545.00;117
9449;72;628261330;9449;271;10189;10306;9.22;0.57;244.09;10.81;740;73;3546.00;117
9450;72;628261339;9450;276;10190;10306;9.01;0.55;244.07;10.81;740;73;3547.00;116
9451;72;628261353;9451;281;10191;10306;8.75;0.54;244.05;10.83;740;73;3548.00;115
9454;72;628261368;9454;283;10191;10307;8.53;0.53;244.08;10.83;737;73;3549.00;116
9456;72;628261377;9456;278;10194;10308;8.36;0.52;244.05;10.84;738;73;3550.00;114
9460;72;628261386;9460;282;10194;10308;8.23;0.51;244.01;10.84;734;73;3551.00;114
9462;72;628261395;9462;290;10206;10321;8.07;0.50;243.97;10.83;744;73;3552.00;115
9465;72;628261404;9465;290;10207;10321;7.92;0.49;243.98;10.84;742;73;3553.00;114
9469;72;628261413;9469;294;10207;10321;7.78;0.48;244.00;10.84;738;73;3554.00;114
9470;72;628261422;9470;295;10209;10323;7.72;0.48;243.98;10.84;739;73;3555.00;114
9471;72;628261430;9471;302;10210;10323;7.71;0.47;243.98;10.85;739;73;3556.00;113
9475;72;628261439;9475;305;10213;10327;7.68;0.47;243.94;10.84;738;73;3557.00;114
9479;72;628261448;9479;313;10213;10327;7.61;0.47;243.93;10.84;734;73;3558.00;114
9479;72;628261456;9479;311;10220;10331;7.52;0.46;243.93;10.87;741;73;3559.00;111
9480;72;628261464;9480;317;10220;10331;7.49;0.46;243.91;10.87;740;73;3560.00;111
9483;72;628261473;9483;322;10221;10331;7.38;0.45;243.90;10.88;738;73;3561.00;110
9484;72;628261486;9484;324;10221;10331;7.25;0.44;243.93;10.88;737;73;3562.00;110
9486;72;628261494;9486;314;10221;10331;7.10;0.43;243.90;10.88;735;73;3563.00;110
9489;72;628261511;9489;306;10231;10343;7.08;0.43;243.91;10.88;742;73;3564.00;112
9490;72;628261525;9490;300;10232;10343;6.98;0.43;243.89;10.89;742;73;3565.00;111
9493;72;628261538;9493;291;10234;10343;6.90;0.42;243.89;10.89;741;73;3566.00;109
9496;72;628261549;9496;286;10237;10343;6.77;0.41;243.93;10.92;741;73;3567.00;106
9498;72;628261566;9498;284;10237;10343;6.72;0.41;243.93;10.92;739;73;3568.00;106
9500;72;628261579;9500;278;10238;10343;6.64;0.41;243.94;10.93;738;73;3569.00;105
9503;72;628261604;9503;268;10238;10344;6.51;0.40;243.93;10.93;735;73;3570.00;106
9504;72;628261617;9504;264;10238;10344;6.47;0.40;243.94;10.93;734;73;3571.00;106
9506;72;628261632;9506;265;10244;10350;6.61;0.41;243.96;10.93;738;73;3572.00;106
9509;72;628261646;9509;253;10247;10351;6.71;0.41;243.98;10.94;738;73;3573.00;104
9509;72;628261657;9509;250;10247;10351;6.87;0.42;243.98;10.94;738;73;3574.00;104
9513;72;628261673;9513;252;10248;10351;6.93;0.43;244.00;10.94;735;73;3575.00;103
9517;72;628261683;9517;254;10251;10355;7.00;0.43;243.97;10.94;734;73;3576.00;104
9522;72;628261693;9522;246;10254;10355;7.06;0.43;244.02;10.96;732;73;3577.00;101
9526;72;628261704;9526;242;10254;10355;7.15;0.44;244.04;10.96;728;73;3578.00;101
9528;72;628261714;9528;240;10255;10356;7.30;0.45;244.05;10.96;727;73;3579.00;101
9532;72;628261724;9532;243;10259;10360;7.45;0.46;244.04;10.96;727;73;3580.00;101
9535;72;628261735;9535;236;10259;10360;7.58;0.46;244.03;10.96;724;73;3581.00;101
9538;72;628261745;9538;227;10261;10363;7.72;0.47;244.08;10.96;723;73;3582.00;102
9539;72;628261755;9539;220;10262;10363;7.86;0.48;244.07;10.96;723;73;3583.00;101
9542;72;628261766;9542;223;10262;10363;7.97;0.49;244.11;10.96;720;73;3584.00;101
9549;72;628261776;9549;224;10262;10363;8.04;0.49;244.15;10.96;713;73;3585.00;101
9553;72;628261787;9553;223;10265;10367;8.18;0.50;244.17;10.95;712;73;3586.00;102
9556;72;628261797;9556;226;10265;10367;8.25;0.50;244.24;10.95;709;73;3587.00;102
9562;72;628261807;9562;219;10266;10367;8.25;0.50;244.23;10.95;704;73;3588.00;101
9564;72;628261817;9564;215;10266;10367;8.30;0.51;244.24;10.95;702;73;3589.00;101
9568;72;628261827;9568;207;10266;10368;8.25;0.50;244.28;10.95;698;73;3590.00;102
9572;72;628261837;9572;205;10267;10369;8.26;0.50;244.27;10.95;695;73;3591.00;102
9575;72;628261848;9575;196;10267;10369;8.29;0.51;244.27;10.95;692;73;3592.00;102
9579;72;628261860;9579;189;10268;10370;8.29;0.51;244.30;10.95;689;73;3593.00;102
9582;72;628261870;9582;180;10268;10370;8.37;0.51;244.29;10.95;686;73;3594.00;102
9586;72;628261880;9586;174;10268;10370;8.36;0.51;244.29;10.95;682;73;3595.00;102
9591;72;628261891;9591;174;10268;10370;8.40;0.51;244.28;10.95;677;73;3596.00;102
9594;72;628261901;9594;173;10269;10370;8.47;0.52;244.26;11.09;675;73;3597.00;101
9598;72;628261911;9598;175;10269;10370;8.52;0.52;244.25;11.09;671;73;3598.00;101
9604;72;628261921;9604;176;10269;10370;8.58;0.52;244.25;11.09;665;73;3599.00;101
9606;72;628261935;9606;214;10383;10623;8.76;0.55;244.27;10.97;777;73;3600.00;240
9612;72;628261973;9612;210;10389;10624;8.83;0.55;244.22;10.96;777;73;3601.00;235
9617;72;628261985;9617;201;10399;10624;8.89;0.55;244.21;10.95;782;73;3602.00;225
9620;72;628261997;9620;194;10404;10624;8.96;0.56;244.24;10.95;784;73;3603.00;220
9624;72;628262009;9624;194;10409;10624;8.97;0.56;244.20;10.95;785;73;3604.00;215
9627;72;628262020;9627;197;10412;10624;9.04;0.56;244.24;10.94;785;73;3605.00;212
9632;72;628262033;9632;203;10422;10624;9.05;0.56;244.27;10.94;790;73;3606.00;202
9635;72;628262044;9635;206;10426;10624;9.03;0.56;244.27;10.94;791;73;3607.00;198
9638;72;628262056;9638;209;10430;10625;9.02;0.56;244.29;10.94;792;73;3608.00;195
9642;72;628262069;9642;215;10434;10626;9.00;0.56;244.35;10.94;792;73;3609.00;192
9643;72;628262081;9643;214;10438;10626;8.98;0.56;244.36;10.94;795;73;3610.00;188
9647;72;628262093;9647;209;10443;10627;8.97;0.56;244.39;10.94;796;73;3611.00;184
9651;72;628262105;9651;219;10449;10627;8.93;0.55;244.40;10.94;798;73;3612.00;178
9654;72;628262123;9654;223;10452;10627;8.95;0.55;244.40;10.94;798;73;3613.00;175
9658;72;628262135;9658;226;10456;10627;8.90;0.55;244.45;10.94;798;73;3614.00;171
9661;72;628262147;9661;230;10461;10631;8.85;0.55;244.47;10.94;800;73;3615.00;170
9663;72;628262166;9663;237;10464;10631;8.83;0.54;244.53;10.94;801;73;3616.00;167
9666;72;628262183;9666;237;10466;10631;8.89;0.55;244.52;10.94;800;73;3617.00;165
9674;72;628262197;9674;235;10469;10634;8.87;0.54;244.55;10.94;795;73;3618.00;165
9676;72;628262216;9676;237;10470;10634;8.96;0.55;244.52;10.94;794;73;3619.00;164
9683;72;628262235;9683;235;10474;10634;8.89;0.54;244.59;10.95;791;73;3620.00;160
9686;72;628262256;9686;231;10478;10638;8.89;0.54;244.60;10.94;792;73;3621.00;160
9687;72;628262269;9687;230;10480;10639;8.98;0.55;244.62;10.94;793;73;3622.00;159
9692;72;628262282;9692;234;10481;10639;9.06;0.55;244.76;10.94;789;73;3623.00;158
9693;72;628262300;9693;237;10483;10643;9.23;0.56;244.75;10.94;790;73;3624.00;160
9699;72;628262313;9699;238;10488;10643;9.30;0.57;244.74;10.95;789;73;3625.00;155
9704;72;628262325;9704;218;10488;10643;9.43;0.57;244.78;10.95;784;73;3626.00;155
9708;72;628262339;9708;206;10490;10644;9.60;0.58;244.76;10.95;782;73;3627.00;154
9711;72;628262352;9711;192;10491;10644;9.74;0.59;244.81;10.95;780;73;3628.00;153
9713;72;628262365;9713;185;10495;10650;9.86;0.60;244.79;10.94;782;73;3629.00;155
9715;72;628262380;9715;180;10495;10650;10.01;0.61;244.82;10.94;780;73;3630.00;155
9718;72;628262393;9718;180;10496;10651;10.10;0.61;244.83;10.95;778;73;3631.00;155
9720;72;628262406;9720;176;10496;10651;10.24;0.62;244.87;10.95;776;73;3632.00;155
9723;72;628262418;9723;177;10496;10651;10.35;0.63;244.93;10.95;773;73;3633.00;155
9723;72;628262431;9723;173;10498;10651;10.47;0.64;244.93;10.95;775;73;3634.00;153
9725;72;628262449;9725;172;10498;10651;10.62;0.65;244.93;10.95;773;73;3635.00;153
9728;72;628262468;9728;171;10506;10663;10.71;0.65;244.93;10.94;778;73;3636.00;157
9730;72;628262482;9730;170;10507;10663;10.81;0.66;244.95;10.94;777;73;3637.00;156
9731;72;628262495;9731;167;10509;10663;10.92;0.66;244.94;10.94;778;73;3638.00;154
9734;72;628262507;9734;165;10511;10663;11.05;0.67;245.03;10.94;777;73;3639.00;152
9737;72;628262520;9737;160;10512;10663;11.10;0.67;245.00;10.95;775;73;3640.00;151
9740;72;628262533;9740;163;10513;10663;11.27;0.68;244.98;10.95;773;73;3641.00;150
9744;72;628262547;9744;165;10516;10667;11.35;0.69;244.99;10.94;772;73;3642.00;151
9749;72;628262560;9749;163;10517;10667;11.43;0.69;245.01;10.94;768;73;3643.00;150
9754;72;628262573;9754;167;10519;10671;11.48;0.70;245.00;10.94;765;73;3644.00;152
9758;72;628262586;9758;164;10521;10673;11.52;0.70;245.04;10.94;763;73;3645.00;152
9759;72;628262600;9759;172;10524;10673;11.56;0.70;245.03;10.94;765;73;3646.00;149
9764;72;628262612;9764;167;10525;10673;11.52;0.70;245.11;10.94;761;73;3647.00;148
9769;72;628262625;9769;169;10534;10686;11.53;0.70;245.19;10.93;765;73;3648.00;152
9772;72;628262643;9772;167;10534;10686;11.59;0.71;245.16;10.93;762;73;3649.00;152
9775;72;628262655;9775;168;10534;10686;11.62;0.71;245.22;10.93;759;73;3650.00;152
9779;72;628262672;9779;171;10535;10687;11.68;0.71;245.25;10.93;756;73;3651.00;152
9781;72;628262683;9781;168;10536;10688;11.62;0.71;245.26;11.07;755;73;3652.00;152
9782;72;628262700;9782;170;10536;10688;11.67;0.71;245.27;11.07;754;73;3653.00;152
9787;72;628262716;9787;166;10538;10691;11.62;0.71;245.25;11.07;751;73;3654.00;153
9788;72;628262728;9788;168;10538;10691;11.58;0.71;245.24;11.07;750;73;3655.00;153
9790;72;628262743;9790;169;10539;10691;11.54;0.70;245.25;11.07;749;73;3656.00;152
9796;72;628262754;9796;167;10539;10691;11.49;0.70;245.23;11.07;743;73;3657.00;152
9798;72;628262765;9798;160;10543;10697;11.40;0.69;245.21;11.07;745;73;3658.00;154
9801;72;628262776;9801;162;10543;10697;11.35;0.69;245.22;11.07;742;73;3659.00;154
9802;72;628262789;9802;167;10544;10697;11.33;0.69;245.24;11.06;742;73;3660.00;153
9807;72;628262799;9807;171;10544;10697;11.30;0.69;245.25;11.06;737;73;3661.00;153
9809;72;628262810;9809;172;10547;10701;11.27;0.69;245.23;11.06;738;73;3662.00;154
9811;72;628262822;9811;169;10548;10702;11.29;0.69;245.28;11.06;737;73;3663.00;154
9815;72;628262832;9815;170;10548;10702;11.23;0.68;245.25;11.06;733;73;3664.00;154
9818;72;628262843;9818;173;10549;10703;11.17;0.68;245.24;11.06;731;73;3665.00;154
9818;72;628262853;9818;174;10549;10703;11.10;0.68;245.24;11.06;731;73;3666.00;154
9821;72;628262862;9821;183;10550;10703;11.05;0.67;245.21;11.20;729;73;3667.00;153
9824;72;628262877;9824;181;10550;10703;10.96;0.67;245.21;11.20;726;73;3668.00;153
9829;72;628262889;9829;188;10551;10703;10.91;0.67;245.22;11.21;722;73;3669.00;152
9834;72;628262899;9834;184;10551;10703;10.82;0.66;245.20;11.21;717;73;3670.00;152
9837;72;628262910;9837;180;10551;10703;10.82;0.66;245.26;11.21;714;73;3671.00;152
9845;72;628262920;9845;182;10580;10773;10.76;0.66;245.22;11.18;735;73;3672.00;193
9846;72;628262935;9846;178;10580;10774;10.77;0.66;245.24;11.18;734;73;3673.00;194
9850;72;628262945;9850;176;10588;10774;10.85;0.66;245.24;11.31;738;73;3674.00;186
9855;72;628262955;9855;174;10592;10774;10.81;0.66;245.19;11.34;737;73;3675.00;182
9855;72;628262967;9855;169;10596;10774;10.86;0.66;245.19;11.34;741;73;3676.00;178
9859;72;628262978;9859;162;10601;10774;10.86;0.66;245.19;11.48;742;73;3677.00;173
9861;72;628262989;9861;157;10604;10774;10.93;0.66;245.21;11.48;743;73;3678.00;170
9865;72;628263000;9865;155;10607;10774;11.01;0.67;245.18;11.48;742;73;3679.00;167
9867;72;628263010;9867;154;10610;10775;11.00;0.67;245.23;11.62;743;73;3680.00;165
9869;72;628263020;9869;150;10613;10776;11.05;0.67;245.22;11.62;744;73;3681.00;163
9870;72;628263031;9870;146;10615;10776;11.09;0.67;245.24;11.62;745;73;3682.00;161
9872;72;628263042;9872;147;10618;10780;11.13;0.68;245.22;11.61;746;73;3683.00;162
9873;72;628263053;9873;146;10618;10780;11.10;0.68;245.21;11.61;745;73;3684.00;162
9875;72;628263063;9875;149;10618;10780;11.07;0.67;245.18;11.61;743;73;3685.00;162
9877;72;628263074;9877;154;10618;10780;11.00;0.67;245.20;11.61;741;73;3686.00;162
9879;72;628263084;9879;163;10622;10786;10.89;0.66;245.17;11.62;743;73;3687.00;164
9882;72;628263095;9882;169;10623;10786;10.79;0.66;245.19;11.62;741;73;3688.00;163
9882;72;628263105;9882;173;10623;10786;10.69;0.65;245.19;11.62;741;73;3689.00;163
9883;72;628263117;9883;175;10628;10792;10.61;0.65;245.17;11.62;745;73;3690.00;164
9884;72;628263128;9884;182;10630;10792;10.50;0.64;245.15;11.62;746;73;3691.00;162
9888;72;628263143;9888;187;10632;10792;10.38;0.63;245.10;11.63;744;73;3692.00;160
9892;72;628263154;9892;192;10634;10793;10.27;0.62;245.06;11.63;742;73;3693.00;159
9895;72;628263164;9895;199;10636;10794;10.20;0.62;245.03;11.63;741;73;3694.00;158
9898;72;628263174;9898;207;10637;10794;10.03;0.61;244.98;11.64;739;73;3695.00;157
9900;72;628263185;9900;211;10648;10807;9.86;0.60;244.98;11.63;748;73;3696.00;159
9903;72;628263196;9903;221;10649;10807;9.68;0.59;244.96;11.64;746;73;3697.00;158
9904;72;628263207;9904;226;10649;10807;9.59;0.58;244.97;11.64;745;73;3698.00;158
9907;72;628263216;9907;232;10654;10808;9.49;0.57;244.94;11.65;747;73;3699.00;154
9907;72;628263227;9907;233;10655;10808;9.47;0.57;244.94;11.67;748;73;3700.00;153
9909;72;628263245;9909;237;10660;10812;9.51;0.58;244.93;11.67;751;73;3701.00;152
9911;72;628263256;9911;243;10661;10812;9.41;0.57;244.89;11.68;750;73;3702.00;151
9914;72;628263267;9914;252;10666;10816;9.28;0.57;244.85;11.69;752;73;3703.00;150
9918;72;628263277;9918;256;10667;10816;9.19;0.56;244.89;11.70;749;73;3704.00;149
9920;72;628263287;9920;261;10668;10816;9.11;0.56;244.84;11.71;748;73;3705.00;148
9922;72;628263297;9922;267;10669;10816;9.00;0.55;244.81;11.72;747;73;3706.00;147
9923;72;628263306;9923;279;10669;10816;8.90;0.54;244.81;11.72;746;73;3707.00;147
9925;72;628263315;9925;287;10680;10828;8.85;0.54;244.77;11.73;755;73;3708.00;148
9926;73;628263326;9926;289;10683;10828;8.74;0.54;244.77;11.75;757;74;3709.00;145
9927;73;628263340;9927;297;10686;10828;8.64;0.53;244.75;11.77;759;74;3710.00;142
9929;73;628263350;9929;300;10687;10828;8.51;0.52;244.73;11.78;758;74;3711.00;141
9930;73;628263359;9930;309;10690;10828;8.39;0.51;244.73;11.80;760;74;3712.00;138
9930;73;628263368;9930;313;10690;10828;8.27;0.51;244.73;11.80;760;74;3713.00;138
9930;73;628263376;9930;318;10691;10829;8.23;0.51;244.73;11.81;761;74;3714.00;138
9932;73;628263385;9932;314;10694;10829;8.16;0.50;244.71;11.83;762;74;3715.00;135
9933;73;628263395;9933;311;10699;10835;8.18;0.50;244.71;11.83;766;74;3716.00;136
9935;73;628263409;9935;306;10701;10836;8.12;0.50;244.77;11.83;766;74;3717.00;135
9938;73;628263418;9938;306;10702;10836;8.04;0.50;244.77;11.84;764;74;3718.00;134
9940;73;628263427;9940;302;10704;10836;8.00;0.49;244.73;11.86;764;74;3719.00;132
9941;73;628263438;9941;296;10707;10841;7.98;0.49;244.72;11.85;766;74;3720.00;134
9941;73;628263448;9941;288;10711;10841;7.90;0.49;244.72;11.88;770;74;3721.00;130
9944;73;628263457;9944;277;10711;10841;7.83;0.48;244.72;11.88;767;74;3722.00;130
9944;73;628263466;9944;276;10713;10842;7.88;0.49;244.72;11.89;769;74;3723.00;129
9944;73;628263476;9944;270;10717;10846;7.89;0.49;244.72;11.89;773;74;3724.00;129
9945;73;628263491;9945;268;10718;10846;7.94;0.49;244.71;11.89;773;74;3725.00;128
9948;73;628263501;9948;265;10721;10849;8.04;0.50;244.69;11.90;773;74;3726.00;128
9950;74;628263516;9950;262;10724;10849;8.08;0.50;244.75;11.91;774;75;3727.00;125
9951;74;628263541;9951;261;10724;10849;8.14;0.50;244.74;11.91;773;75;3728.00;125
9957;74;628263557;9957;263;10725;10849;8.19;0.50;244.65;11.92;768;75;3729.00;124
9958;74;628263578;9958;268;10729;10853;8.24;0.51;244.65;11.92;771;75;3730.00;124
9962;74;628263596;9962;270;10730;10853;8.24;0.50;244.63;11.92;768;75;3731.00;123
9967;74;628263614;9967;272;10732;10853;8.16;0.50;244.66;11.93;765;75;3732.00;121
9971;74;628263636;9971;273;10732;10853;8.09;0.49;244.64;11.93;761;75;3733.00;121
9972;74;628263653;9972;267;10733;10854;7.97;0.49;244.63;11.94;761;75;3734.00;121
9977;74;628263669;9977;266;10735;10856;7.88;0.48;244.62;11.94;758;75;3735.00;121
9980;74;628263684;9980;265;10736;10856;7.81;0.48;244.63;11.95;756;75;3736.00;120
9984;74;628263700;9984;262;10738;10857;7.71;0.47;244.63;11.96;754;75;3737.00;119
9988;74;628263715;9988;260;10738;10857;7.70;0.47;244.61;11.96;750;75;3738.00;119
9992;74;628263728;9992;258;10739;10857;7.67;0.47;244.60;11.97;747;75;3739.00;118
9994;74;628263740;9994;251;10739;10857;7.65;0.47;244.61;11.97;745;75;3740.00;118
9997;74;628263755;9997;246;10741;10857;7.68;0.47;244.61;11.99;744;75;3741.00;116
10000;74;628263770;10000;243;10742;10857;7.72;0.47;244.61;11.99;742;75;3742.00;115
10002;74;628263783;10002;236;10742;10857;7.73;0.47;244.63;11.99;740;75;3743.00;115
10005;74;628263793;10005;248;10808;10984;7.94;0.49;244.68;11.92;803;75;3744.00;176
10010;74;628263813;10010;243;10813;10985;7.89;0.49;244.69;11.92;803;75;3745.00;172
10011;74;628263823;10011;240;10822;10985;7.96;0.49;244.71;11.91;811;75;3746.00;163
10014;74;628263834;10014;233;10829;10985;8.03;0.50;244.72;11.92;815;75;3747.00;156
10020;74;628263845;10020;228;10835;10985;8.03;0.50;244.80;11.91;815;75;3748.00;150
10023;74;628263855;10023;224;10840;10985;8.02;0.49;244.81;11.91;817;75;3749.00;145
10025;74;628263871;10025;221;10844;10990;8.01;0.49;244.83;11.91;819;75;3750.00;146
10031;74;628263883;10031;221;10848;10990;7.99;0.49;244.84;11.90;817;75;3751.00;142
10034;74;628263894;10034;222;10851;10991;8.03;0.49;244.88;11.90;817;75;3752.00;140
10036;74;628263905;10036;215;10854;10992;8.04;0.49;244.87;11.90;818;75;3753.00;138
10040;74;628263916;10040;217;10857;10992;8.09;0.50;244.91;11.90;817;75;3754.00;135
10043;74;628263927;10043;217;10857;10993;8.17;0.50;244.89;11.90;814;75;3755.00;136
10050;74;628263939;10050;217;10859;10993;8.27;0.51;244.85;11.90;809;75;3756.00;134
10055;74;628263950;10055;224;10860;10993;8.30;0.51;244.87;11.90;805;75;3757.00;133
10058;74;628263961;10058;228;10862;10993;8.32;0.51;244.89;11.90;804;75;3758.00;131
10062;74;628263974;10062;232;10866;10997;8.41;0.52;244.89;11.90;804;75;3759.00;131
10066;74;628263986;10066;235;10867;10997;8.41;0.52;244.94;11.90;801;75;3760.00;130
10071;74;628263998;10071;230;10868;10997;8.42;0.52;245.02;11.90;797;75;3761.00;129
10076;74;628264009;10076;229;10871;11000;8.39;0.51;245.05;11.90;795;75;3762.00;129
10079;74;628264021;10079;224;10873;11000;8.42;0.52;245.03;11.90;794;75;3763.00;127
10083;74;628264033;10083;221;10874;11000;8.39;0.51;245.11;11.90;791;75;3764.00;126
10087;74;628264045;10087;218;10877;11004;8.50;0.52;245.16;11.90;790;75;3765.00;127
10092;74;628264057;10092;214;10878;11005;8.55;0.52;245.12;11.90;786;75;3766.00;127
10099;74;628264069;10099;208;10878;11005;8.58;0.53;245.12;11.90;779;75;3767.00;127
10103;74;628264082;10103;206;10880;11009;8.72;0.53;245.19;11.89;777;75;3768.00;129
10106;74;628264094;10106;206;10882;11009;8.83;0.54;245.16;11.89;776;75;3769.00;127
10111;74;628264106;10111;208;10882;11009;8.91;0.55;245.18;11.89;771;75;3770.00;127
10115;74;628264117;10115;208;10883;11010;8.93;0.55;245.23;11.89;768;75;3771.00;127
10119;74;628264129;10119;210;10884;11010;8.98;0.55;245.24;11.89;765;75;3772.00;126
10126;74;628264142;10126;213;10890;11016;8.97;0.55;245.30;12.04;764;75;3773.00;126
10130;74;628264156;10130;211;10890;11016;9.01;0.55;245.29;12.04;760;75;3774.00;126
10134;74;628264167;10134;213;10891;11017;9.09;0.55;245.29;12.04;757;75;3775.00;126
10138;75;628264186;10138;212;10891;11017;9.12;0.56;245.32;12.04;753;76;3776.00;126
10141;76;628264212;10141;208;10891;11017;9.13;0.56;245.34;12.04;750;77;3777.00;126
10145;76;628264235;10145;208;10892;11017;9.13;0.56;245.31;12.03;747;77;3778.00;125
10148;76;628264247;10148;207;10892;11017;9.11;0.55;245.33;12.03;744;77;3779.00;125
10155;76;628264272;10155;211;10916;11053;9.20;0.56;245.37;12.01;761;77;3780.00;137
10158;76;628264287;10158;215;10918;11053;9.23;0.56;245.40;12.01;760;77;3781.00;135
10161;76;628264299;10161;218;10919;11053;9.30;0.57;245.40;12.01;758;77;3782.00;134
10163;76;628264316;10163;220;10922;11053;9.35;0.57;245.44;12.00;759;77;3783.00;131
10169;76;628264328;10169;222;10922;11053;9.37;0.57;245.54;12.00;753;77;3784.00;131
10170;76;628264341;10170;224;10923;11053;9.35;0.57;245.54;12.00;753;77;3785.00;130
10173;76;628264353;10173;227;10926;11057;9.28;0.57;245.55;12.00;753;77;3786.00;131
10176;76;628264365;10176;223;10926;11057;9.21;0.56;245.57;12.00;750;77;3787.00;131
10177;76;628264377;10177;220;10930;11061;9.16;0.56;245.55;12.00;753;77;3788.00;131
10181;76;628264389;10181;218;10932;11062;9.07;0.56;245.60;12.14;751;77;3789.00;130
10183;76;628264400;10183;215;10932;11062;9.08;0.56;245.61;12.14;749;77;3790.00;130
10185;76;628264412;10185;205;10932;11062;9.14;0.56;245.61;12.14;747;77;3791.00;130
10187;76;628264423;10187;204;10942;11075;9.27;0.57;245.64;12.12;755;77;3792.00;133
10188;76;628264436;10188;207;10942;11075;9.31;0.57;245.63;12.12;754;77;3793.00;133
10189;76;628264448;10189;208;10943;11075;9.38;0.58;245.64;12.12;754;77;3794.00;132
10195;76;628264459;10195;208;10944;11076;9.49;0.58;245.61;12.12;749;77;3795.00;132
10200;76;628264471;10200;189;10944;11077;9.54;0.58;245.57;12.12;744;77;3796.00;133
10202;76;628264484;10202;173;10944;11077;9.68;0.59;245.55;12.12;742;77;3797.00;133
10210;76;628264495;10210;166;10946;11080;9.81;0.60;245.57;12.12;736;77;3798.00;134
10214;76;628264508;10214;156;10947;11080;9.92;0.61;245.56;12.12;733;77;3799.00;133
10217;76;628264522;10217;144;10947;11080;9.97;0.61;245.55;12.12;730;77;3800.00;133
10219;76;628264541;10219;138;10947;11080;10.04;0.61;245.60;12.12;728;77;3801.00;133
10223;77;628264554;10223;133;10951;11086;10.12;0.62;245.60;12.12;728;78;3802.00;135
10223;77;628264581;10223;135;10952;11086;10.18;0.62;245.60;12.25;729;78;3803.00;134
10225;77;628264594;10225;130;10953;11086;10.31;0.63;245.62;12.25;728;78;3804.00;133
10228;77;628264605;10228;130;10953;11086;10.38;0.63;245.64;12.25;725;78;3805.00;133
10231;77;628264617;10231;137;10956;11090;10.38;0.63;245.65;12.25;725;78;3806.00;134
10235;77;628264628;10235;135;10957;11091;10.38;0.63;245.72;12.25;722;78;3807.00;134
10239;77;628264640;10239;140;10957;11091;10.36;0.63;245.73;12.25;718;78;3808.00;134
10243;77;628264651;10243;136;10958;11092;10.42;0.63;245.73;12.25;715;78;3809.00;134
10244;77;628264670;10244;136;10958;11092;10.49;0.64;245.74;12.25;714;78;3810.00;134
10246;77;628264683;10246;140;10958;11092;10.52;0.64;245.75;12.25;712;78;3811.00;134
10248;77;628264695;10248;137;10958;11092;10.57;0.64;245.77;12.25;710;78;3812.00;134
10253;77;628264713;10253;142;10958;11092;10.56;0.64;245.82;12.25;705;78;3813.00;134
10256;77;628264727;10256;149;10958;11092;10.56;0.64;245.79;12.25;702;78;3814.00;134
10258;77;628264737;10258;153;10958;11092;10.49;0.64;245.77;12.25;700;78;3815.00;134
10259;77;628264748;10259;165;10994;11162;10.31;0.63;245.76;12.20;735;78;3816.00;168
10261;77;628264764;10261;165;10995;11163;10.36;0.63;245.77;12.20;734;78;3817.00;168
10265;77;628264774;10265;167;11000;11163;10.46;0.64;245.79;12.20;735;78;3818.00;163
10270;77;628264791;10270;169;11004;11163;10.51;0.64;245.81;12.33;734;78;3819.00;159
10273;77;628264802;10273;169;11008;11163;10.57;0.64;245.82;12.33;735;78;3820.00;155
10276;77;628264812;10276;168;11012;11163;10.62;0.65;245.86;12.33;736;78;3821.00;151
10279;77;628264822;10279;168;11018;11163;10.76;0.66;245.84;12.32;739;78;3822.00;145
10284;77;628264833;10284;166;11020;11163;10.78;0.66;245.81;12.32;736;78;3823.00;143
10285;77;628264850;10285;170;11023;11164;10.84;0.66;245.84;12.32;738;78;3824.00;141
10287;78;628264861;10287;169;11025;11166;10.82;0.66;245.84;12.32;738;79;3825.00;141
10290;78;628264881;10290;170;11026;11166;10.79;0.66;245.83;12.32;736;79;3826.00;140
10294;78;628264891;10294;176;11029;11170;10.79;0.66;245.90;12.32;735;79;3827.00;141
10297;78;628264902;10297;179;11029;11170;10.76;0.66;245.93;12.32;732;79;3828.00;141
10300;78;628264913;10300;182;11029;11170;10.73;0.66;245.94;12.32;729;79;3829.00;141
10301;78;628264923;10301;186;11029;11170;10.74;0.66;245.99;12.32;728;79;3830.00;141
10305;78;628264933;10305;191;11032;11176;10.75;0.66;246.03;12.31;727;79;3831.00;144
10306;78;628264945;10306;196;11032;11176;10.72;0.66;246.03;12.31;726;79;3832.00;144
10308;78;628264954;10308;199;11033;11176;10.77;0.66;246.02;12.31;725;79;3833.00;143
10314;78;628264965;10314;203;11035;11179;10.76;0.66;245.99;12.31;721;79;3834.00;144
10317;78;628264975;10317;200;11036;11179;10.71;0.65;245.96;12.31;719;79;3835.00;143
10319;78;628264985;10319;205;11036;11179;10.65;0.65;245.94;12.31;717;79;3836.00;143
10323;78;628264994;10323;208;11036;11180;10.59;0.65;245.97;12.31;713;79;3837.00;144
10328;78;628265006;10328;211;11037;11181;10.54;0.64;245.97;12.31;709;79;3838.00;144
10331;78;628265016;10331;214;11037;11181;10.49;0.64;245.95;12.31;706;79;3839.00;144
10333;78;628265027;10333;220;11052;11207;10.49;0.64;245.93;12.29;719;79;3840.00;155
10340;78;628265039;10340;214;11053;11207;10.50;0.64;245.89;12.29;713;79;3841.00;154
10343;78;628265048;10343;206;11056;11207;10.52;0.64;245.89;12.42;713;79;3842.00;151
10350;78;628265059;10350;200;11058;11208;10.50;0.64;245.80;12.42;708;79;3843.00;150
10354;78;628265070;10354;196;11058;11208;10.53;0.64;245.76;12.42;704;79;3844.00;150
10354;78;628265079;10354;194;11061;11212;10.64;0.65;245.76;12.44;707;79;3845.00;151
10359;78;628265090;10359;191;11063;11214;10.63;0.64;245.74;12.43;704;79;3846.00;151
10362;78;628265100;10362;190;11066;11218;10.67;0.65;245.74;12.43;704;79;3847.00;152
10364;78;628265110;10364;182;11067;11218;10.66;0.65;245.72;12.43;703;79;3848.00;151
10368;78;628265120;10368;176;11067;11218;10.76;0.65;245.69;12.43;699;79;3849.00;151
10371;78;628265129;10371;172;11067;11218;10.83;0.66;245.74;12.43;696;79;3850.00;151
10374;78;628265138;10374;177;11067;11218;10.91;0.66;245.74;12.43;693;79;3851.00;151
10377;78;628265147;10377;175;11077;11230;10.92;0.66;245.69;12.42;700;79;3852.00;153
10380;78;628265158;10380;173;11077;11230;10.83;0.66;245.65;12.42;697;79;3853.00;153
10382;78;628265167;10382;173;11078;11230;10.85;0.66;245.65;12.42;696;79;3854.00;152
10383;78;628265176;10383;175;11078;11230;10.79;0.66;245.63;12.42;695;79;3855.00;152
10386;78;628265185;10386;178;11079;11230;10.76;0.65;245.60;12.42;693;79;3856.00;151
10388;78;628265200;10388;182;11079;11230;10.71;0.65;245.60;12.42;691;79;3857.00;151
10390;78;628265210;10390;191;11079;11231;10.70;0.65;245.58;12.42;689;79;3858.00;152
10390;78;628265222;10390;195;11081;11231;10.67;0.65;245.58;12.42;691;79;3859.00;150
10390;78;628265232;10390;196;11085;11237;10.68;0.65;245.58;12.42;695;79;3860.00;152
10393;78;628265249;10393;199;11088;11238;10.67;0.65;245.58;12.42;695;79;3861.00;150
10394;78;628265259;10394;204;11088;11238;10.59;0.64;245.57;12.42;694;79;3862.00;150
10396;79;628265269;10396;207;11088;11238;10.41;0.63;245.55;12.42;692;80;3863.00;150
10398;79;628265285;10398;212;11091;11242;10.25;0.62;245.52;12.42;693;80;3864.00;151
10400;79;628265300;10400;217;11091;11242;10.07;0.61;245.50;12.42;691;80;3865.00;151
10400;79;628265310;10400;225;11092;11242;9.95;0.60;245.50;12.42;692;80;3866.00;150
10401;79;628265319;10401;219;11094;11243;9.93;0.60;245.48;12.43;693;80;3867.00;149
10401;79;628265330;10401;208;11097;11247;9.95;0.60;245.48;12.42;696;80;3868.00;150
10402;79;628265340;10402;201;11099;11247;9.90;0.60;245.47;12.44;697;80;3869.00;148
10404;79;628265353;10404;196;11104;11253;9.85;0.60;245.44;12.44;700;80;3870.00;149
10405;79;628265363;10405;196;11105;11253;9.80;0.60;245.45;12.44;700;80;3871.00;148
10407;79;628265380;10407;195;11107;11253;9.74;0.59;245.45;12.46;700;80;3872.00;146
10409;79;628265391;10409;197;11108;11253;9.79;0.60;245.44;12.47;699;80;3873.00;145
10410;79;628265407;10410;192;11111;11257;9.97;0.61;245.50;12.46;701;80;3874.00;146
10411;79;628265418;10411;190;11113;11257;9.96;0.61;245.50;12.49;702;80;3875.00;144
10414;79;628265428;10414;196;11114;11257;9.98;0.61;245.47;12.49;700;80;3876.00;143
10417;79;628265439;10417;196;11116;11257;9.95;0.61;245.48;12.51;699;80;3877.00;141
10419;79;628265449;10419;195;11117;11258;9.85;0.60;245.46;12.51;698;80;3878.00;141
10419;79;628265482;10419;198;11119;11259;9.82;0.60;245.46;12.51;700;80;3879.00;140
10419;79;628265506;10419;204;11121;11259;9.77;0.60;245.46;12.52;702;80;3880.00;138
10419;79;628265529;10419;209;11124;11260;9.67;0.59;245.46;12.55;705;80;3881.00;136
10420;79;628265545;10420;210;11124;11260;9.55;0.58;245.46;12.55;704;80;3882.00;136
10420;79;628265559;10420;214;11126;11260;9.46;0.58;245.46;12.57;706;80;3883.00;134
10421;79;628265582;10421;216;11126;11260;9.39;0.58;245.44;12.57;705;80;3884.00;134
10423;80;628265600;10423;223;11128;11260;9.31;0.57;245.45;12.58;705;81;3885.00;132
10429;80;628265621;10429;226;11128;11260;9.27;0.57;245.46;12.58;699;81;3886.00;132
10430;80;628265640;10430;228;11129;11260;9.18;0.56;245.45;12.60;699;81;3887.00;131
10431;80;628265659;10431;246;11199;11387;9.24;0.57;245.45;12.52;768;81;3888.00;188
10433;80;628265686;10433;233;11203;11388;9.16;0.57;245.50;12.53;770;81;3889.00;185
10434;80;628265701;10434;224;11212;11388;9.18;0.57;245.49;12.52;778;81;3890.00;176
10435;80;628265733;10435;217;11219;11388;9.16;0.57;245.50;12.53;784;81;3891.00;169
10437;80;628265747;10437;218;11226;11388;9.12;0.57;245.48;12.52;789;81;3892.00;162
10440;81;628265761;10440;217;11230;11388;9.01;0.56;245.47;12.53;790;82;3893.00;158
10444;81;628265788;10444;213;11234;11388;8.95;0.55;245.49;12.53;790;82;3894.00;154
10446;81;628265802;10446;214;11239;11388;8.93;0.55;245.47;12.54;793;82;3895.00;149
10449;81;628265816;10449;217;11245;11389;8.85;0.54;245.48;12.55;796;82;3896.00;144
10452;81;628265831;10452;219;11246;11390;8.72;0.54;245.52;12.55;794;82;3897.00;144
10457;81;628265845;10457;225;11249;11390;8.65;0.53;245.58;12.58;792;82;3898.00;141
10460;81;628265859;10460;236;11250;11391;8.53;0.52;245.57;12.58;790;82;3899.00;141
10463;81;628265877;10463;248;11257;11406;8.35;0.51;245.58;12.58;794;82;3900.00;149
10466;81;628265898;10466;249;11259;11406;8.22;0.51;245.59;12.59;793;82;3901.00;147
10468;81;628265915;10468;250;11261;11406;8.13;0.50;245.61;12.59;793;82;3902.00;145
10472;81;628265928;10472;259;11265;11410;8.11;0.50;245.61;12.61;793;82;3903.00;145
10477;81;628265941;10477;257;11267;11410;8.08;0.50;245.61;12.61;790;82;3904.00;143
10482;81;628265954;10482;263;11268;11410;8.01;0.49;245.60;12.61;786;82;3905.00;142
10486;81;628265969;10486;263;11273;11413;7.89;0.49;245.62;12.63;787;82;3906.00;140
10489;81;628265982;10489;267;11274;11413;7.81;0.48;245.67;12.63;785;82;3907.00;139
10492;81;628265996;10492;274;11277;11413;7.76;0.48;245.67;12.65;785;82;3908.00;136
10495;81;628266009;10495;277;11280;11417;7.66;0.48;245.69;12.65;785;82;3909.00;137
10499;81;628266032;10499;272;11281;11418;7.71;0.48;245.67;12.64;782;82;3910.00;137
10501;81;628266046;10501;269;11283;11418;7.73;0.48;245.68;12.66;782;82;3911.00;135
10505;81;628266058;10505;268;11287;11422;7.80;0.48;245.70;12.66;782;82;3912.00;135
10511;81;628266073;10511;253;11287;11422;7.82;0.48;245.70;12.66;776;82;3913.00;135
10515;81;628266087;10515;246;11290;11422;7.87;0.49;245.73;12.67;775;82;3914.00;132
10518;81;628266101;10518;241;11292;11424;7.98;0.49;245.74;12.67;774;82;3915.00;132
10525;81;628266114;10525;237;11294;11424;8.04;0.49;245.75;12.68;769;82;3916.00;130
10530;81;628266134;10530;223;11297;11430;8.19;0.50;245.74;12.68;767;82;3917.00;133
10533;81;628266149;10533;215;11298;11430;8.24;0.51;245.74;12.68;765;82;3918.00;132
10537;81;628266163;10537;201;11298;11431;8.35;0.51;245.72;12.68;761;82;3919.00;133
10543;81;628266179;10543;206;11299;11431;8.43;0.52;245.79;12.68;756;82;3920.00;132
10547;81;628266194;10547;202;11299;11431;8.52;0.52;245.82;12.68;752;82;3921.00;132
10552;81;628266216;10552;204;11299;11431;8.62;0.53;245.83;12.68;747;82;3922.00;132
10555;81;628266230;10555;201;11299;11431;8.66;0.53;245.84;12.68;744;82;3923.00;132
10560;81;628266252;10560;202;11308;11443;8.76;0.54;245.87;12.67;748;82;3924.00;135
10564;81;628266267;10564;198;11310;11443;8.76;0.54;245.87;12.67;746;82;3925.00;133
10566;81;628266281;10566;198;11310;11443;8.82;0.54;245.89;12.67;744;82;3926.00;133
10571;81;628266295;10571;196;11310;11443;8.90;0.54;245.92;12.67;739;82;3927.00;133
10573;81;628266310;10573;195;11310;11443;8.94;0.55;245.95;12.67;737;82;3928.00;133
10577;81;628266331;10577;199;11310;11443;8.95;0.55;245.96;12.67;733;82;3929.00;133
10583;81;628266348;10583;198;11313;11447;8.98;0.55;245.96;12.67;730;82;3930.00;134
10589;81;628266363;10589;200;11316;11447;8.98;0.55;245.99;12.67;727;82;3931.00;131
10592;81;628266386;10592;200;11318;11451;9.01;0.55;246.00;12.67;726;82;3932.00;133
10597;81;628266401;10597;198;11321;11452;9.00;0.55;246.07;12.67;724;82;3933.00;131
10599;81;628266416;10599;197;11321;11452;9.02;0.55;246.08;12.67;722;82;3934.00;131
10604;81;628266436;10604;201;11322;11452;9.04;0.55;246.06;12.67;718;82;3935.00;130
10608;81;628266457;10608;204;11332;11465;9.05;0.55;246.07;12.66;724;82;3936.00;133
10610;81;628266472;10610;206;11333;11465;9.07;0.55;246.10;12.66;723;82;3937.00;132
10614;81;628266492;10614;202;11333;11465;9.12;0.56;246.19;12.66;719;82;3938.00;132
10618;81;628266507;10618;202;11335;11466;9.14;0.56;246.19;12.66;717;82;3939.00;131
10619;81;628266521;10619;201;11335;11467;9.23;0.56;246.17;12.66;716;82;3940.00;132
10625;81;628266536;10625;204;11335;11467;9.25;0.56;246.19;12.66;710;82;3941.00;132
10631;81;628266551;10631;203;11338;11470;9.29;0.57;246.22;12.66;707;82;3942.00;132
10632;81;628266564;10632;210;11338;11470;9.42;0.57;246.20;12.66;706;82;3943.00;132
10638;81;628266579;10638;204;11338;11470;9.50;0.58;246.20;12.66;700;82;3944.00;132
10643;81;628266596;10643;211;11338;11470;9.46;0.58;246.20;12.66;695;82;3945.00;132
10646;81;628266613;10646;213;11343;11476;9.45;0.58;246.18;12.66;697;82;3946.00;133
10651;81;628266628;10651;215;11344;11476;9.37;0.57;246.19;12.66;693;82;3947.00;132
10655;81;628266642;10655;215;11344;11476;9.34;0.57;246.20;12.66;689;82;3948.00;132
10657;81;628266655;10657;218;11344;11476;9.34;0.57;246.20;12.66;687;82;3949.00;132
10662;81;628266668;10662;219;11347;11480;9.28;0.56;246.19;12.65;685;82;3950.00;133
10665;81;628266682;10665;223;11349;11481;9.25;0.56;246.19;12.65;684;82;3951.00;132
10671;81;628266695;10671;225;11351;11481;9.10;0.55;246.22;12.79;680;82;3952.00;130
10676;81;628266709;10676;232;11352;11482;9.03;0.55;246.20;12.79;676;82;3953.00;130
10677;81;628266724;10677;234;11353;11482;8.98;0.55;246.22;12.79;676;82;3954.00;129
10679;81;628266737;10679;239;11353;11482;8.96;0.55;246.26;12.79;674;82;3955.00;129
10683;81;628266749;10683;245;11353;11482;8.89;0.54;246.29;12.79;670;82;3956.00;129
10688;81;628266762;10688;236;11353;11482;8.83;0.54;246.26;12.79;665;82;3957.00;129
10693;81;628266776;10693;234;11353;11482;8.68;0.53;246.30;12.79;660;82;3958.00;129
10695;81;628266788;10695;234;11353;11482;8.54;0.52;246.31;12.79;658;83;3959.00;129
10697;81;628266818;10697;257;11422;11607;8.44;0.52;246.29;12.72;725;83;3960.00;185
10700;82;628266845;10700;252;11424;11608;8.39;0.52;246.31;12.71;724;84;3961.00;184
10703;82;628266873;10703;247;11428;11608;8.41;0.52;246.43;12.71;725;84;3962.00;180
10704;82;628266891;10704;238;11430;11608;8.47;0.52;246.44;12.71;726;84;3963.00;178
10706;82;628266915;10706;232;11434;11608;8.56;0.53;246.47;12.70;728;84;3964.00;174
10712;82;628266932;10712;240;11437;11608;8.55;0.53;246.51;12.70;725;84;3965.00;171
10714;82;628266949;10714;227;11442;11608;8.63;0.53;246.52;12.70;728;84;3966.00;166
10717;82;628266960;10717;219;11445;11608;8.69;0.54;246.54;12.70;728;84;3967.00;163
10720;82;628266973;10720;213;11451;11609;8.69;0.54;246.55;12.70;731;84;3968.00;158
10723;82;628266985;10723;211;11453;11610;8.74;0.54;246.60;12.69;730;84;3969.00;157
10728;82;628266998;10728;208;11456;11610;8.71;0.53;246.63;12.69;728;84;3970.00;154
10731;82;628267010;10731;206;11459;11614;8.70;0.53;246.61;12.69;728;84;3971.00;155
10733;82;628267024;10733;206;11461;11614;8.74;0.53;246.62;12.69;728;84;3972.00;153
10737;82;628267036;10737;206;11462;11614;8.74;0.53;246.63;12.69;725;84;3973.00;152
10737;82;628267049;10737;202;11463;11614;8.81;0.54;246.63;12.69;726;84;3974.00;151
10740;82;628267063;10740;200;11466;11620;8.93;0.55;246.65;12.69;726;84;3975.00;154
10742;82;628267077;10742;192;11468;11620;9.01;0.55;246.63;12.69;726;84;3976.00;152
10744;82;628267088;10744;188;11468;11620;9.09;0.55;246.64;12.69;724;84;3977.00;152
10747;82;628267101;10747;192;11471;11623;9.20;0.56;246.64;12.68;724;84;3978.00;152
10748;82;628267113;10748;187;11471;11623;9.32;0.57;246.65;12.68;723;84;3979.00;152
10752;82;628267126;10752;187;11471;11623;9.34;0.57;246.62;12.68;719;84;3980.00;152
10752;82;628267144;10752;187;11471;11624;9.41;0.57;246.62;12.68;719;84;3981.00;153
10755;82;628267157;10755;185;11472;11625;9.42;0.57;246.61;12.68;717;84;3982.00;153
10756;82;628267175;10756;186;11472;11625;9.43;0.57;246.59;12.68;716;84;3983.00;153
10759;82;628267195;10759;195;11482;11638;9.47;0.58;246.60;12.67;723;84;3984.00;156
10760;82;628267209;10760;194;11482;11638;9.54;0.58;246.63;12.67;722;84;3985.00;156
10763;82;628267220;10763;198;11482;11638;9.64;0.59;246.66;12.67;719;84;3986.00;156
10765;82;628267231;10765;201;11483;11639;9.73;0.59;246.63;12.67;718;84;3987.00;156
10766;82;628267242;10766;201;11483;11639;9.74;0.59;246.63;12.67;717;84;3988.00;156
10768;82;628267266;10768;204;11486;11643;9.80;0.60;246.60;12.67;718;84;3989.00;157
10769;83;628267287;10769;207;11486;11643;9.89;0.60;246.67;12.67;717;85;3990.00;157
10769;83;628267313;10769;208;11490;11647;9.99;0.61;246.67;12.66;721;85;3991.00;157
10769;83;628267324;10769;208;11490;11647;9.99;0.61;246.67;12.66;721;85;3992.00;157
10771;83;628267334;10771;212;11490;11647;9.91;0.61;246.64;12.66;719;85;3993.00;157
10772;83;628267352;10772;208;11490;11647;9.91;0.61;246.63;12.66;718;85;3994.00;157
10773;83;628267361;10773;210;11490;11647;9.88;0.60;246.62;12.66;717;85;3995.00;157
10777;83;628267373;10777;213;11500;11659;9.92;0.61;246.58;12.65;723;85;3996.00;159
10779;83;628267385;10779;217;11501;11659;9.86;0.60;246.56;12.65;722;85;3997.00;158
10780;83;628267395;10780;217;11501;11659;9.86;0.60;246.56;12.65;721;85;3998.00;158
10784;83;628267405;10784;217;11501;11659;9.85;0.60;246.52;12.65;717;85;3999.00;158
10789;83;628267417;10789;221;11501;11659;9.86;0.60;246.48;12.65;712;85;4000.00;158
10791;83;628267432;10791;225;11501;11659;9.88;0.61;246.47;12.65;710;85;4001.00;158
10794;83;628267444;10794;225;11501;11660;9.95;0.61;246.44;12.65;707;85;4002.00;159
10799;83;628267455;10799;227;11502;11660;9.96;0.61;246.39;12.79;703;85;4003.00;158
10800;83;628267467;10800;220;11506;11666;9.97;0.61;246.40;12.79;706;85;4004.00;160
10802;83;628267478;10802;222;11509;11668;10.00;0.61;246.39;12.78;707;85;4005.00;159
10807;83;628267489;10807;220;11509;11668;9.93;0.61;246.38;12.78;702;85;4006.00;159
10811;83;628267500;10811;221;11509;11668;9.93;0.61;246.37;12.78;698;85;4007.00;159
10811;83;628267509;10811;223;11512;11672;9.97;0.61;246.37;12.78;701;85;4008.00;160
10813;83;628267520;10813;222;11512;11672;9.96;0.61;246.37;12.78;699;85;4009.00;160
10813;83;628267530;10813;226;11512;11672;9.92;0.61;246.37;12.78;699;85;4010.00;160
10815;83;628267538;10815;223;11513;11673;9.87;0.60;246.35;12.78;698;85;4011.00;160
10820;83;628267552;10820;222;11516;11677;9.81;0.60;246.37;12.78;696;85;4012.00;161
10821;83;628267571;10821;221;11516;11677;9.74;0.59;246.36;12.78;695;85;4013.00;161
10824;83;628267598;10824;217;11518;11680;9.83;0.60;246.34;12.77;694;85;4014.00;162
10827;83;628267612;10827;215;11521;11680;9.87;0.60;246.38;12.80;694;85;4015.00;159
10827;83;628267628;10827;215;11521;11680;9.94;0.61;246.38;12.80;694;85;4016.00;159
10831;83;628267643;10831;212;11521;11680;9.97;0.61;246.38;12.80;690;85;4017.00;159
10834;83;628267658;10834;209;11524;11684;10.06;0.61;246.34;12.80;690;85;4018.00;160
10837;83;628267674;10837;194;11525;11684;10.12;0.62;246.31;12.94;688;85;4019.00;159
10837;83;628267688;10837;184;11526;11684;10.24;0.62;246.31;12.94;689;85;4020.00;158
10840;83;628267703;10840;176;11526;11684;10.39;0.63;246.26;12.94;686;85;4021.00;158
10840;83;628267717;10840;172;11526;11685;10.54;0.64;246.26;12.94;686;85;4022.00;159
10842;83;628267737;10842;166;11528;11686;10.60;0.64;246.24;13.07;686;85;4023.00;158
10844;84;628267751;10844;155;11528;11686;10.65;0.65;246.22;13.07;684;86;4024.00;158
10847;84;628267780;10847;147;11529;11687;10.70;0.65;246.20;13.07;682;86;4025.00;158
10848;84;628267801;10848;140;11529;11687;10.74;0.65;246.18;13.07;681;86;4026.00;158
10849;84;628267821;10849;139;11530;11687;10.76;0.65;246.18;13.08;681;86;4027.00;157
10850;84;628267833;10850;136;11530;11687;10.85;0.66;246.18;13.08;680;86;4028.00;157
10852;84;628267855;10852;132;11530;11687;10.91;0.66;246.16;13.08;678;86;4029.00;157
10854;84;628267869;10854;123;11530;11687;10.98;0.67;246.16;13.08;676;86;4030.00;157
10855;84;628267880;10855;124;11530;11687;11.01;0.67;246.15;13.08;675;86;4031.00;157
10856;84;628267893;10856;137;11592;11814;11.00;0.68;246.14;13.01;736;86;4032.00;222
10856;84;628267919;10856;133;11597;11815;11.09;0.68;246.14;13.00;741;86;4033.00;218
10856;84;628267934;10856;125;11607;11815;11.27;0.69;246.14;12.99;751;86;4034.00;208
10859;84;628267947;10859;126;11612;11815;11.33;0.70;246.19;12.99;753;86;4035.00;203
10859;84;628267960;10859;123;11620;11815;11.38;0.70;246.19;12.98;761;86;4036.00;195
10862;84;628267975;10862;128;11624;11815;11.37;0.70;246.19;12.98;762;86;4037.00;191
10864;84;628267990;10864;129;11630;11815;11.38;0.70;246.20;12.97;766;86;4038.00;185
10865;84;628268003;10865;133;11632;11815;11.33;0.69;246.18;12.97;767;86;4039.00;183
10866;84;628268017;10866;139;11637;11816;11.30;0.69;246.19;12.99;771;86;4040.00;179
10870;84;628268031;10870;139;11639;11817;11.21;0.68;246.12;12.99;769;86;4041.00;178
10875;84;628268043;10875;147;11641;11817;11.11;0.68;246.15;12.98;766;86;4042.00;176
10877;84;628268059;10877;154;11645;11818;10.99;0.67;246.15;13.01;768;86;4043.00;173
10879;84;628268074;10879;165;11646;11818;10.81;0.66;246.15;13.01;767;86;4044.00;172
10882;85;628268089;10882;169;11650;11818;10.62;0.65;246.16;13.03;768;87;4045.00;168
10884;85;628268126;10884;178;11652;11818;10.44;0.64;246.15;13.04;768;87;4046.00;166
10886;85;628268141;10886;192;11657;11822;10.31;0.63;246.16;13.05;771;87;4047.00;165
10887;86;628268155;10887;197;11659;11822;10.12;0.62;246.17;13.06;772;88;4048.00;163
10889;86;628268190;10889;204;11660;11822;9.99;0.61;246.18;13.08;771;88;4049.00;162
10891;86;628268209;10891;207;11664;11828;9.82;0.60;246.17;13.07;773;88;4050.00;164
10894;86;628268231;10894;220;11667;11828;9.62;0.59;246.17;13.10;773;88;4051.00;161
10896;86;628268247;10896;229;11668;11828;9.46;0.58;246.20;13.10;772;88;4052.00;160
10899;86;628268261;10899;240;11673;11832;9.24;0.56;246.23;13.12;774;88;4053.00;159
10901;86;628268278;10901;247;11675;11833;9.15;0.56;246.23;13.11;774;88;4054.00;158
10903;86;628268292;10903;255;11677;11833;9.02;0.55;246.24;13.13;774;88;4055.00;156
10904;86;628268306;10904;264;11681;11837;8.97;0.55;246.24;13.13;777;88;4056.00;156
10909;86;628268322;10909;265;11682;11837;8.82;0.54;246.30;13.13;773;88;4057.00;155
10910;86;628268337;10910;271;11684;11837;8.66;0.53;246.30;13.15;774;88;4058.00;153
10914;86;628268351;10914;270;11686;11838;8.56;0.53;246.27;13.15;772;88;4059.00;152
10915;86;628268364;10915;273;11687;11838;8.43;0.52;246.25;13.16;772;88;4060.00;151
10917;86;628268385;10917;274;11692;11844;8.30;0.51;246.30;13.16;775;88;4061.00;152
10921;86;628268404;10921;269;11692;11844;8.22;0.51;246.34;13.16;771;88;4062.00;152
10923;86;628268419;10923;271;11695;11845;8.19;0.50;246.32;13.18;772;88;4063.00;150
10926;86;628268432;10926;268;11695;11845;8.18;0.50;246.36;13.18;769;88;4064.00;150
10931;86;628268446;10931;268;11695;11845;8.18;0.50;246.36;13.18;764;88;4065.00;150
10932;86;628268460;10932;261;11698;11845;8.23;0.50;246.34;13.20;766;88;4066.00;147
10938;86;628268473;10938;264;11699;11845;8.25;0.50;246.36;13.20;761;88;4067.00;146
10942;86;628268486;10942;259;11711;11857;8.31;0.51;246.31;13.19;769;88;4068.00;146
10945;86;628268500;10945;258;11712;11857;8.31;0.51;246.32;13.21;767;88;4069.00;145
10948;86;628268512;10948;256;11713;11857;8.31;0.51;246.33;13.20;765;88;4070.00;144
10951;86;628268524;10951;253;11713;11857;8.34;0.51;246.32;13.20;762;88;4071.00;144
10957;86;628268540;10957;256;11713;11857;8.25;0.50;246.35;13.20;756;88;4072.00;144
10961;86;628268554;10961;256;11715;11857;8.25;0.50;246.34;13.23;754;88;4073.00;142
10964;86;628268568;10964;251;11718;11861;8.22;0.50;246.35;13.23;754;88;4074.00;143
10968;86;628268582;10968;249;11719;11861;8.18;0.50;246.34;13.24;751;88;4075.00;142
10970;86;628268599;10970;246;11723;11865;8.09;0.49;246.34;13.24;753;88;4076.00;142
10975;86;628268610;10975;247;11724;11866;8.00;0.49;246.34;13.24;749;88;4077.00;142
10979;86;628268622;10979;247;11726;11866;7.83;0.48;246.37;13.25;747;88;4078.00;140
10981;86;628268633;10981;253;11727;11866;7.70;0.47;246.36;13.26;746;88;4079.00;139
10987;86;628268646;10987;255;11746;11895;7.54;0.46;246.38;13.24;759;88;4080.00;149
10993;86;628268661;10993;248;11750;11895;7.45;0.46;246.34;13.25;757;88;4081.00;145
10998;86;628268672;10998;252;11752;11895;7.43;0.46;246.37;13.25;754;88;4082.00;143
11002;86;628268683;11002;255;11756;11896;7.46;0.46;246.38;13.25;754;88;4083.00;140
11005;86;628268700;11005;258;11757;11897;7.53;0.46;246.40;13.26;752;88;4084.00;140
11009;86;628268711;11009;255;11757;11897;7.55;0.46;246.43;13.26;748;88;4085.00;140
11014;86;628268723;11014;257;11761;11900;7.58;0.46;246.47;13.27;747;88;4086.00;139
11015;86;628268738;11015;255;11761;11900;7.70;0.47;246.46;13.27;746;88;4087.00;139
11021;86;628268750;11021;247;11761;11900;7.75;0.47;246.46;13.27;740;88;4088.00;139
11027;86;628268760;11027;242;11761;11900;7.82;0.48;246.48;13.27;734;88;4089.00;139
11030;86;628268771;11030;237;11765;11906;8.03;0.49;246.46;13.26;735;88;4090.00;141
11035;86;628268784;11035;238;11766;11906;8.13;0.50;246.54;13.26;731;88;4091.00;140
11038;86;628268801;11038;235;11766;11906;8.25;0.50;246.58;13.26;728;88;4092.00;140
11042;86;628268816;11042;233;11766;11906;8.37;0.51;246.60;13.26;724;88;4093.00;140
11047;86;628268831;11047;226;11769;11910;8.44;0.52;246.66;13.26;722;88;4094.00;141
11051;86;628268847;11051;225;11771;11912;8.59;0.52;246.66;13.26;720;88;4095.00;141
11054;86;628268862;11054;224;11771;11912;8.71;0.53;246.71;13.26;717;88;4096.00;141
11058;86;628268875;11058;223;11772;11913;8.81;0.54;246.73;13.26;714;88;4097.00;141
11063;86;628268887;11063;221;11772;11913;8.96;0.55;246.78;13.26;709;88;4098.00;141
11066;86;628268898;11066;216;11772;11913;9.06;0.55;246.84;13.26;706;88;4099.00;141
11071;86;628268916;11071;220;11772;11913;9.14;0.56;246.85;13.26;701;88;4100.00;141
11077;86;628268933;11077;213;11772;11913;9.20;0.56;246.83;13.26;695;88;4101.00;141
11081;86;628268946;11081;205;11772;11913;9.28;0.56;246.86;13.26;691;88;4102.00;141
11086;86;628268962;11086;205;11772;11913;9.37;0.57;246.86;13.26;686;88;4103.00;141
11089;86;628268975;11089;212;11813;11983;9.31;0.57;246.86;13.21;724;88;4104.00;170
11094;86;628269002;11094;205;11815;11984;9.45;0.58;246.88;13.21;721;88;4105.00;169
11098;86;628269017;11098;207;11820;11984;9.62;0.59;246.93;13.20;722;88;4106.00;164
11101;86;628269031;11101;206;11821;11984;9.74;0.59;246.95;13.20;720;88;4107.00;163
11103;87;628269044;11103;206;11825;11984;9.85;0.60;246.94;13.20;722;89;4108.00;159
11109;87;628269071;11109;208;11826;11984;9.88;0.60;246.94;13.20;717;89;4109.00;158
11113;87;628269087;11113;213;11830;11984;9.94;0.61;246.92;13.20;717;89;4110.00;154
11117;87;628269102;11117;215;11831;11984;9.95;0.61;246.96;13.19;714;89;4111.00;153
11121;87;628269120;11121;214;11835;11985;9.93;0.60;246.94;13.19;714;89;4112.00;150
11122;87;628269133;11122;210;11836;11986;9.92;0.60;246.95;13.19;714;89;4113.00;150
11126;87;628269147;11126;213;11837;11986;9.84;0.60;246.94;13.19;711;89;4114.00;149
11127;87;628269159;11127;216;11839;11990;9.83;0.60;246.95;13.19;712;89;4115.00;151
11132;87;628269181;11132;216;11839;11990;9.77;0.60;246.98;13.19;707;89;4116.00;151
11138;87;628269204;11138;217;11840;11990;9.70;0.59;247.00;13.33;702;89;4117.00;150
11139;87;628269219;11139;226;11840;11990;9.69;0.59;247.01;13.33;701;89;4118.00;150
11143;87;628269230;11143;229;11844;11996;9.65;0.59;246.99;13.32;701;89;4119.00;152
11148;87;628269241;11148;230;11846;11996;9.53;0.58;246.98;13.33;698;89;4120.00;150
11154;87;628269252;11154;233;11847;11996;9.32;0.56;247.02;13.32;693;89;4121.00;149
11155;87;628269262;11155;239;11849;11999;9.28;0.56;247.01;13.32;694;89;4122.00;150
11158;87;628269272;11158;247;11850;11999;9.20;0.56;247.05;13.32;692;89;4123.00;149
11162;87;628269282;11162;250;11852;11999;8.95;0.54;247.07;13.32;690;89;4124.00;147
11166;87;628269292;11166;258;11852;12000;8.85;0.54;247.07;13.32;686;89;4125.00;148
11169;87;628269302;11169;257;11853;12001;8.67;0.53;247.06;13.32;684;89;4126.00;148
11171;87;628269311;11171;252;11853;12001;8.58;0.52;247.05;13.32;682;89;4127.00;148
11175;87;628269321;11175;248;11864;12014;8.56;0.52;247.11;13.31;689;89;4128.00;150
11177;87;628269332;11177;245;11864;12014;8.47;0.51;247.12;13.31;687;89;4129.00;150
11179;87;628269341;11179;243;11864;12014;8.42;0.51;247.13;13.31;685;89;4130.00;150
11181;87;628269352;11181;247;11865;12015;8.40;0.51;247.11;13.31;684;89;4131.00;150
11184;87;628269361;11184;252;11865;12015;8.40;0.51;247.20;13.31;681;89;4132.00;150
11185;87;628269371;11185;258;11868;12019;8.48;0.52;247.21;13.30;683;89;4133.00;151
11186;87;628269381;11186;261;11868;12019;8.49;0.52;247.21;13.30;682;89;4134.00;151
11187;87;628269390;11187;267;11872;12023;8.46;0.52;247.22;13.30;685;89;4135.00;151
11191;87;628269400;11191;252;11872;12023;8.47;0.52;247.19;13.30;681;89;4136.00;151
11194;87;628269410;11194;241;11872;12023;8.48;0.52;247.16;13.30;678;89;4137.00;151
11195;87;628269420;11195;234;11872;12023;8.53;0.52;247.15;13.30;677;89;4138.00;151
11195;87;628269430;11195;222;11872;12023;8.63;0.52;247.15;13.30;677;89;4139.00;151
11198;87;628269441;11198;222;11896;12057;8.75;0.54;247.13;13.27;698;89;4140.00;161
11199;87;628269454;11199;217;11897;12057;8.85;0.54;247.13;13.27;698;89;4141.00;160
11201;87;628269465;11201;210;11898;12057;8.93;0.55;247.11;13.27;697;89;4142.00;159
11202;87;628269476;11202;208;11898;12057;8.98;0.55;247.11;13.27;696;89;4143.00;159
11204;87;628269486;11204;207;11899;12057;9.06;0.55;247.08;13.27;695;89;4144.00;158
11205;87;628269496;11205;210;11899;12057;9.10;0.56;247.08;13.27;694;89;4145.00;158
11206;87;628269506;11206;202;11900;12058;9.15;0.56;247.07;13.27;694;89;4146.00;158
11209;87;628269517;11209;203;11900;12058;9.13;0.56;247.06;13.27;691;89;4147.00;158
11211;87;628269526;11211;202;11904;12064;9.11;0.56;247.05;13.27;693;89;4148.00;160
11213;87;628269542;11213;203;11905;12065;9.16;0.56;247.03;13.26;692;89;4149.00;160
11214;87;628269557;11214;198;11906;12065;9.23;0.56;247.02;13.26;692;89;4150.00;159
11219;87;628269583;11219;198;11906;12065;9.14;0.56;247.00;13.26;687;89;4151.00;159
11222;87;628269600;11222;198;11910;12069;9.18;0.56;246.95;13.26;688;89;4152.00;159
11224;87;628269615;11224;201;11910;12069;9.19;0.56;246.92;13.26;686;89;4153.00;159
11226;87;628269630;11226;203;11910;12069;9.14;0.56;246.90;13.26;684;89;4154.00;159
11231;87;628269645;11231;199;11911;12070;9.18;0.56;246.86;13.26;680;89;4155.00;159
11235;87;628269659;11235;206;11914;12074;9.19;0.56;246.84;13.26;679;89;4156.00;160
11235;87;628269671;11235;208;11914;12074;9.23;0.56;246.84;13.26;679;89;4157.00;160
11236;87;628269681;11236;212;11916;12077;9.35;0.57;246.84;13.25;680;89;4158.00;161
11238;87;628269702;11238;212;11916;12077;9.41;0.57;246.84;13.25;678;89;4159.00;161
11239;87;628269713;11239;210;11917;12077;9.55;0.58;246.83;13.25;678;89;4160.00;160
11241;87;628269724;11241;211;11917;12077;9.60;0.58;246.88;13.25;676;89;4161.00;160
11242;87;628269735;11242;212;11920;12081;9.65;0.58;246.87;13.25;678;89;4162.00;161
11242;87;628269751;11242;213;11920;12081;9.73;0.59;246.87;13.25;678;89;4163.00;161
11243;87;628269760;11243;215;11921;12081;9.71;0.59;246.87;13.25;678;89;4164.00;160
11243;87;628269771;11243;216;11921;12081;9.68;0.59;246.87;13.25;678;89;4165.00;160
11245;87;628269780;11245;217;11921;12082;9.72;0.59;246.85;13.25;676;89;4166.00;161
11246;87;628269789;11246;222;11922;12083;9.74;0.59;246.83;13.25;676;89;4167.00;161
11247;87;628269799;11247;223;11922;12083;9.81;0.59;246.83;13.25;675;89;4168.00;161
11248;87;628269810;11248;224;11923;12084;9.83;0.60;246.81;13.25;675;89;4169.00;161
11249;87;628269821;11249;222;11923;12084;9.85;0.60;246.82;13.25;674;89;4170.00;161
11251;87;628269830;11251;211;11924;12084;9.80;0.59;246.81;13.39;673;89;4171.00;160
11251;87;628269839;11251;200;11924;12084;9.86;0.60;246.81;13.39;673;89;4172.00;160
11251;87;628269849;11251;197;11926;12086;9.91;0.60;246.81;13.39;675;89;4173.00;160
11251;87;628269859;11251;188;11926;12086;10.00;0.61;246.81;13.39;675;89;4174.00;160
11252;87;628269868;11252;180;11926;12086;10.14;0.62;246.80;13.39;674;89;4175.00;160
11253;87;628269877;11253;200;11994;12213;10.00;0.62;246.79;13.31;741;89;4176.00;219
11255;87;628269897;11255;180;11995;12214;10.10;0.62;246.79;13.31;740;89;4177.00;219
11258;87;628269913;11258;167;12003;12214;10.24;0.63;246.76;13.30;745;89;4178.00;211
11262;87;628269924;11262;155;12007;12214;10.33;0.63;246.81;13.30;745;89;4179.00;207
11264;87;628269934;11264;147;12010;12214;10.43;0.64;246.80;13.30;746;89;4180.00;204
11266;87;628269945;11266;148;12014;12214;10.49;0.64;246.80;13.30;748;89;4181.00;200
11272;87;628269955;11272;142;12017;12214;10.66;0.65;246.78;13.29;745;89;4182.00;197
11275;88;628269972;11275;141;12021;12214;10.83;0.66;246.75;13.29;746;90;4183.00;193
11277;88;628269991;11277;138;12024;12215;10.94;0.67;246.80;13.31;747;90;4184.00;191
11278;88;628270003;11278;132;12027;12217;11.08;0.68;246.79;13.30;749;90;4185.00;190
11281;88;628270019;11281;125;12032;12217;11.16;0.68;246.77;13.32;751;90;4186.00;185
11281;88;628270031;11281;122;12034;12218;11.24;0.69;246.77;13.32;753;90;4187.00;184
11283;88;628270042;11283;126;12038;12218;11.31;0.69;246.76;13.32;755;90;4188.00;180
11284;88;628270053;11284;118;12039;12218;11.29;0.69;246.75;13.32;755;90;4189.00;179
11285;88;628270064;11285;113;12040;12218;11.28;0.69;246.76;13.32;755;90;4190.00;178
11286;88;628270075;11286;111;12044;12222;11.27;0.69;246.75;13.45;758;90;4191.00;178
11287;88;628270087;11287;118;12046;12222;11.24;0.68;246.76;13.45;759;90;4192.00;176
11290;88;628270099;11290;112;12047;12222;11.12;0.68;246.79;13.45;757;90;4193.00;175
11293;88;628270112;11293;115;12050;12225;11.03;0.67;246.78;13.59;757;90;4194.00;175
11295;88;628270125;11295;118;12051;12225;11.02;0.67;246.80;13.59;756;90;4195.00;174
11297;88;628270136;11297;121;12052;12225;11.02;0.67;246.78;13.59;755;90;4196.00;173
11302;88;628270148;11302;127;12055;12229;10.91;0.66;246.78;13.58;753;90;4197.00;174
11308;88;628270160;11308;127;12057;12230;10.89;0.66;246.78;13.72;749;90;4198.00;173
11310;88;628270172;11310;135;12057;12230;10.94;0.66;246.77;13.72;747;90;4199.00;173
11312;88;628270186;11312;142;12067;12264;10.86;0.66;246.76;13.71;755;90;4200.00;197
11315;88;628270206;11315;141;12070;12264;10.84;0.66;246.81;13.71;755;90;4201.00;194
11316;88;628270218;11316;146;12073;12264;10.78;0.66;246.82;13.71;757;90;4202.00;191
11318;88;628270230;11318;148;12075;12265;10.71;0.65;246.83;13.85;757;90;4203.00;190
11322;88;628270241;11322;149;12076;12265;10.66;0.65;246.83;13.85;754;90;4204.00;189
11325;88;628270253;11325;157;12080;12271;10.62;0.65;246.83;13.85;755;90;4205.00;191
11328;88;628270266;11328;163;12082;12271;10.53;0.64;246.86;13.85;754;90;4206.00;189
11333;88;628270280;11333;171;12084;12272;10.45;0.64;246.83;13.85;751;90;4207.00;188
11334;88;628270295;11334;174;12084;12272;10.36;0.63;246.82;13.85;750;90;4208.00;188
11338;88;628270307;11338;175;12084;12272;10.27;0.63;246.85;13.85;746;90;4209.00;188
11341;88;628270318;11341;180;12084;12272;10.18;0.62;246.89;13.85;743;90;4210.00;188
11345;88;628270330;11345;190;12089;12272;10.05;0.61;246.92;13.88;744;90;4211.00;183
11350;88;628270341;11350;194;12097;12284;10.01;0.61;246.95;13.87;747;90;4212.00;187
11352;88;628270355;11352;201;12100;12284;9.98;0.61;246.94;13.87;748;90;4213.00;184
11356;88;628270366;11356;207;12101;12284;9.95;0.61;246.94;13.89;745;90;4214.00;183
11357;88;628270377;11357;206;12101;12284;9.93;0.61;246.95;13.89;744;90;4215.00;183
11358;88;628270387;11358;210;12104;12284;9.91;0.61;246.93;13.91;746;90;4216.00;180
11359;88;628270398;11359;215;12106;12284;9.82;0.60;246.92;13.91;747;90;4217.00;178
11362;88;628270410;11362;213;12111;12288;9.76;0.60;246.92;13.93;749;90;4218.00;177
11365;88;628270421;11365;218;12111;12288;9.72;0.59;246.96;13.93;746;90;4219.00;177
11366;88;628270431;11366;223;12115;12292;9.75;0.60;246.95;13.95;749;90;4220.00;177
11371;88;628270443;11371;229;12117;12293;9.72;0.59;246.96;13.95;746;90;4221.00;176
11373;88;628270454;11373;229;12120;12293;9.62;0.59;246.98;13.97;747;90;4222.00;173
11375;88;628270464;11375;229;12121;12293;9.51;0.58;247.00;13.99;746;90;4223.00;172
11378;88;628270475;11378;235;12129;12306;9.38;0.57;246.98;13.98;751;90;4224.00;177
11380;88;628270488;11380;245;12130;12306;9.26;0.57;246.98;13.98;750;90;4225.00;176
11384;88;628270498;11384;246;12133;12306;9.10;0.56;246.93;14.00;749;90;4226.00;173
11387;88;628270509;11387;254;12135;12307;9.08;0.56;246.93;14.00;748;90;4227.00;172
11389;88;628270520;11389;261;12138;12308;8.97;0.55;246.92;14.02;749;90;4228.00;170
11390;88;628270531;11390;258;12138;12308;8.96;0.55;246.92;14.02;748;90;4229.00;170
11393;88;628270543;11393;265;12142;12314;8.85;0.54;246.91;14.03;749;90;4230.00;172
11396;88;628270556;11396;266;12142;12314;8.75;0.54;246.89;14.03;746;90;4231.00;172
11400;88;628270568;11400;266;12144;12314;8.73;0.53;246.90;14.06;744;90;4232.00;170
11402;88;628270578;11402;267;12144;12314;8.69;0.53;246.90;14.06;742;90;4233.00;170
11407;88;628270589;11407;265;12148;12320;8.68;0.53;246.88;14.06;741;90;4234.00;172
11408;88;628270600;11408;261;12151;12320;8.65;0.53;246.89;14.10;743;90;4235.00;169
11412;88;628270610;11412;261;12151;12320;8.59;0.53;246.89;14.10;739;90;4236.00;169
11414;88;628270621;11414;259;12152;12320;8.56;0.52;246.88;14.11;738;90;4237.00;168
11416;88;628270631;11416;260;12155;12324;8.55;0.53;246.88;14.11;739;90;4238.00;169
11421;88;628270642;11421;257;12157;12325;8.56;0.52;246.84;14.11;736;90;4239.00;168
11424;88;628270651;11424;260;12159;12325;8.54;0.52;246.84;14.12;735;90;4240.00;166
11426;88;628270661;11426;261;12162;12326;8.53;0.52;246.86;14.12;736;90;4241.00;164
11430;88;628270671;11430;258;12163;12326;8.49;0.52;246.89;14.14;733;90;4242.00;163
11434;88;628270680;11434;254;12163;12326;8.48;0.52;246.93;14.14;729;90;4243.00;163
11437;88;628270689;11437;254;12164;12326;8.46;0.52;246.95;14.14;727;90;4244.00;162
11441;88;628270698;11441;251;12166;12326;8.43;0.52;246.96;14.15;725;90;4245.00;160
11444;88;628270708;11444;248;12167;12326;8.30;0.51;247.02;14.15;723;90;4246.00;159
11450;88;628270717;11450;254;12168;12326;8.16;0.50;247.02;14.16;718;90;4247.00;158
11454;88;628270726;11454;264;12205;12396;8.06;0.50;247.08;14.12;751;90;4248.00;191
11460;88;628270741;11460;263;12206;12397;7.84;0.48;247.12;14.13;746;90;4249.00;191
11465;88;628270750;11465;253;12211;12397;7.71;0.47;247.17;14.13;746;90;4250.00;186
11471;88;628270759;11471;252;12217;12397;7.54;0.46;247.20;14.13;746;90;4251.00;180
11475;88;628270769;11475;255;12221;12397;7.49;0.46;247.26;14.13;746;90;4252.00;176
11478;88;628270778;11478;250;12224;12397;7.47;0.46;247.30;14.14;746;90;4253.00;173
11482;88;628270787;11482;253;12229;12397;7.49;0.46;247.35;14.14;747;90;4254.00;168
11484;88;628270796;11484;260;12232;12397;7.56;0.47;247.36;14.15;748;90;4255.00;165
11492;88;628270810;11492;263;12237;12398;7.59;0.47;247.37;14.17;745;90;4256.00;161
11497;88;628270819;11497;254;12240;12399;7.54;0.46;247.42;14.17;743;90;4257.00;159
11499;88;628270829;11499;255;12243;12399;7.54;0.46;247.43;14.18;744;90;4258.00;156
11504;88;628270838;11504;260;12246;12403;7.58;0.47;247.46;14.18;742;90;4259.00;157
11508;88;628270849;11508;259;12247;12403;7.58;0.47;247.47;14.18;739;90;4260.00;156
11511;88;628270858;11511;259;12248;12403;7.65;0.47;247.49;14.18;737;90;4261.00;155
11515;88;628270867;11515;267;12248;12403;7.69;0.47;247.50;14.18;733;90;4262.00;155
11520;88;628270876;11520;265;12252;12409;7.63;0.47;247.52;14.18;732;90;4263.00;157
11525;88;628270886;11525;265;12253;12409;7.56;0.47;247.56;14.18;728;90;4264.00;156
11527;88;628270896;11527;259;12253;12409;7.61;0.47;247.54;14.18;726;90;4265.00;156
11533;88;628270905;11533;261;12255;12412;7.66;0.47;247.54;14.18;722;90;4266.00;157
11537;88;628270914;11537;249;12256;12412;7.62;0.47;247.55;14.18;719;90;4267.00;156
11541;88;628270924;11541;245;12256;12412;7.65;0.47;247.56;14.18;715;90;4268.00;156
11549;88;628270933;11549;241;12256;12413;7.64;0.47;247.52;14.18;707;90;4269.00;157
11552;88;628270942;11552;240;12258;12414;7.70;0.47;247.53;14.18;706;90;4270.00;156
11558;88;628270951;11558;246;12259;12414;7.71;0.47;247.55;14.18;701;90;4271.00;155
11561;88;628270961;11561;248;12271;12427;7.80;0.48;247.53;14.17;710;90;4272.00;156
11567;88;628270971;11567;243;12272;12427;7.82;0.48;247.52;14.17;705;90;4273.00;155
11568;88;628270980;11568;239;12273;12427;7.93;0.49;247.53;14.18;705;90;4274.00;154
11576;88;628270995;11576;235;12275;12429;7.92;0.48;247.50;14.17;699;90;4275.00;154
11581;89;628271011;11581;234;12276;12429;7.98;0.49;247.48;14.17;695;91;4276.00;153
11586;89;628271031;11586;234;12278;12433;8.02;0.49;247.47;14.17;692;91;4277.00;155
11589;89;628271041;11589;238;12279;12433;8.10;0.49;247.46;14.17;690;91;4278.00;154
11591;89;628271050;11591;238;12283;12437;8.16;0.50;247.51;14.31;692;91;4279.00;154
11597;89;628271060;11597;241;12284;12437;8.16;0.50;247.48;14.31;687;91;4280.00;153
11598;89;628271070;11598;241;12284;12437;8.16;0.50;247.48;14.31;686;91;4281.00;153
11603;89;628271079;11603;247;12285;12437;8.13;0.50;247.48;14.31;682;91;4282.00;152
11605;89;628271088;11605;249;12285;12437;8.09;0.49;247.48;14.31;680;91;4283.00;152
11610;89;628271097;11610;251;12296;12449;8.12;0.49;247.48;14.30;686;91;4284.00;153
11612;89;628271112;11612;258;12296;12449;8.12;0.49;247.54;14.30;684;91;4285.00;153
11613;89;628271121;11613;262;12297;12449;8.13;0.50;247.54;14.30;684;91;4286.00;152
11616;89;628271130;11616;263;12297;12449;8.03;0.49;247.55;14.30;681;91;4287.00;152
11619;89;628271139;11619;270;12298;12449;7.99;0.49;247.57;14.30;679;91;4288.00;151
11622;89;628271148;11622;279;12298;12449;7.87;0.48;247.58;14.30;676;91;4289.00;151
11622;89;628271159;11622;287;12299;12450;7.87;0.48;247.58;14.30;677;91;4290.00;151
11624;89;628271167;11624;297;12300;12450;7.84;0.48;247.56;14.30;676;91;4291.00;150
11627;89;628271176;11627;305;12303;12456;7.79;0.48;247.54;14.30;676;91;4292.00;153
11631;89;628271185;11631;306;12305;12457;7.76;0.47;247.51;14.30;674;91;4293.00;152
11634;89;628271194;11634;311;12305;12457;7.70;0.47;247.47;14.30;671;91;4294.00;152
11635;89;628271202;11635;313;12306;12457;7.67;0.47;247.46;14.30;671;91;4295.00;151
11638;89;628271210;11638;319;12309;12461;7.62;0.47;247.44;14.29;671;91;4296.00;152
11639;89;628271219;11639;312;12310;12461;7.64;0.47;247.43;14.29;671;91;4297.00;151
11641;89;628271228;11641;308;12311;12461;7.61;0.46;247.40;14.44;670;91;4298.00;150
11645;89;628271237;11645;304;12312;12462;7.52;0.46;247.38;14.44;667;91;4299.00;150
11648;89;628271246;11648;302;12315;12466;7.53;0.46;247.39;14.43;667;91;4300.00;151
11651;89;628271259;11651;304;12315;12466;7.52;0.46;247.42;14.43;664;91;4301.00;151
11655;89;628271268;11655;301;12317;12469;7.55;0.46;247.39;14.43;662;91;4302.00;152
11657;90;628271277;11657;300;12317;12469;7.46;0.45;247.38;14.43;660;92;4303.00;152
11659;90;628271292;11659;296;12318;12469;7.49;0.46;247.37;14.43;659;92;4304.00;151
11661;90;628271301;11661;294;12318;12469;7.54;0.46;247.37;14.43;657;92;4305.00;151
11665;90;628271309;11665;278;12321;12473;7.59;0.46;247.40;14.43;656;92;4306.00;152
11666;90;628271319;11666;258;12322;12473;7.69;0.47;247.39;14.43;656;92;4307.00;151
11669;90;628271327;11669;251;12322;12473;7.83;0.48;247.37;14.43;653;92;4308.00;151
11671;90;628271341;11671;246;12322;12473;7.94;0.48;247.37;14.43;651;92;4309.00;151
11673;90;628271350;11673;237;12322;12474;8.04;0.49;247.36;14.43;649;92;4310.00;152
11674;90;628271359;11674;230;12323;12475;8.14;0.49;247.36;14.42;649;92;4311.00;152
11677;90;628271368;11677;223;12323;12475;8.26;0.50;247.33;14.42;646;92;4312.00;152
11678;90;628271377;11678;221;12324;12476;8.44;0.51;247.31;14.42;646;92;4313.00;152
11679;90;628271390;11679;218;12324;12476;8.55;0.52;247.32;14.42;645;92;4314.00;152
11679;90;628271400;11679;217;12324;12476;8.66;0.53;247.32;14.42;645;92;4315.00;152
11680;90;628271408;11680;216;12324;12476;8.74;0.53;247.32;14.42;644;92;4316.00;152
11681;90;628271417;11681;212;12324;12476;8.85;0.54;247.31;14.42;643;92;4317.00;152
11681;90;628271426;11681;214;12324;12476;8.98;0.55;247.31;14.42;643;92;4318.00;152
11683;90;628271440;11683;207;12325;12476;9.01;0.55;247.31;14.57;642;92;4319.00;151
11684;90;628271450;11684;246;12437;12706;8.97;0.56;247.30;14.44;753;92;4320.00;269
11685;90;628271475;11685;239;12441;12707;9.00;0.56;247.31;14.43;756;92;4321.00;266
11687;90;628271485;11687;217;12451;12707;9.11;0.57;247.29;14.42;764;92;4322.00;256
11688;90;628271494;11688;198;12457;12707;9.18;0.57;247.29;14.42;769;92;4323.00;250
11688;90;628271504;11688;186;12464;12707;9.30;0.58;247.29;14.41;776;92;4324.00;243
11689;90;628271513;11689;177;12468;12707;9.42;0.59;247.28;14.41;779;92;4325.00;239
11692;90;628271523;11692;174;12473;12707;9.42;0.58;247.33;14.40;781;92;4326.00;234
11694;90;628271533;11694;167;12477;12707;9.46;0.59;247.34;14.40;783;92;4327.00;230
11695;90;628271543;11695;164;12483;12708;9.52;0.59;247.33;14.40;788;92;4328.00;225
11698;90;628271559;11698;161;12486;12709;9.58;0.59;247.34;14.40;788;92;4329.00;223
11698;90;628271577;11698;161;12490;12709;9.69;0.60;247.34;14.40;792;92;4330.00;219
11698;90;628271597;11698;161;12492;12710;9.74;0.60;247.34;14.40;794;92;4331.00;218
11700;91;628271613;11700;163;12497;12710;9.79;0.61;247.34;14.40;797;93;4332.00;213
11701;91;628271649;11701;154;12499;12710;9.89;0.61;247.33;14.39;798;93;4333.00;211
11701;91;628271670;11701;156;12501;12710;9.99;0.62;247.33;14.39;800;93;4334.00;209
11702;91;628271688;11702;158;12507;12714;10.03;0.62;247.34;14.54;805;93;4335.00;207
11704;91;628271701;11704;167;12509;12714;10.03;0.62;247.34;14.54;805;93;4336.00;205
11704;91;628271714;11704;170;12510;12714;10.07;0.62;247.34;14.54;806;93;4337.00;204
11706;91;628271726;11706;175;12514;12717;10.07;0.62;247.32;14.54;808;93;4338.00;203
11708;91;628271739;11708;176;12514;12717;10.06;0.62;247.32;14.54;806;93;4339.00;203
11709;91;628271759;11709;174;12514;12717;10.12;0.62;247.32;14.54;805;93;4340.00;203
11711;91;628271771;11711;183;12517;12721;10.18;0.63;247.31;14.53;806;93;4341.00;204
11714;91;628271784;11714;190;12521;12722;10.20;0.63;247.27;14.53;807;93;4342.00;201
11714;91;628271796;11714;195;12522;12722;10.25;0.63;247.27;14.53;808;93;4343.00;200
11718;91;628271807;11718;195;12525;12726;10.29;0.63;247.24;14.53;807;93;4344.00;201
11720;91;628271819;11720;192;12526;12726;10.32;0.63;247.28;14.53;806;93;4345.00;200
11722;91;628271831;11722;195;12528;12726;10.26;0.63;247.28;14.67;806;93;4346.00;198
11726;91;628271849;11726;196;12529;12727;10.25;0.63;247.31;14.67;803;93;4347.00;198
11728;91;628271861;11728;193;12529;12727;10.29;0.63;247.31;14.67;801;93;4348.00;198
11730;91;628271873;11730;192;12533;12733;10.27;0.63;247.29;14.82;803;93;4349.00;200
11735;91;628271887;11735;191;12534;12733;10.27;0.63;247.30;14.82;799;93;4350.00;199
11739;91;628271899;11739;187;12536;12734;10.21;0.62;247.32;14.96;797;93;4351.00;198
11743;91;628271911;11743;179;12536;12734;10.23;0.62;247.36;14.96;793;93;4352.00;198
11746;91;628271922;11746;175;12537;12734;10.33;0.63;247.39;14.96;791;93;4353.00;197
11751;91;628271940;11751;171;12538;12734;10.33;0.63;247.41;14.96;787;93;4354.00;196
11754;91;628271952;11754;170;12539;12734;10.38;0.63;247.41;14.98;785;93;4355.00;195
11757;91;628271965;11757;164;12549;12746;10.46;0.63;247.42;15.11;792;93;4356.00;197
11761;91;628271978;11761;167;12549;12746;10.56;0.64;247.42;15.11;788;93;4357.00;197
11762;91;628271990;11762;159;12551;12746;10.68;0.65;247.43;15.11;789;93;4358.00;195
11766;91;628272002;11766;152;12551;12746;10.73;0.65;247.41;15.11;785;93;4359.00;195
11770;91;628272013;11770;150;12552;12746;10.76;0.65;247.40;15.25;782;93;4360.00;194
11772;91;628272026;11772;143;12552;12746;10.89;0.66;247.41;15.25;780;93;4361.00;194
11774;91;628272037;11774;146;12555;12750;10.94;0.66;247.43;15.25;781;93;4362.00;195
11779;91;628272050;11779;146;12556;12750;11.00;0.66;247.43;15.39;777;93;4363.00;194
11783;91;628272070;11783;144;12558;12754;11.11;0.67;247.44;15.39;775;93;4364.00;196
11786;91;628272083;11786;141;12561;12756;11.17;0.68;247.45;15.38;775;93;4365.00;195
11786;91;628272097;11786;145;12562;12756;11.23;0.68;247.45;15.52;776;93;4366.00;194
11788;91;628272108;11788;148;12563;12756;11.28;0.68;247.49;15.53;775;93;4367.00;193
11790;91;628272121;11790;150;12571;12769;11.34;0.69;247.51;15.52;781;93;4368.00;198
11791;91;628272134;11791;154;12573;12769;11.39;0.69;247.52;15.52;782;93;4369.00;196
11794;91;628272146;11794;159;12574;12769;11.39;0.69;247.54;15.52;780;93;4370.00;195
11796;91;628272158;11796;157;12575;12770;11.34;0.69;247.53;15.52;779;93;4371.00;195
11798;91;628272177;11798;156;12576;12771;11.25;0.68;247.53;15.52;778;93;4372.00;195
11802;91;628272189;11802;162;12577;12771;11.13;0.68;247.52;15.53;775;93;4373.00;194
11804;91;628272202;11804;169;12580;12774;11.04;0.67;247.51;15.53;776;93;4374.00;194
11808;91;628272214;11808;176;12583;12774;10.99;0.67;247.50;15.54;775;93;4375.00;191
11810;91;628272226;11810;184;12583;12774;10.94;0.67;247.54;15.54;773;93;4376.00;191
11814;91;628272239;11814;190;12584;12774;10.79;0.66;247.56;15.54;770;93;4377.00;190
11816;91;628272251;11816;190;12588;12780;10.67;0.65;247.54;15.54;772;93;4378.00;192
11819;91;628272270;11819;194;12589;12780;10.57;0.64;247.55;15.54;770;93;4379.00;191
11823;91;628272285;11823;199;12593;12780;10.46;0.64;247.56;15.57;770;93;4380.00;187
11825;91;628272297;11825;203;12594;12780;10.35;0.63;247.53;15.57;769;93;4381.00;186
11827;91;628272308;11827;211;12598;12784;10.19;0.62;247.55;15.57;771;93;4382.00;186
11829;91;628272320;11829;218;12601;12785;10.12;0.62;247.54;15.59;772;93;4383.00;184
11831;91;628272332;11831;219;12603;12785;10.14;0.62;247.57;15.60;772;93;4384.00;182
11835;91;628272344;11835;229;12605;12786;10.13;0.62;247.56;15.61;770;93;4385.00;181
11837;91;628272356;11837;235;12606;12786;10.19;0.62;247.56;15.62;769;93;4386.00;180
11840;91;628272367;11840;240;12609;12786;10.16;0.62;247.57;15.64;769;93;4387.00;177
11843;91;628272379;11843;246;12612;12786;10.14;0.62;247.54;15.67;769;93;4388.00;174
11845;91;628272390;11845;249;12614;12786;10.09;0.61;247.53;15.68;769;93;4389.00;172
11847;91;628272402;11847;251;12616;12786;9.99;0.61;247.54;15.68;769;93;4390.00;170
11848;91;628272413;11848;253;12619;12786;9.87;0.60;247.54;15.70;771;93;4391.00;167
11849;91;628272424;11849;259;12654;12856;9.84;0.60;247.53;15.66;805;93;4392.00;202
11850;91;628272441;11850;263;12660;12857;9.75;0.60;247.53;15.67;810;93;4393.00;197
11853;91;628272453;11853;263;12664;12857;9.68;0.59;247.50;15.67;811;93;4394.00;193
11855;91;628272465;11855;267;12671;12857;9.67;0.59;247.48;15.68;816;93;4395.00;186
11858;91;628272478;11858;274;12676;12857;9.60;0.59;247.48;15.68;818;93;4396.00;181
11859;91;628272490;11859;279;12683;12857;9.51;0.58;247.53;15.67;824;93;4397.00;174
11862;91;628272504;11862;281;12686;12857;9.41;0.58;247.53;15.69;824;93;4398.00;171
11865;91;628272515;11865;276;12687;12857;9.33;0.57;247.53;15.69;822;93;4399.00;170
11869;91;628272528;11869;272;12691;12858;9.22;0.56;247.50;15.70;822;93;4400.00;167
11872;92;628272547;11872;270;12692;12859;9.09;0.56;247.52;15.70;820;94;4401.00;167
11875;92;628272578;11875;268;12695;12859;8.99;0.55;247.51;15.73;820;94;4402.00;164
11880;92;628272591;11880;270;12697;12863;8.87;0.54;247.47;15.73;817;94;4403.00;166
11884;92;628272603;11884;269;12697;12863;8.84;0.54;247.44;15.73;813;94;4404.00;166
11888;92;628272615;11888;268;12699;12863;8.73;0.53;247.40;15.76;811;94;4405.00;164
11894;92;628272630;11894;275;12699;12863;8.70;0.53;247.36;15.76;805;94;4406.00;164
11895;92;628272642;11895;281;12705;12869;8.67;0.53;247.36;15.78;810;94;4407.00;164
11897;92;628272652;11897;281;12705;12869;8.70;0.53;247.35;15.78;808;94;4408.00;164
11898;92;628272664;11898;282;12706;12869;8.72;0.53;247.35;15.78;808;94;4409.00;163
11902;92;628272676;11902;287;12713;12875;8.68;0.53;247.36;15.80;811;94;4410.00;162
11903;92;628272687;11903;289;12714;12875;8.69;0.53;247.35;15.80;811;94;4411.00;161
11908;92;628272698;11908;286;12716;12875;8.64;0.53;247.36;15.82;808;94;4412.00;159
11909;92;628272709;11909;287;12716;12876;8.52;0.52;247.36;15.82;807;94;4413.00;160
11915;92;628272719;11915;285;12717;12877;8.30;0.51;247.39;15.82;802;94;4414.00;160
11917;92;628272730;11917;287;12719;12877;8.05;0.49;247.40;15.85;802;94;4415.00;158
11923;92;628272740;11923;286;12730;12890;7.77;0.48;247.40;15.83;807;94;4416.00;160
11927;92;628272751;11927;288;12732;12890;7.55;0.46;247.44;15.85;805;94;4417.00;158
11931;92;628272761;11931;288;12732;12890;7.41;0.45;247.45;15.85;801;94;4418.00;158
11934;92;628272770;11934;295;12733;12891;7.29;0.45;247.46;15.85;799;94;4419.00;158
11938;92;628272780;11938;294;12733;12891;7.17;0.44;247.52;15.85;795;94;4420.00;158
11943;92;628272790;11943;287;12739;12895;7.07;0.43;247.52;15.87;796;94;4421.00;156
11946;92;628272800;11946;285;12739;12895;7.02;0.43;247.55;15.87;793;94;4422.00;156
11950;92;628272809;11950;291;12743;12899;6.91;0.42;247.58;15.88;793;94;4423.00;156
11952;92;628272819;11952;292;12745;12899;6.84;0.42;247.57;15.89;793;94;4424.00;154
11957;92;628272829;11957;295;12746;12899;6.74;0.41;247.59;15.89;789;94;4425.00;153
11959;92;628272839;11959;294;12747;12899;6.72;0.41;247.60;15.90;788;94;4426.00;152
11962;92;628272854;11962;297;12747;12899;6.75;0.41;247.58;15.90;785;94;4427.00;152
11966;92;628272863;11966;296;12760;12911;6.85;0.42;247.61;15.89;794;94;4428.00;151
11967;92;628272874;11967;296;12761;12911;6.96;0.43;247.62;15.88;794;94;4429.00;150
11971;92;628272889;11971;296;12761;12911;7.01;0.43;247.65;15.88;790;94;4430.00;150
11973;92;628272898;11973;295;12761;12911;7.07;0.43;247.68;15.88;788;94;4431.00;150
11977;92;628272909;11977;290;12761;12911;7.14;0.44;247.63;15.88;784;94;4432.00;150
11983;92;628272919;11983;289;12761;12911;7.12;0.43;247.61;15.88;778;94;4433.00;150
11986;92;628272929;11986;288;12761;12912;7.18;0.44;247.60;15.88;775;94;4434.00;151
11990;92;628272939;11990;280;12761;12912;7.18;0.44;247.59;15.88;771;94;4435.00;151
11990;92;628272948;11990;286;12765;12918;7.28;0.44;247.59;15.88;775;94;4436.00;153
11993;92;628272958;11993;276;12767;12919;7.36;0.45;247.60;15.88;774;94;4437.00;152
11996;92;628272969;11996;272;12767;12919;7.46;0.46;247.59;15.88;771;94;4438.00;152
11997;92;628272979;11997;267;12767;12919;7.59;0.46;247.60;15.88;770;94;4439.00;152
11999;92;628272990;11999;268;12771;12924;7.69;0.47;247.63;15.87;772;94;4440.00;153
12004;92;628273000;12004;270;12771;12924;7.66;0.47;247.69;15.87;767;94;4441.00;153
12010;92;628273010;12010;268;12772;12924;7.61;0.46;247.68;16.01;762;94;4442.00;152
12013;92;628273027;12013;270;12773;12925;7.66;0.47;247.69;16.01;760;94;4443.00;152
12014;92;628273038;12014;266;12776;12929;7.72;0.47;247.70;16.01;762;94;4444.00;153
12017;92;628273047;12017;262;12776;12929;7.76;0.47;247.70;16.01;759;94;4445.00;153
12018;92;628273057;12018;268;12778;12932;7.84;0.48;247.69;16.01;760;94;4446.00;154
12022;92;628273067;12022;262;12778;12932;7.85;0.48;247.72;16.01;756;94;4447.00;154
12023;92;628273077;12023;258;12779;12932;7.89;0.48;247.73;16.00;756;94;4448.00;153
12031;92;628273086;12031;256;12779;12932;7.86;0.48;247.64;16.00;748;94;4449.00;153
12035;92;628273096;12035;258;12782;12936;7.90;0.48;247.65;16.00;747;94;4450.00;154
12041;92;628273106;12041;258;12782;12936;7.90;0.48;247.64;16.00;741;94;4451.00;154
12043;92;628273116;12043;260;12783;12936;8.00;0.49;247.61;16.00;740;94;4452.00;153
12049;92;628273131;12049;265;12783;12936;7.95;0.49;247.63;16.00;734;94;4453.00;153
12052;92;628273142;12052;267;12783;12937;7.88;0.48;247.66;16.00;731;94;4454.00;154
12056;92;628273151;12056;276;12785;12939;7.85;0.48;247.63;16.00;729;94;4455.00;154
12060;92;628273161;12060;278;12785;12939;7.79;0.47;247.64;16.00;725;94;4456.00;154
12066;92;628273170;12066;281;12786;12940;7.68;0.47;247.64;16.00;720;94;4457.00;154
12070;92;628273186;12070;286;12786;12940;7.65;0.47;247.63;16.00;716;94;4458.00;154
12075;92;628273196;12075;293;12786;12940;7.58;0.46;247.60;16.00;711;94;4459.00;154
12081;92;628273207;12081;298;12786;12940;7.49;0.45;247.58;16.00;705;94;4460.00;154
12082;92;628273222;12082;302;12786;12940;7.45;0.45;247.57;16.00;704;94;4461.00;154
12083;92;628273232;12083;306;12787;12940;7.34;0.45;247.56;16.14;704;94;4462.00;153
12083;92;628273241;12083;311;12787;12940;7.32;0.45;247.56;16.14;704;94;4463.00;153
12085;92;628273251;12085;327;12855;13067;7.68;0.48;247.62;16.05;770;94;4464.00;212
12087;92;628273271;12087;330;12857;13068;7.56;0.47;247.62;16.05;770;94;4465.00;211
12089;92;628273281;12089;338;12868;13068;7.64;0.47;247.61;16.04;779;94;4466.00;200
12092;92;628273291;12092;332;12869;13068;7.59;0.47;247.62;16.04;777;94;4467.00;199
12095;92;628273305;12095;329;12874;13068;7.60;0.47;247.59;16.03;779;94;4468.00;194
12096;92;628273316;12096;325;12876;13068;7.58;0.47;247.58;16.03;780;94;4469.00;192
12097;92;628273327;12097;323;12881;13068;7.59;0.47;247.57;16.03;784;94;4470.00;187
12097;92;628273337;12097;322;12883;13068;7.61;0.47;247.57;16.02;786;94;4471.00;185
12097;92;628273347;12097;317;12887;13069;7.61;0.47;247.57;16.02;790;94;4472.00;182
12098;92;628273369;12098;319;12889;13070;7.55;0.47;247.57;16.02;791;94;4473.00;181
12098;92;628273380;12098;325;12893;13070;7.50;0.46;247.57;16.02;795;94;4474.00;177
12098;92;628273390;12098;316;12895;13071;7.46;0.46;247.57;16.02;797;94;4475.00;176
12101;92;628273401;12101;290;12899;13071;7.54;0.47;247.55;16.02;798;94;4476.00;172
12101;92;628273413;12101;279;12901;13071;7.65;0.47;247.55;16.02;800;94;4477.00;170
12103;92;628273424;12103;264;12903;13071;7.78;0.48;247.55;16.02;800;94;4478.00;168
12104;92;628273434;12104;260;12906;13075;7.92;0.49;247.54;16.01;802;94;4479.00;169
12104;92;628273446;12104;244;12908;13075;8.12;0.50;247.54;16.01;804;94;4480.00;167
12106;92;628273458;12106;234;12908;13075;8.27;0.51;247.53;16.01;802;94;4481.00;167
12106;92;628273477;12106;224;12911;13078;8.52;0.53;247.53;16.01;805;94;4482.00;167
12109;92;628273489;12109;216;12911;13078;8.71;0.54;247.56;16.01;802;94;4483.00;167
12113;92;628273502;12113;212;12912;13078;8.82;0.54;247.54;16.01;799;94;4484.00;166
12116;92;628273514;12116;207;12915;13082;8.93;0.55;247.54;16.01;799;94;4485.00;167
12119;92;628273526;12119;200;12917;13083;9.11;0.56;247.51;16.00;798;94;4486.00;166
12120;92;628273545;12120;192;12917;13083;9.34;0.57;247.51;16.00;797;94;4487.00;166
12123;92;628273561;12123;184;12921;13087;9.56;0.58;247.55;16.00;798;94;4488.00;166
12125;92;628273585;12125;179;12921;13087;9.70;0.59;247.59;16.00;796;94;4489.00;166
12131;92;628273602;12131;174;12921;13087;9.76;0.59;247.53;16.00;790;94;4490.00;166
12133;92;628273623;12133;166;12922;13088;9.83;0.60;247.53;16.00;789;94;4491.00;166
12137;92;628273642;12137;163;12922;13088;9.92;0.60;247.52;16.00;785;94;4492.00;166
12137;92;628273661;12137;157;12926;13094;10.06;0.61;247.52;15.99;789;94;4493.00;168
12137;92;628273678;12137;151;12926;13094;10.24;0.62;247.52;15.99;789;94;4494.00;168
12138;92;628273691;12138;148;12927;13095;10.38;0.63;247.51;15.99;789;94;4495.00;168
12140;92;628273705;12140;139;12927;13095;10.55;0.64;247.51;15.99;787;94;4496.00;168
12145;92;628273717;12145;137;12927;13095;10.67;0.65;247.51;15.99;782;94;4497.00;168
12147;92;628273737;12147;133;12927;13095;10.79;0.66;247.54;15.99;780;94;4498.00;168
12148;92;628273750;12148;136;12927;13095;10.90;0.66;247.53;15.99;779;94;4499.00;168
12152;92;628273772;12152;136;12950;13145;10.89;0.67;247.56;15.96;798;94;4500.00;195
12155;92;628273793;12155;136;12952;13147;10.98;0.67;247.58;16.10;797;94;4501.00;195
12159;93;628273806;12159;135;12955;13147;11.04;0.67;247.57;16.10;796;95;4502.00;192
12160;93;628273839;12160;128;12955;13147;11.19;0.68;247.58;16.10;795;95;4503.00;192
12166;93;628273851;12166;122;12956;13147;11.30;0.69;247.61;16.10;790;95;4504.00;191
12170;93;628273863;12170;127;12956;13147;11.39;0.69;247.64;16.10;786;95;4505.00;191
12173;93;628273876;12173;129;12962;13151;11.38;0.69;247.65;16.09;789;95;4506.00;189
12178;93;628273888;12178;125;12962;13151;11.39;0.69;247.66;16.09;784;95;4507.00;189
12182;93;628273900;12182;121;12966;13155;11.49;0.70;247.63;16.09;784;95;4508.00;189
12184;93;628273913;12184;118;12968;13156;11.53;0.70;247.65;16.09;784;95;4509.00;188
12188;93;628273925;12188;115;12968;13156;11.58;0.70;247.68;16.09;780;95;4510.00;188
12194;93;628273938;12194;122;12968;13156;11.62;0.71;247.66;16.09;774;95;4511.00;188
12198;93;628273950;12198;127;12975;13169;11.61;0.71;247.67;16.08;777;95;4512.00;194
12199;93;628273964;12199;129;12976;13169;11.68;0.71;247.66;16.08;777;95;4513.00;193
12200;93;628273976;12200;134;12977;13169;11.71;0.71;247.66;16.08;777;95;4514.00;192
12204;93;628273988;12204;133;12978;13170;11.73;0.71;247.65;16.08;774;95;4515.00;192
12207;93;628274000;12207;139;12978;13171;11.69;0.71;247.68;16.08;771;95;4516.00;193
12210;93;628274012;12210;140;12978;13171;11.74;0.71;247.68;16.08;768;95;4517.00;193
12213;93;628274025;12213;145;12980;13174;11.81;0.72;247.73;16.08;767;95;4518.00;194
12215;93;628274037;12215;144;12981;13174;11.84;0.72;247.74;16.08;766;95;4519.00;193
12219;93;628274049;12219;134;12982;13174;11.80;0.72;247.76;16.08;763;95;4520.00;192
12225;93;628274061;12225;129;12982;13174;11.83;0.72;247.78;16.08;757;95;4521.00;192
12227;93;628274072;12227;125;12985;13180;11.87;0.72;247.79;16.07;758;95;4522.00;195
12230;93;628274085;12230;121;12985;13180;11.93;0.73;247.81;16.07;755;95;4523.00;195
12232;93;628274097;12232;121;12986;13180;11.99;0.73;247.82;16.21;754;95;4524.00;194
12235;93;628274111;12235;117;12989;13180;11.94;0.73;247.82;16.24;754;95;4525.00;191
12241;93;628274124;12241;115;12992;13184;11.92;0.72;247.81;16.24;751;95;4526.00;192
12244;93;628274136;12244;116;12994;13185;11.94;0.73;247.84;16.24;750;95;4527.00;191
12250;93;628274148;12250;113;12994;13185;11.93;0.72;247.78;16.24;744;95;4528.00;191
12252;93;628274161;12252;110;12995;13186;11.90;0.72;247.78;16.24;743;95;4529.00;191
12254;93;628274180;12254;112;12995;13186;11.97;0.73;247.78;16.24;741;95;4530.00;191
12259;93;628274192;12259;112;12996;13186;12.04;0.73;247.80;16.24;737;95;4531.00;190
12261;93;628274204;12261;110;12996;13186;12.06;0.73;247.78;16.24;735;95;4532.00;190
12264;93;628274218;12264;113;12997;13186;12.07;0.73;247.79;16.24;733;95;4533.00;189
12266;93;628274229;12266;111;12998;13186;12.14;0.74;247.77;16.24;732;95;4534.00;188
12268;93;628274241;12268;115;12999;13186;12.17;0.74;247.78;16.24;731;95;4535.00;187
12270;93;628274253;12270;123;13037;13256;11.97;0.73;247.83;16.20;767;95;4536.00;219
12271;93;628274271;12271;123;13039;13257;11.96;0.73;247.83;16.20;768;95;4537.00;218
12273;93;628274284;12273;120;13043;13257;12.00;0.73;247.83;16.20;770;95;4538.00;214
12278;93;628274296;12278;122;13045;13257;11.99;0.73;247.81;16.20;767;95;4539.00;212
12283;93;628274309;12283;125;13047;13257;11.96;0.73;247.79;16.19;764;95;4540.00;210
12290;93;628274327;12290;125;13050;13257;11.86;0.72;247.85;16.20;760;95;4541.00;207
12293;93;628274340;12293;132;13055;13257;11.75;0.71;247.86;16.20;762;95;4542.00;202
12294;93;628274352;12294;132;13057;13257;11.76;0.72;247.86;16.20;763;95;4543.00;200
12299;93;628274364;12299;135;13059;13258;11.72;0.71;247.85;16.20;760;95;4544.00;199
12303;93;628274376;12303;135;13063;13260;11.67;0.71;247.82;16.19;760;95;4545.00;197
12303;93;628274395;12303;141;13064;13260;11.58;0.71;247.82;16.19;761;95;4546.00;196
12307;93;628274407;12307;144;13068;13264;11.41;0.70;247.82;16.19;761;95;4547.00;196
12309;93;628274419;12309;150;13073;13264;11.28;0.69;247.81;16.19;764;95;4548.00;191
12314;93;628274431;12314;158;13074;13264;11.19;0.68;247.80;16.19;760;95;4549.00;190
12315;93;628274448;12315;161;13080;13264;10.99;0.67;247.81;16.22;765;95;4550.00;184
12319;93;628274460;12319;166;13084;13270;11.01;0.67;247.80;16.22;765;95;4551.00;186
12321;93;628274474;12321;173;13084;13270;10.95;0.67;247.78;16.22;763;95;4552.00;186
12325;93;628274486;12325;178;13086;13270;10.90;0.67;247.78;16.24;761;95;4553.00;184
12329;93;628274497;12329;185;13089;13273;10.86;0.66;247.81;16.24;760;95;4554.00;184
12332;93;628274510;12332;192;13092;13273;10.79;0.66;247.83;16.25;760;95;4555.00;181
12333;93;628274521;12333;199;13093;13273;10.68;0.65;247.87;16.27;760;95;4556.00;180
12339;93;628274538;12339;200;13095;13274;10.48;0.64;247.96;16.27;756;95;4557.00;179
12341;93;628274554;12341;212;13098;13275;10.35;0.63;247.94;16.29;757;95;4558.00;177
12344;93;628274569;12344;218;13099;13275;10.34;0.63;247.94;16.29;755;95;4559.00;176
12346;93;628274582;12346;226;13116;13301;10.30;0.63;247.92;16.29;770;95;4560.00;185
12351;93;628274595;12351;231;13119;13301;10.21;0.62;247.93;16.29;768;95;4561.00;182
12353;93;628274612;12353;239;13122;13301;10.16;0.62;247.93;16.31;769;95;4562.00;179
12356;93;628274626;12356;244;13124;13302;10.12;0.62;247.93;16.30;768;95;4563.00;178
12358;93;628274637;12358;250;13125;13302;10.05;0.61;247.97;16.30;767;95;4564.00;177
12363;93;628274647;12363;260;13130;13306;9.94;0.60;247.96;16.33;767;95;4565.00;176
12365;93;628274658;12365;260;13133;13306;9.79;0.59;247.96;16.36;768;95;4566.00;173
12367;93;628274668;12367;265;13138;13310;9.55;0.58;247.94;16.38;771;95;4567.00;172
12371;93;628274679;12371;271;13138;13310;9.30;0.57;247.96;16.38;767;95;4568.00;172
12373;93;628274688;12373;268;13139;13310;9.07;0.55;247.96;16.39;766;95;4569.00;171
12374;93;628274698;12374;265;13140;13310;8.78;0.54;247.96;16.41;766;95;4570.00;170
12375;93;628274707;12375;259;13141;13310;8.56;0.52;247.95;16.41;766;95;4571.00;169
12377;93;628274717;12377;262;13151;13322;8.45;0.52;247.94;16.41;774;95;4572.00;171
12377;93;628274727;12377;267;13152;13322;8.34;0.51;247.94;16.42;775;95;4573.00;170
12379;93;628274737;12379;267;13155;13322;8.25;0.51;247.93;16.43;776;95;4574.00;167
12380;93;628274746;12380;269;13156;13322;8.19;0.50;247.93;16.43;776;95;4575.00;166
12381;93;628274755;12381;272;13158;13322;8.08;0.50;247.92;16.44;777;95;4576.00;164
12383;93;628274764;12383;272;13158;13322;8.07;0.50;247.92;16.44;775;95;4577.00;164
12385;93;628274773;12385;275;13158;13323;8.06;0.50;247.92;16.44;773;95;4578.00;165
12390;93;628274783;12390;287;13160;13323;8.02;0.49;247.90;16.47;770;95;4579.00;163
12393;93;628274792;12393;293;13164;13329;8.08;0.50;247.89;16.46;771;95;4580.00;165
12394;93;628274802;12394;294;13167;13330;8.07;0.50;247.94;16.48;773;95;4581.00;163
12396;93;628274811;12396;300;13168;13330;7.99;0.49;247.92;16.48;772;95;4582.00;162
12402;93;628274820;12402;303;13169;13330;7.79;0.48;247.90;16.49;767;95;4583.00;161
12405;93;628274829;12405;309;13173;13334;7.75;0.48;247.88;16.50;768;95;4584.00;161
12410;93;628274838;12410;311;13173;13334;7.65;0.47;247.86;16.50;763;95;4585.00;161
12410;93;628274847;12410;314;13173;13334;7.52;0.46;247.86;16.50;763;95;4586.00;161
12416;93;628274855;12416;317;13176;13335;7.41;0.45;247.84;16.51;760;95;4587.00;159
12420;93;628274863;12420;326;13179;13339;7.20;0.44;247.86;16.51;759;95;4588.00;160
12423;93;628274872;12423;330;13181;13339;7.02;0.43;247.88;16.53;758;95;4589.00;158
12430;93;628274882;12430;320;13184;13345;6.91;0.42;247.88;16.52;754;95;4590.00;161
12435;93;628274892;12435;318;13184;13345;6.79;0.42;247.88;16.52;749;95;4591.00;161
12440;93;628274900;12440;311;13187;13345;6.68;0.41;247.88;16.54;747;95;4592.00;158
12442;93;628274908;12442;307;13187;13345;6.61;0.40;247.90;16.54;745;95;4593.00;158
12447;93;628274916;12447;298;13190;13349;6.52;0.40;247.89;16.54;743;95;4594.00;159
12449;93;628274925;12449;298;13190;13349;6.56;0.40;247.90;16.54;741;95;4595.00;159
12455;93;628274933;12455;301;13193;13349;6.52;0.40;247.93;16.55;738;95;4596.00;156
12459;93;628274942;12459;291;13193;13349;6.56;0.40;247.90;16.55;734;95;4597.00;156
12464;93;628274950;12464;286;13196;13350;6.61;0.40;247.90;16.57;732;95;4598.00;154
12466;93;628274959;12466;282;13197;13351;6.67;0.41;247.91;16.56;731;95;4599.00;154
12469;93;628274969;12469;280;13200;13351;6.68;0.41;247.92;16.58;731;95;4600.00;151
12473;93;628274980;12473;279;13201;13352;6.70;0.41;247.90;16.58;728;95;4601.00;151
12477;93;628274989;12477;280;13201;13352;6.61;0.40;247.88;16.58;724;95;4602.00;151
12478;93;628274997;12478;285;13201;13352;6.64;0.41;247.90;16.58;723;95;4603.00;151
12481;93;628275006;12481;294;13201;13352;6.61;0.40;247.89;16.58;720;95;4604.00;151
12487;93;628275014;12487;294;13201;13352;6.52;0.40;247.85;16.58;714;95;4605.00;151
12490;93;628275023;12490;297;13201;13352;6.47;0.39;247.82;16.58;711;95;4606.00;151
12493;93;628275031;12493;303;13201;13352;6.42;0.39;247.84;16.58;708;95;4607.00;151
12497;93;628275038;12497;313;13267;13479;7.04;0.44;247.82;16.49;770;95;4608.00;212
12500;93;628275056;12500;316;13270;13480;7.11;0.44;247.81;16.49;770;95;4609.00;210
12503;93;628275065;12503;313;13278;13480;7.28;0.45;247.82;16.48;775;95;4610.00;202
12506;93;628275074;12506;311;13282;13480;7.32;0.45;247.81;16.62;776;95;4611.00;198
12508;93;628275085;12508;310;13287;13480;7.33;0.45;247.81;16.62;779;95;4612.00;193
12509;93;628275094;12509;310;13289;13480;7.32;0.45;247.80;16.61;780;95;4613.00;191
12513;93;628275110;12513;316;13293;13480;7.34;0.45;247.76;16.61;780;95;4614.00;187
12516;93;628275119;12516;311;13294;13480;7.29;0.45;247.77;16.61;778;95;4615.00;186
12517;94;628275128;12517;311;13299;13481;7.31;0.45;247.77;16.61;782;96;4616.00;182
12521;94;628275148;12521;317;13300;13482;7.26;0.45;247.75;16.61;779;96;4617.00;182
12523;94;628275163;12523;320;13305;13482;7.29;0.45;247.77;16.60;782;96;4618.00;177
12526;94;628275173;12526;323;13306;13483;7.32;0.45;247.83;16.60;780;96;4619.00;177
12529;94;628275185;12529;326;13312;13483;7.37;0.45;247.82;16.60;783;96;4620.00;171
12534;94;628275194;12534;326;13313;13483;7.36;0.45;247.82;16.60;779;96;4621.00;170
12536;94;628275205;12536;320;13318;13483;7.38;0.46;247.86;16.60;782;96;4622.00;165
12540;94;628275215;12540;324;13321;13487;7.29;0.45;247.84;16.60;781;96;4623.00;166
12541;94;628275226;12541;324;13322;13487;7.26;0.45;247.85;16.60;781;96;4624.00;165
12544;94;628275239;12544;327;13323;13487;7.22;0.45;247.86;16.60;779;96;4625.00;164
12545;94;628275249;12545;328;13325;13490;7.20;0.44;247.87;16.60;780;96;4626.00;165
12548;94;628275269;12548;323;13327;13490;7.20;0.44;247.85;16.59;779;96;4627.00;163
12549;94;628275280;12549;316;13328;13490;7.22;0.45;247.90;16.59;779;96;4628.00;162
12549;94;628275290;12549;312;13331;13494;7.30;0.45;247.90;16.59;782;96;4629.00;163
12552;94;628275300;12552;313;13333;13495;7.39;0.46;247.90;16.59;781;96;4630.00;162
12558;94;628275311;12558;313;13333;13495;7.43;0.46;247.88;16.59;775;96;4631.00;162
12558;94;628275322;12558;306;13336;13499;7.52;0.47;247.88;16.58;778;96;4632.00;163
12564;94;628275343;12564;303;13336;13499;7.52;0.46;247.85;16.58;772;96;4633.00;163
12566;94;628275355;12566;303;13336;13499;7.57;0.47;247.85;16.58;770;96;4634.00;163
12569;94;628275365;12569;302;13338;13501;7.64;0.47;247.86;16.58;769;96;4635.00;163
12571;94;628275376;12571;298;13338;13501;7.75;0.48;247.88;16.58;767;96;4636.00;163
12574;94;628275388;12574;284;13342;13507;7.90;0.49;247.87;16.58;768;96;4637.00;165
12576;94;628275399;12576;273;13342;13507;8.02;0.49;247.85;16.58;766;96;4638.00;165
12577;94;628275410;12577;265;13343;13508;8.18;0.50;247.83;16.58;766;96;4639.00;165
12581;94;628275421;12581;256;13343;13508;8.32;0.51;247.81;16.58;762;96;4640.00;165
12582;94;628275432;12582;250;13343;13508;8.46;0.52;247.82;16.58;761;96;4641.00;165
12585;94;628275444;12585;245;13343;13508;8.58;0.53;247.81;16.58;758;96;4642.00;165
12589;94;628275455;12589;243;13343;13508;8.67;0.53;247.82;16.58;754;96;4643.00;165
12591;94;628275472;12591;241;13353;13520;8.88;0.54;247.80;16.56;762;96;4644.00;167
12593;94;628275485;12593;230;13353;13520;8.99;0.55;247.78;16.56;760;96;4645.00;167
12595;94;628275496;12595;213;13354;13520;9.21;0.56;247.81;16.56;759;96;4646.00;166
12596;94;628275508;12596;189;13354;13520;9.39;0.57;247.80;16.56;758;96;4647.00;166
12600;94;628275524;12600;178;13354;13520;9.58;0.58;247.81;16.56;754;96;4648.00;166
12603;94;628275536;12603;169;13354;13520;9.79;0.60;247.82;16.56;751;96;4649.00;166
12603;94;628275550;12603;157;13359;13526;9.96;0.61;247.82;16.56;756;96;4650.00;167
12606;95;628275568;12606;150;13359;13526;10.17;0.62;247.85;16.56;753;97;4651.00;167
12610;95;628275608;12610;147;13362;13530;10.34;0.63;247.84;16.55;752;97;4652.00;168
12611;95;628275628;12611;146;13364;13531;10.48;0.64;247.85;16.55;753;97;4653.00;167
12615;95;628275647;12615;138;13364;13531;10.60;0.64;247.86;16.55;749;97;4654.00;167
12621;95;628275666;12621;134;13364;13531;10.68;0.65;247.89;16.55;743;97;4655.00;167
12623;95;628275681;12623;133;13375;13544;10.81;0.66;247.91;16.54;752;97;4656.00;169
12625;95;628275695;12625;138;13375;13544;10.98;0.67;247.90;16.54;750;97;4657.00;169
12629;95;628275709;12629;137;13375;13544;11.13;0.67;247.92;16.54;746;97;4658.00;169
12631;95;628275722;12631;131;13376;13545;11.23;0.68;247.97;16.54;745;97;4659.00;169
12637;95;628275736;12637;131;13376;13546;11.34;0.69;247.97;16.54;739;97;4660.00;170
12640;95;628275750;12640;126;13376;13546;11.38;0.69;247.99;16.54;736;97;4661.00;170
12644;95;628275764;12644;118;13378;13549;11.43;0.69;247.98;16.53;734;97;4662.00;171
12647;95;628275777;12647;119;13378;13549;11.40;0.69;247.99;16.53;731;97;4663.00;171
12648;95;628275790;12648;118;13379;13549;11.45;0.69;248.01;16.53;731;97;4664.00;170
12650;95;628275802;12650;119;13379;13549;11.50;0.70;248.05;16.53;729;97;4665.00;170
12651;95;628275816;12651;117;13383;13555;11.58;0.70;248.05;16.53;732;97;4666.00;172
12655;95;628275828;12655;115;13384;13555;11.67;0.71;248.07;16.53;729;97;4667.00;171
12661;95;628275841;12661;116;13384;13555;11.76;0.71;248.07;16.53;723;97;4668.00;171
12664;95;628275853;12664;120;13384;13555;11.81;0.71;248.05;16.53;720;97;4669.00;171
12666;95;628275872;12666;125;13387;13559;11.72;0.71;248.07;16.52;721;97;4670.00;172
12666;95;628275884;12666;126;13388;13560;11.71;0.71;248.07;16.52;722;97;4671.00;172
12668;95;628275897;12668;127;13388;13560;11.68;0.71;248.11;16.52;720;97;4672.00;172
12670;95;628275915;12670;130;13389;13561;11.69;0.71;248.13;16.52;719;97;4673.00;172
12673;95;628275933;12673;129;13389;13561;11.71;0.71;248.11;16.52;716;97;4674.00;172
12675;95;628275952;12675;127;13389;13561;11.78;0.71;248.14;16.52;714;97;4675.00;172
12677;95;628275964;12677;123;13390;13561;11.81;0.71;248.16;16.66;713;97;4676.00;171
12681;95;628275978;12681;125;13390;13561;11.80;0.71;248.16;16.66;709;97;4677.00;171
12682;95;628275990;12682;130;13390;13561;11.85;0.72;248.18;16.66;708;97;4678.00;171
12686;95;628276002;12686;126;13390;13561;11.83;0.72;248.23;16.66;704;97;4679.00;171
12687;95;628276015;12687;151;13456;13686;11.49;0.70;248.25;16.58;769;97;4680.00;230
12688;95;628276038;12688;139;13456;13687;11.57;0.71;248.24;16.58;768;97;4681.00;231
12691;95;628276050;12691;129;13465;13687;11.67;0.71;248.32;16.57;774;97;4682.00;222
12693;95;628276063;12693;123;13469;13687;11.81;0.72;248.34;16.57;776;97;4683.00;218
12697;95;628276074;12697;123;13472;13687;11.88;0.73;248.34;16.57;775;97;4684.00;215
12700;95;628276087;12700;120;13475;13687;11.93;0.73;248.36;16.56;775;97;4685.00;212
12705;95;628276100;12705;122;13479;13687;11.97;0.73;248.38;16.56;774;97;4686.00;208
12709;95;628276113;12709;125;13480;13687;11.99;0.73;248.42;16.56;771;97;4687.00;207
12714;95;628276125;12714;127;13484;13688;12.03;0.73;248.40;16.56;770;97;4688.00;204
12718;95;628276138;12718;131;13485;13689;11.96;0.73;248.38;16.56;767;97;4689.00;204
12722;95;628276156;12722;137;13487;13689;11.91;0.73;248.36;16.55;765;97;4690.00;202
12726;95;628276168;12726;137;13492;13693;11.80;0.72;248.42;16.55;766;97;4691.00;201
12728;95;628276181;12728;131;13494;13693;11.71;0.71;248.40;16.69;766;97;4692.00;199
12731;95;628276193;12731;134;13494;13693;11.57;0.71;248.42;16.69;763;97;4693.00;199
12737;95;628276211;12737;129;13495;13693;11.47;0.70;248.39;16.69;758;97;4694.00;198
12740;95;628276224;12740;128;13501;13699;11.37;0.69;248.40;16.85;761;97;4695.00;198
12741;95;628276239;12741;130;13501;13699;11.44;0.70;248.40;16.85;760;97;4696.00;198
12744;95;628276252;12744;129;13504;13699;11.48;0.70;248.41;16.99;760;97;4697.00;195
12746;95;628276265;12746;132;13506;13702;11.58;0.70;248.44;16.98;760;97;4698.00;196
12748;96;628276277;12748;129;13508;13702;11.60;0.71;248.41;17.12;760;98;4699.00;194
12750;96;628276308;12750;130;13509;13702;11.64;0.71;248.44;17.11;759;98;4700.00;193
12752;96;628276324;12752;128;13510;13703;11.72;0.72;248.44;17.25;758;98;4701.00;193
12755;96;628276336;12755;127;13511;13704;11.80;0.72;248.43;17.25;756;98;4702.00;193
12760;96;628276348;12760;126;13512;13704;11.82;0.72;248.45;17.38;752;98;4703.00;192
12762;96;628276360;12762;128;13521;13717;11.81;0.72;248.43;17.37;759;98;4704.00;196
12771;96;628276373;12771;127;13521;13717;11.85;0.72;248.46;17.37;750;98;4705.00;196
12773;96;628276388;12773;130;13522;13717;11.77;0.72;248.48;17.50;749;98;4706.00;195
12776;96;628276401;12776;132;13524;13718;11.79;0.72;248.53;17.50;748;98;4707.00;194
12778;96;628276413;12778;132;13524;13718;11.82;0.72;248.53;17.50;746;98;4708.00;194
12781;97;628276424;12781;134;13526;13722;11.85;0.72;248.56;17.50;745;99;4709.00;196
12785;97;628276462;12785;141;13530;13722;11.77;0.71;248.54;17.63;745;99;4710.00;192
12787;97;628276475;12787;140;13533;13726;11.67;0.71;248.56;17.63;746;99;4711.00;193
12790;97;628276487;12790;143;13533;13726;11.65;0.71;248.54;17.63;743;99;4712.00;193
12794;97;628276506;12794;145;13535;13726;11.56;0.70;248.55;17.76;741;99;4713.00;191
12796;97;628276519;12796;142;13535;13726;11.50;0.70;248.54;17.76;739;99;4714.00;191
12799;97;628276532;12799;148;13536;13726;11.45;0.69;248.53;17.76;737;99;4715.00;190
12801;97;628276544;12801;154;13546;13738;11.35;0.69;248.54;17.75;745;99;4716.00;192
12804;97;628276559;12804;164;13547;13738;11.31;0.69;248.52;17.75;743;99;4717.00;191
12807;97;628276573;12807;168;13548;13738;11.24;0.69;248.57;17.75;741;99;4718.00;190
12811;97;628276585;12811;176;13549;13738;11.12;0.68;248.60;17.75;738;99;4719.00;189
12811;97;628276616;12811;183;13549;13738;11.07;0.68;248.60;17.75;738;99;4720.00;189
12814;97;628276627;12814;181;13550;13738;10.95;0.67;248.62;17.75;736;99;4721.00;188
12816;97;628276638;12816;191;13552;13739;10.85;0.66;248.62;17.78;736;99;4722.00;187
12817;97;628276649;12817;194;13553;13739;10.73;0.66;248.63;17.79;736;99;4723.00;186
12821;97;628276659;12821;203;13560;13745;10.67;0.65;248.61;17.83;739;99;4724.00;185
12823;97;628276676;12823;206;13563;13747;10.60;0.65;248.60;17.83;740;99;4725.00;184
12826;97;628276687;12826;215;13563;13747;10.50;0.64;248.60;17.83;737;99;4726.00;184
12831;97;628276703;12831;221;13566;13747;10.39;0.64;248.60;17.86;735;99;4727.00;181
12833;97;628276713;12833;224;13569;13751;10.31;0.63;248.59;17.86;736;99;4728.00;182
12835;97;628276724;12835;231;13570;13751;10.22;0.62;248.58;17.87;735;99;4729.00;181
12838;97;628276734;12838;237;13570;13751;10.15;0.62;248.58;17.87;732;99;4730.00;181
12841;97;628276744;12841;241;13574;13752;10.10;0.62;248.59;17.90;733;99;4731.00;178
12842;97;628276755;12842;248;13577;13756;10.04;0.61;248.62;17.90;735;99;4732.00;179
12844;97;628276766;12844;250;13578;13756;9.98;0.61;248.60;17.91;734;99;4733.00;178
12845;97;628276776;12845;254;13581;13759;9.93;0.61;248.61;17.92;736;99;4734.00;178
12848;97;628276791;12848;262;13582;13759;9.80;0.60;248.64;17.93;734;99;4735.00;177
12849;97;628276801;12849;265;13584;13759;9.70;0.60;248.63;17.94;735;99;4736.00;175
12853;97;628276811;12853;268;13585;13759;9.51;0.58;248.60;17.94;732;99;4737.00;174
12857;97;628276820;12857;272;13589;13763;9.35;0.57;248.56;17.95;732;99;4738.00;174
12859;97;628276830;12859;271;13590;13763;9.23;0.57;248.56;17.96;731;99;4739.00;173
12861;97;628276841;12861;271;13592;13763;9.04;0.56;248.57;17.97;731;99;4740.00;171
12865;97;628276851;12865;273;13592;13763;8.89;0.55;248.57;17.97;727;99;4741.00;171
12870;97;628276860;12870;273;13593;13764;8.69;0.53;248.53;17.97;723;99;4742.00;171
12874;97;628276870;12874;275;13595;13765;8.58;0.53;248.55;17.98;721;99;4743.00;170
12878;97;628276884;12878;275;13596;13765;8.46;0.52;248.53;17.99;718;99;4744.00;169
12881;97;628276893;12881;276;13598;13766;8.36;0.51;248.54;18.00;717;99;4745.00;168
12883;97;628276903;12883;281;13598;13766;8.23;0.51;248.54;18.00;715;99;4746.00;168
12886;97;628276912;12886;273;13601;13766;8.14;0.50;248.54;18.02;715;99;4747.00;165
12889;97;628276921;12889;278;13601;13766;8.06;0.49;248.52;18.02;712;99;4748.00;165
12893;97;628276929;12893;281;13602;13766;7.95;0.49;248.51;18.03;709;99;4749.00;164
12894;97;628276938;12894;286;13603;13766;7.81;0.48;248.49;18.04;709;99;4750.00;163
12899;97;628276946;12899;299;13603;13766;7.63;0.47;248.49;18.04;704;99;4751.00;163
12900;97;628276954;12900;315;13667;13893;7.73;0.48;248.48;17.96;767;99;4752.00;226
12903;97;628276972;12903;315;13673;13894;7.54;0.47;248.45;17.98;770;99;4753.00;221
12907;97;628276981;12907;303;13682;13894;7.51;0.47;248.50;17.97;775;99;4754.00;212
12912;97;628276989;12912;301;13687;13894;7.37;0.46;248.49;17.97;775;99;4755.00;207
12913;97;628276998;12913;302;13693;13894;7.27;0.45;248.48;17.97;780;99;4756.00;201
12917;97;628277006;12917;300;13699;13894;7.05;0.44;248.47;17.97;782;99;4757.00;195
12921;97;628277014;12921;306;13705;13894;6.90;0.43;248.45;17.97;784;99;4758.00;189
12921;97;628277022;12921;314;13707;13894;6.80;0.42;248.45;17.97;786;99;4759.00;187
12924;97;628277030;12924;302;13712;13895;6.70;0.41;248.46;17.98;788;99;4760.00;183
12928;97;628277039;12928;303;13714;13896;6.66;0.41;248.44;17.98;786;99;4761.00;182
12929;97;628277047;12929;305;13717;13896;6.65;0.41;248.43;17.98;788;99;4762.00;179
12932;97;628277055;12932;308;13723;13897;6.59;0.41;248.44;17.99;791;99;4763.00;174
12934;97;628277064;12934;308;13725;13897;6.53;0.40;248.44;17.99;791;99;4764.00;172
12937;97;628277072;12937;315;13727;13897;6.44;0.40;248.44;17.99;790;99;4765.00;170
12939;97;628277081;12939;317;13730;13897;6.37;0.40;248.46;18.00;791;99;4766.00;167
12942;97;628277089;12942;317;13733;13901;6.37;0.39;248.45;17.99;791;99;4767.00;168
12944;97;628277099;12944;313;13735;13901;6.36;0.39;248.46;18.00;791;99;4768.00;166
12947;97;628277108;12947;320;13737;13901;6.34;0.39;248.47;18.00;790;99;4769.00;164
12948;97;628277118;12948;314;13741;13907;6.41;0.40;248.49;18.00;793;99;4770.00;166
12950;97;628277128;12950;317;13742;13907;6.46;0.40;248.48;18.00;792;99;4771.00;165
12951;97;628277137;12951;324;13744;13907;6.50;0.40;248.48;17.99;793;99;4772.00;163
12955;97;628277146;12955;324;13748;13911;6.52;0.40;248.48;17.99;793;99;4773.00;163
12961;97;628277155;12961;329;13750;13912;6.50;0.40;248.47;17.99;789;99;4774.00;162
12962;97;628277165;12962;329;13750;13912;6.56;0.40;248.46;17.99;788;99;4775.00;162
12968;97;628277174;12968;328;13753;13916;6.60;0.40;248.46;17.98;785;99;4776.00;163
12973;97;628277184;12973;325;13753;13916;6.61;0.40;248.45;17.98;780;99;4777.00;163
12973;97;628277199;12973;328;13753;13916;6.72;0.41;248.45;17.98;780;99;4778.00;163
12975;97;628277208;12975;314;13754;13917;6.83;0.42;248.46;17.98;779;99;4779.00;163
12980;97;628277217;12980;301;13754;13917;6.89;0.42;248.46;17.98;774;99;4780.00;163
12982;97;628277227;12982;291;13758;13923;6.97;0.43;248.46;17.98;776;99;4781.00;165
12986;97;628277237;12986;278;13758;13923;7.12;0.43;248.46;17.98;772;99;4782.00;165
12989;97;628277247;12989;270;13759;13924;7.37;0.45;248.45;17.98;770;99;4783.00;165
12993;97;628277257;12993;257;13759;13924;7.50;0.46;248.42;17.98;766;99;4784.00;165
12993;97;628277268;12993;256;13759;13924;7.63;0.46;248.42;17.98;766;99;4785.00;165
12995;97;628277284;12995;257;13759;13924;7.77;0.47;248.42;17.98;764;99;4786.00;165
12997;97;628277295;12997;252;13759;13924;7.82;0.48;248.48;17.98;762;99;4787.00;165
13000;97;628277306;13000;251;13768;13936;8.02;0.49;248.46;17.96;768;99;4788.00;168
13004;97;628277319;13004;246;13769;13936;8.09;0.49;248.46;18.10;765;99;4789.00;167
13006;98;628277332;13006;244;13771;13936;8.19;0.50;248.48;18.10;765;100;4790.00;165
13011;99;628277362;13011;245;13771;13936;8.24;0.50;248.46;18.10;760;101;4791.00;165
13016;99;628277389;13016;246;13771;13936;8.33;0.50;248.46;18.10;755;101;4792.00;165
13018;100;628277400;13018;243;13771;13936;8.41;0.51;248.46;18.10;753;102;4793.00;165
13020;100;628277417;13020;248;13774;13940;8.49;0.51;248.46;18.10;754;102;4794.00;166
13021;100;628277428;13021;245;13774;13940;8.54;0.52;248.46;18.10;753;102;4795.00;166
13023;100;628277450;13023;244;13777;13944;8.57;0.52;248.47;18.09;754;102;4796.00;167
13024;100;628277467;13024;246;13778;13945;8.58;0.52;248.47;18.09;754;102;4797.00;167
13025;100;628277478;13025;249;13779;13945;8.67;0.53;248.47;18.09;754;102;4798.00;166
13027;100;628277489;13027;249;13779;13945;8.73;0.53;248.49;18.09;752;102;4799.00;166
13029;100;628277503;13029;257;13800;13986;8.84;0.54;248.50;18.06;771;102;4800.00;186
13031;100;628277521;13031;256;13800;13986;8.80;0.53;248.49;18.06;769;102;4801.00;186
13033;100;628277538;13033;255;13803;13986;8.75;0.53;248.49;18.06;770;102;4802.00;183
13035;100;628277549;13035;251;13805;13987;8.71;0.53;248.47;18.06;770;102;4803.00;182
13038;100;628277569;13038;251;13807;13988;8.67;0.53;248.49;18.05;769;102;4804.00;181
13041;100;628277593;13041;251;13808;13988;8.61;0.52;248.50;18.05;767;102;4805.00;180
13043;100;628277613;13043;255;13811;13991;8.62;0.53;248.50;18.05;768;102;4806.00;180
13046;100;628277630;13046;247;13812;13991;8.61;0.53;248.52;18.05;766;102;4807.00;179
13052;100;628277647;13052;240;13813;13991;8.59;0.52;248.51;18.05;761;102;4808.00;178
13057;100;628277666;13057;233;13813;13991;8.61;0.52;248.51;18.05;756;102;4809.00;178
13060;100;628277682;13060;231;13818;13997;8.65;0.53;248.52;18.04;758;102;4810.00;179
13064;100;628277696;13064;230;13818;13997;8.78;0.53;248.54;18.04;754;102;4811.00;179
13068;100;628277709;13068;236;13820;13997;8.92;0.54;248.60;18.04;752;102;4812.00;177
13073;100;628277728;13073;235;13820;13997;9.04;0.55;248.66;18.04;747;102;4813.00;177
13078;100;628277748;13078;236;13823;14001;9.02;0.55;248.74;18.04;745;102;4814.00;178
13078;100;628277760;13078;228;13825;14003;9.07;0.55;248.74;18.03;747;102;4815.00;178
13082;100;628277772;13082;212;13825;14003;9.17;0.56;248.78;18.03;743;102;4816.00;178
13088;100;628277785;13088;191;13826;14004;9.33;0.57;248.78;18.03;738;102;4817.00;178
13088;100;628277798;13088;180;13827;14004;9.49;0.58;248.78;18.03;739;102;4818.00;177
13091;100;628277811;13091;169;13827;14004;9.58;0.58;248.82;18.03;736;102;4819.00;177
13096;100;628277824;13096;160;13827;14004;9.72;0.59;248.83;18.03;731;102;4820.00;177
13097;100;628277836;13097;154;13827;14004;9.85;0.60;248.84;18.03;730;102;4821.00;177
13102;100;628277849;13102;144;13827;14004;9.98;0.61;248.86;18.03;725;102;4822.00;177
13105;100;628277861;13105;142;13827;14004;10.18;0.62;248.87;18.03;722;102;4823.00;177
13108;100;628277874;13108;146;13870;14074;10.34;0.63;248.88;17.98;762;102;4824.00;204
13110;100;628277892;13110;141;13871;14075;10.60;0.65;248.90;17.98;761;102;4825.00;204
13114;100;628277905;13114;122;13875;14075;10.80;0.66;248.88;17.97;761;102;4826.00;200
13115;100;628277918;13115;116;13878;14075;10.92;0.66;248.90;17.97;763;102;4827.00;197
13117;100;628277930;13117;111;13880;14077;11.02;0.67;248.89;17.97;763;102;4828.00;197
13120;100;628277943;13120;112;13882;14077;11.05;0.67;248.91;17.97;762;102;4829.00;195
13121;100;628277958;13121;114;13887;14077;11.09;0.68;248.92;17.96;766;102;4830.00;190
13125;100;628277972;13125;113;13889;14077;11.06;0.67;248.92;17.96;764;102;4831.00;188
13128;100;628277984;13128;123;13891;14078;11.10;0.67;248.95;17.96;763;102;4832.00;187
13130;100;628277997;13130;119;13893;14079;11.15;0.68;248.93;17.96;763;102;4833.00;186
13132;100;628278009;13132;122;13895;14079;11.24;0.68;248.96;17.96;763;102;4834.00;184
13137;100;628278022;13137;128;13902;14083;11.24;0.68;248.99;17.95;765;102;4835.00;181
13139;100;628278036;13139;129;13902;14083;11.31;0.68;248.99;17.95;763;102;4836.00;181
13142;100;628278049;13142;132;13902;14083;11.37;0.69;249.00;17.95;760;102;4837.00;181
13147;100;628278062;13147;130;13902;14083;11.42;0.69;249.01;17.95;755;102;4838.00;181
13153;100;628278074;13153;133;13907;14089;11.48;0.70;249.02;17.95;754;102;4839.00;182
13156;100;628278087;13156;134;13907;14089;11.54;0.70;249.05;17.95;751;102;4840.00;182
13158;100;628278100;13158;136;13908;14089;11.62;0.70;249.04;17.95;750;102;4841.00;181
13159;100;628278113;13159;141;13911;14092;11.73;0.71;249.05;17.94;752;102;4842.00;181
13160;100;628278124;13160;141;13911;14092;11.78;0.71;249.06;17.94;751;102;4843.00;181
13164;100;628278136;13164;140;13911;14092;11.76;0.71;249.10;17.94;747;102;4844.00;181
13166;100;628278148;13166;142;13911;14093;11.80;0.72;249.11;17.94;745;102;4845.00;182
13168;100;628278166;13168;144;13912;14094;11.88;0.72;249.10;17.94;744;102;4846.00;182
13170;100;628278177;13170;145;13912;14094;11.93;0.73;249.16;17.94;742;102;4847.00;182
13173;100;628278189;13173;147;13923;14107;11.90;0.73;249.17;17.93;750;102;4848.00;184
13176;100;628278201;13176;138;13924;14107;11.87;0.72;249.20;18.07;748;102;4849.00;183
13179;100;628278214;13179;139;13924;14107;11.90;0.73;249.21;18.07;745;102;4850.00;183
13183;101;628278226;13183;141;13925;14108;11.95;0.73;249.23;18.07;742;103;4851.00;183
13186;101;628278244;13186;145;13925;14108;11.92;0.73;249.24;18.07;739;103;4852.00;183
13189;101;628278256;13189;143;13928;14112;11.93;0.73;249.21;18.06;739;103;4853.00;184
13193;101;628278273;13193;141;13928;14112;11.87;0.72;249.22;18.06;735;103;4854.00;184
13195;101;628278284;13195;144;13932;14116;11.81;0.72;249.23;18.06;737;103;4855.00;184
13198;101;628278298;13198;148;13932;14116;11.78;0.72;249.22;18.06;734;103;4856.00;184
13207;101;628278310;13207;142;13932;14116;11.76;0.72;249.25;18.06;725;103;4857.00;184
13211;101;628278324;13211;146;13932;14116;11.79;0.72;249.24;18.06;721;103;4858.00;184
13214;101;628278335;13214;149;13932;14116;11.78;0.72;249.26;18.06;718;103;4859.00;184
13221;101;628278347;13221;146;13952;14150;11.64;0.71;249.26;18.03;731;103;4860.00;198
13224;101;628278361;13224;136;13952;14150;11.54;0.70;249.25;18.03;728;103;4861.00;198
13230;101;628278377;13230;129;13954;14150;11.57;0.71;249.25;18.03;724;103;4862.00;196
13233;101;628278393;13233;129;13955;14150;11.64;0.71;249.23;18.03;722;103;4863.00;195
13236;101;628278403;13236;120;13955;14150;11.67;0.71;249.25;18.03;719;103;4864.00;195
13242;101;628278414;13242;123;13957;14150;11.73;0.71;249.20;18.04;715;103;4865.00;193
13245;101;628278426;13245;123;13959;14151;11.81;0.72;249.20;18.19;714;103;4866.00;192
13251;101;628278436;13251;121;13960;14151;11.93;0.73;249.18;18.19;709;103;4867.00;191
13253;101;628278447;13253;118;13963;14157;12.03;0.73;249.21;18.19;710;103;4868.00;194
13255;101;628278458;13255;118;13965;14158;12.04;0.73;249.26;18.19;710;103;4869.00;193
13260;101;628278469;13260;115;13966;14158;12.02;0.73;249.27;18.19;706;103;4870.00;192
13261;101;628278479;13261;120;13967;14158;12.02;0.73;249.26;18.19;706;103;4871.00;191
13265;101;628278490;13265;117;13969;14162;11.97;0.73;249.27;18.18;704;103;4872.00;193
13267;101;628278501;13267;125;13970;14162;11.94;0.73;249.26;18.18;703;103;4873.00;192
13268;101;628278513;13268;125;13970;14162;11.83;0.72;249.25;18.18;702;103;4874.00;192
13268;101;628278524;13268;125;13971;14163;11.84;0.72;249.25;18.18;703;103;4875.00;192
13275;101;628278534;13275;126;13975;14167;11.71;0.71;249.25;18.18;700;103;4876.00;192
13277;102;628278545;13277;122;13977;14167;11.65;0.71;249.24;18.32;700;104;4877.00;190
13282;102;628278579;13282;118;13979;14170;11.53;0.70;249.23;18.32;697;104;4878.00;191
13282;102;628278598;13282;122;13980;14170;11.50;0.70;249.23;18.31;698;104;4879.00;190
13284;102;628278608;13284;126;13982;14170;11.36;0.69;249.22;18.46;698;104;4880.00;188
13286;102;628278617;13286;125;13982;14170;11.21;0.68;249.21;18.46;696;104;4881.00;188
13289;102;628278628;13289;130;13985;14174;11.17;0.68;249.20;18.45;696;104;4882.00;189
13292;102;628278638;13292;136;13986;14174;11.07;0.68;249.20;18.59;694;104;4883.00;188
13296;102;628278648;13296;142;13987;14174;10.96;0.67;249.24;18.59;691;104;4884.00;187
13299;102;628278658;13299;144;13988;14174;10.94;0.67;249.25;18.61;689;104;4885.00;186
13303;102;628278668;13303;150;13988;14175;10.92;0.67;249.29;18.61;685;104;4886.00;187
13305;102;628278678;13305;156;13989;14176;10.84;0.66;249.28;18.60;684;104;4887.00;187
13307;102;628278688;13307;167;13989;14176;10.77;0.66;249.28;18.60;682;104;4888.00;187
13311;102;628278699;13311;179;13991;14177;10.69;0.65;249.36;18.62;680;104;4889.00;186
13313;102;628278710;13313;186;13992;14177;10.60;0.65;249.36;18.63;679;104;4890.00;185
13316;102;628278721;13316;192;13992;14177;10.50;0.64;249.37;18.63;676;104;4891.00;185
13317;102;628278732;13317;202;13993;14177;10.47;0.64;249.36;18.64;676;104;4892.00;184
13319;102;628278742;13319;209;13994;14177;10.38;0.63;249.35;18.66;675;104;4893.00;183
13322;102;628278753;13322;212;13994;14177;10.31;0.63;249.35;18.66;672;104;4894.00;183
13322;102;628278763;13322;216;13996;14177;10.22;0.62;249.35;18.68;674;104;4895.00;181
13326;102;628278773;13326;235;14059;14304;10.19;0.63;249.33;18.60;733;104;4896.00;245
13329;102;628278796;13329;236;14064;14305;10.04;0.62;249.34;18.61;735;104;4897.00;241
13330;102;628278812;13330;234;14073;14305;10.05;0.62;249.36;18.61;743;104;4898.00;232
13335;102;628278822;13335;237;14077;14305;9.93;0.61;249.32;18.61;742;104;4899.00;228
13337;102;628278833;13337;243;14086;14305;9.86;0.61;249.32;18.63;749;104;4900.00;219
13338;102;628278846;13338;241;14090;14305;9.78;0.60;249.32;18.63;752;104;4901.00;215
13341;102;628278855;13341;244;14097;14305;9.69;0.60;249.33;18.62;756;104;4902.00;208
13342;102;628278870;13342;254;14101;14305;9.58;0.59;249.32;18.64;759;104;4903.00;204
13346;102;628278879;13346;257;14104;14306;9.51;0.58;249.27;18.64;758;104;4904.00;202
13346;102;628278895;13346;261;14111;14308;9.43;0.58;249.27;18.65;765;104;4905.00;197
13348;102;628278904;13348;271;14114;14308;9.30;0.57;249.24;18.65;766;104;4906.00;194
13351;102;628278914;13351;278;14119;14309;9.06;0.56;249.22;18.67;768;104;4907.00;190
13354;102;628278923;13354;286;14121;14309;8.88;0.55;249.18;18.67;767;104;4908.00;188
13354;102;628278932;13354;287;14123;14309;8.64;0.53;249.18;18.68;769;104;4909.00;186
13356;102;628278942;13356;294;14125;14309;8.47;0.52;249.16;18.68;769;104;4910.00;184
13359;102;628278952;13359;295;14128;14313;8.27;0.51;249.17;18.68;769;104;4911.00;185
13362;103;628278963;13362;302;14130;14313;8.14;0.50;249.18;18.68;768;105;4912.00;183
13363;103;628278989;13363;303;14135;14313;7.98;0.49;249.17;18.71;772;105;4913.00;178
13365;103;628278999;13365;308;14137;14316;7.79;0.48;249.15;18.71;772;105;4914.00;179
13367;103;628279013;13367;313;14140;14316;7.64;0.47;249.13;18.72;773;105;4915.00;176
13368;103;628279022;13368;316;14141;14316;7.56;0.46;249.13;18.72;773;105;4916.00;175
13373;103;628279036;13373;325;14145;14320;7.45;0.46;249.08;18.72;772;105;4917.00;175
13375;103;628279045;13375;327;14148;14321;7.38;0.45;249.06;18.73;773;105;4918.00;173
13377;103;628279054;13377;337;14149;14321;7.30;0.45;249.03;18.73;772;105;4919.00;172
13377;103;628279066;13377;343;14155;14326;7.31;0.45;249.03;18.74;778;105;4920.00;171
13379;103;628279075;13379;346;14156;14326;7.19;0.44;249.03;18.74;777;105;4921.00;170
13379;103;628279084;13379;354;14157;14326;7.06;0.44;249.03;18.75;778;105;4922.00;169
13384;103;628279092;13384;353;14158;14327;6.84;0.42;249.01;18.75;774;105;4923.00;169
13386;103;628279105;13386;357;14159;14327;6.65;0.41;249.02;18.75;773;105;4924.00;168
13388;103;628279114;13388;360;14164;14333;6.58;0.41;249.01;18.76;776;105;4925.00;169
13393;103;628279123;13393;365;14165;14333;6.36;0.39;249.00;18.76;772;105;4926.00;168
13395;103;628279132;13395;374;14167;14334;6.22;0.38;248.99;18.77;772;105;4927.00;167
13400;103;628279140;13400;376;14167;14334;6.01;0.37;248.99;18.77;767;105;4928.00;167
13402;103;628279147;13402;381;14167;14334;5.86;0.36;249.00;18.77;765;105;4929.00;167
13403;103;628279155;13403;375;14169;14334;5.73;0.35;249.01;18.78;766;105;4930.00;165
13406;103;628279164;13406;363;14169;14334;5.65;0.35;249.04;18.78;763;105;4931.00;165
13406;103;628279172;13406;346;14182;14346;5.80;0.36;249.04;18.78;776;105;4932.00;164
13409;103;628279181;13409;337;14182;14346;5.85;0.36;249.06;18.78;773;105;4933.00;164
13411;103;628279190;13411;333;14183;14346;5.96;0.37;249.09;18.79;772;105;4934.00;163
13414;103;628279198;13414;330;14183;14346;5.96;0.36;249.10;18.79;769;105;4935.00;163
13415;103;628279207;13415;318;14183;14346;6.05;0.37;249.11;18.79;768;105;4936.00;163
13418;103;628279218;13418;308;14183;14346;6.15;0.38;249.16;18.79;765;105;4937.00;163
13420;103;628279228;13420;294;14186;14350;6.30;0.39;249.15;18.78;766;105;4938.00;164
13422;104;628279237;13422;286;14186;14350;6.42;0.39;249.15;18.78;764;106;4939.00;164
13424;104;628279257;13424;281;14189;14354;6.55;0.40;249.17;18.78;765;106;4940.00;165
13426;104;628279267;13426;272;14191;14355;6.66;0.41;249.16;18.92;765;106;4941.00;164
13428;104;628279278;13428;273;14192;14355;6.81;0.42;249.16;18.92;764;106;4942.00;163
13431;104;628279292;13431;271;14192;14355;6.93;0.43;249.17;18.92;761;106;4943.00;163
13433;104;628279307;13433;270;14203;14368;7.19;0.44;249.15;18.91;770;106;4944.00;165
13436;104;628279318;13436;273;14203;14368;7.29;0.45;249.14;18.91;767;106;4945.00;165
13438;104;628279327;13438;264;14203;14368;7.44;0.46;249.13;18.91;765;106;4946.00;165
13441;104;628279338;13441;257;14204;14369;7.53;0.46;249.13;18.90;763;106;4947.00;165
13444;104;628279348;13444;255;14204;14370;7.60;0.46;249.13;18.90;760;106;4948.00;166
13446;104;628279358;13446;252;14204;14370;7.70;0.47;249.11;18.90;758;106;4949.00;166
13448;104;628279369;13448;244;14208;14379;7.85;0.48;249.10;18.90;760;106;4950.00;171
13450;104;628279379;13450;242;14208;14379;7.98;0.49;249.10;18.90;758;106;4951.00;171
13454;104;628279389;13454;234;14210;14379;8.05;0.49;249.10;18.90;756;106;4952.00;169
13456;104;628279399;13456;228;14210;14379;8.12;0.50;249.11;18.90;754;106;4953.00;169
13461;104;628279415;13461;230;14214;14385;8.19;0.50;249.10;18.89;753;106;4954.00;171
13466;104;628279426;13466;233;14214;14385;8.18;0.50;249.09;18.89;748;106;4955.00;171
13472;104;628279437;13472;233;14215;14385;8.15;0.50;249.09;18.89;743;106;4956.00;170
13475;104;628279447;13475;233;14216;14385;8.07;0.49;249.11;18.89;741;106;4957.00;169
13480;104;628279457;13480;227;14220;14389;8.12;0.50;249.15;18.89;740;106;4958.00;169
13483;104;628279473;13483;226;14222;14390;8.17;0.50;249.14;18.88;739;106;4959.00;168
13487;104;628279484;13487;222;14222;14390;8.24;0.50;249.17;18.88;735;106;4960.00;168
13496;104;628279494;13496;222;14223;14391;8.27;0.50;249.15;18.88;727;106;4961.00;168
13501;104;628279505;13501;230;14223;14391;8.27;0.50;249.13;18.88;722;106;4962.00;168
13505;104;628279515;13505;228;14223;14391;8.40;0.51;249.12;18.88;718;106;4963.00;168
13510;104;628279526;13510;229;14223;14391;8.52;0.52;249.13;18.88;713;106;4964.00;168
13515;104;628279536;13515;225;14223;14391;8.61;0.52;249.11;18.88;708;106;4965.00;168
13521;104;628279546;13521;220;14223;14391;8.63;0.52;249.13;18.88;702;106;4966.00;168
13525;104;628279558;13525;217;14223;14391;8.66;0.53;249.15;18.88;698;106;4967.00;168
13530;104;628279574;13530;225;14267;14461;8.81;0.54;249.18;18.82;737;106;4968.00;194
13536;104;628279610;13536;220;14268;14462;8.86;0.54;249.18;18.82;732;106;4969.00;194
13541;104;628279626;13541;219;14273;14462;9.02;0.55;249.19;18.82;732;106;4970.00;189
13544;104;628279645;13544;222;14274;14462;9.12;0.55;249.18;18.82;730;106;4971.00;188
13547;104;628279661;13547;218;14279;14462;9.22;0.56;249.20;18.81;732;106;4972.00;183
13549;104;628279675;13549;220;14283;14462;9.29;0.56;249.23;18.81;734;106;4973.00;179
13554;104;628279688;13554;219;14287;14462;9.31;0.56;249.24;18.80;733;106;4974.00;175
13555;104;628279701;13555;218;14287;14462;9.27;0.56;249.25;18.80;732;106;4975.00;175
13558;104;628279713;13558;224;14289;14463;9.24;0.56;249.27;18.80;731;106;4976.00;174
13561;104;628279726;13561;212;14290;14464;9.28;0.56;249.28;18.80;729;106;4977.00;174
13564;104;628279739;13564;205;14291;14464;9.24;0.56;249.29;18.80;727;106;4978.00;173
13566;104;628279757;13566;202;14294;14468;9.24;0.56;249.31;18.80;728;106;4979.00;174
13569;104;628279773;13569;197;14294;14468;9.30;0.56;249.33;18.80;725;106;4980.00;174
13571;104;628279785;13571;198;14294;14468;9.34;0.57;249.35;18.80;723;106;4981.00;174
13573;104;628279796;13573;194;14294;14468;9.51;0.58;249.36;18.80;721;106;4982.00;174
13577;104;628279808;13577;195;14298;14474;9.62;0.58;249.40;18.79;721;106;4983.00;176
13579;105;628279821;13579;191;14298;14474;9.70;0.59;249.41;18.79;719;107;4984.00;176
13583;105;628279850;13583;185;14299;14474;9.74;0.59;249.43;18.79;716;107;4985.00;175
13583;105;628279863;13583;170;14301;14477;9.93;0.60;249.43;18.79;718;107;4986.00;176
13584;105;628279875;13584;156;14302;14477;10.17;0.62;249.45;18.79;718;107;4987.00;175
13588;105;628279887;13588;149;14302;14477;10.32;0.62;249.47;18.79;714;107;4988.00;175
13592;105;628279899;13592;141;14302;14478;10.45;0.63;249.50;18.79;710;107;4989.00;176
13594;106;628279912;13594;139;14303;14479;10.63;0.64;249.51;18.78;709;108;4990.00;176
13597;106;628279937;13597;135;14303;14479;10.85;0.66;249.52;18.78;706;108;4991.00;176
13599;106;628279950;13599;134;14314;14492;11.02;0.67;249.54;18.77;715;108;4992.00;178
13602;106;628279964;13602;127;14314;14492;11.14;0.68;249.53;18.77;712;108;4993.00;178
13604;106;628279977;13604;125;14314;14492;11.28;0.68;249.53;18.77;710;108;4994.00;178
13609;106;628279990;13609;123;14316;14494;11.37;0.69;249.54;18.77;707;108;4995.00;178
13610;106;628280003;13610;121;14316;14494;11.48;0.70;249.55;18.77;706;108;4996.00;178
13613;106;628280016;13613;119;14319;14498;11.58;0.70;249.56;18.76;706;108;4997.00;179
13615;106;628280030;13615;114;14319;14498;11.66;0.71;249.56;18.76;704;108;4998.00;179
13617;106;628280043;13617;116;14323;14502;11.73;0.71;249.54;18.76;706;108;4999.00;179
13622;107;628280056;13622;112;14324;14502;11.70;0.71;249.55;18.91;702;109;5000.00;178
13625;107;628280089;13625;110;14324;14502;11.76;0.71;249.57;18.91;699;109;5001.00;178
13626;107;628280102;13626;109;14324;14502;11.81;0.72;249.59;18.91;698;109;5002.00;178
13629;107;628280120;13629;110;14324;14502;11.84;0.72;249.58;18.91;695;109;5003.00;178
13631;107;628280136;13631;112;14333;14514;11.89;0.72;249.59;18.89;702;109;5004.00;181
13634;107;628280155;13634;113;14333;14514;11.97;0.73;249.63;18.89;699;109;5005.00;181
13637;107;628280167;13637;108;14335;14514;12.06;0.73;249.65;18.89;698;109;5006.00;179
13642;107;628280179;13642;108;14335;14514;12.06;0.73;249.66;18.89;693;109;5007.00;179
13644;107;628280191;13644;107;14335;14514;12.15;0.74;249.67;18.89;691;109;5008.00;179
13649;107;628280205;13649;106;14335;14514;12.15;0.74;249.66;18.89;686;109;5009.00;179
13651;107;628280218;13651;108;14335;14515;12.21;0.74;249.65;18.89;684;109;5010.00;180
13654;107;628280230;13654;112;14335;14515;12.32;0.75;249.67;18.89;681;109;5011.00;180
13656;107;628280241;13656;115;14339;14521;12.37;0.75;249.69;18.89;683;109;5012.00;182
13660;109;628280253;13660;111;14340;14522;12.41;0.75;249.69;18.88;680;111;5013.00;182
13663;109;628280283;13663;110;14341;14522;12.46;0.76;249.72;18.88;678;111;5014.00;181
13665;109;628280295;13665;110;14341;14522;12.45;0.76;249.71;18.88;676;111;5015.00;181
13670;109;628280306;13670;111;14344;14526;12.53;0.76;249.74;18.88;674;111;5016.00;182
13672;109;628280323;13672;112;14344;14526;12.58;0.76;249.76;18.88;672;111;5017.00;182
13674;109;628280334;13674;113;14344;14526;12.62;0.77;249.75;18.88;670;111;5018.00;182
13675;109;628280344;13675;113;14345;14527;12.62;0.77;249.76;18.88;670;111;5019.00;182
13677;109;628280355;13677;116;14348;14531;12.52;0.76;249.80;18.87;671;111;5020.00;183
13678;109;628280366;13678;122;14348;14531;12.48;0.76;249.80;18.87;670;111;5021.00;183
13681;109;628280376;13681;125;14351;14534;12.40;0.76;249.83;19.02;670;111;5022.00;183
13688;109;628280394;13688;125;14351;14534;12.26;0.75;249.83;19.02;663;111;5023.00;183
13693;109;628280403;13693;132;14352;14534;12.25;0.75;249.90;19.02;659;111;5024.00;182
13696;109;628280414;13696;132;14352;14534;12.18;0.74;249.90;19.02;656;111;5025.00;182
13700;109;628280423;13700;129;14355;14538;12.10;0.74;249.90;19.01;655;111;5026.00;183
13704;109;628280434;13704;134;14355;14538;12.05;0.73;249.88;19.01;651;111;5027.00;183
13710;109;628280445;13710;135;14356;14538;11.99;0.73;249.90;19.01;646;111;5028.00;182
13714;109;628280454;13714;132;14356;14538;12.06;0.73;249.90;19.01;642;111;5029.00;182
13719;109;628280464;13719;128;14356;14539;12.09;0.74;249.88;19.01;637;111;5030.00;183
13723;109;628280476;13723;128;14357;14540;12.08;0.73;249.86;19.01;634;111;5031.00;183
13727;109;628280486;13727;125;14357;14540;11.98;0.73;249.88;19.01;630;111;5032.00;183
13729;109;628280495;13729;123;14358;14541;11.91;0.73;249.89;19.01;629;111;5033.00;183
13732;109;628280505;13732;119;14359;14541;11.79;0.72;249.89;19.03;627;111;5034.00;182
13732;109;628280515;13732;120;14360;14541;11.80;0.72;249.89;19.04;628;111;5035.00;181
13736;109;628280525;13736;117;14360;14541;11.82;0.72;249.89;19.04;624;111;5036.00;181
13740;109;628280535;13740;115;14360;14541;11.86;0.72;249.87;19.04;620;111;5037.00;181
13744;109;628280545;13744;116;14360;14541;11.88;0.72;249.89;19.04;616;111;5038.00;181
13750;109;628280562;13750;114;14361;14541;11.89;0.73;249.88;19.19;611;111;5039.00;180
13753;109;628280574;13753;149;14461;14771;11.58;0.72;249.88;19.05;708;111;5040.00;310
13757;109;628280604;13757;142;14464;14772;11.59;0.72;249.85;19.05;707;111;5041.00;308
13762;109;628280614;13762;135;14473;14772;11.66;0.72;249.85;19.04;711;111;5042.00;299
13763;109;628280625;13763;128;14479;14772;11.69;0.73;249.85;19.03;716;111;5043.00;293
13764;109;628280635;13764;128;14484;14772;11.61;0.72;249.84;19.03;720;111;5044.00;288
13767;109;628280645;13767;129;14492;14772;11.50;0.71;249.84;19.02;725;111;5045.00;280
13767;109;628280656;13767;124;14498;14772;11.55;0.71;249.84;19.01;731;111;5046.00;274
13770;109;628280669;13770;129;14503;14772;11.46;0.71;249.91;19.15;733;111;5047.00;269
13771;109;628280680;13771;130;14508;14773;11.44;0.71;249.91;19.15;737;111;5048.00;265
13776;109;628280691;13776;130;14512;14774;11.39;0.70;249.86;19.28;736;111;5049.00;262
13779;109;628280703;13779;132;14519;14774;11.23;0.69;249.84;19.28;740;111;5050.00;255
13779;109;628280714;13779;135;14523;14775;11.21;0.69;249.84;19.28;744;111;5051.00;252
13781;109;628280725;13781;144;14528;14775;11.17;0.69;249.84;19.27;747;111;5052.00;247
13782;109;628280740;13782;155;14532;14775;11.01;0.68;249.85;19.41;750;111;5053.00;243
13787;109;628280750;13787;164;14533;14775;10.90;0.67;249.82;19.41;746;111;5054.00;242
13789;109;628280760;13789;169;14539;14779;10.78;0.66;249.81;19.41;750;111;5055.00;240
13790;109;628280771;13790;172;14541;14779;10.60;0.65;249.80;19.41;751;111;5056.00;238
13791;109;628280782;13791;183;14545;14779;10.43;0.64;249.79;19.41;754;111;5057.00;234
13792;109;628280802;13792;196;14546;14782;10.25;0.63;249.77;19.41;754;111;5058.00;236
13793;109;628280814;13793;203;14548;14782;10.13;0.62;249.77;19.41;755;111;5059.00;234
13794;109;628280823;13794;210;14554;14782;9.98;0.61;249.76;19.43;760;111;5060.00;228
13795;109;628280834;13795;220;14559;14786;9.89;0.61;249.76;19.43;764;111;5061.00;227
13800;109;628280845;13800;226;14562;14787;9.74;0.60;249.75;19.43;762;111;5062.00;225
13803;109;628280855;13803;233;14565;14787;9.67;0.59;249.72;19.45;762;111;5063.00;222
13805;109;628280864;13805;244;14567;14791;9.59;0.59;249.71;19.45;762;111;5064.00;224
13808;109;628280875;13808;252;14571;14791;9.46;0.58;249.70;19.47;763;111;5065.00;220
13810;109;628280885;13810;257;14572;14791;9.34;0.57;249.69;19.47;762;111;5066.00;219
13813;109;628280895;13813;266;14576;14792;9.18;0.56;249.69;19.49;763;111;5067.00;216
13814;109;628280906;13814;275;14578;14792;8.98;0.55;249.69;19.49;764;111;5068.00;214
13814;109;628280916;13814;282;14583;14798;8.91;0.55;249.69;19.51;769;111;5069.00;215
13817;109;628280927;13817;285;14586;14798;8.72;0.53;249.70;19.51;769;111;5070.00;212
13818;109;628280938;13818;294;14588;14799;8.62;0.53;249.70;19.53;770;111;5071.00;211
13820;109;628280947;13820;303;14592;14799;8.47;0.52;249.69;19.53;772;111;5072.00;207
13823;109;628280957;13823;311;14593;14799;8.35;0.51;249.65;19.55;770;111;5073.00;206
13824;109;628280966;13824;316;14596;14799;8.23;0.50;249.65;19.55;772;111;5074.00;203
13825;109;628280975;13825;326;14599;14799;8.13;0.50;249.63;19.57;774;111;5075.00;200
13826;109;628280984;13826;341;14612;14811;8.00;0.49;249.62;19.56;786;111;5076.00;199
13827;109;628280995;13827;353;14613;14811;7.86;0.48;249.61;19.57;786;111;5077.00;198
13830;109;628281005;13830;359;14617;14811;7.70;0.47;249.61;19.57;787;111;5078.00;194
13831;109;628281014;13831;363;14619;14811;7.56;0.46;249.59;19.59;788;111;5079.00;192
13832;109;628281024;13832;364;14621;14811;7.41;0.45;249.58;19.59;789;111;5080.00;190
13834;109;628281032;13834;368;14622;14811;7.28;0.45;249.57;19.59;788;111;5081.00;189
13835;109;628281042;13835;371;14626;14815;7.16;0.44;249.57;19.60;791;111;5082.00;189
13836;109;628281051;13836;360;14628;14815;7.05;0.43;249.55;19.60;792;111;5083.00;187
13837;109;628281060;13837;348;14631;14819;7.01;0.43;249.54;19.59;794;111;5084.00;188
13837;109;628281070;13837;337;14634;14821;7.01;0.43;249.54;19.61;797;111;5085.00;187
13838;109;628281080;13838;332;14634;14821;7.02;0.43;249.53;19.61;796;111;5086.00;187
13840;109;628281090;13840;329;14636;14821;7.05;0.43;249.51;19.62;796;111;5087.00;185
13840;109;628281100;13840;326;14648;14834;7.07;0.43;249.51;19.60;808;111;5088.00;186
13845;109;628281110;13845;323;14649;14834;7.08;0.43;249.48;19.62;804;111;5089.00;185
13845;110;628281125;13845;315;14650;14834;7.12;0.44;249.48;19.61;805;112;5090.00;184
13850;110;628281145;13850;310;14651;14835;7.09;0.43;249.48;19.61;801;112;5091.00;184
13850;110;628281156;13850;309;14654;14836;7.09;0.43;249.48;19.65;804;112;5092.00;182
13852;111;628281165;13852;311;14654;14836;7.17;0.44;249.52;19.65;802;113;5093.00;182
13857;111;628281184;13857;312;14657;14839;7.21;0.44;249.50;19.65;800;113;5094.00;182
13860;111;628281196;13860;309;14658;14839;7.22;0.44;249.51;19.66;798;113;5095.00;181
13863;111;628281211;13863;304;14658;14839;7.26;0.45;249.51;19.66;795;113;5096.00;181
13865;111;628281221;13865;306;14661;14839;7.26;0.45;249.54;19.69;796;113;5097.00;178
13868;111;628281230;13868;311;14665;14845;7.30;0.45;249.53;19.69;797;113;5098.00;180
13870;111;628281240;13870;308;14666;14845;7.30;0.45;249.51;19.70;796;113;5099.00;179
13874;111;628281252;13874;303;14672;14864;7.26;0.45;249.50;19.69;798;113;5100.00;192
13877;111;628281268;13877;296;14672;14864;7.25;0.44;249.47;19.69;795;113;5101.00;192
13879;111;628281278;13879;294;14677;14868;7.18;0.44;249.49;19.70;798;113;5102.00;191
13881;111;628281288;13881;287;14678;14869;7.16;0.44;249.50;19.70;797;113;5103.00;191
13883;111;628281297;13883;280;14680;14869;7.22;0.45;249.52;19.72;797;113;5104.00;189
13885;111;628281307;13885;280;14682;14870;7.31;0.45;249.54;19.72;797;113;5105.00;188
13886;111;628281316;13886;275;14683;14870;7.37;0.46;249.53;19.72;797;113;5106.00;187
13892;111;628281336;13892;262;14683;14870;7.42;0.46;249.54;19.72;791;113;5107.00;187
13893;111;628281346;13893;260;14684;14870;7.53;0.46;249.53;19.71;791;113;5108.00;186
13898;111;628281355;13898;251;14684;14870;7.56;0.47;249.53;19.71;786;113;5109.00;186
13904;111;628281365;13904;245;14684;14870;7.64;0.47;249.54;19.71;780;113;5110.00;186
13906;111;628281375;13906;240;14684;14870;7.74;0.48;249.55;19.71;778;113;5111.00;186
13912;111;628281385;13912;238;14717;14940;7.88;0.48;249.55;19.67;805;113;5112.00;223
13918;111;628281400;13918;223;14721;14941;7.96;0.49;249.53;19.81;803;113;5113.00;220
13919;111;628281414;13919;215;14729;14941;8.14;0.50;249.53;19.80;810;113;5114.00;212
13925;111;628281425;13925;215;14729;14941;8.21;0.50;249.53;19.80;804;113;5115.00;212
13928;111;628281435;13928;207;14733;14941;8.26;0.51;249.54;19.79;805;113;5116.00;208
13934;111;628281446;13934;207;14737;14941;8.35;0.51;249.49;19.79;803;113;5117.00;204
13937;111;628281457;13937;204;14740;14941;8.42;0.51;249.48;19.79;803;113;5118.00;201
13943;111;628281468;13943;192;14741;14941;8.38;0.51;249.46;19.79;798;113;5119.00;200
13947;111;628281481;13947;192;14743;14942;8.40;0.51;249.45;19.78;796;113;5120.00;199
13952;111;628281493;13952;187;14745;14943;8.47;0.52;249.42;19.78;793;113;5121.00;198
13956;111;628281503;13956;191;14747;14943;8.53;0.52;249.43;19.78;791;113;5122.00;196
13957;111;628281515;13957;190;14751;14947;8.58;0.52;249.43;19.78;794;113;5123.00;196
13960;111;628281526;13960;197;14753;14947;8.65;0.53;249.47;19.78;793;113;5124.00;194
13962;111;628281537;13962;198;14754;14947;8.76;0.53;249.46;19.78;792;113;5125.00;193
13967;111;628281548;13967;201;14755;14947;8.81;0.54;249.42;19.78;788;113;5126.00;192
13970;111;628281560;13970;203;14758;14953;8.89;0.54;249.41;19.77;788;113;5127.00;195
13978;111;628281577;13978;203;14758;14953;8.90;0.54;249.42;19.77;780;113;5128.00;195
13980;111;628281597;13980;206;14758;14953;9.00;0.55;249.44;19.77;778;113;5129.00;195
13984;111;628281618;13984;205;14762;14959;8.99;0.55;249.45;19.77;778;113;5130.00;197
13990;111;628281637;13990;208;14762;14959;8.97;0.55;249.45;19.77;772;113;5131.00;197
13991;111;628281654;13991;213;14763;14959;9.05;0.55;249.44;19.77;772;113;5132.00;196
13996;111;628281673;13996;217;14763;14960;9.05;0.55;249.44;19.77;767;113;5133.00;197
14001;111;628281688;14001;214;14764;14961;9.06;0.55;249.39;19.77;763;113;5134.00;197
14005;111;628281702;14005;219;14766;14961;9.04;0.55;249.36;19.77;761;113;5135.00;195
14010;111;628281714;14010;221;14775;14974;9.11;0.55;249.37;19.76;765;113;5136.00;199
14014;111;628281728;14014;224;14777;14974;9.15;0.56;249.41;19.76;763;113;5137.00;197
14016;111;628281741;14016;221;14777;14974;9.18;0.56;249.40;19.76;761;113;5138.00;197
14019;111;628281753;14019;224;14778;14975;9.19;0.56;249.42;19.76;759;113;5139.00;197
14025;111;628281766;14025;225;14779;14975;9.17;0.56;249.48;19.76;754;113;5140.00;196
14026;111;628281781;14026;232;14784;14979;9.14;0.56;249.50;19.76;758;113;5141.00;195
14030;111;628281793;14030;235;14784;14979;9.12;0.55;249.51;19.76;754;113;5142.00;195
14034;111;628281806;14034;240;14789;14983;9.08;0.55;249.52;19.75;755;113;5143.00;194
14036;111;628281820;14036;243;14789;14983;9.04;0.55;249.52;19.75;753;113;5144.00;194
14040;111;628281831;14040;245;14790;14983;9.02;0.55;249.56;19.75;750;113;5145.00;193
14043;111;628281844;14043;248;14790;14983;8.98;0.55;249.59;19.75;747;113;5146.00;193
14046;111;628281856;14046;238;14791;14983;8.98;0.55;249.62;19.75;745;113;5147.00;192
14049;111;628281869;14049;230;14801;14995;9.01;0.55;249.63;19.74;752;113;5148.00;194
14053;111;628281882;14053;221;14802;14995;9.12;0.56;249.67;19.74;749;113;5149.00;193
14057;111;628281895;14057;213;14804;14995;9.25;0.56;249.68;19.74;747;113;5150.00;191
14062;111;628281909;14062;206;14805;14995;9.33;0.57;249.71;19.74;743;113;5151.00;190
14067;111;628281921;14067;201;14806;14995;9.39;0.57;249.77;19.74;739;113;5152.00;189
14070;111;628281941;14070;203;14808;14995;9.41;0.57;249.78;19.74;738;113;5153.00;187
14074;111;628281953;14074;201;14808;14996;9.40;0.57;249.82;19.74;734;113;5154.00;188
14076;111;628281966;14076;205;14809;14998;9.34;0.57;249.80;19.74;733;113;5155.00;189
14083;111;628281986;14083;192;14812;15004;9.28;0.57;249.84;19.73;729;113;5156.00;192
14085;111;628282001;14085;181;14815;15005;9.33;0.57;249.85;19.73;730;113;5157.00;190
14086;111;628282016;14086;171;14815;15005;9.42;0.58;249.87;19.73;729;113;5158.00;190
14088;111;628282028;14088;160;14816;15005;9.59;0.59;249.86;19.73;728;113;5159.00;189
14091;111;628282043;14091;159;14820;15010;9.75;0.59;249.88;19.72;729;113;5160.00;190
14095;111;628282057;14095;156;14820;15010;9.88;0.60;249.90;19.72;725;113;5161.00;190
14096;111;628282071;14096;146;14820;15010;10.03;0.61;249.91;19.72;724;113;5162.00;190
14100;111;628282083;14100;142;14821;15011;10.13;0.62;249.98;19.72;721;113;5163.00;190
14102;111;628282096;14102;144;14824;15015;10.20;0.62;249.99;19.72;722;113;5164.00;191
14106;111;628282110;14106;138;14824;15015;10.22;0.62;250.00;19.72;718;113;5165.00;191
14113;111;628282122;14113;132;14827;15018;10.31;0.63;249.98;19.71;714;113;5166.00;191
14116;111;628282134;14116;129;14827;15018;10.37;0.63;250.00;19.71;711;113;5167.00;191
14120;111;628282148;14120;132;14827;15018;10.42;0.63;250.03;19.71;707;113;5168.00;191
14124;111;628282160;14124;133;14827;15018;10.51;0.64;250.04;19.71;703;113;5169.00;191
14126;111;628282173;14126;127;14830;15022;10.58;0.64;250.05;19.71;704;113;5170.00;192
14128;111;628282194;14128;126;14831;15022;10.66;0.65;250.05;19.71;703;113;5171.00;191
14133;111;628282207;14133;127;14831;15022;10.82;0.66;250.07;19.71;698;113;5172.00;191
14135;111;628282220;14135;126;14831;15022;10.95;0.66;250.09;19.71;696;113;5173.00;191
14137;111;628282233;14137;130;14831;15023;11.00;0.67;250.10;19.71;694;113;5174.00;192
14141;111;628282245;14141;129;14833;15025;11.05;0.67;250.09;19.71;692;113;5175.00;192
14146;111;628282259;14146;131;14833;15025;11.04;0.67;250.08;19.71;687;113;5176.00;192
14149;111;628282270;14149;125;14834;15026;11.10;0.67;250.05;19.71;685;113;5177.00;192
14150;111;628282282;14150;127;14834;15026;11.18;0.68;250.06;19.71;684;113;5178.00;192
14152;111;628282300;14152;132;14834;15026;11.30;0.69;250.06;19.71;682;113;5179.00;192
14153;111;628282312;14153;134;14834;15026;11.39;0.69;250.06;19.71;681;113;5180.00;192
14155;111;628282322;14155;138;14834;15026;11.46;0.70;250.07;19.71;679;113;5181.00;192
14157;111;628282333;14157;143;14834;15026;11.58;0.70;250.07;19.71;677;113;5182.00;192
14160;111;628282344;14160;144;14834;15026;11.59;0.70;250.09;19.71;674;113;5183.00;192
14166;112;628282354;14166;176;14908;15153;11.27;0.69;250.11;19.61;742;114;5184.00;245
14168;112;628282392;14168;165;14909;15154;11.26;0.69;250.09;19.61;741;114;5185.00;245
14171;112;628282403;14171;156;14914;15154;11.33;0.70;250.09;19.60;743;114;5186.00;240
14174;112;628282415;14174;158;14917;15154;11.32;0.70;250.12;19.60;743;114;5187.00;237
14176;113;628282425;14176;162;14921;15154;11.29;0.69;250.11;19.59;745;115;5188.00;233
14178;113;628282443;14178;162;14925;15154;11.27;0.69;250.11;19.59;747;115;5189.00;229
14183;113;628282456;14183;164;14930;15154;11.22;0.69;250.11;19.58;747;115;5190.00;224
14187;113;628282478;14187;171;14932;15154;11.22;0.69;250.09;19.58;745;115;5191.00;222
14190;113;628282495;14190;173;14935;15155;11.23;0.69;250.08;19.58;745;115;5192.00;220
14193;113;628282506;14193;182;14938;15156;11.23;0.69;250.11;19.58;745;115;5193.00;218
14195;113;628282517;14195;183;14941;15156;11.24;0.69;250.10;19.58;746;115;5194.00;215
14198;113;628282528;14198;188;14942;15157;11.19;0.69;250.11;19.58;744;115;5195.00;215
14200;113;628282539;14200;195;14944;15157;11.14;0.69;250.11;19.57;744;115;5196.00;213
14204;113;628282550;14204;193;14944;15157;11.03;0.68;250.08;19.57;740;115;5197.00;213
14205;113;628282561;14205;193;14945;15157;11.00;0.68;250.07;19.57;740;115;5198.00;212
14208;113;628282573;14208;197;14948;15161;10.88;0.67;250.06;19.57;740;115;5199.00;213
14212;113;628282585;14212;199;14949;15161;10.75;0.66;250.05;19.57;737;115;5200.00;212
14215;113;628282600;14215;195;14951;15161;10.59;0.65;250.04;19.57;736;115;5201.00;210
14216;113;628282611;14216;192;14953;15164;10.45;0.64;250.04;19.57;737;115;5202.00;211
14218;113;628282621;14218;191;14954;15164;10.41;0.64;250.05;19.57;736;115;5203.00;210
14221;113;628282631;14221;190;14955;15164;10.35;0.63;250.03;19.57;734;115;5204.00;209
14223;113;628282647;14223;194;14961;15168;10.24;0.63;250.07;19.60;738;115;5205.00;207
14230;113;628282664;14230;195;14963;15169;10.24;0.63;250.03;19.59;733;115;5206.00;206
14235;113;628282675;14235;191;14963;15169;10.19;0.62;250.01;19.59;728;115;5207.00;206
14236;113;628282685;14236;188;14966;15173;10.21;0.62;249.99;19.59;730;115;5208.00;207
14242;113;628282695;14242;183;14966;15173;10.22;0.62;250.03;19.59;724;115;5209.00;207
14244;113;628282704;14244;180;14966;15173;10.16;0.62;250.02;19.59;722;115;5210.00;207
14248;113;628282714;14248;176;14967;15174;10.20;0.62;249.99;19.59;719;115;5211.00;207
14249;113;628282724;14249;176;14968;15174;10.21;0.62;249.98;19.59;719;115;5212.00;206
14251;113;628282733;14251;178;14972;15180;10.33;0.63;249.95;19.59;721;115;5213.00;208
14255;113;628282744;14255;180;14972;15180;10.39;0.63;249.94;19.59;717;115;5214.00;208
14257;113;628282754;14257;186;14973;15180;10.42;0.63;249.91;19.59;716;115;5215.00;207
14261;113;628282763;14261;188;14973;15181;10.36;0.63;249.86;19.59;712;115;5216.00;208
14262;113;628282773;14262;200;14975;15181;10.27;0.62;249.86;19.59;713;115;5217.00;206
14265;113;628282783;14265;200;14975;15181;10.15;0.61;249.83;19.59;710;115;5218.00;206
14269;113;628282792;14269;205;14975;15181;10.03;0.61;249.79;19.59;706;115;5219.00;206
14271;113;628282802;14271;215;14996;15217;9.93;0.60;249.78;19.56;725;115;5220.00;221
14274;113;628282815;14274;211;14996;15217;9.78;0.60;249.76;19.56;722;115;5221.00;221
14275;113;628282824;14275;220;14999;15217;9.65;0.59;249.75;19.55;724;115;5222.00;218
14276;113;628282833;14276;223;14999;15217;9.56;0.58;249.75;19.55;723;115;5223.00;218
14277;113;628282843;14277;227;15000;15217;9.46;0.57;249.75;19.55;723;115;5224.00;217
14278;113;628282852;14278;231;15001;15217;9.34;0.57;249.76;19.55;723;115;5225.00;216
14278;113;628282866;14278;233;15005;15221;9.28;0.56;249.76;19.55;727;115;5226.00;216
14278;113;628282876;14278;242;15005;15221;9.23;0.56;249.76;19.55;727;115;5227.00;216
14279;113;628282885;14279;250;15009;15225;9.24;0.56;249.79;19.54;730;115;5228.00;216
14280;113;628282894;14280;254;15012;15226;9.21;0.56;249.78;19.54;732;115;5229.00;214
14281;113;628282904;14281;259;15014;15226;9.16;0.56;249.77;19.56;733;115;5230.00;212
14283;113;628282913;14283;265;15015;15226;9.06;0.55;249.76;19.56;732;115;5231.00;211
14283;113;628282923;14283;272;15027;15239;8.86;0.54;249.76;19.58;744;115;5232.00;212
14285;113;628282933;14285;273;15028;15239;8.72;0.53;249.77;19.58;743;115;5233.00;211
14287;113;628282942;14287;279;15029;15239;8.56;0.52;249.75;19.59;742;115;5234.00;210
14287;113;628282951;14287;273;15032;15240;8.45;0.51;249.75;19.61;745;115;5235.00;208
14288;113;628282960;14288;276;15033;15241;8.41;0.51;249.75;19.62;745;115;5236.00;208
14289;113;628282970;14289;272;15034;15241;8.36;0.51;249.75;19.63;745;115;5237.00;207
14291;113;628282985;14291;272;15038;15244;8.35;0.51;249.74;19.64;747;115;5238.00;206
14291;113;628282995;14291;272;15039;15244;8.35;0.51;249.74;19.66;748;115;5239.00;205
14293;114;628283004;14293;268;15040;15244;8.36;0.51;249.73;19.66;747;116;5240.00;204
14293;114;628283024;14293;269;15042;15244;8.35;0.51;249.73;19.68;749;116;5241.00;202
14294;114;628283033;14294;264;15047;15250;8.41;0.51;249.72;19.68;753;116;5242.00;203
14295;114;628283043;14295;268;15048;15250;8.40;0.51;249.72;19.69;753;116;5243.00;202
14296;114;628283052;14296;268;15050;15250;8.38;0.51;249.71;19.69;754;116;5244.00;200
14296;114;628283061;14296;266;15052;15250;8.39;0.51;249.71;19.71;756;116;5245.00;198
14297;114;628283069;14297;267;15055;15254;8.31;0.51;249.69;19.71;758;116;5246.00;199
14298;114;628283079;14298;265;15058;15255;8.22;0.50;249.70;19.72;760;116;5247.00;197
14298;114;628283088;14298;263;15058;15255;8.19;0.50;249.70;19.72;760;116;5248.00;197
14300;114;628283104;14300;261;15061;15256;8.22;0.50;249.70;19.74;761;116;5249.00;195
14303;114;628283119;14303;257;15061;15256;8.21;0.50;249.67;19.74;758;116;5250.00;195
14303;114;628283135;14303;256;15062;15256;8.19;0.50;249.67;19.75;759;116;5251.00;194
14304;114;628283144;14304;253;15064;15256;8.17;0.50;249.69;19.77;760;116;5252.00;192
14305;114;628283155;14305;248;15064;15256;8.17;0.50;249.68;19.77;759;116;5253.00;192
14305;114;628283165;14305;246;15066;15256;8.22;0.50;249.68;19.78;761;116;5254.00;190
14306;114;628283174;14306;246;15066;15256;8.20;0.50;249.68;19.78;760;116;5255.00;190
14308;114;628283183;14308;246;15104;15326;8.33;0.51;249.67;19.74;796;116;5256.00;222
14311;114;628283197;14311;242;15108;15327;8.27;0.51;249.72;19.74;797;116;5257.00;219
14314;114;628283208;14314;240;15117;15327;8.29;0.51;249.74;19.73;803;116;5258.00;210
14318;114;628283218;14318;243;15123;15327;8.30;0.51;249.72;19.74;805;116;5259.00;204
14321;114;628283229;14321;251;15128;15327;8.27;0.51;249.71;19.73;807;116;5260.00;199
14325;114;628283239;14325;252;15135;15327;8.12;0.50;249.69;19.74;810;116;5261.00;192
14329;114;628283248;14329;253;15137;15327;7.92;0.48;249.71;19.74;808;116;5262.00;190
14333;114;628283258;14333;262;15137;15327;7.86;0.48;249.69;19.74;804;116;5263.00;190
14337;114;628283267;14337;257;15140;15328;7.81;0.48;249.71;19.75;803;116;5264.00;188
14340;114;628283277;14340;258;15143;15330;7.68;0.47;249.72;19.76;803;116;5265.00;187
14345;114;628283287;14345;255;15144;15330;7.56;0.46;249.73;19.77;799;116;5266.00;186
14351;114;628283297;14351;254;15148;15334;7.44;0.46;249.72;19.78;797;116;5267.00;186
14355;114;628283308;14355;255;15149;15334;7.35;0.45;249.70;19.79;794;116;5268.00;185
14360;114;628283317;14360;256;15150;15334;7.20;0.44;249.73;19.80;790;116;5269.00;184
14365;114;628283327;14365;256;15151;15334;7.15;0.44;249.76;19.82;786;116;5270.00;183
14368;114;628283337;14368;259;15156;15340;7.11;0.44;249.74;19.81;788;116;5271.00;184
14369;114;628283348;14369;249;15157;15340;7.14;0.44;249.75;19.82;788;116;5272.00;183
14372;114;628283357;14372;243;15158;15340;7.15;0.44;249.77;19.83;786;116;5273.00;182
14376;114;628283366;14376;238;15160;15343;7.17;0.44;249.81;19.83;784;116;5274.00;183
14382;114;628283376;14382;239;15161;15343;7.14;0.44;249.83;19.84;779;116;5275.00;182
14384;114;628283387;14384;243;15162;15343;7.18;0.44;249.82;19.84;778;116;5276.00;181
14389;114;628283397;14389;232;15162;15344;7.29;0.45;249.82;19.84;773;116;5277.00;182
14391;114;628283413;14391;224;15163;15345;7.43;0.46;249.83;19.84;772;116;5278.00;182
14393;114;628283423;14393;226;15163;15345;7.50;0.46;249.87;19.84;770;116;5279.00;182
14400;114;628283435;14400;222;15183;15371;7.52;0.46;249.89;19.81;783;116;5280.00;188
14404;114;628283447;14404;210;15184;15371;7.66;0.47;249.87;19.81;780;116;5281.00;187
14409;114;628283459;14409;207;15185;15371;7.82;0.48;249.86;19.81;776;116;5282.00;186
14413;114;628283470;14413;204;15186;15372;7.96;0.49;249.85;19.81;773;116;5283.00;186
14416;114;628283481;14416;199;15186;15372;8.14;0.50;249.84;19.81;770;116;5284.00;186
14422;114;628283491;14422;200;15190;15376;8.25;0.50;249.81;19.80;768;116;5285.00;186
14423;114;628283503;14423;194;15190;15376;8.39;0.51;249.81;19.80;767;116;5286.00;186
14428;114;628283513;14428;197;15193;15379;8.49;0.52;249.82;19.80;765;116;5287.00;186
14434;114;628283524;14434;195;15193;15380;8.62;0.52;249.79;19.80;759;116;5288.00;187
14436;114;628283535;14436;194;15193;15380;8.75;0.53;249.77;19.80;757;116;5289.00;187
14442;114;628283545;14442;192;15193;15380;8.77;0.53;249.79;19.80;751;116;5290.00;187
14444;114;628283556;14444;185;15193;15380;8.83;0.54;249.79;19.80;749;116;5291.00;187
14447;114;628283572;14447;188;15202;15392;8.98;0.55;249.81;19.79;755;116;5292.00;190
14451;114;628283592;14451;188;15203;15392;9.04;0.55;249.82;19.78;752;116;5293.00;189
14453;114;628283607;14453;187;15204;15392;9.14;0.56;249.82;19.78;751;116;5294.00;188
14456;114;628283625;14456;185;15204;15392;9.19;0.56;249.85;19.78;748;116;5295.00;188
14462;114;628283644;14462;183;15204;15392;9.27;0.57;249.90;19.78;742;116;5296.00;188
14463;114;628283661;14463;182;15204;15392;9.38;0.57;249.90;19.78;741;116;5297.00;188
14466;114;628283678;14466;182;15204;15393;9.47;0.58;249.91;19.78;738;116;5298.00;189
14472;114;628283690;14472;184;15204;15393;9.53;0.58;249.91;19.78;732;116;5299.00;189
14474;114;628283704;14474;188;15208;15399;9.67;0.59;249.93;19.78;734;116;5300.00;191
14482;114;628283722;14482;187;15209;15400;9.68;0.59;249.93;19.78;727;116;5301.00;191
14487;114;628283735;14487;194;15210;15400;9.75;0.60;249.93;19.78;723;116;5302.00;190
14494;114;628283755;14494;194;15210;15400;9.78;0.60;249.89;19.78;716;116;5303.00;190
14497;114;628283767;14497;195;15213;15404;9.85;0.60;249.90;19.77;716;116;5304.00;191
14502;114;628283780;14502;195;15213;15404;9.88;0.60;249.90;19.77;711;116;5305.00;191
14505;114;628283792;14505;199;15213;15404;9.97;0.61;249.88;19.77;708;116;5306.00;191
14509;114;628283803;14509;195;15214;15405;10.06;0.61;249.89;19.77;705;116;5307.00;191
14513;114;628283815;14513;198;15217;15409;10.14;0.62;249.92;19.77;704;116;5308.00;192
14517;114;628283827;14517;201;15217;15409;10.16;0.62;249.93;19.77;700;116;5309.00;192
14522;114;628283842;14522;201;15220;15415;10.21;0.62;249.92;19.76;698;116;5310.00;195
14526;114;628283854;14526;200;15221;15415;10.22;0.62;249.92;19.76;695;116;5311.00;194
14528;114;628283866;14528;198;15222;15415;10.21;0.62;249.91;19.76;694;116;5312.00;193
14533;114;628283877;14533;202;15222;15415;10.18;0.62;249.90;19.76;689;116;5313.00;193
14538;114;628283889;14538;199;15225;15419;10.19;0.62;249.91;19.76;687;116;5314.00;194
14542;114;628283902;14542;205;15225;15419;10.13;0.62;249.93;19.76;683;116;5315.00;194
14546;114;628283913;14546;211;15226;15419;10.04;0.61;249.92;19.76;680;116;5316.00;193
14551;114;628283924;14551;202;15226;15419;9.98;0.61;249.96;19.76;675;116;5317.00;193
14554;114;628283936;14554;197;15227;15420;9.95;0.61;249.98;19.76;673;116;5318.00;193
14558;114;628283948;14558;188;15228;15421;9.97;0.61;250.01;19.75;670;116;5319.00;193
14564;114;628283960;14564;181;15228;15421;9.98;0.61;250.05;19.75;664;116;5320.00;193
14566;114;628283973;14566;182;15229;15422;10.09;0.61;250.04;19.75;663;116;5321.00;193
14572;114;628283985;14572;180;15229;15422;10.12;0.61;250.10;19.75;657;116;5322.00;193
14575;114;628283997;14575;179;15229;15422;10.13;0.61;250.10;19.75;654;116;5323.00;193
14577;114;628284009;14577;182;15229;15422;10.06;0.61;250.11;19.75;652;116;5324.00;193
14580;114;628284020;14580;182;15229;15422;9.95;0.61;250.13;19.75;649;116;5325.00;193
14582;114;628284032;14582;169;15229;15422;9.89;0.60;250.13;19.75;647;116;5326.00;193
14586;114;628284043;14586;166;15229;15422;9.86;0.60;250.13;19.75;643;116;5327.00;193
14589;114;628284055;14589;175;15296;15549;9.74;0.60;250.14;19.67;707;116;5328.00;253
14589;114;628284075;14589;157;15298;15550;9.78;0.60;250.14;19.66;709;116;5329.00;252
14593;114;628284087;14593;146;15306;15550;9.90;0.61;250.17;19.65;713;116;5330.00;244
14595;114;628284101;14595;139;15307;15550;9.93;0.61;250.19;19.65;712;116;5331.00;243
14596;114;628284115;14596;135;15311;15550;10.05;0.62;250.20;19.65;715;116;5332.00;239
14601;114;628284127;14601;137;15316;15550;10.14;0.62;250.21;19.64;715;116;5333.00;234
14602;114;628284139;14602;141;15320;15550;10.21;0.63;250.22;19.64;718;116;5334.00;230
14607;114;628284150;14607;139;15324;15550;10.22;0.63;250.24;19.64;717;116;5335.00;226
14612;114;628284161;14612;144;15331;15551;10.25;0.63;250.25;19.63;719;116;5336.00;220
14613;114;628284173;14613;139;15333;15552;10.25;0.63;250.25;19.63;720;116;5337.00;219
14615;114;628284186;14615;144;15337;15552;10.20;0.63;250.28;19.63;722;116;5338.00;215
14617;114;628284197;14617;152;15338;15553;10.16;0.63;250.31;19.63;721;116;5339.00;215
14619;115;628284211;14619;155;15342;15553;10.15;0.63;250.33;19.63;723;117;5340.00;211
14621;115;628284229;14621;156;15343;15553;10.15;0.63;250.31;19.63;722;117;5341.00;210
14622;115;628284245;14622;164;15345;15553;10.19;0.63;250.30;19.62;723;117;5342.00;208
14623;115;628284256;14623;166;15348;15557;10.22;0.63;250.30;19.62;725;117;5343.00;209
14626;115;628284268;14626;167;15349;15557;10.25;0.63;250.32;19.62;723;117;5344.00;208
14627;115;628284279;14627;168;15349;15557;10.26;0.63;250.31;19.62;722;117;5345.00;208
14631;115;628284289;14631;176;15352;15560;10.29;0.63;250.32;19.62;721;117;5346.00;208
14631;115;628284300;14631;182;15352;15560;10.30;0.63;250.32;19.62;721;117;5347.00;208
14637;115;628284311;14637;186;15353;15560;10.28;0.63;250.29;19.62;716;117;5348.00;207
14638;115;628284322;14638;189;15356;15564;10.26;0.63;250.28;19.61;718;117;5349.00;208
14645;115;628284340;14645;191;15358;15565;10.23;0.63;250.29;19.61;713;117;5350.00;207
14647;115;628284351;14647;192;15358;15565;10.23;0.63;250.29;19.61;711;117;5351.00;207
14649;116;628284361;14649;197;15362;15569;10.26;0.63;250.27;19.61;713;118;5352.00;207
14651;116;628284384;14651;203;15362;15569;10.30;0.63;250.26;19.61;711;118;5353.00;207
14652;116;628284395;14652;208;15363;15569;10.34;0.63;250.25;19.61;711;118;5354.00;206
14655;116;628284405;14655;207;15365;15571;10.26;0.63;250.23;19.60;710;118;5355.00;206
14655;116;628284415;14655;202;15365;15571;10.30;0.63;250.23;19.60;710;118;5356.00;206
14658;116;628284425;14658;201;15369;15577;10.33;0.63;250.22;19.60;711;118;5357.00;208
14660;116;628284435;14660;206;15369;15577;10.40;0.63;250.20;19.60;709;118;5358.00;208
14661;116;628284445;14661;205;15371;15577;10.54;0.64;250.18;19.75;710;118;5359.00;206
14663;116;628284457;14663;204;15371;15578;10.57;0.64;250.17;19.75;708;118;5360.00;207
14665;116;628284468;14665;200;15371;15578;10.59;0.65;250.15;19.75;706;118;5361.00;207
14668;116;628284479;14668;199;15371;15578;10.56;0.64;250.15;19.75;703;118;5362.00;207
14671;116;628284495;14671;200;15371;15578;10.55;0.64;250.12;19.75;700;118;5363.00;207
14676;116;628284505;14676;204;15381;15590;10.56;0.64;250.11;19.73;705;118;5364.00;209
14677;116;628284516;14677;205;15381;15590;10.60;0.65;250.11;19.73;704;118;5365.00;209
14681;116;628284525;14681;206;15382;15590;10.69;0.65;250.08;19.73;701;118;5366.00;208
14683;116;628284536;14683;210;15382;15590;10.73;0.65;250.08;19.73;699;118;5367.00;208
14688;116;628284545;14688;205;15382;15590;10.78;0.65;250.06;19.73;694;118;5368.00;208
14689;116;628284554;14689;203;15382;15590;10.81;0.66;250.04;19.73;693;118;5369.00;208
14692;116;628284566;14692;201;15385;15594;10.75;0.65;250.03;19.73;693;118;5370.00;209
14694;116;628284581;14694;199;15385;15594;10.76;0.65;250.01;19.73;691;118;5371.00;209
14696;116;628284590;14696;194;15388;15598;10.76;0.65;249.98;19.73;692;118;5372.00;210
14696;116;628284600;14696;192;15390;15599;10.75;0.65;249.98;19.87;694;118;5373.00;209
14700;116;628284610;14700;195;15392;15599;10.72;0.65;250.00;19.89;692;118;5374.00;207
14703;116;628284622;14703;190;15393;15599;10.74;0.65;249.98;19.90;690;118;5375.00;206
14706;116;628284636;14706;196;15403;15612;10.68;0.65;249.96;19.89;697;118;5376.00;209
14707;116;628284647;14707;192;15404;15612;10.70;0.65;249.96;20.03;697;118;5377.00;208
14712;116;628284657;14712;190;15404;15612;10.66;0.65;249.95;20.03;692;118;5378.00;208
14714;116;628284671;14714;191;15406;15613;10.70;0.65;249.94;20.03;692;118;5379.00;207
14717;116;628284680;14717;195;15407;15614;10.71;0.65;249.90;20.04;690;118;5380.00;207
14720;116;628284689;14720;195;15408;15614;10.67;0.65;249.89;20.18;688;118;5381.00;206
14720;116;628284704;14720;192;15410;15617;10.69;0.65;249.89;20.18;690;118;5382.00;207
14724;116;628284713;14724;189;15411;15617;10.58;0.64;249.88;20.18;687;118;5383.00;206
14725;116;628284722;14725;188;15411;15617;10.52;0.64;249.88;20.18;686;118;5384.00;206
14727;116;628284731;14727;194;15411;15617;10.39;0.63;249.89;20.18;684;118;5385.00;206
14730;116;628284740;14730;194;15416;15623;10.33;0.63;249.88;20.32;686;118;5386.00;207
14730;116;628284750;14730;186;15417;15623;10.31;0.63;249.88;20.32;687;118;5387.00;206
14732;116;628284764;14732;186;15417;15623;10.20;0.62;249.87;20.32;685;118;5388.00;206
14734;116;628284773;14734;185;15417;15623;10.12;0.62;249.86;20.32;683;118;5389.00;206
14735;116;628284783;14735;183;15420;15627;9.99;0.61;249.86;20.31;685;118;5390.00;207
14736;116;628284793;14736;179;15421;15628;9.91;0.60;249.87;20.31;685;118;5391.00;207
14738;116;628284803;14738;176;15421;15628;9.88;0.60;249.87;20.31;683;118;5392.00;207
14739;116;628284813;14739;170;15422;15629;9.87;0.60;249.87;20.31;683;118;5393.00;207
14739;117;628284828;14739;169;15422;15629;9.87;0.60;249.87;20.31;683;119;5394.00;207
14740;117;628284848;14740;159;15422;15629;9.87;0.60;249.87;20.31;682;119;5395.00;207
14742;117;628284858;14742;156;15422;15629;9.86;0.60;249.87;20.31;680;119;5396.00;207
14744;117;628284867;14744;158;15423;15629;9.85;0.60;249.89;20.32;679;119;5397.00;206
14746;117;628284876;14746;161;15423;15629;9.92;0.60;249.88;20.32;677;119;5398.00;206
14748;117;628284886;14748;164;15423;15629;9.96;0.61;249.87;20.32;675;119;5399.00;206
