step_arrived;step_collisions;step_duration;step_ended;step_halting;step_inserted;step_loaded;step_meanSpeed;step_meanSpeedRelative;step_meanTravelTime;step_meanWaitingTime;step_running;step_teleports;step_time;step_waiting
0;0;628351706;0;1;85;245;16.06;1.14;-1.00;0.00;85;0;0.00;160
0;0;628351744;0;1;97;245;15.32;1.07;-1.00;0.12;97;0;1.00;148
0;0;628351746;0;0;116;245;14.55;0.99;-1.00;0.43;116;0;2.00;129
0;0;628351747;0;2;131;245;13.31;0.90;-1.00;0.73;131;0;3.00;114
0;0;628351748;0;2;143;245;12.38;0.83;-1.00;1.00;143;0;4.00;102
0;0;628351750;0;5;153;245;11.56;0.78;-1.00;1.26;153;0;5.00;92
0;0;628351752;0;7;163;245;10.92;0.73;-1.00;1.55;163;0;6.00;82
0;0;628351754;0;10;168;245;10.54;0.70;-1.00;1.71;168;0;7.00;77
0;0;628351756;0;15;176;246;10.07;0.67;-1.00;2.00;176;0;8.00;70
0;0;628351759;0;17;182;247;9.65;0.64;-1.00;2.23;182;0;9.00;65
0;0;628351761;0;17;188;247;9.27;0.61;-1.00;2.48;188;0;10.00;59
0;0;628351765;0;24;195;248;9.09;0.60;-1.00;2.73;195;0;11.00;53
1;0;628351769;1;28;196;248;9.06;0.60;12.00;2.78;195;0;12.00;52
1;0;628351772;1;34;205;248;8.98;0.59;12.00;3.20;204;0;13.00;43
1;0;628351775;1;37;206;248;9.19;0.60;12.00;3.25;205;0;14.00;42
1;0;628351778;1;39;212;252;9.17;0.59;12.00;3.45;211;0;15.00;40
1;0;628351781;1;40;216;252;9.02;0.58;12.00;3.68;215;0;16.00;36
1;0;628351784;1;47;220;252;8.92;0.57;12.00;3.92;219;0;17.00;32
2;0;628351787;2;49;221;255;9.00;0.57;15.00;3.90;219;0;18.00;34
2;0;628351790;2;52;225;255;9.04;0.58;15.00;4.17;223;0;19.00;30
2;0;628351792;2;58;226;255;9.14;0.58;15.00;4.24;224;0;20.00;29
3;0;628351795;3;62;235;259;9.27;0.59;17.00;4.54;232;0;21.00;24
3;0;628351798;3;66;237;260;9.33;0.59;17.00;4.60;234;0;22.00;23
4;0;628351802;4;71;240;260;9.27;0.58;18.50;4.83;236;0;23.00;20
5;0;628351804;5;74;247;264;9.13;0.57;19.60;4.95;242;0;24.00;17
6;0;628351808;6;75;249;264;9.08;0.57;20.17;5.11;243;0;25.00;15
6;0;628351812;6;77;251;264;9.02;0.56;20.17;5.21;245;0;26.00;13
6;0;628351815;6;81;252;265;9.10;0.57;20.17;5.24;246;0;27.00;13
6;0;628351818;6;84;253;265;9.15;0.57;20.17;5.22;247;0;28.00;12
6;0;628351821;6;87;258;271;9.24;0.57;20.17;5.25;252;0;29.00;13
7;0;628351827;7;91;259;271;9.16;0.57;21.14;5.29;252;0;30.00;12
7;0;628351830;7;92;261;272;9.07;0.56;21.14;5.30;254;0;31.00;11
7;0;628351833;7;93;262;272;8.90;0.55;21.14;5.30;255;0;32.00;10
7;0;628351836;7;100;264;272;8.84;0.55;21.14;5.40;257;0;33.00;8
8;0;628351840;8;100;264;272;8.77;0.54;22.75;5.40;256;0;34.00;8
9;0;628351844;9;106;264;272;8.70;0.54;23.67;5.40;255;0;35.00;8
10;0;628351847;10;108;276;284;8.89;0.55;24.30;5.17;266;0;36.00;8
10;0;628351851;10;113;276;284;8.87;0.55;24.30;5.17;266;0;37.00;8
10;0;628351855;10;115;276;284;8.86;0.55;24.30;5.17;266;0;38.00;8
10;0;628351858;10;118;276;284;8.78;0.54;24.30;5.17;266;0;39.00;8
11;0;628351861;11;118;276;284;8.66;0.53;25.27;5.17;265;0;40.00;8
12;0;628351865;12;119;276;284;8.55;0.53;26.33;5.17;264;0;41.00;8
13;0;628351868;13;123;280;288;8.54;0.53;27.54;5.11;267;0;42.00;8
13;0;628351871;13;126;280;288;8.35;0.52;27.54;5.11;267;0;43.00;8
13;0;628351875;13;130;283;292;8.24;0.51;27.54;5.06;270;0;44.00;9
14;0;628351878;14;132;285;294;8.05;0.50;27.29;5.03;271;0;45.00;9
16;0;628351881;16;137;286;294;7.92;0.49;28.88;5.02;270;0;46.00;8
17;0;628351884;17;134;286;294;7.83;0.48;29.94;5.02;269;0;47.00;8
17;0;628351887;17;135;297;307;8.06;0.50;29.94;4.84;280;0;48.00;10
18;0;628351892;18;136;297;307;7.94;0.49;30.61;4.84;279;0;49.00;10
18;0;628351895;18;138;298;307;7.91;0.49;30.61;4.83;280;0;50.00;9
19;0;628351900;19;142;299;308;7.84;0.48;31.68;4.81;280;0;51.00;9
19;0;628351903;19;141;300;309;7.84;0.49;31.68;4.80;281;0;52.00;9
20;0;628351907;20;144;300;309;7.83;0.48;32.70;4.80;280;0;53.00;9
20;0;628351910;20;144;302;312;7.81;0.48;32.70;4.77;282;0;54.00;10
20;0;628351913;20;148;302;312;7.69;0.47;32.70;4.77;282;0;55.00;10
21;0;628351916;21;136;303;312;7.68;0.48;32.10;4.76;282;0;56.00;9
23;0;628351919;23;133;303;312;7.60;0.47;33.26;4.76;280;0;57.00;9
23;0;628351923;23;131;308;318;7.58;0.47;33.26;4.70;285;0;58.00;10
24;0;628351927;24;132;308;318;7.61;0.47;34.33;4.70;284;0;59.00;10
25;0;628351931;25;137;309;318;7.64;0.47;35.28;4.69;284;0;60.00;9
26;0;628351935;26;137;309;318;7.70;0.48;36.27;4.69;283;0;61.00;9
29;0;628351938;29;138;313;322;7.71;0.48;38.72;4.65;284;0;62.00;9
29;0;628351941;29;138;314;323;7.87;0.49;38.72;4.63;285;0;63.00;9
30;0;628351944;30;140;314;323;7.99;0.49;38.17;4.63;284;0;64.00;9
30;0;628351947;30;142;315;324;8.15;0.50;38.17;4.62;285;0;65.00;9
32;0;628351951;32;142;315;324;8.07;0.50;38.88;4.62;283;0;66.00;9
33;0;628351954;33;133;315;324;8.11;0.50;39.73;4.62;282;0;67.00;9
33;0;628351958;33;133;315;324;8.18;0.50;39.73;4.62;282;0;68.00;9
34;0;628351961;34;128;315;324;8.20;0.50;39.97;4.62;281;0;69.00;9
36;0;628351965;36;124;315;324;8.26;0.50;41.50;4.62;279;0;70.00;9
36;0;628351968;36;121;315;324;8.35;0.51;41.50;4.62;279;0;71.00;9
37;1;628351972;37;130;356;394;8.36;0.51;42.32;4.09;319;1;72.00;38
37;1;628351994;37;121;358;395;8.59;0.52;42.32;4.07;321;1;73.00;37
37;1;628351997;37;114;363;395;8.94;0.55;42.32;4.04;326;1;74.00;32
38;2;628352002;38;111;366;395;9.21;0.56;43.00;4.03;328;2;75.00;29
38;2;628352014;38;107;370;395;9.51;0.58;43.00;4.03;332;2;76.00;25
38;2;628352022;38;107;372;395;9.76;0.59;43.00;4.04;334;2;77.00;23
38;2;628352026;38;108;375;395;9.88;0.60;43.00;4.05;337;2;78.00;20
38;2;628352036;38;107;378;395;9.90;0.60;43.00;4.08;340;2;79.00;17
39;2;628352052;39;109;380;396;9.86;0.60;43.95;4.08;341;2;80.00;16
40;2;628352056;40;109;381;397;9.95;0.60;44.45;4.07;341;2;81.00;16
40;2;628352060;40;113;382;397;9.93;0.60;44.45;4.08;342;2;82.00;15
40;2;628352065;40;116;386;401;9.84;0.60;44.45;4.05;346;2;83.00;15
41;2;628352069;41;119;386;401;9.75;0.59;45.20;4.05;345;2;84.00;15
43;2;628352073;43;121;386;401;9.64;0.58;46.95;4.05;343;2;85.00;15
44;2;628352082;44;119;386;401;9.58;0.58;47.84;4.05;342;2;86.00;15
45;2;628352086;45;122;390;407;9.57;0.58;48.71;4.02;345;2;87.00;17
46;2;628352091;46;122;390;407;9.39;0.57;49.57;4.02;344;2;88.00;17
46;2;628352095;46;124;391;407;9.39;0.57;49.57;4.02;345;2;89.00;16
48;2;628352101;48;127;394;413;9.31;0.56;51.25;3.99;346;2;90.00;19
50;2;628352106;50;131;395;413;9.26;0.56;52.84;3.98;345;2;91.00;18
52;2;628352110;52;135;395;413;9.26;0.56;54.35;3.98;343;2;92.00;18
53;2;628352114;53;136;397;414;9.25;0.56;55.06;3.97;344;2;93.00;17
53;2;628352118;53;135;398;415;9.27;0.57;55.06;3.96;345;2;94.00;17
56;2;628352122;56;137;399;415;9.21;0.56;57.11;3.96;343;2;95.00;16
57;2;628352126;57;139;409;428;9.16;0.56;56.53;3.87;352;2;96.00;19
59;2;628352131;59;138;410;428;9.12;0.55;57.90;3.86;351;2;97.00;18
59;2;628352134;59;140;410;428;9.18;0.56;57.90;3.86;351;2;98.00;18
61;2;628352138;61;138;411;429;9.22;0.56;59.13;3.85;350;2;99.00;18
61;2;628352149;61;134;411;429;9.25;0.56;59.13;3.85;350;2;100.00;18
63;2;628352157;63;132;413;433;9.30;0.57;60.46;3.84;350;2;101.00;20
64;2;628352162;64;126;413;433;9.39;0.57;61.06;3.84;349;2;102.00;20
65;2;628352165;65;121;418;437;9.32;0.57;61.65;3.81;353;2;103.00;19
66;2;628352170;66;114;418;437;9.50;0.58;62.26;3.81;352;2;104.00;19
67;2;628352175;67;109;418;437;9.62;0.58;62.88;3.81;351;2;105.00;19
68;2;628352180;68;102;418;437;9.75;0.59;63.50;3.81;350;2;106.00;19
68;2;628352184;68;97;418;437;9.83;0.60;63.50;3.81;350;2;107.00;19
68;2;628352189;68;92;428;449;10.01;0.61;63.50;3.72;360;2;108.00;21
69;2;628352194;69;85;429;449;10.15;0.62;64.16;3.71;360;2;109.00;20
69;2;628352204;69;82;430;449;10.33;0.63;64.16;3.71;361;2;110.00;19
69;2;628352209;69;76;430;449;10.43;0.64;64.16;3.71;361;2;111.00;19
69;2;628352220;69;73;430;449;10.66;0.65;64.16;3.71;361;2;112.00;19
69;2;628352224;69;72;430;449;10.82;0.66;64.16;3.71;361;2;113.00;19
71;2;628352229;71;69;431;450;11.06;0.67;64.89;3.70;360;2;114.00;19
71;2;628352235;71;70;431;450;11.17;0.68;64.89;3.70;360;2;115.00;19
71;2;628352241;71;69;435;456;11.33;0.69;64.89;3.68;364;2;116.00;21
71;2;628352246;71;69;438;457;11.39;0.70;64.89;3.92;367;2;117.00;19
72;2;628352252;72;71;438;457;11.42;0.70;65.47;3.92;366;2;118.00;19
73;2;628352257;73;73;438;457;11.47;0.70;65.71;3.92;365;2;119.00;19
73;2;628352265;73;74;444;462;11.57;0.71;65.71;4.25;371;2;120.00;18
74;2;628352272;74;74;445;462;11.66;0.71;66.43;4.35;371;2;121.00;17
75;2;628352278;75;74;446;462;11.69;0.71;67.16;4.61;371;2;122.00;16
79;2;628352284;79;76;450;463;11.58;0.71;68.78;5.08;371;2;123.00;13
80;2;628352291;80;79;456;467;11.42;0.70;69.45;5.15;376;2;124.00;11
80;2;628352297;80;81;456;467;11.55;0.71;69.45;5.15;376;2;125.00;11
81;2;628352303;81;84;460;470;11.62;0.71;70.11;5.41;379;2;126.00;10
83;2;628352309;83;89;461;470;11.64;0.71;71.45;5.40;378;2;127.00;9
84;2;628352315;84;89;462;470;11.73;0.72;71.96;5.66;378;2;128.00;8
84;2;628352322;84;92;462;470;11.69;0.72;71.96;5.66;378;2;129.00;8
84;2;628352327;84;92;466;474;11.64;0.71;71.96;5.90;382;2;130.00;8
87;2;628352335;87;94;466;474;11.66;0.71;73.49;5.90;379;2;131.00;8
89;2;628352341;89;97;468;474;11.63;0.71;74.78;6.16;379;2;132.00;6
90;2;628352348;90;100;469;474;11.64;0.71;75.40;6.33;379;2;133.00;5
92;2;628352354;92;101;472;475;11.60;0.71;76.64;6.56;380;2;134.00;3
95;2;628352360;95;103;474;477;11.60;0.71;76.63;6.53;379;2;135.00;3
96;2;628352366;96;104;475;477;11.55;0.71;77.19;6.60;379;2;136.00;2
97;2;628352372;97;103;476;478;11.59;0.71;77.47;6.59;379;2;137.00;2
98;2;628352378;98;105;476;478;11.57;0.71;77.36;6.59;378;2;138.00;2
99;2;628352385;99;108;477;478;11.48;0.70;77.90;6.66;378;2;139.00;1
101;2;628352393;101;109;477;478;11.46;0.70;78.73;6.66;376;2;140.00;1
102;2;628352400;102;110;478;478;11.33;0.69;79.30;6.69;376;2;141.00;0
104;2;628352415;104;113;478;478;11.24;0.69;80.38;6.69;374;2;142.00;0
108;2;628352423;108;114;478;478;11.14;0.68;82.02;6.69;370;2;143.00;0
108;2;628352430;108;132;551;605;10.90;0.69;82.02;5.81;443;2;144.00;54
109;2;628352447;109;125;557;606;10.91;0.69;82.60;5.76;448;2;145.00;49
113;2;628352454;113;120;566;606;10.91;0.69;83.88;5.70;453;2;146.00;40
113;2;628352460;113;122;573;606;10.83;0.68;83.88;5.67;460;2;147.00;33
114;2;628352466;114;125;579;606;10.83;0.68;83.81;5.65;465;2;148.00;27
114;2;628352472;114;121;583;606;10.88;0.68;83.81;5.64;469;2;149.00;23
117;2;628352480;117;120;587;611;10.80;0.68;85.43;5.65;470;2;150.00;24
117;3;628352489;117;118;591;611;10.89;0.68;85.43;5.66;474;3;151.00;20
119;3;628352502;119;117;593;612;10.96;0.69;85.94;5.65;474;3;152.00;19
124;3;628352513;124;116;594;613;11.02;0.69;87.61;5.66;470;3;153.00;19
125;3;628352520;125;117;597;613;11.06;0.69;86.99;5.67;472;3;154.00;16
128;3;628352526;128;118;599;614;11.01;0.69;88.43;5.67;471;3;155.00;15
130;3;628352533;130;122;601;614;10.93;0.68;88.68;5.69;471;3;156.00;13
131;3;628352540;131;125;601;614;10.86;0.68;89.16;5.69;470;3;157.00;13
133;3;628352546;133;133;603;614;10.82;0.67;89.84;5.72;470;3;158.00;11
133;3;628352552;133;135;606;618;10.82;0.67;89.84;5.72;473;3;159.00;12
135;3;628352559;135;140;609;618;10.70;0.66;90.59;5.76;474;3;160.00;9
138;3;628352571;138;143;609;618;10.62;0.66;91.05;5.76;471;3;161.00;9
138;3;628352577;138;145;612;621;10.49;0.65;91.05;5.78;474;3;162.00;9
139;3;628352584;139;140;613;621;10.40;0.64;91.04;5.79;474;3;163.00;8
144;3;628352590;144;140;613;621;10.26;0.63;92.98;5.79;469;3;164.00;8
145;3;628352597;145;144;617;625;10.18;0.63;93.33;5.76;472;3;165.00;8
146;3;628352604;146;140;618;626;10.11;0.63;93.82;5.75;472;3;166.00;8
148;3;628352610;148;139;618;626;10.03;0.62;93.93;5.75;470;3;167.00;8
151;3;628352615;151;140;625;630;9.85;0.61;94.25;5.76;474;3;168.00;5
153;3;628352622;153;143;625;630;9.68;0.60;94.92;5.76;472;3;169.00;5
155;4;628352628;155;139;627;630;9.59;0.59;95.70;5.78;472;4;170.00;3
156;4;628352643;156;139;629;631;9.61;0.59;96.14;5.81;473;4;171.00;2
160;4;628352655;160;135;629;631;9.67;0.60;97.47;5.81;469;4;172.00;2
161;5;628352662;161;137;634;637;9.71;0.60;97.83;5.78;473;5;173.00;3
162;5;628352679;162;133;635;637;9.71;0.60;98.30;5.78;473;5;174.00;2
164;5;628352685;164;133;636;638;9.69;0.60;99.10;5.77;472;5;175.00;2
165;5;628352691;165;135;638;638;9.67;0.59;99.47;5.80;473;5;176.00;0
168;5;628352697;168;127;638;638;9.79;0.60;99.71;5.80;470;5;177.00;0
168;5;628352708;168;122;638;638;9.90;0.61;99.71;5.80;470;5;178.00;0
169;5;628352719;169;118;638;638;10.09;0.62;99.67;5.80;469;5;179.00;0
169;5;628352727;169;121;670;672;10.13;0.62;99.67;5.52;501;5;180.00;2
169;5;628352735;169;114;671;672;10.19;0.63;99.67;5.52;502;5;181.00;1
169;5;628352742;169;116;671;672;10.15;0.63;99.67;5.52;502;5;182.00;1
170;5;628352748;170;122;672;672;10.18;0.63;99.74;5.51;502;5;183.00;0
172;5;628352754;172;121;672;672;10.12;0.62;100.26;5.51;500;5;184.00;0
174;5;628352766;174;127;672;672;10.12;0.62;100.55;5.51;498;5;185.00;0
175;5;628352773;175;133;676;676;10.10;0.62;101.03;5.49;501;5;186.00;0
176;5;628352780;176;137;676;676;10.02;0.62;101.17;5.49;500;5;187.00;0
178;5;628352786;178;145;679;680;9.98;0.62;101.73;5.47;501;5;188.00;1
179;5;628352796;179;150;680;681;9.90;0.61;101.91;5.46;501;5;189.00;1
181;5;628352807;181;157;681;681;9.79;0.61;102.08;5.45;500;5;190.00;0
183;5;628352816;183;161;681;681;9.60;0.59;101.81;5.45;498;5;191.00;0
187;5;628352823;187;168;694;694;9.50;0.59;103.04;5.35;507;5;192.00;0
189;5;628352831;189;170;694;694;9.35;0.58;102.69;5.35;505;5;193.00;0
190;5;628352838;190;180;694;694;9.27;0.58;102.60;5.35;504;5;194.00;0
194;5;628352844;194;181;695;695;9.22;0.57;101.80;5.35;501;5;195.00;0
199;5;628352851;199;186;696;696;9.08;0.56;102.67;5.34;497;5;196.00;0
203;5;628352864;203;191;696;696;8.95;0.55;102.38;5.34;493;5;197.00;0
206;5;628352870;206;193;698;699;8.93;0.55;102.08;5.32;492;5;198.00;1
209;5;628352877;209;194;699;699;8.82;0.54;102.95;5.32;490;5;199.00;0
210;5;628352883;210;196;699;699;8.72;0.53;102.95;5.32;489;5;200.00;0
212;5;628352894;212;201;699;699;8.54;0.52;103.36;5.32;487;5;201.00;0
213;6;628352900;213;200;704;705;8.39;0.52;103.04;5.29;491;6;202.00;1
215;6;628352918;215;207;704;705;8.26;0.51;102.50;5.29;489;6;203.00;1
217;6;628352924;217;211;705;705;8.14;0.50;102.65;5.28;488;6;204.00;0
219;6;628352932;219;216;705;705;7.98;0.49;102.26;5.28;486;6;205.00;0
220;6;628352938;220;221;709;709;7.92;0.49;102.10;5.26;489;6;206.00;0
221;6;628352944;221;230;710;710;7.76;0.48;101.76;5.25;489;6;207.00;0
223;6;628352951;223;231;710;710;7.65;0.47;102.66;5.25;487;6;208.00;0
225;6;628352956;225;234;711;711;7.53;0.46;102.96;5.25;486;6;209.00;0
226;6;628352964;226;240;711;711;7.40;0.46;102.59;5.25;485;6;210.00;0
226;6;628352970;226;242;711;711;7.24;0.45;102.59;5.25;485;6;211.00;0
226;6;628352976;226;250;711;711;7.22;0.45;102.59;5.25;485;6;212.00;0
228;6;628352981;228;255;711;711;7.19;0.45;102.00;5.25;483;6;213.00;0
230;6;628352987;230;258;711;711;7.15;0.44;102.37;5.25;481;6;214.00;0
230;6;628352996;230;258;711;711;7.09;0.44;102.37;5.25;481;6;215.00;0
233;6;628353003;233;273;753;781;7.22;0.45;102.59;4.95;520;6;216.00;28
234;6;628353015;234;259;755;782;7.19;0.45;103.08;4.94;521;6;217.00;27
234;6;628353022;234;252;762;782;7.35;0.45;103.08;4.92;528;6;218.00;20
237;6;628353029;237;238;767;782;7.52;0.46;104.26;4.90;530;6;219.00;15
238;6;628353036;238;221;771;782;7.78;0.48;104.74;4.90;533;6;220.00;11
239;6;628353043;239;207;774;782;8.03;0.49;105.22;4.90;535;6;221.00;8
240;6;628353050;240;200;778;782;8.25;0.51;105.50;4.90;538;6;222.00;4
240;6;628353057;240;193;779;782;8.41;0.52;105.50;4.91;539;6;223.00;3
241;6;628353065;241;187;782;783;8.57;0.52;105.65;4.91;541;6;224.00;1
242;6;628353072;242;187;784;785;8.70;0.53;106.13;4.90;542;6;225.00;1
242;6;628353080;242;171;785;785;8.89;0.55;106.13;4.90;543;6;226.00;0
243;6;628353088;243;156;789;789;8.97;0.55;106.20;4.88;546;6;227.00;0
247;6;628353097;247;141;789;789;9.18;0.56;107.89;4.88;542;6;228.00;0
249;6;628353105;249;129;789;789;9.42;0.58;107.53;4.88;540;6;229.00;0
253;6;628353119;253;118;789;789;9.63;0.59;108.49;4.88;536;6;230.00;0
255;6;628353127;255;112;794;795;9.86;0.60;108.86;4.86;539;6;231.00;1
256;6;628353137;256;107;794;795;10.07;0.61;109.32;4.86;538;6;232.00;1
257;6;628353146;257;102;795;795;10.31;0.63;109.77;4.86;538;6;233.00;0
258;6;628353154;258;99;797;798;10.56;0.64;109.88;4.85;539;6;234.00;1
258;6;628353163;258;97;798;798;10.73;0.65;109.88;4.84;540;6;235.00;0
259;6;628353172;259;96;798;798;10.89;0.66;110.33;4.84;539;6;236.00;0
260;6;628353180;260;95;799;799;11.05;0.67;109.98;4.84;539;6;237.00;0
261;6;628353188;261;91;800;800;11.28;0.69;109.84;4.83;539;6;238.00;0
263;7;628353196;263;88;800;800;11.42;0.69;110.62;4.83;537;7;239.00;0
264;7;628353220;264;94;824;826;11.34;0.69;110.57;4.69;560;7;240.00;2
267;7;628353230;267;90;825;826;11.51;0.70;111.70;4.69;558;7;241.00;1
268;7;628353239;268;84;826;826;11.62;0.71;112.18;4.68;558;7;242.00;0
270;7;628353246;270;86;827;827;11.74;0.72;112.82;4.68;557;7;243.00;0
274;7;628353254;274;88;827;827;11.85;0.72;113.36;4.68;553;7;244.00;0
277;7;628353262;277;90;830;831;11.97;0.73;114.24;4.66;553;7;245.00;1
280;7;628353271;280;96;830;831;12.06;0.73;115.17;4.66;550;7;246.00;1
282;7;628353278;282;99;835;835;12.06;0.73;115.21;4.64;553;7;247.00;0
284;7;628353287;284;98;835;835;12.09;0.73;115.39;4.64;551;7;248.00;0
285;7;628353295;285;96;835;835;12.13;0.74;115.54;4.64;550;7;249.00;0
288;7;628353303;288;96;835;835;12.14;0.74;116.00;4.64;547;7;250.00;0
290;7;628353311;290;97;835;835;12.20;0.74;115.97;4.64;545;7;251.00;0
291;7;628353319;291;99;845;847;12.18;0.74;115.95;4.59;554;7;252.00;2
292;7;628353336;292;104;845;847;12.19;0.74;115.99;4.59;553;7;253.00;2
294;7;628353350;294;104;847;847;12.21;0.74;116.28;4.58;553;7;254.00;0
295;7;628353357;295;103;847;847;12.28;0.75;116.40;4.58;552;7;255.00;0
296;8;628353365;296;104;847;847;12.35;0.75;116.63;4.58;551;8;256.00;0
297;8;628353391;297;105;847;847;12.44;0.76;117.02;4.58;550;8;257.00;0
298;8;628353399;298;108;848;848;12.52;0.76;117.25;4.58;550;8;258.00;0
300;8;628353414;300;108;848;848;12.48;0.76;117.64;4.58;548;8;259.00;0
304;8;628353422;304;110;853;854;12.36;0.75;118.11;4.56;549;8;260.00;1
307;8;628353438;307;110;854;855;12.39;0.75;118.93;4.55;547;8;261.00;1
309;8;628353446;309;111;855;855;12.41;0.75;119.38;4.55;546;8;262.00;0
312;8;628353453;312;109;855;855;12.42;0.75;119.37;4.55;543;8;263.00;0
314;8;628353461;314;112;859;859;12.42;0.75;119.38;4.53;545;8;264.00;0
320;9;628353470;320;114;859;859;12.40;0.75;120.60;4.53;539;9;265.00;0
321;9;628353485;321;116;859;859;12.48;0.76;120.76;4.53;538;9;266.00;0
323;9;628353493;323;120;860;860;12.54;0.76;120.98;4.53;537;9;267.00;0
326;9;628353501;326;124;864;864;12.47;0.75;121.40;4.51;538;9;268.00;0
331;9;628353509;331;117;864;864;12.48;0.75;121.90;4.51;533;9;269.00;0
335;9;628353519;335;115;867;870;12.49;0.75;122.70;4.49;532;9;270.00;3
337;9;628353527;337;111;867;870;12.45;0.75;123.22;4.49;530;9;271.00;3
340;9;628353535;340;104;868;870;12.47;0.75;123.90;4.49;528;9;272.00;2
342;9;628353544;342;101;868;870;12.48;0.75;123.93;4.49;526;9;273.00;2
346;9;628353552;346;96;871;874;12.52;0.76;124.25;4.48;525;9;274.00;3
351;9;628353560;351;92;871;874;12.60;0.76;124.80;4.48;520;9;275.00;3
352;9;628353573;352;89;872;874;12.72;0.77;124.82;4.48;520;9;276.00;2
353;9;628353581;353;85;872;874;12.80;0.78;125.24;4.48;519;9;277.00;2
354;9;628353589;354;80;874;875;12.91;0.78;125.27;4.48;520;9;278.00;1
356;9;628353598;356;74;875;876;13.00;0.79;125.78;4.48;519;9;279.00;1
358;9;628353606;358;72;876;876;13.03;0.79;125.53;4.48;518;9;280.00;0
360;9;628353615;360;73;877;877;13.11;0.79;125.56;4.47;517;9;281.00;0
361;9;628353623;361;71;877;877;13.13;0.80;125.40;4.47;516;9;282.00;0
362;9;628353632;362;70;877;877;13.16;0.80;125.44;4.47;515;9;283.00;0
363;9;628353640;363;72;877;877;13.22;0.80;125.18;4.47;514;9;284.00;0
365;9;628353648;365;72;877;877;13.24;0.80;125.57;4.47;512;9;285.00;0
366;9;628353660;366;74;877;877;13.21;0.80;125.42;4.47;511;9;286.00;0
366;9;628353672;366;73;877;877;13.21;0.80;125.42;4.47;511;9;287.00;0
366;9;628353682;366;92;950;1004;12.60;0.78;125.42;4.13;584;9;288.00;54
368;9;628353724;368;82;952;1005;12.57;0.78;126.18;4.13;584;9;289.00;53
368;9;628353737;368;79;963;1005;12.54;0.78;126.18;4.10;595;9;290.00;42
370;9;628353757;370;86;965;1005;12.57;0.78;126.48;4.10;595;9;291.00;40
370;9;628353771;370;88;970;1005;12.57;0.78;126.48;4.10;600;9;292.00;35
372;9;628353782;372;91;971;1005;12.60;0.78;126.63;4.10;599;9;293.00;34
372;9;628353797;372;94;975;1005;12.65;0.78;126.63;4.11;603;9;294.00;30
378;9;628353806;378;95;978;1005;12.61;0.78;127.25;4.12;600;9;295.00;27
379;9;628353817;379;94;979;1006;12.65;0.78;126.94;4.12;600;9;296.00;27
385;9;628353826;385;99;983;1007;12.63;0.78;127.24;4.14;598;9;297.00;24
387;9;628353837;387;101;985;1007;12.52;0.77;127.41;4.15;598;9;298.00;22
391;9;628353848;391;104;990;1008;12.42;0.76;127.74;4.19;599;9;299.00;18
391;9;628353860;391;108;995;1014;12.27;0.76;127.74;4.22;604;9;300.00;19
393;9;628353881;393;113;996;1014;12.15;0.75;128.16;4.23;603;9;301.00;18
394;9;628353891;394;122;999;1014;11.94;0.74;128.42;4.25;605;9;302.00;15
396;9;628353900;396;128;1003;1018;11.86;0.73;128.91;4.26;607;9;303.00;15
396;9;628353910;396;138;1004;1018;11.66;0.72;128.91;4.27;608;9;304.00;14
401;9;628353930;401;146;1006;1018;11.57;0.71;129.52;4.29;605;9;305.00;12
402;9;628353940;402;154;1010;1021;11.50;0.71;129.42;4.30;608;9;306.00;11
406;9;628353949;406;161;1010;1021;11.37;0.70;129.86;4.30;604;9;307.00;11
409;9;628353965;409;175;1012;1021;11.20;0.69;130.18;4.31;603;9;308.00;9
409;9;628353975;409;178;1015;1025;11.01;0.68;130.18;4.30;606;9;309.00;10
411;9;628353984;411;181;1016;1026;10.87;0.67;130.41;4.29;605;9;310.00;10
415;9;628353992;415;184;1016;1026;10.71;0.66;130.90;4.29;601;9;311.00;10
417;9;628354000;417;188;1020;1030;10.62;0.65;131.31;4.28;603;9;312.00;10
421;9;628354010;421;191;1020;1030;10.47;0.64;131.79;4.28;599;9;313.00;10
426;9;628354018;426;197;1022;1030;10.29;0.63;132.54;4.29;596;9;314.00;8
428;9;628354033;428;198;1024;1032;10.18;0.62;132.88;4.29;596;9;315.00;8
429;9;628354041;429;203;1024;1032;10.09;0.62;133.27;4.29;595;9;316.00;8
431;9;628354049;431;207;1028;1038;9.99;0.61;133.81;4.27;597;9;317.00;10
434;9;628354057;434;209;1028;1038;9.80;0.60;134.33;4.27;594;9;318.00;10
437;9;628354066;437;204;1030;1039;9.60;0.59;134.48;4.28;593;9;319.00;9
439;9;628354074;439;202;1031;1039;9.46;0.58;134.53;4.31;592;9;320.00;8
443;9;628354082;443;210;1032;1039;9.34;0.57;134.38;4.32;589;9;321.00;7
443;9;628354090;443;211;1033;1039;9.24;0.57;134.38;4.33;590;9;322.00;6
445;9;628354104;445;213;1034;1039;9.15;0.56;134.93;4.35;589;9;323.00;5
447;9;628354112;447;211;1047;1051;9.06;0.56;135.02;4.35;600;9;324.00;4
450;9;628354120;450;212;1048;1051;9.05;0.56;135.21;4.35;598;9;325.00;3
453;9;628354129;453;210;1049;1051;9.05;0.56;135.47;4.39;596;9;326.00;2
454;9;628354136;454;210;1050;1051;9.06;0.56;135.41;4.39;596;9;327.00;1
457;9;628354144;457;212;1050;1051;9.16;0.56;135.30;4.39;593;9;328.00;1
460;9;628354151;460;219;1051;1051;9.26;0.57;135.67;4.39;591;9;329.00;0
461;9;628354160;461;221;1055;1055;9.21;0.56;135.72;4.38;594;9;330.00;0
462;9;628354167;462;220;1055;1055;9.19;0.56;135.86;4.38;593;9;331.00;0
464;9;628354174;464;221;1058;1059;9.11;0.56;135.69;4.37;594;9;332.00;1
467;9;628354181;467;224;1060;1060;8.96;0.55;136.93;4.36;593;9;333.00;0
467;9;628354188;467;222;1060;1060;8.89;0.55;136.93;4.36;593;9;334.00;0
471;9;628354195;471;220;1060;1060;8.74;0.54;137.73;4.36;589;9;335.00;0
476;9;628354203;476;225;1071;1073;8.59;0.53;137.93;4.32;595;9;336.00;2
480;9;628354211;480;229;1071;1073;8.41;0.52;139.56;4.32;591;9;337.00;2
485;9;628354219;485;233;1073;1073;8.22;0.50;139.76;4.31;588;9;338.00;0
489;9;628354225;489;239;1074;1074;8.01;0.49;140.35;4.31;585;9;339.00;0
494;9;628354232;494;232;1075;1075;7.83;0.48;141.06;4.31;581;9;340.00;0
496;9;628354239;496;230;1075;1075;7.65;0.47;141.37;4.31;579;9;341.00;0
497;9;628354246;497;228;1077;1078;7.61;0.47;141.77;4.30;580;9;342.00;1
500;9;628354252;500;227;1077;1078;7.48;0.46;142.01;4.30;577;9;343.00;1
502;9;628354258;502;230;1078;1078;7.46;0.46;142.80;4.30;576;9;344.00;0
505;9;628354264;505;233;1078;1078;7.45;0.46;143.39;4.30;573;9;345.00;0
510;9;628354271;510;235;1083;1084;7.49;0.46;143.73;4.28;573;9;346.00;1
514;9;628354278;514;225;1084;1084;7.48;0.46;144.55;4.28;570;9;347.00;0
516;9;628354286;516;216;1084;1084;7.61;0.47;144.67;4.28;568;9;348.00;0
520;9;628354293;520;219;1084;1084;7.60;0.47;145.35;4.28;564;9;349.00;0
526;9;628354300;526;219;1088;1088;7.58;0.47;145.70;4.27;562;9;350.00;0
528;9;628354307;528;215;1089;1089;7.61;0.47;146.06;4.26;561;9;351.00;0
532;9;628354315;532;217;1089;1089;7.58;0.47;145.70;4.26;557;9;352.00;0
533;9;628354321;533;217;1090;1090;7.62;0.47;145.72;4.26;557;9;353.00;0
539;9;628354328;539;218;1090;1090;7.61;0.47;145.54;4.26;551;9;354.00;0
544;9;628354335;544;219;1090;1090;7.56;0.46;144.98;4.26;546;9;355.00;0
547;9;628354342;547;218;1090;1090;7.52;0.46;144.92;4.26;543;9;356.00;0
549;9;628354348;549;222;1090;1090;7.55;0.46;144.70;4.26;541;9;357.00;0
550;9;628354354;550;220;1090;1090;7.56;0.46;144.56;4.26;540;9;358.00;0
551;9;628354361;551;221;1090;1090;7.53;0.46;144.43;4.26;539;9;359.00;0
554;9;628354369;554;241;1159;1215;7.87;0.49;144.23;4.01;605;9;360.00;56
554;9;628354385;554;240;1168;1216;7.87;0.49;144.23;3.98;614;9;361.00;48
556;9;628354393;556;234;1180;1216;7.95;0.49;144.36;3.96;624;9;362.00;36
558;9;628354401;558;235;1187;1216;7.95;0.49;144.20;3.96;629;9;363.00;29
558;9;628354409;558;237;1191;1216;7.93;0.49;144.20;3.96;633;9;364.00;25
560;9;628354416;560;237;1195;1216;7.87;0.49;144.13;3.96;635;9;365.00;21
561;9;628354424;561;239;1200;1216;7.89;0.49;144.27;3.97;639;9;366.00;16
561;9;628354431;561;245;1202;1216;7.81;0.48;144.27;3.98;641;9;367.00;14
563;9;628354439;563;253;1205;1217;7.78;0.48;144.29;3.98;642;9;368.00;12
564;9;628354447;564;254;1208;1218;7.70;0.48;144.10;3.99;644;9;369.00;10
567;9;628354455;567;257;1210;1218;7.60;0.47;144.08;4.00;643;9;370.00;8
568;9;628354463;568;246;1215;1222;7.55;0.47;144.16;4.00;647;9;371.00;7
570;9;628354478;570;240;1218;1222;7.48;0.46;144.18;4.01;648;9;372.00;4
571;9;628354486;571;239;1218;1222;7.49;0.46;143.96;4.01;647;9;373.00;4
573;9;628354494;573;233;1219;1222;7.58;0.47;143.82;4.02;646;9;374.00;3
574;9;628354503;574;227;1224;1228;7.65;0.47;143.93;4.02;650;9;375.00;4
575;9;628354512;575;223;1226;1228;7.78;0.48;144.08;4.03;651;9;376.00;2
575;9;628354521;575;225;1226;1228;7.88;0.48;144.08;4.03;651;9;377.00;2
578;9;628354536;578;219;1228;1231;8.02;0.49;143.72;4.02;650;9;378.00;3
581;9;628354552;581;218;1230;1231;8.10;0.49;144.15;4.03;649;9;379.00;1
582;9;628354561;582;214;1231;1231;8.24;0.50;144.06;4.03;649;9;380.00;0
582;9;628354570;582;213;1232;1232;8.33;0.51;144.06;4.03;650;9;381.00;0
584;9;628354579;584;212;1233;1233;8.41;0.51;144.34;4.03;649;9;382.00;0
585;9;628354589;585;217;1233;1233;8.50;0.52;144.13;4.03;648;9;383.00;0
586;9;628354599;586;220;1246;1246;8.64;0.53;143.92;3.98;660;9;384.00;0
587;9;628354608;587;215;1246;1246;8.68;0.53;144.03;3.98;659;9;385.00;0
589;10;628354624;589;213;1246;1246;8.75;0.53;143.62;3.98;657;10;386.00;0
590;10;628354653;590;200;1247;1247;8.90;0.54;143.65;3.98;657;10;387.00;0
592;10;628354669;592;194;1247;1247;9.01;0.55;143.38;3.98;655;10;388.00;0
592;10;628354679;592;184;1250;1251;9.16;0.56;143.38;3.97;658;10;389.00;1
595;10;628354692;595;178;1250;1251;9.29;0.57;143.66;3.97;655;10;390.00;1
595;11;628354702;595;173;1255;1255;9.43;0.57;143.66;3.96;660;11;391.00;0
600;11;628354723;600;172;1255;1255;9.56;0.58;144.52;3.96;655;11;392.00;0
603;11;628354734;603;169;1255;1255;9.66;0.59;144.79;3.96;652;11;393.00;0
604;11;628354744;604;171;1255;1255;9.73;0.59;145.19;3.96;651;11;394.00;0
605;11;628354754;605;171;1255;1255;9.74;0.59;145.30;3.96;650;11;395.00;0
609;11;628354772;609;157;1266;1267;9.89;0.60;145.59;3.93;657;11;396.00;1
612;11;628354786;612;148;1267;1267;10.06;0.61;145.99;3.93;655;11;397.00;0
613;11;628354796;613;140;1267;1267;10.31;0.63;146.36;3.93;654;11;398.00;0
617;12;628354807;617;124;1267;1267;10.57;0.64;146.46;3.93;650;12;399.00;0
618;12;628354827;618;118;1267;1267;10.83;0.66;146.37;3.93;649;12;400.00;0
625;12;628354844;625;116;1267;1267;10.98;0.67;147.85;3.93;642;12;401.00;0
625;12;628354855;625;113;1268;1268;11.15;0.68;147.85;3.92;643;12;402.00;0
628;12;628354866;628;110;1268;1268;11.24;0.68;148.33;3.92;640;12;403.00;0
630;12;628354876;630;107;1273;1274;11.31;0.69;149.03;3.91;643;12;404.00;1
633;12;628354888;633;101;1275;1276;11.48;0.70;149.33;3.91;642;12;405.00;1
634;12;628354901;634;98;1276;1276;11.68;0.71;149.73;3.91;642;12;406.00;0
639;12;628354916;639;95;1276;1276;11.82;0.72;150.77;3.91;637;12;407.00;0
640;12;628354927;640;98;1280;1280;11.99;0.73;150.82;3.89;640;12;408.00;0
643;12;628354938;643;96;1280;1280;12.03;0.73;151.44;3.89;637;12;409.00;0
644;12;628354948;644;97;1280;1280;12.10;0.74;151.84;3.89;636;12;410.00;0
646;12;628354959;646;99;1281;1281;12.20;0.74;152.24;3.89;635;12;411.00;0
648;12;628354972;648;102;1285;1285;12.27;0.75;152.79;3.88;637;12;412.00;0
651;12;628354983;651;102;1285;1285;12.41;0.76;153.24;3.88;634;12;413.00;0
653;12;628354993;653;102;1287;1288;12.51;0.76;153.55;3.88;634;12;414.00;1
656;12;628355004;656;102;1287;1288;12.59;0.77;153.72;3.88;631;12;415.00;1
657;12;628355020;657;100;1288;1288;12.67;0.77;154.05;3.88;631;12;416.00;0
661;12;628355029;661;100;1288;1288;12.74;0.78;154.77;3.88;627;12;417.00;0
664;12;628355039;664;102;1291;1292;12.76;0.78;154.93;3.87;627;12;418.00;1
666;12;628355049;666;99;1291;1292;12.79;0.78;155.40;3.87;625;12;419.00;1
673;12;628355062;673;99;1292;1292;12.75;0.78;156.11;3.87;619;12;420.00;0
676;12;628355077;676;99;1292;1292;12.78;0.78;156.75;3.87;616;12;421.00;0
681;12;628355086;681;95;1293;1293;12.73;0.78;157.18;3.87;612;12;422.00;0
683;12;628355097;683;96;1294;1294;12.72;0.78;157.68;3.86;611;12;423.00;0
689;12;628355111;689;97;1294;1294;12.66;0.77;158.58;3.86;605;12;424.00;0
692;12;628355121;692;95;1295;1295;12.66;0.77;158.74;3.86;603;12;425.00;0
695;12;628355137;695;93;1295;1295;12.68;0.77;159.27;3.86;600;12;426.00;0
698;12;628355147;698;93;1295;1295;12.72;0.77;159.44;3.86;597;12;427.00;0
702;12;628355156;702;95;1295;1295;12.71;0.77;160.13;3.86;593;12;428.00;0
705;12;628355165;705;93;1295;1295;12.71;0.77;160.16;3.86;590;12;429.00;0
708;12;628355174;708;98;1295;1295;12.69;0.77;160.54;3.86;587;12;430.00;0
710;12;628355183;710;98;1295;1295;12.60;0.77;160.63;3.86;585;12;431.00;0
711;12;628355192;711;129;1376;1422;11.78;0.73;160.74;3.64;665;12;432.00;46
713;12;628355211;713;114;1378;1423;11.84;0.73;161.02;3.63;665;12;433.00;45
716;12;628355220;716;105;1383;1423;11.98;0.74;161.34;3.63;667;12;434.00;40
719;12;628355230;719;101;1385;1423;12.11;0.74;161.51;3.62;666;12;435.00;38
724;12;628355240;724;104;1389;1423;12.24;0.75;161.86;3.63;665;12;436.00;34
729;12;628355252;729;105;1392;1423;12.24;0.75;162.08;3.63;663;12;437.00;31
732;12;628355262;732;109;1397;1423;12.24;0.75;162.31;3.64;665;12;438.00;26
735;12;628355275;735;110;1399;1423;12.29;0.75;162.75;3.64;664;12;439.00;24
737;12;628355285;737;115;1402;1424;12.40;0.76;163.18;3.65;665;12;440.00;22
738;12;628355294;738;114;1405;1425;12.43;0.76;163.27;3.66;667;12;441.00;20
743;12;628355312;743;111;1409;1425;12.43;0.76;163.16;3.68;666;12;442.00;16
745;12;628355323;745;110;1412;1426;12.37;0.76;163.18;3.69;667;12;443.00;14
749;12;628355334;749;111;1414;1426;12.37;0.76;163.22;3.70;665;12;444.00;12
751;12;628355346;751;109;1417;1426;12.22;0.75;163.35;3.72;666;12;445.00;9
752;12;628355356;752;104;1419;1426;12.21;0.75;163.39;3.73;667;12;446.00;7
756;12;628355365;756;106;1421;1430;12.15;0.74;163.81;3.74;665;12;447.00;9
758;12;628355382;758;104;1423;1430;12.10;0.74;163.89;3.75;665;12;448.00;7
763;12;628355391;763;107;1423;1430;12.06;0.73;163.69;3.75;660;12;449.00;7
766;12;628355409;766;108;1427;1436;12.06;0.73;163.78;3.74;661;12;450.00;9
768;12;628355420;768;113;1427;1436;12.02;0.73;163.91;3.74;659;12;451.00;9
769;12;628355430;769;117;1428;1436;12.06;0.73;163.82;3.74;659;12;452.00;8
770;12;628355440;770;119;1431;1440;12.05;0.73;163.73;3.74;661;12;453.00;9
772;12;628355450;772;116;1433;1441;12.11;0.74;163.72;3.73;661;12;454.00;8
773;12;628355460;773;116;1433;1441;12.21;0.74;163.74;3.73;660;12;455.00;8
777;12;628355471;777;121;1436;1445;12.32;0.75;163.78;3.73;659;12;456.00;9
779;12;628355482;779;124;1438;1445;12.35;0.75;164.19;3.75;659;12;457.00;7
781;12;628355492;781;126;1438;1445;12.45;0.76;164.24;3.75;657;12;458.00;7
782;12;628355502;782;126;1439;1446;12.51;0.76;164.40;3.74;657;12;459.00;7
782;12;628355512;782;125;1442;1446;12.45;0.76;164.40;3.79;660;12;460.00;4
783;12;628355522;783;127;1445;1452;12.38;0.76;164.58;3.78;662;12;461.00;7
785;12;628355538;785;129;1446;1452;12.15;0.74;164.52;3.78;661;12;462.00;6
788;12;628355548;788;131;1448;1453;12.01;0.73;164.54;3.80;660;12;463.00;5
792;12;628355558;792;136;1448;1453;11.87;0.72;164.56;3.80;656;12;464.00;5
794;12;628355568;794;137;1448;1453;11.70;0.71;164.53;3.80;654;12;465.00;5
795;12;628355578;795;144;1449;1453;11.45;0.70;164.55;3.80;654;12;466.00;4
797;12;628355587;797;147;1449;1453;11.39;0.69;164.49;3.80;652;12;467.00;4
800;12;628355598;800;152;1459;1465;11.40;0.69;164.27;3.77;659;12;468.00;6
800;12;628355608;800;151;1460;1465;11.43;0.70;164.27;3.78;660;12;469.00;5
804;12;628355617;804;156;1462;1465;11.43;0.70;164.46;3.79;658;12;470.00;3
807;12;628355626;807;160;1462;1465;11.36;0.69;164.64;3.79;655;12;471.00;3
808;13;628355636;808;164;1463;1465;11.31;0.69;164.58;3.79;655;13;472.00;2
811;13;628355665;811;171;1463;1465;11.24;0.69;164.81;3.79;652;13;473.00;2
813;13;628355685;813;181;1467;1469;11.09;0.68;164.69;3.79;654;13;474.00;2
815;13;628355707;815;180;1468;1469;10.97;0.67;164.56;3.80;653;13;475.00;1
818;13;628355722;818;190;1472;1473;10.91;0.67;164.70;3.79;654;13;476.00;1
821;13;628355738;821;189;1473;1474;10.82;0.66;164.79;3.79;652;13;477.00;1
821;13;628355751;821;195;1474;1474;10.76;0.66;164.79;3.79;653;13;478.00;0
825;13;628355774;825;198;1474;1474;10.57;0.64;164.39;3.79;649;13;479.00;0
829;13;628355789;829;208;1494;1500;10.34;0.63;164.32;3.74;665;13;480.00;6
829;13;628355800;829;207;1496;1500;10.20;0.62;164.32;3.73;667;13;481.00;4
829;13;628355810;829;212;1498;1500;10.14;0.62;164.32;3.73;669;13;482.00;2
831;13;628355819;831;222;1501;1501;10.10;0.62;164.56;3.73;670;13;483.00;0
832;13;628355828;832;234;1502;1502;9.99;0.61;164.60;3.73;670;13;484.00;0
835;13;628355846;835;243;1502;1502;9.76;0.60;164.88;3.73;667;13;485.00;0
835;13;628355855;835;243;1504;1505;9.70;0.59;164.88;3.72;669;13;486.00;1
836;13;628355864;836;247;1505;1505;9.53;0.59;164.83;3.72;669;13;487.00;0
839;13;628355873;839;253;1505;1505;9.32;0.57;164.60;3.72;666;13;488.00;0
840;13;628355881;840;249;1505;1505;9.15;0.56;164.72;3.72;665;13;489.00;0
846;13;628355890;846;250;1510;1511;9.02;0.55;164.60;3.71;664;13;490.00;1
847;13;628355899;847;245;1510;1511;8.89;0.55;164.56;3.71;663;13;491.00;1
849;13;628355907;849;242;1511;1511;8.82;0.54;164.36;3.71;662;13;492.00;0
850;13;628355915;850;245;1511;1511;8.83;0.54;164.32;3.71;661;13;493.00;0
854;13;628355923;854;252;1515;1515;8.70;0.54;164.08;3.70;661;13;494.00;0
854;13;628355933;854;249;1517;1517;8.65;0.53;164.08;3.70;663;13;495.00;0
855;13;628355941;855;248;1517;1517;8.59;0.53;163.93;3.70;662;13;496.00;0
856;13;628355949;856;252;1518;1518;8.59;0.53;163.94;3.70;662;13;497.00;0
859;13;628355957;859;257;1518;1518;8.46;0.52;163.76;3.70;659;13;498.00;0
864;13;628355966;864;260;1518;1518;8.40;0.52;163.62;3.70;654;13;499.00;0
866;13;628355975;866;260;1518;1518;8.30;0.51;163.52;3.70;652;13;500.00;0
871;13;628355987;871;257;1518;1518;8.16;0.50;163.31;3.70;647;13;501.00;0
874;13;628355996;874;260;1518;1518;8.05;0.49;163.69;3.70;644;13;502.00;0
876;13;628356004;876;262;1518;1518;7.91;0.49;163.77;3.70;642;13;503.00;0
879;13;628356012;879;272;1557;1588;7.97;0.49;164.01;3.60;678;13;504.00;31
880;13;628356026;880;271;1561;1589;7.82;0.48;164.35;3.60;681;13;505.00;28
884;13;628356034;884;272;1569;1589;7.76;0.48;165.10;3.59;685;13;506.00;20
886;13;628356042;886;272;1574;1589;7.65;0.47;165.70;3.59;688;13;507.00;15
890;13;628356049;890;276;1579;1589;7.49;0.46;166.19;3.59;689;13;508.00;10
894;13;628356057;894;284;1582;1589;7.34;0.45;166.66;3.59;688;13;509.00;7
899;13;628356067;899;277;1586;1589;7.23;0.45;166.66;3.60;687;13;510.00;3
902;13;628356075;902;275;1587;1589;7.16;0.44;166.71;3.60;685;13;511.00;2
904;13;628356089;904;271;1588;1590;7.14;0.44;167.07;3.60;684;13;512.00;2
909;13;628356097;909;266;1591;1591;7.11;0.44;167.77;3.60;682;13;513.00;0
910;13;628356106;910;266;1591;1591;7.14;0.44;167.68;3.60;681;13;514.00;0
917;13;628356121;917;265;1595;1595;7.10;0.43;167.91;3.60;678;13;515.00;0
920;13;628356131;920;262;1595;1595;7.11;0.44;168.05;3.60;675;13;516.00;0
922;13;628356140;922;257;1595;1595;7.17;0.44;168.31;3.60;673;13;517.00;0
924;13;628356149;924;252;1595;1595;7.24;0.44;168.76;3.60;671;13;518.00;0
926;13;628356157;926;248;1600;1601;7.39;0.45;169.03;3.59;674;13;519.00;1
929;13;628356166;929;249;1600;1601;7.45;0.46;169.46;3.59;671;13;520.00;1
931;13;628356174;931;247;1601;1601;7.55;0.46;169.82;3.59;670;13;521.00;0
933;13;628356182;933;252;1603;1604;7.60;0.47;170.35;3.58;670;13;522.00;1
936;13;628356191;936;233;1604;1604;7.65;0.47;170.56;3.58;668;13;523.00;0
942;13;628356199;942;221;1604;1604;7.65;0.47;171.28;3.58;662;13;524.00;0
945;13;628356207;945;216;1605;1605;7.67;0.47;171.86;3.58;660;13;525.00;0
949;13;628356216;949;208;1606;1606;7.72;0.47;171.95;3.58;657;13;526.00;0
955;13;628356225;955;207;1606;1606;7.77;0.47;171.89;3.58;651;13;527.00;0
955;13;628356234;955;201;1619;1619;8.03;0.49;171.89;3.55;664;13;528.00;0
961;13;628356244;961;201;1619;1619;8.09;0.49;172.22;3.55;658;13;529.00;0
967;13;628356268;967;193;1619;1619;8.13;0.50;172.41;3.55;652;13;530.00;0
969;13;628356278;969;185;1620;1620;8.28;0.51;172.60;3.55;651;13;531.00;0
971;13;628356287;971;184;1620;1620;8.38;0.51;173.00;3.55;649;13;532.00;0
975;13;628356296;975;183;1623;1624;8.49;0.52;173.57;3.54;648;13;533.00;1
976;13;628356306;976;173;1623;1624;8.57;0.52;173.72;3.54;647;13;534.00;1
980;13;628356316;980;173;1628;1628;8.63;0.53;173.94;3.54;648;13;535.00;0
987;13;628356325;987;170;1628;1628;8.64;0.53;174.17;3.54;641;13;536.00;0
989;13;628356334;989;169;1628;1628;8.69;0.53;174.10;3.54;639;13;537.00;0
995;13;628356344;995;171;1628;1628;8.69;0.53;174.35;3.54;633;13;538.00;0
1000;13;628356353;1000;172;1628;1628;8.71;0.53;174.35;3.54;628;13;539.00;0
1005;13;628356364;1005;176;1658;1662;8.90;0.54;174.11;3.47;653;13;540.00;4
1007;13;628356376;1007;176;1658;1662;9.00;0.55;174.20;3.47;651;13;541.00;4
1008;13;628356385;1008;176;1659;1662;9.10;0.56;174.09;3.47;651;13;542.00;3
1010;13;628356395;1010;172;1659;1662;9.22;0.56;174.02;3.47;649;13;543.00;3
1012;13;628356405;1012;171;1660;1662;9.28;0.57;174.28;3.47;648;13;544.00;2
1015;13;628356414;1015;165;1660;1662;9.31;0.57;174.11;3.47;645;13;545.00;2
1017;13;628356424;1017;171;1662;1663;9.34;0.57;174.13;3.47;645;13;546.00;1
1018;13;628356434;1018;169;1662;1663;9.38;0.57;174.22;3.47;644;13;547.00;1
1019;13;628356444;1019;171;1667;1669;9.42;0.57;174.29;3.47;648;13;548.00;2
1021;13;628356455;1021;175;1668;1670;9.44;0.58;174.29;3.47;647;13;549.00;2
1023;13;628356472;1023;177;1669;1670;9.43;0.57;174.39;3.47;646;13;550.00;1
1027;13;628356482;1027;183;1669;1670;9.40;0.57;174.48;3.47;642;13;551.00;1
1029;13;628356491;1029;187;1674;1674;9.41;0.57;174.60;3.46;645;13;552.00;0
1032;13;628356502;1032;186;1674;1674;9.43;0.57;174.83;3.46;642;13;553.00;0
1034;13;628356511;1034;190;1674;1674;9.48;0.58;175.09;3.46;640;13;554.00;0
1036;13;628356521;1036;187;1675;1675;9.55;0.58;175.43;3.46;639;13;555.00;0
1040;13;628356531;1040;187;1679;1679;9.64;0.59;175.95;3.45;639;13;556.00;0
1042;13;628356540;1042;173;1679;1679;9.75;0.59;176.20;3.45;637;13;557.00;0
1044;13;628356550;1044;162;1681;1682;9.93;0.60;176.33;3.45;637;13;558.00;1
1044;13;628356560;1044;156;1681;1682;10.06;0.61;176.33;3.45;637;13;559.00;1
1046;13;628356569;1046;154;1682;1682;10.17;0.62;176.54;3.45;636;13;560.00;0
1050;13;628356579;1050;150;1682;1682;10.18;0.62;176.84;3.45;632;13;561.00;0
1052;13;628356590;1052;155;1685;1686;10.30;0.63;176.71;3.44;633;13;562.00;1
1056;13;628356601;1056;156;1685;1686;10.45;0.64;177.34;3.44;629;13;563.00;1
1062;13;628356618;1062;153;1686;1686;10.55;0.64;177.88;3.44;624;13;564.00;0
1064;13;628356629;1064;152;1686;1686;10.69;0.65;178.00;3.44;622;13;565.00;0
1069;13;628356640;1069;136;1687;1687;10.82;0.66;178.53;3.44;618;13;566.00;0
1072;14;628356651;1072;123;1688;1688;10.96;0.66;178.83;3.44;616;14;567.00;0
1073;14;628356688;1073;113;1688;1688;11.11;0.67;178.76;3.44;615;14;568.00;0
1076;14;628356699;1076;107;1689;1689;11.24;0.68;179.42;3.44;613;14;569.00;0
1078;14;628356711;1078;106;1689;1689;11.35;0.69;179.56;3.44;611;14;570.00;0
1081;14;628356723;1081;97;1689;1689;11.43;0.69;180.02;3.44;608;14;571.00;0
1084;14;628356734;1084;94;1689;1689;11.54;0.70;180.38;3.44;605;14;572.00;0
1086;14;628356746;1086;94;1689;1689;11.69;0.71;180.72;3.44;603;14;573.00;0
1088;14;628356757;1088;89;1689;1689;11.87;0.72;180.75;3.44;601;14;574.00;0
1092;14;628356768;1092;88;1689;1689;11.99;0.73;181.16;3.44;597;14;575.00;0
1097;14;628356779;1097;115;1771;1816;11.72;0.72;181.30;3.28;674;14;576.00;45
1099;14;628356802;1099;102;1774;1817;11.84;0.73;181.22;3.28;675;14;577.00;43
1101;14;628356814;1101;88;1782;1817;12.09;0.74;181.56;3.27;681;14;578.00;35
1105;14;628356825;1105;81;1786;1817;12.22;0.75;181.62;3.27;681;14;579.00;31
1106;14;628356837;1106;80;1791;1817;12.31;0.76;181.76;3.27;685;14;580.00;26
1107;14;628356848;1107;74;1793;1817;12.32;0.76;181.97;3.27;686;14;581.00;24
1112;14;628356859;1112;79;1798;1817;12.32;0.76;182.49;3.28;686;14;582.00;19
1114;14;628356871;1114;83;1800;1817;12.31;0.75;182.62;3.28;686;14;583.00;17
1118;14;628356881;1118;87;1803;1818;12.24;0.75;182.93;3.29;685;14;584.00;15
1119;14;628356892;1119;91;1807;1820;12.19;0.75;183.14;3.30;688;14;585.00;13
1122;14;628356902;1122;97;1811;1820;12.15;0.74;183.38;3.31;689;14;586.00;9
1123;14;628356918;1123;103;1813;1821;12.19;0.75;183.38;3.31;690;14;587.00;8
1128;14;628356928;1128;110;1814;1821;12.21;0.75;183.52;3.32;686;14;588.00;7
1133;14;628356939;1133;116;1815;1821;12.26;0.75;183.63;3.32;682;14;589.00;6
1135;14;628356949;1135;113;1817;1821;12.31;0.76;183.74;3.34;682;14;590.00;4
1139;14;628356960;1139;114;1820;1825;12.34;0.76;184.33;3.34;681;14;591.00;5
1141;14;628356972;1141;116;1821;1825;12.37;0.76;184.59;3.35;680;14;592.00;4
1141;14;628356982;1141;116;1822;1825;12.45;0.76;184.59;3.35;681;14;593.00;3
1146;14;628356992;1146;118;1825;1828;12.52;0.77;185.02;3.35;679;14;594.00;3
1150;14;628357003;1150;118;1825;1828;12.57;0.77;185.34;3.35;675;14;595.00;3
1150;14;628357014;1150;122;1826;1828;12.65;0.77;185.34;3.35;676;14;596.00;2
1156;14;628357025;1156;124;1830;1832;12.58;0.77;185.30;3.35;674;14;597.00;2
1159;14;628357036;1159;126;1832;1833;12.63;0.77;185.47;3.35;673;14;598.00;1
1162;14;628357047;1162;125;1832;1833;12.63;0.77;185.46;3.35;670;14;599.00;1
1165;14;628357060;1165;134;1844;1859;12.57;0.77;185.79;3.33;679;14;600.00;15
1169;14;628357078;1169;130;1845;1859;12.55;0.77;185.55;3.33;676;14;601.00;14
1174;15;628357088;1174;131;1845;1859;12.59;0.77;185.77;3.33;671;15;602.00;14
1180;15;628357115;1180;134;1847;1860;12.62;0.77;185.88;3.33;667;15;603.00;13
1184;15;628357125;1184;133;1848;1860;12.56;0.76;186.03;3.33;664;15;604.00;12
1189;15;628357141;1189;130;1852;1866;12.49;0.76;185.98;3.32;663;15;605.00;14
1194;15;628357151;1194;131;1853;1866;12.43;0.75;185.84;3.33;659;15;606.00;13
1197;15;628357161;1197;134;1855;1867;12.40;0.75;185.99;3.33;658;15;607.00;12
1200;15;628357171;1200;134;1855;1867;12.36;0.75;186.63;3.33;655;15;608.00;12
1204;15;628357180;1204;131;1856;1867;12.37;0.75;186.85;3.33;652;15;609.00;11
1205;15;628357190;1205;125;1857;1867;12.40;0.75;186.82;3.33;652;15;610.00;10
1207;15;628357204;1207;124;1858;1867;12.42;0.75;186.80;3.33;651;15;611.00;9
1211;15;628357213;1211;120;1867;1879;12.39;0.75;187.40;3.32;656;15;612.00;12
1217;15;628357228;1217;115;1867;1879;12.40;0.75;187.47;3.32;650;15;613.00;12
1220;15;628357243;1220;109;1868;1879;12.47;0.76;187.63;3.32;648;15;614.00;11
1224;15;628357253;1224;104;1871;1879;12.46;0.75;188.09;3.33;647;15;615.00;8
1225;15;628357262;1225;101;1871;1879;12.59;0.76;188.04;3.33;646;15;616.00;8
1228;15;628357271;1228;92;1871;1879;12.69;0.77;188.03;3.33;643;15;617.00;8
1231;15;628357280;1231;90;1876;1883;12.79;0.78;187.89;3.33;645;15;618.00;7
1233;15;628357289;1233;85;1876;1883;12.94;0.78;187.88;3.33;643;15;619.00;7
1239;15;628357298;1239;82;1879;1887;13.03;0.79;187.74;3.33;640;15;620.00;8
1242;15;628357307;1242;79;1880;1888;13.12;0.79;187.84;3.33;638;15;621.00;8
1246;15;628357317;1246;82;1881;1888;13.14;0.79;188.01;3.33;635;15;622.00;7
1247;15;628357326;1247;81;1881;1888;13.13;0.79;187.96;3.33;634;15;623.00;7
1250;15;628357335;1250;90;1890;1901;13.05;0.79;188.16;3.32;640;15;624.00;11
1250;15;628357346;1250;89;1890;1901;13.05;0.79;188.16;3.32;640;15;625.00;11
1253;15;628357355;1253;94;1890;1901;12.97;0.78;188.26;3.32;637;15;626.00;11
1256;15;628357364;1256;95;1891;1902;12.99;0.78;188.44;3.32;635;15;627.00;11
1258;15;628357374;1258;95;1891;1903;12.99;0.78;188.50;3.32;633;15;628.00;12
1258;15;628357383;1258;98;1892;1903;12.96;0.78;188.50;3.34;634;15;629.00;11
1259;15;628357394;1259;99;1897;1909;13.00;0.79;188.75;3.35;638;15;630.00;12
1262;15;628357405;1262;102;1898;1909;12.95;0.78;188.96;3.35;636;15;631.00;11
1262;15;628357414;1262;106;1900;1909;12.87;0.78;188.96;3.35;638;15;632.00;9
1264;15;628357424;1264;108;1900;1909;12.72;0.77;188.90;3.35;636;15;633.00;9
1264;15;628357433;1264;115;1905;1915;12.67;0.77;188.90;3.36;641;15;634.00;10
1269;15;628357442;1269;114;1905;1915;12.51;0.76;188.49;3.36;636;15;635.00;10
1269;15;628357452;1269;117;1906;1915;12.37;0.75;188.49;3.36;637;15;636.00;9
1271;15;628357461;1271;123;1906;1915;12.21;0.74;188.41;3.36;635;15;637.00;9
1274;15;628357476;1274;128;1910;1919;12.03;0.73;188.33;3.36;636;15;638.00;9
1274;15;628357485;1274;135;1913;1920;11.84;0.72;188.33;3.37;639;15;639.00;7
1274;15;628357495;1274;149;1914;1920;11.62;0.71;188.33;3.39;640;15;640.00;6
1276;15;628357503;1276;149;1915;1921;11.51;0.70;188.15;3.39;639;15;641.00;6
1278;15;628357512;1278;159;1917;1921;11.29;0.69;188.19;3.40;639;15;642.00;4
1279;15;628357521;1279;163;1917;1921;11.15;0.68;188.20;3.40;638;15;643.00;4
1280;15;628357529;1280;169;1918;1921;11.01;0.67;188.28;3.40;638;15;644.00;3
1283;15;628357538;1283;177;1918;1921;10.84;0.66;188.21;3.40;635;15;645.00;3
1284;15;628357546;1284;184;1920;1921;10.58;0.65;188.12;3.43;636;15;646.00;1
1285;15;628357554;1285;190;1920;1921;10.34;0.63;188.01;3.43;635;15;647.00;1
1287;15;628357562;1287;202;1958;1991;10.24;0.63;187.85;3.38;671;15;648.00;33
1289;15;628357576;1289;204;1964;1992;9.97;0.61;187.73;3.37;675;15;649.00;28
1290;15;628357584;1290;211;1973;1992;9.91;0.61;187.75;3.36;683;15;650.00;19
1293;15;628357592;1293;215;1976;1992;9.83;0.60;187.82;3.36;683;15;651.00;16
1293;15;628357601;1293;219;1979;1992;9.79;0.60;187.82;3.37;686;15;652.00;13
1295;15;628357609;1295;225;1984;1992;9.69;0.60;187.70;3.37;689;15;653.00;8
1298;15;628357617;1298;229;1988;1992;9.62;0.59;187.64;3.37;690;15;654.00;4
1300;15;628357625;1300;231;1990;1992;9.45;0.58;187.55;3.38;690;15;655.00;2
1301;15;628357633;1301;239;1992;1993;9.29;0.57;187.41;3.38;691;15;656.00;1
1304;15;628357641;1304;248;1994;1994;9.13;0.56;187.54;3.38;690;15;657.00;0
1305;15;628357650;1305;254;1994;1994;8.94;0.55;187.78;3.38;689;15;658.00;0
1310;15;628357658;1310;253;1998;1998;8.67;0.53;187.58;3.38;688;15;659.00;0
1312;15;628357673;1312;251;1998;1998;8.50;0.52;187.56;3.38;686;15;660.00;0
1314;15;628357688;1314;255;1998;1998;8.38;0.51;187.49;3.38;684;15;661.00;0
1317;15;628357701;1317;260;1998;1998;8.20;0.50;187.33;3.38;681;15;662.00;0
1318;15;628357720;1318;264;2003;2004;8.18;0.50;187.28;3.37;685;15;663.00;1
1319;15;628357732;1319;269;2004;2004;8.12;0.50;187.20;3.37;685;15;664.00;0
1320;15;628357744;1320;271;2004;2004;8.10;0.50;187.18;3.37;684;15;665.00;0
1322;15;628357756;1322;268;2007;2007;8.11;0.50;187.08;3.36;685;15;666.00;0
1323;15;628357770;1323;272;2007;2007;8.04;0.49;187.04;3.36;684;15;667.00;0
1324;15;628357781;1324;275;2007;2007;7.96;0.49;186.98;3.36;683;15;668.00;0
1327;15;628357790;1327;275;2008;2008;7.90;0.48;186.98;3.36;681;15;669.00;0
1327;15;628357799;1327;279;2009;2009;7.86;0.48;186.98;3.36;682;15;670.00;0
1330;15;628357808;1330;281;2009;2009;7.68;0.47;186.71;3.36;679;15;671.00;0
1331;15;628357818;1331;288;2022;2022;7.52;0.46;186.67;3.34;691;15;672.00;0
1336;15;628357828;1336;294;2022;2022;7.31;0.45;186.69;3.34;686;15;673.00;0
1338;15;628357836;1338;292;2022;2022;7.26;0.44;186.67;3.34;684;15;674.00;0
1341;15;628357844;1341;286;2024;2024;7.20;0.44;187.01;3.34;683;15;675.00;0
1343;15;628357853;1343;274;2024;2024;7.17;0.44;187.20;3.34;681;15;676.00;0
1348;15;628357862;1348;270;2027;2028;7.17;0.44;187.46;3.33;679;15;677.00;1
1351;15;628357870;1351;266;2027;2028;7.11;0.43;187.81;3.33;676;15;678.00;1
1356;15;628357879;1356;259;2032;2032;7.05;0.43;187.88;3.33;676;15;679.00;0
1357;15;628357887;1357;244;2032;2032;7.11;0.43;187.92;3.33;675;15;680.00;0
1360;15;628357895;1360;236;2032;2032;7.18;0.44;187.89;3.33;672;15;681.00;0
1363;15;628357910;1363;219;2032;2032;7.34;0.45;187.89;3.33;669;15;682.00;0
1365;15;628357918;1365;209;2032;2032;7.40;0.45;188.19;3.33;667;15;683.00;0
1368;15;628357926;1368;207;2043;2044;7.64;0.47;188.26;3.31;675;15;684.00;1
1369;15;628357945;1369;205;2044;2044;7.83;0.48;188.47;3.31;675;15;685.00;0
1371;15;628357953;1371;200;2044;2044;7.96;0.49;188.56;3.31;673;15;686.00;0
1374;15;628357972;1374;191;2044;2044;8.10;0.50;188.88;3.31;670;15;687.00;0
1376;15;628357981;1376;184;2044;2044;8.23;0.50;189.07;3.31;668;15;688.00;0
1380;15;628357989;1380;178;2044;2044;8.38;0.51;189.53;3.31;664;15;689.00;0
1381;15;628358000;1381;173;2045;2045;8.61;0.53;189.64;3.31;664;15;690.00;0
1385;15;628358010;1385;169;2045;2045;8.75;0.54;190.09;3.31;660;15;691.00;0
1388;15;628358019;1388;167;2050;2051;8.95;0.55;190.44;3.30;662;15;692.00;1
1388;15;628358028;1388;167;2052;2052;9.16;0.56;190.44;3.30;664;15;693.00;0
1390;15;628358037;1390;165;2052;2052;9.28;0.57;190.73;3.30;662;15;694.00;0
1393;15;628358047;1393;161;2052;2052;9.40;0.58;190.86;3.30;659;15;695.00;0
1396;15;628358056;1396;152;2056;2056;9.45;0.58;191.07;3.29;660;15;696.00;0
1402;15;628358065;1402;150;2056;2056;9.43;0.58;190.90;3.29;654;15;697.00;0
1406;15;628358074;1406;149;2056;2056;9.48;0.58;190.95;3.29;650;15;698.00;0
1412;15;628358083;1412;145;2057;2057;9.47;0.58;191.13;3.29;645;15;699.00;0
1414;15;628358094;1414;145;2061;2061;9.60;0.59;191.14;3.29;647;15;700.00;0
1422;15;628358107;1422;137;2061;2061;9.58;0.59;191.27;3.29;639;15;701.00;0
1429;15;628358117;1429;136;2063;2064;9.62;0.59;191.25;3.29;634;15;702.00;1
1432;15;628358126;1432;128;2063;2064;9.68;0.59;191.04;3.29;631;15;703.00;1
1439;15;628358136;1439;125;2064;2064;9.70;0.59;191.29;3.28;625;15;704.00;0
1441;15;628358147;1441;126;2064;2064;9.67;0.59;191.34;3.28;623;15;705.00;0
1445;15;628358156;1445;126;2067;2068;9.73;0.60;191.53;3.28;622;15;706.00;1
1452;15;628358165;1452;123;2067;2068;9.67;0.59;191.71;3.28;615;15;707.00;1
1455;15;628358174;1455;122;2068;2068;9.72;0.60;191.79;3.28;613;15;708.00;0
1462;15;628358183;1462;121;2068;2068;9.73;0.60;191.90;3.28;606;15;709.00;0
1471;15;628358193;1471;122;2069;2069;9.69;0.59;192.10;3.28;598;15;710.00;0
1475;15;628358204;1475;125;2070;2070;9.74;0.59;192.26;3.28;595;15;711.00;0
1481;15;628358214;1481;124;2070;2070;9.76;0.59;192.67;3.28;589;15;712.00;0
1486;15;628358223;1486;129;2071;2071;9.84;0.60;192.78;3.28;585;15;713.00;0
1491;15;628358232;1491;130;2071;2071;9.95;0.60;192.86;3.28;580;15;714.00;0
1495;15;628358241;1495;132;2071;2071;10.03;0.61;193.30;3.28;576;15;715.00;0
1498;15;628358250;1498;130;2071;2071;10.13;0.61;193.07;3.28;573;15;716.00;0
1500;15;628358260;1500;130;2071;2071;10.18;0.62;193.41;3.28;571;15;717.00;0
1502;15;628358269;1502;133;2071;2071;10.17;0.62;193.64;3.28;569;15;718.00;0
1503;15;628358278;1503;134;2071;2071;10.17;0.62;193.54;3.28;568;15;719.00;0
1508;15;628358289;1508;183;2198;2301;9.94;0.62;194.00;3.09;690;15;720.00;103
1513;15;628358317;1513;180;2209;2302;9.94;0.62;194.25;3.08;696;15;721.00;93
1516;15;628358328;1516;164;2219;2302;10.03;0.63;194.22;3.07;703;15;722.00;83
1519;15;628358338;1519;161;2226;2302;10.01;0.62;194.45;3.07;707;15;723.00;76
1522;15;628358348;1522;159;2231;2302;10.00;0.62;194.61;3.08;709;15;724.00;71
1522;15;628358358;1522;164;2237;2302;9.97;0.62;194.61;3.08;715;15;725.00;65
1525;15;628358369;1525;163;2242;2302;9.95;0.62;194.84;3.09;717;15;726.00;60
1527;15;628358380;1527;150;2247;2302;9.93;0.62;194.93;3.10;720;15;727.00;55
1529;15;628358392;1529;149;2251;2303;9.94;0.62;195.00;3.11;722;15;728.00;52
1530;15;628358417;1530;146;2257;2304;9.88;0.61;195.12;3.12;727;15;729.00;47
1532;15;628358429;1532;152;2261;2304;9.88;0.61;195.19;3.13;729;15;730.00;43
1535;15;628358448;1535;157;2269;2305;9.80;0.61;195.50;3.16;734;15;731.00;36
1538;15;628358460;1538;152;2271;2305;9.76;0.60;195.60;3.16;733;15;732.00;34
1540;15;628358473;1540;159;2275;2305;9.71;0.60;195.58;3.18;735;15;733.00;30
1541;15;628358485;1541;171;2278;2305;9.68;0.60;195.67;3.20;737;15;734.00;27
1542;15;628358497;1542;169;2282;2309;9.76;0.60;195.83;3.20;740;15;735.00;27
1545;15;628358510;1545;159;2283;2309;9.86;0.61;195.92;3.21;738;15;736.00;26
1550;15;628358523;1550;157;2286;2309;9.92;0.61;196.01;3.22;736;15;737.00;23
1551;15;628358536;1551;150;2288;2312;10.07;0.62;196.08;3.23;737;15;738.00;24
1557;15;628358549;1557;149;2288;2312;10.21;0.63;196.44;3.23;731;15;739.00;24
1563;15;628358562;1563;148;2289;2312;10.33;0.64;196.38;3.24;726;15;740.00;23
1563;15;628358582;1563;145;2295;2316;10.53;0.65;196.38;3.25;732;15;741.00;21
1567;15;628358597;1567;143;2296;2317;10.82;0.67;196.83;3.25;729;15;742.00;21
1570;15;628358610;1570;146;2297;2317;11.06;0.68;196.97;3.26;727;15;743.00;20
1572;15;628358623;1572;147;2302;2321;11.21;0.69;197.02;3.27;730;15;744.00;19
1575;15;628358636;1575;145;2304;2321;11.30;0.69;197.14;3.29;729;15;745.00;17
1577;15;628358657;1577;143;2306;2321;11.40;0.70;197.35;3.30;729;15;746.00;15
1582;15;628358672;1582;146;2307;2322;11.48;0.70;197.70;3.30;725;15;747.00;15
1583;15;628358684;1583;142;2308;2322;11.62;0.71;197.86;3.30;725;15;748.00;14
1588;15;628358697;1588;149;2313;2328;11.69;0.71;198.16;3.30;725;15;749.00;15
1590;15;628358712;1590;152;2313;2328;11.76;0.72;198.30;3.30;723;15;750.00;15
1591;15;628358723;1591;153;2316;2329;11.78;0.72;198.33;3.31;725;15;751.00;13
1594;15;628358734;1594;151;2318;2329;11.83;0.72;198.60;3.31;724;15;752.00;11
1597;15;628358746;1597;155;2318;2329;11.86;0.72;198.97;3.31;721;15;753.00;11
1600;15;628358757;1600;153;2318;2329;11.94;0.73;199.01;3.31;718;15;754.00;11
1605;16;628358767;1605;155;2318;2329;11.99;0.73;199.08;3.31;713;16;755.00;11
1608;16;628358795;1608;152;2330;2341;11.96;0.73;199.23;3.29;722;16;756.00;11
1608;16;628358807;1608;151;2330;2341;12.01;0.73;199.23;3.29;722;16;757.00;11
1613;16;628358822;1613;149;2330;2341;12.07;0.73;199.73;3.29;717;16;758.00;11
1616;16;628358833;1616;149;2330;2341;12.06;0.73;199.92;3.29;714;16;759.00;11
1620;16;628358845;1620;149;2330;2341;12.10;0.74;199.86;3.29;710;16;760.00;11
1626;16;628358856;1626;154;2330;2341;12.08;0.73;199.92;3.29;704;16;761.00;11
1631;16;628358867;1631;154;2334;2345;12.01;0.73;199.87;3.29;703;16;762.00;11
1632;16;628358878;1632;154;2334;2345;12.07;0.73;199.95;3.29;702;16;763.00;11
1634;16;628358889;1634;155;2337;2349;12.13;0.74;200.00;3.28;703;16;764.00;12
1637;16;628358901;1637;159;2340;2351;12.10;0.74;200.05;3.30;703;16;765.00;11
1639;16;628358919;1639;159;2341;2351;12.06;0.73;200.23;3.30;702;16;766.00;10
1642;16;628358933;1642;163;2341;2351;12.04;0.73;200.13;3.30;699;16;767.00;10
1644;16;628358950;1644;167;2351;2364;12.00;0.73;200.26;3.28;707;16;768.00;13
1647;16;628358961;1647;167;2351;2364;11.98;0.73;200.19;3.28;704;16;769.00;13
1649;16;628358972;1649;166;2352;2364;12.00;0.73;200.15;3.28;703;16;770.00;12
1652;16;628358987;1652;169;2353;2365;11.98;0.73;200.52;3.28;701;16;771.00;12
1656;16;628358996;1656;164;2354;2366;11.94;0.73;200.64;3.28;698;16;772.00;12
1660;16;628359007;1660;166;2354;2366;11.93;0.73;200.53;3.28;694;16;773.00;12
1663;16;628359017;1663;168;2356;2369;11.93;0.73;200.54;3.28;693;16;774.00;13
1667;16;628359026;1667;169;2356;2369;11.95;0.73;200.51;3.28;689;16;775.00;13
1670;16;628359037;1670;166;2357;2369;11.83;0.72;200.63;3.28;687;16;776.00;12
1672;16;628359046;1672;168;2357;2369;11.89;0.73;200.57;3.28;685;16;777.00;12
1676;16;628359055;1676;170;2361;2375;11.87;0.72;200.52;3.27;685;16;778.00;14
1678;16;628359066;1678;167;2361;2375;11.88;0.73;200.52;3.27;683;16;779.00;14
1681;16;628359082;1681;164;2362;2375;11.83;0.72;200.47;3.27;681;16;780.00;13
1683;16;628359091;1683;161;2363;2375;11.76;0.72;200.65;3.30;680;16;781.00;12
1687;16;628359101;1687;158;2366;2379;11.70;0.72;200.62;3.30;679;16;782.00;13
1689;16;628359111;1689;154;2367;2380;11.69;0.71;200.76;3.29;678;16;783.00;13
1693;16;628359120;1693;144;2367;2380;11.68;0.71;200.81;3.29;674;16;784.00;13
1699;16;628359129;1699;143;2370;2381;11.67;0.71;201.08;3.30;671;16;785.00;11
1700;16;628359139;1700;137;2370;2381;11.69;0.71;201.00;3.30;670;16;786.00;11
1703;16;628359148;1703;140;2370;2381;11.65;0.71;201.11;3.30;667;16;787.00;11
1704;16;628359157;1704;132;2370;2381;11.70;0.71;201.03;3.30;666;16;788.00;11
1708;17;628359166;1708;130;2371;2381;11.69;0.71;200.95;3.32;663;17;789.00;10
1708;17;628359183;1708;129;2371;2381;11.80;0.72;200.95;3.32;663;17;790.00;10
1712;17;628359192;1712;126;2371;2381;11.89;0.72;200.98;3.32;659;17;791.00;10
1717;17;628359202;1717;131;2405;2451;11.83;0.72;200.95;3.31;688;17;792.00;46
1717;17;628359218;1717;129;2405;2452;11.83;0.72;200.95;3.31;688;17;793.00;47
1719;17;628359228;1719;130;2413;2452;11.89;0.73;200.83;3.30;694;17;794.00;39
1721;17;628359238;1721;130;2418;2452;11.80;0.72;200.86;3.30;697;17;795.00;34
1724;17;628359254;1724;134;2424;2452;11.80;0.72;200.90;3.30;700;17;796.00;28
1725;17;628359264;1725;140;2426;2452;11.76;0.72;201.15;3.33;701;17;797.00;26
1725;17;628359274;1725;145;2429;2452;11.72;0.72;201.15;3.34;704;17;798.00;23
1728;17;628359283;1728;145;2430;2452;11.63;0.71;201.17;3.34;702;17;799.00;22
1730;17;628359293;1730;145;2435;2453;11.53;0.70;201.22;3.37;705;17;800.00;18
1736;17;628359307;1736;148;2436;2454;11.41;0.69;200.99;3.37;700;17;801.00;18
1739;17;628359318;1739;154;2439;2454;11.37;0.69;201.03;3.38;700;17;802.00;15
1741;17;628359328;1741;157;2444;2458;11.24;0.68;200.98;3.41;703;17;803.00;14
1741;17;628359339;1741;165;2445;2458;11.11;0.68;200.98;3.42;704;17;804.00;13
1744;17;628359349;1744;172;2445;2458;10.96;0.67;200.83;3.42;701;17;805.00;13
1745;17;628359360;1745;182;2446;2458;10.82;0.66;200.84;3.45;701;17;806.00;12
1749;17;628359371;1749;187;2450;2464;10.70;0.65;200.72;3.45;701;17;807.00;14
1751;18;628359382;1751;192;2452;2464;10.56;0.64;200.57;3.48;701;18;808.00;12
1753;18;628359408;1753;202;2452;2464;10.45;0.64;200.44;3.48;699;18;809.00;12
1755;18;628359421;1755;207;2456;2470;10.31;0.63;200.37;3.48;701;18;810.00;14
1758;18;628359431;1758;216;2458;2470;10.10;0.62;200.28;3.53;700;18;811.00;12
1760;18;628359441;1760;227;2462;2470;9.89;0.60;200.52;3.58;702;18;812.00;8
1765;18;628359449;1765;234;2465;2471;9.65;0.59;200.46;3.60;700;18;813.00;6
1765;18;628359459;1765;244;2467;2472;9.43;0.58;200.46;3.60;702;18;814.00;5
1765;18;628359469;1765;253;2468;2472;9.22;0.56;200.46;3.61;703;18;815.00;4
1768;19;628359477;1768;263;2480;2485;9.04;0.55;200.31;3.62;712;19;816.00;5
1770;19;628359500;1770;272;2483;2485;8.91;0.55;200.23;3.61;713;19;817.00;2
1771;19;628359509;1771;280;2483;2485;8.81;0.54;200.17;3.61;712;19;818.00;2
1774;19;628359517;1774;288;2485;2486;8.72;0.54;200.02;3.61;711;19;819.00;1
1779;19;628359526;1779;298;2486;2486;8.60;0.53;199.90;3.61;707;19;820.00;0
1779;19;628359535;1779;303;2489;2490;8.52;0.52;199.90;3.61;710;19;821.00;1
1780;19;628359544;1780;313;2490;2490;8.44;0.52;199.85;3.61;710;19;822.00;0
1782;19;628359552;1782;325;2494;2494;8.35;0.51;199.76;3.61;712;19;823.00;0
1783;19;628359560;1783;325;2494;2494;8.25;0.51;199.71;3.61;711;19;824.00;0
1787;19;628359569;1787;324;2494;2494;8.10;0.50;199.79;3.61;707;19;825.00;0
1789;19;628359577;1789;331;2494;2494;7.96;0.49;199.82;3.61;705;19;826.00;0
1791;19;628359585;1791;320;2494;2494;7.82;0.48;199.83;3.61;703;19;827.00;0
1794;19;628359593;1794;313;2505;2506;7.75;0.48;199.59;3.59;711;19;828.00;1
1798;19;628359617;1798;301;2506;2506;7.70;0.47;199.47;3.59;708;19;829.00;0
1799;19;628359625;1799;293;2506;2506;7.71;0.47;199.57;3.59;707;19;830.00;0
1800;19;628359634;1800;286;2506;2506;7.74;0.47;199.52;3.59;706;19;831.00;0
1800;19;628359642;1800;277;2506;2506;7.83;0.48;199.52;3.59;706;19;832.00;0
1802;19;628359650;1802;265;2506;2506;7.93;0.48;199.61;3.59;704;19;833.00;0
1802;19;628359666;1802;253;2507;2507;7.99;0.49;199.61;3.59;705;19;834.00;0
1803;19;628359678;1803;250;2507;2507;8.11;0.49;199.56;3.59;704;19;835.00;0
1805;19;628359694;1805;249;2512;2513;8.31;0.51;199.49;3.58;707;19;836.00;1
1806;19;628359707;1806;245;2514;2514;8.42;0.51;199.45;3.58;708;19;837.00;0
1806;19;628359734;1806;247;2514;2514;8.51;0.52;199.45;3.58;708;19;838.00;0
1806;19;628359747;1806;246;2514;2514;8.59;0.52;199.45;3.58;708;19;839.00;0
1807;20;628359762;1807;243;2519;2519;8.68;0.53;199.40;3.57;712;20;840.00;0
1810;20;628359807;1810;246;2519;2519;8.70;0.53;199.36;3.57;709;20;841.00;0
1810;20;628359817;1810;248;2519;2519;8.70;0.53;199.36;3.57;709;20;842.00;0
1813;20;628359826;1813;247;2520;2520;8.70;0.53;199.51;3.57;707;20;843.00;0
1814;20;628359836;1814;247;2524;2524;8.71;0.53;199.45;3.57;710;20;844.00;0
1817;20;628359847;1817;239;2524;2524;8.70;0.53;199.59;3.57;707;20;845.00;0
1821;20;628359857;1821;237;2526;2527;8.67;0.53;199.54;3.56;705;20;846.00;1
1823;20;628359867;1823;236;2527;2527;8.57;0.53;199.67;3.56;704;20;847.00;0
1827;20;628359876;1827;232;2527;2527;8.46;0.52;199.73;3.56;700;20;848.00;0
1829;20;628359886;1829;234;2527;2527;8.42;0.52;199.83;3.56;698;20;849.00;0
1831;20;628359895;1831;230;2530;2531;8.44;0.52;200.10;3.56;699;20;850.00;1
1833;20;628359905;1833;230;2530;2531;8.39;0.52;200.20;3.56;697;20;851.00;1
1838;20;628359914;1838;222;2531;2531;8.39;0.52;200.15;3.56;693;20;852.00;0
1844;20;628359923;1844;213;2531;2531;8.39;0.52;200.35;3.56;687;20;853.00;0
1850;20;628359933;1850;205;2532;2532;8.39;0.52;200.44;3.56;682;20;854.00;0
1855;20;628359943;1855;199;2534;2534;8.45;0.52;200.61;3.56;679;20;855.00;0
1859;20;628359959;1859;195;2534;2534;8.48;0.52;200.75;3.56;675;20;856.00;0
1861;20;628359970;1861;187;2535;2535;8.65;0.53;200.74;3.56;674;20;857.00;0
1868;20;628359980;1868;178;2535;2535;8.70;0.53;200.78;3.56;667;20;858.00;0
1873;20;628359989;1873;170;2535;2535;8.73;0.53;200.84;3.56;662;20;859.00;0
1873;20;628359999;1873;161;2535;2535;8.80;0.54;200.84;3.56;662;20;860.00;0
1878;20;628360008;1878;157;2535;2535;8.85;0.54;201.03;3.56;657;20;861.00;0
1881;20;628360018;1881;152;2535;2535;8.93;0.54;201.07;3.56;654;20;862.00;0
1886;20;628360027;1886;149;2535;2535;8.98;0.55;201.19;3.56;649;20;863.00;0
1890;20;628360037;1890;162;2614;2662;9.07;0.56;201.30;3.45;724;20;864.00;48
1895;20;628360057;1895;150;2619;2663;9.13;0.56;201.23;3.44;724;20;865.00;44
1900;20;628360068;1900;151;2625;2663;9.27;0.57;201.35;3.44;725;20;866.00;38
1905;20;628360078;1905;148;2629;2663;9.33;0.57;201.56;3.44;724;20;867.00;34
1907;20;628360089;1907;137;2632;2663;9.48;0.58;201.76;3.44;725;20;868.00;31
1911;20;628360099;1911;129;2636;2663;9.58;0.59;201.97;3.44;725;20;869.00;27
1916;20;628360112;1916;128;2641;2663;9.67;0.59;202.09;3.45;725;20;870.00;22
1919;20;628360123;1919;124;2643;2663;9.70;0.60;202.18;3.45;724;20;871.00;20
1923;20;628360134;1923;128;2646;2664;9.75;0.60;202.33;3.46;723;20;872.00;18
1924;20;628360145;1924;137;2648;2665;9.73;0.60;202.48;3.46;724;20;873.00;17
1929;20;628360156;1929;138;2652;2665;9.68;0.60;202.79;3.47;723;20;874.00;13
1932;20;628360167;1932;141;2656;2666;9.61;0.59;203.13;3.48;724;20;875.00;10
1937;20;628360178;1937;156;2658;2666;9.56;0.59;203.43;3.48;721;20;876.00;8
1941;20;628360189;1941;161;2659;2666;9.58;0.59;203.46;3.49;718;20;877.00;7
1942;20;628360200;1942;160;2660;2666;9.57;0.59;203.50;3.49;718;20;878.00;6
1950;20;628360211;1950;169;2664;2670;9.52;0.59;203.70;3.50;714;20;879.00;6
1952;20;628360223;1952;165;2665;2670;9.53;0.59;203.75;3.50;713;20;880.00;5
1954;20;628360234;1954;174;2667;2670;9.59;0.59;203.82;3.51;713;20;881.00;3
1958;20;628360246;1958;175;2669;2673;9.57;0.59;203.88;3.51;711;20;882.00;4
1962;20;628360259;1962;178;2670;2673;9.57;0.59;203.98;3.51;708;20;883.00;3
1969;20;628360270;1969;179;2671;2673;9.61;0.59;204.19;3.51;702;20;884.00;2
1972;20;628360282;1972;185;2675;2677;9.70;0.60;204.30;3.51;703;20;885.00;2
1976;20;628360292;1976;188;2677;2678;9.77;0.60;204.30;3.51;701;20;886.00;1
1981;20;628360303;1981;190;2677;2678;9.83;0.60;204.18;3.51;696;20;887.00;1
1987;20;628360315;1987;191;2682;2682;9.89;0.61;204.35;3.50;695;20;888.00;0
1990;20;628360326;1990;194;2682;2682;9.94;0.61;204.38;3.50;692;20;889.00;0
1996;20;628360337;1996;191;2682;2682;9.99;0.61;204.56;3.50;686;20;890.00;0
1998;20;628360348;1998;195;2683;2683;10.03;0.61;204.69;3.50;685;20;891.00;0
2001;20;628360359;2001;194;2683;2683;10.06;0.61;204.84;3.50;682;20;892.00;0
2001;20;628360378;2001;199;2688;2689;10.04;0.61;204.84;3.50;687;20;893.00;1
2005;20;628360388;2005;202;2688;2689;10.02;0.61;204.95;3.50;683;20;894.00;1
2009;20;628360400;2009;203;2690;2690;9.96;0.61;205.05;3.50;681;20;895.00;0
2012;20;628360411;2012;203;2690;2690;9.95;0.61;204.93;3.50;678;20;896.00;0
2014;20;628360427;2014;197;2690;2690;9.98;0.61;205.04;3.50;676;20;897.00;0
2020;20;628360438;2020;192;2690;2690;9.97;0.61;205.50;3.50;670;20;898.00;0
2022;20;628360449;2022;186;2690;2690;10.01;0.61;205.64;3.50;668;20;899.00;0
2027;20;628360468;2027;187;2717;2736;9.94;0.61;205.85;3.46;690;20;900.00;19
2031;20;628360488;2031;177;2717;2736;9.98;0.61;206.14;3.46;686;20;901.00;19
2034;21;628360499;2034;170;2720;2736;10.02;0.62;206.41;3.46;686;21;902.00;16
2038;21;628360522;2038;169;2721;2736;10.05;0.62;206.69;3.46;683;21;903.00;15
2042;21;628360542;2042;172;2722;2736;10.05;0.61;206.72;3.46;680;21;904.00;14
2049;21;628360552;2049;172;2722;2736;10.01;0.61;206.80;3.46;673;21;905.00;14
2050;21;628360563;2050;158;2727;2740;10.01;0.61;206.82;3.46;677;21;906.00;13
2052;21;628360573;2052;148;2728;2740;10.11;0.62;207.15;3.46;676;21;907.00;12
2055;21;628360584;2055;138;2731;2744;10.27;0.63;207.22;3.46;676;21;908.00;13
2059;21;628360595;2059;132;2733;2745;10.44;0.64;207.27;3.46;674;21;909.00;12
2061;21;628360606;2061;125;2734;2745;10.59;0.65;207.32;3.46;673;21;910.00;11
2063;21;628360617;2063;120;2734;2745;10.69;0.65;207.47;3.46;671;21;911.00;11
2064;21;628360628;2064;111;2743;2758;10.97;0.67;207.46;3.45;679;21;912.00;15
2065;21;628360640;2065;112;2743;2758;11.14;0.68;207.45;3.45;678;21;913.00;15
2071;21;628360651;2071;113;2744;2758;11.23;0.68;207.79;3.46;673;21;914.00;14
2073;21;628360664;2073;108;2745;2759;11.34;0.69;207.89;3.45;672;21;915.00;14
2075;21;628360675;2075;109;2747;2760;11.35;0.69;207.96;3.46;672;21;916.00;13
2081;21;628360686;2081;107;2747;2760;11.29;0.69;207.92;3.46;666;21;917.00;13
2083;21;628360697;2083;109;2749;2763;11.29;0.69;207.98;3.46;666;21;918.00;14
2087;21;628360707;2087;112;2749;2763;11.29;0.69;208.08;3.46;662;21;919.00;14
2089;21;628360718;2089;118;2750;2763;11.19;0.68;208.08;3.46;661;21;920.00;13
2092;21;628360728;2092;119;2750;2763;11.20;0.68;208.10;3.46;658;21;921.00;13
2095;21;628360744;2095;121;2755;2769;11.21;0.68;208.21;3.46;660;21;922.00;14
2099;21;628360754;2099;123;2755;2769;11.32;0.69;208.34;3.46;656;21;923.00;14
2102;21;628360765;2102;123;2755;2769;11.35;0.69;208.47;3.46;653;21;924.00;14
2104;21;628360774;2104;123;2757;2769;11.41;0.70;208.62;3.48;653;21;925.00;12
2108;22;628360784;2108;125;2761;2773;11.40;0.69;208.70;3.47;653;22;926.00;12
2111;22;628360810;2111;130;2763;2774;11.47;0.70;208.71;3.48;652;22;927.00;11
2117;22;628360819;2117;135;2763;2774;11.43;0.70;208.78;3.48;646;22;928.00;11
2121;22;628360829;2121;136;2764;2775;11.41;0.70;208.73;3.48;643;22;929.00;11
2124;22;628360840;2124;141;2766;2775;11.51;0.70;208.62;3.49;642;22;930.00;9
2129;22;628360850;2129;142;2766;2775;11.48;0.70;208.79;3.49;637;22;931.00;9
2131;22;628360865;2131;146;2767;2775;11.54;0.70;208.74;3.50;636;22;932.00;8
2133;22;628360874;2133;145;2768;2775;11.56;0.70;208.79;3.50;635;22;933.00;7
2135;22;628360883;2135;141;2768;2775;11.58;0.70;208.76;3.50;633;22;934.00;7
2137;22;628360893;2137;148;2769;2775;11.54;0.70;208.73;3.51;632;22;935.00;6
2138;22;628360902;2138;161;2808;2845;11.22;0.68;208.79;3.46;670;22;936.00;37
2141;22;628360916;2141;156;2810;2846;11.23;0.68;208.91;3.46;669;22;937.00;36
2143;22;628360925;2143;154;2815;2846;11.34;0.69;208.83;3.47;672;22;938.00;31
2145;22;628360936;2145;154;2818;2846;11.41;0.70;208.77;3.47;673;22;939.00;28
2148;23;628360944;2148;158;2820;2846;11.42;0.70;208.76;3.47;672;23;940.00;26
2150;23;628360965;2150;161;2822;2846;11.54;0.70;208.76;3.47;672;23;941.00;24
2153;23;628360975;2153;166;2824;2846;11.63;0.71;208.85;3.47;671;23;942.00;22
2154;23;628360989;2154;166;2827;2846;11.63;0.71;208.83;3.47;673;23;943.00;19
2158;23;628360998;2158;172;2828;2847;11.65;0.71;208.77;3.48;670;23;944.00;19
2162;23;628361007;2162;173;2833;2849;11.58;0.70;208.61;3.49;671;23;945.00;16
2163;23;628361017;2163;172;2834;2849;11.48;0.70;208.68;3.49;671;23;946.00;15
2163;23;628361031;2163;172;2839;2853;11.37;0.69;208.68;3.50;676;23;947.00;14
2167;23;628361040;2167;178;2841;2853;11.30;0.69;208.68;3.50;674;23;948.00;12
2171;23;628361049;2171;176;2841;2853;11.21;0.68;208.65;3.50;670;23;949.00;12
2173;23;628361057;2173;170;2845;2853;11.18;0.68;208.60;3.52;672;23;950.00;8
2180;23;628361066;2180;168;2847;2859;11.12;0.68;208.51;3.52;667;23;951.00;12
2184;23;628361075;2184;165;2850;2859;11.11;0.68;208.51;3.52;666;23;952.00;9
2188;23;628361083;2188;162;2851;2859;11.12;0.68;208.38;3.53;663;23;953.00;8
2190;23;628361092;2190;164;2853;2862;11.17;0.68;208.34;3.53;663;23;954.00;9
2193;23;628361101;2193;165;2854;2862;11.10;0.67;208.21;3.53;661;23;955.00;8
2196;23;628361109;2196;161;2855;2862;11.07;0.67;208.14;3.53;659;23;956.00;7
2199;23;628361119;2199;157;2856;2863;11.07;0.67;208.01;3.53;657;23;957.00;7
2200;23;628361127;2200;159;2857;2864;11.16;0.68;207.95;3.53;657;23;958.00;7
2203;23;628361136;2203;160;2857;2864;11.14;0.68;207.87;3.53;654;23;959.00;7
2206;23;628361146;2206;159;2873;2890;11.00;0.67;207.69;3.53;667;23;960.00;17
2208;23;628361156;2208;160;2874;2890;10.99;0.67;207.78;3.53;666;23;961.00;16
2214;23;628361165;2214;155;2876;2890;11.02;0.67;207.48;3.53;662;23;962.00;14
2216;23;628361173;2216;161;2877;2891;11.05;0.67;207.46;3.52;661;23;963.00;14
2219;23;628361182;2219;159;2877;2891;11.03;0.67;207.37;3.52;658;23;964.00;14
2222;23;628361191;2222;165;2879;2895;11.08;0.67;207.22;3.52;657;23;965.00;16
2224;23;628361199;2224;169;2879;2895;11.11;0.68;207.20;3.52;655;23;966.00;16
2225;23;628361208;2225;170;2883;2899;11.09;0.68;207.22;3.52;658;23;967.00;16
2227;23;628361217;2227;169;2883;2899;11.04;0.67;207.18;3.52;656;23;968.00;16
2230;23;628361225;2230;176;2886;2899;10.96;0.67;207.18;3.55;656;23;969.00;13
2230;23;628361233;2230;174;2886;2899;10.88;0.66;207.18;3.55;656;23;970.00;13
2235;23;628361241;2235;177;2888;2899;10.74;0.65;207.04;3.57;653;23;971.00;11
2235;23;628361251;2235;180;2898;2911;10.70;0.65;207.04;3.56;663;23;972.00;13
2236;23;628361260;2236;184;2899;2911;10.52;0.64;207.06;3.56;663;23;973.00;12
2237;23;628361268;2237;192;2900;2911;10.33;0.63;207.06;3.56;663;23;974.00;11
2239;23;628361276;2239;196;2900;2911;10.19;0.62;207.05;3.56;661;23;975.00;11
2240;23;628361290;2240;204;2900;2911;10.01;0.61;207.07;3.56;660;23;976.00;11
2241;23;628361298;2241;208;2901;2911;9.91;0.61;207.09;3.57;660;23;977.00;10
2243;23;628361306;2243;218;2901;2912;9.81;0.60;207.16;3.57;658;23;978.00;11
2244;23;628361315;2244;211;2902;2912;9.78;0.60;207.15;3.57;658;23;979.00;10
2244;23;628361323;2244;204;2908;2918;9.78;0.60;207.15;3.58;664;23;980.00;10
2246;23;628361337;2246;207;2910;2919;9.76;0.60;207.13;3.59;664;23;981.00;9
2248;23;628361346;2248;204;2913;2919;9.71;0.59;207.10;3.60;665;23;982.00;6
2248;23;628361354;2248;203;2913;2919;9.66;0.59;207.10;3.60;665;23;983.00;6
2251;23;628361363;2251;202;2916;2923;9.67;0.59;207.11;3.59;665;23;984.00;7
2256;23;628361372;2256;202;2918;2923;9.60;0.58;207.08;3.60;662;23;985.00;5
2258;23;628361381;2258;204;2918;2923;9.55;0.58;206.92;3.60;660;23;986.00;5
2259;23;628361389;2259;205;2920;2924;9.53;0.58;206.94;3.60;661;23;987.00;4
2260;23;628361398;2260;204;2923;2928;9.54;0.58;206.89;3.60;663;23;988.00;5
2260;23;628361407;2260;204;2925;2928;9.56;0.58;206.89;3.60;665;23;989.00;3
2263;23;628361417;2263;206;2928;2934;9.54;0.58;206.83;3.59;665;23;990.00;6
2264;23;628361426;2264;206;2928;2934;9.49;0.58;206.75;3.59;664;23;991.00;6
2265;23;628361434;2265;205;2929;2934;9.50;0.58;206.74;3.59;664;23;992.00;5
2266;23;628361448;2266;209;2930;2934;9.45;0.58;206.72;3.59;664;23;993.00;4
2267;23;628361456;2267;214;2932;2938;9.43;0.58;206.68;3.59;665;23;994.00;6
2267;23;628361464;2267;212;2933;2938;9.35;0.57;206.68;3.59;666;23;995.00;5
2268;23;628361473;2268;213;2934;2938;9.26;0.57;206.65;3.59;666;23;996.00;4
2269;23;628361481;2269;218;2934;2938;9.20;0.56;206.62;3.59;665;23;997.00;4
2271;23;628361490;2271;222;2936;2939;9.06;0.55;206.64;3.59;665;23;998.00;3
2272;23;628361498;2272;221;2937;2940;8.88;0.54;206.72;3.59;665;23;999.00;3
2276;23;628361508;2276;217;2937;2940;8.73;0.53;206.63;3.59;661;23;1000.00;3
2278;23;628361520;2278;216;2938;2941;8.68;0.53;206.59;3.59;660;23;1001.00;3
2279;23;628361528;2279;214;2938;2941;8.55;0.52;206.56;3.59;659;23;1002.00;3
2281;23;628361537;2281;212;2938;2941;8.52;0.52;206.50;3.59;657;23;1003.00;3
2286;23;628361545;2286;213;2938;2941;8.50;0.52;206.63;3.59;652;23;1004.00;3
2287;23;628361554;2287;210;2938;2941;8.57;0.53;206.63;3.59;651;23;1005.00;3
2291;23;628361561;2291;206;2938;2941;8.60;0.53;206.61;3.59;647;23;1006.00;3
2293;23;628361570;2293;203;2938;2941;8.59;0.53;206.62;3.59;645;23;1007.00;3
2298;23;628361578;2298;229;3013;3068;8.64;0.54;206.71;3.50;715;23;1008.00;55
2300;23;628361597;2300;222;3015;3069;8.63;0.54;206.69;3.50;715;23;1009.00;54
2301;23;628361606;2301;215;3022;3069;8.66;0.54;206.69;3.49;721;23;1010.00;47
2305;23;628361614;2305;215;3030;3069;8.63;0.54;206.77;3.49;725;23;1011.00;39
2308;23;628361623;2308;213;3038;3069;8.62;0.54;206.75;3.49;730;23;1012.00;31
2312;23;628361631;2312;221;3042;3069;8.58;0.53;206.72;3.50;730;23;1013.00;27
2316;23;628361640;2316;225;3047;3069;8.54;0.53;206.74;3.50;731;23;1014.00;22
2320;23;628361649;2320;227;3050;3069;8.49;0.52;206.85;3.50;730;23;1015.00;19
2323;23;628361658;2323;235;3052;3070;8.43;0.52;206.68;3.50;729;23;1016.00;18
2327;23;628361668;2327;236;3053;3071;8.37;0.52;206.86;3.51;726;23;1017.00;18
2331;23;628361681;2331;241;3055;3071;8.26;0.51;206.94;3.51;724;23;1018.00;16
2336;23;628361700;2336;244;3057;3072;8.07;0.50;206.93;3.51;721;23;1019.00;15
2339;23;628361717;2339;234;3059;3072;7.93;0.49;207.01;3.52;720;23;1020.00;13
2343;23;628361732;2343;229;3059;3072;7.84;0.49;207.15;3.52;716;23;1021.00;13
2346;23;628361745;2346;222;3061;3072;7.81;0.49;207.31;3.52;715;23;1022.00;11
2350;23;628361759;2350;218;3065;3076;7.82;0.48;207.32;3.52;715;23;1023.00;11
2355;23;628361772;2355;213;3066;3076;7.83;0.48;207.50;3.53;711;23;1024.00;10
2360;23;628361787;2360;212;3066;3076;7.91;0.49;207.62;3.53;706;23;1025.00;10
2364;23;628361800;2364;208;3070;3079;7.98;0.49;207.69;3.53;706;23;1026.00;9
2368;23;628361811;2368;199;3070;3079;8.10;0.50;208.00;3.53;702;23;1027.00;9
2371;23;628361821;2371;195;3072;3079;8.27;0.51;208.09;3.54;701;23;1028.00;7
2375;23;628361831;2375;187;3076;3083;8.37;0.52;208.29;3.54;701;23;1029.00;7
2380;23;628361842;2380;183;3078;3084;8.51;0.52;208.42;3.54;698;23;1030.00;6
2384;23;628361853;2384;176;3080;3084;8.68;0.53;208.49;3.57;696;23;1031.00;4
2389;23;628361864;2389;171;3084;3088;8.79;0.54;208.67;3.57;695;23;1032.00;4
2394;23;628361876;2394;167;3084;3088;8.93;0.55;208.96;3.57;690;23;1033.00;4
2396;23;628361889;2396;156;3084;3088;9.11;0.56;208.97;3.57;688;23;1034.00;4
2403;23;628361900;2403;152;3086;3090;9.21;0.56;209.13;3.57;683;23;1035.00;4
2407;23;628361911;2407;151;3086;3090;9.32;0.57;209.32;3.57;679;23;1036.00;4
2409;23;628361921;2409;154;3091;3096;9.48;0.58;209.47;3.56;682;23;1037.00;5
2414;23;628361932;2414;153;3092;3096;9.57;0.58;209.72;3.56;678;23;1038.00;4
2418;23;628361952;2418;151;3093;3097;9.65;0.59;209.80;3.56;675;23;1039.00;4
2422;23;628361971;2422;148;3093;3097;9.79;0.59;209.93;3.56;671;23;1040.00;4
2426;23;628361982;2426;146;3093;3097;9.86;0.60;209.97;3.56;667;23;1041.00;4
2431;23;628361993;2431;144;3093;3097;9.86;0.60;210.20;3.56;662;23;1042.00;4
2432;23;628362003;2432;145;3093;3097;9.89;0.60;210.25;3.56;661;23;1043.00;4
2436;23;628362014;2436;142;3104;3109;9.99;0.61;210.40;3.55;668;23;1044.00;5
2441;23;628362026;2441;137;3104;3109;10.03;0.61;210.46;3.55;663;23;1045.00;5
2444;23;628362037;2444;138;3105;3109;10.13;0.61;210.44;3.55;661;23;1046.00;4
2445;23;628362047;2445;138;3105;3109;10.19;0.62;210.50;3.55;660;23;1047.00;4
2453;23;628362057;2453;141;3105;3109;10.20;0.62;210.87;3.55;652;23;1048.00;4
2459;23;628362068;2459;144;3105;3109;10.30;0.62;211.25;3.55;646;23;1049.00;4
2461;23;628362081;2461;148;3111;3115;10.30;0.62;211.37;3.54;650;23;1050.00;4
2466;23;628362092;2466;147;3111;3115;10.27;0.62;211.47;3.54;645;23;1051.00;4
2471;23;628362103;2471;149;3114;3119;10.35;0.63;211.57;3.54;643;23;1052.00;5
2473;23;628362114;2473;156;3116;3120;10.46;0.64;211.58;3.54;643;23;1053.00;4
2478;23;628362124;2478;158;3116;3120;10.52;0.64;211.71;3.54;638;23;1054.00;4
2479;23;628362135;2479;163;3116;3120;10.64;0.65;211.79;3.54;637;23;1055.00;4
2483;23;628362145;2483;163;3129;3133;10.58;0.64;211.93;3.52;646;23;1056.00;4
2488;23;628362157;2488;166;3129;3133;10.59;0.64;211.98;3.52;641;23;1057.00;4
2492;23;628362168;2492;164;3129;3133;10.61;0.65;212.21;3.52;637;23;1058.00;4
2499;23;628362178;2499;168;3130;3134;10.57;0.64;212.40;3.52;631;23;1059.00;4
2503;23;628362189;2503;171;3131;3135;10.56;0.64;212.51;3.52;628;23;1060.00;4
2506;23;628362199;2506;172;3131;3135;10.52;0.64;212.59;3.52;625;23;1061.00;4
2510;24;628362209;2510;175;3133;3138;10.49;0.63;212.49;3.52;623;24;1062.00;5
2513;24;628362236;2513;181;3133;3138;10.45;0.63;212.70;3.52;620;24;1063.00;5
2515;24;628362245;2515;184;3134;3138;10.44;0.63;212.83;3.52;619;24;1064.00;4
2516;24;628362255;2516;188;3134;3138;10.35;0.63;212.77;3.52;618;24;1065.00;4
2520;24;628362265;2520;190;3139;3144;10.19;0.62;212.86;3.51;619;24;1066.00;5
2523;24;628362275;2523;184;3139;3144;10.12;0.62;213.05;3.51;616;24;1067.00;5
2524;24;628362285;2524;183;3140;3144;10.05;0.61;213.06;3.51;616;24;1068.00;4
2528;24;628362294;2528;182;3140;3144;9.94;0.60;213.16;3.51;612;24;1069.00;4
2531;24;628362304;2531;181;3144;3148;9.85;0.60;213.26;3.51;613;24;1070.00;4
2533;24;628362314;2533;180;3145;3149;9.84;0.60;213.52;3.51;612;24;1071.00;4
2538;24;628362324;2538;188;3145;3149;9.76;0.59;213.60;3.51;607;24;1072.00;4
2541;24;628362334;2541;185;3146;3150;9.71;0.59;213.73;3.51;605;24;1073.00;4
2543;24;628362344;2543;184;3146;3150;9.70;0.59;213.66;3.51;603;24;1074.00;4
2547;24;628362353;2547;186;3146;3150;9.66;0.59;213.65;3.51;599;24;1075.00;4
2549;24;628362362;2549;171;3146;3150;9.75;0.59;213.74;3.51;597;24;1076.00;4
2552;24;628362375;2552;158;3146;3150;9.87;0.60;213.72;3.51;594;24;1077.00;4
2553;24;628362389;2553;152;3146;3150;9.99;0.61;213.75;3.51;593;24;1078.00;4
2557;24;628362409;2557;143;3146;3150;10.08;0.61;213.90;3.51;589;24;1079.00;4
2559;24;628362427;2559;165;3223;3275;9.84;0.61;214.09;3.43;664;24;1080.00;52
2561;24;628362453;2561;151;3226;3276;9.89;0.61;214.11;3.42;665;24;1081.00;50
2563;24;628362464;2563;136;3230;3276;10.02;0.62;214.12;3.42;667;24;1082.00;46
2564;24;628362476;2564;126;3233;3276;10.15;0.63;214.07;3.42;669;24;1083.00;43
2565;24;628362485;2565;113;3236;3276;10.24;0.63;214.03;3.42;671;24;1084.00;40
2566;24;628362502;2566;114;3238;3276;10.32;0.64;214.08;3.42;672;24;1085.00;38
2572;25;628362512;2572;109;3241;3276;10.33;0.63;214.20;3.42;669;25;1086.00;35
2574;25;628362536;2574;116;3244;3276;10.38;0.64;214.13;3.43;670;25;1087.00;32
2576;25;628362546;2576;116;3246;3277;10.38;0.64;214.08;3.43;670;25;1088.00;31
2577;25;628362555;2577;122;3251;3278;10.36;0.64;214.09;3.44;674;25;1089.00;27
2579;25;628362565;2579;129;3254;3278;10.27;0.63;214.03;3.44;675;25;1090.00;24
2582;25;628362575;2582;134;3260;3282;10.16;0.62;214.01;3.44;678;25;1091.00;22
2582;25;628362586;2582;142;3262;3282;10.08;0.62;214.01;3.45;680;25;1092.00;20
2585;25;628362596;2585;144;3263;3282;10.08;0.62;213.88;3.45;678;25;1093.00;19
2586;25;628362606;2586;152;3264;3282;10.07;0.62;213.87;3.45;678;25;1094.00;18
2587;25;628362615;2587;151;3269;3288;10.09;0.62;213.82;3.49;682;25;1095.00;19
2588;25;628362626;2588;147;3270;3288;10.20;0.63;213.88;3.49;682;25;1096.00;18
2588;26;628362635;2588;153;3270;3288;10.32;0.63;213.88;3.49;682;26;1097.00;18
2590;26;628362658;2590;154;3272;3291;10.36;0.63;213.84;3.49;682;26;1098.00;19
2592;26;628362677;2592;156;3273;3291;10.45;0.64;213.83;3.49;681;26;1099.00;18
2595;27;628362689;2595;153;3274;3291;10.56;0.65;213.78;3.49;679;27;1100.00;17
2596;27;628362716;2596;156;3276;3292;10.63;0.65;213.74;3.49;680;27;1101.00;16
2604;27;628362726;2604;162;3277;3293;10.71;0.65;213.82;3.49;673;27;1102.00;16
2605;27;628362736;2605;161;3277;3293;10.80;0.66;213.79;3.49;672;27;1103.00;16
2608;27;628362745;2608;170;3287;3306;10.82;0.66;213.92;3.48;679;27;1104.00;19
2610;27;628362755;2610;171;3287;3306;10.83;0.66;213.92;3.48;677;27;1105.00;19
2612;27;628362775;2612;173;3287;3306;10.91;0.67;213.87;3.48;675;27;1106.00;19
2615;27;628362789;2615;175;3288;3307;10.94;0.67;213.80;3.48;673;27;1107.00;19
2617;27;628362798;2617;177;3288;3307;10.95;0.67;213.76;3.48;671;27;1108.00;19
2618;27;628362807;2618;177;3291;3311;10.98;0.67;213.72;3.48;673;27;1109.00;20
2620;27;628362817;2620;177;3292;3311;11.11;0.68;213.70;3.48;672;27;1110.00;19
2623;27;628362826;2623;178;3295;3315;11.18;0.68;213.58;3.48;672;27;1111.00;20
2626;27;628362835;2626;180;3295;3315;11.24;0.68;213.49;3.48;669;27;1112.00;20
2629;27;628362844;2629;182;3295;3315;11.29;0.69;213.48;3.48;666;27;1113.00;20
2634;27;628362852;2634;185;3296;3315;11.25;0.68;213.35;3.52;662;27;1114.00;19
2636;27;628362867;2636;181;3296;3315;11.21;0.68;213.30;3.52;660;27;1115.00;19
2641;27;628362876;2641;182;3306;3327;11.15;0.68;213.10;3.51;665;27;1116.00;21
2643;27;628362885;2643;186;3306;3327;11.13;0.68;213.05;3.51;663;27;1117.00;21
2647;27;628362894;2647;190;3307;3327;11.09;0.68;212.98;3.51;660;27;1118.00;20
2649;27;628362902;2649;187;3307;3327;11.05;0.67;212.91;3.51;658;27;1119.00;20
2650;27;628362910;2650;185;3307;3327;11.05;0.67;212.88;3.51;657;27;1120.00;20
2652;27;628362918;2652;184;3307;3327;11.01;0.67;212.83;3.51;655;27;1121.00;20
2655;27;628362926;2655;179;3308;3328;11.02;0.67;212.71;3.54;653;27;1122.00;20
2657;27;628362934;2657;177;3309;3328;10.96;0.67;212.76;3.55;652;27;1123.00;19
2659;27;628362949;2659;174;3313;3334;10.97;0.67;212.74;3.54;654;27;1124.00;21
2660;27;628362958;2660;169;3319;3336;10.94;0.67;212.73;3.59;659;27;1125.00;17
2664;27;628362967;2664;167;3319;3336;10.95;0.67;212.79;3.59;655;27;1126.00;17
2667;27;628362976;2667;167;3319;3336;11.02;0.67;212.75;3.59;652;27;1127.00;17
2669;27;628362984;2669;167;3323;3340;11.06;0.67;212.85;3.60;654;27;1128.00;17
2673;27;628362993;2673;167;3323;3340;11.05;0.67;212.78;3.60;650;27;1129.00;17
2675;27;628363001;2675;169;3324;3340;11.05;0.67;212.73;3.61;649;27;1130.00;16
2676;27;628363010;2676;161;3325;3341;11.12;0.68;212.69;3.61;649;27;1131.00;16
2679;27;628363018;2679;154;3328;3345;11.11;0.68;212.57;3.61;649;27;1132.00;17
2681;27;628363027;2681;148;3329;3345;11.20;0.68;212.54;3.62;648;27;1133.00;16
2682;27;628363036;2682;134;3331;3348;11.32;0.69;212.52;3.62;649;27;1134.00;17
2682;27;628363046;2682;130;3333;3348;11.42;0.69;212.52;3.64;651;27;1135.00;15
2685;27;628363054;2685;124;3333;3348;11.46;0.70;212.41;3.64;648;27;1136.00;15
2687;27;628363064;2687;121;3334;3348;11.51;0.70;212.46;3.65;647;27;1137.00;14
2689;27;628363079;2689;118;3337;3352;11.64;0.71;212.41;3.65;648;27;1138.00;15
2690;27;628363089;2690;114;3337;3352;11.75;0.71;212.40;3.65;647;27;1139.00;15
2691;27;628363100;2691;109;3339;3352;11.87;0.72;212.43;3.67;648;27;1140.00;13
2692;27;628363109;2692;106;3339;3352;11.97;0.73;212.45;3.67;647;27;1141.00;13
2693;27;628363118;2693;105;3340;3353;11.90;0.72;212.46;3.68;647;27;1142.00;13
2694;28;628363128;2694;107;3341;3354;11.97;0.73;212.45;3.68;647;28;1143.00;13
2694;28;628363144;2694;108;3342;3354;11.94;0.73;212.45;3.70;648;28;1144.00;12
2695;28;628363153;2695;109;3343;3355;11.85;0.72;212.44;3.70;648;28;1145.00;12
2696;28;628363169;2696;114;3343;3355;11.84;0.72;212.47;3.70;647;28;1146.00;12
2697;28;628363178;2697;118;3343;3355;11.76;0.72;212.43;3.70;646;28;1147.00;12
2701;28;628363191;2701;124;3343;3355;11.72;0.71;212.45;3.70;642;28;1148.00;12
2703;28;628363200;2703;134;3343;3355;11.64;0.71;212.46;3.70;640;28;1149.00;12
2703;28;628363214;2703;138;3345;3355;11.48;0.70;212.46;3.72;642;28;1150.00;10
2706;28;628363223;2706;142;3345;3355;11.38;0.69;212.46;3.72;639;28;1151.00;10
2709;28;628363231;2709;164;3408;3482;11.07;0.68;212.45;3.65;699;28;1152.00;74
2712;28;628363250;2712;160;3410;3483;10.98;0.67;212.45;3.66;698;28;1153.00;73
2713;28;628363259;2713;164;3421;3483;11.04;0.68;212.43;3.65;708;28;1154.00;62
2713;28;628363268;2713;168;3429;3483;11.00;0.68;212.43;3.66;716;28;1155.00;54
2715;28;628363277;2715;170;3438;3483;10.96;0.68;212.46;3.66;723;28;1156.00;45
2717;28;628363286;2717;171;3443;3483;10.93;0.68;212.51;3.67;726;28;1157.00;40
2720;28;628363295;2720;174;3451;3483;10.80;0.67;212.46;3.68;731;28;1158.00;32
2723;28;628363304;2723;178;3455;3483;10.60;0.65;212.56;3.69;732;28;1159.00;28
2728;28;628363314;2728;182;3457;3484;10.52;0.65;212.53;3.69;729;28;1160.00;27
2730;28;628363329;2730;188;3461;3485;10.57;0.65;212.50;3.70;731;28;1161.00;24
2734;28;628363340;2734;193;3464;3485;10.51;0.65;212.46;3.70;730;28;1162.00;21
2738;28;628363350;2738;196;3467;3486;10.43;0.64;212.51;3.71;729;28;1163.00;19
2741;28;628363359;2741;207;3469;3486;10.35;0.64;212.45;3.71;728;28;1164.00;17
2742;28;628363368;2742;205;3472;3486;10.30;0.63;212.42;3.72;730;28;1165.00;14
2745;28;628363377;2745;217;3474;3486;10.17;0.63;212.48;3.73;729;28;1166.00;12
2748;28;628363387;2748;225;3477;3490;10.05;0.62;212.48;3.73;729;28;1167.00;13
2751;28;628363397;2751;234;3480;3490;9.90;0.61;212.42;3.73;729;28;1168.00;10
2754;28;628363417;2754;233;3480;3490;9.76;0.60;212.44;3.73;726;28;1169.00;10
2757;28;628363429;2757;231;3484;3496;9.70;0.60;212.51;3.73;727;28;1170.00;12
2757;28;628363439;2757;235;3484;3496;9.63;0.59;212.51;3.73;727;28;1171.00;12
2760;28;628363454;2760;239;3485;3496;9.58;0.59;212.49;3.73;725;28;1172.00;11
2763;28;628363464;2763;242;3489;3500;9.42;0.58;212.49;3.73;726;28;1173.00;11
2767;28;628363482;2767;240;3491;3501;9.37;0.58;212.50;3.73;724;28;1174.00;10
2770;28;628363493;2770;236;3492;3501;9.32;0.57;212.39;3.73;722;28;1175.00;9
2772;28;628363510;2772;239;3496;3505;9.30;0.57;212.35;3.73;724;28;1176.00;9
2777;28;628363522;2777;240;3497;3505;9.28;0.57;212.39;3.73;720;28;1177.00;8
2779;28;628363532;2779;246;3498;3505;9.33;0.57;212.36;3.73;719;28;1178.00;7
2781;28;628363541;2781;241;3499;3506;9.35;0.57;212.33;3.73;718;28;1179.00;7
2785;28;628363550;2785;242;3499;3506;9.31;0.57;212.30;3.73;714;28;1180.00;7
2789;28;628363561;2789;240;3504;3512;9.29;0.57;212.41;3.72;715;28;1181.00;8
2792;28;628363577;2792;241;3504;3512;9.20;0.56;212.39;3.72;712;28;1182.00;8
2797;28;628363587;2797;244;3506;3513;9.16;0.56;212.48;3.72;709;28;1183.00;7
2804;29;628363597;2804;242;3506;3513;9.06;0.55;212.76;3.72;702;29;1184.00;7
2806;29;628363621;2806;247;3506;3513;9.05;0.55;212.85;3.72;700;29;1185.00;7
2811;29;628363636;2811;250;3506;3513;8.99;0.55;212.97;3.72;695;29;1186.00;7
2815;29;628363645;2815;248;3506;3513;8.89;0.54;213.03;3.72;691;29;1187.00;7
2820;29;628363653;2820;246;3517;3525;8.82;0.54;213.40;3.71;697;29;1188.00;8
2825;29;628363663;2825;245;3517;3525;8.80;0.54;213.39;3.71;692;29;1189.00;8
2829;29;628363677;2829;240;3518;3525;8.79;0.54;213.53;3.71;689;29;1190.00;7
2834;29;628363691;2834;231;3518;3525;8.82;0.54;213.78;3.71;684;29;1191.00;7
2837;29;628363704;2837;231;3518;3525;8.90;0.55;213.88;3.71;681;29;1192.00;7
2842;29;628363719;2842;222;3518;3525;8.89;0.55;214.16;3.71;676;29;1193.00;7
2847;29;628363733;2847;224;3522;3529;8.82;0.54;214.37;3.71;675;29;1194.00;7
2852;29;628363747;2852;219;3522;3529;8.83;0.54;214.40;3.71;670;29;1195.00;7
2856;29;628363760;2856;213;3525;3533;8.94;0.55;214.63;3.71;669;29;1196.00;8
2858;29;628363773;2858;207;3527;3534;9.06;0.56;214.74;3.70;669;29;1197.00;7
2861;29;628363787;2861;199;3527;3534;9.18;0.56;214.90;3.70;666;29;1198.00;7
2867;29;628363797;2867;192;3527;3534;9.23;0.57;214.98;3.70;660;29;1199.00;7
2870;29;628363811;2870;196;3550;3575;9.31;0.57;215.04;3.68;680;29;1200.00;25
2874;29;628363831;2874;191;3552;3575;9.40;0.58;215.11;3.68;678;29;1201.00;23
2879;29;628363845;2879;185;3554;3575;9.43;0.58;215.25;3.68;675;29;1202.00;21
2886;29;628363855;2886;178;3556;3576;9.54;0.58;215.38;3.68;670;29;1203.00;20
2888;29;628363866;2888;174;3559;3577;9.65;0.59;215.43;3.68;671;29;1204.00;18
2892;29;628363876;2892;175;3561;3577;9.66;0.59;215.61;3.68;669;29;1205.00;16
2897;29;628363887;2897;171;3563;3580;9.75;0.60;215.78;3.68;666;29;1206.00;17
2901;29;628363898;2901;173;3564;3580;9.73;0.60;215.81;3.68;663;29;1207.00;16
2902;29;628363908;2902;173;3565;3580;9.76;0.60;215.83;3.68;663;29;1208.00;15
2909;29;628363917;2909;171;3565;3580;9.73;0.59;215.81;3.68;656;29;1209.00;15
2913;29;628363928;2913;169;3572;3586;9.65;0.59;215.93;3.68;659;29;1210.00;14
2920;29;628363939;2920;161;3573;3586;9.55;0.58;216.05;3.68;653;29;1211.00;13
2925;29;628363950;2925;159;3573;3586;9.50;0.58;216.11;3.68;648;29;1212.00;13
2930;29;628363960;2930;163;3573;3586;9.44;0.58;216.13;3.68;643;29;1213.00;13
2934;29;628363977;2934;161;3577;3590;9.43;0.58;216.30;3.67;643;29;1214.00;13
2940;29;628363987;2940;162;3579;3592;9.50;0.58;216.31;3.67;639;29;1215.00;13
2944;29;628363998;2944;164;3580;3592;9.52;0.58;216.35;3.67;636;29;1216.00;12
2947;29;628364008;2947;160;3582;3593;9.53;0.58;216.35;3.71;635;29;1217.00;11
2950;29;628364019;2950;158;3582;3593;9.50;0.58;216.34;3.71;632;29;1218.00;11
2954;29;628364029;2954;166;3582;3593;9.53;0.58;216.21;3.71;628;29;1219.00;11
2957;29;628364039;2957;172;3582;3593;9.50;0.58;216.23;3.71;625;29;1220.00;11
2961;29;628364049;2961;173;3583;3593;9.44;0.58;216.26;3.71;622;29;1221.00;10
2963;29;628364058;2963;179;3583;3593;9.34;0.57;216.27;3.71;620;29;1222.00;10
2965;29;628364075;2965;187;3583;3593;9.30;0.57;216.25;3.71;618;29;1223.00;10
2972;29;628364085;2972;200;3623;3663;9.09;0.56;216.29;3.67;651;29;1224.00;40
2974;29;628364101;2974;203;3625;3664;9.07;0.56;216.34;3.67;651;29;1225.00;39
2976;29;628364111;2976;197;3632;3664;9.15;0.56;216.40;3.68;656;29;1226.00;32
2977;29;628364120;2977;198;3632;3664;9.20;0.56;216.36;3.68;655;29;1227.00;32
2981;29;628364130;2981;202;3635;3666;9.26;0.57;216.41;3.68;654;29;1228.00;31
2983;29;628364141;2983;211;3637;3666;9.31;0.57;216.39;3.68;654;29;1229.00;29
2985;29;628364152;2985;215;3639;3666;9.32;0.57;216.44;3.68;654;29;1230.00;27
2987;29;628364162;2987;220;3641;3666;9.29;0.57;216.37;3.68;654;29;1231.00;25
2991;29;628364171;2991;225;3648;3667;9.05;0.55;216.39;3.73;657;29;1232.00;19
2993;29;628364181;2993;230;3650;3668;8.91;0.54;216.34;3.73;657;29;1233.00;18
2995;29;628364191;2995;240;3652;3668;8.77;0.54;216.37;3.74;657;29;1234.00;16
2999;29;628364201;2999;247;3658;3672;8.53;0.52;216.39;3.74;659;29;1235.00;14
3002;29;628364211;3002;257;3660;3672;8.44;0.51;216.39;3.75;658;29;1236.00;12
3005;29;628364221;3005;252;3662;3672;8.42;0.51;216.34;3.75;657;29;1237.00;10
3008;29;628364231;3008;246;3664;3672;8.41;0.51;216.44;3.75;656;29;1238.00;8
3009;29;628364241;3009;239;3670;3678;8.50;0.52;216.57;3.75;661;29;1239.00;8
3011;29;628364251;3011;238;3670;3678;8.59;0.52;216.65;3.75;659;29;1240.00;8
3014;29;628364260;3014;237;3670;3678;8.65;0.53;216.55;3.75;656;29;1241.00;8
3014;29;628364277;3014;238;3673;3681;8.80;0.53;216.55;3.74;659;29;1242.00;8
3014;29;628364287;3014;237;3673;3681;8.78;0.53;216.55;3.74;659;29;1243.00;8
3016;29;628364296;3016;239;3673;3681;8.79;0.53;216.59;3.74;657;29;1244.00;8
3018;29;628364305;3018;239;3674;3682;8.72;0.53;216.54;3.74;656;29;1245.00;8
3022;29;628364328;3022;223;3675;3683;8.70;0.53;216.65;3.74;653;29;1246.00;8
3024;29;628364339;3024;215;3675;3683;8.71;0.53;216.63;3.74;651;29;1247.00;8
3026;29;628364349;3026;210;3688;3696;8.84;0.54;216.69;3.73;662;29;1248.00;8
3028;29;628364361;3028;199;3688;3696;8.87;0.54;216.68;3.73;660;29;1249.00;8
3029;29;628364370;3029;195;3688;3696;8.83;0.54;216.76;3.73;659;29;1250.00;8
3030;29;628364381;3030;190;3689;3697;8.89;0.54;216.70;3.73;659;29;1251.00;8
3030;29;628364392;3030;187;3689;3697;8.94;0.55;216.70;3.73;659;29;1252.00;8
3033;29;628364402;3033;187;3692;3701;9.07;0.55;216.63;3.73;659;29;1253.00;9
3037;29;628364413;3037;186;3692;3701;9.16;0.56;216.67;3.73;655;29;1254.00;9
3038;29;628364422;3038;177;3697;3705;9.22;0.56;216.65;3.72;659;29;1255.00;8
3039;29;628364432;3039;175;3697;3705;9.26;0.57;216.63;3.72;658;29;1256.00;8
3040;29;628364442;3040;174;3697;3705;9.32;0.57;216.62;3.72;657;29;1257.00;8
3041;29;628364452;3041;177;3697;3705;9.40;0.57;216.63;3.72;656;29;1258.00;8
3042;29;628364461;3042;174;3697;3705;9.46;0.58;216.60;3.72;655;29;1259.00;8
3046;29;628364476;3046;177;3721;3739;9.46;0.58;216.53;3.70;675;29;1260.00;18
3049;29;628364488;3049;175;3721;3739;9.55;0.58;216.40;3.70;672;29;1261.00;18
3051;29;628364498;3051;176;3723;3739;9.59;0.59;216.34;3.70;672;29;1262.00;16
3052;29;628364507;3052;178;3723;3739;9.57;0.59;216.30;3.70;671;29;1263.00;16
3053;29;628364517;3053;177;3726;3739;9.63;0.59;216.29;3.75;673;29;1264.00;13
3058;29;628364526;3058;175;3727;3739;9.68;0.59;216.41;3.75;669;29;1265.00;12
3060;29;628364537;3060;176;3728;3740;9.76;0.60;216.41;3.75;668;29;1266.00;12
3065;29;628364546;3065;180;3728;3740;9.76;0.60;216.29;3.75;663;29;1267.00;12
3067;29;628364562;3067;183;3733;3746;9.72;0.59;216.31;3.75;666;29;1268.00;13
3070;29;628364572;3070;178;3734;3747;9.71;0.59;216.16;3.75;664;29;1269.00;13
3071;29;628364581;3071;181;3735;3747;9.77;0.60;216.10;3.75;664;29;1270.00;12
3073;29;628364590;3073;185;3735;3747;9.80;0.60;216.11;3.75;662;29;1271.00;12
3077;29;628364600;3077;185;3739;3751;9.80;0.60;216.01;3.74;662;29;1272.00;12
3078;29;628364610;3078;190;3739;3751;9.79;0.60;215.96;3.74;661;29;1273.00;12
3080;29;628364619;3080;191;3739;3751;9.75;0.59;215.90;3.74;659;29;1274.00;12
3080;29;628364628;3080;192;3740;3752;9.81;0.60;215.90;3.74;660;29;1275.00;12
3081;29;628364636;3081;195;3743;3756;9.88;0.60;215.88;3.74;662;29;1276.00;13
3083;29;628364648;3083;196;3743;3756;9.94;0.61;215.88;3.74;660;29;1277.00;13
3084;29;628364656;3084;200;3745;3759;9.99;0.61;215.83;3.74;661;29;1278.00;14
3085;29;628364665;3085;195;3745;3759;9.96;0.61;215.77;3.74;660;29;1279.00;14
3086;29;628364673;3086;197;3746;3759;9.97;0.61;215.73;3.74;660;29;1280.00;13
3091;29;628364681;3091;198;3746;3759;10.00;0.61;215.66;3.74;655;29;1281.00;13
3091;29;628364690;3091;197;3749;3763;10.03;0.61;215.66;3.74;658;29;1282.00;14
3092;29;628364698;3092;184;3749;3763;10.08;0.61;215.63;3.74;657;29;1283.00;14
3093;29;628364714;3093;177;3750;3763;10.20;0.62;215.61;3.73;657;29;1284.00;13
3093;29;628364730;3093;171;3750;3763;10.25;0.62;215.61;3.73;657;29;1285.00;13
3098;29;628364739;3098;163;3750;3764;10.30;0.62;215.72;3.73;652;29;1286.00;14
3100;29;628364748;3100;158;3751;3765;10.40;0.63;215.71;3.73;651;29;1287.00;14
3100;30;628364757;3100;153;3751;3765;10.57;0.64;215.71;3.73;651;30;1288.00;14
3101;30;628364777;3101;147;3752;3766;10.69;0.65;215.69;3.73;651;30;1289.00;14
3102;30;628364793;3102;144;3752;3766;10.83;0.66;215.69;3.73;650;30;1290.00;14
3103;30;628364801;3103;137;3752;3766;10.94;0.67;215.68;3.73;649;30;1291.00;14
3110;30;628364811;3110;123;3752;3766;11.09;0.67;215.75;3.73;642;30;1292.00;14
3112;30;628364820;3112;116;3752;3766;11.26;0.68;215.70;3.73;640;30;1293.00;14
3117;30;628364828;3117;109;3753;3766;11.34;0.69;215.68;3.74;636;30;1294.00;13
3117;30;628364844;3117;105;3753;3766;11.47;0.69;215.68;3.74;636;30;1295.00;13
3117;30;628364853;3117;121;3815;3893;11.43;0.70;215.68;3.69;698;30;1296.00;78
3118;30;628364872;3118;111;3815;3894;11.54;0.71;215.72;3.69;697;30;1297.00;79
3119;30;628364882;3119;99;3824;3894;11.70;0.72;215.66;3.68;705;30;1298.00;70
3122;30;628364892;3122;97;3826;3894;11.82;0.73;215.57;3.68;704;30;1299.00;68
3124;30;628364902;3124;94;3832;3894;11.89;0.73;215.60;3.68;708;30;1300.00;62
3126;30;628364916;3126;91;3836;3894;11.92;0.73;215.63;3.68;710;30;1301.00;58
3127;30;628364926;3127;87;3840;3894;12.00;0.73;215.62;3.69;713;30;1302.00;54
3129;30;628364936;3129;86;3842;3894;12.12;0.74;215.62;3.69;713;30;1303.00;52
3130;30;628364946;3130;87;3846;3895;12.19;0.74;215.57;3.69;716;30;1304.00;49
3133;30;628364956;3133;88;3851;3897;12.21;0.75;215.60;3.70;718;30;1305.00;46
3135;30;628364968;3135;93;3853;3897;12.21;0.75;215.70;3.70;718;30;1306.00;44
3141;30;628364978;3141;97;3855;3898;12.13;0.74;215.65;3.70;714;30;1307.00;43
3143;30;628364989;3143;97;3857;3898;12.09;0.74;215.69;3.71;714;30;1308.00;41
3145;30;628364999;3145;100;3858;3898;12.03;0.73;215.65;3.71;713;30;1309.00;40
3150;30;628365009;3150;100;3862;3898;11.96;0.73;215.58;3.72;712;30;1310.00;36
3153;30;628365019;3153;101;3866;3902;11.88;0.72;215.55;3.73;713;30;1311.00;36
3155;30;628365030;3155;116;3870;3902;11.79;0.72;215.55;3.74;715;30;1312.00;32
3158;30;628365041;3158;118;3871;3902;11.78;0.72;215.72;3.75;713;30;1313.00;31
3161;30;628365052;3161;125;3875;3905;11.68;0.71;215.72;3.75;714;30;1314.00;30
3163;30;628365069;3163;129;3876;3905;11.59;0.71;215.83;3.76;713;30;1315.00;29
3167;30;628365079;3167;139;3882;3905;11.49;0.70;215.86;3.78;715;30;1316.00;23
3168;30;628365090;3168;148;3886;3909;11.42;0.70;215.88;3.77;718;30;1317.00;23
3171;30;628365100;3171;147;3888;3910;11.35;0.69;215.88;3.78;717;30;1318.00;22
3175;30;628365111;3175;156;3889;3910;11.29;0.69;215.98;3.78;714;30;1319.00;21
3179;30;628365130;3179;159;3895;3915;11.27;0.69;215.90;3.79;716;30;1320.00;20
3181;30;628365142;3181;160;3895;3915;11.18;0.68;215.91;3.79;714;30;1321.00;20
3184;30;628365152;3184;166;3895;3915;11.11;0.68;215.88;3.79;711;30;1322.00;20
3189;30;628365163;3189;168;3897;3916;11.04;0.67;215.98;3.80;708;30;1323.00;19
3193;30;628365174;3193;175;3897;3916;10.95;0.67;215.93;3.80;704;30;1324.00;19
3196;30;628365185;3196;179;3902;3922;10.82;0.66;216.08;3.80;706;30;1325.00;20
3200;30;628365197;3200;181;3903;3922;10.73;0.65;216.04;3.80;703;30;1326.00;19
3202;30;628365207;3202;182;3904;3923;10.63;0.65;216.20;3.80;702;30;1327.00;19
3205;30;628365218;3205;188;3906;3923;10.50;0.64;216.20;3.82;701;30;1328.00;17
3208;30;628365229;3208;195;3906;3923;10.44;0.64;216.21;3.82;698;30;1329.00;17
3213;30;628365239;3213;195;3906;3923;10.37;0.63;216.21;3.82;693;30;1330.00;17
3215;30;628365260;3215;198;3907;3923;10.33;0.63;216.27;3.82;692;30;1331.00;16
3217;30;628365270;3217;201;3917;3935;10.26;0.62;216.26;3.81;700;30;1332.00;18
3219;30;628365281;3219;204;3920;3935;10.17;0.62;216.23;3.83;701;30;1333.00;15
3220;30;628365292;3220;209;3923;3935;10.06;0.61;216.23;3.84;703;30;1334.00;12
3226;30;628365302;3226;210;3924;3935;9.97;0.61;216.29;3.84;698;30;1335.00;11
3229;30;628365312;3229;214;3924;3935;9.87;0.60;216.25;3.84;695;30;1336.00;11
3231;30;628365323;3231;219;3924;3935;9.80;0.60;216.21;3.84;693;30;1337.00;11
3232;30;628365332;3232;223;3928;3939;9.66;0.59;216.29;3.83;696;30;1338.00;11
3235;30;628365343;3235;228;3928;3939;9.54;0.58;216.26;3.83;693;30;1339.00;11
3236;30;628365352;3236;225;3931;3943;9.55;0.58;216.25;3.83;695;30;1340.00;12
3240;30;628365363;3240;227;3932;3944;9.51;0.58;216.27;3.83;692;30;1341.00;12
3241;30;628365380;3241;223;3933;3944;9.43;0.57;216.35;3.83;692;30;1342.00;11
3244;30;628365391;3244;224;3933;3944;9.35;0.57;216.36;3.83;689;30;1343.00;11
3249;30;628365401;3249;223;3945;3957;9.25;0.56;216.59;3.82;696;30;1344.00;12
3250;30;628365412;3250;224;3945;3957;9.18;0.56;216.70;3.82;695;30;1345.00;12
3253;30;628365422;3253;223;3946;3957;9.19;0.56;216.72;3.82;693;30;1346.00;11
3255;30;628365432;3255;222;3947;3958;9.26;0.57;216.68;3.82;692;30;1347.00;11
3257;30;628365442;3257;222;3948;3959;9.31;0.57;216.74;3.82;691;30;1348.00;11
3258;30;628365452;3258;223;3948;3959;9.38;0.58;216.71;3.82;690;30;1349.00;11
3259;30;628365463;3259;224;3951;3968;9.45;0.58;216.77;3.81;692;30;1350.00;17
3264;30;628365476;3264;221;3951;3968;9.46;0.58;216.78;3.81;687;30;1351.00;17
3266;30;628365486;3266;224;3953;3968;9.49;0.58;216.84;3.81;687;30;1352.00;15
3270;30;628365495;3270;223;3953;3968;9.44;0.58;216.94;3.81;683;30;1353.00;15
3273;30;628365504;3273;218;3958;3974;9.43;0.58;216.96;3.81;685;30;1354.00;16
3277;30;628365515;3277;218;3958;3974;9.33;0.57;217.15;3.81;681;30;1355.00;16
3282;30;628365523;3282;217;3959;3974;9.21;0.57;217.27;3.81;677;30;1356.00;15
3286;30;628365533;3286;220;3959;3974;9.05;0.56;217.34;3.81;673;30;1357.00;15
3291;30;628365541;3291;224;3965;3978;8.81;0.54;217.45;3.81;674;30;1358.00;13
3294;30;628365550;3294;228;3966;3979;8.70;0.54;217.48;3.81;672;30;1359.00;13
3299;30;628365559;3299;224;3967;3979;8.57;0.53;217.67;3.81;668;30;1360.00;12
3303;30;628365568;3303;218;3968;3980;8.52;0.53;217.73;3.81;665;30;1361.00;12
3309;30;628365577;3309;217;3968;3980;8.51;0.53;217.67;3.81;659;30;1362.00;12
3316;30;628365586;3316;218;3968;3980;8.52;0.52;217.65;3.81;652;30;1363.00;12
3319;30;628365595;3319;212;3968;3980;8.55;0.53;217.67;3.81;649;30;1364.00;12
3323;30;628365604;3323;217;3968;3980;8.55;0.53;217.77;3.81;645;30;1365.00;12
3328;30;628365618;3328;220;3968;3980;8.58;0.53;217.79;3.81;640;30;1366.00;12
3332;30;628365627;3332;213;3968;3980;8.68;0.53;217.81;3.81;636;30;1367.00;12
3335;30;628365636;3335;213;4007;4050;8.80;0.54;217.78;3.77;672;30;1368.00;43
3340;30;628365651;3340;205;4012;4051;8.88;0.55;217.79;3.77;672;30;1369.00;39
3344;30;628365661;3344;206;4019;4051;9.05;0.56;217.99;3.76;675;30;1370.00;32
3348;30;628365670;3348;204;4020;4051;9.16;0.56;218.02;3.76;672;30;1371.00;31
3351;30;628365686;3351;207;4025;4051;9.26;0.57;218.00;3.84;674;30;1372.00;26
3354;30;628365700;3354;206;4029;4051;9.33;0.57;218.02;3.84;675;30;1373.00;22
3356;30;628365713;3356;205;4034;4051;9.37;0.57;217.99;3.84;678;30;1374.00;17
3359;30;628365728;3359;207;4035;4051;9.26;0.57;217.97;3.84;676;30;1375.00;16
3365;30;628365741;3365;205;4038;4052;9.17;0.56;218.04;3.84;673;30;1376.00;14
3367;30;628365754;3367;200;4039;4053;9.06;0.55;218.03;3.84;672;30;1377.00;14
3372;30;628365767;3372;204;4040;4053;8.98;0.55;218.10;3.84;668;30;1378.00;13
3379;30;628365781;3379;206;4043;4057;8.90;0.54;218.01;3.84;664;30;1379.00;14
3384;30;628365796;3384;199;4043;4057;8.85;0.54;218.08;3.84;659;30;1380.00;14
3389;30;628365806;3389;197;4043;4057;8.82;0.54;218.18;3.84;654;30;1381.00;14
3392;30;628365817;3392;192;4043;4057;8.77;0.53;218.19;3.84;651;30;1382.00;14
3393;30;628365828;3393;191;4048;4063;8.76;0.53;218.23;3.84;655;30;1383.00;15
3396;30;628365837;3396;191;4049;4063;8.77;0.54;218.26;3.84;653;30;1384.00;14
3400;30;628365854;3400;193;4049;4063;8.77;0.54;218.45;3.84;649;30;1385.00;14
3404;30;628365865;3404;199;4051;4066;8.73;0.53;218.43;3.83;647;30;1386.00;15
3408;30;628365875;3408;206;4053;4066;8.70;0.53;218.59;3.84;645;30;1387.00;13
3411;30;628365885;3411;206;4055;4066;8.60;0.53;218.59;3.92;644;30;1388.00;11
3415;30;628365894;3415;208;4057;4067;8.48;0.52;218.85;3.92;642;30;1389.00;10
3421;30;628365903;3421;209;4058;4068;8.47;0.52;218.92;3.92;637;30;1390.00;10
3426;30;628365913;3426;215;4058;4068;8.39;0.51;219.00;3.92;632;30;1391.00;10
3432;30;628365922;3432;216;4071;4081;8.42;0.51;219.15;3.91;639;30;1392.00;10
3432;30;628365934;3432;222;4071;4081;8.42;0.51;219.15;3.91;639;30;1393.00;10
3437;30;628365951;3437;228;4071;4081;8.31;0.51;219.34;3.91;634;30;1394.00;10
3439;30;628365960;3439;231;4073;4083;8.38;0.51;219.36;3.91;634;30;1395.00;10
3442;30;628365971;3442;229;4073;4083;8.35;0.51;219.38;3.91;631;30;1396.00;10
3444;30;628365979;3444;235;4076;4087;8.33;0.51;219.52;3.90;632;30;1397.00;11
3448;30;628365989;3448;240;4076;4087;8.15;0.50;219.42;3.90;628;30;1398.00;11
3450;30;628365998;3450;245;4081;4091;8.14;0.50;219.52;3.90;631;30;1399.00;10
3453;30;628366008;3453;251;4081;4091;8.13;0.50;219.54;3.90;628;30;1400.00;10
3455;30;628366022;3455;257;4081;4091;8.11;0.49;219.50;3.90;626;30;1401.00;10
3457;30;628366031;3457;266;4081;4091;8.08;0.49;219.54;3.90;624;30;1402.00;10
3457;30;628366040;3457;268;4081;4091;8.08;0.49;219.54;3.90;624;30;1403.00;10
3459;30;628366049;3459;274;4092;4103;8.12;0.49;219.60;3.89;633;30;1404.00;11
3461;30;628366058;3461;282;4092;4103;8.03;0.49;219.58;3.89;631;30;1405.00;11
3463;30;628366067;3463;290;4093;4103;8.02;0.49;219.72;3.89;630;30;1406.00;10
3464;30;628366076;3464;285;4093;4103;7.98;0.49;219.68;3.89;629;30;1407.00;10
3467;30;628366085;3467;282;4093;4103;7.92;0.48;219.61;3.89;626;30;1408.00;10
3467;30;628366094;3467;275;4093;4103;7.89;0.48;219.61;3.89;626;30;1409.00;10
3469;30;628366110;3469;271;4094;4104;7.88;0.48;219.55;3.89;625;30;1410.00;10
3471;30;628366118;3471;271;4094;4104;7.88;0.48;219.48;3.89;623;30;1411.00;10
3474;30;628366127;3474;270;4099;4110;7.86;0.48;219.38;3.89;625;30;1412.00;11
3477;30;628366137;3477;272;4100;4111;7.88;0.48;219.33;3.88;623;30;1413.00;11
3478;30;628366146;3478;269;4101;4111;7.93;0.48;219.31;3.88;623;30;1414.00;10
3481;30;628366155;3481;267;4101;4111;7.87;0.48;219.21;3.88;620;30;1415.00;10
3482;30;628366163;3482;247;4105;4115;7.95;0.48;219.18;3.88;623;30;1416.00;10
3487;30;628366172;3487;237;4105;4115;7.99;0.49;219.11;3.88;618;30;1417.00;10
3488;30;628366181;3488;225;4105;4115;8.11;0.49;219.08;3.88;617;30;1418.00;10
3491;30;628366190;3491;221;4106;4116;8.12;0.49;218.99;3.88;615;30;1419.00;10
3493;30;628366205;3493;214;4110;4120;8.15;0.50;218.96;3.88;617;30;1420.00;10
3494;30;628366221;3494;210;4110;4120;8.20;0.50;218.90;3.88;616;30;1421.00;10
3495;30;628366236;3495;206;4112;4123;8.37;0.51;218.89;3.88;617;30;1422.00;11
3496;30;628366246;3496;203;4112;4123;8.49;0.52;218.85;3.88;616;30;1423.00;11
3496;30;628366256;3496;198;4113;4123;8.64;0.53;218.85;3.87;617;30;1424.00;10
3497;30;628366265;3497;191;4113;4123;8.78;0.54;218.86;3.87;616;30;1425.00;10
3499;30;628366274;3499;184;4116;4127;8.94;0.54;218.87;3.87;617;30;1426.00;11
3502;30;628366284;3502;182;4116;4127;8.98;0.55;218.84;3.87;614;30;1427.00;11
3504;30;628366293;3504;183;4117;4127;9.09;0.55;219.04;3.87;613;30;1428.00;10
3507;30;628366302;3507;180;4117;4127;9.14;0.56;219.01;3.87;610;30;1429.00;10
3507;30;628366311;3507;178;4118;4128;9.26;0.56;219.01;3.87;611;30;1430.00;10
3509;30;628366320;3509;175;4119;4129;9.29;0.57;218.98;3.87;610;30;1431.00;10
3512;30;628366329;3512;176;4119;4129;9.33;0.57;218.93;3.87;607;30;1432.00;10
3513;30;628366338;3513;177;4120;4130;9.43;0.57;218.94;3.87;607;30;1433.00;10
3514;30;628366347;3514;177;4120;4130;9.50;0.58;218.96;3.87;606;30;1434.00;10
3514;30;628366355;3514;167;4120;4130;9.62;0.58;218.96;3.87;606;30;1435.00;10
3514;30;628366366;3514;159;4120;4130;9.72;0.59;218.96;3.87;606;30;1436.00;10
3515;30;628366375;3515;147;4120;4130;9.82;0.60;218.96;3.87;605;30;1437.00;10
3515;31;628366390;3515;143;4120;4130;10.00;0.61;218.96;3.87;605;31;1438.00;10
3516;31;628366417;3516;136;4120;4130;10.15;0.62;218.93;3.87;604;31;1439.00;10
3519;31;628366428;3519;172;4234;4360;9.92;0.62;218.91;3.77;715;31;1440.00;126
3520;31;628366458;3520;153;4238;4361;10.14;0.63;218.85;3.83;718;31;1441.00;123
3521;31;628366470;3521;140;4249;4361;10.40;0.65;218.87;3.83;728;31;1442.00;112
3522;31;628366487;3522;126;4254;4361;10.58;0.66;218.83;3.83;732;31;1443.00;107
3524;31;628366496;3524;116;4260;4361;10.69;0.67;218.86;3.83;736;31;1444.00;101
3524;31;628366506;3524;111;4265;4361;10.81;0.67;218.86;3.83;741;31;1445.00;96
3525;31;628366517;3525;111;4271;4361;10.92;0.68;218.84;3.83;746;31;1446.00;90
3527;31;628366533;3527;117;4277;4361;10.97;0.68;218.81;3.84;750;31;1447.00;84
3529;31;628366543;3529;121;4283;4362;11.00;0.68;218.79;3.84;754;31;1448.00;79
3530;31;628366554;3530;123;4287;4363;11.09;0.69;218.79;3.85;757;31;1449.00;76
3534;31;628366566;3534;127;4292;4363;11.11;0.69;218.71;3.85;758;31;1450.00;71
3535;31;628366577;3535;132;4295;4364;11.12;0.69;218.68;3.86;760;31;1451.00;69
3542;31;628366587;3542;134;4299;4364;11.03;0.68;218.66;3.87;757;31;1452.00;65
3543;31;628366612;3543;143;4301;4364;11.00;0.68;218.62;3.87;758;31;1453.00;63
3547;31;628366629;3547;145;4302;4364;11.01;0.68;218.60;3.87;755;31;1454.00;62
3550;31;628366640;3550;151;4307;4368;10.90;0.67;218.66;3.88;757;31;1455.00;61
3553;31;628366652;3553;152;4309;4368;10.85;0.66;218.70;3.95;756;31;1456.00;59
3553;31;628366663;3553;163;4309;4368;10.85;0.66;218.70;3.95;756;31;1457.00;59
3556;31;628366675;3556;165;4313;4371;10.81;0.66;218.79;4.01;757;31;1458.00;58
3556;31;628366686;3556;166;4313;4371;10.89;0.67;218.79;4.01;757;31;1459.00;58
3560;31;628366696;3560;163;4314;4371;10.93;0.67;218.70;4.02;754;31;1460.00;57
3560;31;628366707;3560;168;4318;4375;10.98;0.67;218.70;4.02;758;31;1461.00;57
3564;31;628366717;3564;164;4321;4376;11.04;0.68;218.77;4.08;757;31;1462.00;55
3567;31;628366728;3567;160;4322;4376;11.02;0.67;218.68;4.08;755;31;1463.00;54
3571;31;628366740;3571;156;4326;4380;11.04;0.67;218.82;4.09;755;31;1464.00;54
3576;31;628366752;3576;158;4328;4380;11.09;0.68;218.91;4.10;752;31;1465.00;52
3578;31;628366764;3578;152;4330;4380;11.18;0.68;218.94;4.16;752;31;1466.00;50
3582;31;628366775;3582;148;4332;4381;11.21;0.68;219.15;4.16;750;31;1467.00;49
3585;31;628366787;3585;142;4333;4381;11.27;0.69;219.24;4.16;748;31;1468.00;48
3586;31;628366797;3586;140;4337;4387;11.34;0.69;219.20;4.20;751;31;1469.00;50
3590;31;628366811;3590;136;4337;4387;11.30;0.69;219.17;4.20;747;31;1470.00;50
3594;31;628366828;3594;132;4339;4388;11.32;0.69;219.30;4.25;745;31;1471.00;49
3597;31;628366839;3597;135;4339;4388;11.35;0.69;219.27;4.25;742;31;1472.00;49
3599;31;628366851;3599;136;4340;4388;11.41;0.69;219.33;4.29;741;31;1473.00;48
3602;31;628366862;3602;134;4340;4388;11.44;0.70;219.27;4.29;738;31;1474.00;48
3603;32;628366873;3603;137;4340;4388;11.42;0.70;219.24;4.29;737;32;1475.00;48
3608;32;628366897;3608;138;4350;4400;11.49;0.70;219.30;4.32;742;32;1476.00;50
3610;32;628366909;3610;138;4352;4400;11.54;0.70;219.29;4.33;742;32;1477.00;48
3611;32;628366920;3611;141;4353;4400;11.62;0.71;219.26;4.33;742;32;1478.00;47
3615;32;628366931;3615;144;4354;4400;11.60;0.71;219.29;4.35;739;32;1479.00;46
3616;32;628366943;3616;150;4356;4400;11.66;0.71;219.28;4.36;740;32;1480.00;44
3620;32;628366955;3620;154;4356;4400;11.66;0.71;219.30;4.36;736;32;1481.00;44
3622;32;628366967;3622;158;4361;4404;11.61;0.71;219.35;4.38;739;32;1482.00;43
3622;32;628366979;3622;160;4361;4404;11.56;0.70;219.35;4.38;739;32;1483.00;43
3625;32;628366996;3625;168;4365;4408;11.54;0.70;219.49;4.38;740;32;1484.00;43
3625;32;628367008;3625;170;4367;4410;11.52;0.70;219.49;4.38;742;32;1485.00;43
3628;32;628367021;3628;171;4369;4410;11.44;0.70;219.54;4.39;741;32;1486.00;41
3631;32;628367033;3631;175;4370;4410;11.39;0.69;219.57;4.40;739;32;1487.00;40
3634;32;628367045;3634;180;4379;4423;11.28;0.69;219.69;4.39;745;32;1488.00;44
3634;32;628367057;3634;183;4379;4423;11.18;0.68;219.69;4.39;745;32;1489.00;44
3636;32;628367068;3636;187;4382;4423;11.12;0.68;219.74;4.42;746;32;1490.00;41
3637;32;628367080;3637;190;4383;4424;11.06;0.67;219.78;4.42;746;32;1491.00;41
3640;32;628367098;3640;193;4383;4425;11.02;0.67;219.86;4.42;743;32;1492.00;42
3648;32;628367110;3648;195;4386;4425;10.92;0.66;219.68;4.45;738;32;1493.00;39
3649;32;628367121;3649;205;4388;4428;10.87;0.66;219.65;4.45;739;32;1494.00;40
3652;32;628367133;3652;210;4390;4428;10.79;0.66;219.61;4.47;738;32;1495.00;38
3654;32;628367144;3654;217;4391;4428;10.70;0.65;219.62;4.47;737;32;1496.00;37
3654;32;628367156;3654;220;4393;4428;10.54;0.64;219.62;4.49;739;32;1497.00;35
3656;32;628367168;3656;224;4399;4434;10.47;0.64;219.60;4.51;743;32;1498.00;35
3661;32;628367181;3661;235;4400;4434;10.25;0.62;219.55;4.51;739;32;1499.00;34
3662;32;628367194;3662;245;4406;4453;10.06;0.61;219.52;4.54;744;32;1500.00;47
3666;32;628367213;3666;247;4409;4453;9.84;0.60;219.50;4.55;743;32;1501.00;44
3668;32;628367225;3668;256;4415;4457;9.67;0.59;219.53;4.57;747;32;1502.00;42
3668;32;628367235;3668;261;4417;4458;9.57;0.58;219.53;4.59;749;32;1503.00;41
3673;32;628367246;3673;265;4418;4458;9.48;0.58;219.63;4.59;745;32;1504.00;40
3673;32;628367257;3673;272;4421;4459;9.40;0.57;219.63;4.60;748;32;1505.00;38
3676;32;628367267;3676;282;4422;4459;9.28;0.57;219.67;4.60;746;32;1506.00;37
3676;32;628367278;3676;287;4427;4459;9.16;0.56;219.67;4.62;751;32;1507.00;32
3679;32;628367288;3679;292;4427;4459;9.06;0.55;219.65;4.62;748;32;1508.00;32
3681;32;628367298;3681;290;4428;4459;8.98;0.55;219.70;4.64;747;32;1509.00;31
3685;32;628367307;3685;286;4428;4459;8.91;0.54;219.69;4.64;743;32;1510.00;31
3688;32;628367318;3688;285;4429;4459;8.94;0.55;219.65;4.65;741;32;1511.00;30
3688;32;628367328;3688;291;4463;4529;8.85;0.54;219.65;4.62;775;32;1512.00;66
3690;32;628367345;3690;283;4470;4530;8.82;0.54;219.63;4.62;780;32;1513.00;60
3692;32;628367357;3692;280;4476;4530;8.79;0.54;219.65;4.62;784;32;1514.00;54
3694;32;628367370;3694;280;4479;4530;8.80;0.54;219.61;4.62;785;32;1515.00;51
3698;32;628367388;3698;278;4483;4530;8.80;0.54;219.56;4.62;785;32;1516.00;47
3700;32;628367401;3700;281;4485;4530;8.80;0.54;219.61;4.62;785;32;1517.00;45
3703;32;628367417;3703;276;4489;4530;8.76;0.54;219.55;4.62;786;32;1518.00;41
3705;32;628367434;3705;274;4491;4530;8.80;0.54;219.54;4.63;786;32;1519.00;39
3708;32;628367446;3708;275;4492;4531;8.85;0.54;219.44;4.63;784;32;1520.00;39
3711;32;628367459;3711;274;4495;4532;8.82;0.54;219.45;4.63;784;32;1521.00;37
3715;32;628367476;3715;272;4495;4532;8.78;0.54;219.57;4.63;780;32;1522.00;37
3721;32;628367493;3721;277;4499;4536;8.64;0.53;219.74;4.63;778;32;1523.00;37
3723;32;628367511;3723;278;4500;4536;8.57;0.52;219.83;4.63;777;32;1524.00;36
3729;32;628367528;3729;278;4502;4536;8.51;0.52;219.92;4.64;773;32;1525.00;34
3732;32;628367541;3732;275;4502;4536;8.34;0.51;219.94;4.64;770;32;1526.00;34
3736;32;628367552;3736;279;4507;4542;8.26;0.51;219.97;4.64;771;32;1527.00;35
3740;32;628367565;3740;281;4507;4542;8.11;0.50;220.11;4.64;767;32;1528.00;35
3743;32;628367576;3743;279;4509;4542;7.96;0.49;220.12;4.65;766;32;1529.00;33
3749;32;628367587;3749;271;4512;4548;7.85;0.48;220.30;4.64;763;32;1530.00;36
3755;32;628367600;3755;265;4512;4548;7.77;0.48;220.34;4.64;757;32;1531.00;36
3758;32;628367612;3758;265;4512;4548;7.71;0.47;220.34;4.64;754;32;1532.00;36
3762;32;628367623;3762;258;4513;4549;7.67;0.47;220.34;4.64;751;32;1533.00;36
3766;32;628367640;3766;261;4515;4550;7.68;0.47;220.43;4.65;749;32;1534.00;35
3773;32;628367651;3773;250;4516;4550;7.65;0.47;220.33;4.66;743;32;1535.00;34
3778;32;628367661;3778;249;4526;4563;7.58;0.46;220.28;4.64;748;32;1536.00;37
3780;32;628367673;3780;246;4529;4563;7.60;0.47;220.39;4.65;749;32;1537.00;34
3783;32;628367689;3783;237;4529;4563;7.65;0.47;220.48;4.65;746;32;1538.00;34
3785;32;628367702;3785;232;4531;4564;7.76;0.48;220.57;4.66;746;32;1539.00;33
3788;32;628367716;3788;226;4534;4564;7.82;0.48;220.59;4.67;746;32;1540.00;30
3789;32;628367731;3789;225;4538;4568;7.89;0.48;220.62;4.68;749;32;1541.00;30
3792;32;628367746;3792;221;4538;4568;7.98;0.49;220.69;4.68;746;32;1542.00;30
3796;32;628367762;3796;217;4544;4572;8.00;0.49;220.73;4.69;748;32;1543.00;28
3799;32;628367777;3799;216;4544;4572;8.01;0.49;220.79;4.69;745;32;1544.00;28
3803;32;628367791;3803;215;4544;4572;8.02;0.49;220.70;4.69;741;32;1545.00;28
3806;32;628367802;3806;212;4544;4572;8.09;0.50;220.76;4.69;738;32;1546.00;28
3808;32;628367813;3808;218;4545;4572;8.14;0.50;220.70;4.69;737;32;1547.00;27
3813;32;628367823;3813;213;4556;4584;8.21;0.50;220.86;4.68;743;32;1548.00;28
3817;32;628367835;3817;206;4557;4584;8.21;0.50;220.95;4.69;740;32;1549.00;27
3824;32;628367846;3824;203;4558;4584;8.17;0.50;220.87;4.70;734;32;1550.00;26
3827;32;628367858;3827;207;4558;4584;8.20;0.50;220.87;4.70;731;32;1551.00;26
3831;32;628367878;3831;217;4559;4584;8.20;0.50;220.88;4.71;728;32;1552.00;25
3833;32;628367891;3833;215;4559;4584;8.15;0.50;220.88;4.71;726;32;1553.00;25
3837;32;628367904;3837;224;4562;4585;8.09;0.49;220.97;4.71;725;32;1554.00;23
3841;32;628367922;3841;228;4565;4587;8.03;0.49;221.02;4.72;724;32;1555.00;22
3845;32;628367935;3845;230;4569;4593;7.95;0.48;221.05;4.72;724;32;1556.00;24
3849;32;628367947;3849;238;4570;4594;7.85;0.48;221.22;4.72;721;32;1557.00;24
3852;32;628367963;3852;242;4571;4594;7.73;0.47;221.16;4.72;719;32;1558.00;23
3854;32;628367978;3854;249;4572;4594;7.68;0.47;221.18;4.73;718;32;1559.00;22
3857;32;628367994;3857;253;4578;4599;7.68;0.47;221.18;4.73;721;32;1560.00;21
3859;32;628368005;3859;267;4579;4599;7.71;0.47;221.19;4.73;720;32;1561.00;20
3865;32;628368015;3865;270;4579;4599;7.60;0.46;221.12;4.73;714;32;1562.00;20
3869;32;628368026;3869;270;4581;4600;7.48;0.46;221.16;4.73;712;32;1563.00;19
3873;32;628368036;3873;275;4586;4604;7.46;0.45;221.00;4.73;713;32;1564.00;18
3879;32;628368047;3879;280;4586;4604;7.41;0.45;221.03;4.73;707;32;1565.00;18
3882;32;628368057;3882;283;4590;4607;7.41;0.45;220.96;4.73;708;32;1566.00;17
3883;32;628368074;3883;287;4591;4607;7.40;0.45;220.93;4.73;708;32;1567.00;16
3885;32;628368087;3885;294;4591;4607;7.29;0.44;220.86;4.73;706;32;1568.00;16
3887;32;628368098;3887;298;4591;4607;7.32;0.45;220.82;4.73;704;32;1569.00;16
3890;32;628368109;3890;308;4594;4611;7.27;0.44;220.78;4.73;704;32;1570.00;17
3893;32;628368128;3893;308;4596;4611;7.27;0.44;220.74;4.75;703;32;1571.00;15
3894;32;628368138;3894;308;4596;4611;7.26;0.44;220.72;4.75;702;32;1572.00;15
3896;32;628368146;3896;311;4596;4611;7.25;0.44;220.65;4.75;700;32;1573.00;15
3899;32;628368155;3899;313;4597;4612;7.17;0.44;220.60;4.75;698;32;1574.00;15
3903;32;628368164;3903;314;4599;4614;7.11;0.43;220.63;4.75;696;32;1575.00;15
3904;32;628368173;3904;320;4599;4614;7.08;0.43;220.68;4.75;695;32;1576.00;15
3906;32;628368181;3906;311;4600;4615;7.13;0.44;220.71;4.75;694;32;1577.00;15
3911;32;628368190;3911;306;4600;4615;7.09;0.43;220.69;4.75;689;32;1578.00;15
3912;32;628368200;3912;299;4600;4615;7.17;0.44;220.67;4.75;688;32;1579.00;15
3913;32;628368208;3913;290;4600;4615;7.20;0.44;220.71;4.75;687;32;1580.00;15
3915;32;628368218;3915;293;4600;4615;7.24;0.44;220.88;4.75;685;32;1581.00;15
3918;32;628368226;3918;288;4600;4615;7.25;0.44;220.88;4.75;682;32;1582.00;15
3921;32;628368236;3921;289;4600;4615;7.26;0.44;221.04;4.75;679;32;1583.00;15
3922;32;628368246;3922;303;4676;4742;7.65;0.47;221.05;4.67;754;32;1584.00;66
3923;32;628368268;3923;298;4678;4743;7.68;0.48;221.10;4.67;755;32;1585.00;65
3925;32;628368279;3925;276;4686;4743;7.80;0.48;221.09;4.67;761;32;1586.00;57
3926;32;628368291;3926;252;4689;4743;7.91;0.49;221.08;4.67;763;32;1587.00;54
3927;32;628368308;3927;231;4694;4743;8.03;0.50;221.06;4.70;767;32;1588.00;49
3929;32;628368319;3929;225;4698;4743;8.14;0.50;221.08;4.70;769;32;1589.00;45
3930;32;628368332;3930;211;4699;4743;8.26;0.51;221.10;4.70;769;32;1590.00;44
3932;32;628368354;3932;206;4701;4743;8.37;0.52;221.06;4.70;769;32;1591.00;42
3933;32;628368376;3933;199;4703;4744;8.44;0.52;221.05;4.70;770;32;1592.00;41
3934;32;628368390;3934;195;4706;4745;8.58;0.53;221.10;4.70;772;32;1593.00;39
3936;32;628368403;3936;189;4707;4745;8.67;0.53;221.10;4.70;771;32;1594.00;38
3936;32;628368416;3936;189;4710;4746;8.73;0.54;221.10;4.71;774;32;1595.00;36
3938;32;628368428;3938;184;4714;4746;8.86;0.55;221.05;4.71;776;32;1596.00;32
3940;32;628368440;3940;184;4716;4746;8.98;0.55;221.04;4.72;776;32;1597.00;30
3942;32;628368453;3942;186;4720;4746;9.12;0.56;221.00;4.72;778;32;1598.00;26
3943;32;628368474;3943;183;4722;4750;9.22;0.57;220.99;4.73;779;32;1599.00;28
3946;32;628368488;3946;178;4726;4750;9.41;0.58;220.99;4.73;780;32;1600.00;24
3947;32;628368505;3947;170;4727;4750;9.49;0.58;221.01;4.73;780;32;1601.00;23
3948;32;628368517;3948;161;4730;4753;9.64;0.59;221.00;4.73;782;32;1602.00;23
3948;32;628368530;3948;156;4731;4753;9.73;0.59;221.00;4.74;783;32;1603.00;22
3951;32;628368542;3951;156;4732;4753;9.90;0.60;221.00;4.73;781;32;1604.00;21
3951;32;628368555;3951;158;4736;4757;10.01;0.61;221.00;4.73;785;32;1605.00;21
3953;32;628368574;3953;153;4738;4758;10.13;0.62;220.96;4.73;785;32;1606.00;20
3956;32;628368587;3956;152;4738;4758;10.25;0.62;220.99;4.73;782;32;1607.00;20
3960;32;628368600;3960;148;4741;4762;10.39;0.63;221.03;4.73;781;32;1608.00;21
3961;32;628368612;3961;147;4741;4762;10.48;0.64;221.07;4.73;780;32;1609.00;21
3962;32;628368625;3962;145;4741;4762;10.49;0.64;221.12;4.73;779;32;1610.00;21
3966;32;628368637;3966;144;4742;4763;10.54;0.64;221.15;4.73;776;32;1611.00;21
3968;32;628368650;3968;144;4742;4763;10.64;0.65;221.18;4.73;774;32;1612.00;21
3972;32;628368664;3972;149;4746;4769;10.71;0.65;221.20;4.73;774;32;1613.00;23
3975;32;628368678;3975;152;4746;4769;10.81;0.66;221.25;4.73;771;32;1614.00;23
3976;32;628368692;3976;152;4747;4770;10.96;0.67;221.31;4.72;771;32;1615.00;23
3978;32;628368703;3978;153;4747;4770;11.02;0.67;221.26;4.72;769;32;1616.00;23
3980;32;628368716;3980;154;4747;4770;11.09;0.67;221.35;4.72;767;32;1617.00;23
3983;32;628368729;3983;150;4747;4770;11.19;0.68;221.34;4.72;764;32;1618.00;23
3987;32;628368742;3987;150;4747;4770;11.23;0.68;221.39;4.72;760;32;1619.00;23
3989;33;628368765;3989;147;4767;4806;11.25;0.68;221.40;4.70;778;33;1620.00;39
3994;33;628368791;3994;145;4768;4806;11.27;0.68;221.54;4.70;774;33;1621.00;38
3996;33;628368804;3996;147;4769;4806;11.35;0.69;221.56;4.70;773;33;1622.00;37
4000;33;628368818;4000;147;4771;4806;11.42;0.69;221.68;4.70;771;33;1623.00;35
4003;33;628368831;4003;145;4772;4806;11.49;0.70;221.75;4.70;769;33;1624.00;34
4006;33;628368852;4006;142;4772;4806;11.58;0.70;221.82;4.70;766;33;1625.00;34
4010;33;628368864;4010;147;4776;4810;11.65;0.71;221.82;4.70;766;33;1626.00;34
4012;34;628368876;4012;146;4777;4810;11.73;0.71;221.90;4.70;765;34;1627.00;33
4018;34;628368903;4018;148;4780;4814;11.77;0.71;222.04;4.70;762;34;1628.00;34
4021;34;628368915;4021;142;4781;4815;11.84;0.72;222.06;4.70;760;34;1629.00;34
4027;34;628368926;4027;139;4782;4815;11.88;0.72;222.22;4.70;755;34;1630.00;33
4028;34;628368938;4028;139;4782;4815;11.92;0.72;222.26;4.70;754;34;1631.00;33
4031;34;628368948;4031;133;4791;4828;11.86;0.72;222.32;4.69;760;34;1632.00;37
4037;34;628368960;4037;135;4791;4828;11.83;0.72;222.43;4.69;754;34;1633.00;37
4039;34;628368977;4039;133;4791;4828;11.74;0.71;222.41;4.69;752;34;1634.00;37
4043;34;628368994;4043;133;4793;4829;11.66;0.71;222.52;4.70;750;34;1635.00;36
4044;34;628369005;4044;131;4793;4830;11.75;0.71;222.52;4.70;749;34;1636.00;37
4050;34;628369015;4050;128;4793;4830;11.83;0.72;222.59;4.70;743;34;1637.00;37
4055;34;628369028;4055;128;4795;4833;11.90;0.72;222.62;4.70;740;34;1638.00;38
4059;34;628369043;4059;124;4795;4833;11.96;0.73;222.57;4.70;736;34;1639.00;38
4064;34;628369056;4064;128;4796;4833;12.05;0.73;222.51;4.69;732;34;1640.00;37
4065;34;628369069;4065;125;4796;4833;12.10;0.73;222.58;4.69;731;34;1641.00;37
4071;34;628369079;4071;128;4801;4839;12.13;0.74;222.53;4.70;730;34;1642.00;38
4073;34;628369091;4073;126;4802;4839;12.13;0.74;222.51;4.69;729;34;1643.00;37
4074;34;628369101;4074;128;4802;4839;12.10;0.73;222.59;4.69;728;34;1644.00;37
4077;34;628369112;4077;128;4802;4839;12.13;0.74;222.58;4.69;725;34;1645.00;37
4080;34;628369122;4080;130;4805;4843;12.05;0.73;222.62;4.69;725;34;1646.00;38
4082;34;628369133;4082;136;4807;4844;12.05;0.73;222.58;4.70;725;34;1647.00;37
4084;34;628369145;4084;137;4807;4844;12.05;0.73;222.56;4.70;723;34;1648.00;37
4086;34;628369155;4086;141;4808;4845;12.12;0.74;222.54;4.70;722;34;1649.00;37
4087;34;628369167;4087;141;4809;4845;12.09;0.73;222.58;4.70;722;34;1650.00;36
4091;34;628369178;4091;145;4810;4845;12.04;0.73;222.54;4.71;719;34;1651.00;35
4094;34;628369189;4094;142;4811;4845;12.00;0.73;222.51;4.72;717;34;1652.00;34
4095;34;628369207;4095;143;4812;4845;11.98;0.73;222.50;4.72;717;34;1653.00;33
4097;34;628369219;4097;146;4812;4845;11.98;0.73;222.46;4.72;715;34;1654.00;33
4099;34;628369230;4099;151;4812;4845;11.95;0.73;222.54;4.72;713;34;1655.00;33
4100;34;628369241;4100;157;4847;4915;11.81;0.72;222.53;4.69;747;34;1656.00;68
4104;34;628369257;4104;155;4848;4916;11.68;0.71;222.68;4.70;744;34;1657.00;68
4106;34;628369268;4106;157;4855;4916;11.68;0.71;222.64;4.70;749;34;1658.00;61
4109;34;628369280;4109;160;4861;4916;11.66;0.71;222.62;4.70;752;34;1659.00;55
4111;34;628369291;4111;165;4871;4916;11.55;0.70;222.60;4.71;760;34;1660.00;45
4114;34;628369302;4114;163;4875;4916;11.53;0.70;222.58;4.71;761;34;1661.00;41
4119;34;628369313;4119;167;4880;4916;11.40;0.69;222.54;4.73;761;34;1662.00;36
4123;34;628369324;4123;169;4881;4916;11.32;0.69;222.52;4.73;758;34;1663.00;35
4125;34;628369336;4125;170;4884;4917;11.28;0.68;222.47;4.75;759;34;1664.00;33
4127;34;628369347;4127;172;4887;4919;11.18;0.68;222.45;4.75;760;34;1665.00;32
4132;35;628369358;4132;172;4888;4919;11.12;0.67;222.64;4.75;756;35;1666.00;31
4134;35;628369389;4134;181;4892;4923;10.99;0.67;222.62;4.76;758;35;1667.00;31
4137;35;628369400;4137;187;4892;4923;10.92;0.66;222.68;4.76;755;35;1668.00;31
4140;35;628369412;4140;196;4894;4923;10.82;0.66;222.70;4.77;754;35;1669.00;29
4141;35;628369423;4141;197;4894;4923;10.72;0.65;222.74;4.77;753;35;1670.00;29
4144;35;628369435;4144;203;4901;4929;10.68;0.65;222.83;4.79;757;35;1671.00;28
4146;35;628369447;4146;209;4901;4929;10.62;0.65;222.82;4.79;755;35;1672.00;28
4149;35;628369458;4149;214;4903;4929;10.55;0.64;222.76;4.80;754;35;1673.00;26
4150;35;628369469;4150;221;4907;4932;10.44;0.64;222.75;4.80;757;35;1674.00;25
4151;35;628369481;4151;226;4907;4932;10.39;0.64;222.76;4.80;756;35;1675.00;25
4151;35;628369492;4151;230;4909;4932;10.29;0.63;222.76;4.80;758;35;1676.00;23
4155;35;628369503;4155;236;4909;4933;10.16;0.62;222.74;4.80;754;35;1677.00;24
4158;35;628369514;4158;242;4910;4934;10.02;0.62;222.68;4.80;752;35;1678.00;24
4162;35;628369526;4162;244;4913;4934;9.84;0.60;222.58;4.80;751;35;1679.00;21
4165;35;628369540;4165;252;4929;4960;9.65;0.59;222.50;4.79;764;35;1680.00;31
4167;35;628369553;4167;247;4932;4960;9.47;0.58;222.49;4.79;765;35;1681.00;28
4167;35;628369564;4167;246;4934;4960;9.39;0.58;222.49;4.78;767;35;1682.00;26
4171;35;628369578;4171;247;4936;4961;9.25;0.57;222.47;4.78;765;35;1683.00;25
4174;35;628369589;4174;238;4936;4961;9.17;0.56;222.43;4.78;762;35;1684.00;25
4177;35;628369602;4177;243;4939;4965;9.15;0.56;222.37;4.78;762;35;1685.00;26
4181;35;628369618;4181;241;4939;4965;9.12;0.56;222.32;4.78;758;35;1686.00;26
4185;35;628369629;4185;243;4943;4969;8.98;0.55;222.35;4.78;758;35;1687.00;26
4188;35;628369640;4188;248;4944;4969;8.91;0.55;222.35;4.78;756;35;1688.00;25
4189;35;628369650;4189;255;4945;4969;8.86;0.54;222.36;4.79;756;35;1689.00;24
4192;35;628369661;4192;256;4945;4969;8.76;0.54;222.30;4.79;753;35;1690.00;24
4195;35;628369671;4195;260;4946;4969;8.73;0.54;222.32;4.79;751;35;1691.00;23
4198;35;628369685;4198;261;4957;4981;8.72;0.54;222.28;4.78;759;35;1692.00;24
4203;35;628369701;4203;264;4957;4981;8.54;0.52;222.26;4.78;754;35;1693.00;24
4209;35;628369719;4209;265;4960;4981;8.41;0.52;222.20;4.78;751;35;1694.00;21
4214;35;628369733;4214;265;4960;4981;8.30;0.51;222.27;4.78;746;35;1695.00;21
4215;35;628369749;4215;269;4960;4981;8.21;0.50;222.33;4.78;745;35;1696.00;21
4217;35;628369763;4217;270;4960;4981;8.08;0.50;222.35;4.78;743;35;1697.00;21
4218;35;628369777;4218;276;4961;4982;7.92;0.49;222.39;4.78;743;35;1698.00;21
4221;35;628369790;4221;289;4961;4982;7.79;0.48;222.40;4.78;740;35;1699.00;21
4222;35;628369803;4222;281;4966;4988;7.66;0.47;222.45;4.78;744;35;1700.00;22
4223;35;628369819;4223;284;4967;4989;7.55;0.47;222.50;4.77;744;35;1701.00;22
4226;35;628369831;4226;284;4968;4989;7.49;0.47;222.61;4.77;742;35;1702.00;21
4230;35;628369843;4230;279;4968;4989;7.44;0.46;222.64;4.77;738;35;1703.00;21
4235;35;628369856;4235;274;4972;4993;7.38;0.46;222.64;4.77;737;35;1704.00;21
4239;35;628369871;4239;277;4972;4993;7.37;0.46;222.69;4.77;733;35;1705.00;21
4244;35;628369884;4244;278;4972;4993;7.32;0.45;222.74;4.77;728;35;1706.00;21
4248;35;628369897;4248;271;4973;4994;7.29;0.45;222.62;4.77;725;35;1707.00;21
4252;35;628369916;4252;268;4977;4998;7.25;0.45;222.63;4.77;725;35;1708.00;21
4257;35;628369927;4257;267;4977;4998;7.25;0.45;222.81;4.77;720;35;1709.00;21
4260;35;628369946;4260;270;4980;5004;7.29;0.45;222.80;4.76;720;35;1710.00;24
4261;35;628369960;4261;274;4981;5004;7.32;0.45;222.77;4.76;720;35;1711.00;23
4263;35;628369976;4263;272;4982;5004;7.34;0.45;222.80;4.76;719;35;1712.00;22
4266;35;628369988;4266;273;4982;5004;7.29;0.45;222.79;4.76;716;35;1713.00;22
4270;35;628370001;4270;273;4985;5008;7.28;0.45;222.79;4.76;715;35;1714.00;23
4273;35;628370015;4273;274;4985;5008;7.23;0.44;222.79;4.76;712;35;1715.00;23
4277;35;628370026;4277;271;4986;5008;7.18;0.44;222.73;4.76;709;35;1716.00;22
4281;35;628370037;4281;270;4986;5008;7.12;0.44;222.68;4.76;705;35;1717.00;22
4290;35;628370047;4290;273;4988;5009;6.98;0.43;222.52;4.76;698;35;1718.00;21
4291;35;628370058;4291;278;4989;5010;7.02;0.43;222.55;4.76;698;35;1719.00;21
4294;35;628370070;4294;275;4989;5010;7.03;0.43;222.66;4.76;695;35;1720.00;21
4300;35;628370079;4300;273;4990;5011;7.07;0.43;222.60;4.76;690;35;1721.00;21
4302;35;628370090;4302;273;4990;5011;7.08;0.43;222.61;4.76;688;35;1722.00;21
4307;35;628370099;4307;271;4990;5011;7.02;0.43;222.60;4.76;683;35;1723.00;21
4312;35;628370109;4312;273;4990;5011;7.02;0.43;222.67;4.76;678;35;1724.00;21
4314;35;628370119;4314;268;4990;5011;7.06;0.43;222.67;4.76;676;35;1725.00;21
4319;35;628370136;4319;266;4990;5011;7.08;0.43;222.73;4.76;671;35;1726.00;21
4320;35;628370146;4320;259;4990;5011;7.13;0.43;222.73;4.76;670;35;1727.00;21
4323;35;628370156;4323;275;5058;5138;7.52;0.47;222.78;4.69;735;35;1728.00;80
4325;35;628370177;4325;270;5062;5139;7.50;0.46;222.83;4.75;737;35;1729.00;77
4328;35;628370189;4328;272;5073;5139;7.65;0.47;222.83;4.74;745;35;1730.00;66
4331;35;628370200;4331;272;5077;5139;7.63;0.47;222.87;4.74;746;35;1731.00;62
4336;35;628370215;4336;270;5083;5139;7.68;0.47;222.85;4.74;747;35;1732.00;56
4340;35;628370229;4340;272;5090;5139;7.69;0.47;222.77;4.74;750;35;1733.00;49
4345;35;628370241;4345;275;5096;5139;7.70;0.47;222.87;4.74;751;35;1734.00;43
4347;35;628370252;4347;278;5098;5139;7.68;0.47;222.88;4.74;751;35;1735.00;41
4352;35;628370262;4352;284;5101;5140;7.69;0.47;222.87;4.75;749;35;1736.00;39
4353;35;628370272;4353;288;5106;5141;7.68;0.47;222.85;4.75;753;35;1737.00;35
4355;35;628370283;4355;291;5108;5141;7.61;0.47;222.88;4.75;753;35;1738.00;33
4358;35;628370293;4358;284;5112;5142;7.56;0.46;222.91;4.75;754;35;1739.00;30
4361;35;628370305;4361;277;5113;5142;7.54;0.46;222.93;4.75;752;35;1740.00;29
4363;35;628370316;4363;280;5114;5142;7.53;0.46;222.94;4.76;751;35;1741.00;28
4365;35;628370326;4365;278;5116;5142;7.64;0.47;222.97;4.76;751;35;1742.00;26
4367;35;628370336;4367;278;5119;5146;7.71;0.47;223.03;4.76;752;35;1743.00;27
4367;35;628370348;4367;280;5121;5146;7.77;0.47;223.03;4.76;754;35;1744.00;25
4369;35;628370365;4369;281;5121;5146;7.82;0.48;223.07;4.76;752;35;1745.00;25
4370;35;628370376;4370;279;5124;5149;7.97;0.49;223.07;4.76;754;35;1746.00;25
4371;35;628370388;4371;272;5124;5149;8.02;0.49;223.02;4.76;753;35;1747.00;25
4371;35;628370403;4371;266;5125;5149;8.16;0.50;223.02;4.76;754;35;1748.00;24
4373;36;628370419;4373;263;5129;5153;8.29;0.51;223.19;4.76;756;36;1749.00;24
4376;36;628370448;4376;257;5131;5154;8.44;0.51;223.15;4.76;755;36;1750.00;23
4377;37;628370465;4377;250;5131;5154;8.57;0.52;223.19;4.76;754;37;1751.00;23
4380;37;628370494;4380;243;5136;5158;8.72;0.53;223.22;4.76;756;37;1752.00;22
4383;37;628370507;4383;239;5136;5158;8.80;0.54;223.18;4.76;753;37;1753.00;22
4385;37;628370525;4385;237;5136;5158;8.88;0.54;223.16;4.76;751;37;1754.00;22
4387;37;628370537;4387;234;5138;5160;8.97;0.55;223.11;4.76;751;37;1755.00;22
4390;37;628370553;4390;218;5138;5160;9.07;0.55;223.16;4.76;748;37;1756.00;22
4393;37;628370564;4393;200;5143;5166;9.17;0.56;223.27;4.75;750;37;1757.00;23
4393;37;628370577;4393;186;5144;5166;9.35;0.57;223.27;4.75;751;37;1758.00;22
4395;37;628370588;4395;172;5145;5167;9.49;0.58;223.24;4.75;750;37;1759.00;22
4400;37;628370605;4400;165;5145;5167;9.67;0.59;223.33;4.75;745;37;1760.00;22
4401;37;628370618;4401;157;5145;5167;9.83;0.60;223.31;4.75;744;37;1761.00;22
4405;38;628370632;4405;154;5145;5167;10.03;0.61;223.42;4.75;740;38;1762.00;22
4405;38;628370656;4405;149;5145;5167;10.25;0.62;223.42;4.75;740;38;1763.00;22
4409;38;628370670;4409;142;5156;5179;10.52;0.64;223.46;4.74;747;38;1764.00;23
4411;39;628370690;4411;136;5157;5179;10.72;0.65;223.52;4.74;746;39;1765.00;22
4413;39;628370727;4413;133;5157;5179;10.84;0.66;223.55;4.74;744;39;1766.00;22
4416;39;628370739;4416;136;5157;5179;10.94;0.66;223.63;4.74;741;39;1767.00;22
4419;39;628370751;4419;138;5157;5179;11.02;0.67;223.64;4.74;738;39;1768.00;22
4422;39;628370768;4422;138;5157;5179;11.08;0.67;223.70;4.74;735;39;1769.00;22
4426;39;628370782;4426;140;5160;5183;11.15;0.68;223.76;4.74;734;39;1770.00;23
4431;39;628370794;4431;136;5160;5183;11.30;0.68;223.88;4.74;729;39;1771.00;23
4436;39;628370810;4436;134;5163;5187;11.34;0.69;224.01;4.74;727;39;1772.00;24
4439;39;628370822;4439;131;5165;5188;11.45;0.69;224.03;4.73;726;39;1773.00;23
4441;39;628370834;4441;125;5165;5188;11.64;0.70;224.07;4.73;724;39;1774.00;23
4443;39;628370846;4443;127;5165;5188;11.75;0.71;224.12;4.73;722;39;1775.00;23
4444;39;628370856;4444;131;5175;5201;11.83;0.72;224.17;4.72;731;39;1776.00;26
4447;39;628370868;4447;124;5175;5201;11.91;0.72;224.20;4.72;728;39;1777.00;26
4451;39;628370880;4451;123;5176;5201;12.01;0.73;224.27;4.72;725;39;1778.00;25
4452;39;628370891;4452;121;5177;5202;12.09;0.73;224.32;4.72;725;39;1779.00;25
4458;39;628370902;4458;124;5177;5203;12.12;0.73;224.45;4.72;719;39;1780.00;26
4462;39;628370914;4462;125;5177;5203;12.15;0.74;224.54;4.72;715;39;1781.00;26
4463;39;628370926;4463;123;5179;5206;12.18;0.74;224.52;4.72;716;39;1782.00;27
4467;39;628370938;4467;125;5179;5206;12.19;0.74;224.69;4.72;712;39;1783.00;27
4471;39;628370949;4471;124;5180;5206;12.27;0.74;224.77;4.72;709;39;1784.00;26
4472;39;628370960;4472;125;5180;5206;12.29;0.74;224.73;4.72;708;39;1785.00;26
4476;39;628370971;4476;125;5184;5212;12.30;0.74;224.77;4.72;708;39;1786.00;28
4479;39;628370988;4479;123;5184;5212;12.42;0.75;224.87;4.72;705;39;1787.00;28
4481;39;628370999;4481;126;5185;5212;12.43;0.75;224.88;4.72;704;39;1788.00;27
4484;39;628371009;4484;122;5185;5212;12.35;0.75;224.98;4.72;701;39;1789.00;27
4484;39;628371021;4484;123;5188;5216;12.28;0.74;224.98;4.72;704;39;1790.00;28
4487;39;628371032;4487;124;5189;5217;12.28;0.75;225.06;4.71;702;39;1791.00;28
4490;39;628371042;4490;127;5189;5217;12.27;0.75;225.10;4.71;699;39;1792.00;28
4491;39;628371053;4491;125;5190;5218;12.29;0.75;225.08;4.71;699;39;1793.00;28
4496;39;628371064;4496;130;5190;5218;12.26;0.75;225.15;4.71;694;39;1794.00;28
4498;39;628371074;4498;128;5190;5218;12.34;0.75;225.16;4.71;692;39;1795.00;28
4503;39;628371085;4503;127;5190;5218;12.34;0.75;225.22;4.71;687;39;1796.00;28
4506;39;628371095;4506;126;5190;5218;12.38;0.75;225.27;4.71;684;39;1797.00;28
4509;39;628371105;4509;124;5190;5218;12.41;0.76;225.36;4.71;681;39;1798.00;28
4512;39;628371116;4512;122;5191;5218;12.45;0.76;225.38;4.78;679;39;1799.00;27
4515;39;628371128;4515;143;5255;5356;11.95;0.74;225.45;4.72;740;39;1800.00;101
4517;39;628371154;4517;135;5256;5357;12.01;0.74;225.47;4.72;739;39;1801.00;101
4519;39;628371164;4519;124;5265;5357;12.07;0.74;225.56;4.72;746;39;1802.00;92
4523;39;628371175;4523;116;5267;5357;12.18;0.75;225.69;4.72;744;39;1803.00;90
4528;39;628371185;4528;106;5272;5357;12.22;0.75;225.74;4.72;744;39;1804.00;85
4536;39;628371196;4536;109;5276;5357;12.21;0.75;225.71;4.73;740;39;1805.00;81
4538;39;628371214;4538;103;5280;5357;12.27;0.75;225.76;4.73;742;39;1806.00;77
4541;39;628371224;4541;103;5282;5357;12.33;0.76;225.78;4.73;741;39;1807.00;75
4546;39;628371234;4546;97;5287;5358;12.36;0.76;225.83;4.73;741;39;1808.00;71
4548;39;628371245;4548;95;5287;5359;12.37;0.76;225.77;4.73;739;39;1809.00;72
4553;39;628371261;4553;93;5291;5359;12.37;0.76;225.83;4.74;738;39;1810.00;68
4558;39;628371272;4558;91;5299;5363;12.31;0.76;225.84;4.74;741;39;1811.00;64
4561;39;628371284;4561;90;5300;5363;12.31;0.76;225.98;4.74;739;39;1812.00;63
4564;39;628371294;4564;87;5301;5363;12.25;0.75;226.01;4.74;737;39;1813.00;62
4569;39;628371310;4569;92;5301;5363;12.16;0.75;225.95;4.74;732;39;1814.00;62
4570;39;628371321;4570;94;5305;5369;12.11;0.74;225.95;4.81;735;39;1815.00;64
4575;39;628371332;4575;99;5306;5369;12.01;0.74;225.92;4.81;731;39;1816.00;63
4579;39;628371343;4579;106;5307;5369;11.98;0.73;225.94;4.82;728;39;1817.00;62
4584;39;628371354;4584;110;5311;5372;11.90;0.73;225.95;4.89;727;39;1818.00;61
4584;39;628371365;4584;112;5311;5372;11.89;0.73;225.95;4.89;727;39;1819.00;61
4586;39;628371380;4586;111;5312;5372;11.85;0.73;225.92;4.89;726;39;1820.00;60
4589;39;628371391;4589;120;5314;5373;11.82;0.73;225.94;4.96;725;39;1821.00;59
4594;39;628371402;4594;126;5317;5374;11.80;0.72;225.95;4.97;723;39;1822.00;57
4599;39;628371420;4599;128;5317;5374;11.79;0.72;225.99;4.97;718;39;1823.00;57
4600;39;628371433;4600;129;5326;5387;11.66;0.71;225.98;4.96;726;39;1824.00;61
4603;39;628371445;4603;136;5326;5387;11.64;0.71;225.96;4.96;723;39;1825.00;61
4605;39;628371456;4605;139;5329;5387;11.54;0.71;225.97;5.04;724;39;1826.00;58
4607;39;628371467;4607;145;5330;5388;11.49;0.70;225.95;5.04;723;39;1827.00;58
4613;39;628371478;4613;151;5331;5388;11.41;0.69;225.88;5.04;718;39;1828.00;57
4615;39;628371496;4615;157;5335;5392;11.35;0.69;225.85;5.05;720;39;1829.00;57
4618;39;628371509;4618;160;5337;5392;11.25;0.69;225.86;5.06;719;39;1830.00;55
4621;39;628371520;4621;163;5341;5396;11.14;0.68;225.84;5.06;720;39;1831.00;55
4621;39;628371531;4621;174;5343;5396;11.09;0.68;225.84;5.07;722;39;1832.00;53
4623;39;628371541;4623;172;5345;5396;11.02;0.67;225.80;5.08;722;39;1833.00;51
4626;39;628371551;4626;176;5346;5396;10.88;0.66;225.90;5.09;720;39;1834.00;50
4629;39;628371563;4629;182;5348;5396;10.70;0.65;225.95;5.10;719;39;1835.00;48
4634;39;628371573;4634;188;5358;5408;10.59;0.65;226.20;5.09;724;39;1836.00;50
4634;39;628371584;4634;193;5361;5408;10.51;0.64;226.20;5.10;727;39;1837.00;47
4637;39;628371594;4637;198;5365;5408;10.40;0.64;226.23;5.11;728;39;1838.00;43
4640;39;628371603;4640;205;5366;5408;10.34;0.63;226.38;5.12;726;39;1839.00;42
4642;39;628371613;4642;210;5368;5408;10.23;0.63;226.36;5.13;726;39;1840.00;40
4644;39;628371623;4644;218;5369;5408;10.06;0.62;226.40;5.13;725;39;1841.00;39
4649;39;628371633;4649;223;5369;5409;9.98;0.61;226.34;5.13;720;39;1842.00;40
4652;39;628371644;4652;233;5371;5409;9.89;0.60;226.35;5.14;719;39;1843.00;38
4653;39;628371656;4653;239;5375;5415;9.87;0.60;226.33;5.14;722;39;1844.00;40
4656;39;628371667;4656;244;5378;5417;9.74;0.59;226.30;5.14;722;39;1845.00;39
4658;39;628371677;4658;253;5380;5417;9.57;0.58;226.26;5.15;722;39;1846.00;37
4662;39;628371692;4662;255;5381;5417;9.40;0.58;226.19;5.15;719;39;1847.00;36
4663;39;628371710;4663;259;5386;5421;9.26;0.57;226.24;5.16;723;39;1848.00;35
4664;39;628371732;4664;261;5387;5421;9.12;0.56;226.23;5.16;723;39;1849.00;34
4666;39;628371747;4666;264;5387;5421;9.03;0.55;226.26;5.16;721;39;1850.00;34
4668;39;628371759;4668;267;5389;5422;8.91;0.55;226.34;5.16;721;39;1851.00;33
4672;40;628371774;4672;271;5393;5426;8.70;0.53;226.41;5.16;721;40;1852.00;33
4672;40;628371817;4672;269;5393;5426;8.60;0.53;226.41;5.16;721;40;1853.00;33
4677;40;628371828;4677;267;5396;5429;8.44;0.52;226.53;5.15;719;40;1854.00;33
4680;40;628371844;4680;268;5396;5429;8.27;0.51;226.55;5.15;716;40;1855.00;33
4684;40;628371853;4684;271;5397;5429;8.21;0.50;226.45;5.15;713;40;1856.00;32
4688;40;628371868;4688;271;5398;5429;8.14;0.50;226.44;5.15;710;40;1857.00;31
4691;40;628371877;4691;275;5401;5433;8.06;0.49;226.36;5.15;710;40;1858.00;32
4692;40;628371886;4692;278;5401;5433;7.96;0.49;226.34;5.15;709;40;1859.00;32
4693;40;628371897;4693;282;5402;5433;7.94;0.49;226.32;5.15;709;40;1860.00;31
4695;40;628371906;4695;284;5402;5433;7.85;0.48;226.33;5.15;707;40;1861.00;31
4698;40;628371915;4698;278;5403;5434;7.70;0.47;226.50;5.15;705;40;1862.00;31
4703;40;628371923;4703;283;5404;5435;7.57;0.47;226.45;5.15;701;40;1863.00;31
4707;40;628371932;4707;283;5404;5435;7.44;0.46;226.44;5.15;697;40;1864.00;31
4711;40;628371947;4711;286;5405;5436;7.28;0.45;226.35;5.15;694;40;1865.00;31
4714;40;628371955;4714;291;5405;5436;7.06;0.44;226.26;5.15;691;40;1866.00;31
4717;40;628371963;4717;299;5405;5436;6.93;0.43;226.24;5.15;688;40;1867.00;31
4719;40;628371974;4719;303;5405;5436;6.77;0.42;226.24;5.15;686;40;1868.00;31
4722;40;628371981;4722;312;5405;5436;6.64;0.41;226.33;5.15;683;40;1869.00;31
4725;40;628371988;4725;314;5405;5436;6.57;0.41;226.38;5.15;680;40;1870.00;31
4728;40;628371996;4728;319;5405;5436;6.49;0.40;226.46;5.15;677;40;1871.00;31
4733;40;628372005;4733;335;5475;5563;6.79;0.43;226.35;5.08;742;40;1872.00;88
4736;40;628372027;4736;323;5480;5564;6.78;0.43;226.39;5.08;744;40;1873.00;84
4738;40;628372036;4738;315;5488;5564;6.84;0.43;226.40;5.08;750;40;1874.00;76
4740;40;628372044;4740;320;5494;5564;6.85;0.43;226.42;5.07;754;40;1875.00;70
4742;40;628372052;4742;321;5499;5564;6.83;0.43;226.40;5.07;757;40;1876.00;65
4744;40;628372060;4744;314;5506;5564;6.83;0.43;226.46;5.07;762;40;1877.00;58
4745;40;628372069;4745;309;5511;5564;6.93;0.43;226.43;5.07;766;40;1878.00;53
4751;40;628372077;4751;304;5514;5564;6.92;0.43;226.41;5.07;763;40;1879.00;50
4751;40;628372086;4751;299;5518;5565;6.99;0.43;226.41;5.08;767;40;1880.00;47
4753;40;628372096;4753;298;5520;5566;6.98;0.43;226.48;5.16;767;40;1881.00;46
4756;40;628372105;4756;298;5524;5568;7.03;0.44;226.46;5.16;768;40;1882.00;44
4757;40;628372114;4757;300;5526;5569;7.00;0.44;226.49;5.16;769;40;1883.00;43
4760;40;628372123;4760;307;5528;5569;7.05;0.44;226.50;5.16;768;40;1884.00;41
4764;40;628372133;4764;310;5529;5569;6.97;0.43;226.56;5.16;765;40;1885.00;40
4767;40;628372149;4767;310;5531;5569;6.98;0.43;226.48;5.16;764;40;1886.00;38
4770;40;628372159;4770;315;5534;5573;6.96;0.43;226.55;5.16;764;40;1887.00;39
4774;40;628372169;4774;318;5536;5573;6.95;0.43;226.55;5.17;762;40;1888.00;37
4776;40;628372178;4776;316;5537;5573;6.89;0.43;226.57;5.17;761;40;1889.00;36
4781;40;628372189;4781;312;5540;5579;6.88;0.42;226.57;5.17;759;40;1890.00;39
4785;40;628372199;4785;305;5541;5579;6.84;0.42;226.48;5.17;756;40;1891.00;38
4786;40;628372208;4786;295;5543;5579;6.85;0.42;226.52;5.17;757;40;1892.00;36
4789;40;628372219;4789;287;5547;5583;6.94;0.43;226.51;5.17;758;40;1893.00;36
4793;40;628372229;4793;288;5550;5584;7.00;0.43;226.51;5.17;757;40;1894.00;34
4796;40;628372239;4796;284;5551;5584;7.06;0.43;226.46;5.17;755;40;1895.00;33
4800;40;628372250;4800;274;5556;5588;7.11;0.44;226.45;5.16;756;40;1896.00;32
4804;40;628372261;4804;277;5557;5588;7.07;0.43;226.54;5.24;753;40;1897.00;31
4806;40;628372283;4806;274;5557;5588;7.14;0.44;226.50;5.24;751;40;1898.00;31
4811;40;628372301;4811;269;5558;5589;7.15;0.44;226.58;5.24;747;40;1899.00;31
4816;40;628372313;4816;270;5558;5589;7.19;0.44;226.56;5.24;742;40;1900.00;31
4819;40;628372328;4819;270;5563;5595;7.28;0.44;226.45;5.24;744;40;1901.00;32
4822;40;628372339;4822;266;5563;5595;7.36;0.45;226.48;5.24;741;40;1902.00;32
4824;40;628372350;4824;263;5565;5596;7.51;0.46;226.48;5.24;741;40;1903.00;31
4824;40;628372360;4824;260;5565;5596;7.65;0.47;226.48;5.24;741;40;1904.00;31
4830;40;628372370;4830;264;5565;5596;7.77;0.47;226.47;5.24;735;40;1905.00;31
4833;40;628372382;4833;262;5565;5596;7.82;0.48;226.56;5.24;732;40;1906.00;31
4835;40;628372393;4835;266;5565;5596;7.89;0.48;226.60;5.24;730;40;1907.00;31
4838;40;628372403;4838;271;5577;5608;8.08;0.49;226.63;5.31;739;40;1908.00;31
4841;40;628372415;4841;267;5578;5608;8.17;0.50;226.68;5.31;737;40;1909.00;30
4844;40;628372425;4844;270;5578;5608;8.25;0.50;226.64;5.31;734;40;1910.00;30
4847;40;628372437;4847;263;5579;5608;8.30;0.50;226.67;5.39;732;40;1911.00;29
4848;40;628372449;4848;265;5579;5608;8.36;0.51;226.70;5.39;731;40;1912.00;29
4851;40;628372461;4851;268;5579;5608;8.40;0.51;226.71;5.39;728;40;1913.00;29
4854;40;628372473;4854;265;5583;5612;8.45;0.51;226.73;5.39;729;40;1914.00;29
4856;40;628372485;4856;269;5583;5612;8.57;0.52;226.77;5.39;727;40;1915.00;29
4859;40;628372495;4859;273;5586;5616;8.57;0.52;226.86;5.39;727;40;1916.00;30
4863;40;628372506;4863;257;5587;5617;8.60;0.52;226.86;5.39;724;40;1917.00;30
4865;40;628372517;4865;249;5588;5617;8.68;0.53;226.94;5.39;723;40;1918.00;29
4867;40;628372529;4867;239;5588;5617;8.74;0.53;226.98;5.39;721;40;1919.00;29
4868;40;628372541;4868;238;5609;5646;8.87;0.54;227.00;5.37;741;40;1920.00;37
4871;40;628372554;4871;230;5610;5646;8.95;0.54;227.07;5.37;739;40;1921.00;36
4873;40;628372566;4873;222;5611;5646;9.14;0.56;227.12;5.36;738;40;1922.00;35
4879;40;628372577;4879;217;5612;5647;9.23;0.56;227.11;5.36;733;40;1923.00;35
4880;40;628372588;4880;215;5613;5648;9.34;0.57;227.12;5.36;733;40;1924.00;35
4884;40;628372600;4884;212;5614;5648;9.36;0.57;227.15;5.36;730;40;1925.00;34
4889;40;628372612;4889;193;5617;5651;9.42;0.57;227.15;5.36;728;40;1926.00;34
4892;40;628372631;4892;174;5617;5651;9.52;0.58;227.27;5.36;725;40;1927.00;34
4895;40;628372643;4895;165;5617;5651;9.63;0.58;227.32;5.36;722;40;1928.00;34
4897;40;628372654;4897;159;5617;5651;9.72;0.59;227.38;5.36;720;40;1929.00;34
4898;40;628372667;4898;152;5621;5657;9.84;0.59;227.40;5.36;723;40;1930.00;36
4900;40;628372680;4900;145;5621;5657;9.95;0.60;227.44;5.36;721;40;1931.00;36
4903;40;628372694;4903;137;5622;5657;10.07;0.61;227.48;5.36;719;40;1932.00;35
4907;40;628372708;4907;136;5622;5657;10.23;0.62;227.48;5.36;715;40;1933.00;35
4910;40;628372727;4910;138;5625;5661;10.35;0.63;227.48;5.35;715;40;1934.00;36
4914;40;628372740;4914;133;5627;5663;10.48;0.64;227.46;5.35;713;40;1935.00;36
4915;40;628372752;4915;134;5627;5663;10.62;0.64;227.49;5.35;712;40;1936.00;36
4921;40;628372763;4921;126;5628;5664;10.72;0.65;227.53;5.35;707;40;1937.00;36
4924;40;628372775;4924;126;5628;5664;10.82;0.65;227.62;5.35;704;40;1938.00;36
4926;40;628372787;4926;124;5628;5664;10.99;0.66;227.58;5.35;702;40;1939.00;36
4928;40;628372799;4928;125;5628;5664;11.06;0.67;227.65;5.35;700;40;1940.00;36
4929;40;628372811;4929;123;5628;5664;11.16;0.68;227.68;5.35;699;40;1941.00;36
4932;40;628372822;4932;122;5628;5664;11.30;0.68;227.71;5.35;696;40;1942.00;36
4932;40;628372833;4932;117;5628;5664;11.42;0.69;227.71;5.35;696;40;1943.00;36
4935;40;628372844;4935;135;5672;5734;11.25;0.68;227.81;5.31;737;40;1944.00;62
4937;40;628372860;4937;124;5673;5735;11.37;0.69;227.84;5.40;736;40;1945.00;62
4939;40;628372872;4939;116;5678;5735;11.54;0.70;227.91;5.40;739;40;1946.00;57
4942;40;628372883;4942;113;5679;5735;11.66;0.71;227.95;5.40;737;40;1947.00;56
4943;40;628372894;4943;115;5683;5735;11.83;0.72;227.97;5.39;740;40;1948.00;52
4946;40;628372906;4946;117;5685;5735;11.97;0.73;227.96;5.39;739;40;1949.00;50
4948;40;628372925;4948;124;5689;5737;12.04;0.73;228.01;5.39;741;40;1950.00;48
4951;40;628372942;4951;125;5690;5737;12.12;0.74;228.01;5.39;739;40;1951.00;47
4956;40;628372953;4956;127;5692;5738;12.10;0.74;228.08;5.39;736;40;1952.00;46
4957;40;628372965;4957;129;5694;5739;12.15;0.74;228.14;5.39;737;40;1953.00;45
4960;40;628372976;4960;134;5696;5739;12.11;0.74;228.19;5.40;736;40;1954.00;43
4963;40;628372987;4963;135;5700;5743;12.07;0.74;228.22;5.39;737;40;1955.00;43
4965;40;628372998;4965;141;5702;5743;11.99;0.73;228.30;5.39;737;40;1956.00;41
4966;40;628373009;4966;141;5702;5743;11.94;0.73;228.28;5.39;736;40;1957.00;41
4968;40;628373020;4968;138;5702;5743;11.90;0.73;228.31;5.39;734;40;1958.00;41
4974;40;628373031;4974;136;5707;5749;11.84;0.72;228.34;5.39;733;40;1959.00;42
4979;41;628373042;4979;137;5707;5749;11.83;0.72;228.38;5.39;728;41;1960.00;42
4982;41;628373059;4982;139;5707;5749;11.76;0.72;228.40;5.39;725;41;1961.00;42
4985;41;628373070;4985;143;5710;5752;11.82;0.72;228.44;5.39;725;41;1962.00;42
4987;41;628373085;4987;145;5711;5752;11.83;0.72;228.43;5.48;724;41;1963.00;41
4989;41;628373095;4989;148;5711;5752;11.75;0.71;228.51;5.48;722;41;1964.00;41
4993;41;628373105;4993;154;5711;5753;11.72;0.71;228.52;5.48;718;41;1965.00;42
4997;42;628373115;4997;153;5712;5754;11.73;0.71;228.51;5.48;715;42;1966.00;42
5001;42;628373138;5001;154;5712;5754;11.82;0.72;228.59;5.48;711;42;1967.00;42
5002;42;628373148;5002;157;5721;5767;11.81;0.72;228.58;5.47;719;42;1968.00;46
5008;42;628373159;5008;154;5721;5767;11.87;0.72;228.55;5.47;713;42;1969.00;46
5014;42;628373169;5014;152;5721;5767;11.90;0.72;228.49;5.47;707;42;1970.00;46
5016;42;628373179;5016;146;5722;5768;11.91;0.72;228.45;5.47;706;42;1971.00;46
5021;42;628373189;5021;134;5722;5768;11.94;0.72;228.47;5.47;701;42;1972.00;46
5026;42;628373199;5026;128;5725;5772;12.00;0.73;228.49;5.47;699;42;1973.00;47
5029;42;628373210;5029;124;5727;5772;12.05;0.73;228.41;5.47;698;42;1974.00;45
5033;42;628373221;5033;124;5731;5776;12.06;0.73;228.56;5.48;698;42;1975.00;45
5036;42;628373232;5036;124;5731;5776;12.10;0.73;228.57;5.48;695;42;1976.00;45
5038;42;628373242;5038;122;5731;5776;12.18;0.74;228.58;5.48;693;42;1977.00;45
5041;42;628373254;5041;116;5731;5776;12.21;0.74;228.59;5.48;690;42;1978.00;45
5044;42;628373265;5044;114;5731;5776;12.23;0.74;228.67;5.48;687;42;1979.00;45
5044;42;628373277;5044;115;5750;5810;12.21;0.74;228.67;5.46;706;42;1980.00;60
5047;42;628373289;5047;112;5752;5810;12.17;0.74;228.80;5.55;705;42;1981.00;58
5050;42;628373299;5050;108;5754;5810;12.13;0.74;228.78;5.55;704;42;1982.00;56
5054;42;628373309;5054;109;5754;5810;12.15;0.74;228.86;5.55;700;42;1983.00;56
5056;42;628373319;5056;112;5755;5810;12.11;0.74;228.91;5.55;699;42;1984.00;55
5060;42;628373329;5060;108;5755;5810;12.17;0.74;228.92;5.55;695;42;1985.00;55
5064;42;628373339;5064;109;5756;5811;12.21;0.75;228.91;5.55;692;42;1986.00;55
5068;42;628373350;5068;113;5757;5811;12.23;0.75;228.92;5.56;689;42;1987.00;54
5076;42;628373360;5076;117;5760;5817;12.18;0.74;228.80;5.55;684;42;1988.00;57
5079;42;628373371;5079;120;5764;5818;12.15;0.74;228.80;5.55;685;42;1989.00;54
5082;42;628373381;5082;119;5764;5818;12.14;0.74;228.81;5.55;682;42;1990.00;54
5088;42;628373392;5088;125;5765;5818;12.05;0.73;228.79;5.56;677;42;1991.00;53
5090;43;628373402;5090;131;5768;5822;11.91;0.72;228.84;5.56;678;43;1992.00;54
5092;43;628373433;5092;133;5769;5822;11.80;0.72;228.82;5.56;677;43;1993.00;53
5094;43;628373443;5094;141;5769;5822;11.70;0.71;228.83;5.56;675;43;1994.00;53
5099;43;628373452;5099;144;5771;5823;11.61;0.70;228.83;5.56;672;43;1995.00;52
5102;43;628373462;5102;152;5775;5827;11.42;0.69;228.76;5.57;673;43;1996.00;52
5103;43;628373473;5103;159;5775;5827;11.30;0.69;228.81;5.57;672;43;1997.00;52
5104;43;628373483;5104;160;5778;5830;11.21;0.68;228.80;5.57;674;43;1998.00;52
5106;43;628373493;5106;167;5780;5830;11.11;0.68;228.91;5.58;674;43;1999.00;50
5107;43;628373503;5107;174;5781;5830;11.00;0.67;228.92;5.59;674;43;2000.00;49
5110;43;628373516;5110;174;5782;5830;10.91;0.67;228.96;5.59;672;43;2001.00;48
5113;43;628373526;5113;181;5786;5834;10.86;0.66;229.04;5.59;673;43;2002.00;48
5114;43;628373536;5114;185;5789;5834;10.78;0.66;229.01;5.60;675;43;2003.00;45
5116;43;628373545;5116;194;5790;5834;10.66;0.65;229.00;5.61;674;43;2004.00;44
5121;43;628373554;5121;202;5791;5834;10.48;0.64;229.05;5.62;670;43;2005.00;43
5122;43;628373564;5122;210;5792;5835;10.27;0.63;229.02;5.62;670;43;2006.00;43
5124;43;628373573;5124;215;5793;5836;10.12;0.62;228.97;5.62;669;43;2007.00;43
5124;43;628373582;5124;221;5794;5836;10.01;0.61;228.97;5.63;670;43;2008.00;42
5126;43;628373591;5126;232;5796;5837;9.83;0.60;229.08;5.63;670;43;2009.00;41
5128;43;628373607;5128;240;5797;5837;9.68;0.59;229.19;5.64;669;43;2010.00;40
5131;43;628373621;5131;246;5797;5837;9.50;0.58;229.14;5.64;666;43;2011.00;40
5132;43;628373630;5132;251;5799;5837;9.41;0.57;229.11;5.66;667;43;2012.00;38
5135;43;628373639;5135;260;5800;5837;9.27;0.57;229.06;5.67;665;43;2013.00;37
5137;43;628373647;5137;265;5800;5837;9.15;0.56;229.02;5.67;663;43;2014.00;37
5138;43;628373655;5138;271;5801;5837;9.03;0.55;229.00;5.67;663;43;2015.00;36
5141;43;628373663;5141;291;5863;5964;9.04;0.56;228.99;5.61;722;43;2016.00;101
5143;43;628373681;5143;292;5865;5965;8.85;0.55;228.94;5.62;722;43;2017.00;100
5145;43;628373694;5145;289;5876;5965;8.82;0.55;228.87;5.61;731;43;2018.00;89
5146;43;628373709;5146;286;5883;5965;8.71;0.54;228.91;5.61;737;43;2019.00;82
5147;43;628373721;5147;283;5888;5965;8.60;0.53;228.90;5.61;741;43;2020.00;77
5149;43;628373737;5149;284;5896;5965;8.53;0.53;228.85;5.61;747;43;2021.00;69
5149;43;628373751;5149;280;5902;5965;8.52;0.53;228.85;5.61;753;43;2022.00;63
5151;43;628373764;5151;281;5908;5965;8.47;0.52;228.89;5.62;757;43;2023.00;57
5156;43;628373779;5156;282;5912;5966;8.46;0.52;228.77;5.62;756;43;2024.00;54
5159;43;628373792;5159;283;5917;5968;8.43;0.52;228.70;5.62;758;43;2025.00;51
5161;43;628373804;5161;287;5920;5968;8.39;0.52;228.65;5.63;759;43;2026.00;48
5163;43;628373815;5163;284;5922;5969;8.32;0.51;228.61;5.63;759;43;2027.00;47
5164;43;628373825;5164;293;5927;5969;8.19;0.50;228.59;5.63;763;43;2028.00;42
5164;43;628373836;5164;300;5928;5969;8.06;0.50;228.59;5.63;764;43;2029.00;41
5167;43;628373846;5167;303;5931;5969;7.90;0.49;228.53;5.64;764;43;2030.00;38
5168;43;628373856;5168;306;5933;5973;7.75;0.48;228.54;5.63;765;43;2031.00;40
5169;43;628373866;5169;313;5935;5973;7.64;0.47;228.56;5.64;766;43;2032.00;38
5172;43;628373876;5172;328;5936;5973;7.49;0.46;228.71;5.64;764;43;2033.00;37
5174;43;628373886;5174;336;5939;5976;7.36;0.45;228.68;5.64;765;43;2034.00;37
5178;43;628373896;5178;343;5939;5976;7.21;0.44;228.75;5.64;761;43;2035.00;37
5181;43;628373905;5181;347;5941;5976;7.07;0.44;228.87;5.64;760;43;2036.00;35
5181;43;628373922;5181;350;5945;5980;6.92;0.43;228.87;5.64;764;43;2037.00;35
5185;43;628373931;5185;354;5947;5981;6.73;0.42;228.95;5.64;762;43;2038.00;34
5186;43;628373940;5186;359;5947;5981;6.62;0.41;228.92;5.64;761;43;2039.00;34
5190;43;628373950;5190;352;5953;5986;6.57;0.41;228.94;5.63;763;43;2040.00;33
5193;43;628373959;5193;351;5953;5986;6.44;0.40;228.89;5.63;760;43;2041.00;33
5196;43;628373969;5196;347;5953;5986;6.34;0.39;228.87;5.63;757;43;2042.00;33
5199;43;628373978;5199;334;5954;5987;6.37;0.39;228.99;5.63;755;43;2043.00;33
5201;43;628373987;5201;321;5954;5987;6.37;0.39;228.94;5.63;753;43;2044.00;33
5205;43;628373996;5205;310;5959;5993;6.41;0.40;228.97;5.63;754;43;2045.00;34
5207;43;628374006;5207;298;5959;5993;6.44;0.40;229.03;5.63;752;43;2046.00;34
5210;43;628374016;5210;286;5961;5994;6.53;0.40;228.99;5.63;751;43;2047.00;33
5213;43;628374025;5213;270;5961;5994;6.60;0.41;228.96;5.63;748;43;2048.00;33
5216;43;628374035;5216;264;5961;5994;6.72;0.41;228.99;5.63;745;43;2049.00;33
5216;43;628374051;5216;250;5961;5994;6.85;0.42;228.99;5.63;745;43;2050.00;33
5219;43;628374060;5219;240;5962;5994;6.97;0.43;229.01;5.72;743;43;2051.00;32
5222;43;628374070;5222;234;5972;6006;7.15;0.44;229.06;5.71;750;43;2052.00;34
5224;43;628374081;5224;224;5972;6006;7.27;0.45;229.01;5.71;748;43;2053.00;34
5227;43;628374090;5227;221;5974;6006;7.39;0.45;228.99;5.71;747;43;2054.00;32
5229;43;628374106;5229;223;5974;6006;7.50;0.46;229.02;5.71;745;43;2055.00;32
5235;43;628374116;5235;222;5974;6006;7.58;0.46;229.15;5.71;739;43;2056.00;32
5236;43;628374126;5236;226;5974;6006;7.72;0.47;229.18;5.71;738;43;2057.00;32
5238;43;628374136;5238;228;5978;6010;7.85;0.48;229.22;5.70;740;43;2058.00;32
5238;43;628374146;5238;225;5978;6010;8.02;0.49;229.22;5.70;740;43;2059.00;32
5242;43;628374156;5242;224;5981;6014;8.09;0.49;229.27;5.70;739;43;2060.00;33
5243;43;628374167;5243;224;5982;6015;8.17;0.50;229.29;5.70;739;43;2061.00;33
5245;43;628374176;5245;221;5983;6015;8.28;0.51;229.30;5.70;738;43;2062.00;32
5246;43;628374186;5246;227;5983;6015;8.36;0.51;229.31;5.70;737;43;2063.00;32
5253;43;628374196;5253;227;5995;6028;8.47;0.52;229.20;5.69;742;43;2064.00;33
5256;43;628374208;5256;226;5995;6028;8.50;0.52;229.26;5.69;739;43;2065.00;33
5263;43;628374220;5263;225;5996;6028;8.49;0.52;229.22;5.69;733;43;2066.00;32
5266;43;628374230;5266;217;5997;6029;8.53;0.52;229.18;5.69;731;43;2067.00;32
5270;43;628374242;5270;215;5998;6030;8.51;0.52;229.17;5.69;728;43;2068.00;32
5276;43;628374252;5276;212;5998;6030;8.47;0.52;229.27;5.69;722;43;2069.00;32
5281;43;628374266;5281;212;6001;6036;8.56;0.52;229.24;5.68;720;43;2070.00;35
5284;43;628374277;5284;211;6001;6036;8.58;0.52;229.28;5.68;717;43;2071.00;35
5290;43;628374289;5290;218;6002;6036;8.63;0.53;229.35;5.68;712;43;2072.00;34
5293;43;628374299;5293;216;6002;6036;8.64;0.53;229.27;5.68;709;43;2073.00;34
5298;43;628374310;5298;215;6007;6042;8.59;0.52;229.31;5.68;709;43;2074.00;35
5304;43;628374322;5304;218;6007;6042;8.52;0.52;229.30;5.68;703;43;2075.00;35
5307;43;628374333;5307;215;6008;6042;8.58;0.52;229.30;5.68;701;43;2076.00;34
5313;43;628374343;5313;212;6009;6042;8.55;0.52;229.30;5.76;696;43;2077.00;33
5318;43;628374354;5318;212;6014;6046;8.61;0.52;229.25;5.76;696;43;2078.00;32
5322;43;628374364;5322;207;6015;6047;8.69;0.53;229.41;5.76;693;43;2079.00;32
5325;43;628374375;5325;208;6016;6047;8.70;0.53;229.45;5.76;691;43;2080.00;31
5328;43;628374385;5328;210;6017;6048;8.74;0.53;229.43;5.75;689;43;2081.00;31
5333;43;628374395;5333;212;6017;6048;8.71;0.53;229.59;5.75;684;43;2082.00;31
5335;43;628374406;5335;214;6017;6048;8.76;0.53;229.63;5.75;682;43;2083.00;31
5336;43;628374417;5336;216;6017;6048;8.82;0.54;229.70;5.75;681;43;2084.00;31
5339;43;628374428;5339;218;6017;6048;8.87;0.54;229.78;5.75;678;43;2085.00;31
5341;43;628374438;5341;219;6017;6048;8.92;0.54;229.75;5.75;676;43;2086.00;31
5347;43;628374449;5347;206;6017;6048;8.88;0.54;229.84;5.75;670;43;2087.00;31
5348;43;628374459;5348;206;6061;6118;8.90;0.54;229.88;5.71;713;43;2088.00;57
5351;43;628374476;5351;189;6062;6119;8.95;0.55;229.89;5.71;711;43;2089.00;57
5354;43;628374487;5354;176;6066;6119;9.10;0.56;229.92;5.71;712;43;2090.00;53
5355;43;628374499;5355;169;6069;6119;9.26;0.57;229.92;5.71;714;43;2091.00;50
5357;43;628374510;5357;167;6072;6119;9.47;0.58;230.01;5.71;715;43;2092.00;47
5362;43;628374521;5362;172;6077;6119;9.68;0.59;230.05;5.71;715;43;2093.00;42
5364;43;628374532;5364;169;6081;6119;9.82;0.60;230.03;5.71;717;43;2094.00;38
5366;43;628374543;5366;172;6083;6119;9.95;0.61;230.11;5.71;717;43;2095.00;36
5369;43;628374554;5369;157;6086;6120;10.04;0.61;230.17;5.71;717;43;2096.00;34
5371;43;628374566;5371;147;6087;6121;10.11;0.62;230.19;5.71;716;43;2097.00;34
5378;43;628374578;5378;141;6088;6121;10.11;0.61;230.22;5.71;710;43;2098.00;33
5380;43;628374596;5380;139;6092;6125;10.18;0.62;230.23;5.79;712;43;2099.00;33
5384;43;628374611;5384;146;6096;6140;10.21;0.62;230.26;5.78;712;43;2100.00;44
5385;43;628374630;5385;139;6096;6140;10.42;0.63;230.29;5.78;711;43;2101.00;44
5391;43;628374643;5391;138;6096;6140;10.58;0.64;230.38;5.78;705;43;2102.00;44
5393;43;628374656;5393;132;6099;6146;10.76;0.65;230.40;5.78;706;43;2103.00;47
5395;43;628374668;5395;132;6099;6146;10.94;0.67;230.40;5.78;704;43;2104.00;47
5397;43;628374681;5397;130;6099;6146;11.04;0.67;230.43;5.78;702;43;2105.00;47
5399;43;628374700;5399;129;6103;6149;11.17;0.68;230.45;5.78;704;43;2106.00;46
5401;43;628374734;5401;124;6103;6149;11.28;0.69;230.49;5.78;702;43;2107.00;46
5404;43;628374751;5404;121;6103;6149;11.34;0.69;230.52;5.78;699;43;2108.00;46
5407;43;628374763;5407;119;6103;6150;11.39;0.69;230.69;5.78;696;43;2109.00;47
5410;43;628374781;5410;115;6104;6151;11.43;0.70;230.76;5.78;694;43;2110.00;47
5414;43;628374798;5414;118;6105;6151;11.47;0.70;230.77;5.78;691;43;2111.00;46
5418;43;628374809;5418;123;6115;6164;11.41;0.69;230.75;5.77;697;43;2112.00;49
5421;43;628374821;5421;120;6115;6164;11.48;0.70;230.80;5.77;694;43;2113.00;49
5423;43;628374832;5423;126;6115;6164;11.53;0.70;230.81;5.77;692;43;2114.00;49
5425;43;628374843;5425;132;6117;6166;11.61;0.71;230.92;5.77;692;43;2115.00;49
5427;43;628374854;5427;134;6117;6166;11.66;0.71;231.00;5.77;690;43;2116.00;49
5430;43;628374866;5430;135;6120;6170;11.70;0.71;231.06;5.77;690;43;2117.00;50
5432;43;628374877;5432;136;6121;6170;11.71;0.71;231.05;5.77;689;43;2118.00;49
5435;43;628374888;5435;141;6124;6174;11.75;0.72;231.17;5.77;689;43;2119.00;50
5438;43;628374898;5438;145;6124;6174;11.87;0.73;231.19;5.77;686;43;2120.00;50
5442;43;628374909;5442;146;6124;6174;11.93;0.73;231.23;5.77;682;43;2121.00;50
5447;44;628374925;5447;145;6124;6174;11.97;0.73;231.26;5.77;677;44;2122.00;50
5451;44;628374942;5451;146;6126;6174;11.96;0.73;231.29;5.78;675;44;2123.00;48
5453;44;628374952;5453;145;6136;6186;11.98;0.73;231.29;5.85;683;44;2124.00;50
5458;44;628374968;5458;147;6136;6186;12.01;0.73;231.28;5.85;678;44;2125.00;50
5459;44;628374979;5459;141;6138;6186;12.02;0.73;231.26;5.86;679;44;2126.00;48
5461;44;628374989;5461;139;6138;6186;12.03;0.73;231.27;5.86;677;44;2127.00;48
5465;44;628374999;5465;133;6139;6186;11.97;0.73;231.26;5.86;674;44;2128.00;47
5467;44;628375009;5467;129;6142;6186;12.00;0.73;231.29;5.87;675;44;2129.00;44
5472;44;628375021;5472;124;6142;6187;12.02;0.73;231.27;5.87;670;44;2130.00;45
5478;44;628375031;5478;128;6143;6187;12.08;0.73;231.22;5.87;665;44;2131.00;44
5479;44;628375041;5479;130;6147;6193;12.10;0.74;231.21;5.86;668;44;2132.00;46
5481;44;628375051;5481;134;6148;6194;12.04;0.73;231.25;5.86;667;44;2133.00;46
5486;44;628375060;5486;132;6149;6194;11.95;0.73;231.19;5.87;663;44;2134.00;45
5490;44;628375070;5490;135;6149;6194;11.83;0.72;231.23;5.87;659;44;2135.00;45
5493;44;628375080;5493;136;6153;6198;11.78;0.72;231.22;5.86;660;44;2136.00;45
5496;44;628375089;5496;139;6153;6198;11.72;0.72;231.28;5.86;657;44;2137.00;45
5499;44;628375098;5499;139;6154;6198;11.78;0.72;231.27;5.86;655;44;2138.00;44
5504;44;628375107;5504;138;6157;6199;11.82;0.72;231.28;5.95;653;44;2139.00;42
5507;45;628375116;5507;133;6160;6203;11.79;0.72;231.26;5.94;653;45;2140.00;43
5509;45;628375142;5509;131;6160;6203;11.88;0.72;231.25;5.94;651;45;2141.00;43
5513;45;628375151;5513;128;6164;6206;11.93;0.73;231.19;6.02;651;45;2142.00;42
5515;45;628375161;5515;130;6164;6206;12.00;0.73;231.18;6.02;649;45;2143.00;42
5521;45;628375170;5521;128;6164;6206;12.02;0.73;231.11;6.02;643;45;2144.00;42
5527;45;628375179;5527;126;6166;6206;11.94;0.73;231.11;6.03;639;45;2145.00;40
5531;46;628375188;5531;122;6170;6210;11.93;0.73;231.07;6.11;639;46;2146.00;40
5535;46;628375206;5535;119;6171;6210;11.90;0.72;231.06;6.11;636;46;2147.00;39
5541;46;628375218;5541;120;6172;6210;11.87;0.72;231.14;6.18;631;46;2148.00;38
5543;46;628375229;5543;118;6172;6210;11.93;0.73;231.12;6.18;629;46;2149.00;38
5544;46;628375244;5544;117;6173;6211;11.93;0.73;231.20;6.25;629;46;2150.00;38
5547;46;628375253;5547;115;6174;6212;11.89;0.72;231.18;6.25;627;46;2151.00;38
5549;46;628375262;5549;119;6174;6212;11.85;0.72;231.15;6.25;625;46;2152.00;38
5556;46;628375274;5556;120;6176;6213;11.80;0.72;231.17;6.31;620;46;2153.00;37
5559;46;628375286;5559;125;6176;6213;11.77;0.72;231.11;6.31;617;46;2154.00;37
5561;46;628375295;5561;129;6176;6213;11.67;0.71;231.11;6.31;615;46;2155.00;37
5562;46;628375304;5562;134;6176;6213;11.59;0.70;231.12;6.31;614;46;2156.00;37
5567;46;628375313;5567;138;6177;6213;11.46;0.70;231.14;6.37;610;46;2157.00;36
5570;46;628375321;5570;141;6177;6213;11.37;0.69;231.22;6.37;607;46;2158.00;36
5570;46;628375330;5570;141;6178;6213;11.32;0.69;231.22;6.43;608;46;2159.00;35
5572;46;628375340;5572;177;6275;6443;11.02;0.69;231.28;6.33;703;46;2160.00;168
5573;46;628375368;5573;172;6276;6444;10.95;0.68;231.26;6.33;703;46;2161.00;168
5575;46;628375377;5575;161;6285;6444;10.96;0.68;231.22;6.32;710;46;2162.00;159
5577;46;628375386;5577;162;6295;6444;10.95;0.68;231.20;6.37;718;46;2163.00;149
5578;46;628375396;5578;159;6303;6444;10.96;0.68;231.21;6.37;725;46;2164.00;141
5579;46;628375405;5579;161;6309;6444;10.90;0.68;231.21;6.37;730;46;2165.00;135
5581;46;628375420;5581;160;6316;6444;10.84;0.67;231.21;6.37;735;46;2166.00;128
5582;46;628375430;5582;168;6321;6444;10.75;0.67;231.21;6.37;739;46;2167.00;123
5584;47;628375445;5584;172;6325;6445;10.71;0.66;231.19;6.37;741;47;2168.00;120
5589;48;628375465;5589;179;6329;6446;10.58;0.66;231.06;6.37;740;48;2169.00;117
5593;48;628375483;5593;185;6333;6446;10.48;0.65;230.97;6.43;740;48;2170.00;113
5593;48;628375493;5593;197;6339;6447;10.32;0.64;230.97;6.44;746;48;2171.00;108
5595;48;628375510;5595;200;6345;6447;10.20;0.63;230.92;6.46;750;48;2172.00;102
5596;48;628375521;5596;210;6349;6447;10.10;0.62;230.88;6.46;753;48;2173.00;98
5598;48;628375532;5598;214;6354;6447;9.90;0.61;230.85;6.48;756;48;2174.00;93
5599;48;628375542;5599;218;6361;6451;9.69;0.60;230.83;6.49;762;48;2175.00;90
5601;48;628375553;5601;223;6364;6451;9.51;0.59;230.81;6.49;763;48;2176.00;87
5602;48;628375564;5602;235;6366;6451;9.35;0.57;230.83;6.49;764;48;2177.00;85
5602;48;628375574;5602;237;6372;6454;9.21;0.57;230.83;6.53;770;48;2178.00;82
5603;48;628375583;5603;245;6374;6454;9.01;0.55;230.83;6.54;771;48;2179.00;80
5606;48;628375599;5606;258;6378;6454;8.78;0.54;230.85;6.55;772;48;2180.00;76
5607;48;628375609;5607;265;6386;6458;8.68;0.53;230.82;6.57;779;48;2181.00;72
5609;48;628375619;5609;273;6388;6459;8.59;0.53;230.74;6.57;779;48;2182.00;71
5611;48;628375629;5611;277;6394;6459;8.49;0.52;230.83;6.59;783;48;2183.00;65
5614;48;628375639;5614;284;6397;6463;8.40;0.51;230.82;6.59;783;48;2184.00;66
5616;48;628375649;5616;286;6399;6463;8.30;0.51;230.84;6.59;783;48;2185.00;64
5618;48;628375659;5618;296;6405;6463;8.10;0.50;230.79;6.61;787;48;2186.00;58
5619;48;628375669;5619;306;6406;6464;7.96;0.49;230.75;6.61;787;48;2187.00;58
5619;48;628375678;5619;317;6409;6464;7.80;0.48;230.75;6.62;790;48;2188.00;55
5621;48;628375691;5621;320;6416;6470;7.73;0.47;230.71;6.63;795;48;2189.00;54
5625;48;628375707;5625;321;6418;6470;7.60;0.46;230.60;6.63;793;48;2190.00;52
5625;48;628375730;5625;326;6419;6471;7.54;0.46;230.60;6.64;794;48;2191.00;52
5626;48;628375746;5626;331;6423;6471;7.38;0.45;230.62;6.65;797;48;2192.00;48
5626;48;628375759;5626;339;6425;6471;7.31;0.45;230.62;6.65;799;48;2193.00;46
5628;48;628375772;5628;349;6426;6471;7.27;0.44;230.63;6.65;798;48;2194.00;45
5630;48;628375787;5630;343;6429;6471;7.20;0.44;230.62;6.66;799;48;2195.00;42
5631;48;628375802;5631;335;6439;6483;7.25;0.44;230.60;6.65;808;48;2196.00;44
5632;48;628375817;5632;333;6441;6483;7.21;0.44;230.56;6.66;809;48;2197.00;42
5633;48;628375829;5633;332;6442;6483;7.20;0.44;230.54;6.66;809;48;2198.00;41
5634;48;628375839;5634;330;6443;6483;7.20;0.44;230.51;6.66;809;48;2199.00;40
5636;48;628375853;5636;334;6443;6483;7.17;0.44;230.46;6.66;807;48;2200.00;40
5636;48;628375879;5636;334;6443;6483;7.15;0.44;230.46;6.66;807;48;2201.00;40
5639;48;628375899;5639;333;6447;6487;7.16;0.44;230.45;6.66;808;48;2202.00;40
5640;48;628375910;5640;325;6448;6487;7.16;0.44;230.43;6.66;808;48;2203.00;39
5641;48;628375920;5641;319;6453;6491;7.19;0.44;230.44;6.66;812;48;2204.00;38
5645;48;628375930;5645;312;6455;6493;7.19;0.44;230.50;6.66;810;48;2205.00;38
5646;48;628375940;5646;314;6457;6493;7.15;0.44;230.52;6.66;811;48;2206.00;36
5652;48;628375956;5652;309;6457;6493;7.05;0.43;230.53;6.66;805;48;2207.00;36
5654;48;628375968;5654;314;6470;6506;6.98;0.43;230.51;6.65;816;48;2208.00;36
5659;48;628375979;5659;311;6470;6506;6.80;0.42;230.51;6.65;811;48;2209.00;36
5662;48;628375989;5662;300;6471;6508;6.71;0.41;230.60;6.64;809;48;2210.00;37
5663;48;628376000;5663;296;6472;6509;6.73;0.41;230.58;6.64;809;48;2211.00;37
5668;48;628376009;5668;291;6473;6510;6.66;0.41;230.61;6.64;805;48;2212.00;37
5669;48;628376019;5669;289;6473;6510;6.67;0.41;230.63;6.64;804;48;2213.00;37
5670;48;628376030;5670;289;6475;6513;6.83;0.42;230.65;6.64;805;48;2214.00;38
5672;48;628376040;5672;286;6475;6513;6.97;0.43;230.67;6.64;803;48;2215.00;38
5676;48;628376050;5676;281;6475;6513;7.03;0.43;230.84;6.64;799;48;2216.00;38
5680;48;628376060;5680;277;6475;6513;7.12;0.44;230.85;6.64;795;48;2217.00;38
5681;48;628376070;5681;260;6479;6519;7.22;0.44;230.87;6.64;798;48;2218.00;40
5684;48;628376081;5684;261;6481;6519;7.36;0.45;231.03;6.64;797;48;2219.00;38
5689;48;628376093;5689;251;6481;6519;7.41;0.46;231.11;6.64;792;48;2220.00;38
5692;48;628376104;5692;239;6482;6519;7.55;0.46;231.05;6.70;790;48;2221.00;37
5695;48;628376116;5695;230;6487;6523;7.61;0.47;231.07;6.70;792;48;2222.00;36
5698;48;628376126;5698;221;6489;6524;7.70;0.47;231.13;6.70;791;48;2223.00;35
5701;48;628376137;5701;218;6489;6524;7.83;0.48;231.12;6.70;788;48;2224.00;35
5707;48;628376148;5707;215;6490;6525;7.87;0.48;231.16;6.70;783;48;2225.00;35
5712;48;628376159;5712;218;6490;6525;7.87;0.48;231.13;6.70;778;48;2226.00;35
5716;48;628376169;5716;217;6490;6525;7.92;0.48;231.11;6.70;774;48;2227.00;35
5721;48;628376179;5721;218;6490;6525;7.98;0.49;231.15;6.70;769;48;2228.00;35
5725;48;628376190;5725;219;6490;6525;8.11;0.49;231.13;6.70;765;48;2229.00;35
5728;48;628376201;5728;213;6490;6525;8.29;0.51;231.13;6.70;762;48;2230.00;35
5732;48;628376212;5732;211;6490;6525;8.40;0.51;231.20;6.70;758;48;2231.00;35
5737;48;628376223;5737;217;6533;6595;8.50;0.52;231.19;6.65;796;48;2232.00;62
5740;48;628376241;5740;203;6536;6596;8.58;0.52;231.20;6.65;796;48;2233.00;60
5745;48;628376253;5745;198;6543;6596;8.72;0.53;231.25;6.64;798;48;2234.00;53
5749;48;628376265;5749;190;6547;6596;8.79;0.54;231.27;6.64;798;48;2235.00;49
5753;48;628376276;5753;187;6552;6596;8.90;0.54;231.22;6.64;799;48;2236.00;44
5760;48;628376288;5760;192;6555;6596;8.89;0.54;231.32;6.64;795;48;2237.00;41
5765;48;628376300;5765;195;6557;6596;9.00;0.55;231.30;6.64;792;48;2238.00;39
5767;48;628376311;5767;203;6557;6596;9.11;0.55;231.31;6.64;790;48;2239.00;39
5773;48;628376323;5773;199;6559;6597;9.13;0.55;231.27;6.64;786;48;2240.00;38
5776;48;628376335;5776;216;6560;6598;9.21;0.56;231.31;6.64;784;48;2241.00;38
5780;48;628376348;5780;214;6561;6598;9.23;0.56;231.34;6.64;781;48;2242.00;37
5786;48;628376359;5786;215;6564;6602;9.18;0.56;231.37;6.64;778;48;2243.00;38
5789;48;628376372;5789;222;6564;6602;9.20;0.56;231.44;6.64;775;48;2244.00;38
5794;48;628376383;5794;226;6564;6602;9.25;0.56;231.43;6.64;770;48;2245.00;38
5796;48;628376395;5796;225;6564;6602;9.28;0.56;231.47;6.64;768;48;2246.00;38
5799;48;628376407;5799;227;6568;6608;9.35;0.57;231.47;6.63;769;48;2247.00;40
5805;48;628376419;5805;228;6568;6608;9.39;0.57;231.63;6.63;763;48;2248.00;40
5810;48;628376431;5810;223;6569;6608;9.41;0.57;231.65;6.63;759;48;2249.00;39
5813;48;628376445;5813;222;6572;6614;9.48;0.58;231.79;6.63;759;48;2250.00;42
5818;48;628376457;5818;216;6572;6614;9.44;0.58;231.92;6.63;754;48;2251.00;42
5820;48;628376470;5820;223;6573;6614;9.49;0.58;232.00;6.63;753;48;2252.00;41
5824;48;628376482;5824;223;6573;6615;9.51;0.58;232.03;6.63;749;48;2253.00;42
5826;48;628376494;5826;226;6575;6616;9.55;0.58;232.02;6.63;749;48;2254.00;41
5829;48;628376505;5829;229;6576;6616;9.56;0.58;232.03;6.63;747;48;2255.00;40
5835;48;628376517;5835;231;6587;6629;9.60;0.58;232.14;6.62;752;48;2256.00;42
5837;48;628376530;5837;221;6587;6629;9.66;0.59;232.09;6.62;750;48;2257.00;42
5845;49;628376541;5845;219;6587;6629;9.66;0.59;232.20;6.62;742;49;2258.00;42
5847;49;628376566;5847;221;6588;6630;9.76;0.59;232.29;6.61;741;49;2259.00;42
5851;49;628376578;5851;216;6588;6630;9.81;0.60;232.39;6.61;737;49;2260.00;42
5855;49;628376590;5855;215;6591;6634;9.86;0.60;232.43;6.61;736;49;2261.00;43
5857;49;628376603;5857;212;6591;6634;9.91;0.61;232.43;6.61;734;49;2262.00;43
5861;49;628376616;5861;212;6595;6638;9.95;0.61;232.44;6.61;734;49;2263.00;43
5865;49;628376635;5865;214;6595;6638;9.91;0.61;232.54;6.61;730;49;2264.00;43
5867;50;628376647;5867;219;6595;6638;9.99;0.61;232.52;6.61;728;50;2265.00;43
5870;50;628376676;5870;203;6595;6638;10.08;0.62;232.59;6.61;725;50;2266.00;43
5874;50;628376699;5874;183;6595;6638;10.13;0.62;232.64;6.61;721;50;2267.00;43
5879;50;628376711;5879;172;6605;6650;10.18;0.62;232.67;6.60;726;50;2268.00;45
5882;50;628376724;5882;165;6606;6650;10.28;0.63;232.75;6.60;724;50;2269.00;44
5888;50;628376739;5888;153;6606;6650;10.38;0.63;232.74;6.60;718;50;2270.00;44
5892;50;628376751;5892;144;6606;6650;10.52;0.64;232.79;6.60;714;50;2271.00;44
5894;50;628376763;5894;137;6606;6650;10.62;0.64;232.79;6.60;712;50;2272.00;44
5896;50;628376775;5896;131;6606;6650;10.74;0.65;232.81;6.60;710;50;2273.00;44
5900;50;628376787;5900;127;6606;6651;10.79;0.66;232.87;6.60;706;50;2274.00;45
5902;50;628376798;5902;127;6606;6651;10.93;0.66;232.90;6.60;704;50;2275.00;45
5906;50;628376810;5906;128;6610;6657;11.01;0.67;232.95;6.59;704;50;2276.00;47
5908;50;628376821;5908;125;6611;6658;11.09;0.67;233.01;6.59;703;50;2277.00;47
5912;51;628376834;5912;122;6612;6658;11.16;0.68;233.00;6.59;700;51;2278.00;46
5914;51;628376856;5914;116;6612;6658;11.21;0.68;233.03;6.59;698;51;2279.00;46
5915;51;628376869;5915;117;6616;6663;11.33;0.69;233.00;6.59;701;51;2280.00;47
5917;51;628376881;5917;122;6616;6663;11.32;0.69;233.04;6.59;699;51;2281.00;47
5921;51;628376893;5921;114;6616;6663;11.32;0.69;233.11;6.59;695;51;2282.00;47
5922;51;628376903;5922;113;6617;6664;11.39;0.69;233.09;6.59;695;51;2283.00;47
5925;51;628376915;5925;117;6620;6668;11.38;0.69;233.12;6.59;695;51;2284.00;48
5928;51;628376926;5928;120;6620;6668;11.43;0.70;233.15;6.59;692;51;2285.00;48
5931;51;628376937;5931;124;6622;6671;11.44;0.70;233.15;6.58;691;51;2286.00;49
5935;51;628376948;5935;123;6622;6671;11.42;0.69;233.19;6.58;687;51;2287.00;49
5938;51;628376959;5938;122;6623;6671;11.39;0.69;233.15;6.58;685;51;2288.00;48
5941;51;628376970;5941;122;6623;6671;11.39;0.69;233.21;6.58;682;51;2289.00;48
5943;51;628376981;5943;123;6626;6675;11.51;0.70;233.20;6.58;683;51;2290.00;49
5946;51;628376992;5946;130;6626;6675;11.58;0.70;233.25;6.58;680;51;2291.00;49
5949;51;628377002;5949;132;6627;6675;11.68;0.71;233.23;6.58;678;51;2292.00;48
5950;51;628377012;5950;131;6627;6675;11.75;0.72;233.21;6.58;677;51;2293.00;48
5952;51;628377022;5952;134;6627;6676;11.84;0.72;233.18;6.58;675;51;2294.00;49
5953;51;628377032;5953;131;6629;6678;11.85;0.72;233.21;6.58;676;51;2295.00;49
5956;51;628377042;5956;126;6629;6678;11.80;0.72;233.21;6.58;673;51;2296.00;49
5957;52;628377052;5957;130;6630;6679;11.73;0.71;233.20;6.58;673;52;2297.00;49
5959;52;628377073;5959;132;6630;6679;11.68;0.71;233.19;6.58;671;52;2298.00;49
5963;52;628377083;5963;138;6630;6679;11.68;0.71;233.22;6.58;667;52;2299.00;49
5966;52;628377093;5966;137;6630;6679;11.63;0.71;233.21;6.58;664;52;2300.00;49
5967;52;628377106;5967;133;6630;6679;11.59;0.71;233.21;6.58;663;52;2301.00;49
5972;52;628377116;5972;136;6630;6679;11.57;0.71;233.26;6.58;658;52;2302.00;49
5976;52;628377125;5976;138;6631;6679;11.56;0.71;233.22;6.65;655;52;2303.00;48
5978;52;628377135;5978;166;6702;6806;11.19;0.69;233.23;6.58;724;52;2304.00;104
5983;52;628377154;5983;158;6702;6807;11.12;0.69;233.24;6.58;719;52;2305.00;105
5985;52;628377164;5985;146;6710;6807;11.17;0.69;233.21;6.58;725;52;2306.00;97
5990;52;628377173;5990;146;6711;6807;11.16;0.69;233.14;6.58;721;52;2307.00;96
5991;52;628377183;5991;149;6716;6807;11.17;0.68;233.13;6.57;725;52;2308.00;91
5993;52;628377192;5993;146;6720;6807;11.14;0.68;233.12;6.57;727;52;2309.00;87
5996;53;628377202;5996;146;6724;6807;11.16;0.68;233.27;6.57;728;53;2310.00;83
6001;53;628377228;6001;143;6726;6807;11.08;0.68;233.34;6.57;725;53;2311.00;81
6005;53;628377243;6005;144;6729;6808;11.08;0.68;233.30;6.57;724;53;2312.00;79
6009;53;628377253;6009;150;6732;6809;11.09;0.68;233.28;6.57;723;53;2313.00;77
6015;53;628377263;6015;150;6736;6809;11.05;0.67;233.20;6.59;721;53;2314.00;73
6019;54;628377279;6019;152;6740;6810;11.05;0.67;233.16;6.60;721;54;2315.00;70
6021;54;628377299;6021;154;6742;6810;10.99;0.67;233.13;6.60;721;54;2316.00;68
6021;54;628377309;6021;153;6746;6810;10.98;0.67;233.13;6.60;725;54;2317.00;64
6024;54;628377323;6024;157;6748;6810;10.87;0.66;233.08;6.61;724;54;2318.00;62
6029;54;628377332;6029;152;6752;6814;10.78;0.66;232.96;6.61;723;54;2319.00;62
6031;54;628377342;6031;158;6754;6814;10.72;0.65;232.92;6.61;723;54;2320.00;60
6031;54;628377351;6031;153;6755;6814;10.63;0.65;232.92;6.61;724;54;2321.00;59
6033;54;628377360;6033;159;6757;6817;10.55;0.64;232.90;6.61;724;54;2322.00;60
6033;54;628377370;6033;160;6758;6817;10.38;0.63;232.90;6.61;725;54;2323.00;59
6036;54;628377379;6036;164;6759;6817;10.31;0.63;232.83;6.61;723;54;2324.00;58
6037;54;628377388;6037;169;6762;6821;10.34;0.63;232.81;6.60;725;54;2325.00;59
6041;54;628377398;6041;175;6764;6822;10.39;0.63;232.82;6.60;723;54;2326.00;58
6043;54;628377408;6043;180;6764;6822;10.45;0.64;232.81;6.60;721;54;2327.00;58
6048;54;628377417;6048;188;6767;6826;10.46;0.64;232.71;6.60;719;54;2328.00;59
6050;54;628377428;6050;184;6767;6826;10.44;0.63;232.69;6.60;717;54;2329.00;59
6054;54;628377437;6054;190;6767;6826;10.38;0.63;232.62;6.60;713;54;2330.00;59
6055;54;628377447;6055;195;6768;6827;10.35;0.63;232.61;6.60;713;54;2331.00;59
6058;54;628377458;6058;197;6768;6827;10.25;0.62;232.64;6.60;710;54;2332.00;59
6059;54;628377490;6059;197;6772;6833;10.22;0.62;232.61;6.60;713;54;2333.00;61
6061;54;628377500;6061;204;6772;6833;10.10;0.61;232.63;6.60;711;54;2334.00;61
6063;54;628377509;6063;208;6773;6834;9.98;0.60;232.57;6.60;710;54;2335.00;61
6065;54;628377519;6065;217;6774;6834;9.85;0.60;232.52;6.61;709;54;2336.00;60
6065;54;628377529;6065;227;6774;6834;9.73;0.59;232.52;6.61;709;54;2337.00;60
6065;54;628377538;6065;233;6774;6834;9.58;0.58;232.52;6.61;709;54;2338.00;60
6066;54;628377547;6066;243;6775;6834;9.43;0.57;232.50;6.62;709;54;2339.00;59
6068;54;628377557;6068;254;6797;6870;9.32;0.57;232.50;6.61;729;54;2340.00;73
6069;54;628377569;6069;263;6798;6870;9.20;0.56;232.49;6.61;729;54;2341.00;72
6069;54;628377577;6069;264;6802;6870;9.19;0.56;232.49;6.62;733;54;2342.00;68
6069;54;628377586;6069;270;6805;6870;9.12;0.56;232.49;6.63;736;54;2343.00;65
6072;54;628377595;6072;269;6807;6870;9.08;0.56;232.46;6.64;735;54;2344.00;63
6072;54;628377604;6072;278;6809;6870;9.09;0.56;232.46;6.64;737;54;2345.00;61
6074;54;628377613;6074;282;6812;6874;9.02;0.55;232.47;6.64;738;54;2346.00;62
6076;54;628377622;6076;275;6815;6874;8.99;0.55;232.42;6.66;739;54;2347.00;59
6078;54;628377631;6078;269;6819;6878;9.01;0.55;232.41;6.65;741;54;2348.00;59
6082;54;628377641;6082;259;6822;6879;8.98;0.55;232.38;6.67;740;54;2349.00;57
6082;54;628377650;6082;250;6823;6879;8.99;0.55;232.38;6.67;741;54;2350.00;56
6084;54;628377659;6084;244;6824;6879;8.93;0.55;232.36;6.68;740;54;2351.00;55
6085;54;628377668;6085;246;6835;6892;8.78;0.54;232.32;6.67;750;54;2352.00;57
6085;54;628377678;6085;242;6837;6892;8.77;0.54;232.32;6.68;752;54;2353.00;55
6088;54;628377687;6088;239;6838;6892;8.75;0.54;232.29;6.69;750;54;2354.00;54
6091;54;628377701;6091;241;6840;6893;8.72;0.53;232.36;6.69;749;54;2355.00;53
6093;54;628377715;6093;237;6840;6894;8.62;0.53;232.35;6.69;747;54;2356.00;54
6094;54;628377741;6094;242;6842;6894;8.53;0.52;232.34;6.70;748;54;2357.00;52
6096;54;628377758;6096;249;6844;6897;8.43;0.52;232.33;6.70;748;54;2358.00;53
6098;54;628377781;6098;247;6846;6897;8.33;0.51;232.30;6.71;748;54;2359.00;51
6100;54;628377795;6100;245;6847;6897;8.32;0.51;232.26;6.71;747;54;2360.00;50
6101;54;628377820;6101;242;6849;6897;8.31;0.51;232.25;6.71;748;54;2361.00;48
6101;54;628377831;6101;246;6853;6903;8.36;0.51;232.25;6.71;752;54;2362.00;50
6103;54;628377842;6103;243;6855;6903;8.28;0.51;232.22;6.72;752;54;2363.00;48
6104;54;628377851;6104;243;6856;6903;8.26;0.51;232.24;6.72;752;54;2364.00;47
6105;54;628377862;6105;241;6857;6903;8.16;0.50;232.25;6.72;752;54;2365.00;46
6108;54;628377874;6108;238;6860;6907;8.12;0.50;232.23;6.72;752;54;2366.00;47
6108;54;628377884;6108;241;6861;6908;8.12;0.50;232.23;6.72;753;54;2367.00;47
6113;54;628377894;6113;244;6862;6908;8.06;0.49;232.16;6.73;749;54;2368.00;46
6117;54;628377905;6117;247;6866;6909;8.03;0.49;232.24;6.74;749;54;2369.00;43
6117;54;628377917;6117;245;6866;6909;8.04;0.49;232.24;6.74;749;54;2370.00;43
6119;54;628377927;6119;247;6868;6909;8.05;0.49;232.24;6.74;749;54;2371.00;41
6122;54;628377937;6122;249;6868;6909;8.03;0.49;232.22;6.74;746;54;2372.00;41
6125;54;628377947;6125;244;6868;6909;8.02;0.49;232.24;6.74;743;54;2373.00;41
6128;54;628377956;6128;237;6870;6909;8.06;0.49;232.29;6.74;742;54;2374.00;39
6134;54;628377965;6134;235;6870;6909;8.04;0.49;232.29;6.74;736;54;2375.00;39
6139;54;628377976;6139;241;6911;6979;8.08;0.50;232.29;6.70;772;54;2376.00;68
6142;54;628377992;6142;239;6912;6980;8.00;0.49;232.34;6.70;770;54;2377.00;68
6146;54;628378003;6146;231;6920;6980;7.94;0.49;232.41;6.70;774;54;2378.00;60
6146;54;628378013;6146;229;6926;6980;7.95;0.49;232.41;6.69;780;54;2379.00;54
6155;54;628378022;6155;219;6933;6980;7.84;0.48;232.40;6.69;778;54;2380.00;47
6158;54;628378033;6158;223;6935;6980;7.85;0.48;232.38;6.69;777;54;2381.00;45
6162;54;628378043;6162;221;6938;6980;7.80;0.48;232.43;6.69;776;54;2382.00;42
6167;54;628378059;6167;221;6939;6980;7.80;0.48;232.50;6.69;772;54;2383.00;41
6169;54;628378069;6169;222;6941;6981;7.83;0.48;232.48;6.69;772;54;2384.00;40
6172;54;628378079;6172;220;6943;6983;7.84;0.48;232.52;6.69;771;54;2385.00;40
6178;54;628378090;6178;223;6943;6983;7.85;0.48;232.50;6.69;765;54;2386.00;40
6183;54;628378101;6183;218;6947;6987;7.88;0.48;232.52;6.69;764;54;2387.00;40
6186;54;628378112;6186;213;6947;6987;7.96;0.49;232.55;6.69;761;54;2388.00;40
6189;54;628378122;6189;212;6947;6987;8.07;0.49;232.51;6.69;758;54;2389.00;40
6194;54;628378132;6194;213;6947;6987;8.20;0.50;232.54;6.69;753;54;2390.00;40
6198;54;628378142;6198;215;6952;6993;8.29;0.51;232.58;6.68;754;54;2391.00;41
6199;54;628378153;6199;215;6952;6993;8.46;0.52;232.57;6.68;753;54;2392.00;41
6204;54;628378165;6204;218;6953;6993;8.51;0.52;232.71;6.68;749;54;2393.00;40
6207;54;628378175;6207;217;6955;6996;8.62;0.53;232.74;6.68;748;54;2394.00;41
6210;54;628378186;6210;216;6956;6996;8.79;0.54;232.82;6.68;746;54;2395.00;40
6216;54;628378196;6216;212;6956;6996;8.88;0.55;232.88;6.68;740;54;2396.00;40
6220;54;628378207;6220;210;6957;6997;8.99;0.55;232.93;6.68;737;54;2397.00;40
6225;54;628378218;6225;206;6958;6998;9.12;0.56;232.89;6.68;733;54;2398.00;40
6232;54;628378229;6232;205;6958;6998;9.19;0.56;232.87;6.68;726;54;2399.00;40
6234;54;628378243;6234;205;6984;7057;9.28;0.57;232.91;6.65;750;54;2400.00;73
6242;54;628378265;6242;199;6985;7057;9.33;0.57;232.89;6.65;743;54;2401.00;72
6245;54;628378277;6245;195;6988;7057;9.45;0.58;232.91;6.65;743;54;2402.00;69
6252;54;628378288;6252;189;6989;7058;9.51;0.58;232.95;6.65;737;54;2403.00;69
6256;54;628378300;6256;192;6991;7058;9.54;0.58;233.00;6.65;735;54;2404.00;67
6261;54;628378317;6261;191;6993;7062;9.49;0.58;233.01;6.65;732;54;2405.00;69
6266;54;628378328;6266;193;6995;7062;9.49;0.58;233.00;6.64;729;54;2406.00;67
6269;54;628378339;6269;196;6999;7066;9.53;0.58;233.01;6.64;730;54;2407.00;67
6274;54;628378350;6274;198;7001;7066;9.51;0.58;233.21;6.64;727;54;2408.00;65
6279;54;628378374;6279;195;7002;7066;9.45;0.58;233.27;6.64;723;54;2409.00;64
6284;54;628378386;6284;196;7002;7066;9.42;0.57;233.37;6.64;718;54;2410.00;64
6287;54;628378398;6287;200;7003;7066;9.41;0.57;233.36;6.64;716;54;2411.00;63
6293;54;628378410;6293;200;7011;7078;9.47;0.58;233.36;6.64;718;54;2412.00;67
6296;54;628378422;6296;200;7011;7078;9.52;0.58;233.38;6.64;715;54;2413.00;67
6301;54;628378433;6301;208;7013;7078;9.46;0.58;233.38;6.64;712;54;2414.00;65
6304;54;628378444;6304;209;7014;7078;9.48;0.58;233.37;6.64;710;54;2415.00;64
6308;54;628378456;6308;210;7014;7078;9.41;0.57;233.39;6.64;706;54;2416.00;64
6311;54;628378468;6311;213;7014;7078;9.44;0.58;233.38;6.64;703;54;2417.00;64
6312;54;628378479;6312;213;7014;7079;9.49;0.58;233.37;6.64;702;54;2418.00;65
6318;54;628378491;6318;219;7017;7079;9.51;0.58;233.42;6.64;699;54;2419.00;62
6321;54;628378503;6321;222;7020;7085;9.51;0.58;233.40;6.64;699;54;2420.00;65
6325;54;628378515;6325;227;7022;7086;9.58;0.58;233.47;6.64;697;54;2421.00;64
6329;54;628378527;6329;225;7022;7086;9.56;0.58;233.47;6.64;693;54;2422.00;64
6332;54;628378538;6332;229;7022;7086;9.52;0.58;233.53;6.64;690;54;2423.00;64
6334;54;628378549;6334;232;7025;7090;9.50;0.58;233.49;6.64;691;54;2424.00;65
6337;54;628378560;6337;240;7025;7090;9.43;0.57;233.59;6.64;688;54;2425.00;65
6338;54;628378571;6338;244;7025;7090;9.46;0.57;233.59;6.64;687;54;2426.00;65
6343;54;628378581;6343;231;7029;7091;9.33;0.57;233.66;6.65;686;54;2427.00;62
6344;54;628378594;6344;228;7032;7095;9.20;0.56;233.69;6.65;688;54;2428.00;63
6346;54;628378605;6346;224;7033;7095;9.10;0.55;233.69;6.65;687;54;2429.00;62
6350;54;628378618;6350;226;7037;7101;9.07;0.55;233.74;6.65;687;54;2430.00;64
6356;54;628378630;6356;226;7037;7101;9.08;0.55;233.96;6.65;681;54;2431.00;64
6358;54;628378641;6358;227;7037;7101;9.12;0.55;233.98;6.65;679;54;2432.00;64
6366;54;628378652;6366;229;7039;7101;9.05;0.55;234.03;6.65;673;54;2433.00;62
6368;54;628378664;6368;230;7042;7105;9.09;0.55;234.06;6.65;674;54;2434.00;63
6370;54;628378675;6370;225;7044;7105;9.12;0.55;234.06;6.65;674;54;2435.00;61
6374;54;628378686;6374;208;7044;7105;9.12;0.55;234.05;6.65;670;54;2436.00;61
6376;54;628378708;6376;196;7046;7105;9.08;0.55;234.08;6.65;670;54;2437.00;59
6378;54;628378720;6378;185;7046;7106;9.08;0.55;234.11;6.65;668;54;2438.00;60
6381;54;628378732;6381;173;7048;7107;9.13;0.56;234.11;6.65;667;54;2439.00;59
6382;54;628378744;6382;173;7048;7107;9.17;0.56;234.15;6.65;666;54;2440.00;59
6386;54;628378760;6386;165;7049;7108;9.25;0.57;234.15;6.65;663;54;2441.00;59
6388;54;628378771;6388;158;7049;7108;9.36;0.57;234.13;6.65;661;54;2442.00;59
6391;54;628378781;6391;162;7049;7108;9.52;0.58;234.11;6.65;658;54;2443.00;59
6392;54;628378791;6392;159;7049;7108;9.66;0.59;234.13;6.65;657;54;2444.00;59
6395;54;628378801;6395;160;7050;7108;9.76;0.59;234.08;6.66;655;54;2445.00;58
6396;54;628378812;6396;156;7050;7108;9.88;0.60;234.10;6.66;654;54;2446.00;58
6400;54;628378822;6400;157;7050;7108;9.95;0.60;234.08;6.66;650;54;2447.00;58
6403;54;628378833;6403;169;7111;7235;10.02;0.62;234.11;6.60;708;54;2448.00;124
6404;54;628378853;6404;159;7113;7236;10.05;0.62;234.14;6.60;709;54;2449.00;123
6408;54;628378864;6408;154;7119;7236;10.14;0.62;234.19;6.59;711;54;2450.00;117
6411;54;628378874;6411;155;7123;7236;10.18;0.62;234.19;6.60;712;54;2451.00;113
6416;54;628378884;6416;152;7126;7236;10.29;0.63;234.18;6.60;710;54;2452.00;110
6421;54;628378894;6421;153;7128;7236;10.37;0.63;234.24;6.60;707;54;2453.00;108
6422;54;628378910;6422;156;7131;7236;10.41;0.64;234.24;6.60;709;54;2454.00;105
6424;54;628378920;6424;154;7137;7236;10.42;0.64;234.35;6.60;713;54;2455.00;99
6427;54;628378929;6427;156;7138;7237;10.44;0.64;234.38;6.60;711;54;2456.00;99
6429;54;628378939;6429;163;7143;7238;10.46;0.64;234.41;6.61;714;54;2457.00;95
6431;54;628378949;6431;167;7144;7238;10.39;0.64;234.43;6.61;713;54;2458.00;94
6433;54;628378959;6433;168;7147;7239;10.41;0.64;234.41;6.61;714;54;2459.00;92
6433;54;628378971;6433;174;7151;7239;10.45;0.64;234.41;6.61;718;54;2460.00;88
6435;54;628378986;6435;178;7154;7239;10.41;0.64;234.39;6.62;719;54;2461.00;85
6437;54;628378995;6437;188;7155;7239;10.42;0.64;234.39;6.62;718;54;2462.00;84
6439;54;628379005;6439;190;7160;7243;10.42;0.64;234.38;6.63;721;54;2463.00;83
6440;54;628379014;6440;189;7162;7243;10.44;0.64;234.37;6.63;722;54;2464.00;81
6442;54;628379024;6442;191;7166;7243;10.41;0.64;234.37;6.73;724;54;2465.00;77
6443;54;628379037;6443;190;7169;7246;10.42;0.64;234.39;6.73;726;54;2466.00;77
6443;54;628379047;6443;192;7171;7246;10.43;0.64;234.39;6.73;728;54;2467.00;75
6443;54;628379056;6443;191;7173;7246;10.46;0.64;234.39;6.73;730;54;2468.00;73
6446;54;628379065;6446;195;7179;7250;10.41;0.64;234.37;6.74;733;54;2469.00;71
6450;54;628379075;6450;198;7181;7251;10.40;0.64;234.30;6.74;731;54;2470.00;70
6454;54;628379084;6454;195;7183;7251;10.37;0.63;234.32;6.75;729;54;2471.00;68
6456;54;628379094;6456;198;7185;7255;10.40;0.63;234.30;6.75;729;54;2472.00;70
6459;54;628379103;6459;200;7185;7255;10.42;0.64;234.26;6.75;726;54;2473.00;70
6465;54;628379114;6465;202;7187;7255;10.38;0.63;234.19;6.75;722;54;2474.00;68
6465;54;628379123;6465;210;7189;7257;10.47;0.64;234.19;6.75;724;54;2475.00;68
6466;54;628379132;6466;209;7189;7257;10.48;0.64;234.17;6.75;723;54;2476.00;68
6469;54;628379148;6469;212;7193;7263;10.42;0.63;234.26;6.74;724;54;2477.00;70
6474;54;628379163;6474;211;7193;7263;10.39;0.63;234.22;6.74;719;54;2478.00;70
6476;54;628379172;6476;208;7194;7264;10.41;0.63;234.22;6.74;718;54;2479.00;70
6478;54;628379181;6478;211;7195;7264;10.37;0.63;234.18;6.84;717;54;2480.00;69
6479;54;628379190;6479;212;7195;7264;10.32;0.63;234.18;6.84;716;54;2481.00;69
6482;54;628379198;6482;203;7195;7264;10.25;0.63;234.21;6.84;713;54;2482.00;69
6484;54;628379207;6484;194;7195;7264;10.18;0.62;234.20;6.84;711;54;2483.00;69
6487;54;628379216;6487;192;7206;7276;10.13;0.62;234.18;6.92;719;54;2484.00;70
6489;54;628379226;6489;185;7209;7276;10.22;0.62;234.20;6.94;720;54;2485.00;67
6492;54;628379235;6492;183;7209;7276;10.23;0.62;234.15;6.94;717;54;2486.00;67
6494;54;628379244;6494;187;7210;7276;10.30;0.63;234.11;7.03;716;54;2487.00;66
6497;54;628379254;6497;188;7210;7276;10.28;0.62;234.08;7.03;713;54;2488.00;66
6498;54;628379264;6498;188;7210;7276;10.33;0.63;234.09;7.03;712;54;2489.00;66
6501;54;628379275;6501;188;7213;7280;10.35;0.63;234.04;7.03;712;54;2490.00;67
6503;54;628379285;6503;188;7213;7280;10.31;0.63;234.00;7.03;710;54;2491.00;67
6504;54;628379294;6504;191;7217;7284;10.34;0.63;233.98;7.12;713;54;2492.00;67
6505;54;628379304;6505;193;7219;7285;10.38;0.63;233.96;7.12;714;54;2493.00;66
6506;54;628379313;6506;195;7219;7285;10.42;0.63;233.93;7.12;713;54;2494.00;66
6508;54;628379323;6508;197;7219;7285;10.42;0.63;233.92;7.12;711;54;2495.00;66
6508;54;628379332;6508;205;7229;7298;10.32;0.63;233.92;7.21;721;54;2496.00;69
6511;54;628379343;6511;203;7230;7298;10.24;0.62;233.90;7.22;719;54;2497.00;68
6514;54;628379352;6514;207;7230;7298;10.15;0.62;233.87;7.22;716;54;2498.00;68
6516;54;628379361;6516;197;7232;7299;10.08;0.61;233.83;7.31;716;54;2499.00;67
6518;54;628379373;6518;187;7232;7300;10.03;0.61;233.78;7.31;714;54;2500.00;68
6520;54;628379386;6520;183;7232;7300;10.06;0.61;233.74;7.31;712;54;2501.00;68
6520;54;628379396;6520;182;7234;7303;10.17;0.62;233.74;7.31;714;54;2502.00;69
6521;54;628379406;6521;179;7236;7303;10.16;0.62;233.70;7.32;715;54;2503.00;67
6526;54;628379416;6526;176;7236;7303;10.15;0.62;233.83;7.32;710;54;2504.00;67
6527;54;628379426;6527;173;7236;7303;10.18;0.62;233.84;7.32;709;54;2505.00;67
6530;54;628379436;6530;168;7240;7309;10.24;0.62;233.96;7.32;710;54;2506.00;69
6530;54;628379447;6530;168;7241;7309;10.26;0.62;233.96;7.32;711;54;2507.00;68
6532;54;628379456;6532;169;7241;7309;10.25;0.62;233.95;7.32;709;54;2508.00;68
6533;54;628379473;6533;174;7243;7309;10.16;0.61;233.94;7.34;710;54;2509.00;66
6535;54;628379484;6535;172;7248;7313;10.06;0.61;233.90;7.45;713;54;2510.00;65
6538;54;628379494;6538;169;7251;7314;9.93;0.60;233.86;7.46;713;54;2511.00;63
6539;54;628379504;6539;172;7252;7314;9.85;0.59;233.87;7.47;713;54;2512.00;62
6539;54;628379514;6539;174;7253;7315;9.79;0.59;233.87;7.47;714;54;2513.00;62
6539;54;628379523;6539;173;7257;7315;9.69;0.59;233.87;7.51;718;54;2514.00;58
6539;54;628379532;6539;174;7259;7315;9.65;0.58;233.87;7.52;720;54;2515.00;56
6539;54;628379541;6539;177;7260;7315;9.67;0.59;233.87;7.53;721;54;2516.00;55
6540;54;628379550;6540;190;7262;7315;9.61;0.58;233.88;7.54;722;54;2517.00;53
6540;54;628379560;6540;195;7264;7315;9.59;0.58;233.88;7.56;724;54;2518.00;51
6541;54;628379573;6541;201;7264;7315;9.52;0.58;233.88;7.56;723;54;2519.00;51
6544;54;628379584;6544;215;7315;7440;9.57;0.59;233.95;7.51;771;54;2520.00;125
6545;54;628379602;6545;224;7321;7441;9.58;0.59;233.99;7.51;776;54;2521.00;120
6546;54;628379612;6546;221;7331;7441;9.60;0.59;233.98;7.51;785;54;2522.00;110
6548;54;628379621;6548;222;7340;7441;9.46;0.58;234.08;7.51;792;54;2523.00;101
6549;54;628379631;6549;224;7344;7441;9.36;0.57;234.09;7.51;795;54;2524.00;97
6552;54;628379640;6552;226;7349;7441;9.20;0.57;234.20;7.52;797;54;2525.00;92
6554;54;628379649;6554;226;7357;7441;9.11;0.56;234.24;7.53;803;54;2526.00;84
6556;54;628379659;6556;229;7359;7441;9.00;0.55;234.25;7.53;803;54;2527.00;82
6559;54;628379668;6559;235;7363;7442;8.90;0.55;234.21;7.53;804;54;2528.00;79
6560;54;628379703;6560;234;7368;7443;8.85;0.54;234.21;7.54;808;54;2529.00;75
6562;54;628379719;6562;231;7372;7443;8.74;0.54;234.21;7.54;810;54;2530.00;71
6564;54;628379735;6564;227;7380;7447;8.67;0.53;234.18;7.55;816;54;2531.00;67
6568;54;628379754;6568;224;7384;7447;8.51;0.52;234.14;7.55;816;54;2532.00;63
6570;54;628379768;6570;229;7385;7447;8.45;0.52;234.13;7.56;815;54;2533.00;62
6572;54;628379784;6572;226;7388;7447;8.41;0.52;234.10;7.56;816;54;2534.00;59
6575;54;628379802;6575;223;7394;7453;8.40;0.51;234.10;7.56;819;54;2535.00;59
6577;54;628379817;6577;227;7394;7453;8.39;0.51;234.08;7.56;817;54;2536.00;59
6579;54;628379829;6579;236;7397;7455;8.40;0.51;234.08;7.56;818;54;2537.00;58
6582;54;628379841;6582;240;7400;7458;8.46;0.52;234.08;7.56;818;54;2538.00;58
6584;54;628379853;6584;240;7400;7458;8.46;0.52;234.05;7.56;816;54;2539.00;58
6588;54;628379865;6588;247;7403;7458;8.40;0.51;234.09;7.57;815;54;2540.00;55
6591;54;628379877;6591;253;7404;7459;8.38;0.51;234.11;7.57;813;54;2541.00;55
6596;54;628379888;6596;253;7406;7460;8.39;0.51;234.21;7.57;810;54;2542.00;54
6602;54;628379900;6602;255;7406;7460;8.34;0.51;234.31;7.57;804;54;2543.00;54
6605;54;628379923;6605;267;7418;7473;8.31;0.51;234.33;7.56;813;54;2544.00;55
6611;54;628379936;6611;271;7419;7473;8.29;0.51;234.31;7.56;808;54;2545.00;54
6616;54;628379947;6616;267;7419;7473;8.15;0.50;234.32;7.56;803;54;2546.00;54
6619;54;628379965;6619;268;7421;7474;8.07;0.49;234.34;7.56;802;54;2547.00;53
6623;54;628379979;6623;267;7422;7474;8.01;0.49;234.33;7.56;799;54;2548.00;52
6627;54;628379991;6627;274;7425;7478;7.92;0.48;234.39;7.56;798;54;2549.00;53
6630;54;628380007;6630;273;7428;7481;7.83;0.48;234.35;7.56;798;54;2550.00;53
6637;54;628380025;6637;266;7433;7485;7.70;0.47;234.34;7.56;796;54;2551.00;52
6639;54;628380042;6639;262;7433;7485;7.68;0.47;234.34;7.56;794;54;2552.00;52
6643;54;628380055;6643;262;7435;7485;7.66;0.47;234.36;7.56;792;54;2553.00;50
6646;54;628380066;6646;259;7436;7485;7.68;0.47;234.45;7.56;790;54;2554.00;49
6649;54;628380077;6649;250;7436;7485;7.67;0.47;234.51;7.56;787;54;2555.00;49
6651;54;628380087;6651;247;7448;7497;7.85;0.48;234.52;7.55;797;54;2556.00;49
6655;54;628380100;6655;246;7448;7497;7.86;0.48;234.61;7.55;793;54;2557.00;49
6659;54;628380111;6659;237;7448;7497;7.97;0.49;234.63;7.55;789;54;2558.00;49
6663;54;628380122;6663;230;7448;7497;8.10;0.50;234.70;7.55;785;54;2559.00;49
6666;54;628380133;6666;227;7448;7497;8.19;0.51;234.78;7.55;782;54;2560.00;49
6668;54;628380152;6668;220;7448;7497;8.29;0.51;234.82;7.55;780;54;2561.00;49
6673;54;628380163;6673;214;7450;7498;8.35;0.51;234.88;7.64;777;54;2562.00;48
6678;54;628380176;6678;212;7450;7498;8.44;0.52;234.93;7.64;772;54;2563.00;48
6680;54;628380187;6680;218;7454;7504;8.63;0.53;235.00;7.63;774;54;2564.00;50
6685;54;628380200;6685;217;7457;7506;8.70;0.54;235.06;7.63;772;54;2565.00;49
6689;54;628380211;6689;215;7457;7506;8.83;0.55;235.10;7.63;768;54;2566.00;49
6694;54;628380223;6694;217;7457;7506;8.94;0.55;235.11;7.63;763;54;2567.00;49
6700;54;628380235;6700;214;7461;7510;9.00;0.56;235.15;7.63;761;54;2568.00;49
6703;54;628380247;6703;203;7461;7510;9.08;0.56;235.17;7.63;758;54;2569.00;49
6707;54;628380258;6707;193;7461;7510;9.10;0.56;235.18;7.63;754;54;2570.00;49
6713;54;628380270;6713;191;7462;7511;9.17;0.57;235.15;7.62;749;54;2571.00;49
6721;54;628380282;6721;191;7465;7515;9.18;0.57;235.18;7.62;744;54;2572.00;50
6724;54;628380293;6724;190;7465;7515;9.16;0.57;235.12;7.62;741;54;2573.00;50
6730;54;628380304;6730;189;7467;7518;9.22;0.57;235.13;7.62;737;54;2574.00;51
6734;54;628380315;6734;185;7468;7518;9.31;0.57;235.12;7.62;734;54;2575.00;50
6740;54;628380326;6740;186;7468;7518;9.32;0.57;235.11;7.62;728;54;2576.00;50
6746;54;628380338;6746;190;7468;7518;9.31;0.57;235.25;7.62;722;54;2577.00;50
6749;54;628380350;6749;188;7471;7522;9.36;0.57;235.41;7.62;722;54;2578.00;51
6754;54;628380361;6754;189;7471;7522;9.32;0.57;235.44;7.62;717;54;2579.00;51
6759;54;628380374;6759;187;7472;7522;9.31;0.57;235.44;7.62;713;54;2580.00;50
6766;54;628380385;6766;192;7472;7522;9.29;0.57;235.51;7.62;706;54;2581.00;50
6771;54;628380397;6771;190;7472;7523;9.31;0.57;235.53;7.62;701;54;2582.00;51
6774;54;628380408;6774;194;7473;7524;9.33;0.57;235.57;7.62;699;54;2583.00;51
6777;54;628380419;6777;192;7473;7524;9.30;0.57;235.62;7.62;696;54;2584.00;51
6786;54;628380430;6786;196;7474;7525;9.19;0.56;235.62;7.61;688;54;2585.00;51
6788;54;628380441;6788;200;7474;7525;9.17;0.56;235.62;7.61;686;54;2586.00;51
6795;54;628380451;6795;206;7474;7525;9.10;0.56;235.62;7.61;679;54;2587.00;51
6800;54;628380462;6800;211;7474;7525;9.08;0.56;235.59;7.61;674;54;2588.00;51
6804;54;628380473;6804;217;7474;7525;8.99;0.55;235.61;7.61;670;54;2589.00;51
6807;54;628380483;6807;222;7474;7525;8.89;0.54;235.59;7.61;667;54;2590.00;51
6811;54;628380494;6811;230;7474;7525;8.70;0.53;235.64;7.61;663;54;2591.00;51
6813;54;628380503;6813;249;7539;7652;8.89;0.55;235.66;7.55;726;54;2592.00;113
6818;54;628380523;6818;246;7544;7653;8.78;0.55;235.73;7.54;726;54;2593.00;109
6823;54;628380535;6823;257;7554;7653;8.83;0.55;235.72;7.54;731;54;2594.00;99
6825;54;628380545;6825;260;7555;7653;8.79;0.55;235.74;7.54;730;54;2595.00;98
6828;54;628380556;6828;270;7559;7653;8.76;0.54;235.76;7.53;731;54;2596.00;94
6833;54;628380567;6833;266;7560;7653;8.74;0.54;235.71;7.53;727;54;2597.00;93
6836;54;628380584;6836;263;7565;7653;8.85;0.55;235.80;7.53;729;54;2598.00;88
6840;54;628380596;6840;261;7567;7653;8.91;0.55;235.79;7.53;727;54;2599.00;86
6841;54;628380610;6841;256;7571;7654;8.92;0.55;235.79;7.53;730;54;2600.00;83
6844;54;628380626;6844;249;7576;7655;8.92;0.55;235.84;7.53;732;54;2601.00;79
6845;54;628380644;6845;251;7579;7655;8.87;0.54;235.84;7.54;734;54;2602.00;76
6847;54;628380655;6847;249;7582;7656;8.77;0.54;235.88;7.54;735;54;2603.00;74
6849;54;628380666;6849;247;7584;7656;8.74;0.54;235.88;7.54;735;54;2604.00;72
6850;54;628380678;6850;253;7588;7656;8.69;0.54;235.88;7.54;738;54;2605.00;68
6852;54;628380696;6852;243;7589;7656;8.73;0.54;235.91;7.54;737;54;2606.00;67
6855;54;628380707;6855;235;7592;7660;8.76;0.54;235.94;7.54;737;54;2607.00;68
6855;54;628380720;6855;225;7594;7660;8.87;0.54;235.94;7.54;739;54;2608.00;66
6857;54;628380730;6857;216;7595;7660;8.94;0.55;236.01;7.54;738;54;2609.00;65
6858;54;628380744;6858;209;7598;7666;8.96;0.55;236.04;7.54;740;54;2610.00;68
6859;54;628380755;6859;204;7599;7666;9.09;0.56;236.05;7.54;740;54;2611.00;67
6862;54;628380766;6862;203;7601;7666;9.14;0.56;236.01;7.64;739;54;2612.00;65
6867;54;628380777;6867;201;7604;7670;9.17;0.56;236.05;7.63;737;54;2613.00;66
6868;54;628380788;6868;196;7606;7671;9.31;0.57;236.04;7.63;738;54;2614.00;65
6868;54;628380799;6868;194;7606;7671;9.35;0.57;236.04;7.63;738;54;2615.00;65
6873;54;628380810;6873;191;7610;7675;9.40;0.57;236.05;7.63;737;54;2616.00;65
6875;54;628380820;6875;195;7610;7675;9.37;0.57;236.02;7.63;735;54;2617.00;65
6878;54;628380831;6878;192;7611;7675;9.37;0.57;236.03;7.63;733;54;2618.00;64
6881;54;628380841;6881;195;7612;7676;9.34;0.57;236.00;7.63;731;54;2619.00;64
6885;54;628380852;6885;200;7613;7676;9.37;0.57;236.05;7.63;728;54;2620.00;63
6890;54;628380867;6890;194;7616;7682;9.35;0.57;236.02;7.63;726;54;2621.00;66
6892;54;628380879;6892;199;7617;7682;9.41;0.57;236.01;7.63;725;54;2622.00;65
6893;54;628380889;6893;198;7617;7683;9.48;0.58;236.09;7.63;724;54;2623.00;66
6894;54;628380898;6894;200;7618;7683;9.56;0.58;236.08;7.63;724;54;2624.00;65
6895;54;628380909;6895;197;7618;7683;9.63;0.59;236.06;7.63;723;54;2625.00;65
6899;54;628380918;6899;197;7618;7683;9.64;0.59;235.99;7.63;719;54;2626.00;65
6900;54;628380929;6900;197;7618;7683;9.66;0.59;235.98;7.63;718;54;2627.00;65
6903;54;628380945;6903;198;7628;7695;9.72;0.59;235.93;7.62;725;54;2628.00;67
6907;54;628380956;6907;195;7628;7695;9.77;0.59;235.93;7.62;721;54;2629.00;67
6908;54;628380966;6908;195;7629;7695;9.85;0.60;235.91;7.62;721;54;2630.00;66
6911;54;628380976;6911;195;7629;7695;9.92;0.60;235.88;7.62;718;54;2631.00;66
6911;55;628380985;6911;199;7629;7695;9.98;0.61;235.88;7.62;718;55;2632.00;66
6916;55;628381006;6916;202;7629;7695;10.02;0.61;235.87;7.62;713;55;2633.00;66
6917;55;628381017;6917;206;7632;7699;10.15;0.62;235.87;7.61;715;55;2634.00;67
6920;55;628381027;6920;208;7632;7699;10.25;0.62;235.83;7.61;712;55;2635.00;67
6922;55;628381036;6922;205;7635;7703;10.32;0.63;235.78;7.61;713;55;2636.00;68
6924;55;628381047;6924;205;7637;7704;10.37;0.63;235.83;7.61;713;55;2637.00;67
6924;55;628381056;6924;206;7637;7704;10.39;0.63;235.83;7.61;713;55;2638.00;67
6926;55;628381066;6926;203;7637;7704;10.43;0.63;235.80;7.61;711;55;2639.00;67
6929;55;628381077;6929;213;7656;7733;10.39;0.63;235.77;7.59;727;55;2640.00;77
6930;55;628381089;6930;209;7657;7733;10.37;0.63;235.77;7.59;727;55;2641.00;76
6931;55;628381098;6931;215;7660;7733;10.33;0.63;235.76;7.59;729;55;2642.00;73
6934;55;628381107;6934;215;7662;7734;10.33;0.63;235.74;7.58;728;55;2643.00;72
6934;55;628381117;6934;220;7663;7735;10.28;0.63;235.74;7.58;729;55;2644.00;72
6935;55;628381126;6935;220;7663;7735;10.26;0.62;235.73;7.58;728;55;2645.00;72
6936;55;628381135;6936;221;7666;7738;10.31;0.63;235.71;7.58;730;55;2646.00;72
6937;55;628381144;6937;221;7666;7738;10.36;0.63;235.72;7.58;729;55;2647.00;72
6940;55;628381154;6940;222;7666;7738;10.34;0.63;235.78;7.58;726;55;2648.00;72
6943;55;628381163;6943;226;7666;7738;10.24;0.62;235.77;7.58;723;55;2649.00;72
6946;55;628381172;6946;228;7670;7744;10.15;0.62;235.78;7.58;724;55;2650.00;74
6949;55;628381181;6949;215;7670;7744;10.13;0.62;235.77;7.58;721;55;2651.00;74
6951;56;628381190;6951;204;7671;7744;10.14;0.62;235.78;7.58;720;56;2652.00;73
6953;56;628381215;6953;190;7671;7744;10.15;0.62;235.76;7.58;718;56;2653.00;73
6956;56;628381225;6956;182;7675;7748;10.09;0.61;235.71;7.59;719;56;2654.00;73
6960;56;628381236;6960;171;7678;7750;10.10;0.61;235.66;7.59;718;56;2655.00;72
6962;56;628381246;6962;158;7678;7750;10.14;0.62;235.65;7.59;716;56;2656.00;72
6965;56;628381256;6965;148;7679;7751;10.19;0.62;235.62;7.59;714;56;2657.00;72
6967;56;628381271;6967;141;7679;7751;10.36;0.63;235.60;7.59;712;56;2658.00;72
6970;56;628381282;6970;133;7679;7751;10.53;0.64;235.64;7.59;709;56;2659.00;72
6972;56;628381292;6972;122;7679;7751;10.68;0.65;235.60;7.59;707;56;2660.00;72
6974;56;628381302;6974;124;7679;7751;10.79;0.66;235.58;7.59;705;56;2661.00;72
6975;56;628381311;6975;115;7679;7751;10.93;0.66;235.56;7.59;704;56;2662.00;72
6977;56;628381326;6977;112;7679;7751;11.03;0.67;235.52;7.59;702;56;2663.00;72
6979;56;628381336;6979;115;7717;7821;11.17;0.68;235.52;7.56;738;56;2664.00;104
6980;56;628381352;6980;110;7719;7822;11.20;0.68;235.51;7.55;739;56;2665.00;103
6982;56;628381363;6982;108;7725;7822;11.30;0.69;235.45;7.55;743;56;2666.00;97
6983;56;628381373;6983;110;7730;7822;11.32;0.69;235.42;7.55;747;56;2667.00;92
6985;56;628381383;6985;106;7735;7822;11.32;0.69;235.42;7.54;750;56;2668.00;87
6986;56;628381394;6986;107;7741;7822;11.29;0.69;235.40;7.54;755;56;2669.00;81
6988;56;628381405;6988;108;7742;7822;11.22;0.68;235.39;7.54;754;56;2670.00;80
6989;56;628381415;6989;116;7743;7822;11.19;0.68;235.36;7.54;754;56;2671.00;79
6992;56;628381425;6992;119;7745;7823;11.16;0.68;235.38;7.54;753;56;2672.00;78
6995;56;628381442;6995;122;7746;7824;11.08;0.67;235.40;7.54;751;56;2673.00;78
6998;56;628381458;6998;123;7747;7824;11.07;0.67;235.41;7.54;749;56;2674.00;77
6999;56;628381469;6999;129;7750;7828;10.97;0.67;235.44;7.54;751;56;2675.00;78
7002;56;628381480;7002;135;7750;7828;10.94;0.67;235.44;7.54;748;56;2676.00;78
7005;56;628381497;7005;140;7751;7828;10.91;0.66;235.42;7.55;746;56;2677.00;77
7006;56;628381508;7006;145;7751;7828;10.84;0.66;235.43;7.55;745;56;2678.00;77
7009;56;628381518;7009;148;7755;7834;10.82;0.66;235.43;7.54;746;56;2679.00;79
7011;56;628381530;7011;154;7757;7834;10.71;0.65;235.45;7.57;746;56;2680.00;77
7015;56;628381540;7015;157;7758;7834;10.64;0.65;235.45;7.57;743;56;2681.00;76
7017;56;628381551;7017;157;7760;7837;10.63;0.65;235.51;7.56;743;56;2682.00;77
7025;56;628381562;7025;164;7763;7837;10.56;0.64;235.55;7.58;738;56;2683.00;74
7027;56;628381573;7027;170;7763;7837;10.50;0.64;235.53;7.58;736;56;2684.00;74
7033;56;628381583;7033;175;7764;7838;10.32;0.63;235.59;7.60;731;56;2685.00;74
7036;56;628381594;7036;175;7765;7839;10.27;0.62;235.54;7.59;729;56;2686.00;74
7040;56;628381605;7040;183;7767;7839;10.18;0.62;235.54;7.61;727;56;2687.00;72
7042;56;628381615;7042;185;7778;7852;10.05;0.61;235.56;7.60;736;56;2688.00;74
7045;56;628381626;7045;193;7780;7852;10.03;0.61;235.57;7.62;735;56;2689.00;72
7048;56;628381636;7048;192;7781;7852;9.97;0.61;235.60;7.62;733;56;2690.00;71
7049;56;628381646;7049;193;7783;7853;9.92;0.60;235.61;7.63;734;56;2691.00;70
7052;56;628381656;7052;200;7784;7853;9.85;0.60;235.62;7.65;732;56;2692.00;69
7055;56;628381666;7055;207;7788;7857;9.87;0.60;235.64;7.65;733;56;2693.00;69
7056;56;628381677;7056;213;7789;7857;9.87;0.60;235.63;7.66;733;56;2694.00;68
7061;56;628381686;7061;216;7794;7861;9.75;0.59;235.67;7.65;733;56;2695.00;67
7062;56;628381699;7062;225;7794;7861;9.65;0.59;235.66;7.65;732;56;2696.00;67
7064;56;628381713;7064;225;7797;7861;9.49;0.58;235.65;7.68;733;56;2697.00;64
7068;56;628381739;7068;230;7797;7861;9.28;0.57;235.67;7.68;729;56;2698.00;64
7072;56;628381766;7072;234;7799;7861;9.09;0.55;235.68;7.69;727;56;2699.00;62
7076;56;628381786;7076;234;7821;7910;9.03;0.55;235.65;7.67;745;56;2700.00;89
7078;56;628381816;7078;232;7824;7910;8.91;0.55;235.67;7.67;746;56;2701.00;86
7080;56;628381827;7080;230;7827;7910;8.85;0.54;235.66;7.67;747;56;2702.00;83
7081;56;628381844;7081;226;7830;7910;8.80;0.54;235.64;7.67;749;56;2703.00;80
7084;56;628381854;7084;221;7831;7910;8.74;0.54;235.65;7.67;747;56;2704.00;79
7086;56;628381870;7086;219;7833;7910;8.75;0.54;235.63;7.67;747;56;2705.00;77
7089;56;628381882;7089;221;7836;7911;8.72;0.53;235.62;7.68;747;56;2706.00;75
7091;56;628381893;7091;222;7837;7911;8.73;0.54;235.62;7.68;746;56;2707.00;74
7095;56;628381904;7095;225;7842;7917;8.70;0.53;235.61;7.67;747;56;2708.00;75
7097;56;628381916;7097;227;7844;7918;8.69;0.53;235.62;7.68;747;56;2709.00;74
7101;56;628381927;7101;235;7844;7918;8.65;0.53;235.61;7.68;743;56;2710.00;74
7104;56;628381937;7104;241;7846;7918;8.54;0.52;235.57;7.69;742;56;2711.00;72
7106;56;628381955;7106;245;7850;7922;8.51;0.52;235.53;7.69;744;56;2712.00;72
7116;56;628381966;7116;250;7854;7922;8.37;0.51;235.53;7.70;738;56;2713.00;68
7118;56;628381977;7118;253;7855;7922;8.37;0.51;235.53;7.70;737;56;2714.00;67
7123;56;628381987;7123;255;7856;7923;8.32;0.51;235.59;7.70;733;56;2715.00;67
7128;56;628381996;7128;257;7860;7927;8.23;0.50;235.63;7.69;732;56;2716.00;67
7130;56;628382013;7130;259;7860;7927;8.25;0.50;235.63;7.69;730;56;2717.00;67
7138;56;628382024;7138;260;7864;7930;8.24;0.50;235.58;7.69;726;56;2718.00;66
7141;56;628382034;7141;261;7865;7930;8.19;0.50;235.57;7.70;724;56;2719.00;65
7144;56;628382044;7144;253;7866;7930;8.08;0.49;235.56;7.70;722;56;2720.00;64
7146;56;628382053;7146;244;7868;7930;8.01;0.49;235.54;7.70;722;56;2721.00;62
7148;56;628382062;7148;245;7870;7934;7.99;0.49;235.61;7.70;722;56;2722.00;64
7154;56;628382072;7154;244;7870;7934;7.92;0.48;235.68;7.70;716;56;2723.00;64
7155;57;628382081;7155;244;7870;7934;7.87;0.48;235.68;7.70;715;57;2724.00;64
7159;57;628382099;7159;240;7871;7934;7.80;0.48;235.72;7.70;712;57;2725.00;63
7160;57;628382114;7160;239;7873;7935;7.81;0.48;235.77;7.70;713;57;2726.00;62
7164;57;628382123;7164;233;7874;7936;7.79;0.47;235.80;7.70;710;57;2727.00;62
7170;57;628382133;7170;223;7874;7936;7.74;0.47;235.89;7.70;704;57;2728.00;62
7171;57;628382143;7171;224;7875;7937;7.83;0.48;235.92;7.70;704;57;2729.00;62
7175;57;628382154;7175;223;7875;7937;7.90;0.48;235.97;7.70;700;57;2730.00;62
7177;57;628382164;7177;223;7877;7937;8.03;0.49;236.00;7.70;700;57;2731.00;60
7182;57;628382173;7182;223;7877;7937;8.09;0.49;236.12;7.70;695;57;2732.00;60
7185;57;628382182;7185;225;7879;7937;8.17;0.50;236.10;7.71;694;57;2733.00;58
7188;57;628382192;7188;228;7879;7937;8.22;0.50;236.14;7.71;691;57;2734.00;58
7196;57;628382201;7196;230;7880;7937;8.22;0.50;236.14;7.71;684;57;2735.00;57
7200;57;628382211;7200;240;7948;8064;8.40;0.52;236.14;7.64;748;57;2736.00;116
7203;57;628382232;7203;229;7955;8065;8.45;0.52;236.19;7.64;752;57;2737.00;110
7207;57;628382243;7207;223;7959;8065;8.48;0.52;236.25;7.64;752;57;2738.00;106
7210;57;628382253;7210;226;7963;8065;8.48;0.53;236.27;7.64;753;57;2739.00;102
7214;57;628382263;7214;224;7966;8065;8.54;0.53;236.28;7.64;752;57;2740.00;99
7220;57;628382274;7220;222;7968;8065;8.46;0.52;236.27;7.74;748;57;2741.00;97
7223;57;628382285;7223;221;7971;8065;8.42;0.52;236.24;7.74;748;57;2742.00;94
7227;57;628382295;7227;222;7974;8065;8.43;0.52;236.29;7.74;747;57;2743.00;91
7231;57;628382306;7231;225;7979;8066;8.45;0.52;236.38;7.74;748;57;2744.00;87
7233;57;628382318;7233;221;7984;8068;8.50;0.52;236.38;7.74;751;57;2745.00;84
7237;57;628382328;7237;232;7987;8068;8.48;0.52;236.47;7.74;750;57;2746.00;81
7240;57;628382338;7240;227;7989;8069;8.50;0.52;236.45;7.74;749;57;2747.00;80
7245;57;628382349;7245;229;7992;8069;8.44;0.52;236.47;7.74;747;57;2748.00;77
7248;57;628382359;7248;224;7996;8069;8.41;0.52;236.46;7.75;748;57;2749.00;73
7251;57;628382369;7251;222;7999;8069;8.39;0.52;236.45;7.75;748;57;2750.00;70
7253;57;628382381;7253;224;8002;8073;8.35;0.51;236.44;7.75;749;57;2751.00;71
7256;57;628382392;7256;227;8006;8073;8.29;0.51;236.50;7.75;750;57;2752.00;67
7260;57;628382402;7260;229;8007;8073;8.27;0.51;236.51;7.75;747;57;2753.00;66
7265;57;628382413;7265;238;8009;8076;8.27;0.51;236.55;7.75;744;57;2754.00;67
7267;57;628382424;7267;245;8010;8076;8.28;0.51;236.53;7.75;743;57;2755.00;66
7271;57;628382435;7271;252;8012;8076;8.26;0.51;236.58;7.75;741;57;2756.00;64
7274;57;628382446;7274;260;8016;8080;8.34;0.51;236.64;7.75;742;57;2757.00;64
7275;57;628382456;7275;273;8018;8081;8.38;0.52;236.65;7.75;743;57;2758.00;63
7279;57;628382468;7279;278;8018;8081;8.34;0.51;236.69;7.75;739;57;2759.00;63
7283;57;628382480;7283;280;8023;8086;8.23;0.51;236.65;7.75;740;57;2760.00;63
7286;57;628382492;7286;288;8023;8086;8.13;0.50;236.63;7.75;737;57;2761.00;63
7288;57;628382502;7288;290;8023;8086;8.04;0.49;236.64;7.75;735;57;2762.00;63
7291;57;628382512;7291;294;8024;8087;7.96;0.49;236.64;7.75;733;57;2763.00;63
7294;57;628382523;7294;297;8024;8087;7.80;0.48;236.68;7.75;730;57;2764.00;63
7296;57;628382534;7296;304;8028;8093;7.70;0.47;236.73;7.74;732;57;2765.00;65
7299;57;628382544;7299;307;8028;8093;7.55;0.46;236.70;7.74;729;57;2766.00;65
7300;57;628382554;7300;303;8029;8094;7.53;0.46;236.67;7.74;729;57;2767.00;65
7302;57;628382564;7302;300;8029;8094;7.53;0.46;236.66;7.74;727;57;2768.00;65
7303;57;628382574;7303;293;8029;8094;7.55;0.46;236.65;7.74;726;57;2769.00;65
7308;57;628382584;7308;289;8029;8094;7.60;0.46;236.61;7.74;721;57;2770.00;65
7309;57;628382595;7309;290;8029;8094;7.72;0.47;236.60;7.74;720;57;2771.00;65
7313;57;628382606;7313;286;8038;8106;7.81;0.48;236.66;7.73;725;57;2772.00;68
7317;57;628382617;7317;285;8038;8106;7.82;0.47;236.70;7.73;721;57;2773.00;68
7319;57;628382628;7319;289;8040;8106;7.88;0.48;236.69;7.73;721;57;2774.00;66
7322;57;628382638;7322;286;8040;8106;7.91;0.48;236.72;7.73;718;57;2775.00;66
7325;57;628382649;7325;265;8040;8106;7.95;0.48;236.70;7.73;715;57;2776.00;66
7326;57;628382659;7326;252;8040;8106;8.06;0.49;236.67;7.73;714;57;2777.00;66
7328;57;628382670;7328;241;8043;8110;8.12;0.49;236.68;7.73;715;57;2778.00;67
7331;57;628382681;7331;236;8043;8110;8.23;0.50;236.69;7.73;712;57;2779.00;67
7332;57;628382691;7332;232;8046;8114;8.34;0.51;236.67;7.73;714;57;2780.00;68
7335;57;628382709;7335;227;8047;8115;8.46;0.51;236.63;7.73;712;57;2781.00;68
7336;57;628382721;7336;227;8048;8115;8.52;0.52;236.60;7.72;712;57;2782.00;67
7337;57;628382732;7337;224;8049;8115;8.62;0.53;236.58;7.83;712;57;2783.00;66
7339;57;628382744;7339;226;8060;8128;8.73;0.53;236.55;7.82;721;57;2784.00;68
7341;57;628382755;7341;226;8060;8128;8.78;0.54;236.54;7.82;719;57;2785.00;68
7342;57;628382765;7342;225;8060;8128;8.79;0.54;236.52;7.82;718;57;2786.00;68
7343;57;628382774;7343;229;8061;8129;8.83;0.54;236.53;7.82;718;57;2787.00;68
7345;57;628382784;7345;227;8061;8130;8.81;0.54;236.48;7.82;716;57;2788.00;69
7345;57;628382795;7345;225;8061;8130;8.82;0.54;236.48;7.82;716;57;2789.00;69
7348;57;628382806;7348;228;8064;8136;8.84;0.54;236.46;7.82;716;57;2790.00;72
7350;57;628382822;7350;232;8065;8136;8.85;0.54;236.45;7.82;715;57;2791.00;71
7351;57;628382832;7351;230;8065;8136;8.84;0.54;236.42;7.82;714;57;2792.00;71
7353;57;628382841;7353;236;8066;8136;8.80;0.53;236.39;7.82;713;57;2793.00;70
7354;57;628382850;7354;234;8069;8142;8.76;0.53;236.40;7.81;715;57;2794.00;73
7356;57;628382860;7356;237;8070;8142;8.78;0.53;236.38;7.81;714;57;2795.00;72
7356;58;628382869;7356;239;8070;8142;8.80;0.53;236.38;7.81;714;58;2796.00;72
7358;58;628382889;7358;237;8071;8142;8.84;0.54;236.35;7.81;713;58;2797.00;71
7358;58;628382899;7358;241;8074;8146;8.88;0.54;236.35;7.81;716;58;2798.00;72
7362;58;628382916;7362;239;8076;8147;8.89;0.54;236.28;7.81;714;58;2799.00;71
7362;58;628382926;7362;244;8076;8147;8.89;0.54;236.28;7.81;714;58;2800.00;71
7362;58;628382940;7362;247;8077;8148;8.93;0.54;236.28;7.81;715;58;2801.00;71
7362;58;628382950;7362;248;8077;8148;8.93;0.54;236.28;7.81;715;58;2802.00;71
7363;58;628382958;7363;233;8077;8148;8.98;0.54;236.29;7.81;714;58;2803.00;71
7365;58;628382968;7365;219;8077;8148;9.11;0.55;236.27;7.81;712;58;2804.00;71
7366;58;628382978;7366;211;8077;8148;9.33;0.57;236.30;7.81;711;58;2805.00;71
7369;58;628382987;7369;209;8077;8148;9.51;0.58;236.26;7.81;708;58;2806.00;71
7369;58;628382997;7369;198;8077;8148;9.65;0.59;236.26;7.81;708;58;2807.00;71
7372;58;628383007;7372;207;8119;8218;9.58;0.58;236.25;7.77;747;58;2808.00;99
7373;58;628383029;7373;192;8120;8219;9.76;0.59;236.23;7.87;747;58;2809.00;99
7374;58;628383040;7374;186;8126;8219;9.96;0.61;236.23;7.87;752;58;2810.00;93
7374;58;628383050;7374;176;8131;8219;10.22;0.62;236.23;7.87;757;58;2811.00;88
7375;58;628383060;7375;170;8136;8219;10.36;0.63;236.22;7.86;761;58;2812.00;83
7376;58;628383080;7376;170;8140;8219;10.41;0.63;236.20;7.86;764;58;2813.00;79
7378;58;628383089;7378;168;8142;8219;10.50;0.64;236.20;7.86;764;58;2814.00;77
7380;58;628383099;7380;168;8142;8219;10.53;0.64;236.18;7.86;762;58;2815.00;77
7383;58;628383109;7383;167;8144;8220;10.64;0.65;236.21;7.86;761;58;2816.00;76
7383;58;628383120;7383;168;8145;8221;10.76;0.66;236.21;7.86;762;58;2817.00;76
7384;58;628383135;7384;164;8146;8221;10.86;0.66;236.21;7.86;762;58;2818.00;75
7385;58;628383146;7385;161;8149;8225;10.84;0.66;236.21;7.86;764;58;2819.00;76
7388;58;628383158;7388;162;8149;8225;10.89;0.66;236.22;7.86;761;58;2820.00;76
7388;58;628383168;7388;155;8149;8225;10.92;0.67;236.22;7.86;761;58;2821.00;76
7392;58;628383178;7392;146;8149;8225;10.93;0.67;236.19;7.86;757;58;2822.00;76
7395;58;628383189;7395;143;8153;8231;10.89;0.66;236.21;7.96;758;58;2823.00;78
7395;58;628383199;7395;141;8154;8231;10.89;0.66;236.21;7.96;759;58;2824.00;77
7398;58;628383209;7398;142;8156;8231;10.89;0.66;236.24;7.98;758;58;2825.00;75
7403;58;628383220;7403;138;8158;8234;10.97;0.67;236.31;7.97;755;58;2826.00;76
7408;58;628383231;7408;131;8159;8234;10.98;0.67;236.37;7.97;751;58;2827.00;75
7412;58;628383242;7412;127;8160;8234;11.03;0.67;236.39;8.08;748;58;2828.00;74
7419;58;628383252;7419;117;8160;8235;11.02;0.67;236.38;8.08;741;58;2829.00;75
7422;58;628383263;7422;117;8161;8236;11.12;0.68;236.41;8.08;739;58;2830.00;75
7426;58;628383274;7426;110;8161;8236;11.17;0.68;236.45;8.08;735;58;2831.00;75
7432;58;628383284;7432;112;8171;8249;11.17;0.68;236.43;8.07;739;58;2832.00;78
7433;58;628383295;7433;114;8172;8249;11.25;0.68;236.47;8.17;739;58;2833.00;77
7437;58;628383306;7437;114;8172;8249;11.24;0.68;236.48;8.17;735;58;2834.00;77
7439;58;628383316;7439;116;8174;8251;11.35;0.69;236.49;8.16;735;58;2835.00;77
7442;58;628383326;7442;117;8174;8251;11.43;0.69;236.49;8.16;732;58;2836.00;77
7445;58;628383338;7445;120;8178;8255;11.45;0.69;236.51;8.16;733;58;2837.00;77
7447;58;628383349;7447;128;8179;8255;11.44;0.70;236.52;8.16;732;58;2838.00;76
7455;58;628383359;7455;129;8182;8259;11.27;0.68;236.61;8.16;727;58;2839.00;77
7455;58;628383370;7455;128;8183;8259;11.29;0.69;236.61;8.16;728;58;2840.00;76
7458;58;628383380;7458;137;8183;8259;11.26;0.68;236.65;8.16;725;58;2841.00;76
7459;58;628383392;7459;138;8183;8259;11.20;0.68;236.66;8.16;724;58;2842.00;76
7461;58;628383402;7461;144;8184;8259;11.14;0.68;236.66;8.26;723;58;2843.00;75
7463;58;628383413;7463;140;8193;8271;11.04;0.67;236.70;8.25;730;58;2844.00;78
7467;58;628383425;7467;145;8194;8271;10.88;0.66;236.74;8.25;727;58;2845.00;77
7472;58;628383435;7472;149;8195;8271;10.83;0.66;236.71;8.25;723;58;2846.00;76
7473;58;628383446;7473;153;8195;8271;10.84;0.66;236.76;8.25;722;58;2847.00;76
7477;58;628383462;7477;159;8195;8271;10.77;0.65;236.82;8.25;718;58;2848.00;76
7479;58;628383474;7479;165;8195;8271;10.74;0.65;236.89;8.25;716;58;2849.00;76
7482;58;628383486;7482;166;8199;8274;10.64;0.64;236.92;8.27;717;58;2850.00;75
7484;58;628383497;7484;165;8199;8274;10.63;0.64;236.97;8.27;715;58;2851.00;75
7487;58;628383507;7487;167;8203;8280;10.62;0.64;237.03;8.27;716;58;2852.00;77
7490;58;628383518;7490;171;8207;8281;10.56;0.64;237.01;8.29;717;58;2853.00;74
7493;58;628383529;7493;174;8207;8281;10.42;0.63;236.98;8.29;714;58;2854.00;74
7494;58;628383539;7494;182;8208;8281;10.35;0.63;236.98;8.30;714;58;2855.00;73
7497;58;628383550;7497;186;8212;8285;10.25;0.62;237.00;8.31;715;58;2856.00;73
7499;58;628383565;7499;190;8212;8285;10.24;0.62;236.99;8.31;713;58;2857.00;73
7502;58;628383576;7502;194;8214;8285;10.20;0.62;237.01;8.33;712;58;2858.00;71
7505;58;628383586;7505;199;8216;8286;10.23;0.62;236.97;8.34;711;58;2859.00;70
7505;58;628383597;7505;204;8220;8290;10.16;0.62;236.97;8.34;715;58;2860.00;70
7507;59;628383607;7507;206;8221;8290;10.09;0.61;236.97;8.35;714;59;2861.00;69
7511;59;628383630;7511;212;8225;8293;10.07;0.61;237.04;8.37;714;59;2862.00;68
7511;59;628383640;7511;216;8226;8293;10.01;0.61;237.04;8.37;715;59;2863.00;67
7515;59;628383650;7515;229;8230;8295;9.93;0.60;237.09;8.38;715;59;2864.00;65
7517;59;628383660;7517;234;8231;8295;9.84;0.60;237.10;8.39;714;59;2865.00;64
7517;59;628383669;7517;233;8235;8299;9.81;0.60;237.10;8.39;718;59;2866.00;64
7521;59;628383679;7521;239;8237;8299;9.76;0.59;237.08;8.39;716;59;2867.00;62
7523;59;628383688;7523;244;8238;8299;9.70;0.59;237.15;8.40;715;59;2868.00;61
7524;59;628383700;7524;241;8239;8299;9.65;0.59;237.14;8.40;715;59;2869.00;60
7528;59;628383714;7528;234;8240;8300;9.50;0.58;237.15;8.40;712;59;2870.00;60
7530;59;628383732;7530;236;8241;8301;9.39;0.57;237.16;8.40;711;59;2871.00;60
7532;59;628383746;7532;227;8242;8301;9.27;0.56;237.15;8.41;710;59;2872.00;59
7535;59;628383762;7535;226;8243;8302;9.20;0.56;237.14;8.41;708;59;2873.00;59
7537;59;628383776;7537;223;8243;8302;9.12;0.56;237.14;8.41;706;59;2874.00;59
7538;59;628383797;7538;219;8244;8302;9.04;0.55;237.14;8.41;706;59;2875.00;58
7545;59;628383810;7545;214;8247;8302;8.93;0.54;237.09;8.43;702;59;2876.00;55
7546;59;628383821;7546;213;8247;8302;8.86;0.54;237.11;8.43;701;59;2877.00;55
7547;59;628383831;7547;211;8249;8302;8.78;0.54;237.11;8.43;702;59;2878.00;53
7551;59;628383842;7551;212;8249;8302;8.72;0.53;237.14;8.43;698;59;2879.00;53
7552;59;628383853;7552;249;8353;8532;8.60;0.54;237.18;8.33;801;59;2880.00;179
7553;59;628383882;7553;245;8358;8533;8.56;0.54;237.16;8.33;805;59;2881.00;175
7558;59;628383893;7558;237;8367;8533;8.51;0.53;237.18;8.32;809;59;2882.00;166
7563;59;628383904;7563;236;8375;8533;8.47;0.53;237.18;8.32;812;59;2883.00;158
7568;59;628383915;7568;234;8380;8533;8.47;0.53;237.19;8.31;812;59;2884.00;153
7571;59;628383926;7571;236;8385;8533;8.56;0.53;237.20;8.31;814;59;2885.00;148
7576;59;628383937;7576;239;8392;8533;8.52;0.53;237.21;8.31;816;59;2886.00;141
7580;59;628383947;7580;245;8396;8533;8.47;0.53;237.20;8.31;816;59;2887.00;137
7585;59;628383958;7585;251;8404;8534;8.36;0.52;237.23;8.31;819;59;2888.00;130
7586;59;628383969;7586;261;8410;8535;8.30;0.52;237.26;8.31;824;59;2889.00;125
7591;59;628383979;7591;255;8415;8535;8.19;0.51;237.31;8.31;824;59;2890.00;120
7599;59;628383991;7599;256;8420;8536;8.07;0.50;237.40;8.31;821;59;2891.00;116
7602;59;628384002;7602;261;8423;8536;7.95;0.49;237.42;8.31;821;59;2892.00;113
7608;59;628384015;7608;268;8428;8536;7.71;0.48;237.48;8.32;820;59;2893.00;108
7611;59;628384027;7611;277;8430;8536;7.61;0.47;237.52;8.32;819;59;2894.00;106
7615;59;628384038;7615;280;8436;8540;7.46;0.46;237.52;8.32;821;59;2895.00;104
7621;59;628384050;7621;290;8437;8540;7.28;0.45;237.54;8.32;816;59;2896.00;103
7622;59;628384061;7622;284;8441;8540;7.18;0.45;237.53;8.33;819;59;2897.00;99
7625;59;628384073;7625;284;8443;8543;7.21;0.45;237.55;8.33;818;59;2898.00;100
7628;59;628384085;7628;285;8445;8543;7.24;0.45;237.58;8.33;817;59;2899.00;98
7631;59;628384096;7631;276;8449;8543;7.24;0.45;237.52;8.33;818;59;2900.00;94
7635;59;628384111;7635;281;8452;8547;7.29;0.45;237.60;8.33;817;59;2901.00;95
7635;59;628384123;7635;286;8454;8548;7.38;0.45;237.60;8.33;819;59;2902.00;94
7639;59;628384134;7639;286;8456;8548;7.42;0.46;237.74;8.34;817;59;2903.00;92
7644;59;628384146;7644;284;8463;8552;7.40;0.46;237.70;8.43;819;59;2904.00;89
7650;59;628384159;7650;283;8466;8552;7.37;0.45;237.72;8.44;816;59;2905.00;86
7653;59;628384171;7653;292;8466;8552;7.38;0.45;237.75;8.44;813;59;2906.00;86
7657;59;628384182;7657;299;8470;8553;7.37;0.45;237.77;8.44;813;59;2907.00;83
7662;59;628384192;7662;298;8473;8553;7.30;0.45;237.80;8.45;811;59;2908.00;80
7663;59;628384203;7663;300;8477;8559;7.41;0.45;237.80;8.45;814;59;2909.00;82
7668;59;628384217;7668;296;8481;8559;7.40;0.45;237.82;8.46;813;59;2910.00;78
7675;59;628384228;7675;292;8484;8560;7.37;0.45;237.87;8.46;809;59;2911.00;76
7675;59;628384241;7675;292;8486;8560;7.43;0.45;237.87;8.46;811;59;2912.00;74
7680;59;628384252;7680;293;8487;8560;7.42;0.45;237.96;8.47;807;59;2913.00;73
7686;59;628384264;7686;303;8487;8560;7.35;0.45;237.99;8.47;801;59;2914.00;73
7688;59;628384275;7688;309;8488;8560;7.36;0.45;237.97;8.47;800;59;2915.00;72
7693;59;628384287;7693;318;8498;8572;7.41;0.45;238.01;8.46;805;59;2916.00;74
7697;59;628384299;7697;321;8499;8572;7.38;0.45;238.11;8.46;802;59;2917.00;73
7701;59;628384310;7701;323;8500;8572;7.35;0.45;238.06;8.46;799;59;2918.00;72
7705;59;628384321;7705;325;8501;8572;7.30;0.45;238.12;8.55;796;59;2919.00;71
7707;59;628384337;7707;322;8501;8572;7.20;0.44;238.17;8.55;794;59;2920.00;71
7711;59;628384349;7711;328;8501;8572;7.15;0.44;238.18;8.55;790;59;2921.00;71
7712;59;628384360;7712;332;8504;8576;7.14;0.44;238.18;8.54;792;59;2922.00;72
7715;59;628384371;7715;340;8504;8576;7.08;0.43;238.16;8.54;789;59;2923.00;72
7717;59;628384382;7717;340;8507;8580;7.07;0.43;238.15;8.54;790;59;2924.00;73
7718;59;628384393;7718;345;8510;8582;7.14;0.44;238.14;8.54;792;59;2925.00;72
7720;59;628384404;7720;343;8510;8582;7.10;0.43;238.17;8.54;790;59;2926.00;72
7721;59;628384420;7721;344;8510;8582;7.12;0.44;238.15;8.54;789;59;2927.00;72
7722;59;628384430;7722;355;8521;8595;7.15;0.44;238.17;8.53;799;59;2928.00;74
7725;59;628384442;7725;360;8522;8595;7.06;0.43;238.19;8.62;797;59;2929.00;73
7730;59;628384452;7730;358;8522;8595;6.99;0.43;238.17;8.62;792;59;2930.00;73
7732;59;628384464;7732;358;8523;8596;6.99;0.43;238.16;8.62;791;59;2931.00;73
7733;59;628384476;7733;364;8523;8597;6.96;0.43;238.18;8.62;790;59;2932.00;74
7738;59;628384486;7738;371;8523;8597;6.90;0.42;238.17;8.62;785;59;2933.00;74
7740;59;628384503;7740;376;8525;8600;6.90;0.42;238.12;8.61;785;59;2934.00;75
7740;59;628384514;7740;382;8526;8600;6.95;0.43;238.12;8.61;786;59;2935.00;74
7744;59;628384525;7744;386;8526;8600;6.85;0.42;238.06;8.61;782;59;2936.00;74
7747;59;628384535;7747;378;8526;8600;6.87;0.42;238.03;8.61;779;59;2937.00;74
7752;59;628384546;7752;376;8530;8606;6.86;0.42;238.07;8.61;778;59;2938.00;76
7754;59;628384556;7754;373;8530;8606;6.87;0.42;238.08;8.61;776;59;2939.00;76
7759;59;628384569;7759;369;8531;8606;6.89;0.42;238.03;8.61;772;59;2940.00;75
7764;59;628384580;7764;366;8531;8606;6.93;0.42;238.13;8.61;767;59;2941.00;75
7765;59;628384591;7765;365;8534;8610;7.06;0.43;238.11;8.61;769;59;2942.00;76
7769;59;628384602;7769;367;8535;8611;7.09;0.43;238.10;8.60;766;59;2943.00;76
7773;59;628384613;7773;374;8535;8611;7.12;0.43;238.17;8.60;762;59;2944.00;76
7776;59;628384623;7776;371;8536;8612;7.14;0.43;238.11;8.60;760;59;2945.00;76
7779;59;628384641;7779;357;8536;8612;7.21;0.44;238.10;8.60;757;59;2946.00;76
7782;59;628384651;7782;343;8536;8612;7.19;0.44;238.05;8.60;754;59;2947.00;76
7783;59;628384662;7783;331;8536;8612;7.24;0.44;238.02;8.60;753;59;2948.00;76
7784;59;628384673;7784;325;8536;8612;7.31;0.44;238.02;8.60;752;59;2949.00;76
7784;59;628384684;7784;319;8536;8612;7.39;0.45;238.02;8.60;752;59;2950.00;76
7787;59;628384695;7787;312;8536;8612;7.48;0.46;238.03;8.60;749;59;2951.00;76
7788;59;628384708;7788;308;8570;8682;7.72;0.47;238.02;8.66;782;59;2952.00;112
7788;59;628384726;7788;291;8570;8683;7.85;0.48;238.02;8.66;782;59;2953.00;113
7790;60;628384737;7790;282;8577;8683;8.03;0.49;237.98;8.66;787;60;2954.00;106
7790;60;628384765;7790;262;8580;8683;8.19;0.50;237.98;8.65;790;60;2955.00;103
7793;60;628384775;7793;252;8583;8683;8.37;0.51;238.00;8.65;790;60;2956.00;100
7793;60;628384786;7793;243;8586;8683;8.52;0.52;238.00;8.65;793;60;2957.00;97
7795;60;628384797;7795;229;8589;8683;8.66;0.53;238.03;8.65;794;60;2958.00;94
7796;60;628384808;7796;221;8591;8683;8.80;0.54;238.00;8.65;795;60;2959.00;92
7800;60;628384820;7800;218;8593;8684;8.89;0.54;237.98;8.65;793;60;2960.00;91
7800;60;628384831;7800;211;8596;8685;9.04;0.55;237.98;8.65;796;60;2961.00;89
7801;60;628384848;7801;209;8598;8685;9.17;0.56;237.96;8.65;797;60;2962.00;87
7803;60;628384859;7803;202;8601;8689;9.24;0.56;237.96;8.65;798;60;2963.00;88
7805;60;628384870;7805;196;8601;8689;9.33;0.57;238.03;8.65;796;60;2964.00;88
7805;60;628384887;7805;185;8601;8689;9.44;0.57;238.03;8.65;796;60;2965.00;88
7807;61;628384898;7807;184;8601;8689;9.58;0.58;238.03;8.65;794;61;2966.00;88
7809;62;628384926;7809;178;8604;8695;9.68;0.59;238.11;8.64;795;62;2967.00;91
7809;62;628384949;7809;181;8604;8695;9.78;0.60;238.11;8.64;795;62;2968.00;91
7813;62;628384960;7813;178;8605;8695;9.94;0.61;238.08;8.64;792;62;2969.00;90
7814;62;628384974;7814;173;8608;8701;10.09;0.61;238.08;8.64;794;62;2970.00;93
7817;62;628384990;7817;175;8609;8701;10.16;0.62;238.08;8.64;792;62;2971.00;92
7817;62;628385007;7817;177;8609;8701;10.25;0.62;238.08;8.64;792;62;2972.00;92
7817;62;628385023;7817;173;8610;8702;10.32;0.63;238.08;8.64;793;62;2973.00;92
7818;62;628385034;7818;169;8611;8703;10.38;0.63;238.05;8.64;793;62;2974.00;92
7821;62;628385045;7821;164;8613;8703;10.45;0.64;238.06;8.73;792;62;2975.00;90
7823;62;628385056;7823;160;8621;8716;10.57;0.64;238.02;8.72;798;62;2976.00;95
7826;62;628385068;7826;155;8622;8716;10.62;0.65;238.06;8.72;796;62;2977.00;94
7827;62;628385079;7827;154;8622;8716;10.68;0.65;238.09;8.72;795;62;2978.00;94
7829;62;628385090;7829;152;8623;8717;10.80;0.66;238.05;8.72;794;62;2979.00;94
7832;62;628385101;7832;151;8623;8717;10.84;0.66;238.05;8.72;791;62;2980.00;94
7835;62;628385112;7835;151;8625;8721;10.93;0.67;238.05;8.72;790;62;2981.00;96
7840;62;628385123;7840;151;8625;8721;11.01;0.67;238.10;8.72;785;62;2982.00;96
7842;62;628385134;7842;150;8629;8725;11.01;0.67;238.11;8.72;787;62;2983.00;96
7847;62;628385146;7847;149;8629;8725;11.02;0.67;238.12;8.72;782;62;2984.00;96
7849;62;628385157;7849;156;8629;8725;10.97;0.67;238.17;8.72;780;62;2985.00;96
7853;62;628385168;7853;162;8629;8725;11.02;0.67;238.17;8.72;776;62;2986.00;96
7856;62;628385178;7856;164;8629;8725;11.01;0.67;238.21;8.72;773;62;2987.00;96
7861;62;628385188;7861;166;8638;8737;11.04;0.67;238.26;8.71;777;62;2988.00;99
7865;62;628385200;7865;166;8639;8737;11.01;0.67;238.35;8.71;774;62;2989.00;98
7870;62;628385210;7870;165;8642;8737;11.06;0.67;238.35;8.80;772;62;2990.00;95
7874;62;628385221;7874;167;8642;8737;11.07;0.67;238.39;8.80;768;62;2991.00;95
7877;62;628385232;7877;163;8642;8737;11.08;0.67;238.38;8.80;765;62;2992.00;95
7881;62;628385249;7881;165;8644;8737;11.09;0.67;238.40;8.90;763;62;2993.00;93
7885;62;628385260;7885;161;8646;8738;11.06;0.67;238.45;8.91;761;62;2994.00;92
7892;63;628385271;7892;154;8648;8738;11.06;0.67;238.43;8.93;756;63;2995.00;90
7898;63;628385291;7898;152;8651;8744;11.06;0.67;238.48;8.93;753;63;2996.00;93
7902;63;628385307;7902;152;8654;8745;11.09;0.67;238.51;9.02;752;63;2997.00;91
7904;63;628385318;7904;150;8654;8745;11.07;0.67;238.53;9.02;750;63;2998.00;91
7907;63;628385334;7907;146;8654;8745;11.09;0.67;238.54;9.02;747;63;2999.00;91
7912;63;628385348;7912;140;8658;8765;11.11;0.67;238.54;9.02;746;63;3000.00;107
7913;63;628385364;7913;141;8659;8765;11.13;0.67;238.55;9.02;746;63;3001.00;106
7916;63;628385375;7916;134;8659;8765;11.13;0.67;238.54;9.02;743;63;3002.00;106
7918;63;628385386;7918;129;8660;8766;11.15;0.67;238.56;9.02;742;63;3003.00;106
7921;63;628385397;7921;122;8663;8770;11.14;0.67;238.57;9.02;742;63;3004.00;107
7924;63;628385408;7924;115;8663;8770;11.05;0.67;238.57;9.02;739;63;3005.00;107
7926;63;628385419;7926;123;8667;8773;11.10;0.67;238.60;9.01;741;63;3006.00;106
7927;63;628385430;7927;122;8669;8773;11.15;0.67;238.61;9.02;742;63;3007.00;104
7929;63;628385441;7929;116;8669;8773;11.20;0.68;238.60;9.02;740;63;3008.00;104
7932;63;628385452;7932;128;8670;8773;11.30;0.68;238.64;9.03;738;63;3009.00;103
7935;63;628385463;7935;127;8673;8777;11.38;0.69;238.66;9.03;738;63;3010.00;104
7936;63;628385476;7936;127;8675;8777;11.39;0.69;238.64;9.04;739;63;3011.00;102
7941;63;628385488;7941;124;8679;8777;11.34;0.69;238.75;9.04;738;63;3012.00;98
7944;63;628385498;7944;130;8679;8777;11.37;0.69;238.75;9.04;735;63;3013.00;98
7946;63;628385510;7946;132;8679;8778;11.36;0.69;238.74;9.04;733;63;3014.00;99
7948;63;628385521;7948;132;8684;8780;11.36;0.69;238.73;9.04;736;63;3015.00;96
7951;63;628385532;7951;135;8685;8780;11.45;0.70;238.72;9.04;734;63;3016.00;95
7952;63;628385543;7952;138;8688;8781;11.53;0.70;238.71;9.04;736;63;3017.00;93
7955;63;628385554;7955;141;8688;8781;11.60;0.71;238.68;9.04;733;63;3018.00;93
7957;63;628385566;7957;139;8689;8781;11.61;0.71;238.67;9.05;732;63;3019.00;92
7958;63;628385576;7958;142;8691;8781;11.61;0.71;238.69;9.07;733;63;3020.00;90
7963;63;628385587;7963;148;8691;8781;11.59;0.71;238.70;9.07;728;63;3021.00;90
7965;63;628385599;7965;145;8692;8781;11.47;0.70;238.70;9.08;727;63;3022.00;89
7968;63;628385610;7968;150;8694;8781;11.39;0.70;238.71;9.09;726;63;3023.00;87
7969;63;628385621;7969;170;8756;8908;11.10;0.69;238.70;9.03;787;63;3024.00;152
7972;63;628385642;7972;168;8763;8909;11.04;0.68;238.66;9.04;791;63;3025.00;146
7974;63;628385654;7974;168;8771;8909;11.05;0.68;238.65;9.04;797;63;3026.00;138
7977;63;628385665;7977;166;8772;8909;11.01;0.68;238.67;9.04;795;63;3027.00;137
7983;63;628385676;7983;165;8780;8909;10.95;0.68;238.61;9.06;797;63;3028.00;129
7985;63;628385688;7985;173;8784;8909;10.85;0.67;238.65;9.07;799;63;3029.00;125
7989;63;628385703;7989;177;8791;8909;10.78;0.66;238.64;9.08;802;63;3030.00;118
7995;63;628385719;7995;182;8792;8909;10.69;0.66;238.63;9.08;797;63;3031.00;117
7999;63;628385739;7999;187;8796;8910;10.70;0.66;238.58;9.08;797;63;3032.00;114
8001;63;628385756;8001;198;8802;8911;10.59;0.65;238.62;9.10;801;63;3033.00;109
8003;63;628385781;8003;206;8805;8911;10.50;0.65;238.62;9.11;802;63;3034.00;106
8004;63;628385798;8004;213;8810;8912;10.32;0.64;238.60;9.12;806;63;3035.00;102
8007;63;628385814;8007;219;8813;8912;10.18;0.63;238.64;9.12;806;63;3036.00;99
8009;63;628385830;8009;227;8819;8912;10.00;0.62;238.63;9.14;810;63;3037.00;93
8012;63;628385842;8012;234;8821;8912;9.88;0.61;238.59;9.14;809;63;3038.00;91
8014;63;628385853;8014;240;8826;8916;9.73;0.60;238.63;9.15;812;63;3039.00;90
8020;63;628385866;8020;246;8828;8916;9.56;0.59;238.60;9.15;808;63;3040.00;88
8023;63;628385878;8023;246;8834;8916;9.44;0.58;238.57;9.16;811;63;3041.00;82
8025;63;628385891;8025;257;8837;8919;9.30;0.57;238.55;9.16;812;63;3042.00;82
8028;63;628385910;8028;259;8838;8919;9.19;0.57;238.50;9.16;810;63;3043.00;81
8029;63;628385921;8029;266;8840;8919;9.07;0.56;238.50;9.17;811;63;3044.00;79
8029;63;628385933;8029;265;8843;8923;8.96;0.55;238.50;9.16;814;63;3045.00;80
8030;63;628385945;8030;269;8846;8924;8.91;0.55;238.51;9.17;816;63;3046.00;78
8032;64;628385963;8032;268;8848;8924;8.78;0.54;238.48;9.18;816;64;3047.00;76
8037;64;628385994;8037;272;8853;8928;8.73;0.54;238.53;9.18;816;64;3048.00;75
8038;64;628386007;8038;276;8853;8928;8.75;0.54;238.52;9.18;815;64;3049.00;75
8042;64;628386018;8042;281;8853;8928;8.68;0.53;238.48;9.18;811;64;3050.00;75
8045;64;628386029;8045;278;8855;8929;8.57;0.53;238.47;9.19;810;64;3051.00;74
8048;64;628386047;8048;278;8856;8929;8.40;0.52;238.49;9.19;808;64;3052.00;73
8050;64;628386064;8050;284;8861;8935;8.35;0.51;238.52;9.19;811;64;3053.00;74
8057;64;628386076;8057;286;8862;8935;8.25;0.51;238.54;9.19;805;64;3054.00;73
8062;64;628386086;8062;286;8863;8936;8.16;0.50;238.54;9.19;801;64;3055.00;73
8067;64;628386097;8067;290;8864;8936;7.95;0.49;238.58;9.19;797;64;3056.00;72
8069;64;628386108;8069;294;8865;8936;7.82;0.48;238.60;9.19;796;64;3057.00;71
8074;64;628386118;8074;291;8867;8936;7.66;0.47;238.74;9.20;793;64;3058.00;69
8077;64;628386135;8077;292;8868;8936;7.50;0.46;238.74;9.20;791;64;3059.00;68
8081;64;628386147;8081;293;8890;8972;7.51;0.46;238.79;9.18;809;64;3060.00;82
8086;64;628386160;8086;287;8892;8972;7.41;0.46;238.83;9.19;806;64;3061.00;80
8092;64;628386170;8092;288;8895;8972;7.35;0.45;238.79;9.18;803;64;3062.00;77
8094;64;628386181;8094;287;8898;8972;7.25;0.45;238.82;9.18;804;64;3063.00;74
8096;64;628386197;8096;291;8901;8972;7.17;0.44;238.80;9.18;805;64;3064.00;71
8101;64;628386207;8101;298;8901;8972;7.09;0.44;238.91;9.18;800;64;3065.00;71
8101;64;628386223;8101;298;8906;8976;7.15;0.44;238.91;9.18;805;64;3066.00;70
8103;64;628386234;8103;297;8907;8976;7.14;0.44;238.92;9.18;804;64;3067.00;69
8106;64;628386244;8106;300;8909;8980;7.14;0.44;238.92;9.18;803;64;3068.00;71
8111;64;628386256;8111;305;8911;8981;7.05;0.43;238.92;9.18;800;64;3069.00;70
8112;64;628386266;8112;309;8912;8981;6.97;0.43;238.94;9.18;800;64;3070.00;69
8114;64;628386275;8114;312;8912;8981;6.90;0.42;238.95;9.18;798;64;3071.00;69
8118;64;628386285;8118;314;8924;8994;6.85;0.42;238.94;9.16;806;64;3072.00;70
8120;64;628386295;8120;311;8924;8994;6.78;0.42;238.95;9.16;804;64;3073.00;70
8124;64;628386305;8124;318;8924;8994;6.71;0.41;238.95;9.16;800;64;3074.00;70
8126;64;628386314;8126;319;8925;8995;6.67;0.41;238.96;9.16;799;64;3075.00;70
8128;64;628386323;8128;321;8925;8996;6.58;0.41;238.97;9.16;797;64;3076.00;71
8131;64;628386333;8131;320;8925;8996;6.53;0.40;238.98;9.16;794;64;3077.00;71
8131;64;628386343;8131;320;8927;8999;6.60;0.41;238.98;9.16;796;64;3078.00;72
8137;64;628386353;8137;318;8928;8999;6.57;0.40;238.96;9.16;791;64;3079.00;71
8141;64;628386362;8141;320;8928;8999;6.54;0.40;238.93;9.16;787;64;3080.00;71
8143;64;628386372;8143;320;8928;8999;6.54;0.40;238.97;9.16;785;64;3081.00;71
8149;64;628386381;8149;331;8932;9005;6.55;0.40;238.89;9.16;783;64;3082.00;73
8153;64;628386392;8153;331;8933;9005;6.52;0.40;239.00;9.16;780;64;3083.00;72
8157;64;628386402;8157;328;8933;9005;6.49;0.40;238.98;9.16;776;64;3084.00;72
8162;64;628386412;8162;323;8933;9005;6.46;0.39;238.92;9.16;771;64;3085.00;72
8168;64;628386422;8168;323;8936;9009;6.42;0.39;238.89;9.15;768;64;3086.00;73
8169;64;628386432;8169;329;8937;9010;6.43;0.39;238.92;9.15;768;64;3087.00;73
8174;64;628386442;8174;326;8937;9010;6.33;0.39;239.01;9.15;763;64;3088.00;73
8176;64;628386451;8176;332;8938;9011;6.35;0.39;239.00;9.15;762;64;3089.00;73
8181;64;628386463;8181;332;8938;9011;6.29;0.38;238.95;9.15;757;64;3090.00;73
8184;64;628386474;8184;337;8938;9011;6.28;0.38;238.94;9.15;754;64;3091.00;73
8187;64;628386497;8187;337;8938;9011;6.26;0.38;238.92;9.15;751;64;3092.00;73
8191;64;628386508;8191;342;8938;9011;6.22;0.38;238.89;9.15;747;64;3093.00;73
8193;64;628386517;8193;348;8938;9011;6.23;0.38;238.89;9.15;745;64;3094.00;73
8195;64;628386527;8195;351;8938;9011;6.28;0.38;238.94;9.15;743;64;3095.00;73
8197;64;628386536;8197;359;8977;9081;6.58;0.40;238.89;9.22;780;64;3096.00;104
8201;64;628386553;8201;354;8980;9082;6.58;0.40;238.88;9.21;779;64;3097.00;102
8203;64;628386563;8203;350;8985;9082;6.61;0.40;238.89;9.21;782;64;3098.00;97
8203;64;628386572;8203;350;8989;9082;6.65;0.41;238.89;9.21;786;64;3099.00;93
8205;64;628386582;8205;350;8991;9082;6.65;0.41;238.91;9.21;786;64;3100.00;91
8206;64;628386598;8206;355;8995;9082;6.71;0.41;238.91;9.20;789;64;3101.00;87
8208;64;628386608;8208;359;8996;9082;6.69;0.41;238.89;9.20;788;64;3102.00;86
8209;64;628386618;8209;361;9000;9082;6.72;0.41;238.88;9.20;791;64;3103.00;82
8212;64;628386628;8212;363;9004;9083;6.69;0.41;238.90;9.20;792;64;3104.00;79
8213;64;628386639;8213;369;9007;9085;6.71;0.41;238.99;9.20;794;64;3105.00;78
8215;64;628386649;8215;374;9008;9085;6.63;0.41;239.02;9.20;793;64;3106.00;77
8216;64;628386660;8216;359;9011;9089;6.66;0.41;239.00;9.20;795;64;3107.00;78
8220;64;628386671;8220;346;9011;9089;6.68;0.41;238.98;9.20;791;64;3108.00;78
8222;64;628386681;8222;336;9011;9089;6.68;0.41;239.00;9.20;789;64;3109.00;78
8222;64;628386695;8222;335;9011;9089;6.79;0.42;239.00;9.20;789;64;3110.00;78
8225;64;628386711;8225;330;9015;9095;6.87;0.42;239.09;9.19;790;64;3111.00;80
8226;64;628386724;8226;319;9015;9095;7.05;0.43;239.07;9.19;789;64;3112.00;80
8228;64;628386735;8228;311;9016;9095;7.18;0.44;239.03;9.19;788;64;3113.00;79
8229;64;628386754;8229;307;9018;9098;7.25;0.44;239.04;9.19;789;64;3114.00;80
8230;64;628386771;8230;298;9019;9098;7.37;0.45;239.04;9.19;789;64;3115.00;79
8232;65;628386782;8232;281;9019;9098;7.49;0.46;239.01;9.19;787;65;3116.00;79
8234;65;628386809;8234;266;9019;9099;7.66;0.47;239.01;9.19;785;65;3117.00;80
8234;65;628386821;8234;253;9020;9100;7.83;0.48;239.01;9.19;786;65;3118.00;80
8234;65;628386838;8234;237;9020;9100;8.04;0.49;239.01;9.19;786;65;3119.00;80
8237;65;628386851;8237;228;9040;9126;8.25;0.50;238.97;9.17;803;65;3120.00;86
8240;65;628386865;8240;213;9041;9126;8.47;0.52;238.97;9.17;801;65;3121.00;85
8242;65;628386876;8242;206;9042;9126;8.59;0.52;238.93;9.17;800;65;3122.00;84
8243;65;628386888;8243;197;9043;9127;8.80;0.54;238.90;9.17;800;65;3123.00;84
8244;65;628386899;8244;192;9043;9127;8.98;0.55;238.88;9.17;799;65;3124.00;84
8246;65;628386911;8246;183;9046;9131;9.14;0.56;238.86;9.16;800;65;3125.00;85
8246;65;628386923;8246;183;9047;9131;9.28;0.57;238.86;9.16;801;65;3126.00;84
8251;65;628386935;8251;181;9050;9135;9.39;0.57;238.90;9.16;799;65;3127.00;85
8252;65;628386948;8252;173;9050;9135;9.56;0.58;238.96;9.16;798;65;3128.00;85
8255;65;628386959;8255;173;9050;9135;9.63;0.59;239.06;9.16;795;65;3129.00;85
8256;65;628386971;8256;170;9050;9135;9.80;0.60;239.04;9.16;794;65;3130.00;85
8260;65;628386983;8260;164;9050;9135;9.92;0.60;239.02;9.16;790;65;3131.00;85
8262;65;628386995;8262;165;9060;9147;10.11;0.61;239.04;9.15;798;65;3132.00;87
8265;65;628387008;8265;158;9060;9147;10.21;0.62;239.01;9.15;795;65;3133.00;87
8270;65;628387021;8270;156;9061;9147;10.32;0.63;239.13;9.15;791;65;3134.00;86
8271;65;628387033;8271;159;9061;9147;10.46;0.64;239.17;9.15;790;65;3135.00;86
8274;65;628387044;8274;157;9061;9147;10.49;0.64;239.20;9.15;787;65;3136.00;86
8275;65;628387056;8275;158;9061;9147;10.62;0.64;239.22;9.15;786;65;3137.00;86
8280;65;628387068;8280;157;9061;9148;10.72;0.65;239.24;9.15;781;65;3138.00;87
8285;65;628387080;8285;151;9061;9148;10.79;0.65;239.24;9.15;776;65;3139.00;87
8287;65;628387091;8287;153;9065;9154;10.80;0.65;239.26;9.14;778;65;3140.00;89
8293;65;628387103;8293;152;9066;9155;10.85;0.66;239.25;9.14;773;65;3141.00;89
8296;65;628387116;8296;152;9067;9155;10.88;0.66;239.30;9.14;771;65;3142.00;88
8297;65;628387128;8297;153;9067;9155;10.97;0.66;239.29;9.14;770;65;3143.00;88
8301;65;628387140;8301;151;9070;9159;11.00;0.67;239.31;9.14;769;65;3144.00;89
8303;65;628387152;8303;147;9070;9159;10.97;0.66;239.34;9.14;767;65;3145.00;89
8305;65;628387163;8305;149;9070;9159;11.02;0.67;239.35;9.14;765;65;3146.00;89
8309;65;628387175;8309;151;9071;9160;11.07;0.67;239.39;9.14;762;65;3147.00;89
8309;65;628387186;8309;148;9074;9164;11.16;0.68;239.39;9.14;765;65;3148.00;90
8313;65;628387198;8313;145;9074;9164;11.20;0.68;239.37;9.14;761;65;3149.00;90
8315;65;628387211;8315;144;9077;9170;11.22;0.68;239.40;9.13;762;65;3150.00;93
8318;65;628387228;8318;144;9077;9170;11.33;0.69;239.48;9.13;759;65;3151.00;93
8321;65;628387240;8321;144;9078;9170;11.37;0.69;239.52;9.13;757;65;3152.00;92
8323;65;628387252;8323;144;9078;9170;11.32;0.69;239.55;9.13;755;65;3153.00;92
8327;65;628387264;8327;144;9081;9174;11.45;0.69;239.55;9.13;754;65;3154.00;93
8329;65;628387276;8329;139;9081;9174;11.56;0.70;239.58;9.13;752;65;3155.00;93
8333;65;628387288;8333;138;9082;9174;11.63;0.71;239.59;9.13;749;65;3156.00;92
8337;65;628387300;8337;135;9082;9174;11.68;0.71;239.60;9.13;745;65;3157.00;92
8342;65;628387311;8342;136;9083;9175;11.72;0.71;239.68;9.13;741;65;3158.00;92
8346;65;628387322;8346;136;9084;9176;11.76;0.71;239.66;9.13;738;65;3159.00;92
8349;65;628387333;8349;128;9085;9176;11.79;0.72;239.67;9.13;736;65;3160.00;91
8354;65;628387344;8354;124;9087;9177;11.79;0.72;239.80;9.24;733;65;3161.00;90
8359;65;628387356;8359;121;9087;9177;11.75;0.71;239.84;9.24;728;65;3162.00;90
8360;65;628387367;8360;118;9087;9177;11.83;0.72;239.84;9.24;727;65;3163.00;90
8363;65;628387378;8363;113;9088;9177;11.79;0.72;239.88;9.25;725;65;3164.00;89
8367;65;628387390;8367;107;9088;9177;11.86;0.72;239.93;9.25;721;65;3165.00;89
8370;65;628387401;8370;107;9089;9177;11.97;0.73;239.97;9.26;719;65;3166.00;88
8375;65;628387412;8375;103;9089;9177;12.01;0.73;239.97;9.26;714;65;3167.00;88
8379;65;628387422;8379;132;9160;9304;11.69;0.72;240.00;9.19;781;65;3168.00;144
8382;65;628387443;8382;123;9161;9305;11.59;0.71;240.04;9.19;779;65;3169.00;144
8384;65;628387455;8384;107;9168;9305;11.57;0.71;240.06;9.18;784;65;3170.00;137
8389;65;628387472;8389;107;9170;9305;11.58;0.71;240.06;9.18;781;65;3171.00;135
8391;65;628387483;8391;108;9172;9305;11.55;0.71;240.06;9.18;781;65;3172.00;133
8395;65;628387500;8395;109;9175;9305;11.57;0.71;240.08;9.18;780;65;3173.00;130
8397;65;628387512;8397;113;9178;9305;11.59;0.71;240.05;9.18;781;65;3174.00;127
8399;65;628387523;8399;114;9180;9305;11.64;0.71;240.06;9.18;781;65;3175.00;125
8401;65;628387535;8401;111;9184;9306;11.71;0.71;240.08;9.18;783;65;3176.00;122
8405;65;628387546;8405;113;9185;9307;11.78;0.72;240.13;9.18;780;65;3177.00;122
8409;65;628387558;8409;121;9192;9307;11.76;0.72;240.17;9.18;783;65;3178.00;115
8409;65;628387570;8409;117;9193;9308;11.69;0.71;240.17;9.18;784;65;3179.00;115
8413;65;628387583;8413;114;9200;9308;11.54;0.70;240.22;9.18;787;65;3180.00;108
8415;65;628387595;8415;116;9201;9308;11.48;0.70;240.24;9.18;786;65;3181.00;107
8416;65;628387606;8416;126;9202;9308;11.38;0.70;240.24;9.18;786;65;3182.00;106
8420;65;628387617;8420;133;9207;9312;11.31;0.69;240.25;9.18;787;65;3183.00;105
8423;65;628387629;8423;139;9208;9312;11.29;0.69;240.30;9.18;785;65;3184.00;104
8425;65;628387647;8425;141;9211;9312;11.24;0.69;240.26;9.19;786;65;3185.00;101
8429;65;628387659;8429;151;9213;9315;11.23;0.69;240.31;9.19;784;65;3186.00;102
8430;65;628387671;8430;161;9214;9315;11.17;0.68;240.31;9.19;784;65;3187.00;101
8431;65;628387682;8431;166;9215;9315;11.07;0.68;240.36;9.19;784;65;3188.00;100
8437;65;628387694;8437;165;9219;9319;11.05;0.67;240.41;9.19;782;65;3189.00;100
8441;65;628387711;8441;172;9221;9320;11.00;0.67;240.46;9.20;780;65;3190.00;99
8445;65;628387730;8445;172;9224;9322;11.04;0.67;240.47;9.21;779;65;3191.00;98
8449;65;628387750;8449;175;9228;9326;11.00;0.67;240.42;9.21;779;65;3192.00;98
8452;65;628387769;8452;176;9230;9326;10.91;0.66;240.40;9.23;778;65;3193.00;96
8452;65;628387785;8452;185;9230;9326;10.87;0.66;240.40;9.23;778;65;3194.00;96
8455;65;628387812;8455;188;9233;9328;10.86;0.66;240.39;9.23;778;65;3195.00;95
8456;65;628387827;8456;197;9234;9328;10.76;0.65;240.37;9.25;778;65;3196.00;94
8459;65;628387838;8459;201;9240;9334;10.65;0.65;240.39;9.25;781;65;3197.00;94
8462;65;628387859;8462;205;9241;9334;10.50;0.64;240.38;9.26;779;65;3198.00;93
8467;65;628387871;8467;213;9242;9335;10.38;0.63;240.43;9.27;775;65;3199.00;93
8470;65;628387885;8470;218;9244;9335;10.29;0.63;240.49;9.29;774;65;3200.00;91
8472;65;628387902;8472;222;9245;9335;10.22;0.62;240.48;9.30;773;65;3201.00;90
8475;65;628387920;8475;227;9247;9335;10.06;0.61;240.52;9.31;772;65;3202.00;88
8476;65;628387932;8476;231;9247;9335;9.97;0.61;240.52;9.31;771;65;3203.00;88
8481;65;628387943;8481;233;9259;9347;9.84;0.60;240.59;9.31;778;65;3204.00;88
8484;65;628387955;8484;242;9261;9347;9.75;0.60;240.58;9.32;777;65;3205.00;86
8487;65;628387965;8487;243;9261;9347;9.67;0.59;240.57;9.32;774;65;3206.00;86
8488;65;628387977;8488;249;9262;9347;9.50;0.58;240.57;9.33;774;65;3207.00;85
8489;65;628387987;8489;257;9263;9347;9.39;0.58;240.57;9.33;774;65;3208.00;84
8491;65;628387998;8491;260;9265;9347;9.22;0.57;240.56;9.35;774;65;3209.00;82
8495;65;628388010;8495;263;9268;9351;9.05;0.56;240.53;9.35;773;65;3210.00;83
8499;65;628388021;8499;262;9270;9351;8.95;0.55;240.55;9.36;771;65;3211.00;81
8502;65;628388031;8502;266;9273;9355;8.95;0.55;240.52;9.36;771;65;3212.00;82
8507;65;628388042;8507;261;9274;9356;8.85;0.54;240.50;9.36;767;65;3213.00;82
8509;65;628388052;8509;261;9277;9356;8.76;0.54;240.47;9.37;768;65;3214.00;79
8510;65;628388062;8510;261;9277;9356;8.73;0.54;240.44;9.37;767;65;3215.00;79
8513;65;628388072;8513;266;9287;9369;8.69;0.53;240.43;9.36;774;65;3216.00;82
8515;65;628388085;8515;268;9289;9369;8.57;0.53;240.41;9.37;774;65;3217.00;80
8517;65;628388097;8517;269;9290;9369;8.57;0.53;240.43;9.36;773;65;3218.00;79
8520;65;628388108;8520;272;9291;9370;8.51;0.52;240.47;9.36;771;65;3219.00;79
8521;65;628388121;8521;267;9293;9371;8.45;0.52;240.47;9.37;772;65;3220.00;78
8526;65;628388131;8526;265;9293;9371;8.37;0.51;240.49;9.37;767;65;3221.00;78
8530;65;628388142;8530;264;9295;9374;8.31;0.51;240.48;9.37;765;65;3222.00;79
8536;65;628388152;8536;269;9297;9374;8.24;0.50;240.43;9.38;761;65;3223.00;77
8540;65;628388162;8540;268;9298;9374;8.15;0.50;240.44;9.38;758;65;3224.00;76
8544;65;628388174;8544;273;9300;9374;8.04;0.49;240.48;9.38;756;65;3225.00;74
8549;65;628388184;8549;274;9304;9380;7.98;0.49;240.54;9.38;755;65;3226.00;76
8552;65;628388194;8552;276;9305;9380;7.85;0.48;240.60;9.38;753;65;3227.00;75
8559;65;628388203;8559;285;9307;9380;7.55;0.46;240.68;9.38;748;65;3228.00;73
8561;65;628388212;8561;285;9307;9380;7.35;0.45;240.64;9.38;746;65;3229.00;73
8566;65;628388221;8566;285;9310;9384;7.15;0.44;240.60;9.38;744;65;3230.00;74
8571;65;628388230;8571;286;9311;9385;7.01;0.43;240.64;9.38;740;65;3231.00;74
8573;65;628388240;8573;281;9313;9385;6.92;0.42;240.63;9.38;740;65;3232.00;72
8576;65;628388249;8576;287;9314;9386;6.82;0.42;240.66;9.38;738;65;3233.00;72
8577;65;628388257;8577;290;9316;9386;6.72;0.41;240.68;9.39;739;65;3234.00;70
8581;65;628388265;8581;288;9316;9386;6.62;0.41;240.64;9.39;735;65;3235.00;70
8582;65;628388274;8582;285;9316;9386;6.59;0.41;240.66;9.39;734;65;3236.00;70
8586;65;628388282;8586;285;9318;9386;6.56;0.40;240.69;9.39;732;65;3237.00;68
8588;65;628388291;8588;278;9318;9386;6.57;0.40;240.64;9.39;730;65;3238.00;68
8593;65;628388299;8593;282;9318;9386;6.60;0.41;240.67;9.39;725;65;3239.00;68
8595;65;628388310;8595;281;9375;9511;7.01;0.44;240.67;9.33;780;65;3240.00;136
8599;65;628388329;8599;288;9379;9512;7.01;0.44;240.65;9.33;780;65;3241.00;133
8600;65;628388338;8600;294;9390;9512;7.12;0.44;240.68;9.32;790;65;3242.00;122
8604;65;628388347;8604;303;9398;9512;7.16;0.44;240.70;9.31;794;65;3243.00;114
8606;65;628388356;8606;301;9405;9512;7.20;0.45;240.70;9.31;799;65;3244.00;107
8607;65;628388365;8607;307;9408;9512;7.20;0.45;240.71;9.31;801;65;3245.00;104
8613;65;628388375;8613;311;9412;9512;7.11;0.44;240.67;9.31;799;65;3246.00;100
8613;65;628388385;8613;313;9415;9512;7.11;0.44;240.67;9.42;802;65;3247.00;97
8615;65;628388396;8615;318;9418;9513;7.10;0.44;240.71;9.42;803;65;3248.00;95
8623;65;628388406;8623;318;9420;9514;7.02;0.43;240.67;9.42;797;65;3249.00;94
8625;65;628388417;8625;328;9423;9514;6.97;0.43;240.64;9.42;798;65;3250.00;91
8630;65;628388426;8630;329;9426;9518;6.91;0.42;240.61;9.42;796;65;3251.00;92
8631;65;628388437;8631;332;9427;9518;6.84;0.42;240.59;9.42;796;65;3252.00;91
8634;65;628388446;8634;326;9428;9518;6.72;0.41;240.63;9.42;794;65;3253.00;90
8637;65;628388456;8637;318;9429;9518;6.66;0.41;240.66;9.42;792;65;3254.00;89
8639;65;628388467;8639;322;9434;9524;6.63;0.41;240.64;9.42;795;65;3255.00;90
8643;65;628388478;8643;315;9435;9524;6.61;0.41;240.75;9.41;792;65;3256.00;89
8648;65;628388488;8648;320;9435;9524;6.59;0.40;240.74;9.41;787;65;3257.00;89
8650;65;628388497;8650;325;9438;9527;6.57;0.40;240.73;9.41;788;65;3258.00;89
8653;65;628388508;8653;312;9438;9527;6.60;0.40;240.83;9.41;785;65;3259.00;89
8656;65;628388519;8656;299;9438;9527;6.73;0.41;240.87;9.41;782;65;3260.00;89
8660;65;628388529;8660;297;9438;9528;6.80;0.42;240.89;9.41;778;65;3261.00;90
8666;65;628388539;8666;295;9440;9529;6.91;0.42;240.86;9.41;774;65;3262.00;89
8667;65;628388552;8667;296;9440;9529;7.01;0.43;240.86;9.41;773;65;3263.00;89
8670;65;628388569;8670;291;9451;9542;7.15;0.44;240.84;9.40;781;65;3264.00;91
8672;65;628388587;8672;289;9451;9542;7.24;0.44;240.87;9.40;779;65;3265.00;91
8672;65;628388599;8672;292;9451;9542;7.36;0.45;240.87;9.40;779;65;3266.00;91
8675;65;628388609;8675;294;9452;9543;7.45;0.45;240.85;9.40;777;65;3267.00;91
8677;65;628388621;8677;292;9452;9543;7.53;0.46;240.84;9.40;775;65;3268.00;91
8678;65;628388632;8678;293;9455;9547;7.63;0.47;240.82;9.40;777;65;3269.00;92
8681;65;628388646;8681;297;9456;9547;7.70;0.47;240.89;9.39;775;65;3270.00;91
8682;65;628388658;8682;297;9459;9551;7.79;0.48;240.86;9.39;777;65;3271.00;92
8690;65;628388669;8690;300;9459;9551;7.75;0.47;240.90;9.39;769;65;3272.00;92
8693;65;628388687;8693;303;9459;9551;7.77;0.47;240.91;9.39;766;65;3273.00;92
8694;65;628388698;8694;307;9459;9551;7.89;0.48;240.90;9.39;765;65;3274.00;92
8698;65;628388711;8698;304;9459;9551;7.91;0.48;240.94;9.39;761;65;3275.00;92
8700;65;628388723;8700;307;9468;9563;8.04;0.49;240.94;9.38;768;65;3276.00;95
8701;65;628388735;8701;301;9468;9563;8.10;0.49;240.94;9.38;767;65;3277.00;95
8703;65;628388748;8703;289;9470;9563;8.25;0.50;240.94;9.38;767;65;3278.00;93
8705;65;628388759;8705;279;9470;9563;8.32;0.51;240.93;9.38;765;65;3279.00;93
8708;65;628388771;8708;271;9470;9563;8.37;0.51;240.90;9.38;762;65;3280.00;93
8711;65;628388782;8711;268;9470;9563;8.45;0.51;240.92;9.38;759;65;3281.00;93
8714;65;628388793;8714;264;9470;9564;8.47;0.52;240.91;9.38;756;65;3282.00;94
8717;65;628388803;8717;258;9470;9564;8.54;0.52;240.92;9.38;753;65;3283.00;94
8719;65;628388816;8719;254;9474;9570;8.61;0.52;240.98;9.38;755;65;3284.00;96
8721;65;628388831;8721;251;9476;9572;8.64;0.52;240.97;9.38;755;65;3285.00;96
8723;65;628388844;8723;231;9477;9572;8.84;0.54;240.96;9.38;754;65;3286.00;95
8725;65;628388856;8725;216;9477;9572;8.98;0.55;240.98;9.38;752;65;3287.00;95
8726;65;628388873;8726;198;9480;9576;9.13;0.55;241.02;9.37;754;65;3288.00;96
8726;65;628388885;8726;185;9480;9576;9.22;0.56;241.02;9.37;754;65;3289.00;96
8730;65;628388902;8730;173;9480;9576;9.37;0.57;241.00;9.37;750;65;3290.00;96
8734;65;628388914;8734;164;9481;9577;9.50;0.58;241.06;9.37;747;65;3291.00;96
8736;65;628388925;8736;160;9484;9581;9.69;0.59;241.06;9.37;748;65;3292.00;97
8741;65;628388936;8741;156;9484;9581;9.77;0.59;241.12;9.37;743;65;3293.00;97
8742;65;628388948;8742;147;9486;9584;9.98;0.61;241.16;9.37;744;65;3294.00;98
8746;65;628388960;8746;150;9486;9584;10.09;0.61;241.17;9.37;740;65;3295.00;98
8748;65;628388977;8748;156;9487;9584;10.33;0.63;241.19;9.37;739;65;3296.00;97
8750;66;628388989;8750;154;9487;9584;10.51;0.64;241.19;9.37;737;66;3297.00;97
8754;66;628389018;8754;155;9490;9588;10.69;0.65;241.22;9.36;736;66;3298.00;98
8756;66;628389030;8756;151;9490;9588;10.85;0.66;241.24;9.36;734;66;3299.00;98
8759;66;628389045;8759;152;9494;9607;10.89;0.66;241.26;9.36;735;66;3300.00;113
8763;66;628389062;8763;147;9495;9607;10.95;0.67;241.34;9.36;732;66;3301.00;112
8765;66;628389074;8765;143;9495;9608;11.01;0.67;241.33;9.36;730;66;3302.00;113
8767;66;628389085;8767;141;9496;9609;11.00;0.67;241.37;9.36;729;66;3303.00;113
8768;66;628389097;8768;131;9496;9609;11.02;0.67;241.40;9.36;728;66;3304.00;113
8772;66;628389109;8772;127;9498;9610;11.16;0.68;241.41;9.36;726;66;3305.00;112
8776;66;628389120;8776;125;9498;9610;11.20;0.68;241.45;9.36;722;66;3306.00;112
8778;66;628389131;8778;122;9499;9610;11.23;0.68;241.46;9.36;721;66;3307.00;111
8783;66;628389142;8783;122;9499;9610;11.35;0.69;241.48;9.36;716;66;3308.00;111
8787;66;628389154;8787;122;9499;9610;11.52;0.70;241.45;9.36;712;66;3309.00;111
8791;66;628389164;8791;118;9500;9610;11.64;0.71;241.46;9.48;709;66;3310.00;110
8794;66;628389176;8794;122;9501;9610;11.74;0.71;241.49;9.48;707;66;3311.00;109
8795;66;628389193;8795;148;9570;9737;11.44;0.71;241.50;9.41;775;66;3312.00;167
8798;66;628389214;8798;134;9572;9738;11.46;0.71;241.54;9.41;774;66;3313.00;166
8798;66;628389225;8798;131;9575;9738;11.55;0.71;241.54;9.41;777;66;3314.00;163
8801;66;628389236;8801;121;9575;9738;11.62;0.72;241.54;9.41;774;66;3315.00;163
8805;66;628389247;8805;118;9579;9738;11.72;0.72;241.50;9.40;774;66;3316.00;159
8808;66;628389259;8808;123;9581;9738;11.69;0.72;241.51;9.40;773;66;3317.00;157
8811;66;628389270;8811;129;9584;9738;11.69;0.72;241.55;9.40;773;66;3318.00;154
8814;67;628389281;8814;129;9588;9738;11.70;0.72;241.55;9.40;774;67;3319.00;150
8818;67;628389299;8818;136;9590;9739;11.70;0.72;241.56;9.40;772;67;3320.00;149
8821;67;628389311;8821;138;9592;9740;11.78;0.72;241.56;9.40;771;67;3321.00;148
8826;67;628389326;8826;144;9595;9740;11.79;0.72;241.56;9.40;769;67;3322.00;145
8830;67;628389338;8830;158;9598;9741;11.76;0.72;241.58;9.40;768;67;3323.00;143
8833;67;628389349;8833;158;9600;9741;11.73;0.72;241.61;9.41;767;67;3324.00;141
8836;67;628389366;8836;162;9603;9741;11.64;0.71;241.64;9.41;767;67;3325.00;138
8838;67;628389383;8838;160;9606;9741;11.48;0.70;241.67;9.53;768;67;3326.00;135
8844;67;628389400;8844;164;9609;9745;11.42;0.70;241.70;9.53;765;67;3327.00;136
8846;67;628389411;8846;165;9611;9745;11.39;0.70;241.73;9.53;765;67;3328.00;134
8848;67;628389428;8848;165;9615;9745;11.36;0.69;241.76;9.65;767;67;3329.00;130
8854;67;628389445;8854;158;9619;9751;11.33;0.69;241.77;9.65;765;67;3330.00;132
8858;67;628389457;8858;164;9621;9751;11.30;0.69;241.84;9.77;763;67;3331.00;130
8861;67;628389468;8861;153;9621;9751;11.23;0.68;241.86;9.77;760;67;3332.00;130
8867;67;628389479;8867;157;9624;9755;11.15;0.68;241.85;9.77;757;67;3333.00;131
8870;67;628389491;8870;149;9629;9756;11.09;0.67;241.84;9.90;759;67;3334.00;127
8874;67;628389507;8874;150;9632;9756;11.08;0.67;241.83;9.92;758;67;3335.00;124
8876;67;628389520;8876;140;9635;9760;11.17;0.68;241.81;10.04;759;67;3336.00;125
8879;67;628389532;8879;137;9635;9760;11.22;0.68;241.85;10.04;756;67;3337.00;125
8882;67;628389543;8882;144;9636;9760;11.23;0.68;241.88;10.04;754;67;3338.00;124
8885;67;628389554;8885;143;9637;9761;11.25;0.68;241.86;10.03;752;67;3339.00;124
8886;67;628389565;8886;144;9638;9761;11.23;0.68;241.90;10.04;752;67;3340.00;123
8889;67;628389575;8889;146;9642;9767;11.28;0.68;241.93;10.04;753;67;3341.00;125
8892;67;628389587;8892;150;9644;9767;11.30;0.68;241.95;10.04;752;67;3342.00;123
8896;67;628389599;8896;151;9646;9768;11.29;0.68;241.94;10.05;750;67;3343.00;122
8899;67;628389611;8899;155;9647;9768;11.33;0.69;241.98;10.05;748;67;3344.00;121
8900;67;628389622;8900;156;9648;9768;11.42;0.69;241.97;10.06;748;67;3345.00;120
8906;67;628389633;8906;159;9649;9768;11.42;0.69;241.98;10.06;743;67;3346.00;119
8908;67;628389645;8908;162;9650;9768;11.38;0.69;241.96;10.06;742;67;3347.00;118
8910;67;628389656;8910;166;9659;9780;11.27;0.68;241.95;10.06;749;67;3348.00;121
8912;67;628389667;8912;167;9660;9780;11.13;0.67;241.94;10.05;748;67;3349.00;120
8912;67;628389678;8912;165;9662;9780;11.01;0.67;241.94;10.05;750;67;3350.00;118
8917;67;628389689;8917;177;9665;9780;10.85;0.66;241.99;10.06;748;67;3351.00;115
8920;67;628389699;8920;182;9667;9780;10.74;0.65;241.96;10.06;747;67;3352.00;113
8923;67;628389713;8923;183;9670;9780;10.57;0.64;241.98;10.07;747;67;3353.00;110
8924;67;628389729;8924;184;9674;9784;10.53;0.64;242.02;10.07;750;67;3354.00;110
8925;67;628389750;8925;189;9674;9784;10.51;0.64;242.02;10.07;749;67;3355.00;110
8928;67;628389772;8928;189;9679;9788;10.48;0.64;242.06;10.07;751;67;3356.00;109
8934;67;628389790;8934;189;9681;9789;10.43;0.63;242.01;10.07;747;67;3357.00;108
8936;67;628389804;8936;196;9681;9789;10.43;0.63;242.00;10.07;745;67;3358.00;108
8937;67;628389819;8937;200;9681;9789;10.40;0.63;242.00;10.07;744;67;3359.00;108
8942;67;628389832;8942;209;9702;9818;10.17;0.62;242.01;10.07;760;67;3360.00;116
8944;67;628389846;8944;216;9703;9818;10.15;0.62;242.03;10.07;759;67;3361.00;115
8947;67;628389857;8947;225;9705;9818;10.10;0.61;242.02;10.06;758;67;3362.00;113
8950;67;628389868;8950;235;9709;9819;10.06;0.61;242.01;10.08;759;67;3363.00;110
8955;67;628389879;8955;237;9710;9820;10.01;0.61;242.09;10.08;755;67;3364.00;110
8958;67;628389891;8958;239;9713;9820;9.92;0.60;242.10;10.10;755;67;3365.00;107
8961;67;628389901;8961;248;9716;9823;9.83;0.60;242.12;10.10;755;67;3366.00;107
8963;67;628389914;8963;253;9718;9823;9.74;0.59;242.10;10.12;755;67;3367.00;105
8966;67;628389925;8966;262;9719;9823;9.57;0.58;242.12;10.13;753;67;3368.00;104
8969;67;628389935;8969;264;9719;9823;9.41;0.57;242.16;10.13;750;67;3369.00;104
8969;67;628389945;8969;275;9725;9829;9.37;0.57;242.16;10.15;756;67;3370.00;104
8971;67;628389955;8971;285;9726;9829;9.21;0.56;242.16;10.15;755;67;3371.00;103
8971;67;628389964;8971;295;9726;9829;9.04;0.55;242.16;10.15;755;67;3372.00;103
8973;67;628389974;8973;297;9728;9829;8.87;0.54;242.19;10.16;755;67;3373.00;101
8974;67;628389984;8974;299;9731;9833;8.71;0.53;242.21;10.16;757;67;3374.00;102
8978;67;628389993;8978;302;9734;9835;8.48;0.52;242.21;10.17;756;67;3375.00;101
8980;67;628390003;8980;311;9734;9835;8.33;0.51;242.22;10.17;754;67;3376.00;101
8981;67;628390012;8981;317;9737;9836;8.23;0.51;242.20;10.18;756;67;3377.00;99
8983;67;628390020;8983;321;9738;9836;8.08;0.50;242.19;10.19;755;67;3378.00;98
8984;67;628390029;8984;320;9738;9836;7.97;0.49;242.17;10.19;754;67;3379.00;98
8987;67;628390038;8987;316;9739;9836;7.81;0.48;242.16;10.19;752;67;3380.00;97
8990;67;628390053;8990;314;9739;9836;7.70;0.47;242.11;10.19;749;67;3381.00;97
8992;67;628390063;8992;316;9739;9836;7.60;0.47;242.08;10.19;747;67;3382.00;97
8994;67;628390071;8994;317;9744;9836;7.47;0.46;242.04;10.23;750;67;3383.00;92
8995;67;628390080;8995;320;9779;9906;7.63;0.47;242.02;10.20;784;67;3384.00;127
8997;67;628390095;8997;320;9781;9907;7.56;0.47;241.99;10.19;784;67;3385.00;126
8999;67;628390104;8999;319;9793;9907;7.62;0.47;241.97;10.19;794;67;3386.00;114
8999;67;628390112;8999;321;9798;9907;7.54;0.46;241.97;10.19;799;67;3387.00;109
9001;67;628390122;9001;326;9804;9907;7.52;0.46;241.95;10.18;803;67;3388.00;103
9002;67;628390130;9002;333;9810;9907;7.52;0.46;241.94;10.19;808;67;3389.00;97
9005;67;628390142;9005;334;9814;9907;7.44;0.46;241.97;10.19;809;67;3390.00;93
9008;67;628390151;9008;340;9815;9907;7.35;0.45;241.93;10.19;807;67;3391.00;92
9010;67;628390160;9010;351;9817;9908;7.27;0.45;241.92;10.19;807;67;3392.00;91
9014;67;628390169;9014;351;9818;9909;7.14;0.44;241.89;10.19;804;67;3393.00;91
9015;67;628390178;9015;347;9818;9909;7.08;0.44;241.88;10.19;803;67;3394.00;91
9021;67;628390200;9021;351;9824;9913;6.88;0.42;241.88;10.21;803;67;3395.00;89
9023;67;628390226;9023;356;9825;9913;6.77;0.42;241.85;10.21;802;67;3396.00;88
9029;67;628390249;9029;366;9826;9913;6.61;0.41;241.81;10.21;797;67;3397.00;87
9034;67;628390275;9034;362;9826;9913;6.43;0.40;241.77;10.21;792;67;3398.00;87
9035;67;628390288;9035;371;9832;9919;6.33;0.39;241.80;10.21;797;67;3399.00;87
9039;67;628390302;9039;366;9833;9919;6.18;0.38;241.81;10.21;794;67;3400.00;86
9041;67;628390320;9041;358;9833;9919;6.06;0.37;241.78;10.21;792;67;3401.00;86
9044;67;628390332;9044;355;9837;9922;5.97;0.37;241.77;10.21;793;67;3402.00;85
9046;67;628390346;9046;353;9837;9922;5.86;0.36;241.77;10.21;791;67;3403.00;85
9047;68;628390358;9047;348;9837;9922;5.89;0.36;241.77;10.21;790;68;3404.00;85
9049;68;628390386;9049;348;9837;9923;5.92;0.37;241.76;10.21;788;68;3405.00;86
9053;68;628390398;9053;350;9838;9924;5.92;0.37;241.75;10.21;785;68;3406.00;86
9058;68;628390413;9058;354;9839;9924;5.91;0.36;241.73;10.21;781;68;3407.00;85
9060;68;628390425;9060;354;9849;9937;5.98;0.37;241.73;10.20;789;68;3408.00;88
9064;68;628390440;9064;350;9849;9937;6.03;0.37;241.75;10.20;785;68;3409.00;88
9064;68;628390452;9064;354;9850;9937;6.09;0.37;241.75;10.20;786;68;3410.00;87
9069;68;628390463;9069;341;9851;9938;6.12;0.38;241.74;10.20;782;68;3411.00;87
9070;68;628390477;9070;327;9851;9938;6.21;0.38;241.76;10.20;781;68;3412.00;87
9074;68;628390489;9074;316;9854;9942;6.31;0.39;241.72;10.20;780;68;3413.00;88
9078;68;628390502;9078;311;9854;9942;6.37;0.39;241.79;10.20;776;68;3414.00;88
9083;68;628390514;9083;302;9857;9946;6.56;0.40;241.78;10.20;774;68;3415.00;89
9086;68;628390527;9086;293;9858;9946;6.74;0.41;241.79;10.19;772;68;3416.00;88
9089;68;628390542;9089;282;9858;9946;6.90;0.42;241.79;10.19;769;68;3417.00;88
9092;68;628390554;9092;268;9858;9946;7.02;0.43;241.77;10.19;766;68;3418.00;88
9094;68;628390566;9094;266;9858;9946;7.12;0.43;241.78;10.19;764;68;3419.00;88
9096;68;628390589;9096;268;9885;9980;7.36;0.45;241.82;10.17;789;68;3420.00;95
9100;68;628390626;9100;259;9886;9980;7.42;0.46;241.82;10.17;786;68;3421.00;94
9101;68;628390651;9101;252;9887;9980;7.47;0.46;241.84;10.29;786;68;3422.00;93
9105;68;628390666;9105;245;9888;9980;7.49;0.46;241.85;10.28;783;68;3423.00;92
9108;68;628390679;9108;241;9888;9980;7.54;0.46;241.83;10.28;780;68;3424.00;92
9111;68;628390695;9111;239;9888;9980;7.55;0.46;241.83;10.28;777;68;3425.00;92
9116;68;628390711;9116;234;9888;9981;7.63;0.47;241.82;10.28;772;68;3426.00;93
9118;68;628390723;9118;231;9888;9981;7.74;0.47;241.79;10.28;770;68;3427.00;93
9124;68;628390737;9124;234;9893;9987;7.79;0.47;241.90;10.28;769;68;3428.00;94
9125;68;628390751;9125;231;9894;9988;7.93;0.48;241.91;10.28;769;68;3429.00;94
9127;68;628390765;9127;235;9894;9988;7.98;0.49;241.94;10.28;767;68;3430.00;94
9129;68;628390778;9129;235;9894;9988;8.02;0.49;241.93;10.28;765;68;3431.00;94
9133;68;628390789;9133;240;9897;9992;8.10;0.49;241.92;10.28;764;68;3432.00;95
9137;68;628390802;9137;238;9897;9992;8.16;0.50;241.90;10.28;760;68;3433.00;95
9140;68;628390815;9140;244;9897;9992;8.20;0.50;241.89;10.28;757;68;3434.00;95
9141;68;628390827;9141;240;9898;9993;8.25;0.50;241.88;10.27;757;68;3435.00;95
9146;68;628390840;9146;237;9901;9997;8.38;0.51;241.91;10.27;755;68;3436.00;96
9147;68;628390853;9147;244;9902;9997;8.50;0.52;241.92;10.39;755;68;3437.00;95
9152;68;628390864;9152;238;9904;10000;8.53;0.52;241.94;10.38;752;68;3438.00;96
9154;68;628390877;9154;237;9905;10000;8.57;0.52;241.94;10.38;751;68;3439.00;95
9160;68;628390889;9160;238;9905;10000;8.55;0.52;241.98;10.38;745;68;3440.00;95
9162;68;628390901;9162;231;9905;10000;8.55;0.52;241.98;10.38;743;68;3441.00;95
9167;68;628390913;9167;227;9908;10004;8.62;0.52;242.01;10.38;741;68;3442.00;96
9169;68;628390925;9169;228;9908;10004;8.66;0.53;242.01;10.38;739;68;3443.00;96
9171;68;628390939;9171;232;9909;10004;8.67;0.53;242.02;10.38;738;68;3444.00;95
9175;68;628390950;9175;231;9909;10004;8.67;0.53;242.03;10.38;734;68;3445.00;95
9177;68;628390963;9177;233;9909;10005;8.67;0.53;242.04;10.38;732;68;3446.00;96
9181;68;628390976;9181;216;9910;10006;8.66;0.53;242.09;10.38;729;68;3447.00;96
9187;69;628390988;9187;207;9910;10006;8.64;0.53;242.11;10.38;723;69;3448.00;96
9192;69;628391014;9192;207;9911;10007;8.76;0.53;242.18;10.38;719;69;3449.00;96
9197;69;628391029;9197;197;9911;10007;8.84;0.54;242.31;10.38;714;69;3450.00;96
9199;69;628391049;9199;201;9911;10007;8.93;0.54;242.33;10.38;712;69;3451.00;96
9201;69;628391062;9201;201;9911;10007;9.06;0.55;242.36;10.38;710;69;3452.00;96
9204;69;628391080;9204;195;9911;10007;9.17;0.56;242.36;10.38;707;69;3453.00;96
9207;69;628391092;9207;193;9911;10007;9.22;0.56;242.39;10.38;704;69;3454.00;96
9209;69;628391120;9209;189;9911;10007;9.27;0.56;242.43;10.38;702;69;3455.00;96
9212;69;628391132;9212;196;9984;10134;9.30;0.57;242.47;10.30;772;69;3456.00;150
9214;69;628391162;9214;178;9986;10135;9.39;0.58;242.47;10.30;772;69;3457.00;149
9216;69;628391176;9216;160;9994;10135;9.63;0.59;242.51;10.29;778;69;3458.00;141
9219;69;628391190;9219;148;9998;10135;9.76;0.60;242.53;10.29;779;69;3459.00;137
9221;69;628391211;9221;131;10004;10135;9.97;0.61;242.54;10.29;783;69;3460.00;131
9222;69;628391230;9222;127;10007;10135;10.10;0.62;242.55;10.28;785;69;3461.00;128
9223;69;628391250;9223;129;10012;10135;10.28;0.63;242.55;10.28;789;69;3462.00;123
9227;69;628391263;9227;129;10014;10135;10.34;0.63;242.57;10.28;787;69;3463.00;121
9231;69;628391277;9231;130;10018;10136;10.41;0.64;242.57;10.28;787;69;3464.00;118
9234;69;628391291;9234;131;10021;10138;10.47;0.64;242.63;10.28;787;69;3465.00;117
9235;69;628391305;9235;134;10023;10138;10.52;0.64;242.64;10.28;788;69;3466.00;115
9239;69;628391327;9239;127;10024;10139;10.52;0.64;242.71;10.28;785;69;3467.00;115
9242;69;628391341;9242;123;10026;10139;10.55;0.65;242.70;10.28;784;69;3468.00;113
9245;69;628391355;9245;132;10027;10139;10.58;0.65;242.75;10.28;782;69;3469.00;112
9248;69;628391369;9248;135;10029;10139;10.69;0.65;242.86;10.28;781;69;3470.00;110
9250;69;628391383;9250;141;10032;10143;10.76;0.66;242.86;10.28;782;69;3471.00;111
9253;69;628391398;9253;140;10033;10143;10.80;0.66;242.89;10.28;780;69;3472.00;110
9255;69;628391411;9255;142;10033;10143;10.89;0.67;242.91;10.28;778;69;3473.00;110
9257;70;628391426;9257;143;10037;10146;11.03;0.68;243.00;10.39;780;70;3474.00;109
9259;70;628391450;9259;146;10037;10146;11.14;0.68;243.02;10.39;778;70;3475.00;109
9262;70;628391470;9262;149;10038;10146;11.21;0.69;243.04;10.39;776;70;3476.00;108
9264;70;628391489;9264;152;10041;10150;11.32;0.69;243.04;10.39;777;70;3477.00;109
9266;70;628391503;9266;155;10043;10151;11.39;0.70;243.09;10.39;777;70;3478.00;108
9268;70;628391517;9268;157;10043;10151;11.51;0.70;243.11;10.39;775;70;3479.00;108
9273;70;628391532;9273;156;10048;10156;11.61;0.71;243.09;10.38;775;70;3480.00;108
9278;70;628391560;9278;159;10048;10156;11.70;0.71;243.14;10.38;770;70;3481.00;108
9281;70;628391574;9281;159;10048;10156;11.76;0.72;243.16;10.38;767;70;3482.00;108
9284;70;628391594;9284;161;10049;10157;11.76;0.72;243.17;10.38;765;70;3483.00;108
9286;70;628391623;9286;156;10049;10157;11.76;0.72;243.21;10.38;763;70;3484.00;108
9292;70;628391636;9292;156;10053;10163;11.63;0.71;243.20;10.38;761;70;3485.00;110
9294;70;628391650;9294;156;10053;10163;11.66;0.71;243.19;10.38;759;70;3486.00;110
9298;70;628391665;9298;156;10054;10164;11.62;0.71;243.23;10.38;756;70;3487.00;110
9302;70;628391678;9302;156;10054;10164;11.58;0.70;243.20;10.38;752;70;3488.00;110
9304;70;628391691;9304;155;10054;10164;11.53;0.70;243.17;10.38;750;70;3489.00;110
9309;70;628391704;9309;159;10054;10164;11.48;0.70;243.21;10.38;745;70;3490.00;110
9310;70;628391721;9310;157;10054;10164;11.42;0.69;243.23;10.38;744;70;3491.00;110
9314;70;628391743;9314;159;10064;10176;11.42;0.69;243.22;10.37;750;70;3492.00;112
9319;70;628391764;9319;162;10064;10176;11.49;0.70;243.35;10.37;745;70;3493.00;112
9321;70;628391784;9321;160;10065;10176;11.56;0.70;243.40;10.37;744;70;3494.00;111
9325;70;628391801;9325;156;10065;10176;11.56;0.70;243.40;10.37;740;70;3495.00;111
9326;70;628391820;9326;153;10065;10176;11.61;0.70;243.40;10.37;739;70;3496.00;111
9332;70;628391835;9332;152;10065;10176;11.64;0.71;243.45;10.37;733;70;3497.00;111
9332;70;628391849;9332;152;10068;10180;11.67;0.71;243.45;10.36;736;70;3498.00;112
9338;71;628391862;9338;153;10068;10180;11.79;0.72;243.50;10.36;730;71;3499.00;112
9346;71;628391891;9346;149;10071;10184;11.84;0.72;243.49;10.36;725;71;3500.00;113
9347;71;628391912;9347;146;10073;10185;11.81;0.71;243.48;10.36;726;71;3501.00;112
9350;71;628391927;9350;140;10074;10185;11.77;0.71;243.51;10.47;724;71;3502.00;111
9352;71;628391943;9352;141;10074;10185;11.80;0.72;243.50;10.47;722;71;3503.00;111
9354;71;628391957;9354;137;10086;10198;11.70;0.71;243.52;10.49;732;71;3504.00;112
9357;71;628391973;9357;137;10086;10198;11.65;0.71;243.58;10.49;729;71;3505.00;112
9362;71;628391987;9362;134;10086;10198;11.61;0.71;243.64;10.49;724;71;3506.00;112
9367;71;628392000;9367;137;10087;10199;11.67;0.71;243.64;10.49;720;71;3507.00;112
9370;71;628392015;9370;135;10087;10200;11.78;0.72;243.64;10.49;717;71;3508.00;113
9372;71;628392029;9372;130;10087;10200;11.82;0.72;243.67;10.49;715;71;3509.00;113
9378;71;628392044;9378;128;10090;10206;11.90;0.72;243.72;10.48;712;71;3510.00;116
9381;71;628392058;9381;128;10091;10206;11.95;0.73;243.73;10.48;710;71;3511.00;115
9383;71;628392072;9383;129;10092;10206;11.99;0.73;243.75;10.48;709;71;3512.00;114
9387;71;628392086;9387;131;10092;10206;12.08;0.74;243.75;10.48;705;71;3513.00;114
9389;71;628392102;9389;133;10096;10212;12.12;0.74;243.73;10.48;707;71;3514.00;116
9394;71;628392116;9394;128;10096;10212;12.15;0.74;243.73;10.48;702;71;3515.00;116
9396;71;628392132;9396;128;10097;10212;12.15;0.74;243.73;10.48;701;71;3516.00;115
9400;71;628392146;9400;125;10099;10212;12.05;0.73;243.73;10.49;699;71;3517.00;113
9402;71;628392160;9402;128;10103;10216;11.81;0.72;243.73;10.49;701;71;3518.00;113
9406;71;628392174;9406;125;10106;10219;11.61;0.70;243.75;10.60;700;71;3519.00;113
9409;71;628392188;9409;128;10107;10219;11.44;0.69;243.79;10.60;698;71;3520.00;112
9412;71;628392200;9412;133;10108;10220;11.34;0.69;243.86;10.60;696;71;3521.00;112
9415;71;628392223;9415;136;10108;10220;11.23;0.68;243.86;10.60;693;71;3522.00;112
9417;71;628392238;9417;139;10108;10220;11.10;0.67;243.90;10.60;691;71;3523.00;112
9418;71;628392252;9418;144;10109;10220;10.94;0.66;243.90;10.61;691;71;3524.00;111
9418;71;628392265;9418;151;10109;10220;10.89;0.66;243.90;10.61;691;71;3525.00;111
9421;71;628392280;9421;160;10112;10220;10.77;0.65;243.89;10.74;691;71;3526.00;108
9422;71;628392293;9422;165;10112;10220;10.70;0.65;243.92;10.74;690;71;3527.00;108
9427;71;628392307;9427;177;10147;10290;10.62;0.65;243.99;10.71;720;71;3528.00;143
9428;71;628392328;9428;185;10150;10291;10.50;0.64;243.99;10.70;722;71;3529.00;141
9433;71;628392340;9433;192;10159;10291;10.47;0.64;243.95;10.72;726;71;3530.00;132
9433;71;628392354;9433;202;10162;10291;10.46;0.64;243.95;10.72;729;71;3531.00;129
9438;71;628392366;9438;204;10164;10291;10.38;0.63;243.90;10.72;726;71;3532.00;127
9439;71;628392381;9439;208;10168;10291;10.26;0.62;243.88;10.73;729;71;3533.00;123
9442;71;628392393;9442;216;10171;10291;10.15;0.62;243.86;10.74;729;71;3534.00;120
9442;71;628392406;9442;225;10176;10291;10.10;0.62;243.86;10.75;734;71;3535.00;115
9445;71;628392418;9445;230;10178;10292;9.98;0.61;243.80;10.75;733;71;3536.00;114
9447;71;628392441;9447;235;10182;10293;9.91;0.60;243.77;10.75;735;71;3537.00;111
9449;71;628392453;9449;244;10184;10293;9.80;0.60;243.74;10.76;735;71;3538.00;109
9449;71;628392466;9449;245;10190;10297;9.68;0.59;243.74;10.77;741;71;3539.00;107
9450;71;628392480;9450;251;10192;10297;9.54;0.58;243.73;10.78;742;71;3540.00;105
9452;71;628392492;9452;259;10194;10297;9.39;0.57;243.71;10.80;742;71;3541.00;103
9452;71;628392509;9452;265;10194;10297;9.27;0.57;243.71;10.80;742;71;3542.00;103
9454;71;628392521;9454;272;10200;10303;9.23;0.56;243.68;10.81;746;71;3543.00;103
9455;71;628392535;9455;282;10201;10303;9.11;0.56;243.75;10.81;746;71;3544.00;102
9458;71;628392546;9458;285;10202;10303;8.98;0.55;243.73;10.81;744;71;3545.00;101
9459;71;628392557;9459;293;10205;10306;8.91;0.55;243.72;10.82;746;71;3546.00;101
9461;71;628392570;9461;302;10207;10306;8.73;0.53;243.70;10.82;746;71;3547.00;99
9462;71;628392581;9462;307;10208;10306;8.53;0.52;243.68;10.83;746;71;3548.00;98
9463;71;628392593;9463;307;10209;10307;8.36;0.51;243.67;10.83;746;71;3549.00;98
9466;71;628392604;9466;305;10211;10308;8.21;0.50;243.62;10.84;745;71;3550.00;97
9466;71;628392616;9466;306;10212;10308;8.11;0.50;243.62;10.84;746;71;3551.00;96
9467;71;628392628;9467;314;10223;10321;7.99;0.49;243.62;10.83;756;71;3552.00;98
9471;71;628392641;9471;311;10224;10321;7.84;0.48;243.55;10.84;753;71;3553.00;97
9472;71;628392651;9472;313;10224;10321;7.71;0.47;243.53;10.84;752;71;3554.00;97
9472;71;628392662;9472;314;10230;10323;7.61;0.47;243.53;10.87;758;71;3555.00;93
9473;71;628392672;9473;320;10230;10323;7.50;0.46;243.52;10.87;757;71;3556.00;93
9476;71;628392682;9476;321;10234;10327;7.49;0.46;243.51;10.87;758;71;3557.00;93
9478;71;628392694;9478;327;10235;10327;7.44;0.46;243.49;10.87;757;71;3558.00;92
9480;71;628392706;9480;325;10239;10331;7.43;0.45;243.50;10.87;759;71;3559.00;92
9481;71;628392723;9481;328;10240;10331;7.39;0.45;243.48;10.88;759;71;3560.00;91
9484;71;628392733;9484;327;10240;10331;7.30;0.45;243.44;10.88;756;71;3561.00;91
9484;71;628392745;9484;327;10240;10331;7.24;0.44;243.44;10.88;756;71;3562.00;91
9486;71;628392763;9486;320;10243;10331;7.13;0.44;243.44;10.90;757;71;3563.00;88
9489;71;628392772;9489;310;10252;10343;7.14;0.44;243.42;10.89;763;71;3564.00;91
9493;71;628392784;9493;303;10253;10343;7.01;0.43;243.45;10.89;760;71;3565.00;90
9497;71;628392794;9497;290;10255;10343;6.93;0.42;243.42;10.89;758;71;3566.00;88
9498;71;628392805;9498;289;10258;10343;6.82;0.42;243.44;10.90;760;71;3567.00;85
9501;72;628392815;9501;286;10258;10343;6.72;0.41;243.45;10.90;757;72;3568.00;85
9506;72;628392838;9506;289;10259;10343;6.56;0.40;243.47;10.91;753;72;3569.00;84
9507;72;628392852;9507;283;10259;10344;6.47;0.40;243.50;10.91;752;72;3570.00;85
9508;72;628392870;9508;278;10259;10344;6.49;0.40;243.51;10.91;751;72;3571.00;85
9511;72;628392881;9511;279;10266;10350;6.55;0.40;243.49;10.91;755;72;3572.00;84
9513;72;628392904;9513;278;10268;10351;6.57;0.40;243.52;10.91;755;72;3573.00;83
9515;72;628392922;9515;279;10269;10351;6.62;0.41;243.53;10.91;754;72;3574.00;82
9517;72;628392933;9517;270;10269;10351;6.72;0.41;243.54;10.91;752;72;3575.00;82
9518;72;628392943;9518;266;10272;10355;6.86;0.42;243.53;10.91;754;72;3576.00;83
9521;72;628392957;9521;256;10272;10355;6.91;0.42;243.56;10.91;751;72;3577.00;83
9523;72;628392970;9523;258;10272;10355;7.05;0.43;243.57;10.91;749;72;3578.00;83
9526;72;628392980;9526;249;10273;10356;7.20;0.44;243.57;10.91;747;72;3579.00;83
9529;72;628392992;9529;247;10276;10360;7.35;0.45;243.53;10.90;747;72;3580.00;84
9530;72;628393002;9530;243;10276;10360;7.50;0.46;243.55;10.90;746;72;3581.00;84
9534;72;628393014;9534;240;10278;10363;7.61;0.47;243.58;10.90;744;72;3582.00;85
9537;72;628393024;9537;234;10279;10363;7.70;0.47;243.60;10.90;742;72;3583.00;84
9539;72;628393039;9539;230;10279;10363;7.80;0.48;243.61;10.90;740;72;3584.00;84
9545;72;628393051;9545;226;10279;10363;7.84;0.48;243.63;10.90;734;72;3585.00;84
9550;72;628393062;9550;224;10282;10367;7.99;0.49;243.62;10.90;732;72;3586.00;85
9553;72;628393075;9553;222;10282;10367;8.06;0.49;243.62;10.90;729;72;3587.00;85
9558;72;628393086;9558;223;10283;10367;8.19;0.50;243.61;10.90;725;72;3588.00;84
9561;72;628393098;9561;218;10283;10367;8.28;0.51;243.63;10.90;722;72;3589.00;84
9566;72;628393109;9566;214;10283;10368;8.38;0.51;243.67;10.90;717;72;3590.00;85
9571;72;628393121;9571;207;10284;10369;8.39;0.51;243.65;10.90;713;72;3591.00;85
9575;72;628393137;9575;203;10284;10369;8.47;0.52;243.76;10.90;709;72;3592.00;85
9583;72;628393149;9583;198;10285;10370;8.47;0.52;243.80;10.90;702;72;3593.00;85
9585;72;628393161;9585;194;10285;10370;8.47;0.52;243.81;10.90;700;72;3594.00;85
9590;72;628393173;9590;197;10285;10370;8.53;0.52;243.83;10.90;695;72;3595.00;85
9594;72;628393184;9594;201;10285;10370;8.55;0.52;243.81;10.90;691;72;3596.00;85
9596;72;628393196;9596;202;10285;10370;8.61;0.53;243.79;10.90;689;72;3597.00;85
9601;72;628393208;9601;198;10285;10370;8.65;0.53;243.80;10.90;684;72;3598.00;85
9604;72;628393226;9604;198;10285;10370;8.69;0.53;243.81;10.90;681;72;3599.00;85
9613;72;628393240;9613;233;10394;10623;8.74;0.55;243.86;10.78;781;72;3600.00;229
9617;72;628393278;9617;228;10399;10624;8.81;0.55;243.87;10.78;782;72;3601.00;225
9622;72;628393290;9622;216;10410;10624;8.87;0.55;243.86;10.77;788;72;3602.00;214
9627;72;628393303;9627;216;10416;10624;8.89;0.55;243.85;10.76;789;72;3603.00;208
9631;72;628393315;9631;211;10422;10624;8.95;0.56;243.85;10.76;791;72;3604.00;202
9635;72;628393329;9635;206;10430;10624;8.93;0.56;243.87;10.75;795;72;3605.00;194
9639;72;628393341;9639;205;10438;10624;8.98;0.56;243.87;10.75;799;72;3606.00;186
9640;72;628393357;9640;206;10442;10624;9.03;0.56;243.90;10.75;802;72;3607.00;182
9644;72;628393374;9644;202;10447;10625;9.02;0.56;243.95;10.75;803;72;3608.00;178
9645;72;628393389;9645;209;10449;10626;9.04;0.56;243.94;10.75;804;72;3609.00;177
9649;72;628393408;9649;209;10455;10626;9.01;0.56;243.99;10.75;806;72;3610.00;171
9653;72;628393421;9653;217;10458;10627;8.92;0.55;244.02;10.75;805;72;3611.00;169
9656;72;628393435;9656;221;10463;10627;8.86;0.55;244.01;10.75;807;72;3612.00;164
9660;72;628393448;9660;227;10465;10627;8.80;0.55;244.04;10.75;805;72;3613.00;162
9663;72;628393468;9663;234;10470;10627;8.76;0.54;244.09;10.75;807;72;3614.00;157
9666;72;628393482;9666;242;10474;10631;8.72;0.54;244.09;10.75;808;72;3615.00;157
9668;72;628393496;9668;240;10477;10631;8.75;0.54;244.15;10.75;809;72;3616.00;154
9672;72;628393510;9672;242;10480;10631;8.80;0.54;244.16;10.75;808;72;3617.00;151
9675;72;628393524;9675;238;10482;10634;8.85;0.55;244.17;10.76;807;72;3618.00;152
9683;72;628393539;9683;234;10486;10634;8.81;0.54;244.20;10.76;803;72;3619.00;148
9686;72;628393561;9686;229;10489;10634;8.88;0.54;244.25;10.76;803;72;3620.00;145
9691;72;628393574;9691;231;10494;10638;8.97;0.55;244.43;10.76;803;72;3621.00;144
9694;72;628393590;9694;232;10495;10639;9.09;0.56;244.47;10.76;801;72;3622.00;144
9698;72;628393605;9698;235;10500;10639;9.14;0.56;244.47;10.76;802;72;3623.00;139
9703;72;628393622;9703;232;10503;10643;9.21;0.56;244.55;10.76;800;72;3624.00;140
9707;72;628393637;9707;232;10505;10643;9.35;0.57;244.52;10.76;798;72;3625.00;138
9715;72;628393653;9715;223;10507;10643;9.48;0.58;244.49;10.76;792;72;3626.00;136
9720;72;628393670;9720;215;10507;10644;9.59;0.58;244.47;10.76;787;72;3627.00;137
9722;72;628393683;9722;202;10510;10644;9.70;0.59;244.47;10.76;788;72;3628.00;134
9724;72;628393700;9724;191;10514;10650;9.80;0.59;244.48;10.76;790;72;3629.00;136
9726;72;628393730;9726;183;10514;10650;9.98;0.61;244.48;10.76;788;72;3630.00;136
9728;72;628393765;9728;177;10515;10651;10.18;0.62;244.54;10.76;787;72;3631.00;136
9730;72;628393788;9730;171;10516;10651;10.37;0.63;244.54;10.76;786;72;3632.00;135
9733;72;628393820;9733;166;10516;10651;10.53;0.64;244.58;10.76;783;72;3633.00;135
9735;72;628393852;9735;164;10518;10651;10.69;0.65;244.57;10.76;783;72;3634.00;133
9741;72;628393869;9741;163;10518;10651;10.79;0.65;244.64;10.76;777;72;3635.00;133
9744;72;628393888;9744;166;10527;10663;10.90;0.66;244.63;10.76;783;72;3636.00;136
9745;73;628393908;9745;163;10527;10663;11.00;0.67;244.65;10.76;782;73;3637.00;136
9748;73;628393938;9748;163;10529;10663;11.12;0.67;244.67;10.75;781;73;3638.00;134
9751;73;628393952;9751;167;10530;10663;11.19;0.68;244.68;10.76;779;73;3639.00;133
9751;73;628393966;9751;166;10530;10663;11.26;0.68;244.68;10.76;779;73;3640.00;133
9755;73;628393980;9755;163;10530;10663;11.33;0.69;244.67;10.76;775;73;3641.00;133
9756;73;628393992;9756;171;10533;10667;11.38;0.69;244.69;10.75;777;73;3642.00;134
9760;73;628394005;9760;167;10533;10667;11.44;0.69;244.68;10.75;773;73;3643.00;134
9762;73;628394024;9762;167;10536;10671;11.50;0.70;244.70;10.75;774;73;3644.00;135
9763;73;628394037;9763;170;10540;10673;11.54;0.70;244.71;10.75;777;73;3645.00;133
9765;73;628394050;9765;166;10541;10673;11.60;0.71;244.73;10.75;776;73;3646.00;132
9768;73;628394062;9768;169;10541;10673;11.61;0.71;244.84;10.75;773;73;3647.00;132
9771;73;628394074;9771;170;10550;10686;11.64;0.71;244.83;10.74;779;73;3648.00;136
9776;73;628394087;9776;172;10550;10686;11.65;0.71;244.92;10.74;774;73;3649.00;136
9780;73;628394099;9780;167;10550;10686;11.65;0.71;244.95;10.74;770;73;3650.00;136
9782;73;628394111;9782;160;10551;10687;11.70;0.71;245.00;10.74;769;73;3651.00;136
9786;73;628394122;9786;164;10551;10688;11.70;0.71;245.01;10.74;765;73;3652.00;137
9790;73;628394134;9790;163;10551;10688;11.72;0.71;245.09;10.74;761;73;3653.00;137
9795;73;628394146;9795;165;10553;10691;11.62;0.71;245.10;10.74;758;73;3654.00;138
9798;73;628394158;9798;166;10553;10691;11.51;0.70;245.08;10.74;755;73;3655.00;138
9801;73;628394169;9801;176;10554;10691;11.41;0.69;245.11;10.74;753;73;3656.00;137
9805;73;628394181;9805;176;10554;10691;11.32;0.69;245.12;10.74;749;73;3657.00;137
9807;73;628394192;9807;177;10558;10697;11.30;0.69;245.13;10.73;751;73;3658.00;139
9812;73;628394203;9812;176;10558;10697;11.28;0.69;245.12;10.73;746;73;3659.00;139
9815;73;628394216;9815;172;10559;10697;11.29;0.69;245.14;10.73;744;73;3660.00;138
9818;73;628394228;9818;172;10559;10697;11.26;0.69;245.14;10.73;741;73;3661.00;138
9823;73;628394240;9823;171;10562;10701;11.20;0.68;245.20;10.73;739;73;3662.00;139
9824;73;628394253;9824;171;10563;10702;11.21;0.68;245.20;10.73;739;73;3663.00;139
9826;73;628394264;9826;171;10563;10702;11.19;0.68;245.21;10.73;737;73;3664.00;139
9828;73;628394275;9828;178;10565;10703;11.17;0.68;245.19;10.85;737;73;3665.00;138
9831;73;628394286;9831;175;10565;10703;11.14;0.68;245.19;10.85;734;73;3666.00;138
9835;73;628394297;9835;176;10565;10703;11.10;0.68;245.18;10.85;730;73;3667.00;138
9839;73;628394307;9839;180;10565;10703;10.97;0.67;245.17;10.85;726;73;3668.00;138
9840;73;628394318;9840;183;10566;10703;10.82;0.66;245.17;10.85;726;73;3669.00;137
9843;73;628394328;9843;182;10566;10703;10.75;0.65;245.15;10.85;723;73;3670.00;137
9846;73;628394338;9846;189;10566;10703;10.73;0.65;245.13;10.85;720;73;3671.00;137
9850;73;628394348;9850;193;10595;10773;10.66;0.65;245.11;10.94;745;73;3672.00;178
9854;73;628394364;9854;187;10595;10774;10.63;0.65;245.09;10.94;741;73;3673.00;179
9857;73;628394375;9857;178;10602;10774;10.70;0.65;245.15;11.05;745;73;3674.00;172
9863;73;628394386;9863;179;10609;10774;10.69;0.65;245.13;11.08;746;73;3675.00;165
9865;73;628394399;9865;171;10614;10774;10.69;0.65;245.14;11.07;749;73;3676.00;160
9869;73;628394417;9869;169;10621;10774;10.70;0.65;245.13;11.18;752;73;3677.00;153
9873;73;628394428;9873;165;10625;10774;10.68;0.65;245.13;11.18;752;73;3678.00;149
9876;73;628394439;9876;160;10626;10774;10.72;0.65;245.11;11.18;750;73;3679.00;148
9878;73;628394450;9878;163;10629;10775;10.80;0.66;245.09;11.29;751;73;3680.00;146
9880;73;628394461;9880;160;10630;10776;10.84;0.66;245.06;11.29;750;73;3681.00;146
9882;73;628394472;9882;155;10631;10776;10.90;0.66;245.06;11.29;749;73;3682.00;145
9884;73;628394483;9884;153;10635;10780;10.84;0.66;245.04;11.39;751;73;3683.00;145
9885;73;628394494;9885;152;10635;10780;10.76;0.65;245.03;11.39;750;73;3684.00;145
9886;73;628394505;9886;157;10635;10780;10.68;0.65;245.04;11.39;749;73;3685.00;145
9888;73;628394517;9888;161;10636;10780;10.57;0.64;245.01;11.50;748;73;3686.00;144
9889;73;628394527;9889;160;10640;10786;10.55;0.64;245.01;11.51;751;73;3687.00;146
9891;73;628394539;9891;164;10641;10786;10.55;0.64;244.98;11.51;750;73;3688.00;145
9894;73;628394556;9894;169;10642;10786;10.42;0.63;244.95;11.61;748;73;3689.00;144
9896;73;628394569;9896;179;10647;10792;10.31;0.63;244.93;11.62;751;73;3690.00;145
9898;73;628394580;9898;184;10648;10792;10.27;0.62;244.92;11.62;750;73;3691.00;144
9899;73;628394591;9899;195;10652;10792;10.23;0.62;244.91;11.74;753;73;3692.00;140
9901;73;628394602;9901;195;10653;10793;10.14;0.62;244.88;11.74;752;73;3693.00;140
9902;73;628394613;9902;202;10657;10794;10.06;0.61;244.93;11.74;755;73;3694.00;137
9904;73;628394623;9904;205;10658;10794;9.90;0.60;244.91;11.74;754;73;3695.00;136
9906;73;628394634;9906;211;10668;10807;9.75;0.59;244.88;11.74;762;73;3696.00;139
9910;73;628394645;9910;214;10671;10807;9.66;0.59;244.83;11.74;761;73;3697.00;136
9912;73;628394655;9912;223;10672;10807;9.57;0.58;244.82;11.74;760;73;3698.00;135
9913;73;628394666;9913;235;10674;10808;9.57;0.58;244.83;11.75;761;73;3699.00;134
9916;73;628394678;9916;245;10677;10808;9.45;0.58;244.83;11.78;761;73;3700.00;131
9917;73;628394693;9917;254;10680;10812;9.44;0.58;244.81;11.78;763;73;3701.00;132
9922;73;628394703;9922;264;10681;10812;9.26;0.57;244.81;11.89;759;73;3702.00;131
9927;73;628394714;9927;264;10687;10816;9.12;0.56;244.73;11.91;760;73;3703.00;129
9929;73;628394725;9929;267;10688;10816;8.99;0.55;244.70;11.91;759;73;3704.00;128
9932;73;628394736;9932;276;10689;10816;8.86;0.54;244.66;11.92;757;73;3705.00;127
9933;73;628394745;9933;284;10689;10816;8.78;0.54;244.65;11.92;756;73;3706.00;127
9935;73;628394755;9935;283;10690;10816;8.62;0.53;244.66;11.94;755;73;3707.00;126
9938;73;628394765;9938;285;10701;10828;8.59;0.53;244.63;11.93;763;73;3708.00;127
9939;73;628394775;9939;290;10703;10828;8.46;0.52;244.62;11.94;764;73;3709.00;125
9941;73;628394785;9941;297;10705;10828;8.29;0.51;244.62;11.96;764;73;3710.00;123
9943;73;628394794;9943;303;10706;10828;8.14;0.50;244.59;11.97;763;73;3711.00;122
9945;73;628394803;9945;308;10708;10828;7.98;0.49;244.58;11.98;763;73;3712.00;120
9948;73;628394812;9948;313;10710;10828;7.88;0.48;244.58;11.99;762;73;3713.00;118
9948;73;628394822;9948;324;10710;10829;7.79;0.48;244.58;11.99;762;73;3714.00;119
9948;73;628394831;9948;321;10713;10829;7.69;0.47;244.58;12.01;765;73;3715.00;116
9949;73;628394839;9949;316;10719;10835;7.66;0.47;244.56;12.02;770;73;3716.00;116
9951;73;628394849;9951;314;10723;10836;7.61;0.47;244.57;12.04;772;73;3717.00;113
9953;73;628394858;9953;311;10724;10836;7.57;0.46;244.55;12.04;771;73;3718.00;112
9953;73;628394867;9953;311;10724;10836;7.52;0.46;244.55;12.04;771;73;3719.00;112
9956;73;628394878;9956;303;10730;10841;7.49;0.46;244.51;12.05;774;73;3720.00;111
9958;73;628394888;9958;297;10730;10841;7.38;0.45;244.50;12.05;772;73;3721.00;111
9960;73;628394903;9960;296;10730;10841;7.32;0.45;244.56;12.05;770;73;3722.00;111
9961;73;628394913;9961;291;10733;10842;7.28;0.45;244.55;12.07;772;73;3723.00;109
9965;73;628394922;9965;288;10736;10846;7.29;0.45;244.61;12.07;771;73;3724.00;110
9966;73;628394932;9966;291;10736;10846;7.28;0.44;244.61;12.07;770;73;3725.00;110
9967;73;628394942;9967;290;10738;10849;7.37;0.45;244.60;12.07;771;73;3726.00;111
9968;73;628394958;9968;287;10742;10849;7.44;0.45;244.59;12.09;774;73;3727.00;107
9968;73;628394967;9968;288;10742;10849;7.48;0.46;244.59;12.09;774;73;3728.00;107
9969;73;628394977;9969;285;10745;10849;7.49;0.46;244.57;12.11;776;73;3729.00;104
9970;73;628394986;9970;285;10748;10853;7.53;0.46;244.56;12.11;778;73;3730.00;105
9972;73;628394996;9972;290;10749;10853;7.52;0.46;244.55;12.11;777;73;3731.00;104
9975;73;628395005;9975;292;10751;10853;7.48;0.46;244.51;12.12;776;73;3732.00;102
9977;73;628395015;9977;296;10751;10853;7.46;0.46;244.51;12.12;774;73;3733.00;102
9977;73;628395024;9977;291;10751;10854;7.46;0.46;244.51;12.12;774;73;3734.00;103
9981;73;628395033;9981;289;10755;10856;7.42;0.45;244.49;12.13;774;73;3735.00;101
9984;73;628395043;9984;292;10755;10856;7.35;0.45;244.48;12.13;771;73;3736.00;101
9985;73;628395051;9985;289;10757;10857;7.31;0.45;244.47;12.14;772;73;3737.00;100
9990;73;628395060;9990;291;10757;10857;7.17;0.44;244.47;12.14;767;73;3738.00;100
9993;73;628395069;9993;295;10758;10857;7.05;0.43;244.49;12.14;765;73;3739.00;99
9998;73;628395078;9998;280;10759;10857;6.97;0.43;244.47;12.15;761;73;3740.00;98
10004;73;628395087;10004;268;10759;10857;6.90;0.42;244.50;12.15;755;73;3741.00;98
10007;73;628395096;10007;263;10761;10857;6.94;0.43;244.49;12.16;754;73;3742.00;96
10010;73;628395104;10010;258;10761;10857;6.89;0.42;244.53;12.16;751;73;3743.00;96
10016;73;628395113;10016;271;10826;10984;7.21;0.45;244.57;12.08;810;73;3744.00;158
10021;73;628395132;10021;270;10827;10985;7.18;0.45;244.56;12.08;806;73;3745.00;158
10023;73;628395141;10023;263;10836;10985;7.31;0.45;244.58;12.08;813;73;3746.00;149
10030;73;628395151;10030;259;10844;10985;7.39;0.46;244.56;12.07;814;73;3747.00;141
10034;73;628395161;10034;249;10850;10985;7.45;0.46;244.63;12.06;816;73;3748.00;135
10037;73;628395170;10037;242;10855;10985;7.47;0.46;244.64;12.06;818;73;3749.00;130
10039;73;628395182;10039;238;10860;10990;7.50;0.46;244.66;12.06;821;73;3750.00;130
10042;73;628395192;10042;236;10865;10990;7.55;0.47;244.67;12.17;823;73;3751.00;125
10044;73;628395203;10044;237;10867;10991;7.63;0.47;244.68;12.17;823;73;3752.00;124
10048;73;628395213;10048;242;10871;10992;7.65;0.47;244.71;12.17;823;73;3753.00;121
10053;73;628395224;10053;247;10874;10992;7.75;0.48;244.72;12.16;821;73;3754.00;118
10055;73;628395234;10055;245;10876;10993;7.83;0.48;244.71;12.16;821;73;3755.00;117
10058;73;628395244;10058;248;10877;10993;7.91;0.49;244.73;12.16;819;73;3756.00;116
10060;73;628395255;10060;242;10878;10993;8.03;0.49;244.74;12.16;818;73;3757.00;115
10062;73;628395266;10062;238;10880;10993;8.14;0.50;244.74;12.16;818;73;3758.00;113
10070;73;628395277;10070;236;10884;10997;8.10;0.50;244.78;12.16;814;73;3759.00;113
10074;73;628395288;10074;232;10886;10997;8.09;0.50;244.76;12.16;812;73;3760.00;111
10076;73;628395300;10076;225;10886;10997;8.11;0.50;244.77;12.16;810;73;3761.00;111
10080;73;628395311;10080;218;10889;11000;8.25;0.51;244.78;12.16;809;73;3762.00;111
10084;73;628395323;10084;215;10889;11000;8.34;0.51;244.78;12.16;805;73;3763.00;111
10087;73;628395334;10087;218;10890;11000;8.43;0.52;244.77;12.16;803;73;3764.00;110
10092;73;628395345;10092;213;10893;11004;8.46;0.52;244.77;12.16;801;73;3765.00;111
10096;73;628395357;10096;216;10894;11005;8.58;0.53;244.75;12.16;798;73;3766.00;111
10100;73;628395368;10100;210;10894;11005;8.68;0.53;244.74;12.16;794;73;3767.00;111
10105;73;628395379;10105;209;10896;11009;8.80;0.54;244.72;12.15;791;73;3768.00;113
10108;73;628395391;10108;210;10898;11009;8.92;0.55;244.70;12.15;790;73;3769.00;111
10115;73;628395402;10115;209;10898;11009;8.95;0.55;244.79;12.15;783;73;3770.00;111
10122;73;628395414;10122;211;10899;11010;8.95;0.55;244.82;12.15;777;73;3771.00;111
10126;73;628395426;10126;213;10901;11010;8.97;0.55;244.83;12.15;775;73;3772.00;109
10132;73;628395437;10132;216;10904;11016;8.94;0.55;244.79;12.15;772;73;3773.00;112
10134;73;628395449;10134;214;10905;11016;8.91;0.54;244.82;12.15;771;73;3774.00;111
10140;73;628395460;10140;217;10906;11017;8.92;0.54;244.89;12.15;766;73;3775.00;111
10143;74;628395472;10143;213;10906;11017;8.99;0.55;244.87;12.15;763;74;3776.00;111
10147;74;628395494;10147;214;10907;11017;9.03;0.55;244.95;12.15;760;74;3777.00;110
10150;74;628395505;10150;211;10907;11017;9.12;0.56;245.03;12.15;757;74;3778.00;110
10155;74;628395516;10155;215;10907;11017;9.16;0.56;245.04;12.15;752;74;3779.00;110
10157;74;628395529;10157;219;10931;11053;9.30;0.57;245.07;12.12;774;74;3780.00;122
10162;74;628395549;10162;222;10933;11053;9.33;0.57;245.11;12.12;771;74;3781.00;120
10167;74;628395561;10167;221;10934;11053;9.39;0.57;245.14;12.12;767;74;3782.00;119
10170;74;628395572;10170;225;10935;11053;9.40;0.58;245.16;12.12;765;74;3783.00;118
10173;74;628395584;10173;229;10936;11053;9.44;0.58;245.20;12.12;763;74;3784.00;117
10175;74;628395595;10175;227;10938;11053;9.41;0.58;245.20;12.23;763;74;3785.00;115
10180;74;628395607;10180;226;10941;11057;9.41;0.58;245.24;12.23;761;74;3786.00;116
10183;74;628395619;10183;216;10942;11057;9.33;0.57;245.24;12.23;759;74;3787.00;115
10186;74;628395630;10186;215;10945;11061;9.34;0.57;245.25;12.22;759;74;3788.00;116
10189;74;628395643;10189;214;10947;11062;9.40;0.57;245.27;12.22;758;74;3789.00;115
10192;74;628395654;10192;212;10947;11062;9.37;0.57;245.30;12.22;755;74;3790.00;115
10197;74;628395666;10197;210;10947;11062;9.32;0.57;245.28;12.22;750;74;3791.00;115
10200;74;628395677;10200;210;10957;11075;9.40;0.57;245.28;12.21;757;74;3792.00;118
10201;74;628395695;10201;210;10957;11075;9.50;0.58;245.29;12.21;756;74;3793.00;118
10208;74;628395706;10208;212;10958;11075;9.58;0.58;245.25;12.21;750;74;3794.00;117
10211;74;628395722;10211;213;10959;11076;9.60;0.58;245.25;12.21;748;74;3795.00;117
10215;74;628395739;10215;197;10959;11077;9.65;0.59;245.28;12.21;744;74;3796.00;118
10218;74;628395758;10218;182;10959;11077;9.78;0.60;245.40;12.21;741;74;3797.00;118
10221;74;628395785;10221;168;10961;11080;9.95;0.61;245.40;12.21;740;74;3798.00;119
10223;74;628395802;10223;157;10962;11080;10.02;0.61;245.42;12.21;739;74;3799.00;118
10226;74;628395821;10226;151;10962;11080;10.16;0.62;245.42;12.21;736;74;3800.00;118
10229;74;628395843;10229;148;10962;11080;10.21;0.62;245.45;12.21;733;74;3801.00;118
10231;74;628395858;10231;147;10966;11086;10.35;0.63;245.46;12.20;735;74;3802.00;120
10236;74;628395871;10236;141;10966;11086;10.41;0.63;245.52;12.20;730;74;3803.00;120
10239;74;628395884;10239;135;10967;11086;10.57;0.64;245.56;12.20;728;74;3804.00;119
10240;74;628395904;10240;134;10968;11086;10.66;0.65;245.54;12.32;728;74;3805.00;118
10244;74;628395916;10244;134;10971;11090;10.63;0.65;245.56;12.31;727;74;3806.00;119
10247;75;628395929;10247;135;10972;11091;10.60;0.65;245.57;12.31;725;75;3807.00;119
10251;75;628395961;10251;135;10972;11091;10.51;0.64;245.55;12.31;721;75;3808.00;119
10255;75;628395974;10255;136;10973;11092;10.51;0.64;245.53;12.31;718;75;3809.00;119
10259;75;628395988;10259;136;10973;11092;10.52;0.64;245.53;12.31;714;75;3810.00;119
10263;75;628396006;10263;141;10973;11092;10.54;0.64;245.51;12.31;710;75;3811.00;119
10264;75;628396018;10264;140;10973;11092;10.57;0.64;245.53;12.31;709;75;3812.00;119
10268;75;628396028;10268;139;10973;11092;10.61;0.65;245.52;12.31;705;75;3813.00;119
10271;75;628396040;10271;140;10973;11092;10.63;0.65;245.55;12.31;702;75;3814.00;119
10273;75;628396050;10273;141;10973;11092;10.68;0.65;245.53;12.31;700;75;3815.00;119
10274;75;628396062;10274;158;11009;11162;10.58;0.65;245.53;12.27;735;75;3816.00;153
10274;75;628396078;10274;152;11011;11163;10.64;0.65;245.53;12.27;737;75;3817.00;152
10279;75;628396089;10279;151;11014;11163;10.78;0.66;245.51;12.27;735;75;3818.00;149
10282;75;628396107;10282;155;11017;11163;10.87;0.67;245.54;12.26;735;75;3819.00;146
10288;75;628396119;10288;156;11021;11163;10.99;0.67;245.52;12.26;733;75;3820.00;142
10290;75;628396130;10290;160;11023;11163;11.09;0.68;245.63;12.26;733;75;3821.00;140
10293;75;628396141;10293;162;11026;11163;11.15;0.68;245.64;12.26;733;75;3822.00;137
10297;75;628396152;10297;164;11030;11163;11.24;0.68;245.71;12.26;733;75;3823.00;133
10301;75;628396163;10301;170;11031;11164;11.25;0.68;245.69;12.26;730;75;3824.00;133
10307;75;628396173;10307;175;11036;11166;11.21;0.68;245.74;12.25;729;75;3825.00;130
10309;75;628396186;10309;179;11040;11166;11.15;0.68;245.72;12.25;731;75;3826.00;126
10312;75;628396197;10312;183;11043;11170;11.02;0.67;245.75;12.25;731;75;3827.00;127
10313;75;628396208;10313;187;11043;11170;11.02;0.67;245.74;12.25;730;75;3828.00;127
10316;75;628396219;10316;194;11043;11170;10.97;0.67;245.75;12.25;727;75;3829.00;127
10318;75;628396230;10318;195;11043;11170;10.92;0.66;245.75;12.25;725;75;3830.00;127
10319;75;628396240;10319;196;11046;11176;10.87;0.66;245.75;12.25;727;75;3831.00;130
10321;75;628396252;10321;200;11046;11176;10.85;0.66;245.75;12.25;725;75;3832.00;130
10324;75;628396263;10324;204;11047;11176;10.81;0.66;245.80;12.24;723;75;3833.00;129
10326;75;628396275;10326;204;11049;11179;10.80;0.66;245.79;12.24;723;75;3834.00;130
10330;75;628396285;10330;205;11049;11179;10.72;0.65;245.74;12.24;719;75;3835.00;130
10332;75;628396296;10332;209;11050;11179;10.79;0.66;245.74;12.24;718;75;3836.00;129
10336;75;628396307;10336;212;11050;11180;10.81;0.66;245.75;12.24;714;75;3837.00;130
10338;75;628396320;10338;213;11051;11181;10.74;0.65;245.75;12.24;713;75;3838.00;130
10341;75;628396331;10341;212;11051;11181;10.66;0.65;245.73;12.24;710;75;3839.00;130
10343;75;628396343;10343;215;11066;11207;10.57;0.64;245.69;12.22;723;75;3840.00;141
10346;75;628396355;10346;213;11067;11207;10.54;0.64;245.66;12.22;721;75;3841.00;140
10348;75;628396365;10348;207;11069;11207;10.57;0.64;245.69;12.22;721;75;3842.00;138
10352;75;628396377;10352;205;11071;11208;10.56;0.64;245.65;12.22;719;75;3843.00;137
10358;75;628396387;10358;203;11071;11208;10.53;0.64;245.59;12.22;713;75;3844.00;137
10361;75;628396397;10361;196;11074;11212;10.51;0.64;245.56;12.23;713;75;3845.00;138
10365;75;628396408;10365;192;11075;11214;10.52;0.64;245.52;12.23;710;75;3846.00;139
10366;75;628396418;10366;189;11079;11218;10.59;0.64;245.50;12.23;713;75;3847.00;139
10371;75;628396429;10371;187;11080;11218;10.65;0.65;245.45;12.35;709;75;3848.00;138
10376;75;628396440;10376;186;11081;11218;10.69;0.65;245.40;12.35;705;75;3849.00;137
10379;75;628396450;10379;185;11081;11218;10.82;0.66;245.43;12.35;702;75;3850.00;137
10381;76;628396459;10381;185;11081;11218;10.81;0.66;245.39;12.35;700;76;3851.00;137
10386;76;628396483;10386;183;11092;11230;10.85;0.66;245.32;12.33;706;76;3852.00;138
10390;76;628396495;10390;183;11092;11230;10.86;0.66;245.31;12.33;702;76;3853.00;138
10390;76;628396505;10390;183;11092;11230;10.86;0.66;245.31;12.33;702;76;3854.00;138
10392;76;628396515;10392;185;11092;11230;10.84;0.66;245.29;12.33;700;76;3855.00;138
10395;76;628396531;10395;186;11092;11230;10.79;0.65;245.29;12.33;697;76;3856.00;138
10395;76;628396540;10395;193;11093;11230;10.77;0.65;245.29;12.34;698;76;3857.00;137
10396;76;628396550;10396;199;11093;11231;10.70;0.65;245.29;12.34;697;76;3858.00;138
10397;76;628396560;10397;199;11095;11231;10.65;0.65;245.29;12.34;698;76;3859.00;136
10399;76;628396575;10399;203;11098;11237;10.60;0.65;245.29;12.34;699;76;3860.00;139
10400;76;628396586;10400;204;11101;11238;10.49;0.64;245.28;12.33;701;76;3861.00;137
10400;76;628396596;10400;208;11102;11238;10.38;0.63;245.28;12.33;702;76;3862.00;136
10403;76;628396612;10403;215;11104;11238;10.19;0.62;245.25;12.45;701;76;3863.00;134
10404;76;628396622;10404;214;11106;11242;10.06;0.61;245.25;12.45;702;76;3864.00;136
10406;76;628396632;10406;220;11108;11242;9.85;0.60;245.22;12.47;702;76;3865.00;134
10406;76;628396642;10406;225;11110;11242;9.66;0.59;245.22;12.48;704;76;3866.00;132
10406;76;628396651;10406;214;11111;11243;9.55;0.58;245.22;12.48;705;76;3867.00;132
10407;76;628396660;10407;206;11115;11247;9.44;0.58;245.23;12.47;708;76;3868.00;132
10410;76;628396671;10410;198;11115;11247;9.39;0.57;245.20;12.47;705;76;3869.00;132
10412;76;628396682;10412;200;11120;11253;9.42;0.57;245.18;12.50;708;76;3870.00;133
10415;76;628396693;10415;199;11121;11253;9.51;0.58;245.16;12.49;706;76;3871.00;132
10417;76;628396703;10417;197;11122;11253;9.56;0.58;245.14;12.49;705;76;3872.00;131
10418;76;628396714;10418;196;11124;11253;9.58;0.58;245.14;12.52;706;76;3873.00;129
10419;76;628396726;10419;198;11127;11257;9.67;0.59;245.14;12.52;708;76;3874.00;130
10421;77;628396744;10421;200;11129;11257;9.68;0.59;245.18;12.54;708;77;3875.00;128
10421;77;628396767;10421;203;11130;11257;9.73;0.59;245.18;12.54;709;77;3876.00;127
10421;77;628396776;10421;203;11130;11257;9.73;0.59;245.18;12.54;709;77;3877.00;127
10423;77;628396785;10423;208;11133;11258;9.63;0.58;245.17;12.56;710;77;3878.00;125
10423;77;628396795;10423;208;11134;11259;9.56;0.58;245.17;12.56;711;77;3879.00;125
10424;77;628396804;10424;212;11135;11259;9.52;0.58;245.18;12.57;711;77;3880.00;124
10425;77;628396814;10425;216;11137;11260;9.48;0.58;245.18;12.58;712;77;3881.00;123
10426;77;628396822;10426;220;11138;11260;9.44;0.58;245.17;12.59;712;77;3882.00;122
10428;77;628396837;10428;229;11138;11260;9.38;0.58;245.17;12.59;710;77;3883.00;122
10431;77;628396847;10431;228;11140;11260;9.32;0.57;245.15;12.61;709;77;3884.00;120
10433;77;628396857;10433;231;11141;11260;9.22;0.57;245.15;12.62;708;77;3885.00;119
10435;77;628396866;10435;233;11142;11260;9.16;0.56;245.14;12.63;707;77;3886.00;118
10436;77;628396875;10436;236;11143;11260;9.08;0.56;245.15;12.64;707;77;3887.00;117
10438;77;628396884;10438;254;11209;11387;9.07;0.56;245.13;12.58;771;77;3888.00;178
10438;77;628396904;10438;250;11213;11388;9.03;0.56;245.13;12.58;775;77;3889.00;175
10441;77;628396914;10441;245;11220;11388;8.99;0.56;245.18;12.57;779;77;3890.00;168
10442;77;628396924;10442;243;11226;11388;8.96;0.56;245.19;12.60;784;77;3891.00;162
10444;77;628396933;10444;232;11232;11388;8.94;0.55;245.18;12.59;788;77;3892.00;156
10447;77;628396943;10447;230;11237;11388;8.88;0.55;245.15;12.61;790;77;3893.00;151
10450;77;628396952;10450;233;11242;11388;8.81;0.55;245.17;12.61;792;77;3894.00;146
10454;77;628396962;10454;233;11246;11388;8.77;0.54;245.14;12.62;792;77;3895.00;142
10459;77;628396973;10459;232;11252;11389;8.76;0.54;245.10;12.63;793;77;3896.00;137
10462;77;628396984;10462;237;11254;11390;8.65;0.53;245.20;12.63;792;77;3897.00;136
10466;77;628396994;10466;235;11260;11390;8.53;0.52;245.21;12.65;794;77;3898.00;130
10468;77;628397009;10468;242;11263;11391;8.46;0.52;245.20;12.65;795;77;3899.00;128
10472;77;628397022;10472;254;11270;11406;8.31;0.51;245.24;12.67;798;77;3900.00;136
10473;77;628397037;10473;256;11272;11406;8.19;0.50;245.24;12.67;799;77;3901.00;134
10476;77;628397047;10476;259;11275;11406;8.08;0.50;245.24;12.68;799;77;3902.00;131
10480;77;628397057;10480;267;11278;11410;8.01;0.49;245.25;12.68;798;77;3903.00;132
10483;77;628397067;10483;267;11281;11410;7.86;0.48;245.25;12.69;798;77;3904.00;129
10487;77;628397077;10487;275;11282;11410;7.71;0.48;245.27;12.69;795;77;3905.00;128
10492;77;628397088;10492;274;11287;11413;7.55;0.46;245.22;12.70;795;77;3906.00;126
10496;77;628397098;10496;279;11288;11413;7.40;0.46;245.26;12.71;792;77;3907.00;125
10498;77;628397108;10498;284;11291;11413;7.31;0.45;245.27;12.70;793;77;3908.00;122
10501;77;628397117;10501;288;11294;11417;7.23;0.45;245.29;12.70;793;77;3909.00;123
10505;77;628397127;10505;288;11296;11418;7.23;0.45;245.28;12.71;791;77;3910.00;122
10508;77;628397137;10508;278;11298;11418;7.26;0.45;245.35;12.71;790;77;3911.00;120
10512;77;628397147;10512;267;11301;11422;7.35;0.46;245.37;12.72;789;77;3912.00;121
10516;77;628397157;10516;265;11304;11422;7.41;0.46;245.39;12.72;788;77;3913.00;118
10521;77;628397174;10521;255;11305;11422;7.45;0.46;245.39;12.72;784;77;3914.00;117
10524;77;628397190;10524;250;11307;11424;7.52;0.47;245.42;12.72;783;77;3915.00;117
10530;77;628397200;10530;244;11310;11424;7.49;0.46;245.42;12.74;780;77;3916.00;114
10534;77;628397211;10534;233;11313;11430;7.63;0.47;245.43;12.73;779;77;3917.00;117
10537;77;628397222;10537;224;11313;11430;7.72;0.47;245.45;12.73;776;77;3918.00;117
10540;77;628397232;10540;225;11314;11431;7.79;0.48;245.45;12.73;774;77;3919.00;117
10546;77;628397242;10546;215;11314;11431;7.83;0.48;245.47;12.73;768;77;3920.00;117
10551;77;628397253;10551;216;11315;11431;7.91;0.49;245.45;12.86;764;77;3921.00;116
10556;77;628397265;10556;206;11316;11431;7.97;0.49;245.44;12.86;760;77;3922.00;115
10558;77;628397275;10558;201;11316;11431;8.05;0.49;245.46;12.86;758;77;3923.00;115
10563;77;628397285;10563;195;11324;11443;8.06;0.49;245.46;12.85;761;77;3924.00;119
10568;77;628397296;10568;193;11325;11443;8.09;0.49;245.47;12.85;757;77;3925.00;118
10571;77;628397307;10571;188;11326;11443;8.20;0.50;245.49;12.85;755;77;3926.00;117
10574;77;628397317;10574;189;11328;11443;8.27;0.51;245.49;12.85;754;77;3927.00;115
10578;77;628397327;10578;190;11328;11443;8.41;0.51;245.47;12.85;750;77;3928.00;115
10586;77;628397337;10586;187;11328;11443;8.49;0.52;245.56;12.85;742;77;3929.00;115
10589;77;628397349;10589;181;11332;11447;8.55;0.52;245.58;12.85;743;77;3930.00;115
10591;77;628397359;10591;179;11332;11447;8.66;0.53;245.58;12.85;741;77;3931.00;115
10596;77;628397370;10596;174;11334;11451;8.77;0.54;245.63;12.85;738;77;3932.00;117
10597;77;628397380;10597;175;11337;11452;8.87;0.54;245.65;12.85;740;77;3933.00;115
10601;77;628397391;10601;178;11338;11452;8.84;0.54;245.67;12.85;737;77;3934.00;114
10604;77;628397402;10604;188;11338;11452;8.87;0.54;245.68;12.85;734;77;3935.00;114
10609;77;628397412;10609;190;11349;11465;8.95;0.55;245.71;12.84;740;77;3936.00;116
10616;77;628397424;10616;194;11349;11465;8.98;0.55;245.79;12.84;733;77;3937.00;116
10619;77;628397435;10619;195;11351;11465;9.05;0.55;245.80;12.84;732;77;3938.00;114
10624;77;628397445;10624;198;11352;11466;9.11;0.56;245.82;12.84;728;77;3939.00;114
10630;77;628397455;10630;201;11354;11467;9.16;0.56;245.87;12.84;724;77;3940.00;113
10633;77;628397466;10633;198;11354;11467;9.18;0.56;245.86;12.84;721;77;3941.00;113
10638;77;628397478;10638;198;11358;11470;9.19;0.56;245.86;12.83;720;77;3942.00;112
10645;77;628397489;10645;196;11358;11470;9.22;0.56;245.91;12.83;713;77;3943.00;112
10648;77;628397500;10648;195;11358;11470;9.32;0.56;245.94;12.83;710;77;3944.00;112
10651;77;628397511;10651;194;11359;11470;9.35;0.57;245.96;12.96;708;77;3945.00;111
10652;77;628397521;10652;196;11363;11476;9.36;0.57;245.97;12.95;711;77;3946.00;113
10654;77;628397533;10654;198;11364;11476;9.32;0.57;245.98;12.95;710;77;3947.00;112
10659;77;628397543;10659;199;11364;11476;9.25;0.56;246.05;12.95;705;77;3948.00;112
10662;77;628397554;10662;201;11364;11476;9.20;0.56;246.08;12.95;702;77;3949.00;112
10664;77;628397564;10664;202;11367;11480;9.19;0.56;246.06;12.95;703;77;3950.00;113
10667;77;628397575;10667;199;11368;11481;9.15;0.56;246.09;12.95;701;77;3951.00;113
10671;77;628397585;10671;205;11368;11481;9.13;0.56;246.13;12.95;697;77;3952.00;113
10674;77;628397595;10674;211;11369;11482;9.07;0.55;246.14;12.95;695;77;3953.00;113
10677;77;628397606;10677;214;11369;11482;9.02;0.55;246.12;12.95;692;77;3954.00;113
10679;77;628397615;10679;222;11369;11482;8.91;0.54;246.16;12.95;690;77;3955.00;113
10683;77;628397626;10683;228;11369;11482;8.81;0.54;246.14;12.95;686;77;3956.00;113
10688;77;628397636;10688;216;11369;11482;8.67;0.53;246.18;12.95;681;77;3957.00;113
10690;77;628397647;10690;216;11369;11482;8.56;0.52;246.18;12.95;679;77;3958.00;113
10695;77;628397657;10695;212;11369;11482;8.39;0.51;246.23;12.95;674;77;3959.00;113
10696;77;628397671;10696;233;11440;11607;8.32;0.51;246.29;12.87;744;77;3960.00;167
10700;77;628397690;10700;223;11442;11608;8.27;0.51;246.32;12.87;742;77;3961.00;166
10703;77;628397701;10703;215;11447;11608;8.38;0.52;246.32;12.86;744;77;3962.00;161
10706;77;628397713;10706;210;11449;11608;8.43;0.52;246.35;12.86;743;77;3963.00;159
10708;77;628397728;10708;212;11453;11608;8.52;0.52;246.34;12.86;745;77;3964.00;155
10711;77;628397746;10711;213;11457;11608;8.57;0.53;246.36;12.97;746;77;3965.00;151
10712;77;628397766;10712;201;11461;11608;8.68;0.53;246.39;12.97;749;77;3966.00;147
10719;77;628397781;10719;193;11462;11608;8.80;0.54;246.49;12.97;743;77;3967.00;146
10720;77;628397797;10720;187;11468;11609;8.89;0.54;246.47;12.97;748;77;3968.00;141
10724;77;628397813;10724;186;11469;11610;8.90;0.55;246.48;12.97;745;77;3969.00;141
10727;77;628397827;10727;185;11470;11610;8.87;0.54;246.46;12.97;743;77;3970.00;140
10731;77;628397841;10731;182;11476;11614;8.79;0.54;246.47;12.96;745;77;3971.00;138
10736;77;628397854;10736;185;11478;11614;8.72;0.53;246.46;12.96;742;77;3972.00;136
10737;77;628397866;10737;187;11479;11614;8.75;0.54;246.45;12.96;742;77;3973.00;135
10742;77;628397878;10742;185;11480;11614;8.80;0.54;246.49;12.96;738;77;3974.00;134
10745;77;628397890;10745;192;11484;11620;8.86;0.54;246.49;12.96;739;77;3975.00;136
10746;77;628397902;10746;190;11484;11620;8.96;0.55;246.51;12.96;738;77;3976.00;136
10748;77;628397935;10748;189;11485;11620;9.05;0.55;246.54;12.96;737;77;3977.00;135
10750;77;628397952;10750;195;11487;11623;9.09;0.55;246.53;12.95;737;77;3978.00;136
10750;77;628397964;10750;197;11487;11623;9.16;0.56;246.53;12.95;737;77;3979.00;136
10752;77;628397977;10752;197;11487;11623;9.19;0.56;246.54;12.95;735;77;3980.00;136
10753;77;628397989;10753;197;11488;11624;9.21;0.56;246.56;12.95;735;77;3981.00;136
10757;77;628398001;10757;195;11489;11625;9.16;0.56;246.53;12.95;732;77;3982.00;136
10758;77;628398012;10758;198;11489;11625;9.21;0.56;246.52;12.95;731;77;3983.00;136
10761;77;628398022;10761;200;11497;11638;9.20;0.56;246.50;12.94;736;77;3984.00;141
10763;77;628398041;10763;200;11498;11638;9.21;0.56;246.55;12.94;735;77;3985.00;140
10765;77;628398052;10765;203;11499;11638;9.22;0.56;246.55;12.94;734;77;3986.00;139
10767;77;628398068;10767;212;11500;11639;9.25;0.56;246.52;12.94;733;77;3987.00;139
10768;77;628398078;10768;211;11500;11639;9.29;0.57;246.51;12.94;732;77;3988.00;139
10769;77;628398089;10769;221;11503;11643;9.40;0.57;246.52;12.94;734;77;3989.00;140
10770;77;628398101;10770;218;11504;11643;9.51;0.58;246.51;12.94;734;77;3990.00;139
10774;77;628398111;10774;224;11507;11647;9.55;0.58;246.48;12.93;733;77;3991.00;140
10777;77;628398121;10777;226;11507;11647;9.51;0.58;246.46;12.93;730;77;3992.00;140
10779;77;628398132;10779;225;11507;11647;9.58;0.58;246.53;12.93;728;77;3993.00;140
10780;77;628398142;10780;232;11507;11647;9.56;0.58;246.52;12.93;727;77;3994.00;140
10780;77;628398152;10780;230;11507;11647;9.63;0.59;246.52;12.93;727;77;3995.00;140
10784;77;628398161;10784;233;11517;11659;9.66;0.59;246.48;12.92;733;77;3996.00;142
10785;77;628398172;10785;235;11518;11659;9.73;0.60;246.48;12.92;733;77;3997.00;141
10787;77;628398182;10787;238;11518;11659;9.75;0.60;246.45;12.92;731;77;3998.00;141
10790;77;628398192;10790;240;11518;11659;9.78;0.60;246.43;12.92;728;77;3999.00;141
10791;77;628398202;10791;239;11518;11659;9.86;0.60;246.41;12.92;727;77;4000.00;141
10794;77;628398216;10794;237;11518;11659;9.86;0.60;246.40;12.92;724;77;4001.00;141
10798;77;628398226;10798;238;11519;11660;9.83;0.60;246.35;13.04;721;77;4002.00;141
10800;77;628398243;10800;238;11519;11660;9.85;0.60;246.33;13.04;719;77;4003.00;141
10800;77;628398254;10800;236;11523;11666;9.85;0.60;246.33;13.04;723;77;4004.00;143
10803;77;628398263;10803;235;11526;11668;9.91;0.61;246.33;13.03;723;77;4005.00;142
10807;77;628398275;10807;238;11526;11668;9.99;0.61;246.28;13.03;719;77;4006.00;142
10810;77;628398284;10810;238;11526;11668;10.03;0.61;246.25;13.03;716;77;4007.00;142
10811;77;628398294;10811;236;11529;11672;10.06;0.61;246.24;13.03;718;77;4008.00;143
10812;77;628398303;10812;236;11529;11672;10.06;0.61;246.24;13.03;717;77;4009.00;143
10815;77;628398312;10815;233;11529;11672;10.10;0.62;246.23;13.03;714;77;4010.00;143
10818;77;628398321;10818;231;11530;11673;10.16;0.62;246.23;13.03;712;77;4011.00;143
10823;77;628398330;10823;233;11533;11677;10.13;0.62;246.17;13.03;710;77;4012.00;144
10825;77;628398340;10825;225;11533;11677;10.10;0.62;246.21;13.03;708;77;4013.00;144
10828;77;628398350;10828;226;11535;11680;10.15;0.62;246.21;13.02;707;77;4014.00;145
10831;77;628398362;10831;221;11538;11680;10.15;0.62;246.20;13.05;707;77;4015.00;142
10834;77;628398377;10834;214;11538;11680;10.13;0.62;246.18;13.05;704;77;4016.00;142
10836;77;628398391;10836;217;11539;11680;10.07;0.61;246.17;13.17;703;77;4017.00;141
10836;77;628398401;10836;217;11542;11684;10.10;0.62;246.17;13.17;706;77;4018.00;142
10838;77;628398411;10838;201;11542;11684;10.23;0.62;246.15;13.17;704;77;4019.00;142
10842;77;628398422;10842;191;11543;11684;10.37;0.63;246.10;13.17;701;77;4020.00;141
10843;77;628398432;10843;178;11543;11684;10.53;0.64;246.09;13.17;700;77;4021.00;141
10845;77;628398442;10845;175;11544;11685;10.62;0.65;246.06;13.29;699;77;4022.00;141
10846;77;628398452;10846;169;11545;11686;10.72;0.65;246.06;13.28;699;77;4023.00;141
10849;77;628398461;10849;164;11545;11686;10.77;0.65;246.06;13.28;696;77;4024.00;141
10850;77;628398472;10850;163;11546;11687;10.81;0.66;246.06;13.28;696;77;4025.00;141
10854;77;628398482;10854;156;11546;11687;10.77;0.65;246.02;13.28;692;77;4026.00;141
10855;77;628398492;10855;153;11546;11687;10.76;0.65;246.01;13.28;691;77;4027.00;141
10857;77;628398508;10857;154;11547;11687;10.71;0.65;246.03;13.29;690;77;4028.00;140
10860;77;628398525;10860;152;11547;11687;10.77;0.65;246.04;13.29;687;77;4029.00;140
10860;77;628398535;10860;150;11547;11687;10.79;0.65;246.04;13.29;687;77;4030.00;140
10863;77;628398556;10863;148;11547;11687;10.80;0.65;246.01;13.29;684;77;4031.00;140
10863;77;628398567;10863;165;11611;11814;10.81;0.66;246.01;13.21;748;77;4032.00;203
10864;77;628398587;10864;163;11614;11815;10.80;0.66;246.01;13.21;750;77;4033.00;201
10865;77;628398598;10865;152;11624;11815;10.83;0.67;246.01;13.20;759;77;4034.00;191
10865;77;628398609;10865;151;11626;11815;10.82;0.66;246.01;13.20;761;77;4035.00;189
10866;77;628398619;10866;146;11631;11815;10.80;0.66;246.00;13.19;765;77;4036.00;184
10867;77;628398630;10867;148;11635;11815;10.74;0.66;246.01;13.19;768;77;4037.00;180
10868;77;628398641;10868;149;11638;11815;10.70;0.66;246.01;13.19;770;77;4038.00;177
10869;77;628398651;10869;155;11641;11815;10.67;0.65;246.01;13.19;772;77;4039.00;174
10870;77;628398662;10870;161;11645;11816;10.62;0.65;245.98;13.20;775;77;4040.00;171
10874;77;628398678;10874;168;11648;11817;10.59;0.65;246.01;13.20;774;77;4041.00;169
10878;77;628398690;10878;177;11651;11817;10.53;0.64;246.04;13.20;773;77;4042.00;166
10880;77;628398701;10880;175;11654;11818;10.40;0.64;246.08;13.22;774;77;4043.00;164
10886;77;628398712;10886;181;11658;11818;10.29;0.63;246.09;13.23;772;77;4044.00;160
10889;77;628398726;10889;183;11662;11818;10.17;0.62;246.08;13.26;773;77;4045.00;156
10891;77;628398737;10891;187;11666;11818;10.03;0.61;246.09;13.26;775;77;4046.00;152
10894;77;628398749;10894;190;11671;11822;9.90;0.61;246.09;13.29;777;77;4047.00;151
10897;77;628398760;10897;194;11675;11822;9.83;0.60;246.11;13.30;778;77;4048.00;147
10899;77;628398771;10899;195;11677;11822;9.65;0.59;246.18;13.31;778;77;4049.00;145
10901;77;628398783;10901;206;11681;11828;9.57;0.59;246.18;13.31;780;77;4050.00;147
10904;77;628398793;10904;211;11683;11828;9.41;0.58;246.18;13.33;779;77;4051.00;145
10906;77;628398809;10906;216;11687;11828;9.35;0.57;246.15;13.36;781;77;4052.00;141
10910;77;628398820;10910;223;11691;11832;9.20;0.56;246.15;13.36;781;77;4053.00;141
10913;77;628398830;10913;231;11694;11833;9.15;0.56;246.18;13.37;781;77;4054.00;139
10915;77;628398841;10915;242;11695;11833;9.05;0.55;246.17;13.38;780;77;4055.00;138
10918;77;628398851;10918;245;11701;11837;8.94;0.55;246.17;13.40;783;77;4056.00;136
10919;77;628398861;10919;249;11701;11837;8.83;0.54;246.17;13.40;782;77;4057.00;136
10922;77;628398871;10922;255;11703;11837;8.72;0.53;246.19;13.41;781;77;4058.00;134
10923;77;628398880;10923;252;11705;11838;8.62;0.53;246.22;13.41;782;77;4059.00;133
10924;77;628398891;10924;252;11706;11838;8.48;0.52;246.26;13.42;782;77;4060.00;132
10929;77;628398901;10929;253;11711;11844;8.40;0.51;246.23;13.42;782;77;4061.00;133
10930;77;628398912;10930;248;11713;11844;8.26;0.51;246.23;13.44;783;77;4062.00;131
10931;77;628398922;10931;244;11713;11845;8.23;0.50;246.22;13.44;782;77;4063.00;132
10935;77;628398932;10935;246;11714;11845;8.19;0.50;246.25;13.45;779;77;4064.00;131
10939;77;628398942;10939;244;11715;11845;8.16;0.50;246.26;13.46;776;77;4065.00;130
10941;77;628398952;10941;249;11716;11845;8.14;0.50;246.23;13.46;775;77;4066.00;129
10945;77;628398961;10945;251;11717;11845;8.09;0.49;246.21;13.48;772;77;4067.00;128
10947;77;628398972;10947;249;11728;11857;8.14;0.50;246.21;13.47;781;77;4068.00;129
10949;77;628398983;10949;247;11729;11857;8.17;0.50;246.21;13.48;780;77;4069.00;128
10951;77;628398992;10951;250;11731;11857;8.17;0.50;246.19;13.49;780;77;4070.00;126
10952;77;628399002;10952;247;11732;11857;8.12;0.50;246.20;13.50;780;77;4071.00;125
10953;77;628399011;10953;245;11733;11857;8.08;0.49;246.19;13.50;780;77;4072.00;124
10958;77;628399020;10958;255;11734;11857;7.97;0.49;246.20;13.51;776;77;4073.00;123
10960;77;628399030;10960;246;11737;11861;7.86;0.48;246.22;13.51;777;77;4074.00;124
10963;77;628399040;10963;241;11739;11861;7.87;0.48;246.25;13.52;776;77;4075.00;122
10967;77;628399050;10967;243;11742;11865;7.84;0.48;246.26;13.52;775;77;4076.00;123
10969;77;628399060;10969;248;11745;11866;7.73;0.47;246.25;13.53;776;77;4077.00;121
10974;77;628399070;10974;254;11746;11866;7.56;0.46;246.27;13.52;772;77;4078.00;120
10979;77;628399079;10979;266;11746;11866;7.40;0.45;246.33;13.52;767;77;4079.00;120
10982;77;628399090;10982;266;11767;11895;7.33;0.45;246.29;13.51;785;77;4080.00;128
10987;77;628399101;10987;259;11769;11895;7.31;0.45;246.29;13.51;782;77;4081.00;126
10991;77;628399111;10991;260;11773;11895;7.37;0.45;246.28;13.51;782;77;4082.00;122
10994;77;628399120;10994;252;11776;11896;7.44;0.46;246.30;13.52;782;77;4083.00;120
10999;77;628399130;10999;248;11776;11897;7.46;0.46;246.32;13.52;777;77;4084.00;121
11002;77;628399139;11002;246;11776;11897;7.47;0.46;246.31;13.52;774;77;4085.00;121
11007;77;628399155;11007;242;11779;11900;7.56;0.46;246.39;13.51;772;77;4086.00;121
11008;77;628399164;11008;236;11779;11900;7.67;0.47;246.38;13.51;771;77;4087.00;121
11013;77;628399174;11013;231;11779;11900;7.73;0.47;246.38;13.51;766;77;4088.00;121
11018;77;628399183;11018;228;11779;11900;7.82;0.48;246.44;13.51;761;77;4089.00;121
11022;77;628399193;11022;224;11784;11906;7.91;0.49;246.41;13.51;762;77;4090.00;122
11027;77;628399203;11027;222;11785;11906;7.98;0.49;246.42;13.63;758;77;4091.00;121
11031;77;628399215;11031;217;11785;11906;8.14;0.50;246.47;13.63;754;77;4092.00;121
11036;77;628399226;11036;214;11785;11906;8.27;0.51;246.50;13.63;749;77;4093.00;121
11044;77;628399236;11044;207;11788;11910;8.36;0.51;246.62;13.62;744;77;4094.00;122
11044;77;628399246;11044;201;11790;11912;8.56;0.53;246.62;13.62;746;77;4095.00;122
11049;77;628399256;11049;194;11790;11912;8.64;0.53;246.66;13.62;741;77;4096.00;122
11055;77;628399266;11055;189;11791;11913;8.73;0.54;246.65;13.62;736;77;4097.00;122
11059;77;628399277;11059;191;11791;11913;8.82;0.54;246.66;13.62;732;77;4098.00;122
11065;77;628399287;11065;194;11791;11913;8.87;0.54;246.71;13.62;726;77;4099.00;122
11069;77;628399298;11069;197;11791;11913;8.97;0.55;246.69;13.62;722;77;4100.00;122
11073;77;628399317;11073;202;11791;11913;9.06;0.56;246.72;13.62;718;77;4101.00;122
11076;77;628399327;11076;200;11791;11913;9.20;0.56;246.74;13.62;715;77;4102.00;122
11081;77;628399337;11081;199;11791;11913;9.24;0.57;246.73;13.62;710;77;4103.00;122
11088;77;628399347;11088;206;11833;11983;9.17;0.56;246.71;13.57;745;77;4104.00;150
11092;77;628399363;11092;199;11833;11984;9.19;0.56;246.71;13.57;741;77;4105.00;151
11098;77;628399374;11098;194;11838;11984;9.28;0.57;246.75;13.57;740;77;4106.00;146
11102;77;628399385;11102;191;11842;11984;9.45;0.58;246.80;13.56;740;77;4107.00;142
11109;77;628399395;11109;192;11846;11984;9.59;0.58;246.81;13.56;737;77;4108.00;138
11112;77;628399406;11112;197;11849;11984;9.76;0.59;246.77;13.56;737;77;4109.00;135
11117;77;628399417;11117;199;11851;11984;9.87;0.60;246.79;13.56;734;77;4110.00;133
11122;77;628399428;11122;202;11852;11984;9.89;0.60;246.78;13.56;730;77;4111.00;132
11123;77;628399438;11123;208;11854;11985;9.89;0.60;246.79;13.55;731;77;4112.00;131
11124;77;628399449;11124;211;11855;11986;9.80;0.59;246.80;13.55;731;77;4113.00;131
11127;77;628399459;11127;216;11856;11986;9.70;0.59;246.84;13.55;729;77;4114.00;130
11131;77;628399470;11131;224;11858;11990;9.60;0.58;246.82;13.55;727;77;4115.00;132
11135;77;628399481;11135;226;11858;11990;9.56;0.58;246.84;13.55;723;77;4116.00;132
11138;77;628399492;11138;228;11858;11990;9.46;0.58;246.84;13.55;720;77;4117.00;132
11142;77;628399502;11142;226;11858;11990;9.34;0.57;246.89;13.55;716;77;4118.00;132
11145;77;628399512;11145;224;11862;11996;9.28;0.57;246.90;13.55;717;77;4119.00;134
11148;77;628399523;11148;226;11865;11996;9.27;0.57;246.92;13.55;717;77;4120.00;131
11153;77;628399533;11153;236;11865;11996;9.21;0.56;246.98;13.55;712;77;4121.00;131
11157;77;628399543;11157;245;11867;11999;9.15;0.56;247.02;13.54;710;77;4122.00;132
11162;77;628399554;11162;249;11869;11999;9.04;0.55;247.05;13.54;707;77;4123.00;130
11165;77;628399564;11165;253;11870;11999;8.89;0.54;247.06;13.54;705;77;4124.00;129
11169;77;628399573;11169;259;11870;12000;8.75;0.53;247.09;13.54;701;77;4125.00;130
11172;77;628399583;11172;266;11871;12001;8.55;0.52;247.10;13.54;699;77;4126.00;130
11176;77;628399593;11176;263;11871;12001;8.40;0.51;247.14;13.54;695;77;4127.00;130
11179;77;628399603;11179;263;11882;12014;8.48;0.51;247.10;13.53;703;77;4128.00;132
11181;77;628399613;11181;263;11882;12014;8.40;0.51;247.10;13.53;701;77;4129.00;132
11182;77;628399623;11182;260;11882;12014;8.34;0.51;247.10;13.53;700;77;4130.00;132
11183;77;628399632;11183;261;11883;12015;8.39;0.51;247.09;13.53;700;77;4131.00;132
11188;77;628399642;11188;259;11883;12015;8.32;0.51;247.12;13.53;695;77;4132.00;132
11190;77;628399652;11190;265;11886;12019;8.33;0.51;247.12;13.52;696;77;4133.00;133
11194;77;628399663;11194;265;11886;12019;8.26;0.50;247.12;13.52;692;77;4134.00;133
11195;77;628399673;11195;264;11891;12023;8.25;0.50;247.11;13.64;696;77;4135.00;132
11196;77;628399683;11196;250;11891;12023;8.26;0.50;247.11;13.64;695;77;4136.00;132
11197;77;628399693;11197;240;11891;12023;8.29;0.50;247.13;13.64;694;77;4137.00;132
11198;77;628399702;11198;231;11891;12023;8.38;0.51;247.13;13.64;693;77;4138.00;132
11199;77;628399712;11199;229;11891;12023;8.42;0.51;247.13;13.64;692;77;4139.00;132
11199;77;628399729;11199;230;11915;12057;8.49;0.52;247.13;13.61;716;77;4140.00;142
11202;77;628399748;11202;228;11916;12057;8.56;0.52;247.12;13.61;714;77;4141.00;141
11203;78;628399765;11203;223;11917;12057;8.64;0.53;247.11;13.61;714;78;4142.00;140
11203;78;628399796;11203;214;11917;12057;8.75;0.54;247.11;13.61;714;78;4143.00;140
11205;78;628399811;11205;214;11918;12057;8.85;0.54;247.08;13.61;713;78;4144.00;139
11206;78;628399826;11206;211;11918;12057;8.96;0.55;247.07;13.61;712;78;4145.00;139
11209;78;628399839;11209;212;11919;12058;9.06;0.55;247.07;13.61;710;78;4146.00;139
11210;78;628399851;11210;205;11919;12058;9.19;0.56;247.05;13.61;709;78;4147.00;139
11214;78;628399862;11214;205;11923;12064;9.29;0.57;247.07;13.61;709;78;4148.00;141
11215;78;628399874;11215;201;11924;12065;9.36;0.57;247.06;13.60;709;78;4149.00;141
11219;78;628399886;11219;204;11925;12065;9.37;0.57;247.02;13.60;706;78;4150.00;140
11221;78;628399897;11221;208;11925;12065;9.36;0.57;247.02;13.60;704;78;4151.00;140
11224;78;628399914;11224;211;11929;12069;9.34;0.57;247.00;13.60;705;78;4152.00;140
11225;78;628399926;11225;211;11930;12069;9.24;0.56;246.98;13.72;705;78;4153.00;139
11227;78;628399937;11227;207;11930;12069;9.19;0.56;246.97;13.72;703;78;4154.00;139
11229;78;628399947;11229;209;11931;12070;9.18;0.56;246.95;13.72;702;78;4155.00;139
11230;78;628399957;11230;220;11934;12074;9.16;0.56;246.94;13.72;704;78;4156.00;140
11232;78;628399967;11232;224;11934;12074;9.22;0.56;246.91;13.72;702;78;4157.00;140
11234;78;628399977;11234;228;11936;12077;9.29;0.57;246.90;13.71;702;78;4158.00;141
11236;78;628399987;11236;227;11936;12077;9.25;0.57;246.91;13.71;700;78;4159.00;141
11238;79;628399997;11238;230;11937;12077;9.25;0.56;246.89;13.71;699;79;4160.00;140
11238;79;628400020;11238;232;11937;12077;9.27;0.57;246.89;13.71;699;79;4161.00;140
11241;79;628400029;11241;235;11940;12081;9.29;0.57;246.87;13.71;699;79;4162.00;141
11244;79;628400040;11244;240;11940;12081;9.31;0.57;246.90;13.71;696;79;4163.00;141
11245;79;628400049;11245;242;11941;12081;9.38;0.57;246.89;13.71;696;79;4164.00;140
11246;79;628400058;11246;238;11941;12081;9.43;0.58;246.89;13.71;695;79;4165.00;140
11247;79;628400067;11247;243;11941;12082;9.44;0.58;246.88;13.71;694;79;4166.00;141
11248;79;628400076;11248;241;11942;12083;9.48;0.58;246.89;13.71;694;79;4167.00;141
11249;79;628400086;11249;245;11942;12083;9.49;0.58;246.89;13.71;693;79;4168.00;141
11249;79;628400095;11249;247;11944;12084;9.48;0.58;246.89;13.83;695;79;4169.00;140
11250;79;628400106;11250;250;11944;12084;9.46;0.58;246.88;13.83;694;79;4170.00;140
11252;79;628400114;11252;235;11944;12084;9.50;0.58;246.85;13.83;692;79;4171.00;140
11254;79;628400124;11254;222;11944;12084;9.50;0.58;246.84;13.83;690;79;4172.00;140
11255;79;628400133;11255;215;11946;12086;9.50;0.58;246.90;13.82;691;79;4173.00;140
11258;79;628400142;11258;207;11946;12086;9.59;0.58;246.88;13.82;688;79;4174.00;140
11261;79;628400152;11261;200;11946;12086;9.70;0.59;246.87;13.82;685;79;4175.00;140
11262;79;628400162;11262;215;12015;12213;9.66;0.60;246.88;13.74;753;79;4176.00;198
11263;79;628400181;11263;199;12016;12214;9.78;0.60;246.87;13.74;753;79;4177.00;198
11268;79;628400191;11268;180;12023;12214;9.97;0.61;246.87;13.74;755;79;4178.00;191
11272;79;628400204;11272;168;12025;12214;10.06;0.62;246.85;13.73;753;79;4179.00;189
11274;79;628400214;11274;165;12029;12214;10.20;0.63;246.84;13.73;755;79;4180.00;185
11279;79;628400232;11279;163;12033;12214;10.21;0.63;246.80;13.73;754;79;4181.00;181
11281;79;628400243;11281;157;12039;12214;10.28;0.63;246.78;13.72;758;79;4182.00;175
11285;79;628400261;11285;154;12042;12214;10.32;0.63;246.76;13.84;757;79;4183.00;172
11286;79;628400272;11286;156;12046;12215;10.41;0.64;246.75;13.84;760;79;4184.00;169
11288;79;628400283;11288;156;12053;12217;10.46;0.64;246.77;13.85;765;79;4185.00;164
11290;79;628400295;11290;151;12056;12217;10.56;0.64;246.81;13.97;766;79;4186.00;161
11292;79;628400306;11292;153;12057;12218;10.62;0.65;246.80;13.96;765;79;4187.00;161
11295;79;628400318;11295;156;12058;12218;10.66;0.65;246.79;13.96;763;79;4188.00;160
11298;79;628400328;11298;159;12061;12218;10.68;0.65;246.78;14.07;763;79;4189.00;157
11301;79;628400339;11301;158;12062;12218;10.66;0.65;246.77;14.07;761;79;4190.00;156
11302;79;628400350;11302;161;12065;12222;10.66;0.65;246.79;14.07;763;79;4191.00;157
11305;79;628400361;11305;157;12067;12222;10.61;0.65;246.78;14.18;762;79;4192.00;155
11306;79;628400374;11306;160;12068;12222;10.63;0.65;246.77;14.18;762;79;4193.00;154
11309;79;628400386;11309;155;12071;12225;10.69;0.65;246.82;14.28;762;79;4194.00;154
11311;79;628400405;11311;161;12072;12225;10.72;0.65;246.81;14.28;761;79;4195.00;153
11312;79;628400419;11312;162;12073;12225;10.79;0.66;246.80;14.29;761;79;4196.00;152
11315;79;628400430;11315;165;12080;12229;10.75;0.65;246.79;14.40;765;79;4197.00;149
11317;79;628400443;11317;164;12081;12230;10.74;0.65;246.78;14.40;764;79;4198.00;149
11321;79;628400455;11321;159;12081;12230;10.75;0.65;246.74;14.40;760;79;4199.00;149
11325;79;628400473;11325;165;12091;12264;10.56;0.64;246.75;14.39;766;79;4200.00;173
11329;79;628400493;11329;162;12093;12264;10.42;0.63;246.79;14.38;764;79;4201.00;171
11330;79;628400511;11330;159;12093;12264;10.32;0.63;246.79;14.38;763;79;4202.00;171
11332;79;628400523;11332;161;12096;12265;10.18;0.62;246.82;14.38;764;79;4203.00;169
11335;79;628400534;11335;164;12097;12265;10.10;0.62;246.87;14.38;762;79;4204.00;168
11339;79;628400545;11339;170;12101;12271;10.02;0.61;246.87;14.38;762;79;4205.00;170
11343;79;628400557;11343;170;12104;12271;9.89;0.60;246.89;14.39;761;79;4206.00;167
11346;79;628400568;11346;174;12105;12272;9.79;0.60;246.92;14.39;759;79;4207.00;167
11347;79;628400579;11347;177;12105;12272;9.74;0.59;246.94;14.39;758;79;4208.00;167
11351;79;628400591;11351;183;12107;12272;9.64;0.59;246.98;14.41;756;79;4209.00;165
11353;79;628400604;11353;191;12108;12272;9.71;0.59;246.98;14.41;755;79;4210.00;164
11355;79;628400615;11355;198;12110;12272;9.72;0.59;246.98;14.41;755;79;4211.00;162
11358;79;628400627;11358;199;12121;12284;9.68;0.59;246.98;14.43;763;79;4212.00;163
11363;79;628400640;11363;196;12123;12284;9.60;0.58;246.98;14.42;760;79;4213.00;161
11365;79;628400652;11365;202;12124;12284;9.56;0.58;246.97;14.44;759;79;4214.00;160
11368;79;628400663;11368;200;12125;12284;9.49;0.58;247.02;14.45;757;79;4215.00;159
11370;79;628400682;11370;208;12126;12284;9.49;0.58;247.05;14.45;756;79;4216.00;158
11374;79;628400693;11374;210;12128;12284;9.48;0.57;247.01;14.46;754;79;4217.00;156
11375;79;628400710;11375;215;12133;12288;9.45;0.57;247.03;14.47;758;79;4218.00;155
11378;79;628400723;11378;219;12133;12288;9.38;0.57;247.06;14.47;755;79;4219.00;155
11381;79;628400734;11381;224;12136;12292;9.36;0.57;247.07;14.48;755;79;4220.00;156
11384;79;628400749;11384;227;12139;12293;9.36;0.57;247.10;14.50;755;79;4221.00;154
11387;79;628400767;11387;232;12139;12293;9.31;0.57;247.09;14.50;752;79;4222.00;154
11388;79;628400781;11388;242;12143;12293;9.26;0.57;247.10;14.52;755;79;4223.00;150
11392;79;628400792;11392;245;12150;12306;9.17;0.56;247.08;14.53;758;79;4224.00;156
11394;79;628400803;11394;242;12152;12306;9.14;0.56;247.08;14.53;758;79;4225.00;154
11395;79;628400813;11395;243;12154;12306;9.10;0.56;247.07;14.55;759;79;4226.00;152
11397;79;628400823;11397;247;12155;12307;9.08;0.55;247.09;14.55;758;79;4227.00;152
11400;79;628400834;11400;249;12157;12308;8.98;0.55;247.16;14.57;757;79;4228.00;151
11404;79;628400849;11404;257;12160;12308;8.88;0.54;247.14;14.57;756;79;4229.00;148
11405;79;628400861;11405;253;12164;12314;8.92;0.55;247.13;14.58;759;79;4230.00;150
11408;79;628400872;11408;253;12165;12314;8.93;0.55;247.12;14.58;757;79;4231.00;149
11413;79;628400882;11413;251;12168;12314;8.94;0.55;247.21;14.62;755;79;4232.00;146
11415;79;628400892;11415;247;12168;12314;8.95;0.55;247.20;14.62;753;79;4233.00;146
11416;79;628400901;11416;246;12171;12320;8.96;0.55;247.18;14.62;755;79;4234.00;149
11417;79;628400912;11417;244;12173;12320;8.88;0.54;247.18;14.63;756;79;4235.00;147
11418;79;628400922;11418;246;12174;12320;8.79;0.54;247.21;14.64;756;79;4236.00;146
11420;79;628400932;11420;248;12175;12320;8.77;0.54;247.19;14.65;755;79;4237.00;145
11423;79;628400942;11423;252;12180;12324;8.73;0.54;247.18;14.65;757;79;4238.00;144
11427;79;628400953;11427;251;12182;12325;8.75;0.54;247.16;14.66;755;79;4239.00;143
11431;79;628400963;11431;252;12182;12325;8.72;0.54;247.15;14.66;751;79;4240.00;143
11435;79;628400974;11435;251;12185;12326;8.70;0.53;247.15;14.66;750;79;4241.00;141
11437;79;628400984;11437;255;12186;12326;8.66;0.53;247.15;14.67;749;79;4242.00;140
11445;79;628400993;11445;258;12187;12326;8.53;0.52;247.15;14.67;742;79;4243.00;139
11449;79;628401009;11449;255;12187;12326;8.46;0.52;247.20;14.67;738;79;4244.00;139
11455;79;628401019;11455;254;12188;12326;8.35;0.51;247.18;14.69;733;79;4245.00;138
11458;79;628401029;11458;257;12190;12326;8.23;0.51;247.22;14.71;732;79;4246.00;136
11466;79;628401038;11466;261;12192;12326;7.98;0.49;247.24;14.72;726;79;4247.00;134
11471;79;628401047;11471;279;12228;12396;7.87;0.48;247.23;14.68;757;79;4248.00;168
11477;79;628401061;11477;275;12228;12397;7.71;0.48;247.24;14.68;751;79;4249.00;169
11481;79;628401070;11481;267;12234;12397;7.65;0.47;247.27;14.70;753;79;4250.00;163
11486;79;628401079;11486;268;12241;12397;7.59;0.47;247.27;14.70;755;79;4251.00;156
11489;79;628401089;11489;266;12244;12397;7.58;0.47;247.29;14.70;755;79;4252.00;153
11492;79;628401098;11492;268;12250;12397;7.59;0.47;247.32;14.71;758;79;4253.00;147
11498;79;628401107;11498;269;12254;12397;7.57;0.47;247.32;14.71;756;79;4254.00;143
11501;79;628401116;11501;262;12259;12397;7.58;0.47;247.36;14.71;758;79;4255.00;138
11505;80;628401125;11505;261;12260;12398;7.60;0.47;247.35;14.71;755;80;4256.00;138
11510;80;628401151;11510;260;12264;12399;7.66;0.47;247.38;14.72;754;80;4257.00;135
11512;80;628401162;11512;259;12266;12399;7.78;0.48;247.40;14.72;754;80;4258.00;133
11515;80;628401171;11515;253;12268;12403;7.86;0.48;247.42;14.72;753;80;4259.00;135
11517;80;628401182;11517;253;12269;12403;7.95;0.49;247.44;14.72;752;80;4260.00;134
11522;80;628401192;11522;256;12269;12403;7.98;0.49;247.44;14.72;747;80;4261.00;134
11525;80;628401202;11525;252;12269;12403;8.05;0.49;247.47;14.72;744;80;4262.00;134
11530;80;628401211;11530;253;12273;12409;8.01;0.49;247.49;14.72;743;80;4263.00;136
11535;80;628401221;11535;259;12274;12409;7.97;0.49;247.50;14.72;739;80;4264.00;135
11539;80;628401231;11539;252;12274;12409;7.96;0.49;247.51;14.72;735;80;4265.00;135
11542;80;628401246;11542;247;12277;12412;8.04;0.49;247.50;14.72;735;80;4266.00;135
11545;80;628401257;11545;246;12277;12412;8.07;0.49;247.49;14.72;732;80;4267.00;135
11550;80;628401266;11550;239;12278;12412;8.10;0.49;247.52;14.72;728;80;4268.00;134
11554;80;628401276;11554;240;12278;12413;8.07;0.49;247.51;14.72;724;80;4269.00;135
11558;80;628401285;11558;238;12280;12414;8.09;0.49;247.49;14.72;722;80;4270.00;134
11563;80;628401295;11563;232;12281;12414;8.02;0.49;247.54;14.72;718;80;4271.00;133
11566;80;628401304;11566;237;12294;12427;8.06;0.49;247.56;14.71;728;80;4272.00;133
11569;80;628401315;11569;238;12295;12427;8.01;0.49;247.57;14.71;726;80;4273.00;132
11576;80;628401325;11576;240;12296;12427;7.96;0.48;247.55;14.71;720;80;4274.00;131
11580;80;628401335;11580;243;12298;12429;7.94;0.48;247.56;14.71;718;80;4275.00;131
11584;80;628401345;11584;247;12299;12429;7.91;0.48;247.60;14.71;715;80;4276.00;130
11590;80;628401355;11590;252;12302;12433;7.80;0.48;247.64;14.71;712;80;4277.00;131
11593;80;628401365;11593;249;12303;12433;7.74;0.47;247.65;14.71;710;80;4278.00;130
11594;80;628401375;11594;249;12307;12437;7.75;0.47;247.64;14.71;713;80;4279.00;130
11597;80;628401385;11597;248;12307;12437;7.78;0.48;247.63;14.71;710;80;4280.00;130
11599;80;628401394;11599;252;12308;12437;7.82;0.48;247.71;14.71;709;80;4281.00;129
11603;80;628401403;11603;258;12308;12437;7.89;0.48;247.74;14.71;705;80;4282.00;129
11605;80;628401414;11605;261;12309;12437;7.98;0.49;247.73;14.71;704;80;4283.00;128
11613;80;628401423;11613;264;12319;12449;8.13;0.50;247.68;14.69;706;80;4284.00;130
11617;80;628401433;11617;262;12320;12449;8.16;0.50;247.69;14.69;703;80;4285.00;129
11621;80;628401443;11621;262;12321;12449;8.18;0.50;247.69;14.69;700;80;4286.00;128
11624;80;628401452;11624;265;12322;12449;8.18;0.50;247.69;14.69;698;80;4287.00;127
11628;80;628401463;11628;270;12322;12449;8.13;0.50;247.71;14.69;694;80;4288.00;127
11628;80;628401473;11628;274;12322;12449;8.09;0.50;247.71;14.69;694;80;4289.00;127
11636;80;628401484;11636;277;12322;12450;7.98;0.49;247.67;14.69;686;80;4290.00;128
11636;80;628401494;11636;288;12322;12450;7.97;0.49;247.67;14.69;686;80;4291.00;128
11641;80;628401503;11641;292;12326;12456;7.93;0.48;247.64;14.69;685;80;4292.00;130
11644;80;628401513;11644;303;12328;12457;7.82;0.48;247.64;14.80;684;80;4293.00;129
11646;80;628401523;11646;309;12329;12457;7.80;0.47;247.65;14.80;683;80;4294.00;128
11649;80;628401532;11649;313;12329;12457;7.69;0.47;247.62;14.80;680;80;4295.00;128
11652;80;628401542;11652;319;12332;12461;7.63;0.46;247.62;14.79;680;80;4296.00;129
11653;80;628401551;11653;312;12332;12461;7.58;0.46;247.61;14.79;679;80;4297.00;129
11655;80;628401559;11655;312;12332;12461;7.51;0.46;247.58;14.79;677;80;4298.00;129
11658;80;628401569;11658;311;12333;12462;7.48;0.45;247.61;14.79;675;80;4299.00;129
11660;80;628401578;11660;313;12336;12466;7.53;0.46;247.63;14.79;676;80;4300.00;130
11660;80;628401592;11660;311;12336;12466;7.57;0.46;247.63;14.79;676;80;4301.00;130
11662;80;628401602;11662;305;12338;12469;7.60;0.46;247.62;14.79;676;80;4302.00;131
11663;80;628401611;11663;308;12339;12469;7.65;0.47;247.61;14.79;676;80;4303.00;130
11665;80;628401620;11665;306;12339;12469;7.67;0.47;247.58;14.79;674;80;4304.00;130
11667;81;628401629;11667;308;12339;12469;7.68;0.47;247.60;14.79;672;81;4305.00;130
11670;81;628401645;11670;295;12342;12473;7.70;0.47;247.59;14.78;672;81;4306.00;131
11671;81;628401655;11671;281;12343;12473;7.85;0.48;247.59;14.78;672;81;4307.00;130
11671;81;628401669;11671;261;12343;12473;7.95;0.48;247.59;14.78;672;81;4308.00;130
11672;81;628401678;11672;246;12343;12473;8.03;0.49;247.59;14.78;671;81;4309.00;130
11674;81;628401688;11674;243;12343;12474;8.15;0.50;247.57;14.78;669;81;4310.00;131
11676;81;628401704;11676;236;12344;12475;8.23;0.50;247.56;14.78;668;81;4311.00;131
11679;81;628401715;11679;230;12344;12475;8.28;0.50;247.53;14.78;665;81;4312.00;131
11680;81;628401730;11680;226;12345;12476;8.41;0.51;247.52;14.78;665;81;4313.00;131
11681;81;628401745;11681;223;12345;12476;8.51;0.52;247.51;14.78;664;81;4314.00;131
11682;81;628401760;11682;222;12345;12476;8.57;0.52;247.51;14.78;663;81;4315.00;131
11685;81;628401776;11685;218;12345;12476;8.68;0.53;247.51;14.78;660;81;4316.00;131
11685;81;628401790;11685;218;12345;12476;8.76;0.53;247.51;14.78;660;81;4317.00;131
11686;81;628401804;11686;219;12345;12476;8.79;0.53;247.50;14.78;659;81;4318.00;131
11687;81;628401817;11687;219;12345;12476;8.81;0.53;247.49;14.78;658;81;4319.00;131
11689;81;628401834;11689;263;12458;12706;8.83;0.55;247.46;14.65;769;81;4320.00;248
11690;81;628401865;11690;251;12461;12707;8.85;0.55;247.53;14.64;771;81;4321.00;246
11691;81;628401877;11691;238;12471;12707;8.93;0.56;247.52;14.63;780;81;4322.00;236
11692;81;628401887;11692;223;12478;12707;9.03;0.56;247.50;14.63;786;81;4323.00;229
11695;81;628401898;11695;205;12484;12707;9.08;0.57;247.49;14.62;789;81;4324.00;223
11695;81;628401910;11695;201;12488;12707;9.13;0.57;247.49;14.62;793;81;4325.00;219
11696;81;628401920;11696;188;12492;12707;9.22;0.57;247.49;14.62;796;81;4326.00;215
11699;81;628401938;11699;183;12495;12707;9.29;0.58;247.48;14.61;796;81;4327.00;212
11701;81;628401950;11701;182;12500;12708;9.36;0.58;247.55;14.61;799;81;4328.00;208
11704;81;628401961;11704;180;12506;12709;9.39;0.58;247.55;14.61;802;81;4329.00;203
11706;82;628401980;11706;170;12510;12709;9.37;0.58;247.56;14.61;804;82;4330.00;199
11708;83;628402005;11708;174;12512;12710;9.42;0.58;247.54;14.61;804;83;4331.00;198
11710;83;628402028;11710;171;12516;12710;9.48;0.59;247.52;14.61;806;83;4332.00;194
11711;83;628402040;11711;171;12520;12710;9.55;0.59;247.53;14.72;809;83;4333.00;190
11713;83;628402052;11713;170;12523;12710;9.60;0.59;247.52;14.72;810;83;4334.00;187
11714;84;628402070;11714;177;12526;12714;9.66;0.59;247.51;14.72;812;84;4335.00;188
11714;84;628402093;11714;175;12528;12714;9.66;0.59;247.51;14.72;814;84;4336.00;186
11714;84;628402104;11714;176;12530;12714;9.75;0.60;247.51;14.72;816;84;4337.00;184
11714;84;628402115;11714;176;12532;12717;9.87;0.61;247.51;14.72;818;84;4338.00;185
11714;84;628402127;11714;180;12533;12717;9.97;0.61;247.51;14.72;819;84;4339.00;184
11718;84;628402144;11718;185;12533;12717;10.07;0.62;247.49;14.72;815;84;4340.00;184
11718;84;628402162;11718;187;12538;12721;10.11;0.62;247.49;14.71;820;84;4341.00;183
11721;84;628402174;11721;192;12542;12722;10.19;0.62;247.46;14.71;821;84;4342.00;180
11722;84;628402185;11722;192;12543;12722;10.28;0.63;247.47;14.71;821;84;4343.00;179
11726;84;628402197;11726;194;12546;12726;10.30;0.63;247.45;14.71;820;84;4344.00;180
11727;85;628402214;11727;197;12547;12726;10.32;0.63;247.47;14.71;820;85;4345.00;179
11732;85;628402237;11732;198;12548;12726;10.32;0.63;247.50;14.71;816;85;4346.00;178
11734;85;628402252;11734;198;12549;12727;10.34;0.63;247.49;14.71;815;85;4347.00;178
11738;85;628402267;11738;199;12549;12727;10.31;0.63;247.44;14.71;811;85;4348.00;178
11740;85;628402279;11740;199;12552;12733;10.32;0.63;247.50;14.71;812;85;4349.00;181
11744;85;628402294;11744;196;12552;12733;10.30;0.63;247.48;14.71;808;85;4350.00;181
11747;85;628402314;11747;195;12554;12734;10.26;0.62;247.49;14.82;807;85;4351.00;180
11749;85;628402325;11749;192;12554;12734;10.29;0.63;247.48;14.82;805;85;4352.00;180
11752;85;628402336;11752;192;12554;12734;10.36;0.63;247.49;14.82;802;85;4353.00;180
11753;85;628402349;11753;184;12556;12734;10.34;0.63;247.50;14.84;803;85;4354.00;178
11757;85;628402363;11757;180;12557;12734;10.36;0.63;247.53;14.85;800;85;4355.00;177
11760;85;628402374;11760;177;12568;12746;10.43;0.63;247.54;14.96;808;85;4356.00;178
11762;85;628402387;11762;171;12568;12746;10.47;0.64;247.54;14.96;806;85;4357.00;178
11765;85;628402400;11765;165;12569;12746;10.54;0.64;247.54;14.96;804;85;4358.00;177
11768;85;628402412;11768;156;12569;12746;10.64;0.65;247.55;14.96;801;85;4359.00;177
11771;85;628402423;11771;153;12569;12746;10.78;0.66;247.54;14.96;798;85;4360.00;177
11773;85;628402436;11773;153;12570;12746;10.86;0.66;247.56;15.07;797;85;4361.00;176
11777;85;628402448;11777;149;12573;12750;10.92;0.66;247.56;15.07;796;85;4362.00;177
11779;85;628402461;11779;148;12573;12750;10.98;0.67;247.55;15.07;794;85;4363.00;177
11781;85;628402473;11781;151;12575;12754;11.04;0.67;247.61;15.07;794;85;4364.00;179
11784;85;628402492;11784;155;12579;12756;11.09;0.67;247.62;15.18;795;85;4365.00;177
11786;85;628402505;11786;157;12579;12756;11.09;0.67;247.64;15.18;793;85;4366.00;177
11788;85;628402517;11788;158;12579;12756;11.11;0.67;247.66;15.18;791;85;4367.00;177
11793;85;628402529;11793;161;12590;12769;11.01;0.67;247.72;15.29;797;85;4368.00;179
11793;85;628402543;11793;163;12590;12769;10.96;0.66;247.72;15.29;797;85;4369.00;179
11795;85;628402556;11795;164;12593;12769;10.93;0.66;247.77;15.41;798;85;4370.00;176
11799;85;628402568;11799;167;12594;12770;10.88;0.66;247.75;15.41;795;85;4371.00;176
11801;85;628402580;11801;165;12594;12771;10.83;0.66;247.75;15.41;793;85;4372.00;177
11805;85;628402593;11805;165;12596;12771;10.71;0.65;247.75;15.53;791;85;4373.00;175
11809;85;628402605;11809;162;12598;12774;10.69;0.65;247.80;15.53;789;85;4374.00;176
11811;85;628402618;11811;163;12599;12774;10.70;0.65;247.82;15.53;788;85;4375.00;175
11812;85;628402631;11812;169;12601;12774;10.70;0.65;247.82;15.54;789;85;4376.00;173
11816;85;628402643;11816;172;12603;12774;10.71;0.65;247.88;15.55;787;85;4377.00;171
11819;85;628402655;11819;179;12608;12780;10.69;0.65;247.88;15.54;789;85;4378.00;172
11824;85;628402669;11824;185;12608;12780;10.66;0.65;247.88;15.54;784;85;4379.00;172
11827;85;628402684;11827;185;12611;12780;10.63;0.65;247.86;15.57;784;85;4380.00;169
11830;85;628402696;11830;193;12612;12780;10.57;0.64;247.87;15.57;782;85;4381.00;168
11832;85;628402708;11832;203;12616;12784;10.52;0.64;247.85;15.58;784;85;4382.00;168
11833;85;628402725;11833;208;12618;12785;10.48;0.64;247.84;15.59;785;85;4383.00;167
11837;85;628402741;11837;214;12619;12785;10.44;0.63;247.82;15.59;782;85;4384.00;166
11838;85;628402754;11838;219;12621;12786;10.41;0.63;247.82;15.59;783;85;4385.00;165
11841;85;628402765;11841;226;12624;12786;10.25;0.62;247.79;15.62;783;85;4386.00;162
11843;85;628402778;11843;231;12626;12786;10.17;0.62;247.79;15.64;783;85;4387.00;160
11845;85;628402788;11845;234;12628;12786;10.06;0.61;247.77;15.65;783;85;4388.00;158
11849;85;628402799;11849;244;12629;12786;9.93;0.60;247.73;15.65;780;85;4389.00;157
11851;85;628402810;11851;247;12630;12786;9.88;0.60;247.74;15.67;779;85;4390.00;156
11853;85;628402820;11853;252;12633;12786;9.80;0.60;247.72;15.69;780;85;4391.00;153
11854;85;628402831;11854;257;12666;12856;9.80;0.60;247.71;15.65;812;85;4392.00;190
11858;85;628402848;11858;263;12670;12857;9.71;0.59;247.71;15.67;812;85;4393.00;187
11860;85;628402858;11860;268;12677;12857;9.63;0.59;247.72;15.67;817;85;4394.00;180
11864;85;628402869;11864;269;12685;12857;9.50;0.58;247.73;15.71;821;85;4395.00;172
11865;85;628402880;11865;278;12690;12857;9.39;0.57;247.73;15.71;825;85;4396.00;167
11868;85;628402891;11868;284;12695;12857;9.25;0.57;247.71;15.71;827;85;4397.00;162
11870;85;628402907;11870;281;12701;12857;9.17;0.56;247.69;15.73;831;85;4398.00;156
11873;85;628402917;11873;278;12701;12857;9.10;0.56;247.67;15.73;828;85;4399.00;156
11877;85;628402929;11877;271;12707;12858;9.05;0.55;247.63;15.76;830;85;4400.00;151
11880;85;628402944;11880;268;12709;12859;8.98;0.55;247.63;15.75;829;85;4401.00;150
11881;85;628402955;11881;265;12710;12859;8.94;0.55;247.62;15.75;829;85;4402.00;149
11887;85;628402966;11887;269;12715;12863;8.80;0.54;247.56;15.78;828;85;4403.00;148
11887;85;628402978;11887;269;12715;12863;8.71;0.53;247.56;15.78;828;85;4404.00;148
11890;85;628402988;11890;276;12717;12863;8.67;0.53;247.58;15.80;827;85;4405.00;146
11894;85;628402999;11894;277;12717;12863;8.63;0.53;247.59;15.80;823;85;4406.00;146
11896;85;628403010;11896;277;12721;12869;8.67;0.53;247.58;15.80;825;85;4407.00;148
11901;86;628403022;11901;284;12723;12869;8.60;0.53;247.59;15.83;822;86;4408.00;146
11903;86;628403050;11903;284;12724;12869;8.57;0.53;247.61;15.82;821;86;4409.00;145
11906;86;628403062;11906;293;12729;12875;8.53;0.52;247.62;15.82;823;86;4410.00;146
11906;86;628403074;11906;294;12731;12875;8.50;0.52;247.62;15.84;825;86;4411.00;144
11910;86;628403084;11910;289;12732;12875;8.41;0.52;247.69;15.84;822;86;4412.00;143
11914;86;628403095;11914;291;12734;12876;8.18;0.50;247.71;15.86;820;86;4413.00;142
11918;86;628403106;11918;288;12736;12877;8.05;0.50;247.71;15.87;818;86;4414.00;141
11922;86;628403117;11922;291;12736;12877;7.89;0.49;247.71;15.87;814;86;4415.00;141
11928;86;628403127;11928;297;12748;12890;7.74;0.48;247.74;15.87;820;86;4416.00;142
11932;86;628403139;11932;292;12748;12890;7.59;0.47;247.71;15.87;816;86;4417.00;142
11940;86;628403149;11940;290;12750;12890;7.37;0.45;247.77;15.89;810;86;4418.00;140
11944;86;628403159;11944;290;12751;12891;7.27;0.45;247.75;15.89;807;86;4419.00;140
11951;86;628403169;11951;276;12751;12891;7.12;0.44;247.75;15.89;800;86;4420.00;140
11954;86;628403179;11954;271;12757;12895;7.09;0.43;247.76;15.90;803;86;4421.00;138
11958;86;628403189;11958;272;12757;12895;7.09;0.43;247.76;15.90;799;86;4422.00;138
11964;86;628403199;11964;273;12761;12899;6.98;0.43;247.80;15.91;797;86;4423.00;138
11967;86;628403209;11967;278;12763;12899;6.93;0.42;247.85;15.92;796;86;4424.00;136
11970;86;628403219;11970;277;12763;12899;6.96;0.43;247.87;15.92;793;86;4425.00;136
11972;86;628403229;11972;280;12763;12899;7.00;0.43;247.87;15.92;791;86;4426.00;136
11980;86;628403238;11980;272;12765;12899;6.97;0.43;247.95;15.93;785;86;4427.00;134
11984;86;628403248;11984;272;12778;12911;7.13;0.44;247.96;15.92;794;86;4428.00;133
11987;86;628403259;11987;271;12781;12911;7.16;0.44;247.98;15.93;794;86;4429.00;130
11993;86;628403269;11993;270;12781;12911;7.14;0.44;248.00;15.93;788;86;4430.00;130
11996;86;628403279;11996;266;12781;12911;7.21;0.44;248.01;15.93;785;86;4431.00;130
12001;86;628403289;12001;268;12781;12911;7.23;0.44;248.00;15.93;780;86;4432.00;130
12002;86;628403298;12002;270;12781;12911;7.32;0.45;248.01;15.93;779;86;4433.00;130
12005;86;628403308;12005;261;12781;12912;7.36;0.45;248.01;15.93;776;86;4434.00;131
12009;86;628403318;12009;265;12781;12912;7.44;0.45;248.03;15.93;772;86;4435.00;131
12010;86;628403328;12010;265;12785;12918;7.61;0.46;248.03;15.93;775;86;4436.00;133
12016;86;628403339;12016;266;12787;12919;7.67;0.47;248.00;15.92;771;86;4437.00;132
12018;86;628403350;12018;270;12787;12919;7.72;0.47;247.98;15.92;769;86;4438.00;132
12021;86;628403360;12021;264;12787;12919;7.78;0.47;248.00;15.92;766;86;4439.00;132
12022;86;628403372;12022;263;12791;12924;7.86;0.48;248.01;15.92;769;86;4440.00;133
12024;86;628403383;12024;257;12791;12924;7.86;0.48;248.01;15.92;767;86;4441.00;133
12028;86;628403393;12028;256;12791;12924;7.85;0.48;248.01;15.92;763;86;4442.00;133
12030;86;628403403;12030;266;12792;12925;7.84;0.48;248.00;15.92;762;86;4443.00;133
12034;86;628403413;12034;266;12795;12929;7.80;0.48;247.98;15.92;761;86;4444.00;134
12035;86;628403424;12035;263;12795;12929;7.81;0.48;247.99;15.92;760;86;4445.00;134
12038;86;628403434;12038;259;12797;12932;7.83;0.48;248.00;15.91;759;86;4446.00;135
12041;86;628403444;12041;258;12797;12932;7.85;0.48;247.98;15.91;756;86;4447.00;135
12043;86;628403453;12043;259;12798;12932;7.86;0.48;247.97;15.91;755;86;4448.00;134
12048;86;628403463;12048;262;12798;12932;7.84;0.48;247.94;15.91;750;86;4449.00;134
12051;86;628403473;12051;267;12801;12936;7.87;0.48;247.93;15.91;750;86;4450.00;135
12057;86;628403484;12057;271;12801;12936;7.85;0.48;248.02;15.91;744;86;4451.00;135
12060;86;628403494;12060;274;12802;12936;7.90;0.48;247.99;15.91;742;86;4452.00;134
12062;86;628403503;12062;278;12802;12936;7.91;0.48;248.00;15.91;740;86;4453.00;134
12069;86;628403512;12069;287;12802;12937;7.85;0.48;248.00;15.91;733;86;4454.00;135
12073;86;628403522;12073;290;12805;12939;7.82;0.48;247.94;16.03;732;86;4455.00;134
12079;86;628403532;12079;294;12805;12939;7.75;0.47;247.98;16.03;726;86;4456.00;134
12084;86;628403542;12084;299;12806;12940;7.71;0.47;247.94;16.03;722;86;4457.00;134
12086;86;628403551;12086;306;12806;12940;7.65;0.47;247.95;16.03;720;86;4458.00;134
12090;86;628403560;12090;305;12806;12940;7.58;0.46;247.97;16.03;716;86;4459.00;134
12091;86;628403570;12091;306;12806;12940;7.58;0.46;247.96;16.03;715;86;4460.00;134
12097;86;628403578;12097;310;12806;12940;7.50;0.46;247.95;16.03;709;86;4461.00;134
12099;86;628403587;12099;312;12806;12940;7.42;0.45;247.98;16.03;707;86;4462.00;134
12104;86;628403596;12104;321;12806;12940;7.32;0.44;247.91;16.03;702;86;4463.00;134
12106;86;628403605;12106;340;12871;13067;7.59;0.47;247.94;15.94;765;86;4464.00;196
12107;86;628403623;12107;336;12875;13068;7.42;0.46;247.92;15.94;768;86;4465.00;193
12108;86;628403632;12108;339;12884;13068;7.41;0.46;247.92;15.93;776;86;4466.00;184
12111;86;628403641;12111;330;12885;13068;7.39;0.46;247.92;15.93;774;86;4467.00;183
12111;86;628403651;12111;322;12890;13068;7.53;0.47;247.92;15.92;779;86;4468.00;178
12112;86;628403661;12112;313;12895;13068;7.59;0.47;247.92;15.92;783;86;4469.00;173
12113;86;628403677;12113;313;12901;13068;7.58;0.47;247.92;15.92;788;86;4470.00;167
12115;86;628403692;12115;311;12905;13068;7.54;0.47;247.89;15.91;790;86;4471.00;163
12116;86;628403702;12116;312;12910;13069;7.47;0.46;247.90;15.91;794;86;4472.00;159
12118;86;628403725;12118;313;12913;13070;7.43;0.46;247.90;15.91;795;86;4473.00;157
12119;86;628403743;12119;322;12915;13070;7.42;0.46;247.89;15.91;796;86;4474.00;155
12121;86;628403761;12121;316;12917;13071;7.45;0.46;247.96;15.91;796;86;4475.00;154
12121;86;628403780;12121;295;12918;13071;7.51;0.46;247.96;15.91;797;86;4476.00;153
12123;86;628403797;12123;287;12919;13071;7.64;0.47;247.95;15.91;796;86;4477.00;152
12126;86;628403813;12126;273;12921;13071;7.82;0.48;247.97;15.91;795;86;4478.00;150
12126;86;628403831;12126;261;12924;13075;8.01;0.49;247.97;15.90;798;86;4479.00;151
12127;86;628403846;12127;254;12926;13075;8.18;0.50;247.97;15.90;799;86;4480.00;149
12128;86;628403860;12128;240;12926;13075;8.36;0.51;247.96;15.90;798;86;4481.00;149
12128;86;628403874;12128;229;12929;13078;8.56;0.53;247.96;15.90;801;86;4482.00;149
12130;86;628403887;12130;218;12929;13078;8.73;0.54;247.94;15.90;799;86;4483.00;149
12134;86;628403901;12134;217;12930;13078;8.92;0.55;247.91;15.90;796;86;4484.00;148
12134;86;628403927;12134;210;12933;13082;9.06;0.55;247.91;15.90;799;86;4485.00;149
12135;86;628403941;12135;202;12935;13083;9.22;0.56;247.90;15.90;800;86;4486.00;148
12137;86;628403954;12137;198;12935;13083;9.38;0.57;247.89;15.90;798;86;4487.00;148
12140;86;628403968;12140;186;12939;13087;9.56;0.58;247.89;15.89;799;86;4488.00;148
12141;86;628403981;12141;174;12939;13087;9.62;0.59;247.89;15.89;798;86;4489.00;148
12143;86;628403993;12143;172;12940;13087;9.76;0.59;247.89;15.89;797;86;4490.00;147
12144;86;628404005;12144;169;12941;13088;9.93;0.61;247.87;15.89;797;86;4491.00;147
12148;86;628404018;12148;161;12941;13088;10.01;0.61;247.87;15.89;793;86;4492.00;147
12150;86;628404032;12150;156;12945;13094;10.09;0.61;247.86;15.88;795;86;4493.00;149
12152;86;628404044;12152;158;12946;13094;10.17;0.62;247.85;16.01;794;86;4494.00;148
12154;86;628404057;12154;149;12947;13095;10.25;0.62;247.83;16.01;793;86;4495.00;148
12155;86;628404070;12155;150;12947;13095;10.31;0.63;247.84;16.01;792;86;4496.00;148
12158;86;628404082;12158;146;12947;13095;10.43;0.63;247.81;16.01;789;86;4497.00;148
12160;87;628404095;12160;143;12947;13095;10.54;0.64;247.81;16.01;787;87;4498.00;148
12164;87;628404115;12164;138;12947;13095;10.55;0.64;247.89;16.01;783;87;4499.00;148
12170;88;628404135;12170;140;12969;13145;10.59;0.64;247.90;15.98;799;88;4500.00;176
12170;88;628404176;12170;137;12970;13147;10.67;0.65;247.90;15.98;800;88;4501.00;177
12171;88;628404197;12171;137;12973;13147;10.81;0.66;247.88;15.98;802;88;4502.00;174
12173;88;628404216;12173;136;12973;13147;10.83;0.66;247.90;15.98;800;88;4503.00;174
12175;88;628404228;12175;138;12976;13147;10.90;0.66;247.92;15.97;801;88;4504.00;171
12177;88;628404239;12177;130;12976;13147;10.94;0.66;247.93;15.97;799;88;4505.00;171
12180;88;628404252;12180;133;12980;13151;11.00;0.67;247.95;15.97;800;88;4506.00;171
12181;88;628404272;12181;139;12981;13151;11.13;0.67;247.95;15.97;800;88;4507.00;170
12184;88;628404284;12184;135;12984;13155;11.18;0.68;247.94;15.96;800;88;4508.00;171
12188;88;628404296;12188;132;12985;13156;11.21;0.68;247.97;15.96;797;88;4509.00;171
12190;88;628404308;12190;135;12987;13156;11.25;0.68;247.99;15.96;797;88;4510.00;169
12194;88;628404321;12194;135;12987;13156;11.27;0.68;248.00;15.96;793;88;4511.00;169
12195;88;628404333;12195;137;12994;13169;11.27;0.68;248.03;15.95;799;88;4512.00;175
12196;88;628404351;12196;142;12994;13169;11.25;0.68;248.04;15.95;798;88;4513.00;175
12200;88;628404362;12200;143;12994;13169;11.26;0.68;248.05;15.95;794;88;4514.00;175
12204;88;628404374;12204;143;12995;13170;11.36;0.69;248.09;15.95;791;88;4515.00;175
12206;88;628404386;12206;149;12997;13171;11.40;0.69;248.10;15.95;791;88;4516.00;174
12213;88;628404397;12213;148;12997;13171;11.37;0.69;248.13;15.95;784;88;4517.00;174
12215;88;628404409;12215;153;12999;13174;11.43;0.70;248.11;15.95;784;88;4518.00;175
12218;88;628404421;12218;150;12999;13174;11.46;0.70;248.13;15.95;781;88;4519.00;175
12222;88;628404432;12222;145;13000;13174;11.45;0.70;248.12;16.08;778;88;4520.00;174
12226;88;628404445;12226;142;13000;13174;11.52;0.70;248.10;16.08;774;88;4521.00;174
12229;88;628404456;12229;134;13005;13180;11.59;0.71;248.11;16.07;776;88;4522.00;175
12235;88;628404469;12235;122;13005;13180;11.67;0.71;248.20;16.07;770;88;4523.00;175
12240;88;628404481;12240;119;13005;13180;11.71;0.71;248.23;16.07;765;88;4524.00;175
12245;88;628404494;12245;115;13007;13180;11.72;0.71;248.25;16.10;762;88;4525.00;173
12249;88;628404508;12249;109;13010;13184;11.72;0.71;248.24;16.10;761;88;4526.00;174
12253;88;628404526;12253;113;13013;13185;11.76;0.72;248.24;16.10;760;88;4527.00;172
12258;88;628404542;12258;109;13013;13185;11.78;0.72;248.24;16.10;755;88;4528.00;172
12260;88;628404555;12260;111;13014;13186;11.80;0.72;248.22;16.10;754;88;4529.00;172
12265;88;628404577;12265;104;13014;13186;11.87;0.72;248.23;16.10;749;88;4530.00;172
12267;88;628404590;12267;105;13014;13186;11.95;0.73;248.22;16.10;747;88;4531.00;172
12270;88;628404604;12270;108;13015;13186;11.96;0.73;248.23;16.10;745;88;4532.00;171
12274;88;628404617;12274;108;13016;13186;12.04;0.73;248.24;16.10;742;88;4533.00;170
12275;88;628404629;12275;108;13016;13186;12.17;0.74;248.22;16.10;741;88;4534.00;170
12279;88;628404642;12279;116;13017;13186;12.19;0.74;248.27;16.10;738;88;4535.00;169
12282;88;628404654;12282;121;13054;13256;12.07;0.74;248.29;16.06;772;88;4536.00;202
12288;88;628404672;12288;116;13057;13257;12.03;0.73;248.33;16.05;769;88;4537.00;200
12294;88;628404685;12294;119;13063;13257;12.03;0.73;248.35;16.05;769;88;4538.00;194
12300;88;628404698;12300;125;13065;13257;12.04;0.73;248.32;16.05;765;88;4539.00;192
12303;88;628404711;12303;125;13068;13257;12.00;0.73;248.35;16.05;765;88;4540.00;189
12308;88;628404726;12308;128;13077;13257;11.89;0.72;248.36;16.17;769;88;4541.00;180
12309;88;628404739;12309;139;13079;13257;11.91;0.72;248.37;16.17;770;88;4542.00;178
12314;88;628404754;12314;141;13082;13257;11.93;0.73;248.39;16.16;768;88;4543.00;175
12317;88;628404767;12317;146;13083;13258;11.92;0.73;248.42;16.17;766;88;4544.00;175
12320;88;628404780;12320;142;13089;13260;11.91;0.72;248.40;16.17;769;88;4545.00;171
12324;88;628404798;12324;140;13090;13260;11.80;0.72;248.41;16.17;766;88;4546.00;170
12326;88;628404811;12326;142;13095;13264;11.70;0.71;248.42;16.16;769;88;4547.00;169
12330;88;628404824;12330;145;13096;13264;11.55;0.70;248.41;16.16;766;88;4548.00;168
12332;88;628404836;12332;149;13097;13264;11.45;0.70;248.40;16.16;765;88;4549.00;167
12335;88;628404848;12335;156;13099;13264;11.31;0.69;248.42;16.20;764;88;4550.00;165
12337;88;628404860;12337;162;13103;13270;11.23;0.68;248.43;16.19;766;88;4551.00;167
12342;88;628404873;12342;173;13103;13270;11.12;0.68;248.41;16.19;761;88;4552.00;167
12344;88;628404885;12344;177;13106;13270;10.97;0.67;248.39;16.22;762;88;4553.00;164
12346;88;628404896;12346;186;13108;13273;10.97;0.67;248.37;16.22;762;88;4554.00;165
12349;88;628404909;12349;189;13110;13273;10.90;0.66;248.35;16.23;761;88;4555.00;163
12352;88;628404920;12352;199;13111;13273;10.79;0.66;248.36;16.23;759;88;4556.00;162
12354;88;628404933;12354;200;13114;13274;10.64;0.65;248.35;16.26;760;88;4557.00;160
12357;88;628404945;12357;212;13115;13275;10.58;0.64;248.34;16.26;758;88;4558.00;160
12360;88;628404956;12360;218;13118;13275;10.49;0.64;248.35;16.29;758;88;4559.00;157
12362;88;628404970;12362;232;13136;13301;10.34;0.63;248.40;16.28;774;88;4560.00;165
12365;88;628404984;12365;232;13139;13301;10.27;0.63;248.37;16.29;774;88;4561.00;162
12371;88;628404996;12371;240;13143;13301;10.18;0.62;248.34;16.30;772;88;4562.00;158
12374;88;628405007;12374;247;13145;13302;10.15;0.62;248.32;16.31;771;88;4563.00;157
12377;88;628405019;12377;254;13147;13302;10.08;0.61;248.34;16.32;770;88;4564.00;155
12379;88;628405029;12379;257;13150;13306;9.97;0.61;248.34;16.33;771;88;4565.00;156
12383;88;628405040;12383;255;13153;13306;9.85;0.60;248.35;16.34;770;88;4566.00;153
12386;88;628405057;12386;264;13158;13310;9.64;0.59;248.33;16.35;772;88;4567.00;152
12391;88;628405068;12391;268;13158;13310;9.47;0.58;248.30;16.35;767;88;4568.00;152
12393;88;628405078;12393;270;13160;13310;9.29;0.57;248.32;16.37;767;88;4569.00;150
12398;88;628405088;12398;264;13160;13310;9.17;0.56;248.30;16.37;762;88;4570.00;150
12402;88;628405099;12402;265;13161;13310;9.07;0.56;248.31;16.38;759;88;4571.00;149
12405;88;628405109;12405;268;13171;13322;9.05;0.55;248.30;16.38;766;88;4572.00;151
12407;88;628405120;12407;267;13173;13322;8.95;0.55;248.32;16.40;766;88;4573.00;149
12409;88;628405130;12409;266;13176;13322;8.91;0.55;248.32;16.41;767;88;4574.00;146
12412;88;628405140;12412;268;13177;13322;8.80;0.54;248.30;16.41;765;88;4575.00;145
12414;88;628405150;12414;272;13177;13322;8.68;0.53;248.29;16.41;763;88;4576.00;145
12419;88;628405159;12419;273;13179;13322;8.59;0.53;248.27;16.42;760;88;4577.00;143
12420;88;628405169;12420;271;13180;13323;8.51;0.52;248.26;16.43;760;88;4578.00;143
12423;88;628405178;12423;272;13181;13323;8.41;0.52;248.26;16.44;758;88;4579.00;142
12423;88;628405194;12423;275;13185;13329;8.39;0.52;248.26;16.43;762;88;4580.00;144
12426;88;628405204;12426;280;13186;13330;8.32;0.51;248.26;16.43;760;88;4581.00;144
12428;88;628405214;12428;281;13189;13330;8.24;0.51;248.25;16.45;761;88;4582.00;141
12431;88;628405224;12431;290;13189;13330;8.11;0.50;248.23;16.45;758;88;4583.00;141
12434;88;628405233;12434;288;13192;13334;8.04;0.49;248.21;16.45;758;88;4584.00;142
12438;88;628405242;12438;296;13194;13334;7.87;0.48;248.24;16.47;756;88;4585.00;140
12440;88;628405252;12440;304;13194;13334;7.66;0.47;248.24;16.47;754;88;4586.00;140
12444;88;628405261;12444;303;13197;13335;7.45;0.46;248.25;16.49;753;88;4587.00;138
12448;88;628405271;12448;312;13200;13339;7.22;0.44;248.25;16.48;752;88;4588.00;139
12450;88;628405281;12450;318;13200;13339;6.98;0.43;248.25;16.48;750;88;4589.00;139
12452;88;628405291;12452;317;13205;13345;6.84;0.42;248.26;16.50;753;88;4590.00;140
12455;88;628405301;12455;317;13205;13345;6.73;0.41;248.25;16.50;750;88;4591.00;140
12459;88;628405310;12459;321;13208;13345;6.71;0.41;248.31;16.51;749;88;4592.00;137
12463;88;628405318;12463;322;13208;13345;6.70;0.41;248.31;16.51;745;88;4593.00;137
12467;88;628405327;12467;318;13211;13349;6.76;0.41;248.29;16.51;744;88;4594.00;138
12470;88;628405335;12470;313;13213;13349;6.80;0.41;248.32;16.53;743;88;4595.00;136
12474;88;628405344;12474;307;13214;13349;6.75;0.41;248.33;16.52;740;88;4596.00;135
12476;88;628405353;12476;303;13215;13349;6.74;0.41;248.31;16.53;739;88;4597.00;134
12480;88;628405361;12480;297;13217;13350;6.72;0.41;248.31;16.54;737;88;4598.00;133
12485;88;628405371;12485;293;13218;13351;6.76;0.41;248.31;16.54;733;88;4599.00;133
12489;88;628405381;12489;291;13219;13351;6.75;0.41;248.30;16.53;730;88;4600.00;132
12490;88;628405395;12490;292;13220;13352;6.80;0.41;248.31;16.53;730;88;4601.00;132
12494;88;628405404;12494;294;13220;13352;6.83;0.42;248.30;16.53;726;88;4602.00;132
12496;88;628405412;12496;294;13220;13352;6.85;0.42;248.27;16.53;724;88;4603.00;132
12500;88;628405421;12500;300;13220;13352;6.86;0.42;248.26;16.53;720;88;4604.00;132
12504;88;628405430;12504;299;13220;13352;6.85;0.42;248.27;16.53;716;88;4605.00;132
12506;88;628405439;12506;301;13220;13352;6.94;0.42;248.26;16.53;714;88;4606.00;132
12510;88;628405448;12510;305;13220;13352;6.91;0.42;248.25;16.53;710;88;4607.00;132
12514;88;628405456;12514;308;13288;13479;7.39;0.46;248.25;16.45;774;88;4608.00;191
12515;88;628405476;12515;306;13291;13480;7.37;0.46;248.24;16.45;776;88;4609.00;189
12518;88;628405485;12518;303;13301;13480;7.46;0.46;248.24;16.43;783;88;4610.00;179
12520;88;628405496;12520;301;13303;13480;7.42;0.46;248.23;16.43;783;88;4611.00;177
12525;88;628405506;12525;300;13310;13480;7.44;0.46;248.20;16.43;785;88;4612.00;170
12528;88;628405523;12528;301;13313;13480;7.41;0.46;248.21;16.42;785;88;4613.00;167
12530;88;628405538;12530;306;13319;13480;7.42;0.46;248.18;16.42;789;88;4614.00;161
12534;88;628405548;12534;308;13323;13480;7.32;0.45;248.25;16.42;789;88;4615.00;157
12538;88;628405558;12538;314;13327;13481;7.30;0.45;248.30;16.41;789;88;4616.00;154
12542;88;628405568;12542;314;13328;13482;7.24;0.45;248.30;16.41;786;88;4617.00;154
12545;88;628405579;12545;316;13329;13482;7.25;0.45;248.30;16.41;784;88;4618.00;153
12549;88;628405589;12549;312;13330;13483;7.19;0.44;248.33;16.41;781;88;4619.00;153
12550;88;628405602;12550;321;13332;13483;7.20;0.44;248.34;16.41;782;88;4620.00;151
12553;88;628405613;12553;321;13333;13483;7.15;0.44;248.32;16.41;780;88;4621.00;150
12555;88;628405622;12555;321;13334;13483;7.09;0.44;248.32;16.41;779;88;4622.00;149
12558;88;628405633;12558;317;13337;13487;6.97;0.43;248.32;16.41;779;88;4623.00;150
12559;88;628405644;12559;325;13338;13487;6.92;0.43;248.30;16.41;779;88;4624.00;149
12562;88;628405654;12562;327;13340;13487;6.82;0.42;248.30;16.41;778;88;4625.00;147
12563;88;628405664;12563;332;13342;13490;6.79;0.42;248.32;16.41;779;88;4626.00;148
12566;88;628405675;12566;315;13343;13490;6.81;0.42;248.30;16.41;777;88;4627.00;147
12568;88;628405685;12568;309;13344;13490;6.91;0.43;248.31;16.41;776;88;4628.00;146
12570;88;628405697;12570;300;13348;13494;7.08;0.44;248.30;16.40;778;88;4629.00;146
12573;88;628405708;12573;294;13349;13495;7.17;0.44;248.28;16.40;776;88;4630.00;146
12576;88;628405719;12576;294;13350;13495;7.23;0.45;248.27;16.40;774;88;4631.00;145
12577;88;628405735;12577;294;13353;13499;7.38;0.45;248.27;16.40;776;88;4632.00;146
12580;88;628405749;12580;292;13354;13499;7.46;0.46;248.27;16.40;774;88;4633.00;145
12583;88;628405788;12583;288;13354;13499;7.56;0.47;248.26;16.40;771;88;4634.00;145
12586;88;628405813;12586;291;13356;13501;7.70;0.47;248.26;16.39;770;88;4635.00;145
12589;88;628405831;12589;292;13356;13501;7.76;0.48;248.24;16.39;767;88;4636.00;145
12594;88;628405846;12594;282;13360;13507;7.81;0.48;248.29;16.39;766;88;4637.00;147
12596;88;628405859;12596;269;13361;13507;7.91;0.49;248.30;16.39;765;88;4638.00;146
12599;88;628405870;12599;259;13361;13508;7.98;0.49;248.31;16.39;762;88;4639.00;147
12602;88;628405882;12602;247;13361;13508;8.04;0.49;248.32;16.39;759;88;4640.00;147
12605;88;628405894;12605;246;13361;13508;8.18;0.50;248.31;16.39;756;88;4641.00;147
12609;88;628405912;12609;240;13361;13508;8.30;0.51;248.35;16.39;752;88;4642.00;147
12613;88;628405924;12613;235;13361;13508;8.39;0.51;248.37;16.39;748;88;4643.00;147
12616;88;628405936;12616;225;13371;13520;8.63;0.53;248.37;16.37;755;88;4644.00;149
12618;88;628405949;12618;218;13372;13520;8.84;0.54;248.38;16.37;754;88;4645.00;148
12624;88;628405960;12624;207;13372;13520;8.98;0.55;248.37;16.37;748;88;4646.00;148
12625;88;628405979;12625;198;13372;13520;9.17;0.56;248.37;16.37;747;88;4647.00;148
12628;88;628405991;12628;180;13372;13520;9.34;0.57;248.36;16.37;744;88;4648.00;148
12628;89;628406002;12628;174;13372;13520;9.53;0.58;248.36;16.37;744;89;4649.00;148
12630;89;628406028;12630;170;13377;13526;9.61;0.58;248.36;16.37;747;89;4650.00;149
12630;89;628406041;12630;164;13377;13526;9.81;0.60;248.36;16.37;747;89;4651.00;149
12634;89;628406054;12634;151;13380;13530;9.88;0.60;248.39;16.36;746;89;4652.00;150
12637;89;628406068;12637;151;13382;13531;10.01;0.61;248.43;16.36;745;89;4653.00;149
12638;89;628406081;12638;146;13382;13531;10.09;0.61;248.45;16.36;744;89;4654.00;149
12643;89;628406096;12643;142;13382;13531;10.19;0.62;248.47;16.36;739;89;4655.00;149
12645;89;628406108;12645;140;13393;13544;10.39;0.63;248.47;16.35;748;89;4656.00;151
12648;89;628406121;12648;143;13393;13544;10.51;0.64;248.50;16.35;745;89;4657.00;151
12653;89;628406133;12653;143;13393;13544;10.69;0.65;248.50;16.35;740;89;4658.00;151
12656;89;628406145;12656;139;13394;13545;10.83;0.66;248.52;16.35;738;89;4659.00;151
12660;89;628406158;12660;135;13394;13546;10.90;0.66;248.54;16.35;734;89;4660.00;152
12664;89;628406171;12664;132;13394;13546;11.06;0.67;248.54;16.35;730;89;4661.00;152
12665;89;628406182;12665;129;13396;13549;11.22;0.68;248.56;16.34;731;89;4662.00;153
12671;89;628406194;12671;126;13397;13549;11.36;0.69;248.60;16.34;726;89;4663.00;152
12675;89;628406212;12675;125;13397;13549;11.44;0.69;248.61;16.34;722;89;4664.00;152
12680;89;628406224;12680;120;13397;13549;11.43;0.69;248.62;16.34;717;89;4665.00;152
12681;89;628406237;12681;126;13401;13555;11.45;0.69;248.62;16.34;720;89;4666.00;154
12684;89;628406249;12684;126;13401;13555;11.48;0.69;248.63;16.34;717;89;4667.00;154
12687;89;628406261;12687;120;13402;13555;11.57;0.70;248.65;16.34;715;89;4668.00;153
12690;89;628406274;12690;120;13402;13555;11.63;0.70;248.64;16.34;712;89;4669.00;153
12692;89;628406285;12692;123;13405;13559;11.68;0.71;248.65;16.33;713;89;4670.00;154
12693;89;628406297;12693;120;13406;13560;11.84;0.72;248.64;16.33;713;89;4671.00;154
12697;89;628406309;12697;120;13406;13560;11.89;0.72;248.70;16.33;709;89;4672.00;154
12699;90;628406321;12699;118;13407;13561;12.02;0.73;248.67;16.33;708;90;4673.00;154
12702;90;628406340;12702;121;13407;13561;12.07;0.73;248.71;16.33;705;90;4674.00;154
12703;90;628406352;12703;121;13407;13561;12.15;0.74;248.75;16.33;704;90;4675.00;154
12706;90;628406364;12706;121;13407;13561;12.23;0.74;248.76;16.33;701;90;4676.00;154
12708;90;628406375;12708;123;13407;13561;12.34;0.75;248.77;16.33;699;90;4677.00;154
12709;90;628406387;12709;122;13407;13561;12.39;0.75;248.76;16.33;698;90;4678.00;154
12711;90;628406398;12711;120;13407;13561;12.44;0.76;248.78;16.33;696;90;4679.00;154
12715;90;628406413;12715;146;13469;13686;11.93;0.73;248.79;16.26;754;90;4680.00;217
12716;90;628406433;12716;133;13469;13687;12.00;0.74;248.79;16.26;753;90;4681.00;218
12719;90;628406451;12719;124;13475;13687;12.11;0.74;248.83;16.25;756;90;4682.00;212
12722;90;628406463;12722;122;13478;13687;12.21;0.75;248.83;16.25;756;90;4683.00;209
12726;90;628406482;12726;115;13482;13687;12.31;0.75;248.85;16.24;756;90;4684.00;205
12730;90;628406500;12730;115;13484;13687;12.38;0.76;248.84;16.24;754;90;4685.00;203
12735;90;628406518;12735;120;13487;13687;12.36;0.76;248.89;16.24;752;90;4686.00;200
12738;90;628406530;12738;129;13488;13687;12.38;0.76;248.89;16.24;750;90;4687.00;199
12742;90;628406547;12742;133;13494;13688;12.31;0.75;248.90;16.24;752;90;4688.00;194
12745;91;628406558;12745;132;13496;13689;12.26;0.75;248.90;16.23;751;91;4689.00;193
12749;91;628406580;12749;137;13501;13689;12.27;0.75;248.95;16.23;752;91;4690.00;188
12755;91;628406592;12755;135;13508;13693;12.17;0.74;248.95;16.23;753;91;4691.00;185
12758;91;628406610;12758;135;13511;13693;12.10;0.74;248.94;16.23;753;91;4692.00;182
12761;91;628406622;12761;134;13511;13693;12.04;0.73;248.94;16.23;750;91;4693.00;182
12764;91;628406633;12764;137;13511;13693;12.00;0.73;248.96;16.23;747;91;4694.00;182
12769;91;628406645;12769;141;13516;13699;11.94;0.73;248.99;16.25;747;91;4695.00;183
12769;91;628406658;12769;137;13516;13699;11.93;0.73;248.99;16.25;747;91;4696.00;183
12773;91;628406670;12773;134;13518;13699;11.93;0.73;249.01;16.25;745;91;4697.00;181
12779;91;628406682;12779;131;13520;13702;11.94;0.73;249.02;16.25;741;91;4698.00;182
12781;91;628406693;12781;132;13521;13702;12.00;0.73;249.03;16.25;740;91;4699.00;181
12785;91;628406705;12785;132;13522;13702;12.07;0.73;249.02;16.24;737;91;4700.00;180
12787;91;628406721;12787;128;13522;13703;12.13;0.74;249.03;16.24;735;91;4701.00;181
12792;91;628406736;12792;125;13524;13704;12.13;0.74;249.00;16.37;732;91;4702.00;180
12793;91;628406758;12793;123;13524;13704;12.11;0.74;249.00;16.37;731;91;4703.00;180
12797;91;628406769;12797;124;13533;13717;12.10;0.74;248.99;16.36;736;91;4704.00;184
12802;91;628406782;12802;122;13533;13717;12.08;0.73;248.94;16.36;731;91;4705.00;184
12804;91;628406794;12804;127;13533;13717;12.14;0.74;248.96;16.36;729;91;4706.00;184
12806;91;628406807;12806;123;13535;13718;12.10;0.74;248.99;16.36;729;91;4707.00;183
12808;91;628406819;12808;128;13536;13718;12.12;0.74;248.98;16.36;728;91;4708.00;182
12810;91;628406830;12810;129;13538;13722;12.12;0.74;249.00;16.35;728;91;4709.00;184
12815;91;628406845;12815;130;13540;13722;12.03;0.73;249.01;16.35;725;91;4710.00;182
12816;91;628406856;12816;136;13544;13726;11.91;0.72;249.03;16.35;728;91;4711.00;182
12819;91;628406872;12819;137;13545;13726;11.93;0.72;249.04;16.35;726;91;4712.00;181
12822;91;628406884;12822;143;13545;13726;11.86;0.72;249.11;16.35;723;91;4713.00;181
12825;91;628406895;12825;149;13546;13726;11.81;0.72;249.12;16.35;721;91;4714.00;180
12826;91;628406906;12826;149;13546;13726;11.79;0.72;249.11;16.35;720;91;4715.00;180
12829;91;628406917;12829;152;13556;13738;11.72;0.71;249.11;16.34;727;91;4716.00;182
12833;91;628406934;12833;158;13557;13738;11.62;0.71;249.08;16.34;724;91;4717.00;181
12836;91;628406945;12836;166;13559;13738;11.54;0.70;249.09;16.34;723;91;4718.00;179
12841;91;628406956;12841;173;13559;13738;11.43;0.70;249.07;16.34;718;91;4719.00;179
12843;91;628406968;12843;174;13560;13738;11.35;0.69;249.05;16.35;717;91;4720.00;178
12844;91;628406979;12844;176;13560;13738;11.30;0.69;249.04;16.35;716;91;4721.00;178
12846;91;628406989;12846;177;13561;13739;11.23;0.68;249.04;16.37;715;91;4722.00;178
12846;91;628406999;12846;182;13563;13739;11.12;0.68;249.04;16.40;717;91;4723.00;176
12849;91;628407010;12849;188;13567;13745;11.02;0.67;249.01;16.39;718;91;4724.00;178
12853;91;628407021;12853;186;13571;13747;10.90;0.66;249.05;16.40;718;91;4725.00;176
12855;91;628407031;12855;195;13572;13747;10.76;0.66;249.03;16.42;717;91;4726.00;175
12858;91;628407042;12858;195;13573;13747;10.58;0.64;249.02;16.43;715;91;4727.00;174
12862;91;628407052;12862;208;13577;13751;10.52;0.64;249.00;16.44;715;91;4728.00;174
12863;91;628407063;12863;213;13577;13751;10.48;0.64;248.99;16.44;714;91;4729.00;174
12865;91;628407072;12865;212;13579;13751;10.36;0.63;248.98;16.46;714;91;4730.00;172
12867;91;628407087;12867;222;13580;13752;10.28;0.63;249.00;16.46;713;91;4731.00;172
12870;91;628407102;12870;230;13586;13756;10.18;0.62;249.01;16.50;716;91;4732.00;170
12875;91;628407112;12875;232;13587;13756;10.10;0.62;249.03;16.51;712;91;4733.00;169
12875;91;628407121;12875;242;13589;13759;10.04;0.61;249.03;16.51;714;91;4734.00;170
12877;91;628407131;12877;245;13590;13759;9.86;0.60;249.06;16.51;713;91;4735.00;169
12880;91;628407145;12880;252;13593;13759;9.75;0.60;249.06;16.53;713;91;4736.00;166
12880;91;628407154;12880;253;13593;13759;9.57;0.59;249.06;16.53;713;91;4737.00;166
12883;91;628407163;12883;256;13598;13763;9.42;0.58;249.06;16.55;715;91;4738.00;165
12885;91;628407172;12885;257;13598;13763;9.33;0.58;249.06;16.55;713;91;4739.00;165
12890;91;628407184;12890;258;13601;13763;9.19;0.57;249.08;16.57;711;91;4740.00;162
12893;91;628407193;12893;255;13601;13763;9.09;0.56;249.05;16.57;708;91;4741.00;162
12897;91;628407202;12897;256;13603;13764;8.92;0.55;249.03;16.59;706;91;4742.00;161
12897;91;628407210;12897;255;13604;13765;8.91;0.55;249.03;16.58;707;91;4743.00;161
12898;91;628407218;12898;259;13605;13765;8.77;0.54;249.01;16.59;707;91;4744.00;160
12900;91;628407227;12900;263;13609;13766;8.71;0.54;249.03;16.61;709;91;4745.00;157
12903;91;628407235;12903;264;13609;13766;8.61;0.53;249.06;16.61;706;91;4746.00;157
12906;91;628407243;12906;266;13610;13766;8.49;0.52;249.08;16.62;704;91;4747.00;156
12911;91;628407252;12911;271;13611;13766;8.36;0.52;249.01;16.63;700;91;4748.00;155
12915;91;628407260;12915;276;13611;13766;8.26;0.51;248.98;16.63;696;91;4749.00;155
12920;91;628407269;12920;281;13613;13766;8.12;0.50;248.96;16.64;693;91;4750.00;153
12923;91;628407277;12923;278;13613;13766;8.00;0.49;248.98;16.64;690;91;4751.00;153
12926;91;628407285;12926;304;13678;13893;8.13;0.51;248.98;16.58;752;91;4752.00;215
12930;91;628407302;12930;297;13682;13894;8.08;0.50;248.93;16.58;752;91;4753.00;212
12932;91;628407311;12932;300;13692;13894;8.06;0.50;248.93;16.58;760;91;4754.00;202
12937;91;628407319;12937;302;13695;13894;7.94;0.50;248.91;16.58;758;91;4755.00;199
12938;91;628407327;12938;299;13703;13894;7.87;0.49;248.90;16.58;765;91;4756.00;191
12942;91;628407335;12942;293;13706;13894;7.76;0.48;248.90;16.58;764;91;4757.00;188
12944;91;628407343;12944;292;13711;13894;7.66;0.48;248.87;16.58;767;91;4758.00;183
12948;91;628407351;12948;295;13716;13894;7.50;0.47;248.93;16.58;768;91;4759.00;178
12953;91;628407360;12953;291;13722;13895;7.39;0.46;248.91;16.59;769;91;4760.00;173
12955;91;628407368;12955;292;13724;13896;7.30;0.45;248.89;16.59;769;91;4761.00;172
12960;91;628407377;12960;297;13729;13896;7.22;0.45;248.88;16.58;769;91;4762.00;167
12963;91;628407385;12963;299;13733;13897;7.13;0.44;248.89;16.59;770;91;4763.00;164
12964;91;628407394;12964;306;13736;13897;7.07;0.44;248.88;16.59;772;91;4764.00;161
12968;91;628407409;12968;308;13737;13897;6.96;0.43;248.88;16.59;769;91;4765.00;160
12972;91;628407418;12972;308;13740;13897;6.91;0.43;248.86;16.60;768;91;4766.00;157
12973;91;628407426;12973;308;13742;13901;6.93;0.43;248.88;16.60;769;91;4767.00;159
12978;91;628407435;12978;306;13745;13901;6.88;0.43;248.85;16.60;767;91;4768.00;156
12979;91;628407444;12979;308;13745;13901;6.86;0.42;248.87;16.60;766;91;4769.00;156
12983;91;628407455;12983;307;13749;13907;6.90;0.43;248.87;16.59;766;91;4770.00;158
12984;91;628407464;12984;307;13750;13907;6.90;0.42;248.86;16.59;766;91;4771.00;157
12987;91;628407474;12987;306;13752;13907;6.83;0.42;248.88;16.72;765;91;4772.00;155
12989;91;628407485;12989;304;13755;13911;6.80;0.42;248.89;16.71;766;91;4773.00;156
12990;91;628407495;12990;307;13757;13912;6.79;0.42;248.88;16.71;767;91;4774.00;155
12996;91;628407503;12996;306;13757;13912;6.71;0.41;248.86;16.71;761;91;4775.00;155
13001;91;628407513;13001;314;13761;13916;6.69;0.41;248.84;16.71;760;91;4776.00;155
13003;91;628407522;13003;316;13761;13916;6.69;0.41;248.84;16.71;758;91;4777.00;155
13007;91;628407532;13007;318;13762;13916;6.73;0.41;248.85;16.71;755;91;4778.00;154
13011;91;628407540;13011;306;13763;13917;6.77;0.41;248.84;16.71;752;91;4779.00;154
13011;91;628407550;13011;299;13763;13917;6.88;0.42;248.84;16.71;752;91;4780.00;154
13017;91;628407559;13017;286;13767;13923;6.90;0.42;248.80;16.70;750;91;4781.00;156
13021;91;628407569;13021;279;13767;13923;6.96;0.43;248.78;16.70;746;91;4782.00;156
13022;91;628407579;13022;270;13768;13924;7.12;0.43;248.78;16.70;746;91;4783.00;156
13025;91;628407589;13025;263;13768;13924;7.20;0.44;248.75;16.70;743;91;4784.00;156
13027;91;628407599;13027;263;13768;13924;7.30;0.45;248.74;16.70;741;91;4785.00;156
13029;91;628407609;13029;265;13768;13924;7.52;0.46;248.74;16.70;739;91;4786.00;156
13032;92;628407619;13032;260;13768;13924;7.63;0.46;248.80;16.70;736;92;4787.00;156
13034;92;628407640;13034;265;13778;13936;7.84;0.48;248.81;16.69;744;92;4788.00;158
13039;92;628407651;13039;265;13778;13936;7.87;0.48;248.81;16.69;739;92;4789.00;158
13040;92;628407661;13040;261;13779;13936;7.99;0.49;248.82;16.69;739;92;4790.00;157
13045;92;628407672;13045;253;13779;13936;8.01;0.49;248.81;16.69;734;92;4791.00;157
13046;92;628407682;13046;254;13779;13936;8.07;0.49;248.82;16.69;733;92;4792.00;157
13051;92;628407692;13051;251;13779;13936;8.13;0.49;248.80;16.69;728;92;4793.00;157
13053;92;628407703;13053;249;13782;13940;8.26;0.50;248.81;16.68;729;92;4794.00;158
13055;92;628407713;13055;250;13782;13940;8.29;0.50;248.82;16.68;727;92;4795.00;158
13058;92;628407723;13058;257;13785;13944;8.32;0.50;248.84;16.68;727;92;4796.00;159
13059;92;628407738;13059;258;13786;13945;8.34;0.50;248.84;16.68;727;92;4797.00;159
13062;92;628407756;13062;260;13787;13945;8.31;0.50;248.87;16.68;725;92;4798.00;158
13063;92;628407775;13063;260;13787;13945;8.30;0.50;248.87;16.68;724;92;4799.00;158
13065;92;628407797;13065;262;13809;13986;8.44;0.51;248.88;16.65;744;92;4800.00;177
13068;92;628407828;13068;258;13809;13986;8.34;0.51;248.91;16.65;741;92;4801.00;177
13071;92;628407845;13071;257;13813;13986;8.32;0.51;248.93;16.77;742;92;4802.00;173
13072;92;628407857;13072;250;13815;13987;8.36;0.51;248.93;16.77;743;92;4803.00;172
13078;92;628407868;13078;245;13815;13988;8.35;0.51;248.92;16.77;737;92;4804.00;173
13083;92;628407879;13083;250;13816;13988;8.25;0.50;248.91;16.77;733;92;4805.00;172
13085;92;628407890;13085;253;13819;13991;8.26;0.50;248.93;16.77;734;92;4806.00;172
13085;92;628407902;13085;245;13819;13991;8.25;0.50;248.93;16.77;734;92;4807.00;172
13088;92;628407914;13088;240;13821;13991;8.24;0.50;248.97;16.77;733;92;4808.00;170
13091;92;628407926;13091;234;13822;13991;8.22;0.50;249.01;16.77;731;92;4809.00;169
13092;92;628407938;13092;230;13825;13997;8.26;0.50;249.01;16.76;733;92;4810.00;172
13097;92;628407951;13097;231;13828;13997;8.25;0.50;249.02;16.76;731;92;4811.00;169
13099;92;628407962;13099;231;13828;13997;8.30;0.51;249.02;16.76;729;92;4812.00;169
13102;92;628407974;13102;233;13829;13997;8.37;0.51;249.00;16.76;727;92;4813.00;168
13107;92;628407986;13107;233;13832;14001;8.42;0.51;248.96;16.76;725;92;4814.00;169
13109;92;628407997;13109;230;13834;14003;8.54;0.52;249.00;16.75;725;92;4815.00;169
13111;92;628408009;13111;214;13834;14003;8.70;0.53;249.01;16.75;723;92;4816.00;169
13113;92;628408021;13113;191;13836;14004;8.93;0.54;249.00;16.75;723;92;4817.00;168
13117;92;628408031;13117;173;13836;14004;9.14;0.56;249.03;16.75;719;92;4818.00;168
13120;92;628408043;13120;158;13836;14004;9.37;0.57;249.06;16.75;716;92;4819.00;168
13121;92;628408056;13121;152;13836;14004;9.59;0.58;249.05;16.75;715;92;4820.00;168
13123;92;628408074;13123;148;13836;14004;9.74;0.59;249.06;16.75;713;92;4821.00;168
13124;92;628408087;13124;137;13837;14004;9.95;0.60;249.06;16.75;713;92;4822.00;167
13127;92;628408099;13127;130;13837;14004;10.15;0.61;249.06;16.75;710;92;4823.00;167
13130;92;628408118;13130;141;13878;14074;10.13;0.61;249.06;16.70;748;92;4824.00;196
13132;92;628408136;13132;132;13878;14075;10.26;0.62;249.07;16.70;746;92;4825.00;197
13133;92;628408149;13133;125;13883;14075;10.49;0.64;249.09;16.70;750;92;4826.00;192
13136;92;628408162;13136;118;13883;14075;10.56;0.64;249.12;16.70;747;92;4827.00;192
13140;92;628408174;13140;119;13890;14077;10.69;0.65;249.16;16.69;750;92;4828.00;187
13144;92;628408187;13144;120;13890;14077;10.75;0.65;249.19;16.69;746;92;4829.00;187
13145;92;628408201;13145;116;13894;14077;10.91;0.66;249.18;16.69;749;92;4830.00;183
13147;92;628408214;13147;113;13896;14077;11.02;0.67;249.20;16.69;749;92;4831.00;181
13149;92;628408226;13149;120;13899;14078;11.13;0.68;249.21;16.69;750;92;4832.00;179
13151;92;628408239;13151;125;13902;14079;11.20;0.68;249.21;16.68;751;92;4833.00;177
13153;92;628408252;13153;131;13907;14079;11.23;0.68;249.21;16.68;754;92;4834.00;172
13154;92;628408265;13154;132;13910;14083;11.25;0.68;249.19;16.68;756;92;4835.00;173
13157;92;628408278;13157;137;13911;14083;11.25;0.69;249.20;16.68;754;92;4836.00;172
13161;92;628408291;13161;138;13911;14083;11.36;0.69;249.22;16.68;750;92;4837.00;172
13161;92;628408303;13161;140;13911;14083;11.40;0.70;249.22;16.68;750;92;4838.00;172
13165;92;628408315;13165;147;13917;14089;11.38;0.69;249.22;16.67;752;92;4839.00;172
13170;92;628408328;13170;145;13917;14089;11.44;0.70;249.30;16.67;747;92;4840.00;172
13175;92;628408341;13175;147;13917;14089;11.59;0.71;249.30;16.67;742;92;4841.00;172
13177;92;628408353;13177;153;13920;14092;11.70;0.71;249.30;16.67;743;92;4842.00;172
13179;92;628408371;13179;155;13920;14092;11.73;0.71;249.33;16.67;741;92;4843.00;172
13181;93;628408383;13181;154;13920;14092;11.74;0.72;249.33;16.67;739;93;4844.00;172
13183;93;628408404;13183;148;13921;14093;11.74;0.72;249.34;16.80;738;93;4845.00;172
13186;93;628408421;13186;149;13922;14094;11.77;0.72;249.33;16.80;736;93;4846.00;172
13187;93;628408433;13187;150;13922;14094;11.81;0.72;249.34;16.80;735;93;4847.00;172
13191;93;628408447;13191;149;13932;14107;11.77;0.72;249.34;16.78;741;93;4848.00;175
13194;93;628408459;13194;148;13933;14107;11.77;0.72;249.34;16.78;739;93;4849.00;174
13197;93;628408472;13197;144;13933;14107;11.86;0.72;249.36;16.78;736;93;4850.00;174
13200;93;628408485;13200;143;13934;14108;11.93;0.73;249.37;16.78;734;93;4851.00;174
13207;93;628408496;13207;141;13934;14108;11.93;0.72;249.37;16.78;727;93;4852.00;174
13209;93;628408508;13209;139;13937;14112;11.94;0.72;249.37;16.78;728;93;4853.00;175
13212;93;628408520;13212;141;13937;14112;11.95;0.72;249.37;16.78;725;93;4854.00;175
13217;93;628408531;13217;141;13941;14116;11.91;0.72;249.36;16.77;724;93;4855.00;175
13219;93;628408543;13219;137;13941;14116;11.83;0.72;249.37;16.77;722;93;4856.00;175
13221;93;628408554;13221;139;13941;14116;11.74;0.71;249.35;16.77;720;93;4857.00;175
13226;93;628408565;13226;142;13941;14116;11.67;0.71;249.38;16.77;715;93;4858.00;175
13228;93;628408576;13228;143;13941;14116;11.60;0.70;249.36;16.77;713;93;4859.00;175
13235;93;628408589;13235;149;13962;14150;11.49;0.70;249.39;16.75;727;93;4860.00;188
13237;93;628408603;13237;147;13962;14150;11.55;0.70;249.42;16.75;725;93;4861.00;188
13238;93;628408614;13238;142;13963;14150;11.56;0.70;249.41;16.75;725;93;4862.00;187
13247;93;628408633;13247;142;13964;14150;11.58;0.70;249.48;16.75;717;93;4863.00;186
13252;93;628408647;13252;137;13964;14150;11.70;0.71;249.55;16.75;712;93;4864.00;186
13253;93;628408659;13253;136;13966;14150;11.78;0.72;249.55;16.76;713;93;4865.00;184
13258;93;628408671;13258;130;13966;14151;11.81;0.72;249.55;16.76;708;93;4866.00;185
13264;93;628408683;13264;125;13967;14151;11.92;0.72;249.56;16.76;703;93;4867.00;184
13270;93;628408695;13270;126;13971;14157;11.93;0.72;249.55;16.88;701;93;4868.00;186
13272;93;628408708;13272;122;13973;14158;11.89;0.72;249.56;16.88;701;93;4869.00;185
13277;93;628408728;13277;125;13974;14158;11.91;0.72;249.55;16.88;697;93;4870.00;184
13278;93;628408742;13278;126;13974;14158;11.89;0.72;249.54;16.88;696;93;4871.00;184
13282;93;628408753;13282;128;13976;14162;11.89;0.72;249.56;16.88;694;93;4872.00;186
13283;93;628408772;13283;127;13976;14162;11.83;0.72;249.55;16.88;693;93;4873.00;186
13284;93;628408783;13284;130;13976;14162;11.75;0.71;249.56;16.88;692;93;4874.00;186
13286;93;628408792;13286;128;13977;14163;11.66;0.71;249.57;16.88;691;93;4875.00;186
13288;93;628408802;13288;128;13980;14167;11.57;0.70;249.56;16.87;692;93;4876.00;187
13291;93;628408812;13291;130;13981;14167;11.52;0.70;249.53;16.87;690;93;4877.00;186
13294;93;628408822;13294;132;13983;14170;11.52;0.70;249.50;16.87;689;93;4878.00;187
13296;93;628408833;13296;137;13985;14170;11.51;0.70;249.49;16.87;689;93;4879.00;185
13298;93;628408844;13298;134;13985;14170;11.49;0.70;249.48;16.87;687;93;4880.00;185
13300;93;628408854;13300;137;13986;14170;11.45;0.70;249.51;16.87;686;93;4881.00;184
13302;93;628408864;13302;141;13989;14174;11.42;0.70;249.50;16.87;687;93;4882.00;185
13304;93;628408875;13304;145;13989;14174;11.44;0.70;249.49;16.87;685;93;4883.00;185
13308;93;628408884;13308;148;13991;14174;11.38;0.69;249.50;16.87;683;93;4884.00;183
13311;93;628408894;13311;150;13992;14174;11.27;0.69;249.47;16.88;681;93;4885.00;182
13317;93;628408904;13317;154;13993;14175;11.11;0.68;249.50;16.88;676;93;4886.00;182
13319;93;628408914;13319;157;13994;14176;11.05;0.67;249.50;16.88;675;93;4887.00;182
13322;93;628408924;13322;162;13994;14176;11.02;0.67;249.49;16.88;672;93;4888.00;182
13325;93;628408933;13325;168;13997;14177;10.86;0.66;249.53;16.90;672;93;4889.00;180
13329;93;628408944;13329;179;13997;14177;10.72;0.65;249.53;16.90;668;93;4890.00;180
13332;93;628408954;13332;187;13997;14177;10.61;0.65;249.57;16.90;665;93;4891.00;180
13338;93;628408963;13338;197;13998;14177;10.49;0.64;249.56;16.92;660;93;4892.00;179
13341;93;628408973;13341;201;13999;14177;10.31;0.63;249.60;16.93;658;93;4893.00;178
13344;93;628408982;13344;207;14001;14177;10.16;0.62;249.62;16.95;657;93;4894.00;176
13348;93;628408991;13348;215;14001;14177;10.07;0.61;249.61;16.95;653;93;4895.00;176
13350;93;628409000;13350;237;14065;14304;9.97;0.62;249.66;16.89;715;93;4896.00;239
13351;93;628409018;13351;238;14070;14305;9.86;0.61;249.64;16.89;719;93;4897.00;235
13353;93;628409026;13353;237;14081;14305;9.82;0.61;249.63;16.90;728;93;4898.00;224
13355;93;628409035;13355;240;14082;14305;9.68;0.60;249.61;16.90;727;93;4899.00;223
13355;93;628409045;13355;241;14089;14305;9.64;0.59;249.61;16.91;734;93;4900.00;216
13357;93;628409057;13357;243;14097;14305;9.57;0.59;249.58;16.92;740;93;4901.00;208
13358;93;628409065;13358;243;14103;14305;9.44;0.58;249.57;16.92;745;93;4902.00;202
13359;93;628409074;13359;253;14109;14305;9.37;0.58;249.55;16.94;750;93;4903.00;196
13363;93;628409083;13363;255;14112;14306;9.27;0.57;249.51;16.94;749;93;4904.00;194
13369;93;628409091;13369;262;14117;14308;9.15;0.56;249.44;16.93;748;93;4905.00;191
13369;93;628409101;13369;263;14121;14308;9.04;0.56;249.44;16.95;752;93;4906.00;187
13371;93;628409110;13371;269;14124;14309;8.93;0.55;249.45;16.95;753;93;4907.00;185
13372;93;628409119;13372;278;14126;14309;8.79;0.54;249.45;16.95;754;93;4908.00;183
13376;93;628409129;13376;277;14129;14309;8.65;0.53;249.45;16.97;753;93;4909.00;180
13378;93;628409138;13378;280;14131;14309;8.52;0.52;249.45;16.97;753;93;4910.00;178
13380;93;628409147;13380;276;14137;14313;8.40;0.52;249.45;16.99;757;93;4911.00;176
13383;93;628409157;13383;280;14137;14313;8.23;0.51;249.45;16.99;754;93;4912.00;176
13384;93;628409166;13384;285;14139;14313;8.14;0.50;249.45;16.99;755;93;4913.00;174
13388;93;628409175;13388;296;14143;14316;7.99;0.49;249.42;17.00;755;93;4914.00;173
13389;93;628409185;13389;296;14144;14316;7.91;0.48;249.42;17.00;755;93;4915.00;172
13392;93;628409193;13392;300;14146;14316;7.76;0.48;249.42;17.02;754;93;4916.00;170
13394;93;628409202;13394;308;14150;14320;7.69;0.47;249.42;17.01;756;93;4917.00;170
13395;93;628409212;13395;316;14152;14321;7.63;0.47;249.40;17.01;757;93;4918.00;169
13396;93;628409221;13396;318;14153;14321;7.55;0.46;249.38;17.02;757;93;4919.00;168
13397;93;628409231;13397;326;14160;14326;7.46;0.46;249.42;17.02;763;93;4920.00;166
13399;93;628409240;13399;331;14161;14326;7.32;0.45;249.41;17.03;762;93;4921.00;165
13401;93;628409248;13401;334;14161;14326;7.23;0.45;249.42;17.03;760;93;4922.00;165
13403;93;628409256;13403;337;14163;14327;7.08;0.44;249.42;17.05;760;93;4923.00;164
13405;93;628409265;13405;341;14163;14327;6.92;0.43;249.40;17.05;758;93;4924.00;164
13409;93;628409273;13409;344;14168;14333;6.75;0.42;249.40;17.04;759;93;4925.00;165
13411;93;628409282;13411;348;14169;14333;6.56;0.41;249.39;17.05;758;93;4926.00;164
13414;93;628409290;13414;353;14170;14334;6.37;0.40;249.40;17.05;756;93;4927.00;164
13417;93;628409299;13417;357;14171;14334;6.28;0.39;249.37;17.06;754;93;4928.00;163
13422;93;628409307;13422;360;14173;14334;6.11;0.38;249.37;17.09;751;93;4929.00;161
13427;93;628409315;13427;356;14174;14334;5.91;0.37;249.34;17.10;747;93;4930.00;160
13429;93;628409323;13429;347;14174;14334;5.84;0.36;249.36;17.10;745;93;4931.00;160
13433;93;628409331;13433;332;14184;14346;5.87;0.36;249.39;17.09;751;93;4932.00;162
13436;93;628409340;13436;328;14185;14346;5.80;0.36;249.40;17.10;749;93;4933.00;161
13437;93;628409348;13437;316;14188;14346;5.80;0.36;249.41;17.12;751;93;4934.00;158
13439;93;628409357;13439;310;14189;14346;5.84;0.36;249.43;17.13;750;93;4935.00;157
13442;93;628409364;13442;305;14189;14346;5.93;0.37;249.43;17.13;747;93;4936.00;157
13443;93;628409373;13443;293;14189;14346;6.14;0.38;249.43;17.13;746;93;4937.00;157
13444;93;628409382;13444;284;14192;14350;6.38;0.39;249.44;17.13;748;93;4938.00;158
13446;93;628409390;13446;270;14192;14350;6.60;0.41;249.44;17.13;746;93;4939.00;158
13447;93;628409405;13447;267;14195;14354;6.83;0.42;249.45;17.13;748;93;4940.00;159
13449;94;628409414;13449;260;14196;14355;6.98;0.43;249.44;17.13;747;94;4941.00;159
13452;94;628409430;13452;255;14197;14355;7.10;0.44;249.46;17.13;745;94;4942.00;158
13453;94;628409440;13453;255;14197;14355;7.23;0.44;249.44;17.13;744;94;4943.00;158
13454;94;628409450;13454;242;14208;14368;7.48;0.46;249.45;17.11;754;94;4944.00;160
13462;95;628409460;13462;237;14208;14368;7.54;0.46;249.40;17.11;746;95;4945.00;160
13465;95;628409481;13465;234;14208;14368;7.72;0.47;249.40;17.11;743;95;4946.00;160
13468;95;628409490;13468;227;14209;14369;7.93;0.48;249.39;17.11;741;95;4947.00;160
13470;95;628409505;13470;223;14209;14370;8.14;0.50;249.41;17.11;739;95;4948.00;161
13473;95;628409515;13473;219;14209;14370;8.29;0.51;249.42;17.11;736;95;4949.00;161
13475;95;628409526;13475;212;14213;14379;8.41;0.52;249.41;17.11;738;95;4950.00;166
13480;95;628409536;13480;217;14214;14379;8.52;0.52;249.41;17.11;734;95;4951.00;165
13482;95;628409552;13482;212;14215;14379;8.65;0.53;249.44;17.10;733;95;4952.00;164
13487;95;628409562;13487;208;14215;14379;8.68;0.53;249.43;17.10;728;95;4953.00;164
13489;95;628409578;13489;203;14219;14385;8.82;0.54;249.42;17.10;730;95;4954.00;166
13495;95;628409588;13495;197;14219;14385;8.80;0.54;249.39;17.10;724;95;4955.00;166
13500;95;628409604;13500;200;14220;14385;8.79;0.54;249.39;17.10;720;95;4956.00;165
13506;95;628409615;13506;201;14220;14385;8.69;0.53;249.37;17.10;714;95;4957.00;165
13510;95;628409629;13510;200;14224;14389;8.73;0.53;249.43;17.09;714;95;4958.00;165
13515;95;628409639;13515;200;14227;14390;8.78;0.53;249.43;17.22;712;95;4959.00;163
13521;95;628409651;13521;201;14228;14390;8.82;0.54;249.45;17.22;707;95;4960.00;162
13527;95;628409661;13527;202;14229;14391;8.89;0.54;249.46;17.22;702;95;4961.00;162
13530;95;628409672;13530;203;14229;14391;8.94;0.54;249.46;17.22;699;95;4962.00;162
13535;95;628409681;13535;200;14229;14391;8.90;0.54;249.48;17.22;694;95;4963.00;162
13539;95;628409698;13539;202;14229;14391;8.94;0.54;249.47;17.22;690;95;4964.00;162
13545;95;628409708;13545;203;14229;14391;8.91;0.54;249.48;17.22;684;95;4965.00;162
13551;95;628409719;13551;207;14229;14391;8.83;0.54;249.47;17.22;678;95;4966.00;162
13552;95;628409739;13552;204;14229;14391;8.91;0.54;249.46;17.22;677;95;4967.00;162
13556;95;628409755;13556;219;14272;14461;9.08;0.55;249.48;17.17;716;95;4968.00;189
13559;95;628409781;13559;208;14273;14462;9.13;0.56;249.48;17.17;714;95;4969.00;189
13563;95;628409799;13563;205;14278;14462;9.24;0.56;249.45;17.16;715;95;4970.00;184
13565;95;628409815;13565;199;14280;14462;9.33;0.57;249.49;17.16;715;95;4971.00;182
13569;95;628409829;13569;197;14283;14462;9.39;0.57;249.51;17.16;714;95;4972.00;179
13575;95;628409848;13575;198;14287;14462;9.51;0.58;249.55;17.15;712;95;4973.00;175
13576;95;628409862;13576;199;14292;14462;9.62;0.58;249.57;17.15;716;95;4974.00;170
13579;95;628409873;13579;200;14293;14462;9.60;0.58;249.59;17.15;714;95;4975.00;169
13581;95;628409885;13581;205;14295;14463;9.54;0.58;249.60;17.15;714;95;4976.00;168
13584;95;628409896;13584;206;14296;14464;9.56;0.58;249.61;17.15;712;95;4977.00;168
13588;95;628409909;13588;201;14297;14464;9.47;0.57;249.64;17.14;709;95;4978.00;167
13589;95;628409921;13589;194;14300;14468;9.43;0.57;249.63;17.14;711;95;4979.00;168
13593;95;628409934;13593;183;14300;14468;9.47;0.58;249.67;17.14;707;95;4980.00;168
13596;95;628409948;13596;183;14300;14468;9.61;0.59;249.69;17.14;704;95;4981.00;168
13597;95;628409960;13597;185;14300;14468;9.76;0.59;249.69;17.14;703;95;4982.00;168
13600;95;628409972;13600;182;14304;14474;9.82;0.60;249.70;17.14;704;95;4983.00;170
13601;95;628409986;13601;182;14305;14474;9.87;0.60;249.72;17.14;704;95;4984.00;169
13604;95;628409996;13604;185;14305;14474;9.89;0.60;249.74;17.14;701;95;4985.00;169
13608;95;628410013;13608;171;14307;14477;10.07;0.61;249.74;17.13;699;95;4986.00;170
13610;95;628410027;13610;156;14307;14477;10.25;0.62;249.76;17.13;697;95;4987.00;170
13612;95;628410040;13612;150;14308;14477;10.40;0.63;249.76;17.13;696;95;4988.00;169
13614;95;628410052;13614;141;14308;14478;10.56;0.64;249.76;17.13;694;95;4989.00;170
13617;95;628410064;13617;140;14309;14479;10.68;0.65;249.76;17.13;692;95;4990.00;170
13619;96;628410076;13619;141;14309;14479;10.81;0.66;249.75;17.13;690;96;4991.00;170
13625;96;628410102;13625;135;14320;14492;11.05;0.67;249.76;17.12;695;96;4992.00;172
13627;96;628410115;13627;128;14320;14492;11.20;0.68;249.77;17.12;693;96;4993.00;172
13628;96;628410134;13628;124;14320;14492;11.40;0.69;249.75;17.12;692;96;4994.00;172
13632;96;628410147;13632;125;14322;14494;11.53;0.70;249.76;17.12;690;96;4995.00;172
13635;96;628410159;13635;122;14322;14494;11.61;0.70;249.79;17.12;687;96;4996.00;172
13637;97;628410170;13637;118;14325;14498;11.70;0.71;249.77;17.11;688;97;4997.00;173
13642;97;628410196;13642;117;14325;14498;11.68;0.71;249.78;17.11;683;97;4998.00;173
13644;97;628410208;13644;114;14329;14502;11.64;0.71;249.79;17.11;685;97;4999.00;173
13646;97;628410221;13646;111;14329;14502;11.72;0.71;249.79;17.11;683;97;5000.00;173
13650;97;628410237;13650;113;14329;14502;11.72;0.71;249.78;17.11;679;97;5001.00;173
13655;97;628410249;13655;110;14329;14502;11.61;0.70;249.78;17.11;674;97;5002.00;173
13657;97;628410266;13657;114;14329;14502;11.65;0.70;249.78;17.11;672;97;5003.00;173
13658;97;628410278;13658;118;14338;14514;11.70;0.71;249.79;17.10;680;97;5004.00;176
13660;97;628410290;13660;119;14338;14514;11.77;0.71;249.82;17.10;678;97;5005.00;176
13661;97;628410301;13661;119;14340;14514;11.87;0.72;249.81;17.09;679;97;5006.00;174
13666;97;628410312;13666;118;14340;14514;11.90;0.72;249.81;17.09;674;97;5007.00;174
13667;97;628410333;13667;119;14340;14514;11.90;0.72;249.83;17.09;673;97;5008.00;174
13669;97;628410345;13669;121;14340;14514;11.97;0.73;249.82;17.09;671;97;5009.00;174
13671;97;628410358;13671;121;14340;14515;12.02;0.73;249.86;17.09;669;97;5010.00;175
13674;97;628410369;13674;121;14340;14515;12.03;0.73;249.87;17.09;666;97;5011.00;175
13675;97;628410380;13675;121;14344;14521;12.00;0.73;249.88;17.09;669;97;5012.00;177
13676;98;628410399;13676;122;14345;14522;12.04;0.73;249.90;17.09;669;98;5013.00;177
13678;98;628410435;13678;122;14346;14522;12.14;0.74;249.92;17.09;668;98;5014.00;176
13683;98;628410446;13683;122;14346;14522;12.10;0.74;249.92;17.09;663;98;5015.00;176
13688;98;628410457;13688;120;14349;14526;12.05;0.73;249.93;17.08;661;98;5016.00;177
13691;98;628410468;13691;119;14349;14526;12.03;0.73;249.91;17.08;658;98;5017.00;177
13693;98;628410478;13693;119;14349;14526;11.96;0.73;249.96;17.08;656;98;5018.00;177
13696;98;628410489;13696;120;14350;14527;11.97;0.73;249.95;17.08;654;98;5019.00;177
13697;98;628410499;13697;125;14353;14531;11.92;0.73;249.95;17.08;656;98;5020.00;178
13702;98;628410510;13702;122;14353;14531;11.92;0.73;250.02;17.08;651;98;5021.00;178
13708;98;628410520;13708;129;14355;14534;11.95;0.73;249.99;17.08;647;98;5022.00;179
13710;98;628410530;13710;132;14355;14534;11.91;0.72;249.98;17.08;645;98;5023.00;179
13714;98;628410540;13714;132;14356;14534;11.87;0.72;249.97;17.08;642;98;5024.00;178
13716;98;628410549;13716;131;14356;14534;11.84;0.72;249.97;17.08;640;98;5025.00;178
13719;98;628410558;13719;137;14359;14538;11.83;0.72;249.97;17.07;640;98;5026.00;179
13723;98;628410569;13723;137;14359;14538;11.88;0.72;250.00;17.07;636;98;5027.00;179
13729;98;628410580;13729;139;14360;14538;11.89;0.72;249.99;17.07;631;98;5028.00;178
13732;98;628410590;13732;133;14360;14538;11.79;0.72;249.98;17.07;628;98;5029.00;178
13736;98;628410600;13736;128;14360;14539;11.75;0.72;249.97;17.07;624;98;5030.00;179
13739;98;628410610;13739;127;14361;14540;11.69;0.71;249.97;17.07;622;98;5031.00;179
13742;98;628410619;13742;119;14361;14540;11.62;0.71;249.97;17.07;619;98;5032.00;179
13746;98;628410628;13746;123;14362;14541;11.63;0.71;249.93;17.07;616;98;5033.00;179
13748;98;628410639;13748;127;14362;14541;11.66;0.71;249.93;17.07;614;98;5034.00;179
13751;98;628410649;13751;125;14363;14541;11.74;0.71;249.96;17.09;612;98;5035.00;178
13753;98;628410660;13753;119;14363;14541;11.84;0.72;249.97;17.09;610;98;5036.00;178
13755;98;628410669;13755;114;14363;14541;11.88;0.72;249.96;17.09;608;98;5037.00;178
13760;98;628410678;13760;111;14363;14541;11.85;0.72;249.94;17.09;603;98;5038.00;178
13762;98;628410688;13762;110;14363;14541;11.88;0.72;249.94;17.09;601;98;5039.00;178
13766;98;628410700;13766;141;14466;14771;11.45;0.72;249.90;16.97;700;98;5040.00;305
13767;99;628410734;13767;137;14469;14772;11.44;0.72;249.90;16.96;702;99;5041.00;303
13770;99;628410769;13770;125;14478;14772;11.53;0.72;249.87;16.95;708;99;5042.00;294
13772;99;628410780;13772;124;14484;14772;11.55;0.72;249.87;17.09;712;99;5043.00;288
13774;99;628410790;13774;126;14491;14772;11.52;0.72;249.90;17.10;717;99;5044.00;281
13777;99;628410799;13777;122;14499;14772;11.46;0.71;249.91;17.37;722;99;5045.00;273
13782;99;628410815;13782;119;14504;14772;11.45;0.71;249.89;17.37;722;99;5046.00;268
13785;99;628410825;13785;119;14510;14772;11.41;0.71;249.87;17.37;725;99;5047.00;262
13788;99;628410839;13788;120;14517;14773;11.34;0.70;249.85;17.49;729;99;5048.00;256
13790;99;628410849;13790;128;14522;14774;11.34;0.70;249.85;17.49;732;99;5049.00;252
13793;99;628410860;13793;126;14527;14774;11.34;0.70;249.83;17.48;734;99;5050.00;247
13794;99;628410869;13794;133;14530;14775;11.32;0.70;249.82;17.61;736;99;5051.00;245
13794;99;628410885;13794;134;14533;14775;11.23;0.69;249.82;17.61;739;99;5052.00;242
13798;99;628410900;13798;140;14536;14775;11.04;0.68;249.83;17.60;738;99;5053.00;239
13801;99;628410911;13801;140;14537;14775;10.91;0.67;249.83;17.60;736;99;5054.00;238
13803;99;628410922;13803;151;14545;14779;10.71;0.66;249.83;17.60;742;99;5055.00;234
13804;99;628410933;13804;160;14548;14779;10.52;0.65;249.82;17.62;744;99;5056.00;231
13806;99;628410943;13806;169;14550;14779;10.44;0.64;249.82;17.62;744;99;5057.00;229
13807;99;628410959;13807;178;14554;14782;10.29;0.63;249.81;17.62;747;99;5058.00;228
13809;100;628410971;13809;185;14556;14782;10.22;0.63;249.80;17.62;747;100;5059.00;226
13812;100;628410991;13812;193;14559;14782;10.16;0.62;249.79;17.62;747;100;5060.00;223
13814;100;628411002;13814;201;14564;14786;10.05;0.62;249.78;17.64;750;100;5061.00;222
13816;100;628411013;13816;213;14568;14787;9.97;0.61;249.76;17.64;752;100;5062.00;219
13817;101;628411024;13817;225;14569;14787;9.90;0.61;249.74;17.65;752;101;5063.00;218
13819;101;628411045;13819;232;14577;14791;9.81;0.60;249.73;17.67;758;101;5064.00;214
13823;101;628411055;13823;237;14578;14791;9.67;0.59;249.71;17.67;755;101;5065.00;213
13824;101;628411066;13824;244;14580;14791;9.59;0.59;249.70;17.67;756;101;5066.00;211
13827;101;628411081;13827;254;14583;14792;9.43;0.58;249.68;17.69;756;101;5067.00;209
13828;101;628411098;13828;262;14585;14792;9.34;0.57;249.67;17.71;757;101;5068.00;207
13832;101;628411108;13832;269;14591;14798;9.12;0.56;249.64;17.71;759;101;5069.00;207
13833;101;628411120;13833;274;14595;14798;8.90;0.54;249.63;17.72;762;101;5070.00;203
13835;101;628411129;13835;282;14597;14799;8.66;0.53;249.61;17.73;762;101;5071.00;202
13836;101;628411139;13836;293;14598;14799;8.47;0.52;249.61;17.73;762;101;5072.00;201
13839;101;628411148;13839;304;14603;14799;8.25;0.50;249.64;17.75;764;101;5073.00;196
13842;101;628411157;13842;318;14605;14799;8.07;0.49;249.62;17.75;763;101;5074.00;194
13842;101;628411166;13842;335;14606;14799;7.90;0.48;249.62;17.75;764;101;5075.00;193
13842;101;628411175;13842;342;14621;14811;7.84;0.48;249.62;17.75;779;101;5076.00;190
13843;101;628411190;13843;352;14622;14811;7.72;0.47;249.61;17.76;779;101;5077.00;189
13843;101;628411199;13843;360;14624;14811;7.60;0.47;249.61;17.77;781;101;5078.00;187
13843;101;628411207;13843;362;14626;14811;7.41;0.45;249.61;17.77;783;101;5079.00;185
13844;101;628411216;13844;362;14626;14811;7.31;0.45;249.61;17.77;782;101;5080.00;185
13847;101;628411225;13847;366;14628;14811;7.21;0.44;249.58;17.79;781;101;5081.00;183
13848;101;628411234;13848;371;14631;14815;7.14;0.44;249.57;17.79;783;101;5082.00;184
13848;101;628411244;13848;362;14632;14815;7.04;0.43;249.57;17.80;784;101;5083.00;183
13848;101;628411253;13848;350;14637;14819;7.05;0.43;249.57;17.80;789;101;5084.00;182
13849;101;628411263;13849;346;14639;14821;7.04;0.43;249.56;17.80;790;101;5085.00;182
13850;101;628411273;13850;340;14641;14821;7.03;0.43;249.57;17.81;791;101;5086.00;180
13851;101;628411282;13851;339;14641;14821;7.07;0.43;249.56;17.81;790;101;5087.00;180
13853;101;628411292;13853;330;14654;14834;7.14;0.44;249.55;17.81;801;101;5088.00;180
13855;101;628411303;13855;326;14655;14834;7.13;0.44;249.52;17.83;800;101;5089.00;179
13856;101;628411320;13856;322;14655;14834;7.17;0.44;249.51;17.83;799;101;5090.00;179
13858;101;628411329;13858;321;14657;14835;7.27;0.45;249.50;17.84;799;101;5091.00;178
13861;102;628411339;13861;313;14657;14836;7.33;0.45;249.49;17.84;796;102;5092.00;179
13864;103;628411366;13864;308;14657;14836;7.35;0.45;249.47;17.84;793;103;5093.00;179
13868;103;628411388;13868;303;14662;14839;7.42;0.46;249.43;17.88;794;103;5094.00;177
13871;103;628411398;13871;302;14663;14839;7.50;0.46;249.42;17.88;792;103;5095.00;176
13873;104;628411408;13873;303;14664;14839;7.52;0.46;249.42;17.89;791;104;5096.00;175
13880;104;628411433;13880;303;14664;14839;7.48;0.46;249.48;17.89;784;104;5097.00;175
13881;104;628411444;13881;304;14670;14845;7.51;0.46;249.49;17.91;789;104;5098.00;175
13885;104;628411454;13885;304;14671;14845;7.43;0.46;249.50;17.92;786;104;5099.00;174
13887;104;628411467;13887;301;14678;14864;7.37;0.45;249.48;17.93;791;104;5100.00;186
13888;104;628411482;13888;292;14678;14864;7.41;0.46;249.49;17.93;790;104;5101.00;186
13888;104;628411492;13888;292;14683;14868;7.44;0.46;249.49;17.94;795;104;5102.00;185
13890;104;628411501;13890;286;14684;14869;7.45;0.46;249.50;17.94;794;104;5103.00;185
13893;104;628411511;13893;279;14685;14869;7.46;0.46;249.49;17.95;792;104;5104.00;184
13895;104;628411520;13895;281;14687;14870;7.47;0.46;249.50;17.96;792;104;5105.00;183
13899;104;628411530;13899;277;14689;14870;7.40;0.45;249.52;17.96;790;104;5106.00;181
13903;104;628411539;13903;268;14689;14870;7.45;0.46;249.53;17.96;786;104;5107.00;181
13905;104;628411550;13905;266;14690;14870;7.57;0.47;249.55;17.95;785;104;5108.00;180
13909;104;628411561;13909;257;14690;14870;7.68;0.47;249.61;17.95;781;104;5109.00;180
13913;104;628411571;13913;249;14690;14870;7.84;0.48;249.61;17.95;777;104;5110.00;180
13917;104;628411580;13917;247;14691;14870;7.92;0.49;249.65;17.95;774;104;5111.00;179
13921;104;628411590;13921;247;14724;14940;8.08;0.50;249.65;18.04;803;104;5112.00;216
13926;104;628411607;13926;237;14726;14941;8.20;0.51;249.63;18.04;800;104;5113.00;215
13934;104;628411617;13934;231;14735;14941;8.27;0.51;249.64;18.03;801;104;5114.00;206
13938;104;628411628;13938;227;14738;14941;8.37;0.51;249.63;18.03;800;104;5115.00;203
13941;104;628411639;13941;219;14741;14941;8.49;0.52;249.61;18.02;800;104;5116.00;200
13949;104;628411649;13949;217;14745;14941;8.54;0.52;249.56;18.02;796;104;5117.00;196
13954;104;628411659;13954;211;14747;14941;8.56;0.52;249.53;18.02;793;104;5118.00;194
13959;104;628411670;13959;213;14748;14941;8.58;0.52;249.53;18.02;789;104;5119.00;193
13963;104;628411680;13963;214;14750;14942;8.56;0.52;249.52;18.02;787;104;5120.00;192
13965;104;628411691;13965;211;14752;14943;8.59;0.52;249.53;18.02;787;104;5121.00;191
13969;104;628411702;13969;210;14754;14943;8.64;0.53;249.56;18.02;785;104;5122.00;189
13972;104;628411718;13972;210;14759;14947;8.77;0.54;249.55;18.01;787;104;5123.00;188
13977;104;628411729;13977;205;14760;14947;8.91;0.55;249.55;18.01;783;104;5124.00;187
13983;104;628411746;13983;206;14760;14947;8.92;0.55;249.51;18.01;777;104;5125.00;187
13988;104;628411765;13988;205;14761;14947;8.96;0.55;249.49;18.01;773;104;5126.00;186
13996;104;628411783;13996;204;14764;14953;8.94;0.55;249.50;18.01;768;104;5127.00;189
14000;104;628411800;14000;206;14766;14953;8.95;0.55;249.49;18.14;766;104;5128.00;187
14005;104;628411818;14005;211;14766;14953;8.89;0.54;249.49;18.14;761;104;5129.00;187
14011;104;628411844;14011;210;14769;14959;8.98;0.55;249.51;18.13;758;104;5130.00;190
14014;104;628411860;14014;213;14770;14959;8.98;0.55;249.51;18.13;756;104;5131.00;189
14018;104;628411874;14018;211;14770;14959;8.98;0.55;249.52;18.13;752;104;5132.00;189
14023;104;628411886;14023;208;14771;14960;8.85;0.54;249.55;18.13;748;104;5133.00;189
14028;104;628411900;14028;213;14774;14961;8.84;0.54;249.52;18.13;746;104;5134.00;187
14030;104;628411913;14030;207;14774;14961;8.84;0.54;249.53;18.13;744;104;5135.00;187
14036;104;628411925;14036;212;14784;14974;8.86;0.54;249.51;18.12;748;104;5136.00;190
14040;104;628411939;14040;209;14784;14974;8.90;0.54;249.49;18.12;744;104;5137.00;190
14042;104;628411952;14042;214;14784;14974;8.92;0.54;249.52;18.12;742;104;5138.00;190
14044;104;628411964;14044;214;14786;14975;9.03;0.55;249.54;18.12;742;104;5139.00;189
14046;104;628411978;14046;220;14788;14975;9.09;0.55;249.57;18.12;742;104;5140.00;187
14051;104;628411989;14051;223;14790;14979;9.10;0.55;249.59;18.12;739;104;5141.00;189
14053;104;628412002;14053;222;14792;14979;9.06;0.55;249.61;18.12;739;104;5142.00;187
14057;104;628412014;14057;231;14796;14983;9.05;0.55;249.62;18.12;739;104;5143.00;187
14059;104;628412026;14059;227;14796;14983;9.04;0.55;249.63;18.12;737;104;5144.00;187
14064;104;628412038;14064;227;14797;14983;9.01;0.55;249.64;18.12;733;104;5145.00;186
14068;104;628412051;14068;235;14797;14983;8.93;0.54;249.65;18.12;729;104;5146.00;186
14072;104;628412063;14072;231;14798;14983;8.93;0.54;249.67;18.12;726;104;5147.00;185
14075;104;628412075;14075;229;14809;14995;9.02;0.55;249.68;18.11;734;104;5148.00;186
14079;104;628412089;14079;227;14810;14995;9.05;0.55;249.72;18.23;731;104;5149.00;185
14082;104;628412103;14082;222;14811;14995;9.17;0.56;249.73;18.23;729;104;5150.00;184
14084;104;628412115;14084;219;14811;14995;9.20;0.56;249.75;18.23;727;104;5151.00;184
14086;104;628412127;14086;216;14812;14995;9.25;0.56;249.81;18.23;726;104;5152.00;183
14089;104;628412144;14089;214;14813;14995;9.32;0.57;249.84;18.23;724;104;5153.00;182
14093;104;628412163;14093;211;14813;14996;9.32;0.57;249.86;18.23;720;104;5154.00;183
14096;104;628412175;14096;210;14815;14998;9.29;0.56;249.87;18.23;719;104;5155.00;183
14100;104;628412189;14100;194;14819;15004;9.30;0.56;249.87;18.23;719;104;5156.00;185
14102;104;628412201;14102;179;14821;15005;9.38;0.57;249.85;18.23;719;104;5157.00;184
14104;104;628412214;14104;172;14821;15005;9.43;0.57;249.84;18.23;717;104;5158.00;184
14105;104;628412226;14105;157;14823;15005;9.54;0.58;249.85;18.23;718;104;5159.00;182
14108;104;628412246;14108;147;14828;15010;9.71;0.59;249.85;18.22;720;104;5160.00;182
14109;104;628412259;14109;145;14828;15010;9.83;0.60;249.86;18.22;719;104;5161.00;182
14110;104;628412272;14110;139;14828;15010;9.95;0.60;249.86;18.22;718;104;5162.00;182
14112;104;628412284;14112;135;14829;15011;10.09;0.61;249.86;18.22;717;104;5163.00;182
14115;104;628412296;14115;132;14832;15015;10.18;0.62;249.87;18.22;717;104;5164.00;183
14116;104;628412309;14116;126;14833;15015;10.28;0.62;249.86;18.34;717;104;5165.00;182
14120;104;628412321;14120;128;14836;15018;10.43;0.63;249.86;18.34;716;104;5166.00;182
14123;104;628412334;14123;121;14836;15018;10.51;0.64;249.86;18.34;713;104;5167.00;182
14125;104;628412346;14125;120;14836;15018;10.63;0.65;249.92;18.34;711;104;5168.00;182
14127;104;628412358;14127;117;14836;15018;10.69;0.65;249.94;18.34;709;104;5169.00;182
14132;104;628412369;14132;119;14839;15022;10.86;0.66;249.94;18.34;707;104;5170.00;183
14134;104;628412381;14134;118;14840;15022;10.99;0.67;249.96;18.34;706;104;5171.00;182
14136;104;628412393;14136;123;14840;15022;11.13;0.68;249.97;18.34;704;104;5172.00;182
14141;104;628412405;14141;123;14840;15022;11.20;0.68;249.94;18.34;699;104;5173.00;182
14144;104;628412417;14144;119;14840;15023;11.22;0.68;249.95;18.34;696;104;5174.00;183
14147;104;628412428;14147;124;14842;15025;11.18;0.68;249.94;18.33;695;104;5175.00;183
14148;104;628412439;14148;133;14842;15025;11.21;0.68;249.95;18.33;694;104;5176.00;183
14150;104;628412450;14150;130;14843;15026;11.15;0.68;249.96;18.33;693;104;5177.00;183
14154;104;628412461;14154;131;14843;15026;11.19;0.68;249.95;18.33;689;104;5178.00;183
14156;104;628412473;14156;134;14843;15026;11.25;0.68;249.96;18.33;687;104;5179.00;183
14159;104;628412489;14159;129;14843;15026;11.19;0.68;250.00;18.33;684;104;5180.00;183
14161;104;628412500;14161;127;14843;15026;11.20;0.68;249.98;18.33;682;104;5181.00;183
14162;104;628412511;14162;131;14843;15026;11.21;0.68;249.98;18.33;681;104;5182.00;183
14166;104;628412522;14166;137;14843;15026;11.19;0.68;249.98;18.33;677;104;5183.00;183
14169;104;628412533;14169;162;14916;15153;10.95;0.67;249.98;18.24;747;104;5184.00;237
14172;104;628412554;14172;154;14917;15154;10.90;0.67;249.98;18.24;745;104;5185.00;237
14174;104;628412565;14174;147;14922;15154;10.98;0.68;249.96;18.24;748;104;5186.00;232
14176;104;628412576;14176;145;14926;15154;11.04;0.68;249.98;18.23;750;104;5187.00;228
14178;104;628412586;14178;141;14928;15154;11.13;0.69;249.99;18.23;750;104;5188.00;226
14180;104;628412598;14180;140;14930;15154;11.20;0.69;250.00;18.23;750;104;5189.00;224
14184;104;628412610;14184;147;14932;15154;11.31;0.70;250.00;18.23;748;104;5190.00;222
14185;104;628412622;14185;152;14935;15154;11.39;0.70;249.99;18.22;750;104;5191.00;219
14190;104;628412639;14190;153;14938;15155;11.42;0.70;249.99;18.22;748;104;5192.00;217
14193;104;628412650;14193;154;14940;15156;11.48;0.70;249.96;18.22;747;104;5193.00;216
14197;104;628412661;14197;157;14944;15156;11.45;0.70;249.97;18.22;747;104;5194.00;212
14200;104;628412678;14200;161;14946;15157;11.44;0.70;250.03;18.22;746;104;5195.00;211
14202;104;628412689;14202;167;14950;15157;11.37;0.70;250.02;18.22;748;104;5196.00;207
14205;104;628412699;14205;174;14952;15157;11.35;0.70;250.02;18.22;747;104;5197.00;205
14208;104;628412710;14208;178;14956;15157;11.31;0.69;250.01;18.21;748;104;5198.00;201
14210;104;628412722;14210;180;14958;15161;11.20;0.69;250.02;18.21;748;104;5199.00;203
14213;104;628412737;14213;181;14959;15161;11.14;0.68;250.02;18.21;746;104;5200.00;202
14215;104;628412755;14215;185;14960;15161;11.05;0.68;250.01;18.21;745;104;5201.00;201
14218;104;628412766;14218;181;14963;15164;10.95;0.67;250.00;18.21;745;104;5202.00;201
14222;104;628412777;14222;182;14964;15164;10.84;0.66;250.01;18.21;742;104;5203.00;200
14224;104;628412789;14224;181;14965;15164;10.85;0.66;250.01;18.21;741;104;5204.00;199
14227;104;628412799;14227;180;14971;15168;10.80;0.66;249.99;18.24;744;104;5205.00;197
14228;105;628412812;14228;182;14973;15169;10.84;0.66;249.98;18.24;745;105;5206.00;196
14233;105;628412830;14233;181;14973;15169;10.84;0.66;249.96;18.24;740;105;5207.00;196
14237;105;628412846;14237;178;14975;15173;10.77;0.66;249.93;18.23;738;105;5208.00;198
14240;105;628412858;14240;174;14975;15173;10.70;0.65;249.92;18.23;735;105;5209.00;198
14241;105;628412869;14241;171;14975;15173;10.61;0.65;249.91;18.23;734;105;5210.00;198
14243;105;628412879;14243;169;14976;15174;10.58;0.65;249.91;18.23;733;105;5211.00;198
14250;105;628412895;14250;170;14977;15174;10.51;0.64;249.86;18.23;727;105;5212.00;197
14251;105;628412906;14251;170;14980;15180;10.60;0.65;249.85;18.23;729;105;5213.00;200
14254;105;628412916;14254;172;14981;15180;10.63;0.65;249.82;18.23;727;105;5214.00;199
14259;105;628412926;14259;176;14982;15180;10.67;0.65;249.78;18.23;723;105;5215.00;198
14262;105;628412935;14262;181;14982;15181;10.68;0.65;249.76;18.23;720;105;5216.00;199
14264;105;628412945;14264;190;14983;15181;10.64;0.65;249.73;18.23;719;105;5217.00;198
14267;105;628412954;14267;193;14983;15181;10.57;0.64;249.76;18.23;716;105;5218.00;198
14269;105;628412964;14269;198;14984;15181;10.43;0.64;249.74;18.23;715;105;5219.00;197
14271;105;628412976;14271;201;15005;15217;10.33;0.63;249.72;18.20;734;105;5220.00;212
14273;105;628412989;14273;206;15005;15217;10.25;0.63;249.71;18.20;732;105;5221.00;212
14274;105;628412998;14274;211;15008;15217;10.20;0.62;249.70;18.20;734;105;5222.00;209
14275;105;628413008;14275;214;15008;15217;10.19;0.62;249.71;18.20;733;105;5223.00;209
14275;105;628413023;14275;215;15010;15217;10.12;0.62;249.71;18.20;735;105;5224.00;207
14275;105;628413033;14275;213;15011;15217;10.07;0.62;249.71;18.20;736;105;5225.00;206
14277;105;628413042;14277;217;15015;15221;10.03;0.61;249.70;18.19;738;105;5226.00;206
14278;105;628413059;14278;226;15016;15221;10.01;0.61;249.69;18.19;738;105;5227.00;205
14283;105;628413068;14283;235;15021;15225;9.94;0.61;249.67;18.19;738;105;5228.00;204
14284;105;628413079;14284;247;15024;15226;9.82;0.60;249.67;18.20;740;105;5229.00;202
14285;105;628413089;14285;250;15026;15226;9.70;0.59;249.65;18.22;741;105;5230.00;200
14285;105;628413098;14285;256;15026;15226;9.57;0.58;249.65;18.22;741;105;5231.00;200
14287;105;628413108;14287;262;15036;15239;9.33;0.57;249.63;18.21;749;105;5232.00;203
14289;105;628413119;14289;266;15039;15239;9.15;0.56;249.63;18.24;750;105;5233.00;200
14289;105;628413129;14289;275;15039;15239;9.01;0.55;249.63;18.24;750;105;5234.00;200
14293;105;628413138;14293;268;15040;15240;8.93;0.54;249.61;18.24;747;105;5235.00;200
14295;105;628413148;14295;260;15042;15241;8.87;0.54;249.61;18.28;747;105;5236.00;199
14297;105;628413158;14297;259;15043;15241;8.80;0.54;249.61;18.29;746;105;5237.00;198
14298;105;628413168;14298;265;15045;15244;8.74;0.53;249.60;18.29;747;105;5238.00;199
14300;106;628413177;14300;264;15046;15244;8.69;0.53;249.59;18.31;746;106;5239.00;198
14300;106;628413207;14300;267;15048;15244;8.70;0.53;249.59;18.32;748;106;5240.00;196
14302;106;628413222;14302;269;15049;15244;8.69;0.53;249.63;18.34;747;106;5241.00;195
14303;106;628413231;14303;265;15054;15250;8.74;0.53;249.63;18.35;751;106;5242.00;196
14303;106;628413241;14303;266;15055;15250;8.68;0.53;249.63;18.36;752;106;5243.00;195
14303;106;628413250;14303;267;15057;15250;8.67;0.53;249.63;18.37;754;106;5244.00;193
14305;106;628413265;14305;261;15059;15250;8.54;0.52;249.60;18.40;754;106;5245.00;191
14306;106;628413274;14306;263;15064;15254;8.43;0.51;249.60;18.42;758;106;5246.00;190
14307;106;628413284;14307;262;15065;15255;8.35;0.51;249.58;18.42;758;106;5247.00;190
14308;106;628413294;14308;267;15067;15255;8.28;0.50;249.58;18.45;759;106;5248.00;188
14310;106;628413303;14310;265;15068;15256;8.30;0.51;249.56;18.45;758;106;5249.00;188
14310;106;628413313;14310;267;15070;15256;8.19;0.50;249.56;18.47;760;106;5250.00;186
14312;106;628413323;14312;262;15071;15256;8.18;0.50;249.57;18.48;759;106;5251.00;185
14314;106;628413332;14314;260;15072;15256;8.14;0.50;249.55;18.50;758;106;5252.00;184
14316;106;628413341;14316;259;15072;15256;8.13;0.50;249.54;18.50;756;106;5253.00;184
14317;106;628413356;14317;258;15074;15256;8.10;0.49;249.53;18.52;757;106;5254.00;182
14318;106;628413365;14318;258;15074;15256;8.15;0.50;249.53;18.52;756;106;5255.00;182
14320;106;628413374;14320;255;15109;15326;8.28;0.51;249.55;18.48;789;106;5256.00;217
14323;106;628413389;14323;254;15111;15327;8.22;0.50;249.54;18.50;788;106;5257.00;216
14324;106;628413398;14324;251;15122;15327;8.27;0.51;249.55;18.50;798;106;5258.00;205
14327;106;628413407;14327;255;15130;15327;8.17;0.50;249.53;18.50;803;106;5259.00;197
14329;106;628413417;14329;252;15135;15327;8.14;0.50;249.56;18.49;806;106;5260.00;192
14333;106;628413426;14333;258;15135;15327;8.06;0.49;249.56;18.49;802;106;5261.00;192
14336;106;628413435;14336;259;15139;15327;7.99;0.49;249.54;18.49;803;106;5262.00;188
14340;106;628413445;14340;268;15145;15327;7.96;0.49;249.56;18.52;805;106;5263.00;182
14345;106;628413454;14345;270;15147;15328;7.91;0.49;249.61;18.51;802;106;5264.00;181
14347;106;628413464;14347;268;15152;15330;7.83;0.48;249.61;18.54;805;106;5265.00;178
14352;106;628413475;14352;266;15153;15330;7.69;0.47;249.63;18.54;801;106;5266.00;177
14355;106;628413485;14355;266;15157;15334;7.52;0.46;249.61;18.54;802;106;5267.00;177
14358;106;628413495;14358;277;15158;15334;7.38;0.45;249.64;18.55;800;106;5268.00;176
14365;106;628413505;14365;278;15158;15334;7.19;0.44;249.61;18.55;793;106;5269.00;176
14371;106;628413515;14371;272;15159;15334;7.17;0.44;249.63;18.56;788;106;5270.00;175
14377;106;628413525;14377;267;15164;15340;7.19;0.44;249.63;18.56;787;106;5271.00;176
14380;106;628413536;14380;264;15164;15340;7.26;0.44;249.62;18.56;784;106;5272.00;176
14384;106;628413546;14384;259;15164;15340;7.34;0.45;249.63;18.56;780;106;5273.00;176
14389;106;628413556;14389;258;15168;15343;7.38;0.45;249.62;18.57;779;106;5274.00;175
14391;106;628413566;14391;262;15168;15343;7.45;0.46;249.63;18.57;777;106;5275.00;175
14395;106;628413576;14395;257;15169;15343;7.44;0.45;249.64;18.58;774;106;5276.00;174
14401;106;628413586;14401;249;15171;15344;7.51;0.46;249.63;18.58;770;106;5277.00;173
14407;106;628413597;14407;243;15172;15345;7.59;0.46;249.61;18.58;765;106;5278.00;173
14411;106;628413607;14411;232;15172;15345;7.71;0.47;249.65;18.58;761;106;5279.00;173
14414;106;628413619;14414;229;15190;15371;7.75;0.47;249.65;18.55;776;106;5280.00;181
14417;106;628413631;14417;225;15192;15371;7.87;0.48;249.66;18.55;775;106;5281.00;179
14419;106;628413642;14419;224;15194;15371;7.99;0.49;249.67;18.55;775;106;5282.00;177
14422;106;628413652;14422;217;15195;15372;8.05;0.49;249.68;18.55;773;106;5283.00;177
14427;106;628413663;14427;214;15195;15372;8.15;0.50;249.71;18.55;768;106;5284.00;177
14429;106;628413673;14429;212;15198;15376;8.24;0.50;249.70;18.54;769;106;5285.00;178
14434;106;628413684;14434;208;15199;15376;8.33;0.51;249.67;18.54;765;106;5286.00;177
14437;106;628413695;14437;214;15202;15379;8.36;0.51;249.68;18.54;765;106;5287.00;177
14441;106;628413705;14441;213;15202;15380;8.44;0.52;249.69;18.54;761;106;5288.00;178
14447;106;628413715;14447;208;15202;15380;8.45;0.52;249.70;18.54;755;106;5289.00;178
14449;106;628413726;14449;206;15202;15380;8.51;0.52;249.70;18.54;753;106;5290.00;178
14458;106;628413738;14458;203;15202;15380;8.48;0.52;249.68;18.54;744;106;5291.00;178
14460;106;628413754;14460;204;15211;15392;8.64;0.53;249.68;18.53;751;106;5292.00;181
14463;106;628413772;14463;204;15211;15392;8.72;0.53;249.68;18.53;748;106;5293.00;181
14469;106;628413789;14469;200;15213;15392;8.77;0.54;249.68;18.53;744;106;5294.00;179
14474;106;628413806;14474;204;15213;15392;8.85;0.54;249.67;18.53;739;106;5295.00;179
14478;106;628413823;14478;201;15213;15392;8.94;0.55;249.73;18.53;735;106;5296.00;179
14483;106;628413839;14483;201;15213;15392;9.01;0.55;249.75;18.53;730;106;5297.00;179
14490;106;628413860;14490;198;15213;15393;9.06;0.55;249.78;18.53;723;106;5298.00;180
14492;106;628413871;14492;206;15213;15393;9.11;0.56;249.80;18.53;721;106;5299.00;180
14498;106;628413884;14498;210;15217;15399;9.20;0.56;249.82;18.52;719;106;5300.00;182
14500;106;628413901;14500;207;15218;15400;9.31;0.57;249.82;18.52;718;106;5301.00;182
14505;106;628413913;14505;208;15219;15400;9.33;0.57;249.82;18.52;714;106;5302.00;181
14510;106;628413925;14510;208;15219;15400;9.35;0.57;249.83;18.52;709;106;5303.00;181
14514;106;628413937;14514;210;15222;15404;9.46;0.58;249.88;18.52;708;106;5304.00;182
14520;106;628413949;14520;205;15222;15404;9.46;0.58;249.88;18.52;702;106;5305.00;182
14523;106;628413962;14523;206;15222;15404;9.53;0.58;249.91;18.52;699;106;5306.00;182
14526;106;628413973;14526;212;15223;15405;9.61;0.59;249.89;18.52;697;106;5307.00;182
14529;106;628413984;14529;211;15226;15409;9.67;0.59;249.88;18.51;697;106;5308.00;183
14533;106;628413996;14533;212;15226;15409;9.69;0.59;249.89;18.51;693;106;5309.00;183
14537;106;628414008;14537;210;15229;15415;9.66;0.59;249.92;18.51;692;106;5310.00;186
14542;106;628414020;14542;207;15230;15415;9.64;0.59;249.93;18.51;688;106;5311.00;185
14544;106;628414032;14544;204;15230;15415;9.67;0.59;249.95;18.51;686;106;5312.00;185
14549;106;628414044;14549;208;15231;15415;9.68;0.59;249.95;18.51;682;106;5313.00;184
14552;106;628414055;14552;209;15233;15419;9.71;0.59;249.97;18.50;681;106;5314.00;186
14554;106;628414067;14554;215;15234;15419;9.67;0.59;249.97;18.50;680;106;5315.00;185
14556;106;628414078;14556;219;15234;15419;9.69;0.59;249.97;18.50;678;106;5316.00;185
14562;106;628414089;14562;212;15235;15419;9.66;0.59;249.98;18.50;673;106;5317.00;184
14565;106;628414100;14565;212;15235;15420;9.73;0.59;249.99;18.50;670;106;5318.00;185
14568;106;628414111;14568;208;15237;15421;9.73;0.59;249.99;18.50;669;106;5319.00;184
14571;106;628414122;14571;208;15237;15421;9.75;0.59;250.00;18.50;666;106;5320.00;184
14573;106;628414132;14573;214;15238;15422;9.72;0.59;250.01;18.50;665;106;5321.00;184
14576;106;628414144;14576;212;15238;15422;9.72;0.59;250.02;18.50;662;106;5322.00;184
14581;106;628414155;14581;213;15238;15422;9.62;0.58;250.06;18.50;657;106;5323.00;184
14585;106;628414173;14585;213;15238;15422;9.63;0.58;250.05;18.50;653;106;5324.00;184
14589;106;628414184;14589;213;15238;15422;9.54;0.58;250.07;18.50;649;106;5325.00;184
14592;107;628414195;14592;200;15238;15422;9.46;0.57;250.10;18.50;646;107;5326.00;184
14594;107;628414226;14594;187;15238;15422;9.42;0.57;250.10;18.50;644;107;5327.00;184
14597;107;628414241;14597;199;15306;15549;9.32;0.57;250.11;18.42;709;107;5328.00;243
14598;107;628414263;14598;178;15308;15550;9.37;0.58;250.12;18.41;710;107;5329.00;242
14599;107;628414276;14599;163;15315;15550;9.51;0.59;250.13;18.41;716;107;5330.00;235
14602;107;628414287;14602;155;15319;15550;9.64;0.59;250.13;18.40;717;107;5331.00;231
14606;107;628414298;14606;149;15322;15550;9.79;0.60;250.15;18.40;716;107;5332.00;228
14608;107;628414309;14608;150;15326;15550;9.97;0.61;250.14;18.40;718;107;5333.00;224
14613;107;628414321;14613;149;15330;15550;10.08;0.62;250.18;18.39;717;107;5334.00;220
14616;107;628414333;14616;148;15332;15550;10.17;0.63;250.19;18.39;716;107;5335.00;218
14617;107;628414351;14617;143;15338;15551;10.18;0.63;250.21;18.39;721;107;5336.00;213
14622;107;628414363;14622;139;15341;15552;10.21;0.63;250.22;18.39;719;107;5337.00;211
14624;108;628414381;14624;143;15344;15552;10.16;0.62;250.24;18.38;720;108;5338.00;208
14626;108;628414405;14626;147;15347;15553;10.09;0.62;250.22;18.38;721;108;5339.00;206
14630;108;628414418;14630;151;15349;15553;10.09;0.62;250.22;18.38;719;108;5340.00;204
14634;108;628414429;14634;152;15350;15553;10.03;0.62;250.22;18.38;716;108;5341.00;203
14637;108;628414441;14637;153;15353;15553;9.99;0.61;250.23;18.38;716;108;5342.00;200
14640;108;628414452;14640;157;15356;15557;9.95;0.61;250.20;18.38;716;108;5343.00;201
14642;108;628414463;14642;157;15358;15557;9.96;0.61;250.20;18.38;716;108;5344.00;199
14643;108;628414475;14643;162;15359;15557;10.07;0.62;250.18;18.38;716;108;5345.00;198
14647;108;628414485;14647;170;15362;15560;10.15;0.62;250.22;18.37;715;108;5346.00;198
14647;108;628414497;14647;175;15363;15560;10.13;0.62;250.22;18.37;716;108;5347.00;197
14649;108;628414514;14649;177;15364;15560;10.20;0.63;250.26;18.37;715;108;5348.00;196
14651;108;628414524;14651;183;15367;15564;10.17;0.62;250.25;18.37;716;108;5349.00;197
14654;108;628414535;14654;182;15369;15565;10.19;0.62;250.27;18.37;715;108;5350.00;196
14655;108;628414546;14655;186;15369;15565;10.22;0.63;250.26;18.37;714;108;5351.00;196
14656;108;628414556;14656;189;15372;15569;10.20;0.62;250.26;18.36;716;108;5352.00;197
14657;108;628414567;14657;187;15372;15569;10.27;0.63;250.27;18.36;715;108;5353.00;197
14658;108;628414576;14658;187;15372;15569;10.35;0.63;250.25;18.36;714;108;5354.00;197
14660;108;628414587;14660;194;15374;15571;10.35;0.63;250.25;18.36;714;108;5355.00;197
14664;108;628414598;14664;197;15374;15571;10.33;0.63;250.23;18.36;710;108;5356.00;197
14664;108;628414608;14664;198;15378;15577;10.29;0.63;250.23;18.36;714;108;5357.00;199
14668;109;628414618;14668;200;15378;15577;10.28;0.63;250.20;18.36;710;109;5358.00;199
14671;109;628414647;14671;204;15379;15577;10.26;0.62;250.18;18.36;708;109;5359.00;198
14674;109;628414657;14674;206;15379;15578;10.29;0.63;250.23;18.36;705;109;5360.00;199
14676;109;628414666;14676;211;15379;15578;10.34;0.63;250.21;18.36;703;109;5361.00;199
14677;109;628414676;14677;210;15379;15578;10.37;0.63;250.20;18.36;702;109;5362.00;199
14679;109;628414686;14679;206;15379;15578;10.38;0.63;250.19;18.36;700;109;5363.00;199
14680;109;628414695;14680;210;15388;15590;10.39;0.63;250.18;18.34;708;109;5364.00;202
14682;109;628414706;14682;210;15388;15590;10.38;0.63;250.17;18.34;706;109;5365.00;202
14684;109;628414716;14684;211;15390;15590;10.38;0.63;250.16;18.34;706;109;5366.00;200
14685;109;628414726;14685;213;15390;15590;10.45;0.63;250.15;18.34;705;109;5367.00;200
14690;109;628414736;14690;212;15391;15590;10.41;0.63;250.11;18.48;701;109;5368.00;199
14695;109;628414747;14695;208;15391;15590;10.43;0.63;250.09;18.48;696;109;5369.00;199
14697;109;628414761;14697;203;15394;15594;10.41;0.63;250.09;18.48;697;109;5370.00;200
14698;110;628414772;14698;202;15394;15594;10.39;0.63;250.09;18.48;696;110;5371.00;200
14700;110;628414789;14700;198;15397;15598;10.44;0.63;250.09;18.47;697;110;5372.00;201
14701;110;628414802;14701;197;15398;15599;10.50;0.64;250.07;18.47;697;110;5373.00;201
14704;110;628414811;14704;191;15399;15599;10.53;0.64;250.04;18.47;695;110;5374.00;200
14708;110;628414825;14708;190;15400;15599;10.57;0.64;250.07;18.48;692;110;5375.00;199
14710;110;628414835;14710;188;15410;15612;10.56;0.64;250.06;18.47;700;110;5376.00;202
14715;110;628414846;14715;190;15410;15612;10.59;0.64;250.03;18.47;695;110;5377.00;202
14716;110;628414855;14716;180;15411;15612;10.69;0.65;250.02;18.47;695;110;5378.00;201
14719;110;628414864;14719;183;15412;15613;10.73;0.65;250.02;18.47;693;110;5379.00;201
14722;110;628414873;14722;185;15412;15614;10.77;0.65;249.98;18.47;690;110;5380.00;202
14724;110;628414882;14724;188;15412;15614;10.84;0.66;249.96;18.47;688;110;5381.00;202
14725;110;628414891;14725;192;15415;15617;10.80;0.65;249.95;18.61;690;110;5382.00;202
14727;110;628414901;14727;195;15416;15617;10.75;0.65;249.98;18.60;689;110;5383.00;201
14729;110;628414909;14729;201;15416;15617;10.75;0.65;249.98;18.60;687;110;5384.00;201
14729;110;628414918;14729;203;15416;15617;10.77;0.65;249.98;18.60;687;110;5385.00;201
14731;110;628414927;14731;208;15421;15623;10.77;0.65;249.97;18.74;690;110;5386.00;202
14732;110;628414936;14732;195;15421;15623;10.66;0.65;249.97;18.74;689;110;5387.00;202
14732;110;628414950;14732;186;15422;15623;10.62;0.64;249.97;18.74;690;110;5388.00;201
14732;110;628414960;14732;175;15422;15623;10.49;0.64;249.97;18.74;690;110;5389.00;201
14733;110;628414970;14733;170;15425;15627;10.38;0.63;249.96;18.73;692;110;5390.00;202
14735;110;628414980;14735;161;15426;15628;10.42;0.63;249.95;18.73;691;110;5391.00;202
14736;110;628414990;14736;160;15426;15628;10.40;0.63;249.95;18.73;690;110;5392.00;202
14736;110;628414999;14736;157;15427;15629;10.47;0.64;249.95;18.73;691;110;5393.00;202
14738;110;628415008;14738;148;15427;15629;10.54;0.64;249.94;18.73;689;110;5394.00;202
14740;110;628415018;14740;147;15427;15629;10.57;0.64;249.93;18.73;687;110;5395.00;202
14744;110;628415027;14744;145;15428;15629;10.58;0.64;249.93;18.75;684;110;5396.00;201
14746;110;628415043;14746;147;15428;15629;10.59;0.64;249.94;18.75;682;110;5397.00;201
14747;110;628415053;14747;151;15428;15629;10.67;0.65;249.98;18.75;681;110;5398.00;201
14747;110;628415062;14747;150;15431;15629;10.66;0.65;249.98;18.79;684;110;5399.00;198
