step_arrived;step_collisions;step_duration;step_ended;step_halting;step_inserted;step_loaded;step_meanSpeed;step_meanSpeedRelative;step_meanTravelTime;step_meanWaitingTime;step_running;step_teleports;step_time;step_waiting
0;0;628479881;0;1;85;245;16.20;1.14;-1.00;0.00;85;0;0.00;160
0;0;628479921;0;1;97;245;15.43;1.07;-1.00;0.12;97;0;1.00;148
0;0;628479923;0;0;113;245;14.78;1.01;-1.00;0.39;113;0;2.00;132
0;0;628479925;0;3;129;245;13.64;0.92;-1.00;0.71;129;0;3.00;116
0;0;628479926;0;2;143;245;12.58;0.85;-1.00;1.03;143;0;4.00;102
0;0;628479928;0;7;150;245;11.74;0.79;-1.00;1.22;150;0;5.00;95
0;0;628479930;0;5;161;245;11.15;0.75;-1.00;1.55;161;0;6.00;84
0;0;628479932;0;11;167;245;10.76;0.72;-1.00;1.74;167;0;7.00;78
0;0;628479934;0;17;173;246;10.33;0.69;-1.00;1.96;173;0;8.00;73
0;0;628479937;0;16;179;247;10.00;0.66;-1.00;2.20;179;0;9.00;68
0;0;628479940;0;20;185;247;9.69;0.64;-1.00;2.45;185;0;10.00;62
0;0;628479942;0;24;193;248;9.46;0.62;-1.00;2.75;193;0;11.00;55
1;0;628479944;1;26;198;248;9.14;0.60;12.00;2.98;197;0;12.00;50
1;0;628479947;1;33;203;248;9.01;0.59;12.00;3.23;202;0;13.00;45
1;0;628479949;1;35;208;248;8.94;0.58;12.00;3.49;207;0;14.00;40
1;0;628479952;1;39;214;252;8.92;0.58;12.00;3.75;213;0;15.00;38
1;0;628479955;1;43;219;252;8.93;0.57;12.00;4.00;218;0;16.00;33
1;0;628479958;1;49;222;252;8.95;0.57;12.00;4.11;221;0;17.00;30
1;0;628479961;1;57;226;255;8.93;0.57;12.00;4.27;225;0;18.00;29
1;0;628479964;1;59;227;255;9.07;0.58;12.00;4.34;226;0;19.00;28
2;0;628479968;2;62;228;255;9.12;0.57;16.00;4.41;226;0;20.00;27
2;0;628479971;2;64;235;259;9.18;0.58;16.00;4.56;233;0;21.00;24
5;0;628479975;5;68;237;260;9.12;0.57;19.60;4.62;232;0;22.00;23
5;0;628479978;5;69;243;260;9.00;0.56;19.60;5.04;238;0;23.00;17
6;0;628479982;6;71;246;264;9.03;0.56;20.00;4.98;240;0;24.00;18
6;0;628479986;6;74;248;264;9.06;0.57;20.00;5.14;242;0;25.00;16
6;0;628479991;6;76;249;264;9.11;0.57;20.00;5.15;243;0;26.00;15
6;0;628479995;6;78;250;265;9.14;0.57;20.00;5.24;244;0;27.00;15
6;0;628479998;6;83;254;265;9.08;0.56;20.00;5.49;248;0;28.00;11
6;0;628480001;6;86;259;271;9.00;0.56;20.00;5.51;253;0;29.00;12
6;0;628480007;6;90;259;271;8.91;0.55;20.00;5.51;253;0;30.00;12
7;0;628480010;7;93;261;272;8.78;0.54;21.14;5.59;254;0;31.00;11
7;0;628480014;7;99;262;272;8.60;0.53;21.14;5.60;255;0;32.00;10
8;0;628480017;8;99;263;272;8.52;0.52;22.63;5.70;255;0;33.00;9
10;0;628480020;10;104;263;272;8.47;0.52;24.00;5.70;253;0;34.00;9
10;0;628480023;10;106;264;272;8.53;0.53;24.00;5.76;254;0;35.00;8
10;0;628480026;10;111;276;284;8.75;0.54;24.00;5.59;266;0;36.00;8
10;0;628480031;10;116;277;284;8.65;0.54;24.00;5.64;267;0;37.00;7
10;0;628480034;10;120;278;284;8.65;0.54;24.00;5.65;268;0;38.00;6
11;0;628480037;11;123;278;284;8.47;0.52;24.91;5.65;267;0;39.00;6
11;0;628480041;11;126;279;284;8.34;0.52;24.91;5.68;268;0;40.00;5
13;0;628480044;13;128;279;284;8.20;0.51;27.15;5.68;266;0;41.00;5
13;0;628480047;13;132;283;288;8.31;0.51;27.15;5.61;270;0;42.00;5
14;0;628480051;14;136;284;288;8.14;0.50;26.79;5.62;270;0;43.00;4
14;0;628480053;14;138;287;292;8.08;0.50;26.79;5.57;273;0;44.00;5
15;0;628480057;15;141;290;294;7.97;0.49;28.00;5.52;275;0;45.00;4
18;0;628480060;18;142;290;294;7.66;0.47;30.22;5.52;272;0;46.00;4
18;0;628480063;18;141;290;294;7.56;0.47;30.22;5.52;272;0;47.00;4
19;0;628480066;19;145;302;307;7.83;0.48;30.79;5.30;283;0;48.00;5
20;0;628480070;20;144;302;307;7.71;0.48;31.70;5.30;282;0;49.00;5
20;0;628480074;20;146;302;307;7.68;0.48;31.70;5.30;282;0;50.00;5
20;0;628480077;20;147;303;308;7.67;0.48;31.70;5.28;283;0;51.00;5
20;0;628480080;20;149;304;309;7.65;0.48;31.70;5.27;284;0;52.00;5
22;0;628480082;22;152;304;309;7.55;0.47;31.95;5.27;282;0;53.00;5
22;0;628480086;22;153;306;312;7.60;0.47;31.95;5.24;284;0;54.00;6
22;0;628480089;22;154;306;312;7.51;0.47;31.95;5.24;284;0;55.00;6
22;0;628480093;22;143;307;312;7.53;0.47;31.95;5.22;285;0;56.00;5
24;0;628480096;24;138;307;312;7.44;0.46;33.08;5.22;283;0;57.00;5
25;0;628480099;25;138;312;318;7.47;0.46;34.00;5.16;287;0;58.00;6
25;0;628480103;25;139;312;318;7.51;0.46;34.00;5.16;287;0;59.00;6
25;0;628480109;25;142;313;318;7.65;0.47;34.00;5.15;288;0;60.00;5
26;0;628480112;26;144;313;318;7.75;0.48;33.96;5.15;287;0;61.00;5
28;0;628480118;28;145;317;322;7.79;0.48;35.82;5.10;289;0;62.00;5
30;0;628480122;30;147;318;323;7.90;0.48;36.23;5.08;288;0;63.00;5
30;0;628480125;30;148;318;323;7.94;0.49;36.23;5.08;288;0;64.00;5
30;0;628480129;30;148;319;324;8.00;0.49;36.23;5.07;289;0;65.00;5
31;0;628480132;31;152;319;324;7.97;0.49;37.19;5.07;288;0;66.00;5
31;0;628480135;31;141;319;324;8.06;0.49;37.19;5.07;288;0;67.00;5
32;0;628480139;32;136;319;324;8.17;0.50;38.16;5.07;287;0;68.00;5
33;0;628480142;33;135;319;324;8.23;0.50;39.09;5.07;286;0;69.00;5
33;0;628480145;33;132;319;324;8.37;0.51;39.09;5.07;286;0;70.00;5
33;0;628480148;33;127;319;324;8.53;0.52;39.09;5.07;286;0;71.00;5
33;0;628480151;33;134;356;394;8.66;0.53;39.09;4.54;323;0;72.00;38
34;0;628480160;34;126;357;395;8.77;0.54;39.91;4.53;323;0;73.00;38
34;0;628480170;34;118;363;395;9.15;0.56;39.91;4.49;329;0;74.00;32
35;0;628480174;35;115;368;395;9.47;0.58;40.71;4.47;333;0;75.00;27
35;0;628480178;35;112;372;395;9.78;0.60;40.71;4.47;337;0;76.00;23
37;1;628480182;37;109;375;395;9.98;0.61;42.11;4.47;338;1;77.00;20
38;1;628480204;38;107;378;395;10.15;0.62;43.05;4.48;340;1;78.00;17
38;2;628480207;38;109;378;395;10.14;0.62;43.05;4.48;340;2;79.00;17
38;2;628480231;38;111;380;396;10.18;0.62;43.05;4.48;342;2;80.00;16
39;2;628480235;39;111;381;397;10.20;0.62;44.03;4.47;342;2;81.00;16
40;2;628480240;40;110;382;397;10.19;0.62;44.55;4.48;342;2;82.00;15
40;2;628480244;40;113;386;401;10.02;0.61;44.55;4.45;346;2;83.00;15
42;2;628480248;42;117;386;401;9.96;0.60;46.12;4.45;344;2;84.00;15
42;2;628480252;42;119;386;401;9.89;0.60;46.12;4.45;344;2;85.00;15
42;2;628480256;42;121;386;401;9.75;0.59;46.12;4.45;344;2;86.00;15
43;2;628480260;43;119;390;407;9.59;0.59;47.07;4.41;347;2;87.00;17
43;2;628480265;43;123;390;407;9.46;0.58;47.07;4.41;347;2;88.00;17
44;2;628480268;44;123;391;407;9.37;0.57;47.93;4.41;347;2;89.00;16
45;2;628480274;45;127;394;413;9.35;0.57;48.87;4.38;349;2;90.00;19
46;2;628480278;46;130;395;413;9.44;0.57;49.78;4.37;349;2;91.00;18
49;2;628480282;49;133;395;413;9.37;0.57;52.37;4.37;346;2;92.00;18
52;2;628480286;52;134;397;414;9.30;0.57;54.69;4.36;345;2;93.00;17
53;2;628480290;53;138;398;415;9.34;0.57;55.43;4.35;345;2;94.00;17
53;2;628480294;53;136;399;415;9.39;0.58;55.43;4.35;346;2;95.00;16
56;2;628480298;56;138;409;428;9.34;0.57;56.23;4.24;353;2;96.00;19
57;2;628480303;57;138;410;428;9.44;0.58;56.84;4.23;353;2;97.00;18
58;2;628480307;58;140;410;428;9.52;0.58;57.55;4.23;352;2;98.00;18
62;2;628480311;62;136;411;429;9.56;0.58;60.19;4.22;349;2;99.00;18
62;2;628480317;62;135;411;429;9.64;0.59;60.19;4.22;349;2;100.00;18
63;2;628480325;63;130;413;433;9.72;0.59;60.84;4.21;350;2;101.00;20
64;2;628480330;64;124;413;433;9.75;0.59;61.48;4.21;349;2;102.00;20
64;3;628480334;64;118;418;437;9.72;0.59;61.48;4.17;354;3;103.00;19
65;3;628480351;65;112;419;437;9.75;0.59;61.82;4.24;354;3;104.00;18
66;3;628480356;66;111;419;437;9.80;0.60;62.45;4.24;353;3;105.00;18
67;3;628480367;67;104;419;437;9.91;0.60;63.10;4.24;352;3;106.00;18
67;3;628480372;67;98;419;437;10.04;0.61;63.10;4.24;352;3;107.00;18
67;3;628480376;67;92;430;449;10.27;0.63;63.10;4.13;363;3;108.00;19
69;3;628480382;69;90;431;449;10.44;0.64;64.39;4.13;362;3;109.00;18
69;3;628480387;69;83;431;449;10.65;0.65;64.39;4.13;362;3;110.00;18
70;3;628480393;70;79;431;449;10.78;0.66;65.03;4.13;361;3;111.00;18
71;3;628480399;71;72;431;449;10.92;0.66;65.66;4.13;360;3;112.00;18
71;3;628480404;71;72;431;449;11.10;0.68;65.66;4.13;360;3;113.00;18
71;3;628480409;71;68;432;450;11.27;0.69;65.66;4.12;361;3;114.00;18
71;3;628480414;71;68;432;450;11.32;0.69;65.66;4.12;361;3;115.00;18
71;3;628480420;71;66;436;456;11.43;0.70;65.66;4.09;365;3;116.00;20
71;3;628480426;71;68;439;457;11.52;0.70;65.66;4.33;368;3;117.00;18
72;3;628480432;72;70;439;457;11.52;0.70;66.36;4.33;367;3;118.00;18
74;3;628480439;74;71;439;457;11.40;0.69;67.77;4.33;365;3;119.00;18
75;3;628480453;75;73;446;462;11.41;0.70;68.45;4.75;371;3;120.00;16
77;3;628480459;77;75;446;462;11.45;0.70;69.17;4.75;369;3;121.00;16
78;3;628480466;78;76;448;462;11.47;0.70;69.85;4.95;370;3;122.00;14
78;3;628480473;78;77;450;463;11.52;0.70;69.85;5.20;372;3;123.00;13
79;3;628480479;79;81;455;467;11.46;0.70;70.27;5.27;376;3;124.00;12
81;3;628480486;81;82;457;467;11.54;0.71;71.53;5.64;376;3;125.00;10
81;3;628480493;81;82;459;470;11.61;0.71;71.53;5.61;378;3;126.00;11
83;3;628480500;83;85;463;470;11.59;0.71;72.42;5.94;380;3;127.00;7
84;3;628480507;84;88;466;470;11.54;0.71;72.65;6.11;382;3;128.00;4
86;3;628480513;86;91;466;470;11.55;0.70;72.86;6.11;380;3;129.00;4
86;3;628480519;86;93;468;474;11.66;0.71;72.86;6.09;382;3;130.00;6
88;3;628480526;88;94;470;474;11.59;0.71;74.16;6.20;382;3;131.00;4
90;3;628480532;90;94;471;474;11.70;0.72;75.21;6.19;381;3;132.00;3
92;3;628480538;92;97;472;474;11.74;0.72;76.21;6.25;380;3;133.00;2
94;3;628480545;94;98;473;475;11.75;0.72;77.40;6.24;379;3;134.00;2
97;3;628480551;97;100;476;477;11.67;0.71;77.62;6.29;379;3;135.00;1
97;3;628480558;97;102;476;477;11.62;0.71;77.62;6.29;379;3;136.00;1
98;3;628480564;98;104;478;478;11.61;0.71;78.16;6.30;380;3;137.00;0
99;3;628480569;99;108;478;478;11.57;0.71;78.62;6.30;379;3;138.00;0
99;3;628480575;99;109;478;478;11.54;0.71;78.62;6.30;379;3;139.00;0
103;3;628480581;103;109;478;478;11.48;0.70;79.89;6.30;375;3;140.00;0
105;3;628480587;105;110;478;478;11.33;0.70;81.06;6.30;373;3;141.00;0
109;3;628480594;109;111;478;478;11.25;0.69;81.94;6.30;369;3;142.00;0
110;3;628480600;110;113;478;478;11.19;0.69;82.43;6.30;368;3;143.00;0
112;3;628480606;112;136;552;605;10.81;0.68;83.49;5.46;440;3;144.00;53
113;3;628480626;113;130;558;606;10.80;0.68;83.40;5.41;445;3;145.00;48
113;3;628480635;113;124;567;606;10.78;0.68;83.40;5.36;454;3;146.00;39
114;3;628480644;114;127;569;606;10.77;0.68;83.91;5.35;455;3;147.00;37
116;3;628480652;116;127;575;606;10.86;0.68;84.96;5.33;459;3;148.00;31
118;3;628480661;118;123;576;606;10.84;0.68;85.64;5.33;458;3;149.00;30
118;3;628480673;118;123;580;611;10.81;0.68;85.64;5.33;462;3;150.00;31
121;3;628480685;121;119;583;611;10.86;0.68;86.21;5.34;462;3;151.00;28
121;3;628480692;121;120;586;612;11.07;0.69;86.21;5.35;465;3;152.00;26
122;3;628480699;122;119;588;613;11.15;0.70;85.57;5.36;466;3;153.00;25
125;3;628480706;125;121;590;613;11.20;0.70;86.35;5.38;465;3;154.00;23
127;3;628480712;127;121;594;614;11.17;0.70;87.27;5.40;467;3;155.00;20
129;3;628480719;129;125;598;614;11.09;0.69;88.19;5.43;469;3;156.00;16
131;3;628480726;131;125;600;614;11.04;0.69;88.15;5.46;469;3;157.00;14
132;3;628480732;132;129;604;614;11.01;0.69;88.48;5.50;472;3;158.00;10
137;3;628480740;137;135;607;618;10.91;0.68;89.42;5.50;470;3;159.00;11
138;3;628480746;138;143;609;618;10.81;0.67;89.62;5.54;471;3;160.00;9
140;3;628480760;140;142;610;618;10.67;0.66;90.61;5.54;470;3;161.00;8
141;3;628480767;141;142;612;621;10.54;0.65;91.04;5.55;471;3;162.00;9
143;3;628480774;143;143;613;621;10.45;0.65;91.78;5.55;470;3;163.00;8
145;3;628480786;145;146;614;621;10.34;0.64;92.74;5.56;469;3;164.00;7
146;3;628480793;146;146;617;625;10.22;0.63;93.24;5.54;471;3;165.00;8
147;3;628480800;147;144;618;626;10.20;0.63;93.23;5.53;471;3;166.00;8
150;3;628480807;150;142;618;626;10.14;0.63;93.25;5.53;468;3;167.00;8
153;3;628480814;153;142;623;630;10.06;0.62;93.99;5.52;470;3;168.00;7
157;3;628480822;157;146;625;630;9.93;0.61;95.10;5.55;468;3;169.00;5
160;3;628480828;160;139;625;630;9.88;0.61;95.44;5.55;465;3;170.00;5
162;3;628480835;162;134;627;631;9.81;0.60;96.17;5.57;465;3;171.00;4
163;3;628480848;163;131;628;631;9.75;0.60;96.34;5.58;465;3;172.00;3
163;3;628480854;163;129;633;637;9.70;0.60;96.34;5.57;470;3;173.00;4
164;3;628480860;164;128;634;637;9.70;0.60;96.77;5.58;470;3;174.00;3
165;3;628480867;165;120;636;638;9.65;0.59;97.16;5.57;471;3;175.00;2
167;3;628480874;167;120;637;638;9.55;0.59;97.82;5.60;470;3;176.00;1
169;3;628480879;169;120;637;638;9.57;0.59;97.95;5.60;468;3;177.00;1
169;3;628480886;169;118;638;638;9.65;0.59;97.95;5.60;469;3;178.00;0
169;3;628480892;169;113;638;638;9.67;0.59;97.95;5.60;469;3;179.00;0
170;3;628480899;170;125;669;672;9.68;0.60;98.39;5.34;499;3;180.00;3
170;3;628480908;170;122;670;672;9.66;0.60;98.39;5.34;500;3;181.00;2
171;3;628480914;171;119;671;672;9.71;0.60;98.76;5.33;500;3;182.00;1
172;3;628480920;172;125;671;672;9.79;0.61;98.74;5.33;499;3;183.00;1
173;3;628480926;173;129;672;672;9.80;0.61;99.24;5.33;499;3;184.00;0
175;3;628480935;175;131;672;672;9.74;0.60;99.51;5.33;497;3;185.00;0
179;3;628480943;179;137;676;676;9.66;0.59;100.26;5.30;497;3;186.00;0
179;3;628480950;179;141;676;676;9.57;0.59;100.26;5.30;497;3;187.00;0
180;3;628480956;180;147;679;680;9.46;0.58;100.75;5.28;499;3;188.00;1
182;3;628480963;182;152;680;681;9.30;0.58;100.85;5.28;498;3;189.00;1
184;3;628480971;184;162;681;681;9.20;0.57;101.23;5.27;497;3;190.00;0
188;3;628480977;188;167;681;681;9.04;0.56;101.29;5.27;493;3;191.00;0
191;3;628480984;191;175;694;694;9.02;0.56;101.57;5.17;503;3;192.00;0
194;3;628480997;194;184;694;694;8.82;0.54;101.44;5.17;500;3;193.00;0
196;3;628481003;196;185;694;694;8.74;0.54;101.77;5.17;498;3;194.00;0
200;3;628481010;200;190;695;695;8.62;0.53;102.47;5.17;495;3;195.00;0
200;3;628481017;200;190;696;696;8.54;0.53;102.47;5.16;496;3;196.00;0
203;3;628481023;203;190;696;696;8.48;0.52;102.21;5.16;493;3;197.00;0
207;3;628481030;207;193;698;699;8.43;0.52;101.51;5.15;491;3;198.00;1
208;3;628481037;208;198;699;699;8.33;0.51;101.17;5.14;491;3;199.00;0
210;3;628481050;210;204;699;699;8.26;0.51;101.05;5.14;489;3;200.00;0
212;3;628481060;212;204;699;699;8.19;0.50;101.04;5.14;487;3;201.00;0
214;3;628481068;214;204;704;705;8.09;0.49;100.95;5.11;490;3;202.00;1
215;3;628481075;215;212;704;705;7.99;0.49;101.42;5.11;489;3;203.00;1
215;3;628481081;215;218;705;705;7.95;0.49;101.42;5.11;490;3;204.00;0
218;3;628481087;218;219;705;705;7.83;0.48;100.58;5.11;487;3;205.00;0
218;3;628481094;218;228;709;709;7.87;0.48;100.58;5.09;491;3;206.00;0
219;3;628481100;219;231;710;710;7.77;0.48;100.41;5.08;491;3;207.00;0
220;3;628481112;220;239;710;710;7.68;0.47;100.86;5.08;490;3;208.00;0
221;3;628481119;221;243;711;711;7.57;0.46;100.59;5.07;490;3;209.00;0
221;3;628481127;221;246;711;711;7.45;0.46;100.59;5.07;490;3;210.00;0
221;3;628481133;221;249;711;711;7.43;0.46;100.59;5.07;490;3;211.00;0
222;3;628481139;222;255;711;711;7.38;0.45;101.09;5.07;489;3;212.00;0
223;3;628481144;223;257;711;711;7.29;0.45;100.73;5.07;488;3;213.00;0
226;3;628481151;226;262;711;711;7.18;0.44;100.76;5.07;485;3;214.00;0
227;3;628481157;227;262;711;711;7.12;0.44;100.84;5.07;484;3;215.00;0
227;3;628481163;227;277;753;781;7.34;0.46;100.84;4.79;526;3;216.00;28
228;3;628481176;228;259;755;782;7.37;0.46;101.32;4.78;527;3;217.00;27
231;3;628481183;231;248;763;782;7.53;0.47;102.41;4.75;532;3;218.00;19
231;4;628481196;231;229;765;782;7.65;0.47;102.41;4.75;534;4;219.00;17
232;4;628481214;232;214;770;782;7.97;0.49;102.73;4.74;538;4;220.00;12
235;4;628481221;235;205;773;782;8.14;0.50;103.33;4.74;538;4;221.00;9
236;4;628481228;236;199;779;782;8.42;0.52;103.83;4.75;543;4;222.00;3
237;4;628481235;237;193;780;782;8.54;0.52;103.99;4.76;543;4;223.00;2
237;4;628481242;237;184;782;783;8.70;0.53;103.99;4.75;545;4;224.00;1
240;4;628481251;240;181;784;785;8.69;0.53;105.04;4.74;544;4;225.00;1
240;4;628481264;240;161;785;785;8.82;0.54;105.04;4.75;545;4;226.00;0
242;4;628481272;242;152;789;789;8.93;0.55;106.02;4.73;547;4;227.00;0
245;4;628481281;245;140;789;789;9.14;0.56;106.81;4.73;544;4;228.00;0
248;4;628481294;248;131;789;789;9.33;0.57;106.73;4.73;541;4;229.00;0
249;4;628481303;249;124;789;789;9.57;0.59;106.65;4.73;540;4;230.00;0
252;4;628481317;252;115;794;795;9.80;0.60;107.20;4.71;542;4;231.00;1
254;4;628481326;254;110;794;795;10.08;0.62;107.59;4.71;540;4;232.00;1
254;4;628481334;254;103;795;795;10.33;0.63;107.59;4.70;541;4;233.00;0
255;4;628481341;255;95;797;798;10.59;0.65;107.44;4.69;542;4;234.00;1
256;4;628481349;256;91;798;798;10.85;0.66;107.93;4.69;542;4;235.00;0
257;4;628481357;257;87;798;798;11.03;0.67;108.39;4.69;541;4;236.00;0
261;4;628481364;261;85;799;799;11.09;0.67;109.79;4.68;538;4;237.00;0
262;4;628481372;262;86;800;800;11.26;0.68;110.11;4.68;538;4;238.00;0
263;4;628481379;263;85;800;800;11.33;0.69;109.78;4.68;537;4;239.00;0
268;4;628481389;268;94;824;826;11.22;0.68;111.00;4.54;556;4;240.00;2
269;4;628481399;269;90;825;826;11.34;0.69;111.21;4.54;556;4;241.00;1
270;4;628481407;270;87;826;826;11.49;0.70;111.16;4.54;556;4;242.00;0
271;4;628481414;271;89;827;827;11.66;0.71;111.64;4.53;556;4;243.00;0
273;4;628481422;273;90;827;827;11.78;0.72;112.08;4.53;554;4;244.00;0
276;4;628481429;276;91;830;831;11.85;0.72;112.82;4.52;554;4;245.00;1
279;4;628481443;279;94;830;831;11.87;0.72;113.72;4.52;551;4;246.00;1
281;4;628481451;281;92;835;835;11.84;0.72;114.07;4.50;554;4;247.00;0
284;4;628481458;284;96;835;835;11.88;0.72;114.47;4.50;551;4;248.00;0
288;4;628481466;288;94;835;835;11.96;0.73;114.60;4.50;547;4;249.00;0
290;4;628481474;290;96;835;835;12.06;0.74;115.49;4.50;545;4;250.00;0
291;4;628481481;291;96;835;835;12.18;0.74;115.59;4.50;544;4;251.00;0
295;4;628481489;295;94;846;847;12.15;0.74;116.31;4.44;551;4;252.00;1
295;4;628481497;295;95;846;847;12.25;0.75;116.31;4.44;551;4;253.00;1
298;4;628481504;298;95;847;847;12.29;0.75;116.90;4.44;549;4;254.00;0
301;4;628481512;301;97;847;847;12.29;0.75;117.27;4.44;546;4;255.00;0
302;4;628481520;302;100;847;847;12.31;0.75;117.25;4.44;545;4;256.00;0
304;4;628481528;304;103;847;847;12.31;0.75;117.06;4.44;543;4;257.00;0
307;4;628481535;307;106;848;848;12.23;0.74;117.92;4.43;541;4;258.00;0
307;4;628481543;307;106;848;848;12.29;0.75;117.92;4.43;541;4;259.00;0
309;4;628481554;309;110;853;854;12.20;0.74;118.06;4.41;544;4;260.00;1
311;4;628481562;311;108;854;855;12.26;0.74;118.44;4.41;543;4;261.00;1
313;4;628481569;313;109;855;855;12.28;0.74;118.67;4.41;542;4;262.00;0
316;4;628481577;316;111;855;855;12.30;0.74;119.14;4.41;539;4;263.00;0
317;4;628481584;317;113;859;859;12.23;0.74;119.03;4.39;542;4;264.00;0
318;4;628481592;318;116;859;859;12.22;0.74;119.26;4.39;541;4;265.00;0
318;4;628481599;318;116;859;859;12.23;0.74;119.26;4.39;541;4;266.00;0
319;4;628481606;319;117;860;860;12.28;0.74;119.45;4.38;541;4;267.00;0
323;4;628481613;323;120;864;864;12.18;0.73;120.10;4.37;541;4;268.00;0
327;4;628481620;327;117;864;864;12.09;0.73;120.42;4.37;537;4;269.00;0
329;4;628481629;329;111;867;870;12.10;0.73;120.88;4.35;538;4;270.00;3
332;4;628481637;332;109;867;870;12.12;0.74;121.58;4.35;535;4;271.00;3
334;4;628481643;334;103;868;870;12.15;0.74;121.84;4.35;534;4;272.00;2
336;4;628481651;336;98;868;870;12.22;0.74;122.15;4.35;532;4;273.00;2
342;4;628481658;342;96;871;874;12.29;0.75;123.52;4.34;529;4;274.00;3
342;4;628481666;342;93;871;874;12.38;0.75;123.52;4.34;529;4;275.00;3
345;4;628481673;345;88;872;874;12.45;0.76;124.13;4.34;527;4;276.00;2
350;4;628481680;350;85;872;874;12.45;0.76;124.81;4.34;522;4;277.00;2
354;4;628481688;354;82;874;875;12.51;0.76;125.41;4.34;520;4;278.00;1
355;4;628481695;355;79;875;876;12.54;0.76;125.44;4.33;520;4;279.00;1
356;4;628481702;356;78;876;876;12.64;0.77;125.84;4.34;520;4;280.00;0
358;4;628481710;358;71;877;877;12.68;0.77;125.60;4.33;519;4;281.00;0
360;4;628481718;360;70;877;877;12.70;0.77;125.47;4.33;517;4;282.00;0
361;4;628481726;361;71;877;877;12.79;0.78;125.66;4.33;516;4;283.00;0
363;4;628481734;363;76;877;877;12.75;0.77;125.44;4.33;514;4;284.00;0
364;4;628481742;364;77;877;877;12.77;0.77;125.83;4.33;513;4;285.00;0
365;4;628481750;365;75;877;877;12.78;0.78;125.67;4.33;512;4;286.00;0
366;4;628481757;366;77;877;877;12.78;0.78;125.61;4.33;511;4;287.00;0
366;4;628481764;366;97;947;1004;12.17;0.75;125.61;4.02;581;4;288.00;57
367;4;628481782;367;89;949;1005;12.12;0.75;125.46;4.01;582;4;289.00;56
368;4;628481790;368;84;953;1005;12.25;0.76;125.90;4.00;585;4;290.00;52
369;4;628481798;369;84;958;1005;12.29;0.76;126.02;4.00;589;4;291.00;47
369;4;628481806;369;84;962;1005;12.32;0.76;126.02;4.00;593;4;292.00;43
371;4;628481815;371;89;965;1005;12.33;0.76;126.58;4.00;594;4;293.00;40
374;4;628481825;374;90;971;1005;12.32;0.76;127.09;4.01;597;4;294.00;34
378;4;628481838;378;91;972;1005;12.41;0.76;127.23;4.01;594;4;295.00;33
379;4;628481853;379;96;976;1006;12.50;0.77;126.92;4.03;597;4;296.00;30
382;4;628481866;382;98;981;1007;12.55;0.77;127.52;4.06;599;4;297.00;26
382;4;628481883;382;103;986;1007;12.55;0.77;127.52;4.09;604;4;298.00;21
383;4;628481897;383;106;990;1008;12.44;0.77;127.34;4.11;607;4;299.00;18
385;4;628481915;385;110;994;1014;12.25;0.76;127.40;4.14;609;4;300.00;20
389;4;628481935;389;112;995;1014;12.07;0.74;127.95;4.15;606;4;301.00;19
391;4;628481947;391;118;998;1014;11.94;0.74;128.48;4.17;607;4;302.00;16
391;4;628481956;391;125;1002;1018;11.82;0.73;128.48;4.18;611;4;303.00;16
393;4;628481967;393;136;1004;1018;11.59;0.71;128.80;4.20;611;4;304.00;14
394;4;628481978;394;140;1004;1018;11.48;0.71;128.87;4.20;610;4;305.00;14
396;4;628481988;396;152;1009;1021;11.38;0.70;129.70;4.22;613;4;306.00;12
397;4;628481999;397;157;1009;1021;11.28;0.69;129.60;4.22;612;4;307.00;12
401;4;628482008;401;170;1011;1021;11.11;0.68;130.98;4.24;610;4;308.00;10
405;4;628482025;405;173;1015;1025;10.90;0.67;132.25;4.23;610;4;309.00;10
408;4;628482036;408;179;1016;1026;10.76;0.66;132.36;4.23;608;4;310.00;10
413;4;628482045;413;184;1016;1026;10.59;0.65;133.59;4.23;603;4;311.00;10
417;4;628482054;417;191;1020;1030;10.49;0.64;133.86;4.21;603;4;312.00;10
418;4;628482064;418;193;1020;1030;10.36;0.64;133.86;4.21;602;4;313.00;10
422;4;628482072;422;196;1021;1030;10.20;0.63;133.71;4.22;599;4;314.00;9
425;4;628482081;425;200;1024;1032;10.01;0.62;134.12;4.22;599;4;315.00;8
427;4;628482090;427;203;1024;1032;9.84;0.61;134.56;4.22;597;4;316.00;8
431;4;628482098;431;206;1028;1038;9.68;0.60;134.87;4.21;597;4;317.00;10
433;4;628482108;433;207;1028;1038;9.46;0.58;134.92;4.21;595;4;318.00;10
436;4;628482131;436;207;1029;1039;9.30;0.57;135.33;4.21;593;4;319.00;10
437;4;628482139;437;209;1032;1039;9.19;0.57;135.44;4.28;595;4;320.00;7
438;4;628482148;438;205;1032;1039;9.14;0.56;135.79;4.28;594;4;321.00;7
441;4;628482156;441;210;1032;1039;9.13;0.56;136.51;4.28;591;4;322.00;7
445;4;628482164;445;216;1033;1039;9.12;0.56;136.68;4.29;588;4;323.00;6
447;4;628482172;447;213;1047;1051;9.09;0.56;137.11;4.31;600;4;324.00;4
449;4;628482182;449;209;1048;1051;9.10;0.56;137.34;4.32;599;4;325.00;3
453;4;628482191;453;210;1049;1051;9.11;0.56;137.26;4.33;596;4;326.00;2
454;4;628482199;454;213;1050;1051;9.14;0.56;137.35;4.33;596;4;327.00;1
455;4;628482208;455;213;1050;1051;9.17;0.56;137.38;4.33;595;4;328.00;1
457;4;628482215;457;215;1051;1051;9.15;0.56;137.20;4.33;594;4;329.00;0
458;4;628482225;458;217;1055;1055;9.14;0.56;137.21;4.32;597;4;330.00;0
461;4;628482233;461;218;1055;1055;9.09;0.56;137.63;4.32;594;4;331.00;0
464;4;628482240;464;219;1059;1059;8.97;0.55;137.90;4.31;595;4;332.00;0
467;4;628482248;467;224;1060;1060;8.83;0.54;138.46;4.30;593;4;333.00;0
469;4;628482255;469;227;1060;1060;8.71;0.53;138.78;4.30;591;4;334.00;0
473;4;628482262;473;231;1060;1060;8.56;0.52;139.75;4.30;587;4;335.00;0
475;4;628482270;475;237;1073;1073;8.45;0.52;139.77;4.25;598;4;336.00;0
480;4;628482278;480;238;1073;1073;8.25;0.51;140.70;4.25;593;4;337.00;0
482;4;628482286;482;241;1073;1073;8.02;0.49;141.16;4.25;591;4;338.00;0
486;4;628482292;486;250;1074;1074;7.83;0.48;141.79;4.25;588;4;339.00;0
490;4;628482298;490;245;1075;1075;7.65;0.47;142.50;4.25;585;4;340.00;0
495;4;628482305;495;240;1075;1075;7.59;0.47;142.76;4.25;580;4;341.00;0
498;4;628482312;498;238;1077;1078;7.53;0.46;143.42;4.24;579;4;342.00;1
498;4;628482319;498;238;1077;1078;7.56;0.47;143.42;4.24;579;4;343.00;1
501;4;628482325;501;238;1078;1078;7.61;0.47;144.25;4.24;577;4;344.00;0
504;4;628482332;504;238;1078;1078;7.56;0.47;144.96;4.24;574;4;345.00;0
508;4;628482339;508;234;1083;1084;7.60;0.47;145.61;4.22;575;4;346.00;1
512;4;628482347;512;221;1084;1084;7.52;0.47;146.48;4.22;572;4;347.00;0
515;4;628482354;515;219;1084;1084;7.46;0.46;147.15;4.22;569;4;348.00;0
516;4;628482361;516;220;1084;1084;7.48;0.46;147.35;4.22;568;4;349.00;0
521;4;628482368;521;221;1088;1088;7.42;0.46;147.13;4.21;567;4;350.00;0
524;4;628482375;524;218;1089;1089;7.41;0.46;146.88;4.20;565;4;351.00;0
525;5;628482382;525;216;1089;1089;7.40;0.46;146.78;4.20;564;5;352.00;0
534;5;628482400;534;219;1090;1090;7.37;0.45;146.47;4.20;556;5;353.00;0
537;5;628482408;537;222;1090;1090;7.37;0.45;146.37;4.20;553;5;354.00;0
539;5;628482415;539;224;1090;1090;7.34;0.45;146.16;4.20;551;5;355.00;0
545;5;628482421;545;226;1090;1090;7.25;0.44;145.70;4.20;545;5;356.00;0
546;5;628482431;546;225;1090;1090;7.26;0.44;145.83;4.20;544;5;357.00;0
547;5;628482439;547;235;1090;1090;7.26;0.44;145.69;4.20;543;5;358.00;0
547;5;628482446;547;236;1090;1090;7.29;0.45;145.69;4.20;543;5;359.00;0
549;5;628482454;549;250;1159;1215;7.72;0.48;145.75;3.95;610;5;360.00;56
550;5;628482473;550;245;1165;1216;7.71;0.48;145.88;3.94;615;5;361.00;51
551;5;628482482;551;241;1178;1216;7.78;0.48;145.75;3.91;627;5;362.00;38
551;5;628482491;551;239;1183;1216;7.81;0.49;145.75;3.91;632;5;363.00;33
552;5;628482499;552;244;1188;1216;7.82;0.48;145.72;3.91;636;5;364.00;28
552;5;628482507;552;249;1191;1216;7.87;0.49;145.72;3.91;639;5;365.00;25
555;5;628482515;555;247;1196;1216;7.83;0.48;145.62;3.92;641;5;366.00;20
557;5;628482523;557;249;1198;1216;7.73;0.48;145.85;3.93;641;5;367.00;18
558;5;628482532;558;253;1202;1217;7.57;0.47;145.99;3.94;644;5;368.00;15
559;5;628482542;559;256;1206;1218;7.45;0.46;145.88;3.96;647;5;369.00;12
562;5;628482551;562;263;1209;1218;7.33;0.45;145.59;3.97;647;5;370.00;9
562;5;628482559;562;260;1215;1222;7.23;0.45;145.59;3.97;653;5;371.00;7
562;5;628482569;562;250;1217;1222;7.29;0.45;145.59;3.97;655;5;372.00;5
563;5;628482576;563;246;1219;1222;7.31;0.45;145.86;3.99;656;5;373.00;3
565;5;628482592;565;244;1219;1222;7.37;0.46;145.92;3.99;654;5;374.00;3
568;5;628482600;568;238;1226;1228;7.44;0.46;145.62;3.98;658;5;375.00;2
570;5;628482609;570;236;1226;1228;7.53;0.46;145.73;3.98;656;5;376.00;2
570;5;628482619;570;237;1227;1228;7.69;0.47;145.73;3.99;657;5;377.00;1
572;5;628482634;572;241;1230;1231;7.82;0.48;145.97;3.98;658;5;378.00;1
572;5;628482643;572;230;1230;1231;7.98;0.49;145.97;3.98;658;5;379.00;1
573;5;628482653;573;225;1231;1231;8.08;0.49;146.19;4.00;658;5;380.00;0
574;5;628482663;574;226;1232;1232;8.16;0.50;146.02;4.00;658;5;381.00;0
575;5;628482672;575;227;1233;1233;8.29;0.51;145.80;3.99;658;5;382.00;0
576;5;628482681;576;226;1233;1233;8.36;0.51;145.83;3.99;657;5;383.00;0
578;5;628482690;578;230;1246;1246;8.47;0.52;145.67;3.95;668;5;384.00;0
578;5;628482707;578;223;1246;1246;8.52;0.52;145.67;3.95;668;5;385.00;0
580;5;628482718;580;221;1246;1246;8.53;0.52;145.57;3.95;666;5;386.00;0
581;5;628482733;581;206;1247;1247;8.61;0.52;145.49;3.95;666;5;387.00;0
582;5;628482743;582;200;1247;1247;8.68;0.53;145.28;3.95;665;5;388.00;0
582;5;628482752;582;194;1250;1251;8.79;0.54;145.28;3.94;668;5;389.00;1
584;5;628482765;584;192;1250;1251;8.90;0.54;145.57;3.94;666;5;390.00;1
586;5;628482775;586;190;1255;1255;9.01;0.55;145.65;3.93;669;5;391.00;0
587;5;628482787;587;183;1255;1255;9.17;0.56;145.58;3.93;668;5;392.00;0
588;5;628482796;588;184;1255;1255;9.33;0.57;145.58;3.93;667;5;393.00;0
588;5;628482806;588;179;1255;1255;9.45;0.58;145.58;3.93;667;5;394.00;0
592;5;628482818;592;178;1255;1255;9.55;0.58;146.15;3.93;663;5;395.00;0
594;5;628482834;594;164;1266;1267;9.73;0.59;146.26;3.90;672;5;396.00;1
595;5;628482847;595;151;1267;1267;10.01;0.61;146.20;3.89;672;5;397.00;0
601;5;628482858;601;136;1267;1267;10.17;0.62;147.47;3.89;666;5;398.00;0
605;5;628482870;605;129;1267;1267;10.34;0.63;147.76;3.89;662;5;399.00;0
609;5;628482882;609;122;1267;1267;10.53;0.64;148.49;3.89;658;5;400.00;0
610;5;628482896;610;113;1267;1267;10.73;0.65;148.40;3.89;657;5;401.00;0
613;5;628482906;613;110;1268;1268;10.90;0.66;148.87;3.89;655;5;402.00;0
615;5;628482917;615;108;1268;1268;11.02;0.67;149.10;3.89;653;5;403.00;0
617;5;628482927;617;103;1273;1274;11.16;0.68;149.66;3.88;656;5;404.00;1
619;5;628482939;619;100;1276;1276;11.36;0.69;149.86;3.87;657;5;405.00;0
623;5;628482949;623;98;1276;1276;11.50;0.70;150.50;3.87;653;5;406.00;0
625;5;628482960;625;93;1276;1276;11.62;0.71;151.22;3.87;651;5;407.00;0
628;5;628482970;628;90;1280;1280;11.70;0.71;151.74;3.86;652;5;408.00;0
630;5;628482981;630;95;1280;1280;11.75;0.72;152.24;3.86;650;5;409.00;0
631;5;628482991;631;93;1280;1280;11.80;0.72;152.25;3.86;649;5;410.00;0
634;5;628483001;634;100;1281;1281;11.87;0.73;152.93;3.86;647;5;411.00;0
634;5;628483012;634;105;1285;1285;11.93;0.73;152.93;3.85;651;5;412.00;0
636;5;628483022;636;105;1285;1285;11.94;0.73;153.51;3.85;649;5;413.00;0
638;5;628483031;638;103;1287;1288;12.08;0.74;154.16;3.84;649;5;414.00;1
642;5;628483041;642;102;1287;1288;12.21;0.75;154.66;3.84;645;5;415.00;1
647;5;628483051;647;100;1288;1288;12.32;0.75;155.40;3.84;641;5;416.00;0
650;5;628483062;650;101;1288;1288;12.36;0.76;156.04;3.84;638;5;417.00;0
656;5;628483071;656;100;1291;1292;12.43;0.76;156.77;3.84;635;5;418.00;1
662;5;628483082;662;98;1291;1292;12.50;0.76;157.95;3.84;629;5;419.00;1
665;5;628483094;665;94;1292;1292;12.59;0.77;158.01;3.84;627;5;420.00;0
670;6;628483103;670;95;1292;1292;12.67;0.77;158.21;3.84;622;6;421.00;0
674;6;628483120;674;95;1293;1293;12.70;0.77;158.93;3.83;619;6;422.00;0
677;6;628483130;677;95;1294;1294;12.77;0.78;159.06;3.83;617;6;423.00;0
680;6;628483144;680;96;1294;1294;12.75;0.78;159.08;3.83;614;6;424.00;0
683;6;628483153;683;96;1295;1295;12.83;0.78;159.87;3.83;612;6;425.00;0
685;6;628483163;685;100;1295;1295;12.89;0.79;160.16;3.83;610;6;426.00;0
688;6;628483172;688;97;1295;1295;12.89;0.78;160.54;3.83;607;6;427.00;0
691;6;628483181;691;96;1295;1295;12.89;0.78;160.27;3.83;604;6;428.00;0
693;7;628483190;693;96;1295;1295;12.92;0.79;160.58;3.83;602;7;429.00;0
696;7;628483211;696;98;1295;1295;13.03;0.79;161.02;3.83;599;7;430.00;0
699;7;628483220;699;99;1295;1295;13.12;0.80;161.41;3.83;596;7;431.00;0
706;7;628483233;706;133;1375;1422;12.16;0.75;161.78;3.61;669;7;432.00;47
708;7;628483253;708;116;1375;1423;12.23;0.75;161.99;3.61;667;7;433.00;48
712;7;628483262;712;104;1381;1423;12.35;0.76;161.92;3.60;669;7;434.00;42
716;7;628483272;716;102;1384;1423;12.40;0.76;162.27;3.60;668;7;435.00;39
719;7;628483281;719;107;1389;1423;12.51;0.77;162.24;3.60;670;7;436.00;34
722;7;628483291;722;105;1393;1423;12.60;0.77;162.59;3.60;671;7;437.00;30
724;7;628483305;724;107;1397;1423;12.64;0.77;163.07;3.61;673;7;438.00;26
729;7;628483314;729;106;1401;1423;12.70;0.78;163.14;3.62;672;7;439.00;22
731;7;628483323;731;109;1403;1424;12.78;0.78;163.45;3.63;672;7;440.00;21
737;7;628483332;737;112;1406;1425;12.78;0.78;163.49;3.63;669;7;441.00;19
742;7;628483341;742;107;1408;1425;12.76;0.78;163.55;3.64;666;7;442.00;17
746;7;628483350;746;109;1410;1426;12.70;0.78;163.65;3.65;664;7;443.00;16
747;7;628483360;747;103;1411;1426;12.66;0.77;163.70;3.66;664;7;444.00;15
753;7;628483370;753;104;1415;1426;12.58;0.77;164.23;3.69;662;7;445.00;11
755;7;628483380;755;102;1416;1426;12.58;0.77;164.58;3.69;661;7;446.00;10
755;7;628483390;755;105;1418;1430;12.57;0.77;164.58;3.70;663;7;447.00;12
758;7;628483399;758;104;1420;1430;12.51;0.76;164.50;3.72;662;7;448.00;10
764;7;628483409;764;107;1421;1430;12.45;0.76;164.35;3.72;657;7;449.00;9
764;7;628483426;764;107;1425;1436;12.46;0.76;164.35;3.72;661;7;450.00;11
765;7;628483436;765;106;1425;1436;12.45;0.76;164.71;3.72;660;7;451.00;11
767;7;628483445;767;108;1426;1436;12.46;0.76;164.61;3.72;659;7;452.00;10
769;7;628483455;769;113;1429;1440;12.41;0.76;164.70;3.72;660;7;453.00;11
773;7;628483465;773;111;1431;1441;12.41;0.75;164.47;3.72;658;7;454.00;10
775;7;628483481;775;116;1431;1441;12.52;0.76;164.25;3.72;656;7;455.00;10
777;7;628483491;777;117;1434;1445;12.57;0.76;164.48;3.71;657;7;456.00;11
777;7;628483500;777;118;1436;1445;12.57;0.77;164.48;3.73;659;7;457.00;9
780;7;628483510;780;121;1436;1445;12.65;0.77;164.70;3.73;656;7;458.00;9
782;7;628483520;782;122;1438;1446;12.73;0.78;164.77;3.73;656;7;459.00;8
784;7;628483534;784;126;1440;1446;12.64;0.77;165.30;3.76;656;7;460.00;6
784;7;628483544;784;129;1444;1452;12.57;0.77;165.30;3.75;660;7;461.00;8
786;7;628483554;786;132;1444;1452;12.35;0.75;165.14;3.75;658;7;462.00;8
789;7;628483568;789;130;1446;1453;12.17;0.74;165.29;3.77;657;7;463.00;7
791;7;628483584;791;133;1447;1453;11.95;0.73;165.05;3.79;656;7;464.00;6
793;7;628483593;793;134;1447;1453;11.83;0.72;165.16;3.79;654;7;465.00;6
796;7;628483603;796;138;1448;1453;11.70;0.71;164.96;3.79;652;7;466.00;5
797;7;628483612;797;144;1448;1453;11.63;0.71;165.07;3.79;651;7;467.00;5
798;7;628483621;798;152;1457;1465;11.54;0.70;165.08;3.77;659;7;468.00;8
800;7;628483637;800;153;1457;1465;11.55;0.70;165.12;3.77;657;7;469.00;8
800;7;628483646;800;158;1461;1465;11.52;0.70;165.12;3.79;661;7;470.00;4
803;7;628483655;803;157;1461;1465;11.49;0.70;165.09;3.79;658;7;471.00;4
806;7;628483665;806;161;1462;1465;11.44;0.70;165.37;3.80;656;7;472.00;3
807;7;628483674;807;166;1462;1465;11.36;0.69;165.30;3.80;655;7;473.00;3
810;7;628483683;810;175;1465;1469;11.22;0.68;165.34;3.79;655;7;474.00;4
811;7;628483693;811;182;1465;1469;11.08;0.68;165.45;3.79;654;7;475.00;4
815;7;628483701;815;189;1470;1473;10.96;0.67;165.30;3.80;655;7;476.00;3
823;8;628483711;823;193;1473;1474;10.85;0.66;165.31;3.81;650;8;477.00;1
825;8;628483738;825;200;1474;1474;10.70;0.65;165.43;3.80;649;8;478.00;0
828;8;628483747;828;205;1474;1474;10.50;0.64;165.30;3.80;646;8;479.00;0
829;8;628483761;829;216;1493;1500;10.27;0.63;165.12;3.76;664;8;480.00;7
829;8;628483771;829;217;1493;1500;10.08;0.61;165.12;3.76;664;8;481.00;7
829;8;628483779;829;220;1496;1500;9.99;0.61;165.12;3.75;667;8;482.00;4
830;8;628483792;830;226;1499;1501;9.87;0.60;165.13;3.75;669;8;483.00;2
831;8;628483801;831;236;1502;1502;9.75;0.60;165.07;3.75;671;8;484.00;0
833;8;628483809;833;244;1502;1502;9.60;0.59;164.97;3.75;669;8;485.00;0
833;8;628483818;833;245;1504;1505;9.51;0.58;164.97;3.74;671;8;486.00;1
835;8;628483829;835;255;1504;1505;9.40;0.58;164.87;3.74;669;8;487.00;1
838;8;628483840;838;263;1505;1505;9.26;0.57;164.69;3.74;667;8;488.00;0
840;8;628483860;840;265;1505;1505;9.19;0.57;164.52;3.74;665;8;489.00;0
845;8;628483877;845;261;1510;1511;9.12;0.56;164.50;3.73;665;8;490.00;1
846;8;628483890;846;261;1510;1511;8.98;0.55;164.45;3.73;664;8;491.00;1
846;8;628483904;846;259;1511;1511;8.85;0.55;164.45;3.73;665;8;492.00;0
848;8;628483915;848;259;1511;1511;8.79;0.54;164.50;3.73;663;8;493.00;0
849;8;628483928;849;260;1515;1515;8.66;0.53;164.38;3.73;666;8;494.00;0
853;8;628483941;853;259;1517;1517;8.51;0.52;164.64;3.72;664;8;495.00;0
854;8;628483953;854;262;1517;1517;8.39;0.52;164.52;3.72;663;8;496.00;0
859;8;628483964;859;266;1518;1518;8.31;0.51;164.23;3.72;659;8;497.00;0
863;8;628483978;863;267;1518;1518;8.22;0.51;164.13;3.72;655;8;498.00;0
868;8;628483995;868;272;1518;1518;8.09;0.50;164.01;3.72;650;8;499.00;0
870;8;628484007;870;277;1518;1518;7.97;0.49;163.85;3.72;648;8;500.00;0
872;8;628484022;872;279;1518;1518;7.84;0.48;164.01;3.72;646;8;501.00;0
875;8;628484032;875;276;1518;1518;7.65;0.47;163.96;3.72;643;8;502.00;0
877;8;628484041;877;278;1518;1518;7.49;0.46;164.24;3.72;641;8;503.00;0
880;8;628484049;880;283;1557;1588;7.63;0.47;164.39;3.63;677;8;504.00;31
886;8;628484065;886;280;1561;1589;7.46;0.46;164.75;3.62;675;8;505.00;28
889;8;628484075;889;280;1571;1589;7.47;0.46;164.90;3.61;682;8;506.00;18
891;8;628484084;891;283;1572;1589;7.40;0.46;165.39;3.61;681;8;507.00;17
897;8;628484094;897;283;1578;1589;7.33;0.45;165.71;3.61;681;8;508.00;11
900;8;628484104;900;288;1581;1589;7.27;0.45;166.20;3.61;681;8;509.00;8
903;8;628484115;903;280;1586;1589;7.25;0.45;166.82;3.62;683;8;510.00;3
905;8;628484125;905;277;1588;1589;7.25;0.45;167.21;3.62;683;8;511.00;1
909;8;628484135;909;275;1590;1590;7.24;0.44;167.15;3.63;681;8;512.00;0
910;8;628484145;910;272;1591;1591;7.24;0.44;167.41;3.62;681;8;513.00;0
913;8;628484154;913;269;1591;1591;7.21;0.44;167.86;3.62;678;8;514.00;0
916;8;628484163;916;267;1595;1595;7.13;0.44;168.38;3.62;679;8;515.00;0
919;8;628484173;919;276;1595;1595;7.09;0.43;168.57;3.62;676;8;516.00;0
922;8;628484184;922;272;1595;1595;7.13;0.44;169.34;3.62;673;8;517.00;0
922;8;628484194;922;275;1595;1595;7.13;0.44;169.34;3.62;673;8;518.00;0
927;8;628484203;927;270;1600;1601;7.20;0.44;169.82;3.61;673;8;519.00;1
929;8;628484216;929;274;1600;1601;7.23;0.44;170.35;3.61;671;8;520.00;1
932;8;628484231;932;272;1601;1601;7.33;0.45;170.52;3.61;669;8;521.00;0
936;8;628484244;936;268;1603;1604;7.37;0.45;171.23;3.60;667;8;522.00;1
939;8;628484259;939;250;1604;1604;7.45;0.46;171.65;3.60;665;8;523.00;0
941;8;628484275;941;232;1604;1604;7.51;0.46;171.84;3.60;663;8;524.00;0
944;8;628484288;944;228;1605;1605;7.55;0.46;172.22;3.60;661;8;525.00;0
948;8;628484299;948;228;1606;1606;7.66;0.47;172.83;3.60;658;8;526.00;0
953;8;628484314;953;225;1606;1606;7.78;0.48;172.80;3.60;653;8;527.00;0
959;8;628484328;959;217;1619;1619;7.93;0.48;172.78;3.57;660;8;528.00;0
960;8;628484343;960;209;1619;1619;8.12;0.50;172.98;3.57;659;8;529.00;0
964;8;628484357;964;204;1619;1619;8.26;0.50;173.48;3.57;655;8;530.00;0
968;8;628484372;968;206;1620;1620;8.41;0.51;173.68;3.57;652;8;531.00;0
970;8;628484395;970;200;1620;1620;8.56;0.52;173.79;3.57;650;8;532.00;0
972;8;628484407;972;191;1623;1624;8.66;0.53;174.01;3.56;651;8;533.00;1
978;8;628484420;978;186;1623;1624;8.71;0.53;174.32;3.56;645;8;534.00;1
981;8;628484433;981;185;1628;1628;8.80;0.54;174.18;3.56;647;8;535.00;0
984;8;628484446;984;183;1628;1628;8.81;0.54;174.45;3.56;644;8;536.00;0
990;8;628484459;990;181;1628;1628;8.82;0.54;174.08;3.56;638;8;537.00;0
995;8;628484472;995;179;1628;1628;8.81;0.53;174.50;3.56;633;8;538.00;0
996;8;628484486;996;180;1628;1628;8.84;0.54;174.57;3.56;632;8;539.00;0
999;8;628484501;999;186;1657;1662;8.94;0.55;174.47;3.49;658;8;540.00;5
1001;8;628484517;1001;186;1657;1662;8.99;0.55;174.48;3.49;656;8;541.00;5
1004;8;628484529;1004;182;1659;1662;9.05;0.55;174.38;3.49;655;8;542.00;3
1004;8;628484544;1004;184;1659;1662;9.18;0.56;174.38;3.49;655;8;543.00;3
1008;8;628484556;1008;183;1660;1662;9.22;0.56;174.50;3.49;652;8;544.00;2
1009;8;628484568;1009;184;1660;1662;9.33;0.57;174.37;3.49;651;8;545.00;2
1012;8;628484580;1012;182;1662;1663;9.33;0.57;174.23;3.49;650;8;546.00;1
1014;8;628484594;1014;182;1662;1663;9.33;0.57;174.44;3.49;648;8;547.00;1
1019;8;628484605;1019;185;1667;1669;9.28;0.57;174.53;3.49;648;8;548.00;2
1019;8;628484627;1019;186;1668;1670;9.36;0.57;174.53;3.49;649;8;549.00;2
1024;8;628484641;1024;191;1669;1670;9.36;0.57;174.46;3.49;645;8;550.00;1
1026;8;628484655;1026;193;1669;1670;9.41;0.57;174.52;3.49;643;8;551.00;1
1029;8;628484669;1029;194;1674;1674;9.46;0.58;174.70;3.48;645;8;552.00;0
1033;8;628484683;1033;199;1674;1674;9.40;0.57;174.73;3.48;641;8;553.00;0
1035;8;628484696;1035;197;1674;1674;9.39;0.57;175.09;3.48;639;8;554.00;0
1036;8;628484710;1036;195;1675;1675;9.39;0.57;175.42;3.48;639;8;555.00;0
1039;8;628484724;1039;199;1679;1679;9.45;0.58;175.70;3.47;640;8;556.00;0
1042;8;628484738;1042;187;1679;1679;9.53;0.58;175.96;3.47;637;8;557.00;0
1046;8;628484752;1046;176;1681;1682;9.62;0.58;176.36;3.47;635;8;558.00;1
1048;8;628484765;1048;162;1681;1682;9.78;0.60;176.80;3.47;633;8;559.00;1
1051;8;628484779;1051;161;1682;1682;9.92;0.60;176.75;3.47;631;8;560.00;0
1053;8;628484792;1053;155;1682;1682;10.01;0.61;177.11;3.47;629;8;561.00;0
1058;8;628484805;1058;156;1685;1686;10.11;0.61;177.58;3.46;627;8;562.00;1
1061;8;628484821;1061;154;1685;1686;10.24;0.62;177.75;3.46;624;8;563.00;1
1064;8;628484836;1064;149;1686;1686;10.30;0.62;178.15;3.46;622;8;564.00;0
1067;8;628484858;1067;147;1686;1686;10.45;0.63;178.25;3.46;619;8;565.00;0
1070;8;628484873;1070;129;1687;1687;10.57;0.64;178.92;3.46;617;8;566.00;0
1072;8;628484887;1072;112;1688;1688;10.70;0.65;179.23;3.46;616;8;567.00;0
1074;8;628484901;1074;102;1688;1688;10.88;0.66;179.56;3.46;614;8;568.00;0
1074;8;628484916;1074;91;1689;1689;11.10;0.67;179.56;3.46;615;8;569.00;0
1075;8;628484933;1075;90;1689;1689;11.35;0.69;179.48;3.46;614;8;570.00;0
1079;8;628484947;1079;82;1689;1689;11.51;0.70;180.07;3.46;610;8;571.00;0
1082;8;628484962;1082;78;1689;1689;11.72;0.71;180.32;3.46;607;8;572.00;0
1084;8;628484975;1084;79;1689;1689;11.86;0.72;180.48;3.46;605;8;573.00;0
1086;8;628484991;1086;77;1689;1689;12.05;0.73;180.83;3.46;603;8;574.00;0
1088;8;628485005;1088;77;1689;1689;12.24;0.74;181.02;3.46;601;8;575.00;0
1089;8;628485020;1089;107;1770;1816;11.96;0.74;180.90;3.30;681;8;576.00;46
1091;8;628485047;1091;93;1773;1817;12.09;0.74;181.16;3.30;682;8;577.00;44
1094;8;628485063;1094;82;1779;1817;12.23;0.75;181.30;3.29;685;8;578.00;38
1097;8;628485079;1097;73;1782;1817;12.34;0.76;181.46;3.29;685;8;579.00;35
1101;8;628485094;1101;71;1785;1817;12.39;0.76;181.89;3.29;684;8;580.00;32
1105;8;628485107;1105;73;1787;1817;12.42;0.76;182.00;3.29;682;8;581.00;30
1107;8;628485127;1107;78;1790;1817;12.53;0.77;182.29;3.30;683;8;582.00;27
1110;9;628485139;1110;85;1793;1817;12.56;0.77;182.40;3.31;683;9;583.00;24
1114;9;628485173;1114;87;1796;1818;12.52;0.76;182.98;3.31;682;9;584.00;22
1115;9;628485188;1115;88;1800;1820;12.48;0.76;183.02;3.32;685;9;585.00;20
1119;10;628485212;1119;94;1803;1820;12.36;0.76;183.13;3.33;684;10;586.00;17
1121;10;628485233;1121;100;1807;1821;12.25;0.75;183.13;3.34;686;10;587.00;14
1125;10;628485254;1125;108;1810;1821;12.25;0.75;183.32;3.36;685;10;588.00;11
1128;10;628485267;1128;112;1813;1821;12.31;0.75;183.62;3.37;685;10;589.00;8
1129;10;628485279;1129;116;1815;1821;12.41;0.76;183.85;3.39;686;10;590.00;6
1131;10;628485297;1131;116;1818;1825;12.42;0.76;184.09;3.40;687;10;591.00;7
1135;10;628485310;1135;119;1822;1825;12.45;0.76;184.80;3.41;687;10;592.00;3
1137;10;628485321;1137;126;1822;1825;12.46;0.76;184.90;3.41;685;10;593.00;3
1142;10;628485342;1142;123;1825;1828;12.50;0.77;185.15;3.41;683;10;594.00;3
1144;10;628485354;1144;127;1825;1828;12.54;0.77;185.47;3.41;681;10;595.00;3
1147;10;628485374;1147;122;1826;1828;12.58;0.77;185.61;3.41;679;10;596.00;2
1154;10;628485386;1154;124;1830;1832;12.57;0.77;185.56;3.41;676;10;597.00;2
1157;10;628485398;1157;126;1832;1833;12.61;0.77;186.13;3.41;675;10;598.00;1
1161;10;628485411;1161;124;1832;1833;12.63;0.77;186.21;3.41;671;10;599.00;1
1166;10;628485426;1166;131;1843;1859;12.50;0.76;186.36;3.39;677;10;600.00;16
1166;10;628485447;1166;130;1846;1859;12.43;0.76;186.36;3.39;680;10;601.00;13
1170;10;628485458;1170;129;1846;1859;12.53;0.76;186.22;3.39;676;10;602.00;13
1172;10;628485478;1172;129;1847;1860;12.64;0.77;186.40;3.39;675;10;603.00;13
1176;10;628485490;1176;131;1848;1860;12.66;0.77;186.53;3.39;672;10;604.00;12
1179;10;628485501;1179;131;1851;1866;12.68;0.77;186.75;3.38;672;10;605.00;15
1181;10;628485512;1181;133;1852;1866;12.77;0.77;186.62;3.38;671;10;606.00;14
1188;10;628485523;1188;134;1855;1867;12.65;0.77;186.64;3.39;667;10;607.00;12
1191;10;628485541;1191;134;1855;1867;12.63;0.76;186.95;3.39;664;10;608.00;12
1192;10;628485552;1192;129;1855;1867;12.64;0.77;186.88;3.39;663;10;609.00;12
1196;10;628485563;1196;128;1857;1867;12.63;0.76;186.79;3.39;661;10;610.00;10
1202;10;628485574;1202;126;1857;1867;12.58;0.76;186.92;3.39;655;10;611.00;10
1207;10;628485584;1207;123;1868;1879;12.40;0.75;187.72;3.38;661;10;612.00;11
1209;10;628485596;1209;122;1868;1879;12.34;0.75;187.87;3.38;659;10;613.00;11
1211;10;628485606;1211;113;1869;1879;12.36;0.75;188.01;3.38;658;10;614.00;10
1216;10;628485617;1216;110;1871;1879;12.33;0.75;188.28;3.39;655;10;615.00;8
1218;10;628485628;1218;105;1871;1879;12.48;0.76;188.29;3.39;653;10;616.00;8
1219;10;628485639;1219;106;1871;1879;12.62;0.77;188.40;3.39;652;10;617.00;8
1224;10;628485649;1224;101;1875;1883;12.56;0.76;188.39;3.39;651;10;618.00;8
1224;10;628485661;1224;94;1875;1883;12.68;0.77;188.39;3.39;651;10;619.00;8
1229;10;628485670;1229;88;1878;1887;12.74;0.77;188.41;3.39;649;10;620.00;9
1231;10;628485690;1231;85;1880;1888;12.85;0.78;188.51;3.38;649;10;621.00;8
1233;10;628485701;1233;86;1880;1888;12.84;0.78;188.49;3.38;647;10;622.00;8
1236;10;628485721;1236;88;1880;1888;12.79;0.77;188.54;3.38;644;10;623.00;8
1237;10;628485738;1237;89;1889;1901;12.68;0.77;188.43;3.38;652;10;624.00;12
1237;10;628485750;1237;93;1889;1901;12.70;0.77;188.43;3.38;652;10;625.00;12
1241;10;628485760;1241;96;1889;1901;12.74;0.77;188.95;3.38;648;10;626.00;12
1243;10;628485772;1243;99;1890;1902;12.73;0.77;188.95;3.38;647;10;627.00;12
1245;10;628485799;1245;106;1890;1903;12.71;0.77;188.82;3.38;645;10;628.00;13
1246;10;628485809;1246;112;1893;1903;12.62;0.76;188.88;3.41;647;10;629.00;10
1247;10;628485830;1247;113;1896;1909;12.55;0.76;188.80;3.41;649;10;630.00;13
1250;10;628485847;1250;117;1898;1909;12.50;0.76;188.81;3.41;648;10;631.00;11
1252;10;628485863;1252;118;1899;1909;12.43;0.75;188.79;3.41;647;10;632.00;10
1253;10;628485879;1253;128;1899;1909;12.35;0.75;188.65;3.41;646;10;633.00;10
1254;10;628485893;1254;132;1903;1915;12.32;0.75;188.72;3.40;649;10;634.00;12
1258;10;628485910;1258;130;1904;1915;12.24;0.74;188.62;3.42;646;10;635.00;11
1259;10;628485926;1259;133;1905;1915;12.13;0.74;188.51;3.42;646;10;636.00;10
1262;10;628485940;1262;134;1905;1915;12.09;0.73;188.78;3.42;643;10;637.00;10
1265;10;628485954;1265;137;1909;1919;12.01;0.73;188.86;3.42;644;10;638.00;10
1268;10;628485967;1268;143;1911;1920;11.86;0.72;188.73;3.42;643;10;639.00;9
1271;10;628485979;1271;153;1913;1920;11.74;0.71;188.99;3.45;642;10;640.00;7
1271;10;628485990;1271;160;1914;1921;11.63;0.71;188.99;3.45;643;10;641.00;7
1272;10;628486000;1272;166;1916;1921;11.46;0.70;188.91;3.46;644;10;642.00;5
1274;10;628486011;1274;171;1916;1921;11.39;0.69;189.00;3.46;642;10;643.00;5
1277;10;628486021;1277;176;1916;1921;11.29;0.69;189.14;3.46;639;10;644.00;5
1277;10;628486031;1277;186;1919;1921;11.10;0.68;189.14;3.50;642;10;645.00;2
1279;10;628486040;1279;190;1919;1921;10.90;0.66;188.98;3.50;640;10;646.00;2
1281;10;628486049;1281;195;1921;1921;10.64;0.65;188.85;3.51;640;10;647.00;0
1285;10;628486058;1285;209;1958;1991;10.52;0.64;188.57;3.45;673;10;648.00;33
1285;10;628486074;1285;214;1962;1992;10.26;0.63;188.57;3.44;677;10;649.00;30
1286;10;628486084;1286;210;1975;1992;10.12;0.62;188.45;3.43;689;10;650.00;17
1287;10;628486093;1287;221;1977;1992;9.91;0.61;188.36;3.43;690;10;651.00;15
1291;10;628486103;1291;227;1982;1992;9.78;0.60;188.38;3.43;691;10;652.00;10
1292;10;628486120;1292;235;1983;1992;9.60;0.59;188.36;3.43;691;10;653.00;9
1293;10;628486130;1293;236;1986;1992;9.56;0.59;188.28;3.44;693;10;654.00;6
1293;10;628486140;1293;241;1988;1992;9.39;0.58;188.28;3.44;695;10;655.00;4
1294;10;628486149;1294;245;1991;1993;9.29;0.57;188.19;3.45;697;10;656.00;2
1297;10;628486158;1297;251;1993;1994;9.16;0.56;188.10;3.45;696;10;657.00;1
1300;10;628486167;1300;259;1994;1994;9.02;0.55;187.92;3.45;694;10;658.00;0
1301;10;628486176;1301;259;1998;1998;8.78;0.54;187.91;3.44;697;10;659.00;0
1303;10;628486188;1303;261;1998;1998;8.64;0.53;187.70;3.44;695;10;660.00;0
1304;10;628486198;1304;264;1998;1998;8.43;0.52;187.62;3.44;694;10;661.00;0
1309;10;628486207;1309;272;1998;1998;8.27;0.51;187.41;3.44;689;10;662.00;0
1310;10;628486217;1310;274;2003;2004;8.14;0.50;187.36;3.44;693;10;663.00;1
1314;10;628486226;1314;273;2004;2004;8.05;0.49;187.45;3.44;690;10;664.00;0
1314;10;628486236;1314;274;2004;2004;7.91;0.49;187.45;3.44;690;10;665.00;0
1316;10;628486256;1316;281;2007;2007;7.86;0.48;187.50;3.43;691;10;666.00;0
1318;10;628486266;1318;281;2007;2007;7.74;0.47;187.44;3.43;689;10;667.00;0
1320;10;628486275;1320;285;2007;2007;7.64;0.47;187.30;3.43;687;10;668.00;0
1321;10;628486285;1321;289;2008;2008;7.52;0.46;187.26;3.43;687;10;669.00;0
1322;10;628486294;1322;297;2009;2009;7.43;0.45;187.13;3.43;687;10;670.00;0
1323;10;628486303;1323;303;2009;2009;7.31;0.45;187.08;3.43;686;10;671.00;0
1324;10;628486311;1324;307;2022;2022;7.20;0.44;187.08;3.41;698;10;672.00;0
1327;10;628486321;1327;311;2022;2022;7.11;0.44;187.12;3.41;695;10;673.00;0
1332;10;628486330;1332;315;2022;2022;7.05;0.43;187.03;3.41;690;10;674.00;0
1336;10;628486339;1336;302;2024;2024;6.99;0.43;187.24;3.40;688;10;675.00;0
1340;10;628486349;1340;291;2024;2024;6.97;0.43;187.16;3.40;684;10;676.00;0
1343;10;628486358;1343;288;2027;2028;6.94;0.42;187.37;3.40;684;10;677.00;1
1344;10;628486367;1344;276;2028;2028;6.92;0.42;187.52;3.40;684;10;678.00;0
1346;10;628486375;1346;274;2032;2032;6.87;0.42;187.41;3.40;686;10;679.00;0
1348;10;628486385;1348;262;2032;2032;6.83;0.42;187.21;3.40;684;10;680.00;0
1351;10;628486394;1351;250;2032;2032;6.82;0.42;187.79;3.40;681;10;681.00;0
1354;10;628486404;1354;248;2032;2032;6.88;0.42;188.17;3.40;678;10;682.00;0
1358;11;628486413;1358;235;2032;2032;6.92;0.43;188.22;3.40;674;11;683.00;0
1362;11;628486437;1362;225;2043;2044;7.12;0.44;188.63;3.38;681;11;684.00;1
1365;11;628486449;1365;227;2044;2044;7.33;0.45;188.90;3.38;679;11;685.00;0
1368;11;628486459;1368;217;2044;2044;7.47;0.46;189.38;3.38;676;11;686.00;0
1371;11;628486479;1371;214;2044;2044;7.64;0.47;189.54;3.38;673;11;687.00;0
1374;11;628486491;1374;204;2044;2044;7.77;0.48;189.76;3.38;670;11;688.00;0
1377;11;628486500;1377;199;2044;2044;7.86;0.48;190.08;3.38;667;11;689.00;0
1380;11;628486511;1380;192;2045;2045;7.96;0.49;190.29;3.37;665;11;690.00;0
1384;11;628486522;1384;186;2045;2045;8.02;0.49;190.59;3.37;661;11;691.00;0
1385;11;628486532;1385;186;2050;2051;8.18;0.50;190.72;3.37;665;11;692.00;1
1388;11;628486542;1388;181;2052;2052;8.35;0.51;191.04;3.37;664;11;693.00;0
1391;11;628486552;1391;182;2052;2052;8.47;0.52;191.21;3.37;661;11;694.00;0
1394;11;628486562;1394;174;2052;2052;8.59;0.53;191.08;3.37;658;11;695.00;0
1401;11;628486571;1401;174;2056;2056;8.67;0.53;191.60;3.36;655;11;696.00;0
1404;11;628486581;1404;175;2056;2056;8.75;0.54;191.76;3.36;652;11;697.00;0
1407;11;628486595;1407;171;2056;2056;8.79;0.54;191.98;3.36;649;11;698.00;0
1413;11;628486605;1413;168;2057;2057;8.79;0.54;192.06;3.36;644;11;699.00;0
1419;12;628486617;1419;163;2061;2061;8.81;0.54;192.31;3.35;642;12;700.00;0
1421;12;628486644;1421;164;2061;2061;8.96;0.55;192.22;3.35;640;12;701.00;0
1430;12;628486656;1430;167;2063;2064;8.99;0.55;192.16;3.35;633;12;702.00;1
1438;12;628486672;1438;158;2063;2064;9.03;0.55;192.31;3.35;625;12;703.00;1
1440;12;628486682;1440;155;2064;2064;9.19;0.56;192.32;3.35;624;12;704.00;0
1444;12;628486692;1444;151;2064;2064;9.27;0.56;192.67;3.35;620;12;705.00;0
1450;12;628486702;1450;152;2067;2068;9.31;0.57;192.60;3.35;617;12;706.00;1
1455;12;628486712;1455;151;2067;2068;9.37;0.57;192.87;3.35;612;12;707.00;1
1461;12;628486728;1461;141;2068;2068;9.39;0.57;192.99;3.35;607;12;708.00;0
1469;12;628486739;1469;140;2068;2068;9.32;0.57;193.03;3.35;599;12;709.00;0
1473;12;628486749;1473;142;2069;2069;9.30;0.56;193.13;3.35;596;12;710.00;0
1478;12;628486760;1478;144;2070;2070;9.30;0.56;193.14;3.34;592;12;711.00;0
1481;12;628486771;1481;142;2070;2070;9.32;0.56;193.25;3.34;589;12;712.00;0
1484;12;628486781;1484;141;2071;2071;9.39;0.57;193.32;3.34;587;12;713.00;0
1485;12;628486792;1485;136;2071;2071;9.52;0.58;193.38;3.34;586;12;714.00;0
1489;12;628486801;1489;137;2071;2071;9.65;0.58;193.87;3.34;582;12;715.00;0
1490;12;628486811;1490;141;2071;2071;9.76;0.59;193.96;3.34;581;12;716.00;0
1493;12;628486822;1493;144;2071;2071;9.82;0.59;194.25;3.34;578;12;717.00;0
1496;12;628486833;1496;143;2071;2071;9.92;0.60;194.47;3.34;575;12;718.00;0
1497;12;628486844;1497;143;2071;2071;10.07;0.61;194.39;3.34;574;12;719.00;0
1500;12;628486855;1500;180;2192;2301;10.05;0.63;194.75;3.16;692;12;720.00;109
1503;12;628486887;1503;173;2204;2302;10.09;0.63;194.72;3.15;701;12;721.00;98
1505;12;628486900;1505;167;2216;2302;10.17;0.63;194.96;3.14;711;12;722.00;86
1509;12;628486912;1509;166;2225;2302;10.13;0.63;195.20;3.14;716;12;723.00;77
1511;12;628486924;1511;160;2231;2302;10.06;0.63;195.65;3.14;720;12;724.00;71
1514;12;628486935;1514;161;2236;2302;10.08;0.63;195.77;3.15;722;12;725.00;66
1517;12;628486946;1517;161;2244;2302;10.01;0.62;196.01;3.16;727;12;726.00;58
1519;12;628486957;1519;159;2247;2302;10.03;0.62;196.14;3.16;728;12;727.00;55
1522;12;628486969;1522;155;2252;2303;10.05;0.62;196.41;3.17;730;12;728.00;51
1524;12;628486981;1524;153;2255;2304;10.07;0.62;196.73;3.18;731;12;729.00;49
1526;12;628486993;1526;153;2261;2304;10.05;0.62;196.94;3.20;735;12;730.00;43
1529;13;628487004;1529;155;2265;2305;10.00;0.62;196.89;3.21;736;13;731.00;40
1532;13;628487028;1532;155;2269;2305;9.94;0.61;197.17;3.22;737;13;732.00;36
1533;13;628487040;1533;156;2272;2305;9.86;0.61;197.28;3.23;739;13;733.00;33
1536;13;628487055;1536;160;2275;2305;9.80;0.61;197.40;3.25;739;13;734.00;30
1539;13;628487067;1539;166;2279;2309;9.75;0.60;197.56;3.26;740;13;735.00;30
1541;13;628487084;1541;162;2282;2309;9.74;0.60;197.72;3.27;741;13;736.00;27
1545;13;628487102;1545;153;2286;2309;9.76;0.60;197.74;3.30;741;13;737.00;23
1547;13;628487114;1547;153;2289;2312;9.90;0.61;197.99;3.31;742;13;738.00;23
1549;13;628487126;1549;152;2289;2312;10.09;0.62;198.01;3.31;740;13;739.00;23
1551;13;628487138;1551;147;2290;2312;10.23;0.63;198.19;3.32;739;13;740.00;22
1557;13;628487150;1557;152;2297;2316;10.29;0.63;198.49;3.34;740;13;741.00;19
1560;13;628487163;1560;148;2298;2317;10.45;0.64;198.59;3.33;738;13;742.00;19
1562;13;628487176;1562;147;2299;2317;10.61;0.65;198.61;3.34;737;13;743.00;18
1567;13;628487189;1567;150;2302;2321;10.70;0.65;198.90;3.34;735;13;744.00;19
1568;13;628487202;1568;145;2306;2321;10.76;0.66;198.92;3.36;738;13;745.00;15
1574;13;628487213;1574;148;2306;2321;10.86;0.66;199.05;3.36;732;13;746.00;15
1576;13;628487232;1576;149;2306;2322;10.96;0.67;199.41;3.36;730;13;747.00;16
1578;13;628487244;1578;149;2307;2322;11.06;0.68;199.51;3.36;729;13;748.00;15
1581;13;628487257;1581;157;2312;2328;11.16;0.68;199.62;3.37;731;13;749.00;16
1583;13;628487271;1583;160;2313;2328;11.27;0.69;199.90;3.37;730;13;750.00;15
1584;14;628487284;1584;157;2314;2329;11.35;0.70;199.98;3.37;730;14;751.00;15
1587;15;628487313;1587;155;2315;2329;11.36;0.70;200.13;3.38;728;15;752.00;14
1588;15;628487337;1588;152;2315;2329;11.50;0.71;200.04;3.38;727;15;753.00;14
1592;15;628487348;1592;154;2315;2329;11.59;0.71;200.20;3.38;723;15;754.00;14
1594;15;628487364;1594;154;2316;2329;11.63;0.71;200.27;3.38;722;15;755.00;13
1598;15;628487376;1598;154;2328;2341;11.65;0.71;200.43;3.37;730;15;756.00;13
1603;15;628487395;1603;154;2328;2341;11.65;0.71;200.76;3.37;725;15;757.00;13
1607;15;628487406;1607;156;2329;2341;11.72;0.71;200.89;3.38;722;15;758.00;12
1609;16;628487418;1609;155;2329;2341;11.75;0.72;200.79;3.38;720;16;759.00;12
1609;16;628487440;1609;159;2330;2341;11.80;0.72;200.79;3.38;721;16;760.00;11
1616;16;628487455;1616;157;2330;2341;11.75;0.72;201.14;3.38;714;16;761.00;11
1619;16;628487473;1619;160;2335;2345;11.70;0.71;201.03;3.38;716;16;762.00;10
1621;16;628487484;1621;161;2335;2345;11.74;0.72;200.99;3.38;714;16;763.00;10
1624;16;628487495;1624;162;2338;2349;11.73;0.71;201.12;3.38;714;16;764.00;11
1628;16;628487512;1628;163;2340;2351;11.73;0.72;201.36;3.37;712;16;765.00;11
1630;16;628487523;1630;165;2341;2351;11.77;0.72;201.60;3.37;711;16;766.00;10
1633;16;628487534;1633;168;2341;2351;11.79;0.72;201.74;3.37;708;16;767.00;10
1633;16;628487544;1633;171;2351;2364;11.78;0.72;201.74;3.38;718;16;768.00;13
1635;16;628487555;1635;168;2351;2364;11.81;0.72;201.72;3.38;716;16;769.00;13
1639;16;628487565;1639;163;2351;2364;11.79;0.72;201.59;3.38;712;16;770.00;13
1641;16;628487575;1641;166;2352;2365;11.87;0.72;201.54;3.38;711;16;771.00;13
1645;16;628487586;1645;165;2352;2366;11.94;0.73;201.82;3.38;707;16;772.00;14
1646;16;628487596;1646;162;2352;2366;11.95;0.73;201.85;3.38;706;16;773.00;14
1649;16;628487606;1649;160;2354;2369;11.93;0.73;201.86;3.37;705;16;774.00;15
1656;16;628487615;1656;162;2354;2369;11.95;0.73;201.99;3.37;698;16;775.00;15
1662;16;628487626;1662;165;2355;2369;12.01;0.73;202.12;3.37;693;16;776.00;14
1666;16;628487636;1666;161;2355;2369;11.98;0.73;202.13;3.37;689;16;777.00;14
1667;16;628487647;1667;165;2359;2375;12.03;0.73;202.09;3.37;692;16;778.00;16
1671;16;628487657;1671;161;2359;2375;11.97;0.73;202.25;3.37;688;16;779.00;16
1674;16;628487669;1674;158;2360;2375;12.02;0.73;202.40;3.37;686;16;780.00;15
1675;16;628487679;1675;156;2360;2375;11.99;0.73;202.39;3.37;685;16;781.00;15
1680;16;628487695;1680;155;2364;2379;11.94;0.73;202.31;3.39;684;16;782.00;15
1686;16;628487706;1686;154;2365;2380;11.93;0.72;202.12;3.39;679;16;783.00;15
1688;16;628487718;1688;151;2365;2380;11.94;0.72;202.00;3.39;677;16;784.00;15
1689;16;628487729;1689;145;2369;2381;11.91;0.72;202.03;3.43;680;16;785.00;12
1691;16;628487747;1691;138;2369;2381;11.95;0.73;202.15;3.43;678;16;786.00;12
1695;16;628487760;1695;136;2369;2381;11.99;0.73;202.18;3.43;674;16;787.00;12
1699;16;628487772;1699;130;2369;2381;12.04;0.73;202.31;3.43;670;16;788.00;12
1703;16;628487783;1703;125;2369;2381;12.10;0.74;202.35;3.43;666;16;789.00;12
1704;16;628487798;1704;123;2369;2381;12.16;0.74;202.27;3.43;665;16;790.00;12
1706;16;628487823;1706;122;2369;2381;12.17;0.74;202.34;3.43;663;16;791.00;12
1706;16;628487845;1706;125;2401;2451;12.20;0.75;202.34;3.38;695;16;792.00;50
1712;16;628487872;1712;120;2401;2452;12.18;0.75;202.28;3.38;689;16;793.00;51
1714;16;628487888;1714;123;2409;2452;12.22;0.75;202.23;3.38;695;16;794.00;43
1717;16;628487905;1717;128;2411;2452;12.16;0.74;202.13;3.38;694;16;795.00;41
1718;16;628487922;1718;130;2415;2452;12.08;0.74;202.06;3.38;697;16;796.00;37
1720;16;628487943;1720;137;2420;2452;12.01;0.73;202.16;3.41;700;16;797.00;32
1723;16;628487957;1723;136;2425;2452;11.92;0.73;202.05;3.42;702;16;798.00;27
1723;16;628487971;1723;140;2427;2452;11.75;0.72;202.05;3.45;704;16;799.00;25
1725;16;628487986;1725;141;2431;2453;11.62;0.71;201.90;3.45;706;16;800.00;22
1728;16;628488006;1728;149;2434;2454;11.47;0.70;201.79;3.49;706;16;801.00;20
1731;16;628488021;1731;158;2436;2454;11.33;0.69;201.62;3.49;705;16;802.00;18
1734;16;628488034;1734;163;2440;2458;11.14;0.68;201.61;3.49;706;16;803.00;18
1736;16;628488047;1736;169;2441;2458;11.03;0.67;201.48;3.52;705;16;804.00;17
1737;16;628488061;1737;175;2443;2458;10.86;0.66;201.40;3.53;706;16;805.00;15
1738;16;628488075;1738;184;2443;2458;10.75;0.66;201.39;3.53;705;16;806.00;15
1740;16;628488089;1740;192;2448;2464;10.70;0.65;201.33;3.56;708;16;807.00;16
1743;16;628488111;1743;208;2449;2464;10.71;0.65;201.18;3.56;706;16;808.00;15
1748;16;628488125;1748;213;2451;2464;10.62;0.65;201.09;3.61;703;16;809.00;13
1748;16;628488142;1748;216;2456;2470;10.63;0.65;201.09;3.62;708;16;810.00;14
1752;16;628488156;1752;224;2457;2470;10.56;0.64;200.91;3.65;705;16;811.00;13
1755;16;628488168;1755;226;2459;2470;10.49;0.64;200.83;3.66;704;16;812.00;11
1758;16;628488181;1758;231;2461;2471;10.31;0.63;200.64;3.69;703;16;813.00;10
1759;16;628488193;1759;229;2463;2472;10.13;0.62;200.60;3.68;704;16;814.00;9
1762;16;628488204;1762;236;2467;2472;9.87;0.60;200.42;3.72;705;16;815.00;5
1766;16;628488215;1766;241;2476;2485;9.65;0.59;200.19;3.71;710;16;816.00;9
1767;16;628488228;1767;245;2479;2485;9.44;0.58;200.16;3.72;712;16;817.00;6
1768;16;628488239;1768;255;2479;2485;9.28;0.57;200.20;3.72;711;16;818.00;6
1771;16;628488250;1771;261;2481;2486;9.14;0.56;200.02;3.73;710;16;819.00;5
1771;16;628488261;1771;265;2483;2486;8.96;0.55;200.02;3.74;712;16;820.00;3
1774;16;628488273;1774;274;2486;2490;8.90;0.55;199.90;3.73;712;16;821.00;4
1776;16;628488284;1776;282;2488;2490;8.76;0.54;199.80;3.74;712;16;822.00;2
1777;16;628488295;1777;290;2492;2494;8.70;0.53;199.79;3.73;715;16;823.00;2
1779;16;628488306;1779;296;2493;2494;8.59;0.53;199.74;3.73;714;16;824.00;1
1780;16;628488318;1780;306;2494;2494;8.45;0.52;199.65;3.73;714;16;825.00;0
1782;16;628488328;1782;307;2494;2494;8.23;0.50;199.60;3.73;712;16;826.00;0
1783;16;628488338;1783;301;2494;2494;8.10;0.50;199.71;3.73;711;16;827.00;0
1786;16;628488348;1786;296;2504;2506;8.01;0.49;199.62;3.72;718;16;828.00;2
1788;16;628488361;1788;291;2505;2506;7.90;0.48;199.64;3.72;717;16;829.00;1
1788;16;628488372;1788;286;2506;2506;7.88;0.48;199.64;3.72;718;16;830.00;0
1789;16;628488384;1789;280;2506;2506;7.83;0.48;199.59;3.72;717;16;831.00;0
1790;16;628488397;1790;281;2506;2506;7.79;0.48;199.62;3.72;716;16;832.00;0
1790;16;628488409;1790;272;2506;2506;7.84;0.48;199.62;3.72;716;16;833.00;0
1791;16;628488419;1791;269;2507;2507;7.90;0.49;199.67;3.72;716;16;834.00;0
1792;16;628488430;1792;262;2507;2507;7.98;0.49;199.65;3.72;715;16;835.00;0
1793;16;628488447;1793;262;2512;2513;8.15;0.50;199.64;3.71;719;16;836.00;1
1794;16;628488468;1794;260;2514;2514;8.30;0.51;199.63;3.71;720;16;837.00;0
1796;16;628488479;1796;260;2514;2514;8.37;0.51;199.57;3.71;718;16;838.00;0
1799;16;628488499;1799;250;2514;2514;8.47;0.52;199.44;3.71;715;16;839.00;0
1802;16;628488513;1802;252;2519;2519;8.56;0.52;199.26;3.70;717;16;840.00;0
1804;16;628488524;1804;253;2519;2519;8.60;0.52;199.52;3.70;715;16;841.00;0
1804;16;628488536;1804;252;2519;2519;8.59;0.52;199.52;3.70;715;16;842.00;0
1806;16;628488546;1806;255;2520;2520;8.51;0.52;199.64;3.70;714;16;843.00;0
1808;16;628488557;1808;251;2524;2524;8.40;0.51;199.87;3.70;716;16;844.00;0
1809;16;628488569;1809;251;2524;2524;8.35;0.51;199.99;3.70;715;16;845.00;0
1811;16;628488579;1811;247;2526;2527;8.26;0.51;200.06;3.69;715;16;846.00;1
1814;16;628488591;1814;243;2527;2527;8.14;0.50;199.94;3.69;713;16;847.00;0
1818;16;628488601;1818;246;2527;2527;8.04;0.49;200.21;3.69;709;16;848.00;0
1821;16;628488611;1821;248;2527;2527;7.99;0.49;200.33;3.69;706;16;849.00;0
1825;16;628488621;1825;241;2530;2531;8.07;0.50;200.29;3.69;705;16;850.00;1
1828;16;628488634;1828;233;2530;2531;8.08;0.50;200.33;3.69;702;16;851.00;1
1832;16;628488646;1832;230;2531;2531;8.14;0.50;200.49;3.69;699;16;852.00;0
1836;16;628488657;1836;221;2531;2531;8.22;0.51;200.51;3.69;695;16;853.00;0
1840;16;628488668;1840;209;2532;2532;8.28;0.51;200.71;3.69;692;16;854.00;0
1845;16;628488679;1845;205;2534;2534;8.41;0.52;200.64;3.68;689;16;855.00;0
1851;16;628488691;1851;201;2534;2534;8.52;0.52;200.72;3.68;683;16;856.00;0
1854;16;628488703;1854;191;2535;2535;8.63;0.53;200.90;3.68;681;16;857.00;0
1857;16;628488714;1857;189;2535;2535;8.77;0.54;200.91;3.68;678;16;858.00;0
1863;16;628488725;1863;180;2535;2535;8.81;0.54;201.05;3.68;672;16;859.00;0
1867;16;628488737;1867;170;2535;2535;8.82;0.54;201.14;3.68;668;16;860.00;0
1870;16;628488749;1870;165;2535;2535;8.85;0.54;201.20;3.68;665;16;861.00;0
1874;16;628488767;1874;156;2535;2535;8.88;0.55;201.25;3.68;661;16;862.00;0
1877;16;628488778;1877;154;2535;2535;8.96;0.55;201.29;3.68;658;16;863.00;0
1884;16;628488789;1884;163;2616;2662;9.03;0.56;201.61;3.57;732;16;864.00;46
1890;16;628488816;1890;152;2620;2663;9.07;0.56;201.56;3.57;730;16;865.00;43
1895;16;628488831;1895;144;2628;2663;9.24;0.57;201.70;3.56;733;16;866.00;35
1897;16;628488845;1897;139;2632;2663;9.41;0.58;201.78;3.56;735;16;867.00;31
1902;16;628488856;1902;137;2637;2663;9.54;0.59;201.87;3.56;735;16;868.00;26
1907;16;628488868;1907;135;2642;2663;9.53;0.59;202.14;3.56;735;16;869.00;21
1912;16;628488883;1912;133;2647;2663;9.50;0.58;202.13;3.57;735;16;870.00;16
1919;17;628488895;1919;133;2649;2663;9.43;0.58;202.34;3.57;730;17;871.00;14
1924;17;628488924;1924;138;2653;2664;9.40;0.57;202.70;3.58;729;17;872.00;11
1927;17;628488936;1927;145;2654;2665;9.40;0.58;202.77;3.58;727;17;873.00;11
1929;17;628488948;1929;151;2656;2665;9.41;0.58;202.90;3.58;727;17;874.00;9
1935;17;628488959;1935;153;2658;2666;9.28;0.57;203.45;3.58;723;17;875.00;8
1939;17;628488971;1939;162;2660;2666;9.25;0.57;203.56;3.59;721;17;876.00;6
1943;17;628488987;1943;170;2661;2666;9.27;0.57;203.58;3.59;718;17;877.00;5
1947;17;628489000;1947;176;2663;2666;9.32;0.57;203.86;3.60;716;17;878.00;3
1952;17;628489012;1952;183;2666;2670;9.31;0.57;204.03;3.60;714;17;879.00;4
1957;17;628489025;1957;185;2668;2670;9.40;0.58;203.97;3.61;711;17;880.00;2
1960;17;628489037;1960;189;2668;2670;9.45;0.58;204.08;3.61;708;17;881.00;2
1961;17;628489049;1961;193;2671;2673;9.62;0.59;204.20;3.61;710;17;882.00;2
1965;17;628489061;1965;196;2671;2673;9.68;0.59;204.33;3.61;706;17;883.00;2
1967;17;628489079;1967;196;2672;2673;9.78;0.60;204.44;3.61;705;17;884.00;1
1970;17;628489096;1970;189;2676;2677;9.80;0.60;204.55;3.61;706;17;885.00;1
1973;17;628489108;1973;188;2678;2678;9.84;0.60;204.44;3.60;705;17;886.00;0
1976;17;628489127;1976;186;2678;2678;9.87;0.60;204.56;3.60;702;17;887.00;0
1979;17;628489138;1979;188;2682;2682;9.91;0.60;204.75;3.60;703;17;888.00;0
1984;17;628489150;1984;190;2682;2682;9.91;0.60;204.99;3.60;698;17;889.00;0
1987;17;628489167;1987;191;2682;2682;9.93;0.60;204.94;3.60;695;17;890.00;0
1990;17;628489179;1990;190;2683;2683;9.97;0.61;205.19;3.60;693;17;891.00;0
1992;17;628489197;1992;198;2683;2683;10.00;0.61;205.22;3.60;691;17;892.00;0
1996;17;628489208;1996;197;2688;2689;9.95;0.61;205.30;3.59;692;17;893.00;1
1999;17;628489221;1999;199;2688;2689;9.90;0.60;205.38;3.59;689;17;894.00;1
2001;17;628489232;2001;197;2690;2690;9.77;0.59;205.44;3.59;689;17;895.00;0
2006;17;628489251;2006;201;2690;2690;9.66;0.59;205.50;3.59;684;17;896.00;0
2009;17;628489263;2009;193;2690;2690;9.64;0.59;205.76;3.59;681;17;897.00;0
2011;17;628489275;2011;190;2690;2690;9.68;0.59;205.84;3.59;679;17;898.00;0
2016;17;628489289;2016;187;2690;2690;9.75;0.60;206.08;3.59;674;17;899.00;0
2017;17;628489304;2017;195;2719;2736;9.72;0.60;206.22;3.55;702;17;900.00;17
2022;17;628489326;2022;186;2719;2736;9.82;0.60;206.57;3.55;697;17;901.00;17
2026;17;628489338;2026;184;2722;2736;9.96;0.61;206.64;3.55;696;17;902.00;14
2028;17;628489363;2028;179;2722;2736;10.10;0.62;206.87;3.55;694;17;903.00;14
2033;17;628489378;2033;179;2724;2736;10.14;0.62;206.94;3.55;691;17;904.00;12
2036;17;628489390;2036;177;2724;2736;10.16;0.62;206.85;3.55;688;17;905.00;12
2039;17;628489402;2039;163;2729;2740;10.12;0.62;207.31;3.55;690;17;906.00;11
2043;17;628489420;2043;156;2730;2740;10.17;0.62;207.43;3.55;687;17;907.00;10
2045;17;628489432;2045;145;2733;2744;10.28;0.63;207.58;3.55;688;17;908.00;11
2048;17;628489445;2048;137;2734;2745;10.38;0.63;207.62;3.55;686;17;909.00;11
2053;17;628489458;2053;131;2736;2745;10.35;0.63;207.87;3.55;683;17;910.00;9
2054;17;628489471;2054;127;2736;2745;10.43;0.64;207.94;3.55;682;17;911.00;9
2057;17;628489483;2057;123;2745;2758;10.58;0.65;207.87;3.54;688;17;912.00;13
2059;17;628489496;2059;112;2745;2758;10.72;0.65;207.93;3.54;686;17;913.00;13
2061;17;628489509;2061;107;2745;2758;10.83;0.66;208.04;3.54;684;17;914.00;13
2063;17;628489520;2063;105;2746;2759;11.01;0.67;208.11;3.54;683;17;915.00;13
2065;17;628489533;2065;107;2749;2760;11.12;0.68;208.28;3.55;684;17;916.00;11
2068;17;628489545;2068;110;2749;2760;11.16;0.68;208.22;3.55;681;17;917.00;11
2069;17;628489564;2069;107;2751;2763;11.31;0.69;208.28;3.55;682;17;918.00;12
2074;17;628489579;2074;110;2751;2763;11.29;0.69;208.44;3.55;677;17;919.00;12
2079;17;628489592;2079;114;2751;2763;11.34;0.69;208.49;3.55;672;17;920.00;12
2081;18;628489603;2081;118;2751;2763;11.37;0.69;208.67;3.55;670;18;921.00;12
2085;18;628489631;2085;125;2757;2769;11.42;0.70;209.05;3.56;672;18;922.00;12
2088;18;628489644;2088;119;2757;2769;11.50;0.70;209.24;3.56;669;18;923.00;12
2091;18;628489656;2091;120;2757;2769;11.55;0.70;209.23;3.56;666;18;924.00;12
2095;18;628489667;2095;122;2757;2769;11.63;0.70;209.10;3.56;662;18;925.00;12
2100;18;628489678;2100;125;2761;2773;11.65;0.70;209.11;3.55;661;18;926.00;12
2101;18;628489690;2101;130;2763;2774;11.65;0.71;209.11;3.56;662;18;927.00;11
2103;18;628489701;2103;138;2765;2774;11.61;0.70;209.06;3.57;662;18;928.00;9
2107;18;628489711;2107;138;2766;2775;11.57;0.70;209.09;3.57;659;18;929.00;9
2107;18;628489725;2107;144;2768;2775;11.58;0.70;209.09;3.59;661;18;930.00;7
2109;18;628489735;2109;149;2768;2775;11.57;0.70;209.05;3.59;659;18;931.00;7
2114;18;628489752;2114;153;2769;2775;11.50;0.70;209.15;3.59;655;18;932.00;6
2116;18;628489769;2116;155;2770;2775;11.41;0.69;209.15;3.60;654;18;933.00;5
2118;18;628489781;2118;162;2770;2775;11.33;0.69;209.12;3.60;652;18;934.00;5
2124;18;628489791;2124;163;2771;2775;11.25;0.68;209.32;3.60;647;18;935.00;4
2124;18;628489803;2124;171;2804;2845;11.00;0.67;209.32;3.56;680;18;936.00;41
2126;18;628489819;2126;170;2810;2846;10.93;0.67;209.36;3.57;684;18;937.00;36
2127;18;628489832;2127;165;2816;2846;11.04;0.67;209.36;3.57;689;18;938.00;30
2129;18;628489847;2129;163;2819;2846;11.06;0.67;209.46;3.57;690;18;939.00;27
2132;18;628489864;2132;161;2822;2846;11.14;0.68;209.44;3.57;690;18;940.00;24
2133;18;628489882;2133;156;2827;2846;11.20;0.68;209.46;3.57;694;18;941.00;19
2135;18;628489908;2135;157;2831;2846;11.30;0.69;209.44;3.58;696;18;942.00;15
2137;18;628489924;2137;163;2835;2846;11.38;0.69;209.40;3.58;698;18;943.00;11
2140;19;628489948;2140;163;2836;2847;11.51;0.70;209.38;3.58;696;19;944.00;11
2145;19;628489982;2145;165;2840;2849;11.54;0.70;209.41;3.58;695;19;945.00;9
2145;19;628489995;2145;169;2840;2849;11.54;0.70;209.41;3.58;695;19;946.00;9
2147;19;628490006;2147;169;2844;2853;11.51;0.70;209.39;3.58;697;19;947.00;9
2153;19;628490019;2153;174;2844;2853;11.46;0.70;209.65;3.58;691;19;948.00;9
2158;19;628490032;2158;170;2844;2853;11.43;0.70;209.65;3.58;686;19;949.00;9
2162;19;628490043;2162;170;2844;2853;11.42;0.70;209.69;3.58;682;19;950.00;9
2166;19;628490055;2166;169;2847;2859;11.36;0.69;209.71;3.58;681;19;951.00;12
2171;19;628490069;2171;168;2847;2859;11.35;0.69;209.68;3.58;676;19;952.00;12
2175;19;628490081;2175;166;2849;2859;11.25;0.68;209.52;3.58;674;19;953.00;10
2179;19;628490092;2179;164;2851;2862;11.21;0.68;209.29;3.58;672;19;954.00;11
2182;19;628490104;2182;168;2854;2862;11.09;0.68;209.16;3.59;672;19;955.00;8
2187;19;628490116;2187;163;2854;2862;11.07;0.67;208.97;3.59;667;19;956.00;8
2189;19;628490128;2189;165;2854;2863;11.01;0.67;208.86;3.59;665;19;957.00;9
2195;19;628490139;2195;165;2855;2864;10.97;0.67;208.86;3.59;660;19;958.00;9
2198;19;628490151;2198;167;2855;2864;10.92;0.66;208.87;3.59;657;19;959.00;9
2200;19;628490164;2200;170;2872;2890;10.75;0.66;208.76;3.57;672;19;960.00;18
2201;19;628490178;2201;165;2872;2890;10.74;0.66;208.71;3.57;671;19;961.00;18
2204;19;628490189;2204;159;2874;2890;10.78;0.66;208.58;3.57;670;19;962.00;16
2207;19;628490200;2207;162;2876;2891;10.86;0.66;208.44;3.57;669;19;963.00;15
2207;19;628490212;2207;168;2876;2891;10.96;0.67;208.44;3.57;669;19;964.00;15
2209;19;628490223;2209;169;2878;2895;10.92;0.67;208.41;3.56;669;19;965.00;17
2211;19;628490235;2211;169;2878;2895;10.85;0.66;208.34;3.56;667;19;966.00;17
2214;19;628490247;2214;173;2882;2899;10.81;0.66;208.39;3.56;668;19;967.00;17
2217;19;628490259;2217;177;2882;2899;10.74;0.65;208.34;3.56;665;19;968.00;17
2222;19;628490278;2222;180;2884;2899;10.66;0.65;208.23;3.59;662;19;969.00;15
2222;19;628490290;2222;182;2884;2899;10.51;0.64;208.23;3.59;662;19;970.00;15
2224;19;628490301;2224;179;2885;2899;10.35;0.63;208.20;3.61;661;19;971.00;14
2227;19;628490314;2227;180;2897;2911;10.27;0.62;208.16;3.60;670;19;972.00;14
2227;19;628490327;2227;188;2899;2911;10.17;0.62;208.16;3.60;672;19;973.00;12
2229;19;628490338;2229;187;2900;2911;10.09;0.61;208.16;3.61;671;19;974.00;11
2229;19;628490349;2229;195;2900;2911;9.99;0.61;208.16;3.61;671;19;975.00;11
2230;19;628490359;2230;203;2901;2911;9.85;0.60;208.19;3.61;671;19;976.00;10
2232;19;628490370;2232;209;2902;2911;9.78;0.59;208.22;3.62;670;19;977.00;9
2232;19;628490381;2232;215;2902;2912;9.68;0.59;208.22;3.62;670;19;978.00;10
2233;19;628490392;2233;208;2902;2912;9.58;0.59;208.17;3.62;669;19;979.00;10
2235;19;628490411;2235;197;2907;2918;9.61;0.59;208.19;3.62;672;19;980.00;11
2235;19;628490430;2235;193;2909;2919;9.63;0.59;208.19;3.63;674;19;981.00;10
2236;19;628490441;2236;192;2910;2919;9.62;0.59;208.21;3.63;674;19;982.00;9
2238;19;628490452;2238;194;2911;2919;9.66;0.59;208.14;3.64;673;19;983.00;8
2239;20;628490463;2239;193;2915;2923;9.71;0.59;208.06;3.65;676;20;984.00;8
2241;20;628490488;2241;193;2916;2923;9.68;0.59;208.03;3.65;675;20;985.00;7
2244;20;628490509;2244;192;2917;2923;9.63;0.59;208.03;3.67;673;20;986.00;6
2248;20;628490520;2248;193;2920;2924;9.66;0.59;207.95;3.68;672;20;987.00;4
2251;20;628490532;2251;194;2923;2928;9.60;0.58;207.89;3.68;672;20;988.00;5
2251;20;628490559;2251;191;2924;2928;9.59;0.58;207.89;3.69;673;20;989.00;4
2253;20;628490585;2253;194;2928;2934;9.58;0.58;207.80;3.69;675;20;990.00;6
2253;20;628490599;2253;199;2929;2934;9.55;0.58;207.80;3.69;676;20;991.00;5
2253;20;628490612;2253;202;2930;2934;9.50;0.58;207.80;3.69;677;20;992.00;4
2253;20;628490624;2253;201;2933;2934;9.38;0.57;207.80;3.69;680;20;993.00;1
2254;20;628490636;2254;203;2936;2938;9.39;0.58;207.83;3.69;682;20;994.00;2
2255;20;628490648;2255;211;2936;2938;9.32;0.57;207.91;3.69;681;20;995.00;2
2257;20;628490660;2257;211;2937;2938;9.21;0.57;207.86;3.69;680;20;996.00;1
2257;20;628490671;2257;217;2937;2938;9.14;0.56;207.86;3.69;680;20;997.00;1
2258;20;628490681;2258;220;2939;2939;9.01;0.56;207.86;3.69;681;20;998.00;0
2261;20;628490694;2261;218;2940;2940;8.90;0.55;207.89;3.69;679;20;999.00;0
2263;20;628490705;2263;214;2940;2940;8.77;0.54;207.88;3.69;677;20;1000.00;0
2269;20;628490720;2269;211;2941;2941;8.69;0.54;207.90;3.69;672;20;1001.00;0
2273;20;628490735;2273;216;2941;2941;8.58;0.53;207.97;3.69;668;20;1002.00;0
2276;20;628490747;2276;214;2941;2941;8.49;0.52;207.87;3.69;665;20;1003.00;0
2278;20;628490758;2278;208;2941;2941;8.42;0.52;207.82;3.69;663;20;1004.00;0
2282;20;628490769;2282;209;2941;2941;8.34;0.51;207.91;3.69;659;20;1005.00;0
2286;20;628490780;2286;206;2941;2941;8.22;0.51;207.96;3.69;655;20;1006.00;0
2288;20;628490790;2288;208;2941;2941;8.22;0.51;207.89;3.69;653;20;1007.00;0
2293;20;628490800;2293;232;3019;3068;8.30;0.52;207.90;3.59;726;20;1008.00;49
2295;20;628490833;2295;226;3023;3069;8.23;0.51;207.88;3.59;728;20;1009.00;46
2297;20;628490845;2297;219;3031;3069;8.31;0.52;207.83;3.59;734;20;1010.00;38
2299;20;628490855;2299;222;3035;3069;8.28;0.52;207.93;3.58;736;20;1011.00;34
2304;20;628490866;2304;219;3040;3069;8.18;0.51;207.93;3.59;736;20;1012.00;29
2307;20;628490877;2307;222;3044;3069;8.10;0.50;207.89;3.59;737;20;1013.00;25
2310;20;628490887;2310;222;3048;3069;8.08;0.50;207.94;3.59;738;20;1014.00;21
2312;20;628490897;2312;219;3050;3069;8.13;0.50;208.02;3.59;738;20;1015.00;19
2316;20;628490906;2316;219;3054;3070;8.10;0.50;208.03;3.60;738;20;1016.00;16
2320;20;628490916;2320;223;3056;3071;8.06;0.50;207.97;3.60;736;20;1017.00;15
2323;20;628490927;2323;235;3060;3071;8.02;0.50;208.19;3.61;737;20;1018.00;11
2327;20;628490937;2327;237;3062;3072;7.97;0.49;208.08;3.61;735;20;1019.00;10
2330;20;628490948;2330;226;3065;3072;7.89;0.49;208.22;3.62;735;20;1020.00;7
2334;20;628490958;2334;219;3066;3072;7.87;0.49;208.39;3.62;732;20;1021.00;6
2339;20;628490968;2339;225;3067;3072;7.78;0.48;208.55;3.62;728;20;1022.00;5
2345;20;628490979;2345;218;3070;3076;7.81;0.48;208.68;3.63;725;20;1023.00;6
2348;20;628490990;2348;219;3072;3076;7.84;0.48;208.63;3.63;724;20;1024.00;4
2352;20;628491000;2352;220;3073;3076;7.88;0.49;208.68;3.63;721;20;1025.00;3
2358;20;628491011;2358;215;3076;3079;7.93;0.49;208.73;3.64;718;20;1026.00;3
2360;20;628491023;2360;204;3077;3079;8.11;0.50;208.77;3.64;717;20;1027.00;2
2366;20;628491035;2366;196;3079;3079;8.25;0.51;208.95;3.64;713;20;1028.00;0
2370;20;628491046;2370;190;3083;3083;8.42;0.52;208.97;3.64;713;20;1029.00;0
2371;20;628491056;2371;181;3084;3084;8.71;0.54;208.94;3.63;713;20;1030.00;0
2376;20;628491066;2376;179;3084;3084;8.86;0.54;209.16;3.63;708;20;1031.00;0
2379;20;628491075;2379;176;3088;3088;9.05;0.55;209.19;3.63;709;20;1032.00;0
2384;20;628491086;2384;172;3088;3088;9.12;0.56;209.23;3.63;704;20;1033.00;0
2389;20;628491098;2389;169;3088;3088;9.21;0.56;209.14;3.63;699;20;1034.00;0
2395;20;628491107;2395;166;3090;3090;9.25;0.56;209.22;3.63;695;20;1035.00;0
2399;20;628491118;2399;169;3090;3090;9.32;0.57;209.31;3.63;691;20;1036.00;0
2404;20;628491128;2404;164;3095;3096;9.46;0.58;209.45;3.62;691;20;1037.00;1
2409;20;628491139;2409;158;3095;3096;9.57;0.58;209.49;3.62;686;20;1038.00;1
2412;20;628491149;2412;158;3097;3097;9.63;0.58;209.67;3.62;685;20;1039.00;0
2413;20;628491165;2413;156;3097;3097;9.69;0.59;209.79;3.62;684;20;1040.00;0
2417;20;628491175;2417;164;3097;3097;9.72;0.59;210.13;3.62;680;20;1041.00;0
2420;21;628491184;2420;166;3097;3097;9.75;0.59;210.23;3.62;677;21;1042.00;0
2422;21;628491210;2422;169;3097;3097;9.75;0.59;210.36;3.62;675;21;1043.00;0
2428;21;628491220;2428;169;3108;3109;9.85;0.60;210.67;3.61;680;21;1044.00;1
2431;21;628491231;2431;165;3108;3109;9.90;0.60;210.74;3.61;677;21;1045.00;1
2434;21;628491241;2434;163;3109;3109;9.98;0.61;210.89;3.61;675;21;1046.00;0
2440;21;628491252;2440;167;3109;3109;10.02;0.61;211.05;3.61;669;21;1047.00;0
2443;21;628491262;2443;162;3109;3109;10.04;0.61;211.39;3.61;666;21;1048.00;0
2448;21;628491272;2448;160;3109;3109;10.04;0.61;211.46;3.61;661;21;1049.00;0
2452;21;628491284;2452;162;3115;3115;10.05;0.61;211.89;3.60;663;21;1050.00;0
2454;21;628491295;2454;158;3115;3115;10.14;0.62;211.99;3.60;661;21;1051.00;0
2460;21;628491304;2460;158;3118;3119;10.23;0.62;212.38;3.60;658;21;1052.00;1
2463;21;628491315;2463;160;3120;3120;10.33;0.63;212.39;3.60;657;21;1053.00;0
2467;21;628491325;2467;165;3120;3120;10.46;0.64;212.53;3.60;653;21;1054.00;0
2470;21;628491335;2470;163;3120;3120;10.50;0.64;212.55;3.60;650;21;1055.00;0
2474;21;628491344;2474;168;3133;3133;10.44;0.63;212.72;3.58;659;21;1056.00;0
2478;21;628491355;2478;170;3133;3133;10.42;0.63;212.79;3.58;655;21;1057.00;0
2482;21;628491370;2482;171;3133;3133;10.36;0.63;212.67;3.58;651;21;1058.00;0
2488;21;628491380;2488;170;3134;3134;10.26;0.62;212.97;3.58;646;21;1059.00;0
2492;21;628491390;2492;172;3135;3135;10.28;0.62;213.08;3.58;643;21;1060.00;0
2493;21;628491399;2493;177;3135;3135;10.25;0.62;213.16;3.58;642;21;1061.00;0
2498;21;628491409;2498;177;3137;3138;10.22;0.62;213.49;3.58;639;21;1062.00;1
2504;21;628491418;2504;182;3138;3138;10.16;0.62;213.62;3.58;634;21;1063.00;0
2505;21;628491428;2505;186;3138;3138;10.13;0.62;213.58;3.58;633;21;1064.00;0
2510;21;628491436;2510;195;3138;3138;10.05;0.61;213.78;3.58;628;21;1065.00;0
2512;21;628491446;2512;201;3143;3144;9.95;0.61;213.90;3.58;631;21;1066.00;1
2515;21;628491456;2515;194;3143;3144;9.89;0.61;214.10;3.58;628;21;1067.00;1
2522;21;628491466;2522;192;3144;3144;9.82;0.60;214.15;3.58;622;21;1068.00;0
2523;21;628491476;2523;189;3144;3144;9.75;0.60;214.21;3.58;621;21;1069.00;0
2526;21;628491485;2526;189;3148;3148;9.67;0.59;214.44;3.57;622;21;1070.00;0
2528;21;628491495;2528;192;3149;3149;9.55;0.58;214.70;3.57;621;21;1071.00;0
2530;21;628491504;2530;187;3149;3149;9.49;0.58;214.80;3.57;619;21;1072.00;0
2534;21;628491513;2534;189;3150;3150;9.45;0.58;214.96;3.57;616;21;1073.00;0
2537;21;628491522;2537;190;3150;3150;9.48;0.58;214.98;3.57;613;21;1074.00;0
2539;21;628491531;2539;193;3150;3150;9.54;0.58;214.96;3.57;611;21;1075.00;0
2544;21;628491540;2544;181;3150;3150;9.51;0.58;214.92;3.57;606;21;1076.00;0
2548;21;628491549;2548;169;3150;3150;9.57;0.58;214.85;3.57;602;21;1077.00;0
2550;21;628491564;2550;164;3150;3150;9.66;0.59;214.80;3.57;600;21;1078.00;0
2555;21;628491573;2555;151;3150;3150;9.85;0.60;214.83;3.57;595;21;1079.00;0
2558;21;628491584;2558;168;3228;3275;9.63;0.59;214.90;3.48;670;21;1080.00;47
2560;21;628491609;2560;151;3231;3276;9.74;0.60;214.91;3.48;671;21;1081.00;45
2560;21;628491619;2560;136;3237;3276;9.95;0.61;214.91;3.48;677;21;1082.00;39
2561;21;628491628;2561;124;3242;3276;10.15;0.62;215.03;3.48;681;21;1083.00;34
2565;21;628491638;2565;117;3246;3276;10.28;0.63;215.03;3.48;681;21;1084.00;30
2567;21;628491648;2567;118;3249;3276;10.32;0.63;215.03;3.48;682;21;1085.00;27
2572;21;628491658;2572;117;3252;3276;10.32;0.63;215.17;3.48;680;21;1086.00;24
2574;21;628491667;2574;126;3252;3276;10.42;0.64;215.13;3.48;678;21;1087.00;24
2578;21;628491677;2578;128;3255;3277;10.50;0.64;215.13;3.48;677;21;1088.00;22
2580;21;628491687;2580;125;3257;3278;10.47;0.64;215.21;3.49;677;21;1089.00;21
2583;21;628491697;2583;126;3259;3278;10.44;0.64;215.18;3.49;676;21;1090.00;19
2583;21;628491706;2583;135;3264;3282;10.42;0.64;215.18;3.49;681;21;1091.00;18
2585;21;628491716;2585;139;3266;3282;10.33;0.63;215.14;3.49;681;21;1092.00;16
2586;21;628491725;2586;145;3267;3282;10.29;0.63;215.15;3.50;681;21;1093.00;15
2588;21;628491736;2588;150;3267;3282;10.29;0.63;215.15;3.50;679;21;1094.00;15
2588;21;628491746;2588;152;3271;3288;10.32;0.63;215.15;3.49;683;21;1095.00;17
2589;21;628491756;2589;156;3271;3288;10.40;0.64;215.10;3.49;682;21;1096.00;17
2591;21;628491770;2591;162;3272;3288;10.49;0.64;215.10;3.49;681;21;1097.00;16
2593;21;628491780;2593;162;3274;3291;10.63;0.65;215.14;3.49;681;21;1098.00;17
2596;21;628491789;2596;167;3274;3291;10.69;0.65;215.10;3.49;678;21;1099.00;17
2598;21;628491805;2598;172;3275;3291;10.79;0.66;215.14;3.49;677;21;1100.00;16
2600;21;628491819;2600;172;3276;3292;10.78;0.66;215.07;3.49;676;21;1101.00;16
2603;21;628491828;2603;174;3277;3293;10.78;0.66;215.03;3.49;674;21;1102.00;16
2606;21;628491843;2606;178;3277;3293;10.86;0.66;215.15;3.49;671;21;1103.00;16
2609;21;628491858;2609;182;3287;3306;10.79;0.66;215.05;3.48;678;21;1104.00;19
2612;21;628491875;2612;183;3287;3306;10.82;0.66;214.87;3.48;675;21;1105.00;19
2612;21;628491890;2612;184;3287;3306;10.83;0.66;214.87;3.48;675;21;1106.00;19
2614;21;628491903;2614;183;3289;3307;10.82;0.66;214.84;3.48;675;21;1107.00;18
2614;21;628491918;2614;189;3289;3307;10.87;0.67;214.84;3.48;675;21;1108.00;18
2616;21;628491932;2616;189;3292;3311;10.92;0.67;214.81;3.48;676;21;1109.00;19
2620;21;628491948;2620;192;3292;3311;10.96;0.67;214.85;3.48;672;21;1110.00;19
2623;21;628491958;2623;193;3296;3315;10.95;0.67;214.83;3.48;673;21;1111.00;19
2625;21;628491968;2625;189;3296;3315;11.03;0.67;214.74;3.48;671;21;1112.00;19
2628;21;628491980;2628;191;3296;3315;11.14;0.68;214.64;3.48;668;21;1113.00;19
2630;21;628491990;2630;187;3296;3315;11.24;0.69;214.67;3.48;666;21;1114.00;19
2636;22;628491999;2636;189;3296;3315;11.23;0.68;214.61;3.48;660;22;1115.00;19
2636;22;628492020;2636;187;3306;3327;11.25;0.69;214.61;3.47;670;22;1116.00;21
2639;23;628492030;2639;191;3306;3327;11.22;0.68;214.57;3.47;667;23;1117.00;21
2641;23;628492047;2641;191;3307;3327;11.26;0.69;214.51;3.47;666;23;1118.00;20
2644;23;628492061;2644;190;3307;3327;11.29;0.69;214.42;3.47;663;23;1119.00;20
2648;23;628492071;2648;189;3307;3327;11.26;0.69;214.32;3.47;659;23;1120.00;20
2651;23;628492079;2651;189;3307;3327;11.26;0.68;214.25;3.47;656;23;1121.00;20
2657;23;628492088;2657;188;3308;3328;11.25;0.68;214.11;3.48;651;23;1122.00;20
2660;23;628492098;2660;187;3309;3328;11.23;0.68;214.05;3.49;649;23;1123.00;19
2662;23;628492107;2662;186;3313;3334;11.27;0.68;213.99;3.48;651;23;1124.00;21
2663;23;628492117;2663;182;3317;3336;11.22;0.68;213.95;3.49;654;23;1125.00;19
2665;23;628492126;2665;179;3318;3336;11.19;0.68;213.96;3.49;653;23;1126.00;18
2666;23;628492135;2666;179;3319;3336;11.18;0.68;213.93;3.50;653;23;1127.00;17
2668;23;628492148;2668;177;3322;3340;11.19;0.68;213.90;3.50;654;23;1128.00;18
2670;23;628492158;2670;175;3322;3340;11.20;0.68;213.87;3.50;652;23;1129.00;18
2671;23;628492166;2671;179;3324;3340;11.22;0.68;213.89;3.53;653;23;1130.00;16
2675;23;628492175;2675;167;3325;3341;11.19;0.68;213.80;3.53;650;23;1131.00;16
2677;23;628492190;2677;158;3328;3345;11.15;0.68;213.75;3.53;651;23;1132.00;17
2679;23;628492200;2679;148;3329;3345;11.17;0.68;213.98;3.54;650;23;1133.00;16
2680;23;628492220;2680;140;3331;3348;11.27;0.68;213.97;3.54;651;23;1134.00;17
2680;23;628492230;2680;135;3333;3348;11.30;0.68;213.97;3.55;653;23;1135.00;15
2682;23;628492246;2682;135;3333;3348;11.39;0.69;213.97;3.55;651;23;1136.00;15
2685;23;628492256;2685;125;3333;3348;11.42;0.69;213.79;3.55;648;23;1137.00;15
2685;23;628492265;2685;120;3337;3352;11.46;0.69;213.79;3.57;652;23;1138.00;15
2687;23;628492275;2687;113;3337;3352;11.53;0.70;213.79;3.57;650;23;1139.00;15
2688;23;628492286;2688;112;3338;3352;11.54;0.70;213.78;3.57;650;23;1140.00;14
2689;24;628492295;2689;116;3339;3352;11.52;0.70;213.79;3.58;650;24;1141.00;13
2689;24;628492316;2689;114;3339;3353;11.53;0.70;213.79;3.58;650;24;1142.00;14
2689;24;628492325;2689;118;3340;3354;11.49;0.70;213.79;3.58;651;24;1143.00;14
2691;24;628492335;2691;122;3340;3354;11.42;0.69;213.80;3.58;649;24;1144.00;14
2691;24;628492345;2691;124;3341;3355;11.44;0.70;213.80;3.58;650;24;1145.00;14
2691;24;628492354;2691;128;3341;3355;11.48;0.70;213.80;3.58;650;24;1146.00;14
2691;25;628492364;2691;135;3341;3355;11.47;0.70;213.80;3.58;650;25;1147.00;14
2693;25;628492391;2693;137;3341;3355;11.40;0.70;213.82;3.58;648;25;1148.00;14
2695;25;628492400;2695;142;3341;3355;11.30;0.69;213.80;3.58;646;25;1149.00;14
2699;25;628492410;2699;145;3343;3355;11.21;0.68;213.75;3.61;644;25;1150.00;12
2701;25;628492420;2701;148;3343;3355;11.18;0.68;213.77;3.61;642;25;1151.00;12
2703;25;628492429;2703;169;3411;3482;10.98;0.68;213.75;3.55;708;25;1152.00;71
2709;25;628492454;2709;162;3418;3483;10.97;0.68;213.75;3.55;709;25;1153.00;65
2711;25;628492464;2711;161;3427;3483;11.02;0.68;213.75;3.56;716;25;1154.00;56
2714;25;628492475;2714;163;3433;3483;11.00;0.68;213.76;3.57;719;25;1155.00;50
2719;25;628492484;2719;168;3440;3483;10.91;0.67;213.91;3.58;721;25;1156.00;43
2719;25;628492494;2719;169;3442;3483;10.80;0.66;213.91;3.58;723;25;1157.00;41
2720;25;628492503;2720;175;3447;3483;10.75;0.66;213.90;3.59;727;25;1158.00;36
2722;25;628492512;2722;177;3450;3483;10.66;0.66;214.18;3.59;728;25;1159.00;33
2725;25;628492522;2725;180;3455;3484;10.66;0.66;214.12;3.60;730;25;1160.00;29
2728;25;628492538;2728;186;3457;3485;10.58;0.65;214.15;3.60;729;25;1161.00;28
2732;25;628492548;2732;188;3462;3485;10.52;0.65;214.55;3.62;730;25;1162.00;23
2736;25;628492558;2736;196;3462;3486;10.45;0.64;214.65;3.62;726;25;1163.00;24
2737;25;628492568;2737;200;3466;3486;10.37;0.64;214.63;3.63;729;25;1164.00;20
2741;25;628492578;2741;209;3467;3486;10.19;0.63;214.68;3.63;726;25;1165.00;19
2743;25;628492588;2743;217;3470;3486;10.03;0.62;214.68;3.64;727;25;1166.00;16
2748;25;628492599;2748;223;3473;3490;9.86;0.61;214.68;3.64;725;25;1167.00;17
2750;25;628492609;2750;232;3477;3490;9.67;0.59;214.64;3.65;727;25;1168.00;13
2753;25;628492619;2753;231;3478;3490;9.53;0.59;214.56;3.66;725;25;1169.00;12
2754;25;628492636;2754;234;3482;3496;9.49;0.58;214.57;3.66;728;25;1170.00;14
2756;25;628492647;2756;234;3483;3496;9.42;0.58;214.52;3.66;727;25;1171.00;13
2758;25;628492658;2758;238;3485;3496;9.43;0.58;214.48;3.66;727;25;1172.00;11
2760;25;628492668;2760;241;3489;3500;9.35;0.57;214.47;3.66;729;25;1173.00;11
2763;25;628492678;2763;243;3491;3501;9.34;0.57;214.50;3.66;728;25;1174.00;10
2765;25;628492690;2765;240;3491;3501;9.28;0.57;214.49;3.66;726;25;1175.00;10
2767;25;628492700;2767;246;3496;3505;9.29;0.57;214.52;3.66;729;25;1176.00;9
2771;25;628492710;2771;243;3496;3505;9.24;0.57;214.43;3.66;725;25;1177.00;9
2775;25;628492727;2775;242;3497;3505;9.23;0.57;214.48;3.66;722;25;1178.00;8
2779;25;628492737;2779;246;3498;3506;9.21;0.56;214.52;3.66;719;25;1179.00;8
2781;25;628492756;2781;242;3499;3506;9.13;0.56;214.55;3.66;718;25;1180.00;7
2786;25;628492766;2786;245;3504;3512;9.11;0.56;214.49;3.66;718;25;1181.00;8
2792;25;628492776;2792;244;3504;3512;9.03;0.55;214.61;3.66;712;25;1182.00;8
2795;25;628492786;2795;247;3506;3513;8.94;0.55;214.64;3.65;711;25;1183.00;7
2801;25;628492796;2801;245;3506;3513;8.91;0.55;214.70;3.65;705;25;1184.00;7
2803;25;628492805;2803;248;3506;3513;8.89;0.54;214.82;3.65;703;25;1185.00;7
2809;25;628492815;2809;248;3506;3513;8.85;0.54;215.05;3.65;697;25;1186.00;7
2811;25;628492824;2811;247;3506;3513;8.83;0.54;215.11;3.65;695;25;1187.00;7
2815;25;628492834;2815;252;3517;3525;8.81;0.54;215.27;3.64;702;25;1188.00;8
2822;25;628492852;2822;251;3517;3525;8.77;0.54;215.45;3.64;695;25;1189.00;8
2828;25;628492861;2828;243;3518;3525;8.75;0.54;215.68;3.64;690;25;1190.00;7
2834;25;628492876;2834;236;3518;3525;8.74;0.54;215.93;3.64;684;25;1191.00;7
2836;25;628492886;2836;228;3518;3525;8.82;0.54;216.00;3.64;682;25;1192.00;7
2843;25;628492895;2843;219;3518;3525;8.82;0.54;216.24;3.64;675;25;1193.00;7
2844;25;628492904;2844;217;3522;3529;8.84;0.54;216.28;3.64;678;25;1194.00;7
2848;25;628492913;2848;215;3522;3529;8.83;0.54;216.34;3.64;674;25;1195.00;7
2854;25;628492922;2854;209;3525;3533;8.86;0.54;216.61;3.64;671;25;1196.00;8
2856;25;628492932;2856;203;3526;3534;8.95;0.55;216.56;3.64;670;25;1197.00;8
2862;25;628492942;2862;200;3527;3534;8.92;0.55;216.78;3.64;665;25;1198.00;7
2866;25;628492951;2866;201;3527;3534;8.96;0.55;216.83;3.64;661;25;1199.00;7
2872;25;628492962;2872;204;3549;3575;8.87;0.54;216.86;3.61;677;25;1200.00;26
2878;25;628492981;2878;196;3550;3575;8.96;0.55;216.94;3.61;672;25;1201.00;25
2879;25;628492990;2879;189;3553;3575;9.14;0.56;216.93;3.61;674;25;1202.00;22
2885;25;628492998;2885;188;3555;3576;9.22;0.56;217.08;3.61;670;25;1203.00;21
2890;25;628493008;2890;189;3559;3577;9.33;0.57;217.22;3.61;669;25;1204.00;18
2893;25;628493017;2893;183;3561;3577;9.44;0.58;217.40;3.61;668;25;1205.00;16
2899;25;628493026;2899;176;3563;3580;9.53;0.58;217.46;3.61;664;25;1206.00;17
2904;25;628493036;2904;170;3563;3580;9.54;0.58;217.54;3.61;659;25;1207.00;17
2910;25;628493045;2910;168;3565;3580;9.51;0.58;217.60;3.61;655;25;1208.00;15
2915;25;628493054;2915;171;3565;3580;9.46;0.58;217.78;3.61;650;25;1209.00;15
2919;25;628493063;2919;175;3569;3586;9.52;0.58;217.84;3.61;650;25;1210.00;17
2924;25;628493072;2924;180;3572;3586;9.42;0.58;217.89;3.61;648;25;1211.00;14
2927;25;628493082;2927;178;3573;3586;9.35;0.57;217.96;3.61;646;25;1212.00;13
2935;25;628493092;2935;177;3573;3586;9.25;0.57;218.00;3.61;638;25;1213.00;13
2938;25;628493107;2938;175;3577;3590;9.22;0.57;218.15;3.61;639;25;1214.00;13
2941;25;628493117;2941;179;3579;3592;9.22;0.57;218.09;3.61;638;25;1215.00;13
2944;25;628493126;2944;177;3579;3592;9.17;0.56;218.09;3.61;635;25;1216.00;13
2948;25;628493135;2948;177;3581;3593;9.12;0.56;218.22;3.61;633;25;1217.00;12
2950;25;628493144;2950;185;3581;3593;9.09;0.56;218.24;3.61;631;25;1218.00;12
2955;25;628493153;2955;186;3582;3593;9.05;0.56;218.30;3.65;627;25;1219.00;11
2960;25;628493162;2960;187;3582;3593;9.02;0.55;218.40;3.65;622;25;1220.00;11
2961;25;628493171;2961;191;3582;3593;9.07;0.56;218.40;3.65;621;25;1221.00;11
2966;25;628493180;2966;194;3583;3593;9.08;0.56;218.16;3.65;617;25;1222.00;10
2970;25;628493189;2970;198;3583;3593;9.02;0.55;218.23;3.65;613;25;1223.00;10
2977;25;628493198;2977;217;3623;3663;8.81;0.54;218.06;3.61;646;25;1224.00;40
2981;25;628493212;2981;209;3624;3664;8.79;0.54;218.10;3.61;643;25;1225.00;40
2985;25;628493221;2985;205;3628;3664;8.85;0.54;218.18;3.61;643;25;1226.00;36
2987;25;628493230;2987;208;3631;3664;8.89;0.54;218.19;3.61;644;25;1227.00;33
2990;25;628493239;2990;215;3636;3666;8.95;0.55;218.18;3.62;646;25;1228.00;30
2993;25;628493249;2993;215;3638;3666;8.94;0.55;218.23;3.62;645;25;1229.00;28
2995;25;628493260;2995;219;3642;3666;8.99;0.55;218.29;3.62;647;25;1230.00;24
2998;25;628493269;2998;226;3645;3666;8.99;0.55;218.33;3.62;647;25;1231.00;21
3002;25;628493277;3002;238;3649;3667;8.92;0.54;218.39;3.63;647;25;1232.00;18
3004;25;628493287;3004;245;3650;3668;8.80;0.54;218.42;3.63;646;25;1233.00;18
3005;25;628493296;3005;255;3654;3668;8.66;0.53;218.40;3.64;649;25;1234.00;14
3007;25;628493304;3007;261;3660;3672;8.50;0.52;218.42;3.64;653;25;1235.00;12
3008;25;628493313;3008;272;3661;3672;8.39;0.51;218.40;3.64;653;25;1236.00;11
3009;25;628493322;3009;264;3661;3672;8.27;0.51;218.44;3.64;652;25;1237.00;11
3010;25;628493331;3010;257;3661;3672;8.31;0.51;218.41;3.64;651;25;1238.00;11
3013;25;628493341;3013;249;3668;3678;8.32;0.51;218.39;3.64;655;25;1239.00;10
3015;25;628493351;3015;247;3669;3678;8.39;0.51;218.31;3.64;654;25;1240.00;9
3020;25;628493360;3020;248;3669;3678;8.41;0.51;218.25;3.64;649;25;1241.00;9
3020;25;628493369;3020;248;3672;3681;8.54;0.52;218.25;3.64;652;25;1242.00;9
3021;25;628493378;3021;241;3672;3681;8.64;0.52;218.22;3.64;651;25;1243.00;9
3023;25;628493388;3023;243;3672;3681;8.71;0.53;218.39;3.64;649;25;1244.00;9
3023;25;628493397;3023;239;3673;3682;8.74;0.53;218.39;3.64;650;25;1245.00;9
3024;25;628493406;3024;223;3674;3683;8.83;0.54;218.40;3.64;650;25;1246.00;9
3025;25;628493416;3025;211;3675;3683;8.88;0.54;218.39;3.68;650;25;1247.00;8
3028;25;628493425;3028;204;3687;3696;9.03;0.55;218.32;3.67;659;25;1248.00;9
3030;25;628493441;3030;196;3688;3696;9.11;0.55;218.28;3.67;658;25;1249.00;8
3032;25;628493451;3032;189;3688;3696;9.10;0.55;218.20;3.67;656;25;1250.00;8
3032;25;628493460;3032;183;3689;3697;9.23;0.56;218.20;3.67;657;25;1251.00;8
3033;25;628493470;3033;183;3689;3697;9.29;0.57;218.18;3.67;656;25;1252.00;8
3039;25;628493480;3039;179;3692;3701;9.34;0.57;218.26;3.67;653;25;1253.00;9
3039;25;628493490;3039;182;3692;3701;9.47;0.57;218.26;3.67;653;25;1254.00;9
3042;25;628493499;3042;178;3696;3705;9.62;0.58;218.24;3.66;654;25;1255.00;9
3043;25;628493509;3043;175;3696;3705;9.72;0.59;218.21;3.66;653;25;1256.00;9
3044;25;628493518;3044;171;3696;3705;9.75;0.59;218.16;3.66;652;25;1257.00;9
3046;25;628493527;3046;167;3696;3705;9.79;0.59;218.09;3.66;650;25;1258.00;9
3047;25;628493536;3047;169;3696;3705;9.77;0.59;218.08;3.66;649;25;1259.00;9
3050;25;628493546;3050;168;3717;3739;9.83;0.60;218.20;3.64;667;25;1260.00;22
3052;25;628493558;3052;166;3717;3739;9.87;0.60;218.10;3.64;665;25;1261.00;22
3054;25;628493567;3054;167;3719;3739;9.93;0.61;218.08;3.64;665;25;1262.00;20
3054;25;628493575;3054;166;3719;3739;9.93;0.61;218.08;3.64;665;25;1263.00;20
3060;25;628493584;3060;166;3721;3739;9.94;0.61;217.96;3.64;661;25;1264.00;18
3061;25;628493594;3061;173;3723;3739;10.05;0.61;218.11;3.64;662;25;1265.00;16
3063;25;628493603;3063;172;3723;3740;10.17;0.62;218.02;3.64;660;25;1266.00;17
3065;25;628493611;3065;174;3724;3740;10.21;0.62;217.91;3.64;659;25;1267.00;16
3066;25;628493620;3066;178;3728;3746;10.17;0.62;217.85;3.64;662;25;1268.00;18
3066;25;628493630;3066;181;3730;3747;10.25;0.62;217.85;3.64;664;25;1269.00;17
3067;25;628493639;3067;182;3730;3747;10.34;0.63;217.81;3.64;663;25;1270.00;17
3070;25;628493647;3070;183;3731;3747;10.43;0.64;217.69;3.64;661;25;1271.00;16
3070;25;628493656;3070;186;3734;3751;10.47;0.64;217.69;3.64;664;25;1272.00;17
3074;25;628493671;3074;186;3734;3751;10.45;0.64;217.54;3.64;660;25;1273.00;17
3077;25;628493680;3077;192;3734;3751;10.38;0.63;217.61;3.64;657;25;1274.00;17
3077;25;628493688;3077;193;3735;3752;10.34;0.63;217.61;3.64;658;25;1275.00;17
3079;25;628493696;3079;197;3738;3756;10.32;0.63;217.60;3.64;659;25;1276.00;18
3079;25;628493705;3079;197;3738;3756;10.34;0.63;217.60;3.64;659;25;1277.00;18
3082;25;628493713;3082;201;3740;3759;10.36;0.63;217.51;3.63;658;25;1278.00;19
3082;25;628493724;3082;199;3740;3759;10.33;0.63;217.51;3.63;658;25;1279.00;19
3082;25;628493734;3082;199;3741;3759;10.37;0.63;217.51;3.63;659;25;1280.00;18
3083;25;628493744;3083;202;3742;3759;10.40;0.63;217.53;3.69;659;25;1281.00;17
3086;25;628493757;3086;199;3745;3763;10.48;0.64;217.49;3.68;659;25;1282.00;18
3088;25;628493768;3088;182;3745;3763;10.56;0.64;217.46;3.68;657;25;1283.00;18
3089;25;628493776;3089;168;3746;3763;10.69;0.65;217.48;3.68;657;25;1284.00;17
3090;25;628493785;3090;155;3746;3763;10.77;0.66;217.47;3.68;656;25;1285.00;17
3093;25;628493793;3093;150;3746;3764;10.92;0.66;217.37;3.68;653;25;1286.00;18
3097;25;628493801;3097;149;3747;3765;11.01;0.67;217.35;3.68;650;25;1287.00;18
3099;25;628493811;3099;140;3747;3765;11.05;0.67;217.30;3.68;648;25;1288.00;18
3101;25;628493819;3101;132;3748;3766;11.13;0.68;217.44;3.68;647;25;1289.00;18
3103;25;628493840;3103;124;3748;3766;11.22;0.68;217.40;3.68;645;25;1290.00;18
3103;25;628493852;3103;114;3748;3766;11.26;0.68;217.40;3.68;645;25;1291.00;18
3108;25;628493874;3108;111;3748;3766;11.30;0.69;217.30;3.68;640;25;1292.00;18
3112;25;628493893;3112;104;3748;3766;11.35;0.69;217.24;3.68;636;25;1293.00;18
3116;25;628493907;3116;95;3749;3766;11.40;0.69;217.24;3.69;633;25;1294.00;17
3116;25;628493920;3116;90;3750;3766;11.48;0.70;217.24;3.70;634;25;1295.00;16
3118;25;628493939;3118;100;3812;3893;11.42;0.70;217.22;3.70;694;25;1296.00;81
3119;25;628493965;3119;100;3813;3894;11.58;0.71;217.24;3.70;694;25;1297.00;81
3125;25;628493978;3125;95;3820;3894;11.72;0.72;217.09;3.69;695;25;1298.00;74
3125;25;628493989;3125;93;3824;3894;11.85;0.73;217.09;3.69;699;25;1299.00;70
3126;25;628494007;3126;87;3830;3894;11.96;0.73;217.05;3.69;704;25;1300.00;64
3126;25;628494030;3126;87;3833;3894;12.07;0.74;217.05;3.69;707;25;1301.00;61
3127;25;628494048;3127;88;3838;3894;12.09;0.74;217.05;3.75;711;25;1302.00;56
3128;25;628494062;3128;89;3841;3894;12.07;0.74;217.07;3.76;713;25;1303.00;53
3133;25;628494072;3133;92;3844;3895;12.09;0.74;217.06;3.76;711;25;1304.00;51
3136;25;628494083;3136;89;3849;3897;12.12;0.74;217.06;3.76;713;25;1305.00;48
3140;25;628494094;3140;93;3852;3897;12.13;0.74;217.17;3.77;712;25;1306.00;45
3141;25;628494104;3141;96;3854;3898;12.14;0.74;217.13;3.77;713;25;1307.00;44
3143;25;628494115;3143;102;3856;3898;12.12;0.74;217.16;3.77;713;25;1308.00;42
3144;25;628494125;3144;108;3857;3898;12.07;0.74;217.11;3.78;713;25;1309.00;41
3147;25;628494136;3147;112;3861;3898;11.95;0.73;216.98;3.79;714;25;1310.00;37
3150;25;628494146;3150;114;3865;3902;11.86;0.73;216.98;3.80;715;25;1311.00;37
3153;25;628494157;3153;118;3868;3902;11.79;0.72;217.00;3.80;715;25;1312.00;34
3160;25;628494167;3160;121;3868;3902;11.65;0.71;217.21;3.80;708;25;1313.00;34
3163;25;628494178;3163;129;3873;3905;11.61;0.71;217.22;3.81;710;25;1314.00;32
3168;25;628494189;3168;135;3874;3905;11.49;0.70;217.32;3.82;706;25;1315.00;31
3172;25;628494199;3172;140;3878;3905;11.32;0.69;217.36;3.84;706;25;1316.00;27
3173;25;628494210;3173;147;3883;3909;11.13;0.68;217.38;3.84;710;25;1317.00;26
3177;25;628494220;3177;159;3884;3910;11.05;0.67;217.47;3.84;707;25;1318.00;26
3180;25;628494234;3180;162;3886;3910;11.00;0.67;217.42;3.85;706;25;1319.00;24
3182;25;628494249;3182;166;3892;3915;10.94;0.66;217.43;3.87;710;25;1320.00;23
3186;25;628494262;3186;165;3892;3915;10.84;0.66;217.39;3.87;706;25;1321.00;23
3188;25;628494276;3188;170;3892;3915;10.78;0.65;217.38;3.87;704;25;1322.00;23
3192;25;628494294;3192;177;3895;3916;10.70;0.65;217.32;3.89;703;25;1323.00;21
3193;25;628494313;3193;185;3895;3916;10.65;0.65;217.29;3.89;702;25;1324.00;21
3194;25;628494327;3194;188;3901;3922;10.61;0.64;217.27;3.91;707;25;1325.00;21
3195;25;628494345;3195;190;3903;3922;10.48;0.63;217.28;3.91;708;25;1326.00;19
3198;25;628494360;3198;192;3903;3923;10.31;0.63;217.27;3.91;705;25;1327.00;20
3199;25;628494372;3199;197;3905;3923;10.21;0.62;217.28;3.92;706;25;1328.00;18
3201;25;628494384;3201;201;3905;3923;10.12;0.61;217.33;3.92;704;25;1329.00;18
3203;25;628494394;3203;202;3906;3923;10.04;0.61;217.26;3.93;703;25;1330.00;17
3205;25;628494405;3205;210;3906;3923;9.99;0.61;217.24;3.93;701;25;1331.00;17
3208;25;628494416;3208;215;3918;3935;10.01;0.61;217.25;3.94;710;25;1332.00;17
3210;25;628494427;3210;225;3920;3935;9.91;0.60;217.24;3.94;710;25;1333.00;15
3212;25;628494438;3212;223;3921;3935;9.83;0.60;217.35;3.95;709;25;1334.00;14
3217;25;628494449;3217;224;3923;3935;9.69;0.59;217.40;3.96;706;25;1335.00;12
3220;25;628494461;3220;226;3923;3935;9.56;0.58;217.46;3.96;703;25;1336.00;12
3221;25;628494473;3221;231;3925;3935;9.42;0.57;217.43;3.97;704;25;1337.00;10
3224;25;628494484;3224;234;3928;3939;9.31;0.57;217.39;3.96;704;25;1338.00;11
3226;25;628494495;3226;231;3930;3939;9.24;0.57;217.58;3.97;704;25;1339.00;9
3229;25;628494505;3229;229;3933;3943;9.25;0.56;217.56;3.96;704;25;1340.00;10
3231;25;628494516;3231;228;3935;3944;9.27;0.57;217.74;3.96;704;25;1341.00;9
3233;25;628494526;3233;222;3935;3944;9.28;0.57;217.78;3.96;702;25;1342.00;9
3235;25;628494542;3235;222;3935;3944;9.22;0.57;217.70;3.96;700;25;1343.00;9
3236;25;628494552;3236;223;3948;3957;9.18;0.56;217.68;3.95;712;25;1344.00;9
3240;25;628494564;3240;222;3948;3957;9.17;0.56;217.66;3.95;708;25;1345.00;9
3244;25;628494573;3244;221;3948;3957;9.17;0.56;217.77;3.95;704;25;1346.00;9
3245;25;628494584;3245;221;3949;3958;9.25;0.56;217.84;3.95;704;25;1347.00;9
3249;25;628494594;3249;225;3950;3959;9.23;0.56;217.90;3.95;701;25;1348.00;9
3250;25;628494604;3250;227;3950;3959;9.32;0.57;217.95;3.95;700;25;1349.00;9
3251;25;628494616;3251;228;3953;3968;9.42;0.58;218.01;3.94;702;25;1350.00;15
3254;25;628494626;3254;232;3954;3968;9.41;0.58;218.09;3.94;700;25;1351.00;14
3257;25;628494637;3257;233;3955;3968;9.36;0.57;218.15;3.94;698;25;1352.00;13
3261;25;628494648;3261;232;3955;3968;9.31;0.57;218.29;3.94;694;25;1353.00;13
3265;25;628494658;3265;237;3960;3974;9.28;0.57;218.42;3.94;695;25;1354.00;14
3272;25;628494676;3272;238;3960;3974;9.20;0.56;218.60;3.94;688;25;1355.00;14
3276;25;628494686;3276;241;3961;3974;9.16;0.56;218.61;3.94;685;25;1356.00;13
3277;25;628494720;3277;240;3961;3974;9.14;0.56;218.67;3.94;684;25;1357.00;13
3282;25;628494731;3282;244;3966;3978;8.90;0.55;218.84;3.94;684;25;1358.00;12
3285;25;628494742;3285;247;3968;3979;8.76;0.54;218.99;3.94;683;25;1359.00;11
3294;25;628494752;3294;240;3969;3979;8.64;0.53;219.07;3.94;675;25;1360.00;10
3298;25;628494761;3298;238;3970;3980;8.56;0.53;219.14;3.94;672;25;1361.00;10
3306;25;628494772;3306;232;3970;3980;8.61;0.53;219.15;3.94;664;25;1362.00;10
3310;25;628494782;3310;228;3970;3980;8.67;0.53;219.26;3.94;660;25;1363.00;10
3315;25;628494794;3315;224;3970;3980;8.72;0.54;219.28;3.94;655;25;1364.00;10
3319;25;628494808;3319;220;3970;3980;8.73;0.54;219.37;3.94;651;25;1365.00;10
3325;25;628494818;3325;217;3970;3980;8.69;0.53;219.60;3.94;645;25;1366.00;10
3327;25;628494828;3327;210;3970;3980;8.85;0.54;219.64;3.94;643;25;1367.00;10
3334;25;628494840;3334;210;4010;4050;8.91;0.55;219.63;3.90;676;25;1368.00;40
3338;25;628494859;3338;202;4015;4051;9.06;0.56;219.75;3.89;677;25;1369.00;36
3342;25;628494869;3342;198;4021;4051;9.24;0.57;219.69;3.89;679;25;1370.00;30
3348;25;628494880;3348;195;4023;4051;9.30;0.57;219.84;3.89;675;25;1371.00;28
3353;25;628494889;3353;195;4027;4051;9.35;0.57;219.84;3.95;674;25;1372.00;24
3358;25;628494898;3358;201;4031;4051;9.40;0.58;220.00;3.95;673;25;1373.00;20
3361;25;628494907;3361;200;4036;4051;9.35;0.57;220.05;3.95;675;25;1374.00;15
3366;25;628494916;3366;206;4038;4051;9.27;0.57;220.18;3.95;672;25;1375.00;13
3371;25;628494925;3371;213;4040;4052;9.27;0.57;220.13;3.95;669;25;1376.00;12
3375;25;628494935;3375;209;4041;4053;9.19;0.56;220.21;3.95;666;25;1377.00;12
3380;25;628494944;3380;212;4042;4053;9.10;0.56;220.18;3.95;662;25;1378.00;11
3385;25;628494954;3385;209;4045;4057;9.05;0.55;220.26;3.95;660;25;1379.00;12
3388;25;628494966;3388;202;4045;4057;8.99;0.55;220.20;3.95;657;25;1380.00;12
3394;25;628494975;3394;207;4045;4057;8.88;0.54;220.27;3.95;651;25;1381.00;12
3395;26;628494985;3395;205;4045;4057;8.86;0.54;220.32;3.95;650;26;1382.00;12
3400;26;628495011;3400;205;4050;4063;8.78;0.54;220.41;3.95;650;26;1383.00;13
3404;26;628495021;3404;207;4052;4063;8.74;0.53;220.52;3.95;648;26;1384.00;11
3409;26;628495037;3409;206;4052;4063;8.74;0.53;220.56;3.95;643;26;1385.00;11
3411;26;628495046;3411;214;4055;4066;8.78;0.53;220.56;3.94;644;26;1386.00;11
3415;26;628495056;3415;217;4057;4066;8.71;0.53;220.59;4.01;642;26;1387.00;9
3421;26;628495066;3421;217;4057;4066;8.74;0.53;220.60;4.01;636;26;1388.00;9
3425;26;628495076;3425;216;4059;4067;8.63;0.52;220.66;4.01;634;26;1389.00;8
3428;26;628495085;3428;216;4060;4068;8.49;0.51;220.63;4.01;632;26;1390.00;8
3429;26;628495095;3429;214;4060;4068;8.42;0.51;220.66;4.01;631;26;1391.00;8
3431;26;628495104;3431;219;4073;4081;8.44;0.51;220.62;4.00;642;26;1392.00;8
3434;27;628495114;3434;224;4073;4081;8.35;0.51;220.65;4.00;639;27;1393.00;8
3435;27;628495138;3435;223;4073;4081;8.31;0.51;220.66;4.00;638;27;1394.00;8
3437;27;628495148;3437;229;4075;4083;8.31;0.51;220.69;4.00;638;27;1395.00;8
3438;27;628495165;3438;233;4075;4083;8.22;0.50;220.70;4.00;637;27;1396.00;8
3441;27;628495175;3441;238;4078;4087;8.20;0.50;220.59;3.99;637;27;1397.00;9
3444;27;628495186;3444;244;4078;4087;8.08;0.49;220.51;3.99;634;27;1398.00;9
3446;27;628495197;3446;251;4083;4091;8.02;0.49;220.61;3.99;637;27;1399.00;8
3450;27;628495207;3450;257;4083;4091;7.90;0.48;220.62;3.99;633;27;1400.00;8
3451;27;628495220;3451;263;4083;4091;7.92;0.48;220.59;3.99;632;27;1401.00;8
3453;27;628495229;3453;273;4083;4091;7.88;0.48;220.57;3.99;630;27;1402.00;8
3454;27;628495240;3454;280;4083;4091;7.90;0.48;220.62;3.99;629;27;1403.00;8
3455;27;628495252;3455;282;4094;4103;7.98;0.49;220.65;3.98;639;27;1404.00;9
3457;27;628495264;3457;289;4094;4103;7.96;0.49;220.66;3.98;637;27;1405.00;9
3459;27;628495276;3459;297;4095;4103;8.00;0.49;220.79;3.98;636;27;1406.00;8
3461;27;628495285;3461;288;4095;4103;7.98;0.49;220.74;3.98;634;27;1407.00;8
3464;27;628495294;3464;284;4095;4103;8.01;0.49;220.69;3.98;631;27;1408.00;8
3468;27;628495303;3468;278;4095;4103;8.02;0.49;220.62;3.98;627;27;1409.00;8
3470;27;628495314;3470;274;4096;4104;8.02;0.49;220.58;3.98;626;27;1410.00;8
3474;27;628495323;3474;274;4096;4104;7.97;0.49;220.44;3.98;622;27;1411.00;8
3475;27;628495331;3475;271;4101;4110;7.93;0.49;220.38;3.97;626;27;1412.00;9
3479;27;628495341;3479;274;4102;4111;7.92;0.48;220.34;3.97;623;27;1413.00;9
3480;27;628495349;3480;271;4103;4111;7.94;0.49;220.32;3.97;623;27;1414.00;8
3482;27;628495357;3482;273;4103;4111;7.91;0.48;220.28;3.97;621;27;1415.00;8
3483;27;628495373;3483;258;4107;4115;7.97;0.49;220.26;3.97;624;27;1416.00;8
3487;27;628495384;3487;246;4107;4115;7.98;0.49;220.18;3.97;620;27;1417.00;8
3489;27;628495402;3489;236;4107;4115;7.99;0.49;220.13;3.97;618;27;1418.00;8
3492;27;628495413;3492;231;4108;4116;8.02;0.49;220.12;3.97;616;27;1419.00;8
3493;27;628495422;3493;221;4112;4120;8.08;0.49;220.08;3.97;619;27;1420.00;8
3494;27;628495438;3494;210;4112;4120;8.18;0.50;220.04;3.97;618;27;1421.00;8
3496;27;628495447;3496;201;4114;4123;8.35;0.51;220.09;3.96;618;27;1422.00;9
3496;27;628495457;3496;201;4114;4123;8.57;0.52;220.09;3.96;618;27;1423.00;9
3496;27;628495466;3496;193;4115;4123;8.73;0.53;220.09;3.96;619;27;1424.00;8
3498;27;628495475;3498;189;4115;4123;8.81;0.54;219.99;3.96;617;27;1425.00;8
3499;27;628495484;3499;188;4118;4127;8.93;0.55;220.00;3.96;619;27;1426.00;9
3501;27;628495493;3501;188;4118;4127;8.97;0.55;219.98;3.96;617;27;1427.00;9
3503;27;628495502;3503;183;4119;4127;9.06;0.55;219.96;3.96;616;27;1428.00;8
3505;27;628495510;3505;182;4119;4127;9.10;0.56;219.94;3.96;614;27;1429.00;8
3506;27;628495519;3506;179;4120;4128;9.10;0.56;219.91;3.96;614;27;1430.00;8
3507;27;628495528;3507;181;4121;4129;9.20;0.56;219.93;3.96;614;27;1431.00;8
3512;27;628495537;3512;181;4121;4129;9.20;0.56;219.91;3.96;609;27;1432.00;8
3513;27;628495546;3513;179;4122;4130;9.24;0.56;219.90;3.96;609;27;1433.00;8
3514;27;628495554;3514;179;4122;4130;9.28;0.56;220.07;3.96;608;27;1434.00;8
3514;27;628495563;3514;166;4122;4130;9.32;0.57;220.07;3.96;608;27;1435.00;8
3516;27;628495572;3516;156;4122;4130;9.38;0.57;220.08;3.96;606;27;1436.00;8
3517;27;628495581;3517;149;4122;4130;9.54;0.58;220.09;3.96;605;27;1437.00;8
3518;27;628495596;3518;142;4122;4130;9.83;0.60;220.08;3.96;604;27;1438.00;8
3519;27;628495605;3519;137;4122;4130;10.00;0.61;220.08;3.96;603;27;1439.00;8
3521;27;628495616;3521;178;4239;4360;9.68;0.61;220.08;3.85;718;27;1440.00;121
3521;27;628495643;3521;164;4240;4361;9.85;0.62;220.08;3.85;719;27;1441.00;121
3523;27;628495652;3523;139;4247;4361;10.15;0.63;220.03;3.85;724;27;1442.00;114
3524;28;628495662;3524;132;4251;4361;10.35;0.65;220.01;3.85;727;28;1443.00;110
3528;28;628495685;3528;122;4258;4361;10.52;0.65;219.94;3.90;730;28;1444.00;103
3528;28;628495696;3528;115;4263;4361;10.66;0.66;219.94;3.90;735;28;1445.00;98
3531;28;628495712;3531;113;4269;4361;10.69;0.66;219.86;3.91;738;28;1446.00;92
3532;28;628495734;3532;109;4274;4361;10.81;0.67;219.84;3.91;742;28;1447.00;87
3535;28;628495750;3535;118;4281;4362;10.95;0.68;219.84;3.92;746;28;1448.00;81
3536;28;628495762;3536;114;4284;4363;11.06;0.68;219.82;3.92;748;28;1449.00;79
3536;28;628495778;3536;122;4288;4363;11.18;0.69;219.82;3.92;752;28;1450.00;75
3538;28;628495789;3538;125;4289;4364;11.25;0.69;219.76;3.93;751;28;1451.00;75
3538;28;628495807;3538;132;4295;4364;11.27;0.69;219.76;3.94;757;28;1452.00;69
3539;28;628495818;3539;135;4296;4364;11.29;0.69;219.78;3.94;757;28;1453.00;68
3541;28;628495835;3541;142;4298;4364;11.39;0.70;219.77;3.94;757;28;1454.00;66
3542;28;628495853;3542;147;4301;4368;11.36;0.70;219.75;3.95;759;28;1455.00;67
3546;28;628495875;3546;159;4304;4368;11.28;0.69;219.84;3.95;758;28;1456.00;64
3547;28;628495889;3547;159;4305;4368;11.28;0.69;219.84;3.96;758;28;1457.00;63
3550;28;628495908;3550;162;4308;4371;11.36;0.69;219.84;3.96;758;28;1458.00;63
3553;28;628495926;3553;163;4308;4371;11.37;0.69;219.87;3.96;755;28;1459.00;63
3557;28;628495944;3557;166;4312;4371;11.40;0.70;219.95;4.03;755;28;1460.00;59
3560;28;628495963;3560;167;4317;4375;11.42;0.70;219.96;4.03;757;28;1461.00;58
3564;28;628495979;3564;163;4318;4376;11.52;0.70;219.95;4.03;754;28;1462.00;58
3567;28;628495992;3567;157;4320;4376;11.60;0.71;220.04;4.09;753;28;1463.00;56
3572;28;628496007;3572;155;4324;4380;11.70;0.71;220.18;4.10;752;28;1464.00;56
3574;28;628496025;3574;152;4326;4380;11.70;0.71;220.14;4.10;752;28;1465.00;54
3577;28;628496039;3577;152;4329;4380;11.57;0.70;220.26;4.16;752;28;1466.00;51
3579;28;628496063;3579;148;4330;4381;11.56;0.70;220.21;4.16;751;28;1467.00;51
3581;28;628496087;3581;145;4331;4381;11.51;0.70;220.32;4.20;750;28;1468.00;50
3583;28;628496110;3583;139;4333;4387;11.44;0.69;220.39;4.20;750;28;1469.00;54
3586;28;628496125;3586;146;4335;4387;11.40;0.69;220.64;4.24;749;28;1470.00;52
3587;28;628496138;3587;138;4336;4388;11.45;0.70;220.62;4.24;749;28;1471.00;52
3589;28;628496150;3589;140;4337;4388;11.43;0.69;220.71;4.24;748;28;1472.00;51
3592;28;628496162;3592;135;4338;4388;11.45;0.70;220.73;4.28;746;28;1473.00;50
3594;28;628496174;3594;140;4338;4388;11.54;0.70;220.68;4.28;744;28;1474.00;50
3596;28;628496187;3596;140;4339;4388;11.54;0.70;220.66;4.31;743;28;1475.00;49
3598;28;628496199;3598;147;4349;4400;11.55;0.70;220.64;4.30;751;28;1476.00;51
3603;28;628496212;3603;147;4349;4400;11.60;0.70;220.60;4.30;746;28;1477.00;51
3609;28;628496225;3609;151;4352;4400;11.59;0.70;220.71;4.31;743;28;1478.00;48
3610;28;628496237;3610;150;4353;4400;11.57;0.70;220.68;4.31;743;28;1479.00;47
3612;28;628496261;3612;155;4355;4400;11.57;0.70;220.72;4.33;743;28;1480.00;45
3615;28;628496275;3615;160;4355;4400;11.52;0.70;220.74;4.33;740;28;1481.00;45
3616;28;628496289;3616;163;4359;4404;11.45;0.70;220.72;4.34;743;28;1482.00;45
3619;28;628496305;3619;165;4359;4404;11.38;0.69;220.68;4.34;740;28;1483.00;45
3622;29;628496322;3622;165;4363;4408;11.37;0.69;220.71;4.34;741;29;1484.00;45
3623;29;628496350;3623;169;4366;4410;11.36;0.69;220.72;4.34;743;29;1485.00;44
3623;30;628496364;3623;166;4367;4410;11.40;0.70;220.72;4.35;744;30;1486.00;43
3628;30;628496403;3628;176;4367;4410;11.40;0.70;220.80;4.35;739;30;1487.00;43
3630;30;628496419;3630;185;4376;4423;11.38;0.69;220.96;4.35;746;30;1488.00;47
3631;30;628496434;3631;185;4377;4423;11.37;0.69;220.94;4.36;746;30;1489.00;46
3633;30;628496453;3633;188;4380;4423;11.36;0.69;220.84;4.38;747;30;1490.00;43
3635;30;628496466;3635;191;4381;4424;11.28;0.69;220.90;4.38;746;30;1491.00;43
3636;30;628496480;3636;195;4383;4425;11.22;0.68;220.93;4.40;747;30;1492.00;42
3640;31;628496492;3640;204;4384;4425;11.15;0.68;220.94;4.41;744;31;1493.00;41
3641;31;628496525;3641;207;4388;4428;11.12;0.68;220.91;4.43;747;31;1494.00;40
3646;31;628496539;3646;217;4390;4428;10.97;0.67;220.95;4.45;744;31;1495.00;38
3648;31;628496552;3648;220;4392;4428;10.85;0.66;221.01;4.47;744;31;1496.00;36
3650;31;628496565;3650;225;4393;4428;10.68;0.65;220.99;4.48;743;31;1497.00;35
3653;32;628496581;3653;234;4400;4434;10.56;0.65;220.96;4.51;747;32;1498.00;34
3655;32;628496612;3655;238;4400;4434;10.45;0.64;220.98;4.51;745;32;1499.00;34
3657;32;628496629;3657;249;4407;4453;10.24;0.62;220.98;4.54;750;32;1500.00;46
3660;32;628496648;3660;251;4409;4453;10.07;0.62;220.93;4.56;749;32;1501.00;44
3662;32;628496660;3662;266;4415;4457;9.88;0.60;220.89;4.58;753;32;1502.00;42
3665;32;628496671;3665;268;4419;4458;9.65;0.59;220.87;4.61;754;32;1503.00;39
3668;32;628496681;3668;270;4422;4458;9.51;0.58;220.85;4.62;754;32;1504.00;36
3671;32;628496691;3671;278;4426;4459;9.35;0.57;220.82;4.63;755;32;1505.00;33
3674;32;628496700;3674;280;4426;4459;9.21;0.56;221.00;4.63;752;32;1506.00;33
3675;32;628496710;3675;283;4428;4459;9.16;0.56;221.02;4.64;753;32;1507.00;31
3676;32;628496720;3676;286;4430;4459;9.14;0.56;221.01;4.64;754;32;1508.00;29
3677;32;628496729;3677;280;4432;4459;9.10;0.56;220.99;4.64;755;32;1509.00;27
3678;32;628496738;3678;278;4432;4459;9.07;0.56;220.99;4.64;754;32;1510.00;27
3682;32;628496749;3682;279;4434;4459;9.03;0.55;220.95;4.65;752;32;1511.00;25
3684;32;628496759;3684;279;4466;4529;9.03;0.56;220.89;4.61;782;32;1512.00;63
3689;32;628496774;3689;275;4469;4530;9.03;0.55;220.85;4.61;780;32;1513.00;61
3691;32;628496790;3691;270;4479;4530;9.06;0.56;220.80;4.61;788;32;1514.00;51
3698;32;628496808;3698;270;4484;4530;9.04;0.55;220.72;4.61;786;32;1515.00;46
3700;32;628496820;3700;266;4488;4530;9.08;0.56;220.70;4.61;788;32;1516.00;42
3704;32;628496833;3704;268;4491;4530;9.07;0.55;220.78;4.62;787;32;1517.00;39
3709;32;628496846;3709;269;4493;4530;9.05;0.55;220.92;4.62;784;32;1518.00;37
3714;32;628496857;3714;269;4494;4530;9.09;0.55;220.94;4.62;780;32;1519.00;36
3717;32;628496867;3717;271;4496;4531;9.09;0.55;220.92;4.62;779;32;1520.00;35
3720;32;628496878;3720;276;4498;4532;9.05;0.55;220.96;4.62;778;32;1521.00;34
3723;32;628496889;3723;271;4499;4532;9.00;0.55;221.04;4.62;776;32;1522.00;33
3728;32;628496900;3728;273;4504;4536;8.87;0.54;221.09;4.62;776;32;1523.00;32
3732;32;628496910;3732;271;4504;4536;8.79;0.54;221.21;4.62;772;32;1524.00;32
3736;32;628496920;3736;269;4504;4536;8.69;0.53;221.20;4.62;768;32;1525.00;32
3741;32;628496929;3741;274;4504;4536;8.54;0.52;221.29;4.62;763;32;1526.00;32
3743;32;628496939;3743;277;4508;4542;8.45;0.52;221.42;4.62;765;32;1527.00;34
3747;32;628496950;3747;284;4508;4542;8.23;0.50;221.56;4.62;761;32;1528.00;34
3749;32;628496959;3749;292;4510;4542;8.11;0.50;221.56;4.63;761;32;1529.00;32
3753;32;628496971;3753;281;4513;4548;7.95;0.49;221.74;4.63;760;32;1530.00;35
3755;32;628496986;3755;276;4513;4548;7.90;0.48;221.75;4.63;758;32;1531.00;35
3761;32;628496996;3761;281;4513;4548;7.83;0.48;221.82;4.63;752;32;1532.00;35
3766;32;628497006;3766;269;4514;4549;7.75;0.47;221.91;4.62;748;32;1533.00;35
3769;32;628497016;3769;271;4515;4550;7.74;0.47;221.90;4.62;746;32;1534.00;35
3772;32;628497025;3772;268;4517;4550;7.73;0.47;221.92;4.64;745;32;1535.00;33
3776;32;628497034;3776;263;4529;4563;7.71;0.47;221.96;4.63;753;32;1536.00;34
3782;32;628497052;3782;257;4530;4563;7.69;0.47;221.98;4.63;748;32;1537.00;33
3785;32;628497062;3785;258;4530;4563;7.73;0.47;222.01;4.63;745;32;1538.00;33
3788;32;628497070;3788;252;4531;4564;7.78;0.48;221.99;4.63;743;32;1539.00;33
3792;32;628497079;3792;247;4533;4564;7.75;0.48;222.14;4.64;741;32;1540.00;31
3794;32;628497088;3794;248;4538;4568;7.83;0.48;222.15;4.66;744;32;1541.00;30
3797;32;628497098;3797;245;4538;4568;7.84;0.48;222.20;4.66;741;32;1542.00;30
3799;32;628497107;3799;244;4543;4572;7.83;0.48;222.29;4.66;744;32;1543.00;29
3801;32;628497116;3801;247;4545;4572;7.85;0.48;222.29;4.67;744;32;1544.00;27
3804;32;628497125;3804;249;4545;4572;7.85;0.48;222.35;4.67;741;32;1545.00;27
3810;32;628497134;3810;250;4546;4572;7.85;0.48;222.32;4.68;736;32;1546.00;26
3813;32;628497143;3813;247;4546;4572;7.87;0.48;222.26;4.68;733;32;1547.00;26
3818;32;628497152;3818;245;4557;4584;7.87;0.48;222.34;4.67;739;32;1548.00;27
3821;32;628497163;3821;246;4558;4584;7.86;0.48;222.29;4.67;737;32;1549.00;26
3823;32;628497171;3823;245;4558;4584;7.88;0.48;222.38;4.67;735;32;1550.00;26
3826;32;628497181;3826;251;4560;4584;7.85;0.48;222.51;4.69;734;32;1551.00;24
3828;32;628497196;3828;255;4560;4584;7.81;0.48;222.47;4.69;732;32;1552.00;24
3833;32;628497211;3833;258;4561;4584;7.72;0.47;222.45;4.69;728;32;1553.00;23
3836;32;628497220;3836;259;4563;4585;7.60;0.46;222.47;4.70;727;32;1554.00;22
3839;32;628497230;3839;264;4565;4587;7.47;0.46;222.46;4.70;726;32;1555.00;22
3844;32;628497239;3844;260;4571;4593;7.38;0.45;222.41;4.71;727;32;1556.00;22
3845;32;628497249;3845;267;4572;4594;7.44;0.46;222.44;4.71;727;32;1557.00;22
3848;32;628497258;3848;275;4573;4594;7.37;0.45;222.49;4.71;725;32;1558.00;21
3854;32;628497267;3854;278;4573;4594;7.28;0.45;222.41;4.71;719;32;1559.00;21
3857;32;628497278;3857;280;4578;4599;7.19;0.44;222.43;4.70;721;32;1560.00;21
3860;32;628497287;3860;280;4579;4599;7.17;0.44;222.44;4.71;719;32;1561.00;20
3865;32;628497296;3865;286;4580;4599;7.09;0.43;222.44;4.71;715;32;1562.00;19
3870;32;628497305;3870;285;4581;4600;7.12;0.44;222.41;4.71;711;32;1563.00;19
3874;32;628497314;3874;290;4586;4604;7.15;0.44;222.41;4.71;712;32;1564.00;18
3878;32;628497323;3878;293;4586;4604;7.10;0.43;222.27;4.71;708;32;1565.00;18
3881;32;628497332;3881;300;4590;4607;7.06;0.43;222.19;4.71;709;32;1566.00;17
3881;32;628497341;3881;303;4590;4607;7.09;0.43;222.19;4.71;709;32;1567.00;17
3886;32;628497355;3886;306;4591;4607;7.02;0.43;222.28;4.71;705;32;1568.00;16
3890;32;628497364;3890;310;4592;4607;6.99;0.43;222.21;4.71;702;32;1569.00;15
3895;32;628497373;3895;315;4595;4611;6.94;0.42;222.12;4.71;700;32;1570.00;16
3895;32;628497383;3895;323;4595;4611;6.98;0.43;222.12;4.71;700;32;1571.00;16
3899;32;628497391;3899;336;4596;4611;6.94;0.42;222.25;4.71;697;32;1572.00;15
3903;32;628497400;3903;339;4596;4611;6.89;0.42;222.27;4.71;693;32;1573.00;15
3904;32;628497409;3904;345;4597;4612;6.84;0.42;222.26;4.71;693;32;1574.00;15
3907;32;628497418;3907;346;4599;4614;6.82;0.41;222.33;4.71;692;32;1575.00;15
3910;32;628497427;3910;355;4599;4614;6.74;0.41;222.40;4.71;689;32;1576.00;15
3911;32;628497442;3911;348;4600;4615;6.76;0.41;222.35;4.71;689;32;1577.00;15
3913;33;628497451;3913;338;4600;4615;6.76;0.41;222.34;4.71;687;33;1578.00;15
3914;33;628497472;3914;334;4600;4615;6.84;0.42;222.39;4.71;686;33;1579.00;15
3916;33;628497480;3916;329;4600;4615;6.89;0.42;222.36;4.71;684;33;1580.00;15
3919;33;628497489;3919;323;4600;4615;6.99;0.42;222.48;4.71;681;33;1581.00;15
3921;33;628497498;3921;319;4600;4615;7.05;0.43;222.53;4.71;679;33;1582.00;15
3924;33;628497512;3924;315;4600;4615;7.08;0.43;222.58;4.71;676;33;1583.00;15
3925;33;628497521;3925;339;4671;4742;7.37;0.46;222.64;4.64;746;33;1584.00;71
3925;33;628497545;3925;329;4673;4743;7.40;0.46;222.64;4.63;748;33;1585.00;70
3927;33;628497555;3927;307;4683;4743;7.53;0.46;222.60;4.63;756;33;1586.00;60
3928;33;628497565;3928;274;4688;4743;7.62;0.47;222.59;4.63;760;33;1587.00;55
3929;33;628497575;3929;255;4692;4743;7.77;0.48;222.54;4.63;763;33;1588.00;51
3929;33;628497584;3929;238;4695;4743;7.94;0.49;222.54;4.63;766;33;1589.00;48
3931;33;628497596;3931;221;4700;4743;8.18;0.50;222.56;4.63;769;33;1590.00;43
3932;33;628497607;3932;214;4701;4743;8.36;0.51;222.54;4.63;769;33;1591.00;42
3933;33;628497618;3933;203;4705;4744;8.54;0.53;222.52;4.63;772;33;1592.00;39
3933;33;628497629;3933;188;4710;4745;8.67;0.53;222.52;4.64;777;33;1593.00;35
3937;33;628497646;3937;183;4713;4745;8.81;0.54;222.52;4.64;776;33;1594.00;32
3937;33;628497657;3937;179;4716;4746;8.97;0.55;222.52;4.64;779;33;1595.00;30
3938;33;628497669;3938;169;4718;4746;9.11;0.56;222.52;4.64;780;33;1596.00;28
3941;33;628497685;3941;164;4719;4746;9.28;0.57;222.46;4.65;778;33;1597.00;27
3943;33;628497697;3943;167;4720;4746;9.36;0.57;222.43;4.65;777;33;1598.00;26
3943;33;628497708;3943;161;4724;4750;9.53;0.58;222.43;4.65;781;33;1599.00;26
3944;33;628497721;3944;161;4725;4750;9.64;0.59;222.42;4.65;781;33;1600.00;25
3945;33;628497737;3945;159;4726;4750;9.73;0.59;222.40;4.65;781;33;1601.00;24
3946;33;628497748;3946;156;4729;4753;9.85;0.60;222.39;4.65;783;33;1602.00;24
3947;33;628497759;3947;153;4730;4753;10.01;0.61;222.35;4.65;783;33;1603.00;23
3948;33;628497772;3948;151;4732;4753;10.14;0.62;222.33;4.65;784;33;1604.00;21
3948;33;628497788;3948;151;4735;4757;10.23;0.62;222.33;4.65;787;33;1605.00;22
3949;33;628497806;3949;147;4736;4758;10.39;0.63;222.34;4.65;787;33;1606.00;22
3954;33;628497817;3954;144;4736;4758;10.48;0.64;222.39;4.65;782;33;1607.00;22
3958;33;628497829;3958;147;4739;4762;10.60;0.65;222.37;4.65;781;33;1608.00;23
3963;33;628497842;3963;149;4739;4762;10.73;0.65;222.35;4.65;776;33;1609.00;23
3967;34;628497861;3967;156;4739;4762;10.75;0.65;222.31;4.65;772;34;1610.00;23
3971;34;628497891;3971;157;4740;4763;10.78;0.65;222.33;4.65;769;34;1611.00;23
3973;35;628497908;3973;162;4740;4763;10.87;0.66;222.34;4.65;767;35;1612.00;23
3974;35;628497943;3974;164;4744;4769;10.94;0.66;222.36;4.64;770;35;1613.00;25
3976;35;628497957;3976;157;4744;4769;10.94;0.66;222.39;4.64;768;35;1614.00;25
3978;35;628497976;3978;154;4745;4770;10.97;0.67;222.50;4.64;767;35;1615.00;25
3981;35;628497990;3981;151;4745;4770;11.08;0.67;222.59;4.64;764;35;1616.00;25
3981;35;628498002;3981;150;4745;4770;11.14;0.68;222.59;4.64;764;35;1617.00;25
3983;35;628498013;3983;151;4745;4770;11.17;0.68;222.61;4.64;762;35;1618.00;25
3987;35;628498025;3987;143;4745;4770;11.32;0.69;222.67;4.64;758;35;1619.00;25
3989;35;628498039;3989;143;4766;4806;11.27;0.69;222.75;4.62;777;35;1620.00;40
3995;36;628498061;3995;141;4766;4806;11.35;0.69;222.86;4.62;771;36;1621.00;40
3999;36;628498083;3999;141;4768;4806;11.45;0.70;222.95;4.62;769;36;1622.00;38
4001;36;628498095;4001;141;4768;4806;11.53;0.70;222.96;4.62;767;36;1623.00;38
4002;36;628498105;4002;144;4770;4806;11.64;0.71;223.01;4.62;768;36;1624.00;36
4006;36;628498121;4006;143;4772;4806;11.70;0.71;223.03;4.62;766;36;1625.00;34
4010;36;628498132;4010;146;4776;4810;11.75;0.71;223.11;4.62;766;36;1626.00;34
4013;36;628498143;4013;146;4777;4810;11.86;0.72;223.16;4.62;764;36;1627.00;33
4016;36;628498154;4016;150;4781;4814;11.90;0.72;223.21;4.62;765;36;1628.00;33
4019;36;628498167;4019;144;4783;4815;11.86;0.72;223.24;4.62;764;36;1629.00;32
4024;36;628498180;4024;138;4784;4815;11.87;0.72;223.33;4.62;760;36;1630.00;31
4025;36;628498191;4025;136;4784;4815;11.86;0.72;223.30;4.62;759;36;1631.00;31
4029;36;628498201;4029;139;4794;4828;11.75;0.72;223.32;4.61;765;36;1632.00;34
4032;36;628498213;4032;138;4794;4828;11.80;0.72;223.31;4.61;762;36;1633.00;34
4035;36;628498229;4035;139;4794;4828;11.81;0.72;223.31;4.61;759;36;1634.00;34
4041;36;628498240;4041;137;4796;4829;11.85;0.72;223.28;4.62;755;36;1635.00;33
4048;36;628498251;4048;136;4796;4830;11.82;0.72;223.37;4.62;748;36;1636.00;34
4050;36;628498262;4050;135;4796;4830;11.85;0.72;223.38;4.62;746;36;1637.00;34
4051;36;628498273;4051;136;4798;4833;11.85;0.72;223.37;4.62;747;36;1638.00;35
4057;36;628498285;4057;128;4798;4833;11.81;0.72;223.37;4.62;741;36;1639.00;35
4059;37;628498296;4059;126;4799;4833;11.83;0.72;223.37;4.62;740;37;1640.00;34
4063;37;628498320;4063;125;4799;4833;11.82;0.72;223.39;4.62;736;37;1641.00;34
4068;37;628498331;4068;122;4803;4839;11.82;0.72;223.42;4.61;735;37;1642.00;36
4070;37;628498343;4070;120;4804;4839;11.88;0.72;223.44;4.61;734;37;1643.00;35
4073;37;628498353;4073;119;4804;4839;11.81;0.72;223.42;4.61;731;37;1644.00;35
4076;38;628498365;4076;119;4804;4839;11.74;0.72;223.32;4.61;728;38;1645.00;35
4079;38;628498391;4079;119;4807;4843;11.69;0.71;223.37;4.61;728;38;1646.00;36
4081;38;628498402;4081;122;4809;4844;11.68;0.71;223.36;4.61;728;38;1647.00;35
4085;38;628498413;4085;121;4809;4844;11.62;0.71;223.36;4.61;724;38;1648.00;35
4087;38;628498425;4087;123;4810;4845;11.65;0.71;223.40;4.61;723;38;1649.00;35
4089;38;628498437;4089;123;4811;4845;11.66;0.71;223.38;4.62;722;38;1650.00;34
4093;38;628498454;4093;129;4811;4845;11.65;0.71;223.43;4.62;718;38;1651.00;34
4094;38;628498470;4094;134;4812;4845;11.69;0.71;223.45;4.63;718;38;1652.00;33
4096;38;628498480;4096;137;4812;4845;11.80;0.72;223.51;4.63;716;38;1653.00;33
4097;38;628498491;4097;139;4812;4845;11.89;0.72;223.51;4.63;715;38;1654.00;33
4101;38;628498501;4101;144;4812;4845;11.95;0.73;223.55;4.63;711;38;1655.00;33
4104;38;628498512;4104;154;4850;4915;11.82;0.72;223.62;4.60;746;38;1656.00;65
4108;38;628498529;4108;157;4850;4916;11.73;0.71;223.60;4.60;742;38;1657.00;66
4112;38;628498540;4112;162;4856;4916;11.69;0.71;223.69;4.60;744;38;1658.00;60
4115;38;628498551;4115;167;4861;4916;11.60;0.71;223.64;4.60;746;38;1659.00;55
4116;38;628498570;4116;166;4867;4916;11.50;0.70;223.60;4.62;751;38;1660.00;49
4119;38;628498581;4119;173;4869;4916;11.43;0.70;223.60;4.62;750;38;1661.00;47
4121;38;628498593;4121;179;4872;4916;11.28;0.69;223.70;4.62;751;38;1662.00;44
4122;38;628498603;4122;184;4877;4916;11.21;0.68;223.70;4.64;755;38;1663.00;39
4124;38;628498614;4124;186;4880;4917;11.06;0.67;223.65;4.64;756;38;1664.00;37
4127;38;628498624;4127;191;4885;4919;10.98;0.67;223.66;4.65;758;38;1665.00;34
4129;38;628498634;4129;197;4888;4919;10.89;0.67;223.69;4.66;759;38;1666.00;31
4132;38;628498646;4132;200;4890;4923;10.74;0.66;223.65;4.66;758;38;1667.00;33
4135;38;628498657;4135;205;4890;4923;10.69;0.65;223.60;4.66;755;38;1668.00;33
4137;38;628498667;4137;210;4891;4923;10.61;0.65;223.60;4.67;754;38;1669.00;32
4140;38;628498678;4140;216;4891;4923;10.56;0.65;223.57;4.67;751;38;1670.00;32
4143;38;628498689;4143;219;4899;4929;10.51;0.64;223.60;4.70;756;38;1671.00;30
4143;38;628498700;4143;230;4900;4929;10.42;0.64;223.60;4.70;757;38;1672.00;29
4148;38;628498710;4148;239;4902;4929;10.27;0.63;223.62;4.71;754;38;1673.00;27
4150;38;628498721;4150;240;4904;4932;10.20;0.63;223.58;4.70;754;38;1674.00;28
4153;38;628498732;4153;239;4906;4932;10.11;0.62;223.52;4.71;753;38;1675.00;26
4157;38;628498742;4157;244;4907;4932;9.97;0.61;223.49;4.71;750;38;1676.00;25
4161;38;628498752;4161;246;4907;4933;9.75;0.60;223.46;4.71;746;38;1677.00;26
4164;38;628498763;4164;253;4909;4934;9.49;0.58;223.35;4.72;745;38;1678.00;25
4169;38;628498773;4169;249;4910;4934;9.27;0.57;223.36;4.72;741;38;1679.00;24
4173;38;628498786;4173;250;4927;4960;9.06;0.56;223.30;4.70;754;38;1680.00;33
4175;38;628498799;4175;257;4930;4960;8.93;0.55;223.31;4.70;755;38;1681.00;30
4177;38;628498809;4177;254;4932;4960;8.83;0.54;223.32;4.70;755;38;1682.00;28
4180;38;628498819;4180;254;4935;4961;8.67;0.53;223.28;4.70;755;38;1683.00;26
4183;38;628498829;4183;258;4935;4961;8.56;0.52;223.27;4.70;752;38;1684.00;26
4185;38;628498843;4185;261;4938;4965;8.58;0.52;223.30;4.70;753;38;1685.00;27
4186;38;628498858;4186;267;4938;4965;8.51;0.52;223.27;4.70;752;38;1686.00;27
4188;38;628498869;4188;265;4942;4969;8.45;0.52;223.29;4.70;754;38;1687.00;27
4189;38;628498881;4189;272;4944;4969;8.40;0.51;223.36;4.71;755;38;1688.00;25
4191;38;628498892;4191;277;4944;4969;8.35;0.51;223.37;4.71;753;38;1689.00;25
4195;38;628498903;4195;277;4944;4969;8.27;0.51;223.39;4.71;749;38;1690.00;25
4199;38;628498917;4199;287;4944;4969;8.15;0.50;223.36;4.71;745;38;1691.00;25
4201;38;628498927;4201;291;4957;4981;8.09;0.50;223.34;4.70;756;38;1692.00;24
4202;38;628498939;4202;292;4957;4981;7.98;0.49;223.37;4.70;755;38;1693.00;24
4206;38;628498950;4206;291;4959;4981;7.87;0.48;223.35;4.70;753;38;1694.00;22
4209;38;628498961;4209;291;4959;4981;7.80;0.48;223.41;4.70;750;38;1695.00;22
4213;38;628498970;4213;295;4959;4981;7.68;0.47;223.49;4.70;746;38;1696.00;22
4218;38;628498979;4218;295;4959;4981;7.50;0.46;223.45;4.70;741;38;1697.00;22
4222;38;628498988;4222;304;4960;4982;7.31;0.45;223.44;4.70;738;38;1698.00;22
4226;39;628498997;4226;308;4960;4982;7.14;0.44;223.42;4.70;734;39;1699.00;22
4228;39;628499017;4228;305;4965;4988;7.10;0.44;223.45;4.69;737;39;1700.00;23
4231;39;628499031;4231;299;4966;4989;6.99;0.43;223.61;4.69;735;39;1701.00;23
4233;39;628499039;4233;289;4967;4989;6.92;0.43;223.65;4.69;734;39;1702.00;22
4234;39;628499048;4234;280;4967;4989;6.92;0.43;223.70;4.69;733;39;1703.00;22
4237;39;628499062;4237;282;4971;4993;6.95;0.43;223.61;4.69;734;39;1704.00;22
4238;39;628499070;4238;281;4971;4993;6.93;0.43;223.65;4.69;733;39;1705.00;22
4240;39;628499078;4240;281;4971;4993;6.92;0.43;223.60;4.69;731;39;1706.00;22
4244;39;628499086;4244;272;4972;4994;6.94;0.43;223.67;4.69;728;39;1707.00;22
4247;39;628499095;4247;268;4976;4998;7.01;0.43;223.80;4.68;729;39;1708.00;22
4251;39;628499104;4251;270;4976;4998;7.10;0.44;223.96;4.68;725;39;1709.00;22
4252;39;628499114;4252;261;4979;5004;7.27;0.45;223.92;4.68;727;39;1710.00;25
4254;39;628499123;4254;260;4979;5004;7.32;0.45;223.94;4.68;725;39;1711.00;25
4256;39;628499132;4256;263;4980;5004;7.35;0.45;224.02;4.68;724;39;1712.00;24
4261;39;628499140;4261;266;4980;5004;7.34;0.45;223.93;4.68;719;39;1713.00;24
4265;39;628499149;4265;267;4983;5008;7.33;0.45;223.92;4.68;718;39;1714.00;25
4270;39;628499158;4270;267;4983;5008;7.20;0.44;223.78;4.68;713;39;1715.00;25
4272;39;628499166;4272;270;4984;5008;7.11;0.44;223.77;4.68;712;39;1716.00;24
4277;39;628499174;4277;273;4984;5008;7.05;0.43;223.74;4.68;707;39;1717.00;24
4281;39;628499182;4281;270;4986;5009;6.97;0.43;223.80;4.68;705;39;1718.00;23
4287;39;628499190;4287;269;4987;5010;6.97;0.43;223.75;4.68;700;39;1719.00;23
4291;39;628499199;4291;265;4988;5010;6.95;0.43;223.85;4.68;697;39;1720.00;22
4293;39;628499208;4293;267;4989;5011;7.00;0.43;223.86;4.68;696;39;1721.00;22
4298;39;628499216;4298;270;4989;5011;7.02;0.43;223.81;4.68;691;39;1722.00;22
4301;39;628499225;4301;274;4989;5011;7.00;0.43;223.76;4.68;688;39;1723.00;22
4305;39;628499233;4305;270;4989;5011;7.00;0.43;223.76;4.68;684;39;1724.00;22
4308;39;628499242;4308;267;4989;5011;7.01;0.43;223.93;4.68;681;39;1725.00;22
4311;39;628499251;4311;267;4989;5011;7.05;0.43;223.92;4.68;678;39;1726.00;22
4314;39;628499259;4314;266;4989;5011;7.06;0.43;223.96;4.68;675;39;1727.00;22
4318;39;628499267;4318;282;5060;5138;7.46;0.46;223.91;4.61;742;39;1728.00;78
4320;39;628499285;4320;285;5063;5139;7.44;0.46;223.89;4.61;743;39;1729.00;76
4323;39;628499294;4323;287;5074;5139;7.47;0.46;223.92;4.61;751;39;1730.00;65
4326;39;628499309;4326;287;5079;5139;7.51;0.47;223.89;4.60;753;39;1731.00;60
4327;39;628499318;4327;288;5085;5139;7.58;0.47;223.92;4.60;758;39;1732.00;54
4331;39;628499327;4331;287;5090;5139;7.54;0.47;223.90;4.60;759;39;1733.00;49
4334;39;628499336;4334;287;5096;5139;7.61;0.47;223.89;4.60;762;39;1734.00;43
4339;39;628499345;4339;296;5099;5139;7.60;0.47;223.81;4.61;760;39;1735.00;40
4343;39;628499355;4343;301;5103;5140;7.55;0.46;223.78;4.61;760;39;1736.00;37
4347;39;628499365;4347;308;5106;5141;7.51;0.46;223.90;4.61;759;39;1737.00;35
4348;39;628499375;4348;314;5107;5141;7.47;0.46;223.94;4.61;759;39;1738.00;34
4350;39;628499389;4350;313;5109;5142;7.43;0.46;223.97;4.61;759;39;1739.00;33
4352;39;628499401;4352;308;5111;5142;7.40;0.45;223.97;4.61;759;39;1740.00;31
4352;39;628499411;4352;305;5112;5142;7.47;0.46;223.97;4.62;760;39;1741.00;30
4355;39;628499427;4355;306;5114;5142;7.56;0.46;224.03;4.62;759;39;1742.00;28
4356;39;628499437;4356;299;5117;5146;7.66;0.47;224.05;4.62;761;39;1743.00;29
4358;39;628499448;4358;295;5118;5146;7.70;0.47;224.05;4.62;760;39;1744.00;28
4360;39;628499458;4360;297;5119;5146;7.72;0.47;224.05;4.62;759;39;1745.00;27
4363;39;628499475;4363;298;5122;5149;7.81;0.48;224.00;4.62;759;39;1746.00;27
4366;39;628499486;4366;281;5122;5149;7.87;0.48;224.04;4.62;756;39;1747.00;27
4367;39;628499497;4367;272;5123;5149;7.98;0.49;224.03;4.62;756;39;1748.00;26
4371;39;628499507;4371;266;5127;5153;8.15;0.50;224.18;4.62;756;39;1749.00;26
4372;39;628499518;4372;260;5129;5154;8.32;0.51;224.20;4.62;757;39;1750.00;25
4374;39;628499529;4374;258;5129;5154;8.48;0.52;224.11;4.62;755;39;1751.00;25
4376;39;628499540;4376;252;5134;5158;8.66;0.53;224.11;4.62;758;39;1752.00;24
4378;39;628499551;4378;248;5134;5158;8.77;0.54;224.17;4.62;756;39;1753.00;24
4381;39;628499562;4381;245;5134;5158;8.85;0.54;224.21;4.62;753;39;1754.00;24
4383;40;628499573;4383;236;5136;5160;8.97;0.55;224.28;4.62;753;40;1755.00;24
4384;40;628499595;4384;217;5136;5160;9.13;0.56;224.34;4.62;752;40;1756.00;24
4384;40;628499606;4384;198;5141;5166;9.28;0.57;224.34;4.61;757;40;1757.00;25
4386;40;628499617;4386;188;5141;5166;9.47;0.58;224.33;4.61;755;40;1758.00;25
4391;40;628499629;4391;167;5143;5167;9.65;0.59;224.29;4.61;752;40;1759.00;24
4393;40;628499641;4393;159;5143;5167;9.81;0.60;224.32;4.61;750;40;1760.00;24
4394;40;628499652;4394;157;5143;5167;9.94;0.60;224.32;4.61;749;40;1761.00;24
4396;40;628499663;4396;150;5143;5167;10.08;0.61;224.32;4.61;747;40;1762.00;24
4399;40;628499675;4399;151;5143;5167;10.19;0.62;224.27;4.61;744;40;1763.00;24
4401;40;628499686;4401;148;5153;5179;10.36;0.63;224.33;4.60;752;40;1764.00;26
4405;40;628499699;4405;148;5153;5179;10.48;0.64;224.43;4.60;748;40;1765.00;26
4407;40;628499710;4407;141;5154;5179;10.65;0.65;224.41;4.60;747;40;1766.00;25
4410;40;628499721;4410;142;5154;5179;10.83;0.66;224.52;4.60;744;40;1767.00;25
4414;40;628499732;4414;140;5154;5179;10.86;0.66;224.67;4.60;740;40;1768.00;25
4417;40;628499744;4417;142;5154;5179;10.92;0.66;224.77;4.60;737;40;1769.00;25
4419;40;628499764;4419;138;5157;5183;10.99;0.67;224.86;4.60;738;40;1770.00;26
4421;40;628499777;4421;141;5157;5183;11.05;0.67;224.91;4.60;736;40;1771.00;26
4423;40;628499789;4423;136;5160;5187;11.16;0.68;225.02;4.60;737;40;1772.00;27
4427;40;628499809;4427;133;5161;5188;11.27;0.68;225.08;4.60;734;40;1773.00;27
4429;40;628499822;4429;134;5162;5188;11.32;0.69;225.12;4.60;733;40;1774.00;26
4435;40;628499839;4435;132;5162;5188;11.38;0.69;225.18;4.60;727;40;1775.00;26
4439;41;628499869;4439;131;5173;5201;11.55;0.70;225.27;4.59;734;41;1776.00;28
4443;41;628499911;4443;132;5173;5201;11.60;0.70;225.54;4.59;730;41;1777.00;28
4445;41;628499928;4445;126;5173;5201;11.68;0.71;225.58;4.59;728;41;1778.00;28
4448;43;628499945;4448;125;5174;5202;11.73;0.71;225.64;4.59;726;43;1779.00;28
4449;43;628499989;4449;124;5174;5203;11.87;0.72;225.67;4.59;725;43;1780.00;29
4450;43;628500004;4450;129;5174;5203;11.90;0.72;225.71;4.59;724;43;1781.00;29
4456;43;628500020;4456;125;5176;5206;11.90;0.72;225.84;4.59;720;43;1782.00;30
4457;43;628500045;4457;122;5176;5206;11.90;0.72;225.80;4.59;719;43;1783.00;30
4460;44;628500060;4460;118;5177;5206;11.88;0.72;225.74;4.58;717;44;1784.00;29
4462;44;628500090;4462;119;5177;5206;11.91;0.72;225.72;4.58;715;44;1785.00;29
4464;44;628500102;4464;117;5181;5212;12.02;0.73;225.71;4.58;717;44;1786.00;31
4466;44;628500115;4466;119;5181;5212;11.96;0.73;225.79;4.58;715;44;1787.00;31
4470;44;628500126;4470;119;5182;5212;12.00;0.73;225.77;4.58;712;44;1788.00;30
4476;44;628500137;4476;121;5182;5212;12.02;0.73;225.88;4.58;706;44;1789.00;30
4479;44;628500154;4479;121;5185;5216;12.02;0.73;225.99;4.58;706;44;1790.00;31
4481;44;628500165;4481;120;5186;5217;12.11;0.73;226.05;4.58;705;44;1791.00;31
4486;44;628500176;4486;118;5186;5217;12.13;0.74;226.09;4.58;700;44;1792.00;31
4487;44;628500188;4487;121;5187;5218;12.14;0.74;226.07;4.58;700;44;1793.00;31
4492;44;628500199;4492;120;5187;5218;12.12;0.74;226.21;4.58;695;44;1794.00;31
4496;44;628500210;4496;122;5187;5218;12.15;0.74;226.26;4.58;691;44;1795.00;31
4497;44;628500222;4497;123;5187;5218;12.23;0.74;226.30;4.58;690;44;1796.00;31
4503;44;628500233;4503;121;5187;5218;12.23;0.74;226.36;4.58;684;44;1797.00;31
4506;44;628500244;4506;123;5187;5218;12.28;0.75;226.37;4.58;681;44;1798.00;31
4510;44;628500256;4510;125;5187;5218;12.23;0.74;226.45;4.58;677;44;1799.00;31
4514;44;628500270;4514;146;5248;5356;11.71;0.72;226.41;4.52;734;44;1800.00;108
4515;44;628500296;4515;131;5249;5357;11.68;0.72;226.46;4.59;734;44;1801.00;108
4521;44;628500314;4521;118;5260;5357;11.72;0.72;226.46;4.59;739;44;1802.00;97
4525;44;628500325;4525;113;5262;5357;11.73;0.72;226.57;4.59;737;44;1803.00;95
4528;44;628500336;4528;111;5266;5357;11.77;0.72;226.66;4.59;738;44;1804.00;91
4533;44;628500348;4533;114;5273;5357;11.76;0.72;226.68;4.60;740;44;1805.00;84
4536;44;628500360;4536;113;5277;5357;11.83;0.73;226.69;4.60;741;44;1806.00;80
4542;44;628500371;4542;112;5281;5357;11.88;0.73;226.87;4.60;739;44;1807.00;76
4547;44;628500383;4547;117;5284;5358;11.98;0.73;226.93;4.60;737;44;1808.00;74
4551;44;628500396;4551;112;5287;5359;12.03;0.74;226.92;4.61;736;44;1809.00;72
4554;44;628500407;4554;108;5290;5359;12.05;0.74;226.87;4.61;736;44;1810.00;69
4558;44;628500418;4558;104;5295;5363;12.05;0.74;227.00;4.61;737;44;1811.00;68
4564;44;628500430;4564;101;5296;5363;12.07;0.74;226.91;4.61;732;44;1812.00;67
4565;44;628500442;4565;91;5297;5363;12.05;0.73;226.98;4.61;732;44;1813.00;66
4567;44;628500459;4567;90;5297;5363;12.00;0.73;226.99;4.61;730;44;1814.00;66
4571;44;628500472;4571;96;5300;5369;11.98;0.73;227.04;4.61;729;44;1815.00;69
4574;44;628500484;4574;100;5301;5369;11.93;0.73;227.05;4.61;727;44;1816.00;68
4580;44;628500503;4580;103;5303;5369;11.95;0.73;227.23;4.69;723;44;1817.00;66
4581;44;628500515;4581;109;5305;5372;11.97;0.73;227.18;4.68;724;44;1818.00;67
4585;44;628500526;4585;115;5306;5372;12.02;0.73;227.27;4.69;721;44;1819.00;66
4588;44;628500539;4588;127;5308;5372;12.00;0.73;227.26;4.69;720;44;1820.00;64
4589;44;628500551;4589;123;5308;5373;12.00;0.73;227.35;4.69;719;44;1821.00;65
4591;44;628500563;4591;123;5312;5374;11.99;0.73;227.37;4.70;721;44;1822.00;62
4592;44;628500574;4592;124;5313;5374;12.01;0.73;227.43;4.71;721;44;1823.00;61
4594;45;628500585;4594;132;5320;5387;12.02;0.73;227.40;4.70;726;45;1824.00;67
4597;45;628500610;4597;135;5320;5387;12.03;0.73;227.40;4.70;723;45;1825.00;67
4600;45;628500623;4600;139;5321;5387;12.05;0.73;227.37;4.70;721;45;1826.00;66
4604;45;628500634;4604;143;5325;5388;12.00;0.73;227.35;4.71;721;45;1827.00;63
4608;45;628500653;4608;143;5326;5388;11.98;0.73;227.34;4.72;718;45;1828.00;62
4612;45;628500667;4612;147;5328;5392;11.98;0.73;227.38;4.71;716;45;1829.00;64
4614;45;628500682;4614;158;5330;5392;11.75;0.71;227.42;4.73;716;45;1830.00;62
4619;45;628500694;4619;169;5335;5396;11.53;0.70;227.39;4.73;716;45;1831.00;61
4623;45;628500706;4623;176;5336;5396;11.30;0.69;227.39;4.73;713;45;1832.00;60
4627;45;628500717;4627;181;5339;5396;11.12;0.67;227.40;4.75;712;45;1833.00;57
4628;45;628500728;4628;182;5340;5396;10.95;0.66;227.47;4.76;712;45;1834.00;56
4629;45;628500738;4629;189;5343;5396;10.83;0.66;227.47;4.77;714;45;1835.00;53
4633;45;628500749;4633;191;5353;5408;10.72;0.65;227.39;4.76;720;45;1836.00;55
4635;45;628500767;4635;198;5357;5408;10.58;0.64;227.34;4.78;722;45;1837.00;51
4636;45;628500777;4636;203;5359;5408;10.47;0.64;227.41;4.78;723;45;1838.00;49
4639;45;628500788;4639;207;5362;5408;10.37;0.63;227.34;4.80;723;45;1839.00;46
4641;45;628500798;4641;214;5363;5408;10.33;0.63;227.40;4.80;722;45;1840.00;45
4643;45;628500808;4643;218;5364;5408;10.25;0.63;227.39;4.81;721;45;1841.00;44
4646;45;628500818;4646;227;5365;5409;10.10;0.62;227.39;4.81;719;45;1842.00;44
4650;45;628500829;4650;228;5366;5409;9.97;0.61;227.43;4.82;716;45;1843.00;43
4651;45;628500846;4651;235;5370;5415;9.86;0.60;227.42;4.81;719;45;1844.00;45
4653;45;628500859;4653;245;5373;5417;9.67;0.59;227.43;4.82;720;45;1845.00;44
4654;45;628500869;4654;255;5375;5417;9.48;0.58;227.45;4.82;721;45;1846.00;42
4656;45;628500879;4656;255;5375;5417;9.32;0.57;227.42;4.82;719;45;1847.00;42
4657;45;628500889;4657;258;5381;5421;9.18;0.56;227.42;4.83;724;45;1848.00;40
4658;45;628500898;4658;263;5381;5421;9.02;0.55;227.42;4.83;723;45;1849.00;40
4661;45;628500907;4661;265;5381;5421;8.91;0.55;227.37;4.83;720;45;1850.00;40
4662;45;628500915;4662;273;5384;5422;8.77;0.54;227.34;4.83;722;45;1851.00;38
4664;45;628500923;4664;269;5387;5426;8.57;0.53;227.34;4.83;723;45;1852.00;39
4666;45;628500934;4666;270;5388;5426;8.46;0.52;227.29;4.83;722;45;1853.00;38
4669;45;628500942;4669;270;5390;5429;8.38;0.52;227.25;4.83;721;45;1854.00;39
4671;45;628500951;4671;267;5390;5429;8.29;0.51;227.49;4.83;719;45;1855.00;39
4675;45;628500960;4675;270;5392;5429;8.20;0.50;227.43;4.83;717;45;1856.00;37
4676;45;628500970;4676;272;5392;5429;8.18;0.50;227.40;4.83;716;45;1857.00;37
4680;45;628500978;4680;275;5396;5433;8.17;0.50;227.39;4.83;716;45;1858.00;37
4683;45;628500988;4683;276;5396;5433;8.07;0.50;227.33;4.83;713;45;1859.00;37
4687;45;628500998;4687;276;5397;5433;7.96;0.49;227.27;4.83;710;45;1860.00;36
4689;45;628501006;4689;278;5397;5433;7.76;0.48;227.26;4.83;708;45;1861.00;36
4692;45;628501020;4692;278;5398;5434;7.54;0.46;227.17;4.83;706;45;1862.00;36
4695;45;628501027;4695;287;5399;5435;7.35;0.45;227.11;4.83;704;45;1863.00;36
4698;45;628501035;4698;289;5399;5435;7.21;0.44;227.09;4.83;701;45;1864.00;36
4704;45;628501043;4704;293;5400;5436;7.07;0.44;227.05;4.83;696;45;1865.00;36
4706;45;628501051;4706;298;5400;5436;6.94;0.43;227.12;4.83;694;45;1866.00;36
4707;45;628501058;4707;305;5400;5436;6.81;0.42;227.16;4.83;693;45;1867.00;36
4710;45;628501065;4710;306;5400;5436;6.59;0.41;227.23;4.83;690;45;1868.00;36
4713;45;628501072;4713;312;5400;5436;6.43;0.40;227.20;4.83;687;45;1869.00;36
4718;45;628501079;4718;305;5400;5436;6.26;0.39;227.15;4.83;682;45;1870.00;36
4718;45;628501086;4718;302;5400;5436;6.21;0.39;227.15;4.83;682;45;1871.00;36
4721;45;628501093;4721;328;5470;5563;6.51;0.41;227.27;4.77;749;45;1872.00;93
4721;45;628501110;4721;321;5473;5564;6.48;0.41;227.27;4.76;752;45;1873.00;91
4724;45;628501118;4724;312;5482;5564;6.56;0.41;227.33;4.76;758;45;1874.00;82
4729;45;628501126;4729;318;5488;5564;6.51;0.41;227.39;4.76;759;45;1875.00;76
4730;45;628501133;4730;320;5495;5564;6.61;0.41;227.36;4.76;765;45;1876.00;69
4734;45;628501141;4734;315;5497;5564;6.58;0.41;227.42;4.76;763;45;1877.00;67
4736;45;628501149;4736;308;5502;5564;6.62;0.41;227.49;4.76;766;45;1878.00;62
4739;45;628501157;4739;307;5504;5564;6.58;0.41;227.47;4.76;765;45;1879.00;60
4742;45;628501165;4742;308;5508;5565;6.56;0.41;227.48;4.76;766;45;1880.00;57
4746;45;628501178;4746;307;5510;5566;6.51;0.40;227.48;4.76;764;45;1881.00;56
4750;45;628501187;4750;307;5514;5568;6.55;0.41;227.39;4.77;764;45;1882.00;54
4751;45;628501195;4751;311;5517;5569;6.59;0.41;227.44;4.77;766;45;1883.00;52
4754;45;628501204;4754;317;5521;5569;6.60;0.41;227.42;4.77;767;45;1884.00;48
4757;45;628501212;4757;325;5523;5569;6.67;0.41;227.44;4.78;766;45;1885.00;46
4761;45;628501221;4761;328;5526;5569;6.68;0.41;227.47;4.78;765;45;1886.00;43
4764;45;628501229;4764;327;5530;5573;6.68;0.41;227.58;4.78;766;45;1887.00;43
4765;45;628501238;4765;332;5532;5573;6.64;0.41;227.59;4.78;767;45;1888.00;41
4766;45;628501247;4766;327;5534;5573;6.65;0.41;227.58;4.78;768;45;1889.00;39
4769;45;628501257;4769;328;5538;5579;6.66;0.41;227.60;4.78;769;45;1890.00;41
4771;45;628501267;4771;309;5539;5579;6.73;0.42;227.59;4.78;768;45;1891.00;40
4774;45;628501276;4774;296;5540;5579;6.77;0.42;227.57;4.78;766;45;1892.00;39
4777;45;628501286;4777;289;5545;5583;6.86;0.42;227.58;4.78;768;45;1893.00;38
4781;45;628501296;4781;287;5546;5584;6.99;0.43;227.51;4.78;765;45;1894.00;38
4785;45;628501307;4785;275;5546;5584;7.02;0.43;227.51;4.78;761;45;1895.00;38
4787;45;628501316;4787;274;5550;5588;7.08;0.43;227.55;4.77;763;45;1896.00;38
4790;45;628501326;4790;271;5551;5588;7.14;0.44;227.54;4.85;761;45;1897.00;37
4795;45;628501345;4795;272;5551;5588;7.16;0.44;227.49;4.85;756;45;1898.00;37
4798;45;628501354;4798;266;5552;5589;7.24;0.44;227.54;4.85;754;45;1899.00;37
4798;45;628501365;4798;266;5552;5589;7.35;0.45;227.54;4.85;754;45;1900.00;37
4803;45;628501378;4803;265;5557;5595;7.43;0.45;227.37;4.85;754;45;1901.00;38
4807;45;628501388;4807;264;5558;5595;7.51;0.46;227.34;4.85;751;45;1902.00;37
4809;45;628501398;4809;263;5559;5596;7.56;0.46;227.41;4.85;750;45;1903.00;37
4811;45;628501408;4811;259;5559;5596;7.69;0.47;227.39;4.85;748;45;1904.00;37
4815;45;628501418;4815;258;5559;5596;7.75;0.47;227.42;4.85;744;45;1905.00;37
4818;45;628501428;4818;258;5559;5596;7.82;0.48;227.42;4.85;741;45;1906.00;37
4821;45;628501438;4821;264;5559;5596;7.85;0.48;227.55;4.85;738;45;1907.00;37
4825;45;628501448;4825;264;5569;5608;8.00;0.49;227.61;4.84;744;45;1908.00;39
4828;45;628501458;4828;264;5570;5608;8.06;0.49;227.57;4.84;742;45;1909.00;38
4832;45;628501468;4832;261;5571;5608;8.11;0.49;227.60;4.84;739;45;1910.00;37
4835;45;628501478;4835;269;5571;5608;8.10;0.49;227.71;4.84;736;45;1911.00;37
4835;45;628501488;4835;270;5571;5608;8.21;0.50;227.71;4.84;736;45;1912.00;37
4839;45;628501498;4839;277;5571;5608;8.20;0.50;227.82;4.84;732;45;1913.00;37
4841;45;628501509;4841;278;5575;5612;8.29;0.50;227.82;4.83;734;45;1914.00;37
4842;45;628501519;4842;273;5575;5612;8.35;0.51;227.86;4.83;733;45;1915.00;37
4844;45;628501529;4844;273;5578;5616;8.42;0.51;227.89;4.83;734;45;1916.00;38
4846;45;628501540;4846;261;5579;5617;8.47;0.51;227.89;4.83;733;45;1917.00;38
4850;45;628501551;4850;250;5581;5617;8.49;0.51;227.93;4.92;731;45;1918.00;36
4851;45;628501561;4851;244;5581;5617;8.50;0.52;227.95;4.92;730;45;1919.00;36
4853;45;628501574;4853;240;5602;5646;8.64;0.53;228.00;4.90;749;45;1920.00;44
4854;45;628501587;4854;235;5603;5646;8.75;0.53;228.01;4.90;749;45;1921.00;43
4859;45;628501597;4859;227;5604;5646;8.89;0.54;228.06;4.90;745;45;1922.00;42
4861;45;628501608;4861;220;5606;5647;9.06;0.55;228.14;4.90;745;45;1923.00;41
4861;45;628501619;4861;217;5607;5648;9.18;0.56;228.14;4.90;746;45;1924.00;41
4864;45;628501635;4864;218;5607;5648;9.25;0.56;228.23;4.90;743;45;1925.00;41
4868;45;628501651;4868;200;5610;5651;9.26;0.56;228.24;4.89;742;45;1926.00;41
4870;45;628501663;4870;181;5610;5651;9.34;0.57;228.32;4.89;740;45;1927.00;41
4873;45;628501674;4873;167;5610;5651;9.44;0.57;228.37;4.89;737;45;1928.00;41
4877;45;628501686;4877;158;5610;5651;9.54;0.58;228.43;4.89;733;45;1929.00;41
4880;45;628501697;4880;149;5614;5657;9.67;0.59;228.47;4.89;734;45;1930.00;43
4886;45;628501709;4886;143;5615;5657;9.72;0.59;228.50;4.89;729;45;1931.00;42
4889;45;628501721;4889;133;5615;5657;9.84;0.60;228.56;4.89;726;45;1932.00;42
4892;45;628501733;4892;132;5615;5657;10.00;0.61;228.64;4.89;723;45;1933.00;42
4895;45;628501744;4895;131;5618;5661;10.13;0.62;228.63;4.89;723;45;1934.00;43
4897;45;628501756;4897;128;5620;5663;10.30;0.63;228.67;4.89;723;45;1935.00;43
4899;45;628501768;4899;127;5620;5663;10.43;0.63;228.62;4.89;721;45;1936.00;43
4903;45;628501779;4903;131;5621;5664;10.59;0.64;228.67;4.89;718;45;1937.00;43
4910;45;628501791;4910;132;5622;5664;10.60;0.64;228.68;4.97;712;45;1938.00;42
4911;45;628501808;4911;124;5622;5664;10.73;0.65;228.67;4.97;711;45;1939.00;42
4915;45;628501820;4915;130;5622;5664;10.86;0.66;228.72;4.97;707;45;1940.00;42
4917;45;628501831;4917;125;5622;5664;11.01;0.67;228.73;4.97;705;45;1941.00;42
4922;45;628501853;4922;121;5622;5664;11.10;0.67;228.73;4.97;700;45;1942.00;42
4923;45;628501882;4923;117;5622;5664;11.22;0.68;228.79;4.97;699;45;1943.00;42
4927;45;628501901;4927;133;5664;5734;11.01;0.67;228.94;4.94;737;45;1944.00;70
4927;45;628501926;4927;120;5664;5735;11.17;0.68;228.94;4.94;737;45;1945.00;71
4932;45;628501943;4932;111;5669;5735;11.35;0.69;228.94;4.93;737;45;1946.00;66
4934;45;628501957;4934;109;5673;5735;11.47;0.70;229.03;4.93;739;45;1947.00;62
4936;45;628501971;4936;110;5678;5735;11.71;0.71;229.03;4.93;742;45;1948.00;57
4939;45;628501983;4939;116;5682;5735;11.77;0.72;229.12;4.93;743;45;1949.00;53
4940;45;628501998;4940;122;5686;5737;11.90;0.72;229.16;4.93;746;45;1950.00;51
4943;45;628502010;4943;131;5686;5737;11.96;0.73;229.22;4.93;743;45;1951.00;51
4945;46;628502023;4945;130;5689;5738;11.95;0.73;229.31;4.93;744;46;1952.00;49
4946;47;628502050;4946;133;5690;5739;12.10;0.74;229.30;4.93;744;47;1953.00;49
4949;47;628502070;4949;135;5691;5739;12.12;0.74;229.43;4.93;742;47;1954.00;48
4951;47;628502087;4951;139;5695;5743;12.05;0.73;229.45;4.93;744;47;1955.00;48
4953;47;628502104;4953;137;5695;5743;12.05;0.73;229.47;4.93;742;47;1956.00;48
4954;47;628502117;4954;140;5695;5743;12.02;0.73;229.52;4.93;741;47;1957.00;48
4955;47;628502134;4955;143;5695;5743;12.01;0.73;229.56;4.93;740;47;1958.00;48
4958;47;628502145;4958;147;5700;5749;11.88;0.73;229.61;4.93;742;47;1959.00;49
4960;47;628502157;4960;152;5700;5749;11.83;0.72;229.60;4.93;740;47;1960.00;49
4964;47;628502168;4964;157;5700;5749;11.76;0.72;229.70;4.93;736;47;1961.00;49
4965;47;628502179;4965;162;5704;5752;11.74;0.72;229.69;5.01;739;47;1962.00;48
4970;47;628502191;4970;165;5704;5752;11.66;0.71;229.69;5.01;734;47;1963.00;48
4974;47;628502202;4974;167;5704;5752;11.70;0.71;229.68;5.01;730;47;1964.00;48
4976;47;628502212;4976;166;5704;5753;11.73;0.71;229.68;5.01;728;47;1965.00;49
4982;47;628502223;4982;162;5705;5754;11.75;0.71;229.71;5.01;723;47;1966.00;49
4986;47;628502234;4986;163;5705;5754;11.72;0.71;229.74;5.01;719;47;1967.00;49
4990;47;628502245;4990;163;5714;5767;11.67;0.71;229.69;5.01;724;47;1968.00;53
4995;47;628502257;4995;156;5714;5767;11.61;0.70;229.74;5.01;719;47;1969.00;53
4998;47;628502268;4998;152;5714;5767;11.61;0.70;229.75;5.01;716;47;1970.00;53
5000;47;628502278;5000;148;5715;5768;11.63;0.71;229.72;5.00;715;47;1971.00;53
5006;47;628502289;5006;141;5715;5768;11.66;0.71;229.94;5.00;709;47;1972.00;53
5012;47;628502299;5012;135;5718;5772;11.71;0.71;229.97;5.00;706;47;1973.00;54
5016;47;628502311;5016;130;5720;5772;11.67;0.71;229.95;5.01;704;47;1974.00;52
5020;47;628502323;5020;131;5724;5776;11.66;0.71;229.96;5.02;704;47;1975.00;52
5023;47;628502340;5023;131;5724;5776;11.73;0.71;229.96;5.02;701;47;1976.00;52
5026;47;628502351;5026;126;5724;5776;11.87;0.72;229.97;5.02;698;47;1977.00;52
5031;47;628502361;5031;123;5724;5776;11.95;0.72;229.95;5.02;693;47;1978.00;52
5033;47;628502372;5033;124;5724;5776;12.00;0.73;229.91;5.02;691;47;1979.00;52
5036;47;628502384;5036;123;5744;5810;11.94;0.73;230.00;5.00;708;47;1980.00;66
5037;47;628502397;5037;122;5745;5810;11.95;0.73;229.99;5.00;708;47;1981.00;65
5041;47;628502415;5041;119;5746;5810;11.94;0.73;230.01;5.00;705;47;1982.00;64
5041;47;628502425;5041;123;5746;5810;11.95;0.73;230.01;5.00;705;47;1983.00;64
5043;47;628502435;5043;121;5747;5810;11.97;0.73;229.99;5.00;704;47;1984.00;63
5044;47;628502447;5044;122;5747;5810;11.98;0.73;229.99;5.00;703;47;1985.00;63
5048;47;628502457;5048;125;5748;5811;12.03;0.73;230.11;5.00;700;47;1986.00;63
5051;47;628502468;5051;124;5749;5811;12.01;0.73;230.11;5.00;698;47;1987.00;62
5054;48;628502479;5054;127;5752;5817;12.06;0.73;230.06;5.00;698;48;1988.00;65
5060;48;628502502;5060;130;5754;5818;12.08;0.73;229.98;5.00;694;48;1989.00;64
5065;48;628502513;5065;125;5754;5818;12.03;0.73;229.90;5.00;689;48;1990.00;64
5066;48;628502524;5066;125;5756;5818;12.05;0.73;229.93;5.00;690;48;1991.00;62
5068;48;628502535;5068;126;5758;5822;11.97;0.73;229.91;5.00;690;48;1992.00;64
5070;48;628502546;5070;133;5759;5822;11.91;0.72;229.86;5.00;689;48;1993.00;63
5074;48;628502556;5074;137;5759;5822;11.84;0.72;229.88;5.00;685;48;1994.00;63
5077;48;628502567;5077;141;5761;5823;11.73;0.71;229.84;5.00;684;48;1995.00;62
5080;48;628502577;5080;145;5766;5827;11.61;0.70;229.79;5.01;686;48;1996.00;61
5085;48;628502587;5085;145;5766;5827;11.50;0.70;229.85;5.01;681;48;1997.00;61
5088;48;628502599;5088;149;5769;5830;11.33;0.69;229.91;5.01;681;48;1998.00;61
5091;48;628502609;5091;156;5771;5830;11.24;0.68;229.97;5.02;680;48;1999.00;59
5095;48;628502620;5095;161;5772;5830;11.10;0.67;229.95;5.02;677;48;2000.00;58
5098;48;628502634;5098;167;5773;5830;11.04;0.67;230.01;5.04;675;48;2001.00;57
5099;48;628502644;5099;167;5778;5834;11.01;0.67;230.03;5.04;679;48;2002.00;56
5100;48;628502654;5100;174;5779;5834;10.94;0.67;230.06;5.05;679;48;2003.00;55
5101;48;628502664;5101;176;5781;5834;10.86;0.66;230.07;5.06;680;48;2004.00;53
5102;48;628502674;5102;180;5782;5834;10.72;0.65;230.12;5.07;680;48;2005.00;52
5105;48;628502684;5105;186;5782;5835;10.55;0.64;230.24;5.07;677;48;2006.00;53
5106;48;628502694;5106;191;5785;5836;10.40;0.63;230.24;5.08;679;48;2007.00;51
5110;48;628502703;5110;200;5785;5836;10.22;0.62;230.27;5.08;675;48;2008.00;51
5114;48;628502712;5114;207;5787;5837;10.09;0.61;230.30;5.09;673;48;2009.00;50
5114;48;628502724;5114;211;5788;5837;9.99;0.61;230.30;5.09;674;48;2010.00;49
5117;48;628502732;5117;218;5789;5837;9.82;0.60;230.31;5.10;672;48;2011.00;48
5120;48;628502742;5120;220;5790;5837;9.61;0.59;230.33;5.11;670;48;2012.00;47
5121;48;628502751;5121;231;5791;5837;9.45;0.58;230.32;5.11;670;48;2013.00;46
5124;48;628502759;5124;235;5791;5837;9.32;0.57;230.26;5.11;667;48;2014.00;46
5126;48;628502768;5126;237;5792;5837;9.22;0.57;230.23;5.12;666;48;2015.00;45
5129;48;628502776;5129;262;5858;5964;9.21;0.57;230.14;5.08;729;48;2016.00;106
5132;48;628502794;5132;263;5859;5965;9.06;0.56;230.08;5.08;727;48;2017.00;106
5133;48;628502804;5133;265;5870;5965;9.09;0.56;230.07;5.08;737;48;2018.00;95
5137;48;628502813;5137;266;5878;5965;9.01;0.56;229.95;5.08;741;48;2019.00;87
5138;48;628502823;5138;261;5884;5965;8.88;0.55;229.93;5.08;746;48;2020.00;81
5141;48;628502832;5141;260;5891;5965;8.73;0.54;229.87;5.08;750;48;2021.00;74
5145;48;628502841;5145;262;5897;5965;8.60;0.53;229.93;5.08;752;48;2022.00;68
5146;48;628502852;5146;265;5903;5965;8.42;0.52;229.91;5.08;757;48;2023.00;62
5148;48;628502862;5148;266;5905;5966;8.32;0.51;229.84;5.09;757;48;2024.00;61
5152;48;628502871;5152;269;5909;5968;8.27;0.51;229.78;5.09;757;48;2025.00;59
5153;48;628502882;5153;269;5914;5968;8.26;0.51;229.77;5.09;761;48;2026.00;54
5157;48;628502892;5157;279;5916;5969;8.13;0.50;229.69;5.09;759;48;2027.00;53
5158;48;628502901;5158;283;5918;5969;8.07;0.50;229.66;5.09;760;48;2028.00;51
5160;48;628502910;5160;296;5919;5969;7.92;0.49;229.65;5.09;759;48;2029.00;50
5161;48;628502920;5161;299;5922;5969;7.75;0.48;229.63;5.10;761;48;2030.00;47
5163;48;628502929;5163;310;5925;5973;7.58;0.47;229.61;5.10;762;48;2031.00;48
5165;48;628502939;5165;314;5927;5973;7.41;0.45;229.61;5.10;762;48;2032.00;46
5170;48;628502948;5170;324;5927;5973;7.19;0.44;229.64;5.10;757;48;2033.00;46
5173;48;628502957;5173;328;5930;5976;7.08;0.43;229.70;5.10;757;48;2034.00;46
5174;48;628502969;5174;332;5931;5976;6.97;0.43;229.71;5.10;757;48;2035.00;45
5176;48;628502978;5176;335;5932;5976;6.81;0.42;229.76;5.11;756;48;2036.00;44
5177;48;628502986;5177;344;5936;5980;6.64;0.41;229.80;5.10;759;48;2037.00;44
5179;48;628502997;5179;348;5938;5981;6.51;0.40;229.83;5.10;759;48;2038.00;43
5181;48;628503005;5181;355;5938;5981;6.34;0.39;229.82;5.10;757;48;2039.00;43
5182;48;628503016;5182;352;5944;5986;6.34;0.39;229.86;5.10;762;48;2040.00;42
5185;48;628503024;5185;357;5945;5986;6.28;0.39;229.79;5.10;760;48;2041.00;41
5187;48;628503034;5187;355;5945;5986;6.22;0.38;229.81;5.10;758;48;2042.00;41
5191;48;628503042;5191;342;5946;5987;6.18;0.38;229.81;5.10;755;48;2043.00;41
5192;48;628503051;5192;329;5946;5987;6.20;0.38;229.80;5.10;754;48;2044.00;41
5195;48;628503060;5195;326;5951;5993;6.29;0.39;229.85;5.10;756;48;2045.00;42
5199;48;628503070;5199;315;5951;5993;6.37;0.39;229.85;5.10;752;48;2046.00;42
5201;48;628503079;5201;303;5953;5994;6.49;0.40;229.86;5.09;752;48;2047.00;41
5202;48;628503088;5202;292;5953;5994;6.60;0.41;229.88;5.09;751;48;2048.00;41
5206;48;628503103;5206;287;5953;5994;6.72;0.41;229.88;5.09;747;48;2049.00;41
5206;48;628503112;5206;278;5953;5994;6.87;0.42;229.88;5.09;747;48;2050.00;41
5212;48;628503121;5212;276;5953;5994;6.98;0.43;229.82;5.09;741;48;2051.00;41
5215;48;628503130;5215;272;5963;6006;7.12;0.44;229.89;5.09;748;48;2052.00;43
5216;48;628503140;5216;266;5963;6006;7.24;0.44;229.87;5.09;747;48;2053.00;43
5220;48;628503154;5220;261;5965;6006;7.35;0.45;229.94;5.08;745;48;2054.00;41
5222;48;628503164;5222;257;5965;6006;7.45;0.46;229.95;5.08;743;48;2055.00;41
5225;48;628503173;5225;257;5965;6006;7.57;0.46;229.96;5.08;740;48;2056.00;41
5228;48;628503189;5228;253;5965;6006;7.64;0.47;229.93;5.08;737;48;2057.00;41
5231;48;628503198;5231;252;5969;6010;7.69;0.47;229.96;5.08;738;48;2058.00;41
5235;48;628503208;5235;243;5969;6010;7.75;0.47;229.89;5.08;734;48;2059.00;41
5237;48;628503217;5237;239;5972;6014;7.87;0.48;229.93;5.08;735;48;2060.00;42
5240;48;628503227;5240;239;5973;6015;7.91;0.48;229.94;5.08;733;48;2061.00;42
5240;48;628503237;5240;238;5974;6015;8.01;0.49;229.94;5.08;734;48;2062.00;41
5245;48;628503247;5245;235;5974;6015;7.97;0.48;229.94;5.08;729;48;2063.00;41
5249;48;628503257;5249;234;5986;6028;8.05;0.49;229.97;5.07;737;48;2064.00;42
5251;48;628503268;5251;236;5986;6028;8.02;0.49;230.03;5.07;735;48;2065.00;42
5254;48;628503283;5254;229;5987;6028;8.09;0.49;229.98;5.07;733;48;2066.00;41
5258;48;628503292;5258;230;5988;6029;8.12;0.49;229.92;5.07;730;48;2067.00;41
5261;48;628503302;5261;227;5989;6030;8.18;0.50;229.88;5.07;728;48;2068.00;41
5266;48;628503312;5266;228;5989;6030;8.17;0.50;229.86;5.07;723;48;2069.00;41
5269;48;628503323;5269;227;5992;6036;8.23;0.50;229.84;5.06;723;48;2070.00;44
5273;48;628503334;5273;226;5992;6036;8.25;0.50;229.96;5.06;719;48;2071.00;44
5276;48;628503344;5276;224;5993;6036;8.31;0.50;230.02;5.06;717;48;2072.00;43
5281;48;628503359;5281;225;5993;6036;8.30;0.50;230.03;5.06;712;48;2073.00;43
5283;48;628503369;5283;225;5998;6042;8.35;0.51;230.06;5.06;715;48;2074.00;44
5290;48;628503379;5290;223;5998;6042;8.29;0.50;230.06;5.06;708;48;2075.00;44
5295;48;628503390;5295;219;5999;6042;8.28;0.50;230.10;5.06;704;48;2076.00;43
5298;48;628503400;5298;219;5999;6042;8.29;0.50;230.05;5.06;701;48;2077.00;43
5302;48;628503411;5302;224;6004;6046;8.32;0.51;230.14;5.06;702;48;2078.00;42
5308;48;628503420;5308;221;6005;6047;8.36;0.51;230.16;5.06;697;48;2079.00;42
5310;48;628503430;5310;220;6006;6047;8.43;0.51;230.18;5.06;696;48;2080.00;41
5317;48;628503440;5317;221;6007;6048;8.40;0.51;230.28;5.06;690;48;2081.00;41
5320;48;628503450;5320;218;6007;6048;8.37;0.51;230.32;5.06;687;48;2082.00;41
5323;48;628503459;5323;221;6007;6048;8.41;0.51;230.38;5.06;684;48;2083.00;41
5326;48;628503470;5326;225;6007;6048;8.45;0.51;230.41;5.06;681;48;2084.00;41
5327;48;628503479;5327;225;6007;6048;8.47;0.52;230.41;5.06;680;48;2085.00;41
5329;48;628503489;5329;228;6007;6048;8.51;0.52;230.43;5.06;678;48;2086.00;41
5332;48;628503498;5332;222;6007;6048;8.57;0.52;230.48;5.06;675;48;2087.00;41
5335;48;628503509;5335;225;6050;6118;8.62;0.53;230.51;5.02;715;48;2088.00;68
5337;48;628503524;5337;214;6051;6119;8.71;0.53;230.50;5.02;714;48;2089.00;68
5342;48;628503535;5342;204;6057;6119;8.92;0.54;230.60;5.02;715;48;2090.00;62
5346;48;628503545;5346;203;6058;6119;9.12;0.55;230.71;5.02;712;48;2091.00;61
5346;48;628503560;5346;198;6062;6119;9.35;0.57;230.71;5.02;716;48;2092.00;57
5348;48;628503575;5348;194;6067;6119;9.51;0.58;230.76;5.02;719;48;2093.00;52
5350;48;628503596;5350;191;6071;6119;9.64;0.58;230.83;5.02;721;48;2094.00;48
5350;48;628503615;5350;187;6073;6119;9.79;0.59;230.83;5.02;723;48;2095.00;46
5353;48;628503629;5353;167;6075;6120;9.89;0.60;230.89;5.02;722;48;2096.00;45
5355;48;628503643;5355;162;6076;6121;10.01;0.61;230.94;5.02;721;48;2097.00;45
5357;48;628503662;5357;150;6077;6121;10.08;0.61;231.01;5.02;720;48;2098.00;44
5360;48;628503680;5360;144;6080;6125;10.11;0.61;231.01;5.02;720;48;2099.00;45
5362;48;628503696;5362;145;6084;6140;10.16;0.62;231.06;5.01;722;48;2100.00;56
5365;48;628503715;5365;143;6084;6140;10.26;0.62;231.07;5.01;719;48;2101.00;56
5367;48;628503727;5367;140;6084;6140;10.43;0.63;231.13;5.01;717;48;2102.00;56
5368;48;628503739;5368;136;6087;6146;10.56;0.64;231.15;5.01;719;48;2103.00;59
5370;48;628503751;5370;128;6087;6146;10.69;0.65;231.23;5.01;717;48;2104.00;59
5371;48;628503769;5371;129;6088;6146;10.80;0.66;231.20;5.01;717;48;2105.00;58
5374;48;628503781;5374;130;6091;6149;10.97;0.67;231.28;5.01;717;48;2106.00;58
5378;48;628503793;5378;127;6091;6149;11.11;0.68;231.40;5.01;713;48;2107.00;58
5378;48;628503805;5378;125;6091;6149;11.27;0.69;231.40;5.01;713;48;2108.00;58
5383;48;628503816;5383;121;6091;6150;11.33;0.69;231.45;5.01;708;48;2109.00;59
5387;48;628503828;5387;122;6092;6151;11.44;0.70;231.40;5.01;705;48;2110.00;59
5390;48;628503840;5390;123;6093;6151;11.52;0.70;231.39;5.01;703;48;2111.00;58
5393;48;628503857;5393;122;6103;6164;11.50;0.70;231.58;5.00;710;48;2112.00;61
5397;48;628503879;5397;121;6103;6164;11.47;0.70;231.56;5.00;706;48;2113.00;61
5400;48;628503900;5400;121;6103;6164;11.54;0.70;231.76;5.00;703;48;2114.00;61
5403;48;628503919;5403;121;6105;6166;11.56;0.70;231.79;5.00;702;48;2115.00;61
5404;49;628503943;5404;128;6106;6166;11.65;0.71;231.82;5.00;702;49;2116.00;60
5410;49;628503988;5410;128;6108;6170;11.66;0.71;231.86;5.00;698;49;2117.00;62
5411;49;628504022;5411;132;6109;6170;11.68;0.71;231.89;5.00;698;49;2118.00;61
5412;49;628504044;5412;137;6112;6174;11.63;0.71;231.88;5.00;700;49;2119.00;62
5415;49;628504061;5415;135;6112;6174;11.63;0.71;231.94;5.00;697;49;2120.00;62
5418;49;628504077;5418;138;6112;6174;11.64;0.71;231.98;5.00;694;49;2121.00;62
5420;49;628504092;5420;137;6113;6174;11.64;0.71;231.99;5.00;693;49;2122.00;61
5423;49;628504107;5423;138;6113;6174;11.57;0.71;232.02;5.00;690;49;2123.00;61
5425;49;628504118;5425;139;6123;6186;11.53;0.70;232.06;5.00;698;49;2124.00;63
5428;49;628504130;5428;138;6123;6186;11.55;0.70;232.09;5.00;695;49;2125.00;63
5430;49;628504141;5430;142;6123;6186;11.58;0.71;232.09;5.00;693;49;2126.00;63
5434;49;628504152;5434;138;6127;6186;11.54;0.70;232.18;5.01;693;49;2127.00;59
5437;49;628504163;5437;139;6128;6186;11.56;0.70;232.22;5.01;691;49;2128.00;58
5440;49;628504174;5440;136;6129;6186;11.61;0.71;232.25;5.01;689;49;2129.00;57
5444;49;628504187;5444;136;6130;6187;11.64;0.71;232.18;5.02;686;49;2130.00;57
5448;49;628504197;5448;137;6130;6187;11.65;0.71;232.23;5.02;682;49;2131.00;57
5453;49;628504208;5453;141;6134;6193;11.63;0.70;232.22;5.02;681;49;2132.00;59
5456;49;628504219;5456;138;6136;6194;11.60;0.70;232.26;5.02;680;49;2133.00;58
5460;49;628504229;5460;140;6136;6194;11.53;0.70;232.23;5.02;676;49;2134.00;58
5462;49;628504240;5462;141;6137;6194;11.48;0.70;232.19;5.02;675;49;2135.00;57
5467;49;628504251;5467;140;6141;6198;11.50;0.70;232.27;5.02;674;49;2136.00;57
5470;49;628504261;5470;142;6142;6198;11.53;0.70;232.32;5.02;672;49;2137.00;56
5474;49;628504272;5474;140;6142;6198;11.62;0.71;232.33;5.02;668;49;2138.00;56
5477;49;628504282;5477;140;6143;6199;11.72;0.71;232.38;5.02;666;49;2139.00;56
5482;49;628504292;5482;138;6146;6203;11.69;0.71;232.38;5.01;664;49;2140.00;57
5482;49;628504302;5482;142;6146;6203;11.81;0.72;232.38;5.01;664;49;2141.00;57
5486;49;628504311;5486;138;6148;6206;11.89;0.72;232.40;5.01;662;49;2142.00;58
5488;49;628504321;5488;135;6148;6206;11.87;0.72;232.41;5.01;660;49;2143.00;58
5492;49;628504331;5492;132;6149;6206;11.90;0.72;232.43;5.01;657;49;2144.00;57
5496;49;628504348;5496;134;6151;6206;11.89;0.72;232.42;5.03;655;49;2145.00;55
5498;49;628504365;5498;124;6154;6210;12.03;0.73;232.44;5.03;656;49;2146.00;56
5500;49;628504375;5500;121;6154;6210;12.04;0.73;232.46;5.03;654;49;2147.00;56
5508;49;628504385;5508;119;6156;6210;12.03;0.73;232.42;5.14;648;49;2148.00;54
5513;49;628504396;5513;117;6156;6210;12.07;0.73;232.42;5.14;643;49;2149.00;54
5516;49;628504406;5516;114;6156;6211;12.10;0.73;232.37;5.14;640;49;2150.00;55
5518;49;628504415;5518;114;6157;6212;12.16;0.74;232.39;5.14;639;49;2151.00;55
5523;49;628504424;5523;117;6157;6212;12.15;0.74;232.42;5.14;634;49;2152.00;55
5525;49;628504434;5525;120;6158;6213;12.12;0.74;232.45;5.14;633;49;2153.00;55
5527;49;628504444;5527;125;6158;6213;12.08;0.74;232.42;5.14;631;49;2154.00;55
5529;49;628504453;5529;123;6158;6213;12.06;0.73;232.41;5.14;629;49;2155.00;55
5531;49;628504462;5531;126;6158;6213;12.01;0.73;232.44;5.14;627;49;2156.00;55
5532;49;628504472;5532;132;6158;6213;11.95;0.73;232.48;5.14;626;49;2157.00;55
5534;49;628504481;5534;135;6158;6213;11.99;0.73;232.50;5.14;624;49;2158.00;55
5538;49;628504491;5538;140;6158;6213;11.95;0.73;232.48;5.14;620;49;2159.00;55
5540;49;628504502;5540;171;6255;6443;11.57;0.72;232.53;5.06;715;49;2160.00;188
5542;49;628504531;5542;170;6256;6444;11.42;0.71;232.58;5.06;714;49;2161.00;188
5542;49;628504542;5542;165;6266;6444;11.44;0.71;232.58;5.05;724;49;2162.00;178
5545;49;628504552;5545;165;6272;6444;11.30;0.70;232.59;5.05;727;49;2163.00;172
5548;49;628504563;5548;166;6281;6444;11.20;0.70;232.65;5.05;733;49;2164.00;163
5549;49;628504580;5549;162;6288;6444;11.13;0.69;232.63;5.05;739;49;2165.00;156
5552;49;628504590;5552;168;6295;6444;11.03;0.68;232.59;5.05;743;49;2166.00;149
5554;49;628504601;5554;170;6297;6444;10.92;0.68;232.54;5.05;743;49;2167.00;147
5556;49;628504628;5556;170;6304;6445;10.86;0.67;232.47;5.06;748;49;2168.00;141
5560;49;628504644;5560;181;6305;6446;10.77;0.67;232.41;5.06;745;49;2169.00;141
5562;49;628504655;5562;184;6311;6446;10.66;0.66;232.39;5.06;749;49;2170.00;135
5564;49;628504666;5564;193;6318;6447;10.57;0.65;232.38;5.08;754;49;2171.00;129
5569;49;628504676;5569;204;6324;6447;10.38;0.64;232.35;5.09;755;49;2172.00;123
5572;49;628504688;5572;206;6328;6447;10.18;0.63;232.46;5.11;756;49;2173.00;119
5573;49;628504698;5573;215;6331;6447;10.03;0.62;232.45;5.11;758;49;2174.00;116
5573;49;628504708;5573;227;6339;6451;9.84;0.61;232.45;5.12;766;49;2175.00;112
5576;49;628504718;5576;236;6342;6451;9.63;0.59;232.41;5.13;766;49;2176.00;109
5577;49;628504729;5577;241;6346;6451;9.34;0.58;232.42;5.16;769;49;2177.00;105
5581;49;628504739;5581;249;6350;6454;9.15;0.56;232.41;5.17;769;49;2178.00;104
5581;49;628504750;5581;253;6354;6454;9.00;0.55;232.41;5.19;773;49;2179.00;100
5583;49;628504759;5583;261;6357;6454;8.90;0.55;232.40;5.19;774;49;2180.00;97
5583;49;628504770;5583;263;6362;6458;8.79;0.54;232.40;5.20;779;49;2181.00;96
5584;49;628504781;5584;274;6365;6459;8.66;0.53;232.36;5.21;781;49;2182.00;94
5587;49;628504791;5587;281;6368;6459;8.52;0.52;232.28;5.21;781;49;2183.00;91
5593;49;628504807;5593;292;6371;6463;8.46;0.52;232.24;5.22;778;49;2184.00;92
5596;49;628504819;5596;300;6376;6463;8.35;0.51;232.23;5.24;780;49;2185.00;87
5596;49;628504828;5596;303;6378;6463;8.32;0.51;232.23;5.25;782;49;2186.00;85
5597;49;628504838;5597;311;6381;6464;8.30;0.51;232.22;5.25;784;49;2187.00;83
5597;49;628504849;5597;313;6385;6464;8.17;0.50;232.22;5.27;788;49;2188.00;79
5601;49;628504859;5601;319;6389;6470;8.02;0.49;232.16;5.27;788;49;2189.00;81
5602;49;628504872;5602;321;6393;6470;7.84;0.48;232.12;5.29;791;49;2190.00;77
5604;49;628504882;5604;327;6394;6471;7.75;0.47;232.06;5.29;790;49;2191.00;77
5606;49;628504892;5606;329;6397;6471;7.61;0.46;232.05;5.30;791;49;2192.00;74
5606;49;628504901;5606;339;6399;6471;7.48;0.46;232.05;5.31;793;49;2193.00;72
5608;49;628504910;5608;339;6399;6471;7.37;0.45;231.98;5.31;791;49;2194.00;72
5611;49;628504919;5611;334;6401;6471;7.28;0.44;231.98;5.31;790;49;2195.00;70
5611;49;628504929;5611;326;6411;6483;7.30;0.44;231.98;5.31;800;49;2196.00;72
5613;49;628504945;5613;327;6412;6483;7.30;0.44;231.99;5.32;799;49;2197.00;71
5613;49;628504954;5613;321;6414;6483;7.32;0.45;231.99;5.32;801;49;2198.00;69
5614;49;628504964;5614;329;6415;6483;7.33;0.45;231.95;5.32;801;49;2199.00;68
5615;49;628504974;5615;324;6417;6483;7.30;0.45;231.95;5.33;802;49;2200.00;66
5617;49;628504994;5617;321;6420;6483;7.31;0.45;231.94;5.34;803;49;2201.00;63
5622;49;628505005;5622;318;6424;6487;7.26;0.44;231.89;5.34;802;49;2202.00;63
5622;50;628505019;5622;313;6425;6487;7.34;0.45;231.89;5.34;803;50;2203.00;62
5627;50;628505046;5627;311;6429;6491;7.38;0.45;231.88;5.34;802;50;2204.00;62
5628;50;628505057;5628;307;6432;6493;7.35;0.45;231.85;5.34;804;50;2205.00;61
5632;50;628505066;5632;301;6433;6493;7.31;0.45;231.81;5.34;801;50;2206.00;60
5633;50;628505075;5633;302;6435;6493;7.28;0.45;231.85;5.34;802;50;2207.00;58
5635;50;628505084;5635;300;6444;6506;7.22;0.44;231.86;5.34;809;50;2208.00;62
5638;50;628505094;5638;295;6446;6506;7.08;0.43;231.89;5.34;808;50;2209.00;60
5638;50;628505104;5638;288;6449;6508;7.01;0.43;231.89;5.34;811;50;2210.00;59
5640;50;628505113;5640;279;6451;6509;6.92;0.43;231.97;5.33;811;50;2211.00;58
5643;50;628505123;5643;274;6451;6510;6.94;0.43;231.96;5.33;808;50;2212.00;59
5644;50;628505133;5644;272;6452;6510;7.02;0.43;231.97;5.33;808;50;2213.00;58
5646;50;628505142;5646;274;6454;6513;7.11;0.44;231.98;5.33;808;50;2214.00;59
5648;50;628505152;5648;267;6454;6513;7.12;0.44;232.01;5.33;806;50;2215.00;59
5649;50;628505162;5649;265;6455;6513;7.19;0.44;232.00;5.33;806;50;2216.00;58
5653;50;628505171;5653;253;6455;6513;7.28;0.45;231.98;5.33;802;50;2217.00;58
5656;50;628505181;5656;243;6460;6519;7.41;0.46;232.05;5.33;804;50;2218.00;59
5659;50;628505192;5659;239;6460;6519;7.48;0.46;232.02;5.33;801;50;2219.00;59
5664;50;628505203;5664;236;6462;6519;7.53;0.47;232.05;5.45;798;50;2220.00;57
5666;50;628505214;5666;228;6462;6519;7.66;0.47;232.08;5.45;796;50;2221.00;57
5669;50;628505223;5669;218;6467;6523;7.77;0.48;232.10;5.45;798;50;2222.00;56
5673;50;628505233;5673;214;6468;6524;7.88;0.49;232.16;5.45;795;50;2223.00;56
5675;50;628505243;5675;213;6468;6524;8.04;0.50;232.14;5.45;793;50;2224.00;56
5686;50;628505253;5686;210;6469;6525;8.07;0.50;232.18;5.44;783;50;2225.00;56
5694;50;628505264;5694;213;6469;6525;8.07;0.50;232.16;5.44;775;50;2226.00;56
5697;50;628505274;5697;211;6469;6525;8.07;0.49;232.17;5.44;772;50;2227.00;56
5702;50;628505284;5702;212;6469;6525;8.07;0.49;232.22;5.44;767;50;2228.00;56
5707;50;628505294;5707;209;6469;6525;8.13;0.50;232.20;5.44;762;50;2229.00;56
5714;50;628505304;5714;204;6469;6525;8.15;0.50;232.20;5.44;755;50;2230.00;56
5718;50;628505314;5718;200;6469;6525;8.21;0.50;232.17;5.44;751;50;2231.00;56
5724;50;628505324;5724;201;6510;6595;8.30;0.51;232.27;5.41;786;50;2232.00;85
5729;50;628505339;5729;195;6512;6596;8.37;0.51;232.23;5.41;783;50;2233.00;84
5733;50;628505350;5733;196;6521;6596;8.51;0.52;232.21;5.40;788;50;2234.00;75
5738;50;628505361;5738;189;6524;6596;8.57;0.53;232.27;5.40;786;50;2235.00;72
5741;50;628505371;5741;179;6529;6596;8.70;0.53;232.29;5.40;788;50;2236.00;67
5746;50;628505382;5746;187;6533;6596;8.83;0.54;232.31;5.40;787;50;2237.00;63
5754;50;628505393;5754;193;6534;6596;8.89;0.54;232.39;5.40;780;50;2238.00;62
5757;50;628505404;5757;193;6535;6596;9.00;0.55;232.43;5.40;778;50;2239.00;61
5763;50;628505415;5763;191;6537;6597;9.04;0.55;232.52;5.40;774;50;2240.00;60
5768;50;628505425;5768;195;6538;6598;9.11;0.56;232.63;5.40;770;50;2241.00;60
5773;50;628505436;5773;199;6539;6598;9.15;0.56;232.68;5.40;766;50;2242.00;59
5777;50;628505447;5777;205;6542;6602;9.27;0.56;232.67;5.40;765;50;2243.00;60
5780;50;628505459;5780;209;6542;6602;9.31;0.57;232.69;5.40;762;50;2244.00;60
5784;50;628505471;5784;211;6542;6602;9.36;0.57;232.74;5.40;758;50;2245.00;60
5787;50;628505482;5787;214;6542;6602;9.41;0.57;232.80;5.40;755;50;2246.00;60
5791;50;628505493;5791;211;6546;6608;9.42;0.57;232.85;5.40;755;50;2247.00;62
5796;50;628505504;5796;213;6547;6608;9.36;0.57;232.84;5.52;751;50;2248.00;61
5799;50;628505515;5799;213;6548;6608;9.42;0.57;232.80;5.52;749;50;2249.00;60
5806;50;628505528;5806;209;6551;6614;9.46;0.58;232.74;5.52;745;50;2250.00;63
5809;50;628505540;5809;206;6552;6614;9.54;0.58;232.79;5.52;743;50;2251.00;62
5812;50;628505550;5812;204;6552;6614;9.52;0.58;232.84;5.52;740;50;2252.00;62
5816;50;628505561;5816;200;6553;6615;9.47;0.58;232.96;5.52;737;50;2253.00;62
5820;50;628505571;5820;202;6554;6616;9.43;0.57;233.00;5.51;734;50;2254.00;62
5823;50;628505582;5823;204;6555;6616;9.48;0.58;233.01;5.51;732;50;2255.00;61
5826;50;628505593;5826;210;6565;6629;9.55;0.58;233.05;5.51;739;50;2256.00;64
5829;50;628505606;5829;199;6566;6629;9.60;0.58;233.03;5.51;737;50;2257.00;63
5832;50;628505617;5832;194;6566;6629;9.62;0.59;233.09;5.51;734;50;2258.00;63
5834;50;628505628;5834;189;6567;6630;9.69;0.59;233.10;5.50;733;50;2259.00;63
5837;50;628505639;5837;186;6567;6630;9.71;0.59;233.21;5.50;730;50;2260.00;63
5845;50;628505650;5845;189;6570;6634;9.78;0.60;233.25;5.50;725;50;2261.00;64
5847;50;628505661;5847;187;6570;6634;9.83;0.60;233.26;5.50;723;50;2262.00;64
5852;50;628505672;5852;190;6574;6638;9.87;0.60;233.38;5.50;722;50;2263.00;64
5856;50;628505689;5856;194;6574;6638;9.87;0.60;233.40;5.50;718;50;2264.00;64
5860;50;628505700;5860;192;6574;6638;9.81;0.60;233.49;5.50;714;50;2265.00;64
5866;50;628505722;5866;185;6574;6638;9.82;0.60;233.53;5.50;708;50;2266.00;64
5867;50;628505733;5867;169;6574;6638;9.91;0.60;233.53;5.50;707;50;2267.00;64
5872;50;628505744;5872;164;6584;6650;10.01;0.61;233.63;5.49;712;50;2268.00;66
5875;50;628505756;5875;157;6584;6650;10.15;0.62;233.68;5.49;709;50;2269.00;66
5876;50;628505768;5876;153;6585;6650;10.24;0.62;233.68;5.49;709;50;2270.00;65
5880;50;628505779;5880;149;6585;6650;10.39;0.63;233.71;5.49;705;50;2271.00;65
5882;50;628505791;5882;146;6585;6650;10.50;0.64;233.76;5.49;703;50;2272.00;65
5886;50;628505802;5886;139;6585;6650;10.58;0.64;233.76;5.49;699;50;2273.00;65
5890;50;628505814;5890;138;6585;6651;10.69;0.65;233.92;5.49;695;50;2274.00;66
5894;50;628505825;5894;131;6585;6651;10.82;0.66;233.94;5.49;691;50;2275.00;66
5895;50;628505837;5895;121;6589;6657;10.95;0.67;233.96;5.49;694;50;2276.00;68
5896;50;628505853;5896;122;6590;6658;11.06;0.67;234.00;5.49;694;50;2277.00;68
5900;50;628505871;5900;122;6591;6658;11.16;0.68;234.00;5.49;691;50;2278.00;67
5903;50;628505887;5903;121;6591;6658;11.32;0.69;233.96;5.49;688;50;2279.00;67
5905;50;628505907;5905;117;6595;6663;11.44;0.69;233.99;5.48;690;50;2280.00;68
5907;50;628505925;5907;122;6595;6663;11.47;0.70;233.99;5.48;688;50;2281.00;68
5911;50;628505942;5911;121;6595;6663;11.55;0.70;233.92;5.48;684;50;2282.00;68
5915;50;628505956;5915;121;6596;6664;11.63;0.70;233.92;5.48;681;50;2283.00;68
5916;50;628505970;5916;119;6599;6668;11.64;0.71;233.92;5.48;683;50;2284.00;69
5919;50;628505982;5919;119;6599;6668;11.70;0.71;233.96;5.48;680;50;2285.00;69
5923;50;628505994;5923;119;6601;6671;11.77;0.71;233.96;5.48;678;50;2286.00;70
5928;50;628506008;5928;115;6601;6671;11.76;0.71;233.97;5.48;673;50;2287.00;70
5929;50;628506020;5929;117;6602;6671;11.72;0.71;234.00;5.48;673;50;2288.00;69
5930;50;628506032;5930;120;6602;6671;11.75;0.71;234.01;5.48;672;50;2289.00;69
5932;50;628506044;5932;119;6606;6675;11.77;0.71;233.98;5.61;674;50;2290.00;69
5933;50;628506056;5933;118;6606;6675;11.77;0.71;234.02;5.61;673;50;2291.00;69
5935;50;628506073;5935;123;6607;6675;11.80;0.72;234.04;5.60;672;50;2292.00;68
5939;50;628506084;5939;123;6607;6675;11.78;0.72;234.02;5.60;668;50;2293.00;68
5941;50;628506095;5941;127;6607;6676;11.82;0.72;234.00;5.60;666;50;2294.00;69
5945;50;628506111;5945;127;6609;6678;11.87;0.72;234.01;5.60;664;50;2295.00;69
5946;50;628506122;5946;130;6609;6678;11.89;0.72;234.02;5.60;663;50;2296.00;69
5950;50;628506133;5950;125;6610;6679;11.85;0.72;234.12;5.60;660;50;2297.00;69
5952;50;628506144;5952;131;6610;6679;11.77;0.72;234.17;5.60;658;50;2298.00;69
5956;50;628506154;5956;130;6610;6679;11.77;0.72;234.16;5.60;654;50;2299.00;69
5959;50;628506165;5959;131;6610;6679;11.76;0.72;234.17;5.60;651;50;2300.00;69
5961;51;628506179;5961;132;6610;6679;11.80;0.72;234.14;5.60;649;51;2301.00;69
5963;51;628506197;5963;134;6610;6679;11.75;0.71;234.16;5.60;647;51;2302.00;69
5968;51;628506211;5968;133;6610;6679;11.68;0.71;234.11;5.60;642;51;2303.00;69
5970;51;628506221;5970;160;6682;6806;11.24;0.69;234.07;5.54;712;51;2304.00;124
5972;51;628506241;5972;151;6682;6807;11.26;0.69;234.17;5.54;710;51;2305.00;125
5974;51;628506252;5974;139;6691;6807;11.33;0.70;234.15;5.67;717;51;2306.00;116
5977;51;628506262;5977;140;6692;6807;11.33;0.70;234.21;5.67;715;51;2307.00;115
5978;51;628506272;5978;138;6699;6807;11.39;0.70;234.19;5.66;721;51;2308.00;108
5981;51;628506282;5981;134;6702;6807;11.42;0.70;234.20;5.66;721;51;2309.00;105
5984;51;628506294;5984;134;6707;6807;11.47;0.70;234.18;5.66;723;51;2310.00;100
5990;51;628506304;5990;135;6709;6807;11.45;0.70;234.13;5.66;719;51;2311.00;98
5993;51;628506314;5993;132;6712;6808;11.52;0.71;234.09;5.67;719;51;2312.00;96
5994;51;628506324;5994;131;6717;6809;11.50;0.71;234.12;5.67;723;51;2313.00;92
5996;51;628506334;5996;140;6720;6809;11.46;0.70;234.12;5.67;724;51;2314.00;89
6002;51;628506345;6002;137;6724;6810;11.35;0.70;234.10;5.80;722;51;2315.00;86
6004;51;628506362;6004;139;6726;6810;11.31;0.69;234.07;5.81;722;51;2316.00;84
6007;51;628506374;6007;138;6727;6810;11.16;0.69;234.04;5.81;720;51;2317.00;83
6011;51;628506384;6011;139;6729;6810;11.06;0.68;233.98;5.82;718;51;2318.00;81
6015;51;628506395;6015;140;6731;6814;10.92;0.67;233.93;5.82;716;51;2319.00;83
6016;51;628506406;6016;142;6733;6814;10.91;0.67;233.99;5.82;717;51;2320.00;81
6016;51;628506416;6016;145;6733;6814;10.81;0.66;233.99;5.82;717;51;2321.00;81
6020;51;628506426;6020;145;6737;6817;10.70;0.65;233.88;5.95;717;51;2322.00;80
6022;51;628506436;6022;147;6737;6817;10.62;0.65;233.87;5.95;715;51;2323.00;80
6023;51;628506452;6023;152;6738;6817;10.58;0.65;233.88;5.95;715;51;2324.00;79
6023;51;628506462;6023;162;6742;6821;10.54;0.64;233.88;5.95;719;51;2325.00;79
6026;51;628506473;6026;167;6743;6822;10.54;0.64;233.84;5.95;717;51;2326.00;79
6029;51;628506483;6029;167;6745;6822;10.57;0.65;233.84;5.95;716;51;2327.00;77
6034;51;628506493;6034;172;6747;6826;10.54;0.64;233.79;5.95;713;51;2328.00;79
6038;51;628506503;6038;175;6747;6826;10.42;0.63;233.82;5.95;709;51;2329.00;79
6041;51;628506513;6041;183;6747;6826;10.26;0.62;233.75;5.95;706;51;2330.00;79
6043;51;628506523;6043;183;6749;6827;10.10;0.61;233.71;5.94;706;51;2331.00;78
6046;51;628506532;6046;192;6749;6827;9.90;0.60;233.64;5.94;703;51;2332.00;78
6048;51;628506542;6048;196;6753;6833;9.82;0.60;233.61;5.94;705;51;2333.00;80
6048;51;628506552;6048;207;6753;6833;9.76;0.59;233.61;5.94;705;51;2334.00;80
6050;51;628506561;6050;216;6754;6834;9.67;0.59;233.56;5.94;704;51;2335.00;80
6052;51;628506571;6052;218;6754;6834;9.63;0.58;233.54;5.94;702;51;2336.00;80
6052;51;628506580;6052;224;6755;6834;9.57;0.58;233.54;5.95;703;51;2337.00;79
6053;51;628506590;6053;227;6755;6834;9.55;0.58;233.50;5.95;702;51;2338.00;79
6056;51;628506600;6056;231;6755;6834;9.47;0.57;233.47;5.95;699;51;2339.00;79
6058;51;628506612;6058;244;6777;6870;9.42;0.57;233.43;5.95;719;51;2340.00;93
6059;51;628506625;6059;249;6779;6870;9.34;0.57;233.44;5.96;720;51;2341.00;91
6062;51;628506634;6062;257;6782;6870;9.30;0.57;233.46;5.96;720;51;2342.00;88
6062;51;628506644;6062;258;6785;6870;9.25;0.56;233.46;5.97;723;51;2343.00;85
6062;51;628506654;6062;260;6786;6870;9.19;0.56;233.46;5.97;724;51;2344.00;84
6064;51;628506663;6064;265;6789;6870;9.04;0.55;233.42;5.99;725;51;2345.00;81
6064;51;628506679;6064;271;6793;6874;8.95;0.55;233.42;5.98;729;51;2346.00;81
6065;51;628506689;6065;266;6795;6874;8.86;0.54;233.41;6.00;730;51;2347.00;79
6067;51;628506699;6067;260;6799;6878;8.86;0.54;233.40;6.01;732;51;2348.00;79
6067;51;628506716;6067;249;6803;6879;8.89;0.54;233.40;6.02;736;51;2349.00;76
6068;51;628506726;6068;244;6804;6879;8.87;0.54;233.50;6.02;736;51;2350.00;75
6069;51;628506735;6069;239;6806;6879;8.83;0.54;233.50;6.03;737;51;2351.00;73
6072;51;628506745;6072;238;6817;6892;8.75;0.53;233.55;6.02;745;51;2352.00;75
6073;51;628506762;6073;235;6819;6892;8.77;0.54;233.53;6.04;746;51;2353.00;73
6075;51;628506772;6075;235;6819;6892;8.77;0.54;233.51;6.04;744;51;2354.00;73
6077;52;628506782;6077;238;6822;6893;8.72;0.53;233.50;6.05;745;52;2355.00;71
6080;52;628506805;6080;240;6823;6894;8.73;0.53;233.47;6.06;743;52;2356.00;71
6080;52;628506815;6080;243;6823;6894;8.76;0.54;233.47;6.06;743;52;2357.00;71
6082;52;628506831;6082;246;6827;6897;8.72;0.53;233.42;6.06;745;52;2358.00;70
6083;52;628506841;6083;248;6827;6897;8.64;0.53;233.43;6.06;744;52;2359.00;70
6084;52;628506853;6084;251;6830;6897;8.63;0.53;233.41;6.09;746;52;2360.00;67
6085;52;628506862;6085;247;6830;6897;8.54;0.52;233.39;6.09;745;52;2361.00;67
6087;52;628506872;6087;246;6835;6903;8.52;0.52;233.37;6.08;748;52;2362.00;68
6088;52;628506882;6088;245;6836;6903;8.38;0.51;233.36;6.09;748;52;2363.00;67
6090;52;628506893;6090;247;6837;6903;8.31;0.51;233.33;6.09;747;52;2364.00;66
6092;52;628506902;6092;244;6838;6903;8.25;0.50;233.29;6.10;746;52;2365.00;65
6092;52;628506911;6092;251;6841;6907;8.24;0.50;233.29;6.10;749;52;2366.00;66
6093;52;628506920;6093;251;6845;6908;8.24;0.50;233.29;6.12;752;52;2367.00;63
6095;52;628506935;6095;254;6845;6908;8.21;0.50;233.26;6.12;750;52;2368.00;63
6097;52;628506944;6097;251;6846;6909;8.25;0.50;233.22;6.11;749;52;2369.00;63
6100;52;628506955;6100;249;6847;6909;8.25;0.50;233.18;6.12;747;52;2370.00;62
6103;52;628506971;6103;246;6847;6909;8.23;0.50;233.19;6.12;744;52;2371.00;62
6106;52;628506980;6106;245;6850;6909;8.14;0.50;233.16;6.13;744;52;2372.00;59
6108;52;628506989;6108;252;6850;6909;8.11;0.50;233.18;6.13;742;52;2373.00;59
6113;52;628506999;6113;249;6850;6909;8.09;0.50;233.18;6.13;737;52;2374.00;59
6118;52;628507007;6118;247;6851;6909;8.11;0.50;233.29;6.13;733;52;2375.00;58
6124;52;628507016;6124;252;6890;6979;8.19;0.50;233.32;6.10;766;52;2376.00;89
6127;52;628507031;6127;247;6893;6980;8.14;0.50;233.35;6.10;766;52;2377.00;87
6131;52;628507040;6131;251;6901;6980;8.11;0.50;233.38;6.10;770;52;2378.00;79
6136;52;628507048;6136;254;6904;6980;8.09;0.50;233.34;6.09;768;52;2379.00;76
6143;52;628507057;6143;252;6910;6980;8.03;0.49;233.41;6.09;767;52;2380.00;70
6148;52;628507067;6148;246;6916;6980;7.91;0.49;233.42;6.09;768;52;2381.00;64
6152;52;628507077;6152;244;6919;6980;7.86;0.48;233.46;6.09;767;52;2382.00;61
6156;52;628507086;6156;243;6922;6980;7.87;0.48;233.51;6.09;766;52;2383.00;58
6161;52;628507102;6161;241;6924;6981;7.88;0.48;233.48;6.09;763;52;2384.00;57
6162;52;628507112;6162;247;6926;6983;7.98;0.49;233.51;6.09;764;52;2385.00;57
6167;52;628507123;6167;244;6926;6983;8.01;0.49;233.53;6.09;759;52;2386.00;57
6170;52;628507132;6170;243;6930;6987;8.06;0.50;233.55;6.09;760;52;2387.00;57
6171;52;628507143;6171;232;6930;6987;8.24;0.51;233.58;6.09;759;52;2388.00;57
6176;52;628507154;6176;231;6930;6987;8.32;0.51;233.59;6.09;754;52;2389.00;57
6179;52;628507164;6179;226;6930;6987;8.46;0.52;233.59;6.09;751;52;2390.00;57
6181;52;628507179;6181;227;6934;6993;8.57;0.53;233.58;6.09;753;52;2391.00;59
6185;52;628507190;6185;227;6935;6993;8.63;0.53;233.58;6.08;750;52;2392.00;58
6194;52;628507200;6194;228;6935;6993;8.61;0.53;233.60;6.08;741;52;2393.00;58
6196;52;628507217;6196;224;6937;6996;8.72;0.53;233.64;6.08;741;52;2394.00;59
6200;52;628507227;6200;217;6937;6996;8.73;0.53;233.70;6.08;737;52;2395.00;59
6206;52;628507237;6206;213;6938;6996;8.76;0.53;233.67;6.08;732;52;2396.00;58
6209;52;628507247;6209;211;6939;6997;8.83;0.54;233.62;6.08;730;52;2397.00;58
6216;52;628507257;6216;212;6940;6998;8.86;0.54;233.57;6.08;724;52;2398.00;58
6220;52;628507268;6220;211;6940;6998;8.90;0.54;233.74;6.08;720;52;2399.00;58
6225;52;628507281;6225;217;6964;7057;8.92;0.54;233.67;6.06;739;52;2400.00;93
6228;52;628507301;6228;206;6965;7057;9.00;0.55;233.72;6.06;737;52;2401.00;92
6232;52;628507312;6232;208;6968;7057;9.05;0.55;233.79;6.06;736;52;2402.00;89
6237;52;628507322;6237;198;6969;7058;9.20;0.56;233.90;6.06;732;52;2403.00;89
6241;52;628507333;6241;199;6971;7058;9.23;0.56;233.92;6.06;730;52;2404.00;87
6247;53;628507343;6247;191;6973;7062;9.29;0.57;234.02;6.05;726;53;2405.00;89
6249;53;628507371;6249;193;6975;7062;9.37;0.57;234.00;6.05;726;53;2406.00;87
6253;53;628507381;6253;187;6979;7066;9.43;0.58;234.03;6.05;726;53;2407.00;87
6257;53;628507392;6257;187;6980;7066;9.44;0.58;234.07;6.05;723;53;2408.00;86
6260;53;628507402;6260;190;6980;7066;9.48;0.58;234.18;6.05;720;53;2409.00;86
6266;53;628507413;6266;191;6981;7066;9.50;0.58;234.35;6.05;715;53;2410.00;85
6268;53;628507424;6268;196;6981;7066;9.61;0.59;234.39;6.05;713;53;2411.00;85
6276;53;628507434;6276;198;6990;7078;9.62;0.59;234.44;6.05;714;53;2412.00;88
6281;53;628507447;6281;200;6991;7078;9.63;0.59;234.46;6.05;710;53;2413.00;87
6283;53;628507457;6283;203;6992;7078;9.68;0.59;234.48;6.05;709;53;2414.00;86
6288;53;628507468;6288;208;6993;7078;9.64;0.59;234.52;6.05;705;53;2415.00;85
6296;53;628507479;6296;210;6993;7078;9.60;0.59;234.52;6.05;697;53;2416.00;85
6299;53;628507489;6299;216;6993;7078;9.64;0.59;234.52;6.05;694;53;2417.00;85
6300;53;628507499;6300;216;6994;7079;9.59;0.59;234.50;6.05;694;53;2418.00;85
6306;53;628507510;6306;220;6994;7079;9.64;0.59;234.55;6.05;688;53;2419.00;85
6311;53;628507520;6311;227;6999;7085;9.61;0.58;234.53;6.05;688;53;2420.00;86
6315;53;628507531;6315;227;7001;7086;9.59;0.58;234.52;6.05;686;53;2421.00;85
6320;53;628507542;6320;228;7001;7086;9.54;0.58;234.57;6.05;681;53;2422.00;85
6323;53;628507553;6323;232;7001;7086;9.50;0.58;234.59;6.05;678;53;2423.00;85
6325;53;628507563;6325;237;7004;7090;9.44;0.57;234.64;6.05;679;53;2424.00;86
6328;53;628507573;6328;238;7004;7090;9.45;0.57;234.67;6.05;676;53;2425.00;86
6331;53;628507583;6331;239;7004;7090;9.40;0.57;234.66;6.05;673;53;2426.00;86
6334;53;628507593;6334;230;7008;7091;9.35;0.57;234.70;6.06;674;53;2427.00;83
6337;53;628507603;6337;221;7011;7095;9.27;0.56;234.71;6.06;674;53;2428.00;84
6339;53;628507614;6339;215;7012;7095;9.17;0.56;234.74;6.06;673;53;2429.00;83
6342;53;628507625;6342;214;7016;7101;9.20;0.56;234.79;6.06;674;53;2430.00;85
6345;53;628507635;6345;216;7016;7101;9.13;0.55;234.77;6.06;671;53;2431.00;85
6347;53;628507651;6347;215;7018;7101;9.10;0.55;234.76;6.06;671;53;2432.00;83
6352;53;628507662;6352;218;7018;7101;9.11;0.55;234.90;6.06;666;53;2433.00;83
6355;53;628507671;6355;219;7021;7105;9.16;0.56;234.92;6.06;666;53;2434.00;84
6357;53;628507682;6357;225;7021;7105;9.15;0.56;234.91;6.06;664;53;2435.00;84
6360;53;628507692;6360;213;7021;7105;9.24;0.56;234.94;6.06;661;53;2436.00;84
6362;53;628507707;6362;199;7022;7105;9.29;0.56;234.98;6.06;660;53;2437.00;83
6364;53;628507717;6364;189;7024;7106;9.37;0.57;234.95;6.07;660;53;2438.00;82
6368;53;628507727;6368;181;7026;7107;9.45;0.57;235.06;6.07;658;53;2439.00;81
6372;53;628507737;6372;174;7027;7107;9.46;0.57;235.09;6.07;655;53;2440.00;80
6374;53;628507747;6374;168;7028;7108;9.56;0.58;235.10;6.07;654;53;2441.00;80
6376;53;628507757;6376;157;7028;7108;9.64;0.59;235.24;6.07;652;53;2442.00;80
6378;53;628507767;6378;159;7029;7108;9.72;0.59;235.24;6.07;651;53;2443.00;79
6381;53;628507777;6381;157;7029;7108;9.75;0.59;235.23;6.07;648;53;2444.00;79
6385;53;628507787;6385;156;7029;7108;9.84;0.60;235.24;6.07;644;53;2445.00;79
6386;53;628507797;6386;151;7029;7108;9.97;0.61;235.27;6.07;643;53;2446.00;79
6388;53;628507807;6388;150;7029;7108;10.10;0.61;235.31;6.07;641;53;2447.00;79
6390;53;628507821;6390;163;7089;7235;10.22;0.63;235.27;6.02;699;53;2448.00;146
6391;53;628507841;6391;159;7094;7236;10.31;0.63;235.33;6.02;703;53;2449.00;142
6394;53;628507855;6394;151;7101;7236;10.45;0.64;235.36;6.02;707;53;2450.00;135
6398;53;628507870;6398;148;7103;7236;10.40;0.64;235.37;6.02;705;53;2451.00;133
6400;53;628507896;6400;149;7109;7236;10.47;0.64;235.36;6.02;709;53;2452.00;127
6402;53;628507918;6402;146;7112;7236;10.61;0.65;235.33;6.02;710;53;2453.00;124
6404;53;628507932;6404;148;7117;7236;10.61;0.65;235.43;6.02;713;53;2454.00;119
6407;53;628507949;6407;157;7121;7236;10.56;0.65;235.43;6.02;714;53;2455.00;115
6408;53;628507972;6408;154;7124;7237;10.55;0.65;235.41;6.02;716;53;2456.00;113
6410;53;628507983;6410;158;7127;7238;10.57;0.65;235.43;6.03;717;53;2457.00;111
6412;53;628508003;6412;162;7130;7238;10.44;0.64;235.45;6.03;718;53;2458.00;108
6416;53;628508013;6416;166;7132;7239;10.40;0.64;235.41;6.03;716;53;2459.00;107
6417;53;628508027;6417;168;7134;7239;10.41;0.64;235.51;6.03;717;53;2460.00;105
6418;53;628508038;6418;175;7137;7239;10.38;0.64;235.48;6.04;719;53;2461.00;102
6418;53;628508048;6418;177;7140;7239;10.31;0.63;235.48;6.04;722;53;2462.00;99
6420;53;628508058;6420;181;7143;7243;10.33;0.63;235.49;6.04;723;53;2463.00;100
6422;53;628508069;6422;187;7145;7243;10.41;0.64;235.51;6.05;723;53;2464.00;98
6426;53;628508079;6426;194;7149;7243;10.35;0.63;235.50;6.05;723;53;2465.00;94
6428;53;628508090;6428;191;7151;7246;10.44;0.64;235.45;6.05;723;53;2466.00;95
6430;53;628508103;6430;193;7155;7246;10.39;0.63;235.42;6.07;725;53;2467.00;91
6432;53;628508113;6432;195;7157;7246;10.34;0.63;235.42;6.21;725;53;2468.00;89
6433;53;628508123;6433;199;7161;7250;10.32;0.63;235.40;6.21;728;53;2469.00;89
6434;53;628508133;6434;197;7164;7251;10.28;0.63;235.39;6.21;730;53;2470.00;87
6435;53;628508143;6435;200;7164;7251;10.29;0.63;235.37;6.21;729;53;2471.00;87
6436;53;628508152;6436;198;7167;7255;10.23;0.62;235.35;6.34;731;53;2472.00;88
6437;53;628508163;6437;204;7167;7255;10.27;0.63;235.32;6.34;730;53;2473.00;88
6441;53;628508172;6441;210;7167;7255;10.17;0.62;235.29;6.34;726;53;2474.00;88
6445;53;628508182;6445;208;7170;7257;10.11;0.62;235.34;6.47;725;53;2475.00;87
6449;53;628508192;6449;208;7170;7257;10.11;0.62;235.34;6.47;721;53;2476.00;87
6450;53;628508201;6450;209;7174;7263;10.16;0.62;235.32;6.46;724;53;2477.00;89
6453;53;628508211;6453;216;7176;7263;10.08;0.61;235.25;6.59;723;53;2478.00;87
6455;53;628508221;6455;210;7176;7264;10.05;0.61;235.27;6.59;721;53;2479.00;88
6455;53;628508230;6455;205;7176;7264;10.03;0.61;235.27;6.59;721;53;2480.00;88
6456;53;628508240;6456;203;7176;7264;9.98;0.61;235.25;6.59;720;53;2481.00;88
6458;53;628508249;6458;197;7176;7264;10.00;0.61;235.33;6.59;718;53;2482.00;88
6462;53;628508257;6462;191;7176;7264;10.06;0.62;235.31;6.59;714;53;2483.00;88
6464;53;628508266;6464;189;7186;7276;10.15;0.62;235.31;6.58;722;53;2484.00;90
6467;53;628508276;6467;187;7189;7276;10.17;0.62;235.30;6.60;722;53;2485.00;87
6471;53;628508287;6471;186;7189;7276;10.27;0.63;235.24;6.60;718;53;2486.00;87
6473;53;628508296;6473;186;7190;7276;10.37;0.63;235.22;6.72;717;53;2487.00;86
6476;53;628508305;6476;184;7190;7276;10.40;0.63;235.18;6.72;714;53;2488.00;86
6480;53;628508316;6480;188;7190;7276;10.43;0.64;235.15;6.72;710;53;2489.00;86
6482;53;628508328;6482;188;7193;7280;10.44;0.64;235.09;6.72;711;53;2490.00;87
6483;53;628508338;6483;189;7193;7280;10.42;0.64;235.08;6.72;710;53;2491.00;87
6486;53;628508347;6486;191;7196;7284;10.48;0.64;235.02;6.71;710;53;2492.00;88
6489;53;628508357;6489;199;7198;7285;10.48;0.64;235.03;6.71;709;53;2493.00;87
6489;53;628508367;6489;199;7198;7285;10.45;0.64;235.03;6.71;709;53;2494.00;87
6490;53;628508377;6490;198;7198;7285;10.46;0.64;235.10;6.71;708;53;2495.00;87
6492;53;628508387;6492;201;7207;7298;10.35;0.63;235.06;6.72;715;53;2496.00;91
6493;54;628508399;6493;205;7207;7298;10.37;0.63;235.05;6.72;714;54;2497.00;91
6499;54;628508427;6499;207;7208;7298;10.26;0.62;235.03;6.72;709;54;2498.00;90
6499;54;628508437;6499;200;7209;7299;10.24;0.62;235.03;6.72;710;54;2499.00;90
6502;54;628508456;6502;193;7209;7300;10.21;0.62;235.11;6.72;707;54;2500.00;91
6504;54;628508471;6504;188;7209;7300;10.17;0.62;235.10;6.72;705;54;2501.00;91
6505;54;628508482;6505;186;7212;7303;10.20;0.62;235.08;6.73;707;54;2502.00;91
6509;54;628508492;6509;181;7212;7303;10.14;0.62;235.05;6.73;703;54;2503.00;91
6509;54;628508503;6509;176;7213;7303;10.17;0.62;235.05;6.73;704;54;2504.00;90
6509;54;628508512;6509;176;7213;7303;10.19;0.62;235.05;6.73;704;54;2505.00;90
6512;54;628508528;6512;172;7217;7309;10.25;0.62;235.13;6.72;705;54;2506.00;92
6514;55;628508540;6514;171;7218;7309;10.24;0.62;235.11;6.72;704;55;2507.00;91
6517;55;628508563;6517;164;7220;7309;10.21;0.62;235.14;6.74;703;55;2508.00;89
6520;55;628508575;6520;163;7220;7309;10.18;0.62;235.13;6.74;700;55;2509.00;89
6521;55;628508585;6521;166;7226;7313;10.14;0.61;235.15;6.78;705;55;2510.00;87
6524;55;628508597;6524;169;7228;7314;10.07;0.61;235.14;6.78;704;55;2511.00;86
6524;55;628508608;6524;170;7228;7314;10.07;0.61;235.14;6.78;704;55;2512.00;86
6525;55;628508618;6525;172;7230;7315;10.09;0.61;235.15;6.79;705;55;2513.00;85
6526;55;628508628;6526;177;7232;7315;10.10;0.61;235.12;6.80;706;55;2514.00;83
6526;55;628508639;6526;180;7232;7315;10.11;0.61;235.12;6.80;706;55;2515.00;83
6527;55;628508649;6527;182;7235;7315;10.06;0.61;235.11;6.83;708;55;2516.00;80
6529;55;628508660;6529;185;7236;7315;10.03;0.61;235.11;6.84;707;55;2517.00;79
6530;55;628508669;6530;184;7238;7315;10.01;0.61;235.10;6.87;708;55;2518.00;77
6530;55;628508679;6530;186;7239;7315;9.96;0.60;235.10;6.88;709;55;2519.00;76
6530;55;628508696;6530;199;7294;7440;10.05;0.62;235.10;6.84;764;55;2520.00;146
6532;55;628508714;6532;197;7298;7441;9.98;0.61;235.10;6.85;766;55;2521.00;143
6534;55;628508725;6534;197;7310;7441;9.95;0.61;235.14;6.85;776;55;2522.00;131
6536;55;628508735;6536;201;7319;7441;9.86;0.61;235.20;6.85;783;55;2523.00;122
6538;55;628508750;6538;207;7326;7441;9.71;0.60;235.32;6.85;788;55;2524.00;115
6540;55;628508766;6540;214;7331;7441;9.58;0.59;235.29;6.86;791;55;2525.00;110
6544;55;628508776;6544;215;7338;7441;9.46;0.58;235.40;6.87;794;55;2526.00;103
6545;55;628508787;6545;224;7341;7441;9.29;0.57;235.43;6.87;796;55;2527.00;100
6549;55;628508797;6549;227;7344;7442;9.14;0.56;235.38;6.87;795;55;2528.00;98
6552;55;628508808;6552;224;7346;7443;9.05;0.56;235.49;6.88;794;55;2529.00;97
6554;55;628508820;6554;228;7350;7443;8.88;0.55;235.51;6.89;796;55;2530.00;93
6557;55;628508835;6557;225;7355;7447;8.73;0.54;235.51;6.90;798;55;2531.00;92
6561;55;628508849;6561;224;7359;7447;8.61;0.53;235.42;6.90;798;55;2532.00;88
6564;55;628508860;6564;225;7360;7447;8.60;0.53;235.47;6.91;796;55;2533.00;87
6567;55;628508871;6567;224;7363;7447;8.58;0.53;235.44;6.91;796;55;2534.00;84
6571;55;628508890;6571;227;7367;7453;8.58;0.53;235.47;6.92;796;55;2535.00;86
6574;55;628508902;6574;233;7368;7453;8.54;0.52;235.44;6.92;794;55;2536.00;85
6576;55;628508919;6576;232;7371;7455;8.52;0.52;235.43;6.92;795;55;2537.00;84
6581;55;628508930;6581;231;7374;7458;8.56;0.52;235.45;6.92;793;55;2538.00;84
6581;55;628508941;6581;232;7375;7458;8.59;0.53;235.45;6.92;794;55;2539.00;83
6586;55;628508952;6586;238;7376;7458;8.61;0.53;235.43;6.93;790;55;2540.00;82
6591;55;628508963;6591;244;7378;7459;8.60;0.52;235.40;6.94;787;55;2541.00;81
6594;55;628508974;6594;248;7379;7460;8.65;0.53;235.36;6.94;785;55;2542.00;81
6596;55;628508984;6596;259;7381;7460;8.63;0.53;235.37;6.94;785;55;2543.00;79
6600;55;628508995;6600;259;7390;7473;8.59;0.52;235.42;6.94;790;55;2544.00;83
6602;55;628509006;6602;256;7392;7473;8.60;0.52;235.47;6.94;790;55;2545.00;81
6608;55;628509016;6608;256;7394;7473;8.53;0.52;235.46;6.94;786;55;2546.00;79
6611;55;628509026;6611;255;7395;7474;8.43;0.51;235.47;6.94;784;55;2547.00;79
6615;55;628509037;6615;259;7397;7474;8.32;0.51;235.42;6.94;782;55;2548.00;77
6620;55;628509046;6620;263;7400;7478;8.21;0.50;235.48;6.94;780;55;2549.00;78
6623;55;628509058;6623;257;7403;7481;8.13;0.50;235.48;6.94;780;55;2550.00;78
6625;55;628509069;6625;255;7408;7485;7.99;0.49;235.47;6.94;783;55;2551.00;77
6631;55;628509078;6631;251;7410;7485;7.92;0.48;235.53;6.95;779;55;2552.00;75
6634;55;628509089;6634;253;7412;7485;7.88;0.48;235.51;6.95;778;55;2553.00;73
6638;55;628509099;6638;250;7412;7485;7.90;0.48;235.49;6.95;774;55;2554.00;73
6641;55;628509108;6641;253;7413;7485;7.88;0.48;235.51;6.96;772;55;2555.00;72
6645;55;628509118;6645;255;7424;7497;7.96;0.49;235.53;6.95;779;55;2556.00;73
6649;55;628509130;6649;247;7424;7497;7.97;0.49;235.55;6.95;775;55;2557.00;73
6651;55;628509140;6651;239;7424;7497;8.02;0.49;235.60;6.95;773;55;2558.00;73
6655;55;628509150;6655;236;7424;7497;8.09;0.50;235.71;6.95;769;55;2559.00;73
6657;55;628509161;6657;237;7424;7497;8.11;0.50;235.78;6.95;767;55;2560.00;73
6660;55;628509171;6660;236;7424;7497;8.14;0.50;235.81;6.95;764;55;2561.00;73
6664;55;628509181;6664;230;7425;7498;8.21;0.50;235.86;7.07;761;55;2562.00;73
6666;55;628509192;6666;222;7425;7498;8.35;0.51;235.89;7.07;759;55;2563.00;73
6670;55;628509202;6670;217;7429;7504;8.46;0.52;235.98;7.07;759;55;2564.00;75
6676;55;628509213;6676;218;7431;7506;8.52;0.52;235.99;7.07;755;55;2565.00;75
6680;55;628509223;6680;222;7432;7506;8.63;0.53;235.98;7.07;752;55;2566.00;74
6682;55;628509233;6682;214;7432;7506;8.76;0.54;236.04;7.07;750;55;2567.00;74
6686;55;628509243;6686;210;7435;7510;8.89;0.55;236.04;7.06;749;55;2568.00;75
6692;55;628509254;6692;209;7435;7510;8.93;0.55;236.03;7.06;743;55;2569.00;75
6698;55;628509264;6698;204;7435;7510;8.97;0.55;236.19;7.06;737;55;2570.00;75
6702;55;628509274;6702;195;7436;7511;9.01;0.56;236.23;7.06;734;55;2571.00;75
6706;55;628509284;6706;191;7439;7515;9.09;0.56;236.25;7.06;733;55;2572.00;76
6712;55;628509295;6712;191;7439;7515;9.21;0.57;236.38;7.06;727;55;2573.00;76
6718;55;628509306;6718;185;7441;7518;9.30;0.57;236.39;7.06;723;55;2574.00;77
6722;55;628509317;6722;187;7441;7518;9.33;0.57;236.46;7.06;719;55;2575.00;77
6730;55;628509327;6730;182;7442;7518;9.44;0.58;236.59;7.06;712;55;2576.00;76
6732;55;628509337;6732;190;7443;7518;9.42;0.58;236.58;7.18;711;55;2577.00;75
6739;55;628509348;6739;187;7446;7522;9.49;0.58;236.73;7.18;707;55;2578.00;76
6745;55;628509359;6745;187;7446;7522;9.53;0.59;236.72;7.18;701;55;2579.00;76
6750;55;628509372;6750;188;7447;7522;9.58;0.59;236.73;7.18;697;55;2580.00;75
6753;55;628509382;6753;190;7447;7522;9.50;0.58;236.72;7.18;694;55;2581.00;75
6758;55;628509393;6758;198;7447;7523;9.48;0.58;236.76;7.18;689;55;2582.00;76
6761;55;628509403;6761;198;7448;7524;9.47;0.58;236.78;7.18;687;55;2583.00;76
6766;55;628509413;6766;206;7448;7524;9.42;0.58;236.74;7.18;682;55;2584.00;76
6771;55;628509423;6771;206;7449;7525;9.44;0.58;236.77;7.17;678;55;2585.00;76
6774;55;628509433;6774;206;7449;7525;9.47;0.58;236.81;7.17;675;55;2586.00;76
6780;55;628509443;6780;205;7449;7525;9.41;0.58;236.79;7.17;669;55;2587.00;76
6783;55;628509453;6783;210;7449;7525;9.41;0.58;236.85;7.17;666;55;2588.00;76
6786;55;628509463;6786;217;7449;7525;9.33;0.57;236.93;7.17;663;55;2589.00;76
6789;55;628509473;6789;222;7449;7525;9.22;0.57;236.96;7.17;660;55;2590.00;76
6792;55;628509482;6792;224;7449;7525;9.08;0.56;237.02;7.17;657;55;2591.00;76
6797;55;628509492;6797;242;7515;7652;9.10;0.57;237.04;7.11;718;55;2592.00;137
6802;55;628509512;6802;235;7518;7653;8.89;0.55;237.03;7.11;716;55;2593.00;135
6809;55;628509522;6809;236;7525;7653;8.86;0.55;236.90;7.11;716;55;2594.00;128
6812;55;628509532;6812;243;7528;7653;8.86;0.55;236.94;7.10;716;55;2595.00;125
6817;55;628509541;6817;248;7533;7653;8.87;0.55;237.03;7.10;716;55;2596.00;120
6820;55;628509551;6820;233;7536;7653;8.92;0.55;236.99;7.10;716;55;2597.00;117
6823;55;628509562;6823;231;7541;7653;8.95;0.55;237.03;7.10;718;55;2598.00;112
6827;55;628509572;6827;227;7546;7653;8.92;0.55;237.14;7.10;719;55;2599.00;107
6827;55;628509583;6827;233;7551;7654;8.91;0.55;237.14;7.10;724;56;2600.00;103
6830;55;628509611;6830;234;7556;7655;8.86;0.55;237.22;7.10;726;56;2601.00;99
6837;55;628509622;6837;241;7560;7655;8.83;0.54;237.17;7.22;723;56;2602.00;95
6841;55;628509633;6841;238;7560;7656;8.74;0.54;237.19;7.22;719;56;2603.00;96
6844;55;628509644;6844;240;7563;7656;8.68;0.53;237.17;7.22;719;56;2604.00;93
6846;55;628509660;6846;239;7564;7656;8.66;0.53;237.18;7.23;718;56;2605.00;92
6847;55;628509670;6847;229;7566;7656;8.69;0.53;237.23;7.23;719;56;2606.00;90
6849;55;628509680;6849;226;7569;7660;8.72;0.53;237.30;7.23;720;56;2607.00;91
6851;55;628509692;6851;213;7571;7660;8.83;0.54;237.29;7.23;720;56;2608.00;89
6852;55;628509702;6852;204;7572;7660;8.89;0.54;237.28;7.23;720;56;2609.00;88
6854;55;628509715;6854;198;7575;7666;9.00;0.55;237.25;7.23;721;56;2610.00;91
6857;55;628509732;6857;196;7576;7666;9.09;0.55;237.25;7.23;719;56;2611.00;90
6859;55;628509743;6859;192;7577;7666;9.24;0.56;237.21;7.23;718;56;2612.00;89
6862;55;628509753;6862;193;7581;7670;9.35;0.57;237.30;7.22;719;56;2613.00;89
6864;55;628509764;6864;184;7582;7671;9.41;0.57;237.26;7.22;718;56;2614.00;89
6865;55;628509775;6865;177;7583;7671;9.44;0.57;237.27;7.22;718;56;2615.00;88
6866;55;628509791;6866;174;7586;7675;9.49;0.58;237.28;7.22;720;56;2616.00;89
6868;55;628509802;6868;174;7587;7675;9.57;0.58;237.24;7.22;719;56;2617.00;88
6872;55;628509812;6872;169;7588;7675;9.62;0.58;237.45;7.34;716;56;2618.00;87
6873;55;628509823;6873;166;7589;7676;9.65;0.59;237.46;7.34;716;56;2619.00;87
6874;55;628509832;6874;169;7589;7676;9.64;0.59;237.45;7.34;715;56;2620.00;87
6875;55;628509843;6875;164;7593;7682;9.65;0.59;237.45;7.34;718;56;2621.00;89
6876;55;628509858;6876;173;7593;7682;9.76;0.60;237.48;7.34;717;56;2622.00;89
6878;55;628509873;6878;177;7594;7683;9.84;0.60;237.48;7.34;716;56;2623.00;89
6881;55;628509888;6881;184;7594;7683;9.93;0.60;237.43;7.34;713;56;2624.00;89
6882;55;628509905;6882;186;7594;7683;9.95;0.61;237.41;7.34;712;56;2625.00;89
6884;55;628509921;6884;184;7594;7683;9.96;0.61;237.39;7.34;710;56;2626.00;89
6888;55;628509937;6888;188;7594;7683;10.00;0.61;237.31;7.34;706;56;2627.00;89
6891;55;628509959;6891;190;7603;7695;9.99;0.61;237.37;7.33;712;56;2628.00;92
6894;55;628509971;6894;187;7604;7695;10.07;0.61;237.32;7.33;710;56;2629.00;91
6896;55;628509982;6896;189;7605;7695;10.22;0.62;237.28;7.33;709;56;2630.00;90
6898;55;628509993;6898;193;7605;7695;10.29;0.63;237.23;7.33;707;56;2631.00;90
6900;55;628510009;6900;194;7605;7695;10.33;0.63;237.23;7.33;705;56;2632.00;90
6902;55;628510020;6902;192;7605;7695;10.39;0.63;237.21;7.33;703;56;2633.00;90
6904;55;628510030;6904;193;7608;7699;10.44;0.64;237.19;7.32;704;56;2634.00;91
6904;55;628510041;6904;196;7608;7699;10.49;0.64;237.19;7.32;704;56;2635.00;91
6908;55;628510052;6908;195;7611;7703;10.55;0.64;237.17;7.32;703;56;2636.00;92
6911;55;628510062;6911;192;7612;7704;10.55;0.64;237.11;7.32;701;56;2637.00;92
6913;55;628510072;6913;193;7614;7704;10.66;0.65;237.07;7.44;701;56;2638.00;90
6914;55;628510083;6914;200;7614;7704;10.65;0.65;237.04;7.44;700;56;2639.00;90
6916;55;628510095;6916;209;7634;7733;10.53;0.64;237.02;7.42;718;56;2640.00;99
6917;55;628510106;6917;206;7635;7733;10.49;0.64;237.01;7.42;718;56;2641.00;98
6921;55;628510116;6921;206;7638;7733;10.43;0.64;237.05;7.42;717;56;2642.00;95
6924;55;628510126;6924;208;7640;7734;10.48;0.64;237.01;7.41;716;56;2643.00;94
6927;55;628510135;6927;213;7640;7735;10.44;0.64;237.00;7.41;713;56;2644.00;95
6929;55;628510145;6929;213;7640;7735;10.48;0.64;236.99;7.41;711;56;2645.00;95
6932;55;628510155;6932;213;7643;7738;10.42;0.63;236.97;7.41;711;56;2646.00;95
6933;55;628510165;6933;214;7643;7738;10.37;0.63;236.96;7.41;710;56;2647.00;95
6934;55;628510174;6934;219;7643;7738;10.27;0.62;236.99;7.41;709;56;2648.00;95
6937;55;628510183;6937;221;7643;7738;10.22;0.62;236.99;7.41;706;56;2649.00;95
6939;55;628510193;6939;222;7647;7744;10.15;0.62;236.96;7.41;708;56;2650.00;97
6940;55;628510202;6940;205;7648;7744;10.18;0.62;236.96;7.41;708;56;2651.00;96
6943;55;628510211;6943;187;7648;7744;10.19;0.62;237.05;7.41;705;56;2652.00;96
6943;55;628510222;6943;179;7648;7744;10.27;0.63;237.05;7.41;705;56;2653.00;96
6944;55;628510230;6944;165;7652;7748;10.34;0.63;237.05;7.42;708;56;2654.00;96
6946;55;628510241;6946;153;7655;7750;10.46;0.64;237.03;7.43;709;56;2655.00;95
6947;55;628510251;6947;140;7655;7750;10.59;0.64;237.03;7.43;708;56;2656.00;95
6950;55;628510261;6950;138;7656;7751;10.61;0.64;237.00;7.43;706;56;2657.00;95
6952;55;628510277;6952;128;7656;7751;10.63;0.65;236.99;7.43;704;56;2658.00;95
6955;55;628510288;6955;135;7656;7751;10.65;0.65;236.94;7.43;701;56;2659.00;95
6959;55;628510304;6959;131;7656;7751;10.65;0.65;236.88;7.43;697;56;2660.00;95
6960;55;628510314;6960;131;7656;7751;10.78;0.66;236.86;7.43;696;56;2661.00;95
6963;55;628510324;6963;121;7656;7751;10.82;0.66;236.81;7.43;693;56;2662.00;95
6966;55;628510339;6966;121;7656;7751;10.87;0.66;236.77;7.43;690;56;2663.00;95
6969;55;628510354;6969;125;7691;7821;11.00;0.67;236.83;7.40;722;56;2664.00;130
6972;55;628510370;6972;117;7693;7822;11.09;0.67;236.75;7.39;721;56;2665.00;129
6973;55;628510381;6973;118;7699;7822;11.22;0.68;236.75;7.39;726;56;2666.00;123
6976;55;628510393;6976;118;7707;7822;11.25;0.68;236.71;7.39;731;56;2667.00;115
6977;55;628510403;6977;116;7712;7822;11.29;0.69;236.71;7.38;735;56;2668.00;110
6977;55;628510414;6977;121;7716;7822;11.34;0.69;236.71;7.38;739;56;2669.00;106
6978;55;628510426;6978;122;7720;7822;11.35;0.69;236.71;7.38;742;56;2670.00;102
6979;55;628510437;6979;123;7720;7822;11.38;0.69;236.72;7.38;741;56;2671.00;102
6980;55;628510448;6980;123;7722;7823;11.42;0.69;236.69;7.38;742;56;2672.00;101
6986;55;628510459;6986;124;7723;7824;11.44;0.69;236.74;7.38;737;56;2673.00;101
6988;55;628510471;6988;126;7724;7824;11.46;0.70;236.78;7.38;736;56;2674.00;100
6992;55;628510482;6992;131;7727;7828;11.36;0.69;236.83;7.38;735;56;2675.00;101
6992;55;628510494;6992;133;7728;7828;11.26;0.68;236.83;7.39;736;56;2676.00;100
6994;55;628510505;6994;131;7728;7828;11.22;0.68;236.79;7.39;734;56;2677.00;100
6999;55;628510516;6999;135;7728;7828;11.25;0.68;236.86;7.39;729;56;2678.00;100
7001;55;628510527;7001;137;7732;7834;11.26;0.68;236.84;7.39;731;56;2679.00;102
7003;55;628510538;7003;153;7735;7834;11.25;0.68;236.83;7.41;732;56;2680.00;99
7007;55;628510549;7007;154;7735;7834;11.22;0.68;236.81;7.41;728;56;2681.00;99
7007;55;628510559;7007;163;7737;7837;11.27;0.69;236.81;7.41;730;56;2682.00;100
7010;55;628510570;7010;169;7738;7837;11.13;0.68;236.77;7.43;728;56;2683.00;99
7013;55;628510581;7013;181;7740;7837;11.01;0.67;236.82;7.44;727;56;2684.00;97
7017;55;628510592;7017;185;7741;7838;10.97;0.67;236.84;7.45;724;56;2685.00;97
7019;55;628510603;7019;185;7743;7839;10.93;0.66;236.83;7.46;724;56;2686.00;96
7021;55;628510614;7021;188;7744;7839;10.82;0.66;236.83;7.48;723;56;2687.00;95
7024;55;628510623;7024;197;7756;7852;10.66;0.65;236.79;7.47;732;56;2688.00;96
7028;55;628510636;7028;199;7757;7852;10.59;0.64;236.79;7.49;729;56;2689.00;95
7031;55;628510647;7031;203;7758;7852;10.52;0.64;236.83;7.49;727;56;2690.00;94
7033;55;628510658;7033;208;7760;7853;10.40;0.63;236.83;7.51;727;56;2691.00;93
7034;55;628510669;7034;217;7761;7853;10.24;0.62;236.81;7.51;727;56;2692.00;92
7037;55;628510679;7037;221;7765;7857;10.22;0.62;236.80;7.52;728;56;2693.00;92
7038;55;628510690;7038;229;7766;7857;10.12;0.62;236.78;7.52;728;56;2694.00;91
7042;55;628510700;7042;232;7771;7861;9.95;0.61;236.76;7.53;729;56;2695.00;90
7044;55;628510710;7044;232;7772;7861;9.80;0.60;236.81;7.53;728;56;2696.00;89
7046;55;628510721;7046;238;7773;7861;9.64;0.59;236.80;7.55;727;56;2697.00;88
7049;55;628510730;7049;245;7774;7861;9.44;0.58;236.78;7.55;725;56;2698.00;87
7052;55;628510740;7052;242;7775;7861;9.27;0.57;236.79;7.56;723;56;2699.00;86
7055;55;628510751;7055;242;7798;7910;9.10;0.56;236.83;7.54;743;56;2700.00;112
7058;55;628510769;7058;241;7799;7910;8.96;0.55;236.84;7.54;741;56;2701.00;111
7064;55;628510779;7064;239;7803;7910;8.86;0.54;236.81;7.55;739;56;2702.00;107
7068;55;628510789;7068;231;7805;7910;8.79;0.54;236.80;7.55;737;56;2703.00;105
7070;55;628510798;7070;231;7807;7910;8.70;0.53;236.78;7.55;737;56;2704.00;103
7074;55;628510808;7074;229;7809;7910;8.62;0.53;236.77;7.56;735;56;2705.00;101
7077;55;628510818;7077;228;7810;7911;8.56;0.52;236.75;7.56;733;56;2706.00;101
7078;55;628510828;7078;227;7811;7911;8.50;0.52;236.74;7.56;733;56;2707.00;100
7080;55;628510844;7080;236;7820;7917;8.46;0.52;236.75;7.59;740;56;2708.00;97
7081;55;628510857;7081;240;7821;7918;8.50;0.52;236.75;7.58;740;56;2709.00;97
7085;55;628510867;7085;244;7822;7918;8.43;0.51;236.69;7.59;737;56;2710.00;96
7087;55;628510878;7087;251;7823;7918;8.38;0.51;236.69;7.59;736;56;2711.00;95
7092;55;628510894;7092;254;7826;7922;8.41;0.51;236.83;7.59;734;56;2712.00;96
7096;55;628510904;7096;263;7827;7922;8.34;0.51;236.87;7.60;731;56;2713.00;95
7102;55;628510913;7102;263;7829;7922;8.18;0.50;236.93;7.60;727;56;2714.00;93
7107;55;628510922;7107;253;7833;7923;8.08;0.49;237.00;7.63;726;56;2715.00;90
7115;55;628510932;7115;257;7837;7927;7.97;0.49;237.06;7.63;722;56;2716.00;90
7117;55;628510942;7117;256;7837;7927;7.92;0.48;237.04;7.63;720;56;2717.00;90
7125;55;628510951;7125;260;7840;7930;7.84;0.48;237.16;7.63;715;56;2718.00;90
7127;55;628510960;7127;262;7843;7930;7.73;0.47;237.21;7.64;716;56;2719.00;87
7130;55;628510969;7130;256;7843;7930;7.70;0.47;237.21;7.64;713;56;2720.00;87
7136;55;628510978;7136;256;7844;7930;7.71;0.47;237.29;7.65;708;56;2721.00;86
7139;55;628510988;7139;251;7847;7934;7.82;0.48;237.32;7.65;708;56;2722.00;87
7143;55;628510997;7143;251;7847;7934;7.82;0.48;237.35;7.65;704;56;2723.00;87
7146;55;628511006;7146;244;7849;7934;7.83;0.48;237.37;7.66;703;56;2724.00;85
7149;55;628511014;7149;240;7851;7934;7.85;0.48;237.47;7.66;702;56;2725.00;83
7152;55;628511023;7152;238;7851;7935;7.90;0.48;237.49;7.66;699;56;2726.00;84
7156;55;628511032;7156;228;7854;7936;7.91;0.48;237.56;7.66;698;56;2727.00;82
7161;55;628511041;7161;224;7854;7936;7.99;0.49;237.56;7.66;693;56;2728.00;82
7163;55;628511051;7163;217;7855;7937;8.10;0.50;237.57;7.66;692;56;2729.00;82
7165;55;628511061;7165;215;7855;7937;8.21;0.50;237.57;7.66;690;56;2730.00;82
7168;55;628511070;7168;215;7857;7937;8.27;0.51;237.59;7.67;689;56;2731.00;80
7171;55;628511078;7171;211;7857;7937;8.33;0.51;237.62;7.67;686;56;2732.00;80
7173;55;628511088;7173;212;7857;7937;8.30;0.51;237.66;7.67;684;56;2733.00;80
7178;55;628511097;7178;211;7859;7937;8.35;0.51;237.72;7.67;681;56;2734.00;78
7184;55;628511105;7184;208;7859;7937;8.41;0.52;237.73;7.67;675;56;2735.00;78
7187;55;628511114;7187;223;7929;8064;8.68;0.54;237.77;7.61;742;56;2736.00;135
7190;55;628511133;7190;218;7933;8065;8.78;0.55;237.76;7.61;743;56;2737.00;132
7196;55;628511142;7196;216;7938;8065;8.81;0.55;237.75;7.61;742;56;2738.00;127
7199;55;628511152;7199;208;7940;8065;8.90;0.55;237.79;7.61;741;56;2739.00;125
7204;55;628511163;7204;205;7945;8065;8.92;0.56;237.83;7.61;741;56;2740.00;120
7208;55;628511173;7208;210;7945;8065;8.96;0.56;237.81;7.61;737;56;2741.00;120
7214;55;628511183;7214;213;7948;8065;8.99;0.56;237.89;7.61;734;56;2742.00;117
7219;55;628511201;7219;210;7951;8065;9.01;0.56;237.88;7.61;732;56;2743.00;114
7223;55;628511211;7223;211;7956;8066;8.96;0.55;237.92;7.61;733;56;2744.00;110
7227;55;628511222;7227;212;7961;8068;8.90;0.55;237.93;7.61;734;56;2745.00;107
7232;55;628511232;7232;220;7965;8068;8.82;0.54;237.93;7.61;733;56;2746.00;103
7236;55;628511243;7236;226;7968;8069;8.71;0.54;237.90;7.61;732;56;2747.00;101
7242;55;628511254;7242;222;7970;8069;8.62;0.53;238.04;7.61;728;56;2748.00;99
7248;55;628511265;7248;226;7973;8069;8.55;0.53;238.03;7.61;725;56;2749.00;96
7252;55;628511275;7252;223;7975;8069;8.54;0.53;237.98;7.61;723;56;2750.00;94
7254;55;628511285;7254;218;7978;8073;8.61;0.53;238.02;7.61;724;56;2751.00;95
7257;55;628511295;7257;225;7981;8073;8.65;0.53;238.00;7.61;724;56;2752.00;92
7263;55;628511305;7263;228;7981;8073;8.67;0.53;238.09;7.61;718;56;2753.00;92
7265;55;628511315;7265;231;7983;8076;8.67;0.53;238.10;7.61;718;56;2754.00;93
7269;55;628511326;7269;242;7986;8076;8.61;0.53;238.10;7.61;717;56;2755.00;90
7273;55;628511336;7273;247;7988;8076;8.54;0.52;238.08;7.62;715;56;2756.00;88
7275;55;628511346;7275;252;7991;8080;8.60;0.53;238.05;7.61;716;56;2757.00;89
7277;55;628511355;7277;260;7995;8081;8.62;0.53;238.07;7.61;718;56;2758.00;86
7278;55;628511365;7278;263;7995;8081;8.56;0.53;238.10;7.61;717;56;2759.00;86
7283;55;628511377;7283;271;7999;8086;8.47;0.52;238.12;7.61;716;56;2760.00;87
7286;55;628511393;7286;270;7999;8086;8.38;0.52;238.12;7.61;713;56;2761.00;87
7288;55;628511403;7288;277;7999;8086;8.33;0.51;238.13;7.61;711;56;2762.00;87
7290;55;628511413;7290;287;8000;8087;8.28;0.51;238.12;7.61;710;56;2763.00;87
7296;55;628511423;7296;292;8000;8087;8.10;0.50;238.09;7.61;704;56;2764.00;87
7297;55;628511433;7297;297;8004;8093;7.99;0.49;238.11;7.61;707;56;2765.00;89
7298;55;628511443;7298;302;8004;8093;7.91;0.48;238.10;7.61;706;56;2766.00;89
7301;55;628511453;7301;295;8005;8094;7.88;0.48;238.13;7.61;704;56;2767.00;89
7302;55;628511463;7302;287;8005;8094;7.86;0.48;238.13;7.61;703;56;2768.00;89
7304;55;628511473;7304;285;8005;8094;7.87;0.48;238.12;7.61;701;56;2769.00;89
7304;55;628511483;7304;277;8005;8094;7.92;0.48;238.12;7.61;701;56;2770.00;89
7310;55;628511492;7310;280;8005;8094;7.95;0.48;238.27;7.61;695;56;2771.00;89
7311;55;628511502;7311;281;8015;8106;8.03;0.49;238.25;7.60;704;56;2772.00;91
7314;55;628511512;7314;275;8015;8106;8.07;0.49;238.23;7.60;701;56;2773.00;91
7315;55;628511522;7315;277;8016;8106;8.13;0.49;238.24;7.60;701;56;2774.00;90
7317;55;628511532;7317;274;8016;8106;8.16;0.50;238.21;7.60;699;56;2775.00;90
7319;55;628511542;7319;262;8016;8106;8.24;0.50;238.18;7.60;697;56;2776.00;90
7320;55;628511552;7320;247;8016;8106;8.31;0.51;238.17;7.60;696;56;2777.00;90
7324;55;628511561;7324;242;8019;8110;8.37;0.51;238.11;7.59;695;56;2778.00;91
7326;55;628511571;7326;231;8019;8110;8.40;0.51;238.07;7.59;693;56;2779.00;91
7327;55;628511587;7327;228;8022;8114;8.50;0.52;238.05;7.59;695;56;2780.00;92
7329;55;628511604;7329;219;8024;8115;8.57;0.52;238.00;7.59;695;56;2781.00;91
7330;55;628511614;7330;216;8024;8115;8.65;0.53;237.97;7.59;694;56;2782.00;91
7332;55;628511630;7332;218;8024;8115;8.75;0.53;237.94;7.59;692;56;2783.00;91
7336;55;628511640;7336;219;8035;8128;8.90;0.54;237.96;7.58;699;56;2784.00;93
7340;55;628511651;7340;217;8035;8128;8.96;0.54;237.95;7.58;695;56;2785.00;93
7340;55;628511660;7340;217;8035;8128;9.02;0.55;237.95;7.58;695;56;2786.00;93
7342;55;628511670;7342;217;8036;8129;9.06;0.55;237.91;7.58;694;56;2787.00;93
7343;55;628511680;7343;218;8036;8130;9.12;0.56;237.90;7.58;693;56;2788.00;94
7345;55;628511690;7345;219;8036;8130;9.15;0.56;237.89;7.58;691;56;2789.00;94
7348;55;628511701;7348;218;8039;8136;9.18;0.56;237.86;7.58;691;56;2790.00;97
7349;55;628511711;7349;217;8040;8136;9.24;0.56;237.85;7.57;691;56;2791.00;96
7350;55;628511720;7350;217;8040;8136;9.24;0.56;237.85;7.57;690;56;2792.00;96
7351;55;628511730;7351;215;8041;8136;9.24;0.56;237.84;7.57;690;56;2793.00;95
7352;55;628511739;7352;214;8044;8142;9.25;0.56;237.81;7.57;692;56;2794.00;98
7353;55;628511749;7353;208;8045;8142;9.28;0.56;237.80;7.57;692;56;2795.00;97
7355;55;628511758;7355;209;8045;8142;9.31;0.57;237.78;7.57;690;56;2796.00;97
7357;55;628511767;7357;211;8046;8142;9.44;0.57;237.77;7.57;689;56;2797.00;96
7361;55;628511776;7361;211;8049;8146;9.46;0.57;237.72;7.57;688;56;2798.00;97
7363;55;628511786;7363;209;8051;8147;9.56;0.58;237.68;7.57;688;56;2799.00;96
7364;55;628511801;7364;212;8051;8147;9.63;0.59;237.68;7.57;687;56;2800.00;96
7365;55;628511814;7365;214;8052;8148;9.76;0.59;237.74;7.57;687;56;2801.00;96
7366;55;628511823;7366;218;8052;8148;9.84;0.60;237.75;7.57;686;56;2802.00;96
7367;55;628511832;7367;209;8052;8148;9.91;0.60;237.73;7.57;685;56;2803.00;96
7371;55;628511841;7371;200;8052;8148;9.95;0.60;237.72;7.57;681;56;2804.00;96
7371;55;628511850;7371;194;8052;8148;10.08;0.61;237.72;7.57;681;56;2805.00;96
7372;55;628511863;7372;186;8052;8148;10.19;0.62;237.71;7.57;680;56;2806.00;96
7375;55;628511877;7375;177;8052;8148;10.26;0.62;237.71;7.57;677;56;2807.00;96
7376;55;628511894;7376;188;8095;8218;10.18;0.62;237.70;7.53;719;56;2808.00;123
7378;55;628511916;7378;175;8095;8219;10.30;0.63;237.69;7.53;717;56;2809.00;124
7378;55;628511941;7378;166;8101;8219;10.50;0.64;237.69;7.52;723;56;2810.00;118
7379;55;628511956;7379;159;8106;8219;10.72;0.65;237.67;7.52;727;56;2811.00;113
7379;55;628511971;7379;154;8111;8219;10.87;0.66;237.67;7.52;732;56;2812.00;108
7380;55;628511989;7380;150;8114;8219;11.00;0.67;237.69;7.52;734;56;2813.00;105
7382;55;628511999;7382;155;8115;8219;11.12;0.68;237.67;7.52;733;56;2814.00;104
7384;55;628512010;7384;154;8116;8219;11.23;0.68;237.65;7.52;732;56;2815.00;103
7388;55;628512021;7388;150;8118;8220;11.30;0.69;237.65;7.51;730;56;2816.00;102
7389;55;628512033;7389;156;8119;8221;11.36;0.69;237.63;7.51;730;56;2817.00;102
7393;55;628512044;7393;151;8120;8221;11.43;0.69;237.60;7.51;727;56;2818.00;101
7393;55;628512054;7393;151;8124;8225;11.40;0.69;237.60;7.65;731;56;2819.00;101
7397;55;628512069;7397;141;8124;8225;11.41;0.69;237.58;7.65;727;56;2820.00;101
7397;55;628512079;7397;137;8124;8225;11.39;0.69;237.58;7.65;727;56;2821.00;101
7399;55;628512091;7399;129;8124;8225;11.38;0.69;237.58;7.65;725;56;2822.00;101
7403;55;628512101;7403;128;8127;8231;11.33;0.69;237.58;7.64;724;56;2823.00;104
7404;55;628512112;7404;131;8128;8231;11.34;0.69;237.59;7.64;724;56;2824.00;103
7409;55;628512123;7409;128;8130;8231;11.36;0.69;237.55;7.67;721;56;2825.00;101
7413;55;628512135;7413;127;8132;8234;11.43;0.69;237.52;7.67;719;56;2826.00;102
7414;55;628512146;7414;121;8132;8234;11.50;0.70;237.53;7.67;718;56;2827.00;102
7417;55;628512157;7417;114;8133;8234;11.47;0.70;237.59;7.67;716;56;2828.00;101
7420;55;628512167;7420;114;8133;8235;11.52;0.70;237.56;7.67;713;56;2829.00;102
7423;55;628512177;7423;112;8134;8236;11.47;0.70;237.62;7.66;711;56;2830.00;102
7429;55;628512188;7429;112;8134;8236;11.43;0.70;237.68;7.66;705;56;2831.00;102
7431;55;628512201;7431;111;8144;8249;11.48;0.70;237.68;7.66;713;56;2832.00;105
7434;55;628512220;7434;106;8144;8249;11.47;0.70;237.71;7.66;710;56;2833.00;105
7437;55;628512230;7437;108;8144;8249;11.50;0.70;237.69;7.66;707;56;2834.00;105
7439;55;628512240;7439;112;8146;8251;11.58;0.70;237.70;7.65;707;56;2835.00;105
7440;55;628512252;7440;116;8147;8251;11.61;0.70;237.70;7.78;707;56;2836.00;104
7445;55;628512262;7445;118;8150;8255;11.61;0.70;237.65;7.78;705;56;2837.00;105
7445;55;628512274;7445;123;8151;8255;11.57;0.70;237.65;7.78;706;56;2838.00;104
7451;55;628512284;7451;122;8155;8259;11.47;0.69;237.65;7.77;704;56;2839.00;104
7453;55;628512295;7453;127;8157;8259;11.47;0.69;237.65;7.90;704;56;2840.00;102
7455;55;628512305;7455;129;8157;8259;11.48;0.70;237.66;7.90;702;56;2841.00;102
7457;55;628512316;7457;129;8157;8259;11.47;0.70;237.65;7.90;700;56;2842.00;102
7459;55;628512326;7459;132;8157;8259;11.44;0.69;237.65;7.90;698;56;2843.00;102
7462;55;628512343;7462;135;8168;8271;11.41;0.69;237.66;8.02;706;56;2844.00;103
7462;55;628512354;7462;141;8169;8271;11.38;0.69;237.66;8.02;707;56;2845.00;102
7463;55;628512365;7463;142;8169;8271;11.24;0.69;237.70;8.02;706;56;2846.00;102
7466;55;628512383;7466;148;8169;8271;11.17;0.68;237.71;8.02;703;56;2847.00;102
7469;55;628512394;7469;153;8169;8271;11.12;0.68;237.79;8.02;700;56;2848.00;102
7470;55;628512405;7470;163;8169;8271;11.09;0.68;237.78;8.02;699;56;2849.00;102
7476;55;628512417;7476;162;8174;8274;10.89;0.66;237.80;8.17;698;56;2850.00;100
7480;55;628512429;7480;163;8174;8274;10.85;0.66;237.83;8.17;694;56;2851.00;100
7484;55;628512440;7484;164;8179;8280;10.83;0.66;237.82;8.18;695;56;2852.00;101
7486;55;628512451;7486;169;8182;8281;10.75;0.65;237.80;8.19;696;56;2853.00;99
7490;55;628512462;7490;170;8183;8281;10.64;0.65;237.78;8.20;693;56;2854.00;98
7491;55;628512474;7491;170;8183;8281;10.53;0.64;237.75;8.20;692;56;2855.00;98
7494;55;628512484;7494;181;8187;8285;10.53;0.64;237.71;8.22;693;56;2856.00;98
7497;55;628512495;7497;180;8188;8285;10.50;0.64;237.71;8.23;691;56;2857.00;97
7500;55;628512505;7500;178;8189;8285;10.42;0.63;237.69;8.24;689;56;2858.00;96
7501;55;628512515;7501;184;8191;8286;10.38;0.63;237.68;8.25;690;56;2859.00;95
7503;55;628512525;7503;191;8195;8290;10.31;0.63;237.68;8.26;692;56;2860.00;95
7506;55;628512535;7506;196;8195;8290;10.29;0.63;237.67;8.26;689;56;2861.00;95
7510;55;628512546;7510;203;8198;8293;10.19;0.62;237.79;8.27;688;56;2862.00;95
7513;55;628512557;7513;204;8198;8293;10.09;0.61;237.78;8.27;685;56;2863.00;95
7516;55;628512567;7516;213;8203;8295;10.01;0.61;237.83;8.31;687;56;2864.00;92
7518;55;628512577;7518;219;8205;8295;9.95;0.60;237.82;8.32;687;56;2865.00;90
7518;55;628512587;7518;225;8209;8299;9.92;0.60;237.82;8.32;691;56;2866.00;90
7520;55;628512597;7520;226;8209;8299;9.85;0.60;237.82;8.32;689;56;2867.00;90
7521;55;628512607;7521;228;8212;8299;9.72;0.59;237.82;8.34;691;56;2868.00;87
7523;55;628512616;7523;228;8212;8299;9.61;0.58;237.79;8.34;689;56;2869.00;87
7525;55;628512632;7525;223;8214;8300;9.44;0.57;237.78;8.36;689;56;2870.00;86
7528;55;628512642;7528;223;8216;8301;9.28;0.56;237.81;8.37;688;56;2871.00;85
7530;55;628512651;7530;223;8218;8301;9.16;0.56;237.81;8.38;688;56;2872.00;83
7535;55;628512661;7535;216;8219;8302;9.04;0.55;237.77;8.38;684;56;2873.00;83
7536;55;628512671;7536;214;8220;8302;9.02;0.55;237.80;8.39;684;56;2874.00;82
7538;55;628512681;7538;210;8221;8302;8.90;0.54;237.79;8.39;683;56;2875.00;81
7540;55;628512690;7540;207;8223;8302;8.78;0.54;237.82;8.40;683;56;2876.00;79
7540;55;628512700;7540;209;8223;8302;8.70;0.53;237.82;8.40;683;56;2877.00;79
7543;55;628512708;7543;210;8224;8302;8.65;0.53;237.85;8.41;681;56;2878.00;78
7546;55;628512718;7546;209;8225;8302;8.64;0.53;237.85;8.41;679;56;2879.00;77
7547;55;628512729;7547;248;8325;8532;8.65;0.55;237.84;8.31;778;56;2880.00;207
7550;55;628512756;7550;236;8328;8533;8.65;0.54;237.82;8.32;778;56;2881.00;205
7554;55;628512766;7554;226;8338;8533;8.72;0.55;237.84;8.32;784;56;2882.00;195
7557;55;628512776;7557;225;8346;8533;8.72;0.55;237.83;8.31;789;56;2883.00;187
7561;55;628512786;7561;228;8356;8533;8.69;0.54;237.82;8.32;795;56;2884.00;177
7567;55;628512796;7567;228;8360;8533;8.65;0.54;237.94;8.32;793;56;2885.00;173
7571;55;628512806;7571;227;8368;8533;8.56;0.54;237.97;8.32;797;56;2886.00;165
7574;55;628512816;7574;226;8371;8533;8.44;0.53;237.96;8.32;797;56;2887.00;162
7580;55;628512826;7580;233;8378;8534;8.30;0.52;237.93;8.32;798;56;2888.00;156
7586;55;628512836;7586;240;8381;8535;8.19;0.51;237.92;8.32;795;56;2889.00;154
7591;55;628512848;7591;242;8386;8535;8.10;0.50;238.00;8.32;795;56;2890.00;149
7594;55;628512860;7594;246;8394;8536;7.97;0.49;237.99;8.32;800;56;2891.00;142
7597;55;628512870;7597;246;8399;8536;7.92;0.49;238.07;8.32;802;56;2892.00;137
7601;55;628512880;7601;248;8402;8536;7.78;0.48;238.15;8.33;801;56;2893.00;134
7602;55;628512890;7602;262;8408;8536;7.67;0.48;238.19;8.33;806;56;2894.00;128
7605;55;628512901;7605;260;8413;8540;7.53;0.47;238.29;8.33;808;56;2895.00;127
7608;55;628512912;7608;259;8416;8540;7.36;0.46;238.29;8.33;808;56;2896.00;124
7612;55;628512921;7612;253;8420;8540;7.24;0.45;238.31;8.34;808;56;2897.00;120
7616;55;628512931;7616;253;8424;8543;7.21;0.45;238.33;8.34;808;56;2898.00;119
7619;55;628512941;7619;255;8424;8543;7.26;0.45;238.37;8.34;805;56;2899.00;119
7624;55;628512951;7624;258;8425;8543;7.29;0.45;238.40;8.34;801;56;2900.00;118
7628;55;628512965;7628;256;8432;8547;7.38;0.45;238.40;8.47;804;56;2901.00;115
7634;55;628512984;7634;258;8433;8548;7.38;0.45;238.40;8.47;799;56;2902.00;115
7637;55;628512995;7637;255;8435;8548;7.45;0.46;238.47;8.48;798;56;2903.00;113
7638;55;628513005;7638;260;8440;8552;7.55;0.47;238.48;8.48;802;56;2904.00;112
7643;55;628513016;7643;262;8442;8552;7.58;0.47;238.49;8.48;799;56;2905.00;110
7649;55;628513026;7649;266;8444;8552;7.57;0.46;238.53;8.48;795;56;2906.00;108
7653;55;628513036;7653;267;8447;8553;7.61;0.47;238.51;8.49;794;56;2907.00;106
7656;55;628513047;7656;271;8448;8553;7.61;0.47;238.58;8.49;792;56;2908.00;105
7660;55;628513056;7660;280;8453;8559;7.60;0.47;238.66;8.49;793;56;2909.00;106
7665;55;628513069;7665;279;8456;8559;7.54;0.46;238.72;8.50;791;56;2910.00;103
7670;55;628513079;7670;279;8457;8560;7.51;0.46;238.76;8.50;787;56;2911.00;103
7673;55;628513090;7673;290;8458;8560;7.53;0.46;238.77;8.50;785;56;2912.00;102
7675;55;628513105;7675;289;8460;8560;7.52;0.46;238.78;8.51;785;56;2913.00;100
7679;55;628513115;7679;292;8462;8560;7.52;0.46;238.81;8.51;783;56;2914.00;98
7685;55;628513126;7685;296;8463;8560;7.45;0.46;238.78;8.51;778;56;2915.00;97
7687;55;628513141;7687;297;8473;8572;7.44;0.46;238.80;8.50;786;56;2916.00;99
7693;55;628513157;7693;302;8474;8572;7.35;0.45;238.81;8.51;781;56;2917.00;98
7695;55;628513167;7695;297;8476;8572;7.31;0.45;238.76;8.50;781;56;2918.00;96
7700;55;628513177;7700;307;8476;8572;7.25;0.44;238.80;8.50;776;56;2919.00;96
7702;55;628513186;7702;310;8477;8572;7.20;0.44;238.81;8.50;775;56;2920.00;95
7706;55;628513196;7706;313;8477;8572;7.18;0.44;238.79;8.50;771;56;2921.00;95
7707;55;628513206;7707;315;8480;8576;7.28;0.45;238.81;8.50;773;56;2922.00;96
7710;55;628513216;7710;319;8480;8576;7.28;0.45;238.84;8.50;770;56;2923.00;96
7715;55;628513226;7715;325;8483;8580;7.25;0.44;238.90;8.50;768;56;2924.00;97
7717;55;628513236;7717;326;8485;8582;7.29;0.45;238.92;8.50;768;56;2925.00;97
7719;55;628513246;7719;325;8486;8582;7.34;0.45;238.94;8.50;767;56;2926.00;96
7721;55;628513256;7721;326;8486;8582;7.39;0.45;238.93;8.50;765;56;2927.00;96
7723;55;628513266;7723;332;8496;8595;7.49;0.46;238.95;8.49;773;56;2928.00;99
7727;55;628513276;7727;338;8496;8595;7.47;0.45;238.91;8.49;769;56;2929.00;99
7727;55;628513286;7727;341;8496;8595;7.50;0.46;238.91;8.49;769;56;2930.00;99
7729;55;628513296;7729;344;8497;8596;7.50;0.46;238.91;8.49;768;56;2931.00;99
7730;55;628513305;7730;352;8497;8597;7.45;0.45;238.89;8.49;767;56;2932.00;100
7735;55;628513315;7735;356;8497;8597;7.44;0.45;238.92;8.49;762;56;2933.00;100
7739;55;628513325;7739;363;8499;8600;7.44;0.45;238.93;8.48;760;56;2934.00;101
7744;55;628513335;7744;368;8500;8600;7.36;0.45;238.86;8.48;756;56;2935.00;100
7745;55;628513345;7745;375;8500;8600;7.24;0.44;238.83;8.48;755;56;2936.00;100
7749;55;628513355;7749;370;8500;8600;7.14;0.44;238.79;8.48;751;56;2937.00;100
7751;55;628513364;7751;361;8504;8606;7.14;0.44;238.75;8.48;753;56;2938.00;102
7754;55;628513375;7754;359;8505;8606;7.12;0.43;238.79;8.48;751;56;2939.00;101
7755;55;628513386;7755;353;8505;8606;7.09;0.43;238.77;8.48;750;56;2940.00;101
7756;55;628513397;7756;349;8505;8606;7.16;0.44;238.80;8.48;749;56;2941.00;101
7758;55;628513407;7758;350;8508;8610;7.18;0.44;238.80;8.48;750;56;2942.00;102
7761;55;628513416;7761;350;8509;8611;7.21;0.44;238.79;8.47;748;56;2943.00;102
7763;55;628513426;7763;349;8509;8611;7.24;0.44;238.76;8.47;746;56;2944.00;102
7764;55;628513436;7764;348;8510;8612;7.28;0.44;238.74;8.47;746;56;2945.00;102
7765;55;628513452;7765;334;8510;8612;7.27;0.44;238.71;8.47;745;56;2946.00;102
7767;55;628513461;7767;323;8510;8612;7.34;0.45;238.69;8.47;743;56;2947.00;102
7768;55;628513471;7768;316;8510;8612;7.38;0.45;238.69;8.47;742;56;2948.00;102
7772;55;628513482;7772;299;8510;8612;7.41;0.45;238.65;8.47;738;56;2949.00;102
7772;55;628513492;7772;290;8510;8612;7.45;0.45;238.65;8.47;738;56;2950.00;102
7773;55;628513501;7773;285;8510;8612;7.57;0.46;238.62;8.47;737;56;2951.00;102
7775;55;628513511;7775;290;8547;8682;7.78;0.47;238.64;8.44;772;56;2952.00;135
7776;55;628513527;7776;282;8547;8683;7.90;0.48;238.65;8.44;771;56;2953.00;136
7778;55;628513538;7778;276;8554;8683;8.10;0.49;238.64;8.43;776;56;2954.00;129
7779;55;628513548;7779;259;8560;8683;8.32;0.51;238.64;8.56;781;56;2955.00;123
7782;55;628513558;7782;244;8565;8683;8.50;0.52;238.60;8.56;783;56;2956.00;118
7785;55;628513569;7785;236;8567;8683;8.63;0.52;238.63;8.56;782;56;2957.00;116
7785;55;628513580;7785;221;8569;8683;8.80;0.53;238.63;8.56;784;56;2958.00;114
7786;55;628513591;7786;218;8570;8683;8.95;0.54;238.63;8.56;784;56;2959.00;113
7787;55;628513602;7787;203;8572;8684;9.09;0.55;238.61;8.56;785;56;2960.00;112
7789;55;628513621;7789;197;8573;8685;9.19;0.56;238.64;8.56;784;56;2961.00;112
7790;55;628513637;7790;192;8574;8685;9.29;0.56;238.62;8.56;784;56;2962.00;111
7791;55;628513648;7791;189;8577;8689;9.38;0.57;238.61;8.55;786;56;2963.00;112
7793;55;628513660;7793;181;8577;8689;9.52;0.58;238.60;8.55;784;56;2964.00;112
7794;55;628513671;7794;180;8577;8689;9.58;0.58;238.59;8.55;783;56;2965.00;112
7796;55;628513688;7796;176;8577;8689;9.68;0.59;238.59;8.55;781;56;2966.00;112
7797;55;628513699;7797;167;8580;8695;9.79;0.59;238.58;8.55;783;56;2967.00;115
7799;55;628513716;7799;169;8580;8695;9.93;0.60;238.58;8.55;781;56;2968.00;115
7801;55;628513726;7801;168;8581;8695;10.04;0.61;238.64;8.55;780;56;2969.00;114
7802;55;628513739;7802;163;8584;8701;10.18;0.62;238.63;8.55;782;56;2970.00;117
7802;55;628513751;7802;161;8585;8701;10.35;0.63;238.63;8.55;783;56;2971.00;116
7805;55;628513761;7805;161;8585;8701;10.47;0.64;238.60;8.55;780;56;2972.00;116
7806;55;628513772;7806;162;8586;8702;10.54;0.64;238.58;8.55;780;56;2973.00;116
7807;55;628513783;7807;158;8587;8703;10.65;0.65;238.58;8.55;780;56;2974.00;116
7809;55;628513794;7809;154;8589;8703;10.67;0.65;238.58;8.68;780;56;2975.00;114
7812;55;628513805;7812;156;8597;8716;10.69;0.65;238.61;8.67;785;56;2976.00;119
7815;55;628513817;7815;156;8598;8716;10.77;0.65;238.64;8.67;783;56;2977.00;118
7818;55;628513828;7818;156;8598;8716;10.87;0.66;238.63;8.67;780;56;2978.00;118
7820;55;628513840;7820;157;8599;8717;10.96;0.66;238.62;8.67;779;56;2979.00;118
7823;55;628513851;7823;157;8599;8717;10.98;0.67;238.68;8.67;776;56;2980.00;118
7826;55;628513867;7826;159;8601;8721;11.04;0.67;238.72;8.67;775;56;2981.00;120
7826;55;628513888;7826;157;8601;8721;11.14;0.68;238.72;8.67;775;56;2982.00;120
7830;55;628513906;7830;160;8605;8725;11.19;0.68;238.79;8.67;775;56;2983.00;120
7830;55;628513924;7830;156;8605;8725;11.23;0.68;238.79;8.67;775;56;2984.00;120
7836;55;628513950;7836;155;8605;8725;11.22;0.68;238.80;8.67;769;56;2985.00;120
7840;55;628513974;7840;156;8605;8725;11.23;0.68;238.83;8.67;765;56;2986.00;120
7844;55;628513985;7844;154;8605;8725;11.25;0.68;238.82;8.67;761;56;2987.00;120
7849;55;628513997;7849;157;8615;8737;11.31;0.69;238.84;8.66;766;56;2988.00;122
7854;55;628514011;7854;153;8616;8737;11.32;0.69;238.85;8.66;762;56;2989.00;121
7857;55;628514022;7857;157;8618;8737;11.31;0.69;238.85;8.80;761;56;2990.00;119
7862;55;628514040;7862;153;8618;8737;11.32;0.69;238.86;8.80;756;56;2991.00;119
7867;55;628514051;7867;146;8618;8737;11.27;0.69;238.95;8.80;751;56;2992.00;119
7870;55;628514063;7870;146;8619;8737;11.34;0.69;238.93;8.93;749;56;2993.00;118
7875;55;628514074;7875;140;8621;8738;11.34;0.69;238.94;8.94;746;56;2994.00;117
7878;55;628514085;7878;133;8624;8738;11.33;0.69;238.97;9.10;746;56;2995.00;114
7879;55;628514104;7879;130;8627;8744;11.49;0.70;238.96;9.10;748;56;2996.00;117
7881;55;628514116;7881;130;8629;8745;11.56;0.70;238.94;9.10;748;56;2997.00;116
7883;55;628514127;7883;122;8629;8745;11.67;0.71;238.97;9.10;746;56;2998.00;116
7887;55;628514137;7887;120;8630;8745;11.74;0.72;238.93;9.23;743;56;2999.00;115
7890;55;628514156;7890;121;8634;8765;11.74;0.72;238.95;9.23;744;56;3000.00;131
7895;55;628514173;7895;115;8635;8765;11.68;0.71;238.96;9.37;740;56;3001.00;130
7900;55;628514185;7900;116;8636;8765;11.64;0.71;238.98;9.37;736;56;3002.00;129
7902;55;628514196;7902;117;8637;8766;11.71;0.71;238.97;9.37;735;56;3003.00;129
7907;55;628514207;7907;116;8640;8770;11.62;0.71;238.92;9.36;733;56;3004.00;130
7912;55;628514219;7912;116;8640;8770;11.65;0.71;238.92;9.36;728;56;3005.00;130
7914;55;628514230;7914;118;8643;8773;11.77;0.72;238.92;9.36;729;56;3006.00;130
7916;55;628514241;7916;126;8644;8773;11.78;0.72;238.90;9.37;728;56;3007.00;129
7918;55;628514252;7918;130;8647;8773;11.70;0.71;238.87;9.38;729;56;3008.00;126
7920;55;628514263;7920;132;8648;8773;11.73;0.71;238.89;9.38;728;56;3009.00;125
7924;55;628514274;7924;133;8649;8777;11.77;0.72;238.85;9.38;725;56;3010.00;128
7925;55;628514286;7925;137;8653;8777;11.71;0.71;238.85;9.39;728;56;3011.00;124
7928;55;628514297;7928;141;8654;8777;11.68;0.71;238.82;9.39;726;56;3012.00;123
7930;55;628514307;7930;144;8656;8777;11.64;0.71;238.84;9.39;726;56;3013.00;121
7934;55;628514318;7934;140;8658;8778;11.56;0.70;238.83;9.39;724;56;3014.00;120
7937;55;628514329;7937;142;8661;8780;11.49;0.70;238.82;9.39;724;56;3015.00;119
7938;55;628514341;7938;141;8662;8780;11.47;0.70;238.83;9.39;724;56;3016.00;118
7944;55;628514352;7944;139;8664;8781;11.41;0.69;238.77;9.39;720;56;3017.00;117
7945;55;628514363;7945;143;8664;8781;11.35;0.69;238.80;9.39;719;56;3018.00;117
7948;55;628514373;7948;143;8665;8781;11.30;0.68;238.78;9.39;717;56;3019.00;116
7952;55;628514385;7952;138;8667;8781;11.22;0.68;238.80;9.42;715;56;3020.00;114
7953;55;628514396;7953;142;8668;8781;11.21;0.68;238.81;9.42;715;56;3021.00;113
7955;55;628514407;7955;145;8669;8781;11.15;0.68;238.78;9.43;714;56;3022.00;112
7956;55;628514419;7956;151;8670;8781;11.08;0.67;238.82;9.45;714;56;3023.00;111
7958;55;628514429;7958;176;8736;8908;10.72;0.66;238.80;9.39;778;56;3024.00;172
7961;55;628514450;7961;172;8739;8909;10.71;0.66;238.78;9.39;778;56;3025.00;170
7962;55;628514461;7962;166;8748;8909;10.69;0.66;238.80;9.42;786;56;3026.00;161
7963;55;628514473;7963;171;8750;8909;10.59;0.65;238.80;9.42;787;56;3027.00;159
7965;55;628514483;7965;177;8754;8909;10.57;0.65;238.85;9.41;789;56;3028.00;155
7967;55;628514494;7967;183;8764;8909;10.55;0.65;238.82;9.43;797;56;3029.00;145
7970;55;628514506;7970;187;8767;8909;10.53;0.65;238.81;9.43;797;56;3030.00;142
7973;55;628514518;7973;192;8771;8909;10.53;0.65;238.78;9.43;798;56;3031.00;138
7974;55;628514540;7974;198;8778;8910;10.56;0.65;238.77;9.46;804;56;3032.00;132
7976;55;628514557;7976;200;8781;8911;10.53;0.65;238.76;9.47;805;56;3033.00;130
7978;55;628514569;7978;204;8785;8911;10.48;0.65;238.76;9.48;807;56;3034.00;126
7981;55;628514580;7981;208;8787;8912;10.35;0.64;238.76;9.49;806;56;3035.00;125
7982;55;628514591;7982;215;8791;8912;10.22;0.63;238.76;9.50;809;56;3036.00;121
7986;55;628514603;7986;226;8796;8912;10.03;0.62;238.69;9.51;810;56;3037.00;116
7991;55;628514614;7991;229;8800;8912;9.79;0.60;238.66;9.52;809;56;3038.00;112
7996;55;628514625;7996;232;8804;8916;9.55;0.59;238.61;9.52;808;56;3039.00;112
7997;55;628514637;7997;238;8807;8916;9.36;0.58;238.60;9.53;810;56;3040.00;109
8000;55;628514654;8000;239;8808;8916;9.20;0.57;238.59;9.53;808;56;3041.00;108
8006;55;628514666;8006;245;8812;8919;9.03;0.55;238.56;9.55;806;56;3042.00;107
8009;55;628514678;8009;249;8814;8919;8.93;0.55;238.52;9.55;805;56;3043.00;105
8010;55;628514689;8010;256;8816;8919;8.86;0.54;238.61;9.55;806;56;3044.00;103
8011;55;628514699;8011;262;8819;8923;8.77;0.54;238.60;9.55;808;56;3045.00;104
8015;55;628514711;8015;266;8821;8924;8.70;0.54;238.63;9.55;806;56;3046.00;103
8017;55;628514721;8017;269;8823;8924;8.64;0.53;238.58;9.56;806;56;3047.00;101
8021;55;628514732;8021;274;8826;8928;8.66;0.53;238.54;9.56;805;56;3048.00;102
8023;55;628514742;8023;280;8829;8928;8.55;0.52;238.55;9.57;806;56;3049.00;99
8025;55;628514753;8025;277;8829;8928;8.50;0.52;238.54;9.57;804;56;3050.00;99
8029;55;628514763;8029;268;8830;8929;8.38;0.51;238.52;9.57;801;56;3051.00;99
8034;55;628514773;8034;269;8832;8929;8.23;0.51;238.52;9.58;798;56;3052.00;97
8036;55;628514784;8036;277;8836;8935;8.28;0.51;238.51;9.58;800;56;3053.00;99
8040;55;628514794;8040;278;8837;8935;8.16;0.50;238.52;9.58;797;56;3054.00;98
8047;55;628514811;8047;281;8839;8936;8.00;0.49;238.49;9.58;792;56;3055.00;97
8050;55;628514821;8050;288;8840;8936;7.86;0.48;238.54;9.58;790;56;3056.00;96
8052;55;628514831;8052;293;8841;8936;7.65;0.47;238.53;9.59;789;56;3057.00;95
8058;55;628514847;8058;300;8841;8936;7.43;0.46;238.58;9.59;783;56;3058.00;95
8060;55;628514859;8060;310;8842;8936;7.24;0.45;238.60;9.60;782;56;3059.00;94
8063;55;628514874;8063;306;8867;8972;7.19;0.45;238.68;9.58;804;56;3060.00;105
8067;55;628514888;8067;304;8868;8972;7.07;0.44;238.69;9.58;801;56;3061.00;104
8072;55;628514898;8072;300;8872;8972;7.00;0.43;238.72;9.58;800;56;3062.00;100
8076;55;628514910;8076;295;8874;8972;6.98;0.43;238.83;9.58;798;56;3063.00;98
8079;55;628514932;8079;297;8876;8972;6.96;0.43;238.82;9.59;797;56;3064.00;96
8082;55;628514956;8082;292;8877;8972;6.99;0.43;238.83;9.58;795;56;3065.00;95
8085;55;628514980;8085;293;8880;8976;6.99;0.43;238.85;9.58;795;56;3066.00;96
8086;55;628514998;8086;288;8882;8976;6.96;0.43;238.83;9.59;796;56;3067.00;94
8091;55;628515009;8091;287;8884;8980;6.98;0.43;238.96;9.58;793;56;3068.00;96
8095;55;628515022;8095;286;8886;8981;6.98;0.43;238.96;9.58;791;56;3069.00;95
8098;55;628515034;8098;283;8887;8981;6.95;0.43;238.95;9.58;789;56;3070.00;94
8101;55;628515045;8101;277;8888;8981;6.92;0.43;239.02;9.58;787;56;3071.00;93
8106;55;628515055;8106;284;8899;8994;7.00;0.43;239.02;9.57;793;56;3072.00;95
8109;55;628515067;8109;288;8899;8994;7.01;0.43;239.13;9.57;790;56;3073.00;95
8110;55;628515077;8110;289;8899;8994;7.12;0.44;239.12;9.57;789;56;3074.00;95
8114;55;628515088;8114;290;8900;8995;7.14;0.44;239.12;9.57;786;56;3075.00;95
8119;55;628515099;8119;297;8900;8996;7.18;0.44;239.09;9.57;781;56;3076.00;96
8122;55;628515108;8122;296;8900;8996;7.19;0.44;239.09;9.57;778;56;3077.00;96
8124;55;628515118;8124;290;8902;8999;7.29;0.45;239.17;9.57;778;56;3078.00;97
8128;55;628515129;8128;292;8903;8999;7.24;0.44;239.18;9.56;775;56;3079.00;96
8130;55;628515140;8130;290;8903;8999;7.20;0.44;239.18;9.56;773;56;3080.00;96
8133;55;628515153;8133;289;8903;8999;7.14;0.44;239.19;9.56;770;56;3081.00;96
8135;56;628515165;8135;298;8907;9005;7.07;0.43;239.22;9.56;772;57;3082.00;98
8138;56;628515189;8138;308;8908;9005;6.97;0.43;239.22;9.56;770;57;3083.00;97
8141;56;628515200;8141;309;8908;9005;6.86;0.42;239.16;9.56;767;57;3084.00;97
8147;56;628515211;8147;306;8908;9005;6.79;0.41;239.14;9.56;761;57;3085.00;97
8150;56;628515221;8150;309;8911;9009;6.78;0.41;239.13;9.56;761;57;3086.00;98
8154;56;628515232;8154;312;8912;9010;6.70;0.41;239.21;9.56;758;57;3087.00;98
8158;56;628515243;8158;312;8912;9010;6.66;0.41;239.17;9.56;754;57;3088.00;98
8160;56;628515254;8160;312;8913;9011;6.61;0.40;239.18;9.56;753;57;3089.00;98
8167;56;628515266;8167;317;8913;9011;6.45;0.39;239.16;9.56;746;57;3090.00;98
8172;56;628515277;8172;326;8913;9011;6.35;0.39;239.15;9.56;741;57;3091.00;98
8176;56;628515287;8176;329;8913;9011;6.31;0.38;239.07;9.56;737;57;3092.00;98
8176;56;628515306;8176;331;8913;9011;6.38;0.39;239.07;9.56;737;57;3093.00;98
8179;56;628515317;8179;334;8913;9011;6.37;0.39;239.07;9.56;734;57;3094.00;98
8181;56;628515327;8181;337;8913;9011;6.39;0.39;239.11;9.56;732;57;3095.00;98
8188;56;628515338;8188;348;8952;9081;6.64;0.41;239.08;9.51;764;57;3096.00;129
8188;56;628515358;8188;342;8953;9082;6.67;0.41;239.08;9.51;765;57;3097.00;129
8192;56;628515369;8192;337;8961;9082;6.78;0.41;239.12;9.51;769;57;3098.00;121
8194;56;628515379;8194;346;8962;9082;6.78;0.41;239.17;9.51;768;57;3099.00;120
8195;56;628515389;8195;350;8967;9082;6.81;0.42;239.18;9.50;772;57;3100.00;115
8199;56;628515405;8199;354;8969;9082;6.76;0.41;239.21;9.50;770;57;3101.00;113
8200;56;628515417;8200;359;8971;9082;6.73;0.41;239.19;9.50;771;57;3102.00;111
8201;56;628515428;8201;364;8974;9082;6.72;0.41;239.20;9.50;773;57;3103.00;108
8201;56;628515439;8201;368;8975;9083;6.70;0.41;239.20;9.50;774;57;3104.00;108
8203;56;628515448;8203;377;8980;9085;6.72;0.41;239.21;9.50;777;57;3105.00;105
8203;56;628515459;8203;386;8982;9085;6.65;0.41;239.21;9.50;779;57;3106.00;103
8205;56;628515470;8205;361;8985;9089;6.61;0.41;239.17;9.49;780;57;3107.00;104
8206;56;628515482;8206;351;8985;9089;6.63;0.41;239.19;9.49;779;57;3108.00;104
8209;56;628515494;8209;341;8985;9089;6.68;0.41;239.19;9.49;776;57;3109.00;104
8212;56;628515505;8212;334;8985;9089;6.75;0.41;239.30;9.49;773;57;3110.00;104
8216;56;628515518;8216;324;8989;9095;6.85;0.42;239.28;9.49;773;57;3111.00;106
8218;56;628515530;8218;317;8989;9095;6.98;0.43;239.32;9.49;771;57;3112.00;106
8219;56;628515543;8219;310;8990;9095;7.07;0.43;239.29;9.49;771;57;3113.00;105
8222;56;628515570;8222;299;8992;9098;7.18;0.44;239.32;9.49;770;57;3114.00;106
8224;56;628515582;8224;294;8993;9098;7.30;0.45;239.38;9.49;769;57;3115.00;105
8225;56;628515596;8225;275;8993;9098;7.46;0.45;239.37;9.49;768;57;3116.00;105
8227;56;628515608;8227;262;8993;9099;7.58;0.46;239.32;9.49;766;57;3117.00;106
8229;57;628515622;8229;245;8994;9100;7.78;0.47;239.30;9.48;765;58;3118.00;106
8231;57;628515653;8231;234;8994;9100;7.95;0.48;239.29;9.48;763;58;3119.00;106
8232;57;628515666;8232;229;9014;9126;8.21;0.50;239.29;9.46;782;58;3120.00;112
8233;57;628515687;8233;215;9015;9126;8.41;0.51;239.29;9.46;782;58;3121.00;111
8233;57;628515700;8233;208;9016;9126;8.65;0.53;239.29;9.46;783;58;3122.00;110
8234;57;628515712;8234;202;9017;9127;8.90;0.54;239.27;9.46;783;58;3123.00;110
8236;57;628515725;8236;192;9017;9127;9.11;0.55;239.26;9.46;781;58;3124.00;110
8239;58;628515739;8239;184;9020;9131;9.32;0.57;239.25;9.46;781;59;3125.00;111
8240;58;628515768;8240;174;9020;9131;9.52;0.58;239.23;9.46;780;59;3126.00;111
8241;58;628515784;8241;170;9024;9135;9.68;0.59;239.23;9.45;783;59;3127.00;111
8245;58;628515798;8245;168;9024;9135;9.72;0.59;239.25;9.45;779;59;3128.00;111
8249;58;628515814;8249;165;9024;9135;9.83;0.60;239.30;9.45;775;59;3129.00;111
8251;58;628515827;8251;161;9024;9135;9.90;0.60;239.26;9.45;773;59;3130.00;111
8255;58;628515840;8255;161;9024;9135;9.97;0.61;239.26;9.45;769;59;3131.00;111
8259;58;628515853;8259;156;9033;9147;10.07;0.61;239.28;9.45;774;59;3132.00;114
8261;58;628515872;8261;162;9033;9147;10.15;0.62;239.40;9.45;772;59;3133.00;114
8264;58;628515901;8264;158;9035;9147;10.27;0.62;239.43;9.44;771;59;3134.00;112
8268;58;628515920;8268;158;9036;9147;10.39;0.63;239.49;9.59;768;59;3135.00;111
8270;58;628515941;8270;155;9036;9147;10.50;0.64;239.47;9.59;766;59;3136.00;111
8272;58;628515958;8272;153;9036;9147;10.62;0.64;239.49;9.59;764;59;3137.00;111
8274;58;628515979;8274;150;9036;9148;10.68;0.65;239.51;9.59;762;59;3138.00;112
8277;58;628515996;8277;143;9036;9148;10.74;0.65;239.60;9.59;759;59;3139.00;112
8281;58;628516018;8281;142;9040;9154;10.83;0.66;239.60;9.59;759;59;3140.00;114
8283;58;628516035;8283;141;9041;9155;10.92;0.66;239.63;9.59;758;59;3141.00;114
8284;58;628516049;8284;132;9042;9155;11.02;0.67;239.66;9.58;758;59;3142.00;113
8287;58;628516067;8287;132;9042;9155;11.10;0.67;239.66;9.58;755;59;3143.00;113
8288;58;628516081;8288;133;9045;9159;11.14;0.68;239.69;9.58;757;59;3144.00;114
8291;58;628516096;8291;132;9045;9159;11.21;0.68;239.65;9.58;754;59;3145.00;114
8295;58;628516111;8295;128;9045;9159;11.28;0.68;239.69;9.58;750;59;3146.00;114
8296;58;628516125;8296;132;9046;9160;11.35;0.69;239.71;9.58;750;59;3147.00;114
8298;58;628516141;8298;133;9049;9164;11.30;0.69;239.74;9.58;751;59;3148.00;115
8300;59;628516156;8300;132;9049;9164;11.35;0.69;239.74;9.58;749;60;3149.00;115
8303;59;628516182;8303;135;9052;9170;11.42;0.69;239.78;9.57;749;60;3150.00;118
8308;59;628516202;8308;140;9052;9170;11.49;0.70;239.77;9.57;744;60;3151.00;118
8310;59;628516221;8310;141;9053;9170;11.59;0.70;239.80;9.57;743;60;3152.00;117
8314;59;628516236;8314;139;9053;9170;11.62;0.70;239.83;9.57;739;60;3153.00;117
8316;59;628516257;8316;138;9056;9174;11.76;0.71;239.85;9.57;740;60;3154.00;118
8322;59;628516273;8322;139;9056;9174;11.79;0.71;239.93;9.57;734;60;3155.00;118
8327;59;628516288;8327;144;9057;9174;11.79;0.71;239.96;9.57;730;60;3156.00;117
8328;59;628516302;8328;144;9057;9174;11.81;0.71;239.96;9.57;729;60;3157.00;117
8332;59;628516317;8332;146;9058;9175;11.81;0.71;239.99;9.57;726;60;3158.00;117
8334;59;628516335;8334;142;9059;9176;11.82;0.71;239.99;9.57;725;60;3159.00;117
8338;59;628516350;8338;142;9060;9176;11.78;0.71;240.03;9.57;722;60;3160.00;116
8342;59;628516371;8342;140;9061;9177;11.79;0.71;240.06;9.57;719;60;3161.00;116
8345;59;628516385;8345;133;9061;9177;11.79;0.71;240.08;9.57;716;60;3162.00;116
8349;59;628516408;8349;135;9061;9177;11.82;0.72;240.07;9.57;712;60;3163.00;116
8355;59;628516423;8355;129;9062;9177;11.79;0.71;240.08;9.58;707;60;3164.00;115
8359;59;628516437;8359;127;9063;9177;11.76;0.71;240.16;9.60;704;60;3165.00;114
8363;59;628516449;8363;128;9063;9177;11.79;0.71;240.17;9.60;700;60;3166.00;114
8368;59;628516461;8368;132;9063;9177;11.84;0.72;240.19;9.60;695;60;3167.00;114
8369;59;628516474;8369;155;9133;9304;11.49;0.70;240.23;9.52;764;60;3168.00;171
8370;59;628516503;8370;138;9134;9305;11.52;0.71;240.24;9.52;764;60;3169.00;171
8375;59;628516518;8375;128;9140;9305;11.65;0.71;240.23;9.52;765;60;3170.00;165
8377;59;628516533;8377;126;9144;9305;11.73;0.72;240.21;9.52;767;60;3171.00;161
8379;59;628516549;8379;127;9149;9305;11.82;0.72;240.25;9.51;770;60;3172.00;156
8382;59;628516564;8382;124;9152;9305;11.87;0.73;240.27;9.51;770;60;3173.00;153
8382;59;628516578;8382;128;9156;9305;11.93;0.73;240.27;9.51;774;60;3174.00;149
8387;59;628516592;8387;126;9158;9305;12.01;0.73;240.29;9.51;771;60;3175.00;147
8391;59;628516606;8391;123;9162;9306;12.14;0.74;240.28;9.51;771;60;3176.00;144
8394;59;628516621;8394;123;9165;9307;12.21;0.75;240.31;9.51;771;60;3177.00;142
8397;59;628516652;8397;126;9170;9307;12.22;0.75;240.40;9.51;773;60;3178.00;137
8399;59;628516668;8399;123;9171;9308;12.10;0.74;240.35;9.51;772;60;3179.00;137
8402;59;628516685;8402;120;9175;9308;11.97;0.73;240.42;9.51;773;60;3180.00;133
8405;59;628516701;8405;125;9176;9308;11.77;0.72;240.45;9.51;771;60;3181.00;132
8408;59;628516717;8408;127;9179;9308;11.68;0.71;240.53;9.51;771;60;3182.00;129
8410;59;628516733;8410;129;9182;9312;11.57;0.71;240.51;9.51;772;60;3183.00;130
8412;59;628516750;8412;131;9184;9312;11.48;0.70;240.53;9.51;772;60;3184.00;128
8414;59;628516765;8414;138;9184;9312;11.39;0.70;240.55;9.51;770;60;3185.00;128
8419;59;628516780;8419;144;9187;9315;11.32;0.69;240.55;9.51;768;60;3186.00;128
8424;59;628516796;8424;149;9188;9315;11.30;0.69;240.58;9.52;764;60;3187.00;127
8429;59;628516810;8429;155;9190;9315;11.23;0.68;240.61;9.53;761;60;3188.00;125
8432;59;628516824;8432;164;9194;9319;11.08;0.67;240.60;9.53;762;60;3189.00;125
8433;59;628516848;8433;173;9197;9320;11.01;0.67;240.59;9.55;764;60;3190.00;123
8435;59;628516864;8435;178;9198;9322;10.89;0.66;240.62;9.55;763;60;3191.00;124
8437;59;628516881;8437;187;9203;9326;10.87;0.66;240.60;9.55;766;60;3192.00;123
8442;59;628516896;8442;194;9204;9326;10.84;0.66;240.60;9.55;762;60;3193.00;122
8444;59;628516912;8444;197;9205;9326;10.80;0.66;240.57;9.57;761;60;3194.00;121
8445;59;628516924;8445;201;9208;9328;10.76;0.66;240.56;9.58;763;60;3195.00;120
8447;59;628516937;8447;205;9209;9328;10.64;0.65;240.56;9.59;762;60;3196.00;119
8448;59;628516950;8448;213;9215;9334;10.46;0.64;240.55;9.61;767;60;3197.00;119
8449;59;628516968;8449;217;9216;9334;10.27;0.63;240.54;9.61;767;60;3198.00;118
8449;59;628516980;8449;224;9216;9335;10.21;0.62;240.54;9.61;767;60;3199.00;119
8451;59;628516992;8451;230;9218;9335;10.10;0.62;240.58;9.63;767;60;3200.00;117
8455;59;628517008;8455;234;9218;9335;10.03;0.61;240.61;9.63;763;60;3201.00;117
8458;59;628517021;8458;234;9219;9335;9.88;0.60;240.60;9.64;761;60;3202.00;116
8458;59;628517034;8458;245;9220;9335;9.73;0.59;240.60;9.66;762;60;3203.00;115
8460;59;628517044;8460;246;9230;9347;9.60;0.59;240.60;9.66;770;60;3204.00;117
8463;60;628517062;8463;256;9232;9347;9.43;0.58;240.58;9.69;769;61;3205.00;115
8464;60;628517086;8464;257;9234;9347;9.32;0.57;240.57;9.69;770;61;3206.00;113
8468;60;628517098;8468;260;9236;9347;9.16;0.56;240.57;9.71;768;61;3207.00;111
8473;60;628517109;8473;267;9236;9347;9.03;0.55;240.61;9.71;763;61;3208.00;111
8477;60;628517121;8477;272;9238;9347;8.93;0.55;240.66;9.73;761;61;3209.00;109
8480;60;628517136;8480;269;9241;9351;8.81;0.54;240.66;9.73;761;61;3210.00;110
8481;60;628517148;8481;273;9241;9351;8.75;0.54;240.66;9.73;760;61;3211.00;110
8485;60;628517160;8485;268;9246;9355;8.71;0.53;240.67;9.75;761;61;3212.00;109
8488;60;628517171;8488;270;9248;9356;8.65;0.53;240.67;9.75;760;61;3213.00;108
8494;60;628517182;8494;273;9251;9356;8.55;0.53;240.67;9.77;757;61;3214.00;105
8496;60;628517194;8496;272;9252;9356;8.48;0.52;240.65;9.78;756;61;3215.00;104
8499;60;628517203;8499;274;9263;9369;8.47;0.52;240.63;9.77;764;61;3216.00;106
8503;60;628517215;8503;267;9265;9369;8.42;0.52;240.60;9.78;762;61;3217.00;104
8507;60;628517227;8507;266;9265;9369;8.36;0.51;240.63;9.78;758;61;3218.00;104
8510;60;628517237;8510;268;9266;9370;8.29;0.51;240.62;9.78;756;61;3219.00;104
8512;60;628517248;8512;271;9268;9371;8.19;0.50;240.63;9.79;756;61;3220.00;103
8516;60;628517257;8516;271;9268;9371;8.04;0.49;240.64;9.79;752;61;3221.00;103
8521;60;628517268;8521;275;9271;9374;7.94;0.48;240.66;9.79;750;61;3222.00;103
8526;60;628517278;8526;276;9272;9374;7.87;0.48;240.67;9.80;746;61;3223.00;102
8527;60;628517289;8527;281;9274;9374;7.81;0.48;240.67;9.80;747;61;3224.00;100
8534;60;628517299;8534;288;9274;9374;7.69;0.47;240.69;9.80;740;61;3225.00;100
8537;60;628517310;8537;291;9280;9380;7.60;0.46;240.69;9.80;743;61;3226.00;100
8542;60;628517319;8542;292;9281;9380;7.48;0.46;240.70;9.80;739;61;3227.00;99
8543;60;628517328;8543;298;9283;9380;7.31;0.45;240.68;9.81;740;61;3228.00;97
8547;60;628517337;8547;307;9283;9380;7.20;0.44;240.68;9.81;736;61;3229.00;97
8548;60;628517345;8548;306;9287;9384;7.08;0.43;240.69;9.81;739;61;3230.00;97
8548;60;628517355;8548;298;9289;9385;7.02;0.43;240.69;9.81;741;61;3231.00;96
8552;60;628517365;8552;296;9289;9385;6.95;0.43;240.66;9.81;737;61;3232.00;96
8555;60;628517374;8555;298;9291;9386;6.86;0.42;240.66;9.81;736;61;3233.00;95
8559;60;628517383;8559;296;9291;9386;6.77;0.41;240.72;9.81;732;61;3234.00;95
8562;60;628517393;8562;297;9293;9386;6.76;0.41;240.73;9.82;731;61;3235.00;93
8562;60;628517402;8562;291;9293;9386;6.85;0.42;240.73;9.82;731;61;3236.00;93
8566;60;628517411;8566;289;9294;9386;6.87;0.42;240.72;9.82;728;61;3237.00;92
8566;60;628517420;8566;285;9295;9386;6.93;0.43;240.72;9.83;729;61;3238.00;91
8568;60;628517430;8568;285;9295;9386;6.97;0.43;240.76;9.83;727;61;3239.00;91
8573;60;628517440;8573;286;9349;9511;7.39;0.46;240.73;9.77;776;61;3240.00;162
8575;60;628517460;8575;289;9353;9512;7.45;0.46;240.74;9.77;778;61;3241.00;159
8577;60;628517472;8577;286;9365;9512;7.56;0.47;240.80;9.76;788;61;3242.00;147
8581;60;628517484;8581;294;9373;9512;7.54;0.46;240.82;9.75;792;61;3243.00;139
8584;60;628517496;8584;290;9377;9512;7.54;0.47;240.80;9.75;793;61;3244.00;135
8587;60;628517510;8587;293;9382;9512;7.54;0.47;240.79;9.75;795;61;3245.00;130
8592;60;628517520;8592;295;9385;9512;7.53;0.46;240.80;9.74;793;61;3246.00;127
8595;60;628517531;8595;293;9388;9512;7.53;0.46;240.78;9.74;793;61;3247.00;124
8598;60;628517542;8598;296;9391;9513;7.51;0.46;240.81;9.74;793;61;3248.00;122
8600;60;628517552;8600;292;9393;9514;7.49;0.46;240.80;9.74;793;61;3249.00;121
8604;60;628517564;8604;287;9396;9514;7.38;0.45;240.77;9.74;792;61;3250.00;118
8607;60;628517582;8607;299;9400;9518;7.35;0.45;240.78;9.74;793;61;3251.00;118
8610;60;628517594;8610;303;9401;9518;7.31;0.45;240.73;9.74;791;61;3252.00;117
8613;60;628517606;8613;303;9404;9518;7.20;0.44;240.73;9.74;791;61;3253.00;114
8617;60;628517618;8617;304;9404;9518;7.13;0.44;240.74;9.74;787;61;3254.00;114
8618;60;628517630;8618;308;9407;9524;7.06;0.43;240.74;9.74;789;61;3255.00;117
8621;60;628517642;8621;312;9408;9524;7.02;0.43;240.77;9.74;787;61;3256.00;116
8622;60;628517656;8622;320;9408;9524;6.96;0.43;240.78;9.74;786;61;3257.00;116
8626;60;628517672;8626;327;9411;9527;6.94;0.43;240.83;9.74;785;61;3258.00;116
8629;60;628517685;8629;322;9411;9527;6.89;0.42;240.85;9.74;782;61;3259.00;116
8634;60;628517704;8634;316;9412;9527;6.90;0.42;240.82;9.73;778;61;3260.00;115
8637;60;628517717;8637;307;9413;9528;6.98;0.43;240.83;9.73;776;61;3261.00;115
8638;60;628517731;8638;297;9414;9529;7.09;0.44;240.86;9.73;776;61;3262.00;115
8642;60;628517742;8642;290;9414;9529;7.18;0.44;240.85;9.73;772;61;3263.00;115
8645;60;628517754;8645;292;9425;9542;7.36;0.45;240.87;9.72;780;61;3264.00;117
8650;60;628517769;8650;285;9425;9542;7.35;0.45;240.90;9.72;775;61;3265.00;117
8653;60;628517792;8653;277;9425;9542;7.37;0.45;240.90;9.72;772;61;3266.00;117
8655;60;628517807;8655;276;9426;9543;7.45;0.46;240.92;9.72;771;61;3267.00;117
8659;60;628517820;8659;278;9426;9543;7.48;0.46;240.89;9.72;767;61;3268.00;117
8661;60;628517833;8661;280;9429;9547;7.43;0.45;240.93;9.72;768;61;3269.00;118
8662;60;628517852;8662;281;9429;9547;7.44;0.45;240.94;9.72;767;61;3270.00;118
8664;60;628517869;8664;283;9433;9551;7.50;0.46;240.91;9.71;769;61;3271.00;118
8666;60;628517901;8666;283;9433;9551;7.51;0.46;240.92;9.71;767;61;3272.00;118
8670;60;628517919;8670;287;9433;9551;7.49;0.46;240.87;9.71;763;61;3273.00;118
8671;60;628517936;8671;286;9433;9551;7.54;0.46;240.88;9.71;762;61;3274.00;118
8672;60;628517955;8672;289;9433;9551;7.58;0.46;240.86;9.71;761;61;3275.00;118
8674;60;628517972;8674;293;9443;9563;7.77;0.47;240.87;9.70;769;61;3276.00;120
8676;60;628517988;8676;288;9443;9563;7.84;0.48;240.87;9.70;767;61;3277.00;120
8678;60;628518001;8678;286;9444;9563;7.92;0.48;240.88;9.70;766;61;3278.00;119
8681;60;628518017;8681;275;9444;9563;8.01;0.49;240.84;9.70;763;61;3279.00;119
8683;60;628518037;8683;270;9444;9563;8.12;0.49;240.87;9.70;761;61;3280.00;119
8685;60;628518052;8685;262;9444;9563;8.21;0.50;240.86;9.70;759;61;3281.00;119
8688;60;628518068;8688;259;9444;9564;8.35;0.51;240.89;9.70;756;61;3282.00;120
8691;60;628518082;8691;257;9444;9564;8.41;0.51;240.84;9.70;753;61;3283.00;120
8693;60;628518106;8693;253;9448;9570;8.47;0.51;240.85;9.70;755;61;3284.00;122
8695;60;628518121;8695;251;9450;9572;8.50;0.52;240.86;9.70;755;61;3285.00;122
8699;60;628518146;8699;234;9451;9572;8.62;0.52;240.91;9.70;752;61;3286.00;121
8702;60;628518166;8702;220;9451;9572;8.77;0.53;240.93;9.70;749;61;3287.00;121
8704;60;628518181;8704;208;9454;9576;8.90;0.54;240.97;9.69;750;61;3288.00;122
8705;60;628518203;8705;192;9454;9576;9.04;0.55;241.01;9.69;749;61;3289.00;122
8706;60;628518219;8706;180;9454;9576;9.26;0.56;240.99;9.69;748;61;3290.00;122
8708;60;628518234;8708;177;9455;9577;9.46;0.58;241.02;9.69;747;61;3291.00;122
8713;60;628518256;8713;167;9458;9581;9.56;0.58;241.04;9.69;745;61;3292.00;123
8714;60;628518272;8714;160;9458;9581;9.73;0.59;241.08;9.69;744;61;3293.00;123
8716;60;628518289;8716;157;9460;9584;9.93;0.60;241.06;9.69;744;61;3294.00;124
8719;60;628518306;8719;155;9460;9584;10.01;0.61;241.10;9.69;741;61;3295.00;124
8723;60;628518323;8723;154;9461;9584;10.06;0.61;241.18;9.69;738;61;3296.00;123
8724;60;628518339;8724;154;9461;9584;10.15;0.62;241.20;9.69;737;61;3297.00;123
8726;60;628518363;8726;151;9464;9588;10.29;0.62;241.21;9.68;738;61;3298.00;124
8728;60;628518380;8728;149;9464;9588;10.40;0.63;241.21;9.68;736;61;3299.00;124
8730;60;628518402;8730;148;9468;9607;10.50;0.64;241.22;9.68;738;61;3300.00;139
8734;60;628518427;8734;147;9469;9607;10.58;0.64;241.20;9.68;735;61;3301.00;138
8737;60;628518446;8737;143;9469;9608;10.68;0.65;241.21;9.68;732;61;3302.00;139
8740;61;628518465;8740;134;9470;9609;10.82;0.66;241.22;9.68;730;62;3303.00;139
8741;61;628518496;8741;132;9470;9609;10.89;0.66;241.22;9.68;729;62;3304.00;139
8744;61;628518514;8744;135;9472;9610;11.01;0.67;241.22;9.68;728;62;3305.00;138
8746;61;628518530;8746;134;9472;9610;11.13;0.68;241.22;9.68;726;62;3306.00;138
8749;61;628518556;8749;134;9473;9610;11.22;0.68;241.23;9.68;724;62;3307.00;137
8753;61;628518570;8753;136;9473;9610;11.35;0.69;241.27;9.68;720;62;3308.00;137
8755;61;628518585;8755;133;9473;9610;11.52;0.70;241.28;9.68;718;62;3309.00;137
8757;61;628518609;8757;129;9473;9610;11.68;0.71;241.30;9.68;716;62;3310.00;137
8759;61;628518626;8759;134;9474;9610;11.75;0.72;241.33;9.68;715;62;3311.00;136
8763;61;628518641;8763;152;9542;9737;11.49;0.71;241.33;9.61;779;62;3312.00;195
8766;61;628518663;8766;147;9546;9738;11.47;0.71;241.35;9.61;780;62;3313.00;192
8773;61;628518682;8773;137;9550;9738;11.55;0.71;241.38;9.60;777;62;3314.00;188
8775;61;628518700;8775;140;9550;9738;11.68;0.72;241.39;9.60;775;62;3315.00;188
8779;61;628518712;8779;137;9554;9738;11.72;0.72;241.40;9.75;775;62;3316.00;184
8784;61;628518725;8784;136;9556;9738;11.70;0.72;241.41;9.75;772;62;3317.00;182
8787;61;628518736;8787;136;9559;9738;11.72;0.72;241.41;9.75;772;62;3318.00;179
8789;61;628518747;8789;141;9561;9738;11.78;0.72;241.44;9.75;772;62;3319.00;177
8791;61;628518759;8791;146;9562;9739;11.86;0.73;241.47;9.75;771;62;3320.00;177
8793;61;628518771;8793;144;9565;9740;11.80;0.72;241.51;9.75;772;62;3321.00;175
8798;61;628518783;8798;148;9565;9740;11.69;0.71;241.52;9.75;767;62;3322.00;175
8802;61;628518795;8802;153;9569;9741;11.67;0.71;241.52;9.75;767;62;3323.00;172
8804;61;628518806;8804;155;9573;9741;11.65;0.71;241.53;9.75;769;62;3324.00;168
8809;61;628518819;8809;156;9576;9741;11.67;0.71;241.55;9.76;767;62;3325.00;165
8813;61;628518831;8813;157;9579;9741;11.61;0.71;241.60;9.76;766;62;3326.00;162
8816;61;628518843;8816;159;9582;9745;11.54;0.70;241.62;9.76;766;62;3327.00;163
8819;61;628518854;8819;165;9585;9745;11.40;0.70;241.64;9.76;766;62;3328.00;160
8822;61;628518871;8822;163;9588;9745;11.35;0.69;241.67;9.76;766;62;3329.00;157
8827;61;628518885;8827;161;9591;9751;11.30;0.69;241.65;9.76;764;62;3330.00;160
8835;61;628518897;8835;161;9592;9751;11.32;0.69;241.66;9.76;757;62;3331.00;159
8838;61;628518910;8838;158;9594;9751;11.28;0.69;241.65;9.76;756;62;3332.00;157
8840;61;628518921;8840;158;9599;9755;11.19;0.68;241.67;9.76;759;62;3333.00;156
8842;61;628518933;8842;154;9601;9756;11.19;0.68;241.66;9.76;759;62;3334.00;155
8843;61;628518944;8843;153;9604;9756;11.15;0.68;241.68;9.79;761;62;3335.00;152
8846;61;628518956;8846;151;9605;9760;11.22;0.68;241.68;9.79;759;62;3336.00;155
8852;61;628518968;8852;153;9607;9760;11.23;0.68;241.66;9.79;755;62;3337.00;153
8854;61;628518980;8854;154;9608;9760;11.28;0.68;241.66;9.95;754;62;3338.00;152
8855;61;628518990;8855;154;9612;9761;11.27;0.68;241.64;9.95;757;62;3339.00;149
8858;61;628519002;8858;153;9614;9761;11.20;0.68;241.67;10.11;756;62;3340.00;147
8859;61;628519012;8859;142;9619;9767;11.21;0.68;241.67;10.11;760;62;3341.00;148
8860;61;628519024;8860;142;9620;9767;11.23;0.68;241.67;10.11;760;62;3342.00;147
8863;61;628519035;8863;139;9622;9768;11.16;0.68;241.69;10.26;759;62;3343.00;146
8866;61;628519046;8866;142;9623;9768;11.14;0.68;241.67;10.26;757;62;3344.00;145
8868;61;628519056;8868;143;9623;9768;11.09;0.67;241.67;10.26;755;62;3345.00;145
8872;61;628519067;8872;147;9625;9768;11.00;0.67;241.66;10.26;753;62;3346.00;143
8874;61;628519078;8874;149;9626;9768;10.90;0.66;241.68;10.26;752;62;3347.00;142
8875;61;628519089;8875;155;9634;9780;10.89;0.66;241.68;10.25;759;62;3348.00;146
8877;61;628519100;8877;154;9636;9780;10.86;0.66;241.76;10.25;759;62;3349.00;144
8882;61;628519117;8882;156;9639;9780;10.82;0.66;241.72;10.25;757;62;3350.00;141
8884;61;628519128;8884;155;9641;9780;10.78;0.65;241.80;10.25;757;62;3351.00;139
8886;61;628519138;8886;155;9642;9780;10.72;0.65;241.78;10.26;756;62;3352.00;138
8890;61;628519148;8890;157;9643;9780;10.65;0.65;241.80;10.26;753;62;3353.00;137
8894;61;628519159;8894;161;9646;9784;10.50;0.64;241.86;10.26;752;62;3354.00;138
8898;61;628519169;8898;166;9647;9784;10.42;0.63;241.87;10.26;749;62;3355.00;137
8903;61;628519179;8903;169;9650;9788;10.38;0.63;241.90;10.26;747;62;3356.00;138
8906;61;628519190;8906;172;9651;9789;10.40;0.63;241.91;10.25;745;62;3357.00;138
8907;61;628519200;8907;182;9652;9789;10.39;0.63;241.90;10.25;745;62;3358.00;137
8911;61;628519210;8911;194;9653;9789;10.32;0.62;241.91;10.26;742;62;3359.00;136
8913;61;628519223;8913;202;9672;9818;10.21;0.62;241.91;10.26;759;62;3360.00;146
8916;61;628519235;8916;207;9674;9818;10.09;0.61;241.98;10.26;758;62;3361.00;144
8918;61;628519245;8918;218;9678;9818;10.03;0.61;241.98;10.27;760;62;3362.00;140
8923;61;628519256;8923;220;9682;9819;9.97;0.60;241.97;10.28;759;62;3363.00;137
8924;61;628519266;8924;236;9682;9820;9.96;0.60;241.96;10.28;758;62;3364.00;138
8927;61;628519276;8927;240;9684;9820;9.93;0.60;241.98;10.30;757;62;3365.00;136
8928;61;628519292;8928;242;9687;9823;9.96;0.60;241.98;10.30;759;62;3366.00;136
8931;61;628519302;8931;252;9688;9823;9.90;0.60;242.00;10.31;757;62;3367.00;135
8934;61;628519312;8934;259;9689;9823;9.80;0.60;242.02;10.32;755;62;3368.00;134
8937;61;628519322;8937;262;9690;9823;9.71;0.59;241.99;10.33;753;62;3369.00;133
8938;61;628519331;8938;264;9695;9829;9.61;0.58;241.98;10.34;757;62;3370.00;134
8939;61;628519342;8939;265;9697;9829;9.47;0.58;242.00;10.35;758;62;3371.00;132
8940;61;628519351;8940;270;9698;9829;9.30;0.57;242.03;10.36;758;62;3372.00;131
8940;61;628519361;8940;269;9699;9829;9.18;0.56;242.03;10.37;759;62;3373.00;130
8941;61;628519370;8941;280;9703;9833;9.00;0.55;242.02;10.38;762;62;3374.00;130
8943;61;628519380;8943;282;9705;9835;8.86;0.54;242.06;10.38;762;62;3375.00;130
8943;61;628519390;8943;289;9706;9835;8.75;0.54;242.06;10.39;763;62;3376.00;129
8943;61;628519401;8943;297;9708;9836;8.63;0.53;242.06;10.40;765;62;3377.00;128
8945;61;628519410;8945;302;9709;9836;8.47;0.52;242.11;10.41;764;62;3378.00;127
8946;61;628519419;8946;302;9709;9836;8.34;0.51;242.10;10.41;763;62;3379.00;127
8949;61;628519428;8949;305;9711;9836;8.23;0.51;242.14;10.43;762;62;3380.00;125
8954;61;628519438;8954;307;9711;9836;8.14;0.50;242.09;10.43;757;62;3381.00;125
8958;61;628519448;8958;311;9713;9836;8.08;0.50;242.06;10.44;755;62;3382.00;123
8962;61;628519458;8962;312;9713;9836;7.96;0.49;241.99;10.44;751;62;3383.00;123
8963;61;628519467;8963;316;9750;9906;8.07;0.50;241.97;10.40;787;62;3384.00;156
8966;61;628519482;8966;316;9755;9907;7.90;0.49;241.94;10.42;789;62;3385.00;152
8969;61;628519492;8969;306;9765;9907;7.85;0.48;241.90;10.41;796;62;3386.00;142
8969;61;628519506;8969;310;9771;9907;7.79;0.48;241.90;10.42;802;62;3387.00;136
8972;61;628519515;8972;313;9774;9907;7.68;0.47;241.89;10.42;802;62;3388.00;133
8973;61;628519524;8973;316;9775;9907;7.62;0.47;241.90;10.42;802;62;3389.00;132
8977;61;628519534;8977;319;9777;9907;7.52;0.46;241.85;10.41;800;62;3390.00;130
8980;61;628519543;8980;327;9784;9907;7.35;0.45;241.84;10.45;804;62;3391.00;123
8983;61;628519552;8983;331;9787;9908;7.21;0.44;241.79;10.46;804;62;3392.00;121
8986;61;628519561;8986;333;9792;9909;7.09;0.44;241.77;10.47;806;62;3393.00;117
8990;61;628519570;8990;337;9792;9909;6.97;0.43;241.75;10.47;802;62;3394.00;117
8996;61;628519579;8996;340;9797;9913;6.87;0.42;241.76;10.47;801;62;3395.00;116
9000;61;628519588;9000;341;9798;9913;6.71;0.41;241.72;10.47;798;62;3396.00;115
9003;61;628519597;9003;344;9799;9913;6.55;0.40;241.74;10.48;796;62;3397.00;114
9009;61;628519606;9009;350;9799;9913;6.41;0.40;241.76;10.48;790;62;3398.00;114
9012;61;628519614;9012;359;9804;9919;6.36;0.39;241.77;10.48;792;62;3399.00;115
9016;61;628519624;9016;345;9805;9919;6.28;0.39;241.78;10.48;789;62;3400.00;114
9019;61;628519637;9019;343;9806;9919;6.19;0.38;241.76;10.48;787;62;3401.00;113
9021;61;628519646;9021;340;9810;9922;6.14;0.38;241.73;10.48;789;62;3402.00;112
9025;61;628519661;9025;345;9810;9922;6.05;0.37;241.82;10.48;785;62;3403.00;112
9026;61;628519669;9026;335;9811;9922;6.03;0.37;241.81;10.49;785;62;3404.00;111
9029;61;628519677;9029;333;9811;9923;5.99;0.37;241.78;10.49;782;62;3405.00;112
9029;61;628519686;9029;332;9813;9924;6.00;0.37;241.78;10.49;784;62;3406.00;111
9034;61;628519695;9034;333;9813;9924;5.97;0.37;241.77;10.49;779;62;3407.00;111
9039;61;628519704;9039;335;9823;9937;5.98;0.37;241.77;10.48;784;62;3408.00;114
9041;61;628519714;9041;334;9824;9937;6.02;0.37;241.76;10.48;783;62;3409.00;113
9044;61;628519723;9044;338;9824;9937;6.03;0.37;241.80;10.48;780;62;3410.00;113
9048;61;628519731;9048;312;9825;9938;6.10;0.37;241.79;10.47;777;62;3411.00;113
9049;61;628519741;9049;288;9826;9938;6.23;0.38;241.82;10.63;777;62;3412.00;112
9051;61;628519751;9051;281;9829;9942;6.41;0.39;241.83;10.62;778;62;3413.00;113
9053;61;628519760;9053;280;9830;9942;6.54;0.40;241.85;10.62;777;62;3414.00;112
9055;61;628519770;9055;276;9833;9946;6.77;0.41;241.87;10.62;778;62;3415.00;113
9057;61;628519779;9057;270;9833;9946;6.84;0.42;241.89;10.62;776;62;3416.00;113
9058;61;628519789;9058;266;9833;9946;6.98;0.43;241.87;10.62;775;62;3417.00;113
9061;61;628519804;9061;260;9833;9946;7.11;0.43;241.88;10.62;772;62;3418.00;113
9064;61;628519814;9064;257;9833;9946;7.21;0.44;241.89;10.62;769;62;3419.00;113
9065;61;628519825;9065;252;9858;9980;7.56;0.46;241.89;10.59;793;62;3420.00;122
9068;61;628519838;9068;254;9858;9980;7.66;0.47;241.92;10.59;790;62;3421.00;122
9069;61;628519849;9069;237;9860;9980;7.85;0.48;241.94;10.59;791;62;3422.00;120
9071;61;628519859;9071;232;9860;9980;8.01;0.49;241.95;10.59;789;62;3423.00;120
9077;61;628519873;9077;231;9861;9980;8.11;0.50;241.94;10.59;784;62;3424.00;119
9082;61;628519899;9082;226;9862;9980;8.12;0.50;242.01;10.59;780;62;3425.00;118
9083;61;628519927;9083;227;9862;9981;8.13;0.50;242.03;10.59;779;62;3426.00;119
9084;61;628519942;9084;225;9862;9981;8.21;0.50;242.04;10.59;778;62;3427.00;119
9087;61;628519958;9087;221;9866;9987;8.29;0.51;242.05;10.58;779;62;3428.00;121
9089;61;628519975;9089;222;9867;9988;8.36;0.51;242.04;10.58;778;62;3429.00;121
9092;61;628519988;9092;230;9868;9988;8.43;0.51;242.08;10.58;776;62;3430.00;120
9097;61;628519999;9097;226;9868;9988;8.46;0.52;242.13;10.58;771;62;3431.00;120
9103;61;628520012;9103;224;9871;9992;8.53;0.52;242.14;10.58;768;62;3432.00;121
9107;61;628520024;9107;226;9871;9992;8.53;0.52;242.13;10.58;764;62;3433.00;121
9108;61;628520036;9108;227;9871;9992;8.62;0.53;242.11;10.58;763;62;3434.00;121
9111;61;628520046;9111;225;9872;9993;8.69;0.53;242.08;10.58;761;62;3435.00;121
9116;61;628520058;9116;224;9875;9997;8.76;0.54;242.14;10.58;759;62;3436.00;122
9122;61;628520069;9122;222;9875;9997;8.77;0.54;242.15;10.58;753;62;3437.00;122
9128;61;628520088;9128;224;9877;10000;8.77;0.54;242.18;10.57;749;62;3438.00;123
9132;61;628520099;9132;222;9877;10000;8.73;0.53;242.21;10.57;745;62;3439.00;123
9138;61;628520110;9138;220;9878;10000;8.73;0.53;242.19;10.57;740;62;3440.00;122
9142;61;628520122;9142;221;9878;10000;8.77;0.54;242.19;10.57;736;62;3441.00;122
9146;61;628520132;9146;223;9881;10004;8.79;0.54;242.15;10.57;735;62;3442.00;123
9147;61;628520143;9147;221;9882;10004;8.83;0.54;242.16;10.57;735;62;3443.00;122
9152;61;628520155;9152;227;9882;10004;8.82;0.54;242.15;10.57;730;62;3444.00;122
9155;61;628520165;9155;226;9882;10004;8.85;0.54;242.17;10.57;727;62;3445.00;122
9159;61;628520176;9159;235;9882;10005;8.86;0.54;242.17;10.57;723;62;3446.00;123
9160;61;628520188;9160;224;9883;10006;8.95;0.54;242.17;10.57;723;62;3447.00;123
9161;61;628520201;9161;220;9883;10006;8.98;0.55;242.21;10.57;722;62;3448.00;123
9165;61;628520212;9165;212;9884;10007;8.98;0.55;242.30;10.57;719;62;3449.00;123
9169;61;628520226;9169;204;9884;10007;9.02;0.55;242.35;10.57;715;62;3450.00;123
9172;61;628520238;9172;202;9884;10007;9.07;0.55;242.35;10.57;712;62;3451.00;123
9177;61;628520249;9177;203;9884;10007;9.10;0.55;242.39;10.57;707;62;3452.00;123
9180;61;628520260;9180;193;9884;10007;9.17;0.56;242.37;10.57;704;62;3453.00;123
9184;61;628520271;9184;194;9884;10007;9.23;0.56;242.52;10.57;700;62;3454.00;123
9187;61;628520283;9187;189;9884;10007;9.30;0.57;242.57;10.57;697;62;3455.00;123
9187;61;628520300;9187;194;9958;10134;9.43;0.58;242.57;10.49;771;62;3456.00;176
9193;61;628520320;9193;171;9960;10135;9.58;0.59;242.63;10.49;767;62;3457.00;175
9196;61;628520332;9196;147;9967;10135;9.84;0.61;242.64;10.48;771;62;3458.00;168
9198;61;628520345;9198;136;9972;10135;10.06;0.62;242.71;10.48;774;62;3459.00;163
9201;61;628520356;9201;132;9975;10135;10.23;0.63;242.78;10.48;774;62;3460.00;160
9203;62;628520368;9203;124;9978;10135;10.38;0.64;242.79;10.47;775;63;3461.00;157
9209;62;628520389;9209;124;9983;10135;10.52;0.65;242.84;10.47;774;63;3462.00;152
9212;62;628520403;9212;122;9985;10135;10.58;0.65;242.88;10.47;773;63;3463.00;150
9220;62;628520416;9220;122;9989;10136;10.72;0.66;242.97;10.47;769;63;3464.00;147
9222;62;628520429;9222;119;9993;10138;10.72;0.66;242.97;10.47;771;63;3465.00;145
9225;62;628520441;9225;128;9995;10138;10.74;0.66;242.98;10.47;770;63;3466.00;143
9227;62;628520453;9227;123;9996;10139;10.78;0.66;242.98;10.47;769;63;3467.00;143
9232;62;628520465;9232;129;9997;10139;10.74;0.66;243.02;10.47;765;63;3468.00;142
9236;62;628520479;9236;134;9998;10139;10.73;0.66;243.06;10.47;762;63;3469.00;141
9237;62;628520502;9237;145;10000;10139;10.78;0.66;243.06;10.47;763;63;3470.00;139
9240;62;628520513;9240;148;10003;10143;10.83;0.66;243.10;10.47;763;63;3471.00;140
9243;62;628520526;9243;152;10005;10143;10.91;0.67;243.18;10.47;762;63;3472.00;138
9246;62;628520538;9246;151;10006;10143;10.91;0.67;243.21;10.47;760;63;3473.00;137
9250;62;628520550;9250;152;10008;10146;10.98;0.67;243.21;10.47;758;63;3474.00;138
9252;62;628520569;9252;152;10009;10146;11.09;0.68;243.23;10.47;757;63;3475.00;137
9258;62;628520581;9258;155;10010;10146;11.17;0.68;243.33;10.47;752;63;3476.00;136
9261;62;628520595;9261;155;10014;10150;11.18;0.68;243.33;10.46;753;63;3477.00;136
9265;62;628520607;9265;156;10016;10151;11.33;0.69;243.34;10.46;751;63;3478.00;135
9269;62;628520619;9269;157;10016;10151;11.43;0.70;243.37;10.46;747;63;3479.00;135
9272;63;628520633;9272;156;10020;10156;11.51;0.70;243.34;10.46;748;64;3480.00;136
9275;63;628520663;9275;158;10020;10156;11.59;0.70;243.39;10.46;745;64;3481.00;136
9276;63;628520675;9276;153;10020;10156;11.67;0.71;243.41;10.46;744;64;3482.00;136
9278;63;628520694;9278;152;10021;10157;11.65;0.71;243.46;10.46;743;64;3483.00;136
9281;63;628520705;9281;154;10021;10157;11.72;0.71;243.45;10.46;740;64;3484.00;136
9283;63;628520717;9283;157;10025;10163;11.69;0.71;243.47;10.45;742;64;3485.00;138
9287;63;628520740;9287;157;10025;10163;11.70;0.71;243.52;10.45;738;64;3486.00;138
9291;63;628520755;9291;152;10027;10164;11.65;0.71;243.49;10.60;736;64;3487.00;137
9294;63;628520769;9294;151;10027;10164;11.77;0.72;243.53;10.60;733;64;3488.00;137
9298;63;628520781;9298;151;10027;10164;11.87;0.72;243.54;10.60;729;64;3489.00;137
9300;63;628520792;9300;148;10027;10164;11.94;0.73;243.56;10.60;727;64;3490.00;137
9304;63;628520803;9304;149;10027;10164;11.91;0.72;243.62;10.60;723;64;3491.00;137
9307;63;628520815;9307;150;10037;10176;11.90;0.72;243.61;10.59;730;64;3492.00;139
9311;63;628520827;9311;150;10038;10176;12.00;0.73;243.59;10.59;727;64;3493.00;138
9314;63;628520838;9314;151;10038;10176;12.08;0.74;243.68;10.59;724;64;3494.00;138
9318;63;628520850;9318;149;10038;10176;12.18;0.74;243.72;10.59;720;64;3495.00;138
9320;63;628520860;9320;147;10038;10176;12.24;0.75;243.70;10.59;718;64;3496.00;138
9322;63;628520872;9322;142;10038;10176;12.19;0.74;243.72;10.59;716;64;3497.00;138
9327;63;628520888;9327;142;10041;10180;12.10;0.74;243.70;10.59;714;64;3498.00;139
9329;63;628520899;9329;138;10041;10180;12.09;0.74;243.70;10.59;712;64;3499.00;139
9334;63;628520911;9334;137;10044;10184;12.08;0.74;243.71;10.59;710;64;3500.00;140
9337;63;628520926;9337;141;10046;10185;12.09;0.74;243.69;10.59;709;64;3501.00;139
9344;63;628520937;9344;137;10046;10185;12.01;0.73;243.72;10.59;702;64;3502.00;139
9346;63;628520948;9346;137;10047;10185;11.97;0.73;243.76;10.74;701;64;3503.00;138
9351;64;628520958;9351;139;10056;10198;11.88;0.72;243.79;10.73;705;65;3504.00;142
9357;64;628520977;9357;131;10057;10198;11.84;0.72;243.84;10.74;700;65;3505.00;141
9358;64;628520993;9358;125;10058;10198;11.89;0.72;243.83;10.74;700;65;3506.00;140
9363;64;628521004;9363;124;10059;10199;11.90;0.72;243.84;10.74;696;65;3507.00;140
9364;64;628521014;9364;124;10059;10200;11.98;0.73;243.87;10.74;695;65;3508.00;141
9367;64;628521024;9367;118;10059;10200;11.97;0.72;243.91;10.74;692;65;3509.00;141
9372;64;628521036;9372;105;10062;10206;11.91;0.72;243.93;10.74;690;65;3510.00;144
9373;64;628521046;9373;107;10063;10206;11.94;0.72;243.91;10.73;690;65;3511.00;143
9376;64;628521056;9376;110;10064;10206;11.94;0.72;243.94;10.73;688;65;3512.00;142
9381;64;628521066;9381;111;10064;10206;11.97;0.73;243.91;10.73;683;65;3513.00;142
9385;64;628521076;9385;116;10069;10212;12.00;0.73;243.93;10.88;684;65;3514.00;143
9388;64;628521087;9388;116;10069;10212;12.01;0.73;243.96;10.88;681;65;3515.00;143
9390;64;628521097;9390;115;10070;10212;11.96;0.73;243.99;10.88;680;65;3516.00;142
9391;64;628521106;9391;112;10071;10212;11.90;0.72;243.99;10.88;680;65;3517.00;141
9393;64;628521116;9393;114;10076;10216;11.79;0.72;243.98;11.03;683;65;3518.00;140
9396;64;628521127;9396;114;10078;10219;11.69;0.71;243.99;11.02;682;65;3519.00;141
9397;64;628521137;9397;120;10079;10219;11.59;0.70;244.01;11.02;682;65;3520.00;140
9399;64;628521147;9399;122;10080;10220;11.54;0.70;243.99;11.02;681;65;3521.00;140
9401;64;628521156;9401;135;10081;10220;11.49;0.70;244.01;11.17;680;65;3522.00;139
9406;64;628521166;9406;141;10082;10220;11.44;0.69;244.04;11.18;676;65;3523.00;138
9406;64;628521177;9406;143;10082;10220;11.38;0.69;244.04;11.18;676;65;3524.00;138
9408;64;628521186;9408;149;10083;10220;11.30;0.69;244.03;11.19;675;65;3525.00;137
9412;64;628521202;9412;158;10083;10220;11.31;0.69;244.02;11.19;671;65;3526.00;137
9415;64;628521212;9415;165;10083;10220;11.25;0.68;243.99;11.19;668;65;3527.00;137
9416;64;628521221;9416;173;10119;10290;11.24;0.68;244.05;11.16;703;65;3528.00;171
9417;64;628521241;9417;174;10119;10291;11.12;0.68;244.04;11.16;702;65;3529.00;172
9417;64;628521251;9417;174;10130;10291;11.14;0.68;244.04;11.31;713;65;3530.00;161
9421;64;628521261;9421;178;10136;10291;11.09;0.68;244.02;11.32;715;65;3531.00;155
9424;64;628521271;9424;183;10140;10291;11.04;0.67;243.98;11.31;716;65;3532.00;151
9425;64;628521280;9425;188;10144;10291;10.96;0.67;243.98;11.33;719;65;3533.00;147
9428;64;628521290;9428;191;10147;10291;10.91;0.67;243.97;11.34;719;65;3534.00;144
9429;64;628521299;9429;200;10150;10291;10.82;0.66;243.95;11.35;721;65;3535.00;141
9431;64;628521315;9431;202;10153;10292;10.64;0.65;243.92;11.36;722;65;3536.00;139
9434;64;628521328;9434;209;10156;10293;10.52;0.64;243.91;11.37;722;65;3537.00;137
9438;64;628521340;9438;213;10160;10293;10.34;0.63;243.84;11.38;722;65;3538.00;133
9442;64;628521350;9442;214;10164;10297;10.10;0.62;243.82;11.39;722;65;3539.00;133
9444;64;628521362;9444;224;10166;10297;9.87;0.60;243.78;11.39;722;65;3540.00;131
9445;64;628521371;9445;229;10167;10297;9.68;0.59;243.77;11.41;722;65;3541.00;130
9446;64;628521379;9446;243;10168;10297;9.53;0.58;243.76;11.41;722;65;3542.00;129
9448;64;628521388;9448;253;10173;10303;9.44;0.58;243.74;11.42;725;65;3543.00;130
9449;64;628521398;9449;263;10173;10303;9.33;0.57;243.75;11.42;724;65;3544.00;130
9449;64;628521407;9449;274;10176;10303;9.18;0.56;243.75;11.44;727;65;3545.00;127
9453;64;628521415;9453;286;10178;10306;9.06;0.56;243.80;11.43;725;65;3546.00;128
9454;64;628521424;9454;296;10181;10306;8.81;0.54;243.78;11.45;727;65;3547.00;125
9456;64;628521432;9456;304;10181;10306;8.60;0.53;243.76;11.45;725;65;3548.00;125
9457;64;628521441;9457;304;10182;10307;8.39;0.52;243.75;11.45;725;65;3549.00;125
9462;64;628521450;9462;304;10184;10308;8.19;0.50;243.70;11.46;722;65;3550.00;124
9463;64;628521458;9463;306;10184;10308;8.03;0.49;243.67;11.46;721;65;3551.00;124
9464;64;628521468;9464;306;10197;10321;7.88;0.48;243.75;11.46;733;65;3552.00;124
9465;64;628521483;9465;312;10197;10321;7.73;0.48;243.73;11.46;732;65;3553.00;124
9465;64;628521491;9465;310;10198;10321;7.60;0.47;243.73;11.46;733;65;3554.00;123
9466;64;628521499;9466;317;10201;10323;7.53;0.46;243.71;11.47;735;65;3555.00;122
9470;64;628521508;9470;320;10201;10323;7.42;0.45;243.65;11.47;731;65;3556.00;122
9473;64;628521516;9473;324;10204;10327;7.43;0.45;243.62;11.46;731;65;3557.00;123
9474;64;628521525;9474;326;10205;10327;7.36;0.45;243.62;11.48;731;65;3558.00;122
9477;64;628521533;9477;325;10210;10331;7.31;0.45;243.57;11.48;733;65;3559.00;121
9478;64;628521542;9478;324;10211;10331;7.16;0.44;243.57;11.49;733;65;3560.00;120
9480;64;628521550;9480;328;10212;10331;6.98;0.43;243.58;11.50;732;65;3561.00;119
9481;64;628521558;9481;331;10212;10331;6.88;0.42;243.58;11.50;731;65;3562.00;119
9484;64;628521566;9484;319;10215;10331;6.76;0.41;243.56;11.53;731;65;3563.00;116
9484;64;628521579;9484;310;10225;10343;6.89;0.42;243.56;11.52;741;65;3564.00;118
9489;64;628521588;9489;299;10226;10343;6.80;0.42;243.55;11.53;737;65;3565.00;117
9492;64;628521597;9492;302;10227;10343;6.77;0.42;243.59;11.53;735;65;3566.00;116
9492;64;628521605;9492;296;10230;10343;6.80;0.42;243.59;11.55;738;65;3567.00;113
9495;64;628521613;9495;291;10230;10343;6.75;0.42;243.61;11.55;735;65;3568.00;113
9498;64;628521621;9498;291;10230;10343;6.70;0.41;243.66;11.55;732;65;3569.00;113
9501;64;628521631;9501;278;10231;10344;6.66;0.41;243.64;11.56;730;65;3570.00;113
9506;64;628521639;9506;267;10231;10344;6.68;0.41;243.65;11.56;725;65;3571.00;113
9507;64;628521647;9507;264;10238;10350;6.80;0.42;243.64;11.57;731;65;3572.00;112
9512;64;628521656;9512;267;10239;10351;6.90;0.42;243.65;11.57;727;65;3573.00;112
9515;65;628521666;9515;255;10240;10351;6.99;0.43;243.64;11.57;725;66;3574.00;111
9518;65;628521685;9518;252;10242;10351;7.04;0.43;243.64;11.58;724;66;3575.00;109
9521;65;628521694;9521;253;10245;10355;7.13;0.44;243.66;11.57;724;66;3576.00;110
9524;65;628521713;9524;242;10246;10355;7.17;0.44;243.62;11.58;722;66;3577.00;109
9526;65;628521722;9526;236;10246;10355;7.29;0.45;243.64;11.58;720;66;3578.00;109
9528;65;628521737;9528;232;10247;10356;7.51;0.46;243.64;11.58;719;66;3579.00;109
9530;65;628521747;9530;227;10250;10360;7.70;0.47;243.66;11.57;720;66;3580.00;110
9533;65;628521757;9533;220;10250;10360;7.86;0.48;243.67;11.57;717;66;3581.00;110
9534;65;628521767;9534;215;10253;10363;7.99;0.49;243.67;11.71;719;66;3582.00;110
9537;65;628521777;9537;212;10254;10363;8.08;0.49;243.69;11.71;717;66;3583.00;109
9542;65;628521786;9542;214;10254;10363;8.14;0.50;243.68;11.71;712;66;3584.00;109
9544;65;628521801;9544;213;10254;10363;8.21;0.50;243.68;11.71;710;66;3585.00;109
9547;65;628521811;9547;204;10257;10367;8.32;0.51;243.70;11.70;710;66;3586.00;110
9552;65;628521820;9552;202;10257;10367;8.34;0.51;243.75;11.70;705;66;3587.00;110
9558;65;628521830;9558;195;10258;10367;8.34;0.51;243.75;11.70;700;66;3588.00;109
9559;65;628521840;9559;192;10258;10367;8.45;0.51;243.74;11.70;699;66;3589.00;109
9563;65;628521848;9563;182;10258;10368;8.49;0.52;243.76;11.70;695;66;3590.00;110
9568;65;628521859;9568;176;10259;10369;8.62;0.53;243.73;11.70;691;66;3591.00;110
9574;65;628521873;9574;176;10259;10369;8.67;0.53;243.74;11.70;685;66;3592.00;110
9580;65;628521888;9580;176;10260;10370;8.74;0.53;243.75;11.70;680;66;3593.00;110
9583;65;628521904;9583;173;10260;10370;8.76;0.53;243.81;11.70;677;66;3594.00;110
9587;65;628521920;9587;179;10260;10370;8.73;0.53;243.85;11.70;673;66;3595.00;110
9592;65;628521935;9592;178;10260;10370;8.70;0.53;243.82;11.70;668;66;3596.00;110
9595;65;628521949;9595;182;10260;10370;8.76;0.54;243.82;11.70;665;66;3597.00;110
9600;65;628521963;9600;189;10260;10370;8.76;0.54;243.83;11.70;660;66;3598.00;110
9604;65;628521978;9604;184;10260;10370;8.82;0.54;243.82;11.70;656;66;3599.00;110
9610;65;628521992;9610;212;10375;10623;8.97;0.56;243.85;11.57;765;66;3600.00;248
9612;65;628522028;9612;205;10382;10624;9.05;0.57;243.84;11.56;770;66;3601.00;242
9615;65;628522041;9615;197;10394;10624;9.23;0.58;243.85;11.55;779;66;3602.00;230
9622;65;628522054;9622;193;10399;10624;9.24;0.58;243.84;11.55;777;66;3603.00;225
9625;65;628522067;9625;188;10405;10624;9.29;0.58;243.85;11.54;780;66;3604.00;219
9630;65;628522079;9630;189;10412;10624;9.27;0.58;243.80;11.54;782;66;3605.00;212
9633;65;628522092;9633;189;10418;10624;9.26;0.57;243.83;11.54;785;66;3606.00;206
9637;65;628522104;9637;193;10423;10624;9.23;0.57;243.84;11.53;786;66;3607.00;201
9639;65;628522115;9639;193;10429;10625;9.25;0.57;243.87;11.53;790;66;3608.00;196
9643;65;628522127;9643;193;10434;10626;9.26;0.57;243.89;11.53;791;66;3609.00;192
9647;65;628522139;9647;202;10436;10626;9.24;0.57;243.94;11.53;789;66;3610.00;190
9649;65;628522151;9649;212;10443;10627;9.16;0.57;243.98;11.53;794;66;3611.00;184
9654;65;628522163;9654;207;10447;10627;9.07;0.56;244.02;11.53;793;66;3612.00;180
9658;65;628522175;9658;208;10449;10627;9.04;0.56;244.06;11.53;791;66;3613.00;178
9659;65;628522187;9659;209;10452;10627;9.05;0.56;244.04;11.53;793;66;3614.00;175
9662;65;628522199;9662;214;10455;10631;9.13;0.56;244.10;11.53;793;66;3615.00;176
9665;65;628522211;9665;221;10457;10631;9.09;0.56;244.13;11.53;792;66;3616.00;174
9668;65;628522230;9668;218;10460;10631;9.09;0.56;244.15;11.53;792;66;3617.00;171
9673;65;628522249;9673;215;10461;10634;9.14;0.56;244.15;11.53;788;66;3618.00;173
9675;65;628522268;9675;216;10462;10634;9.16;0.56;244.15;11.53;787;66;3619.00;172
9678;65;628522280;9678;214;10463;10634;9.22;0.57;244.17;11.53;785;66;3620.00;171
9682;65;628522292;9682;215;10469;10638;9.20;0.56;244.15;11.53;787;66;3621.00;169
9684;65;628522306;9684;217;10473;10639;9.29;0.57;244.13;11.53;789;66;3622.00;166
9689;65;628522326;9689;216;10473;10639;9.42;0.58;244.21;11.53;784;66;3623.00;166
9691;65;628522342;9691;221;10477;10643;9.53;0.58;244.24;11.53;786;66;3624.00;166
9694;65;628522355;9694;218;10478;10643;9.65;0.59;244.25;11.53;784;66;3625.00;165
9699;65;628522368;9699;206;10480;10643;9.75;0.60;244.24;11.53;781;66;3626.00;163
9702;65;628522382;9702;196;10482;10644;9.83;0.60;244.25;11.53;780;66;3627.00;162
9704;65;628522402;9704;186;10482;10644;10.02;0.61;244.30;11.53;778;66;3628.00;162
9707;65;628522415;9707;179;10486;10650;10.20;0.62;244.30;11.53;779;66;3629.00;164
9710;65;628522431;9710;176;10486;10650;10.34;0.63;244.29;11.53;776;66;3630.00;164
9715;65;628522446;9715;168;10487;10651;10.47;0.64;244.27;11.53;772;66;3631.00;164
9719;65;628522459;9719;165;10488;10651;10.60;0.65;244.29;11.54;769;66;3632.00;163
9723;65;628522473;9723;162;10489;10651;10.75;0.65;244.27;11.54;766;66;3633.00;162
9729;65;628522486;9729;164;10490;10651;10.82;0.66;244.28;11.54;761;66;3634.00;161
9730;65;628522504;9730;163;10490;10651;10.97;0.67;244.26;11.54;760;66;3635.00;161
9731;65;628522518;9731;160;10500;10663;11.10;0.67;244.28;11.53;769;66;3636.00;163
9733;65;628522538;9733;160;10500;10663;11.26;0.68;244.26;11.53;767;66;3637.00;163
9738;65;628522551;9738;155;10502;10663;11.36;0.69;244.30;11.53;764;66;3638.00;161
9741;65;628522564;9741;153;10502;10663;11.48;0.70;244.30;11.53;761;66;3639.00;161
9743;65;628522577;9743;150;10503;10663;11.55;0.70;244.31;11.53;760;66;3640.00;160
9745;65;628522592;9745;152;10503;10663;11.59;0.70;244.38;11.53;758;66;3641.00;160
9747;65;628522605;9747;155;10506;10667;11.61;0.70;244.40;11.53;759;66;3642.00;161
9749;65;628522619;9749;156;10506;10667;11.70;0.71;244.41;11.53;757;66;3643.00;161
9752;65;628522631;9752;157;10512;10671;11.74;0.71;244.48;11.53;760;66;3644.00;159
9755;65;628522643;9755;160;10516;10673;11.75;0.71;244.48;11.53;761;66;3645.00;157
9757;65;628522655;9757;166;10516;10673;11.79;0.71;244.49;11.53;759;66;3646.00;157
9759;65;628522668;9759;167;10516;10673;11.80;0.72;244.53;11.53;757;66;3647.00;157
9762;65;628522684;9762;171;10525;10686;11.90;0.72;244.49;11.52;763;66;3648.00;161
9766;65;628522697;9766;166;10525;10686;11.89;0.72;244.48;11.52;759;66;3649.00;161
9768;65;628522714;9768;168;10525;10686;11.86;0.72;244.51;11.52;757;66;3650.00;161
9768;65;628522725;9768;173;10526;10687;11.88;0.72;244.51;11.52;758;66;3651.00;161
9769;65;628522737;9769;178;10526;10688;11.94;0.73;244.53;11.52;757;66;3652.00;162
9774;65;628522748;9774;180;10526;10688;11.90;0.72;244.55;11.52;752;66;3653.00;162
9774;65;628522760;9774;183;10528;10691;11.84;0.72;244.55;11.51;754;66;3654.00;163
9778;65;628522771;9778;183;10528;10691;11.68;0.71;244.56;11.51;750;66;3655.00;163
9780;65;628522782;9780;182;10529;10691;11.57;0.70;244.55;11.51;749;66;3656.00;162
9783;65;628522793;9783;177;10529;10691;11.50;0.70;244.60;11.51;746;66;3657.00;162
9785;65;628522804;9785;176;10533;10697;11.42;0.70;244.64;11.51;748;66;3658.00;164
9789;65;628522821;9789;177;10534;10697;11.43;0.70;244.66;11.65;745;66;3659.00;163
9795;65;628522836;9795;177;10535;10697;11.41;0.69;244.63;11.65;740;66;3660.00;162
9798;65;628522848;9798;175;10535;10697;11.37;0.69;244.60;11.65;737;66;3661.00;162
9799;65;628522858;9799;175;10538;10701;11.27;0.69;244.62;11.65;739;66;3662.00;163
9804;65;628522871;9804;172;10539;10702;11.17;0.68;244.64;11.65;735;66;3663.00;163
9809;65;628522884;9809;173;10539;10702;11.10;0.68;244.68;11.65;730;66;3664.00;163
9812;65;628522897;9812;172;10540;10703;11.11;0.67;244.67;11.64;728;66;3665.00;163
9815;65;628522909;9815;179;10540;10703;11.12;0.68;244.67;11.64;725;66;3666.00;163
9816;65;628522920;9816;181;10540;10703;11.11;0.68;244.68;11.64;724;66;3667.00;163
9816;65;628522930;9816;186;10540;10703;11.13;0.68;244.68;11.64;724;66;3668.00;163
9818;65;628522944;9818;190;10541;10703;11.10;0.68;244.69;11.65;723;66;3669.00;162
9823;65;628522953;9823;189;10541;10703;11.10;0.68;244.67;11.65;718;66;3670.00;162
9828;65;628522964;9828;191;10541;10703;11.04;0.67;244.62;11.65;713;66;3671.00;162
9830;65;628522975;9830;195;10571;10773;10.95;0.67;244.62;11.62;741;66;3672.00;202
9834;65;628522990;9834;186;10572;10774;10.89;0.67;244.63;11.76;738;66;3673.00;202
9838;65;628523000;9838;188;10580;10774;10.94;0.67;244.64;11.75;742;66;3674.00;194
9841;65;628523010;9841;186;10584;10774;10.93;0.67;244.65;11.78;743;66;3675.00;190
9841;65;628523022;9841;181;10589;10774;11.00;0.67;244.65;11.78;748;66;3676.00;185
9844;65;628523033;9844;178;10592;10774;11.01;0.67;244.64;11.78;748;66;3677.00;182
9848;65;628523043;9848;175;10596;10774;11.02;0.67;244.66;11.92;748;66;3678.00;178
9853;65;628523053;9853;167;10598;10774;11.03;0.67;244.59;11.92;745;66;3679.00;176
9857;65;628523064;9857;161;10601;10775;11.03;0.67;244.57;11.92;744;66;3680.00;174
9860;65;628523074;9860;150;10603;10776;11.02;0.67;244.55;11.91;743;66;3681.00;173
9861;65;628523084;9861;149;10604;10776;11.00;0.67;244.55;11.91;743;66;3682.00;172
9862;65;628523095;9862;143;10607;10780;10.89;0.66;244.54;11.91;745;66;3683.00;173
9863;65;628523106;9863;142;10608;10780;10.78;0.66;244.55;12.05;745;66;3684.00;172
9864;65;628523116;9864;148;10608;10780;10.75;0.65;244.55;12.05;744;66;3685.00;172
9866;65;628523127;9866;147;10608;10780;10.74;0.65;244.54;12.05;742;66;3686.00;172
9868;65;628523136;9868;152;10613;10786;10.74;0.65;244.51;12.20;745;66;3687.00;173
9874;65;628523148;9874;161;10614;10786;10.71;0.65;244.54;12.20;740;66;3688.00;172
9875;65;628523157;9875;166;10615;10786;10.61;0.65;244.57;12.34;740;66;3689.00;171
9877;65;628523169;9877;170;10621;10792;10.57;0.64;244.54;12.35;744;66;3690.00;171
9878;65;628523180;9878;182;10621;10792;10.53;0.64;244.53;12.35;743;66;3691.00;171
9882;65;628523190;9882;188;10625;10792;10.38;0.63;244.51;12.35;743;66;3692.00;167
9885;65;628523200;9885;195;10627;10793;10.32;0.63;244.46;12.50;742;66;3693.00;166
9889;65;628523210;9889;202;10629;10794;10.27;0.62;244.43;12.49;740;66;3694.00;165
9890;65;628523220;9890;207;10631;10794;10.18;0.62;244.41;12.50;741;66;3695.00;163
9892;65;628523230;9892;218;10641;10807;10.03;0.61;244.40;12.64;749;66;3696.00;166
9893;65;628523241;9893;224;10641;10807;9.94;0.61;244.37;12.64;748;66;3697.00;166
9894;65;628523251;9894;230;10643;10807;9.84;0.60;244.36;12.65;749;66;3698.00;164
9896;65;628523262;9896;234;10645;10808;9.74;0.59;244.32;12.65;749;66;3699.00;163
9897;65;628523272;9897;242;10648;10808;9.57;0.58;244.32;12.67;751;66;3700.00;160
9899;65;628523287;9899;249;10651;10812;9.46;0.58;244.43;12.68;752;66;3701.00;161
9901;65;628523297;9901;252;10656;10812;9.35;0.57;244.43;12.70;755;66;3702.00;156
9901;65;628523311;9901;259;10660;10816;9.22;0.56;244.43;12.70;759;66;3703.00;156
9903;65;628523324;9903;269;10660;10816;9.07;0.55;244.42;12.70;757;66;3704.00;156
9908;65;628523338;9908;272;10662;10816;8.88;0.54;244.35;12.72;754;66;3705.00;154
9910;65;628523350;9910;281;10663;10816;8.72;0.53;244.32;12.73;753;66;3706.00;153
9913;65;628523362;9913;290;10664;10816;8.60;0.53;244.31;12.75;751;66;3707.00;152
9914;65;628523372;9914;289;10676;10828;8.55;0.52;244.30;12.76;762;66;3708.00;152
9919;65;628523384;9919;291;10677;10828;8.39;0.51;244.33;12.75;758;66;3709.00;151
9922;65;628523394;9922;303;10678;10828;8.28;0.51;244.27;12.76;756;66;3710.00;150
9924;65;628523403;9924;313;10679;10828;8.21;0.50;244.24;12.78;755;66;3711.00;149
9925;65;628523412;9925;318;10682;10828;8.11;0.50;244.23;12.80;757;66;3712.00;146
9926;65;628523422;9926;323;10683;10828;8.01;0.49;244.25;12.81;757;66;3713.00;145
9926;65;628523431;9926;329;10684;10829;7.91;0.48;244.25;12.82;758;66;3714.00;145
9927;65;628523439;9927;325;10687;10829;7.80;0.48;244.23;12.84;760;66;3715.00;142
9930;65;628523449;9930;323;10691;10835;7.81;0.48;244.21;12.84;761;66;3716.00;144
9930;65;628523459;9930;320;10695;10836;7.81;0.48;244.21;12.85;765;66;3717.00;141
9932;65;628523468;9932;321;10696;10836;7.75;0.48;244.20;12.85;764;66;3718.00;140
9934;65;628523480;9934;316;10698;10836;7.66;0.47;244.17;12.87;764;66;3719.00;138
9934;65;628523492;9934;314;10701;10841;7.65;0.47;244.17;12.87;767;66;3720.00;140
9935;66;628523504;9935;305;10704;10841;7.62;0.47;244.16;12.89;769;67;3721.00;137
9936;66;628523535;9936;305;10704;10841;7.67;0.47;244.15;12.89;768;67;3722.00;137
9937;66;628523546;9937;299;10706;10842;7.70;0.47;244.22;12.89;769;67;3723.00;136
9938;66;628523557;9938;296;10711;10846;7.68;0.47;244.21;12.90;773;67;3724.00;135
9940;66;628523573;9940;293;10711;10846;7.71;0.47;244.19;12.90;771;67;3725.00;135
9941;66;628523583;9941;285;10713;10849;7.78;0.48;244.17;12.90;772;67;3726.00;136
9943;66;628523598;9943;280;10714;10849;7.82;0.48;244.18;12.90;771;67;3727.00;135
9944;66;628523608;9944;286;10717;10849;7.88;0.48;244.16;12.93;773;67;3728.00;132
9946;66;628523618;9946;286;10717;10849;7.91;0.48;244.16;12.93;771;67;3729.00;132
9946;66;628523633;9946;280;10723;10853;7.94;0.49;244.16;12.95;777;67;3730.00;130
9946;66;628523649;9946;285;10724;10853;7.94;0.49;244.16;12.95;778;67;3731.00;129
9952;66;628523658;9952;285;10725;10853;7.77;0.48;244.19;12.96;773;67;3732.00;128
9955;66;628523667;9955;285;10727;10853;7.65;0.47;244.16;12.97;772;67;3733.00;126
9957;66;628523676;9957;279;10727;10854;7.61;0.46;244.13;12.97;770;67;3734.00;127
9961;66;628523686;9961;281;10729;10856;7.54;0.46;244.11;12.97;768;67;3735.00;127
9963;66;628523701;9963;281;10731;10856;7.52;0.46;244.12;12.98;768;67;3736.00;125
9967;66;628523712;9967;278;10732;10857;7.49;0.46;244.14;12.98;765;67;3737.00;125
9973;66;628523722;9973;284;10733;10857;7.40;0.45;244.09;12.98;760;67;3738.00;124
9976;66;628523731;9976;283;10734;10857;7.26;0.44;244.12;12.99;758;67;3739.00;123
9978;66;628523740;9978;271;10734;10857;7.22;0.44;244.16;12.99;756;67;3740.00;123
9981;66;628523749;9981;271;10736;10857;7.15;0.44;244.13;13.00;755;67;3741.00;121
9986;66;628523758;9986;265;10736;10857;7.16;0.44;244.23;13.00;750;67;3742.00;121
9992;66;628523767;9992;261;10737;10857;7.09;0.43;244.23;13.00;745;67;3743.00;120
9995;66;628523776;9995;276;10803;10984;7.39;0.46;244.29;12.92;808;67;3744.00;181
9999;66;628523794;9999;272;10807;10985;7.43;0.46;244.31;12.92;808;67;3745.00;178
10001;66;628523804;10001;271;10817;10985;7.52;0.47;244.30;12.92;816;67;3746.00;168
10006;66;628523813;10006;260;10820;10985;7.62;0.47;244.32;12.91;814;67;3747.00;165
10009;66;628523822;10009;253;10826;10985;7.76;0.48;244.31;12.91;817;67;3748.00;159
10014;66;628523833;10014;243;10831;10985;7.85;0.49;244.28;12.91;817;67;3749.00;154
10019;66;628523845;10019;238;10837;10990;7.91;0.49;244.28;12.91;818;67;3750.00;153
10023;66;628523861;10023;240;10842;10990;7.96;0.49;244.27;13.05;819;67;3751.00;148
10024;66;628523875;10024;239;10848;10991;7.98;0.49;244.28;13.05;824;67;3752.00;143
10029;66;628523891;10029;235;10851;10992;8.00;0.49;244.32;13.05;822;67;3753.00;141
10030;66;628523910;10030;237;10854;10992;8.10;0.50;244.37;13.05;824;67;3754.00;138
10035;66;628523927;10035;236;10855;10993;8.11;0.50;244.38;13.04;820;67;3755.00;138
10038;66;628523943;10038;240;10857;10993;8.25;0.51;244.38;13.04;819;67;3756.00;136
10041;66;628523959;10041;236;10858;10993;8.37;0.52;244.38;13.04;817;67;3757.00;135
10045;66;628523976;10045;226;10860;10993;8.55;0.53;244.39;13.04;815;67;3758.00;133
10050;66;628523992;10050;221;10863;10997;8.64;0.53;244.44;13.04;813;67;3759.00;134
10054;66;628524006;10054;211;10866;10997;8.64;0.53;244.46;13.04;812;67;3760.00;131
10058;66;628524019;10058;209;10867;10997;8.61;0.53;244.47;13.04;809;67;3761.00;130
10062;66;628524032;10062;204;10869;11000;8.67;0.53;244.50;13.04;807;67;3762.00;131
10068;66;628524045;10068;204;10869;11000;8.66;0.53;244.50;13.04;801;67;3763.00;131
10070;66;628524058;10070;209;10869;11000;8.69;0.53;244.53;13.04;799;67;3764.00;131
10075;66;628524071;10075;205;10872;11004;8.73;0.53;244.54;13.04;797;67;3765.00;132
10079;66;628524084;10079;209;10874;11005;8.75;0.53;244.59;13.04;795;67;3766.00;131
10084;66;628524097;10084;212;10874;11005;8.70;0.53;244.56;13.04;790;67;3767.00;131
10089;66;628524115;10089;217;10876;11009;8.70;0.53;244.55;13.03;787;67;3768.00;133
10092;66;628524128;10092;216;10878;11009;8.72;0.53;244.53;13.03;786;67;3769.00;131
10097;66;628524140;10097;219;10879;11009;8.76;0.53;244.52;13.03;782;67;3770.00;130
10101;66;628524152;10101;224;10880;11010;8.76;0.53;244.56;13.03;779;67;3771.00;130
10107;66;628524164;10107;228;10881;11010;8.76;0.53;244.57;13.03;774;67;3772.00;129
10110;66;628524176;10110;224;10884;11016;8.76;0.53;244.58;13.03;774;67;3773.00;132
10113;66;628524202;10113;222;10885;11016;8.80;0.53;244.58;13.03;772;67;3774.00;131
10117;66;628524213;10117;222;10886;11017;8.87;0.54;244.58;13.02;769;67;3775.00;131
10122;66;628524225;10122;221;10886;11017;8.94;0.54;244.64;13.02;764;67;3776.00;131
10126;66;628524243;10126;225;10886;11017;9.03;0.55;244.72;13.02;760;67;3777.00;131
10129;66;628524256;10129;227;10886;11017;9.04;0.55;244.74;13.02;757;67;3778.00;131
10132;66;628524268;10132;226;10886;11017;9.07;0.55;244.74;13.02;754;67;3779.00;131
10137;66;628524281;10137;235;10909;11053;9.22;0.56;244.73;13.00;772;67;3780.00;144
10141;66;628524296;10141;233;10910;11053;9.17;0.56;244.74;13.00;769;67;3781.00;143
10143;66;628524308;10143;237;10912;11053;9.23;0.56;244.75;12.99;769;67;3782.00;141
10145;66;628524320;10145;241;10913;11053;9.20;0.56;244.77;12.99;768;67;3783.00;140
10150;66;628524331;10150;240;10914;11053;9.24;0.57;244.82;12.99;764;67;3784.00;139
10152;66;628524346;10152;242;10914;11053;9.22;0.56;244.82;12.99;762;67;3785.00;139
10152;66;628524358;10152;244;10918;11057;9.28;0.57;244.82;12.99;766;67;3786.00;139
10157;66;628524370;10157;230;10918;11057;9.31;0.57;244.83;12.99;761;67;3787.00;139
10161;66;628524381;10161;225;10921;11061;9.35;0.58;244.92;12.99;760;67;3788.00;140
10168;66;628524394;10168;217;10922;11062;9.42;0.58;244.92;12.98;754;67;3789.00;140
10170;66;628524407;10170;214;10923;11062;9.45;0.58;244.94;12.98;753;67;3790.00;139
10174;66;628524419;10174;210;10925;11062;9.46;0.58;244.96;13.13;751;67;3791.00;137
10179;66;628524431;10179;208;10936;11075;9.49;0.58;244.97;13.12;757;67;3792.00;139
10184;66;628524445;10184;210;10936;11075;9.49;0.58;244.98;13.12;752;67;3793.00;139
10188;66;628524457;10188;211;10937;11075;9.53;0.58;245.02;13.12;749;67;3794.00;138
10195;66;628524469;10195;211;10938;11076;9.50;0.58;245.09;13.12;743;67;3795.00;138
10197;66;628524481;10197;190;10938;11077;9.55;0.58;245.09;13.12;741;67;3796.00;139
10200;66;628524494;10200;178;10938;11077;9.58;0.58;245.09;13.12;738;67;3797.00;139
10204;66;628524506;10204;172;10941;11080;9.64;0.59;245.10;13.11;737;67;3798.00;139
10208;66;628524518;10208;168;10941;11080;9.72;0.59;245.13;13.11;733;67;3799.00;139
10210;66;628524531;10210;162;10941;11080;9.83;0.60;245.12;13.11;731;67;3800.00;139
10214;66;628524547;10214;161;10941;11080;9.92;0.60;245.16;13.11;727;67;3801.00;139
10217;66;628524560;10217;158;10945;11086;10.01;0.61;245.16;13.11;728;67;3802.00;141
10219;66;628524572;10219;154;10945;11086;10.11;0.62;245.17;13.11;726;67;3803.00;141
10221;66;628524584;10221;148;10946;11086;10.22;0.62;245.23;13.11;725;67;3804.00;140
10224;66;628524596;10224;149;10946;11086;10.31;0.63;245.25;13.11;722;67;3805.00;140
10225;66;628524608;10225;148;10949;11090;10.35;0.63;245.27;13.10;724;67;3806.00;141
10229;66;628524620;10229;146;10950;11091;10.36;0.63;245.30;13.10;721;67;3807.00;141
10231;66;628524640;10231;153;10950;11091;10.36;0.63;245.32;13.10;719;67;3808.00;141
10234;66;628524651;10234;151;10951;11092;10.42;0.63;245.34;13.10;717;67;3809.00;141
10237;66;628524665;10237;147;10951;11092;10.43;0.63;245.35;13.10;714;67;3810.00;141
10240;66;628524676;10240;154;10951;11092;10.47;0.64;245.35;13.10;711;67;3811.00;141
10241;66;628524688;10241;155;10951;11092;10.48;0.64;245.33;13.10;710;67;3812.00;141
10247;66;628524699;10247;156;10951;11092;10.50;0.64;245.40;13.10;704;67;3813.00;141
10249;66;628524711;10249;158;10951;11092;10.54;0.64;245.38;13.10;702;67;3814.00;141
10252;66;628524724;10252;161;10951;11092;10.52;0.64;245.40;13.10;699;67;3815.00;141
10258;66;628524741;10258;176;10989;11162;10.41;0.63;245.39;13.06;731;67;3816.00;173
10259;66;628524762;10259;170;10991;11163;10.48;0.64;245.40;13.05;732;67;3817.00;172
10260;66;628524774;10260;170;10995;11163;10.58;0.64;245.39;13.05;735;67;3818.00;168
10264;66;628524785;10264;167;11000;11163;10.62;0.65;245.36;13.05;736;67;3819.00;163
10265;66;628524802;10265;164;11005;11163;10.68;0.65;245.40;13.04;740;67;3820.00;158
10269;66;628524814;10269;163;11010;11163;10.73;0.65;245.45;13.04;741;67;3821.00;153
10271;67;628524825;10271;171;11012;11163;10.82;0.66;245.46;13.04;741;68;3822.00;151
10273;67;628524843;10273;176;11013;11163;10.89;0.66;245.43;13.04;740;68;3823.00;150
10277;67;628524854;10277;185;11015;11164;10.97;0.67;245.43;13.04;738;68;3824.00;149
10278;67;628524870;10278;184;11017;11166;10.99;0.67;245.47;13.03;739;68;3825.00;149
10279;67;628524882;10279;184;11018;11166;10.89;0.66;245.46;13.03;739;68;3826.00;148
10283;67;628524893;10283;189;11021;11170;10.80;0.66;245.46;13.03;738;68;3827.00;149
10285;67;628524905;10285;189;11021;11170;10.76;0.66;245.48;13.03;736;68;3828.00;149
10288;67;628524916;10288;195;11021;11170;10.74;0.66;245.47;13.03;733;68;3829.00;149
10290;67;628524926;10290;199;11021;11170;10.74;0.66;245.44;13.03;731;68;3830.00;149
10291;67;628524936;10291;202;11024;11176;10.72;0.66;245.48;13.03;733;68;3831.00;152
10292;67;628524947;10292;206;11024;11176;10.67;0.65;245.47;13.03;732;68;3832.00;152
10295;67;628524957;10295;207;11025;11176;10.73;0.66;245.48;13.03;730;68;3833.00;151
10298;67;628524967;10298;206;11027;11179;10.77;0.66;245.45;13.02;729;68;3834.00;152
10301;67;628524977;10301;208;11027;11179;10.70;0.65;245.42;13.02;726;68;3835.00;152
10303;67;628524988;10303;208;11028;11179;10.65;0.65;245.43;13.02;725;68;3836.00;151
10310;67;628524997;10310;211;11028;11180;10.56;0.64;245.39;13.02;718;68;3837.00;152
10314;67;628525007;10314;210;11029;11181;10.50;0.64;245.36;13.02;715;68;3838.00;152
10319;67;628525016;10319;208;11029;11181;10.46;0.64;245.35;13.02;710;68;3839.00;152
10323;67;628525028;10323;207;11044;11207;10.32;0.63;245.33;13.00;721;68;3840.00;163
10328;67;628525039;10328;201;11044;11207;10.30;0.63;245.28;13.00;716;68;3841.00;163
10328;67;628525048;10328;196;11046;11207;10.34;0.63;245.28;13.00;718;68;3842.00;161
10332;67;628525058;10332;195;11049;11208;10.29;0.62;245.23;13.00;717;68;3843.00;159
10335;67;628525068;10335;196;11049;11208;10.27;0.62;245.20;13.00;714;68;3844.00;159
10338;67;628525077;10338;197;11052;11212;10.33;0.63;245.24;13.01;714;68;3845.00;160
10340;67;628525087;10340;200;11054;11214;10.33;0.63;245.23;13.01;714;68;3846.00;160
10343;67;628525097;10343;197;11058;11218;10.31;0.63;245.21;13.16;715;68;3847.00;160
10349;67;628525114;10349;194;11059;11218;10.29;0.62;245.16;13.16;710;68;3848.00;159
10353;67;628525123;10353;196;11059;11218;10.26;0.62;245.11;13.16;706;68;3849.00;159
10354;67;628525133;10354;200;11059;11218;10.32;0.63;245.10;13.16;705;68;3850.00;159
10355;67;628525142;10355;194;11059;11218;10.36;0.63;245.08;13.16;704;68;3851.00;159
10357;67;628525151;10357;188;11069;11230;10.25;0.62;245.06;13.15;712;68;3852.00;161
10358;67;628525162;10358;187;11069;11230;10.18;0.62;245.06;13.15;711;68;3853.00;161
10360;67;628525171;10360;186;11070;11230;10.10;0.61;245.06;13.14;710;68;3854.00;160
10361;67;628525180;10361;183;11070;11230;10.14;0.62;245.04;13.14;709;68;3855.00;160
10366;67;628525188;10366;190;11070;11230;10.14;0.61;245.04;13.14;704;68;3856.00;160
10369;67;628525197;10369;195;11071;11230;10.17;0.62;245.01;13.15;702;68;3857.00;159
10370;67;628525206;10370;201;11071;11231;10.18;0.62;245.00;13.15;701;68;3858.00;160
10371;67;628525215;10371;206;11071;11231;10.18;0.62;244.98;13.15;700;68;3859.00;160
10374;67;628525229;10374;205;11076;11237;10.10;0.61;244.97;13.15;702;68;3860.00;161
10376;67;628525239;10376;210;11079;11238;10.07;0.61;244.95;13.14;703;68;3861.00;159
10376;67;628525248;10376;220;11080;11238;10.02;0.61;244.95;13.15;704;68;3862.00;158
10378;67;628525257;10378;220;11081;11238;9.93;0.60;244.92;13.14;703;68;3863.00;157
10379;67;628525267;10379;225;11084;11242;9.93;0.60;244.92;13.14;705;68;3864.00;158
10383;67;628525276;10383;224;11084;11242;9.90;0.60;244.88;13.14;701;68;3865.00;158
10384;67;628525285;10384;232;11086;11242;9.85;0.60;244.87;13.15;702;68;3866.00;156
10385;67;628525294;10385;223;11087;11243;9.80;0.59;244.87;13.15;702;68;3867.00;156
10388;67;628525305;10388;221;11091;11247;9.75;0.59;244.91;13.15;703;68;3868.00;156
10390;67;628525318;10390;215;11091;11247;9.76;0.59;244.92;13.15;701;68;3869.00;156
10390;67;628525331;10390;209;11096;11253;9.75;0.59;244.92;13.17;706;68;3870.00;157
10391;67;628525350;10391;206;11097;11253;9.77;0.59;244.91;13.17;706;68;3871.00;156
10391;67;628525364;10391;203;11098;11253;9.80;0.60;244.91;13.17;707;68;3872.00;155
10392;67;628525373;10392;198;11099;11253;9.80;0.60;244.90;13.18;707;68;3873.00;154
10392;67;628525389;10392;196;11103;11257;9.94;0.60;244.90;13.19;711;68;3874.00;154
10393;68;628525398;10393;192;11104;11257;9.99;0.61;244.90;13.20;711;69;3875.00;153
10398;68;628525419;10398;192;11106;11257;9.99;0.61;244.88;13.21;708;69;3876.00;151
10400;68;628525429;10400;189;11106;11257;9.92;0.60;244.85;13.21;706;69;3877.00;151
10400;68;628525438;10400;190;11109;11258;9.78;0.59;244.85;13.23;709;69;3878.00;149
10402;68;628525447;10402;192;11110;11259;9.74;0.59;244.85;13.23;708;69;3879.00;149
10402;68;628525457;10402;200;11111;11259;9.65;0.59;244.85;13.25;709;69;3880.00;148
10403;68;628525466;10403;198;11114;11260;9.51;0.58;244.85;13.28;711;69;3881.00;146
10403;68;628525476;10403;209;11114;11260;9.45;0.58;244.85;13.28;711;69;3882.00;146
10403;68;628525485;10403;210;11116;11260;9.39;0.57;244.85;13.30;713;69;3883.00;144
10404;69;628525494;10404;220;11116;11260;9.29;0.57;244.84;13.30;712;70;3884.00;144
10404;69;628525513;10404;223;11118;11260;9.22;0.57;244.84;13.32;714;70;3885.00;142
10404;69;628525523;10404;226;11118;11260;9.22;0.57;244.84;13.32;714;70;3886.00;142
10407;69;628525537;10407;231;11120;11260;9.14;0.56;244.84;13.33;713;70;3887.00;140
10409;69;628525552;10409;256;11186;11387;9.14;0.57;244.83;13.26;777;70;3888.00;201
10411;69;628525570;10411;251;11189;11388;9.05;0.56;244.85;13.27;778;70;3889.00;199
10413;69;628525580;10413;243;11197;11388;9.04;0.56;244.84;13.26;784;70;3890.00;191
10417;69;628525589;10417;241;11204;11388;8.94;0.56;244.91;13.26;787;70;3891.00;184
10418;69;628525600;10418;241;11211;11388;8.94;0.56;244.90;13.25;793;70;3892.00;177
10421;69;628525610;10421;232;11217;11388;9.00;0.56;244.89;13.26;796;70;3893.00;171
10424;69;628525619;10424;230;11223;11388;8.94;0.56;244.87;13.27;799;70;3894.00;165
10424;69;628525634;10424;234;11226;11388;8.94;0.56;244.87;13.29;802;70;3895.00;162
10430;69;628525644;10430;236;11231;11389;8.95;0.56;244.87;13.28;801;70;3896.00;158
10434;69;628525655;10434;242;11236;11390;8.89;0.55;244.84;13.31;802;70;3897.00;154
10439;69;628525665;10439;239;11240;11390;8.84;0.55;244.85;13.30;801;70;3898.00;150
10441;69;628525675;10441;235;11241;11391;8.74;0.54;244.87;13.30;800;70;3899.00;150
10443;69;628525688;10443;242;11249;11406;8.55;0.53;244.85;13.32;806;70;3900.00;157
10447;69;628525705;10447;242;11249;11406;8.39;0.52;244.84;13.32;802;70;3901.00;157
10455;69;628525715;10455;242;11253;11406;8.18;0.51;244.82;13.34;798;70;3902.00;153
10455;69;628525727;10455;253;11256;11410;8.14;0.50;244.82;13.34;801;70;3903.00;154
10460;69;628525737;10460;256;11259;11410;8.08;0.50;244.87;13.34;799;70;3904.00;151
10466;69;628525747;10466;266;11260;11410;7.95;0.49;244.95;13.35;794;70;3905.00;150
10472;69;628525758;10472;264;11264;11413;7.84;0.48;244.93;13.34;792;70;3906.00;149
10480;69;628525769;10480;267;11265;11413;7.66;0.47;244.91;13.35;785;70;3907.00;148
10484;69;628525778;10484;271;11267;11413;7.49;0.46;244.90;13.35;783;70;3908.00;146
10487;69;628525788;10487;275;11270;11417;7.43;0.46;244.89;13.35;783;70;3909.00;147
10492;69;628525798;10492;265;11273;11418;7.43;0.46;244.91;13.37;781;70;3910.00;145
10496;69;628525808;10496;265;11274;11418;7.38;0.45;244.93;13.37;778;70;3911.00;144
10498;69;628525818;10498;263;11277;11422;7.53;0.46;244.96;13.36;779;70;3912.00;145
10505;69;628525829;10505;258;11279;11422;7.55;0.46;245.01;13.38;774;70;3913.00;143
10508;69;628525839;10508;261;11280;11422;7.67;0.47;245.02;13.38;772;70;3914.00;142
10509;69;628525849;10509;261;11284;11424;7.85;0.48;245.01;13.39;775;70;3915.00;140
10513;69;628525859;10513;259;11285;11424;7.96;0.49;245.03;13.39;772;70;3916.00;139
10519;69;628525869;10519;250;11290;11430;8.00;0.49;245.06;13.40;771;70;3917.00;140
10521;69;628525886;10521;252;11290;11430;8.11;0.50;245.03;13.40;769;70;3918.00;140
10525;69;628525905;10525;248;11290;11431;8.16;0.50;245.09;13.40;765;70;3919.00;141
10527;69;628525929;10527;241;11291;11431;8.26;0.51;245.12;13.40;764;70;3920.00;140
10532;69;628525944;10532;233;11291;11431;8.35;0.51;245.09;13.40;759;70;3921.00;140
10538;69;628525960;10538;233;11292;11431;8.36;0.51;245.13;13.40;754;70;3922.00;139
10541;69;628525976;10541;231;11292;11431;8.51;0.52;245.16;13.40;751;70;3923.00;139
10544;69;628525990;10544;227;11300;11443;8.68;0.53;245.16;13.39;756;70;3924.00;143
10549;69;628526005;10549;221;11301;11443;8.66;0.53;245.16;13.39;752;70;3925.00;142
10554;69;628526019;10554;215;11302;11443;8.68;0.53;245.24;13.39;748;70;3926.00;141
10557;69;628526032;10557;213;11302;11443;8.70;0.53;245.25;13.39;745;70;3927.00;141
10561;69;628526044;10561;210;11304;11443;8.73;0.53;245.27;13.39;743;70;3928.00;139
10565;69;628526058;10565;206;11304;11443;8.77;0.53;245.28;13.39;739;70;3929.00;139
10569;69;628526072;10569;205;11307;11447;8.82;0.54;245.35;13.39;738;70;3930.00;140
10573;69;628526084;10573;201;11308;11447;8.83;0.54;245.34;13.39;735;70;3931.00;139
10578;69;628526096;10578;195;11310;11451;8.94;0.54;245.34;13.39;732;70;3932.00;141
10582;69;628526110;10582;195;11311;11452;9.03;0.55;245.38;13.39;729;70;3933.00;141
10585;69;628526122;10585;202;11313;11452;9.04;0.55;245.39;13.39;728;70;3934.00;139
10590;69;628526134;10590;199;11314;11452;9.05;0.55;245.42;13.39;724;70;3935.00;138
10596;69;628526146;10596;199;11324;11465;9.03;0.55;245.50;13.38;728;70;3936.00;141
10599;69;628526160;10599;197;11325;11465;9.06;0.55;245.48;13.38;726;70;3937.00;140
10605;69;628526170;10605;193;11326;11465;9.03;0.55;245.48;13.38;721;70;3938.00;139
10608;69;628526182;10608;199;11328;11466;9.17;0.56;245.51;13.38;720;70;3939.00;138
10612;69;628526195;10612;199;11328;11467;9.29;0.57;245.60;13.38;716;70;3940.00;139
10615;69;628526208;10615;200;11329;11467;9.35;0.57;245.64;13.38;714;70;3941.00;138
10621;69;628526220;10621;198;11332;11470;9.45;0.58;245.68;13.38;711;70;3942.00;138
10625;69;628526232;10625;195;11333;11470;9.47;0.58;245.68;13.38;708;70;3943.00;137
10630;69;628526245;10630;199;11333;11470;9.51;0.58;245.73;13.38;703;70;3944.00;137
10633;69;628526258;10633;204;11334;11470;9.54;0.58;245.78;13.37;701;70;3945.00;136
10636;69;628526271;10636;210;11338;11476;9.57;0.59;245.81;13.37;702;70;3946.00;138
10641;69;628526284;10641;212;11338;11476;9.54;0.58;245.80;13.37;697;70;3947.00;138
10644;69;628526297;10644;217;11339;11476;9.51;0.58;245.78;13.37;695;70;3948.00;137
10648;69;628526308;10648;217;11339;11476;9.49;0.58;245.81;13.37;691;70;3949.00;137
10654;69;628526320;10654;217;11342;11480;9.49;0.58;245.82;13.37;688;70;3950.00;138
10658;69;628526334;10658;220;11343;11481;9.47;0.58;245.80;13.36;685;70;3951.00;138
10661;69;628526346;10661;219;11343;11481;9.38;0.57;245.80;13.36;682;70;3952.00;138
10664;69;628526359;10664;220;11344;11482;9.33;0.57;245.81;13.36;680;70;3953.00;138
10668;69;628526371;10668;221;11344;11482;9.22;0.56;245.85;13.36;676;70;3954.00;138
10670;69;628526382;10670;229;11344;11482;9.22;0.56;245.84;13.36;674;70;3955.00;138
10676;69;628526393;10676;238;11344;11482;9.16;0.56;245.90;13.36;668;70;3956.00;138
10681;69;628526405;10681;230;11344;11482;9.15;0.56;245.89;13.36;663;70;3957.00;138
10684;69;628526418;10684;226;11344;11482;9.06;0.55;245.90;13.36;660;70;3958.00;138
10689;69;628526429;10689;221;11344;11482;8.87;0.54;245.87;13.36;655;70;3959.00;138
10691;69;628526443;10691;238;11414;11607;8.76;0.54;245.89;13.44;723;70;3960.00;193
10692;69;628526470;10692;232;11416;11608;8.68;0.54;245.90;13.44;724;70;3961.00;192
10695;69;628526481;10695;220;11420;11608;8.71;0.54;245.91;13.43;725;70;3962.00;188
10699;69;628526499;10699;220;11423;11608;8.77;0.54;245.98;13.43;724;70;3963.00;185
10704;69;628526509;10704;219;11427;11608;8.84;0.55;245.98;13.43;723;70;3964.00;181
10706;69;628526521;10706;221;11429;11608;8.96;0.55;245.99;13.43;723;70;3965.00;179
10710;69;628526533;10710;209;11434;11608;9.01;0.56;246.02;13.42;724;70;3966.00;174
10717;69;628526551;10717;200;11436;11608;9.05;0.56;246.07;13.42;719;70;3967.00;172
10718;69;628526563;10718;190;11441;11609;9.16;0.56;246.09;13.42;723;70;3968.00;168
10723;69;628526573;10723;193;11445;11610;9.15;0.56;246.13;13.42;722;70;3969.00;165
10727;69;628526584;10727;195;11446;11610;9.10;0.56;246.16;13.42;719;70;3970.00;164
10731;69;628526596;10731;197;11452;11614;9.07;0.55;246.19;13.41;721;70;3971.00;162
10734;69;628526608;10734;197;11453;11614;9.01;0.55;246.20;13.41;719;70;3972.00;161
10736;69;628526619;10736;188;11453;11614;9.02;0.55;246.20;13.41;717;70;3973.00;161
10738;69;628526631;10738;190;11454;11614;9.07;0.56;246.20;13.41;716;70;3974.00;160
10742;69;628526643;10742;187;11458;11620;9.12;0.56;246.24;13.41;716;70;3975.00;162
10744;69;628526656;10744;194;11458;11620;9.20;0.56;246.24;13.41;714;70;3976.00;162
10747;69;628526667;10747;186;11460;11620;9.22;0.56;246.26;13.41;713;70;3977.00;160
10750;69;628526677;10750;189;11462;11623;9.29;0.57;246.24;13.40;712;70;3978.00;161
10752;69;628526690;10752;185;11463;11623;9.40;0.57;246.23;13.40;711;70;3979.00;160
10754;69;628526700;10754;183;11463;11623;9.55;0.58;246.21;13.40;709;70;3980.00;160
10755;69;628526711;10755;183;11463;11624;9.64;0.59;246.22;13.40;708;70;3981.00;161
10758;69;628526722;10758;183;11464;11625;9.69;0.59;246.22;13.40;706;70;3982.00;161
10759;69;628526733;10759;180;11464;11625;9.74;0.59;246.20;13.40;705;70;3983.00;161
10759;69;628526743;10759;186;11474;11638;9.77;0.59;246.20;13.39;715;70;3984.00;164
10759;69;628526754;10759;189;11474;11638;9.76;0.59;246.20;13.39;715;70;3985.00;164
10761;70;628526765;10761;192;11474;11638;9.82;0.60;246.25;13.39;713;71;3986.00;164
10763;70;628526796;10763;194;11475;11639;9.92;0.60;246.24;13.39;712;71;3987.00;164
10764;70;628526807;10764;198;11475;11639;9.95;0.61;246.23;13.39;711;71;3988.00;164
10765;70;628526818;10765;200;11478;11643;10.04;0.61;246.22;13.39;713;71;3989.00;165
10765;70;628526830;10765;204;11479;11643;10.10;0.62;246.22;13.39;714;71;3990.00;164
10770;70;628526840;10770;203;11482;11647;10.06;0.61;246.19;13.38;712;71;3991.00;165
10771;70;628526852;10771;205;11482;11647;10.08;0.61;246.18;13.38;711;71;3992.00;165
10772;70;628526861;10772;210;11482;11647;10.12;0.62;246.18;13.38;710;71;3993.00;165
10773;70;628526871;10773;208;11482;11647;10.14;0.62;246.17;13.38;709;71;3994.00;165
10775;70;628526888;10775;209;11482;11647;10.18;0.62;246.18;13.38;707;71;3995.00;165
10777;70;628526898;10777;210;11492;11659;10.21;0.62;246.17;13.37;715;71;3996.00;167
10778;70;628526909;10778;211;11493;11659;10.29;0.63;246.16;13.37;715;71;3997.00;166
10780;70;628526919;10780;213;11493;11659;10.32;0.63;246.13;13.37;713;71;3998.00;166
10782;70;628526930;10782;216;11493;11659;10.30;0.63;246.10;13.37;711;71;3999.00;166
10785;70;628526940;10785;213;11493;11659;10.26;0.63;246.07;13.37;708;71;4000.00;166
10789;70;628526953;10789;214;11493;11659;10.19;0.62;246.03;13.37;704;71;4001.00;166
10790;70;628526963;10790;216;11493;11660;10.21;0.62;246.02;13.37;703;71;4002.00;167
10791;70;628526972;10791;219;11493;11660;10.21;0.62;246.01;13.37;702;71;4003.00;167
10795;70;628526981;10795;216;11497;11666;10.19;0.62;245.98;13.36;702;71;4004.00;169
10799;70;628526991;10799;214;11500;11668;10.20;0.62;245.95;13.36;701;71;4005.00;168
10801;70;628527000;10801;216;11500;11668;10.22;0.62;245.92;13.36;699;71;4006.00;168
10804;70;628527009;10804;218;11501;11668;10.20;0.62;245.88;13.52;697;71;4007.00;167
10809;70;628527018;10809;221;11504;11672;10.13;0.62;245.87;13.52;695;71;4008.00;168
10810;70;628527027;10810;220;11504;11672;10.09;0.61;245.85;13.52;694;71;4009.00;168
10811;70;628527036;10811;219;11504;11672;10.04;0.61;245.84;13.52;693;71;4010.00;168
10814;70;628527044;10814;218;11505;11673;10.04;0.61;245.84;13.52;691;71;4011.00;168
10816;70;628527053;10816;215;11509;11677;9.94;0.61;245.83;13.67;693;71;4012.00;168
10819;70;628527061;10819;209;11509;11677;9.86;0.60;245.81;13.67;690;71;4013.00;168
10822;70;628527070;10822;213;11512;11680;9.85;0.60;245.83;13.83;690;71;4014.00;168
10822;70;628527079;10822;213;11515;11680;9.79;0.59;245.83;13.86;693;71;4015.00;165
10823;70;628527094;10823;209;11515;11680;9.84;0.60;245.88;13.86;692;71;4016.00;165
10826;70;628527103;10826;207;11516;11680;9.90;0.60;245.88;14.01;690;71;4017.00;164
10831;70;628527112;10831;207;11519;11684;10.04;0.61;245.87;14.01;688;71;4018.00;165
10834;70;628527121;10834;192;11519;11684;10.14;0.62;245.90;14.01;685;71;4019.00;165
10835;70;628527132;10835;172;11521;11684;10.26;0.62;245.88;14.15;686;71;4020.00;163
10836;70;628527143;10836;157;11521;11684;10.39;0.63;245.86;14.15;685;71;4021.00;163
10840;70;628527152;10840;148;11522;11685;10.48;0.64;245.84;14.30;682;71;4022.00;163
10840;70;628527162;10840;138;11523;11686;10.67;0.65;245.84;14.30;683;71;4023.00;163
10841;70;628527171;10841;132;11524;11686;10.83;0.66;245.83;14.44;683;71;4024.00;162
10843;70;628527181;10843;127;11525;11687;10.89;0.66;245.83;14.44;682;71;4025.00;162
10845;70;628527201;10845;126;11525;11687;10.93;0.66;245.80;14.44;680;71;4026.00;162
10846;70;628527211;10846;122;11526;11687;10.96;0.66;245.81;14.45;680;71;4027.00;161
10848;70;628527220;10848;112;11526;11687;10.98;0.66;245.79;14.45;678;71;4028.00;161
10849;70;628527229;10849;110;11526;11687;11.04;0.67;245.78;14.45;677;71;4029.00;161
10850;70;628527239;10850;116;11527;11687;11.02;0.67;245.79;14.59;677;71;4030.00;160
10852;70;628527249;10852;116;11527;11687;11.01;0.67;245.77;14.59;675;71;4031.00;160
10852;70;628527258;10852;127;11589;11814;10.94;0.67;245.77;14.51;737;71;4032.00;225
10853;70;628527283;10853;123;11593;11815;10.93;0.67;245.77;14.51;740;71;4033.00;222
10853;70;628527293;10853;122;11601;11815;11.05;0.68;245.77;14.50;748;71;4034.00;214
10854;70;628527303;10854;117;11606;11815;11.08;0.68;245.76;14.50;752;71;4035.00;209
10855;70;628527313;10855;117;11612;11815;11.22;0.69;245.76;14.49;757;71;4036.00;203
10856;70;628527324;10856;123;11615;11815;11.23;0.69;245.75;14.49;759;71;4037.00;200
10856;70;628527335;10856;124;11620;11815;11.22;0.69;245.75;14.48;764;71;4038.00;195
10858;70;628527345;10858;130;11622;11815;11.15;0.68;245.74;14.62;764;71;4039.00;193
10863;70;628527356;10863;140;11628;11816;11.11;0.68;245.72;14.65;765;71;4040.00;188
10864;70;628527367;10864;147;11630;11817;11.10;0.68;245.73;14.65;766;71;4041.00;187
10867;70;628527378;10867;157;11635;11817;11.05;0.67;245.79;14.66;768;71;4042.00;182
10869;70;628527389;10869;159;11637;11818;10.95;0.67;245.82;14.66;768;71;4043.00;181
10870;70;628527400;10870;165;11642;11818;10.81;0.66;245.81;14.67;772;71;4044.00;176
10872;70;628527411;10872;175;11645;11818;10.71;0.66;245.79;14.68;773;71;4045.00;173
10875;70;628527422;10875;184;11651;11818;10.58;0.65;245.81;14.71;776;71;4046.00;167
10877;70;628527432;10877;194;11655;11822;10.47;0.64;245.81;14.71;778;71;4047.00;167
10879;70;628527443;10879;199;11657;11822;10.32;0.63;245.81;14.71;778;71;4048.00;165
10880;70;628527453;10880;208;11659;11822;10.19;0.63;245.81;14.73;779;71;4049.00;163
10886;70;628527465;10886;214;11664;11828;10.07;0.62;245.79;14.73;778;71;4050.00;164
10888;70;628527477;10888;220;11666;11828;9.95;0.61;245.82;14.75;778;71;4051.00;162
10892;70;628527493;10892;224;11667;11828;9.93;0.61;245.78;14.75;775;71;4052.00;161
10895;70;628527503;10895;240;11672;11832;9.80;0.60;245.79;14.77;777;71;4053.00;160
10899;70;628527519;10899;248;11674;11833;9.75;0.60;245.81;14.77;775;71;4054.00;159
10902;70;628527530;10902;248;11677;11833;9.64;0.59;245.84;14.79;775;71;4055.00;156
10907;70;628527540;10907;253;11680;11837;9.60;0.59;245.84;14.78;773;71;4056.00;157
10910;70;628527550;10910;257;11682;11837;9.50;0.58;245.82;14.79;772;71;4057.00;155
10912;70;628527560;10912;260;11684;11837;9.40;0.57;245.81;14.80;772;71;4058.00;153
10914;70;628527570;10914;253;11686;11838;9.27;0.57;245.81;14.81;772;71;4059.00;152
10915;70;628527580;10915;256;11686;11838;9.16;0.56;245.80;14.81;771;71;4060.00;152
10918;70;628527591;10918;252;11692;11844;9.05;0.55;245.80;14.83;774;71;4061.00;152
10920;70;628527605;10920;254;11692;11844;8.95;0.55;245.81;14.83;772;71;4062.00;152
10922;70;628527614;10922;256;11695;11845;8.77;0.54;245.80;14.84;773;71;4063.00;150
10925;70;628527630;10925;256;11695;11845;8.69;0.53;245.80;14.84;770;71;4064.00;150
10927;70;628527641;10927;255;11695;11845;8.70;0.53;245.80;14.84;768;71;4065.00;150
10931;70;628527652;10931;257;11697;11845;8.59;0.53;245.79;14.86;766;71;4066.00;148
10935;70;628527663;10935;258;11698;11845;8.53;0.52;245.76;14.87;763;71;4067.00;147
10938;70;628527673;10938;262;11709;11857;8.53;0.52;245.74;14.86;771;71;4068.00;148
10944;70;628527684;10944;261;11711;11857;8.47;0.52;245.77;14.87;767;71;4069.00;146
10945;70;628527699;10945;262;11712;11857;8.44;0.52;245.76;14.87;767;71;4070.00;145
10948;70;628527708;10948;259;11712;11857;8.35;0.51;245.75;14.87;764;71;4071.00;145
10952;70;628527718;10952;260;11714;11857;8.28;0.51;245.74;14.88;762;71;4072.00;143
10953;70;628527727;10953;258;11714;11857;8.29;0.51;245.74;14.88;761;71;4073.00;143
10957;70;628527737;10957;257;11719;11861;8.21;0.50;245.73;14.89;762;71;4074.00;142
10960;70;628527746;10960;256;11719;11861;8.19;0.50;245.73;14.89;759;71;4075.00;142
10967;70;628527756;10967;266;11722;11865;8.20;0.50;245.75;14.88;755;71;4076.00;143
10971;70;628527766;10971;263;11724;11866;8.16;0.50;245.75;14.89;753;71;4077.00;142
10976;70;628527775;10976;268;11725;11866;8.05;0.49;245.78;14.89;749;71;4078.00;141
10979;70;628527785;10979;273;11728;11866;7.85;0.48;245.81;14.92;749;71;4079.00;138
10986;70;628527795;10986;273;11748;11895;7.63;0.47;245.85;14.89;762;71;4080.00;147
10990;70;628527807;10990;266;11748;11895;7.53;0.47;245.91;14.89;758;71;4081.00;147
10995;70;628527816;10995;262;11752;11895;7.53;0.47;245.93;14.90;757;71;4082.00;143
10999;70;628527825;10999;252;11755;11896;7.64;0.47;245.94;14.90;756;71;4083.00;141
11007;70;628527834;11007;250;11757;11897;7.73;0.48;245.97;14.90;750;71;4084.00;140
11010;70;628527844;11010;245;11757;11897;7.80;0.48;246.03;14.90;747;71;4085.00;140
11014;70;628527853;11014;239;11760;11900;7.84;0.48;246.08;14.90;746;71;4086.00;140
11020;70;628527863;11020;235;11760;11900;7.85;0.48;246.08;14.90;740;71;4087.00;140
11023;70;628527873;11023;231;11760;11900;7.86;0.48;246.12;14.90;737;71;4088.00;140
11028;70;628527887;11028;224;11760;11900;7.96;0.49;246.12;14.90;732;71;4089.00;140
11031;70;628527903;11031;221;11764;11906;8.06;0.50;246.15;14.89;733;71;4090.00;142
11036;70;628527918;11036;221;11765;11906;8.12;0.50;246.15;14.89;729;71;4091.00;141
11043;70;628527934;11043;229;11765;11906;8.16;0.50;246.14;14.89;722;71;4092.00;141
11046;70;628527950;11046;223;11765;11906;8.25;0.51;246.19;14.89;719;71;4093.00;141
11051;70;628527963;11051;219;11768;11910;8.34;0.51;246.18;14.89;717;71;4094.00;142
11057;70;628527979;11057;213;11770;11912;8.46;0.52;246.17;14.89;713;71;4095.00;142
11060;70;628527994;11060;210;11770;11912;8.59;0.53;246.17;14.89;710;71;4096.00;142
11065;70;628528005;11065;210;11771;11913;8.67;0.53;246.21;14.88;706;71;4097.00;142
11068;70;628528016;11068;209;11771;11913;8.79;0.54;246.21;14.88;703;71;4098.00;142
11071;70;628528026;11071;215;11771;11913;8.85;0.54;246.23;14.88;700;71;4099.00;142
11074;70;628528038;11074;207;11771;11913;8.90;0.54;246.23;14.88;697;71;4100.00;142
11077;70;628528053;11077;211;11771;11913;8.93;0.55;246.24;14.88;694;71;4101.00;142
11083;70;628528064;11083;208;11771;11913;8.94;0.55;246.28;14.88;688;71;4102.00;142
11090;70;628528075;11090;211;11771;11913;8.92;0.54;246.24;14.88;681;71;4103.00;142
11092;70;628528086;11092;214;11812;11983;8.82;0.54;246.26;14.83;720;71;4104.00;171
11099;70;628528103;11099;206;11812;11984;8.82;0.54;246.21;14.83;713;71;4105.00;172
11103;70;628528114;11103;197;11817;11984;9.04;0.55;246.27;14.83;714;71;4106.00;167
11105;70;628528125;11105;193;11821;11984;9.24;0.56;246.28;14.82;716;71;4107.00;163
11112;70;628528142;11112;198;11826;11984;9.35;0.57;246.31;14.82;714;71;4108.00;158
11114;70;628528153;11114;203;11828;11984;9.43;0.57;246.30;14.82;714;71;4109.00;156
11120;70;628528165;11120;205;11831;11984;9.45;0.57;246.28;14.82;711;71;4110.00;153
11122;70;628528177;11122;208;11832;11984;9.54;0.58;246.25;14.81;710;71;4111.00;152
11124;70;628528188;11124;213;11834;11985;9.53;0.58;246.27;14.81;710;71;4112.00;151
11130;70;628528199;11130;216;11835;11986;9.52;0.58;246.28;14.81;705;71;4113.00;151
11133;70;628528209;11133;221;11836;11986;9.54;0.58;246.28;14.81;703;71;4114.00;150
11135;70;628528220;11135;225;11838;11990;9.53;0.58;246.30;14.81;703;71;4115.00;152
11136;70;628528231;11136;230;11838;11990;9.55;0.58;246.29;14.81;702;71;4116.00;152
11137;70;628528242;11137;231;11838;11990;9.58;0.58;246.30;14.81;701;71;4117.00;152
11140;70;628528253;11140;227;11838;11990;9.56;0.58;246.32;14.81;698;71;4118.00;152
11141;70;628528264;11141;226;11842;11996;9.56;0.58;246.33;14.80;701;71;4119.00;154
11143;70;628528275;11143;231;11843;11996;9.50;0.58;246.33;14.80;700;71;4120.00;153
11150;70;628528292;11150;232;11844;11996;9.43;0.58;246.33;14.80;694;71;4121.00;152
11153;70;628528303;11153;235;11846;11999;9.42;0.57;246.32;14.80;693;71;4122.00;153
11159;70;628528314;11159;242;11849;11999;9.26;0.56;246.34;14.80;690;71;4123.00;150
11160;70;628528325;11160;248;11849;11999;9.12;0.56;246.33;14.80;689;71;4124.00;150
11163;70;628528336;11163;258;11850;12000;8.99;0.55;246.35;14.80;687;71;4125.00;150
11164;70;628528346;11164;262;11851;12001;8.84;0.54;246.37;14.80;687;71;4126.00;150
11165;70;628528356;11165;253;11851;12001;8.72;0.53;246.36;14.80;686;71;4127.00;150
11168;70;628528367;11168;249;11862;12014;8.76;0.54;246.38;14.79;694;71;4128.00;152
11169;70;628528385;11169;248;11862;12014;8.76;0.54;246.39;14.79;693;71;4129.00;152
11174;70;628528396;11174;244;11862;12014;8.71;0.53;246.44;14.79;688;71;4130.00;152
11176;70;628528407;11176;242;11864;12015;8.77;0.54;246.46;14.93;688;71;4131.00;151
11179;70;628528419;11179;239;11864;12015;8.83;0.54;246.49;14.93;685;71;4132.00;151
11184;70;628528429;11184;240;11867;12019;8.84;0.54;246.49;14.93;683;71;4133.00;152
11187;70;628528440;11187;245;11867;12019;8.79;0.54;246.57;14.93;680;71;4134.00;152
11188;71;628528451;11188;247;11871;12023;8.85;0.54;246.57;14.92;683;72;4135.00;152
11192;71;628528479;11192;234;11871;12023;8.80;0.54;246.59;14.92;679;72;4136.00;152
11195;71;628528490;11195;227;11871;12023;8.83;0.54;246.58;14.92;676;72;4137.00;152
11195;71;628528501;11195;216;11871;12023;8.89;0.54;246.58;14.92;676;72;4138.00;152
11198;71;628528511;11198;208;11871;12023;9.02;0.55;246.53;14.92;673;72;4139.00;152
11201;71;628528524;11201;205;11895;12057;9.12;0.56;246.53;14.89;694;72;4140.00;162
11202;71;628528537;11202;190;11896;12057;9.21;0.56;246.55;14.89;694;72;4141.00;161
11205;71;628528549;11205;190;11897;12057;9.32;0.57;246.53;14.89;692;72;4142.00;160
11207;72;628528559;11207;186;11897;12057;9.35;0.57;246.52;14.89;690;73;4143.00;160
11208;72;628528581;11208;183;11898;12057;9.43;0.58;246.52;14.89;690;73;4144.00;159
11210;72;628528594;11210;178;11898;12057;9.50;0.58;246.49;14.89;688;73;4145.00;159
11212;72;628528609;11212;185;11899;12058;9.60;0.58;246.49;14.89;687;73;4146.00;159
11212;72;628528621;11212;187;11900;12058;9.64;0.59;246.49;15.03;688;73;4147.00;158
11216;72;628528633;11216;193;11904;12064;9.66;0.59;246.48;15.03;688;73;4148.00;160
11216;72;628528647;11216;189;11905;12065;9.68;0.59;246.48;15.03;689;73;4149.00;160
11217;72;628528660;11217;190;11906;12065;9.67;0.59;246.46;15.03;689;73;4150.00;159
11218;72;628528673;11218;188;11906;12065;9.59;0.58;246.45;15.03;688;73;4151.00;159
11221;72;628528685;11221;192;11910;12069;9.53;0.58;246.43;15.02;689;73;4152.00;159
11223;72;628528698;11223;190;11910;12069;9.46;0.58;246.40;15.02;687;73;4153.00;159
11224;72;628528709;11224;185;11910;12069;9.42;0.57;246.39;15.02;686;73;4154.00;159
11226;72;628528719;11226;194;11911;12070;9.47;0.58;246.37;15.02;685;73;4155.00;159
11229;72;628528735;11229;197;11914;12074;9.50;0.58;246.37;15.02;685;73;4156.00;160
11230;72;628528746;11230;199;11914;12074;9.54;0.58;246.36;15.02;684;73;4157.00;160
11235;73;628528757;11235;204;11916;12077;9.62;0.59;246.32;15.01;681;74;4158.00;161
11237;73;628528784;11237;205;11916;12077;9.65;0.59;246.31;15.01;679;74;4159.00;161
11238;73;628528794;11238;207;11917;12077;9.74;0.59;246.30;15.01;679;74;4160.00;160
11240;73;628528803;11240;212;11917;12077;9.80;0.60;246.28;15.01;677;74;4161.00;160
11241;74;628528813;11241;214;11920;12081;9.92;0.60;246.28;15.01;679;75;4162.00;161
11241;74;628528843;11241;216;11920;12081;9.95;0.61;246.28;15.01;679;75;4163.00;161
11243;74;628528852;11243;216;11921;12081;9.87;0.60;246.27;15.01;678;75;4164.00;160
11244;74;628528870;11244;214;11921;12081;9.84;0.60;246.32;15.01;677;75;4165.00;160
11246;74;628528881;11246;216;11922;12082;9.81;0.60;246.31;15.15;676;75;4166.00;160
11249;74;628528891;11249;214;11923;12083;9.77;0.59;246.29;15.15;674;75;4167.00;160
11249;74;628528901;11249;214;11923;12083;9.77;0.59;246.29;15.15;674;75;4168.00;160
11252;74;628528910;11252;215;11924;12084;9.74;0.59;246.28;15.15;672;75;4169.00;160
11254;74;628528921;11254;219;11924;12084;9.70;0.59;246.27;15.15;670;75;4170.00;160
11254;74;628528930;11254;206;11924;12084;9.73;0.59;246.27;15.15;670;75;4171.00;160
11254;74;628528938;11254;193;11924;12084;9.78;0.59;246.27;15.15;670;75;4172.00;160
11258;74;628528946;11258;183;11926;12086;9.77;0.60;246.29;15.15;668;75;4173.00;160
11261;74;628528955;11261;176;11926;12086;9.87;0.60;246.27;15.15;665;75;4174.00;160
11262;74;628528964;11262;173;11926;12086;9.98;0.61;246.27;15.15;664;75;4175.00;160
11263;74;628528973;11263;188;11995;12213;9.85;0.61;246.26;15.06;732;75;4176.00;218
11264;74;628528992;11264;172;11996;12214;10.01;0.62;246.26;15.06;732;75;4177.00;218
11267;74;628529002;11267;163;12003;12214;10.21;0.63;246.23;15.05;736;75;4178.00;211
11271;75;628529011;11271;155;12005;12214;10.34;0.64;246.22;15.05;734;76;4179.00;209
11273;75;628529032;11273;151;12008;12214;10.50;0.64;246.27;15.05;735;76;4180.00;206
11274;75;628529042;11274;151;12014;12214;10.64;0.65;246.27;15.18;740;76;4181.00;200
11278;75;628529051;11278;145;12016;12214;10.71;0.66;246.24;15.18;738;76;4182.00;198
11281;75;628529067;11281;146;12021;12214;10.78;0.66;246.22;15.18;740;76;4183.00;193
11282;75;628529077;11282;139;12025;12215;10.92;0.67;246.21;15.33;743;76;4184.00;190
11284;75;628529088;11284;137;12031;12217;11.07;0.67;246.19;15.34;747;76;4185.00;186
11284;75;628529100;11284;137;12033;12217;11.19;0.68;246.19;15.48;749;76;4186.00;184
11287;75;628529116;11287;134;12036;12218;11.30;0.69;246.17;15.48;749;76;4187.00;182
11290;75;628529126;11290;132;12040;12218;11.27;0.69;246.20;15.48;750;76;4188.00;178
11290;75;628529137;11290;131;12042;12218;11.21;0.68;246.20;15.61;752;76;4189.00;176
11293;75;628529147;11293;132;12045;12218;11.14;0.68;246.19;15.62;752;76;4190.00;173
11293;75;628529156;11293;127;12046;12222;11.04;0.67;246.19;15.62;753;76;4191.00;176
11298;75;628529168;11298;123;12049;12222;10.90;0.66;246.20;15.76;751;76;4192.00;173
11299;75;628529179;11299;122;12050;12222;10.87;0.66;246.18;15.76;751;76;4193.00;172
11301;75;628529190;11301;122;12054;12225;10.78;0.66;246.20;15.89;753;76;4194.00;171
11304;75;628529201;11304;130;12055;12225;10.78;0.66;246.21;15.89;751;76;4195.00;170
11306;75;628529211;11306;138;12056;12225;10.73;0.65;246.19;15.89;750;76;4196.00;169
11308;75;628529222;11308;146;12061;12229;10.63;0.65;246.17;16.02;753;76;4197.00;168
11313;75;628529232;11313;147;12062;12230;10.63;0.65;246.17;16.02;749;76;4198.00;168
11314;75;628529243;11314;152;12062;12230;10.64;0.65;246.15;16.02;748;76;4199.00;168
11318;75;628529256;11318;157;12073;12264;10.44;0.63;246.15;16.01;755;76;4200.00;191
11320;75;628529274;11320;157;12076;12264;10.35;0.63;246.16;16.15;756;76;4201.00;188
11322;75;628529285;11322;158;12078;12264;10.20;0.62;246.20;16.15;756;76;4202.00;186
11325;75;628529295;11325;163;12079;12265;10.25;0.62;246.26;16.15;754;76;4203.00;186
11326;75;628529306;11326;161;12079;12265;10.29;0.63;246.26;16.15;753;76;4204.00;186
11330;75;628529316;11330;169;12084;12271;10.29;0.63;246.30;16.14;754;76;4205.00;187
11333;75;628529327;11333;169;12085;12271;10.29;0.62;246.31;16.14;752;76;4206.00;186
11337;75;628529338;11337;168;12087;12272;10.27;0.62;246.38;16.15;750;76;4207.00;185
11339;75;628529348;11339;172;12088;12272;10.24;0.62;246.37;16.15;749;76;4208.00;184
11343;75;628529359;11343;177;12088;12272;10.28;0.62;246.40;16.15;745;76;4209.00;184
11347;75;628529375;11347;182;12091;12272;10.26;0.62;246.38;16.17;744;76;4210.00;181
11351;75;628529386;11351;186;12093;12272;10.19;0.62;246.39;16.17;742;76;4211.00;179
11353;75;628529397;11353;191;12101;12284;10.17;0.62;246.38;16.16;748;76;4212.00;183
11355;75;628529408;11355;192;12104;12284;10.17;0.62;246.38;16.17;749;76;4213.00;180
11357;75;628529419;11357;195;12106;12284;10.15;0.62;246.36;16.18;749;76;4214.00;178
11361;75;628529430;11361;197;12106;12284;10.06;0.61;246.36;16.18;745;76;4215.00;178
11362;75;628529442;11362;199;12108;12284;9.97;0.61;246.36;16.20;746;76;4216.00;176
11365;75;628529452;11365;205;12110;12284;9.87;0.60;246.38;16.20;745;76;4217.00;174
11367;75;628529463;11367;213;12114;12288;9.76;0.59;246.41;16.20;747;76;4218.00;174
11367;75;628529474;11367;217;12117;12288;9.73;0.59;246.41;16.23;750;76;4219.00;171
11372;75;628529484;11372;227;12119;12292;9.61;0.58;246.40;16.23;747;76;4220.00;173
11374;75;628529495;11374;227;12122;12293;9.53;0.58;246.38;16.25;748;76;4221.00;171
11378;75;628529505;11378;234;12122;12293;9.46;0.58;246.35;16.25;744;76;4222.00;171
11382;75;628529515;11382;238;12124;12293;9.42;0.58;246.38;16.26;742;76;4223.00;169
11384;75;628529525;11384;239;12132;12306;9.33;0.57;246.35;16.26;748;76;4224.00;174
11386;75;628529535;11386;250;12134;12306;9.20;0.56;246.34;16.27;748;76;4225.00;172
11389;75;628529545;11389;252;12135;12306;9.15;0.56;246.34;16.29;746;76;4226.00;171
11389;75;628529555;11389;261;12138;12307;9.08;0.56;246.34;16.30;749;76;4227.00;169
11393;75;628529565;11393;267;12138;12308;9.05;0.55;246.33;16.30;745;76;4228.00;170
11394;75;628529574;11394;264;12140;12308;9.03;0.55;246.32;16.32;746;76;4229.00;168
11398;75;628529586;11398;260;12146;12314;8.98;0.55;246.34;16.32;748;76;4230.00;168
11401;75;628529602;11401;256;12147;12314;9.01;0.55;246.34;16.33;746;76;4231.00;167
11404;75;628529612;11404;257;12148;12314;9.01;0.55;246.33;16.33;744;76;4232.00;166
11406;75;628529622;11406;251;12149;12314;8.94;0.55;246.32;16.34;743;76;4233.00;165
11410;75;628529632;11410;251;12153;12320;8.92;0.55;246.30;16.35;743;76;4234.00;167
11410;75;628529643;11410;249;12154;12320;8.86;0.54;246.30;16.35;744;76;4235.00;166
11415;75;628529652;11415;249;12156;12320;8.79;0.54;246.27;16.38;741;76;4236.00;164
11419;75;628529662;11419;248;12156;12320;8.75;0.53;246.30;16.38;737;76;4237.00;164
11419;75;628529671;11419;253;12161;12324;8.65;0.53;246.30;16.40;742;76;4238.00;163
11422;75;628529681;11422;250;12162;12325;8.64;0.53;246.33;16.40;740;76;4239.00;163
11424;75;628529690;11424;251;12163;12325;8.65;0.53;246.32;16.40;739;76;4240.00;162
11430;75;628529700;11430;251;12166;12326;8.59;0.53;246.35;16.42;736;76;4241.00;160
11433;75;628529709;11433;249;12166;12326;8.53;0.52;246.36;16.42;733;76;4242.00;160
11438;75;628529718;11438;254;12166;12326;8.46;0.52;246.44;16.42;728;76;4243.00;160
11440;75;628529727;11440;250;12169;12326;8.46;0.52;246.42;16.44;729;76;4244.00;157
11446;75;628529736;11446;251;12169;12326;8.41;0.51;246.48;16.44;723;76;4245.00;157
11449;75;628529745;11449;251;12172;12326;8.34;0.51;246.44;16.46;723;76;4246.00;154
11456;75;628529754;11456;255;12172;12326;8.12;0.50;246.48;16.46;716;76;4247.00;154
11462;75;628529763;11462;263;12209;12396;7.94;0.49;246.52;16.43;747;76;4248.00;187
11465;75;628529777;11465;260;12213;12397;7.74;0.48;246.51;16.43;748;76;4249.00;184
11470;75;628529786;11470;249;12218;12397;7.58;0.47;246.52;16.43;748;76;4250.00;179
11475;75;628529795;11475;244;12223;12397;7.44;0.46;246.58;16.44;748;76;4251.00;174
11476;75;628529804;11476;252;12227;12397;7.43;0.46;246.60;16.44;751;76;4252.00;170
11478;75;628529812;11478;252;12232;12397;7.41;0.46;246.60;16.46;754;76;4253.00;165
11482;75;628529820;11482;251;12237;12397;7.46;0.46;246.63;16.45;755;76;4254.00;160
11484;75;628529829;11484;255;12239;12397;7.49;0.46;246.66;16.45;755;76;4255.00;158
11488;75;628529838;11488;255;12240;12398;7.52;0.46;246.67;16.45;752;76;4256.00;158
11490;75;628529847;11490;257;12245;12399;7.59;0.47;246.69;16.46;755;76;4257.00;154
11495;75;628529856;11495;257;12247;12399;7.67;0.47;246.69;16.46;752;76;4258.00;152
11500;75;628529865;11500;256;12252;12403;7.75;0.48;246.71;16.46;752;76;4259.00;151
11503;75;628529876;11503;250;12253;12403;7.90;0.49;246.71;16.46;750;76;4260.00;150
11507;75;628529890;11507;248;12254;12403;8.05;0.50;246.72;16.46;747;76;4261.00;149
11513;75;628529908;11513;249;12254;12403;8.12;0.50;246.72;16.46;741;76;4262.00;149
11516;75;628529922;11516;246;12257;12409;8.18;0.50;246.73;16.46;741;76;4263.00;152
11521;75;628529944;11521;251;12258;12409;8.23;0.51;246.76;16.46;737;76;4264.00;151
11528;75;628529960;11528;248;12259;12409;8.26;0.51;246.81;16.46;731;76;4265.00;150
11532;75;628529974;11532;243;12263;12412;8.32;0.51;246.79;16.46;731;76;4266.00;149
11538;75;628529995;11538;233;12263;12412;8.36;0.51;246.82;16.46;725;76;4267.00;149
11543;75;628530008;11543;231;12264;12412;8.37;0.51;246.82;16.46;721;76;4268.00;148
11546;75;628530021;11546;230;12265;12413;8.36;0.51;246.81;16.46;719;76;4269.00;148
11550;75;628530033;11550;229;12266;12414;8.30;0.51;246.85;16.46;716;76;4270.00;148
11557;75;628530044;11557;228;12267;12414;8.23;0.50;246.89;16.46;710;76;4271.00;147
11559;75;628530062;11559;234;12279;12427;8.23;0.50;246.91;16.45;720;76;4272.00;148
11564;76;628530073;11564;234;12279;12427;8.19;0.50;246.94;16.45;715;77;4273.00;148
11572;76;628530098;11572;235;12280;12427;8.09;0.49;246.94;16.45;708;77;4274.00;147
11575;76;628530109;11575;233;12283;12429;8.13;0.50;246.95;16.45;708;77;4275.00;146
11577;76;628530119;11577;232;12284;12429;8.13;0.50;246.96;16.45;707;77;4276.00;145
11578;76;628530130;11578;235;12286;12433;8.22;0.50;246.96;16.44;708;77;4277.00;147
11582;76;628530141;11582;236;12287;12433;8.16;0.50;246.95;16.58;705;77;4278.00;146
11586;76;628530152;11586;238;12291;12437;8.19;0.50;247.00;16.58;705;77;4279.00;146
11591;76;628530163;11591;244;12292;12437;8.18;0.50;246.97;16.58;701;77;4280.00;145
11595;76;628530173;11595;248;12294;12437;8.12;0.50;246.94;16.58;699;77;4281.00;143
11598;76;628530183;11598;254;12294;12437;8.11;0.49;246.93;16.58;696;77;4282.00;143
11604;76;628530193;11604;257;12295;12437;8.01;0.49;246.89;16.58;691;77;4283.00;142
11607;76;628530204;11607;259;12306;12449;8.07;0.49;246.89;16.56;699;77;4284.00;143
11609;76;628530214;11609;261;12306;12449;8.04;0.49;246.90;16.56;697;77;4285.00;143
11610;76;628530224;11610;260;12306;12449;8.03;0.49;246.90;16.56;696;77;4286.00;143
11615;76;628530233;11615;260;12306;12449;7.95;0.49;246.88;16.56;691;77;4287.00;143
11615;76;628530244;11615;261;12306;12449;7.91;0.48;246.88;16.56;691;77;4288.00;143
11616;76;628530254;11616;269;12306;12449;7.91;0.48;246.87;16.56;690;77;4289.00;143
11616;76;628530265;11616;276;12306;12450;7.96;0.49;246.87;16.56;690;77;4290.00;144
11621;76;628530273;11621;282;12306;12450;7.86;0.48;246.87;16.56;685;77;4291.00;144
11621;76;628530284;11621;291;12310;12456;7.91;0.49;246.87;16.56;689;77;4292.00;146
11623;76;628530294;11623;298;12311;12457;7.92;0.49;246.85;16.56;688;77;4293.00;146
11629;76;628530303;11629;304;12312;12457;7.87;0.48;246.88;16.56;683;77;4294.00;145
11630;76;628530313;11630;311;12312;12457;7.81;0.48;246.87;16.56;682;77;4295.00;145
11633;76;628530329;11633;316;12315;12461;7.73;0.47;246.84;16.55;682;77;4296.00;146
11636;76;628530338;11636;311;12315;12461;7.62;0.47;246.80;16.55;679;77;4297.00;146
11640;76;628530347;11640;305;12315;12461;7.57;0.46;246.80;16.55;675;77;4298.00;146
11641;76;628530356;11641;306;12316;12462;7.55;0.46;246.79;16.55;675;77;4299.00;146
11644;77;628530367;11644;307;12319;12466;7.53;0.46;246.76;16.55;675;78;4300.00;147
11648;77;628530393;11648;304;12319;12466;7.49;0.46;246.74;16.55;671;78;4301.00;147
11654;77;628530403;11654;305;12321;12469;7.46;0.45;246.71;16.54;667;78;4302.00;148
11655;77;628530413;11655;301;12322;12469;7.53;0.46;246.77;16.54;667;78;4303.00;147
11660;77;628530422;11660;301;12322;12469;7.52;0.46;246.75;16.54;662;78;4304.00;147
11662;77;628530432;11662;300;12322;12469;7.49;0.45;246.72;16.54;660;78;4305.00;147
11664;77;628530447;11664;284;12325;12473;7.59;0.46;246.73;16.54;661;78;4306.00;148
11666;77;628530457;11666;272;12325;12473;7.71;0.47;246.72;16.54;659;78;4307.00;148
11667;77;628530467;11667;257;12326;12473;7.89;0.48;246.71;16.54;659;78;4308.00;147
11667;77;628530477;11667;246;12326;12473;8.06;0.49;246.71;16.54;659;78;4309.00;147
11669;77;628530486;11669;239;12326;12474;8.11;0.49;246.69;16.54;657;78;4310.00;148
11671;77;628530502;11671;230;12327;12475;8.18;0.50;246.71;16.54;656;78;4311.00;148
11671;77;628530513;11671;226;12327;12475;8.22;0.50;246.71;16.54;656;78;4312.00;148
11673;77;628530522;11673;224;12328;12476;8.34;0.51;246.69;16.54;655;78;4313.00;148
11673;77;628530532;11673;225;12328;12476;8.51;0.52;246.69;16.54;655;78;4314.00;148
11674;77;628530542;11674;225;12328;12476;8.62;0.52;246.69;16.54;654;78;4315.00;148
11676;77;628530551;11676;222;12328;12476;8.73;0.53;246.69;16.54;652;78;4316.00;148
11677;77;628530566;11677;221;12328;12476;8.79;0.53;246.75;16.54;651;78;4317.00;148
11679;77;628530575;11679;214;12328;12476;8.83;0.53;246.76;16.54;649;78;4318.00;148
11680;77;628530585;11680;215;12328;12476;8.94;0.54;246.75;16.54;648;78;4319.00;148
11681;77;628530602;11681;259;12438;12706;8.93;0.56;246.75;16.39;757;78;4320.00;268
11682;77;628530629;11682;245;12441;12707;9.00;0.56;246.75;16.39;759;78;4321.00;266
11683;77;628530641;11683;228;12450;12707;9.13;0.57;246.75;16.38;767;78;4322.00;257
11684;77;628530651;11684;213;12455;12707;9.25;0.58;246.75;16.37;771;78;4323.00;252
11687;77;628530661;11687;199;12463;12707;9.35;0.58;246.78;16.36;776;78;4324.00;244
11687;77;628530672;11687;186;12466;12707;9.37;0.58;246.78;16.36;779;78;4325.00;241
11689;77;628530681;11689;180;12471;12707;9.46;0.59;246.78;16.35;782;78;4326.00;236
11691;78;628530691;11691;179;12474;12707;9.54;0.59;246.79;16.35;783;79;4327.00;233
11691;78;628530713;11691;171;12479;12708;9.60;0.60;246.79;16.35;788;79;4328.00;229
11692;78;628530725;11692;172;12482;12709;9.70;0.60;246.79;16.35;790;79;4329.00;227
11693;78;628530736;11693;173;12486;12709;9.80;0.61;246.79;16.35;793;79;4330.00;223
11696;78;628530747;11696;171;12489;12710;9.83;0.61;246.79;16.34;793;79;4331.00;221
11698;78;628530759;11698;166;12496;12710;9.86;0.61;246.78;16.34;798;79;4332.00;214
11700;79;628530776;11700;170;12497;12710;9.93;0.61;246.77;16.34;797;80;4333.00;213
11700;79;628530804;11700;168;12503;12710;9.92;0.61;246.77;16.34;803;80;4334.00;207
11701;80;628530815;11701;175;12508;12714;9.92;0.61;246.76;16.34;807;81;4335.00;206
11701;80;628530838;11701;176;12511;12714;9.99;0.61;246.76;16.34;810;81;4336.00;203
11703;80;628530850;11703;178;12512;12714;10.13;0.62;246.74;16.34;809;81;4337.00;202
11703;80;628530861;11703;180;12513;12717;10.17;0.62;246.74;16.34;810;81;4338.00;204
11706;80;628530878;11706;180;12514;12717;10.26;0.63;246.72;16.34;808;81;4339.00;203
11707;80;628530901;11707;185;12516;12717;10.30;0.63;246.72;16.34;809;81;4340.00;201
11709;80;628530913;11709;186;12519;12721;10.31;0.63;246.70;16.33;810;81;4341.00;202
11712;80;628530925;11712;188;12520;12722;10.39;0.63;246.69;16.33;808;81;4342.00;202
11713;80;628530943;11713;187;12520;12722;10.41;0.64;246.68;16.33;807;81;4343.00;202
11715;80;628530954;11715;189;12524;12726;10.38;0.63;246.67;16.33;809;81;4344.00;202
11717;80;628530965;11717;190;12525;12726;10.36;0.63;246.65;16.33;808;81;4345.00;201
11721;80;628530977;11721;190;12525;12726;10.38;0.63;246.62;16.33;804;81;4346.00;201
11723;80;628530994;11723;192;12526;12727;10.37;0.63;246.63;16.33;803;81;4347.00;201
11728;80;628531011;11728;191;12527;12727;10.39;0.63;246.65;16.33;799;81;4348.00;200
11730;80;628531023;11730;191;12531;12733;10.35;0.63;246.67;16.47;801;81;4349.00;202
11734;80;628531035;11734;186;12531;12733;10.31;0.63;246.69;16.47;797;81;4350.00;202
11735;80;628531052;11735;182;12532;12734;10.31;0.63;246.71;16.47;797;81;4351.00;202
11738;80;628531062;11738;174;12533;12734;10.30;0.63;246.70;16.47;795;81;4352.00;201
11743;80;628531072;11743;174;12536;12734;10.25;0.62;246.69;16.62;793;81;4353.00;198
11747;80;628531083;11747;168;12538;12734;10.24;0.62;246.74;16.62;791;81;4354.00;196
11748;80;628531095;11748;158;12541;12734;10.21;0.62;246.73;16.64;793;81;4355.00;193
11752;80;628531107;11752;150;12551;12746;10.19;0.62;246.73;16.77;799;81;4356.00;195
11754;80;628531119;11754;150;12551;12746;10.23;0.62;246.74;16.77;797;81;4357.00;195
11757;80;628531130;11757;151;12553;12746;10.28;0.62;246.73;16.77;796;81;4358.00;193
11760;80;628531141;11760;153;12553;12746;10.33;0.62;246.74;16.77;793;81;4359.00;193
11762;80;628531153;11762;151;12553;12746;10.30;0.62;246.72;16.77;791;81;4360.00;193
11762;80;628531164;11762;150;12553;12746;10.35;0.63;246.72;16.77;791;81;4361.00;193
11765;80;628531175;11765;151;12557;12750;10.33;0.62;246.76;16.91;792;81;4362.00;193
11768;80;628531187;11768;148;12557;12750;10.34;0.63;246.78;16.91;789;81;4363.00;193
11770;80;628531198;11770;146;12559;12754;10.40;0.63;246.78;16.91;789;81;4364.00;195
11772;80;628531209;11772;150;12561;12756;10.45;0.63;246.79;16.91;789;81;4365.00;195
11773;80;628531221;11773;154;12562;12756;10.52;0.64;246.80;16.91;789;81;4366.00;194
11775;80;628531232;11775;156;12563;12756;10.55;0.64;246.80;16.91;788;81;4367.00;193
11777;80;628531249;11777;162;12572;12769;10.55;0.64;246.83;16.90;795;81;4368.00;197
11779;80;628531261;11779;158;12574;12769;10.57;0.64;246.81;16.90;795;81;4369.00;195
11782;80;628531272;11782;162;12574;12769;10.59;0.64;246.84;16.90;792;81;4370.00;195
11785;80;628531283;11785;161;12575;12770;10.57;0.64;246.87;16.90;790;81;4371.00;195
11786;80;628531295;11786;162;12575;12771;10.59;0.64;246.88;16.90;789;81;4372.00;196
11790;80;628531306;11790;165;12576;12771;10.58;0.64;246.89;16.90;786;81;4373.00;195
11793;80;628531318;11793;167;12578;12774;10.55;0.64;246.96;16.90;785;81;4374.00;196
11798;80;628531330;11798;174;12579;12774;10.56;0.64;246.98;16.90;781;81;4375.00;195
11802;80;628531341;11802;176;12580;12774;10.55;0.64;246.99;16.90;778;81;4376.00;194
11804;80;628531352;11804;180;12581;12774;10.55;0.64;247.01;16.90;777;81;4377.00;193
11805;80;628531364;11805;186;12586;12780;10.56;0.64;247.00;16.90;781;81;4378.00;194
11807;80;628531376;11807;191;12587;12780;10.52;0.64;246.99;16.92;780;81;4379.00;193
11808;80;628531389;11808;194;12589;12780;10.45;0.64;246.98;16.92;781;81;4380.00;191
11810;80;628531400;11810;199;12589;12780;10.39;0.63;246.98;16.92;779;81;4381.00;191
11813;80;628531411;11813;207;12594;12784;10.22;0.62;246.94;16.94;781;81;4382.00;190
11816;80;628531423;11816;213;12596;12785;10.10;0.62;246.96;16.95;780;81;4383.00;189
11818;80;628531434;11818;218;12600;12785;10.00;0.61;246.97;16.99;782;81;4384.00;185
11819;80;628531445;11819;222;12603;12786;9.94;0.61;246.99;16.99;784;81;4385.00;183
11823;80;628531456;11823;224;12603;12786;9.98;0.61;247.01;16.99;780;81;4386.00;183
11824;81;628531468;11824;232;12606;12786;10.01;0.61;247.01;17.01;782;82;4387.00;180
11829;81;628531489;11829;238;12608;12786;10.01;0.61;246.98;17.04;779;82;4388.00;178
11831;81;628531500;11831;237;12611;12786;9.99;0.61;246.98;17.06;780;82;4389.00;175
11833;81;628531510;11833;238;12613;12786;9.95;0.61;247.00;17.08;780;82;4390.00;173
11835;81;628531521;11835;237;12615;12786;9.92;0.61;246.99;17.08;780;82;4391.00;171
11839;81;628531531;11839;249;12651;12856;9.84;0.60;247.00;17.05;812;82;4392.00;205
11841;81;628531548;11841;247;12654;12857;9.79;0.60;246.99;17.06;813;82;4393.00;203
11843;81;628531559;11843;250;12664;12857;9.77;0.60;247.00;17.06;821;82;4394.00;193
11844;81;628531570;11844;257;12667;12857;9.73;0.60;247.00;17.08;823;82;4395.00;190
11847;81;628531580;11847;261;12673;12857;9.71;0.59;247.01;17.07;826;82;4396.00;184
11848;81;628531592;11848;265;12677;12857;9.62;0.59;247.01;17.08;829;82;4397.00;180
11853;81;628531608;11853;268;12682;12857;9.58;0.59;247.07;17.08;829;82;4398.00;175
11856;81;628531620;11856;262;12685;12857;9.52;0.58;247.05;17.09;829;82;4399.00;172
11860;81;628531631;11860;265;12688;12858;9.45;0.58;247.02;17.09;828;82;4400.00;170
11863;81;628531646;11863;270;12691;12859;9.44;0.58;246.98;17.10;828;82;4401.00;168
11868;81;628531658;11868;270;12692;12859;9.42;0.58;246.94;17.11;824;82;4402.00;167
11871;81;628531670;11871;270;12695;12863;9.31;0.57;246.92;17.12;824;82;4403.00;168
11872;81;628531682;11872;274;12695;12863;9.28;0.57;246.92;17.12;823;82;4404.00;168
11876;81;628531694;11876;272;12695;12863;9.22;0.56;246.92;17.12;819;82;4405.00;168
11877;81;628531707;11877;274;12697;12863;9.19;0.56;246.93;17.13;820;82;4406.00;166
11882;81;628531719;11882;280;12703;12869;9.19;0.56;246.93;17.13;821;82;4407.00;166
11883;81;628531731;11883;283;12705;12869;9.17;0.56;246.94;17.15;822;82;4408.00;164
11886;81;628531742;11886;285;12705;12869;9.13;0.56;246.91;17.15;819;82;4409.00;164
11887;81;628531757;11887;288;12711;12875;9.12;0.56;246.90;17.15;824;82;4410.00;164
11890;81;628531769;11890;287;12712;12875;9.07;0.56;246.89;17.16;822;82;4411.00;163
11894;81;628531780;11894;287;12713;12875;8.97;0.55;246.91;17.15;819;82;4412.00;162
11899;81;628531791;11899;292;12715;12876;8.85;0.54;246.92;17.17;816;82;4413.00;161
11902;81;628531802;11902;289;12716;12877;8.73;0.54;246.93;17.17;814;82;4414.00;161
11909;81;628531812;11909;287;12717;12877;8.50;0.52;246.99;17.17;808;82;4415.00;160
11913;81;628531823;11913;286;12728;12890;8.30;0.51;246.98;17.17;815;82;4416.00;162
11922;81;628531835;11922;284;12728;12890;8.09;0.50;246.95;17.17;806;82;4417.00;162
11927;81;628531847;11927;280;12729;12890;7.90;0.48;247.00;17.17;802;82;4418.00;161
11931;81;628531857;11931;281;12731;12891;7.63;0.47;247.02;17.18;800;82;4419.00;160
11936;81;628531867;11936;277;12731;12891;7.41;0.45;247.01;17.18;795;82;4420.00;160
11942;81;628531876;11942;270;12735;12895;7.27;0.44;246.98;17.17;793;82;4421.00;160
11947;81;628531892;11947;268;12737;12895;7.19;0.44;247.04;17.18;790;82;4422.00;158
11955;81;628531909;11955;269;12740;12899;7.10;0.43;247.09;17.18;785;82;4423.00;159
11956;81;628531925;11956;263;12742;12899;7.13;0.44;247.10;17.18;786;82;4424.00;157
11959;81;628531941;11959;266;12743;12899;7.15;0.44;247.13;17.19;784;82;4425.00;156
11964;81;628531956;11964;261;12744;12899;7.13;0.44;247.14;17.19;780;82;4426.00;155
11966;81;628531973;11966;258;12745;12899;7.17;0.44;247.16;17.20;779;82;4427.00;154
11970;81;628531991;11970;257;12758;12911;7.26;0.45;247.16;17.18;788;82;4428.00;153
11973;81;628532005;11973;253;12758;12911;7.29;0.45;247.17;17.18;785;82;4429.00;153
11977;81;628532015;11977;254;12758;12911;7.29;0.45;247.20;17.18;781;82;4430.00;153
11980;81;628532026;11980;253;12759;12911;7.31;0.45;247.21;17.18;779;82;4431.00;152
11983;81;628532037;11983;251;12759;12911;7.33;0.45;247.22;17.18;776;82;4432.00;152
11988;81;628532047;11988;248;12759;12911;7.36;0.45;247.19;17.18;771;82;4433.00;152
11993;81;628532058;11993;261;12759;12912;7.37;0.45;247.21;17.18;766;82;4434.00;153
11997;81;628532069;11997;256;12759;12912;7.45;0.46;247.19;17.18;762;82;4435.00;153
12001;81;628532079;12001;254;12763;12918;7.56;0.46;247.21;17.18;762;82;4436.00;155
12005;81;628532091;12005;260;12764;12919;7.56;0.46;247.24;17.18;759;82;4437.00;155
12009;81;628532102;12009;260;12765;12919;7.63;0.47;247.27;17.18;756;82;4438.00;154
12012;81;628532113;12012;265;12765;12919;7.65;0.47;247.25;17.18;753;82;4439.00;154
12015;81;628532124;12015;267;12769;12924;7.72;0.47;247.25;17.17;754;82;4440.00;155
12019;81;628532135;12019;263;12769;12924;7.76;0.47;247.23;17.17;750;82;4441.00;155
12022;81;628532146;12022;262;12769;12924;7.73;0.47;247.23;17.17;747;82;4442.00;155
12023;81;628532155;12023;263;12770;12925;7.71;0.47;247.23;17.17;747;82;4443.00;155
12026;81;628532166;12026;268;12773;12929;7.76;0.47;247.27;17.16;747;82;4444.00;156
12030;81;628532176;12030;268;12773;12929;7.74;0.47;247.24;17.16;743;82;4445.00;156
12033;81;628532186;12033;261;12776;12932;7.73;0.47;247.27;17.31;743;82;4446.00;156
12036;81;628532198;12036;267;12776;12932;7.78;0.48;247.26;17.31;740;82;4447.00;156
12040;81;628532207;12040;266;12777;12932;7.80;0.48;247.27;17.31;737;82;4448.00;155
12044;81;628532217;12044;266;12777;12932;7.80;0.48;247.26;17.31;733;82;4449.00;155
12051;81;628532227;12051;265;12780;12936;7.74;0.47;247.24;17.31;729;82;4450.00;156
12055;81;628532238;12055;266;12780;12936;7.77;0.47;247.22;17.31;725;82;4451.00;156
12060;81;628532247;12060;275;12781;12936;7.73;0.47;247.20;17.31;721;82;4452.00;155
12063;81;628532258;12063;268;12781;12936;7.78;0.47;247.18;17.31;718;82;4453.00;155
12065;81;628532268;12065;272;12781;12937;7.78;0.47;247.19;17.31;716;82;4454.00;156
12071;81;628532277;12071;274;12783;12939;7.69;0.47;247.18;17.30;712;82;4455.00;156
12075;81;628532287;12075;282;12783;12939;7.63;0.46;247.13;17.30;708;82;4456.00;156
12080;81;628532297;12080;294;12784;12940;7.56;0.46;247.16;17.30;704;82;4457.00;156
12083;81;628532306;12083;297;12784;12940;7.49;0.46;247.16;17.30;701;82;4458.00;156
12086;81;628532316;12086;298;12784;12940;7.42;0.45;247.15;17.30;698;82;4459.00;156
12088;81;628532324;12088;302;12784;12940;7.38;0.45;247.14;17.30;696;82;4460.00;156
12092;81;628532333;12092;308;12784;12940;7.34;0.45;247.11;17.30;692;82;4461.00;156
12094;81;628532343;12094;317;12784;12940;7.30;0.45;247.12;17.30;690;82;4462.00;156
12097;81;628532352;12097;328;12784;12940;7.22;0.44;247.13;17.30;687;82;4463.00;156
12097;81;628532361;12097;345;12850;13067;7.66;0.47;247.13;17.21;753;82;4464.00;217
12100;81;628532381;12100;345;12853;13068;7.54;0.47;247.11;17.21;753;82;4465.00;215
12100;81;628532391;12100;348;12862;13068;7.56;0.47;247.11;17.34;762;82;4466.00;206
12102;81;628532400;12102;340;12865;13068;7.42;0.46;247.09;17.34;763;82;4467.00;203
12103;81;628532410;12103;334;12871;13068;7.46;0.46;247.13;17.33;768;82;4468.00;197
12103;81;628532428;12103;326;12873;13068;7.49;0.47;247.13;17.33;770;82;4469.00;195
12104;81;628532440;12104;328;12879;13068;7.58;0.47;247.13;17.33;775;82;4470.00;189
12106;81;628532450;12106;324;12879;13068;7.51;0.47;247.10;17.33;773;82;4471.00;189
12107;81;628532467;12107;322;12885;13069;7.50;0.46;247.11;17.32;778;82;4472.00;184
12108;81;628532479;12108;323;12888;13070;7.42;0.46;247.10;17.32;780;82;4473.00;182
12109;81;628532489;12109;333;12890;13070;7.29;0.45;247.09;17.32;781;82;4474.00;180
12111;81;628532500;12111;323;12892;13071;7.26;0.45;247.12;17.32;781;82;4475.00;179
12112;81;628532511;12112;302;12895;13071;7.35;0.45;247.10;17.32;783;82;4476.00;176
12114;81;628532528;12114;286;12897;13071;7.42;0.46;247.12;17.32;783;82;4477.00;174
12115;81;628532545;12115;272;12901;13071;7.59;0.47;247.12;17.32;786;82;4478.00;170
12116;81;628532556;12116;263;12904;13075;7.77;0.48;247.11;17.31;788;82;4479.00;171
12116;81;628532568;12116;247;12905;13075;7.98;0.49;247.11;17.31;789;82;4480.00;170
12118;81;628532580;12118;239;12906;13075;8.16;0.50;247.11;17.31;788;82;4481.00;169
12119;81;628532592;12119;227;12909;13078;8.34;0.51;247.11;17.31;790;82;4482.00;169
12120;81;628532611;12120;217;12909;13078;8.52;0.52;247.11;17.31;789;82;4483.00;169
12121;81;628532623;12121;209;12910;13078;8.72;0.53;247.10;17.31;789;82;4484.00;168
12124;81;628532636;12124;199;12913;13082;8.86;0.54;247.06;17.30;789;82;4485.00;169
12124;81;628532650;12124;192;12915;13083;9.09;0.56;247.06;17.30;791;82;4486.00;168
12128;81;628532663;12128;185;12915;13083;9.30;0.57;247.03;17.30;787;82;4487.00;168
12128;81;628532676;12128;177;12919;13087;9.52;0.58;247.03;17.30;791;82;4488.00;168
12130;81;628532689;12130;167;12919;13087;9.69;0.59;247.01;17.30;789;82;4489.00;168
12131;81;628532707;12131;162;12919;13087;9.85;0.60;247.00;17.30;788;82;4490.00;168
12133;81;628532720;12133;154;12920;13088;9.98;0.61;247.00;17.30;787;82;4491.00;168
12138;81;628532732;12138;154;12920;13088;10.09;0.61;247.04;17.30;782;82;4492.00;168
12139;81;628532746;12139;151;12924;13094;10.19;0.62;247.02;17.29;785;82;4493.00;170
12140;81;628532759;12140;153;12924;13094;10.27;0.62;247.02;17.29;784;82;4494.00;170
12142;81;628532771;12142;143;12925;13095;10.35;0.63;247.00;17.29;783;82;4495.00;170
12145;81;628532783;12145;135;12925;13095;10.41;0.63;247.04;17.29;780;82;4496.00;170
12147;81;628532795;12147;131;12925;13095;10.52;0.64;247.03;17.29;778;82;4497.00;170
12150;81;628532814;12150;126;12925;13095;10.63;0.64;247.01;17.29;775;82;4498.00;170
12152;81;628532838;12152;128;12925;13095;10.75;0.65;246.99;17.29;773;82;4499.00;170
12157;81;628532852;12157;132;12947;13145;10.78;0.66;246.98;17.26;790;82;4500.00;198
12160;82;628532876;12160;129;12948;13147;10.79;0.66;246.98;17.26;788;83;4501.00;199
12163;82;628532905;12163;130;12951;13147;10.92;0.66;246.97;17.26;788;83;4502.00;196
12165;82;628532917;12165;130;12952;13147;11.04;0.67;247.01;17.25;787;83;4503.00;195
12167;82;628532929;12167;132;12953;13147;11.14;0.68;247.01;17.25;786;83;4504.00;194
12169;82;628532941;12169;132;12953;13147;11.22;0.68;247.02;17.25;784;83;4505.00;194
12175;82;628532952;12175;133;12958;13151;11.30;0.68;247.06;17.25;783;83;4506.00;193
12177;82;628532964;12177;137;12959;13151;11.37;0.69;247.05;17.25;782;83;4507.00;192
12180;82;628532975;12180;135;12963;13155;11.41;0.69;247.06;17.24;783;83;4508.00;192
12181;82;628532986;12181;131;12964;13156;11.50;0.70;247.07;17.24;783;83;4509.00;192
12183;82;628532998;12183;133;12965;13156;11.43;0.69;247.09;17.24;782;83;4510.00;191
12185;82;628533009;12185;136;12965;13156;11.37;0.69;247.11;17.24;780;83;4511.00;191
12185;82;628533020;12185;138;12972;13169;11.32;0.69;247.11;17.23;787;83;4512.00;197
12187;82;628533032;12187;140;12972;13169;11.31;0.69;247.12;17.23;785;83;4513.00;197
12188;82;628533043;12188;145;12973;13169;11.30;0.69;247.13;17.23;785;83;4514.00;196
12192;82;628533054;12192;146;12974;13170;11.37;0.69;247.14;17.23;782;83;4515.00;196
12198;82;628533065;12198;146;12975;13171;11.39;0.69;247.14;17.23;777;83;4516.00;196
12199;82;628533077;12199;144;12975;13171;11.43;0.70;247.14;17.23;776;83;4517.00;196
12204;82;628533088;12204;151;12977;13174;11.44;0.70;247.14;17.23;773;83;4518.00;197
12205;82;628533100;12205;152;12978;13174;11.44;0.70;247.14;17.23;773;83;4519.00;196
12207;82;628533111;12207;150;12979;13174;11.49;0.70;247.16;17.38;772;83;4520.00;195
12214;82;628533123;12214;146;12979;13174;11.45;0.70;247.19;17.38;765;83;4521.00;195
12218;82;628533134;12218;142;12983;13180;11.44;0.70;247.18;17.37;765;83;4522.00;197
12222;82;628533146;12222;139;12983;13180;11.46;0.70;247.17;17.37;761;83;4523.00;197
12226;82;628533157;12226;136;12983;13180;11.37;0.69;247.17;17.37;757;83;4524.00;197
12226;82;628533168;12226;135;12985;13180;11.36;0.69;247.17;17.39;759;83;4525.00;195
12232;82;628533180;12232;133;12988;13184;11.29;0.69;247.15;17.38;756;83;4526.00;196
12237;82;628533191;12237;129;12989;13185;11.28;0.69;247.17;17.38;752;83;4527.00;196
12240;82;628533203;12240;129;12990;13185;11.32;0.69;247.19;17.38;750;83;4528.00;195
12246;82;628533214;12246;122;12991;13186;11.35;0.69;247.15;17.38;745;83;4529.00;195
12249;82;628533227;12249;122;12991;13186;11.42;0.69;247.14;17.38;742;83;4530.00;195
12250;82;628533238;12250;117;12992;13186;11.44;0.69;247.15;17.38;742;83;4531.00;194
12253;82;628533248;12253;108;12992;13186;11.42;0.69;247.18;17.38;739;83;4532.00;194
12256;82;628533259;12256;107;12992;13186;11.42;0.69;247.17;17.38;736;83;4533.00;194
12262;82;628533269;12262;107;12993;13186;11.46;0.70;247.14;17.38;731;83;4534.00;193
12267;82;628533281;12267;111;12995;13186;11.47;0.70;247.18;17.53;728;83;4535.00;191
12269;82;628533291;12269;116;13035;13256;11.33;0.69;247.18;17.48;766;83;4536.00;221
12273;82;628533308;12273;118;13037;13257;11.30;0.69;247.20;17.48;764;83;4537.00;220
12275;82;628533319;12275;111;13040;13257;11.36;0.69;247.22;17.48;765;83;4538.00;217
12280;82;628533330;12280;116;13041;13257;11.47;0.70;247.23;17.48;761;83;4539.00;216
12282;82;628533342;12282;121;13047;13257;11.53;0.70;247.22;17.47;765;83;4540.00;210
12287;82;628533353;12287;124;13048;13257;11.62;0.71;247.28;17.47;761;83;4541.00;209
12291;82;628533364;12291;127;13051;13257;11.70;0.71;247.32;17.47;760;83;4542.00;206
12293;82;628533376;12293;130;13058;13257;11.67;0.71;247.32;17.47;765;83;4543.00;199
12297;82;628533393;12297;132;13061;13258;11.66;0.71;247.28;17.47;764;83;4544.00;197
12300;82;628533405;12300;136;13066;13260;11.69;0.71;247.26;17.47;766;83;4545.00;194
12302;82;628533417;12302;137;13068;13260;11.66;0.71;247.27;17.47;766;83;4546.00;192
12307;82;628533428;12307;141;13072;13264;11.52;0.70;247.24;17.47;765;83;4547.00;192
12309;82;628533440;12309;148;13073;13264;11.44;0.70;247.25;17.47;764;83;4548.00;191
12311;82;628533451;12311;154;13074;13264;11.36;0.69;247.23;17.47;763;83;4549.00;190
12314;82;628533462;12314;160;13075;13264;11.30;0.69;247.21;17.49;761;83;4550.00;189
12316;82;628533474;12316;164;13080;13270;11.23;0.68;247.21;17.49;764;83;4551.00;190
12317;82;628533491;12317;170;13080;13270;11.11;0.68;247.21;17.49;763;83;4552.00;190
12321;82;628533502;12321;172;13082;13270;10.98;0.67;247.22;17.51;761;83;4553.00;188
12324;82;628533514;12324;178;13086;13273;10.90;0.66;247.22;17.51;762;83;4554.00;187
12326;82;628533526;12326;184;13087;13273;10.86;0.66;247.24;17.53;761;83;4555.00;186
12332;82;628533537;12332;190;13088;13273;10.78;0.66;247.28;17.53;756;83;4556.00;185
12332;82;628533548;12332;195;13091;13274;10.70;0.65;247.28;17.55;759;83;4557.00;183
12341;82;628533558;12341;203;13092;13275;10.54;0.64;247.26;17.55;751;83;4558.00;183
12341;82;628533569;12341;213;13096;13275;10.36;0.63;247.26;17.57;755;83;4559.00;179
12343;82;628533581;12343;220;13114;13301;10.15;0.62;247.27;17.57;771;83;4560.00;187
12344;82;628533594;12344;224;13115;13301;10.11;0.62;247.26;17.57;771;83;4561.00;186
12346;82;628533604;12346;229;13120;13301;10.03;0.61;247.23;17.58;774;83;4562.00;181
12351;82;628533621;12351;235;13124;13302;9.96;0.61;247.21;17.58;773;83;4563.00;178
12353;82;628533631;12353;240;13124;13302;9.80;0.60;247.22;17.58;771;83;4564.00;178
12356;82;628533641;12356;248;13129;13306;9.64;0.59;247.20;17.60;773;83;4565.00;177
12358;82;628533652;12358;252;13130;13306;9.38;0.57;247.19;17.60;772;83;4566.00;176
12359;82;628533661;12359;263;13134;13310;9.21;0.56;247.24;17.61;775;83;4567.00;176
12361;82;628533671;12361;271;13134;13310;9.04;0.55;247.26;17.61;773;83;4568.00;176
12362;82;628533680;12362;262;13135;13310;8.88;0.54;247.26;17.62;773;83;4569.00;175
12366;82;628533689;12366;262;13136;13310;8.74;0.54;247.27;17.63;770;83;4570.00;174
12371;82;628533698;12371;263;13137;13310;8.64;0.53;247.28;17.64;766;83;4571.00;173
12371;82;628533708;12371;267;13149;13322;8.68;0.53;247.28;17.64;778;83;4572.00;173
12374;82;628533718;12374;271;13150;13322;8.67;0.53;247.30;17.65;776;83;4573.00;172
12379;82;628533727;12379;268;13151;13322;8.60;0.53;247.30;17.65;772;83;4574.00;171
12380;82;628533737;12380;262;13153;13322;8.62;0.53;247.31;17.65;773;83;4575.00;169
12383;82;628533746;12383;253;13155;13322;8.55;0.53;247.37;17.66;772;83;4576.00;167
12388;82;628533755;12388;259;13155;13322;8.45;0.52;247.40;17.66;767;83;4577.00;167
12391;82;628533764;12391;260;13157;13323;8.35;0.51;247.39;17.68;766;83;4578.00;166
12393;83;628533779;12393;263;13157;13323;8.32;0.51;247.39;17.68;764;84;4579.00;166
12394;83;628533798;12394;277;13161;13329;8.40;0.52;247.42;17.67;767;84;4580.00;168
12396;83;628533808;12396;281;13164;13330;8.33;0.51;247.42;17.68;768;84;4581.00;166
12400;83;628533817;12400;280;13165;13330;8.22;0.50;247.39;17.68;765;84;4582.00;165
12402;83;628533826;12402;281;13165;13330;8.10;0.50;247.40;17.68;763;84;4583.00;165
12407;83;628533836;12407;281;13169;13334;7.94;0.49;247.36;17.69;762;84;4584.00;165
12411;83;628533846;12411;291;13169;13334;7.76;0.47;247.36;17.69;758;84;4585.00;165
12414;83;628533856;12414;289;13170;13334;7.51;0.46;247.36;17.70;756;84;4586.00;164
12415;83;628533864;12415;299;13171;13335;7.35;0.45;247.36;17.70;756;84;4587.00;164
12420;83;628533873;12420;307;13175;13339;7.09;0.43;247.33;17.71;755;84;4588.00;164
12422;83;628533883;12422;319;13175;13339;6.87;0.42;247.36;17.71;753;84;4589.00;164
12424;83;628533897;12424;313;13179;13345;6.73;0.41;247.33;17.72;755;84;4590.00;166
12429;83;628533913;12429;307;13181;13345;6.61;0.41;247.34;17.74;752;84;4591.00;164
12432;83;628533926;12432;306;13183;13345;6.56;0.40;247.33;17.75;751;84;4592.00;162
12433;83;628533941;12433;304;13183;13345;6.61;0.41;247.33;17.75;750;84;4593.00;162
12437;83;628533955;12437;303;13186;13349;6.62;0.41;247.31;17.75;749;84;4594.00;163
12441;83;628533968;12441;298;13187;13349;6.57;0.40;247.31;17.76;746;84;4595.00;162
12444;83;628533980;12444;299;13189;13349;6.53;0.40;247.28;17.77;745;84;4596.00;160
12449;83;628533992;12449;292;13190;13349;6.48;0.40;247.27;17.78;741;84;4597.00;159
12452;83;628534002;12452;296;13191;13350;6.45;0.40;247.29;17.78;739;84;4598.00;159
12456;83;628534011;12456;292;13192;13351;6.44;0.39;247.24;17.78;736;84;4599.00;159
12458;83;628534022;12458;292;13193;13351;6.50;0.40;247.26;17.78;735;84;4600.00;158
12461;83;628534035;12461;293;13194;13352;6.52;0.40;247.25;17.78;733;84;4601.00;158
12463;83;628534045;12463;293;13194;13352;6.59;0.40;247.23;17.78;731;84;4602.00;158
12466;83;628534054;12466;291;13194;13352;6.60;0.40;247.23;17.78;728;84;4603.00;158
12469;83;628534063;12469;294;13194;13352;6.64;0.41;247.26;17.78;725;84;4604.00;158
12476;83;628534073;12476;294;13194;13352;6.62;0.40;247.23;17.78;718;84;4605.00;158
12480;83;628534082;12480;293;13194;13352;6.68;0.41;247.23;17.78;714;84;4606.00;158
12483;83;628534092;12483;291;13194;13352;6.75;0.41;247.22;17.78;711;84;4607.00;158
12486;83;628534101;12486;291;13257;13479;7.31;0.45;247.22;17.69;771;84;4608.00;222
12487;83;628534121;12487;291;13261;13480;7.40;0.46;247.21;17.69;774;84;4609.00;219
12492;83;628534131;12492;287;13269;13480;7.51;0.47;247.22;17.68;777;84;4610.00;211
12494;83;628534142;12494;287;13274;13480;7.56;0.47;247.24;17.67;780;84;4611.00;206
12497;83;628534153;12497;287;13280;13480;7.69;0.48;247.23;17.67;783;84;4612.00;200
12499;83;628534163;12499;287;13284;13480;7.71;0.48;247.24;17.66;785;84;4613.00;196
12503;83;628534172;12503;291;13290;13480;7.73;0.48;247.22;17.66;787;84;4614.00;190
12506;83;628534182;12506;289;13292;13480;7.68;0.47;247.22;17.66;786;84;4615.00;188
12510;83;628534193;12510;291;13296;13481;7.71;0.48;247.22;17.65;786;84;4616.00;185
12514;83;628534203;12514;295;13301;13482;7.63;0.47;247.19;17.80;787;84;4617.00;181
12518;83;628534214;12518;298;13304;13482;7.59;0.47;247.23;17.80;786;84;4618.00;178
12521;83;628534225;12521;302;13307;13483;7.56;0.47;247.22;17.79;786;84;4619.00;176
12525;83;628534251;12525;304;13308;13483;7.45;0.46;247.21;17.79;783;84;4620.00;175
12529;83;628534262;12529;313;13309;13483;7.35;0.45;247.20;17.79;780;84;4621.00;174
12529;83;628534272;12529;317;13310;13483;7.35;0.45;247.20;17.79;781;84;4622.00;173
12533;83;628534283;12533;322;13314;13487;7.25;0.45;247.21;17.79;781;84;4623.00;173
12535;83;628534294;12535;325;13315;13487;7.19;0.44;247.21;17.79;780;84;4624.00;172
12538;83;628534311;12538;331;13317;13487;7.14;0.44;247.16;17.79;779;84;4625.00;170
12539;83;628534321;12539;327;13319;13490;7.13;0.44;247.17;17.79;780;84;4626.00;171
12540;83;628534331;12540;314;13320;13490;7.13;0.44;247.17;17.79;780;84;4627.00;170
12543;83;628534348;12543;305;13321;13490;7.22;0.44;247.18;17.78;778;84;4628.00;169
12545;83;628534359;12545;302;13324;13494;7.35;0.45;247.19;17.78;779;84;4629.00;170
12549;83;628534370;12549;299;13326;13495;7.43;0.45;247.19;17.78;777;84;4630.00;169
12552;83;628534381;12552;295;13326;13495;7.55;0.46;247.16;17.78;774;84;4631.00;169
12552;83;628534392;12552;295;13329;13499;7.67;0.47;247.16;17.77;777;84;4632.00;170
12555;83;628534405;12555;292;13329;13499;7.80;0.48;247.19;17.77;774;84;4633.00;170
12558;83;628534423;12558;291;13329;13499;7.87;0.48;247.22;17.77;771;84;4634.00;170
12559;83;628534443;12559;282;13331;13501;7.93;0.49;247.21;17.77;772;84;4635.00;170
12560;83;628534454;12560;282;13331;13501;7.95;0.49;247.20;17.77;771;84;4636.00;170
12563;83;628534465;12563;270;13335;13507;8.01;0.49;247.20;17.77;772;84;4637.00;172
12567;83;628534478;12567;263;13335;13507;8.08;0.50;247.20;17.77;768;84;4638.00;172
12568;83;628534490;12568;252;13336;13508;8.20;0.50;247.22;17.77;768;84;4639.00;172
12569;83;628534501;12569;246;13336;13508;8.32;0.51;247.20;17.77;767;84;4640.00;172
12572;83;628534513;12572;248;13336;13508;8.40;0.52;247.22;17.77;764;84;4641.00;172
12577;83;628534525;12577;239;13336;13508;8.47;0.52;247.27;17.77;759;84;4642.00;172
12577;83;628534537;12577;234;13336;13508;8.60;0.53;247.27;17.77;759;84;4643.00;172
12580;83;628534550;12580;232;13346;13520;8.79;0.54;247.31;17.75;766;84;4644.00;174
12582;83;628534570;12582;236;13347;13520;8.94;0.55;247.31;17.75;765;84;4645.00;173
12586;83;628534582;12586;225;13347;13520;9.04;0.55;247.31;17.75;761;84;4646.00;173
12591;83;628534594;12591;206;13347;13520;9.18;0.56;247.30;17.75;756;84;4647.00;173
12594;83;628534608;12594;194;13347;13520;9.32;0.57;247.30;17.75;753;84;4648.00;173
12596;83;628534620;12596;177;13347;13520;9.47;0.58;247.31;17.75;751;84;4649.00;173
12599;83;628534647;12599;165;13352;13526;9.57;0.58;247.31;17.74;753;84;4650.00;174
12602;83;628534661;12602;157;13352;13526;9.72;0.59;247.29;17.74;750;84;4651.00;174
12605;83;628534674;12605;148;13355;13530;9.94;0.61;247.28;17.74;750;84;4652.00;175
12608;83;628534686;12608;148;13357;13531;10.06;0.61;247.29;17.74;749;84;4653.00;174
12610;83;628534699;12610;147;13357;13531;10.16;0.62;247.31;17.74;747;84;4654.00;174
12612;83;628534711;12612;144;13357;13531;10.23;0.62;247.35;17.74;745;84;4655.00;174
12616;83;628534724;12616;139;13369;13544;10.31;0.63;247.39;17.87;753;84;4656.00;175
12618;83;628534738;12618;137;13369;13544;10.45;0.64;247.41;17.87;751;84;4657.00;175
12622;83;628534750;12622;133;13369;13544;10.48;0.64;247.40;17.87;747;84;4658.00;175
12626;83;628534763;12626;127;13370;13545;10.63;0.65;247.42;17.87;744;84;4659.00;175
12632;83;628534775;12632;123;13370;13546;10.67;0.65;247.45;17.87;738;84;4660.00;176
12634;83;628534788;12634;124;13370;13546;10.75;0.65;247.43;17.87;736;84;4661.00;176
12641;83;628534800;12641;120;13372;13549;10.84;0.66;247.49;17.87;731;84;4662.00;177
12644;83;628534813;12644;120;13372;13549;10.95;0.66;247.50;17.87;728;84;4663.00;177
12647;83;628534825;12647;118;13373;13549;11.05;0.67;247.52;17.87;726;84;4664.00;176
12649;83;628534837;12649;125;13373;13549;11.20;0.68;247.54;17.87;724;84;4665.00;176
12651;83;628534850;12651;122;13377;13555;11.34;0.69;247.54;17.86;726;84;4666.00;178
12656;84;628534862;12656;114;13377;13555;11.38;0.69;247.59;17.86;721;85;4667.00;178
12659;84;628534900;12659;115;13378;13555;11.50;0.70;247.60;17.86;719;85;4668.00;177
12663;84;628534913;12663;120;13378;13555;11.54;0.70;247.58;17.86;715;85;4669.00;177
12666;84;628534925;12666;124;13381;13559;11.55;0.70;247.64;17.86;715;85;4670.00;178
12666;84;628534938;12666;126;13382;13560;11.54;0.70;247.64;17.85;716;85;4671.00;178
12670;84;628534950;12670;125;13382;13560;11.57;0.70;247.67;17.85;712;85;4672.00;178
12674;84;628534961;12674;121;13383;13561;11.68;0.71;247.73;17.85;709;85;4673.00;178
12675;84;628534973;12675;121;13383;13561;11.80;0.71;247.73;17.85;708;85;4674.00;178
12680;84;628534983;12680;123;13383;13561;11.89;0.72;247.75;17.85;703;85;4675.00;178
12683;85;628534995;12683;124;13383;13561;11.94;0.72;247.76;17.85;700;86;4676.00;178
12683;85;628535017;12683;125;13383;13561;12.05;0.73;247.76;17.85;700;86;4677.00;178
12686;85;628535033;12686;131;13383;13561;11.99;0.73;247.77;17.85;697;86;4678.00;178
12690;85;628535044;12690;127;13383;13561;12.05;0.73;247.80;17.85;693;86;4679.00;178
12693;85;628535057;12693;144;13446;13686;11.66;0.71;247.81;17.77;753;86;4680.00;240
12695;85;628535076;12695;132;13448;13687;11.76;0.72;247.84;17.77;753;86;4681.00;239
12698;85;628535088;12698;122;13455;13687;11.84;0.72;247.84;17.76;757;86;4682.00;232
12702;85;628535100;12702;127;13460;13687;11.94;0.73;247.85;17.75;758;86;4683.00;227
12703;85;628535111;12703;124;13465;13687;11.92;0.73;247.86;17.75;762;86;4684.00;222
12705;85;628535123;12705;123;13467;13687;11.88;0.73;247.87;17.75;762;86;4685.00;220
12707;85;628535134;12707;129;13472;13687;11.94;0.73;247.87;17.74;765;86;4686.00;215
12710;85;628535150;12710;128;13475;13687;11.88;0.73;247.90;17.89;765;86;4687.00;212
12714;85;628535163;12714;129;13479;13688;11.83;0.72;247.91;17.88;765;86;4688.00;209
12719;85;628535174;12719;130;13481;13689;11.83;0.72;247.93;17.88;762;86;4689.00;208
12722;85;628535186;12722;131;13483;13689;11.77;0.72;247.92;17.88;761;86;4690.00;206
12725;85;628535197;12725;130;13487;13693;11.72;0.72;247.95;17.88;762;86;4691.00;206
12727;85;628535209;12727;131;13488;13693;11.79;0.72;247.95;17.88;761;86;4692.00;205
12732;85;628535220;12732;124;13489;13693;11.76;0.72;247.98;17.88;757;86;4693.00;204
12735;85;628535232;12735;124;13490;13693;11.83;0.73;248.01;17.89;755;86;4694.00;203
12742;85;628535245;12742;121;13494;13699;11.81;0.72;248.05;17.89;752;86;4695.00;205
12745;85;628535258;12745;120;13495;13699;11.83;0.72;248.03;17.90;750;86;4696.00;204
12747;85;628535270;12747;122;13495;13699;11.93;0.73;248.05;17.90;748;86;4697.00;204
12751;85;628535281;12751;119;13498;13702;11.94;0.73;248.08;17.90;747;86;4698.00;204
12755;85;628535292;12755;121;13498;13702;11.98;0.73;248.06;17.90;743;86;4699.00;204
12758;85;628535304;12758;119;13498;13702;12.05;0.74;248.04;17.90;740;86;4700.00;204
12762;85;628535325;12762;116;13498;13703;12.02;0.73;248.06;17.90;736;86;4701.00;205
12767;85;628535337;12767;115;13500;13704;11.94;0.73;248.05;18.04;733;86;4702.00;204
12768;85;628535354;12768;111;13500;13704;11.94;0.73;248.06;18.04;732;86;4703.00;204
12771;86;628535366;12771;118;13509;13717;11.94;0.73;248.06;18.03;738;87;4704.00;208
12774;86;628535395;12774;117;13510;13717;12.00;0.73;248.10;18.18;736;87;4705.00;207
12777;87;628535407;12777;121;13510;13717;12.09;0.74;248.10;18.18;733;88;4706.00;207
12781;87;628535430;12781;119;13514;13718;12.06;0.74;248.10;18.32;733;88;4707.00;204
12783;87;628535447;12783;119;13514;13718;12.03;0.73;248.10;18.32;731;88;4708.00;204
12787;87;628535469;12787;122;13518;13722;11.98;0.73;248.08;18.46;731;88;4709.00;204
12790;87;628535488;12790;125;13519;13722;11.97;0.73;248.09;18.46;729;88;4710.00;203
12795;87;628535508;12795;130;13524;13726;11.81;0.72;248.10;18.45;729;88;4711.00;202
12796;87;628535520;12796;135;13524;13726;11.78;0.72;248.08;18.45;728;88;4712.00;202
12800;87;628535532;12800;134;13526;13726;11.72;0.71;248.10;18.60;726;88;4713.00;200
12801;87;628535542;12801;141;13527;13726;11.71;0.71;248.10;18.60;726;88;4714.00;199
12803;87;628535552;12803;144;13527;13726;11.59;0.71;248.13;18.60;724;88;4715.00;199
12804;87;628535567;12804;151;13538;13738;11.55;0.70;248.13;18.60;734;88;4716.00;200
12809;87;628535578;12809;158;13539;13738;11.43;0.70;248.17;18.60;730;88;4717.00;199
12812;87;628535589;12812;166;13541;13738;11.32;0.69;248.16;18.60;729;88;4718.00;197
12814;87;628535600;12814;174;13543;13738;11.16;0.68;248.15;18.61;729;88;4719.00;195
12817;87;628535611;12817;181;13544;13738;11.00;0.67;248.13;18.62;727;88;4720.00;194
12820;87;628535622;12820;188;13544;13738;10.83;0.66;248.15;18.62;724;88;4721.00;194
12822;87;628535632;12822;195;13545;13739;10.71;0.65;248.14;18.63;723;88;4722.00;194
12825;87;628535643;12825;200;13546;13739;10.68;0.65;248.14;18.65;721;88;4723.00;193
12827;87;628535653;12827;207;13550;13745;10.64;0.65;248.13;18.64;723;88;4724.00;195
12830;87;628535664;12830;209;13555;13747;10.50;0.64;248.10;18.66;725;88;4725.00;192
12833;87;628535674;12833;212;13555;13747;10.38;0.63;248.13;18.66;722;88;4726.00;192
12837;87;628535684;12837;223;13557;13747;10.34;0.63;248.10;18.68;720;88;4727.00;190
12838;87;628535694;12838;229;13560;13751;10.32;0.63;248.09;18.68;722;88;4728.00;191
12841;87;628535706;12841;234;13562;13751;10.20;0.62;248.13;18.70;721;88;4729.00;189
12843;87;628535718;12843;233;13562;13751;10.19;0.62;248.12;18.70;719;88;4730.00;189
12847;87;628535728;12847;233;13565;13752;10.12;0.62;248.10;18.71;718;88;4731.00;187
12849;87;628535738;12849;240;13568;13756;10.07;0.62;248.09;18.71;719;88;4732.00;188
12851;87;628535747;12851;246;13570;13756;10.04;0.61;248.11;18.73;719;88;4733.00;186
12855;87;628535758;12855;253;13574;13759;9.94;0.61;248.15;18.75;719;88;4734.00;185
12856;87;628535768;12856;258;13575;13759;9.86;0.60;248.14;18.74;719;88;4735.00;184
12861;87;628535777;12861;266;13575;13759;9.75;0.59;248.13;18.74;714;88;4736.00;184
12862;87;628535787;12862;267;13577;13759;9.61;0.59;248.12;18.76;715;88;4737.00;182
12865;87;628535797;12865;267;13580;13763;9.51;0.58;248.11;18.76;715;88;4738.00;183
12866;87;628535809;12866;265;13582;13763;9.37;0.57;248.11;18.78;716;88;4739.00;181
12867;87;628535820;12867;266;13583;13763;9.24;0.57;248.10;18.78;716;88;4740.00;180
12870;87;628535830;12870;265;13585;13763;9.04;0.55;248.07;18.79;715;88;4741.00;178
12873;87;628535840;12873;260;13585;13764;8.83;0.54;248.07;18.79;712;88;4742.00;179
12874;87;628535849;12874;259;13587;13765;8.69;0.53;248.06;18.81;713;88;4743.00;178
12879;87;628535859;12879;265;13588;13765;8.51;0.52;248.07;18.81;709;88;4744.00;177
12880;87;628535868;12880;266;13589;13766;8.42;0.52;248.08;18.81;709;88;4745.00;177
12884;87;628535877;12884;268;13590;13766;8.32;0.51;248.08;18.82;706;88;4746.00;176
12886;87;628535888;12886;269;13591;13766;8.24;0.51;248.06;18.82;705;88;4747.00;175
12890;87;628535900;12890;269;13591;13766;8.13;0.50;248.02;18.82;701;88;4748.00;175
12890;87;628535917;12890;277;13592;13766;8.06;0.50;248.02;18.84;702;88;4749.00;174
12890;87;628535928;12890;279;13592;13766;7.97;0.49;248.02;18.84;702;88;4750.00;174
12894;87;628535943;12894;282;13592;13766;7.79;0.48;248.04;18.84;698;88;4751.00;174
12896;87;628535955;12896;300;13660;13893;7.94;0.50;248.02;18.79;764;88;4752.00;233
12900;87;628535982;12900;300;13661;13894;7.74;0.48;247.98;18.79;761;88;4753.00;233
12907;87;628535995;12907;304;13672;13894;7.69;0.48;247.94;18.79;765;88;4754.00;222
12909;87;628536007;12909;307;13676;13894;7.61;0.47;247.94;18.78;767;88;4755.00;218
12916;87;628536017;12916;302;13685;13894;7.52;0.47;247.91;18.79;769;88;4756.00;209
12919;87;628536027;12919;308;13691;13894;7.53;0.47;247.88;18.78;772;88;4757.00;203
12921;87;628536036;12921;309;13696;13894;7.44;0.46;247.90;18.77;775;88;4758.00;198
12924;87;628536046;12924;312;13699;13894;7.34;0.46;247.88;18.79;775;88;4759.00;195
12928;87;628536055;12928;301;13704;13895;7.30;0.45;247.88;18.78;776;88;4760.00;191
12931;87;628536078;12931;294;13709;13896;7.25;0.45;247.89;18.80;778;88;4761.00;187
12932;87;628536088;12932;297;13713;13896;7.20;0.45;247.91;18.81;781;88;4762.00;183
12935;87;628536098;12935;301;13714;13897;7.09;0.44;247.90;18.81;779;88;4763.00;183
12936;87;628536107;12936;308;13716;13897;6.95;0.43;247.91;18.81;780;88;4764.00;181
12938;87;628536116;12938;312;13719;13897;6.84;0.43;247.94;18.83;781;88;4765.00;178
12941;87;628536126;12941;318;13721;13897;6.78;0.42;247.94;18.83;780;88;4766.00;176
12943;87;628536135;12943;311;13724;13901;6.66;0.41;247.94;18.83;781;88;4767.00;177
12947;87;628536146;12947;311;13726;13901;6.64;0.41;247.92;18.83;779;88;4768.00;175
12949;87;628536162;12949;311;13727;13901;6.59;0.41;247.95;18.83;778;88;4769.00;174
12951;87;628536173;12951;312;13731;13907;6.64;0.41;247.97;18.82;780;88;4770.00;176
12952;87;628536182;12952;308;13731;13907;6.63;0.41;247.96;18.82;779;88;4771.00;176
12955;87;628536193;12955;311;13732;13907;6.64;0.41;247.98;18.82;777;88;4772.00;175
12957;87;628536202;12957;312;13735;13911;6.71;0.41;247.97;18.82;778;88;4773.00;176
12963;87;628536211;12963;314;13737;13912;6.66;0.41;247.95;18.82;774;88;4774.00;175
12968;87;628536221;12968;318;13738;13912;6.66;0.41;247.94;18.81;770;88;4775.00;174
12970;87;628536231;12970;320;13741;13916;6.65;0.41;247.93;18.81;771;88;4776.00;175
12973;87;628536240;12973;323;13742;13916;6.67;0.41;247.99;18.81;769;88;4777.00;174
12976;87;628536250;12976;327;13742;13916;6.68;0.41;248.00;18.81;766;88;4778.00;174
12979;87;628536260;12979;313;13744;13917;6.77;0.41;248.02;18.81;765;88;4779.00;173
12980;87;628536270;12980;300;13744;13917;6.83;0.42;248.01;18.81;764;88;4780.00;173
12985;87;628536280;12985;296;13748;13923;6.88;0.42;247.98;18.80;763;88;4781.00;175
12987;87;628536290;12987;286;13748;13923;6.99;0.43;247.97;18.80;761;88;4782.00;175
12992;87;628536300;12992;274;13749;13924;7.04;0.43;247.96;18.80;757;88;4783.00;175
12994;87;628536311;12994;275;13749;13924;7.06;0.43;247.95;18.80;755;88;4784.00;175
12997;87;628536322;12997;273;13749;13924;7.19;0.44;247.95;18.80;752;88;4785.00;175
12999;87;628536332;12999;270;13749;13924;7.25;0.44;247.95;18.80;750;88;4786.00;175
13001;87;628536343;13001;268;13749;13924;7.46;0.45;247.92;18.80;748;88;4787.00;175
13005;87;628536354;13005;263;13759;13936;7.68;0.47;247.93;18.79;754;88;4788.00;177
13008;87;628536371;13008;260;13759;13936;7.77;0.47;247.97;18.79;751;88;4789.00;177
13009;87;628536382;13009;261;13760;13936;7.93;0.48;247.96;18.79;751;88;4790.00;176
13012;87;628536393;13012;257;13760;13936;7.96;0.48;247.94;18.79;748;88;4791.00;176
13014;87;628536403;13014;261;13760;13936;7.97;0.49;247.96;18.79;746;88;4792.00;176
13017;87;628536415;13017;263;13760;13936;8.03;0.49;247.95;18.79;743;88;4793.00;176
13019;87;628536427;13019;266;13763;13940;8.12;0.49;247.98;18.78;744;88;4794.00;177
13019;87;628536438;13019;264;13763;13940;8.16;0.50;247.98;18.78;744;88;4795.00;177
13022;87;628536449;13022;263;13766;13944;8.19;0.50;247.99;18.78;744;88;4796.00;178
13023;87;628536461;13023;265;13767;13945;8.23;0.50;247.99;18.78;744;88;4797.00;178
13025;87;628536472;13025;262;13768;13945;8.26;0.50;248.01;18.78;743;88;4798.00;177
13027;87;628536484;13027;263;13768;13945;8.30;0.50;248.00;18.78;741;88;4799.00;177
13030;87;628536497;13030;268;13789;13986;8.42;0.51;248.00;18.75;759;88;4800.00;197
13035;87;628536516;13035;268;13791;13986;8.38;0.51;248.02;18.74;756;88;4801.00;195
13036;87;628536527;13036;269;13792;13986;8.51;0.52;248.02;18.74;756;88;4802.00;194
13038;87;628536538;13038;266;13793;13987;8.56;0.52;248.01;18.74;755;88;4803.00;194
13041;87;628536549;13041;267;13794;13988;8.58;0.52;248.02;18.74;753;88;4804.00;194
13043;87;628536560;13043;261;13795;13988;8.59;0.52;248.01;18.74;752;88;4805.00;193
13046;87;628536572;13046;263;13799;13991;8.60;0.52;248.01;18.74;753;88;4806.00;192
13048;87;628536583;13048;249;13801;13991;8.62;0.52;248.02;18.73;753;88;4807.00;190
13049;87;628536595;13049;239;13801;13991;8.57;0.52;248.02;18.73;752;88;4808.00;190
13053;87;628536607;13053;235;13802;13991;8.57;0.52;248.06;18.73;749;88;4809.00;189
13058;87;628536618;13058;228;13808;13997;8.56;0.52;248.07;18.73;750;88;4810.00;189
13061;87;628536630;13061;224;13808;13997;8.66;0.53;248.05;18.73;747;88;4811.00;189
13062;87;628536643;13062;221;13809;13997;8.79;0.53;248.07;18.86;747;88;4812.00;188
13066;87;628536662;13066;215;13810;13997;8.92;0.54;248.11;18.86;744;88;4813.00;187
13070;87;628536673;13070;215;13813;14001;9.02;0.55;248.19;18.86;743;88;4814.00;188
13073;87;628536685;13073;211;13815;14003;9.08;0.55;248.20;18.86;742;88;4815.00;188
13076;87;628536705;13076;194;13815;14003;9.22;0.56;248.20;18.86;739;88;4816.00;188
13080;87;628536717;13080;179;13816;14004;9.39;0.57;248.22;18.86;736;88;4817.00;188
13083;87;628536729;13083;165;13816;14004;9.59;0.58;248.26;18.86;733;88;4818.00;188
13088;87;628536742;13088;159;13817;14004;9.72;0.59;248.28;18.86;729;88;4819.00;187
13093;87;628536756;13093;154;13817;14004;9.87;0.60;248.26;18.86;724;88;4820.00;187
13096;87;628536770;13096;144;13817;14004;10.03;0.61;248.27;18.86;721;88;4821.00;187
13099;87;628536782;13099;140;13817;14004;10.19;0.62;248.28;18.86;718;88;4822.00;187
13101;87;628536795;13101;129;13817;14004;10.36;0.63;248.30;18.86;716;88;4823.00;187
13104;87;628536807;13104;134;13859;14074;10.39;0.63;248.29;18.80;755;88;4824.00;215
13107;87;628536825;13107;126;13861;14075;10.57;0.64;248.30;18.80;754;88;4825.00;214
13109;87;628536838;13109;120;13865;14075;10.76;0.65;248.33;18.79;756;88;4826.00;210
13113;87;628536851;13113;119;13866;14075;10.88;0.66;248.31;18.79;753;88;4827.00;209
13115;87;628536864;13115;117;13869;14077;10.94;0.66;248.33;18.79;754;88;4828.00;208
13116;87;628536883;13116;116;13871;14077;10.98;0.67;248.36;18.79;755;88;4829.00;206
13122;87;628536898;13122;120;13875;14077;11.04;0.67;248.41;18.78;753;88;4830.00;202
13123;87;628536911;13123;125;13877;14077;11.02;0.67;248.42;18.78;754;88;4831.00;200
13128;87;628536924;13128;127;13879;14078;11.00;0.67;248.44;18.78;751;88;4832.00;199
13129;87;628536937;13129;128;13881;14079;11.00;0.67;248.45;18.78;752;88;4833.00;198
13131;87;628536949;13131;136;13883;14079;11.01;0.67;248.46;18.78;752;88;4834.00;196
13134;87;628536961;13134;136;13888;14083;10.99;0.67;248.50;18.77;754;88;4835.00;195
13137;87;628536973;13137;139;13889;14083;11.03;0.67;248.50;18.77;752;88;4836.00;194
13141;87;628536984;13141;148;13892;14083;11.11;0.68;248.55;18.77;751;88;4837.00;191
13143;87;628536996;13143;148;13892;14083;11.24;0.69;248.60;18.77;749;88;4838.00;191
13145;87;628537008;13145;151;13896;14089;11.28;0.69;248.61;18.77;751;88;4839.00;193
13148;87;628537019;13148;152;13897;14089;11.33;0.69;248.61;18.77;749;88;4840.00;192
13151;87;628537030;13151;155;13897;14089;11.34;0.69;248.59;18.77;746;88;4841.00;192
13154;87;628537052;13154;157;13901;14092;11.31;0.69;248.60;18.76;747;88;4842.00;191
13159;87;628537064;13159;155;13901;14092;11.32;0.69;248.62;18.76;742;88;4843.00;191
13161;87;628537075;13161;154;13901;14092;11.34;0.69;248.60;18.76;740;88;4844.00;191
13166;87;628537092;13166;153;13901;14093;11.33;0.69;248.64;18.76;735;88;4845.00;192
13168;87;628537103;13168;155;13902;14094;11.40;0.70;248.66;18.76;734;88;4846.00;192
13176;87;628537113;13176;158;13902;14094;11.47;0.70;248.66;18.76;726;88;4847.00;192
13179;87;628537124;13179;161;13913;14107;11.48;0.70;248.66;18.75;734;88;4848.00;194
13183;87;628537135;13183;159;13913;14107;11.45;0.69;248.67;18.75;730;88;4849.00;194
13186;87;628537146;13186;161;13913;14107;11.41;0.69;248.64;18.75;727;88;4850.00;194
13188;87;628537157;13188;163;13914;14108;11.40;0.69;248.66;18.74;726;88;4851.00;194
13189;87;628537167;13189;163;13914;14108;11.38;0.69;248.67;18.74;725;88;4852.00;194
13190;87;628537177;13190;160;13917;14112;11.43;0.69;248.69;18.74;727;88;4853.00;195
13192;87;628537188;13192;157;13917;14112;11.45;0.70;248.71;18.74;725;88;4854.00;195
13196;87;628537199;13196;153;13921;14116;11.46;0.70;248.70;18.74;725;88;4855.00;195
13198;87;628537209;13198;151;13921;14116;11.44;0.70;248.72;18.74;723;88;4856.00;195
13204;87;628537219;13204;148;13921;14116;11.43;0.70;248.72;18.74;717;88;4857.00;195
13207;87;628537230;13207;150;13922;14116;11.46;0.70;248.73;18.88;715;88;4858.00;194
13209;87;628537240;13209;144;13922;14116;11.48;0.70;248.73;18.88;713;88;4859.00;194
13213;87;628537252;13213;144;13942;14150;11.41;0.70;248.71;18.85;729;88;4860.00;208
13217;87;628537264;13217;139;13942;14150;11.45;0.70;248.71;18.85;725;88;4861.00;208
13222;87;628537274;13222;132;13943;14150;11.43;0.70;248.73;18.85;721;88;4862.00;207
13225;87;628537285;13225;134;13943;14150;11.45;0.70;248.72;18.85;718;88;4863.00;207
13227;87;628537294;13227;135;13944;14150;11.49;0.70;248.73;18.85;717;88;4864.00;206
13230;87;628537315;13230;134;13946;14150;11.52;0.70;248.73;18.88;716;88;4865.00;204
13232;88;628537327;13232;132;13947;14151;11.62;0.71;248.72;18.88;715;89;4866.00;204
13237;88;628537349;13237;132;13947;14151;11.70;0.71;248.72;18.88;710;89;4867.00;204
13239;88;628537363;13239;133;13951;14157;11.72;0.71;248.74;18.88;712;89;4868.00;206
13244;88;628537374;13244;131;13952;14158;11.62;0.71;248.76;18.87;708;89;4869.00;206
13246;88;628537385;13246;132;13953;14158;11.56;0.70;248.78;18.87;707;89;4870.00;205
13247;88;628537394;13247;131;13954;14158;11.55;0.70;248.76;18.87;707;89;4871.00;204
13253;88;628537410;13253;130;13958;14162;11.47;0.70;248.72;18.87;705;89;4872.00;204
13257;88;628537428;13257;133;13959;14162;11.44;0.70;248.72;19.01;702;89;4873.00;203
13258;88;628537438;13258;137;13959;14162;11.49;0.70;248.71;19.01;701;89;4874.00;203
13263;88;628537448;13263;133;13960;14163;11.52;0.70;248.69;19.01;697;89;4875.00;203
13267;88;628537458;13267;135;13965;14167;11.47;0.70;248.76;19.15;698;89;4876.00;202
13272;88;628537474;13272;135;13965;14167;11.50;0.70;248.73;19.15;693;89;4877.00;202
13276;88;628537484;13276;135;13967;14170;11.46;0.69;248.72;19.14;691;89;4878.00;203
13278;88;628537494;13278;138;13970;14170;11.42;0.69;248.70;19.28;692;89;4879.00;200
13280;88;628537504;13280;141;13970;14170;11.34;0.69;248.68;19.28;690;89;4880.00;200
13281;88;628537514;13281;139;13970;14170;11.24;0.68;248.68;19.28;689;89;4881.00;200
13284;88;628537524;13284;142;13974;14174;11.20;0.68;248.70;19.28;690;89;4882.00;200
13289;88;628537535;13289;146;13975;14174;11.18;0.68;248.69;19.28;686;89;4883.00;199
13289;88;628537544;13289;147;13975;14174;11.15;0.68;248.69;19.28;686;89;4884.00;199
13293;88;628537553;13293;152;13976;14174;11.08;0.68;248.70;19.28;683;89;4885.00;198
13294;88;628537568;13294;153;13976;14175;11.05;0.67;248.70;19.28;682;89;4886.00;199
13296;88;628537578;13296;157;13977;14176;11.00;0.67;248.71;19.28;681;89;4887.00;199
13299;88;628537588;13299;158;13977;14176;10.86;0.66;248.72;19.28;678;89;4888.00;199
13300;88;628537603;13300;165;13978;14177;10.78;0.66;248.71;19.28;678;89;4889.00;199
13304;88;628537614;13304;175;13980;14177;10.60;0.64;248.70;19.30;676;89;4890.00;197
13304;88;628537624;13304;181;13980;14177;10.51;0.64;248.70;19.30;676;89;4891.00;197
13307;88;628537633;13307;192;13981;14177;10.42;0.63;248.73;19.32;674;89;4892.00;196
13307;88;628537642;13307;198;13982;14177;10.28;0.63;248.73;19.34;675;89;4893.00;195
13309;88;628537651;13309;207;13983;14177;10.16;0.62;248.76;19.36;674;89;4894.00;194
13311;88;628537661;13311;210;13985;14177;9.98;0.61;248.75;19.38;674;89;4895.00;192
13313;88;628537669;13313;237;14050;14304;10.00;0.62;248.76;19.29;737;89;4896.00;254
13316;88;628537688;13316;242;14054;14305;9.87;0.61;248.79;19.28;738;89;4897.00;251
13319;88;628537698;13319;239;14064;14305;9.83;0.61;248.76;19.30;745;89;4898.00;241
13321;88;628537707;13321;242;14068;14305;9.75;0.60;248.75;19.30;747;89;4899.00;237
13325;88;628537716;13325;248;14075;14305;9.72;0.60;248.75;19.31;750;89;4900.00;230
13325;88;628537729;13325;252;14081;14305;9.61;0.59;248.75;19.31;756;89;4901.00;224
13326;88;628537739;13326;260;14087;14305;9.39;0.58;248.74;19.32;761;89;4902.00;218
13328;88;628537748;13328;265;14091;14305;9.26;0.57;248.72;19.32;763;89;4903.00;214
13331;88;628537757;13331;268;14096;14306;9.13;0.57;248.68;19.32;765;89;4904.00;210
13333;88;628537771;13333;272;14101;14308;9.00;0.56;248.66;19.33;768;89;4905.00;207
13335;88;628537780;13335;276;14105;14308;8.88;0.55;248.66;19.33;770;89;4906.00;203
13337;88;628537790;13337;281;14108;14309;8.66;0.54;248.66;19.35;771;89;4907.00;201
13342;88;628537799;13342;289;14110;14309;8.47;0.52;248.64;19.35;768;89;4908.00;199
13345;88;628537808;13345;285;14113;14309;8.23;0.51;248.61;19.36;768;89;4909.00;196
13349;88;628537817;13349;291;14115;14309;8.07;0.50;248.66;19.36;766;89;4910.00;194
13352;88;628537827;13352;288;14118;14313;7.92;0.49;248.64;19.37;766;89;4911.00;195
13354;88;628537836;13354;293;14121;14313;7.79;0.48;248.66;19.37;767;89;4912.00;192
13356;88;628537845;13356;295;14123;14313;7.71;0.47;248.67;19.39;767;89;4913.00;190
13359;88;628537854;13359;302;14128;14316;7.57;0.47;248.68;19.39;769;89;4914.00;188
13359;88;628537863;13359;302;14129;14316;7.47;0.46;248.68;19.40;770;89;4915.00;187
13361;88;628537872;13361;306;14131;14316;7.42;0.46;248.67;19.40;770;89;4916.00;185
13364;88;628537881;13364;315;14136;14320;7.38;0.45;248.66;19.40;772;89;4917.00;184
13366;88;628537894;13366;318;14138;14321;7.33;0.45;248.65;19.41;772;89;4918.00;183
13369;88;628537908;13369;327;14139;14321;7.24;0.44;248.62;19.42;770;89;4919.00;182
13372;88;628537924;13372;327;14143;14326;7.20;0.44;248.58;19.42;771;89;4920.00;183
13375;88;628537942;13375;339;14143;14326;7.07;0.43;248.56;19.42;768;89;4921.00;183
13376;88;628537961;13376;342;14147;14326;6.97;0.43;248.57;19.47;771;89;4922.00;179
13379;88;628537974;13379;344;14148;14327;6.89;0.42;248.59;19.47;769;89;4923.00;179
13383;88;628537987;13383;348;14149;14327;6.77;0.42;248.55;19.48;766;89;4924.00;178
13386;88;628538000;13386;349;14154;14333;6.73;0.41;248.57;19.49;768;89;4925.00;179
13386;88;628538020;13386;355;14155;14333;6.63;0.41;248.57;19.50;769;89;4926.00;178
13392;88;628538029;13392;357;14157;14334;6.44;0.39;248.54;19.51;765;89;4927.00;177
13394;88;628538039;13394;360;14157;14334;6.33;0.39;248.55;19.51;763;89;4928.00;177
13397;88;628538048;13397;363;14158;14334;6.21;0.38;248.55;19.52;761;89;4929.00;176
13400;88;628538057;13400;355;14159;14334;6.07;0.37;248.58;19.53;759;89;4930.00;175
13403;88;628538067;13403;342;14160;14334;6.02;0.37;248.59;19.54;757;89;4931.00;174
13405;88;628538076;13405;326;14170;14346;6.13;0.38;248.61;19.53;765;89;4932.00;176
13408;88;628538086;13408;314;14170;14346;6.18;0.38;248.61;19.53;762;89;4933.00;176
13411;88;628538096;13411;302;14171;14346;6.25;0.38;248.64;19.53;760;89;4934.00;175
13413;88;628538106;13413;303;14171;14346;6.40;0.39;248.64;19.53;758;89;4935.00;175
13417;88;628538115;13417;298;14171;14346;6.48;0.40;248.61;19.53;754;89;4936.00;175
13419;88;628538124;13419;282;14171;14346;6.57;0.40;248.64;19.53;752;89;4937.00;175
13422;88;628538140;13422;269;14174;14350;6.70;0.41;248.66;19.53;752;89;4938.00;176
13425;88;628538150;13425;263;14174;14350;6.81;0.42;248.66;19.53;749;89;4939.00;176
13427;88;628538166;13427;252;14177;14354;6.98;0.43;248.63;19.52;750;89;4940.00;177
13430;88;628538176;13430;248;14178;14355;7.11;0.43;248.64;19.52;748;89;4941.00;177
13433;88;628538186;13433;238;14179;14355;7.26;0.44;248.65;19.52;746;89;4942.00;176
13434;88;628538195;13434;228;14179;14355;7.44;0.46;248.67;19.52;745;89;4943.00;176
13437;88;628538205;13437;229;14190;14368;7.67;0.47;248.69;19.50;753;89;4944.00;178
13441;88;628538216;13441;222;14190;14368;7.84;0.48;248.69;19.50;749;89;4945.00;178
13443;88;628538226;13443;217;14190;14368;8.00;0.49;248.70;19.50;747;89;4946.00;178
13451;88;628538236;13451;212;14191;14369;8.14;0.50;248.72;19.50;740;89;4947.00;178
13455;88;628538247;13455;213;14191;14370;8.24;0.50;248.72;19.50;736;89;4948.00;179
13458;88;628538258;13458;216;14191;14370;8.32;0.51;248.75;19.50;733;89;4949.00;179
13461;88;628538270;13461;213;14195;14379;8.46;0.52;248.78;19.50;734;89;4950.00;184
13467;88;628538282;13467;216;14196;14379;8.50;0.52;248.76;19.50;729;89;4951.00;183
13470;88;628538292;13470;210;14197;14379;8.61;0.52;248.75;19.49;727;89;4952.00;182
13476;88;628538310;13476;207;14197;14379;8.66;0.53;248.79;19.49;721;89;4953.00;182
13481;88;628538321;13481;207;14201;14385;8.80;0.54;248.77;19.49;720;89;4954.00;184
13486;88;628538333;13486;202;14201;14385;8.81;0.54;248.75;19.49;715;89;4955.00;184
13489;88;628538344;13489;198;14202;14385;8.83;0.54;248.76;19.49;713;89;4956.00;183
13494;88;628538354;13494;194;14202;14385;8.85;0.54;248.76;19.49;708;89;4957.00;183
13496;88;628538365;13496;191;14206;14389;8.88;0.54;248.76;19.48;710;89;4958.00;183
13500;88;628538376;13500;186;14208;14390;8.89;0.54;248.76;19.48;708;89;4959.00;182
13504;88;628538392;13504;191;14209;14390;8.89;0.54;248.77;19.48;705;89;4960.00;181
13507;88;628538404;13507;192;14210;14391;8.95;0.54;248.75;19.48;703;89;4961.00;181
13512;88;628538415;13512;192;14210;14391;8.92;0.54;248.73;19.48;698;89;4962.00;181
13517;88;628538427;13517;193;14210;14391;8.92;0.54;248.73;19.48;693;89;4963.00;181
13518;88;628538438;13518;193;14210;14391;9.05;0.55;248.72;19.48;692;89;4964.00;181
13521;88;628538448;13521;195;14210;14391;9.10;0.55;248.71;19.48;689;89;4965.00;181
13522;88;628538459;13522;195;14210;14391;9.10;0.55;248.70;19.48;688;89;4966.00;181
13522;88;628538471;13522;193;14210;14391;9.20;0.56;248.70;19.48;688;89;4967.00;181
13528;88;628538481;13528;205;14253;14461;9.25;0.56;248.72;19.42;725;89;4968.00;208
13534;88;628538498;13534;205;14254;14462;9.25;0.56;248.74;19.42;720;89;4969.00;208
13538;88;628538510;13538;199;14260;14462;9.33;0.57;248.74;19.41;722;89;4970.00;202
13541;88;628538521;13541;202;14261;14462;9.47;0.58;248.74;19.41;720;89;4971.00;201
13544;88;628538532;13544;200;14265;14462;9.60;0.58;248.75;19.41;721;89;4972.00;197
13545;88;628538543;13545;200;14266;14462;9.68;0.59;248.75;19.41;721;89;4973.00;196
13551;88;628538555;13551;204;14270;14462;9.67;0.59;248.73;19.40;719;89;4974.00;192
13553;88;628538566;13553;208;14272;14462;9.69;0.59;248.76;19.40;719;89;4975.00;190
13554;88;628538578;13554;210;14274;14463;9.73;0.59;248.75;19.40;720;89;4976.00;189
13557;88;628538589;13557;198;14277;14464;9.67;0.59;248.77;19.39;720;89;4977.00;187
13561;88;628538602;13561;194;14278;14464;9.69;0.59;248.80;19.39;717;89;4978.00;186
13562;88;628538614;13562;189;14282;14468;9.59;0.58;248.82;19.54;720;89;4979.00;186
13565;88;628538629;13565;184;14282;14468;9.61;0.58;248.83;19.54;717;89;4980.00;186
13569;88;628538641;13569;188;14282;14468;9.62;0.58;248.90;19.54;713;89;4981.00;186
13573;88;628538653;13573;189;14282;14468;9.64;0.58;248.90;19.54;709;89;4982.00;186
13575;88;628538665;13575;189;14286;14474;9.72;0.59;248.92;19.53;711;89;4983.00;188
13579;88;628538678;13579;186;14286;14474;9.82;0.60;248.92;19.53;707;89;4984.00;188
13582;88;628538696;13582;180;14287;14474;9.87;0.60;248.92;19.53;705;89;4985.00;187
13584;88;628538713;13584;162;14289;14477;9.98;0.61;248.93;19.53;705;89;4986.00;188
13586;88;628538726;13586;148;14289;14477;10.15;0.62;248.95;19.53;703;89;4987.00;188
13588;88;628538738;13588;143;14290;14477;10.32;0.63;248.94;19.53;702;89;4988.00;187
13591;88;628538751;13591;135;14290;14478;10.49;0.64;248.96;19.53;699;89;4989.00;188
13593;88;628538765;13593;132;14291;14479;10.67;0.65;248.96;19.52;698;89;4990.00;188
13595;88;628538777;13595;128;14291;14479;10.80;0.66;248.95;19.52;696;89;4991.00;188
13598;88;628538789;13598;125;14301;14492;10.98;0.67;248.95;19.51;703;89;4992.00;191
13601;88;628538801;13601;123;14301;14492;11.06;0.67;248.95;19.51;700;89;4993.00;191
13604;88;628538815;13604;122;14302;14492;11.27;0.68;248.96;19.51;698;89;4994.00;190
13608;88;628538827;13608;122;14304;14494;11.40;0.69;248.98;19.51;696;89;4995.00;190
13610;88;628538840;13610;123;14304;14494;11.44;0.69;249.00;19.51;694;89;4996.00;190
13613;88;628538853;13613;121;14307;14498;11.50;0.69;248.98;19.50;694;89;4997.00;191
13615;88;628538866;13615;120;14307;14498;11.52;0.70;249.00;19.50;692;89;4998.00;191
13618;89;628538877;13618;120;14311;14502;11.49;0.69;249.00;19.50;693;90;4999.00;191
13621;89;628538906;13621;117;14311;14502;11.52;0.70;249.03;19.50;690;90;5000.00;191
13624;89;628538929;13624;120;14311;14502;11.56;0.70;249.04;19.50;687;90;5001.00;191
13626;89;628538942;13626;116;14311;14502;11.49;0.70;249.05;19.50;685;90;5002.00;191
13629;89;628538953;13629;112;14311;14502;11.46;0.70;249.07;19.50;682;90;5003.00;191
13630;89;628538964;13630;113;14321;14514;11.50;0.70;249.07;19.48;691;90;5004.00;193
13633;89;628538976;13633;117;14321;14514;11.57;0.70;249.09;19.48;688;90;5005.00;193
13636;89;628538987;13636;114;14322;14514;11.59;0.70;249.08;19.48;686;90;5006.00;192
13637;89;628539003;13637;113;14322;14514;11.73;0.71;249.08;19.48;685;90;5007.00;192
13642;89;628539014;13642;113;14322;14514;11.81;0.72;249.09;19.48;680;90;5008.00;192
13643;89;628539025;13643;110;14322;14514;11.91;0.72;249.09;19.48;679;90;5009.00;192
13645;89;628539038;13645;115;14322;14515;12.00;0.73;249.13;19.48;677;90;5010.00;193
13649;89;628539048;13649;113;14322;14515;12.02;0.73;249.13;19.48;673;90;5011.00;193
13650;89;628539064;13650;114;14326;14521;12.03;0.73;249.14;19.48;676;90;5012.00;195
13654;89;628539075;13654;114;14327;14522;12.01;0.73;249.12;19.48;673;90;5013.00;195
13656;89;628539085;13656;118;14328;14522;12.18;0.74;249.14;19.48;672;90;5014.00;194
13657;89;628539095;13657;120;14328;14522;12.17;0.74;249.15;19.48;671;90;5015.00;194
13658;89;628539104;13658;122;14331;14526;12.19;0.74;249.14;19.47;673;90;5016.00;195
13661;89;628539114;13661;124;14331;14526;12.30;0.75;249.16;19.47;670;90;5017.00;195
13663;89;628539124;13663;127;14331;14526;12.37;0.75;249.16;19.47;668;90;5018.00;195
13667;89;628539134;13667;127;14332;14527;12.42;0.75;249.14;19.47;665;90;5019.00;195
13671;89;628539144;13671;134;14335;14531;12.32;0.75;249.17;19.47;664;90;5020.00;196
13676;89;628539154;13676;137;14335;14531;12.33;0.75;249.14;19.47;659;90;5021.00;196
13677;89;628539164;13677;134;14337;14534;12.28;0.75;249.13;19.46;660;90;5022.00;197
13680;89;628539173;13680;138;14337;14534;12.12;0.74;249.18;19.46;657;90;5023.00;197
13683;89;628539188;13683;141;14338;14534;12.00;0.73;249.21;19.46;655;90;5024.00;196
13687;89;628539197;13687;140;14338;14534;11.89;0.72;249.20;19.46;651;90;5025.00;196
13690;89;628539206;13690;142;14341;14538;11.90;0.72;249.21;19.46;651;90;5026.00;197
13697;89;628539215;13697;141;14341;14538;11.93;0.73;249.21;19.46;644;90;5027.00;197
13701;89;628539225;13701;136;14342;14538;11.97;0.73;249.20;19.46;641;90;5028.00;196
13703;89;628539233;13703;127;14343;14538;11.90;0.72;249.19;19.61;640;90;5029.00;195
13708;89;628539242;13708;117;14343;14539;11.82;0.72;249.18;19.61;635;90;5030.00;196
13714;89;628539252;13714;116;14344;14540;11.77;0.71;249.22;19.60;630;90;5031.00;196
13717;89;628539262;13717;109;14344;14540;11.65;0.71;249.27;19.60;627;90;5032.00;196
13722;89;628539271;13722;106;14345;14541;11.69;0.71;249.25;19.60;623;90;5033.00;196
13725;89;628539281;13725;101;14346;14541;11.76;0.71;249.23;19.62;621;90;5034.00;195
13728;89;628539291;13728;99;14347;14541;11.80;0.72;249.24;19.64;619;90;5035.00;194
13731;89;628539300;13731;95;14347;14541;11.88;0.72;249.22;19.64;616;90;5036.00;194
13736;89;628539309;13736;99;14347;14541;11.93;0.73;249.19;19.64;611;90;5037.00;194
13740;89;628539318;13740;98;14347;14541;11.98;0.73;249.17;19.64;607;90;5038.00;194
13743;89;628539327;13743;102;14347;14541;12.06;0.73;249.16;19.64;604;90;5039.00;194
13748;89;628539339;13748;133;14446;14771;11.72;0.73;249.17;19.50;698;90;5040.00;325
13752;89;628539366;13752;128;14447;14772;11.78;0.74;249.20;19.50;695;90;5041.00;325
13753;89;628539377;13753;119;14457;14772;11.87;0.74;249.19;19.49;704;90;5042.00;315
13760;89;628539387;13760;115;14461;14772;11.76;0.73;249.17;19.64;701;90;5043.00;311
13762;89;628539397;13762;113;14470;14772;11.66;0.73;249.17;19.63;708;90;5044.00;302
13763;89;628539407;13763;114;14476;14772;11.62;0.72;249.18;19.62;713;90;5045.00;296
13765;89;628539417;13765;112;14484;14772;11.54;0.72;249.18;19.76;719;90;5046.00;288
13766;89;628539427;13766;114;14492;14772;11.47;0.71;249.16;19.75;726;90;5047.00;280
13769;89;628539437;13769;115;14497;14773;11.44;0.71;249.17;19.75;728;90;5048.00;276
13770;89;628539448;13770;118;14501;14774;11.35;0.71;249.16;19.90;731;90;5049.00;273
13773;89;628539463;13773;124;14507;14774;11.26;0.70;249.17;19.89;734;90;5050.00;267
13775;89;628539474;13775;129;14510;14775;11.15;0.69;249.14;19.89;735;90;5051.00;265
13777;89;628539485;13777;138;14514;14775;11.01;0.68;249.15;20.04;737;90;5052.00;261
13780;89;628539500;13780;144;14517;14775;10.90;0.67;249.17;20.04;737;90;5053.00;258
13782;89;628539511;13782;146;14521;14775;10.71;0.66;249.16;20.03;739;90;5054.00;254
13784;89;628539521;13784;154;14527;14779;10.53;0.65;249.15;20.18;743;90;5055.00;252
13786;89;628539532;13786;160;14531;14779;10.35;0.64;249.12;20.19;745;90;5056.00;248
13788;89;628539548;13788;164;14533;14779;10.27;0.63;249.12;20.18;745;90;5057.00;246
13792;89;628539558;13792;167;14538;14782;10.19;0.63;249.11;20.33;746;90;5058.00;244
13795;89;628539569;13795;179;14540;14782;10.19;0.62;249.10;20.33;745;90;5059.00;242
13796;89;628539581;13796;184;14545;14782;10.14;0.62;249.09;20.36;749;90;5060.00;237
13799;89;628539591;13799;194;14548;14786;10.03;0.61;249.07;20.35;749;90;5061.00;238
13800;89;628539602;13800;208;14553;14787;9.93;0.61;249.11;20.35;753;90;5062.00;234
13801;89;628539612;13801;219;14557;14787;9.75;0.60;249.09;20.36;756;90;5063.00;230
13803;89;628539622;13803;234;14562;14791;9.56;0.59;249.07;20.37;759;90;5064.00;229
13805;89;628539633;13805;243;14564;14791;9.44;0.58;249.06;20.37;759;90;5065.00;227
13806;89;628539643;13806;251;14565;14791;9.32;0.57;249.04;20.39;759;90;5066.00;226
13809;89;628539653;13809;261;14568;14792;9.21;0.56;249.03;20.40;759;90;5067.00;224
13810;89;628539664;13810;268;14571;14792;9.05;0.55;249.01;20.41;761;90;5068.00;221
13811;89;628539674;13811;278;14575;14798;8.94;0.55;249.01;20.41;764;90;5069.00;223
13812;89;628539686;13812;288;14579;14798;8.80;0.54;249.00;20.43;767;90;5070.00;219
13812;89;628539696;13812;298;14581;14799;8.64;0.53;249.00;20.43;769;90;5071.00;218
13815;89;628539711;13815;302;14584;14799;8.50;0.52;248.98;20.45;769;90;5072.00;215
13817;89;628539721;13817;304;14585;14799;8.36;0.51;248.96;20.45;768;90;5073.00;214
13818;89;628539730;13818;308;14587;14799;8.19;0.50;248.95;20.47;769;90;5074.00;212
13819;89;628539739;13819;319;14588;14799;8.01;0.49;248.96;20.47;769;90;5075.00;211
13822;89;628539748;13822;330;14600;14811;7.87;0.48;248.94;20.48;778;90;5076.00;211
13824;89;628539759;13824;339;14600;14811;7.72;0.47;248.91;20.48;776;90;5077.00;211
13828;89;628539769;13828;343;14606;14811;7.54;0.46;248.93;20.50;778;90;5078.00;205
13828;89;628539777;13828;343;14607;14811;7.43;0.45;248.93;20.50;779;90;5079.00;204
13828;89;628539786;13828;346;14609;14811;7.27;0.45;248.93;20.51;781;90;5080.00;202
13831;89;628539795;13831;348;14609;14811;7.21;0.44;248.91;20.51;778;90;5081.00;202
13832;89;628539804;13832;348;14614;14815;7.10;0.43;248.90;20.53;782;90;5082.00;201
13832;89;628539813;13832;343;14614;14815;7.12;0.44;248.90;20.53;782;90;5083.00;201
13833;89;628539823;13833;332;14618;14819;7.19;0.44;248.89;20.52;785;90;5084.00;201
13833;89;628539832;13833;327;14621;14821;7.21;0.44;248.89;20.54;788;90;5085.00;200
13835;89;628539841;13835;328;14622;14821;7.29;0.45;248.93;20.54;787;90;5086.00;199
13836;89;628539851;13836;321;14623;14821;7.36;0.45;248.91;20.55;787;90;5087.00;198
13840;89;628539861;13840;317;14635;14834;7.40;0.45;248.88;20.54;795;90;5088.00;199
13841;89;628539871;13841;313;14637;14834;7.45;0.46;248.87;20.56;796;90;5089.00;197
13841;89;628539881;13841;311;14638;14834;7.56;0.46;248.87;20.56;797;90;5090.00;196
13843;89;628539892;13843;310;14639;14835;7.66;0.47;248.85;20.55;796;90;5091.00;196
13845;89;628539907;13845;305;14641;14836;7.72;0.47;248.85;20.57;796;90;5092.00;195
13848;89;628539924;13848;303;14641;14836;7.65;0.47;248.88;20.57;793;90;5093.00;195
13850;90;628539939;13850;288;14643;14839;7.61;0.47;248.88;20.56;793;91;5094.00;196
13852;90;628539986;13852;294;14644;14839;7.62;0.47;248.88;20.58;792;91;5095.00;195
13856;90;628540002;13856;286;14645;14839;7.56;0.46;248.88;20.58;789;91;5096.00;194
13859;90;628540025;13859;289;14646;14839;7.45;0.46;248.87;20.59;787;91;5097.00;193
13861;90;628540036;13861;295;14652;14845;7.44;0.46;248.87;20.60;791;91;5098.00;193
13861;90;628540046;13861;299;14653;14845;7.35;0.45;248.87;20.60;792;91;5099.00;192
13864;90;628540059;13864;298;14658;14864;7.27;0.45;248.89;20.61;794;91;5100.00;206
13865;90;628540076;13865;292;14659;14864;7.30;0.45;248.89;20.61;794;91;5101.00;205
13868;90;628540086;13868;283;14663;14868;7.28;0.45;248.92;20.61;795;91;5102.00;205
13874;90;628540097;13874;288;14665;14869;7.22;0.44;248.91;20.63;791;91;5103.00;204
13878;90;628540107;13878;285;14665;14869;7.31;0.45;248.95;20.63;787;91;5104.00;204
13882;90;628540117;13882;278;14669;14870;7.37;0.45;248.94;20.65;787;91;5105.00;201
13887;90;628540129;13887;275;14670;14870;7.36;0.45;248.98;20.65;783;91;5106.00;200
13891;90;628540139;13891;259;14671;14870;7.37;0.45;248.97;20.65;780;91;5107.00;199
13895;90;628540150;13895;252;14673;14870;7.40;0.46;248.96;20.67;778;91;5108.00;197
13898;90;628540160;13898;241;14673;14870;7.50;0.46;248.97;20.67;775;91;5109.00;197
13904;90;628540170;13904;241;14673;14870;7.60;0.47;248.96;20.67;769;91;5110.00;197
13905;90;628540180;13905;238;14673;14870;7.75;0.48;248.97;20.67;768;91;5111.00;197
13908;90;628540189;13908;234;14707;14940;7.85;0.49;248.95;20.63;799;91;5112.00;233
13911;90;628540205;13911;227;14711;14941;7.85;0.49;248.94;20.62;800;91;5113.00;230
13915;90;628540216;13915;217;14717;14941;7.99;0.49;248.94;20.61;802;91;5114.00;224
13916;90;628540226;13916;217;14717;14941;8.09;0.50;248.95;20.61;801;91;5115.00;224
13923;90;628540236;13923;214;14720;14941;8.12;0.50;248.94;20.61;797;91;5116.00;221
13927;90;628540248;13927;212;14722;14941;8.19;0.50;248.94;20.61;795;91;5117.00;219
13931;90;628540259;13931;203;14728;14941;8.20;0.50;248.95;20.60;797;91;5118.00;213
13935;90;628540271;13935;203;14731;14941;8.26;0.51;248.93;20.60;796;91;5119.00;210
13940;90;628540282;13940;206;14733;14942;8.32;0.51;248.93;20.60;793;91;5120.00;209
13944;90;628540294;13944;206;14736;14943;8.43;0.52;248.91;20.60;792;91;5121.00;207
13949;90;628540306;13949;208;14738;14943;8.55;0.52;248.91;20.60;789;91;5122.00;205
13954;90;628540317;13954;214;14742;14947;8.60;0.53;248.91;20.59;788;91;5123.00;205
13960;90;628540329;13960;212;14743;14947;8.67;0.53;248.90;20.59;783;91;5124.00;204
13963;90;628540341;13963;208;14743;14947;8.80;0.54;248.88;20.59;780;91;5125.00;204
13968;90;628540353;13968;211;14743;14947;8.80;0.54;248.93;20.59;775;91;5126.00;204
13974;90;628540366;13974;213;14746;14953;8.74;0.53;248.88;20.59;772;91;5127.00;207
13978;90;628540379;13978;213;14746;14953;8.73;0.53;248.88;20.59;768;91;5128.00;207
13984;90;628540390;13984;217;14747;14953;8.65;0.53;248.88;20.59;763;91;5129.00;206
13986;90;628540404;13986;227;14751;14959;8.78;0.54;248.88;20.58;765;91;5130.00;208
13993;90;628540417;13993;224;14751;14959;8.81;0.54;248.90;20.58;758;91;5131.00;208
13997;90;628540430;13997;224;14751;14959;8.88;0.54;248.90;20.58;754;91;5132.00;208
14001;90;628540442;14001;226;14753;14960;8.92;0.54;248.89;20.58;752;91;5133.00;207
14005;90;628540453;14005;229;14755;14961;8.90;0.54;248.93;20.73;750;91;5134.00;206
14009;90;628540467;14009;231;14757;14961;8.91;0.54;248.90;20.74;748;91;5135.00;204
14013;90;628540480;14013;235;14765;14974;9.01;0.55;248.91;20.72;752;91;5136.00;209
14018;90;628540492;14018;230;14766;14974;9.02;0.55;248.93;20.72;748;91;5137.00;208
14023;90;628540504;14023;233;14767;14974;8.99;0.55;248.92;20.72;744;91;5138.00;207
14026;90;628540516;14026;232;14768;14975;8.99;0.55;248.93;20.72;742;91;5139.00;207
14029;90;628540528;14029;238;14768;14975;9.03;0.55;248.92;20.72;739;91;5140.00;207
14031;90;628540540;14031;240;14773;14979;8.98;0.54;248.94;20.72;742;91;5141.00;206
14036;90;628540552;14036;242;14774;14979;8.91;0.54;248.96;20.72;738;91;5142.00;205
14038;90;628540564;14038;244;14779;14983;8.86;0.54;248.96;20.72;741;91;5143.00;204
14040;90;628540576;14040;246;14779;14983;8.83;0.54;248.96;20.72;739;91;5144.00;204
14043;90;628540587;14043;253;14781;14983;8.84;0.54;249.00;20.72;738;91;5145.00;202
14047;90;628540599;14047;258;14781;14983;8.83;0.54;249.02;20.72;734;91;5146.00;202
14051;90;628540610;14051;250;14782;14983;8.82;0.54;249.06;20.72;731;91;5147.00;201
14053;90;628540622;14053;241;14792;14995;8.94;0.54;249.07;20.70;739;91;5148.00;203
14055;90;628540634;14055;234;14793;14995;9.00;0.55;249.07;20.70;738;91;5149.00;202
14056;90;628540647;14056;232;14795;14995;9.06;0.55;249.08;20.70;739;91;5150.00;200
14059;90;628540659;14059;225;14796;14995;9.09;0.55;249.08;20.70;737;91;5151.00;199
14062;90;628540671;14062;223;14796;14995;9.12;0.55;249.07;20.70;734;91;5152.00;199
14063;90;628540683;14063;226;14797;14995;9.11;0.55;249.09;20.70;734;91;5153.00;198
14066;90;628540702;14066;229;14797;14996;9.14;0.55;249.08;20.70;731;91;5154.00;199
14070;90;628540714;14070;228;14799;14998;9.18;0.56;249.08;20.70;729;91;5155.00;199
14071;90;628540727;14071;207;14803;15004;9.23;0.56;249.09;20.69;732;91;5156.00;201
14075;90;628540740;14075;190;14805;15005;9.32;0.56;249.13;20.69;730;91;5157.00;200
14078;90;628540752;14078;183;14805;15005;9.42;0.57;249.14;20.69;727;91;5158.00;200
14079;90;628540764;14079;174;14805;15005;9.55;0.58;249.15;20.69;726;91;5159.00;200
14082;90;628540778;14082;163;14809;15010;9.64;0.58;249.16;20.68;727;91;5160.00;201
14084;90;628540791;14084;152;14809;15010;9.72;0.59;249.20;20.68;725;91;5161.00;201
14086;90;628540805;14086;149;14809;15010;9.88;0.60;249.18;20.68;723;91;5162.00;201
14089;90;628540818;14089;141;14810;15011;10.05;0.61;249.22;20.68;721;91;5163.00;201
14091;90;628540830;14091;147;14813;15015;10.10;0.61;249.24;20.68;722;91;5164.00;202
14093;90;628540844;14093;139;14813;15015;10.24;0.62;249.22;20.68;720;91;5165.00;202
14096;90;628540856;14096;142;14816;15018;10.33;0.63;249.24;20.67;720;91;5166.00;202
14097;90;628540875;14097;139;14816;15018;10.43;0.63;249.24;20.67;719;91;5167.00;202
14101;90;628540888;14101;137;14816;15018;10.48;0.64;249.29;20.67;715;91;5168.00;202
14108;90;628540902;14108;137;14816;15018;10.49;0.64;249.31;20.67;708;91;5169.00;202
14109;90;628540915;14109;139;14819;15022;10.56;0.64;249.32;20.67;710;91;5170.00;203
14111;90;628540929;14111;142;14820;15022;10.63;0.65;249.32;20.67;709;91;5171.00;202
14115;90;628540942;14115;141;14820;15022;10.67;0.65;249.33;20.67;705;91;5172.00;202
14118;90;628540953;14118;144;14820;15022;10.72;0.65;249.33;20.67;702;91;5173.00;202
14120;90;628540964;14120;142;14820;15023;10.71;0.65;249.32;20.67;700;91;5174.00;203
14122;91;628540975;14122;143;14822;15025;10.72;0.65;249.34;20.67;700;92;5175.00;203
14125;91;628540997;14125;142;14822;15025;10.69;0.65;249.32;20.67;697;92;5176.00;203
14127;91;628541007;14127;139;14823;15026;10.74;0.65;249.32;20.66;696;92;5177.00;203
14133;91;628541019;14133;136;14823;15026;10.72;0.65;249.30;20.66;690;92;5178.00;203
14133;91;628541029;14133;133;14823;15026;10.80;0.66;249.30;20.66;690;92;5179.00;203
14139;91;628541039;14139;137;14823;15026;10.87;0.66;249.31;20.66;684;92;5180.00;203
14144;91;628541055;14144;134;14823;15026;10.91;0.66;249.33;20.66;679;92;5181.00;203
14147;91;628541066;14147;135;14823;15026;11.00;0.67;249.31;20.66;676;92;5182.00;203
14150;91;628541076;14150;143;14823;15026;11.04;0.67;249.30;20.66;673;92;5183.00;203
14151;91;628541086;14151;167;14893;15153;10.78;0.66;249.30;20.57;742;92;5184.00;260
14153;91;628541105;14153;156;14894;15154;10.79;0.66;249.32;20.57;741;92;5185.00;260
14154;91;628541116;14154;153;14898;15154;10.92;0.67;249.32;20.56;744;92;5186.00;256
14156;91;628541126;14156;148;14901;15154;10.98;0.68;249.32;20.56;745;92;5187.00;253
14159;92;628541143;14159;147;14904;15154;11.03;0.68;249.31;20.55;745;93;5188.00;250
14161;92;628541160;14161;147;14907;15154;11.04;0.68;249.37;20.55;746;93;5189.00;247
14165;92;628541172;14165;153;14909;15154;11.09;0.68;249.36;20.55;744;93;5190.00;245
14166;92;628541187;14166;162;14910;15154;11.22;0.69;249.35;20.55;744;93;5191.00;244
14168;92;628541197;14168;164;14916;15155;11.32;0.69;249.35;20.54;748;93;5192.00;239
14172;92;628541208;14172;167;14917;15156;11.40;0.70;249.37;20.54;745;93;5193.00;239
14172;92;628541219;14172;171;14923;15156;11.52;0.70;249.37;20.69;751;93;5194.00;233
14177;92;628541230;14177;172;14927;15157;11.53;0.71;249.36;20.69;750;93;5195.00;230
14183;92;628541242;14183;178;14931;15157;11.54;0.70;249.38;20.69;748;93;5196.00;226
14186;92;628541253;14186;180;14934;15157;11.49;0.70;249.40;20.69;748;93;5197.00;223
14188;92;628541264;14188;182;14935;15157;11.43;0.70;249.38;20.69;747;93;5198.00;222
14188;92;628541274;14188;185;14937;15161;11.39;0.69;249.38;20.68;749;93;5199.00;224
14194;92;628541285;14194;186;14939;15161;11.21;0.68;249.41;20.68;745;93;5200.00;222
14198;92;628541300;14198;186;14940;15161;11.18;0.68;249.39;20.68;742;93;5201.00;221
14201;92;628541310;14201;180;14943;15164;11.10;0.68;249.40;20.68;742;93;5202.00;221
14207;92;628541320;14207;181;14944;15164;11.01;0.67;249.41;20.68;737;93;5203.00;220
14212;92;628541330;14212;181;14945;15164;10.94;0.67;249.38;20.68;733;93;5204.00;219
14216;92;628541341;14216;180;14951;15168;10.78;0.66;249.38;20.71;735;93;5205.00;217
14219;92;628541353;14219;173;14953;15169;10.66;0.65;249.35;20.71;734;93;5206.00;216
14222;92;628541363;14222;181;14953;15169;10.55;0.64;249.32;20.71;731;93;5207.00;216
14226;92;628541373;14226;180;14956;15173;10.57;0.64;249.30;20.71;730;93;5208.00;217
14226;92;628541384;14226;181;14956;15173;10.49;0.64;249.30;20.71;730;93;5209.00;217
14229;92;628541393;14229;175;14956;15173;10.47;0.64;249.28;20.71;727;93;5210.00;217
14231;92;628541413;14231;174;14957;15174;10.41;0.63;249.26;20.70;726;93;5211.00;217
14233;92;628541428;14233;174;14958;15174;10.37;0.63;249.26;20.70;725;93;5212.00;216
14235;92;628541437;14235;173;14961;15180;10.45;0.64;249.24;20.70;726;93;5213.00;219
14238;92;628541447;14238;179;14962;15180;10.40;0.63;249.22;20.70;724;93;5214.00;218
14240;92;628541457;14240;184;14963;15180;10.43;0.63;249.20;20.70;723;93;5215.00;217
14242;92;628541466;14242;190;14963;15181;10.42;0.63;249.18;20.70;721;93;5216.00;218
14246;92;628541476;14246;194;14965;15181;10.35;0.63;249.12;20.72;719;93;5217.00;216
14248;92;628541486;14248;198;14965;15181;10.33;0.63;249.11;20.72;717;93;5218.00;216
14249;92;628541495;14249;205;14965;15181;10.32;0.63;249.10;20.72;716;93;5219.00;216
14252;92;628541507;14252;207;14987;15217;10.27;0.63;249.07;20.69;735;93;5220.00;230
14253;92;628541519;14253;214;14987;15217;10.17;0.62;249.07;20.69;734;93;5221.00;230
14254;92;628541529;14254;212;14989;15217;10.08;0.61;249.06;20.69;735;93;5222.00;228
14256;92;628541539;14256;218;14991;15217;9.96;0.61;249.04;20.68;735;93;5223.00;226
14256;92;628541548;14256;220;14991;15217;9.88;0.60;249.04;20.68;735;93;5224.00;226
14256;92;628541557;14256;227;14993;15217;9.80;0.60;249.04;20.68;737;93;5225.00;224
14256;92;628541566;14256;232;14996;15221;9.73;0.59;249.04;20.68;740;93;5226.00;225
14259;92;628541576;14259;242;14998;15221;9.65;0.59;249.04;20.68;739;93;5227.00;223
14262;92;628541585;14262;244;15000;15225;9.60;0.58;249.02;20.67;738;93;5228.00;225
14262;92;628541596;14262;253;15003;15226;9.56;0.58;249.02;20.67;741;93;5229.00;223
14265;92;628541605;14265;253;15006;15226;9.47;0.57;249.03;20.69;741;93;5230.00;220
14265;92;628541615;14265;262;15007;15226;9.35;0.57;249.03;20.69;742;93;5231.00;219
14267;92;628541624;14267;267;15019;15239;9.16;0.56;249.01;20.71;752;93;5232.00;220
14268;92;628541635;14268;265;15020;15239;8.97;0.54;249.00;20.71;752;93;5233.00;219
14270;92;628541645;14270;269;15020;15239;8.79;0.53;249.01;20.71;750;93;5234.00;219
14271;92;628541654;14271;270;15022;15240;8.69;0.53;249.00;20.71;751;93;5235.00;218
14271;92;628541664;14271;269;15023;15241;8.67;0.53;249.00;20.73;752;93;5236.00;218
14271;92;628541673;14271;272;15025;15241;8.65;0.53;249.00;20.75;754;93;5237.00;216
14273;92;628541683;14273;274;15029;15244;8.67;0.53;249.00;20.76;756;93;5238.00;215
14274;92;628541693;14274;275;15030;15244;8.65;0.52;249.00;20.78;756;93;5239.00;214
14274;92;628541702;14274;270;15031;15244;8.61;0.52;249.00;20.78;757;93;5240.00;213
14274;92;628541712;14274;268;15031;15244;8.62;0.52;249.00;20.78;757;93;5241.00;213
14276;92;628541721;14276;265;15036;15250;8.68;0.53;249.00;20.79;760;93;5242.00;214
14277;92;628541731;14277;263;15037;15250;8.64;0.52;248.99;20.79;760;93;5243.00;213
14278;92;628541740;14278;258;15039;15250;8.59;0.52;248.98;20.81;761;93;5244.00;211
14278;92;628541750;14278;256;15039;15250;8.57;0.52;248.98;20.81;761;93;5245.00;211
14279;92;628541760;14279;254;15044;15254;8.45;0.51;248.97;20.83;765;93;5246.00;210
14279;92;628541770;14279;254;15045;15255;8.48;0.52;248.97;20.83;766;93;5247.00;210
14280;92;628541780;14280;258;15047;15255;8.47;0.52;248.95;20.85;767;93;5248.00;208
14281;92;628541789;14281;253;15048;15256;8.53;0.52;248.95;20.85;767;93;5249.00;208
14282;92;628541801;14282;255;15050;15256;8.49;0.52;248.94;20.87;768;93;5250.00;206
14283;92;628541816;14283;253;15050;15256;8.47;0.52;248.93;20.87;767;93;5251.00;206
14285;92;628541825;14285;246;15051;15256;8.44;0.51;248.95;20.88;766;93;5252.00;205
14287;92;628541835;14287;240;15052;15256;8.43;0.51;248.93;20.88;765;93;5253.00;204
14287;92;628541845;14287;237;15052;15256;8.42;0.51;248.93;20.88;765;93;5254.00;204
14288;92;628541854;14288;237;15054;15256;8.41;0.51;248.92;20.90;766;93;5255.00;202
14290;92;628541863;14290;243;15093;15326;8.55;0.52;248.91;20.85;803;93;5256.00;233
14291;92;628541878;14291;242;15098;15327;8.53;0.52;248.92;20.86;807;93;5257.00;229
14294;92;628541888;14294;239;15106;15327;8.54;0.52;248.94;20.85;812;93;5258.00;221
14297;92;628541901;14297;235;15112;15327;8.50;0.52;248.93;20.86;815;93;5259.00;215
14299;92;628541916;14299;232;15118;15327;8.44;0.52;248.94;20.85;819;93;5260.00;209
14300;92;628541933;14300;241;15122;15327;8.43;0.52;248.94;20.85;822;93;5261.00;205
14302;92;628541946;14302;237;15126;15327;8.35;0.51;248.92;20.86;824;93;5262.00;201
14307;92;628541964;14307;239;15126;15327;8.22;0.51;248.94;20.86;819;93;5263.00;201
14311;92;628541979;14311;240;15127;15328;8.22;0.51;248.93;20.86;816;93;5264.00;201
14317;92;628541993;14317;241;15131;15330;8.09;0.50;248.95;20.87;814;93;5265.00;199
14319;92;628542011;14319;246;15131;15330;7.98;0.49;248.95;20.87;812;93;5266.00;199
14324;92;628542024;14324;251;15134;15334;7.86;0.49;248.95;20.87;810;93;5267.00;200
14330;92;628542036;14330;254;15135;15334;7.70;0.48;248.94;20.88;805;93;5268.00;199
14332;92;628542047;14332;261;15136;15334;7.61;0.47;248.94;20.90;804;93;5269.00;198
14339;92;628542058;14339;249;15138;15334;7.45;0.46;248.96;20.92;799;93;5270.00;196
14341;92;628542070;14341;240;15143;15340;7.45;0.46;248.96;20.92;802;93;5271.00;197
14345;92;628542081;14345;240;15144;15340;7.43;0.46;248.98;20.93;799;93;5272.00;196
14351;92;628542092;14351;234;15144;15340;7.48;0.46;248.99;20.93;793;93;5273.00;196
14351;92;628542104;14351;233;15148;15343;7.59;0.47;248.99;20.93;797;93;5274.00;195
14354;92;628542115;14354;234;15149;15343;7.59;0.47;249.01;20.94;795;93;5275.00;194
14358;92;628542127;14358;235;15150;15343;7.64;0.47;249.03;20.95;792;93;5276.00;193
14364;92;628542137;14364;229;15150;15344;7.64;0.47;249.00;20.95;786;93;5277.00;194
14369;92;628542149;14369;224;15152;15345;7.73;0.48;249.03;20.96;783;93;5278.00;193
14371;92;628542160;14371;210;15152;15345;7.89;0.49;249.03;20.96;781;93;5279.00;193
14376;92;628542172;14376;206;15172;15371;7.99;0.49;249.02;20.94;796;93;5280.00;199
14379;92;628542185;14379;201;15173;15371;8.12;0.50;249.00;20.94;794;93;5281.00;198
14383;92;628542196;14383;201;15174;15371;8.23;0.50;249.03;20.93;791;93;5282.00;197
14387;92;628542207;14387;197;15175;15372;8.33;0.51;249.02;20.93;788;93;5283.00;197
14390;92;628542219;14390;198;15175;15372;8.40;0.52;249.05;20.93;785;93;5284.00;197
14393;92;628542230;14393;195;15179;15376;8.49;0.52;249.04;20.93;786;93;5285.00;197
14399;92;628542242;14399;191;15179;15376;8.60;0.53;249.04;20.93;780;93;5286.00;197
14402;92;628542255;14402;188;15182;15379;8.66;0.53;249.04;20.92;780;93;5287.00;197
14410;92;628542266;14410;188;15182;15380;8.70;0.53;249.06;20.92;772;93;5288.00;198
14416;92;628542277;14416;181;15182;15380;8.71;0.53;249.05;20.92;766;93;5289.00;198
14420;92;628542288;14420;179;15182;15380;8.74;0.54;249.05;20.92;762;93;5290.00;198
14426;92;628542300;14426;178;15182;15380;8.78;0.54;249.03;20.92;756;93;5291.00;198
14433;92;628542311;14433;179;15191;15392;8.89;0.55;249.08;20.91;758;93;5292.00;201
14437;92;628542324;14437;182;15191;15392;9.02;0.56;249.08;20.91;754;93;5293.00;201
14442;92;628542335;14442;185;15193;15392;9.21;0.57;249.08;20.91;751;93;5294.00;199
14451;92;628542347;14451;189;15193;15392;9.29;0.57;249.12;20.91;742;93;5295.00;199
14455;92;628542358;14455;189;15193;15392;9.37;0.57;249.14;20.91;738;93;5296.00;199
14460;92;628542370;14460;194;15193;15392;9.45;0.58;249.15;20.91;733;93;5297.00;199
14464;92;628542381;14464;187;15193;15393;9.47;0.58;249.18;20.91;729;93;5298.00;200
14469;92;628542392;14469;191;15193;15393;9.56;0.58;249.18;20.91;724;93;5299.00;200
14474;92;628542405;14474;190;15197;15399;9.63;0.59;249.18;20.90;723;93;5300.00;202
14479;92;628542422;14479;194;15199;15400;9.74;0.59;249.19;20.90;720;93;5301.00;201
14484;92;628542435;14484;194;15199;15400;9.69;0.59;249.18;20.90;715;93;5302.00;201
14487;92;628542446;14487;196;15199;15400;9.74;0.59;249.20;20.90;712;93;5303.00;201
14493;92;628542457;14493;191;15202;15404;9.73;0.59;249.24;20.90;709;93;5304.00;202
14497;92;628542469;14497;192;15202;15404;9.65;0.58;249.22;20.90;705;93;5305.00;202
14500;92;628542480;14500;194;15202;15404;9.67;0.59;249.22;20.90;702;93;5306.00;202
14503;92;628542491;14503;198;15203;15405;9.66;0.58;249.23;20.90;700;93;5307.00;202
14506;92;628542502;14506;193;15206;15409;9.72;0.59;249.25;20.89;700;93;5308.00;203
14509;92;628542513;14509;190;15206;15409;9.76;0.59;249.27;20.89;697;93;5309.00;203
14511;92;628542526;14511;194;15209;15415;9.82;0.60;249.29;20.89;698;93;5310.00;206
14518;92;628542537;14518;193;15209;15415;9.80;0.60;249.28;20.89;691;93;5311.00;206
14522;92;628542549;14522;197;15210;15415;9.79;0.59;249.27;20.89;688;93;5312.00;205
14526;92;628542560;14526;201;15210;15415;9.74;0.59;249.27;20.89;684;93;5313.00;205
14529;92;628542571;14529;201;15213;15419;9.74;0.59;249.30;20.88;684;93;5314.00;206
14534;93;628542582;14534;207;15213;15419;9.65;0.58;249.32;20.88;679;94;5315.00;206
14537;93;628542605;14537;209;15214;15419;9.60;0.58;249.37;20.88;677;94;5316.00;205
14541;93;628542615;14541;203;15214;15419;9.56;0.58;249.40;20.88;673;94;5317.00;205
14544;93;628542631;14544;194;15215;15420;9.52;0.58;249.42;20.88;671;94;5318.00;205
14549;93;628542642;14549;195;15216;15421;9.57;0.58;249.48;20.88;667;94;5319.00;205
14552;93;628542653;14552;194;15217;15421;9.61;0.58;249.49;20.88;665;94;5320.00;204
14554;93;628542665;14554;193;15218;15422;9.64;0.59;249.49;20.88;664;94;5321.00;204
14557;93;628542676;14557;193;15218;15422;9.59;0.58;249.51;20.88;661;94;5322.00;204
14560;93;628542687;14560;190;15218;15422;9.60;0.58;249.50;20.88;658;94;5323.00;204
14563;93;628542698;14563;189;15218;15422;9.53;0.58;249.51;20.88;655;94;5324.00;204
14568;93;628542708;14568;190;15218;15422;9.44;0.57;249.53;20.88;650;94;5325.00;204
14569;93;628542725;14569;181;15218;15422;9.36;0.57;249.54;20.88;649;94;5326.00;204
14573;93;628542736;14573;177;15218;15422;9.32;0.57;249.55;20.88;645;94;5327.00;204
14575;93;628542747;14575;193;15286;15549;9.28;0.57;249.56;20.78;711;94;5328.00;263
14576;93;628542769;14576;173;15288;15550;9.34;0.58;249.55;20.78;712;94;5329.00;262
14578;93;628542781;14578;162;15296;15550;9.47;0.58;249.56;20.77;718;94;5330.00;254
14580;93;628542792;14580;156;15299;15550;9.59;0.59;249.58;20.77;719;94;5331.00;251
14582;93;628542804;14582;153;15302;15550;9.76;0.60;249.57;20.77;720;94;5332.00;248
14585;93;628542815;14585;144;15306;15550;9.92;0.61;249.58;20.76;721;94;5333.00;244
14589;93;628542827;14589;140;15311;15550;10.14;0.63;249.60;20.76;722;94;5334.00;239
14591;93;628542838;14591;134;15315;15550;10.33;0.64;249.59;20.75;724;94;5335.00;235
14594;93;628542850;14594;133;15321;15551;10.40;0.64;249.64;20.75;727;94;5336.00;230
14597;93;628542862;14597;131;15324;15552;10.49;0.65;249.63;20.74;727;94;5337.00;228
14598;93;628542874;14598;136;15325;15552;10.48;0.64;249.64;20.74;727;94;5338.00;227
14602;93;628542886;14602;139;15327;15553;10.37;0.64;249.63;20.74;725;94;5339.00;226
14608;93;628542902;14608;139;15329;15553;10.33;0.63;249.65;20.74;721;94;5340.00;224
14612;93;628542915;14612;143;15330;15553;10.30;0.63;249.69;20.74;718;94;5341.00;223
14614;93;628542925;14614;148;15332;15553;10.32;0.63;249.68;20.74;718;94;5342.00;221
14618;93;628542937;14618;155;15336;15557;10.33;0.63;249.71;20.74;718;94;5343.00;221
14620;93;628542949;14620;158;15336;15557;10.35;0.63;249.71;20.74;716;94;5344.00;221
14621;93;628542959;14621;162;15338;15557;10.38;0.64;249.71;20.74;717;94;5345.00;219
14623;93;628542970;14623;164;15340;15560;10.38;0.64;249.72;20.73;717;94;5346.00;220
14624;93;628542981;14624;166;15342;15560;10.40;0.64;249.72;20.73;718;94;5347.00;218
14627;94;628542991;14627;169;15342;15560;10.40;0.64;249.70;20.73;715;95;5348.00;218
14628;94;628543012;14628;171;15346;15564;10.49;0.64;249.71;20.73;718;95;5349.00;218
14631;94;628543023;14631;176;15347;15565;10.51;0.64;249.69;20.73;716;95;5350.00;218
14632;94;628543033;14632;176;15348;15565;10.54;0.64;249.70;20.73;716;95;5351.00;217
14635;94;628543043;14635;184;15351;15569;10.63;0.65;249.70;20.72;716;95;5352.00;218
14637;94;628543053;14637;185;15352;15569;10.70;0.65;249.69;20.72;715;95;5353.00;217
14639;94;628543063;14639;196;15352;15569;10.72;0.65;249.71;20.72;713;95;5354.00;217
14643;94;628543073;14643;200;15354;15571;10.68;0.65;249.69;20.72;711;95;5355.00;217
14644;94;628543083;14644;201;15354;15571;10.63;0.65;249.68;20.72;710;95;5356.00;217
14645;94;628543099;14645;201;15358;15577;10.58;0.65;249.69;20.71;713;95;5357.00;219
14648;94;628543109;14648;203;15358;15577;10.57;0.65;249.66;20.71;710;95;5358.00;219
14652;94;628543117;14652;201;15359;15577;10.63;0.65;249.63;20.71;707;95;5359.00;218
14653;94;628543127;14653;203;15359;15578;10.66;0.65;249.62;20.71;706;95;5360.00;219
14654;94;628543136;14654;201;15359;15578;10.66;0.65;249.61;20.71;705;95;5361.00;219
14657;94;628543145;14657;200;15359;15578;10.62;0.65;249.60;20.71;702;95;5362.00;219
14662;94;628543154;14662;200;15359;15578;10.59;0.65;249.60;20.71;697;95;5363.00;219
14664;94;628543163;14664;205;15368;15590;10.65;0.65;249.59;20.70;704;95;5364.00;222
14666;94;628543173;14666;206;15368;15590;10.71;0.65;249.56;20.70;702;95;5365.00;222
14669;94;628543182;14669;208;15370;15590;10.73;0.66;249.57;20.70;701;95;5366.00;220
14674;94;628543191;14674;203;15370;15590;10.71;0.65;249.54;20.70;696;95;5367.00;220
14676;94;628543206;14676;203;15370;15590;10.76;0.66;249.54;20.70;694;95;5368.00;220
14680;94;628543214;14680;203;15371;15590;10.70;0.65;249.51;20.85;691;95;5369.00;219
14682;94;628543227;14682;198;15374;15594;10.70;0.65;249.51;20.85;692;95;5370.00;220
14685;94;628543236;14685;200;15374;15594;10.73;0.65;249.54;20.85;689;95;5371.00;220
14691;94;628543245;14691;195;15377;15598;10.77;0.66;249.51;20.85;686;95;5372.00;221
14695;94;628543256;14695;194;15378;15599;10.85;0.66;249.49;20.84;683;95;5373.00;221
14698;94;628543265;14698;188;15380;15599;10.88;0.66;249.46;20.86;682;95;5374.00;219
14703;94;628543275;14703;184;15380;15599;10.89;0.66;249.45;20.86;677;95;5375.00;219
14706;94;628543285;14706;178;15391;15612;10.81;0.65;249.43;20.87;685;95;5376.00;221
14706;94;628543295;14706;176;15391;15612;10.76;0.65;249.43;20.87;685;95;5377.00;221
14707;95;628543303;14707;178;15392;15612;10.78;0.65;249.42;20.87;685;96;5378.00;220
14709;95;628543325;14709;183;15393;15613;10.77;0.65;249.41;20.86;684;96;5379.00;220
14712;95;628543334;14712;183;15393;15614;10.66;0.65;249.39;20.86;681;96;5380.00;221
14714;95;628543343;14714;182;15393;15614;10.64;0.64;249.37;20.86;679;96;5381.00;221
14716;95;628543352;14716;184;15395;15617;10.74;0.65;249.35;20.86;679;96;5382.00;222
14717;95;628543365;14717;187;15396;15617;10.65;0.65;249.34;20.86;679;96;5383.00;221
14718;95;628543374;14718;188;15396;15617;10.72;0.65;249.33;20.86;678;96;5384.00;221
14718;95;628543383;14718;191;15396;15617;10.72;0.65;249.33;20.86;678;96;5385.00;221
14720;95;628543392;14720;193;15400;15623;10.70;0.65;249.32;20.86;680;96;5386.00;223
14720;95;628543401;14720;190;15400;15623;10.69;0.65;249.32;20.86;680;96;5387.00;223
14721;95;628543410;14721;179;15401;15623;10.59;0.64;249.31;20.85;680;96;5388.00;222
14724;95;628543419;14724;176;15401;15623;10.57;0.64;249.29;20.85;677;96;5389.00;222
14725;95;628543428;14725;169;15404;15627;10.50;0.64;249.30;20.85;679;96;5390.00;223
14727;95;628543438;14727;168;15405;15628;10.57;0.64;249.34;20.85;678;96;5391.00;223
14728;95;628543447;14728;165;15405;15628;10.58;0.64;249.33;20.85;677;96;5392.00;223
14728;95;628543456;14728;166;15406;15629;10.55;0.64;249.33;20.85;678;96;5393.00;223
14729;95;628543466;14729;163;15406;15629;10.53;0.64;249.33;20.85;677;96;5394.00;223
14734;96;628543475;14734;158;15406;15629;10.51;0.64;249.37;20.85;672;97;5395.00;223
14734;96;628543495;14734;152;15406;15629;10.56;0.64;249.37;20.85;672;97;5396.00;223
14737;96;628543504;14737;152;15407;15629;10.56;0.64;249.35;20.85;670;97;5397.00;222
14737;96;628543514;14737;154;15407;15629;10.55;0.64;249.35;20.85;670;97;5398.00;222
14737;96;628543523;14737;157;15407;15629;10.54;0.64;249.35;20.85;670;97;5399.00;222
