step_arrived;step_collisions;step_duration;step_ended;step_halting;step_inserted;step_loaded;step_meanSpeed;step_meanSpeedRelative;step_meanTravelTime;step_meanWaitingTime;step_running;step_teleports;step_time;step_waiting
0;0;22551647;0;1;87;245;16.24;1.14;-1.00;0.00;87;0;0.00;158
0;0;22551685;0;1;101;245;15.35;1.06;-1.00;0.14;101;0;1.00;144
0;0;22551687;0;0;120;245;14.59;0.99;-1.00;0.43;120;0;2.00;125
0;0;22551689;0;3;136;245;13.56;0.91;-1.00;0.74;136;0;3.00;109
0;0;22551692;0;1;148;245;12.68;0.85;-1.00;1.00;148;0;4.00;97
0;0;22551697;0;5;161;245;11.56;0.77;-1.00;1.32;161;0;5.00;84
0;0;22551699;0;7;171;245;10.94;0.72;-1.00;1.60;171;0;6.00;74
0;0;22551702;0;11;182;245;10.18;0.67;-1.00;1.92;182;0;7.00;63
0;0;22551704;0;20;189;246;9.72;0.64;-1.00;2.15;189;0;8.00;57
0;0;22551708;0;20;193;247;9.32;0.61;-1.00;2.29;193;0;9.00;54
0;0;22551715;0;25;201;247;8.84;0.58;-1.00;2.60;201;0;10.00;46
1;0;22551718;1;28;206;248;8.44;0.56;11.00;2.75;205;0;11.00;42
2;0;22551722;2;32;209;248;8.24;0.54;11.50;2.89;207;0;12.00;39
2;0;22551725;2;34;214;248;8.05;0.53;11.50;3.12;212;0;13.00;34
3;0;22551730;3;40;216;248;7.99;0.52;12.33;3.22;213;0;14.00;32
3;0;22551735;3;45;221;252;7.89;0.51;12.33;3.36;218;0;15.00;31
3;0;22551738;3;48;223;252;7.89;0.51;12.33;3.48;220;0;16.00;29
3;0;22551740;3;47;226;252;7.94;0.51;12.33;3.62;223;0;17.00;26
4;0;22551748;4;53;230;255;7.92;0.51;13.75;3.81;226;0;18.00;25
4;0;22551752;4;59;232;255;7.98;0.51;13.75;3.87;228;0;19.00;23
4;0;22551755;4;64;235;255;8.01;0.51;13.75;4.07;231;0;20.00;20
5;0;22551758;5;72;242;259;8.06;0.51;15.20;4.23;237;0;21.00;17
5;0;22551763;5;76;244;260;8.08;0.51;15.20;4.29;239;0;22.00;16
5;0;22551768;5;81;245;260;8.02;0.51;15.20;4.37;240;0;23.00;15
6;0;22551773;6;85;249;264;8.01;0.51;16.67;4.39;243;0;24.00;15
6;0;22551779;6;84;253;264;7.97;0.50;16.67;4.57;247;0;25.00;11
6;0;22551783;6;86;253;264;8.09;0.51;16.67;4.57;247;0;26.00;11
6;0;22551787;6;89;253;265;8.25;0.52;16.67;4.57;247;0;27.00;12
6;0;22551790;6;90;254;265;8.32;0.52;16.67;4.66;248;0;28.00;11
6;0;22551796;6;91;259;271;8.39;0.52;16.67;4.59;253;0;29.00;12
7;0;22551806;7;93;259;271;8.45;0.53;18.57;4.59;252;0;30.00;12
8;0;22551811;8;95;261;272;8.41;0.52;19.75;4.68;253;0;31.00;11
8;0;22551817;8;97;262;272;8.44;0.52;19.75;4.71;254;0;32.00;10
8;0;22551821;8;102;263;272;8.47;0.53;19.75;4.82;255;0;33.00;9
10;0;22551826;10;104;263;272;8.44;0.52;22.10;4.82;253;0;34.00;9
11;0;22551832;11;105;264;272;8.42;0.52;23.27;4.83;253;0;35.00;8
11;0;22551835;11;106;275;284;8.58;0.53;23.27;4.77;264;0;36.00;9
12;0;22551840;12;109;276;284;8.43;0.52;24.17;4.75;264;0;37.00;8
13;0;22551846;13;113;277;284;8.35;0.52;24.92;4.87;264;0;38.00;7
13;0;22551851;13;115;277;284;8.28;0.51;24.92;4.87;264;0;39.00;7
14;0;22551855;14;117;278;284;8.18;0.51;25.64;4.97;264;0;40.00;6
14;0;22551860;14;119;281;284;8.10;0.50;25.64;5.06;267;0;41.00;3
15;0;22551866;15;123;285;288;8.03;0.50;26.27;5.01;270;0;42.00;3
16;0;22551871;16;126;285;288;7.88;0.49;27.19;5.01;269;0;43.00;3
18;0;22551875;18;129;289;292;7.79;0.48;27.56;4.95;271;0;44.00;3
18;0;22551883;18;134;291;294;7.66;0.48;27.56;4.92;273;0;45.00;3
18;0;22551887;18;137;291;294;7.54;0.47;27.56;4.92;273;0;46.00;3
18;0;22551890;18;137;291;294;7.46;0.46;27.56;4.92;273;0;47.00;3
19;0;22551896;19;141;301;307;7.71;0.48;28.63;4.75;282;0;48.00;6
19;0;22551902;19;143;302;307;7.63;0.47;28.63;4.74;283;0;49.00;5
19;0;22551908;19;145;302;307;7.59;0.47;28.63;4.74;283;0;50.00;5
19;0;22551916;19;145;303;308;7.59;0.47;28.63;4.73;284;0;51.00;5
19;0;22551920;19;147;304;309;7.50;0.47;28.63;4.72;285;0;52.00;5
20;0;22551926;20;149;304;309;7.48;0.46;29.80;4.72;284;0;53.00;5
21;0;22551930;21;147;306;312;7.51;0.47;29.95;4.69;285;0;54.00;6
22;0;22551935;22;149;306;312;7.45;0.46;31.09;4.69;284;0;55.00;6
24;0;22551938;24;139;307;312;7.32;0.45;31.67;4.68;283;0;56.00;5
25;0;22551945;25;138;307;312;7.26;0.45;32.68;4.68;282;0;57.00;5
26;0;22551949;26;137;311;318;7.33;0.45;33.58;4.63;285;0;58.00;7
28;0;22551954;28;140;312;318;7.22;0.44;35.39;4.62;284;0;59.00;6
29;0;22551959;29;143;312;318;7.14;0.44;36.14;4.62;283;0;60.00;6
30;0;22551964;30;145;312;318;7.10;0.44;36.17;4.62;282;0;61.00;6
30;0;22551969;30;148;316;322;7.12;0.44;36.17;4.58;286;0;62.00;6
30;0;22551972;30;151;317;323;7.29;0.45;36.17;4.56;287;0;63.00;6
31;0;22551977;31;151;317;323;7.34;0.45;35.71;4.56;286;0;64.00;6
32;0;22551982;32;152;318;324;7.47;0.46;36.47;4.55;286;0;65.00;6
34;0;22551987;34;155;318;324;7.47;0.46;37.85;4.55;284;0;66.00;6
34;0;22551991;34;144;318;324;7.53;0.46;37.85;4.55;284;0;67.00;6
35;0;22551999;35;138;318;324;7.63;0.46;38.71;4.55;283;0;68.00;6
35;0;22552012;35;136;318;324;7.68;0.47;38.71;4.55;283;0;69.00;6
35;0;22552016;35;132;318;324;7.86;0.48;38.71;4.55;283;0;70.00;6
35;0;22552020;35;131;318;324;8.07;0.49;38.71;4.55;283;0;71.00;6
35;0;22552022;35;134;352;394;8.31;0.51;38.71;4.11;317;0;72.00;42
35;0;22552035;35;126;353;395;8.51;0.52;38.71;4.10;318;0;73.00;42
36;0;22552039;36;119;360;395;8.88;0.54;39.11;4.06;324;0;74.00;35
36;0;22552045;36;119;362;395;9.11;0.56;39.11;4.06;326;0;75.00;33
37;0;22552052;37;115;364;395;9.28;0.57;40.11;4.05;327;0;76.00;31
38;0;22552057;38;113;366;395;9.36;0.57;41.08;4.06;328;0;77.00;29
38;0;22552064;38;114;368;395;9.46;0.57;41.08;4.07;330;0;78.00;27
40;0;22552078;40;117;370;395;9.49;0.58;42.58;4.09;330;0;79.00;25
40;0;22552085;40;119;372;396;9.44;0.57;42.58;4.11;332;0;80.00;24
40;0;22552090;40;123;374;397;9.40;0.57;42.58;4.13;334;0;81.00;23
40;0;22552098;40;128;376;397;9.34;0.57;42.58;4.16;336;0;82.00;21
40;0;22552102;40;128;381;401;9.21;0.56;42.58;4.15;341;0;83.00;20
40;0;22552107;40;126;383;401;9.21;0.56;42.58;4.17;343;0;84.00;18
40;0;22552112;40;128;384;401;9.14;0.56;42.58;4.19;344;0;85.00;17
40;0;22552118;40;128;385;401;9.06;0.55;42.58;4.20;345;0;86.00;16
42;0;22552122;42;128;390;407;9.00;0.55;44.67;4.16;348;0;87.00;17
42;0;22552128;42;132;390;407;8.94;0.55;44.67;4.16;348;0;88.00;17
45;0;22552134;45;132;390;407;8.76;0.53;47.40;4.16;345;0;89.00;17
47;0;22552142;47;132;394;413;8.76;0.53;49.21;4.11;347;0;90.00;19
49;0;22552150;49;130;394;413;8.73;0.53;50.92;4.11;345;0;91.00;19
49;0;22552155;49;130;396;413;8.82;0.54;50.92;4.10;347;0;92.00;17
50;0;22552158;50;131;397;414;8.69;0.53;51.66;4.10;347;0;93.00;17
50;0;22552166;50;131;398;415;8.62;0.52;51.66;4.09;348;0;94.00;17
52;0;22552173;52;131;398;415;8.44;0.51;53.33;4.09;346;0;95.00;17
55;0;22552180;55;137;409;428;8.31;0.50;54.22;3.98;354;0;96.00;19
57;0;22552188;57;135;409;428;8.19;0.50;55.67;3.98;352;0;97.00;19
58;0;22552192;58;136;409;428;8.15;0.49;56.40;3.98;351;0;98.00;19
59;0;22552200;59;137;410;429;8.18;0.50;57.12;3.97;351;0;99.00;19
60;0;22552206;60;139;410;429;8.24;0.50;57.83;3.97;350;0;100.00;19
62;0;22552216;62;136;413;433;8.31;0.51;59.19;3.95;351;0;101.00;20
62;0;22552222;62;137;413;433;8.38;0.51;59.19;3.95;351;0;102.00;20
63;0;22552229;63;136;417;437;8.36;0.51;59.89;3.92;354;0;103.00;20
63;0;22552236;63;132;417;437;8.46;0.52;59.89;3.92;354;0;104.00;20
65;0;22552240;65;127;417;437;8.59;0.52;61.25;3.92;352;0;105.00;20
65;0;22552248;65;123;417;437;8.80;0.54;61.25;3.92;352;0;106.00;20
66;0;22552254;66;114;417;437;8.94;0.54;61.79;3.92;351;0;107.00;20
66;0;22552259;66;107;430;449;9.08;0.55;61.79;4.25;364;0;108.00;19
67;0;22552270;67;102;431;449;9.26;0.56;62.46;4.25;364;0;109.00;18
67;0;22552275;67;97;432;449;9.48;0.58;62.46;4.24;365;0;110.00;17
68;0;22552284;68;94;432;449;9.61;0.59;63.13;4.24;364;0;111.00;17
68;0;22552290;68;91;432;449;9.85;0.60;63.13;4.24;364;0;112.00;17
68;0;22552299;68;86;432;449;10.00;0.61;63.13;4.24;364;0;113.00;17
69;0;22552305;69;84;433;450;10.10;0.61;63.87;4.23;364;0;114.00;17
70;0;22552310;70;82;433;450;10.05;0.61;64.60;4.23;363;0;115.00;17
70;0;22552318;70;77;438;456;10.27;0.63;64.60;4.20;368;0;116.00;18
70;0;22552324;70;72;438;457;10.32;0.63;64.60;4.20;368;0;117.00;19
72;0;22552333;72;66;439;457;10.42;0.63;66.00;4.19;367;0;118.00;18
73;0;22552340;73;66;439;457;10.49;0.64;66.23;4.19;366;0;119.00;18
73;0;22552351;73;67;443;462;10.66;0.65;66.23;4.15;370;0;120.00;19
73;0;22552358;73;68;443;462;10.76;0.66;66.23;4.15;370;0;121.00;19
73;0;22552367;73;67;444;462;10.82;0.66;66.23;4.42;371;0;122.00;18
73;0;22552373;73;70;445;463;10.97;0.67;66.23;4.41;372;0;123.00;18
73;0;22552384;73;72;449;467;11.03;0.68;66.23;4.38;376;0;124.00;18
75;0;22552390;75;73;452;467;11.01;0.67;67.48;4.86;377;0;125.00;15
77;0;22552401;77;74;454;470;11.20;0.68;68.81;4.84;377;0;126.00;16
79;0;22552409;79;77;455;470;11.29;0.69;70.24;4.83;376;0;127.00;15
80;0;22552419;80;76;456;470;11.34;0.69;70.89;5.00;376;0;128.00;14
81;0;22552426;81;78;457;470;11.32;0.69;71.59;5.11;376;0;129.00;13
82;0;22552436;82;81;461;474;11.45;0.70;72.30;5.20;379;0;130.00;13
82;0;22552442;82;82;462;474;11.51;0.70;72.30;5.31;380;0;131.00;12
84;0;22552452;84;83;464;474;11.60;0.71;73.54;5.60;380;0;132.00;10
84;0;22552464;84;85;465;474;11.64;0.71;73.54;5.72;381;0;133.00;9
84;0;22552484;84;86;468;475;11.66;0.71;73.54;5.92;384;0;134.00;7
85;0;22552501;85;88;471;477;11.63;0.71;74.24;5.96;386;0;135.00;6
86;0;22552514;86;88;473;477;11.66;0.71;74.91;6.11;387;0;136.00;4
88;0;22552524;88;90;476;478;11.70;0.72;76.30;6.18;388;0;137.00;2
89;0;22552536;89;91;476;478;11.76;0.72;76.99;6.18;387;0;138.00;2
90;0;22552542;90;93;476;478;11.77;0.72;76.88;6.18;386;0;139.00;2
92;0;22552551;92;96;477;478;11.70;0.72;77.85;6.26;385;0;140.00;1
94;0;22552559;94;95;477;478;11.63;0.71;78.93;6.26;383;0;141.00;1
96;0;22552568;96;96;478;478;11.59;0.71;79.47;6.29;382;0;142.00;0
97;0;22552575;97;96;478;478;11.48;0.71;79.98;6.29;381;0;143.00;0
100;0;22552584;100;122;554;605;10.99;0.69;80.78;5.43;454;0;144.00;51
105;0;22552606;105;115;557;606;10.84;0.68;82.68;5.41;452;0;145.00;49
105;0;22552616;105;111;568;606;10.85;0.68;82.68;5.34;463;0;146.00;38
106;0;22552624;106;110;570;606;10.78;0.68;83.28;5.34;464;0;147.00;36
109;0;22552636;109;111;575;606;10.73;0.67;84.96;5.32;466;0;148.00;31
109;0;22552649;109;108;577;606;10.65;0.67;84.96;5.32;468;0;149.00;29
112;0;22552665;112;109;582;611;10.43;0.65;85.88;5.31;470;0;150.00;29
115;0;22552676;115;109;584;611;10.36;0.65;87.40;5.31;469;0;151.00;27
115;0;22552688;115;110;586;612;10.43;0.65;87.40;5.32;471;0;152.00;26
117;0;22552700;117;113;589;613;10.41;0.65;88.21;5.34;472;0;153.00;24
120;0;22552715;120;113;591;613;10.40;0.65;88.68;5.36;471;0;154.00;22
121;0;22552727;121;113;594;614;10.36;0.64;89.23;5.37;473;0;155.00;20
124;0;22552744;124;118;601;614;10.17;0.63;89.16;5.43;477;0;156.00;13
126;0;22552758;126;122;603;614;10.05;0.62;90.10;5.45;477;0;157.00;11
126;0;22552777;126;129;605;614;10.04;0.62;90.10;5.47;479;0;158.00;9
126;0;22552793;126;131;610;618;10.00;0.62;90.10;5.45;484;0;159.00;8
130;0;22552806;130;138;610;618;9.94;0.62;90.03;5.45;480;0;160.00;8
132;0;22552818;132;143;611;618;9.96;0.62;91.06;5.47;479;0;161.00;7
133;0;22552826;133;151;613;621;9.86;0.61;91.43;5.48;480;0;162.00;8
133;0;22552839;133;155;614;621;9.89;0.61;91.43;5.51;481;0;163.00;7
136;0;22552850;136;159;615;621;9.80;0.61;92.99;5.53;479;0;164.00;6
137;0;22552868;137;163;619;625;9.64;0.60;93.33;5.52;482;0;165.00;6
137;0;22552879;137;162;621;626;9.65;0.60;93.33;5.51;484;0;166.00;5
140;0;22552897;140;163;621;626;9.63;0.60;94.38;5.51;481;0;167.00;5
140;0;22552908;140;160;625;630;9.65;0.60;94.38;5.47;485;0;168.00;5
143;0;22552918;143;157;626;630;9.60;0.59;95.30;5.48;483;0;169.00;4
144;0;22552928;144;157;627;630;9.66;0.60;95.78;5.51;483;0;170.00;3
148;0;22552936;148;153;629;631;9.53;0.59;96.95;5.53;481;0;171.00;2
149;0;22552946;149;153;629;631;9.47;0.59;97.44;5.53;480;0;172.00;2
153;0;22552956;153;153;635;637;9.47;0.58;98.24;5.49;482;0;173.00;2
153;0;22552968;153;155;635;637;9.33;0.58;98.24;5.49;482;0;174.00;2
155;0;22552975;155;143;636;638;9.26;0.57;99.22;5.48;481;0;175.00;2
156;0;22552986;156;139;636;638;9.18;0.57;99.62;5.48;480;0;176.00;2
156;0;22552999;156;134;636;638;9.05;0.56;99.62;5.48;480;0;177.00;2
159;0;22553007;159;131;636;638;9.03;0.56;100.26;5.48;477;0;178.00;2
160;0;22553019;160;132;638;638;8.98;0.55;100.68;5.54;478;0;179.00;0
160;0;22553030;160;132;669;672;9.13;0.57;100.68;5.28;509;0;180.00;3
160;0;22553042;160;128;669;672;9.14;0.57;100.68;5.28;509;0;181.00;3
161;0;22553053;161;126;671;672;9.19;0.57;100.73;5.27;510;0;182.00;1
163;0;22553066;163;126;671;672;9.26;0.57;101.18;5.27;508;0;183.00;1
165;0;22553074;165;126;672;672;9.37;0.58;100.54;5.27;507;0;184.00;0
165;0;22553086;165;123;672;672;9.44;0.58;100.54;5.27;507;0;185.00;0
166;0;22553105;166;120;676;676;9.48;0.59;100.51;5.24;510;0;186.00;0
166;0;22553117;166;119;676;676;9.44;0.58;100.51;5.24;510;0;187.00;0
167;0;22553125;167;119;680;680;9.41;0.58;100.66;5.22;513;0;188.00;0
169;0;22553137;169;126;681;681;9.42;0.58;100.96;5.21;512;0;189.00;0
172;0;22553149;172;134;681;681;9.41;0.58;102.23;5.21;509;0;190.00;0
175;0;22553158;175;142;681;681;9.38;0.58;102.87;5.21;506;0;191.00;0
177;0;22553169;177;154;694;694;9.38;0.58;102.83;5.11;517;0;192.00;0
177;0;22553180;177;153;694;694;9.27;0.57;102.83;5.11;517;0;193.00;0
177;0;22553189;177;157;694;694;9.22;0.57;102.83;5.11;517;0;194.00;0
181;0;22553199;181;160;695;695;9.07;0.56;103.31;5.11;514;0;195.00;0
184;0;22553210;184;164;696;696;8.97;0.55;102.98;5.10;512;0;196.00;0
185;0;22553222;185;171;696;696;8.96;0.55;102.97;5.10;511;0;197.00;0
188;0;22553233;188;178;698;699;8.95;0.55;102.93;5.09;510;0;198.00;1
191;0;22553243;191;176;699;699;8.87;0.54;103.47;5.08;508;0;199.00;0
192;0;22553256;192;178;699;699;8.78;0.54;103.59;5.08;507;0;200.00;0
194;0;22553273;194;186;699;699;8.59;0.53;103.69;5.08;505;0;201.00;0
196;0;22553287;196;192;704;705;8.49;0.52;103.43;5.05;508;0;202.00;1
198;0;22553299;198;196;705;705;8.39;0.52;102.98;5.05;507;0;203.00;0
199;0;22553307;199;203;705;705;8.22;0.51;102.77;5.05;506;0;204.00;0
203;0;22553320;203;212;705;705;8.11;0.50;102.23;5.05;502;0;205.00;0
204;0;22553336;204;218;709;709;8.01;0.49;101.86;5.02;505;0;206.00;0
208;0;22553349;208;223;710;710;7.91;0.48;102.52;5.02;502;0;207.00;0
209;0;22553364;209;228;710;710;7.78;0.48;102.54;5.02;501;0;208.00;0
210;0;22553374;210;229;711;711;7.72;0.47;102.81;5.01;501;0;209.00;0
212;0;22553392;212;231;711;711;7.60;0.47;102.24;5.01;499;0;210.00;0
214;0;22553403;214;239;711;711;7.48;0.46;102.88;5.01;497;0;211.00;0
214;0;22553414;214;241;711;711;7.37;0.45;102.88;5.01;497;0;212.00;0
216;0;22553422;216;244;711;711;7.20;0.44;102.79;5.01;495;0;213.00;0
217;0;22553430;217;246;711;711;7.15;0.44;102.96;5.01;494;0;214.00;0
219;0;22553438;219;252;711;711;7.04;0.43;103.19;5.01;492;0;215.00;0
221;0;22553445;221;264;752;781;7.16;0.44;103.21;4.74;531;0;216.00;29
223;0;22553460;223;264;754;782;7.05;0.44;103.37;4.73;531;0;217.00;28
223;0;22553471;223;266;762;782;7.12;0.44;103.37;4.70;539;0;218.00;20
224;0;22553481;224;269;763;782;7.05;0.44;103.08;4.70;539;0;219.00;19
224;0;22553488;224;273;767;782;7.11;0.44;103.08;4.69;543;0;220.00;15
226;0;22553496;226;277;768;782;7.09;0.44;103.48;4.69;542;0;221.00;14
228;0;22553505;228;266;771;782;7.14;0.44;103.48;4.70;543;0;222.00;11
230;0;22553516;230;263;774;782;7.19;0.44;104.00;4.71;544;0;223.00;8
231;0;22553524;231;243;777;783;7.24;0.45;104.49;4.72;546;0;224.00;6
232;0;22553535;232;233;780;785;7.28;0.45;105.00;4.73;548;0;225.00;5
235;0;22553545;235;232;783;785;7.29;0.45;105.89;4.74;548;0;226.00;2
236;0;22553556;236;235;788;789;7.38;0.45;106.40;4.73;552;0;227.00;1
238;0;22553570;238;230;789;789;7.52;0.46;107.40;4.72;551;0;228.00;0
241;0;22553584;241;231;789;789;7.66;0.47;107.84;4.72;548;0;229.00;0
242;0;22553597;242;230;789;789;7.85;0.48;108.33;4.72;547;0;230.00;0
242;0;22553620;242;213;795;795;8.06;0.49;108.33;4.70;553;0;231.00;0
242;0;22553634;242;207;795;795;8.21;0.50;108.33;4.70;553;0;232.00;0
242;0;22553642;242;194;795;795;8.39;0.51;108.33;4.70;553;0;233.00;0
244;0;22553657;244;186;797;798;8.57;0.52;108.28;4.68;553;0;234.00;1
245;0;22553669;245;182;797;798;8.71;0.53;108.79;4.68;552;0;235.00;1
245;0;22553680;245;176;798;798;8.85;0.54;108.79;4.68;553;0;236.00;0
247;0;22553691;247;166;799;799;8.96;0.55;109.47;4.68;552;0;237.00;0
248;0;22553704;248;162;800;800;9.12;0.56;109.96;4.67;552;0;238.00;0
249;0;22553718;249;159;800;800;9.23;0.56;110.09;4.67;551;0;239.00;0
250;0;22553731;250;160;823;826;9.35;0.57;109.75;4.54;573;0;240.00;3
253;0;22553746;253;154;824;826;9.45;0.58;110.72;4.54;571;0;241.00;2
255;0;22553761;255;141;826;826;9.61;0.59;110.87;4.53;571;0;242.00;0
257;0;22553773;257;139;827;827;9.72;0.59;110.72;4.52;570;0;243.00;0
258;0;22553787;258;138;827;827;9.71;0.59;111.20;4.52;569;0;244.00;0
261;0;22553798;261;126;831;831;9.71;0.59;112.01;4.51;570;0;245.00;0
264;0;22553808;264;126;831;831;9.62;0.59;112.62;4.51;567;0;246.00;0
264;0;22553821;264;125;835;835;9.59;0.59;112.62;4.49;571;0;247.00;0
267;0;22553833;267;122;835;835;9.59;0.59;112.91;4.49;568;0;248.00;0
269;0;22553842;269;127;835;835;9.60;0.59;113.38;4.49;566;0;249.00;0
273;0;22553859;273;123;835;835;9.62;0.59;114.89;4.49;562;0;250.00;0
277;0;22553869;277;123;835;835;9.69;0.59;115.44;4.49;558;0;251.00;0
278;0;22553877;278;129;845;847;9.74;0.60;115.42;4.44;567;0;252.00;2
282;0;22553887;282;125;845;847;9.78;0.60;115.87;4.44;563;0;253.00;2
282;0;22553907;282;128;847;847;9.88;0.60;115.87;4.43;565;0;254.00;0
284;0;22553917;284;126;847;847;9.99;0.61;116.34;4.43;563;0;255.00;0
288;0;22553935;288;128;847;847;10.07;0.61;117.31;4.43;559;0;256.00;0
290;0;22553943;290;130;847;847;10.12;0.62;117.49;4.43;557;0;257.00;0
293;0;22553952;293;132;848;848;10.11;0.61;118.17;4.43;555;0;258.00;0
294;0;22553962;294;135;848;848;10.11;0.61;118.19;4.43;554;0;259.00;0
296;0;22553978;296;139;854;854;10.07;0.61;118.46;4.40;558;0;260.00;0
299;0;22553988;299;142;855;855;10.00;0.61;119.25;4.40;556;0;261.00;0
300;0;22553998;300;141;855;855;10.02;0.61;119.69;4.40;555;0;262.00;0
302;0;22554008;302;148;855;855;9.96;0.60;119.81;4.40;553;0;263.00;0
303;0;22554017;303;151;859;859;9.90;0.60;120.24;4.38;556;0;264.00;0
303;0;22554026;303;150;859;859;9.93;0.60;120.24;4.38;556;0;265.00;0
303;0;22554037;303;147;859;859;9.94;0.60;120.24;4.38;556;0;266.00;0
305;0;22554046;305;145;860;860;9.98;0.60;120.86;4.37;555;0;267.00;0
306;0;22554054;306;143;864;864;9.91;0.60;120.87;4.36;558;0;268.00;0
307;0;22554066;307;138;864;864;10.01;0.61;121.20;4.36;557;0;269.00;0
309;0;22554077;309;137;868;870;10.14;0.61;121.53;4.34;559;0;270.00;2
311;0;22554086;311;133;868;870;10.21;0.62;122.03;4.34;557;0;271.00;2
311;0;22554098;311;136;870;870;10.32;0.63;122.03;4.33;559;0;272.00;0
315;0;22554107;315;134;870;870;10.36;0.63;122.53;4.33;555;0;273.00;0
316;0;22554118;316;131;874;874;10.41;0.63;123.01;4.32;558;0;274.00;0
320;0;22554128;320;130;874;874;10.43;0.63;123.85;4.32;554;0;275.00;0
325;0;22554139;325;130;874;874;10.44;0.63;124.24;4.32;549;0;276.00;0
328;0;22554148;328;129;874;874;10.50;0.63;124.32;4.32;546;0;277.00;0
330;0;22554155;330;130;875;875;10.43;0.63;124.60;4.31;545;0;278.00;0
332;0;22554167;332;122;876;876;10.44;0.63;124.66;4.31;544;0;279.00;0
333;0;22554175;333;116;876;876;10.42;0.63;124.70;4.31;543;0;280.00;0
335;0;22554186;335;110;877;877;10.46;0.63;124.84;4.31;542;0;281.00;0
337;0;22554195;337;102;877;877;10.51;0.64;124.98;4.31;540;0;282.00;0
339;0;22554205;339;97;877;877;10.66;0.65;124.94;4.31;538;0;283.00;0
340;0;22554217;340;94;877;877;10.74;0.65;125.19;4.31;537;0;284.00;0
341;0;22554225;341;91;877;877;10.87;0.66;125.64;4.31;536;0;285.00;0
342;0;22554236;342;91;877;877;10.95;0.66;125.69;4.31;535;0;286.00;0
343;0;22554247;343;83;877;877;11.09;0.67;125.74;4.31;534;0;287.00;0
345;0;22554257;345;99;945;1004;10.87;0.67;125.74;4.00;600;0;288.00;59
345;0;22554284;345;88;948;1005;10.94;0.67;125.74;3.99;603;0;289.00;57
347;0;22554293;347;84;955;1005;11.05;0.68;126.16;3.97;608;0;290.00;50
350;0;22554308;350;81;959;1005;10.97;0.68;125.83;3.97;609;0;291.00;46
350;0;22554321;350;86;964;1005;10.96;0.67;125.83;3.97;614;0;292.00;41
352;0;22554337;352;80;965;1005;10.98;0.67;126.05;3.97;613;0;293.00;40
352;0;22554352;352;82;968;1005;10.99;0.68;126.05;3.98;616;0;294.00;37
355;0;22554372;355;77;970;1005;11.14;0.68;126.76;3.98;615;0;295.00;35
356;0;22554396;356;78;974;1006;11.27;0.69;126.83;4.00;618;0;296.00;32
358;0;22554417;358;77;977;1007;11.37;0.70;127.22;4.02;619;0;297.00;30
360;0;22554436;360;76;980;1007;11.42;0.70;127.31;4.03;620;0;298.00;27
362;0;22554452;362;79;982;1008;11.39;0.70;127.47;4.05;620;0;299.00;26
362;0;22554476;362;85;987;1014;11.32;0.69;127.47;4.06;625;0;300.00;27
363;0;22554501;363;79;991;1014;11.35;0.70;127.36;4.10;628;0;301.00;23
365;0;22554517;365;85;992;1014;11.37;0.70;127.25;4.11;627;0;302.00;22
368;0;22554535;368;88;998;1018;11.32;0.69;128.06;4.17;630;0;303.00;20
369;0;22554551;369;92;1000;1018;11.34;0.69;128.02;4.18;631;0;304.00;18
369;0;22554565;369;100;1002;1018;11.28;0.69;128.02;4.19;633;0;305.00;16
372;0;22554576;372;106;1008;1021;11.20;0.69;128.00;4.23;636;0;306.00;13
373;0;22554590;373;113;1008;1021;11.13;0.68;128.46;4.23;635;0;307.00;13
378;0;22554604;378;116;1012;1021;11.08;0.68;129.58;4.28;634;0;308.00;9
381;0;22554618;381;119;1015;1025;11.09;0.68;130.75;4.27;634;0;309.00;10
381;0;22554630;381;121;1019;1026;11.11;0.68;130.75;4.29;638;0;310.00;7
383;0;22554640;383;124;1020;1026;11.11;0.68;131.33;4.30;637;0;311.00;6
384;0;22554652;384;131;1025;1030;11.04;0.68;131.79;4.29;641;0;312.00;5
387;0;22554665;387;133;1026;1030;11.03;0.68;132.02;4.30;639;0;313.00;4
389;0;22554679;389;135;1027;1030;11.00;0.68;132.16;4.30;638;0;314.00;3
391;0;22554692;391;137;1030;1032;10.96;0.67;132.82;4.30;639;0;315.00;2
392;0;22554704;392;139;1030;1032;10.93;0.67;133.22;4.30;638;0;316.00;2
395;0;22554715;395;140;1036;1038;10.91;0.67;133.73;4.28;641;0;317.00;2
401;0;22554728;401;147;1036;1038;10.82;0.66;134.49;4.28;635;0;318.00;2
402;0;22554740;402;152;1037;1039;10.64;0.65;134.83;4.28;635;0;319.00;2
402;0;22554752;402;153;1037;1039;10.46;0.64;134.83;4.28;635;0;320.00;2
404;0;22554765;404;154;1037;1039;10.29;0.63;135.40;4.28;633;0;321.00;2
406;0;22554774;406;159;1037;1039;10.10;0.62;135.84;4.28;631;0;322.00;2
408;0;22554786;408;162;1037;1039;9.98;0.61;135.88;4.28;629;0;323.00;2
412;0;22554797;412;160;1048;1051;9.90;0.61;136.17;4.24;636;0;324.00;3
413;0;22554809;413;159;1048;1051;9.80;0.60;136.10;4.24;635;0;325.00;3
414;0;22554820;414;161;1049;1051;9.70;0.59;136.30;4.23;635;0;326.00;2
417;0;22554832;417;165;1049;1051;9.62;0.59;136.43;4.23;632;0;327.00;2
419;0;22554844;419;161;1049;1051;9.56;0.59;136.57;4.23;630;0;328.00;2
420;0;22554856;420;167;1049;1051;9.56;0.59;136.60;4.23;629;0;329.00;2
421;0;22554871;421;170;1053;1055;9.49;0.58;137.05;4.26;632;0;330.00;2
422;0;22554886;422;172;1053;1055;9.50;0.58;137.20;4.26;631;0;331.00;2
422;0;22554898;422;176;1058;1059;9.60;0.59;137.20;4.27;636;0;332.00;1
425;0;22554913;425;179;1060;1060;9.62;0.59;137.33;4.26;635;0;333.00;0
427;0;22554925;427;180;1060;1060;9.65;0.59;137.99;4.26;633;0;334.00;0
431;0;22554939;431;185;1060;1060;9.59;0.59;138.61;4.26;629;0;335.00;0
433;0;22554951;433;189;1073;1073;9.47;0.58;138.77;4.21;640;0;336.00;0
438;0;22554964;438;198;1073;1073;9.39;0.58;139.34;4.21;635;0;337.00;0
441;0;22554973;441;200;1073;1073;9.37;0.58;140.06;4.21;632;0;338.00;0
443;0;22554987;443;205;1074;1074;9.40;0.58;140.27;4.21;631;0;339.00;0
447;0;22554998;447;207;1075;1075;9.26;0.57;141.00;4.21;628;0;340.00;0
451;0;22555007;451;207;1075;1075;9.14;0.56;142.04;4.21;624;0;341.00;0
457;0;22555019;457;212;1078;1078;8.97;0.55;143.73;4.19;621;0;342.00;0
461;0;22555032;461;216;1078;1078;8.82;0.54;144.48;4.19;617;0;343.00;0
463;0;22555041;463;215;1078;1078;8.79;0.54;145.34;4.19;615;0;344.00;0
463;0;22555054;463;217;1078;1078;8.72;0.54;145.34;4.19;615;0;345.00;0
470;0;22555065;470;221;1084;1084;8.60;0.53;145.92;4.18;614;0;346.00;0
475;0;22555077;475;224;1084;1084;8.41;0.51;146.93;4.18;609;0;347.00;0
475;0;22555089;475;221;1084;1084;8.34;0.51;146.93;4.18;609;0;348.00;0
478;0;22555100;478;228;1084;1084;8.15;0.50;147.69;4.18;606;0;349.00;0
480;0;22555108;480;215;1088;1088;8.08;0.49;147.94;4.16;608;0;350.00;0
484;0;22555119;484;210;1089;1089;8.04;0.49;148.55;4.16;605;0;351.00;0
484;0;22555130;484;204;1089;1089;8.07;0.50;148.55;4.16;605;0;352.00;0
488;0;22555148;488;197;1090;1090;8.04;0.49;148.73;4.16;602;0;353.00;0
495;0;22555158;495;194;1090;1090;7.92;0.48;149.59;4.16;595;0;354.00;0
497;0;22555170;497;197;1090;1090;7.90;0.48;150.35;4.16;593;0;355.00;0
499;0;22555180;499;198;1090;1090;7.83;0.48;150.06;4.16;591;0;356.00;0
500;0;22555190;500;198;1090;1090;7.86;0.48;150.44;4.16;590;0;357.00;0
502;0;22555202;502;194;1090;1090;7.87;0.49;150.75;4.16;588;0;358.00;0
504;0;22555212;504;196;1090;1090;7.92;0.49;150.77;4.16;586;0;359.00;0
504;0;22555223;504;203;1158;1215;8.21;0.52;150.77;3.91;654;0;360.00;57
508;0;22555250;508;210;1164;1216;8.22;0.52;150.63;3.90;656;0;361.00;52
513;0;22555261;513;210;1178;1216;8.19;0.51;150.47;3.88;665;0;362.00;38
516;0;22555284;516;216;1183;1216;8.13;0.51;150.64;3.87;667;0;363.00;33
522;0;22555298;522;221;1187;1216;7.99;0.50;151.00;3.87;665;0;364.00;29
524;0;22555310;524;229;1189;1216;7.90;0.49;150.76;3.87;665;0;365.00;27
527;0;22555324;527;235;1195;1216;7.81;0.48;151.07;3.89;668;0;366.00;21
529;1;22555337;529;237;1197;1216;7.69;0.48;151.31;3.89;668;1;367.00;19
530;1;22555366;530;243;1201;1217;7.60;0.47;151.18;3.90;671;1;368.00;16
532;1;22555375;532;252;1209;1218;7.42;0.46;151.09;3.94;677;1;369.00;9
534;1;22555389;534;251;1211;1218;7.29;0.45;150.83;3.95;677;1;370.00;7
535;1;22555401;535;256;1217;1222;7.11;0.44;150.70;3.95;682;1;371.00;5
540;1;22555413;540;265;1219;1222;6.88;0.43;150.46;3.95;679;1;372.00;3
541;1;22555423;541;270;1220;1222;6.72;0.42;150.23;3.96;679;1;373.00;2
542;1;22555435;542;276;1220;1222;6.62;0.41;150.11;3.96;678;1;374.00;2
545;1;22555445;545;281;1227;1228;6.57;0.41;150.05;3.95;682;1;375.00;1
546;1;22555454;546;291;1227;1228;6.55;0.41;150.13;3.95;681;1;376.00;1
547;1;22555464;547;293;1228;1228;6.54;0.40;150.20;3.96;681;1;377.00;0
548;1;22555474;548;303;1230;1231;6.52;0.40;150.28;3.96;682;1;378.00;1
549;1;22555483;549;307;1231;1231;6.50;0.40;150.43;3.95;682;1;379.00;0
551;1;22555492;551;313;1231;1231;6.46;0.40;150.32;3.95;680;1;380.00;0
554;1;22555507;554;306;1232;1232;6.42;0.40;150.61;3.95;678;1;381.00;0
557;1;22555518;557;295;1233;1233;6.44;0.39;150.30;3.95;676;1;382.00;0
557;1;22555533;557;293;1233;1233;6.53;0.40;150.30;3.95;676;1;383.00;0
559;1;22555542;559;290;1246;1246;6.68;0.41;150.08;3.91;687;1;384.00;0
561;1;22555554;561;289;1246;1246;6.80;0.42;150.07;3.91;685;1;385.00;0
565;1;22555565;565;284;1246;1246;6.87;0.42;150.08;3.91;681;1;386.00;0
566;1;22555575;566;279;1247;1247;6.94;0.42;149.98;3.90;681;1;387.00;0
568;1;22555592;568;272;1247;1247;7.02;0.43;149.55;3.90;679;1;388.00;0
570;1;22555604;570;271;1251;1251;7.13;0.43;149.69;3.90;681;1;389.00;0
570;1;22555618;570;270;1251;1251;7.21;0.44;149.69;3.90;681;1;390.00;0
573;1;22555629;573;271;1255;1255;7.22;0.44;149.74;3.89;682;1;391.00;0
575;1;22555645;575;268;1255;1255;7.23;0.44;149.72;3.89;680;1;392.00;0
576;2;22555655;576;266;1255;1255;7.26;0.44;149.89;3.89;679;2;393.00;0
577;2;22555679;577;268;1255;1255;7.19;0.44;150.25;3.89;678;2;394.00;0
579;2;22555696;579;270;1255;1255;7.19;0.44;149.85;3.89;676;2;395.00;0
579;2;22555715;579;266;1266;1267;7.34;0.45;149.85;3.85;687;2;396.00;1
582;2;22555725;582;257;1267;1267;7.42;0.45;150.03;3.85;685;2;397.00;0
584;2;22555738;584;253;1267;1267;7.55;0.46;150.09;3.85;683;2;398.00;0
585;2;22555750;585;249;1267;1267;7.66;0.47;150.18;3.85;682;2;399.00;0
586;2;22555761;586;245;1267;1267;7.80;0.47;150.11;3.85;681;2;400.00;0
586;2;22555778;586;243;1267;1267;7.92;0.48;150.11;3.85;681;2;401.00;0
587;2;22555792;587;242;1268;1268;7.96;0.49;150.05;3.85;681;2;402.00;0
589;2;22555805;589;244;1268;1268;8.05;0.49;150.12;3.85;679;2;403.00;0
589;2;22555817;589;242;1274;1274;8.19;0.50;150.12;3.83;685;2;404.00;0
590;2;22555828;590;244;1276;1276;8.25;0.50;150.31;3.83;686;2;405.00;0
591;2;22555850;591;234;1276;1276;8.24;0.50;150.73;3.83;685;2;406.00;0
592;2;22555861;592;224;1276;1276;8.29;0.50;150.68;3.83;684;2;407.00;0
595;2;22555872;595;220;1280;1280;8.32;0.51;150.99;3.82;685;2;408.00;0
596;2;22555885;596;212;1280;1280;8.30;0.51;151.18;3.82;684;2;409.00;0
598;2;22555896;598;210;1280;1280;8.40;0.51;151.37;3.82;682;2;410.00;0
602;2;22555907;602;205;1281;1281;8.49;0.52;152.17;3.81;679;2;411.00;0
605;2;22555920;605;203;1285;1285;8.61;0.52;152.30;3.81;680;2;412.00;0
607;2;22555932;607;205;1285;1285;8.69;0.53;153.02;3.81;678;2;413.00;0
608;2;22555945;608;204;1287;1288;8.74;0.53;153.45;3.80;679;2;414.00;1
610;2;22555957;610;201;1287;1288;8.75;0.53;153.77;3.80;677;2;415.00;1
610;2;22555968;610;203;1288;1288;8.79;0.54;153.77;3.80;678;2;416.00;0
615;2;22555982;615;200;1288;1288;8.73;0.53;154.11;3.80;673;2;417.00;0
617;2;22555997;617;196;1292;1292;8.85;0.54;154.90;3.79;675;2;418.00;0
620;2;22556009;620;186;1292;1292;8.88;0.54;155.47;3.79;672;2;419.00;0
622;2;22556022;622;184;1292;1292;8.95;0.55;155.97;3.79;670;2;420.00;0
625;2;22556033;625;179;1292;1292;8.98;0.55;156.34;3.79;667;2;421.00;0
627;2;22556044;627;171;1293;1293;9.00;0.55;156.77;3.79;666;2;422.00;0
630;2;22556065;630;170;1294;1294;9.06;0.55;157.45;3.78;664;2;423.00;0
634;2;22556075;634;167;1294;1294;9.11;0.56;157.68;3.78;660;2;424.00;0
636;2;22556088;636;165;1295;1295;9.19;0.56;158.40;3.78;659;2;425.00;0
642;2;22556099;642;171;1295;1295;9.22;0.56;159.11;3.78;653;2;426.00;0
644;2;22556110;644;169;1295;1295;9.19;0.56;159.55;3.78;651;2;427.00;0
646;2;22556122;646;166;1295;1295;9.27;0.57;160.17;3.78;649;2;428.00;0
650;2;22556135;650;166;1295;1295;9.40;0.58;161.33;3.78;645;2;429.00;0
650;2;22556152;650;163;1295;1295;9.55;0.59;161.33;3.78;645;2;430.00;0
655;2;22556165;655;163;1295;1295;9.60;0.59;162.50;3.78;640;2;431.00;0
657;2;22556175;657;191;1375;1422;9.41;0.59;163.11;3.56;718;2;432.00;47
661;2;22556199;661;179;1375;1423;9.38;0.58;163.61;3.56;714;2;433.00;48
662;2;22556212;662;169;1381;1423;9.51;0.59;163.47;3.56;719;2;434.00;42
664;2;22556225;664;173;1382;1423;9.55;0.59;163.69;3.56;718;2;435.00;41
666;2;22556241;666;169;1386;1423;9.53;0.59;164.40;3.56;720;2;436.00;37
669;2;22556266;669;168;1388;1423;9.58;0.59;164.74;3.56;719;2;437.00;35
673;2;22556280;673;168;1390;1423;9.58;0.59;165.34;3.56;717;2;438.00;33
677;2;22556292;677;167;1393;1423;9.59;0.59;166.07;3.57;716;2;439.00;30
678;2;22556308;678;165;1396;1424;9.70;0.60;166.13;3.58;718;2;440.00;28
680;2;22556324;680;164;1398;1425;9.73;0.60;166.85;3.59;718;2;441.00;27
683;2;22556341;683;162;1402;1425;9.78;0.60;167.28;3.61;719;2;442.00;23
684;2;22556358;684;163;1406;1426;9.85;0.60;167.26;3.63;722;2;443.00;20
687;2;22556375;687;162;1409;1426;9.91;0.61;167.73;3.65;722;2;444.00;17
687;2;22556404;687;158;1410;1426;9.97;0.61;167.73;3.65;723;2;445.00;16
689;2;22556421;689;158;1413;1426;9.99;0.61;167.79;3.67;724;2;446.00;13
690;2;22556439;690;162;1416;1430;10.08;0.62;167.78;3.68;726;2;447.00;14
693;2;22556456;693;166;1417;1430;10.14;0.62;168.01;3.68;724;2;448.00;13
697;2;22556474;697;165;1419;1430;10.10;0.62;168.36;3.70;722;2;449.00;11
703;2;22556496;703;169;1423;1436;10.08;0.62;169.15;3.70;720;2;450.00;13
706;2;22556512;706;166;1423;1436;10.09;0.62;169.50;3.70;717;2;451.00;13
708;2;22556529;708;168;1426;1436;10.06;0.62;169.56;3.70;718;2;452.00;10
714;2;22556544;714;167;1429;1440;9.99;0.61;169.89;3.69;715;2;453.00;11
717;2;22556559;717;165;1430;1441;9.99;0.61;170.24;3.69;713;2;454.00;11
718;2;22556573;718;160;1433;1441;10.04;0.61;170.57;3.72;715;2;455.00;8
720;2;22556587;720;157;1435;1445;10.13;0.62;170.71;3.71;715;2;456.00;10
727;2;22556601;727;154;1435;1445;10.11;0.62;170.91;3.71;708;2;457.00;10
730;2;22556617;730;143;1438;1445;10.11;0.62;171.55;3.74;708;2;458.00;7
731;2;22556631;731;141;1440;1446;10.17;0.62;171.55;3.75;709;2;459.00;6
735;2;22556644;735;139;1440;1446;10.11;0.61;172.11;3.75;705;2;460.00;6
738;2;22556656;738;135;1444;1452;10.11;0.61;172.16;3.74;706;2;461.00;8
739;2;22556669;739;133;1444;1452;10.12;0.61;172.41;3.74;705;2;462.00;8
741;2;22556680;741;129;1444;1453;10.06;0.61;172.48;3.74;703;2;463.00;9
742;2;22556691;742;125;1444;1453;10.03;0.61;172.82;3.74;702;2;464.00;9
746;2;22556705;746;128;1444;1453;10.05;0.61;173.36;3.74;698;2;465.00;9
750;2;22556717;750;131;1444;1453;10.05;0.61;173.50;3.74;694;2;466.00;9
753;2;22556727;753;130;1444;1453;10.09;0.61;173.40;3.74;691;2;467.00;9
757;2;22556738;757;126;1454;1465;10.18;0.62;173.73;3.71;697;2;468.00;11
761;2;22556751;761;123;1455;1465;10.25;0.62;174.11;3.71;694;2;469.00;10
764;2;22556765;764;123;1455;1465;10.32;0.63;174.02;3.71;691;2;470.00;10
764;2;22556779;764;126;1455;1465;10.44;0.63;174.02;3.71;691;2;471.00;10
766;2;22556790;766;125;1455;1465;10.56;0.64;174.28;3.71;689;2;472.00;10
771;2;22556802;771;125;1455;1465;10.66;0.65;174.54;3.71;684;2;473.00;10
773;2;22556814;773;126;1458;1469;10.67;0.65;174.56;3.71;685;2;474.00;11
775;3;22556828;775;127;1458;1469;10.71;0.65;174.55;3.71;683;3;475.00;11
778;3;22556868;778;125;1463;1473;10.66;0.65;174.72;3.76;685;3;476.00;10
779;3;22556884;779;125;1464;1474;10.65;0.65;174.68;3.75;685;3;477.00;10
781;3;22556898;781;129;1465;1474;10.57;0.64;174.63;3.78;684;3;478.00;9
783;3;22556909;783;134;1466;1474;10.47;0.64;174.75;3.80;683;3;479.00;8
787;3;22556928;787;132;1490;1500;10.31;0.63;174.96;3.76;703;3;480.00;10
789;3;22556944;789;129;1493;1500;10.26;0.63;175.09;3.79;704;3;481.00;7
791;3;22556959;791;135;1495;1500;10.31;0.63;175.05;3.80;704;3;482.00;5
793;3;22556973;793;138;1497;1501;10.32;0.63;175.07;3.81;704;3;483.00;4
794;3;22556988;794;138;1497;1502;10.41;0.63;175.00;3.81;703;3;484.00;5
795;3;22557003;795;141;1499;1502;10.40;0.63;174.94;3.82;704;3;485.00;3
798;3;22557017;798;146;1501;1505;10.40;0.63;174.93;3.82;703;3;486.00;4
799;3;22557031;799;151;1504;1505;10.38;0.63;174.90;3.82;705;3;487.00;1
799;3;22557046;799;155;1504;1505;10.35;0.63;174.90;3.82;705;3;488.00;1
802;3;22557058;802;160;1505;1505;10.29;0.63;174.96;3.82;703;3;489.00;0
804;3;22557073;804;167;1511;1511;10.27;0.63;174.94;3.81;707;3;490.00;0
806;3;22557090;806;173;1511;1511;10.19;0.62;175.10;3.81;705;3;491.00;0
809;3;22557113;809;177;1511;1511;10.12;0.62;174.94;3.81;702;3;492.00;0
811;3;22557129;811;179;1511;1511;10.06;0.61;174.91;3.81;700;3;493.00;0
813;3;22557141;813;186;1515;1515;10.00;0.61;174.87;3.80;702;3;494.00;0
815;3;22557156;815;188;1517;1517;9.92;0.61;175.03;3.80;702;3;495.00;0
818;3;22557169;818;199;1517;1517;9.86;0.60;175.00;3.80;699;3;496.00;0
819;3;22557181;819;207;1518;1518;9.84;0.60;175.14;3.80;699;3;497.00;0
821;4;22557192;821;211;1518;1518;9.74;0.60;174.96;3.80;697;4;498.00;0
822;4;22557218;822;211;1518;1518;9.66;0.59;174.89;3.80;696;4;499.00;0
823;4;22557231;823;209;1518;1518;9.64;0.59;174.85;3.80;695;4;500.00;0
824;4;22557249;824;207;1518;1518;9.68;0.59;174.81;3.80;694;4;501.00;0
826;4;22557258;826;211;1518;1518;9.61;0.59;174.75;3.80;692;4;502.00;0
828;4;22557271;828;215;1518;1518;9.56;0.59;174.62;3.80;690;4;503.00;0
831;4;22557285;831;223;1556;1588;9.70;0.60;174.78;3.70;725;4;504.00;32
832;4;22557303;832;223;1559;1589;9.64;0.59;174.68;3.70;727;4;505.00;30
833;4;22557314;833;225;1569;1589;9.64;0.59;174.71;3.69;736;4;506.00;20
835;4;22557326;835;225;1572;1589;9.61;0.59;174.55;3.69;737;4;507.00;17
836;4;22557338;836;228;1576;1589;9.57;0.59;174.60;3.69;740;4;508.00;13
839;4;22557348;839;228;1578;1589;9.53;0.59;174.50;3.69;739;4;509.00;11
842;4;22557361;842;231;1582;1589;9.47;0.58;174.49;3.69;740;4;510.00;7
846;4;22557377;846;234;1585;1589;9.36;0.57;174.85;3.70;739;4;511.00;4
848;4;22557388;848;235;1587;1590;9.30;0.57;174.72;3.71;739;4;512.00;3
849;4;22557407;849;240;1590;1591;9.26;0.57;174.61;3.71;741;4;513.00;1
852;4;22557417;852;242;1590;1591;9.18;0.56;174.76;3.71;738;4;514.00;1
857;4;22557428;857;248;1595;1595;9.07;0.56;175.54;3.70;738;4;515.00;0
861;4;22557440;861;252;1595;1595;8.96;0.55;175.49;3.70;734;4;516.00;0
868;4;22557451;868;256;1595;1595;8.76;0.54;176.06;3.70;727;4;517.00;0
870;4;22557462;870;263;1595;1595;8.59;0.53;176.21;3.70;725;4;518.00;0
874;4;22557473;874;270;1601;1601;8.50;0.52;177.12;3.69;727;4;519.00;0
879;4;22557484;879;276;1601;1601;8.31;0.51;177.58;3.69;722;4;520.00;0
883;4;22557496;883;280;1601;1601;8.20;0.50;177.47;3.69;718;4;521.00;0
889;4;22557507;889;282;1603;1604;7.99;0.49;177.90;3.69;714;4;522.00;1
889;4;22557517;889;289;1603;1604;7.83;0.48;177.90;3.69;714;4;523.00;1
893;4;22557526;893;285;1604;1604;7.55;0.46;177.81;3.69;711;4;524.00;0
894;4;22557537;894;273;1605;1605;7.46;0.46;178.15;3.69;711;4;525.00;0
895;4;22557548;895;271;1606;1606;7.34;0.45;178.37;3.68;711;4;526.00;0
897;4;22557556;897;267;1606;1606;7.18;0.44;178.18;3.68;709;4;527.00;0
900;4;22557566;900;272;1618;1619;7.11;0.43;177.82;3.66;718;4;528.00;1
901;4;22557579;901;271;1619;1619;7.10;0.43;177.73;3.66;718;4;529.00;0
903;4;22557589;903;278;1619;1619;7.03;0.43;178.16;3.66;716;4;530.00;0
906;4;22557601;906;283;1620;1620;7.09;0.43;177.83;3.65;714;4;531.00;0
907;4;22557611;907;278;1620;1620;7.09;0.43;178.18;3.65;713;4;532.00;0
908;4;22557620;908;279;1624;1624;7.27;0.44;178.21;3.65;716;4;533.00;0
908;4;22557632;908;274;1624;1624;7.27;0.44;178.21;3.65;716;4;534.00;0
909;4;22557641;909;271;1628;1628;7.23;0.44;178.58;3.64;719;4;535.00;0
911;4;22557653;911;281;1628;1628;7.02;0.43;178.70;3.64;717;4;536.00;0
916;4;22557665;916;278;1628;1628;6.90;0.42;178.87;3.64;712;4;537.00;0
917;4;22557674;917;263;1628;1628;6.83;0.42;179.17;3.64;711;4;538.00;0
918;4;22557685;918;259;1628;1628;6.81;0.42;179.45;3.64;710;4;539.00;0
923;4;22557696;923;255;1659;1662;7.00;0.43;179.86;3.57;736;4;540.00;3
924;4;22557708;924;252;1659;1662;7.10;0.44;179.82;3.57;735;4;541.00;3
928;4;22557720;928;250;1661;1662;7.22;0.44;180.31;3.57;733;4;542.00;1
930;4;22557732;930;243;1661;1662;7.31;0.45;180.42;3.57;731;4;543.00;1
932;4;22557751;932;245;1662;1662;7.33;0.45;180.30;3.57;730;4;544.00;0
935;4;22557760;935;245;1662;1662;7.37;0.45;180.70;3.57;727;4;545.00;0
937;4;22557771;937;243;1663;1663;7.45;0.46;180.82;3.57;726;4;546.00;0
941;4;22557784;941;238;1663;1663;7.52;0.46;181.14;3.57;722;4;547.00;0
944;4;22557794;944;238;1669;1669;7.58;0.46;181.35;3.56;725;4;548.00;0
946;4;22557809;946;238;1670;1670;7.56;0.46;181.52;3.56;724;4;549.00;0
948;4;22557821;948;237;1670;1670;7.50;0.46;181.66;3.56;722;4;550.00;0
950;4;22557840;950;242;1670;1670;7.50;0.46;182.02;3.56;720;4;551.00;0
952;4;22557852;952;246;1674;1674;7.47;0.46;182.27;3.55;722;4;552.00;0
954;4;22557864;954;246;1674;1674;7.43;0.45;182.11;3.55;720;4;553.00;0
957;4;22557875;957;254;1674;1674;7.37;0.45;182.40;3.55;717;4;554.00;0
959;4;22557887;959;255;1675;1675;7.30;0.45;182.41;3.55;716;4;555.00;0
959;4;22557900;959;244;1679;1679;7.31;0.45;182.41;3.54;720;4;556.00;0
961;4;22557910;961;247;1679;1679;7.27;0.45;182.36;3.54;718;4;557.00;0
966;4;22557921;966;245;1681;1682;7.25;0.44;182.65;3.54;715;4;558.00;1
970;4;22557932;970;249;1681;1682;7.22;0.44;182.63;3.54;711;4;559.00;1
973;4;22557944;973;246;1682;1682;7.22;0.44;183.13;3.54;709;4;560.00;0
976;4;22557954;976;246;1682;1682;7.15;0.44;183.05;3.54;706;4;561.00;0
979;4;22557964;979;248;1686;1686;7.16;0.44;183.37;3.53;707;4;562.00;0
979;4;22557974;979;250;1686;1686;7.16;0.44;183.37;3.53;707;4;563.00;0
983;4;22557985;983;252;1686;1686;7.16;0.43;183.76;3.53;703;4;564.00;0
984;4;22557997;984;252;1686;1686;7.18;0.44;183.86;3.53;702;4;565.00;0
987;4;22558007;987;248;1687;1687;7.16;0.44;184.03;3.53;700;4;566.00;0
990;4;22558020;990;246;1688;1688;7.15;0.43;184.31;3.53;698;4;567.00;0
993;4;22558030;993;252;1688;1688;7.13;0.43;184.62;3.53;695;4;568.00;0
993;4;22558040;993;250;1689;1689;7.20;0.44;184.62;3.53;696;4;569.00;0
994;4;22558052;994;249;1689;1689;7.20;0.44;184.74;3.53;695;4;570.00;0
996;4;22558064;996;254;1689;1689;7.21;0.44;184.75;3.53;693;4;571.00;0
997;4;22558074;997;241;1689;1689;7.27;0.44;184.92;3.53;692;4;572.00;0
999;4;22558087;999;236;1689;1689;7.35;0.45;184.97;3.53;690;4;573.00;0
999;4;22558098;999;233;1689;1689;7.48;0.45;184.97;3.53;690;4;574.00;0
1000;4;22558108;1000;231;1689;1689;7.60;0.46;184.93;3.53;689;4;575.00;0
1005;4;22558121;1005;255;1770;1816;7.90;0.49;184.99;3.37;765;4;576.00;46
1008;4;22558147;1008;244;1774;1817;8.02;0.49;185.11;3.36;766;4;577.00;43
1012;4;22558162;1012;237;1782;1817;8.16;0.50;185.63;3.35;770;4;578.00;35
1015;4;22558177;1015;232;1785;1817;8.24;0.51;186.35;3.35;770;4;579.00;32
1017;4;22558193;1017;225;1789;1817;8.34;0.51;186.52;3.35;772;4;580.00;28
1020;4;22558209;1020;212;1791;1817;8.35;0.51;186.86;3.36;771;4;581.00;26
1021;4;22558226;1021;201;1793;1817;8.34;0.51;186.95;3.36;772;4;582.00;24
1024;4;22558240;1024;200;1795;1817;8.26;0.51;187.58;3.36;771;4;583.00;22
1026;4;22558255;1026;204;1797;1818;8.23;0.50;187.89;3.37;771;4;584.00;21
1027;4;22558269;1027;207;1800;1820;8.18;0.50;187.92;3.37;773;4;585.00;20
1030;4;22558283;1030;214;1803;1820;8.15;0.50;188.23;3.38;773;4;586.00;17
1032;4;22558297;1032;212;1808;1821;8.15;0.50;188.57;3.40;776;4;587.00;13
1034;4;22558310;1034;222;1810;1821;8.18;0.50;189.17;3.41;776;4;588.00;11
1036;4;22558325;1036;235;1813;1821;8.20;0.50;189.49;3.43;777;4;589.00;8
1040;4;22558338;1040;240;1815;1821;8.10;0.50;190.24;3.43;775;4;590.00;6
1043;4;22558355;1043;251;1821;1825;8.11;0.50;190.55;3.45;778;4;591.00;4
1044;4;22558372;1044;247;1822;1825;8.13;0.50;190.72;3.45;778;4;592.00;3
1047;4;22558388;1047;246;1823;1825;8.15;0.50;191.01;3.45;776;4;593.00;2
1048;4;22558415;1048;238;1824;1828;8.21;0.50;191.04;3.45;776;4;594.00;4
1050;4;22558430;1050;231;1824;1828;8.28;0.51;191.28;3.45;774;4;595.00;4
1053;4;22558448;1053;227;1826;1828;8.29;0.51;191.76;3.46;773;4;596.00;2
1055;4;22558464;1055;224;1830;1832;8.27;0.50;191.78;3.46;775;4;597.00;2
1060;4;22558476;1060;218;1832;1833;8.28;0.50;192.57;3.46;772;4;598.00;1
1061;4;22558490;1061;215;1833;1833;8.36;0.51;192.75;3.46;772;4;599.00;0
1062;4;22558507;1062;218;1844;1859;8.41;0.51;192.73;3.44;782;4;600.00;15
1065;4;22558530;1065;215;1846;1859;8.51;0.52;192.78;3.44;781;4;601.00;13
1066;4;22558542;1066;210;1846;1859;8.63;0.52;192.89;3.44;780;4;602.00;13
1067;4;22558554;1067;216;1847;1860;8.75;0.53;192.97;3.44;780;4;603.00;13
1068;4;22558570;1068;218;1848;1860;8.82;0.54;192.91;3.44;780;4;604.00;12
1071;4;22558582;1071;215;1852;1866;8.86;0.54;193.05;3.43;781;4;605.00;14
1074;4;22558599;1074;214;1854;1866;8.88;0.54;193.19;3.43;780;4;606.00;12
1079;4;22558610;1079;217;1856;1867;8.91;0.54;193.65;3.43;777;4;607.00;11
1082;4;22558622;1082;215;1856;1867;8.91;0.54;193.95;3.43;774;4;608.00;11
1085;4;22558635;1085;214;1857;1867;8.95;0.54;194.13;3.43;772;4;609.00;10
1088;4;22558648;1088;219;1857;1867;8.95;0.54;194.53;3.43;769;4;610.00;10
1088;4;22558661;1088;219;1857;1867;8.94;0.54;194.53;3.43;769;4;611.00;10
1090;4;22558674;1090;230;1866;1879;8.94;0.54;194.55;3.42;776;4;612.00;13
1092;4;22558687;1092;227;1868;1879;8.91;0.54;194.71;3.43;776;4;613.00;11
1092;4;22558709;1092;231;1869;1879;9.02;0.55;194.71;3.43;777;4;614.00;10
1092;4;22558720;1092;229;1869;1879;9.06;0.55;194.71;3.43;777;4;615.00;10
1092;4;22558734;1092;227;1869;1879;9.14;0.56;194.71;3.43;777;4;616.00;10
1095;4;22558745;1095;224;1869;1879;9.16;0.56;194.81;3.43;774;4;617.00;10
1095;4;22558756;1095;221;1873;1883;9.22;0.56;194.81;3.43;778;4;618.00;10
1095;4;22558770;1095;216;1873;1883;9.29;0.56;194.81;3.43;778;4;619.00;10
1096;4;22558782;1096;215;1877;1887;9.34;0.57;194.76;3.43;781;4;620.00;10
1099;4;22558794;1099;213;1878;1888;9.35;0.57;195.19;3.42;779;4;621.00;10
1101;4;22558806;1101;206;1878;1888;9.29;0.56;195.36;3.42;777;4;622.00;10
1106;4;22558821;1106;205;1878;1888;9.25;0.56;196.01;3.42;772;4;623.00;10
1107;4;22558836;1107;207;1889;1901;9.18;0.56;196.01;3.42;782;4;624.00;12
1110;4;22558850;1110;203;1889;1901;9.15;0.56;196.15;3.42;779;4;625.00;12
1112;4;22558861;1112;202;1889;1901;9.13;0.56;196.49;3.42;777;4;626.00;12
1114;4;22558872;1114;200;1890;1902;9.12;0.56;197.00;3.42;776;4;627.00;12
1120;4;22558885;1120;203;1890;1903;9.09;0.55;197.93;3.42;770;4;628.00;13
1121;4;22558899;1121;199;1890;1903;9.11;0.56;198.17;3.42;769;4;629.00;13
1131;4;22558916;1131;199;1897;1909;9.02;0.55;198.99;3.44;766;4;630.00;12
1134;4;22558928;1134;191;1899;1909;9.00;0.55;199.30;3.45;765;4;631.00;10
1136;4;22558941;1136;181;1901;1909;9.02;0.55;199.45;3.45;765;4;632.00;8
1140;4;22558953;1140;178;1901;1909;9.01;0.55;199.83;3.45;761;4;633.00;8
1143;4;22558965;1143;176;1906;1915;8.97;0.55;200.23;3.44;763;4;634.00;9
1144;4;22558979;1144;170;1906;1915;8.94;0.54;200.41;3.44;762;4;635.00;9
1147;4;22558989;1147;166;1906;1915;8.93;0.54;200.86;3.44;759;4;636.00;9
1149;4;22559001;1149;167;1906;1915;8.95;0.54;201.06;3.44;757;4;637.00;9
1152;4;22559014;1152;162;1909;1919;8.95;0.54;200.98;3.44;757;4;638.00;10
1156;4;22559025;1156;163;1910;1920;8.92;0.54;201.22;3.44;754;4;639.00;10
1160;4;22559037;1160;165;1910;1920;8.90;0.54;201.51;3.44;750;4;640.00;10
1162;4;22559050;1162;162;1911;1921;8.92;0.54;201.85;3.44;749;4;641.00;10
1164;4;22559059;1164;163;1911;1921;8.92;0.54;201.89;3.44;747;4;642.00;10
1165;4;22559072;1165;163;1911;1921;8.94;0.54;201.87;3.44;746;4;643.00;10
1166;4;22559085;1166;165;1911;1921;8.93;0.54;201.94;3.44;745;4;644.00;10
1167;4;22559097;1167;169;1911;1921;8.95;0.54;202.13;3.44;744;4;645.00;10
1169;4;22559109;1169;170;1911;1921;8.96;0.54;202.44;3.44;742;4;646.00;10
1171;4;22559121;1171;172;1912;1921;8.93;0.54;202.47;3.46;741;4;647.00;9
1173;4;22559133;1173;179;1946;1991;8.98;0.55;202.66;3.40;773;4;648.00;45
1176;4;22559153;1176;177;1947;1992;8.91;0.54;202.79;3.40;771;4;649.00;45
1177;4;22559166;1177;179;1954;1992;8.98;0.55;202.80;3.39;777;4;650.00;38
1179;4;22559178;1179;180;1956;1992;8.96;0.55;202.70;3.39;777;4;651.00;36
1184;4;22559189;1184;182;1962;1992;8.99;0.55;202.72;3.40;778;4;652.00;30
1187;4;22559201;1187;186;1964;1992;9.04;0.55;203.05;3.42;777;4;653.00;28
1190;4;22559214;1190;187;1967;1992;9.11;0.55;203.13;3.43;777;4;654.00;25
1191;4;22559227;1191;190;1971;1992;9.11;0.55;203.16;3.45;780;4;655.00;21
1193;4;22559238;1193;196;1974;1993;9.13;0.55;202.88;3.45;781;4;656.00;19
1195;4;22559253;1195;196;1978;1994;9.10;0.55;202.79;3.49;783;4;657.00;16
1196;4;22559265;1196;201;1982;1994;9.03;0.55;202.72;3.50;786;4;658.00;12
1197;4;22559277;1197;210;1987;1998;8.91;0.54;202.56;3.52;790;4;659.00;11
1198;4;22559292;1198;220;1989;1998;8.83;0.54;202.50;3.54;791;4;660.00;9
1198;4;22559303;1198;226;1990;1998;8.76;0.54;202.50;3.55;792;4;661.00;8
1199;4;22559316;1199;231;1990;1998;8.72;0.53;202.40;3.55;791;4;662.00;8
1202;4;22559328;1202;241;1997;2004;8.70;0.53;202.24;3.56;795;4;663.00;7
1203;4;22559339;1203;251;1999;2004;8.58;0.53;202.37;3.59;796;4;664.00;5
1204;4;22559352;1204;258;2000;2004;8.51;0.52;202.29;3.60;796;4;665.00;4
1206;4;22559365;1206;263;2004;2007;8.44;0.52;202.11;3.61;798;4;666.00;3
1207;4;22559377;1207;267;2006;2007;8.38;0.52;202.07;3.62;799;4;667.00;1
1208;4;22559389;1208;272;2007;2007;8.34;0.51;202.10;3.62;799;4;668.00;0
1211;4;22559400;1211;274;2008;2008;8.26;0.51;202.11;3.62;797;4;669.00;0
1216;4;22559412;1216;278;2009;2009;8.21;0.50;201.78;3.62;793;4;670.00;0
1218;4;22559425;1218;279;2009;2009;8.10;0.50;201.73;3.62;791;4;671.00;0
1221;4;22559436;1221;288;2021;2022;8.00;0.49;201.63;3.60;800;4;672.00;1
1221;4;22559448;1221;289;2022;2022;7.92;0.49;201.63;3.60;801;4;673.00;0
1224;4;22559459;1224;286;2022;2022;7.76;0.48;201.45;3.60;798;4;674.00;0
1227;4;22559471;1227;280;2024;2024;7.64;0.47;201.60;3.59;797;4;675.00;0
1231;4;22559483;1231;280;2024;2024;7.53;0.46;201.51;3.59;793;4;676.00;0
1232;4;22559495;1232;283;2028;2028;7.52;0.46;201.51;3.59;796;4;677.00;0
1235;4;22559505;1235;284;2028;2028;7.43;0.45;201.32;3.59;793;4;678.00;0
1237;4;22559516;1237;291;2032;2032;7.28;0.45;201.14;3.58;795;4;679.00;0
1238;4;22559526;1238;290;2032;2032;7.19;0.44;201.11;3.58;794;4;680.00;0
1240;4;22559537;1240;294;2032;2032;7.18;0.44;200.92;3.58;792;4;681.00;0
1243;4;22559547;1243;298;2032;2032;7.21;0.44;201.06;3.58;789;4;682.00;0
1244;4;22559558;1244;306;2032;2032;7.20;0.44;200.93;3.58;788;4;683.00;0
1245;4;22559568;1245;309;2043;2044;7.30;0.45;200.78;3.56;798;4;684.00;1
1247;4;22559578;1247;310;2043;2044;7.37;0.45;200.79;3.56;796;4;685.00;1
1248;4;22559588;1248;310;2044;2044;7.40;0.45;200.74;3.56;796;4;686.00;0
1252;4;22559598;1252;309;2044;2044;7.40;0.45;200.86;3.56;792;4;687.00;0
1254;4;22559609;1254;308;2044;2044;7.43;0.45;200.92;3.56;790;4;688.00;0
1259;4;22559619;1259;316;2044;2044;7.33;0.45;201.38;3.56;785;4;689.00;0
1260;4;22559632;1260;319;2045;2045;7.30;0.45;201.39;3.56;785;4;690.00;0
1261;4;22559641;1261;323;2045;2045;7.25;0.44;201.49;3.56;784;4;691.00;0
1265;4;22559651;1265;330;2051;2051;7.22;0.44;201.62;3.55;786;4;692.00;0
1268;4;22559661;1268;337;2052;2052;7.07;0.43;202.00;3.55;784;4;693.00;0
1270;4;22559672;1270;333;2052;2052;6.97;0.43;202.25;3.55;782;4;694.00;0
1275;4;22559681;1275;319;2052;2052;6.91;0.42;202.25;3.55;777;4;695.00;0
1278;4;22559692;1278;306;2056;2056;6.86;0.42;202.36;3.55;778;4;696.00;0
1281;4;22559703;1281;306;2056;2056;6.77;0.41;202.49;3.55;775;4;697.00;0
1282;4;22559712;1282;305;2056;2056;6.71;0.41;202.54;3.55;774;4;698.00;0
1284;4;22559722;1284;303;2057;2057;6.67;0.41;202.73;3.54;773;4;699.00;0
1286;4;22559733;1286;293;2061;2061;6.65;0.41;202.76;3.54;775;4;700.00;0
1288;4;22559748;1288;284;2061;2061;6.62;0.41;202.62;3.54;773;4;701.00;0
1293;4;22559767;1293;279;2063;2064;6.65;0.41;202.83;3.54;770;4;702.00;1
1294;4;22559776;1294;270;2063;2064;6.65;0.41;203.03;3.54;769;4;703.00;1
1298;4;22559786;1298;267;2064;2064;6.63;0.41;203.00;3.53;766;4;704.00;0
1302;4;22559799;1302;264;2064;2064;6.60;0.41;203.41;3.53;762;4;705.00;0
1304;4;22559812;1304;258;2068;2068;6.68;0.41;203.76;3.53;764;4;706.00;0
1305;4;22559822;1305;253;2068;2068;6.73;0.41;203.92;3.53;763;4;707.00;0
1309;4;22559835;1309;248;2068;2068;6.82;0.42;204.29;3.53;759;4;708.00;0
1312;4;22559847;1312;240;2068;2068;6.94;0.43;204.54;3.53;756;4;709.00;0
1316;4;22559856;1316;235;2069;2069;6.99;0.43;204.52;3.53;753;4;710.00;0
1319;4;22559869;1319;231;2070;2070;7.08;0.43;204.74;3.53;751;4;711.00;0
1320;4;22559880;1320;228;2070;2070;7.19;0.44;204.98;3.53;750;4;712.00;0
1321;4;22559890;1321;225;2071;2071;7.32;0.45;204.98;3.53;750;4;713.00;0
1324;4;22559902;1324;223;2071;2071;7.31;0.45;205.37;3.53;747;4;714.00;0
1328;4;22559914;1328;225;2071;2071;7.39;0.45;205.50;3.53;743;4;715.00;0
1331;4;22559923;1331;219;2071;2071;7.51;0.46;205.70;3.53;740;4;716.00;0
1337;4;22559954;1337;216;2071;2071;7.54;0.46;206.27;3.53;734;4;717.00;0
1341;4;22559967;1341;220;2071;2071;7.61;0.46;206.66;3.53;730;4;718.00;0
1347;4;22559977;1347;216;2071;2071;7.64;0.47;206.81;3.53;724;4;719.00;0
1351;4;22559990;1351;219;2171;2301;8.13;0.51;207.07;3.36;820;4;720.00;130
1354;4;22560027;1354;214;2179;2302;8.17;0.51;207.09;3.36;825;4;721.00;123
1355;4;22560040;1355;215;2195;2302;8.23;0.52;207.21;3.35;840;4;722.00;107
1361;4;22560051;1361;214;2209;2302;8.21;0.52;207.48;3.34;848;4;723.00;93
1366;4;22560066;1366;211;2219;2302;8.15;0.51;207.45;3.35;853;4;724.00;83
1370;4;22560082;1370;217;2227;2302;8.05;0.50;207.47;3.35;857;4;725.00;75
1374;4;22560095;1374;218;2234;2302;7.94;0.50;207.87;3.36;860;4;726.00;68
1377;4;22560107;1377;228;2240;2302;7.79;0.49;208.30;3.37;863;4;727.00;62
1383;4;22560128;1383;227;2249;2303;7.70;0.48;208.53;3.39;866;4;728.00;54
1384;4;22560141;1384;236;2255;2304;7.61;0.47;208.77;3.40;871;4;729.00;49
1389;4;22560157;1389;230;2261;2304;7.55;0.47;209.25;3.42;872;4;730.00;43
1390;4;22560171;1390;239;2271;2305;7.47;0.46;209.42;3.45;881;4;731.00;34
1394;4;22560184;1394;240;2273;2305;7.35;0.46;209.85;3.46;879;4;732.00;32
1396;4;22560197;1396;250;2276;2305;7.29;0.45;209.78;3.47;880;4;733.00;29
1400;4;22560220;1400;257;2279;2305;7.20;0.45;210.42;3.48;879;4;734.00;26
1404;4;22560234;1404;263;2284;2309;7.16;0.44;210.92;3.49;880;4;735.00;25
1405;4;22560249;1405;268;2284;2309;7.14;0.44;211.17;3.49;879;4;736.00;25
1411;4;22560261;1411;281;2289;2309;7.05;0.43;211.23;3.52;878;4;737.00;20
1414;4;22560282;1414;289;2290;2312;7.00;0.43;211.00;3.52;876;4;738.00;22
1417;4;22560297;1417;297;2290;2312;6.90;0.43;210.88;3.52;873;4;739.00;22
1418;4;22560311;1418;296;2293;2312;6.91;0.43;210.95;3.54;875;4;740.00;19
1419;4;22560324;1419;296;2297;2316;6.96;0.43;210.91;3.53;878;4;741.00;19
1421;4;22560338;1421;296;2299;2317;6.94;0.43;210.99;3.54;878;4;742.00;18
1423;4;22560356;1423;298;2300;2317;6.96;0.43;211.13;3.55;877;4;743.00;17
1425;4;22560385;1425;304;2302;2321;7.03;0.43;211.30;3.55;877;4;744.00;19
1427;4;22560404;1427;303;2305;2321;7.03;0.43;211.31;3.56;878;4;745.00;16
1432;4;22560433;1432;307;2306;2321;7.03;0.43;211.29;3.57;874;4;746.00;15
1434;4;22560450;1434;303;2307;2322;7.12;0.43;211.30;3.58;873;4;747.00;15
1437;4;22560470;1437;300;2308;2322;7.19;0.44;211.55;3.58;871;4;748.00;14
1438;4;22560487;1438;292;2313;2328;7.21;0.44;211.63;3.58;875;4;749.00;15
1440;4;22560506;1440;280;2315;2328;7.28;0.45;211.86;3.59;875;4;750.00;13
1446;4;22560527;1446;280;2316;2329;7.33;0.45;211.97;3.59;870;4;751.00;13
1447;4;22560544;1447;279;2316;2329;7.38;0.45;212.01;3.59;869;4;752.00;13
1450;4;22560563;1450;275;2318;2329;7.46;0.45;212.15;3.61;868;4;753.00;11
1452;4;22560580;1452;271;2320;2329;7.54;0.46;212.29;3.64;868;4;754.00;9
1452;4;22560598;1452;273;2320;2329;7.60;0.46;212.29;3.64;868;4;755.00;9
1454;4;22560623;1454;259;2331;2341;7.80;0.47;212.39;3.63;877;4;756.00;10
1455;4;22560641;1455;254;2333;2341;7.89;0.48;212.48;3.64;878;4;757.00;8
1459;4;22560669;1459;244;2334;2341;7.89;0.48;212.79;3.64;875;4;758.00;7
1459;4;22560698;1459;244;2334;2341;7.95;0.49;212.79;3.64;875;4;759.00;7
1464;4;22560713;1464;245;2336;2341;7.93;0.48;212.82;3.64;872;4;760.00;5
1466;4;22560729;1466;246;2336;2341;7.92;0.48;213.00;3.64;870;4;761.00;5
1468;4;22560747;1468;252;2340;2345;7.85;0.48;213.02;3.64;872;4;762.00;5
1470;4;22560766;1470;248;2340;2345;7.86;0.48;213.14;3.64;870;4;763.00;5
1472;4;22560782;1472;249;2344;2349;7.92;0.48;213.50;3.64;872;4;764.00;5
1476;4;22560801;1476;253;2346;2351;7.98;0.49;213.65;3.63;870;4;765.00;5
1481;4;22560820;1481;256;2346;2351;7.99;0.49;213.61;3.63;865;4;766.00;5
1483;4;22560837;1483;256;2346;2351;8.01;0.49;213.84;3.63;863;4;767.00;5
1486;4;22560854;1486;251;2357;2364;8.10;0.49;214.06;3.62;871;4;768.00;7
1487;4;22560873;1487;246;2357;2364;8.19;0.50;214.18;3.62;870;4;769.00;7
1488;4;22560889;1488;249;2357;2364;8.19;0.50;214.30;3.62;869;4;770.00;7
1489;4;22560903;1489;245;2358;2365;8.29;0.51;214.31;3.61;869;4;771.00;7
1491;4;22560917;1491;239;2358;2366;8.33;0.51;214.25;3.61;867;4;772.00;8
1493;4;22560932;1493;239;2358;2366;8.39;0.51;214.31;3.61;865;4;773.00;8
1493;4;22560945;1493;230;2360;2369;8.48;0.52;214.31;3.61;867;4;774.00;9
1495;4;22560959;1495;225;2360;2369;8.53;0.52;214.40;3.61;865;4;775.00;9
1499;4;22560973;1499;225;2361;2369;8.56;0.52;214.67;3.61;862;4;776.00;8
1501;4;22560986;1501;230;2361;2369;8.57;0.52;214.55;3.61;860;4;777.00;8
1505;4;22561008;1505;233;2366;2375;8.57;0.52;214.70;3.60;861;4;778.00;9
1507;4;22561023;1507;235;2366;2375;8.55;0.52;214.69;3.60;859;4;779.00;9
1510;4;22561039;1510;238;2366;2375;8.52;0.52;214.66;3.60;856;4;780.00;9
1513;4;22561052;1513;239;2366;2375;8.44;0.51;214.64;3.60;853;4;781.00;9
1514;4;22561066;1514;241;2369;2379;8.44;0.51;214.63;3.60;855;4;782.00;10
1515;4;22561083;1515;248;2370;2380;8.45;0.51;214.62;3.60;855;4;783.00;10
1516;4;22561098;1516;255;2370;2380;8.38;0.51;214.64;3.60;854;4;784.00;10
1516;4;22561115;1516;256;2371;2381;8.35;0.51;214.64;3.60;855;4;785.00;10
1518;4;22561130;1518;258;2371;2381;8.37;0.51;214.49;3.60;853;4;786.00;10
1520;4;22561147;1520;262;2371;2381;8.39;0.51;214.71;3.60;851;4;787.00;10
1520;4;22561159;1520;268;2371;2381;8.40;0.51;214.71;3.60;851;4;788.00;10
1522;4;22561176;1522;269;2371;2381;8.39;0.51;214.65;3.60;849;4;789.00;10
1524;4;22561192;1524;262;2371;2381;8.33;0.51;214.55;3.60;847;4;790.00;10
1525;4;22561209;1525;254;2371;2381;8.27;0.50;214.64;3.60;846;4;791.00;10
1525;4;22561225;1525;259;2402;2451;8.23;0.50;214.64;3.55;877;4;792.00;49
1525;4;22561250;1525;255;2402;2452;8.20;0.50;214.64;3.55;877;4;793.00;50
1526;4;22561266;1526;251;2407;2452;8.22;0.50;214.63;3.55;881;4;794.00;45
1529;4;22561286;1529;250;2410;2452;8.24;0.50;214.74;3.55;881;4;795.00;42
1532;4;22561307;1532;241;2412;2452;8.28;0.51;214.74;3.55;880;4;796.00;40
1535;4;22561324;1535;240;2414;2452;8.28;0.51;214.85;3.55;879;4;797.00;38
1538;4;22561343;1538;241;2417;2452;8.29;0.50;214.92;3.55;879;4;798.00;35
1542;4;22561363;1542;237;2419;2452;8.28;0.50;215.12;3.56;877;4;799.00;33
1547;4;22561381;1547;231;2421;2453;8.22;0.50;215.62;3.56;874;4;800.00;32
1549;4;22561401;1549;234;2423;2454;8.20;0.50;215.75;3.56;874;4;801.00;31
1549;4;22561417;1549;228;2425;2454;8.20;0.50;215.75;3.57;876;4;802.00;29
1554;4;22561432;1554;230;2429;2458;8.09;0.49;216.27;3.57;875;4;803.00;29
1556;4;22561447;1556;230;2431;2458;8.01;0.49;216.49;3.57;875;4;804.00;27
1558;4;22561464;1558;229;2433;2458;7.97;0.48;216.70;3.60;875;4;805.00;25
1559;4;22561479;1559;227;2434;2458;7.93;0.48;216.62;3.60;875;4;806.00;24
1565;4;22561492;1565;225;2438;2464;7.82;0.47;217.19;3.60;873;4;807.00;26
1568;4;22561507;1568;226;2438;2464;7.72;0.47;217.58;3.60;870;4;808.00;26
1570;4;22561523;1570;223;2439;2464;7.63;0.46;217.61;3.60;869;4;809.00;25
1570;4;22561540;1570;228;2445;2470;7.61;0.46;217.61;3.60;875;4;810.00;25
1570;4;22561557;1570;224;2446;2470;7.58;0.46;217.61;3.60;876;4;811.00;24
1570;4;22561570;1570;228;2447;2470;7.52;0.46;217.61;3.60;877;4;812.00;23
1571;4;22561583;1571;223;2447;2471;7.47;0.45;217.62;3.60;876;4;813.00;24
1572;4;22561597;1572;225;2448;2472;7.49;0.45;217.58;3.60;876;4;814.00;24
1573;4;22561616;1573;222;2448;2472;7.48;0.45;217.56;3.60;875;4;815.00;24
1574;4;22561628;1574;226;2456;2485;7.47;0.45;217.50;3.59;882;4;816.00;29
1575;4;22561646;1575;230;2456;2485;7.48;0.46;217.38;3.59;881;4;817.00;29
1576;4;22561661;1576;235;2457;2485;7.49;0.46;217.30;3.59;881;4;818.00;28
1578;4;22561675;1578;235;2458;2486;7.52;0.46;217.23;3.59;880;4;819.00;28
1580;4;22561690;1580;237;2458;2486;7.48;0.46;217.39;3.59;878;4;820.00;28
1580;4;22561706;1580;241;2461;2490;7.48;0.46;217.39;3.58;881;4;821.00;29
1580;4;22561724;1580;241;2462;2490;7.47;0.46;217.39;3.62;882;4;822.00;28
1586;4;22561739;1586;243;2465;2494;7.34;0.45;217.21;3.62;879;4;823.00;29
1587;4;22561758;1587;244;2465;2494;7.27;0.44;217.36;3.62;878;4;824.00;29
1588;4;22561774;1588;251;2467;2494;7.21;0.44;217.33;3.67;879;4;825.00;27
1590;4;22561790;1590;259;2468;2494;7.18;0.44;217.34;3.69;878;4;826.00;26
1592;4;22561805;1592;264;2469;2494;7.15;0.44;217.20;3.73;877;4;827.00;25
1595;4;22561821;1595;271;2480;2506;7.17;0.44;217.11;3.73;885;4;828.00;26
1597;4;22561838;1597;271;2483;2506;7.20;0.44;217.01;3.78;886;4;829.00;23
1598;4;22561856;1598;277;2485;2506;7.22;0.44;216.94;3.81;887;4;830.00;21
1600;4;22561873;1600;279;2486;2506;7.22;0.44;216.95;3.86;886;4;831.00;20
1600;4;22561890;1600;292;2487;2506;7.24;0.44;216.95;3.87;887;4;832.00;19
1607;4;22561905;1607;297;2491;2506;7.15;0.44;216.88;3.94;884;4;833.00;15
1608;4;22561922;1608;300;2493;2507;7.12;0.44;216.76;3.95;885;4;834.00;14
1610;5;22561938;1610;305;2496;2507;7.07;0.43;216.75;4.00;886;5;835.00;11
1613;5;22561959;1613;309;2502;2513;7.06;0.43;216.51;4.01;889;5;836.00;11
1615;5;22561977;1615;312;2502;2514;7.10;0.43;216.56;4.01;887;5;837.00;12
1617;5;22561991;1617;318;2506;2514;7.11;0.44;216.38;4.04;889;5;838.00;8
1619;5;22562005;1619;324;2506;2514;7.14;0.44;216.24;4.04;887;5;839.00;8
1621;5;22562020;1621;327;2510;2519;7.17;0.44;216.20;4.05;889;5;840.00;9
1625;5;22562038;1625;330;2512;2519;7.13;0.44;216.43;4.06;887;5;841.00;7
1629;5;22562052;1629;331;2513;2519;7.02;0.43;216.31;4.07;884;5;842.00;6
1630;5;22562066;1630;337;2515;2520;6.95;0.42;216.30;4.08;885;5;843.00;5
1630;5;22562077;1630;340;2520;2524;6.88;0.42;216.30;4.09;890;5;844.00;4
1634;5;22562090;1634;343;2520;2524;6.75;0.41;216.11;4.09;886;5;845.00;4
1636;5;22562104;1636;346;2525;2527;6.68;0.41;215.90;4.09;889;5;846.00;2
1636;5;22562115;1636;352;2525;2527;6.65;0.41;215.90;4.09;889;5;847.00;2
1637;5;22562127;1637;352;2527;2527;6.59;0.40;215.92;4.09;890;5;848.00;0
1640;5;22562139;1640;354;2527;2527;6.55;0.40;215.90;4.09;887;5;849.00;0
1641;5;22562153;1641;349;2531;2531;6.60;0.40;215.84;4.08;890;5;850.00;0
1641;5;22562167;1641;350;2531;2531;6.62;0.41;215.84;4.08;890;5;851.00;0
1642;5;22562181;1642;337;2531;2531;6.58;0.40;215.74;4.08;889;5;852.00;0
1645;5;22562195;1645;324;2531;2531;6.63;0.41;215.64;4.08;886;5;853.00;0
1646;5;22562209;1646;312;2532;2532;6.63;0.41;215.59;4.08;886;5;854.00;0
1646;5;22562224;1646;305;2534;2534;6.68;0.41;215.59;4.08;888;5;855.00;0
1648;5;22562239;1648;303;2534;2534;6.74;0.41;215.49;4.08;886;5;856.00;0
1649;5;22562256;1649;298;2535;2535;6.80;0.42;215.49;4.08;886;5;857.00;0
1650;5;22562273;1650;293;2535;2535;6.87;0.42;215.44;4.08;885;5;858.00;0
1652;5;22562304;1652;289;2535;2535;6.89;0.42;215.52;4.08;883;5;859.00;0
1652;5;22562320;1652;283;2535;2535;6.98;0.43;215.52;4.08;883;5;860.00;0
1654;5;22562337;1654;281;2535;2535;7.02;0.43;215.46;4.08;881;5;861.00;0
1656;5;22562355;1656;275;2535;2535;7.09;0.43;215.82;4.08;879;5;862.00;0
1659;5;22562373;1659;274;2535;2535;7.17;0.44;215.90;4.08;876;5;863.00;0
1661;5;22562390;1661;298;2607;2662;7.34;0.46;216.10;3.97;946;5;864.00;55
1665;5;22562430;1665;287;2613;2663;7.29;0.45;216.41;3.96;948;5;865.00;50
1665;5;22562451;1665;280;2621;2663;7.37;0.46;216.41;3.95;956;5;866.00;42
1668;5;22562469;1668;282;2623;2663;7.32;0.45;216.53;3.95;955;5;867.00;40
1670;5;22562488;1670;279;2630;2663;7.31;0.45;216.64;3.95;960;5;868.00;33
1674;5;22562503;1674;276;2632;2663;7.23;0.45;216.76;3.95;958;5;869.00;31
1676;5;22562519;1676;274;2635;2663;7.18;0.44;216.97;3.96;959;5;870.00;28
1677;5;22562532;1677;273;2638;2663;7.13;0.44;216.93;3.96;961;5;871.00;25
1681;5;22562545;1681;276;2640;2664;7.06;0.44;217.04;3.96;959;5;872.00;24
1682;5;22562557;1682;279;2644;2665;7.03;0.43;217.12;3.97;962;5;873.00;21
1685;5;22562569;1685;280;2647;2665;7.00;0.43;217.48;3.98;962;5;874.00;18
1692;5;22562581;1692;277;2651;2666;6.89;0.43;217.75;3.98;959;5;875.00;15
1697;5;22562595;1697;274;2652;2666;6.80;0.42;217.96;3.99;955;5;876.00;14
1700;5;22562610;1700;267;2656;2666;6.70;0.41;217.85;4.00;956;5;877.00;10
1705;5;22562625;1705;269;2659;2666;6.68;0.41;218.02;4.01;954;5;878.00;7
1709;5;22562641;1709;277;2664;2670;6.70;0.41;218.13;4.02;955;5;879.00;6
1714;5;22562660;1714;281;2665;2670;6.75;0.41;218.56;4.02;951;5;880.00;5
1719;5;22562677;1719;274;2666;2670;6.79;0.42;219.11;4.02;947;5;881.00;4
1724;5;22562692;1724;271;2668;2673;6.79;0.42;219.25;4.03;944;5;882.00;5
1727;5;22562716;1727;263;2670;2673;6.83;0.42;219.77;4.03;943;5;883.00;3
1730;5;22562739;1730;259;2671;2673;6.86;0.42;220.26;4.04;941;5;884.00;2
1735;5;22562756;1735;258;2675;2677;6.89;0.42;220.60;4.03;940;5;885.00;2
1739;5;22562773;1739;255;2677;2678;6.93;0.43;221.08;4.03;938;5;886.00;1
1745;5;22562791;1745;254;2678;2678;6.98;0.43;221.76;4.03;933;5;887.00;0
1746;5;22562808;1746;252;2682;2682;7.07;0.43;222.00;4.03;936;5;888.00;0
1753;5;22562827;1753;247;2682;2682;7.15;0.44;222.64;4.03;929;5;889.00;0
1756;5;22562848;1756;243;2682;2682;7.21;0.44;222.75;4.03;926;5;890.00;0
1756;5;22562868;1756;244;2683;2683;7.34;0.45;222.75;4.02;927;5;891.00;0
1762;5;22562883;1762;249;2683;2683;7.32;0.45;223.07;4.02;921;5;892.00;0
1766;5;22562907;1766;250;2689;2689;7.36;0.45;223.36;4.02;923;5;893.00;0
1769;5;22562924;1769;244;2689;2689;7.38;0.45;223.82;4.02;920;5;894.00;0
1775;5;22562938;1775;252;2690;2690;7.37;0.45;223.94;4.02;915;5;895.00;0
1779;5;22562954;1779;250;2690;2690;7.38;0.45;224.29;4.02;911;5;896.00;0
1784;5;22562968;1784;250;2690;2690;7.32;0.45;224.78;4.02;906;5;897.00;0
1790;5;22562983;1790;247;2690;2690;7.32;0.45;224.78;4.02;900;5;898.00;0
1795;5;22562998;1795;252;2690;2690;7.33;0.45;224.96;4.02;895;5;899.00;0
1798;5;22563015;1798;256;2721;2736;7.47;0.46;225.18;3.97;923;5;900.00;15
1801;5;22563039;1801;249;2721;2736;7.50;0.46;225.45;3.97;920;5;901.00;15
1810;5;22563053;1810;252;2726;2736;7.49;0.46;226.11;3.97;916;5;902.00;10
1816;5;22563069;1816;249;2726;2736;7.57;0.46;226.63;3.97;910;5;903.00;10
1820;5;22563085;1820;252;2728;2736;7.58;0.46;226.99;3.97;908;5;904.00;8
1824;5;22563106;1824;249;2728;2736;7.59;0.46;227.01;3.97;904;5;905.00;8
1827;5;22563125;1827;254;2733;2740;7.68;0.47;227.24;3.96;906;5;906.00;7
1831;5;22563141;1831;256;2733;2740;7.67;0.47;227.61;3.96;902;5;907.00;7
1835;5;22563158;1835;259;2737;2744;7.65;0.47;227.68;3.96;902;5;908.00;7
1837;5;22563173;1837;259;2738;2745;7.68;0.47;227.81;3.96;901;5;909.00;7
1840;5;22563188;1840;263;2738;2745;7.65;0.47;228.13;3.96;898;5;910.00;7
1841;5;22563204;1841;260;2738;2745;7.63;0.47;228.33;3.96;897;5;911.00;7
1845;5;22563220;1845;268;2750;2758;7.62;0.47;228.66;3.95;905;5;912.00;8
1847;5;22563237;1847;266;2750;2758;7.63;0.47;228.86;3.95;903;5;913.00;8
1854;5;22563252;1854;269;2751;2758;7.58;0.46;229.12;3.95;897;5;914.00;7
1859;5;22563267;1859;268;2751;2759;7.61;0.46;229.32;3.95;892;5;915.00;8
1861;5;22563286;1861;271;2753;2760;7.59;0.46;229.54;3.95;892;5;916.00;7
1866;5;22563300;1866;276;2753;2760;7.54;0.46;229.85;3.95;887;5;917.00;7
1868;5;22563321;1868;273;2755;2763;7.49;0.46;229.99;3.95;887;5;918.00;8
1871;5;22563337;1871;275;2756;2763;7.46;0.46;230.45;3.95;885;5;919.00;7
1875;5;22563351;1875;280;2759;2763;7.39;0.45;230.82;3.96;884;5;920.00;4
1878;5;22563366;1878;287;2759;2763;7.35;0.45;231.10;3.96;881;5;921.00;4
1880;5;22563379;1880;283;2764;2769;7.31;0.45;231.32;3.95;884;5;922.00;5
1885;5;22563395;1885;280;2764;2769;7.34;0.45;231.19;3.95;879;5;923.00;5
1888;5;22563410;1888;287;2765;2769;7.31;0.45;231.74;3.96;877;5;924.00;4
1889;5;22563424;1889;280;2765;2769;7.31;0.45;231.90;3.96;876;5;925.00;4
1891;5;22563438;1891;280;2773;2773;7.30;0.45;231.90;3.97;882;5;926.00;0
1894;5;22563452;1894;283;2774;2774;7.27;0.44;232.13;3.97;880;5;927.00;0
1898;5;22563469;1898;285;2774;2774;7.24;0.44;232.33;3.97;876;5;928.00;0
1900;5;22563494;1900;282;2775;2775;7.21;0.44;232.31;3.97;875;5;929.00;0
1900;5;22563511;1900;288;2775;2775;7.15;0.44;232.31;3.97;875;5;930.00;0
1900;5;22563523;1900;279;2775;2775;7.14;0.44;232.31;3.97;875;5;931.00;0
1906;5;22563538;1906;267;2775;2775;7.11;0.43;232.44;3.97;869;5;932.00;0
1910;5;22563552;1910;260;2775;2775;7.17;0.44;232.98;3.97;865;5;933.00;0
1913;5;22563567;1913;260;2775;2775;7.19;0.44;233.08;3.97;862;5;934.00;0
1916;5;22563581;1916;258;2775;2775;7.17;0.44;233.44;3.97;859;5;935.00;0
1918;5;22563593;1918;277;2819;2845;7.21;0.44;233.44;3.91;901;5;936.00;26
1922;5;22563615;1922;278;2821;2846;7.24;0.44;233.72;3.91;899;5;937.00;25
1924;5;22563628;1924;271;2826;2846;7.34;0.45;233.99;3.90;902;5;938.00;20
1930;5;22563641;1930;266;2828;2846;7.41;0.45;234.24;3.90;898;5;939.00;18
1935;5;22563657;1935;278;2830;2846;7.50;0.46;234.42;3.90;895;5;940.00;16
1937;5;22563672;1937;279;2832;2846;7.57;0.46;234.44;3.90;895;5;941.00;14
1941;5;22563688;1941;278;2835;2846;7.60;0.46;234.59;3.91;894;5;942.00;11
1941;5;22563703;1941;278;2837;2846;7.72;0.47;234.59;3.91;896;5;943.00;9
1945;5;22563717;1945;270;2840;2847;7.75;0.47;234.88;3.91;895;5;944.00;7
1947;5;22563733;1947;271;2842;2849;7.76;0.47;234.89;3.91;895;5;945.00;7
1952;5;22563749;1952;264;2844;2849;7.71;0.47;234.96;3.92;892;5;946.00;5
1954;5;22563762;1954;270;2849;2853;7.69;0.47;234.87;3.92;895;5;947.00;4
1955;5;22563779;1955;278;2850;2853;7.66;0.46;235.00;3.92;895;5;948.00;3
1957;5;22563791;1957;278;2850;2853;7.70;0.47;234.97;3.92;893;5;949.00;3
1958;5;22563807;1958;285;2850;2853;7.73;0.47;234.97;3.92;892;5;950.00;3
1960;5;22563823;1960;278;2855;2859;7.73;0.47;235.14;3.91;895;5;951.00;4
1964;5;22563839;1964;271;2855;2859;7.71;0.47;235.18;3.91;891;5;952.00;4
1964;5;22563856;1964;270;2855;2859;7.69;0.47;235.18;3.91;891;5;953.00;4
1969;5;22563882;1969;266;2857;2862;7.67;0.47;235.46;3.91;888;5;954.00;5
1972;5;22563896;1972;264;2857;2862;7.65;0.46;235.61;3.91;885;5;955.00;5
1974;5;22563910;1974;269;2859;2862;7.69;0.47;235.61;3.92;885;5;956.00;3
1977;5;22563925;1977;265;2859;2863;7.72;0.47;235.73;3.92;882;5;957.00;4
1978;5;22563940;1978;277;2860;2864;7.70;0.47;235.77;3.92;882;5;958.00;4
1980;5;22563955;1980;275;2861;2864;7.71;0.47;235.92;3.92;881;5;959.00;3
1981;5;22563971;1981;287;2882;2890;7.68;0.47;235.99;3.89;901;5;960.00;8
1982;5;22563989;1982;284;2883;2890;7.63;0.46;236.03;3.89;901;5;961.00;7
1984;5;22564003;1984;287;2884;2890;7.62;0.46;236.06;3.89;900;5;962.00;6
1985;5;22564020;1985;292;2885;2891;7.66;0.47;236.03;3.89;900;5;963.00;6
1987;5;22564033;1987;291;2886;2891;7.63;0.46;236.07;3.89;899;5;964.00;5
1990;5;22564046;1990;291;2890;2895;7.56;0.46;236.10;3.88;900;5;965.00;5
1992;5;22564062;1992;289;2890;2895;7.58;0.46;236.22;3.88;898;5;966.00;5
1995;5;22564075;1995;293;2893;2899;7.56;0.46;236.42;3.88;898;5;967.00;6
1998;5;22564091;1998;289;2893;2899;7.56;0.46;236.43;3.88;895;5;968.00;6
2000;5;22564104;2000;280;2893;2899;7.55;0.46;236.39;3.88;893;5;969.00;6
2002;5;22564119;2002;280;2893;2899;7.59;0.46;236.40;3.88;891;5;970.00;6
2002;5;22564132;2002;282;2893;2899;7.62;0.46;236.40;3.88;891;5;971.00;6
2004;5;22564145;2004;273;2903;2911;7.65;0.47;236.58;3.87;899;5;972.00;8
2005;5;22564159;2005;276;2903;2911;7.69;0.47;236.66;3.87;898;5;973.00;8
2006;5;22564173;2006;276;2904;2911;7.72;0.47;236.76;3.87;898;5;974.00;7
2010;5;22564189;2010;282;2904;2911;7.64;0.46;236.82;3.87;894;5;975.00;7
2011;5;22564202;2011;282;2904;2911;7.65;0.47;236.83;3.87;893;5;976.00;7
2014;5;22564218;2014;284;2904;2911;7.61;0.46;236.87;3.87;890;5;977.00;7
2017;5;22564231;2017;288;2904;2912;7.58;0.46;236.84;3.87;887;5;978.00;8
2021;5;22564242;2021;286;2904;2912;7.46;0.45;236.97;3.87;883;5;979.00;8
2027;5;22564258;2027;284;2910;2918;7.32;0.44;237.04;3.87;883;5;980.00;8
2029;5;22564278;2029;283;2912;2919;7.26;0.44;236.92;3.88;883;5;981.00;7
2031;5;22564292;2031;279;2912;2919;7.15;0.43;237.05;3.88;881;5;982.00;7
2034;5;22564306;2034;280;2912;2919;7.08;0.43;236.87;3.88;878;5;983.00;7
2037;5;22564320;2037;279;2914;2923;6.98;0.42;236.79;3.87;877;5;984.00;9
2040;5;22564336;2040;279;2914;2923;6.90;0.42;236.80;3.87;874;5;985.00;9
2040;5;22564350;2040;278;2914;2923;6.90;0.42;236.80;3.87;874;5;986.00;9
2040;5;22564367;2040;281;2915;2924;6.93;0.42;236.80;3.87;875;5;987.00;9
2043;5;22564383;2043;279;2918;2928;6.91;0.42;236.64;3.87;875;5;988.00;10
2046;5;22564402;2046;279;2918;2928;6.93;0.42;236.57;3.87;872;5;989.00;10
2048;5;22564420;2048;278;2922;2934;7.03;0.43;236.38;3.87;874;5;990.00;12
2050;5;22564437;2050;278;2923;2934;7.13;0.43;236.35;3.86;873;5;991.00;11
2054;5;22564451;2054;279;2924;2934;7.21;0.44;236.22;3.86;870;5;992.00;10
2055;5;22564469;2055;279;2925;2934;7.30;0.44;236.14;3.87;870;5;993.00;9
2056;5;22564483;2056;280;2929;2938;7.36;0.45;236.05;3.86;873;5;994.00;9
2058;5;22564498;2058;283;2929;2938;7.38;0.45;236.17;3.86;871;5;995.00;9
2059;5;22564512;2059;283;2929;2938;7.37;0.45;236.07;3.86;870;5;996.00;9
2059;5;22564526;2059;284;2929;2938;7.35;0.45;236.07;3.86;870;5;997.00;9
2059;5;22564539;2059;282;2929;2939;7.33;0.45;236.07;3.86;870;5;998.00;10
2064;5;22564551;2064;283;2930;2940;7.28;0.44;236.07;3.86;866;5;999.00;10
2066;5;22564565;2066;284;2930;2940;7.24;0.44;236.17;3.86;864;5;1000.00;10
2068;5;22564583;2068;289;2931;2941;7.14;0.43;236.13;3.86;863;5;1001.00;10
2070;5;22564596;2070;292;2931;2941;7.02;0.43;236.16;3.86;861;5;1002.00;10
2072;5;22564608;2072;294;2931;2941;7.01;0.43;236.30;3.86;859;5;1003.00;10
2074;5;22564621;2074;296;2931;2941;6.97;0.42;236.39;3.86;857;5;1004.00;10
2074;5;22564640;2074;301;2932;2941;6.97;0.42;236.39;3.88;858;5;1005.00;9
2076;5;22564653;2076;309;2933;2941;6.92;0.42;236.36;3.89;857;5;1006.00;8
2076;5;22564666;2076;315;2933;2941;6.86;0.42;236.36;3.89;857;5;1007.00;8
2078;5;22564677;2078;339;3002;3068;7.11;0.44;236.17;3.83;924;5;1008.00;66
2079;5;22564704;2079;323;3006;3069;7.10;0.44;236.16;3.83;927;5;1009.00;63
2081;5;22564720;2081;311;3018;3069;7.18;0.44;236.16;3.84;937;5;1010.00;51
2081;5;22564735;2081;307;3020;3069;7.22;0.45;236.16;3.84;939;5;1011.00;49
2081;5;22564753;2081;303;3030;3069;7.28;0.45;236.16;3.85;949;5;1012.00;39
2082;5;22564767;2082;302;3033;3069;7.31;0.45;236.18;3.85;951;5;1013.00;36
2086;5;22564781;2086;300;3036;3069;7.31;0.45;236.19;3.86;950;5;1014.00;33
2087;5;22564793;2087;301;3038;3069;7.35;0.45;236.14;3.87;951;5;1015.00;31
2088;5;22564815;2088;299;3041;3070;7.40;0.46;236.24;3.88;953;5;1016.00;29
2091;5;22564829;2091;299;3047;3071;7.43;0.46;236.21;3.89;956;5;1017.00;24
2092;5;22564845;2092;306;3051;3071;7.45;0.46;236.43;3.90;959;5;1018.00;20
2093;5;22564857;2093;302;3053;3072;7.43;0.46;236.50;3.90;960;5;1019.00;19
2097;5;22564872;2097;300;3055;3072;7.35;0.45;236.30;3.91;958;5;1020.00;17
2098;5;22564887;2098;301;3057;3072;7.30;0.45;236.32;3.92;959;5;1021.00;15
2100;5;22564901;2100;302;3063;3072;7.19;0.44;236.30;3.94;963;5;1022.00;9
2101;5;22564916;2101;306;3068;3076;7.10;0.44;236.19;3.94;967;5;1023.00;8
2105;5;22564930;2105;299;3070;3076;7.04;0.43;236.19;3.94;965;5;1024.00;6
2106;5;22564944;2106;301;3072;3076;6.95;0.43;236.12;3.95;966;5;1025.00;4
2106;5;22564958;2106;295;3073;3079;6.92;0.43;236.12;3.94;967;5;1026.00;6
2107;5;22564976;2107;299;3074;3079;6.89;0.42;236.11;3.95;967;5;1027.00;5
2107;5;22564990;2107;296;3076;3079;6.85;0.42;236.11;3.95;969;5;1028.00;3
2110;5;22565004;2110;298;3080;3083;6.76;0.42;236.07;3.95;970;5;1029.00;3
2113;5;22565022;2113;300;3081;3084;6.73;0.41;235.95;3.95;968;5;1030.00;3
2115;5;22565037;2115;303;3083;3084;6.74;0.42;235.83;3.96;968;5;1031.00;1
2116;5;22565053;2116;302;3087;3088;6.79;0.42;235.78;3.95;971;5;1032.00;1
2121;5;22565067;2121;303;3087;3088;6.73;0.41;235.69;3.95;966;5;1033.00;1
2122;5;22565082;2122;299;3088;3088;6.67;0.41;235.80;3.95;966;5;1034.00;0
2125;5;22565094;2125;301;3090;3090;6.64;0.41;235.92;3.95;965;5;1035.00;0
2127;5;22565107;2127;303;3090;3090;6.64;0.41;236.08;3.95;963;5;1036.00;0
2128;5;22565121;2128;305;3096;3096;6.70;0.41;236.06;3.95;968;5;1037.00;0
2132;5;22565134;2132;308;3096;3096;6.72;0.41;236.17;3.95;964;5;1038.00;0
2134;5;22565148;2134;311;3097;3097;6.71;0.41;236.28;3.95;963;5;1039.00;0
2138;5;22565163;2138;308;3097;3097;6.66;0.41;236.25;3.95;959;5;1040.00;0
2140;5;22565175;2140;310;3097;3097;6.64;0.41;236.23;3.95;957;5;1041.00;0
2144;5;22565190;2144;313;3097;3097;6.62;0.40;236.40;3.95;953;5;1042.00;0
2146;5;22565203;2146;308;3097;3097;6.60;0.40;236.42;3.95;951;5;1043.00;0
2147;5;22565218;2147;313;3109;3109;6.55;0.40;236.56;3.93;962;5;1044.00;0
2152;5;22565233;2152;312;3109;3109;6.49;0.40;236.70;3.93;957;5;1045.00;0
2156;5;22565248;2156;309;3109;3109;6.39;0.39;236.67;3.93;953;5;1046.00;0
2158;5;22565262;2158;308;3109;3109;6.38;0.39;236.76;3.93;951;5;1047.00;0
2165;5;22565283;2165;306;3109;3109;6.28;0.38;237.13;3.93;944;5;1048.00;0
2167;5;22565298;2167;312;3109;3109;6.30;0.39;237.29;3.93;942;5;1049.00;0
2170;5;22565311;2170;295;3115;3115;6.25;0.38;237.44;3.92;945;5;1050.00;0
2174;5;22565327;2174;287;3115;3115;6.26;0.38;237.62;3.92;941;5;1051.00;0
2177;5;22565339;2177;281;3119;3119;6.29;0.39;237.83;3.92;942;5;1052.00;0
2182;5;22565354;2182;285;3120;3120;6.30;0.39;237.98;3.92;938;5;1053.00;0
2187;5;22565370;2187;286;3120;3120;6.27;0.38;238.18;3.92;933;5;1054.00;0
2190;5;22565383;2190;279;3120;3120;6.32;0.39;238.30;3.92;930;5;1055.00;0
2193;5;22565397;2193;286;3133;3133;6.38;0.39;238.45;3.90;940;5;1056.00;0
2200;5;22565410;2200;277;3133;3133;6.36;0.39;238.72;3.90;933;5;1057.00;0
2203;5;22565423;2203;270;3133;3133;6.43;0.39;238.68;3.90;930;5;1058.00;0
2208;5;22565437;2208;261;3134;3134;6.46;0.39;239.25;3.90;926;5;1059.00;0
2212;5;22565451;2212;258;3135;3135;6.51;0.40;239.55;3.90;923;5;1060.00;0
2215;5;22565467;2215;257;3135;3135;6.61;0.40;239.65;3.90;920;5;1061.00;0
2220;5;22565479;2220;254;3137;3138;6.68;0.41;239.94;3.90;917;5;1062.00;1
2226;5;22565492;2226;248;3137;3138;6.71;0.41;240.35;3.90;911;5;1063.00;1
2230;5;22565508;2230;244;3138;3138;6.75;0.41;240.39;3.90;908;5;1064.00;0
2234;5;22565523;2234;242;3138;3138;6.81;0.41;240.84;3.90;904;5;1065.00;0
2237;5;22565537;2237;241;3144;3144;6.95;0.42;240.91;3.89;907;5;1066.00;0
2241;5;22565551;2241;243;3144;3144;7.04;0.43;241.23;3.89;903;5;1067.00;0
2243;5;22565563;2243;240;3144;3144;7.08;0.43;241.34;3.89;901;5;1068.00;0
2249;5;22565578;2249;249;3144;3144;7.12;0.43;241.65;3.89;895;5;1069.00;0
2254;5;22565593;2254;249;3148;3148;7.18;0.44;242.16;3.89;894;5;1070.00;0
2256;5;22565607;2256;250;3149;3149;7.26;0.44;242.31;3.89;893;5;1071.00;0
2260;5;22565621;2260;254;3149;3149;7.23;0.44;242.68;3.89;889;5;1072.00;0
2263;5;22565636;2263;255;3150;3150;7.20;0.44;243.00;3.89;887;5;1073.00;0
2268;5;22565649;2268;257;3150;3150;7.17;0.44;243.08;3.89;882;5;1074.00;0
2272;5;22565663;2272;260;3150;3150;7.19;0.44;243.31;3.89;878;5;1075.00;0
2276;5;22565676;2276;259;3150;3150;7.26;0.44;243.55;3.89;874;5;1076.00;0
2279;5;22565690;2279;257;3150;3150;7.28;0.44;243.49;3.89;871;5;1077.00;0
2283;5;22565704;2283;263;3150;3150;7.33;0.45;243.75;3.89;867;5;1078.00;0
2287;5;22565717;2287;261;3150;3150;7.35;0.45;243.97;3.89;863;5;1079.00;0
2291;5;22565733;2291;288;3228;3275;7.40;0.46;243.94;3.79;937;5;1080.00;47
2296;5;22565757;2296;278;3234;3276;7.43;0.46;244.22;3.79;938;5;1081.00;42
2298;5;22565774;2298;266;3239;3276;7.49;0.46;244.32;3.78;941;5;1082.00;37
2303;5;22565788;2303;261;3242;3276;7.54;0.47;244.42;3.78;939;5;1083.00;34
2307;5;22565805;2307;254;3245;3276;7.63;0.47;244.48;3.78;938;5;1084.00;31
2315;5;22565820;2315;252;3247;3276;7.65;0.47;244.74;3.78;932;5;1085.00;29
2318;5;22565842;2318;250;3251;3276;7.69;0.47;245.02;3.79;933;5;1086.00;25
2322;5;22565857;2322;261;3255;3276;7.65;0.47;245.44;3.79;933;5;1087.00;21
2326;5;22565871;2326;268;3257;3277;7.62;0.47;245.59;3.79;931;5;1088.00;20
2331;5;22565886;2331;269;3261;3278;7.58;0.47;245.75;3.80;930;5;1089.00;17
2336;5;22565901;2336;273;3265;3278;7.47;0.46;246.05;3.81;929;5;1090.00;13
2338;5;22565922;2338;281;3270;3282;7.37;0.45;246.06;3.81;932;5;1091.00;12
2341;5;22565937;2341;287;3272;3282;7.21;0.44;246.29;3.81;931;5;1092.00;10
2343;5;22565952;2343;298;3274;3282;7.08;0.43;246.40;3.82;931;5;1093.00;8
2345;5;22565968;2345;309;3275;3282;7.01;0.43;246.59;3.82;930;5;1094.00;7
2349;5;22565984;2349;318;3282;3288;6.84;0.42;247.23;3.83;933;5;1095.00;6
2351;5;22565999;2351;331;3284;3288;6.82;0.42;247.27;3.83;933;5;1096.00;4
2355;5;22566014;2355;324;3284;3288;6.81;0.42;247.48;3.83;929;5;1097.00;4
2358;5;22566030;2358;319;3288;3291;6.79;0.42;247.57;3.83;930;5;1098.00;3
2362;5;22566048;2362;315;3288;3291;6.84;0.42;247.44;3.83;926;5;1099.00;3
2363;5;22566065;2363;312;3289;3291;6.87;0.42;247.45;3.83;926;5;1100.00;2
2366;5;22566086;2366;307;3290;3292;6.89;0.42;247.60;3.83;924;5;1101.00;2
2370;5;22566101;2370;313;3291;3293;6.87;0.42;247.97;3.83;921;5;1102.00;2
2372;5;22566119;2372;315;3291;3293;6.83;0.42;248.04;3.83;919;5;1103.00;2
2375;5;22566134;2375;323;3303;3306;6.84;0.42;248.15;3.81;928;5;1104.00;3
2377;5;22566152;2377;322;3304;3306;6.81;0.42;248.35;3.81;927;5;1105.00;2
2379;5;22566167;2379;314;3304;3306;6.83;0.42;248.40;3.81;925;5;1106.00;2
2384;5;22566183;2384;304;3305;3307;6.82;0.42;248.64;3.81;921;5;1107.00;2
2389;5;22566200;2389;307;3305;3307;6.80;0.41;249.05;3.81;916;5;1108.00;2
2392;5;22566225;2392;303;3309;3311;6.81;0.42;249.02;3.81;917;5;1109.00;2
2395;5;22566243;2395;296;3309;3311;6.86;0.42;249.08;3.81;914;5;1110.00;2
2396;5;22566260;2396;295;3311;3315;6.85;0.42;249.08;3.81;915;5;1111.00;4
2399;5;22566273;2399;302;3312;3315;6.86;0.42;249.35;3.82;913;5;1112.00;3
2401;5;22566289;2401;298;3312;3315;6.89;0.42;249.39;3.82;911;5;1113.00;3
2402;5;22566303;2402;305;3312;3315;6.90;0.42;249.44;3.82;910;5;1114.00;3
2406;5;22566320;2406;308;3312;3315;6.89;0.42;250.09;3.82;906;5;1115.00;3
2406;5;22566333;2406;310;3323;3327;6.94;0.42;250.09;3.81;917;5;1116.00;4
2408;5;22566349;2408;309;3324;3327;6.91;0.42;250.28;3.81;916;5;1117.00;3
2412;5;22566368;2412;305;3325;3327;6.87;0.42;250.86;3.81;913;5;1118.00;2
2417;5;22566384;2417;301;3325;3327;6.89;0.42;251.09;3.81;908;5;1119.00;2
2418;5;22566401;2418;299;3325;3327;6.90;0.42;251.11;3.81;907;5;1120.00;2
2422;5;22566419;2422;296;3325;3327;6.89;0.42;251.37;3.81;903;5;1121.00;2
2422;5;22566435;2422;288;3325;3328;6.93;0.42;251.37;3.81;903;5;1122.00;3
2426;5;22566450;2426;284;3325;3328;6.96;0.43;251.43;3.81;899;5;1123.00;3
2427;5;22566478;2427;279;3330;3334;7.10;0.43;251.38;3.81;903;5;1124.00;4
2430;5;22566496;2430;269;3332;3336;7.15;0.44;251.51;3.80;902;5;1125.00;4
2431;5;22566508;2431;265;3332;3336;7.20;0.44;251.52;3.80;901;5;1126.00;4
2435;5;22566521;2435;263;3332;3336;7.17;0.44;251.73;3.80;897;5;1127.00;4
2440;5;22566535;2440;268;3335;3340;7.17;0.44;251.79;3.80;895;5;1128.00;5
2443;5;22566550;2443;264;3335;3340;7.18;0.44;251.78;3.80;892;5;1129.00;5
2445;5;22566564;2445;262;3335;3340;7.17;0.44;251.90;3.80;890;5;1130.00;5
2447;5;22566575;2447;259;3336;3341;7.20;0.44;251.86;3.80;889;5;1131.00;5
2452;5;22566590;2452;259;3339;3345;7.25;0.44;252.11;3.80;887;5;1132.00;6
2453;5;22566604;2453;270;3339;3345;7.25;0.44;252.10;3.80;886;5;1133.00;6
2457;5;22566618;2457;275;3341;3348;7.30;0.45;252.16;3.80;884;5;1134.00;7
2461;5;22566632;2461;278;3341;3348;7.27;0.44;252.16;3.80;880;5;1135.00;7
2463;5;22566644;2463;277;3342;3348;7.30;0.44;252.19;3.80;879;5;1136.00;6
2467;5;22566656;2467;288;3342;3348;7.27;0.44;252.12;3.80;875;5;1137.00;6
2468;5;22566670;2468;293;3346;3352;7.29;0.44;252.12;3.79;878;5;1138.00;6
2470;5;22566691;2470;295;3346;3352;7.28;0.44;252.01;3.79;876;5;1139.00;6
2474;5;22566707;2474;283;3346;3352;7.23;0.44;251.85;3.79;872;5;1140.00;6
2476;5;22566728;2476;283;3346;3352;7.17;0.44;251.81;3.79;870;5;1141.00;6
2477;5;22566742;2477;277;3346;3353;7.17;0.44;251.80;3.79;869;5;1142.00;7
2478;5;22566756;2478;277;3347;3354;7.15;0.43;251.71;3.79;869;5;1143.00;7
2478;5;22566771;2478;277;3347;3354;7.10;0.43;251.71;3.79;869;5;1144.00;7
2479;5;22566783;2479;274;3348;3355;7.10;0.43;251.65;3.79;869;5;1145.00;7
2479;5;22566796;2479;272;3348;3355;7.11;0.43;251.65;3.79;869;5;1146.00;7
2481;5;22566810;2481;268;3348;3355;7.11;0.43;251.69;3.79;867;5;1147.00;7
2485;5;22566822;2485;267;3348;3355;7.06;0.43;251.44;3.79;863;5;1148.00;7
2487;5;22566836;2487;277;3348;3355;7.07;0.43;251.38;3.79;861;5;1149.00;7
2489;5;22566848;2489;271;3348;3355;7.04;0.43;251.35;3.79;859;5;1150.00;7
2490;5;22566860;2490;273;3348;3355;7.08;0.43;251.27;3.79;858;5;1151.00;7
2491;5;22566873;2491;293;3414;3482;7.13;0.44;251.26;3.72;923;5;1152.00;68
2492;5;22566899;2492;282;3414;3483;7.08;0.44;251.19;3.72;922;5;1153.00;69
2495;5;22566911;2495;268;3421;3483;7.15;0.44;251.15;3.71;926;5;1154.00;62
2496;5;22566923;2496;263;3423;3483;7.13;0.44;251.15;3.74;927;5;1155.00;60
2497;5;22566938;2497;258;3429;3483;7.14;0.44;251.12;3.74;932;5;1156.00;54
2498;5;22566951;2498;252;3433;3483;7.20;0.44;251.03;3.74;935;5;1157.00;50
2499;5;22566965;2499;256;3439;3483;7.17;0.44;251.03;3.74;940;5;1158.00;44
2500;5;22566981;2500;255;3443;3483;7.13;0.44;251.07;3.76;943;5;1159.00;40
2502;5;22566992;2502;254;3446;3484;7.14;0.44;251.10;3.76;944;5;1160.00;38
2503;5;22567005;2503;254;3448;3485;7.15;0.44;251.08;3.76;945;5;1161.00;37
2506;5;22567027;2506;253;3450;3485;7.14;0.44;251.03;3.77;944;5;1162.00;35
2508;5;22567042;2508;252;3454;3486;7.13;0.44;251.06;3.77;946;5;1163.00;32
2510;5;22567055;2510;251;3457;3486;7.17;0.44;250.94;3.78;947;5;1164.00;29
2510;5;22567068;2510;247;3457;3486;7.17;0.44;250.94;3.78;947;5;1165.00;29
2513;5;22567080;2513;230;3463;3486;7.14;0.44;250.92;3.80;950;5;1166.00;23
2513;5;22567096;2513;227;3464;3490;7.20;0.44;250.92;3.80;951;5;1167.00;26
2515;5;22567112;2515;221;3466;3490;7.22;0.44;250.89;3.80;951;5;1168.00;24
2515;5;22567125;2515;225;3467;3490;7.23;0.44;250.89;3.80;952;5;1169.00;23
2516;5;22567140;2516;219;3471;3496;7.29;0.45;250.83;3.80;955;5;1170.00;25
2518;5;22567156;2518;225;3472;3496;7.28;0.45;250.71;3.81;954;5;1171.00;24
2520;5;22567171;2520;222;3475;3496;7.28;0.44;250.69;3.81;955;5;1172.00;21
2520;5;22567194;2520;229;3479;3500;7.33;0.45;250.69;3.81;959;5;1173.00;21
2520;5;22567209;2520;224;3481;3501;7.35;0.45;250.69;3.81;961;5;1174.00;20
2521;5;22567224;2521;228;3482;3501;7.34;0.45;250.69;3.82;961;5;1175.00;19
2525;5;22567240;2525;227;3486;3505;7.36;0.45;250.73;3.82;961;5;1176.00;19
2527;5;22567258;2527;231;3486;3505;7.37;0.45;250.61;3.82;959;5;1177.00;19
2529;5;22567272;2529;235;3487;3505;7.35;0.45;250.54;3.82;958;5;1178.00;18
2532;5;22567288;2532;239;3489;3506;7.31;0.45;250.47;3.83;957;5;1179.00;17
2534;5;22567302;2534;236;3492;3506;7.30;0.44;250.48;3.86;958;5;1180.00;14
2536;5;22567317;2536;239;3497;3512;7.35;0.45;250.50;3.86;961;5;1181.00;15
2537;5;22567333;2537;241;3498;3512;7.35;0.45;250.48;3.86;961;5;1182.00;14
2538;5;22567347;2538;245;3500;3513;7.35;0.45;250.47;3.89;962;5;1183.00;13
2541;5;22567361;2541;252;3500;3513;7.30;0.44;250.44;3.89;959;5;1184.00;13
2541;5;22567374;2541;251;3500;3513;7.35;0.45;250.44;3.89;959;5;1185.00;13
2541;5;22567389;2541;259;3502;3513;7.37;0.45;250.44;3.90;961;5;1186.00;11
2544;5;22567402;2544;259;3502;3513;7.38;0.45;250.27;3.90;958;5;1187.00;11
2545;5;22567418;2545;262;3512;3525;7.41;0.45;250.18;3.89;967;5;1188.00;13
2547;5;22567441;2547;264;3514;3525;7.38;0.45;250.15;3.91;967;5;1189.00;11
2550;5;22567457;2550;265;3516;3525;7.37;0.45;250.12;3.92;966;5;1190.00;9
2553;5;22567473;2553;267;3518;3525;7.37;0.45;250.19;3.94;965;5;1191.00;7
2557;5;22567491;2557;265;3519;3525;7.33;0.45;250.08;3.95;962;5;1192.00;6
2559;5;22567508;2559;264;3520;3525;7.33;0.45;250.03;3.96;961;5;1193.00;5
2559;5;22567528;2559;265;3524;3529;7.32;0.45;250.03;3.96;965;5;1194.00;5
2561;5;22567552;2561;262;3524;3529;7.33;0.45;250.07;3.96;963;5;1195.00;5
2565;6;22567570;2565;264;3529;3533;7.33;0.45;250.00;3.96;964;6;1196.00;4
2568;6;22567616;2568;269;3530;3534;7.29;0.44;250.29;3.96;962;6;1197.00;4
2569;6;22567650;2569;268;3531;3534;7.22;0.44;250.25;3.97;962;6;1198.00;3
2570;6;22567670;2570;266;3531;3534;7.18;0.44;250.42;3.97;961;6;1199.00;3
2573;6;22567690;2573;269;3558;3575;7.17;0.44;250.45;3.95;985;6;1200.00;17
2573;6;22567723;2573;259;3559;3575;7.20;0.44;250.45;3.94;986;6;1201.00;16
2575;6;22567741;2575;262;3562;3575;7.26;0.45;250.42;3.94;987;6;1202.00;13
2576;6;22567759;2576;261;3564;3576;7.27;0.45;250.46;3.94;988;6;1203.00;12
2581;6;22567775;2581;262;3568;3577;7.26;0.44;250.56;3.94;987;6;1204.00;9
2583;6;22567793;2583;261;3568;3577;7.22;0.44;250.66;3.94;985;6;1205.00;9
2587;6;22567812;2587;255;3571;3580;7.22;0.44;250.98;3.94;984;6;1206.00;9
2592;6;22567831;2592;255;3571;3580;7.28;0.44;251.10;3.94;979;6;1207.00;9
2594;6;22567850;2594;257;3573;3580;7.33;0.45;251.15;3.94;979;6;1208.00;7
2597;6;22567873;2597;256;3575;3580;7.39;0.45;251.26;3.94;978;6;1209.00;5
2600;6;22567902;2600;250;3582;3586;7.44;0.45;251.54;3.94;982;6;1210.00;4
2602;6;22567920;2602;248;3582;3586;7.49;0.46;251.61;3.94;980;6;1211.00;4
2603;6;22567938;2603;250;3582;3586;7.51;0.46;251.66;3.94;979;6;1212.00;4
2607;6;22567954;2607;244;3582;3586;7.52;0.46;251.78;3.94;975;6;1213.00;4
2612;6;22567973;2612;248;3587;3590;7.46;0.46;251.95;3.94;975;6;1214.00;3
2614;6;22567990;2614;245;3589;3592;7.46;0.46;252.04;3.94;975;6;1215.00;3
2618;6;22568011;2618;250;3589;3592;7.42;0.45;251.99;3.94;971;6;1216.00;3
2623;6;22568029;2623;251;3590;3593;7.40;0.45;252.13;3.94;967;6;1217.00;3
2629;6;22568046;2629;256;3590;3593;7.29;0.45;252.31;3.94;961;6;1218.00;3
2633;6;22568064;2633;252;3590;3593;7.23;0.44;252.27;3.94;957;6;1219.00;3
2636;6;22568083;2636;257;3591;3593;7.18;0.44;252.59;3.94;955;6;1220.00;2
2642;6;22568101;2642;264;3591;3593;7.04;0.43;252.59;3.94;949;6;1221.00;2
2645;6;22568119;2645;266;3591;3593;6.99;0.43;252.57;3.94;946;6;1222.00;2
2651;6;22568136;2651;275;3591;3593;6.85;0.42;252.73;3.94;940;6;1223.00;2
2654;6;22568151;2654;290;3633;3663;6.87;0.42;252.82;3.90;979;6;1224.00;30
2655;6;22568173;2655;276;3637;3664;6.86;0.42;252.80;3.89;982;6;1225.00;27
2659;6;22568189;2659;275;3644;3664;6.77;0.42;252.97;3.89;985;6;1226.00;20
2662;6;22568206;2662;264;3644;3664;6.73;0.41;253.00;3.89;982;6;1227.00;20
2665;6;22568221;2665;261;3648;3666;6.69;0.41;252.98;3.89;983;6;1228.00;18
2669;6;22568235;2669;255;3649;3666;6.64;0.41;253.06;3.89;980;6;1229.00;17
2674;6;22568254;2674;258;3651;3666;6.62;0.41;253.33;3.90;977;6;1230.00;15
2678;6;22568268;2678;265;3653;3666;6.67;0.41;253.70;3.90;975;6;1231.00;13
2682;6;22568283;2682;262;3657;3667;6.63;0.41;254.13;3.91;975;6;1232.00;10
2684;6;22568296;2684;260;3661;3668;6.68;0.41;254.24;3.91;977;6;1233.00;7
2688;6;22568307;2688;256;3663;3668;6.68;0.41;254.54;3.91;975;6;1234.00;5
2691;6;22568320;2691;255;3668;3672;6.66;0.41;254.88;3.91;977;6;1235.00;4
2695;6;22568333;2695;260;3669;3672;6.72;0.41;254.94;3.92;974;6;1236.00;3
2699;6;22568347;2699;259;3671;3672;6.74;0.41;255.21;3.92;972;6;1237.00;1
2702;6;22568367;2702;265;3672;3672;6.83;0.42;255.46;3.92;970;6;1238.00;0
2705;6;22568383;2705;263;3678;3678;6.95;0.43;255.78;3.92;973;6;1239.00;0
2711;6;22568401;2711;269;3678;3678;7.02;0.43;255.96;3.92;967;6;1240.00;0
2715;6;22568420;2715;266;3678;3678;7.10;0.44;256.13;3.92;963;6;1241.00;0
2723;6;22568442;2723;269;3680;3681;7.15;0.44;256.41;3.91;957;6;1242.00;1
2726;6;22568467;2726;265;3681;3681;7.17;0.44;256.26;3.91;955;6;1243.00;0
2732;7;22568484;2732;266;3681;3681;7.14;0.44;256.82;3.91;949;7;1244.00;0
2737;7;22568530;2737;265;3682;3682;7.12;0.44;257.05;3.91;945;7;1245.00;0
2742;7;22568549;2742;272;3683;3683;7.05;0.43;257.28;3.91;941;7;1246.00;0
2748;7;22568565;2748;271;3683;3683;7.01;0.43;257.55;3.91;935;7;1247.00;0
2755;7;22568580;2755;275;3696;3696;7.04;0.43;257.90;3.90;941;7;1248.00;0
2761;7;22568598;2761;280;3696;3696;7.03;0.43;257.94;3.90;935;7;1249.00;0
2769;7;22568611;2769;279;3696;3696;6.99;0.43;258.23;3.90;927;7;1250.00;0
2776;7;22568625;2776;282;3697;3697;7.02;0.43;258.41;3.90;921;7;1251.00;0
2781;7;22568639;2781;287;3697;3697;6.93;0.42;258.74;3.90;916;7;1252.00;0
2783;7;22568652;2783;287;3701;3701;6.91;0.42;258.86;3.89;918;7;1253.00;0
2789;7;22568667;2789;289;3701;3701;6.86;0.42;259.22;3.89;912;7;1254.00;0
2794;7;22568683;2794;291;3705;3705;6.86;0.42;259.38;3.89;911;7;1255.00;0
2801;7;22568702;2801;293;3705;3705;6.86;0.42;259.60;3.89;904;7;1256.00;0
2806;7;22568719;2806;296;3705;3705;6.83;0.42;259.73;3.89;899;7;1257.00;0
2810;7;22568734;2810;294;3705;3705;6.80;0.41;259.77;3.89;895;7;1258.00;0
2814;7;22568750;2814;299;3705;3705;6.79;0.41;259.94;3.89;891;7;1259.00;0
2817;7;22568771;2817;302;3735;3739;6.95;0.43;259.96;3.86;918;7;1260.00;4
2822;7;22568792;2822;300;3735;3739;6.93;0.42;260.21;3.86;913;7;1261.00;4
2827;7;22568811;2827;307;3738;3739;6.90;0.42;260.30;3.86;911;7;1262.00;1
2828;7;22568836;2828;308;3738;3739;6.86;0.42;260.30;3.86;910;7;1263.00;1
2829;7;22568851;2829;320;3739;3739;6.83;0.42;260.45;3.86;910;7;1264.00;0
2833;7;22568868;2833;319;3739;3739;6.74;0.41;260.54;3.86;906;7;1265.00;0
2836;7;22568882;2836;327;3740;3740;6.71;0.41;260.38;3.86;904;7;1266.00;0
2838;7;22568899;2838;325;3740;3740;6.67;0.41;260.40;3.86;902;7;1267.00;0
2839;7;22568914;2839;333;3745;3746;6.69;0.41;260.32;3.85;906;7;1268.00;1
2845;7;22568933;2845;340;3746;3747;6.60;0.40;260.41;3.85;901;7;1269.00;1
2846;7;22568950;2846;344;3746;3747;6.50;0.40;260.43;3.85;900;7;1270.00;1
2850;7;22568965;2850;353;3746;3747;6.44;0.40;260.58;3.85;896;7;1271.00;1
2852;7;22568982;2852;343;3750;3751;6.51;0.40;260.56;3.85;898;7;1272.00;1
2855;7;22568998;2855;343;3750;3751;6.53;0.40;260.72;3.85;895;7;1273.00;1
2859;7;22569013;2859;343;3750;3751;6.53;0.40;260.85;3.85;891;7;1274.00;1
2859;7;22569027;2859;338;3751;3752;6.53;0.40;260.85;3.85;892;7;1275.00;1
2863;7;22569044;2863;343;3754;3756;6.55;0.40;261.06;3.84;891;7;1276.00;2
2864;7;22569064;2864;342;3754;3756;6.52;0.40;261.07;3.84;890;7;1277.00;2
2867;7;22569079;2867;337;3756;3759;6.56;0.40;261.08;3.84;889;7;1278.00;3
2868;7;22569097;2868;339;3756;3759;6.59;0.40;261.06;3.84;888;7;1279.00;3
2869;7;22569114;2869;341;3757;3759;6.65;0.41;261.08;3.84;888;7;1280.00;2
2869;7;22569130;2869;326;3757;3759;6.68;0.41;261.08;3.84;888;7;1281.00;2
2871;7;22569158;2871;321;3761;3763;6.79;0.41;261.14;3.84;890;7;1282.00;2
2872;7;22569181;2872;310;3761;3763;6.82;0.42;261.21;3.84;889;7;1283.00;2
2873;7;22569202;2873;311;3761;3763;6.88;0.42;261.21;3.84;888;7;1284.00;2
2873;7;22569221;2873;301;3761;3763;6.93;0.42;261.21;3.84;888;7;1285.00;2
2875;7;22569247;2875;302;3761;3764;6.96;0.43;261.26;3.84;886;7;1286.00;3
2876;7;22569274;2876;301;3762;3765;7.03;0.43;261.24;3.84;886;7;1287.00;3
2882;7;22569296;2882;304;3762;3765;7.04;0.43;261.41;3.84;880;7;1288.00;3
2885;7;22569321;2885;308;3763;3766;7.01;0.43;261.37;3.84;878;7;1289.00;3
2888;7;22569344;2888;312;3763;3766;7.05;0.43;261.43;3.84;875;7;1290.00;3
2892;7;22569367;2892;313;3763;3766;7.04;0.43;261.47;3.84;871;7;1291.00;3
2893;7;22569384;2893;308;3763;3766;7.06;0.43;261.58;3.84;870;7;1292.00;3
2896;7;22569402;2896;303;3763;3766;7.10;0.43;261.65;3.84;867;7;1293.00;3
2900;7;22569420;2900;300;3763;3766;7.10;0.43;261.89;3.84;863;7;1294.00;3
2902;7;22569437;2902;298;3763;3766;7.06;0.43;262.03;3.84;861;7;1295.00;3
2905;7;22569453;2905;315;3831;3893;7.40;0.46;262.08;3.77;926;7;1296.00;62
2909;7;22569482;2909;309;3833;3894;7.47;0.46;262.08;3.77;924;7;1297.00;61
2911;7;22569499;2911;296;3841;3894;7.62;0.47;262.08;3.77;930;7;1298.00;53
2913;7;22569517;2913;292;3844;3894;7.64;0.47;262.05;3.76;931;7;1299.00;50
2915;7;22569539;2915;289;3850;3894;7.65;0.47;262.13;3.76;935;7;1300.00;44
2917;7;22569562;2917;293;3853;3894;7.63;0.47;262.01;3.77;936;7;1301.00;41
2919;7;22569582;2919;293;3856;3894;7.59;0.47;261.99;3.77;937;7;1302.00;38
2920;7;22569602;2920;293;3859;3894;7.55;0.46;261.93;3.77;939;7;1303.00;35
2924;7;22569619;2924;294;3862;3895;7.54;0.46;261.93;3.77;938;7;1304.00;33
2929;7;22569636;2929;301;3867;3897;7.50;0.46;261.88;3.78;938;7;1305.00;30
2933;7;22569667;2933;307;3869;3897;7.31;0.45;261.76;3.78;936;7;1306.00;28
2934;7;22569684;2934;306;3871;3898;7.28;0.45;261.78;3.78;937;7;1307.00;27
2934;7;22569699;2934;309;3872;3898;7.22;0.44;261.78;3.79;938;7;1308.00;26
2934;7;22569715;2934;320;3876;3898;7.25;0.45;261.78;3.80;942;7;1309.00;22
2937;7;22569731;2937;320;3877;3898;7.21;0.44;261.76;3.80;940;7;1310.00;21
2938;7;22569746;2938;322;3881;3902;7.17;0.44;261.75;3.80;943;7;1311.00;21
2941;7;22569765;2941;326;3882;3902;7.10;0.43;261.73;3.80;941;7;1312.00;20
2944;7;22569784;2944;332;3883;3902;6.99;0.43;261.81;3.80;939;7;1313.00;19
2947;7;22569803;2947;336;3885;3905;6.96;0.42;261.73;3.80;938;7;1314.00;20
2948;7;22569827;2948;333;3886;3905;6.88;0.42;261.75;3.81;938;7;1315.00;19
2950;7;22569845;2950;334;3887;3905;6.77;0.41;261.72;3.81;937;7;1316.00;18
2952;7;22569873;2952;330;3891;3909;6.77;0.41;261.70;3.81;939;7;1317.00;18
2952;7;22569895;2952;325;3894;3910;6.78;0.41;261.70;3.82;942;7;1318.00;16
2953;7;22569915;2953;326;3894;3910;6.81;0.41;261.62;3.82;941;7;1319.00;16
2954;7;22569934;2954;322;3898;3915;6.86;0.42;261.71;3.82;944;7;1320.00;17
2955;7;22569958;2955;317;3898;3915;6.89;0.42;261.71;3.82;943;7;1321.00;17
2958;7;22569979;2958;316;3899;3915;6.84;0.41;261.65;3.82;941;7;1322.00;16
2960;7;22570000;2960;302;3900;3916;6.88;0.42;261.58;3.82;940;7;1323.00;16
2961;7;22570019;2961;291;3900;3916;6.87;0.42;261.65;3.82;939;7;1324.00;16
2963;7;22570036;2963;276;3904;3922;6.94;0.42;261.66;3.81;941;7;1325.00;18
2967;7;22570052;2967;276;3904;3922;6.95;0.42;261.80;3.81;937;7;1326.00;18
2970;7;22570065;2970;267;3904;3923;6.95;0.42;261.66;3.81;934;7;1327.00;19
2971;7;22570080;2971;267;3904;3923;6.96;0.42;261.68;3.81;933;7;1328.00;19
2974;7;22570093;2974;262;3905;3923;6.89;0.42;261.72;3.83;931;7;1329.00;18
2978;7;22570122;2978;258;3906;3923;6.84;0.41;261.63;3.84;928;7;1330.00;17
2979;7;22570136;2979;254;3906;3923;6.84;0.41;261.64;3.84;927;7;1331.00;17
2981;7;22570149;2981;243;3916;3935;6.91;0.42;261.70;3.83;935;7;1332.00;19
2983;7;22570162;2983;237;3917;3935;6.89;0.42;261.69;3.83;934;7;1333.00;18
2984;7;22570178;2984;225;3917;3935;6.95;0.42;261.67;3.83;933;7;1334.00;18
2985;7;22570194;2985;220;3917;3935;6.99;0.42;261.60;3.83;932;7;1335.00;18
2986;7;22570215;2986;226;3917;3935;7.04;0.43;261.61;3.83;931;7;1336.00;18
2987;7;22570228;2987;218;3917;3935;7.14;0.43;261.53;3.83;930;7;1337.00;18
2987;7;22570244;2987;213;3920;3939;7.20;0.44;261.53;3.83;933;7;1338.00;19
2988;7;22570261;2988;207;3920;3939;7.26;0.44;261.48;3.83;932;7;1339.00;19
2989;7;22570279;2989;201;3923;3943;7.35;0.45;261.47;3.83;934;7;1340.00;20
2990;7;22570297;2990;190;3923;3944;7.39;0.45;261.42;3.83;933;7;1341.00;21
2991;7;22570310;2991;188;3924;3944;7.51;0.46;261.42;3.82;933;7;1342.00;20
2994;7;22570324;2994;179;3924;3944;7.55;0.46;261.50;3.82;930;7;1343.00;20
2996;7;22570337;2996;176;3934;3957;7.69;0.47;261.49;3.82;938;7;1344.00;23
2997;7;22570356;2997;175;3935;3957;7.77;0.47;261.44;3.81;938;7;1345.00;22
3001;7;22570380;3001;172;3935;3957;7.76;0.47;261.69;3.81;934;7;1346.00;22
3004;7;22570398;3004;169;3936;3958;7.82;0.48;261.51;3.81;932;7;1347.00;22
3006;7;22570417;3006;166;3939;3959;7.89;0.48;261.51;3.85;933;7;1348.00;20
3009;7;22570436;3009;169;3939;3959;7.97;0.48;261.51;3.85;930;7;1349.00;20
3010;7;22570466;3010;168;3947;3968;8.00;0.49;261.54;3.85;937;7;1350.00;21
3011;7;22570489;3011;166;3948;3968;8.07;0.49;261.56;3.86;937;7;1351.00;20
3011;7;22570515;3011;166;3950;3968;8.18;0.50;261.56;3.86;939;7;1352.00;18
3015;7;22570531;3015;172;3951;3968;8.24;0.50;261.74;3.86;936;7;1353.00;17
3017;7;22570550;3017;171;3956;3974;8.28;0.50;261.72;3.86;939;7;1354.00;18
3020;7;22570567;3020;179;3958;3974;8.31;0.50;261.65;3.88;938;7;1355.00;16
3023;7;22570582;3023;185;3958;3974;8.35;0.51;261.71;3.88;935;7;1356.00;16
3026;7;22570599;3026;190;3959;3974;8.32;0.51;261.73;3.89;933;7;1357.00;15
3029;7;22570616;3029;190;3962;3978;8.29;0.50;262.04;3.89;933;7;1358.00;16
3033;7;22570644;3033;202;3965;3979;8.32;0.51;262.12;3.91;932;7;1359.00;14
3039;7;22570664;3039;204;3965;3979;8.27;0.50;261.98;3.91;926;7;1360.00;14
3040;7;22570683;3040;217;3966;3980;8.29;0.50;262.12;3.91;926;7;1361.00;14
3044;7;22570699;3044;214;3966;3980;8.21;0.50;262.20;3.91;922;7;1362.00;14
3044;7;22570714;3044;220;3967;3980;8.19;0.50;262.20;3.92;923;7;1363.00;13
3046;7;22570729;3046;225;3967;3980;8.14;0.50;262.32;3.92;921;7;1364.00;13
3046;7;22570746;3046;223;3971;3980;8.10;0.49;262.32;3.99;925;7;1365.00;9
3050;7;22570764;3050;223;3971;3980;8.09;0.49;262.44;3.99;921;7;1366.00;9
3054;7;22570780;3054;229;3972;3980;8.05;0.49;262.43;4.00;918;7;1367.00;8
3055;7;22570797;3055;235;4012;4050;8.16;0.50;262.48;3.97;957;7;1368.00;38
3057;7;22570831;3057;236;4016;4051;8.10;0.50;262.62;3.98;959;7;1369.00;35
3058;7;22570850;3058;236;4023;4051;8.06;0.49;262.59;3.98;965;7;1370.00;28
3061;7;22570867;3061;235;4026;4051;7.95;0.49;262.70;3.98;965;7;1371.00;25
3063;7;22570886;3063;237;4030;4051;7.86;0.48;262.75;3.99;967;7;1372.00;21
3066;7;22570904;3066;240;4033;4051;7.75;0.47;262.81;4.00;967;7;1373.00;18
3067;7;22570924;3067;232;4035;4051;7.70;0.47;262.82;4.00;968;7;1374.00;16
3069;7;22570942;3069;231;4040;4051;7.66;0.47;262.84;4.01;971;7;1375.00;11
3071;7;22570960;3071;231;4043;4052;7.67;0.47;262.86;4.02;972;7;1376.00;9
3074;7;22570979;3074;232;4048;4053;7.65;0.47;262.83;4.02;974;7;1377.00;5
3076;7;22571000;3076;230;4049;4053;7.67;0.47;262.99;4.02;973;7;1378.00;4
3081;7;22571017;3081;227;4055;4057;7.67;0.47;263.17;4.02;974;7;1379.00;2
3083;7;22571037;3083;227;4056;4057;7.68;0.47;263.25;4.03;973;7;1380.00;1
3088;7;22571057;3088;229;4056;4057;7.67;0.47;263.28;4.03;968;7;1381.00;1
3090;7;22571073;3090;230;4057;4057;7.64;0.47;263.39;4.03;967;7;1382.00;0
3092;7;22571091;3092;234;4063;4063;7.67;0.47;263.32;4.02;971;7;1383.00;0
3094;7;22571108;3094;235;4063;4063;7.65;0.47;263.31;4.02;969;7;1384.00;0
3096;7;22571124;3096;243;4063;4063;7.71;0.47;263.39;4.02;967;7;1385.00;0
3102;7;22571140;3102;240;4065;4066;7.72;0.47;263.36;4.02;963;7;1386.00;1
3105;7;22571159;3105;242;4065;4066;7.72;0.47;263.43;4.02;960;7;1387.00;1
3110;7;22571183;3110;245;4066;4066;7.71;0.47;263.23;4.02;956;7;1388.00;0
3114;7;22571206;3114;251;4067;4067;7.72;0.47;263.35;4.02;953;7;1389.00;0
3115;7;22571223;3115;256;4068;4068;7.66;0.47;263.41;4.02;953;7;1390.00;0
3121;7;22571238;3121;260;4068;4068;7.59;0.46;263.35;4.02;947;7;1391.00;0
3125;7;22571255;3125;270;4080;4081;7.52;0.46;263.37;4.01;955;7;1392.00;1
3129;7;22571275;3129;275;4081;4081;7.43;0.45;263.38;4.00;952;7;1393.00;0
3135;7;22571290;3135;283;4081;4081;7.34;0.45;263.35;4.00;946;7;1394.00;0
3141;7;22571306;3141;289;4083;4083;7.26;0.44;263.45;4.00;942;7;1395.00;0
3144;7;22571322;3144;285;4083;4083;7.17;0.44;263.45;4.00;939;7;1396.00;0
3147;7;22571338;3147;290;4087;4087;7.16;0.44;263.59;4.00;940;7;1397.00;0
3153;7;22571355;3153;287;4087;4087;7.01;0.43;263.77;4.00;934;7;1398.00;0
3156;7;22571370;3156;297;4091;4091;6.87;0.42;264.01;4.00;935;7;1399.00;0
3159;7;22571391;3159;281;4091;4091;6.75;0.41;263.95;4.00;932;7;1400.00;0
3162;7;22571409;3162;283;4091;4091;6.67;0.40;264.10;4.00;929;7;1401.00;0
3164;7;22571422;3164;277;4091;4091;6.67;0.41;264.18;4.00;927;7;1402.00;0
3169;7;22571436;3169;273;4091;4091;6.61;0.40;264.45;4.00;922;7;1403.00;0
3171;7;22571449;3171;268;4102;4103;6.70;0.41;264.52;3.99;931;7;1404.00;1
3175;7;22571463;3175;270;4103;4103;6.72;0.41;264.87;3.99;928;7;1405.00;0
3175;7;22571474;3175;273;4103;4103;6.74;0.41;264.87;3.99;928;7;1406.00;0
3180;7;22571487;3180;264;4103;4103;6.75;0.41;265.21;3.99;923;7;1407.00;0
3183;7;22571502;3183;262;4103;4103;6.80;0.41;265.36;3.99;920;7;1408.00;0
3186;7;22571515;3186;257;4103;4103;6.89;0.42;265.49;3.99;917;7;1409.00;0
3187;7;22571528;3187;257;4104;4104;6.94;0.42;265.49;3.98;917;7;1410.00;0
3191;7;22571540;3191;256;4104;4104;6.97;0.43;265.66;3.98;913;7;1411.00;0
3194;7;22571552;3194;256;4110;4110;7.05;0.43;265.74;3.98;916;7;1412.00;0
3199;7;22571567;3199;256;4111;4111;7.06;0.43;265.88;3.98;912;7;1413.00;0
3203;7;22571579;3203;262;4111;4111;7.06;0.43;266.04;3.98;908;7;1414.00;0
3206;7;22571591;3206;267;4111;4111;7.02;0.43;266.24;3.98;905;7;1415.00;0
3211;7;22571605;3211;270;4115;4115;7.05;0.43;266.30;3.98;904;7;1416.00;0
3218;7;22571617;3218;273;4115;4115;6.97;0.43;266.73;3.98;897;7;1417.00;0
3222;7;22571633;3222;279;4115;4115;6.93;0.42;266.87;3.98;893;7;1418.00;0
3227;7;22571645;3227;282;4116;4116;6.82;0.42;266.86;3.97;889;7;1419.00;0
3233;7;22571656;3233;289;4120;4120;6.73;0.41;267.03;3.97;887;7;1420.00;0
3236;7;22571669;3236;297;4120;4120;6.64;0.41;267.39;3.97;884;7;1421.00;0
3242;7;22571690;3242;298;4122;4123;6.56;0.40;267.44;3.97;880;7;1422.00;1
3249;7;22571702;3249;300;4122;4123;6.45;0.39;267.33;3.97;873;7;1423.00;1
3252;7;22571713;3252;308;4123;4123;6.38;0.39;267.39;3.97;871;7;1424.00;0
3255;7;22571723;3255;311;4123;4123;6.34;0.39;267.58;3.97;868;7;1425.00;0
3257;7;22571736;3257;310;4127;4127;6.38;0.39;267.61;3.97;870;7;1426.00;0
3264;7;22571748;3264;315;4127;4127;6.36;0.39;267.93;3.97;863;7;1427.00;0
3268;7;22571758;3268;314;4127;4127;6.35;0.39;267.95;3.97;859;7;1428.00;0
3273;7;22571771;3273;319;4127;4127;6.35;0.39;268.21;3.97;854;7;1429.00;0
3277;7;22571784;3277;319;4128;4128;6.26;0.38;268.35;3.97;851;7;1430.00;0
3280;7;22571797;3280;324;4129;4129;6.22;0.38;268.53;3.97;849;7;1431.00;0
3282;7;22571810;3282;329;4129;4129;6.21;0.38;268.59;3.97;847;7;1432.00;0
3285;7;22571821;3285;331;4130;4130;6.26;0.38;268.49;3.96;845;7;1433.00;0
3287;7;22571833;3287;338;4130;4130;6.21;0.38;268.52;3.96;843;7;1434.00;0
3289;7;22571847;3289;336;4130;4130;6.18;0.38;268.42;3.96;841;7;1435.00;0
3291;7;22571860;3291;336;4130;4130;6.19;0.38;268.48;3.96;839;7;1436.00;0
3294;7;22571872;3294;338;4130;4130;6.12;0.37;268.48;3.96;836;7;1437.00;0
3299;7;22571884;3299;344;4130;4130;6.09;0.37;268.66;3.96;831;7;1438.00;0
3302;7;22571895;3302;344;4130;4130;6.08;0.37;268.70;3.96;828;7;1439.00;0
3304;7;22571909;3304;382;4238;4360;6.64;0.42;268.78;3.86;934;7;1440.00;122
3310;7;22571942;3310;381;4246;4361;6.62;0.42;268.96;3.86;936;7;1441.00;115
3312;7;22571957;3312;372;4261;4361;6.71;0.42;269.07;3.85;949;7;1442.00;100
3315;7;22571969;3315;371;4269;4361;6.66;0.42;269.20;3.85;954;7;1443.00;92
3318;7;22571982;3318;381;4278;4361;6.62;0.42;269.25;3.85;960;7;1444.00;83
3323;7;22571994;3323;384;4288;4361;6.51;0.41;269.36;3.85;965;7;1445.00;73
3327;7;22572006;3327;386;4295;4361;6.44;0.40;269.60;3.86;968;7;1446.00;66
3329;7;22572021;3329;381;4302;4361;6.40;0.40;269.59;3.86;973;7;1447.00;59
3331;7;22572034;3331;378;4310;4362;6.34;0.40;269.56;3.87;979;7;1448.00;52
3334;7;22572049;3334;376;4314;4363;6.33;0.40;269.47;3.87;980;7;1449.00;49
3337;7;22572062;3337;373;4317;4363;6.32;0.39;269.50;3.88;980;7;1450.00;46
3341;7;22572073;3341;377;4322;4364;6.19;0.39;269.30;3.89;981;7;1451.00;42
3341;7;22572088;3341;379;4325;4364;6.10;0.38;269.30;3.89;984;7;1452.00;39
3344;7;22572100;3344;390;4328;4364;5.97;0.37;269.42;3.90;984;7;1453.00;36
3345;7;22572112;3345;391;4330;4364;5.89;0.37;269.40;3.90;985;7;1454.00;34
3347;7;22572126;3347;403;4334;4368;5.87;0.36;269.48;3.91;987;7;1455.00;34
3348;7;22572147;3348;392;4336;4368;5.90;0.37;269.42;3.91;988;7;1456.00;32
3349;7;22572158;3349;386;4339;4368;5.95;0.37;269.34;3.92;990;7;1457.00;29
3351;7;22572171;3351;383;4340;4371;6.04;0.37;269.38;3.92;989;7;1458.00;31
3351;7;22572186;3351;380;4342;4371;6.11;0.38;269.38;3.92;991;7;1459.00;29
3352;7;22572203;3352;383;4342;4371;6.16;0.38;269.32;3.92;990;7;1460.00;29
3352;7;22572217;3352;383;4346;4375;6.24;0.39;269.32;3.92;994;7;1461.00;29
3358;7;22572236;3358;382;4348;4376;6.29;0.39;269.14;3.93;990;7;1462.00;28
3360;7;22572251;3360;384;4349;4376;6.40;0.39;269.08;3.93;989;7;1463.00;27
3362;7;22572266;3362;379;4352;4380;6.52;0.40;268.99;3.92;990;7;1464.00;28
3364;7;22572289;3364;380;4353;4380;6.63;0.41;269.05;3.93;989;7;1465.00;27
3364;7;22572303;3364;385;4354;4380;6.71;0.41;269.05;3.93;990;7;1466.00;26
3365;7;22572317;3365;386;4355;4381;6.79;0.42;268.98;3.94;990;7;1467.00;26
3365;7;22572330;3365;385;4356;4381;6.86;0.42;268.98;3.94;991;7;1468.00;25
3370;7;22572344;3370;386;4360;4387;6.88;0.42;268.86;3.94;990;7;1469.00;27
3371;7;22572364;3371;387;4362;4387;6.92;0.42;268.91;3.95;991;7;1470.00;25
3372;7;22572385;3372;387;4362;4388;6.97;0.43;268.86;3.95;990;7;1471.00;26
3374;7;22572405;3374;383;4363;4388;6.99;0.43;268.82;3.95;989;7;1472.00;25
3377;7;22572428;3377;382;4364;4388;6.98;0.43;268.78;3.96;987;7;1473.00;24
3378;7;22572445;3378;387;4365;4388;6.96;0.42;268.83;3.97;987;7;1474.00;23
3379;7;22572462;3379;377;4365;4388;6.92;0.42;268.76;3.97;986;7;1475.00;23
3383;7;22572481;3383;382;4374;4400;6.85;0.42;268.79;3.96;991;7;1476.00;26
3384;7;22572498;3384;384;4376;4400;6.83;0.42;268.80;3.97;992;7;1477.00;24
3384;7;22572512;3384;380;4377;4400;6.81;0.41;268.80;3.97;993;7;1478.00;23
3386;7;22572527;3386;383;4379;4400;6.80;0.41;268.76;3.97;993;7;1479.00;21
3387;7;22572542;3387;372;4379;4400;6.83;0.42;268.77;3.97;992;7;1480.00;21
3389;7;22572558;3389;364;4379;4400;6.86;0.42;268.80;3.97;990;7;1481.00;21
3390;7;22572572;3390;361;4382;4404;6.88;0.42;268.73;3.97;992;7;1482.00;22
3392;7;22572585;3392;356;4382;4404;6.92;0.42;268.74;3.97;990;7;1483.00;22
3392;8;22572601;3392;351;4386;4408;6.97;0.42;268.74;3.96;994;8;1484.00;22
3394;8;22572630;3394;352;4388;4410;7.04;0.43;268.65;3.96;994;8;1485.00;22
3395;8;22572649;3395;351;4388;4410;7.07;0.43;268.59;3.96;993;8;1486.00;22
3396;8;22572662;3396;349;4388;4410;7.05;0.43;268.62;3.96;992;8;1487.00;22
3399;8;22572675;3399;347;4397;4423;7.09;0.43;268.60;3.95;998;8;1488.00;26
3400;8;22572690;3400;349;4397;4423;7.09;0.43;268.62;3.95;997;8;1489.00;26
3401;8;22572715;3401;353;4397;4423;7.10;0.43;268.60;3.95;996;8;1490.00;26
3402;8;22572728;3402;342;4398;4424;7.16;0.43;268.60;3.95;996;8;1491.00;26
3403;8;22572740;3403;337;4398;4425;7.21;0.44;268.65;3.95;995;8;1492.00;27
3404;9;22572753;3404;332;4398;4425;7.29;0.44;268.59;3.95;994;9;1493.00;27
3405;9;22572776;3405;324;4400;4428;7.32;0.45;268.58;3.95;995;9;1494.00;28
3405;9;22572789;3405;319;4400;4428;7.35;0.45;268.58;3.95;995;9;1495.00;28
3406;9;22572804;3406;318;4401;4428;7.38;0.45;268.57;3.95;995;9;1496.00;27
3411;9;22572819;3411;314;4401;4428;7.41;0.45;268.63;3.95;990;9;1497.00;27
3412;9;22572833;3412;313;4406;4434;7.46;0.45;268.65;3.95;994;9;1498.00;28
3415;9;22572849;3415;307;4406;4434;7.49;0.45;268.68;3.95;991;9;1499.00;28
3415;9;22572872;3415;307;4410;4453;7.48;0.45;268.68;3.94;995;9;1500.00;43
3417;9;22572897;3417;300;4410;4453;7.42;0.45;268.69;3.94;993;9;1501.00;43
3418;9;22572911;3418;295;4413;4457;7.39;0.45;268.73;3.94;995;9;1502.00;44
3422;9;22572924;3422;296;4414;4458;7.38;0.45;268.63;3.94;992;9;1503.00;44
3423;9;22572938;3423;292;4414;4458;7.32;0.45;268.67;3.94;991;9;1504.00;44
3427;9;22572951;3427;289;4417;4459;7.26;0.44;268.67;3.97;990;9;1505.00;42
3430;9;22572967;3430;285;4419;4459;7.22;0.44;268.66;3.97;989;9;1506.00;40
3432;9;22572988;3432;277;4419;4459;7.24;0.44;268.88;3.97;987;9;1507.00;40
3433;9;22573002;3433;279;4419;4459;7.29;0.44;268.90;3.97;986;9;1508.00;40
3434;9;22573015;3434;274;4419;4459;7.34;0.45;268.92;3.97;985;9;1509.00;40
3438;9;22573028;3438;271;4419;4459;7.37;0.45;268.86;3.97;981;9;1510.00;40
3439;9;22573042;3439;267;4420;4459;7.42;0.45;268.85;3.97;981;9;1511.00;39
3442;9;22573057;3442;275;4453;4529;7.41;0.45;268.76;3.94;1011;9;1512.00;76
3446;9;22573078;3446;266;4454;4530;7.45;0.45;268.89;3.94;1008;9;1513.00;76
3448;9;22573092;3448;265;4459;4530;7.51;0.46;268.85;3.94;1011;9;1514.00;71
3450;10;22573105;3450;262;4461;4530;7.58;0.46;268.85;3.94;1011;10;1515.00;69
3452;10;22573131;3452;260;4464;4530;7.66;0.47;268.84;3.94;1012;10;1516.00;66
3453;10;22573153;3453;261;4467;4530;7.74;0.47;268.85;3.94;1014;10;1517.00;63
3458;10;22573167;3458;253;4470;4530;7.80;0.47;268.92;3.95;1012;10;1518.00;60
3458;10;22573180;3458;249;4473;4530;7.86;0.48;268.92;3.95;1015;10;1519.00;57
3463;10;22573193;3463;245;4476;4531;7.88;0.48;268.81;3.95;1013;10;1520.00;55
3466;10;22573208;3466;244;4478;4532;7.94;0.48;268.90;3.96;1012;10;1521.00;54
3468;10;22573224;3468;247;4481;4532;8.03;0.49;268.93;3.98;1013;10;1522.00;51
3473;10;22573239;3473;249;4488;4536;7.94;0.48;269.07;3.98;1015;10;1523.00;48
3475;10;22573257;3475;249;4490;4536;7.94;0.48;269.18;3.98;1015;10;1524.00;46
3477;10;22573271;3477;247;4491;4536;7.98;0.48;269.21;4.00;1014;10;1525.00;45
3481;10;22573288;3481;246;4491;4536;7.99;0.49;269.39;4.00;1010;10;1526.00;45
3482;10;22573302;3482;256;4497;4542;7.96;0.48;269.49;4.02;1015;10;1527.00;45
3484;10;22573318;3484;258;4497;4542;7.95;0.48;269.50;4.02;1013;10;1528.00;45
3487;10;22573335;3487;263;4499;4542;7.88;0.48;269.48;4.05;1012;10;1529.00;43
3490;10;22573351;3490;265;4505;4548;7.85;0.48;269.60;4.09;1015;10;1530.00;43
3492;10;22573365;3492;270;4507;4548;7.91;0.48;269.65;4.09;1015;10;1531.00;41
3494;10;22573378;3494;277;4511;4548;7.90;0.48;269.72;4.12;1017;10;1532.00;37
3498;10;22573396;3498;285;4511;4549;7.96;0.48;269.79;4.12;1013;10;1533.00;38
3504;10;22573409;3504;290;4516;4550;7.99;0.48;269.98;4.15;1012;10;1534.00;34
3506;10;22573425;3506;297;4520;4550;7.91;0.48;270.17;4.21;1014;10;1535.00;30
3509;10;22573440;3509;301;4529;4563;7.87;0.48;270.18;4.23;1020;10;1536.00;34
3512;10;22573455;3512;303;4532;4563;7.81;0.47;270.44;4.26;1020;10;1537.00;31
3516;10;22573475;3516;310;4533;4563;7.69;0.47;270.44;4.28;1017;10;1538.00;30
3519;10;22573491;3519;321;4536;4564;7.59;0.46;270.53;4.31;1017;10;1539.00;28
3522;10;22573507;3522;327;4537;4564;7.49;0.45;270.53;4.33;1015;10;1540.00;27
3526;10;22573521;3526;337;4545;4568;7.37;0.44;270.79;4.36;1019;10;1541.00;23
3526;10;22573536;3526;335;4548;4568;7.32;0.44;270.79;4.38;1022;10;1542.00;20
3528;10;22573549;3528;335;4551;4572;7.27;0.44;271.02;4.38;1023;10;1543.00;21
3532;10;22573590;3532;333;4554;4572;7.18;0.44;271.08;4.41;1022;10;1544.00;18
3532;10;22573607;3532;337;4554;4572;7.17;0.44;271.08;4.41;1022;10;1545.00;18
3535;10;22573621;3535;333;4556;4572;7.06;0.43;271.31;4.42;1021;10;1546.00;16
3537;10;22573634;3537;336;4558;4572;6.97;0.43;271.39;4.44;1021;10;1547.00;14
3540;10;22573647;3540;335;4568;4584;6.95;0.42;271.54;4.43;1028;10;1548.00;16
3540;10;22573663;3540;338;4569;4584;6.96;0.43;271.54;4.43;1029;10;1549.00;15
3546;10;22573678;3546;341;4570;4584;6.95;0.42;271.53;4.44;1024;10;1550.00;14
3547;10;22573694;3547;333;4570;4584;6.97;0.43;271.58;4.44;1023;10;1551.00;14
3549;10;22573708;3549;326;4571;4584;7.00;0.43;271.58;4.45;1022;10;1552.00;13
3552;10;22573722;3552;327;4574;4584;7.07;0.43;271.57;4.48;1022;10;1553.00;10
3556;10;22573740;3556;327;4574;4585;7.12;0.44;271.65;4.48;1018;10;1554.00;11
3558;10;22573754;3558;323;4579;4587;7.17;0.44;271.72;4.50;1021;10;1555.00;8
3559;10;22573770;3559;319;4587;4593;7.31;0.45;271.69;4.51;1028;10;1556.00;6
3561;10;22573787;3561;317;4589;4594;7.40;0.46;271.83;4.51;1028;10;1557.00;5
3563;10;22573802;3563;314;4590;4594;7.47;0.46;271.76;4.51;1027;10;1558.00;4
3567;10;22573816;3567;311;4590;4594;7.51;0.46;271.72;4.51;1023;10;1559.00;4
3570;10;22573831;3570;311;4595;4599;7.51;0.46;271.63;4.51;1025;10;1560.00;4
3573;10;22573848;3573;310;4595;4599;7.48;0.46;271.58;4.51;1022;10;1561.00;4
3576;10;22573864;3576;316;4595;4599;7.48;0.46;271.80;4.51;1019;10;1562.00;4
3577;10;22573878;3577;319;4597;4600;7.52;0.46;271.78;4.51;1020;10;1563.00;3
3584;10;22573900;3584;327;4602;4604;7.49;0.46;271.86;4.51;1018;10;1564.00;2
3587;10;22573915;3587;326;4603;4604;7.48;0.46;271.94;4.51;1016;10;1565.00;1
3590;10;22573928;3590;331;4605;4607;7.51;0.46;272.05;4.51;1015;10;1566.00;2
3595;10;22573949;3595;333;4606;4607;7.46;0.46;272.11;4.51;1011;10;1567.00;1
3603;10;22573969;3603;335;4607;4607;7.36;0.45;272.28;4.51;1004;10;1568.00;0
3608;10;22573987;3608;336;4607;4607;7.28;0.45;272.33;4.51;999;10;1569.00;0
3610;10;22574003;3610;338;4611;4611;7.26;0.44;272.45;4.51;1001;10;1570.00;0
3617;10;22574020;3617;344;4611;4611;7.16;0.44;272.61;4.51;994;10;1571.00;0
3622;10;22574034;3622;345;4611;4611;7.02;0.43;272.61;4.51;989;10;1572.00;0
3628;10;22574047;3628;352;4611;4611;6.85;0.42;272.83;4.51;983;10;1573.00;0
3634;10;22574062;3634;361;4612;4612;6.61;0.40;272.92;4.51;978;10;1574.00;0
3636;10;22574074;3636;353;4614;4614;6.47;0.39;272.87;4.51;978;10;1575.00;0
3639;10;22574087;3639;346;4614;4614;6.36;0.39;272.91;4.51;975;10;1576.00;0
3643;10;22574099;3643;340;4615;4615;6.26;0.38;273.00;4.50;972;10;1577.00;0
3645;10;22574111;3645;343;4615;4615;6.18;0.38;273.11;4.50;970;10;1578.00;0
3648;10;22574127;3648;334;4615;4615;6.12;0.37;273.26;4.50;967;10;1579.00;0
3650;10;22574139;3650;343;4615;4615;6.11;0.37;273.42;4.50;965;10;1580.00;0
3656;10;22574151;3656;337;4615;4615;6.09;0.37;273.43;4.50;959;10;1581.00;0
3663;10;22574163;3663;335;4615;4615;6.05;0.37;273.36;4.50;952;10;1582.00;0
3666;10;22574176;3666;330;4615;4615;6.05;0.37;273.53;4.50;949;10;1583.00;0
3668;10;22574190;3668;340;4690;4742;6.38;0.40;273.58;4.43;1022;10;1584.00;52
3671;10;22574216;3671;335;4695;4743;6.38;0.40;273.66;4.43;1024;10;1585.00;48
3674;10;22574231;3674;324;4704;4743;6.35;0.40;273.93;4.42;1030;10;1586.00;39
3676;10;22574243;3676;334;4705;4743;6.30;0.39;274.08;4.42;1029;10;1587.00;38
3679;10;22574257;3679;337;4710;4743;6.26;0.39;274.15;4.42;1031;10;1588.00;33
3680;10;22574270;3680;351;4710;4743;6.22;0.39;274.24;4.42;1030;10;1589.00;33
3686;10;22574296;3686;356;4714;4743;6.15;0.38;274.31;4.43;1028;10;1590.00;29
3691;10;22574311;3691;373;4717;4743;6.08;0.38;274.64;4.43;1026;10;1591.00;26
3694;10;22574325;3694;377;4720;4744;6.07;0.38;274.72;4.43;1026;10;1592.00;24
3694;10;22574339;3694;380;4725;4745;6.10;0.38;274.72;4.43;1031;10;1593.00;20
3699;10;22574353;3699;381;4728;4745;6.05;0.38;274.81;4.44;1029;10;1594.00;17
3701;10;22574371;3701;382;4731;4746;6.03;0.37;274.96;4.44;1030;10;1595.00;15
3707;10;22574387;3707;382;4732;4746;6.03;0.37;274.98;4.44;1025;10;1596.00;14
3712;10;22574407;3712;390;4735;4746;6.02;0.37;275.12;4.45;1023;10;1597.00;11
3717;10;22574425;3717;397;4738;4746;5.99;0.37;275.09;4.45;1021;10;1598.00;8
3722;10;22574441;3722;405;4742;4750;5.92;0.37;275.17;4.45;1020;10;1599.00;8
3725;10;22574461;3725;412;4743;4750;5.90;0.36;275.25;4.45;1018;10;1600.00;7
3730;10;22574485;3730;418;4743;4750;5.87;0.36;275.25;4.45;1013;10;1601.00;7
3734;10;22574499;3734;422;4745;4753;5.80;0.36;275.38;4.46;1011;10;1602.00;8
3738;10;22574512;3738;424;4746;4753;5.70;0.35;275.34;4.46;1008;10;1603.00;7
3740;10;22574526;3740;422;4747;4753;5.67;0.35;275.44;4.46;1007;10;1604.00;6
3746;10;22574542;3746;423;4751;4757;5.59;0.34;275.54;4.46;1005;10;1605.00;6
3749;10;22574567;3749;437;4753;4758;5.51;0.34;275.42;4.46;1004;10;1606.00;5
3755;10;22574595;3755;438;4754;4758;5.45;0.34;275.33;4.47;999;10;1607.00;4
3758;10;22574614;3758;443;4756;4762;5.44;0.33;275.26;4.46;998;10;1608.00;6
3764;10;22574626;3764;439;4757;4762;5.36;0.33;275.21;4.46;993;10;1609.00;5
3767;10;22574640;3767;437;4759;4762;5.35;0.33;275.14;4.47;992;10;1610.00;3
3770;10;22574655;3770;434;4759;4763;5.36;0.33;275.26;4.47;989;10;1611.00;4
3773;10;22574667;3773;441;4760;4763;5.31;0.33;275.24;4.47;987;10;1612.00;3
3778;10;22574679;3778;444;4764;4769;5.30;0.32;275.27;4.46;986;10;1613.00;5
3779;10;22574692;3779;444;4765;4769;5.28;0.32;275.23;4.46;986;10;1614.00;4
3781;10;22574709;3781;445;4765;4770;5.30;0.32;275.19;4.46;984;10;1615.00;5
3784;10;22574725;3784;456;4765;4770;5.27;0.32;275.18;4.46;981;10;1616.00;5
3786;10;22574739;3786;455;4765;4770;5.26;0.32;275.15;4.46;979;10;1617.00;5
3791;10;22574753;3791;461;4765;4770;5.19;0.32;275.21;4.46;974;10;1618.00;5
3794;10;22574769;3794;462;4765;4770;5.18;0.32;275.03;4.46;971;10;1619.00;5
3796;10;22574785;3796;469;4792;4806;5.32;0.33;275.09;4.44;996;10;1620.00;14
3797;10;22574801;3797;468;4793;4806;5.28;0.32;275.06;4.44;996;10;1621.00;13
3799;10;22574816;3799;455;4796;4806;5.35;0.33;275.03;4.43;997;10;1622.00;10
3802;10;22574832;3802;455;4796;4806;5.33;0.33;274.91;4.43;994;10;1623.00;10
3804;10;22574848;3804;456;4797;4806;5.38;0.33;274.86;4.43;993;10;1624.00;9
3804;10;22574861;3804;444;4797;4806;5.48;0.34;274.86;4.43;993;10;1625.00;9
3805;10;22574874;3805;444;4801;4810;5.55;0.34;274.84;4.43;996;10;1626.00;9
3807;10;22574890;3807;446;4801;4810;5.56;0.34;274.84;4.43;994;10;1627.00;9
3810;10;22574908;3810;445;4805;4814;5.59;0.34;274.72;4.43;995;10;1628.00;9
3812;10;22574928;3812;450;4806;4815;5.61;0.34;274.78;4.43;994;10;1629.00;9
3814;10;22574955;3814;458;4806;4815;5.55;0.34;274.84;4.43;992;10;1630.00;9
3815;10;22574988;3815;444;4806;4815;5.54;0.34;274.82;4.43;991;10;1631.00;9
3815;10;22575008;3815;439;4817;4828;5.61;0.34;274.82;4.42;1002;10;1632.00;11
3817;10;22575030;3817;432;4817;4828;5.61;0.34;274.89;4.42;1000;10;1633.00;11
3818;10;22575050;3818;419;4817;4828;5.67;0.35;274.89;4.42;999;10;1634.00;11
3820;10;22575069;3820;411;4818;4829;5.77;0.35;274.94;4.42;998;10;1635.00;11
3822;10;22575090;3822;407;4818;4830;5.88;0.36;274.91;4.42;996;10;1636.00;12
3823;10;22575111;3823;388;4818;4830;5.99;0.37;274.92;4.42;995;10;1637.00;12
3825;10;22575135;3825;376;4820;4833;6.12;0.37;274.95;4.42;995;10;1638.00;13
3827;10;22575153;3827;370;4820;4833;6.23;0.38;274.98;4.42;993;10;1639.00;13
3827;10;22575169;3827;359;4821;4833;6.36;0.39;274.98;4.42;994;10;1640.00;12
3830;10;22575202;3830;354;4821;4833;6.45;0.39;274.95;4.42;991;10;1641.00;12
3830;10;22575220;3830;347;4826;4839;6.53;0.40;274.95;4.41;996;10;1642.00;13
3831;11;22575236;3831;339;4826;4839;6.64;0.40;274.93;4.41;995;11;1643.00;13
3832;11;22575271;3832;330;4826;4839;6.70;0.41;274.91;4.41;994;11;1644.00;13
3833;11;22575289;3833;321;4826;4839;6.79;0.41;274.91;4.41;993;11;1645.00;13
3834;11;22575307;3834;325;4829;4843;6.88;0.42;274.91;4.41;995;11;1646.00;14
3835;11;22575324;3835;315;4830;4844;7.02;0.43;274.97;4.41;995;11;1647.00;14
3837;11;22575342;3837;319;4830;4844;7.14;0.43;274.88;4.41;993;11;1648.00;14
3837;11;22575360;3837;315;4831;4845;7.27;0.44;274.88;4.41;994;11;1649.00;14
3840;11;22575380;3840;311;4831;4845;7.35;0.45;274.87;4.41;991;11;1650.00;14
3843;11;22575402;3843;310;4831;4845;7.35;0.44;274.89;4.41;988;11;1651.00;14
3843;11;22575430;3843;308;4831;4845;7.34;0.44;274.89;4.41;988;11;1652.00;14
3844;11;22575445;3844;307;4831;4845;7.33;0.44;274.87;4.41;987;11;1653.00;14
3846;11;22575459;3846;307;4831;4845;7.28;0.44;274.91;4.41;985;11;1654.00;14
3848;11;22575473;3848;306;4831;4845;7.25;0.44;274.90;4.41;983;11;1655.00;14
3848;11;22575489;3848;311;4867;4915;7.24;0.44;274.90;4.38;1019;11;1656.00;48
3848;11;22575510;3848;308;4867;4916;7.23;0.44;274.90;4.38;1019;11;1657.00;49
3851;11;22575526;3851;305;4874;4916;7.29;0.44;274.93;4.37;1023;11;1658.00;42
3853;11;22575541;3853;306;4878;4916;7.32;0.44;274.99;4.37;1025;11;1659.00;38
3854;11;22575557;3854;303;4880;4916;7.29;0.44;274.95;4.37;1026;11;1660.00;36
3856;11;22575571;3856;304;4884;4916;7.27;0.44;275.13;4.37;1028;11;1661.00;32
3861;11;22575591;3861;311;4886;4916;7.22;0.44;275.14;4.37;1025;11;1662.00;30
3863;11;22575615;3863;309;4888;4916;7.22;0.44;275.11;4.37;1025;11;1663.00;28
3865;11;22575642;3865;319;4890;4917;7.22;0.44;275.29;4.38;1025;11;1664.00;27
3866;11;22575662;3866;314;4893;4919;7.24;0.44;275.35;4.38;1027;11;1665.00;26
3868;11;22575684;3868;319;4895;4919;7.30;0.44;275.39;4.38;1027;11;1666.00;24
3870;11;22575704;3870;309;4900;4923;7.36;0.45;275.49;4.38;1030;11;1667.00;23
3871;11;22575726;3871;304;4903;4923;7.42;0.45;275.57;4.38;1032;11;1668.00;20
3874;11;22575759;3874;299;4903;4923;7.41;0.45;275.57;4.38;1029;11;1669.00;20
3876;11;22575784;3876;299;4903;4923;7.47;0.45;275.52;4.38;1027;11;1670.00;20
3879;11;22575806;3879;295;4907;4929;7.44;0.45;275.48;4.38;1028;11;1671.00;22
3884;11;22575830;3884;299;4907;4929;7.48;0.45;275.55;4.38;1023;11;1672.00;22
3887;11;22575851;3887;297;4907;4929;7.55;0.46;275.67;4.38;1020;11;1673.00;22
3889;11;22575873;3889;299;4909;4932;7.62;0.46;275.67;4.38;1020;11;1674.00;23
3891;11;22575903;3891;295;4909;4932;7.63;0.46;275.84;4.38;1018;11;1675.00;23
3894;11;22575924;3894;294;4910;4932;7.57;0.46;275.97;4.38;1016;11;1676.00;22
3897;11;22575950;3897;297;4910;4933;7.54;0.46;276.15;4.38;1013;11;1677.00;23
3903;11;22575974;3903;296;4911;4934;7.53;0.46;276.18;4.37;1008;11;1678.00;23
3907;11;22575999;3907;283;4911;4934;7.54;0.46;276.28;4.37;1004;11;1679.00;23
3911;11;22576026;3911;282;4932;4960;7.50;0.46;276.32;4.37;1021;11;1680.00;28
3914;11;22576052;3914;273;4932;4960;7.49;0.45;276.29;4.37;1018;11;1681.00;28
3918;11;22576074;3918;268;4933;4960;7.52;0.46;276.32;4.37;1015;11;1682.00;27
3920;11;22576098;3920;261;4935;4961;7.54;0.46;276.31;4.37;1015;11;1683.00;26
3922;11;22576118;3922;250;4935;4961;7.60;0.46;276.38;4.37;1013;11;1684.00;26
3924;11;22576157;3924;251;4938;4965;7.72;0.47;276.51;4.37;1014;11;1685.00;27
3926;11;22576181;3926;244;4938;4965;7.76;0.47;276.60;4.37;1012;11;1686.00;27
3927;11;22576203;3927;243;4941;4969;7.79;0.47;276.71;4.37;1014;11;1687.00;28
3930;11;22576227;3930;245;4941;4969;7.86;0.48;276.77;4.37;1011;11;1688.00;28
3931;11;22576249;3931;239;4941;4969;7.98;0.48;276.76;4.37;1010;11;1689.00;28
3933;11;22576269;3933;236;4941;4969;8.05;0.49;276.93;4.37;1008;11;1690.00;28
3935;11;22576290;3935;233;4942;4969;8.14;0.49;276.88;4.38;1007;11;1691.00;27
3938;11;22576313;3938;234;4951;4981;8.20;0.50;276.98;4.38;1013;11;1692.00;30
3943;11;22576334;3943;229;4952;4981;8.19;0.49;276.97;4.37;1009;11;1693.00;29
3945;11;22576363;3945;227;4953;4981;8.27;0.50;276.92;4.37;1008;11;1694.00;28
3947;11;22576392;3947;226;4953;4981;8.27;0.50;277.05;4.37;1006;11;1695.00;28
3949;11;22576418;3949;229;4953;4981;8.28;0.50;277.02;4.37;1004;11;1696.00;28
3951;11;22576442;3951;229;4954;4981;8.27;0.50;277.01;4.38;1003;11;1697.00;27
3952;11;22576470;3952;236;4954;4982;8.26;0.50;277.04;4.38;1002;11;1698.00;28
3953;11;22576498;3953;230;4954;4982;8.23;0.50;277.17;4.38;1001;11;1699.00;28
3954;11;22576520;3954;233;4959;4988;8.24;0.50;277.29;4.38;1005;11;1700.00;29
3956;11;22576554;3956;237;4962;4989;8.15;0.49;277.25;4.41;1006;11;1701.00;27
3958;11;22576575;3958;241;4963;4989;8.18;0.50;277.26;4.41;1005;11;1702.00;26
3959;11;22576595;3959;242;4965;4989;8.17;0.50;277.35;4.41;1006;11;1703.00;24
3961;11;22576614;3961;253;4968;4993;8.19;0.50;277.49;4.41;1007;11;1704.00;25
3963;11;22576635;3963;245;4970;4993;8.11;0.49;277.44;4.44;1007;11;1705.00;23
3965;11;22576680;3965;251;4970;4993;8.09;0.49;277.46;4.44;1005;11;1706.00;23
3968;11;22576701;3968;251;4972;4994;8.04;0.49;277.63;4.46;1004;11;1707.00;22
3973;11;22576727;3973;253;4976;4998;7.96;0.49;277.83;4.47;1003;11;1708.00;22
3977;11;22576752;3977;257;4976;4998;7.95;0.48;277.96;4.47;999;11;1709.00;22
3981;11;22576787;3981;267;4982;5004;7.96;0.49;277.93;4.49;1001;11;1710.00;22
3986;11;22576818;3986;267;4983;5004;7.93;0.48;277.95;4.49;997;11;1711.00;21
3988;11;22576839;3988;268;4985;5004;7.95;0.48;278.02;4.50;997;11;1712.00;19
3994;11;22576859;3994;266;4985;5004;7.99;0.49;278.23;4.50;991;11;1713.00;19
3994;11;22576883;3994;276;4992;5008;8.10;0.49;278.23;4.54;998;11;1714.00;16
4001;11;22576902;4001;276;4992;5008;8.07;0.49;278.42;4.54;991;11;1715.00;16
4003;11;22576923;4003;271;4993;5008;8.05;0.49;278.55;4.55;990;11;1716.00;15
4006;11;22576950;4006;274;4993;5008;7.99;0.49;278.72;4.55;987;11;1717.00;15
4010;11;22576968;4010;268;4994;5009;7.91;0.48;278.74;4.57;984;11;1718.00;15
4013;11;22576990;4013;269;4996;5010;7.86;0.48;278.81;4.58;983;11;1719.00;14
4015;11;22577008;4015;268;4996;5010;7.74;0.47;278.97;4.58;981;11;1720.00;14
4019;11;22577028;4019;270;4998;5011;7.64;0.47;279.15;4.60;979;11;1721.00;13
4024;11;22577049;4024;278;4999;5011;7.50;0.46;279.17;4.61;975;11;1722.00;12
4027;11;22577066;4027;285;5000;5011;7.47;0.46;279.18;4.62;973;11;1723.00;11
4031;11;22577083;4031;280;5001;5011;7.39;0.45;279.26;4.63;970;11;1724.00;10
4034;11;22577101;4034;280;5001;5011;7.37;0.45;279.19;4.63;967;11;1725.00;10
4035;11;22577120;4035;281;5004;5011;7.37;0.45;279.27;4.66;969;11;1726.00;7
4038;11;22577136;4038;277;5004;5011;7.36;0.45;279.38;4.66;966;11;1727.00;7
4040;11;22577152;4040;294;5071;5138;7.49;0.47;279.40;4.60;1031;11;1728.00;67
4041;11;22577183;4041;291;5074;5139;7.53;0.47;279.44;4.61;1033;11;1729.00;65
4046;11;22577202;4046;291;5082;5139;7.60;0.47;279.50;4.60;1036;11;1730.00;57
4050;11;22577222;4050;291;5087;5139;7.60;0.47;279.54;4.61;1037;11;1731.00;52
4053;11;22577239;4053;292;5095;5139;7.55;0.47;279.48;4.62;1042;11;1732.00;44
4055;11;22577260;4055;289;5098;5139;7.47;0.46;279.61;4.62;1043;11;1733.00;41
4059;11;22577278;4059;295;5104;5139;7.40;0.46;279.59;4.63;1045;11;1734.00;35
4062;11;22577296;4062;298;5106;5139;7.36;0.45;279.74;4.63;1044;11;1735.00;33
4065;11;22577326;4065;301;5109;5140;7.30;0.45;279.77;4.64;1044;11;1736.00;31
4066;11;22577344;4066;308;5112;5141;7.32;0.45;279.80;4.64;1046;11;1737.00;29
4068;11;22577366;4068;306;5113;5141;7.32;0.45;279.84;4.64;1045;11;1738.00;28
4072;11;22577387;4072;313;5118;5142;7.22;0.44;279.96;4.65;1046;11;1739.00;24
4073;11;22577425;4073;312;5123;5142;7.14;0.44;280.00;4.66;1050;11;1740.00;19
4076;11;22577447;4076;321;5125;5142;7.01;0.43;279.92;4.66;1049;11;1741.00;17
4078;11;22577466;4078;327;5129;5142;6.91;0.42;280.00;4.66;1051;11;1742.00;13
4083;11;22577483;4083;340;5132;5146;6.88;0.42;280.05;4.67;1049;11;1743.00;14
4087;11;22577501;4087;342;5137;5146;6.77;0.41;280.13;4.67;1050;11;1744.00;9
4092;11;22577520;4092;348;5138;5146;6.63;0.41;280.04;4.67;1046;11;1745.00;8
4095;11;22577539;4095;356;5140;5149;6.49;0.40;280.21;4.68;1045;11;1746.00;9
4100;11;22577556;4100;363;5141;5149;6.39;0.39;280.21;4.68;1041;11;1747.00;8
4102;11;22577572;4102;379;5142;5149;6.24;0.38;280.22;4.68;1040;11;1748.00;7
4104;11;22577588;4104;384;5149;5153;6.07;0.37;280.28;4.69;1045;11;1749.00;4
4111;11;22577605;4111;377;5151;5154;5.92;0.36;280.26;4.69;1040;11;1750.00;3
4114;11;22577622;4114;377;5151;5154;5.83;0.36;280.30;4.69;1037;11;1751.00;3
4119;11;22577637;4119;379;5156;5158;5.82;0.35;280.38;4.69;1037;11;1752.00;2
4124;11;22577680;4124;380;5156;5158;5.78;0.35;280.46;4.69;1032;11;1753.00;2
4127;11;22577695;4127;381;5157;5158;5.74;0.35;280.60;4.69;1030;11;1754.00;1
4131;11;22577711;4131;382;5159;5160;5.70;0.35;280.72;4.69;1028;11;1755.00;1
4136;11;22577726;4136;386;5160;5160;5.70;0.35;280.87;4.69;1024;11;1756.00;0
4137;11;22577743;4137;388;5165;5166;5.76;0.35;280.93;4.68;1028;11;1757.00;1
4139;11;22577760;4139;381;5166;5166;5.74;0.35;281.03;4.68;1027;11;1758.00;0
4143;11;22577778;4143;381;5167;5167;5.71;0.35;281.35;4.68;1024;11;1759.00;0
4146;11;22577792;4146;386;5167;5167;5.68;0.35;281.39;4.68;1021;11;1760.00;0
4149;11;22577807;4149;389;5167;5167;5.59;0.34;281.68;4.68;1018;11;1761.00;0
4152;11;22577822;4152;392;5167;5167;5.51;0.34;281.80;4.68;1015;11;1762.00;0
4154;11;22577836;4154;395;5167;5167;5.45;0.33;281.92;4.68;1013;11;1763.00;0
4157;11;22577852;4157;395;5178;5179;5.46;0.34;281.98;4.67;1021;11;1764.00;1
4161;11;22577869;4161;395;5178;5179;5.40;0.33;282.07;4.67;1017;11;1765.00;1
4166;11;22577886;4166;407;5179;5179;5.35;0.33;282.08;4.67;1013;11;1766.00;0
4169;11;22577903;4169;408;5179;5179;5.33;0.33;282.11;4.67;1010;11;1767.00;0
4173;11;22577920;4173;416;5179;5179;5.24;0.32;282.16;4.67;1006;11;1768.00;0
4177;11;22577936;4177;425;5179;5179;5.17;0.32;282.28;4.67;1002;11;1769.00;0
4184;11;22577955;4184;424;5182;5183;5.14;0.31;282.21;4.67;998;11;1770.00;1
4184;11;22577980;4184;436;5182;5183;5.13;0.31;282.21;4.67;998;11;1771.00;1
4189;11;22578001;4189;430;5186;5187;5.15;0.32;282.21;4.67;997;11;1772.00;1
4194;11;22578029;4194;443;5186;5188;5.15;0.32;282.11;4.67;992;11;1773.00;2
4197;11;22578047;4197;445;5187;5188;5.16;0.32;282.05;4.67;990;11;1774.00;1
4202;11;22578064;4202;448;5187;5188;5.11;0.31;282.00;4.67;985;11;1775.00;1
4207;11;22578081;4207;454;5198;5201;5.21;0.32;281.94;4.66;991;11;1776.00;3
4212;11;22578100;4212;452;5198;5201;5.23;0.32;281.92;4.66;986;11;1777.00;3
4216;11;22578115;4216;456;5198;5201;5.20;0.32;281.84;4.66;982;11;1778.00;3
4220;11;22578129;4220;456;5199;5202;5.22;0.32;281.79;4.65;979;11;1779.00;3
4224;11;22578142;4224;457;5199;5203;5.25;0.32;281.72;4.65;975;11;1780.00;4
4229;11;22578157;4229;459;5199;5203;5.26;0.32;281.61;4.65;970;11;1781.00;4
4234;11;22578172;4234;456;5201;5206;5.28;0.32;281.68;4.65;967;11;1782.00;5
4237;11;22578187;4237;458;5201;5206;5.28;0.32;281.67;4.65;964;11;1783.00;5
4239;11;22578203;4239;460;5202;5206;5.28;0.32;281.67;4.65;963;11;1784.00;4
4242;11;22578217;4242;457;5202;5206;5.24;0.32;281.76;4.65;960;11;1785.00;4
4245;11;22578232;4245;462;5207;5212;5.27;0.32;281.86;4.65;962;11;1786.00;5
4250;11;22578247;4250;460;5207;5212;5.25;0.32;281.79;4.65;957;11;1787.00;5
4254;11;22578261;4254;460;5207;5212;5.21;0.32;281.82;4.65;953;11;1788.00;5
4258;11;22578275;4258;465;5207;5212;5.17;0.32;281.74;4.65;949;11;1789.00;5
4261;11;22578289;4261;461;5210;5216;5.21;0.32;281.78;4.65;949;11;1790.00;6
4261;11;22578305;4261;465;5211;5217;5.20;0.32;281.78;4.65;950;11;1791.00;6
4265;11;22578319;4265;474;5211;5217;5.11;0.31;281.75;4.65;946;11;1792.00;6
4269;11;22578332;4269;474;5212;5218;5.04;0.31;281.77;4.65;943;11;1793.00;6
4270;11;22578345;4270;472;5212;5218;5.00;0.31;281.82;4.65;942;11;1794.00;6
4272;11;22578357;4272;458;5212;5218;4.96;0.30;281.84;4.65;940;11;1795.00;6
4273;11;22578376;4273;459;5212;5218;4.96;0.30;281.87;4.65;939;11;1796.00;6
4277;11;22578391;4277;444;5212;5218;5.01;0.31;281.77;4.65;935;11;1797.00;6
4278;11;22578408;4278;428;5212;5218;5.08;0.31;281.78;4.65;934;11;1798.00;6
4279;11;22578427;4279;416;5212;5218;5.18;0.32;281.81;4.65;933;11;1799.00;6
4282;11;22578450;4282;427;5283;5356;5.71;0.36;281.96;4.58;1001;11;1800.00;73
4283;11;22578504;4283;413;5287;5357;5.88;0.37;281.98;4.58;1004;11;1801.00;70
4285;11;22578520;4285;406;5298;5357;6.05;0.38;282.03;4.57;1013;11;1802.00;59
4288;11;22578537;4288;393;5301;5357;6.14;0.38;282.05;4.57;1013;11;1803.00;56
4290;11;22578553;4290;385;5307;5357;6.24;0.38;282.07;4.57;1017;11;1804.00;50
4292;11;22578568;4292;388;5307;5357;6.28;0.39;282.17;4.57;1015;11;1805.00;50
4294;11;22578584;4294;366;5314;5357;6.34;0.39;282.18;4.58;1020;11;1806.00;43
4297;11;22578599;4297;354;5319;5357;6.40;0.39;282.25;4.58;1022;11;1807.00;38
4299;11;22578616;4299;346;5325;5358;6.42;0.39;282.31;4.58;1026;11;1808.00;33
4299;11;22578637;4299;338;5328;5359;6.49;0.40;282.31;4.58;1029;11;1809.00;31
4302;11;22578654;4302;337;5332;5359;6.58;0.40;282.34;4.59;1030;11;1810.00;27
4302;11;22578669;4302;337;5338;5363;6.67;0.41;282.34;4.59;1036;11;1811.00;25
4302;11;22578686;4302;344;5339;5363;6.74;0.41;282.34;4.59;1037;11;1812.00;24
4303;11;22578700;4303;344;5339;5363;6.83;0.42;282.36;4.59;1036;11;1813.00;24
4303;11;22578719;4303;347;5341;5363;6.87;0.42;282.36;4.59;1038;11;1814.00;22
4304;11;22578734;4304;351;5345;5369;6.87;0.42;282.47;4.59;1041;11;1815.00;24
4306;11;22578750;4306;354;5346;5369;6.89;0.42;282.56;4.59;1040;11;1816.00;23
4308;11;22578766;4308;357;5346;5369;6.91;0.42;282.80;4.59;1038;11;1817.00;23
4313;11;22578784;4313;355;5349;5372;6.92;0.42;282.72;4.59;1036;11;1818.00;23
4317;11;22578802;4317;349;5349;5372;6.91;0.42;282.83;4.59;1032;11;1819.00;23
4319;11;22578818;4319;342;5350;5372;6.95;0.42;282.89;4.60;1031;11;1820.00;22
4324;11;22578834;4324;339;5351;5373;6.96;0.42;282.96;4.60;1027;11;1821.00;22
4326;11;22578852;4326;340;5353;5374;6.94;0.42;283.09;4.60;1027;11;1822.00;21
4326;11;22578869;4326;337;5353;5374;6.96;0.42;283.09;4.60;1027;11;1823.00;21
4326;11;22578885;4326;332;5361;5387;7.02;0.43;283.09;4.59;1035;11;1824.00;26
4327;11;22578902;4327;331;5362;5387;7.05;0.43;283.18;4.59;1035;11;1825.00;25
4329;11;22578918;4329;334;5362;5387;7.13;0.43;283.20;4.59;1033;11;1826.00;25
4332;11;22578951;4332;335;5363;5388;7.20;0.44;283.50;4.60;1031;11;1827.00;25
4333;11;22578974;4333;340;5364;5388;7.22;0.44;283.61;4.59;1031;11;1828.00;24
4334;11;22578999;4334;336;5367;5392;7.26;0.44;283.57;4.59;1033;11;1829.00;25
4338;11;22579044;4338;333;5367;5392;7.25;0.44;283.66;4.59;1029;11;1830.00;25
4341;11;22579067;4341;338;5372;5396;7.21;0.44;283.81;4.59;1031;11;1831.00;24
4344;11;22579086;4344;335;5372;5396;7.19;0.44;283.81;4.59;1028;11;1832.00;24
4346;11;22579106;4346;339;5372;5396;7.17;0.44;283.85;4.59;1026;11;1833.00;24
4350;11;22579123;4350;346;5373;5396;7.10;0.43;283.90;4.59;1023;11;1834.00;23
4353;11;22579139;4353;350;5373;5396;7.03;0.43;284.00;4.59;1020;11;1835.00;23
4355;11;22579158;4355;352;5383;5408;7.05;0.43;284.05;4.58;1028;11;1836.00;25
4356;11;22579186;4356;352;5384;5408;7.07;0.43;284.12;4.58;1028;11;1837.00;24
4358;11;22579205;4358;350;5384;5408;7.04;0.43;284.10;4.58;1026;11;1838.00;24
4358;11;22579221;4358;347;5384;5408;7.06;0.43;284.10;4.58;1026;11;1839.00;24
4362;11;22579239;4362;347;5385;5408;7.11;0.43;284.31;4.58;1023;11;1840.00;23
4364;11;22579263;4364;341;5385;5408;7.24;0.44;284.36;4.58;1021;11;1841.00;23
4366;11;22579285;4366;336;5385;5409;7.28;0.45;284.32;4.58;1019;11;1842.00;24
4369;11;22579314;4369;329;5385;5409;7.30;0.45;284.27;4.58;1016;11;1843.00;24
4374;11;22579332;4374;316;5390;5415;7.36;0.45;284.43;4.58;1016;11;1844.00;25
4377;11;22579352;4377;309;5392;5417;7.37;0.45;284.41;4.58;1015;11;1845.00;25
4382;11;22579370;4382;308;5392;5417;7.37;0.45;284.51;4.58;1010;11;1846.00;25
4385;11;22579391;4385;308;5392;5417;7.32;0.45;284.55;4.58;1007;11;1847.00;25
4386;11;22579414;4386;312;5395;5421;7.33;0.45;284.56;4.58;1009;11;1848.00;26
4389;11;22579432;4389;305;5395;5421;7.35;0.45;284.60;4.58;1006;11;1849.00;26
4390;11;22579452;4390;304;5395;5421;7.37;0.45;284.66;4.58;1005;11;1850.00;26
4391;11;22579475;4391;298;5396;5422;7.38;0.45;284.71;4.58;1005;11;1851.00;26
4395;11;22579495;4395;304;5399;5426;7.33;0.45;284.69;4.57;1004;11;1852.00;27
4398;11;22579514;4398;298;5399;5426;7.25;0.44;284.81;4.57;1001;11;1853.00;27
4404;11;22579537;4404;287;5401;5429;7.24;0.44;284.90;4.57;997;11;1854.00;28
4407;11;22579560;4407;284;5404;5429;7.26;0.44;285.06;4.60;997;11;1855.00;25
4410;11;22579586;4410;275;5404;5429;7.22;0.44;285.11;4.60;994;11;1856.00;25
4412;11;22579615;4412;271;5404;5429;7.20;0.44;285.17;4.60;992;11;1857.00;25
4416;11;22579632;4416;262;5408;5433;7.24;0.44;285.45;4.60;992;11;1858.00;25
4419;11;22579657;4419;266;5408;5433;7.31;0.45;285.43;4.60;989;11;1859.00;25
4421;11;22579686;4421;269;5408;5433;7.30;0.44;285.33;4.60;987;11;1860.00;25
4424;11;22579706;4424;264;5408;5433;7.30;0.45;285.54;4.60;984;11;1861.00;25
4427;11;22579724;4427;264;5408;5434;7.37;0.45;285.63;4.60;981;11;1862.00;26
4433;11;22579746;4433;262;5409;5435;7.36;0.45;285.71;4.60;976;11;1863.00;26
4435;11;22579764;4435;259;5409;5435;7.36;0.45;285.78;4.60;974;11;1864.00;26
4436;11;22579778;4436;261;5410;5436;7.38;0.45;285.91;4.60;974;11;1865.00;26
4439;11;22579793;4439;263;5410;5436;7.40;0.45;285.98;4.60;971;11;1866.00;26
4442;11;22579807;4442;254;5410;5436;7.38;0.45;286.06;4.60;968;11;1867.00;26
4446;11;22579823;4446;253;5410;5436;7.38;0.45;286.18;4.60;964;11;1868.00;26
4447;11;22579838;4447;256;5410;5436;7.42;0.45;286.23;4.60;963;11;1869.00;26
4451;11;22579853;4451;258;5410;5436;7.33;0.44;286.14;4.60;959;11;1870.00;26
4455;11;22579868;4455;259;5410;5436;7.25;0.44;286.19;4.60;955;11;1871.00;26
4458;11;22579883;4458;278;5476;5563;7.30;0.45;286.08;4.55;1018;11;1872.00;87
4461;11;22579912;4461;268;5478;5564;7.32;0.45;286.16;4.55;1017;11;1873.00;86
4463;11;22579929;4463;265;5486;5564;7.36;0.45;286.17;4.55;1023;11;1874.00;78
4465;11;22579944;4465;262;5487;5564;7.38;0.45;286.21;4.55;1022;11;1875.00;77
4466;11;22579963;4466;253;5494;5564;7.47;0.46;286.31;4.55;1028;11;1876.00;70
4469;11;22579982;4469;250;5497;5564;7.51;0.46;286.29;4.55;1028;11;1877.00;67
4472;11;22580000;4472;249;5499;5564;7.57;0.47;286.25;4.55;1027;11;1878.00;65
4473;11;22580019;4473;249;5503;5564;7.67;0.47;286.27;4.55;1030;11;1879.00;61
4476;11;22580037;4476;253;5508;5565;7.72;0.47;286.33;4.59;1032;11;1880.00;57
4477;11;22580057;4477;254;5510;5566;7.82;0.48;286.31;4.59;1033;11;1881.00;56
4481;11;22580074;4481;258;5514;5568;7.91;0.49;286.33;4.59;1033;11;1882.00;54
4483;11;22580092;4483;257;5519;5569;7.97;0.49;286.33;4.63;1036;11;1883.00;50
4487;11;22580116;4487;255;5521;5569;7.96;0.49;286.25;4.63;1034;11;1884.00;48
4489;11;22580135;4489;259;5524;5569;7.90;0.48;286.33;4.66;1035;11;1885.00;45
4491;11;22580152;4491;264;5527;5569;7.88;0.48;286.33;4.67;1036;11;1886.00;42
4493;11;22580170;4493;270;5534;5573;7.83;0.48;286.38;4.70;1041;11;1887.00;39
4495;11;22580189;4495;278;5537;5573;7.74;0.48;286.41;4.72;1042;11;1888.00;36
4502;11;22580207;4502;287;5539;5573;7.62;0.47;286.72;4.73;1037;11;1889.00;34
4504;11;22580225;4504;296;5545;5579;7.51;0.46;286.66;4.74;1041;11;1890.00;34
4506;11;22580243;4506;303;5546;5579;7.44;0.46;286.63;4.76;1040;11;1891.00;33
4508;11;22580261;4508;318;5548;5579;7.37;0.45;286.85;4.76;1040;11;1892.00;31
4510;11;22580276;4510;319;5551;5583;7.32;0.45;286.93;4.76;1041;11;1893.00;32
4511;11;22580294;4511;320;5555;5584;7.26;0.45;286.93;4.80;1044;11;1894.00;29
4514;11;22580309;4514;327;5557;5584;7.13;0.44;286.91;4.81;1043;11;1895.00;27
4518;11;22580326;4518;332;5562;5588;7.02;0.43;286.96;4.83;1044;11;1896.00;26
4522;11;22580356;4522;335;5565;5588;6.96;0.43;286.86;4.84;1043;11;1897.00;23
4524;11;22580388;4524;334;5567;5588;6.90;0.42;286.88;4.86;1043;11;1898.00;21
4527;11;22580414;4527;335;5570;5589;6.86;0.42;287.11;4.87;1043;11;1899.00;19
4528;11;22580434;4528;331;5572;5589;6.82;0.42;287.25;4.87;1044;11;1900.00;17
4529;11;22580457;4529;328;5578;5595;6.88;0.42;287.29;4.88;1049;11;1901.00;17
4533;11;22580477;4533;321;5580;5595;6.82;0.42;287.24;4.88;1047;11;1902.00;15
4535;11;22580497;4535;316;5581;5596;6.82;0.42;287.32;4.89;1046;11;1903.00;15
4539;11;22580516;4539;316;5581;5596;6.80;0.42;287.43;4.89;1042;11;1904.00;15
4542;11;22580531;4542;326;5582;5596;6.78;0.42;287.55;4.90;1040;11;1905.00;14
4545;11;22580547;4545;327;5582;5596;6.72;0.41;287.50;4.90;1037;11;1906.00;14
4548;11;22580564;4548;327;5582;5596;6.66;0.41;287.45;4.90;1034;11;1907.00;14
4551;11;22580580;4551;326;5594;5608;6.67;0.41;287.42;4.91;1043;11;1908.00;14
4554;11;22580597;4554;326;5596;5608;6.66;0.41;287.52;4.92;1042;11;1909.00;12
4556;11;22580611;4556;326;5597;5608;6.65;0.41;287.61;4.93;1041;11;1910.00;11
4562;11;22580628;4562;332;5597;5608;6.60;0.40;287.58;4.93;1035;11;1911.00;11
4566;11;22580646;4566;338;5597;5608;6.59;0.40;287.65;4.93;1031;11;1912.00;11
4571;11;22580659;4571;343;5598;5608;6.60;0.40;287.81;4.94;1027;11;1913.00;10
4576;11;22580673;4576;349;5603;5612;6.55;0.40;287.92;4.95;1027;11;1914.00;9
4577;11;22580688;4577;354;5604;5612;6.52;0.40;288.01;4.96;1027;11;1915.00;8
4580;11;22580705;4580;353;5608;5616;6.43;0.39;287.95;4.95;1028;11;1916.00;8
4585;11;22580720;4585;362;5610;5617;6.30;0.38;288.00;4.96;1025;11;1917.00;7
4591;11;22580734;4591;359;5611;5617;6.14;0.37;288.11;4.97;1020;11;1918.00;6
4594;11;22580748;4594;359;5611;5617;6.04;0.37;288.23;4.97;1017;11;1919.00;6
4598;11;22580765;4598;374;5634;5646;5.97;0.36;288.21;4.95;1036;11;1920.00;12
4602;11;22580784;4602;367;5635;5646;5.89;0.36;288.19;4.96;1033;11;1921.00;11
4605;11;22580797;4605;377;5638;5646;5.88;0.36;288.22;4.96;1033;11;1922.00;8
4609;11;22580808;4609;376;5642;5647;5.78;0.35;288.18;4.96;1033;11;1923.00;5
4613;11;22580823;4613;382;5643;5648;5.66;0.35;288.20;4.96;1030;11;1924.00;5
4616;11;22580835;4616;370;5643;5648;5.61;0.34;288.22;4.96;1027;11;1925.00;5
4618;11;22580850;4618;370;5645;5651;5.57;0.34;288.20;4.96;1027;11;1926.00;6
4620;11;22580863;4620;363;5646;5651;5.59;0.34;288.16;4.96;1026;11;1927.00;5
4624;11;22580877;4624;366;5646;5651;5.54;0.34;288.11;4.96;1022;11;1928.00;5
4629;11;22580890;4629;369;5646;5651;5.51;0.34;288.17;4.96;1017;11;1929.00;5
4631;11;22580903;4631;381;5651;5657;5.52;0.34;288.15;4.96;1020;11;1930.00;6
4637;11;22580927;4637;383;5651;5657;5.41;0.33;288.12;4.96;1014;11;1931.00;6
4639;11;22580940;4639;383;5651;5657;5.41;0.33;288.12;4.96;1012;11;1932.00;6
4641;11;22580955;4641;380;5651;5657;5.35;0.33;288.10;4.96;1010;11;1933.00;6
4643;11;22580968;4643;379;5654;5661;5.35;0.33;288.10;4.96;1011;11;1934.00;7
4647;11;22580983;4647;385;5655;5663;5.28;0.32;288.12;4.96;1008;11;1935.00;8
4648;11;22580999;4648;379;5656;5663;5.21;0.32;288.17;4.96;1008;11;1936.00;7
4653;11;22581014;4653;386;5657;5664;5.14;0.32;288.22;4.96;1004;11;1937.00;7
4658;11;22581028;4658;391;5658;5664;5.04;0.31;288.14;4.96;1000;11;1938.00;6
4662;11;22581039;4662;393;5658;5664;5.00;0.31;288.15;4.96;996;11;1939.00;6
4666;11;22581055;4666;395;5658;5664;4.94;0.30;288.06;4.96;992;11;1940.00;6
4671;11;22581069;4671;403;5658;5664;4.93;0.30;287.95;4.96;987;11;1941.00;6
4673;11;22581084;4673;410;5658;5664;4.91;0.30;288.03;4.96;985;11;1942.00;6
4675;11;22581097;4675;414;5658;5664;4.89;0.30;288.04;4.96;983;11;1943.00;6
4678;11;22581107;4678;426;5699;5734;4.99;0.31;288.03;4.92;1021;11;1944.00;35
4680;11;22581130;4680;424;5700;5735;4.95;0.31;288.05;4.92;1020;11;1945.00;35
4684;11;22581142;4684;423;5706;5735;5.00;0.31;288.28;4.92;1022;11;1946.00;29
4687;11;22581155;4687;427;5707;5735;5.02;0.31;288.27;4.92;1020;11;1947.00;28
4692;11;22581169;4692;422;5712;5735;5.03;0.31;288.25;4.92;1020;11;1948.00;23
4694;11;22581184;4694;430;5714;5735;5.09;0.31;288.25;4.92;1020;11;1949.00;21
4699;11;22581201;4699;438;5719;5737;5.09;0.31;288.28;4.92;1020;11;1950.00;18
4701;11;22581217;4701;424;5721;5737;5.16;0.32;288.33;4.92;1020;11;1951.00;16
4703;11;22581231;4703;417;5724;5738;5.20;0.32;288.27;4.92;1021;11;1952.00;14
4707;11;22581255;4707;419;5724;5739;5.19;0.32;288.28;4.92;1017;11;1953.00;15
4711;11;22581270;4711;416;5725;5739;5.19;0.32;288.29;4.92;1014;11;1954.00;14
4714;11;22581285;4714;414;5728;5743;5.26;0.32;288.23;4.91;1014;11;1955.00;15
4719;12;22581302;4719;416;5728;5743;5.25;0.32;288.15;4.91;1009;12;1956.00;15
4723;12;22581332;4723;415;5729;5743;5.26;0.32;288.15;4.92;1006;12;1957.00;14
4725;12;22581355;4725;418;5729;5743;5.29;0.32;288.17;4.92;1004;12;1958.00;14
4729;12;22581371;4729;416;5734;5749;5.30;0.33;288.23;4.92;1005;12;1959.00;15
4731;13;22581387;4731;414;5734;5749;5.34;0.33;288.17;4.92;1003;13;1960.00;15
4737;13;22581413;4737;419;5735;5749;5.41;0.33;288.14;4.92;998;13;1961.00;14
4738;13;22581438;4738;426;5737;5752;5.47;0.33;288.17;4.92;999;13;1962.00;15
4742;13;22581455;4742;419;5738;5752;5.52;0.34;288.07;4.92;996;13;1963.00;14
4746;13;22581471;4746;422;5739;5752;5.58;0.34;288.13;4.92;993;13;1964.00;13
4746;13;22581488;4746;417;5739;5753;5.65;0.34;288.13;4.92;993;13;1965.00;14
4746;13;22581503;4746;419;5740;5754;5.69;0.35;288.13;4.92;994;13;1966.00;14
4746;13;22581519;4746;425;5741;5754;5.73;0.35;288.13;4.92;995;13;1967.00;13
4746;13;22581534;4746;426;5751;5767;5.84;0.36;288.13;4.91;1005;13;1968.00;16
4750;13;22581552;4750;424;5752;5767;5.82;0.36;288.13;4.91;1002;13;1969.00;15
4753;13;22581568;4753;426;5752;5767;5.80;0.35;288.11;4.91;999;13;1970.00;15
4754;13;22581584;4754;428;5753;5768;5.84;0.36;288.14;4.91;999;13;1971.00;15
4756;13;22581603;4756;420;5753;5768;5.82;0.35;288.22;4.91;997;13;1972.00;15
4758;13;22581628;4758;411;5757;5772;5.94;0.36;288.21;4.90;999;13;1973.00;15
4764;13;22581646;4764;405;5757;5772;5.98;0.36;288.40;4.90;993;13;1974.00;15
4767;13;22581663;4767;402;5760;5776;6.04;0.37;288.31;4.90;993;13;1975.00;16
4768;13;22581682;4768;399;5760;5776;6.11;0.37;288.31;4.90;992;13;1976.00;16
4770;13;22581699;4770;394;5760;5776;6.17;0.37;288.35;4.90;990;13;1977.00;16
4773;13;22581718;4773;393;5760;5776;6.19;0.37;288.41;4.90;987;13;1978.00;16
4773;13;22581734;4773;394;5760;5776;6.21;0.38;288.41;4.90;987;13;1979.00;16
4773;13;22581755;4773;401;5787;5810;6.31;0.38;288.41;4.88;1014;13;1980.00;23
4775;13;22581782;4775;387;5787;5810;6.32;0.38;288.44;4.88;1012;13;1981.00;23
4777;13;22581800;4777;375;5790;5810;6.39;0.39;288.56;4.88;1013;13;1982.00;20
4779;13;22581818;4779;372;5790;5810;6.42;0.39;288.56;4.88;1011;13;1983.00;20
4781;13;22581840;4781;364;5791;5810;6.39;0.39;288.63;4.88;1010;13;1984.00;19
4784;13;22581858;4784;361;5791;5810;6.39;0.39;288.77;4.88;1007;13;1985.00;19
4787;13;22581885;4787;357;5791;5811;6.40;0.39;288.75;4.88;1004;13;1986.00;20
4790;13;22581902;4790;367;5791;5811;6.37;0.39;288.88;4.88;1001;13;1987.00;20
4792;13;22581930;4792;360;5796;5817;6.36;0.39;289.03;4.87;1004;13;1988.00;21
4794;13;22581949;4794;363;5796;5818;6.38;0.39;289.05;4.87;1002;13;1989.00;22
4795;13;22581965;4795;367;5797;5818;6.40;0.39;289.14;4.87;1002;13;1990.00;21
4796;13;22581980;4796;366;5797;5818;6.36;0.39;289.21;4.87;1001;13;1991.00;21
4796;13;22582002;4796;367;5800;5822;6.37;0.39;289.21;4.87;1004;13;1992.00;22
4798;13;22582031;4798;371;5800;5822;6.33;0.38;289.22;4.87;1002;13;1993.00;22
4801;13;22582052;4801;355;5800;5822;6.29;0.38;289.31;4.87;999;13;1994.00;22
4804;13;22582071;4804;358;5801;5823;6.26;0.38;289.45;4.87;997;13;1995.00;22
4806;13;22582090;4806;353;5804;5827;6.27;0.38;289.54;4.87;998;13;1996.00;23
4809;13;22582108;4809;349;5804;5827;6.26;0.38;289.77;4.87;995;13;1997.00;23
4812;13;22582129;4812;354;5806;5830;6.34;0.39;289.89;4.87;994;13;1998.00;24
4813;13;22582150;4813;352;5806;5830;6.38;0.39;289.88;4.87;993;13;1999.00;24
4816;13;22582172;4816;356;5807;5830;6.42;0.39;290.02;4.87;991;13;2000.00;23
4816;13;22582201;4816;354;5807;5830;6.48;0.39;290.02;4.87;991;13;2001.00;23
4820;13;22582219;4820;361;5811;5834;6.47;0.39;290.03;4.86;991;13;2002.00;23
4823;13;22582249;4823;358;5811;5834;6.47;0.39;290.07;4.86;988;13;2003.00;23
4825;13;22582271;4825;361;5811;5834;6.50;0.40;290.12;4.86;986;13;2004.00;23
4829;13;22582290;4829;365;5811;5834;6.53;0.40;290.22;4.86;982;13;2005.00;23
4830;13;22582311;4830;363;5811;5835;6.54;0.40;290.19;4.86;981;13;2006.00;24
4833;13;22582338;4833;362;5812;5836;6.57;0.40;290.27;4.86;979;13;2007.00;24
4834;13;22582358;4834;364;5812;5836;6.58;0.40;290.36;4.86;978;13;2008.00;24
4835;13;22582382;4835;364;5813;5837;6.58;0.40;290.34;4.86;978;13;2009.00;24
4837;13;22582408;4837;361;5813;5837;6.55;0.40;290.41;4.86;976;13;2010.00;24
4838;13;22582431;4838;364;5813;5837;6.59;0.40;290.44;4.86;975;13;2011.00;24
4842;13;22582451;4842;368;5813;5837;6.59;0.40;290.70;4.86;971;13;2012.00;24
4845;13;22582472;4845;368;5813;5837;6.56;0.40;290.77;4.86;968;13;2013.00;24
4847;13;22582497;4847;366;5813;5837;6.56;0.40;290.85;4.86;966;13;2014.00;24
4849;13;22582520;4849;363;5813;5837;6.56;0.40;291.02;4.86;964;13;2015.00;24
4853;13;22582538;4853;389;5886;5964;6.49;0.40;291.09;4.80;1033;13;2016.00;78
4853;13;22582572;4853;365;5886;5965;6.53;0.41;291.09;4.80;1033;13;2017.00;79
4856;13;22582591;4856;348;5891;5965;6.62;0.41;291.10;4.80;1035;13;2018.00;74
4859;13;22582614;4859;338;5892;5965;6.68;0.41;291.15;4.80;1033;13;2019.00;73
4859;13;22582634;4859;334;5896;5965;6.76;0.42;291.15;4.80;1037;13;2020.00;69
4862;13;22582655;4862;332;5897;5965;6.81;0.42;291.13;4.80;1035;13;2021.00;68
4863;13;22582675;4863;322;5898;5965;6.91;0.43;291.17;4.80;1035;13;2022.00;67
4864;13;22582695;4864;326;5900;5965;7.01;0.43;291.20;4.80;1036;13;2023.00;65
4867;13;22582715;4867;327;5903;5966;7.13;0.44;291.32;4.80;1036;13;2024.00;63
4871;13;22582735;4871;329;5906;5968;7.20;0.44;291.36;4.80;1035;13;2025.00;62
4875;13;22582755;4875;324;5910;5968;7.18;0.44;291.52;4.81;1035;13;2026.00;58
4878;13;22582782;4878;317;5912;5969;7.11;0.43;291.64;4.81;1034;13;2027.00;57
4879;13;22582800;4879;320;5914;5969;7.07;0.43;291.68;4.81;1035;13;2028.00;55
4883;13;22582818;4883;319;5917;5969;7.00;0.43;291.80;4.83;1034;13;2029.00;52
4886;13;22582838;4886;316;5920;5969;6.92;0.42;291.88;4.85;1034;13;2030.00;49
4889;13;22582856;4889;308;5924;5973;6.87;0.42;291.95;4.86;1035;13;2031.00;49
4892;13;22582874;4892;307;5925;5973;6.81;0.42;291.99;4.86;1033;13;2032.00;48
4895;13;22582893;4895;305;5930;5973;6.79;0.41;292.06;4.87;1035;13;2033.00;43
4897;13;22582915;4897;304;5931;5976;6.81;0.42;292.17;4.87;1034;13;2034.00;45
4899;13;22582933;4899;301;5934;5976;6.84;0.42;292.29;4.87;1035;13;2035.00;42
4901;13;22582951;4901;301;5935;5976;6.86;0.42;292.35;4.88;1034;13;2036.00;41
4903;13;22582970;4903;297;5939;5980;6.85;0.42;292.42;4.87;1036;13;2037.00;41
4905;13;22582988;4905;296;5941;5981;6.87;0.42;292.56;4.88;1036;13;2038.00;40
4907;13;22583006;4907;292;5944;5981;6.92;0.42;292.56;4.88;1037;13;2039.00;37
4913;13;22583025;4913;292;5947;5986;6.96;0.42;292.62;4.88;1034;13;2040.00;39
4917;13;22583042;4917;290;5949;5986;6.97;0.42;292.59;4.88;1032;13;2041.00;37
4920;13;22583060;4920;292;5951;5986;7.07;0.43;292.56;4.90;1031;13;2042.00;35
4921;13;22583078;4921;288;5952;5987;7.14;0.43;292.67;4.90;1031;13;2043.00;35
4924;13;22583097;4924;282;5952;5987;7.15;0.43;292.61;4.90;1028;13;2044.00;35
4927;13;22583113;4927;288;5956;5993;7.23;0.44;292.66;4.89;1029;13;2045.00;37
4930;13;22583127;4930;288;5956;5993;7.19;0.43;292.72;4.89;1026;13;2046.00;37
4933;13;22583143;4933;280;5956;5994;7.10;0.43;292.76;4.89;1023;13;2047.00;38
4934;13;22583161;4934;283;5956;5994;7.02;0.42;292.71;4.89;1022;13;2048.00;38
4937;13;22583175;4937;284;5956;5994;6.90;0.42;292.69;4.89;1019;13;2049.00;38
4939;13;22583192;4939;277;5956;5994;6.79;0.41;292.75;4.89;1017;13;2050.00;38
4942;13;22583223;4942;290;5958;5994;6.70;0.41;292.82;4.92;1016;13;2051.00;36
4942;13;22583245;4942;296;5967;6006;6.72;0.41;292.82;4.91;1025;13;2052.00;39
4948;13;22583267;4948;301;5967;6006;6.68;0.40;292.91;4.91;1019;13;2053.00;39
4950;13;22583284;4950;304;5971;6006;6.73;0.41;292.98;4.92;1021;13;2054.00;35
4950;13;22583300;4950;302;5972;6006;6.79;0.41;292.98;4.94;1022;13;2055.00;34
4954;13;22583317;4954;308;5974;6006;6.71;0.41;293.12;4.96;1020;13;2056.00;32
4956;13;22583335;4956;311;5975;6006;6.72;0.41;293.13;4.98;1019;13;2057.00;31
4958;13;22583351;4958;324;5979;6010;6.74;0.41;293.16;5.00;1021;13;2058.00;31
4960;13;22583367;4960;327;5979;6010;6.74;0.41;293.14;5.00;1019;13;2059.00;31
4962;13;22583391;4962;332;5985;6014;6.77;0.41;293.15;5.02;1023;13;2060.00;29
4965;13;22583407;4965;330;5986;6015;6.75;0.41;293.24;5.02;1021;13;2061.00;29
4968;13;22583425;4968;338;5987;6015;6.68;0.41;293.39;5.04;1019;13;2062.00;28
4970;13;22583441;4970;342;5989;6015;6.64;0.40;293.40;5.07;1019;13;2063.00;26
4973;13;22583456;4973;341;6000;6028;6.63;0.40;293.46;5.06;1027;13;2064.00;28
4974;13;22583472;4974;345;6001;6028;6.60;0.40;293.40;5.08;1027;13;2065.00;27
4977;13;22583490;4977;342;6002;6028;6.61;0.40;293.56;5.09;1025;13;2066.00;26
4978;13;22583507;4978;350;6004;6029;6.60;0.40;293.67;5.10;1026;13;2067.00;25
4981;13;22583525;4981;353;6005;6030;6.51;0.40;293.72;5.12;1024;13;2068.00;25
4983;13;22583540;4983;354;6006;6030;6.43;0.39;293.72;5.13;1023;13;2069.00;24
4986;13;22583557;4986;358;6011;6036;6.40;0.39;293.77;5.15;1025;13;2070.00;25
4987;13;22583572;4987;364;6011;6036;6.39;0.39;293.73;5.15;1024;13;2071.00;25
4990;13;22583587;4990;372;6014;6036;6.30;0.38;293.90;5.16;1024;13;2072.00;22
4991;13;22583605;4991;380;6014;6036;6.26;0.38;293.92;5.16;1023;13;2073.00;22
4992;13;22583621;4992;390;6019;6042;6.30;0.39;294.03;5.16;1027;13;2074.00;23
4993;13;22583636;4993;384;6021;6042;6.24;0.38;294.02;5.19;1028;13;2075.00;21
4998;13;22583651;4998;390;6022;6042;6.19;0.38;293.96;5.20;1024;13;2076.00;20
4999;13;22583667;4999;394;6022;6042;6.19;0.38;293.99;5.20;1023;13;2077.00;20
5001;13;22583682;5001;390;6025;6046;6.19;0.38;293.93;5.20;1024;13;2078.00;21
5003;13;22583700;5003;385;6029;6047;6.12;0.37;293.85;5.23;1026;13;2079.00;18
5004;13;22583717;5004;386;6029;6047;6.13;0.37;293.88;5.23;1025;13;2080.00;18
5008;13;22583730;5008;379;6032;6048;6.13;0.37;293.80;5.25;1024;13;2081.00;16
5009;13;22583744;5009;385;6032;6048;6.14;0.38;293.88;5.25;1023;13;2082.00;16
5010;13;22583762;5010;383;6034;6048;6.16;0.38;293.87;5.27;1024;13;2083.00;14
5012;13;22583778;5012;385;6034;6048;6.16;0.38;293.95;5.27;1022;13;2084.00;14
5014;13;22583792;5014;392;6034;6048;6.15;0.38;293.88;5.27;1020;13;2085.00;14
5014;13;22583807;5014;386;6036;6048;6.15;0.38;293.88;5.29;1022;13;2086.00;12
5017;13;22583822;5017;386;6037;6048;6.15;0.38;293.88;5.30;1020;13;2087.00;11
5020;13;22583837;5020;398;6077;6118;6.28;0.39;293.84;5.27;1057;13;2088.00;41
5025;13;22583865;5025;394;6080;6119;6.23;0.38;293.85;5.28;1055;13;2089.00;39
5028;13;22583878;5028;393;6086;6119;6.19;0.38;293.92;5.28;1058;13;2090.00;33
5034;13;22583892;5034;400;6091;6119;6.04;0.37;293.91;5.28;1057;13;2091.00;28
5038;13;22583906;5038;404;6095;6119;5.92;0.36;293.92;5.28;1057;13;2092.00;24
5040;13;22583920;5040;402;6098;6119;5.84;0.36;293.83;5.28;1058;13;2093.00;21
5046;13;22583936;5046;407;6102;6119;5.69;0.35;293.76;5.29;1056;13;2094.00;17
5052;13;22583950;5052;408;6105;6119;5.59;0.34;293.65;5.29;1053;13;2095.00;14
5052;13;22583971;5052;412;6110;6120;5.59;0.34;293.65;5.31;1058;13;2096.00;10
5059;13;22583985;5059;417;6110;6121;5.47;0.33;293.53;5.31;1051;13;2097.00;11
5062;13;22583998;5062;427;6112;6121;5.38;0.33;293.44;5.31;1050;13;2098.00;9
5063;13;22584012;5063;431;6116;6125;5.28;0.32;293.43;5.31;1053;13;2099.00;9
5063;13;22584029;5063;424;6121;6140;5.23;0.32;293.43;5.31;1058;13;2100.00;19
5066;13;22584048;5066;420;6122;6140;5.11;0.31;293.34;5.31;1056;13;2101.00;18
5070;13;22584061;5070;418;6123;6140;5.03;0.31;293.30;5.32;1053;13;2102.00;17
5072;13;22584072;5072;426;6126;6146;5.00;0.30;293.24;5.31;1054;13;2103.00;20
5074;13;22584084;5074;433;6127;6146;4.96;0.30;293.29;5.31;1053;13;2104.00;19
5076;13;22584098;5076;430;6127;6146;4.92;0.30;293.24;5.31;1051;13;2105.00;19
5078;13;22584111;5078;443;6130;6149;4.90;0.30;293.18;5.31;1052;13;2106.00;19
5080;13;22584123;5080;441;6130;6149;4.87;0.30;293.23;5.31;1050;13;2107.00;19
5082;13;22584135;5082;426;6130;6149;4.89;0.30;293.21;5.31;1048;13;2108.00;19
5083;13;22584148;5083;416;6130;6150;4.93;0.30;293.23;5.31;1047;13;2109.00;20
5085;13;22584160;5085;404;6132;6151;4.98;0.30;293.26;5.31;1047;13;2110.00;19
5087;13;22584172;5087;398;6132;6151;5.05;0.31;293.30;5.31;1045;13;2111.00;19
5093;13;22584187;5093;393;6143;6164;5.10;0.31;293.16;5.31;1050;13;2112.00;21
5095;13;22584203;5095;396;6143;6164;5.14;0.31;293.15;5.31;1048;13;2113.00;21
5096;13;22584217;5096;397;6143;6164;5.25;0.32;293.14;5.31;1047;13;2114.00;21
5099;13;22584229;5099;396;6145;6166;5.33;0.33;293.21;5.31;1046;13;2115.00;21
5101;13;22584242;5101;401;6146;6166;5.38;0.33;293.20;5.31;1045;13;2116.00;20
5103;13;22584256;5103;403;6149;6170;5.50;0.34;293.19;5.31;1046;13;2117.00;21
5107;14;22584271;5107;410;6151;6170;5.54;0.34;293.25;5.31;1044;14;2118.00;19
5110;14;22584302;5110;410;6154;6174;5.64;0.34;293.18;5.31;1044;14;2119.00;20
5114;14;22584318;5114;420;6155;6174;5.68;0.35;293.20;5.31;1041;14;2120.00;19
5117;14;22584333;5117;423;6156;6174;5.72;0.35;293.12;5.31;1039;14;2121.00;18
5120;14;22584346;5120;427;6156;6174;5.73;0.35;293.12;5.31;1036;14;2122.00;18
5122;15;22584361;5122;428;6156;6174;5.76;0.35;293.14;5.31;1034;15;2123.00;18
5124;15;22584401;5124;428;6168;6186;5.88;0.36;293.13;5.31;1044;15;2124.00;18
5127;15;22584426;5127;423;6168;6186;5.90;0.36;293.15;5.31;1041;15;2125.00;18
5131;15;22584444;5131;424;6170;6186;5.94;0.36;293.12;5.31;1039;15;2126.00;16
5135;15;22584467;5135;424;6170;6186;6.00;0.36;293.08;5.31;1035;15;2127.00;16
5139;15;22584498;5139;428;6170;6186;6.04;0.37;293.18;5.31;1031;15;2128.00;16
5144;15;22584514;5144;428;6170;6186;5.95;0.36;293.17;5.31;1026;15;2129.00;16
5149;15;22584536;5149;423;6172;6187;5.94;0.36;293.21;5.32;1023;15;2130.00;15
5152;15;22584556;5152;417;6173;6187;5.86;0.36;293.28;5.32;1021;15;2131.00;14
5155;15;22584574;5155;414;6178;6193;5.80;0.35;293.40;5.31;1023;15;2132.00;15
5160;15;22584590;5160;418;6179;6194;5.78;0.35;293.53;5.31;1019;15;2133.00;15
5161;15;22584607;5161;415;6179;6194;5.79;0.35;293.56;5.31;1018;15;2134.00;15
5165;15;22584624;5165;406;6179;6194;5.80;0.35;293.45;5.31;1014;15;2135.00;15
5169;15;22584649;5169;407;6182;6198;5.82;0.35;293.53;5.31;1013;15;2136.00;16
5172;15;22584665;5172;409;6182;6198;5.85;0.36;293.68;5.31;1010;15;2137.00;16
5174;15;22584682;5174;410;6182;6198;5.91;0.36;293.74;5.31;1008;15;2138.00;16
5177;15;22584696;5177;408;6183;6199;5.94;0.36;293.75;5.31;1006;15;2139.00;16
5179;15;22584711;5179;404;6186;6203;5.97;0.36;293.81;5.31;1007;15;2140.00;17
5182;15;22584727;5182;406;6186;6203;5.97;0.36;293.80;5.31;1004;15;2141.00;17
5188;15;22584742;5188;407;6188;6206;5.93;0.36;293.84;5.31;1000;15;2142.00;18
5192;15;22584758;5192;414;6188;6206;5.85;0.36;294.02;5.31;996;15;2143.00;18
5194;15;22584782;5194;415;6189;6206;5.81;0.35;293.96;5.30;995;15;2144.00;17
5196;15;22584797;5196;419;6189;6206;5.81;0.35;294.08;5.30;993;15;2145.00;17
5196;15;22584811;5196;432;6193;6210;5.84;0.36;294.08;5.30;997;15;2146.00;17
5198;15;22584825;5198;409;6193;6210;5.86;0.36;294.13;5.30;995;15;2147.00;17
5201;15;22584845;5201;401;6193;6210;5.86;0.36;294.12;5.30;992;15;2148.00;17
5206;15;22584867;5206;398;6193;6210;5.83;0.36;294.16;5.30;987;15;2149.00;17
5209;15;22584891;5209;393;6193;6211;5.84;0.36;294.17;5.30;984;15;2150.00;18
5210;15;22584915;5210;388;6194;6212;5.87;0.36;294.14;5.30;984;15;2151.00;18
5213;15;22584935;5213;380;6194;6212;5.92;0.36;294.29;5.30;981;15;2152.00;18
5216;15;22584950;5216;376;6195;6213;5.99;0.37;294.35;5.30;979;15;2153.00;18
5219;15;22584972;5219;378;6195;6213;6.01;0.37;294.52;5.30;976;15;2154.00;18
5220;15;22584991;5220;378;6195;6213;6.08;0.37;294.53;5.30;975;15;2155.00;18
5222;15;22585009;5222;368;6195;6213;6.17;0.38;294.53;5.30;973;15;2156.00;18
5227;15;22585029;5227;357;6195;6213;6.21;0.38;294.63;5.30;968;15;2157.00;18
5228;15;22585047;5228;347;6195;6213;6.27;0.38;294.65;5.30;967;15;2158.00;18
5231;15;22585067;5231;334;6195;6213;6.30;0.38;294.65;5.30;964;15;2159.00;18
5235;15;22585098;5235;373;6310;6443;6.52;0.41;294.80;5.20;1075;15;2160.00;133
5238;15;22585162;5238;368;6320;6444;6.56;0.41;294.89;5.20;1082;15;2161.00;124
5242;15;22585185;5242;350;6329;6444;6.62;0.41;294.93;5.19;1087;15;2162.00;115
5245;15;22585203;5245;343;6335;6444;6.67;0.42;295.02;5.19;1090;15;2163.00;109
5249;15;22585222;5249;350;6344;6444;6.66;0.42;295.10;5.19;1095;15;2164.00;100
5252;15;22585244;5252;356;6349;6444;6.60;0.41;295.18;5.19;1097;15;2165.00;95
5254;15;22585267;5254;356;6355;6444;6.54;0.41;295.29;5.19;1101;15;2166.00;89
5255;15;22585283;5255;359;6361;6444;6.54;0.41;295.30;5.19;1106;15;2167.00;83
5256;15;22585298;5256;363;6366;6445;6.51;0.40;295.29;5.19;1110;15;2168.00;79
5259;15;22585321;5259;371;6368;6446;6.43;0.40;295.36;5.19;1109;15;2169.00;78
5261;15;22585337;5261;377;6376;6446;6.30;0.39;295.47;5.20;1115;15;2170.00;70
5262;15;22585353;5262;392;6379;6447;6.21;0.39;295.54;5.20;1117;15;2171.00;68
5266;15;22585369;5266;385;6381;6447;6.13;0.38;295.61;5.21;1115;15;2172.00;66
5267;15;22585385;5267;398;6383;6447;6.10;0.38;295.64;5.21;1116;15;2173.00;64
5269;15;22585399;5269;398;6388;6447;6.06;0.38;295.66;5.22;1119;15;2174.00;59
5271;15;22585415;5271;400;6392;6451;6.05;0.37;295.81;5.22;1121;15;2175.00;59
5272;15;22585436;5272;401;6394;6451;6.08;0.38;295.85;5.22;1122;15;2176.00;57
5274;15;22585458;5274;413;6395;6451;6.08;0.37;295.89;5.22;1121;15;2177.00;56
5277;15;22585496;5277;413;6397;6454;6.10;0.38;295.88;5.22;1120;15;2178.00;57
5279;15;22585518;5279;412;6397;6454;6.09;0.37;295.90;5.22;1118;15;2179.00;57
5283;15;22585538;5283;411;6397;6454;6.07;0.37;295.93;5.22;1114;15;2180.00;57
5286;15;22585558;5286;412;6402;6458;6.05;0.37;295.99;5.22;1116;15;2181.00;56
5289;15;22585579;5289;416;6403;6459;6.10;0.37;295.99;5.22;1114;15;2182.00;56
5291;15;22585598;5291;415;6404;6459;6.13;0.37;296.09;5.23;1113;15;2183.00;55
5293;15;22585612;5293;418;6406;6463;6.10;0.37;296.17;5.22;1113;15;2184.00;57
5296;15;22585627;5296;419;6407;6463;6.13;0.37;296.32;5.22;1111;15;2185.00;56
5299;15;22585641;5299;420;6408;6463;6.16;0.38;296.43;5.23;1109;15;2186.00;55
5300;15;22585656;5300;416;6410;6464;6.16;0.38;296.42;5.23;1110;15;2187.00;54
5303;15;22585670;5303;421;6411;6464;6.16;0.38;296.49;5.24;1108;15;2188.00;53
5305;15;22585684;5305;419;6416;6470;6.20;0.38;296.47;5.24;1111;15;2189.00;54
5307;15;22585703;5307;416;6417;6470;6.19;0.38;296.46;5.24;1110;15;2190.00;53
5309;15;22585718;5309;410;6418;6471;6.24;0.38;296.50;5.25;1109;15;2191.00;53
5313;15;22585732;5313;405;6419;6471;6.25;0.38;296.50;5.25;1106;15;2192.00;52
5313;15;22585747;5313;400;6419;6471;6.27;0.38;296.50;5.25;1106;15;2193.00;52
5314;15;22585766;5314;401;6421;6471;6.26;0.38;296.51;5.25;1107;15;2194.00;50
5316;15;22585780;5316;395;6422;6471;6.26;0.38;296.54;5.26;1106;15;2195.00;49
5319;15;22585794;5319;387;6430;6483;6.29;0.38;296.63;5.25;1111;15;2196.00;53
5321;15;22585810;5321;379;6432;6483;6.33;0.39;296.80;5.25;1111;15;2197.00;51
5323;15;22585825;5323;375;6433;6483;6.36;0.39;296.82;5.25;1110;15;2198.00;50
5325;15;22585842;5325;371;6435;6483;6.35;0.39;296.86;5.25;1110;15;2199.00;48
5328;15;22585863;5328;367;6435;6483;6.31;0.38;296.81;5.25;1107;15;2200.00;48
5332;15;22585891;5332;370;6436;6483;6.27;0.38;297.07;5.25;1104;15;2201.00;47
5335;15;22585912;5335;365;6439;6487;6.19;0.38;297.12;5.25;1104;15;2202.00;48
5336;15;22585929;5336;364;6439;6487;6.13;0.37;297.12;5.25;1103;15;2203.00;48
5343;15;22585943;5343;355;6443;6491;6.04;0.37;297.11;5.25;1100;15;2204.00;48
5347;15;22585962;5347;356;6447;6493;5.96;0.36;297.32;5.28;1100;15;2205.00;46
5350;15;22585980;5350;357;6447;6493;5.94;0.36;297.32;5.28;1097;15;2206.00;46
5352;15;22586001;5352;348;6447;6493;5.91;0.36;297.32;5.28;1095;15;2207.00;46
5354;15;22586024;5354;352;6456;6506;5.93;0.36;297.33;5.28;1102;15;2208.00;50
5357;15;22586046;5357;346;6456;6506;6.00;0.36;297.45;5.28;1099;15;2209.00;50
5361;15;22586067;5361;342;6458;6508;5.97;0.36;297.65;5.27;1097;15;2210.00;50
5364;15;22586086;5364;332;6459;6509;6.01;0.36;297.78;5.27;1095;15;2211.00;50
5367;15;22586105;5367;324;6459;6510;6.02;0.37;297.87;5.27;1092;15;2212.00;51
5368;15;22586121;5368;327;6459;6510;6.03;0.37;297.95;5.27;1091;15;2213.00;51
5372;15;22586136;5372;327;6461;6513;6.04;0.37;297.99;5.27;1089;15;2214.00;52
5374;15;22586154;5374;326;6462;6513;6.05;0.37;298.13;5.27;1088;15;2215.00;51
5378;15;22586168;5378;331;6462;6513;6.08;0.37;298.16;5.27;1084;15;2216.00;51
5380;15;22586182;5380;328;6462;6513;6.11;0.37;298.23;5.27;1082;15;2217.00;51
5385;15;22586198;5385;324;6467;6519;6.13;0.37;298.33;5.27;1082;15;2218.00;52
5388;15;22586217;5388;327;6467;6519;6.11;0.37;298.45;5.27;1079;15;2219.00;52
5390;15;22586238;5390;327;6467;6519;6.03;0.37;298.58;5.27;1077;15;2220.00;52
5393;15;22586261;5393;332;6467;6519;5.97;0.36;298.56;5.27;1074;15;2221.00;52
5393;15;22586290;5393;337;6471;6523;5.92;0.36;298.56;5.27;1078;15;2222.00;52
5394;15;22586313;5394;342;6472;6524;5.91;0.36;298.55;5.27;1078;15;2223.00;52
5395;15;22586332;5395;341;6472;6524;5.87;0.36;298.54;5.27;1077;15;2224.00;52
5398;15;22586347;5398;347;6474;6525;5.81;0.35;298.46;5.28;1076;15;2225.00;51
5398;15;22586365;5398;352;6474;6525;5.81;0.35;298.46;5.28;1076;15;2226.00;51
5398;15;22586386;5398;350;6475;6525;5.79;0.35;298.46;5.29;1077;15;2227.00;50
5400;15;22586410;5400;358;6475;6525;5.76;0.35;298.47;5.29;1075;15;2228.00;50
5400;15;22586428;5400;360;6475;6525;5.80;0.35;298.47;5.29;1075;15;2229.00;50
5401;15;22586444;5401;368;6477;6525;5.80;0.35;298.43;5.32;1076;15;2230.00;48
5402;15;22586462;5402;376;6478;6525;5.77;0.35;298.40;5.33;1076;15;2231.00;47
5404;15;22586480;5404;388;6515;6595;6.00;0.37;298.36;5.33;1111;15;2232.00;80
5404;15;22586505;5404;389;6517;6596;6.00;0.37;298.36;5.33;1113;15;2233.00;79
5407;15;22586519;5407;396;6527;6596;6.00;0.37;298.24;5.34;1120;15;2234.00;69
5409;15;22586533;5409;397;6531;6596;5.95;0.36;298.18;5.34;1122;15;2235.00;65
5411;15;22586546;5411;407;6536;6596;5.91;0.36;298.10;5.37;1125;15;2236.00;60
5412;15;22586559;5412;413;6537;6596;5.85;0.36;298.07;5.37;1125;15;2237.00;59
5412;15;22586573;5412;418;6541;6596;5.82;0.36;298.07;5.38;1129;15;2238.00;55
5412;15;22586599;5412;433;6546;6596;5.81;0.36;298.07;5.44;1134;15;2239.00;50
5414;15;22586617;5414;440;6548;6597;5.73;0.35;297.99;5.44;1134;15;2240.00;49
5417;15;22586638;5417;445;6551;6598;5.66;0.35;297.89;5.45;1134;15;2241.00;47
5420;15;22586658;5420;453;6553;6598;5.60;0.34;297.79;5.45;1133;15;2242.00;45
5422;15;22586688;5422;454;6558;6602;5.55;0.34;297.76;5.45;1136;15;2243.00;44
5427;15;22586707;5427;458;6558;6602;5.44;0.33;297.64;5.45;1131;15;2244.00;44
5428;15;22586732;5428;458;6564;6602;5.31;0.33;297.60;5.55;1136;15;2245.00;38
5432;15;22586749;5432;458;6565;6602;5.19;0.32;297.47;5.57;1133;15;2246.00;37
5434;15;22586764;5434;466;6572;6608;5.17;0.32;297.39;5.59;1138;15;2247.00;36
5436;15;22586780;5436;466;6574;6608;5.08;0.31;297.34;5.62;1138;15;2248.00;34
5437;15;22586796;5437;467;6575;6608;5.02;0.31;297.32;5.62;1138;15;2249.00;33
5438;15;22586814;5438;468;6582;6614;5.00;0.31;297.27;5.65;1144;15;2250.00;32
5439;15;22586831;5439;477;6584;6614;4.98;0.31;297.25;5.66;1145;15;2251.00;30
5440;15;22586845;5440;473;6585;6614;4.98;0.31;297.27;5.66;1145;15;2252.00;29
5441;15;22586870;5441;478;6586;6615;4.95;0.31;297.25;5.67;1145;15;2253.00;29
5443;15;22586886;5443;474;6588;6616;4.96;0.31;297.21;5.69;1145;15;2254.00;28
5446;15;22586908;5446;472;6589;6616;4.94;0.30;297.13;5.70;1143;15;2255.00;27
5448;15;22586931;5448;484;6600;6629;4.95;0.30;297.17;5.71;1152;15;2256.00;29
5449;15;22586955;5449;485;6602;6629;4.96;0.30;297.12;5.72;1153;15;2257.00;27
5451;15;22586971;5451;494;6602;6629;4.93;0.30;297.02;5.72;1151;15;2258.00;27
5453;15;22586985;5453;495;6604;6630;4.91;0.30;296.97;5.73;1151;15;2259.00;26
5454;15;22586999;5454;495;6604;6630;4.90;0.30;296.95;5.73;1150;15;2260.00;26
5458;15;22587017;5458;499;6609;6634;4.89;0.30;296.89;5.74;1151;15;2261.00;25
5460;15;22587036;5460;502;6610;6634;4.82;0.30;296.87;5.76;1150;15;2262.00;24
5464;15;22587053;5464;508;6613;6638;4.78;0.29;296.86;5.75;1149;15;2263.00;25
5467;15;22587069;5467;510;6613;6638;4.70;0.29;296.81;5.75;1146;15;2264.00;25
5472;15;22587084;5472;502;6613;6638;4.61;0.28;296.79;5.75;1141;15;2265.00;25
5474;15;22587101;5474;497;6613;6638;4.54;0.28;296.80;5.75;1139;15;2266.00;25
5477;15;22587115;5477;497;6613;6638;4.44;0.27;296.70;5.75;1136;15;2267.00;25
5478;15;22587129;5478;497;6624;6650;4.51;0.28;296.69;5.74;1146;15;2268.00;26
5479;15;22587143;5479;492;6624;6650;4.54;0.28;296.65;5.74;1145;15;2269.00;26
5482;15;22587159;5482;493;6624;6650;4.53;0.28;296.62;5.74;1142;15;2270.00;26
5483;15;22587179;5483;486;6624;6650;4.55;0.28;296.62;5.74;1141;15;2271.00;26
5483;16;22587201;5483;485;6624;6650;4.55;0.28;296.62;5.74;1141;16;2272.00;26
5489;16;22587230;5489;478;6624;6650;4.52;0.28;296.62;5.74;1135;16;2273.00;26
5495;16;22587242;5495;483;6624;6651;4.50;0.28;296.60;5.74;1129;16;2274.00;27
5495;16;22587258;5495;463;6624;6651;4.61;0.28;296.60;5.74;1129;16;2275.00;27
5499;16;22587272;5499;456;6629;6657;4.69;0.29;296.63;5.74;1130;16;2276.00;28
5501;16;22587288;5501;450;6630;6658;4.74;0.29;296.69;5.74;1129;16;2277.00;28
5501;16;22587301;5501;437;6630;6658;4.83;0.30;296.69;5.74;1129;16;2278.00;28
5503;16;22587315;5503;436;6630;6658;4.86;0.30;296.74;5.74;1127;16;2279.00;28
5504;16;22587342;5504;437;6634;6663;4.96;0.30;296.77;5.74;1130;16;2280.00;29
5505;16;22587356;5505;431;6634;6663;5.03;0.31;296.80;5.74;1129;16;2281.00;29
5508;16;22587371;5508;419;6634;6663;5.06;0.31;296.81;5.74;1126;16;2282.00;29
5511;16;22587388;5511;405;6635;6664;5.16;0.32;296.78;5.74;1124;16;2283.00;29
5512;16;22587402;5512;395;6638;6668;5.22;0.32;296.80;5.73;1126;16;2284.00;30
5516;16;22587416;5516;388;6638;6668;5.23;0.32;296.89;5.73;1122;16;2285.00;30
5520;16;22587432;5520;383;6640;6671;5.24;0.32;296.92;5.73;1120;16;2286.00;31
5524;16;22587447;5524;372;6640;6671;5.27;0.32;296.99;5.73;1116;16;2287.00;31
5529;16;22587460;5529;375;6640;6671;5.26;0.32;297.02;5.73;1111;16;2288.00;31
5532;16;22587473;5532;371;6641;6671;5.25;0.32;297.11;5.73;1109;16;2289.00;30
5535;16;22587486;5535;377;6644;6675;5.31;0.32;297.13;5.73;1109;16;2290.00;31
5542;16;22587502;5542;374;6644;6675;5.28;0.32;297.14;5.73;1102;16;2291.00;31
5546;16;22587520;5546;371;6644;6675;5.26;0.32;297.14;5.73;1098;16;2292.00;31
5551;16;22587535;5551;370;6644;6675;5.23;0.32;297.11;5.73;1093;16;2293.00;31
5553;16;22587550;5553;367;6644;6676;5.25;0.32;297.11;5.73;1091;16;2294.00;32
5558;16;22587565;5558;366;6645;6678;5.28;0.32;297.13;5.73;1087;16;2295.00;33
5562;16;22587579;5562;364;6647;6678;5.28;0.32;297.14;5.73;1085;16;2296.00;31
5565;16;22587598;5565;362;6648;6679;5.33;0.33;297.20;5.73;1083;16;2297.00;31
5566;16;22587614;5566;357;6648;6679;5.44;0.33;297.22;5.73;1082;16;2298.00;31
5570;16;22587629;5570;359;6648;6679;5.50;0.34;297.22;5.73;1078;16;2299.00;31
5573;16;22587643;5573;356;6648;6679;5.58;0.34;297.26;5.73;1075;16;2300.00;31
5576;16;22587665;5576;357;6648;6679;5.63;0.34;297.26;5.73;1072;16;2301.00;31
5581;16;22587682;5581;357;6648;6679;5.66;0.34;297.26;5.73;1067;16;2302.00;31
5585;16;22587699;5585;352;6648;6679;5.65;0.34;297.33;5.73;1063;16;2303.00;31
5589;16;22587718;5589;369;6724;6806;5.81;0.36;297.46;5.66;1135;16;2304.00;82
5592;16;22587760;5592;356;6727;6807;5.84;0.36;297.55;5.66;1135;16;2305.00;80
5594;16;22587785;5594;358;6733;6807;5.87;0.36;297.61;5.66;1139;16;2306.00;74
5598;16;22587810;5598;355;6735;6807;5.89;0.36;297.70;5.66;1137;16;2307.00;72
5600;16;22587829;5600;357;6739;6807;5.93;0.37;297.82;5.66;1139;16;2308.00;68
5603;16;22587844;5603;357;6741;6807;5.92;0.36;297.85;5.66;1138;16;2309.00;66
5607;16;22587862;5607;360;6744;6807;5.89;0.36;297.88;5.66;1137;16;2310.00;63
5610;16;22587878;5610;366;6746;6807;5.86;0.36;297.79;5.66;1136;16;2311.00;61
5612;16;22587894;5612;366;6748;6808;5.87;0.36;297.87;5.66;1136;16;2312.00;60
5615;16;22587912;5615;374;6751;6809;5.86;0.36;297.98;5.66;1136;16;2313.00;58
5619;16;22587929;5619;376;6752;6809;5.83;0.36;298.02;5.66;1133;16;2314.00;57
5622;16;22587947;5622;381;6754;6810;5.75;0.35;298.13;5.66;1132;16;2315.00;56
5625;16;22587964;5625;382;6757;6810;5.64;0.35;298.20;5.66;1132;16;2316.00;53
5627;16;22587982;5627;378;6758;6810;5.62;0.34;298.31;5.66;1131;16;2317.00;52
5628;16;22588003;5628;384;6759;6810;5.61;0.34;298.43;5.67;1131;16;2318.00;51
5631;16;22588021;5631;392;6764;6814;5.59;0.34;298.54;5.67;1133;16;2319.00;50
5634;16;22588038;5634;391;6765;6814;5.54;0.34;298.58;5.67;1131;16;2320.00;49
5635;16;22588057;5635;399;6768;6814;5.58;0.34;298.58;5.67;1133;16;2321.00;46
5639;16;22588078;5639;392;6770;6817;5.57;0.34;298.76;5.68;1131;16;2322.00;47
5640;16;22588101;5640;392;6772;6817;5.62;0.34;298.79;5.68;1132;16;2323.00;45
5643;16;22588119;5643;395;6772;6817;5.64;0.35;299.00;5.68;1129;16;2324.00;45
5645;16;22588136;5645;398;6776;6821;5.68;0.35;299.08;5.68;1131;16;2325.00;45
5647;16;22588153;5647;397;6777;6822;5.78;0.35;299.19;5.68;1130;16;2326.00;45
5650;16;22588172;5650;398;6778;6822;5.85;0.36;299.23;5.68;1128;16;2327.00;44
5652;16;22588190;5652;400;6781;6826;5.90;0.36;299.24;5.68;1129;16;2328.00;45
5653;16;22588208;5653;402;6781;6826;5.91;0.36;299.26;5.68;1128;16;2329.00;45
5655;16;22588227;5655;402;6781;6826;5.92;0.36;299.32;5.68;1126;16;2330.00;45
5656;16;22588252;5656;393;6784;6827;5.98;0.37;299.30;5.68;1128;17;2331.00;43
5659;16;22588282;5659;391;6785;6827;6.04;0.37;299.33;5.68;1126;17;2332.00;42
5663;16;22588299;5663;390;6789;6833;6.06;0.37;299.36;5.67;1126;17;2333.00;44
5664;16;22588318;5664;389;6790;6833;6.11;0.37;299.39;5.67;1126;17;2334.00;43
5669;16;22588335;5669;389;6790;6834;6.13;0.37;299.54;5.67;1121;17;2335.00;44
5671;16;22588353;5671;397;6790;6834;6.12;0.37;299.67;5.67;1119;17;2336.00;44
5676;16;22588371;5676;404;6790;6834;6.15;0.37;299.68;5.67;1114;17;2337.00;44
5678;16;22588392;5678;411;6790;6834;6.17;0.38;299.78;5.67;1112;17;2338.00;44
5679;16;22588422;5679;410;6790;6834;6.22;0.38;299.81;5.67;1111;17;2339.00;44
5683;16;22588449;5683;408;6818;6870;6.19;0.38;299.93;5.65;1135;17;2340.00;52
5686;16;22588472;5686;413;6819;6870;6.13;0.37;300.07;5.65;1133;17;2341.00;51
5688;16;22588493;5688;418;6821;6870;6.17;0.38;300.14;5.65;1133;17;2342.00;49
5691;16;22588511;5691;417;6821;6870;6.19;0.38;300.25;5.65;1130;17;2343.00;49
5694;16;22588526;5694;421;6822;6870;6.20;0.38;300.30;5.65;1128;17;2344.00;48
5698;16;22588541;5698;419;6822;6870;6.16;0.38;300.53;5.65;1124;17;2345.00;48
5700;16;22588559;5700;422;6826;6874;6.14;0.37;300.63;5.65;1126;17;2346.00;48
5701;16;22588575;5701;422;6826;6874;6.15;0.37;300.61;5.65;1125;17;2347.00;48
5705;16;22588591;5705;419;6830;6878;6.18;0.38;300.60;5.64;1125;17;2348.00;48
5708;16;22588609;5708;421;6831;6879;6.19;0.38;300.81;5.64;1123;17;2349.00;48
5709;16;22588626;5709;420;6831;6879;6.16;0.37;300.79;5.64;1122;17;2350.00;48
5714;16;22588643;5714;425;6831;6879;6.12;0.37;300.93;5.64;1117;17;2351.00;48
5717;16;22588658;5717;424;6842;6892;6.10;0.37;300.89;5.63;1125;17;2352.00;50
5719;16;22588686;5719;421;6842;6892;6.04;0.37;300.87;5.63;1123;17;2353.00;50
5721;16;22588702;5721;418;6842;6892;5.99;0.37;300.94;5.63;1121;17;2354.00;50
5724;16;22588717;5724;420;6843;6893;6.01;0.37;300.95;5.63;1119;17;2355.00;50
5726;16;22588732;5726;426;6843;6894;5.95;0.36;300.98;5.63;1117;17;2356.00;51
5728;16;22588747;5728;433;6843;6894;5.90;0.36;300.99;5.63;1115;17;2357.00;51
5730;16;22588764;5730;431;6845;6897;5.91;0.36;301.09;5.63;1115;17;2358.00;52
5732;16;22588778;5732;439;6845;6897;5.88;0.36;301.22;5.63;1113;17;2359.00;52
5738;16;22588792;5738;443;6846;6897;5.86;0.36;301.26;5.63;1108;17;2360.00;51
5738;16;22588807;5738;446;6846;6897;5.85;0.36;301.26;5.63;1108;17;2361.00;51
5739;16;22588822;5739;449;6851;6903;5.80;0.35;301.27;5.63;1112;17;2362.00;52
5740;16;22588837;5740;458;6851;6903;5.75;0.35;301.25;5.63;1111;17;2363.00;52
5741;16;22588852;5741;460;6851;6903;5.69;0.35;301.26;5.63;1110;17;2364.00;52
5741;17;22588867;5741;452;6851;6903;5.62;0.34;301.26;5.63;1110;18;2365.00;52
5742;17;22588898;5742;457;6854;6907;5.59;0.34;301.27;5.63;1112;18;2366.00;53
5745;17;22588912;5745;452;6855;6908;5.62;0.34;301.30;5.62;1110;18;2367.00;53
5747;17;22588931;5747;451;6855;6908;5.64;0.34;301.34;5.62;1108;18;2368.00;53
5750;17;22588947;5750;449;6856;6909;5.67;0.35;301.33;5.62;1106;18;2369.00;53
5751;17;22588965;5751;447;6856;6909;5.69;0.35;301.36;5.62;1105;18;2370.00;53
5754;17;22588979;5754;442;6856;6909;5.66;0.34;301.42;5.62;1102;18;2371.00;53
5755;17;22588995;5755;441;6856;6909;5.68;0.34;301.45;5.62;1101;18;2372.00;53
5759;17;22589011;5759;439;6856;6909;5.66;0.34;301.48;5.62;1097;18;2373.00;53
5759;17;22589029;5759;440;6856;6909;5.68;0.35;301.48;5.62;1097;18;2374.00;53
5760;17;22589048;5760;439;6856;6909;5.71;0.35;301.54;5.62;1096;18;2375.00;53
5762;17;22589070;5762;450;6896;6979;5.76;0.35;301.58;5.59;1134;18;2376.00;83
5764;17;22589092;5764;436;6896;6980;5.73;0.35;301.63;5.59;1132;18;2377.00;84
5765;17;22589107;5765;439;6901;6980;5.75;0.35;301.62;5.59;1136;18;2378.00;79
5770;17;22589124;5770;432;6901;6980;5.71;0.35;301.73;5.59;1131;18;2379.00;79
5773;17;22589141;5773;429;6904;6980;5.65;0.35;301.86;5.62;1131;18;2380.00;76
5774;17;22589159;5774;427;6907;6980;5.66;0.35;301.83;5.65;1133;18;2381.00;73
5777;17;22589175;5777;424;6909;6980;5.68;0.35;301.99;5.65;1132;18;2382.00;71
5779;17;22589190;5779;425;6913;6980;5.64;0.35;301.96;5.65;1134;18;2383.00;67
5780;17;22589206;5780;428;6915;6981;5.61;0.34;301.98;5.65;1135;18;2384.00;66
5783;17;22589223;5783;425;6917;6983;5.62;0.35;302.01;5.65;1134;18;2385.00;66
5788;17;22589238;5788;430;6919;6983;5.57;0.34;302.21;5.65;1131;18;2386.00;64
5794;17;22589265;5794;427;6924;6987;5.49;0.34;302.15;5.65;1130;18;2387.00;63
5798;17;22589280;5798;429;6926;6987;5.49;0.34;302.10;5.65;1128;18;2388.00;61
5798;17;22589297;5798;425;6927;6987;5.47;0.33;302.10;5.65;1129;18;2389.00;60
5800;17;22589311;5800;425;6928;6987;5.44;0.33;302.02;5.65;1128;18;2390.00;59
5801;17;22589324;5801;417;6932;6993;5.52;0.34;302.02;5.65;1131;18;2391.00;61
5805;17;22589339;5805;417;6932;6993;5.50;0.34;302.01;5.65;1127;18;2392.00;61
5807;17;22589354;5807;419;6933;6993;5.49;0.34;302.00;5.68;1126;18;2393.00;60
5809;17;22589369;5809;415;6935;6996;5.43;0.33;301.92;5.68;1126;18;2394.00;61
5810;17;22589385;5810;415;6936;6996;5.39;0.33;301.92;5.68;1126;18;2395.00;60
5814;17;22589400;5814;416;6937;6996;5.36;0.33;301.89;5.71;1123;18;2396.00;59
5818;17;22589414;5818;421;6937;6997;5.28;0.32;302.01;5.71;1119;18;2397.00;60
5820;17;22589429;5820;424;6938;6998;5.25;0.32;301.93;5.71;1118;18;2398.00;60
5824;17;22589442;5824;424;6938;6998;5.14;0.31;301.79;5.71;1114;18;2399.00;60
5825;17;22589458;5825;433;6963;7057;5.11;0.31;301.79;5.69;1138;18;2400.00;94
5828;17;22589484;5828;441;6967;7057;5.08;0.31;301.76;5.70;1139;18;2401.00;90
5829;17;22589500;5829;444;6971;7057;5.13;0.31;301.71;5.73;1142;18;2402.00;86
5830;17;22589515;5830;449;6974;7058;5.14;0.31;301.74;5.73;1144;18;2403.00;84
5830;17;22589530;5830;451;6975;7058;5.14;0.32;301.74;5.73;1145;18;2404.00;83
5833;17;22589545;5833;456;6981;7062;5.12;0.31;301.83;5.79;1148;18;2405.00;81
5835;17;22589567;5835;454;6983;7062;5.11;0.31;301.79;5.79;1148;18;2406.00;79
5835;17;22589580;5835;461;6989;7066;5.10;0.31;301.79;5.84;1154;18;2407.00;77
5835;17;22589594;5835;458;6990;7066;5.12;0.31;301.79;5.84;1155;18;2408.00;76
5840;17;22589611;5840;459;6990;7066;5.09;0.31;301.64;5.84;1150;18;2409.00;76
5843;17;22589627;5843;466;6993;7066;5.04;0.31;301.62;5.90;1150;18;2410.00;73
5846;17;22589644;5846;464;6993;7066;4.97;0.30;301.56;5.90;1147;18;2411.00;73
5846;17;22589657;5846;465;7004;7078;4.97;0.30;301.56;5.92;1158;18;2412.00;74
5847;17;22589672;5847;476;7006;7078;4.97;0.30;301.51;5.95;1159;18;2413.00;72
5848;17;22589686;5848;476;7008;7078;4.98;0.30;301.50;5.98;1160;18;2414.00;70
5849;17;22589701;5849;472;7008;7078;4.97;0.30;301.51;5.98;1159;18;2415.00;70
5851;17;22589716;5851;474;7009;7078;4.94;0.30;301.48;5.98;1158;18;2416.00;69
5852;17;22589729;5852;474;7010;7078;4.89;0.30;301.50;5.98;1158;18;2417.00;68
5854;17;22589742;5854;477;7013;7079;4.82;0.30;301.47;6.04;1159;18;2418.00;66
5856;17;22589757;5856;485;7013;7079;4.76;0.29;301.44;6.04;1157;18;2419.00;66
5858;17;22589772;5858;494;7019;7085;4.79;0.29;301.40;6.06;1161;18;2420.00;66
5859;17;22589787;5859;501;7020;7086;4.78;0.29;301.38;6.06;1161;18;2421.00;66
5862;17;22589801;5862;492;7024;7086;4.77;0.29;301.35;6.10;1162;18;2422.00;62
5864;17;22589815;5864;486;7025;7086;4.78;0.29;301.29;6.10;1161;18;2423.00;61
5865;17;22589829;5865;470;7029;7090;4.87;0.30;301.28;6.15;1164;18;2424.00;61
5868;17;22589845;5868;461;7029;7090;4.85;0.30;301.16;6.15;1161;18;2425.00;61
5869;17;22589858;5869;462;7034;7090;4.88;0.30;301.14;6.20;1165;18;2426.00;56
5870;17;22589872;5870;452;7037;7091;4.93;0.30;301.11;6.21;1167;18;2427.00;54
5871;17;22589887;5871;446;7040;7095;4.99;0.30;301.08;6.20;1169;18;2428.00;55
5872;17;22589902;5872;439;7042;7095;5.01;0.31;301.03;6.25;1170;18;2429.00;53
5873;17;22589919;5873;443;7047;7101;5.05;0.31;301.00;6.25;1174;18;2430.00;54
5873;17;22589933;5873;446;7048;7101;5.07;0.31;301.00;6.25;1175;18;2431.00;53
5875;17;22589949;5875;442;7051;7101;5.09;0.31;300.96;6.29;1176;18;2432.00;50
5875;17;22589963;5875;441;7051;7101;5.13;0.31;300.96;6.29;1176;18;2433.00;50
5875;17;22589976;5875;440;7057;7105;5.17;0.32;300.96;6.33;1182;18;2434.00;48
5875;17;22589998;5875;440;7057;7105;5.18;0.32;300.96;6.33;1182;18;2435.00;48
5876;17;22590015;5876;443;7058;7105;5.17;0.31;300.92;6.36;1182;18;2436.00;47
5879;17;22590037;5879;448;7060;7105;5.13;0.31;300.94;6.38;1181;18;2437.00;45
5879;17;22590053;5879;448;7060;7106;5.13;0.31;300.94;6.38;1181;18;2438.00;46
5881;17;22590067;5881;444;7063;7107;5.09;0.31;300.95;6.42;1182;18;2439.00;44
5883;17;22590081;5883;439;7064;7107;5.05;0.31;300.92;6.44;1181;18;2440.00;43
5883;17;22590096;5883;452;7065;7108;5.03;0.31;300.92;6.44;1182;18;2441.00;43
5885;17;22590108;5885;460;7066;7108;4.99;0.30;300.93;6.45;1181;18;2442.00;42
5889;17;22590121;5889;467;7069;7108;4.88;0.30;300.95;6.49;1180;18;2443.00;39
5892;17;22590136;5892;467;7069;7108;4.83;0.29;301.00;6.49;1177;18;2444.00;39
5898;17;22590151;5898;467;7072;7108;4.72;0.29;301.10;6.55;1174;18;2445.00;36
5900;17;22590166;5900;462;7072;7108;4.75;0.29;301.02;6.55;1172;18;2446.00;36
5906;17;22590180;5906;464;7072;7108;4.67;0.28;300.94;6.55;1166;18;2447.00;36
5908;17;22590193;5908;484;7144;7235;4.88;0.30;300.96;6.53;1236;18;2448.00;91
5912;17;22590221;5912;477;7147;7236;4.89;0.30;300.96;6.52;1235;18;2449.00;89
5915;17;22590235;5915;460;7154;7236;5.00;0.31;301.14;6.54;1239;18;2450.00;82
5917;17;22590251;5917;453;7159;7236;5.03;0.31;301.11;6.54;1242;18;2451.00;77
5918;17;22590268;5918;442;7164;7236;5.06;0.31;301.15;6.53;1246;18;2452.00;72
5921;17;22590295;5921;436;7165;7236;5.03;0.31;301.23;6.53;1244;18;2453.00;71
5925;17;22590319;5925;436;7169;7236;5.00;0.31;301.30;6.53;1244;18;2454.00;67
5929;17;22590336;5929;434;7172;7236;4.95;0.31;301.32;6.54;1243;18;2455.00;64
5931;17;22590357;5931;440;7174;7237;4.94;0.30;301.38;6.54;1243;18;2456.00;63
5933;17;22590382;5933;437;7176;7238;4.93;0.30;301.52;6.54;1243;18;2457.00;62
5935;17;22590407;5935;435;7178;7238;4.94;0.30;301.54;6.54;1243;18;2458.00;60
5939;17;22590428;5939;431;7183;7239;4.97;0.31;301.67;6.55;1244;18;2459.00;56
5945;17;22590461;5945;429;7185;7239;4.96;0.30;301.88;6.55;1240;18;2460.00;54
5945;17;22590485;5945;439;7187;7239;4.97;0.31;301.88;6.56;1242;18;2461.00;52
5950;17;22590506;5950;434;7190;7239;4.99;0.31;302.21;6.56;1240;18;2462.00;49
5957;17;22590522;5957;433;7192;7243;4.98;0.30;302.47;6.56;1235;18;2463.00;51
5958;17;22590538;5958;435;7192;7243;5.05;0.31;302.43;6.56;1234;18;2464.00;51
5963;17;22590555;5963;436;7194;7243;5.05;0.31;302.67;6.56;1231;18;2465.00;49
5965;17;22590571;5965;435;7196;7246;5.15;0.31;302.67;6.56;1231;18;2466.00;50
5970;17;22590587;5970;427;7198;7246;5.18;0.32;302.87;6.58;1228;18;2467.00;48
5973;17;22590603;5973;428;7199;7246;5.23;0.32;302.99;6.58;1226;18;2468.00;47
5975;17;22590618;5975;434;7205;7250;5.29;0.32;303.04;6.58;1230;18;2469.00;45
5980;17;22590634;5980;435;7207;7251;5.34;0.33;303.17;6.58;1227;18;2470.00;44
5980;17;22590652;5980;433;7208;7251;5.44;0.33;303.17;6.59;1228;18;2471.00;43
5983;17;22590667;5983;432;7210;7255;5.50;0.34;303.31;6.58;1227;18;2472.00;45
5989;17;22590682;5989;442;7213;7255;5.52;0.34;303.53;6.59;1224;18;2473.00;42
5992;17;22590698;5992;430;7213;7255;5.56;0.34;303.53;6.59;1221;18;2474.00;42
5997;17;22590713;5997;433;7217;7257;5.55;0.34;303.73;6.58;1220;18;2475.00;40
6000;17;22590737;6000;428;7217;7257;5.58;0.34;303.68;6.58;1217;18;2476.00;40
6003;17;22590754;6003;426;7221;7263;5.61;0.34;303.78;6.58;1218;18;2477.00;42
6008;17;22590770;6008;422;7221;7263;5.61;0.34;303.86;6.58;1213;18;2478.00;42
6012;17;22590786;6012;422;7222;7264;5.62;0.34;304.03;6.58;1210;18;2479.00;42
6017;17;22590802;6017;422;7222;7264;5.60;0.34;304.04;6.58;1205;18;2480.00;42
6020;17;22590818;6020;420;7222;7264;5.59;0.34;304.10;6.58;1202;18;2481.00;42
6025;17;22590835;6025;414;7222;7264;5.58;0.34;304.19;6.58;1197;18;2482.00;42
6030;17;22590853;6030;411;7222;7264;5.56;0.34;304.17;6.58;1192;18;2483.00;42
6033;17;22590868;6033;413;7228;7276;5.60;0.34;304.21;6.58;1195;18;2484.00;48
6036;17;22590885;6036;415;7230;7276;5.60;0.34;304.22;6.57;1194;18;2485.00;46
6038;17;22590901;6038;417;7230;7276;5.65;0.34;304.32;6.57;1192;18;2486.00;46
6041;17;22590919;6041;423;7230;7276;5.69;0.35;304.43;6.57;1189;18;2487.00;46
6044;17;22590938;6044;426;7230;7276;5.74;0.35;304.41;6.57;1186;18;2488.00;46
6047;17;22590955;6047;430;7231;7276;5.75;0.35;304.47;6.57;1184;18;2489.00;45
6053;17;22590977;6053;440;7234;7280;5.72;0.35;304.55;6.57;1181;18;2490.00;46
6055;17;22590996;6055;437;7234;7280;5.72;0.35;304.68;6.57;1179;18;2491.00;46
6059;17;22591016;6059;440;7238;7284;5.67;0.35;304.71;6.57;1179;18;2492.00;46
6064;17;22591033;6064;445;7240;7285;5.62;0.34;304.86;6.57;1176;18;2493.00;45
6066;17;22591050;6066;455;7241;7285;5.57;0.34;304.98;6.57;1175;18;2494.00;44
6072;17;22591068;6072;460;7242;7285;5.47;0.33;305.27;6.57;1170;18;2495.00;43
6073;17;22591086;6073;473;7252;7298;5.43;0.33;305.26;6.56;1179;18;2496.00;46
6078;17;22591108;6078;458;7252;7298;5.38;0.33;305.43;6.56;1174;18;2497.00;46
6080;17;22591125;6080;456;7253;7298;5.39;0.33;305.53;6.56;1173;18;2498.00;45
6082;17;22591142;6082;452;7254;7299;5.42;0.33;305.58;6.56;1172;18;2499.00;45
6085;17;22591165;6085;455;7254;7300;5.40;0.33;305.62;6.56;1169;18;2500.00;46
6089;17;22591192;6089;451;7254;7300;5.41;0.33;305.69;6.56;1165;18;2501.00;46
6094;17;22591213;6094;453;7256;7303;5.42;0.33;305.84;6.56;1162;18;2502.00;47
6094;17;22591232;6094;457;7256;7303;5.48;0.34;305.84;6.56;1162;18;2503.00;47
6098;17;22591253;6098;467;7257;7303;5.50;0.34;305.93;6.56;1159;18;2504.00;46
6099;17;22591272;6099;469;7257;7303;5.48;0.34;306.05;6.56;1158;18;2505.00;46
6100;17;22591293;6100;459;7262;7309;5.49;0.34;306.01;6.55;1162;18;2506.00;47
6103;17;22591316;6103;457;7262;7309;5.46;0.33;306.02;6.55;1159;18;2507.00;47
6104;17;22591346;6104;460;7262;7309;5.46;0.33;306.04;6.55;1158;18;2508.00;47
6109;17;22591371;6109;460;7262;7309;5.43;0.33;306.02;6.55;1153;18;2509.00;47
6109;17;22591395;6109;460;7264;7313;5.46;0.33;306.02;6.55;1155;18;2510.00;49
6113;17;22591417;6113;461;7265;7314;5.46;0.33;306.08;6.55;1152;18;2511.00;49
6118;17;22591439;6118;462;7265;7314;5.47;0.33;306.25;6.55;1147;18;2512.00;49
6120;17;22591459;6120;465;7266;7315;5.46;0.33;306.27;6.55;1146;18;2513.00;49
6122;17;22591481;6122;469;7266;7315;5.46;0.33;306.43;6.55;1144;18;2514.00;49
6126;17;22591500;6126;481;7266;7315;5.43;0.33;306.54;6.55;1140;18;2515.00;49
6128;17;22591520;6128;483;7266;7315;5.44;0.33;306.53;6.55;1138;18;2516.00;49
6132;17;22591538;6132;481;7266;7315;5.44;0.33;306.59;6.55;1134;18;2517.00;49
6133;17;22591558;6133;488;7266;7315;5.44;0.33;306.70;6.55;1133;18;2518.00;49
6136;17;22591579;6136;489;7266;7315;5.38;0.33;306.84;6.55;1130;18;2519.00;49
6138;17;22591604;6138;513;7334;7440;5.49;0.34;306.83;6.49;1196;18;2520.00;106
6139;17;22591635;6139;508;7335;7441;5.53;0.34;306.85;6.49;1196;18;2521.00;106
6141;17;22591654;6141;498;7342;7441;5.59;0.34;306.96;6.48;1201;18;2522.00;99
6142;17;22591674;6142;496;7343;7441;5.60;0.34;307.06;6.48;1201;18;2523.00;98
6143;17;22591693;6143;491;7347;7441;5.61;0.35;307.09;6.48;1204;18;2524.00;94
6145;17;22591712;6145;494;7349;7441;5.61;0.35;307.19;6.48;1204;18;2525.00;92
6151;17;22591728;6151;487;7354;7441;5.55;0.34;307.36;6.48;1203;18;2526.00;87
6152;17;22591746;6152;487;7358;7441;5.57;0.34;307.37;6.48;1206;18;2527.00;83
6156;17;22591763;6156;492;7364;7442;5.55;0.34;307.50;6.48;1208;18;2528.00;78
6158;17;22591783;6158;495;7368;7443;5.48;0.34;307.65;6.49;1210;18;2529.00;75
6162;17;22591800;6162;502;7371;7443;5.42;0.33;307.78;6.49;1209;18;2530.00;72
6164;17;22591816;6164;507;7375;7447;5.34;0.33;307.80;6.49;1211;18;2531.00;72
6167;17;22591833;6167;519;7378;7447;5.29;0.32;307.95;6.49;1211;18;2532.00;69
6170;17;22591853;6170;522;7380;7447;5.19;0.32;307.92;6.49;1210;18;2533.00;67
6172;17;22591871;6172;537;7383;7447;5.13;0.31;307.96;6.49;1211;18;2534.00;64
6176;17;22591889;6176;534;7388;7453;5.10;0.31;308.12;6.49;1212;18;2535.00;65
6177;17;22591907;6177;535;7390;7453;5.08;0.31;308.14;6.49;1213;18;2536.00;63
6179;17;22591926;6179;540;7393;7455;5.05;0.31;308.20;6.49;1214;18;2537.00;62
6182;17;22591948;6182;548;7396;7458;4.98;0.31;308.22;6.49;1214;18;2538.00;62
6183;17;22591972;6183;554;7396;7458;4.92;0.30;308.24;6.49;1213;18;2539.00;62
6184;17;22591991;6184;554;7396;7458;4.84;0.30;308.25;6.49;1212;18;2540.00;62
6189;17;22592013;6189;555;7396;7459;4.74;0.29;308.48;6.49;1207;18;2541.00;63
6190;17;22592041;6190;558;7397;7460;4.72;0.29;308.46;6.49;1207;18;2542.00;63
6192;17;22592061;6192;551;7398;7460;4.68;0.29;308.45;6.49;1206;18;2543.00;62
6194;17;22592079;6194;559;7407;7473;4.69;0.29;308.40;6.48;1213;18;2544.00;66
6196;17;22592098;6196;555;7407;7473;4.73;0.29;308.39;6.48;1211;18;2545.00;66
6198;17;22592116;6198;558;7407;7473;4.76;0.29;308.37;6.48;1209;18;2546.00;66
6198;17;22592132;6198;557;7408;7474;4.79;0.29;308.37;6.48;1210;18;2547.00;66
6200;17;22592148;6200;560;7408;7474;4.85;0.30;308.43;6.48;1208;18;2548.00;66
6204;17;22592165;6204;562;7410;7478;4.86;0.30;308.41;6.48;1206;18;2549.00;68
6205;17;22592183;6205;564;7413;7481;4.89;0.30;308.39;6.48;1208;18;2550.00;68
6205;17;22592203;6205;567;7417;7485;4.91;0.30;308.39;6.48;1212;18;2551.00;68
6206;17;22592223;6206;563;7417;7485;4.88;0.30;308.41;6.48;1211;18;2552.00;68
6208;17;22592239;6208;572;7418;7485;4.85;0.30;308.40;6.48;1210;18;2553.00;67
6212;17;22592256;6212;569;7418;7485;4.79;0.29;308.45;6.48;1206;18;2554.00;67
6215;17;22592272;6215;569;7420;7485;4.72;0.29;308.47;6.54;1205;18;2555.00;65
6219;17;22592294;6219;569;7431;7497;4.74;0.29;308.59;6.53;1212;18;2556.00;66
6221;17;22592316;6221;568;7431;7497;4.70;0.29;308.57;6.53;1210;18;2557.00;66
6226;17;22592331;6226;563;7432;7497;4.69;0.29;308.65;6.53;1206;18;2558.00;65
6229;17;22592350;6229;557;7432;7497;4.70;0.29;308.62;6.53;1203;18;2559.00;65
6231;17;22592369;6231;558;7432;7497;4.75;0.29;308.57;6.53;1201;18;2560.00;65
6233;17;22592391;6233;557;7432;7497;4.78;0.29;308.56;6.53;1199;18;2561.00;65
6235;17;22592416;6235;553;7432;7498;4.85;0.30;308.51;6.53;1197;18;2562.00;66
6238;17;22592432;6238;546;7432;7498;4.91;0.30;308.47;6.53;1194;18;2563.00;66
6242;17;22592451;6242;542;7436;7504;4.97;0.31;308.38;6.52;1194;18;2564.00;68
6243;17;22592475;6243;543;7437;7506;4.99;0.31;308.35;6.52;1194;18;2565.00;69
6247;17;22592500;6247;537;7438;7506;4.99;0.31;308.32;6.52;1191;18;2566.00;68
6249;17;22592520;6249;542;7438;7506;4.99;0.31;308.25;6.52;1189;18;2567.00;68
6252;17;22592546;6252;539;7440;7510;5.01;0.31;308.14;6.52;1188;18;2568.00;70
6253;17;22592567;6253;538;7440;7510;5.01;0.31;308.17;6.52;1187;18;2569.00;70
6255;17;22592583;6255;544;7440;7510;4.99;0.31;308.16;6.52;1185;18;2570.00;70
6257;17;22592600;6257;545;7441;7511;5.01;0.31;308.25;6.52;1184;18;2571.00;70
6259;17;22592620;6259;539;7446;7515;4.99;0.30;308.25;6.52;1187;18;2572.00;69
6260;17;22592637;6260;533;7447;7515;4.99;0.30;308.20;6.53;1187;18;2573.00;68
6263;17;22592657;6263;532;7449;7518;4.98;0.30;308.17;6.53;1186;18;2574.00;69
6264;17;22592678;6264;533;7451;7518;4.98;0.30;308.12;6.53;1187;18;2575.00;67
6264;17;22592696;6264;537;7452;7518;4.97;0.30;308.12;6.53;1188;18;2576.00;66
6265;17;22592715;6265;528;7452;7518;4.96;0.30;308.14;6.53;1187;18;2577.00;66
6267;17;22592739;6267;535;7456;7522;5.00;0.30;308.22;6.53;1189;18;2578.00;66
6269;17;22592757;6269;522;7457;7522;5.00;0.30;308.18;6.57;1188;18;2579.00;65
6271;17;22592776;6271;516;7458;7522;4.98;0.30;308.21;6.60;1187;18;2580.00;64
6274;17;22592795;6274;512;7459;7522;4.95;0.30;308.17;6.60;1185;18;2581.00;63
6275;17;22592813;6275;507;7459;7523;4.91;0.30;308.18;6.60;1184;18;2582.00;64
6277;17;22592830;6277;503;7462;7524;4.88;0.30;308.20;6.66;1185;18;2583.00;62
6277;17;22592847;6277;497;7462;7524;4.85;0.30;308.20;6.66;1185;18;2584.00;62
6277;17;22592866;6277;492;7464;7525;4.90;0.30;308.20;6.69;1187;18;2585.00;61
6279;17;22592885;6279;494;7465;7525;4.96;0.30;308.21;6.72;1186;18;2586.00;60
6280;17;22592902;6280;493;7466;7525;5.02;0.31;308.21;6.75;1186;18;2587.00;59
6280;17;22592918;6280;486;7468;7525;5.08;0.31;308.21;6.81;1188;18;2588.00;57
6282;17;22592933;6282;489;7468;7525;5.13;0.31;308.16;6.81;1186;18;2589.00;57
6283;17;22592951;6283;487;7470;7525;5.16;0.32;308.12;6.86;1187;18;2590.00;55
6288;17;22592968;6288;489;7470;7525;5.17;0.32;308.04;6.86;1182;18;2591.00;55
6288;17;22592985;6288;515;7541;7652;5.42;0.34;308.04;6.80;1253;18;2592.00;111
6288;17;22593013;6288;511;7545;7653;5.50;0.34;308.04;6.82;1257;19;2593.00;108
6288;17;22593037;6288;505;7554;7653;5.62;0.35;308.04;6.82;1266;19;2594.00;99
6288;17;22593055;6288;500;7558;7653;5.64;0.35;308.04;6.84;1270;19;2595.00;95
6289;17;22593071;6289;500;7562;7653;5.67;0.35;308.01;6.84;1273;19;2596.00;91
6291;17;22593087;6291;503;7566;7653;5.63;0.35;308.05;6.90;1275;19;2597.00;87
6291;17;22593112;6291;501;7571;7653;5.62;0.35;308.05;6.92;1280;19;2598.00;82
6295;17;22593140;6295;491;7574;7653;5.61;0.35;307.99;6.95;1279;19;2599.00;79
6298;17;22593162;6298;488;7576;7654;5.58;0.35;307.94;6.95;1278;19;2600.00;78
6299;17;22593192;6299;487;7581;7655;5.58;0.35;307.95;7.00;1282;19;2601.00;74
6303;17;22593212;6303;477;7583;7655;5.54;0.34;307.89;7.00;1280;19;2602.00;72
6303;17;22593236;6303;472;7585;7656;5.51;0.34;307.89;7.00;1282;19;2603.00;71
6311;17;22593254;6311;470;7589;7656;5.44;0.34;308.06;7.00;1278;19;2604.00;67
6313;17;22593272;6313;465;7592;7656;5.40;0.33;308.17;7.00;1279;19;2605.00;64
6315;17;22593289;6315;472;7596;7656;5.38;0.33;308.16;7.10;1281;19;2606.00;60
6319;17;22593305;6319;471;7600;7660;5.40;0.33;308.28;7.10;1281;19;2607.00;60
6323;17;22593322;6323;470;7604;7660;5.38;0.33;308.23;7.17;1281;19;2608.00;56
6327;17;22593339;6327;475;7604;7660;5.39;0.33;308.27;7.17;1277;19;2609.00;56
6329;18;22593357;6329;470;7608;7666;5.39;0.33;308.30;7.17;1279;20;2610.00;58
6331;18;22593390;6331;469;7611;7666;5.41;0.33;308.26;7.23;1280;20;2611.00;55
6335;18;22593407;6335;467;7612;7666;5.41;0.33;308.31;7.23;1277;20;2612.00;54
6337;18;22593423;6337;470;7617;7670;5.40;0.33;308.29;7.25;1280;20;2613.00;53
6341;18;22593440;6341;484;7620;7671;5.38;0.33;308.46;7.27;1279;20;2614.00;51
6342;18;22593456;6342;478;7620;7671;5.36;0.33;308.50;7.27;1278;20;2615.00;51
6347;18;22593476;6347;485;7626;7675;5.28;0.32;308.55;7.30;1279;21;2616.00;49
6349;18;22593499;6349;491;7626;7675;5.22;0.32;308.56;7.30;1277;21;2617.00;49
6350;18;22593514;6350;499;7629;7675;5.22;0.32;308.54;7.33;1279;21;2618.00;46
6353;18;22593529;6353;498;7630;7676;5.21;0.32;308.61;7.34;1277;21;2619.00;46
6357;18;22593552;6357;502;7630;7676;5.22;0.32;308.63;7.34;1273;21;2620.00;46
6360;18;22593571;6360;505;7635;7682;5.24;0.32;308.57;7.36;1275;21;2621.00;47
6364;18;22593587;6364;502;7635;7682;5.19;0.32;308.63;7.36;1271;21;2622.00;47
6371;18;22593602;6371;508;7637;7683;5.12;0.31;308.89;7.38;1266;21;2623.00;46
6377;18;22593621;6377;500;7639;7683;5.02;0.31;308.95;7.38;1262;21;2624.00;44
6380;18;22593636;6380;488;7639;7683;5.04;0.31;308.97;7.38;1259;21;2625.00;44
6385;18;22593652;6385;480;7639;7683;5.01;0.31;309.17;7.38;1254;21;2626.00;44
6387;18;22593668;6387;469;7639;7683;5.00;0.31;309.17;7.38;1252;21;2627.00;44
6395;18;22593684;6395;467;7648;7695;4.96;0.30;309.25;7.38;1253;21;2628.00;47
6398;18;22593703;6398;457;7648;7695;5.03;0.31;309.31;7.38;1250;21;2629.00;47
6401;18;22593723;6401;455;7649;7695;5.08;0.31;309.42;7.38;1248;21;2630.00;46
6405;18;22593742;6405;462;7649;7695;5.17;0.32;309.55;7.38;1244;21;2631.00;46
6408;18;22593764;6408;450;7650;7695;5.25;0.32;309.70;7.38;1242;21;2632.00;45
6411;18;22593780;6411;445;7650;7695;5.34;0.33;309.69;7.38;1239;21;2633.00;45
6413;18;22593798;6413;441;7652;7699;5.44;0.33;309.73;7.38;1239;21;2634.00;47
6415;18;22593817;6415;431;7652;7699;5.53;0.34;309.88;7.38;1237;21;2635.00;47
6418;18;22593835;6418;418;7655;7703;5.62;0.34;310.01;7.37;1237;21;2636.00;48
6422;18;22593853;6422;419;7655;7704;5.69;0.35;310.09;7.37;1233;21;2637.00;49
6426;18;22593882;6426;421;7655;7704;5.73;0.35;310.20;7.37;1229;21;2638.00;49
6429;18;22593902;6429;420;7655;7704;5.81;0.36;310.33;7.37;1226;21;2639.00;49
6434;18;22593923;6434;428;7672;7733;5.86;0.36;310.42;7.36;1238;21;2640.00;61
6440;18;22593946;6440;428;7674;7733;5.92;0.36;310.55;7.36;1234;21;2641.00;59
6443;18;22593967;6443;423;7677;7733;6.03;0.37;310.65;7.35;1234;21;2642.00;56
6448;18;22593984;6448;424;7680;7734;6.04;0.37;310.77;7.35;1232;21;2643.00;54
6452;18;22594004;6452;420;7681;7735;6.03;0.37;310.77;7.35;1229;21;2644.00;54
6459;18;22594026;6459;419;7682;7735;6.05;0.37;310.91;7.35;1223;21;2645.00;53
6463;18;22594046;6463;415;7683;7738;6.04;0.37;310.91;7.35;1220;21;2646.00;55
6468;18;22594064;6468;416;7683;7738;6.02;0.37;311.04;7.35;1215;21;2647.00;55
6476;18;22594083;6476;414;7683;7738;5.94;0.36;311.26;7.35;1207;21;2648.00;55
6479;18;22594103;6479;412;7685;7738;5.89;0.36;311.25;7.36;1206;21;2649.00;53
6483;18;22594119;6483;411;7689;7744;5.83;0.36;311.38;7.35;1206;21;2650.00;55
6486;18;22594137;6486;420;7690;7744;5.75;0.35;311.36;7.35;1204;21;2651.00;54
6491;18;22594153;6491;418;7691;7744;5.70;0.35;311.39;7.35;1200;21;2652.00;53
6495;18;22594171;6495;426;7691;7744;5.74;0.35;311.41;7.35;1196;21;2653.00;53
6502;18;22594186;6502;428;7694;7748;5.73;0.35;311.50;7.35;1192;21;2654.00;54
6507;18;22594204;6507;433;7696;7750;5.75;0.35;311.59;7.35;1189;21;2655.00;54
6512;18;22594225;6512;430;7698;7750;5.77;0.35;311.68;7.35;1186;21;2656.00;52
6513;18;22594247;6513;431;7699;7751;5.84;0.36;311.73;7.35;1186;21;2657.00;52
6517;18;22594266;6517;439;7699;7751;5.88;0.36;311.89;7.35;1182;21;2658.00;52
6520;18;22594285;6520;447;7699;7751;5.91;0.36;311.92;7.35;1179;21;2659.00;52
6523;18;22594303;6523;446;7699;7751;5.95;0.36;311.99;7.35;1176;21;2660.00;52
6527;18;22594321;6527;451;7699;7751;6.00;0.37;312.14;7.35;1172;21;2661.00;52
6530;18;22594338;6530;457;7699;7751;6.04;0.37;312.11;7.35;1169;21;2662.00;52
6534;18;22594355;6534;458;7699;7751;6.04;0.37;312.18;7.35;1165;21;2663.00;52
6539;18;22594376;6539;473;7739;7821;6.04;0.37;312.43;7.31;1200;21;2664.00;82
6543;18;22594412;6543;477;7739;7822;6.02;0.37;312.46;7.31;1196;21;2665.00;83
6546;18;22594453;6546;469;7744;7822;6.05;0.37;312.56;7.31;1198;21;2666.00;78
6552;18;22594476;6552;470;7746;7822;5.99;0.37;312.72;7.31;1194;21;2667.00;76
6554;18;22594502;6554;467;7749;7822;5.90;0.36;312.70;7.31;1195;21;2668.00;73
6560;18;22594525;6560;476;7750;7822;5.85;0.36;312.97;7.31;1190;21;2669.00;72
6565;18;22594553;6565;485;7754;7822;5.81;0.35;313.21;7.31;1189;21;2670.00;68
6566;18;22594573;6566;496;7756;7822;5.80;0.35;313.23;7.31;1190;21;2671.00;66
6571;18;22594593;6571;496;7759;7823;5.70;0.35;313.34;7.31;1188;21;2672.00;64
6573;18;22594613;6573;498;7761;7824;5.65;0.34;313.42;7.31;1188;21;2673.00;63
6578;18;22594629;6578;496;7761;7824;5.54;0.34;313.45;7.31;1183;21;2674.00;63
6579;18;22594645;6579;501;7765;7828;5.50;0.34;313.48;7.30;1186;21;2675.00;63
6581;18;22594661;6581;503;7765;7828;5.45;0.33;313.51;7.30;1184;21;2676.00;63
6582;18;22594675;6582;506;7765;7828;5.46;0.33;313.60;7.30;1183;21;2677.00;63
6585;18;22594693;6585;510;7766;7828;5.46;0.33;313.63;7.31;1181;21;2678.00;62
6589;18;22594710;6589;516;7771;7834;5.49;0.34;313.75;7.30;1182;21;2679.00;63
6592;18;22594726;6592;523;7771;7834;5.53;0.34;313.85;7.30;1179;21;2680.00;63
6592;18;22594742;6592;515;7771;7834;5.57;0.34;313.85;7.30;1179;21;2681.00;63
6598;18;22594757;6598;512;7773;7837;5.61;0.34;314.01;7.30;1175;21;2682.00;64
6599;18;22594775;6599;518;7773;7837;5.65;0.35;314.11;7.30;1174;21;2683.00;64
6602;18;22594798;6602;518;7774;7837;5.63;0.34;314.27;7.30;1172;21;2684.00;63
6605;18;22594814;6605;522;7774;7838;5.60;0.34;314.37;7.30;1169;21;2685.00;64
6609;18;22594837;6609;517;7777;7839;5.58;0.34;314.45;7.31;1168;21;2686.00;62
6611;18;22594856;6611;523;7777;7839;5.57;0.34;314.52;7.31;1166;21;2687.00;62
6614;18;22594873;6614;533;7788;7852;5.54;0.34;314.60;7.30;1174;21;2688.00;64
6620;18;22594890;6620;539;7790;7852;5.49;0.33;314.71;7.31;1170;21;2689.00;62
6621;18;22594908;6621;542;7790;7852;5.46;0.33;314.78;7.31;1169;21;2690.00;62
6626;18;22594923;6626;544;7793;7853;5.43;0.33;314.93;7.31;1167;21;2691.00;60
6628;18;22594939;6628;544;7794;7853;5.40;0.33;315.00;7.31;1166;21;2692.00;59
6629;18;22594957;6629;541;7799;7857;5.41;0.33;315.06;7.31;1170;21;2693.00;58
6632;18;22594973;6632;543;7799;7857;5.41;0.33;315.27;7.31;1167;21;2694.00;58
6634;18;22594989;6634;532;7801;7861;5.41;0.33;315.40;7.31;1167;21;2695.00;60
6635;18;22595012;6635;533;7803;7861;5.43;0.33;315.38;7.31;1168;21;2696.00;58
6639;18;22595038;6639;531;7803;7861;5.41;0.33;315.63;7.31;1164;21;2697.00;58
6642;18;22595069;6642;531;7803;7861;5.39;0.33;315.60;7.31;1161;21;2698.00;58
6644;18;22595089;6644;526;7803;7861;5.34;0.33;315.70;7.31;1159;21;2699.00;58
6646;18;22595114;6646;530;7831;7910;5.38;0.33;315.71;7.29;1185;21;2700.00;79
6648;18;22595140;6648;528;7832;7910;5.33;0.33;315.78;7.29;1184;21;2701.00;78
6648;18;22595157;6648;523;7834;7910;5.31;0.32;315.78;7.28;1186;21;2702.00;76
6652;18;22595171;6652;519;7834;7910;5.28;0.32;315.74;7.28;1182;21;2703.00;76
6654;18;22595189;6654;522;7837;7910;5.30;0.32;315.75;7.28;1183;21;2704.00;73
6655;18;22595208;6655;524;7838;7910;5.34;0.33;315.75;7.28;1183;21;2705.00;72
6656;18;22595228;6656;525;7839;7911;5.37;0.33;315.72;7.28;1183;21;2706.00;72
6657;18;22595251;6657;519;7839;7911;5.41;0.33;315.73;7.28;1182;21;2707.00;72
6660;18;22595275;6660;528;7843;7917;5.39;0.33;315.72;7.28;1183;21;2708.00;74
6661;18;22595297;6661;530;7844;7918;5.39;0.33;315.69;7.28;1183;21;2709.00;74
6662;18;22595321;6662;535;7844;7918;5.38;0.33;315.66;7.28;1182;21;2710.00;74
6664;18;22595348;6664;540;7845;7918;5.34;0.33;315.62;7.28;1181;21;2711.00;73
6667;18;22595374;6667;543;7849;7922;5.32;0.33;315.58;7.28;1182;21;2712.00;73
6669;18;22595403;6669;541;7849;7922;5.27;0.32;315.58;7.28;1180;21;2713.00;73
6670;18;22595425;6670;542;7849;7922;5.24;0.32;315.59;7.28;1179;21;2714.00;73
6673;18;22595440;6673;547;7850;7923;5.26;0.32;315.59;7.28;1177;21;2715.00;73
6677;18;22595458;6677;549;7853;7927;5.21;0.32;315.60;7.27;1176;21;2716.00;74
6680;18;22595474;6680;546;7854;7927;5.14;0.31;315.60;7.28;1174;21;2717.00;73
6683;18;22595491;6683;544;7857;7930;5.19;0.32;315.57;7.27;1174;21;2718.00;73
6685;18;22595514;6685;547;7857;7930;5.24;0.32;315.53;7.27;1172;21;2719.00;73
6691;18;22595531;6691;541;7858;7930;5.26;0.32;315.63;7.27;1167;21;2720.00;72
6694;18;22595552;6694;539;7858;7930;5.25;0.32;315.59;7.27;1164;21;2721.00;72
6698;18;22595580;6698;534;7861;7934;5.24;0.32;315.53;7.27;1163;21;2722.00;73
6701;18;22595616;6701;538;7862;7934;5.21;0.32;315.50;7.27;1161;21;2723.00;72
6703;18;22595645;6703;536;7863;7934;5.16;0.31;315.42;7.28;1160;21;2724.00;71
6704;18;22595660;6704;532;7863;7934;5.14;0.31;315.38;7.28;1159;21;2725.00;71
6705;18;22595679;6705;527;7863;7935;5.12;0.31;315.38;7.28;1158;21;2726.00;72
6708;18;22595697;6708;534;7864;7936;5.07;0.31;315.35;7.27;1156;21;2727.00;72
6710;18;22595717;6710;531;7864;7936;5.02;0.30;315.29;7.27;1154;21;2728.00;72
6711;18;22595734;6711;524;7866;7937;4.97;0.30;315.28;7.28;1155;21;2729.00;71
6712;18;22595755;6712;521;7868;7937;4.89;0.30;315.25;7.31;1156;21;2730.00;69
6714;18;22595774;6714;525;7869;7937;4.79;0.29;315.22;7.32;1155;21;2731.00;68
6716;18;22595795;6716;519;7870;7937;4.76;0.29;315.21;7.32;1154;21;2732.00;67
6717;18;22595812;6717;515;7870;7937;4.75;0.29;315.24;7.32;1153;21;2733.00;67
6721;18;22595826;6721;513;7870;7937;4.73;0.29;315.18;7.32;1149;21;2734.00;67
6721;18;22595842;6721;508;7870;7937;4.75;0.29;315.18;7.32;1149;21;2735.00;67
6721;18;22595860;6721;505;7935;8064;5.00;0.31;315.18;7.26;1214;21;2736.00;129
6721;18;22595890;6721;487;7936;8065;5.07;0.31;315.18;7.26;1215;21;2737.00;129
6722;18;22595908;6722;468;7943;8065;5.18;0.32;315.15;7.26;1221;21;2738.00;122
6724;18;22595925;6724;455;7948;8065;5.27;0.33;315.14;7.25;1224;21;2739.00;117
6726;18;22595945;6726;449;7953;8065;5.38;0.33;315.15;7.25;1227;21;2740.00;112
6727;18;22595966;6727;440;7956;8065;5.49;0.34;315.13;7.25;1229;21;2741.00;109
6728;18;22595984;6728;428;7960;8065;5.59;0.34;315.12;7.25;1232;21;2742.00;105
6728;18;22596013;6728;416;7961;8065;5.70;0.35;315.12;7.25;1233;21;2743.00;104
6730;18;22596035;6730;423;7963;8066;5.79;0.35;315.07;7.25;1233;21;2744.00;103
6734;18;22596052;6734;417;7965;8068;5.79;0.35;315.02;7.25;1231;21;2745.00;103
6738;18;22596075;6738;416;7967;8068;5.80;0.35;314.96;7.25;1229;21;2746.00;101
6739;18;22596094;6739;415;7970;8069;5.82;0.36;314.97;7.26;1231;21;2747.00;99
6742;18;22596120;6742;414;7973;8069;5.81;0.35;314.90;7.26;1231;21;2748.00;96
6744;18;22596140;6744;406;7976;8069;5.78;0.35;314.97;7.26;1232;21;2749.00;93
6744;18;22596166;6744;413;7980;8069;5.81;0.35;314.97;7.26;1236;21;2750.00;89
6746;18;22596188;6746;410;7984;8073;5.84;0.36;314.94;7.32;1238;21;2751.00;89
6748;18;22596214;6748;409;7988;8073;5.85;0.36;314.97;7.32;1240;21;2752.00;85
6749;18;22596247;6749;416;7990;8073;5.85;0.36;315.01;7.32;1241;21;2753.00;83
6749;18;22596272;6749;420;7993;8076;5.88;0.36;315.01;7.33;1244;21;2754.00;83
6751;18;22596295;6751;427;7997;8076;5.90;0.36;314.95;7.36;1246;21;2755.00;79
6753;18;22596312;6753;427;7999;8076;5.90;0.36;314.96;7.37;1246;21;2756.00;77
6753;18;22596346;6753;430;8002;8080;5.94;0.36;314.96;7.36;1249;21;2757.00;78
6755;18;22596385;6755;435;8005;8081;6.02;0.37;315.06;7.40;1250;21;2758.00;76
6757;18;22596417;6757;441;8005;8081;5.98;0.36;314.99;7.40;1248;21;2759.00;76
6760;18;22596443;6760;445;8012;8086;5.98;0.36;314.92;7.43;1252;21;2760.00;74
6763;18;22596471;6763;447;8013;8086;5.98;0.36;315.10;7.47;1250;21;2761.00;73
6763;18;22596494;6763;452;8015;8086;5.96;0.36;315.10;7.50;1252;21;2762.00;71
6763;18;22596514;6763;454;8017;8087;5.92;0.36;315.10;7.56;1254;21;2763.00;70
6766;18;22596533;6766;467;8019;8087;5.92;0.36;315.19;7.57;1253;21;2764.00;68
6768;18;22596553;6768;469;8024;8093;5.90;0.36;315.13;7.59;1256;21;2765.00;69
6769;18;22596580;6769;477;8026;8093;5.87;0.36;315.24;7.62;1257;21;2766.00;67
6773;18;22596600;6773;477;8026;8094;5.79;0.35;315.38;7.62;1253;21;2767.00;68
6776;18;22596622;6776;477;8028;8094;5.72;0.35;315.33;7.65;1252;21;2768.00;66
6780;18;22596643;6780;482;8028;8094;5.69;0.35;315.52;7.65;1248;21;2769.00;66
6783;18;22596667;6783;484;8029;8094;5.64;0.34;315.65;7.68;1246;21;2770.00;65
6783;18;22596688;6783;485;8029;8094;5.63;0.34;315.65;7.68;1246;21;2771.00;65
6786;18;22596707;6786;484;8040;8106;5.65;0.34;315.67;7.71;1254;21;2772.00;66
6788;18;22596741;6788;478;8040;8106;5.62;0.34;315.76;7.71;1252;21;2773.00;66
6788;18;22596770;6788;480;8043;8106;5.67;0.35;315.76;7.77;1255;21;2774.00;63
6790;18;22596789;6790;473;8043;8106;5.66;0.35;315.78;7.77;1253;21;2775.00;63
6794;18;22596808;6794;463;8045;8106;5.64;0.35;315.76;7.82;1251;21;2776.00;61
6796;18;22596828;6796;462;8046;8106;5.65;0.35;315.71;7.85;1250;21;2777.00;60
6798;18;22596851;6798;464;8049;8110;5.69;0.35;315.66;7.85;1251;21;2778.00;61
6801;18;22596871;6801;464;8050;8110;5.67;0.35;315.67;7.88;1249;21;2779.00;60
6803;18;22596898;6803;463;8054;8114;5.72;0.35;315.76;7.88;1251;21;2780.00;60
6806;18;22596924;6806;457;8055;8115;5.73;0.35;315.88;7.87;1249;21;2781.00;60
6810;18;22596947;6810;450;8058;8115;5.74;0.35;315.99;7.96;1248;21;2782.00;57
6813;18;22596964;6813;439;8059;8115;5.75;0.35;315.99;7.98;1246;21;2783.00;56
6816;18;22596984;6816;437;8070;8128;5.78;0.35;316.10;7.97;1254;21;2784.00;58
6818;18;22597024;6818;434;8072;8128;5.81;0.36;316.10;8.03;1254;21;2785.00;56
6822;18;22597047;6822;436;8072;8128;5.81;0.36;316.13;8.03;1250;21;2786.00;56
6826;18;22597067;6826;444;8073;8129;5.79;0.35;316.21;8.02;1247;21;2787.00;56
6829;18;22597084;6829;445;8073;8130;5.80;0.36;316.32;8.02;1244;21;2788.00;57
6832;18;22597101;6832;442;8075;8130;5.77;0.35;316.34;8.08;1243;21;2789.00;55
6835;18;22597123;6835;451;8081;8136;5.74;0.35;316.41;8.09;1246;21;2790.00;55
6838;18;22597148;6838;448;8082;8136;5.72;0.35;316.52;8.12;1244;21;2791.00;54
6844;18;22597165;6844;458;8083;8136;5.66;0.35;316.51;8.12;1239;21;2792.00;53
6847;18;22597180;6847;459;8085;8136;5.60;0.34;316.56;8.16;1238;21;2793.00;51
6850;18;22597195;6850;465;8090;8142;5.61;0.34;316.66;8.16;1240;21;2794.00;52
6855;18;22597212;6855;465;8090;8142;5.52;0.34;316.71;8.16;1235;21;2795.00;52
6858;18;22597229;6858;467;8092;8142;5.48;0.34;316.69;8.21;1234;21;2796.00;50
6862;18;22597245;6862;469;8092;8142;5.42;0.33;316.73;8.21;1230;21;2797.00;50
6865;18;22597261;6865;475;8095;8146;5.37;0.33;316.78;8.21;1230;21;2798.00;51
6868;18;22597276;6868;470;8096;8147;5.30;0.32;316.80;8.20;1228;21;2799.00;51
6870;18;22597296;6870;456;8096;8147;5.26;0.32;316.86;8.20;1226;21;2800.00;51
6875;18;22597316;6875;460;8097;8148;5.24;0.32;317.08;8.20;1222;21;2801.00;51
6878;18;22597333;6878;456;8097;8148;5.20;0.32;317.15;8.20;1219;21;2802.00;51
6883;18;22597349;6883;447;8097;8148;5.13;0.31;317.28;8.20;1214;21;2803.00;51
6885;18;22597366;6885;441;8097;8148;5.11;0.31;317.36;8.20;1212;21;2804.00;51
6889;18;22597380;6889;439;8097;8148;5.12;0.31;317.48;8.20;1208;21;2805.00;51
6890;18;22597397;6890;434;8097;8148;5.16;0.31;317.45;8.20;1207;21;2806.00;51
6892;18;22597414;6892;430;8097;8148;5.22;0.32;317.53;8.20;1205;21;2807.00;51
6894;18;22597440;6894;432;8137;8218;5.39;0.33;317.60;8.16;1243;21;2808.00;81
6896;18;22597472;6896;420;8140;8219;5.46;0.33;317.59;8.16;1244;21;2809.00;79
6897;18;22597490;6897;419;8144;8219;5.55;0.34;317.58;8.16;1247;21;2810.00;75
6898;18;22597508;6898;426;8148;8219;5.61;0.34;317.56;8.16;1250;21;2811.00;71
6899;18;22597531;6899;424;8149;8219;5.65;0.35;317.66;8.15;1250;21;2812.00;70
6901;18;22597552;6901;426;8151;8219;5.65;0.35;317.68;8.15;1250;21;2813.00;68
6907;18;22597572;6907;429;8152;8219;5.63;0.34;317.64;8.15;1245;21;2814.00;67
6910;18;22597590;6910;430;8154;8219;5.63;0.34;317.70;8.15;1244;21;2815.00;65
6913;18;22597611;6913;433;8155;8220;5.68;0.35;317.73;8.15;1242;21;2816.00;65
6920;18;22597631;6920;435;8156;8221;5.64;0.34;317.71;8.15;1236;21;2817.00;65
6921;18;22597650;6921;436;8158;8221;5.64;0.34;317.78;8.15;1237;21;2818.00;63
6925;18;22597668;6925;443;8160;8225;5.64;0.34;317.84;8.15;1235;21;2819.00;65
6927;18;22597687;6927;442;8161;8225;5.64;0.34;317.85;8.15;1234;21;2820.00;64
6931;18;22597705;6931;452;8161;8225;5.60;0.34;318.02;8.15;1230;21;2821.00;64
6935;18;22597722;6935;465;8161;8225;5.59;0.34;317.99;8.15;1226;21;2822.00;64
6939;18;22597739;6939;461;8165;8231;5.56;0.34;318.12;8.15;1226;21;2823.00;66
6943;18;22597757;6943;457;8165;8231;5.60;0.34;318.24;8.15;1222;21;2824.00;66
6949;18;22597774;6949;456;8165;8231;5.59;0.34;318.32;8.15;1216;21;2825.00;66
6951;18;22597790;6951;457;8167;8234;5.62;0.34;318.42;8.15;1216;21;2826.00;67
6956;18;22597806;6956;464;8168;8234;5.59;0.34;318.54;8.15;1212;21;2827.00;66
6959;18;22597822;6959;468;8168;8234;5.59;0.34;318.66;8.15;1209;21;2828.00;66
6963;18;22597840;6963;475;8169;8235;5.57;0.34;318.76;8.15;1206;21;2829.00;66
6969;18;22597857;6969;472;8171;8236;5.51;0.34;318.86;8.15;1202;21;2830.00;65
6972;18;22597873;6972;479;8172;8236;5.47;0.33;318.86;8.15;1200;21;2831.00;64
6973;18;22597891;6973;480;8183;8249;5.48;0.34;318.88;8.15;1210;21;2832.00;66
6979;18;22597909;6979;480;8183;8249;5.35;0.33;318.76;8.15;1204;21;2833.00;66
6983;18;22597925;6983;481;8184;8249;5.30;0.32;318.83;8.15;1201;21;2834.00;65
6985;18;22597940;6985;479;8186;8251;5.31;0.33;319.01;8.14;1201;21;2835.00;65
6989;18;22597957;6989;486;8188;8251;5.28;0.32;319.12;8.15;1199;21;2836.00;63
6992;18;22597972;6992;492;8192;8255;5.26;0.32;319.24;8.14;1200;21;2837.00;63
6998;18;22597989;6998;485;8192;8255;5.24;0.32;319.19;8.14;1194;21;2838.00;63
7003;18;22598006;7003;484;8196;8259;5.23;0.32;319.28;8.14;1193;21;2839.00;63
7006;18;22598044;7006;484;8196;8259;5.24;0.32;319.27;8.14;1190;21;2840.00;63
7009;18;22598066;7009;482;8197;8259;5.18;0.32;319.56;8.14;1188;21;2841.00;62
7013;18;22598086;7013;486;8198;8259;5.14;0.31;319.54;8.14;1185;21;2842.00;61
7018;18;22598105;7018;496;8198;8259;5.10;0.31;319.61;8.14;1180;21;2843.00;61
7021;18;22598121;7021;497;8207;8271;5.12;0.31;319.86;8.13;1186;21;2844.00;64
7024;18;22598137;7024;506;8207;8271;5.06;0.31;319.82;8.13;1183;21;2845.00;64
7028;18;22598157;7028;512;8209;8271;4.99;0.30;319.97;8.13;1181;21;2846.00;62
7032;18;22598174;7032;500;8209;8271;4.96;0.30;320.03;8.13;1177;21;2847.00;62
7036;18;22598190;7036;507;8209;8271;4.90;0.30;320.05;8.13;1173;21;2848.00;62
7039;18;22598207;7039;506;8209;8271;4.91;0.30;320.19;8.13;1170;21;2849.00;62
7043;18;22598225;7043;508;8211;8274;4.89;0.30;320.34;8.13;1168;21;2850.00;63
7048;18;22598241;7048;504;8211;8274;4.88;0.30;320.41;8.13;1163;21;2851.00;63
7052;18;22598261;7052;498;8216;8280;4.93;0.30;320.55;8.13;1164;21;2852.00;64
7055;18;22598279;7055;500;8217;8281;4.94;0.30;320.56;8.13;1162;21;2853.00;64
7056;18;22598296;7056;500;8217;8281;4.98;0.30;320.62;8.13;1161;21;2854.00;64
7061;18;22598313;7061;501;8217;8281;4.96;0.30;320.66;8.13;1156;21;2855.00;64
7064;18;22598337;7064;489;8220;8285;5.02;0.30;320.66;8.12;1156;21;2856.00;65
7065;18;22598356;7065;482;8220;8285;5.05;0.31;320.62;8.12;1155;21;2857.00;65
7068;18;22598373;7068;475;8220;8285;5.06;0.31;320.59;8.12;1152;21;2858.00;65
7071;18;22598397;7071;468;8221;8286;5.09;0.31;320.72;8.12;1150;21;2859.00;65
7072;18;22598417;7072;468;8224;8290;5.15;0.31;320.74;8.12;1152;21;2860.00;66
7074;18;22598440;7074;463;8224;8290;5.18;0.31;320.69;8.12;1150;21;2861.00;66
7077;18;22598460;7077;457;8226;8293;5.25;0.32;320.62;8.12;1149;21;2862.00;67
7077;18;22598482;7077;459;8227;8293;5.30;0.32;320.62;8.12;1150;21;2863.00;66
7079;18;22598502;7079;456;8229;8295;5.34;0.32;320.72;8.11;1150;21;2864.00;66
7080;18;22598532;7080;456;8229;8295;5.40;0.33;320.78;8.11;1149;21;2865.00;66
7081;18;22598549;7081;455;8233;8299;5.47;0.33;320.84;8.11;1152;21;2866.00;66
7084;18;22598566;7084;450;8233;8299;5.46;0.33;320.81;8.11;1149;21;2867.00;66
7085;18;22598584;7085;447;8233;8299;5.48;0.33;320.79;8.11;1148;21;2868.00;66
7087;18;22598603;7087;444;8233;8299;5.49;0.33;320.82;8.11;1146;21;2869.00;66
7088;18;22598621;7088;444;8233;8300;5.50;0.34;320.78;8.11;1145;21;2870.00;67
7090;18;22598638;7090;444;8234;8301;5.55;0.34;320.80;8.11;1144;21;2871.00;67
7093;18;22598655;7093;443;8234;8301;5.53;0.34;320.72;8.11;1141;21;2872.00;67
7096;18;22598672;7096;446;8235;8302;5.55;0.34;320.72;8.11;1139;21;2873.00;67
7096;18;22598690;7096;442;8235;8302;5.53;0.34;320.72;8.11;1139;21;2874.00;67
7097;18;22598709;7097;439;8235;8302;5.45;0.33;320.70;8.11;1138;21;2875.00;67
7098;18;22598726;7098;444;8235;8302;5.44;0.33;320.72;8.11;1137;21;2876.00;67
7098;18;22598746;7098;442;8235;8302;5.43;0.33;320.72;8.11;1137;21;2877.00;67
7100;18;22598767;7100;446;8235;8302;5.42;0.33;320.72;8.11;1135;21;2878.00;67
7101;18;22598791;7101;448;8235;8302;5.42;0.33;320.69;8.11;1134;21;2879.00;67
7103;18;22598813;7103;513;8363;8532;5.53;0.35;320.63;7.99;1260;21;2880.00;169
7105;18;22598858;7105;504;8366;8533;5.47;0.34;320.63;7.98;1261;21;2881.00;167
7107;18;22598881;7107;486;8376;8533;5.52;0.34;320.56;7.98;1269;21;2882.00;157
7110;18;22598900;7110;485;8378;8533;5.49;0.34;320.55;7.97;1268;21;2883.00;155
7112;18;22598918;7112;488;8384;8533;5.51;0.34;320.53;7.97;1272;21;2884.00;149
7114;18;22598937;7114;485;8388;8533;5.50;0.34;320.49;7.97;1274;21;2885.00;145
7115;18;22598957;7115;494;8392;8533;5.50;0.34;320.51;7.97;1277;21;2886.00;141
7119;18;22598975;7119;494;8397;8533;5.50;0.34;320.58;7.97;1278;21;2887.00;136
7122;18;22598995;7122;499;8402;8534;5.50;0.34;320.57;7.97;1280;21;2888.00;132
7124;18;22599015;7124;504;8407;8535;5.49;0.34;320.50;7.97;1283;21;2889.00;128
7126;18;22599036;7126;505;8412;8535;5.46;0.34;320.54;7.97;1286;21;2890.00;123
7127;18;22599056;7127;508;8415;8536;5.41;0.34;320.63;7.97;1288;21;2891.00;121
7129;18;22599074;7129;509;8417;8536;5.32;0.33;320.62;7.97;1288;21;2892.00;119
7129;18;22599093;7129;484;8419;8536;5.31;0.33;320.62;7.97;1290;21;2893.00;117
7131;18;22599112;7131;478;8422;8536;5.28;0.33;320.59;7.98;1291;21;2894.00;114
7132;18;22599133;7132;476;8424;8540;5.24;0.32;320.59;7.98;1292;21;2895.00;116
7133;18;22599154;7133;464;8425;8540;5.28;0.32;320.61;7.98;1292;21;2896.00;115
7134;18;22599172;7134;455;8429;8540;5.34;0.33;320.63;7.98;1295;21;2897.00;111
7137;18;22599192;7137;454;8430;8543;5.40;0.33;320.67;7.98;1293;21;2898.00;113
7138;18;22599215;7138;452;8431;8543;5.44;0.33;320.70;7.98;1293;21;2899.00;112
7138;18;22599247;7138;444;8431;8543;5.51;0.34;320.70;7.98;1293;21;2900.00;112
7142;18;22599270;7142;444;8434;8547;5.54;0.34;320.84;7.98;1292;21;2901.00;113
7143;18;22599289;7143;448;8436;8548;5.57;0.34;320.87;7.98;1293;21;2902.00;112
7145;18;22599325;7145;461;8436;8548;5.52;0.34;320.91;7.98;1291;21;2903.00;112
7148;18;22599349;7148;456;8439;8552;5.52;0.34;320.88;7.98;1291;21;2904.00;113
7148;18;22599367;7148;445;8441;8552;5.49;0.34;320.88;8.05;1293;21;2905.00;111
7151;18;22599389;7151;444;8442;8552;5.47;0.33;320.88;8.05;1291;21;2906.00;110
7152;18;22599408;7152;442;8443;8553;5.48;0.33;320.91;8.05;1291;21;2907.00;110
7153;18;22599432;7153;441;8446;8553;5.45;0.33;320.89;8.06;1293;21;2908.00;107
7155;18;22599449;7155;438;8450;8559;5.43;0.33;320.94;8.06;1295;21;2909.00;109
7156;18;22599470;7156;436;8450;8559;5.44;0.33;320.90;8.06;1294;21;2910.00;109
7157;18;22599489;7157;435;8453;8560;5.46;0.33;320.92;8.06;1296;21;2911.00;107
7158;18;22599506;7158;432;8453;8560;5.51;0.34;320.88;8.06;1295;21;2912.00;107
7159;18;22599523;7159;431;8454;8560;5.55;0.34;320.87;8.06;1295;21;2913.00;106
7162;18;22599541;7162;434;8454;8560;5.61;0.34;320.89;8.06;1292;21;2914.00;106
7166;18;22599560;7166;433;8455;8560;5.63;0.34;320.81;8.07;1289;21;2915.00;105
7168;18;22599576;7168;427;8464;8572;5.70;0.35;320.80;8.06;1296;21;2916.00;108
7172;18;22599594;7172;417;8465;8572;5.71;0.35;320.68;8.06;1293;21;2917.00;107
7175;18;22599611;7175;412;8467;8572;5.74;0.35;320.68;8.06;1292;21;2918.00;105
7176;18;22599630;7176;415;8467;8572;5.74;0.35;320.77;8.06;1291;21;2919.00;105
7177;18;22599648;7177;415;8468;8572;5.77;0.35;320.75;8.06;1291;21;2920.00;104
7179;18;22599666;7179;414;8468;8572;5.79;0.35;320.81;8.06;1289;21;2921.00;104
7182;18;22599682;7182;416;8473;8576;5.76;0.35;320.78;8.06;1291;21;2922.00;103
7184;18;22599701;7184;416;8473;8576;5.76;0.35;320.86;8.06;1289;21;2923.00;103
7185;18;22599720;7185;417;8476;8580;5.82;0.35;320.91;8.07;1291;21;2924.00;104
7186;18;22599739;7186;418;8480;8582;5.83;0.35;320.93;8.07;1294;21;2925.00;102
7191;18;22599757;7191;415;8482;8582;5.80;0.35;320.98;8.08;1291;21;2926.00;100
7193;18;22599776;7193;419;8483;8582;5.79;0.35;320.97;8.08;1290;21;2927.00;99
7196;18;22599798;7196;434;8493;8595;5.80;0.35;320.99;8.08;1297;21;2928.00;102
7200;18;22599824;7200;428;8495;8595;5.80;0.35;321.10;8.08;1295;21;2929.00;100
7200;18;22599853;7200;438;8497;8595;5.79;0.35;321.10;8.12;1297;21;2930.00;98
7201;18;22599877;7201;440;8499;8596;5.78;0.35;321.10;8.12;1298;21;2931.00;97
7204;18;22599903;7204;445;8500;8597;5.75;0.35;321.13;8.13;1296;21;2932.00;97
7205;18;22599927;7205;455;8502;8597;5.74;0.35;321.14;8.20;1297;21;2933.00;95
7208;18;22599950;7208;456;8505;8600;5.75;0.35;321.35;8.20;1297;21;2934.00;95
7209;18;22599975;7209;467;8507;8600;5.76;0.35;321.33;8.27;1298;21;2935.00;93
7213;18;22600000;7213;467;8509;8600;5.75;0.35;321.41;8.28;1296;21;2936.00;91
7214;18;22600023;7214;475;8511;8600;5.75;0.35;321.37;8.32;1297;21;2937.00;89
7219;18;22600045;7219;476;8516;8606;5.75;0.35;321.44;8.31;1297;21;2938.00;90
7220;18;22600071;7220;471;8518;8606;5.73;0.35;321.41;8.35;1298;21;2939.00;88
7223;18;22600095;7223;474;8521;8606;5.66;0.34;321.70;8.43;1298;21;2940.00;85
7227;18;22600117;7227;479;8523;8606;5.57;0.34;321.73;8.50;1296;21;2941.00;83
7230;18;22600138;7230;486;8527;8610;5.53;0.34;321.80;8.50;1297;21;2942.00;83
7234;18;22600157;7234;490;8530;8611;5.51;0.34;321.90;8.56;1296;21;2943.00;81
7236;18;22600177;7236;494;8530;8611;5.52;0.34;321.92;8.56;1294;21;2944.00;81
7238;18;22600198;7238;490;8532;8612;5.53;0.34;322.02;8.56;1294;21;2945.00;80
7241;18;22600219;7241;495;8534;8612;5.52;0.34;322.07;8.62;1293;21;2946.00;78
7242;18;22600239;7242;495;8535;8612;5.52;0.34;322.10;8.62;1293;21;2947.00;77
7244;18;22600258;7244;490;8535;8612;5.52;0.34;322.21;8.62;1291;21;2948.00;77
7245;18;22600279;7245;482;8535;8612;5.58;0.34;322.25;8.62;1290;21;2949.00;77
7248;18;22600302;7248;476;8535;8612;5.57;0.34;322.31;8.62;1287;21;2950.00;77
7252;18;22600322;7252;474;8539;8612;5.51;0.34;322.42;8.75;1287;21;2951.00;73
7253;18;22600342;7253;486;8582;8682;5.64;0.35;322.40;8.70;1329;21;2952.00;100
7257;18;22600370;7257;482;8585;8683;5.61;0.34;322.50;8.76;1328;21;2953.00;98
7259;18;22600399;7259;476;8589;8683;5.63;0.35;322.66;8.76;1330;21;2954.00;94
7261;18;22600431;7261;475;8590;8683;5.65;0.35;322.70;8.79;1329;21;2955.00;93
7264;18;22600457;7264;472;8593;8683;5.68;0.35;322.68;8.81;1329;21;2956.00;90
7268;18;22600485;7268;473;8594;8683;5.68;0.35;322.82;8.84;1326;21;2957.00;89
7269;18;22600514;7269;473;8598;8683;5.75;0.35;322.82;8.87;1329;21;2958.00;85
7272;18;22600535;7272;477;8598;8683;5.75;0.35;322.96;8.87;1326;21;2959.00;85
7274;18;22600555;7274;482;8600;8684;5.74;0.35;322.97;8.87;1326;21;2960.00;84
7278;18;22600575;7278;485;8605;8685;5.68;0.35;322.89;8.95;1327;21;2961.00;80
7281;18;22600602;7281;494;8607;8685;5.62;0.34;323.01;8.95;1326;21;2962.00;78
7283;18;22600623;7283;490;8614;8689;5.57;0.34;323.06;9.00;1331;21;2963.00;75
7287;18;22600645;7287;495;8615;8689;5.51;0.34;323.01;9.00;1328;21;2964.00;74
7292;18;22600661;7292;497;8617;8689;5.45;0.33;322.96;9.05;1325;21;2965.00;72
7297;18;22600681;7297;507;8617;8689;5.40;0.33;323.05;9.05;1320;21;2966.00;72
7299;18;22600699;7299;512;8621;8695;5.38;0.33;323.06;9.05;1322;21;2967.00;74
7303;18;22600717;7303;518;8623;8695;5.32;0.32;323.16;9.10;1320;21;2968.00;72
7307;18;22600735;7307;518;8623;8695;5.29;0.32;323.14;9.10;1316;21;2969.00;72
7311;18;22600753;7311;514;8626;8701;5.26;0.32;323.23;9.10;1315;21;2970.00;75
7313;18;22600772;7313;517;8627;8701;5.20;0.32;323.29;9.12;1314;21;2971.00;74
7314;18;22600791;7314;513;8628;8701;5.20;0.32;323.27;9.12;1314;21;2972.00;73
7317;18;22600807;7317;513;8629;8702;5.14;0.31;323.34;9.12;1312;21;2973.00;73
7321;18;22600823;7321;520;8630;8703;5.06;0.31;323.44;9.12;1309;21;2974.00;73
7323;18;22600840;7323;505;8630;8703;5.02;0.31;323.38;9.12;1307;21;2975.00;73
7330;18;22600859;7330;494;8639;8716;5.00;0.30;323.47;9.11;1309;21;2976.00;77
7332;18;22600882;7332;488;8640;8716;5.05;0.31;323.48;9.11;1308;21;2977.00;76
7335;18;22600899;7335;477;8640;8716;5.09;0.31;323.56;9.11;1305;21;2978.00;76
7337;18;22600916;7337;470;8640;8717;5.13;0.31;323.60;9.11;1303;21;2979.00;77
7340;18;22600932;7340;457;8640;8717;5.18;0.32;323.63;9.11;1300;21;2980.00;77
7341;18;22600951;7341;452;8643;8721;5.32;0.33;323.62;9.11;1302;21;2981.00;78
7346;18;22600970;7346;442;8643;8721;5.37;0.33;323.84;9.11;1297;21;2982.00;78
7351;18;22600987;7351;449;8646;8725;5.44;0.33;323.89;9.11;1295;21;2983.00;79
7353;18;22601005;7353;441;8646;8725;5.49;0.34;323.86;9.11;1293;21;2984.00;79
7356;18;22601023;7356;438;8646;8725;5.51;0.34;323.99;9.11;1290;21;2985.00;79
7363;18;22601043;7363;435;8646;8725;5.52;0.34;324.07;9.11;1283;21;2986.00;79
7364;18;22601062;7364;434;8647;8725;5.58;0.34;324.05;9.11;1283;21;2987.00;78
7368;18;22601082;7368;427;8655;8737;5.56;0.34;324.07;9.10;1287;21;2988.00;82
7371;18;22601102;7371;433;8655;8737;5.53;0.34;324.10;9.10;1284;21;2989.00;82
7375;18;22601119;7375;436;8656;8737;5.51;0.34;324.10;9.10;1281;21;2990.00;81
7379;18;22601136;7379;438;8656;8737;5.50;0.33;324.11;9.10;1277;21;2991.00;81
7383;18;22601152;7383;450;8657;8737;5.52;0.34;324.24;9.10;1274;21;2992.00;80
7389;18;22601169;7389;448;8658;8737;5.49;0.33;324.29;9.11;1269;21;2993.00;79
7392;18;22601188;7392;451;8658;8738;5.46;0.33;324.44;9.11;1266;21;2994.00;80
7394;18;22601204;7394;456;8658;8738;5.46;0.33;324.48;9.11;1264;21;2995.00;80
7397;18;22601220;7397;457;8664;8744;5.43;0.33;324.47;9.11;1267;21;2996.00;80
7401;18;22601236;7401;457;8664;8745;5.35;0.33;324.55;9.11;1263;21;2997.00;81
7404;18;22601254;7404;464;8664;8745;5.36;0.33;324.55;9.11;1260;21;2998.00;81
7409;18;22601275;7409;465;8666;8745;5.29;0.32;324.54;9.12;1257;21;2999.00;79
7413;18;22601295;7413;470;8674;8765;5.26;0.32;324.67;9.12;1261;21;3000.00;91
7416;18;22601324;7416;475;8674;8765;5.24;0.32;324.74;9.12;1258;21;3001.00;91
7420;18;22601340;7420;471;8676;8765;5.17;0.31;324.79;9.13;1256;21;3002.00;89
7425;18;22601365;7425;466;8677;8766;5.10;0.31;324.89;9.12;1252;21;3003.00;89
7429;18;22601385;7429;467;8682;8770;5.06;0.31;324.87;9.12;1253;21;3004.00;88
7433;18;22601402;7433;468;8683;8770;5.03;0.31;324.91;9.12;1250;21;3005.00;87
7436;18;22601419;7436;460;8688;8773;5.04;0.31;324.92;9.12;1252;21;3006.00;85
7439;18;22601436;7439;459;8689;8773;5.04;0.31;324.91;9.13;1250;21;3007.00;84
7445;18;22601455;7445;471;8690;8773;5.03;0.31;324.99;9.13;1245;21;3008.00;83
7448;18;22601472;7448;478;8691;8773;5.02;0.31;325.02;9.12;1243;21;3009.00;82
7452;18;22601490;7452;482;8695;8777;4.99;0.30;325.22;9.12;1243;21;3010.00;82
7456;18;22601508;7456;486;8698;8777;5.01;0.31;325.33;9.12;1242;21;3011.00;79
7462;18;22601524;7462;485;8698;8777;4.96;0.30;325.48;9.12;1236;21;3012.00;79
7464;18;22601541;7464;479;8698;8777;5.01;0.31;325.54;9.12;1234;21;3013.00;79
7470;18;22601558;7470;489;8699;8778;4.95;0.30;325.66;9.12;1229;21;3014.00;79
7474;18;22601577;7474;496;8701;8780;4.96;0.30;325.76;9.12;1227;21;3015.00;79
7477;18;22601598;7477;496;8701;8780;4.95;0.30;325.79;9.12;1224;21;3016.00;79
7481;18;22601613;7481;501;8703;8781;4.90;0.30;325.94;9.12;1222;21;3017.00;78
7483;18;22601629;7483;508;8703;8781;4.85;0.30;325.98;9.12;1220;21;3018.00;78
7487;18;22601647;7487;524;8703;8781;4.75;0.29;325.97;9.12;1216;21;3019.00;78
7491;18;22601663;7491;530;8703;8781;4.68;0.29;326.13;9.12;1212;21;3020.00;78
7494;18;22601678;7494;538;8703;8781;4.60;0.28;326.11;9.12;1209;21;3021.00;78
7495;18;22601692;7495;536;8704;8781;4.55;0.28;326.14;9.12;1209;21;3022.00;77
7497;18;22601707;7497;529;8704;8781;4.53;0.28;326.13;9.12;1207;21;3023.00;77
7501;18;22601727;7501;539;8768;8908;4.88;0.30;326.22;9.05;1267;21;3024.00;140
7509;18;22601756;7509;523;8771;8909;4.88;0.30;326.50;9.05;1262;21;3025.00;138
7509;18;22601773;7509;522;8779;8909;5.00;0.31;326.50;9.05;1270;21;3026.00;130
7514;18;22601789;7514;518;8781;8909;5.02;0.31;326.69;9.04;1267;21;3027.00;128
7515;18;22601807;7515;518;8787;8909;5.10;0.32;326.73;9.04;1272;21;3028.00;122
7518;18;22601826;7518;518;8789;8909;5.15;0.32;326.82;9.04;1271;21;3029.00;120
7521;18;22601853;7521;525;8791;8909;5.14;0.32;326.80;9.04;1270;21;3030.00;118
7523;18;22601870;7523;519;8794;8909;5.18;0.32;326.81;9.04;1271;21;3031.00;115
7525;18;22601888;7525;507;8796;8910;5.20;0.32;326.83;9.04;1271;21;3032.00;114
7529;18;22601907;7529;504;8800;8911;5.17;0.32;326.85;9.04;1271;21;3033.00;111
7530;18;22601924;7530;495;8804;8911;5.19;0.32;326.81;9.04;1274;21;3034.00;107
7531;18;22601948;7531;495;8806;8912;5.20;0.32;326.78;9.04;1275;21;3035.00;106
7534;18;22601967;7534;501;8809;8912;5.21;0.32;326.72;9.05;1275;21;3036.00;103
7538;18;22601986;7538;507;8811;8912;5.19;0.32;326.75;9.05;1273;21;3037.00;101
7541;18;22602006;7541;508;8812;8912;5.21;0.32;326.71;9.05;1271;21;3038.00;100
7545;18;22602023;7545;506;8817;8916;5.21;0.32;326.75;9.05;1272;21;3039.00;99
7549;18;22602041;7549;513;8820;8916;5.23;0.32;326.89;9.05;1271;21;3040.00;96
7553;18;22602059;7553;519;8822;8916;5.24;0.32;327.04;9.05;1269;21;3041.00;94
7555;18;22602079;7555;526;8824;8919;5.25;0.32;327.12;9.05;1269;21;3042.00;95
7557;18;22602097;7557;522;8826;8919;5.26;0.32;327.17;9.05;1269;21;3043.00;93
7560;18;22602114;7560;519;8828;8919;5.27;0.32;327.10;9.06;1268;21;3044.00;91
7562;18;22602132;7562;520;8833;8923;5.29;0.32;327.05;9.05;1271;21;3045.00;90
7564;18;22602156;7564;522;8835;8924;5.32;0.32;327.06;9.05;1271;21;3046.00;89
7564;18;22602181;7564;521;8837;8924;5.35;0.33;327.06;9.05;1273;21;3047.00;87
7566;18;22602203;7566;517;8839;8928;5.33;0.33;327.00;9.05;1273;21;3048.00;89
7570;18;22602223;7570;520;8840;8928;5.28;0.32;327.00;9.05;1270;21;3049.00;88
7570;18;22602246;7570;502;8840;8928;5.29;0.32;327.00;9.05;1270;21;3050.00;88
7573;18;22602267;7573;491;8841;8929;5.34;0.32;326.95;9.05;1268;21;3051.00;88
7574;18;22602290;7574;495;8841;8929;5.34;0.33;326.93;9.05;1267;21;3052.00;88
7576;18;22602320;7576;488;8846;8935;5.38;0.33;326.94;9.04;1270;21;3053.00;89
7578;18;22602342;7578;490;8846;8935;5.38;0.33;326.87;9.04;1268;21;3054.00;89
7578;18;22602365;7578;491;8846;8936;5.39;0.33;326.87;9.04;1268;21;3055.00;90
7578;18;22602387;7578;487;8846;8936;5.40;0.33;326.87;9.04;1268;21;3056.00;90
7582;18;22602422;7582;493;8846;8936;5.39;0.33;326.89;9.04;1264;21;3057.00;90
7583;18;22602445;7583;490;8846;8936;5.37;0.32;326.89;9.04;1263;21;3058.00;90
7585;18;22602468;7585;490;8846;8936;5.35;0.32;326.86;9.04;1261;21;3059.00;90
7588;18;22602501;7588;491;8871;8972;5.36;0.32;326.88;9.02;1283;21;3060.00;101
7589;18;22602526;7589;490;8871;8972;5.35;0.32;326.84;9.02;1282;21;3061.00;101
7589;18;22602545;7589;487;8875;8972;5.41;0.33;326.84;9.01;1286;21;3062.00;97
7589;18;22602564;7589;491;8875;8972;5.43;0.33;326.84;9.01;1286;21;3063.00;97
7592;18;22602584;7592;491;8876;8972;5.44;0.33;326.83;9.01;1284;21;3064.00;96
7592;18;22602605;7592;485;8876;8972;5.50;0.33;326.83;9.01;1284;21;3065.00;96
7596;18;22602628;7596;480;8880;8976;5.53;0.33;326.79;9.01;1284;21;3066.00;96
7596;18;22602658;7596;481;8880;8976;5.60;0.34;326.79;9.01;1284;21;3067.00;96
7596;18;22602691;7596;482;8883;8980;5.71;0.35;326.79;9.01;1287;21;3068.00;97
7596;18;22602722;7596;473;8884;8981;5.77;0.35;326.79;9.01;1288;21;3069.00;97
7597;18;22602746;7597;473;8884;8981;5.79;0.35;326.79;9.01;1287;21;3070.00;97
7600;18;22602781;7600;469;8884;8981;5.82;0.35;326.83;9.01;1284;21;3071.00;97
7603;18;22602805;7603;464;8893;8994;5.84;0.35;326.90;9.00;1290;21;3072.00;101
7606;18;22602834;7606;462;8893;8994;5.88;0.36;326.95;9.00;1287;21;3073.00;101
7608;18;22602858;7608;454;8893;8994;5.92;0.36;326.99;9.00;1285;21;3074.00;101
7611;18;22602883;7611;453;8894;8995;5.94;0.36;326.96;9.00;1283;21;3075.00;101
7614;18;22602907;7614;450;8894;8996;5.96;0.36;327.16;9.00;1280;21;3076.00;102
7616;18;22602928;7616;448;8895;8996;5.97;0.36;327.24;9.02;1279;21;3077.00;101
7619;18;22602946;7619;445;8897;8999;5.94;0.36;327.25;9.02;1278;21;3078.00;102
7622;18;22602963;7622;440;8898;8999;5.95;0.36;327.24;9.01;1276;21;3079.00;101
7624;18;22602980;7624;439;8900;8999;5.91;0.36;327.21;9.09;1276;21;3080.00;99
7626;18;22603010;7626;430;8900;8999;5.90;0.36;327.27;9.09;1274;21;3081.00;99
7627;18;22603030;7627;426;8904;9005;5.92;0.36;327.25;9.09;1277;21;3082.00;101
7628;18;22603047;7628;414;8905;9005;5.91;0.36;327.28;9.09;1277;21;3083.00;100
7629;18;22603063;7629;412;8906;9005;5.89;0.36;327.26;9.09;1277;21;3084.00;99
7634;18;22603080;7634;410;8906;9005;5.95;0.36;327.39;9.09;1272;21;3085.00;99
7635;18;22603100;7635;409;8909;9009;6.01;0.37;327.39;9.08;1274;21;3086.00;100
7636;18;22603118;7636;410;8910;9010;6.04;0.37;327.49;9.08;1274;21;3087.00;100
7638;18;22603141;7638;412;8911;9010;6.07;0.37;327.45;9.08;1273;21;3088.00;99
7644;18;22603159;7644;411;8912;9011;6.10;0.37;327.47;9.08;1268;21;3089.00;99
7645;18;22603178;7645;409;8912;9011;6.13;0.37;327.59;9.08;1267;21;3090.00;99
7648;18;22603199;7648;415;8912;9011;6.13;0.37;327.52;9.08;1264;21;3091.00;99
7652;18;22603218;7652;413;8912;9011;6.15;0.37;327.52;9.08;1260;21;3092.00;99
7656;18;22603238;7656;417;8913;9011;6.13;0.37;327.61;9.08;1257;21;3093.00;98
7661;18;22603259;7661;412;8913;9011;6.07;0.37;327.63;9.08;1252;21;3094.00;98
7662;18;22603285;7662;410;8913;9011;6.10;0.37;327.60;9.08;1251;21;3095.00;98
7665;18;22603306;7665;415;8946;9081;6.14;0.37;327.66;9.05;1281;21;3096.00;135
7668;18;22603336;7668;418;8947;9082;6.07;0.37;327.78;9.05;1279;21;3097.00;135
7668;18;22603357;7668;422;8953;9082;6.06;0.37;327.78;9.04;1285;21;3098.00;129
7671;18;22603382;7671;426;8953;9082;6.03;0.37;327.90;9.04;1282;21;3099.00;129
7674;18;22603409;7674;436;8959;9082;6.00;0.36;328.06;9.04;1285;21;3100.00;123
7674;18;22603449;7674;441;8959;9082;5.99;0.36;328.06;9.04;1285;21;3101.00;123
7677;18;22603478;7677;444;8963;9082;5.99;0.36;328.20;9.04;1286;21;3102.00;119
7681;18;22603499;7681;448;8969;9082;6.00;0.36;328.27;9.04;1288;21;3103.00;113
7684;18;22603520;7684;436;8972;9083;6.04;0.37;328.18;9.04;1288;21;3104.00;111
7687;18;22603538;7687;438;8977;9085;6.05;0.37;328.12;9.08;1290;21;3105.00;108
7687;18;22603561;7687;448;8979;9085;6.05;0.37;328.12;9.08;1292;21;3106.00;106
7692;18;22603580;7692;449;8986;9089;6.02;0.37;328.16;9.11;1294;21;3107.00;103
7697;18;22603601;7697;451;8987;9089;6.00;0.36;328.29;9.11;1290;21;3108.00;102
7699;18;22603621;7699;456;8987;9089;5.97;0.36;328.24;9.11;1288;21;3109.00;102
7701;18;22603644;7701;461;8988;9089;5.91;0.36;328.31;9.15;1287;21;3110.00;101
7706;18;22603664;7706;471;8993;9095;5.93;0.36;328.56;9.15;1287;21;3111.00;102
7707;18;22603689;7707;468;8994;9095;5.92;0.36;328.59;9.18;1287;21;3112.00;101
7708;18;22603721;7708;480;8994;9095;5.95;0.36;328.58;9.18;1286;21;3113.00;101
7713;18;22603743;7713;488;8996;9098;5.98;0.36;328.69;9.18;1283;21;3114.00;102
7716;18;22603769;7716;494;8997;9098;5.99;0.36;328.65;9.22;1281;21;3115.00;101
7719;18;22603791;7719;489;9001;9098;5.98;0.36;328.91;9.33;1282;21;3116.00;97
7721;18;22603814;7721;487;9001;9099;5.97;0.36;328.88;9.33;1280;21;3117.00;98
7725;18;22603840;7725;483;9004;9100;5.97;0.36;328.98;9.40;1279;21;3118.00;96
7726;18;22603863;7726;480;9005;9100;5.96;0.36;329.04;9.44;1279;21;3119.00;95
7728;18;22603887;7728;485;9023;9126;5.98;0.36;329.09;9.42;1295;21;3120.00;103
7730;18;22603916;7730;484;9023;9126;5.97;0.36;329.18;9.42;1293;21;3121.00;103
7733;18;22603936;7733;488;9027;9126;5.98;0.36;329.20;9.48;1294;21;3122.00;99
7735;18;22603955;7735;491;9029;9127;6.01;0.36;329.34;9.48;1294;21;3123.00;98
7737;18;22603978;7737;494;9031;9127;5.95;0.36;329.37;9.55;1294;21;3124.00;96
7739;18;22603998;7739;489;9036;9131;5.99;0.36;329.43;9.55;1297;21;3125.00;95
7741;18;22604018;7741;482;9036;9131;5.94;0.36;329.61;9.55;1295;21;3126.00;95
7742;18;22604039;7742;488;9041;9135;5.90;0.36;329.58;9.61;1299;21;3127.00;94
7745;18;22604060;7745;494;9041;9135;5.87;0.36;329.64;9.61;1296;21;3128.00;94
7747;18;22604082;7747;495;9041;9135;5.81;0.35;329.82;9.61;1294;21;3129.00;94
7748;18;22604104;7748;497;9042;9135;5.82;0.35;329.80;9.64;1294;21;3130.00;93
7752;18;22604130;7752;502;9042;9135;5.76;0.35;329.99;9.64;1290;21;3131.00;93
7753;18;22604151;7753;509;9052;9147;5.81;0.35;330.04;9.63;1299;21;3132.00;95
7755;18;22604172;7755;511;9053;9147;5.78;0.35;330.10;9.66;1298;21;3133.00;94
7758;18;22604193;7758;513;9054;9147;5.81;0.35;330.10;9.66;1296;21;3134.00;93
7760;18;22604218;7760;517;9054;9147;5.78;0.35;330.11;9.66;1294;21;3135.00;93
7764;18;22604238;7764;516;9056;9147;5.79;0.35;330.11;9.73;1292;21;3136.00;91
7768;18;22604259;7768;517;9056;9147;5.77;0.35;330.19;9.73;1288;21;3137.00;91
7771;18;22604283;7771;527;9056;9148;5.75;0.35;330.21;9.73;1285;21;3138.00;92
7774;18;22604303;7774;527;9056;9148;5.69;0.35;330.20;9.73;1282;21;3139.00;92
7780;18;22604321;7780;528;9061;9154;5.64;0.34;330.36;9.72;1281;21;3140.00;93
7785;18;22604339;7785;530;9062;9155;5.57;0.34;330.29;9.72;1277;21;3141.00;93
7788;18;22604356;7788;540;9062;9155;5.50;0.34;330.43;9.72;1274;21;3142.00;93
7791;18;22604375;7791;549;9062;9155;5.41;0.33;330.56;9.72;1271;21;3143.00;93
7797;18;22604396;7797;551;9065;9159;5.40;0.33;330.72;9.72;1268;21;3144.00;94
7803;18;22604418;7803;552;9065;9159;5.39;0.33;330.78;9.72;1262;21;3145.00;94
7804;18;22604439;7804;555;9065;9159;5.34;0.33;330.75;9.72;1261;21;3146.00;94
7807;18;22604460;7807;559;9066;9160;5.26;0.32;330.73;9.72;1259;21;3147.00;94
7812;18;22604483;7812;565;9069;9164;5.20;0.32;330.73;9.72;1257;21;3148.00;95
7813;18;22604504;7813;563;9069;9164;5.14;0.31;330.72;9.72;1256;21;3149.00;95
7815;18;22604524;7815;560;9073;9170;5.13;0.31;330.76;9.71;1258;21;3150.00;97
7819;18;22604542;7819;555;9073;9170;5.08;0.31;330.76;9.71;1254;21;3151.00;97
7823;18;22604562;7823;552;9075;9170;5.04;0.31;330.90;9.71;1252;21;3152.00;95
7827;18;22604579;7827;550;9075;9170;5.01;0.31;330.92;9.71;1248;21;3153.00;95
7832;18;22604596;7832;547;9079;9174;5.01;0.31;331.03;9.71;1247;21;3154.00;95
7838;18;22604613;7838;549;9079;9174;5.01;0.31;331.27;9.71;1241;21;3155.00;95
7840;18;22604631;7840;553;9079;9174;4.96;0.30;331.31;9.71;1239;21;3156.00;95
7842;18;22604656;7842;544;9079;9174;4.96;0.30;331.40;9.71;1237;21;3157.00;95
7847;18;22604673;7847;540;9079;9175;4.90;0.30;331.42;9.71;1232;21;3158.00;96
7849;18;22604689;7849;534;9080;9176;4.87;0.30;331.47;9.71;1231;21;3159.00;96
7851;18;22604716;7851;531;9080;9176;4.83;0.29;331.53;9.71;1229;21;3160.00;96
7853;18;22604733;7853;526;9081;9177;4.83;0.30;331.54;9.70;1228;21;3161.00;96
7860;18;22604748;7860;522;9081;9177;4.80;0.29;331.58;9.70;1221;21;3162.00;96
7863;18;22604763;7863;517;9081;9177;4.81;0.29;331.62;9.70;1218;21;3163.00;96
7867;18;22604777;7867;524;9081;9177;4.88;0.30;331.76;9.70;1214;21;3164.00;96
7874;18;22604792;7874;522;9081;9177;4.88;0.30;331.74;9.70;1207;21;3165.00;96
7877;18;22604809;7877;531;9081;9177;4.91;0.30;331.73;9.70;1204;21;3166.00;96
7883;18;22604824;7883;536;9081;9177;4.84;0.29;331.88;9.70;1198;21;3167.00;96
7889;18;22604839;7889;536;9145;9304;5.26;0.32;331.97;9.64;1256;21;3168.00;159
7891;18;22604865;7891;537;9149;9305;5.24;0.32;331.98;9.63;1258;21;3169.00;156
7897;18;22604880;7897;540;9160;9305;5.24;0.32;332.10;9.62;1263;21;3170.00;145
7900;18;22604899;7900;539;9163;9305;5.23;0.32;332.10;9.62;1263;21;3171.00;142
7905;18;22604917;7905;535;9169;9305;5.22;0.32;332.26;9.62;1264;21;3172.00;136
7910;18;22604933;7910;536;9172;9305;5.15;0.32;332.21;9.65;1262;21;3173.00;133
7916;18;22604949;7916;545;9174;9305;5.08;0.31;332.48;9.65;1258;21;3174.00;131
7918;18;22604969;7918;542;9178;9305;5.09;0.32;332.52;9.65;1260;21;3175.00;127
7920;18;22604989;7920;540;9181;9306;5.13;0.32;332.59;9.65;1261;21;3176.00;125
7927;18;22605010;7927;544;9185;9307;5.03;0.31;332.64;9.64;1258;21;3177.00;122
7934;18;22605026;7934;554;9187;9307;4.96;0.31;332.61;9.65;1253;21;3178.00;120
7936;18;22605042;7936;561;9188;9308;4.84;0.30;332.57;9.65;1252;21;3179.00;120
7940;18;22605060;7940;556;9193;9308;4.77;0.30;332.51;9.65;1253;21;3180.00;115
7945;18;22605078;7945;565;9195;9308;4.74;0.29;332.64;9.65;1250;21;3181.00;113
7947;18;22605093;7947;568;9196;9308;4.75;0.29;332.58;9.65;1249;21;3182.00;112
7951;18;22605108;7951;569;9201;9312;4.74;0.29;332.63;9.64;1250;21;3183.00;111
7955;18;22605123;7955;576;9201;9312;4.69;0.29;332.62;9.64;1246;21;3184.00;111
7961;18;22605138;7961;579;9202;9312;4.60;0.29;332.58;9.64;1241;21;3185.00;110
7966;18;22605156;7966;576;9204;9315;4.51;0.28;332.61;9.64;1238;21;3186.00;111
7968;18;22605173;7968;573;9205;9315;4.46;0.28;332.62;9.65;1237;21;3187.00;110
7974;18;22605188;7974;573;9207;9315;4.41;0.27;332.61;9.65;1233;21;3188.00;108
7976;18;22605203;7976;579;9211;9319;4.42;0.27;332.65;9.67;1235;21;3189.00;108
7979;18;22605217;7979;582;9213;9320;4.41;0.27;332.63;9.67;1234;21;3190.00;107
7984;18;22605232;7984;581;9215;9322;4.35;0.27;332.51;9.67;1231;21;3191.00;107
7986;18;22605249;7986;573;9219;9326;4.30;0.27;332.44;9.66;1233;21;3192.00;107
7993;18;22605267;7993;570;9219;9326;4.21;0.26;332.31;9.66;1226;21;3193.00;107
7995;18;22605290;7995;581;9219;9326;4.22;0.26;332.36;9.66;1224;21;3194.00;107
7997;18;22605304;7997;577;9221;9328;4.17;0.25;332.30;9.66;1224;21;3195.00;107
7997;18;22605322;7997;585;9221;9328;4.16;0.25;332.30;9.66;1224;21;3196.00;107
7997;18;22605337;7997;564;9226;9334;4.21;0.26;332.30;9.65;1229;21;3197.00;108
8000;18;22605352;8000;562;9226;9334;4.24;0.26;332.42;9.65;1226;21;3198.00;108
8003;18;22605368;8003;556;9226;9335;4.23;0.26;332.37;9.65;1223;21;3199.00;109
8005;18;22605383;8005;552;9226;9335;4.25;0.26;332.47;9.65;1221;21;3200.00;109
8005;18;22605408;8005;555;9226;9335;4.29;0.26;332.47;9.65;1221;21;3201.00;109
8006;18;22605423;8006;553;9226;9335;4.31;0.26;332.55;9.65;1220;21;3202.00;109
8008;18;22605438;8008;553;9226;9335;4.32;0.26;332.54;9.65;1218;21;3203.00;109
8009;18;22605452;8009;566;9236;9347;4.47;0.27;332.54;9.64;1227;21;3204.00;111
8011;18;22605466;8011;562;9237;9347;4.52;0.28;332.52;9.66;1226;21;3205.00;110
8012;18;22605490;8012;543;9238;9347;4.58;0.28;332.48;9.66;1226;21;3206.00;109
8013;19;22605508;8013;528;9238;9347;4.65;0.28;332.49;9.66;1225;22;3207.00;109
8013;19;22605536;8013;504;9238;9347;4.71;0.29;332.49;9.66;1225;22;3208.00;109
8016;19;22605553;8016;489;9238;9347;4.79;0.29;332.44;9.66;1222;22;3209.00;109
8018;19;22605587;8018;474;9241;9351;4.90;0.30;332.47;9.66;1223;22;3210.00;110
8019;19;22605621;8019;460;9241;9351;4.99;0.31;332.46;9.66;1222;22;3211.00;110
8023;19;22605639;8023;456;9245;9355;5.12;0.31;332.47;9.66;1222;22;3212.00;110
8025;19;22605657;8025;450;9246;9356;5.19;0.32;332.45;9.65;1221;22;3213.00;110
8026;19;22605683;8026;452;9246;9356;5.25;0.32;332.47;9.65;1220;22;3214.00;110
8026;19;22605699;8026;447;9246;9356;5.30;0.32;332.47;9.65;1220;22;3215.00;110
8026;19;22605718;8026;451;9257;9369;5.42;0.33;332.47;9.64;1231;22;3216.00;112
8028;19;22605735;8028;445;9257;9369;5.45;0.33;332.44;9.64;1229;22;3217.00;112
8030;19;22605752;8030;447;9257;9369;5.50;0.34;332.44;9.64;1227;22;3218.00;112
8031;19;22605770;8031;448;9258;9370;5.58;0.34;332.41;9.64;1227;22;3219.00;112
8034;19;22605789;8034;438;9259;9371;5.63;0.34;332.52;9.66;1225;22;3220.00;112
8034;19;22605811;8034;442;9259;9371;5.65;0.34;332.52;9.66;1225;22;3221.00;112
8036;19;22605827;8036;438;9261;9374;5.69;0.35;332.61;9.66;1225;22;3222.00;113
8037;19;22605842;8037;427;9261;9374;5.73;0.35;332.59;9.66;1224;22;3223.00;113
8039;19;22605865;8039;433;9262;9374;5.70;0.35;332.63;9.66;1223;22;3224.00;112
8040;19;22605883;8040;429;9262;9374;5.73;0.35;332.63;9.66;1222;22;3225.00;112
8041;19;22605899;8041;424;9267;9380;5.77;0.35;332.63;9.65;1226;22;3226.00;113
8041;19;22605915;8041;423;9267;9380;5.77;0.35;332.63;9.65;1226;22;3227.00;113
8043;19;22605931;8043;417;9268;9380;5.80;0.35;332.62;9.67;1225;22;3228.00;112
8044;19;22605949;8044;419;9268;9380;5.84;0.36;332.62;9.67;1224;22;3229.00;112
8046;19;22605966;8046;419;9271;9384;5.90;0.36;332.59;9.67;1225;22;3230.00;113
8048;19;22605984;8048;412;9272;9385;5.95;0.36;332.57;9.67;1224;22;3231.00;113
8050;19;22605999;8050;414;9272;9385;6.02;0.37;332.63;9.67;1222;22;3232.00;113
8052;19;22606018;8052;408;9273;9386;6.09;0.37;332.72;9.67;1221;22;3233.00;113
8054;19;22606035;8054;404;9273;9386;6.11;0.37;332.76;9.67;1219;22;3234.00;113
8055;19;22606050;8055;408;9273;9386;6.18;0.38;332.76;9.67;1218;22;3235.00;113
8055;19;22606069;8055;402;9273;9386;6.23;0.38;332.76;9.67;1218;22;3236.00;113
8060;19;22606089;8060;405;9273;9386;6.26;0.38;332.80;9.67;1213;22;3237.00;113
8062;19;22606107;8062;405;9273;9386;6.31;0.38;332.79;9.67;1211;22;3238.00;113
8066;19;22606125;8066;409;9273;9386;6.30;0.38;332.81;9.67;1207;22;3239.00;113
8069;19;22606161;8069;431;9339;9511;6.34;0.39;332.87;9.60;1270;22;3240.00;172
8073;19;22606225;8073;414;9339;9512;6.33;0.39;333.01;9.60;1266;22;3241.00;173
8076;19;22606249;8076;394;9346;9512;6.41;0.39;332.98;9.59;1270;22;3242.00;166
8077;19;22606272;8077;399;9347;9512;6.47;0.40;333.07;9.59;1270;22;3243.00;165
8081;19;22606298;8081;392;9352;9512;6.49;0.40;333.24;9.59;1271;22;3244.00;160
8084;19;22606321;8084;388;9353;9512;6.49;0.40;333.33;9.61;1269;22;3245.00;159
8086;19;22606358;8086;388;9360;9512;6.54;0.40;333.40;9.61;1274;22;3246.00;152
8090;19;22606385;8090;393;9360;9512;6.53;0.40;333.41;9.61;1270;22;3247.00;152
8092;19;22606413;8092;397;9364;9513;6.56;0.40;333.42;9.60;1272;22;3248.00;149
8093;19;22606459;8093;387;9370;9514;6.57;0.40;333.41;9.60;1277;22;3249.00;144
8096;19;22606487;8096;378;9373;9514;6.59;0.40;333.47;9.60;1277;22;3250.00;141
8098;19;22606513;8098;380;9379;9518;6.59;0.40;333.45;9.60;1281;22;3251.00;139
8102;19;22606535;8102;380;9379;9518;6.55;0.40;333.52;9.60;1277;22;3252.00;139
8105;19;22606565;8105;390;9379;9518;6.51;0.40;333.58;9.60;1274;22;3253.00;139
8109;19;22606585;8109;386;9379;9518;6.42;0.39;333.66;9.60;1270;22;3254.00;139
8113;19;22606604;8113;377;9385;9524;6.35;0.39;333.71;9.68;1272;22;3255.00;139
8117;19;22606630;8117;386;9385;9524;6.29;0.38;333.72;9.68;1268;22;3256.00;139
8119;19;22606650;8119;377;9385;9524;6.27;0.38;333.74;9.68;1266;22;3257.00;139
8126;19;22606670;8126;380;9390;9527;6.16;0.38;333.82;9.68;1264;22;3258.00;137
8133;19;22606689;8133;380;9390;9527;6.10;0.37;334.04;9.68;1257;22;3259.00;137
8135;19;22606708;8135;373;9390;9527;6.14;0.37;334.01;9.68;1255;22;3260.00;137
8140;19;22606730;8140;367;9390;9528;6.16;0.38;334.03;9.68;1250;22;3261.00;138
8141;19;22606749;8141;364;9391;9529;6.19;0.38;334.00;9.68;1250;22;3262.00;138
8143;19;22606768;8143;365;9391;9529;6.17;0.38;334.02;9.68;1248;22;3263.00;138
8144;19;22606787;8144;356;9400;9542;6.22;0.38;334.08;9.67;1256;22;3264.00;142
8151;19;22606810;8151;362;9401;9542;6.22;0.38;334.12;9.67;1250;22;3265.00;141
8154;19;22606833;8154;365;9401;9542;6.24;0.38;334.12;9.67;1247;22;3266.00;141
8159;19;22606852;8159;363;9402;9543;6.24;0.38;334.12;9.67;1243;22;3267.00;141
8161;19;22606871;8161;358;9402;9543;6.27;0.38;334.21;9.67;1241;22;3268.00;141
8163;19;22606891;8163;358;9405;9547;6.33;0.39;334.23;9.67;1242;22;3269.00;142
8166;19;22606928;8166;357;9405;9547;6.33;0.39;334.45;9.67;1239;22;3270.00;142
8168;19;22606945;8168;359;9408;9551;6.31;0.39;334.48;9.66;1240;22;3271.00;143
8174;19;22606962;8174;356;9408;9551;6.30;0.39;334.71;9.66;1234;22;3272.00;143
8177;19;22606981;8177;353;9409;9551;6.29;0.38;334.80;9.66;1232;22;3273.00;142
8181;19;22607001;8181;354;9409;9551;6.25;0.38;334.96;9.66;1228;22;3274.00;142
8183;19;22607019;8183;349;9409;9551;6.22;0.38;334.89;9.66;1226;22;3275.00;142
8186;19;22607037;8186;348;9420;9563;6.20;0.38;334.95;9.66;1234;22;3276.00;143
8189;19;22607060;8189;355;9421;9563;6.17;0.38;335.14;9.66;1232;22;3277.00;142
8191;19;22607080;8191;351;9422;9563;6.16;0.38;335.25;9.66;1231;22;3278.00;141
8193;19;22607099;8193;355;9424;9563;6.15;0.38;335.42;9.66;1231;22;3279.00;139
8197;19;22607117;8197;360;9425;9563;6.13;0.37;335.62;9.71;1228;22;3280.00;138
8199;19;22607135;8199;360;9426;9563;6.13;0.37;335.67;9.75;1227;22;3281.00;137
8200;19;22607155;8200;365;9428;9564;6.13;0.38;335.72;9.80;1228;22;3282.00;136
8201;19;22607175;8201;370;9428;9564;6.15;0.38;335.81;9.80;1227;22;3283.00;136
8207;19;22607195;8207;372;9433;9570;6.19;0.38;335.89;9.79;1226;22;3284.00;137
8210;19;22607215;8210;378;9437;9572;6.20;0.38;336.00;9.88;1227;22;3285.00;135
8211;19;22607235;8211;382;9437;9572;6.19;0.38;336.00;9.88;1226;22;3286.00;135
8215;19;22607252;8215;382;9438;9572;6.17;0.38;336.06;9.92;1223;22;3287.00;134
8218;19;22607271;8218;387;9442;9576;6.17;0.38;336.09;9.96;1224;22;3288.00;134
8220;19;22607290;8220;384;9442;9576;6.18;0.38;336.18;9.96;1222;22;3289.00;134
8226;19;22607311;8226;389;9442;9576;6.19;0.38;336.25;9.96;1216;22;3290.00;134
8229;19;22607330;8229;394;9444;9577;6.19;0.38;336.20;10.00;1215;22;3291.00;133
8232;19;22607348;8232;383;9447;9581;6.17;0.38;336.24;10.00;1215;22;3292.00;134
8236;19;22607366;8236;385;9449;9581;6.12;0.37;336.37;10.08;1213;22;3293.00;132
8239;19;22607384;8239;389;9452;9584;6.11;0.37;336.39;10.12;1213;22;3294.00;132
8241;19;22607403;8241;388;9454;9584;6.11;0.37;336.48;10.16;1213;22;3295.00;130
8245;19;22607422;8245;392;9454;9584;6.09;0.37;336.63;10.16;1209;22;3296.00;130
8247;19;22607438;8247;393;9454;9584;6.08;0.37;336.81;10.16;1207;22;3297.00;130
8251;19;22607454;8251;395;9460;9588;6.06;0.37;336.89;10.25;1209;22;3298.00;128
8254;19;22607471;8254;399;9461;9588;6.04;0.37;336.98;10.29;1207;22;3299.00;127
8255;19;22607489;8255;406;9466;9607;6.02;0.37;337.00;10.28;1211;22;3300.00;141
8258;19;22607515;8258;391;9466;9607;6.04;0.37;337.17;10.28;1208;22;3301.00;141
8262;19;22607531;8262;393;9469;9608;6.00;0.37;337.33;10.41;1207;22;3302.00;139
8265;19;22607547;8265;389;9471;9609;5.99;0.37;337.31;10.45;1206;22;3303.00;138
8270;19;22607562;8270;390;9472;9609;5.99;0.37;337.44;10.50;1202;22;3304.00;137
8274;19;22607579;8274;389;9473;9610;5.99;0.37;337.49;10.49;1199;22;3305.00;137
8275;19;22607596;8275;390;9475;9610;5.95;0.36;337.47;10.49;1200;22;3306.00;135
8278;19;22607610;8278;394;9477;9610;5.91;0.36;337.49;10.58;1199;22;3307.00;133
8280;19;22607624;8280;400;9477;9610;5.81;0.36;337.51;10.58;1197;22;3308.00;133
8281;19;22607639;8281;401;9477;9610;5.80;0.36;337.49;10.58;1196;22;3309.00;133
8284;19;22607653;8284;399;9479;9610;5.83;0.36;337.48;10.66;1195;22;3310.00;131
8286;19;22607669;8286;405;9480;9610;5.78;0.35;337.55;10.66;1194;22;3311.00;130
8291;19;22607686;8291;418;9545;9737;5.97;0.37;337.58;10.67;1254;22;3312.00;192
8294;19;22607711;8294;417;9548;9738;5.94;0.37;337.60;10.66;1254;22;3313.00;190
8300;19;22607725;8300;420;9552;9738;5.98;0.37;337.77;10.66;1252;22;3314.00;186
8303;19;22607740;8303;423;9557;9738;5.94;0.37;337.79;10.73;1254;22;3315.00;181
8307;19;22607757;8307;419;9566;9738;5.94;0.37;337.87;10.73;1259;22;3316.00;172
8314;19;22607775;8314;421;9567;9738;5.83;0.36;338.00;10.73;1253;22;3317.00;171
8317;19;22607795;8317;426;9575;9738;5.79;0.36;338.03;10.80;1258;22;3318.00;163
8320;19;22607812;8320;422;9578;9738;5.81;0.36;338.17;10.80;1258;22;3319.00;160
8323;19;22607827;8323;437;9582;9739;5.81;0.36;338.20;10.87;1259;22;3320.00;157
8326;19;22607841;8326;438;9584;9740;5.76;0.35;338.23;10.87;1258;22;3321.00;156
8330;19;22607859;8330;445;9587;9740;5.63;0.35;338.30;10.87;1257;22;3322.00;153
8333;19;22607875;8333;454;9592;9741;5.48;0.34;338.32;10.95;1259;22;3323.00;149
8337;19;22607890;8337;465;9596;9741;5.37;0.33;338.31;10.95;1259;22;3324.00;145
8340;19;22607904;8340;459;9598;9741;5.28;0.33;338.28;10.95;1258;22;3325.00;143
8344;19;22607919;8344;454;9600;9741;5.20;0.32;338.33;10.95;1256;22;3326.00;141
8347;19;22607933;8347;452;9604;9745;5.13;0.32;338.26;10.95;1257;22;3327.00;141
8351;19;22607950;8351;448;9605;9745;5.04;0.31;338.25;10.95;1254;22;3328.00;140
8356;19;22607965;8356;454;9608;9745;4.96;0.30;338.21;10.96;1252;22;3329.00;137
8358;19;22607982;8358;446;9612;9751;4.92;0.30;338.15;10.95;1254;22;3330.00;139
8362;19;22607997;8362;442;9614;9751;4.88;0.30;338.06;10.96;1252;22;3331.00;137
8366;19;22608018;8366;447;9617;9751;4.87;0.30;338.06;10.96;1251;22;3332.00;134
8371;19;22608037;8371;440;9620;9755;4.84;0.30;337.96;10.96;1249;22;3333.00;135
8374;19;22608052;8374;440;9623;9756;4.82;0.29;337.93;10.96;1249;22;3334.00;133
8376;19;22608068;8376;439;9624;9756;4.77;0.29;337.91;10.96;1248;22;3335.00;132
8380;19;22608083;8380;434;9626;9760;4.73;0.29;338.01;10.96;1246;22;3336.00;134
8385;19;22608101;8385;439;9627;9760;4.70;0.29;338.05;10.95;1242;22;3337.00;133
8386;19;22608119;8386;432;9628;9760;4.72;0.29;338.03;10.95;1242;22;3338.00;132
8389;19;22608135;8389;432;9630;9761;4.73;0.29;338.05;10.96;1241;22;3339.00;131
8393;19;22608151;8393;434;9632;9761;4.73;0.29;338.06;10.96;1239;22;3340.00;129
8395;19;22608167;8395;432;9637;9767;4.73;0.29;338.05;10.96;1242;22;3341.00;130
8400;19;22608185;8400;445;9637;9767;4.71;0.29;338.05;10.96;1237;22;3342.00;130
8403;19;22608202;8403;440;9637;9768;4.73;0.29;338.13;10.96;1234;22;3343.00;131
8407;19;22608218;8407;454;9639;9768;4.73;0.29;338.15;10.96;1232;22;3344.00;129
8410;19;22608233;8410;466;9640;9768;4.70;0.29;338.19;10.96;1230;22;3345.00;128
8415;19;22608251;8415;461;9640;9768;4.66;0.28;338.15;10.96;1225;22;3346.00;128
8418;19;22608270;8418;469;9642;9768;4.62;0.28;338.10;10.96;1224;22;3347.00;126
8421;19;22608286;8421;475;9649;9780;4.61;0.28;338.10;10.95;1228;22;3348.00;131
8426;19;22608304;8426;476;9651;9780;4.55;0.28;338.11;10.95;1225;22;3349.00;129
8431;19;22608321;8431;478;9653;9780;4.50;0.28;338.04;10.95;1222;22;3350.00;127
8434;19;22608338;8434;479;9653;9780;4.47;0.27;338.04;10.95;1219;22;3351.00;127
8435;19;22608356;8435;491;9653;9780;4.49;0.28;338.02;10.95;1218;22;3352.00;127
8438;19;22608372;8438;497;9653;9780;4.49;0.28;338.00;10.95;1215;22;3353.00;127
8440;19;22608387;8440;507;9656;9784;4.48;0.27;338.00;10.94;1216;22;3354.00;128
8445;19;22608407;8445;505;9656;9784;4.42;0.27;337.91;10.94;1211;22;3355.00;128
8447;19;22608427;8447;515;9660;9788;4.38;0.27;337.89;10.94;1213;22;3356.00;128
8449;19;22608449;8449;516;9661;9789;4.32;0.26;337.93;10.94;1212;22;3357.00;128
8451;19;22608468;8451;521;9661;9789;4.30;0.26;337.88;10.94;1210;22;3358.00;128
8454;19;22608485;8454;527;9661;9789;4.23;0.26;337.92;10.94;1207;22;3359.00;128
8455;19;22608506;8455;529;9684;9818;4.31;0.26;337.92;10.91;1229;22;3360.00;134
8458;19;22608528;8458;522;9684;9818;4.26;0.26;337.88;10.91;1226;22;3361.00;134
8461;19;22608544;8461;524;9686;9818;4.23;0.26;337.91;10.91;1225;22;3362.00;132
8463;19;22608559;8463;523;9687;9819;4.22;0.26;337.88;10.91;1224;22;3363.00;132
8466;19;22608575;8466;508;9688;9820;4.22;0.26;337.87;10.94;1222;22;3364.00;132
8468;19;22608591;8468;506;9688;9820;4.21;0.26;337.86;10.94;1220;22;3365.00;132
8470;19;22608606;8470;507;9690;9823;4.28;0.26;337.97;10.93;1220;22;3366.00;133
8473;19;22608624;8473;505;9690;9823;4.29;0.26;337.95;10.93;1217;22;3367.00;133
8474;19;22608639;8474;502;9691;9823;4.35;0.27;337.95;10.93;1217;22;3368.00;132
8476;19;22608654;8476;494;9691;9823;4.37;0.27;337.92;10.93;1215;22;3369.00;132
8480;19;22608669;8480;499;9696;9829;4.39;0.27;337.92;10.93;1216;22;3370.00;133
8482;19;22608693;8482;492;9696;9829;4.39;0.27;337.87;10.93;1214;22;3371.00;133
8485;19;22608711;8485;478;9696;9829;4.41;0.27;337.95;10.93;1211;22;3372.00;133
8487;19;22608734;8487;467;9696;9829;4.42;0.27;337.99;10.93;1209;22;3373.00;133
8489;19;22608755;8489;462;9699;9833;4.49;0.27;337.96;10.92;1210;22;3374.00;134
8492;19;22608772;8492;454;9701;9835;4.51;0.27;337.98;10.92;1209;22;3375.00;134
8493;19;22608790;8493;444;9701;9835;4.54;0.28;337.94;10.92;1208;22;3376.00;134
8494;19;22608807;8494;441;9702;9836;4.61;0.28;337.96;10.92;1208;22;3377.00;134
8497;19;22608822;8497;440;9702;9836;4.64;0.28;337.87;10.92;1205;22;3378.00;134
8498;19;22608845;8498;434;9702;9836;4.71;0.29;337.86;10.92;1204;22;3379.00;134
8498;19;22608862;8498;433;9702;9836;4.79;0.29;337.86;10.92;1204;22;3380.00;134
8500;19;22608887;8500;417;9702;9836;4.87;0.30;337.85;10.92;1202;22;3381.00;134
8501;19;22608903;8501;404;9702;9836;4.96;0.30;337.82;10.92;1201;22;3382.00;134
8503;19;22608917;8503;396;9702;9836;5.06;0.31;337.83;10.92;1199;22;3383.00;134
8505;19;22608933;8505;404;9745;9906;5.27;0.32;337.80;10.87;1240;22;3384.00;161
8509;19;22608956;8509;392;9745;9907;5.33;0.32;337.90;10.87;1236;22;3385.00;162
8511;19;22608978;8511;384;9750;9907;5.44;0.33;338.07;10.87;1239;22;3386.00;157
8512;19;22608995;8512;374;9750;9907;5.54;0.34;338.12;10.87;1238;22;3387.00;157
8512;19;22609037;8512;370;9752;9907;5.63;0.34;338.12;10.87;1240;22;3388.00;155
8514;19;22609056;8514;374;9753;9907;5.65;0.34;338.18;10.87;1239;22;3389.00;154
8517;19;22609077;8517;381;9757;9907;5.69;0.35;338.24;10.86;1240;22;3390.00;150
8519;19;22609093;8519;390;9758;9907;5.70;0.35;338.26;10.86;1239;22;3391.00;149
8522;19;22609109;8522;390;9761;9908;5.69;0.35;338.42;10.86;1239;22;3392.00;147
8523;19;22609128;8523;389;9763;9909;5.67;0.34;338.40;10.86;1240;22;3393.00;146
8526;19;22609147;8526;393;9766;9909;5.70;0.35;338.52;10.86;1240;22;3394.00;143
8529;19;22609164;8529;392;9772;9913;5.67;0.34;338.54;10.86;1243;22;3395.00;141
8531;19;22609183;8531;405;9773;9913;5.71;0.35;338.59;10.86;1242;22;3396.00;140
8533;19;22609204;8533;409;9773;9913;5.75;0.35;338.61;10.86;1240;22;3397.00;140
8534;19;22609225;8534;405;9773;9913;5.83;0.36;338.62;10.86;1239;22;3398.00;140
8537;19;22609247;8537;404;9778;9919;5.84;0.36;338.75;10.85;1241;22;3399.00;141
8539;19;22609269;8539;404;9778;9919;5.84;0.36;338.82;10.85;1239;22;3400.00;141
8541;19;22609291;8541;410;9778;9919;5.82;0.35;338.91;10.85;1237;22;3401.00;141
8544;19;22609314;8544;414;9780;9922;5.78;0.35;338.94;10.85;1236;22;3402.00;142
8546;19;22609333;8546;410;9780;9922;5.75;0.35;339.03;10.85;1234;22;3403.00;142
8548;19;22609349;8548;409;9781;9922;5.76;0.35;339.08;10.85;1233;22;3404.00;141
8550;19;22609366;8550;411;9781;9923;5.78;0.35;339.17;10.85;1231;22;3405.00;142
8552;19;22609382;8552;413;9782;9924;5.80;0.35;339.10;10.85;1230;22;3406.00;142
8554;19;22609400;8554;416;9782;9924;5.80;0.35;339.20;10.85;1228;22;3407.00;142
8555;19;22609417;8555;417;9793;9937;5.90;0.36;339.20;10.84;1238;22;3408.00;144
8556;19;22609433;8556;416;9793;9937;5.89;0.36;339.27;10.84;1237;22;3409.00;144
8557;19;22609449;8557;415;9793;9937;5.88;0.36;339.32;10.84;1236;22;3410.00;144
8559;19;22609464;8559;410;9794;9938;5.91;0.36;339.39;10.84;1235;22;3411.00;144
8560;19;22609483;8560;412;9794;9938;5.95;0.36;339.46;10.84;1234;22;3412.00;144
8560;19;22609499;8560;416;9798;9942;6.00;0.37;339.46;10.83;1238;22;3413.00;144
8562;19;22609515;8562;421;9798;9942;6.03;0.37;339.57;10.83;1236;22;3414.00;144
8568;19;22609531;8568;413;9801;9946;6.01;0.37;339.64;10.83;1233;22;3415.00;145
8571;19;22609555;8571;417;9801;9946;6.05;0.37;339.76;10.83;1230;22;3416.00;145
8575;19;22609573;8575;402;9801;9946;6.07;0.37;339.91;10.83;1226;22;3417.00;145
8578;19;22609590;8578;397;9801;9946;6.09;0.37;340.04;10.83;1223;22;3418.00;145
8584;19;22609607;8584;398;9801;9946;6.08;0.37;340.12;10.83;1217;22;3419.00;145
8585;19;22609625;8585;395;9827;9980;6.14;0.37;340.17;10.80;1242;22;3420.00;153
8590;19;22609644;8590;381;9827;9980;6.19;0.38;340.22;10.80;1237;22;3421.00;153
8594;19;22609664;8594;373;9829;9980;6.20;0.38;340.26;10.80;1235;22;3422.00;151
8596;19;22609681;8596;370;9830;9980;6.23;0.38;340.37;10.83;1234;22;3423.00;150
8600;19;22609699;8600;376;9831;9980;6.27;0.38;340.40;10.83;1231;22;3424.00;149
8602;19;22609718;8602;366;9831;9980;6.28;0.38;340.39;10.83;1229;22;3425.00;149
8605;19;22609737;8605;367;9831;9981;6.25;0.38;340.48;10.83;1226;22;3426.00;150
8608;19;22609760;8608;369;9831;9981;6.22;0.38;340.52;10.83;1223;22;3427.00;150
8611;19;22609779;8611;361;9836;9987;6.21;0.38;340.68;10.82;1225;22;3428.00;151
8614;19;22609797;8614;359;9837;9988;6.20;0.38;340.76;10.82;1223;22;3429.00;151
8617;19;22609814;8617;350;9839;9988;6.16;0.37;340.76;10.91;1222;22;3430.00;149
8621;19;22609834;8621;339;9839;9988;6.11;0.37;340.86;10.91;1218;22;3431.00;149
8623;19;22609852;8623;339;9842;9992;6.12;0.37;340.93;10.90;1219;22;3432.00;150
8627;19;22609873;8627;334;9842;9992;6.13;0.37;340.99;10.90;1215;22;3433.00;150
8631;19;22609890;8631;331;9842;9992;6.15;0.38;341.01;10.90;1211;22;3434.00;150
8635;19;22609906;8635;337;9843;9993;6.18;0.38;341.03;10.90;1208;22;3435.00;150
8635;19;22609925;8635;340;9846;9997;6.18;0.38;341.03;10.90;1211;22;3436.00;151
8639;19;22609942;8639;344;9846;9997;6.19;0.38;341.14;10.90;1207;22;3437.00;151
8640;19;22609958;8640;343;9849;10000;6.24;0.38;341.11;10.93;1209;22;3438.00;151
8644;19;22609974;8644;340;9850;10000;6.31;0.39;341.11;10.93;1206;22;3439.00;150
8647;19;22609991;8647;331;9850;10000;6.32;0.39;341.15;10.93;1203;22;3440.00;150
8650;19;22610012;8650;340;9850;10000;6.33;0.39;341.22;10.93;1200;22;3441.00;150
8654;19;22610034;8654;344;9854;10004;6.39;0.39;341.20;10.92;1200;22;3442.00;150
8656;19;22610054;8656;343;9854;10004;6.38;0.39;341.29;10.92;1198;22;3443.00;150
8660;19;22610073;8660;349;9854;10004;6.30;0.38;341.25;10.92;1194;22;3444.00;150
8663;19;22610096;8663;351;9854;10004;6.26;0.38;341.31;10.92;1191;22;3445.00;150
8664;19;22610114;8664;358;9854;10005;6.22;0.38;341.34;10.92;1190;22;3446.00;151
8670;19;22610132;8670;361;9855;10006;6.16;0.38;341.34;10.92;1185;22;3447.00;151
8671;19;22610152;8671;357;9855;10006;6.08;0.37;341.30;10.92;1184;22;3448.00;151
8675;19;22610171;8675;355;9856;10007;6.06;0.37;341.35;10.92;1181;22;3449.00;151
8677;19;22610190;8677;360;9856;10007;6.03;0.37;341.38;10.92;1179;22;3450.00;151
8681;19;22610208;8681;359;9856;10007;6.00;0.37;341.48;10.92;1175;22;3451.00;151
8685;19;22610226;8685;365;9856;10007;5.96;0.36;341.56;10.92;1171;22;3452.00;151
8686;19;22610249;8686;374;9856;10007;5.90;0.36;341.63;10.92;1170;22;3453.00;151
8688;19;22610267;8688;370;9856;10007;5.93;0.36;341.64;10.92;1168;22;3454.00;151
8691;19;22610284;8691;368;9856;10007;5.91;0.36;341.70;10.92;1165;22;3455.00;151
8694;19;22610301;8694;392;9922;10134;6.08;0.38;341.75;10.90;1228;22;3456.00;212
8697;19;22610333;8697;380;9924;10135;6.11;0.38;341.82;10.90;1227;22;3457.00;211
8701;19;22610351;8701;379;9933;10135;6.22;0.38;341.97;10.94;1232;22;3458.00;202
8704;19;22610370;8704;383;9936;10135;6.24;0.38;342.03;10.93;1232;22;3459.00;199
8705;19;22610387;8705;390;9943;10135;6.26;0.39;342.10;10.98;1238;22;3460.00;192
8706;19;22610412;8706;391;9944;10135;6.29;0.39;342.15;10.98;1238;22;3461.00;191
8709;19;22610436;8709;393;9947;10135;6.32;0.39;342.22;10.98;1238;22;3462.00;188
8715;19;22610458;8715;394;9951;10135;6.34;0.39;342.24;11.02;1236;22;3463.00;184
8715;19;22610494;8715;395;9955;10136;6.41;0.39;342.24;11.07;1240;22;3464.00;181
8718;19;22610518;8718;394;9962;10138;6.41;0.39;342.28;11.11;1244;22;3465.00;176
8722;19;22610549;8722;399;9966;10138;6.37;0.39;342.34;11.16;1244;22;3466.00;172
8725;19;22610568;8725;391;9968;10139;6.28;0.39;342.41;11.16;1243;22;3467.00;171
8727;19;22610587;8727;402;9970;10139;6.26;0.38;342.45;11.20;1243;22;3468.00;169
8730;19;22610603;8730;397;9973;10139;6.19;0.38;342.52;11.20;1243;22;3469.00;166
8732;19;22610619;8732;399;9974;10139;6.12;0.38;342.57;11.20;1242;22;3470.00;165
8734;19;22610636;8734;408;9986;10143;6.07;0.37;342.63;11.38;1252;22;3471.00;157
8736;19;22610652;8736;415;9987;10143;6.06;0.37;342.69;11.38;1251;22;3472.00;156
8745;19;22610669;8745;421;9990;10143;5.97;0.36;342.89;11.43;1245;22;3473.00;153
8746;19;22610687;8746;418;9992;10146;5.92;0.36;342.87;11.47;1246;22;3474.00;154
8746;19;22610703;8746;424;9994;10146;5.89;0.36;342.87;11.51;1248;22;3475.00;152
8749;19;22610718;8749;427;9996;10146;5.82;0.36;343.11;11.56;1247;22;3476.00;150
8753;19;22610733;8753;431;10000;10150;5.73;0.35;343.16;11.56;1247;22;3477.00;150
8754;19;22610749;8754;436;10002;10151;5.66;0.35;343.14;11.60;1248;22;3478.00;149
8757;19;22610768;8757;442;10004;10151;5.59;0.34;343.21;11.64;1247;22;3479.00;147
8759;19;22610786;8759;449;10008;10156;5.58;0.34;343.32;11.64;1249;22;3480.00;148
8764;19;22610801;8764;453;10011;10156;5.50;0.34;343.36;11.72;1247;22;3481.00;145
8765;19;22610817;8765;461;10012;10156;5.43;0.33;343.34;11.77;1247;22;3482.00;144
8766;19;22610833;8766;467;10013;10157;5.34;0.33;343.40;11.77;1247;22;3483.00;144
8769;19;22610852;8769;469;10014;10157;5.29;0.32;343.47;11.81;1245;22;3484.00;143
8772;19;22610870;8772;477;10019;10163;5.29;0.32;343.43;11.80;1247;22;3485.00;144
8773;19;22610886;8773;480;10021;10163;5.26;0.32;343.44;11.89;1248;22;3486.00;142
8778;19;22610901;8778;476;10022;10164;5.22;0.32;343.53;11.89;1244;22;3487.00;142
8780;19;22610917;8780;483;10024;10164;5.20;0.32;343.60;11.97;1244;22;3488.00;140
8783;19;22610932;8783;493;10025;10164;5.17;0.32;343.62;12.01;1242;22;3489.00;139
8786;19;22610948;8786;493;10026;10164;5.11;0.31;343.57;12.05;1240;22;3490.00;138
8790;19;22610967;8790;500;10026;10164;5.05;0.31;343.61;12.05;1236;22;3491.00;138
8792;19;22610982;8792;508;10038;10176;5.02;0.31;343.59;12.08;1246;22;3492.00;138
8796;19;22610998;8796;503;10038;10176;4.98;0.31;343.53;12.08;1242;22;3493.00;138
8799;19;22611015;8799;519;10038;10176;4.94;0.30;343.56;12.08;1239;22;3494.00;138
8801;19;22611031;8801;519;10038;10176;4.93;0.30;343.53;12.08;1237;22;3495.00;138
8805;19;22611044;8805;518;10038;10176;4.82;0.30;343.46;12.08;1233;22;3496.00;138
8808;19;22611057;8808;524;10038;10176;4.73;0.29;343.42;12.08;1230;22;3497.00;138
8809;19;22611071;8809;537;10041;10180;4.64;0.29;343.39;12.07;1232;22;3498.00;139
8811;19;22611085;8811;539;10041;10180;4.56;0.28;343.38;12.07;1230;22;3499.00;139
8815;19;22611101;8815;528;10045;10184;4.53;0.28;343.53;12.07;1230;22;3500.00;139
8821;19;22611133;8821;526;10046;10185;4.43;0.27;343.50;12.07;1225;22;3501.00;139
8825;19;22611148;8825;527;10046;10185;4.41;0.27;343.42;12.07;1221;22;3502.00;139
8828;19;22611165;8828;523;10046;10185;4.40;0.27;343.34;12.07;1218;22;3503.00;139
8832;19;22611189;8832;525;10056;10198;4.40;0.27;343.26;12.06;1224;22;3504.00;142
8837;19;22611206;8837;516;10056;10198;4.36;0.27;343.19;12.06;1219;22;3505.00;142
8840;19;22611228;8840;523;10056;10198;4.36;0.27;343.15;12.06;1216;22;3506.00;142
8845;19;22611241;8845;511;10057;10199;4.38;0.27;343.11;12.06;1212;22;3507.00;142
8849;19;22611256;8849;510;10057;10200;4.40;0.27;343.05;12.06;1208;22;3508.00;143
8852;19;22611270;8852;511;10057;10200;4.39;0.27;343.01;12.06;1205;22;3509.00;143
8855;19;22611287;8855;502;10061;10206;4.42;0.27;343.00;12.05;1206;22;3510.00;145
8859;19;22611302;8859;502;10061;10206;4.40;0.27;342.94;12.05;1202;22;3511.00;145
8860;19;22611316;8860;498;10062;10206;4.39;0.27;342.96;12.05;1202;22;3512.00;144
8863;19;22611330;8863;495;10062;10206;4.37;0.27;342.95;12.05;1199;22;3513.00;144
8865;19;22611343;8865;499;10066;10212;4.39;0.27;342.95;12.05;1201;22;3514.00;146
8867;19;22611357;8867;505;10066;10212;4.39;0.27;342.93;12.05;1199;22;3515.00;146
8873;19;22611371;8873;507;10066;10212;4.34;0.27;342.97;12.05;1193;22;3516.00;146
8875;19;22611387;8875;506;10066;10212;4.31;0.26;342.95;12.05;1191;22;3517.00;146
8879;19;22611401;8879;505;10069;10216;4.31;0.26;342.92;12.04;1190;22;3518.00;147
8883;19;22611416;8883;502;10071;10219;4.29;0.26;342.97;12.04;1188;22;3519.00;148
8887;19;22611430;8887;496;10071;10219;4.29;0.26;342.94;12.04;1184;22;3520.00;148
8889;19;22611444;8889;492;10072;10220;4.30;0.26;342.98;12.04;1183;22;3521.00;148
8895;19;22611458;8895;476;10073;10220;4.27;0.26;342.91;12.04;1178;22;3522.00;147
8896;19;22611474;8896;471;10074;10220;4.28;0.26;342.90;12.04;1178;22;3523.00;146
8899;19;22611489;8899;467;10074;10220;4.30;0.26;342.90;12.04;1175;22;3524.00;146
8901;19;22611504;8901;461;10074;10220;4.37;0.27;342.89;12.04;1173;22;3525.00;146
8903;19;22611518;8903;453;10075;10220;4.46;0.27;342.88;12.04;1172;22;3526.00;145
8904;19;22611534;8904;447;10075;10220;4.53;0.28;342.89;12.04;1171;22;3527.00;145
8907;19;22611558;8907;458;10111;10290;4.71;0.29;342.90;12.00;1204;22;3528.00;179
8909;19;22611584;8909;449;10112;10291;4.81;0.29;342.89;12.00;1203;22;3529.00;179
8911;19;22611601;8911;449;10118;10291;4.87;0.30;342.94;11.99;1207;22;3530.00;173
8915;19;22611618;8915;448;10123;10291;4.93;0.30;342.92;11.99;1208;22;3531.00;168
8916;19;22611634;8916;441;10125;10291;5.01;0.31;342.89;11.98;1209;22;3532.00;166
8918;19;22611655;8918;437;10127;10291;5.10;0.31;342.93;11.98;1209;22;3533.00;164
8920;19;22611676;8920;438;10129;10291;5.19;0.32;342.93;11.98;1209;22;3534.00;162
8922;19;22611703;8922;432;10132;10291;5.24;0.32;343.00;11.98;1210;22;3535.00;159
8925;19;22611721;8925;437;10134;10292;5.21;0.32;342.95;11.98;1209;22;3536.00;158
8929;19;22611743;8929;446;10136;10293;5.16;0.31;342.94;11.98;1207;22;3537.00;157
8931;19;22611763;8931;449;10137;10293;5.16;0.31;342.96;11.98;1206;22;3538.00;156
8933;19;22611782;8933;454;10140;10297;5.18;0.32;342.95;11.98;1207;22;3539.00;157
8937;19;22611801;8937;463;10141;10297;5.15;0.31;342.96;11.98;1204;22;3540.00;156
8939;19;22611819;8939;470;10141;10297;5.14;0.31;342.98;11.98;1202;22;3541.00;156
8943;19;22611836;8943;476;10142;10297;5.07;0.31;343.08;11.98;1199;22;3542.00;155
8944;19;22611851;8944;477;10147;10303;5.03;0.31;343.10;11.97;1203;22;3543.00;156
8945;19;22611868;8945;478;10149;10303;5.03;0.31;343.09;11.97;1204;22;3544.00;154
8951;19;22611885;8951;487;10149;10303;4.97;0.30;343.22;11.97;1198;22;3545.00;154
8956;19;22611908;8956;500;10152;10306;4.92;0.30;343.25;11.97;1196;22;3546.00;154
8959;19;22611925;8959;502;10153;10306;4.87;0.30;343.30;12.01;1194;22;3547.00;153
8962;19;22611940;8962;490;10154;10306;4.83;0.29;343.35;12.01;1192;22;3548.00;152
8964;19;22611955;8964;494;10154;10307;4.77;0.29;343.39;12.01;1190;22;3549.00;153
8966;19;22611970;8966;485;10157;10308;4.79;0.29;343.43;12.00;1191;22;3550.00;151
8967;19;22611984;8967;485;10157;10308;4.79;0.29;343.49;12.00;1190;22;3551.00;151
8968;19;22612001;8968;487;10168;10321;4.93;0.30;343.48;11.99;1200;22;3552.00;153
8973;19;22612025;8973;478;10168;10321;4.96;0.30;343.52;11.99;1195;22;3553.00;153
8973;19;22612041;8973;468;10168;10321;5.02;0.31;343.52;11.99;1195;22;3554.00;153
8976;19;22612056;8976;470;10170;10323;5.08;0.31;343.57;11.99;1194;22;3555.00;153
8981;19;22612074;8981;451;10170;10323;5.08;0.31;343.58;11.99;1189;23;3556.00;153
8981;19;22612102;8981;435;10174;10327;5.16;0.31;343.58;11.98;1193;23;3557.00;153
8985;19;22612117;8985;427;10174;10327;5.20;0.32;343.60;11.98;1189;23;3558.00;153
8988;19;22612132;8988;420;10177;10331;5.23;0.32;343.59;11.98;1189;23;3559.00;154
8988;19;22612150;8988;411;10177;10331;5.28;0.32;343.59;11.98;1189;23;3560.00;154
8992;19;22612168;8992;408;10177;10331;5.33;0.32;343.60;11.98;1185;23;3561.00;154
8994;19;22612185;8994;402;10177;10331;5.33;0.32;343.61;11.98;1183;23;3562.00;154
8997;19;22612200;8997;405;10177;10331;5.29;0.32;343.63;11.98;1180;23;3563.00;154
8999;19;22612216;8999;407;10186;10343;5.32;0.32;343.59;11.97;1187;23;3564.00;157
9001;19;22612233;9001;420;10186;10343;5.32;0.32;343.63;11.97;1185;23;3565.00;157
9004;19;22612252;9004;426;10188;10343;5.33;0.32;343.70;11.97;1184;23;3566.00;155
9006;19;22612270;9006;422;10188;10343;5.33;0.32;343.74;11.97;1182;23;3567.00;155
9008;19;22612288;9008;421;10188;10343;5.32;0.32;343.74;11.97;1180;23;3568.00;155
9009;19;22612307;9009;416;10188;10343;5.36;0.33;343.75;11.97;1179;23;3569.00;155
9012;19;22612330;9012;418;10188;10344;5.35;0.32;343.87;11.97;1176;23;3570.00;156
9012;19;22612350;9012;421;10188;10344;5.38;0.33;343.87;11.97;1176;23;3571.00;156
9014;19;22612366;9014;413;10193;10350;5.38;0.33;344.10;11.96;1179;23;3572.00;157
9018;19;22612384;9018;412;10195;10351;5.36;0.33;344.18;12.00;1177;23;3573.00;156
9020;19;22612403;9020;411;10195;10351;5.39;0.33;344.20;12.00;1175;23;3574.00;156
9021;19;22612425;9021;402;10195;10351;5.45;0.33;344.22;12.00;1174;23;3575.00;156
9025;19;22612446;9025;394;10198;10355;5.51;0.34;344.31;12.00;1173;23;3576.00;157
9026;19;22612471;9026;394;10198;10355;5.56;0.34;344.28;12.00;1172;23;3577.00;157
9029;19;22612500;9029;388;10198;10355;5.59;0.34;344.40;12.00;1169;23;3578.00;157
9030;19;22612522;9030;393;10199;10356;5.63;0.34;344.46;12.00;1169;23;3579.00;157
9033;19;22612540;9033;392;10202;10360;5.62;0.34;344.49;11.99;1169;23;3580.00;158
9037;19;22612557;9037;389;10202;10360;5.62;0.34;344.59;11.99;1165;23;3581.00;158
9039;19;22612575;9039;392;10204;10363;5.61;0.34;344.61;11.99;1165;23;3582.00;159
9040;19;22612594;9040;395;10204;10363;5.64;0.34;344.61;11.99;1164;23;3583.00;159
9043;19;22612613;9043;401;10205;10363;5.62;0.34;344.65;11.99;1162;23;3584.00;158
9046;19;22612630;9046;397;10205;10363;5.67;0.35;344.64;11.99;1159;23;3585.00;158
9048;19;22612647;9048;398;10209;10367;5.73;0.35;344.66;11.99;1161;23;3586.00;158
9050;19;22612667;9050;393;10209;10367;5.72;0.35;344.68;11.99;1159;23;3587.00;158
9055;19;22612684;9055;393;10209;10367;5.73;0.35;344.81;11.99;1154;23;3588.00;158
9056;19;22612702;9056;390;10209;10367;5.77;0.35;344.87;11.99;1153;23;3589.00;158
9058;19;22612719;9058;386;10209;10368;5.81;0.35;344.94;11.99;1151;23;3590.00;159
9064;19;22612735;9064;378;10210;10369;5.86;0.36;344.99;11.98;1146;23;3591.00;159
9066;19;22612752;9066;377;10211;10369;5.90;0.36;345.00;12.02;1145;23;3592.00;158
9068;19;22612772;9068;364;10212;10370;5.99;0.36;345.03;12.02;1144;23;3593.00;158
9070;19;22612788;9070;355;10212;10370;6.03;0.37;345.09;12.02;1142;23;3594.00;158
9071;19;22612803;9071;355;10212;10370;6.08;0.37;345.08;12.02;1141;23;3595.00;158
9076;19;22612818;9076;351;10212;10370;6.14;0.37;345.26;12.02;1136;23;3596.00;158
9076;19;22612834;9076;350;10212;10370;6.23;0.38;345.26;12.02;1136;23;3597.00;158
9079;19;22612852;9079;345;10212;10370;6.24;0.38;345.27;12.02;1133;23;3598.00;158
9082;19;22612869;9082;340;10212;10370;6.30;0.38;345.28;12.02;1130;23;3599.00;158
9085;19;22612887;9085;398;10335;10623;6.17;0.38;345.28;11.87;1250;23;3600.00;288
9086;19;22612929;9086;379;10335;10624;6.18;0.38;345.27;11.87;1249;23;3601.00;289
9086;19;22612947;9086;362;10343;10624;6.28;0.39;345.27;11.87;1257;23;3602.00;281
9088;19;22612963;9088;355;10344;10624;6.32;0.39;345.26;11.87;1256;23;3603.00;280
9088;19;22612979;9088;339;10349;10624;6.39;0.40;345.26;11.91;1261;23;3604.00;275
9092;19;22613010;9092;322;10353;10624;6.45;0.40;345.37;11.96;1261;23;3605.00;271
9094;19;22613034;9094;317;10359;10624;6.53;0.40;345.37;11.96;1265;23;3606.00;265
9097;19;22613050;9097;309;10362;10624;6.54;0.40;345.35;11.95;1265;23;3607.00;262
9099;19;22613067;9099;309;10371;10625;6.59;0.41;345.46;11.99;1272;23;3608.00;254
9101;19;22613085;9101;308;10377;10626;6.62;0.41;345.45;11.98;1276;23;3609.00;249
9104;19;22613103;9104;309;10384;10626;6.59;0.41;345.59;11.98;1280;23;3610.00;242
9105;19;22613123;9105;318;10385;10627;6.58;0.41;345.60;11.98;1280;23;3611.00;242
9109;19;22613141;9109;320;10390;10627;6.53;0.40;345.69;11.98;1281;23;3612.00;237
9114;20;22613158;9114;320;10393;10627;6.46;0.40;345.84;11.98;1279;24;3613.00;234
9116;20;22613184;9116;321;10394;10627;6.40;0.39;345.84;11.98;1278;24;3614.00;233
9121;20;22613202;9121;326;10397;10631;6.30;0.39;345.99;11.98;1276;24;3615.00;234
9125;20;22613227;9125;328;10403;10631;6.20;0.38;346.22;11.98;1278;24;3616.00;228
9127;20;22613246;9127;333;10404;10631;6.13;0.38;346.17;11.98;1277;24;3617.00;227
9131;20;22613270;9131;330;10406;10634;6.04;0.37;346.19;11.98;1275;24;3618.00;228
9133;20;22613289;9133;341;10407;10634;6.00;0.37;346.21;11.98;1274;24;3619.00;227
9134;20;22613308;9134;342;10407;10634;5.98;0.37;346.21;11.98;1273;24;3620.00;227
9138;20;22613324;9138;340;10411;10638;6.03;0.37;346.46;12.03;1273;24;3621.00;227
9140;20;22613342;9140;351;10414;10639;6.03;0.37;346.47;12.03;1274;24;3622.00;225
9142;20;22613359;9142;350;10414;10639;6.03;0.37;346.55;12.03;1272;24;3623.00;225
9143;20;22613375;9143;353;10416;10643;6.07;0.37;346.56;12.03;1273;24;3624.00;227
9145;20;22613395;9145;364;10418;10643;6.02;0.37;346.63;12.03;1273;24;3625.00;225
9148;20;22613412;9148;368;10421;10643;5.96;0.36;346.64;12.04;1273;24;3626.00;222
9151;20;22613429;9151;372;10422;10644;5.85;0.36;346.62;12.09;1271;24;3627.00;222
9153;20;22613452;9153;377;10424;10644;5.79;0.35;346.72;12.09;1271;24;3628.00;220
9156;20;22613469;9156;388;10433;10650;5.73;0.35;346.85;12.19;1277;24;3629.00;217
9158;20;22613493;9158;399;10434;10650;5.72;0.35;346.87;12.19;1276;24;3630.00;216
9161;20;22613511;9161;401;10437;10651;5.66;0.34;346.97;12.19;1276;24;3631.00;214
9165;20;22613528;9165;412;10439;10651;5.61;0.34;347.06;12.24;1274;24;3632.00;212
9167;20;22613545;9167;428;10443;10651;5.57;0.34;347.09;12.30;1276;24;3633.00;208
9168;20;22613562;9168;435;10444;10651;5.56;0.34;347.14;12.30;1276;24;3634.00;207
9170;20;22613585;9170;440;10446;10651;5.49;0.34;347.19;12.35;1276;24;3635.00;205
9171;20;22613605;9171;447;10455;10663;5.50;0.34;347.17;12.35;1284;24;3636.00;208
9172;20;22613629;9172;451;10456;10663;5.46;0.33;347.16;12.40;1284;24;3637.00;207
9175;20;22613650;9175;463;10460;10663;5.41;0.33;347.15;12.40;1285;24;3638.00;203
9178;20;22613677;9178;464;10464;10663;5.34;0.32;347.22;12.50;1286;24;3639.00;199
9178;20;22613699;9178;474;10468;10663;5.26;0.32;347.22;12.51;1290;24;3640.00;195
9181;20;22613718;9181;485;10471;10663;5.19;0.32;347.26;12.56;1290;24;3641.00;192
9182;20;22613736;9182;500;10478;10667;5.16;0.31;347.23;12.66;1296;24;3642.00;189
9185;21;22613756;9185;505;10481;10667;5.10;0.31;347.28;12.71;1296;25;3643.00;186
9185;21;22613784;9185;513;10485;10671;5.12;0.31;347.28;12.70;1300;25;3644.00;186
9191;21;22613803;9191;523;10488;10673;5.07;0.31;347.49;12.75;1297;25;3645.00;185
9193;21;22613821;9193;534;10490;10673;5.01;0.31;347.44;12.75;1297;25;3646.00;183
9197;21;22613839;9197;539;10494;10673;4.97;0.30;347.46;12.85;1297;25;3647.00;179
9199;21;22613857;9199;553;10503;10686;4.92;0.30;347.48;12.88;1304;25;3648.00;183
9202;21;22613881;9202;546;10506;10686;4.88;0.30;347.53;12.93;1304;25;3649.00;180
9204;21;22613898;9204;545;10507;10686;4.87;0.30;347.47;12.93;1303;25;3650.00;179
9205;21;22613916;9205;551;10510;10687;4.82;0.29;347.46;13.02;1305;25;3651.00;177
9207;21;22613936;9207;553;10510;10688;4.80;0.29;347.42;13.02;1303;25;3652.00;178
9209;21;22613954;9209;548;10511;10688;4.83;0.30;347.35;13.02;1302;25;3653.00;177
9210;21;22613970;9210;541;10515;10691;4.85;0.30;347.33;13.11;1305;25;3654.00;176
9212;21;22613992;9212;535;10516;10691;4.81;0.30;347.34;13.16;1304;25;3655.00;175
9212;21;22614012;9212;539;10517;10691;4.85;0.30;347.34;13.15;1305;25;3656.00;174
9217;21;22614031;9217;540;10517;10691;4.80;0.29;347.26;13.15;1300;25;3657.00;174
9220;21;22614048;9220;552;10522;10697;4.84;0.30;347.17;13.15;1302;25;3658.00;175
9223;21;22614068;9223;548;10527;10697;4.82;0.30;347.09;13.29;1304;25;3659.00;170
9226;21;22614087;9226;556;10529;10697;4.80;0.29;347.00;13.33;1303;25;3660.00;168
9228;21;22614103;9228;554;10531;10697;4.82;0.30;346.95;13.37;1303;25;3661.00;166
9230;21;22614119;9230;561;10534;10701;4.78;0.29;346.94;13.37;1304;25;3662.00;167
9231;21;22614134;9231;570;10537;10702;4.78;0.29;346.93;13.45;1306;25;3663.00;165
9237;21;22614152;9237;575;10537;10702;4.72;0.29;346.86;13.45;1300;25;3664.00;165
9238;21;22614169;9238;575;10538;10703;4.66;0.29;346.87;13.45;1300;25;3665.00;165
9242;21;22614184;9242;585;10540;10703;4.56;0.28;346.81;13.54;1298;25;3666.00;163
9248;21;22614199;9248;587;10540;10703;4.45;0.27;346.87;13.54;1292;25;3667.00;163
9251;21;22614213;9251;596;10542;10703;4.36;0.27;346.84;13.62;1291;25;3668.00;161
9259;21;22614226;9259;598;10542;10703;4.24;0.26;346.94;13.62;1283;25;3669.00;161
9261;21;22614243;9261;616;10543;10703;4.18;0.26;346.90;13.66;1282;25;3670.00;160
9264;21;22614259;9264;617;10544;10703;4.09;0.25;346.91;13.70;1280;25;3671.00;159
9267;21;22614272;9267;626;10584;10773;4.18;0.26;346.92;13.65;1317;25;3672.00;189
9268;21;22614294;9268;632;10588;10774;4.08;0.25;346.91;13.73;1320;25;3673.00;186
9269;21;22614307;9269;636;10594;10774;4.05;0.25;346.89;13.72;1325;25;3674.00;180
9272;21;22614321;9272;623;10598;10774;3.97;0.24;346.86;13.72;1326;25;3675.00;176
9275;21;22614338;9275;622;10600;10774;3.93;0.24;346.82;13.71;1325;25;3676.00;174
9277;21;22614353;9277;616;10603;10774;3.92;0.24;346.81;13.71;1326;25;3677.00;171
9280;21;22614367;9280;601;10606;10774;3.92;0.24;346.74;13.71;1326;25;3678.00;168
9282;21;22614381;9282;586;10607;10774;3.94;0.24;346.72;13.71;1325;25;3679.00;167
9286;21;22614395;9286;583;10608;10775;3.95;0.24;346.64;13.71;1322;25;3680.00;167
9290;21;22614416;9290;574;10610;10776;4.01;0.25;346.59;13.71;1320;25;3681.00;166
9290;21;22614437;9290;565;10612;10776;4.06;0.25;346.59;13.71;1322;25;3682.00;164
9293;21;22614456;9293;558;10615;10780;4.12;0.25;346.60;13.70;1322;25;3683.00;165
9295;21;22614476;9295;544;10615;10780;4.17;0.25;346.61;13.70;1320;25;3684.00;165
9297;21;22614503;9297;542;10615;10780;4.23;0.26;346.60;13.70;1318;25;3685.00;165
9298;21;22614520;9298;540;10615;10780;4.31;0.26;346.58;13.70;1317;25;3686.00;165
9301;21;22614537;9301;532;10619;10786;4.32;0.26;346.58;13.70;1318;25;3687.00;167
9303;21;22614568;9303;533;10619;10786;4.36;0.27;346.60;13.70;1316;25;3688.00;167
9308;21;22614584;9308;529;10619;10786;4.39;0.27;346.53;13.70;1311;25;3689.00;167
9310;21;22614602;9310;526;10622;10792;4.45;0.27;346.52;13.69;1312;25;3690.00;170
9312;21;22614622;9312;522;10622;10792;4.52;0.28;346.53;13.69;1310;25;3691.00;170
9317;21;22614638;9317;526;10624;10792;4.52;0.28;346.49;13.69;1307;25;3692.00;168
9318;21;22614655;9318;529;10624;10793;4.51;0.28;346.49;13.69;1306;25;3693.00;169
9319;21;22614672;9319;530;10625;10794;4.55;0.28;346.46;13.69;1306;25;3694.00;169
9321;21;22614691;9321;535;10625;10794;4.61;0.28;346.48;13.69;1304;25;3695.00;169
9325;21;22614717;9325;535;10636;10807;4.71;0.29;346.43;13.68;1311;25;3696.00;171
9327;21;22614738;9327;538;10638;10807;4.77;0.29;346.43;13.68;1311;25;3697.00;169
9330;21;22614757;9330;541;10638;10807;4.79;0.29;346.41;13.68;1308;25;3698.00;169
9333;21;22614782;9333;532;10639;10808;4.88;0.30;346.39;13.68;1306;25;3699.00;169
9338;21;22614804;9338;531;10639;10808;4.90;0.30;346.48;13.68;1301;25;3700.00;169
9340;21;22614832;9340;526;10643;10812;4.95;0.30;346.46;13.67;1303;25;3701.00;169
9343;21;22614856;9343;528;10645;10812;4.98;0.31;346.44;13.67;1302;25;3702.00;167
9349;21;22614880;9349;529;10648;10816;4.98;0.31;346.56;13.67;1299;25;3703.00;168
9355;21;22614901;9355;528;10648;10816;4.96;0.30;346.45;13.67;1293;25;3704.00;168
9360;21;22614928;9360;526;10648;10816;4.97;0.30;346.51;13.67;1288;25;3705.00;168
9365;21;22614951;9365;532;10648;10816;4.97;0.30;346.53;13.67;1283;25;3706.00;168
9368;21;22614970;9368;528;10648;10816;4.95;0.30;346.67;13.67;1280;25;3707.00;168
9371;21;22614987;9371;523;10659;10828;4.97;0.31;346.73;13.65;1288;25;3708.00;169
9375;21;22615008;9375;523;10659;10828;4.90;0.30;346.83;13.65;1284;25;3709.00;169
9381;21;22615032;9381;519;10659;10828;4.86;0.30;346.83;13.65;1278;25;3710.00;169
9384;21;22615053;9384;518;10660;10828;4.86;0.30;346.86;13.70;1276;25;3711.00;168
9386;21;22615075;9386;509;10660;10828;4.84;0.30;346.95;13.70;1274;25;3712.00;168
9390;21;22615097;9390;512;10660;10828;4.87;0.30;346.91;13.70;1270;25;3713.00;168
9394;21;22615119;9394;507;10660;10829;4.86;0.30;347.01;13.70;1266;25;3714.00;169
9396;21;22615137;9396;505;10660;10829;4.84;0.30;347.04;13.70;1264;25;3715.00;169
9402;21;22615153;9402;501;10665;10835;4.80;0.29;347.07;13.69;1263;25;3716.00;170
9405;21;22615169;9405;503;10666;10836;4.82;0.30;347.06;13.69;1261;25;3717.00;170
9409;21;22615188;9409;502;10666;10836;4.74;0.29;347.12;13.69;1257;25;3718.00;170
9410;21;22615204;9410;496;10666;10836;4.71;0.29;347.10;13.69;1256;25;3719.00;170
9413;21;22615221;9413;505;10670;10841;4.69;0.29;347.13;13.68;1257;25;3720.00;171
9418;21;22615237;9418;509;10670;10841;4.65;0.29;347.08;13.68;1252;25;3721.00;171
9421;21;22615253;9421;495;10670;10841;4.67;0.29;347.13;13.68;1249;25;3722.00;171
9422;21;22615272;9422;475;10671;10842;4.73;0.29;347.10;13.68;1249;25;3723.00;171
9424;21;22615290;9424;466;10674;10846;4.78;0.29;347.27;13.68;1250;25;3724.00;172
9426;21;22615306;9426;468;10674;10846;4.80;0.29;347.23;13.68;1248;25;3725.00;172
9429;21;22615321;9429;468;10676;10849;4.86;0.30;347.27;13.68;1247;25;3726.00;173
9431;21;22615338;9431;472;10676;10849;4.87;0.30;347.38;13.68;1245;25;3727.00;173
9434;21;22615358;9434;471;10677;10849;4.91;0.30;347.38;13.68;1243;25;3728.00;172
9436;21;22615376;9436;469;10677;10849;4.89;0.30;347.47;13.68;1241;25;3729.00;172
9440;21;22615394;9440;476;10682;10853;4.89;0.30;347.49;13.72;1242;25;3730.00;171
9443;21;22615421;9443;469;10682;10853;4.88;0.30;347.49;13.72;1239;25;3731.00;171
9446;21;22615441;9446;462;10682;10853;4.84;0.29;347.48;13.72;1236;25;3732.00;171
9449;21;22615461;9449;462;10682;10853;4.83;0.29;347.59;13.72;1233;25;3733.00;171
9452;21;22615479;9452;455;10682;10854;4.82;0.29;347.67;13.72;1230;25;3734.00;172
9455;21;22615496;9455;444;10684;10856;4.81;0.29;347.73;13.71;1229;25;3735.00;172
9457;21;22615512;9457;438;10684;10856;4.83;0.29;347.78;13.71;1227;25;3736.00;172
9460;21;22615529;9460;444;10685;10857;4.88;0.30;347.85;13.71;1225;25;3737.00;172
9462;21;22615547;9462;447;10685;10857;4.93;0.30;347.86;13.71;1223;25;3738.00;172
9466;21;22615563;9466;450;10685;10857;4.98;0.30;347.98;13.71;1219;25;3739.00;172
9468;21;22615579;9468;451;10685;10857;5.04;0.31;347.98;13.71;1217;25;3740.00;172
9471;21;22615596;9471;454;10685;10857;5.06;0.31;348.05;13.71;1214;25;3741.00;172
9476;21;22615612;9476;451;10685;10857;5.05;0.31;348.05;13.71;1209;25;3742.00;172
9480;21;22615631;9480;453;10686;10857;5.05;0.31;348.16;13.76;1206;25;3743.00;171
9482;21;22615649;9482;478;10762;10984;5.19;0.32;348.22;13.66;1280;25;3744.00;222
9484;21;22615675;9484;466;10762;10985;5.20;0.32;348.33;13.66;1278;25;3745.00;223
9486;21;22615694;9486;451;10768;10985;5.34;0.33;348.30;13.65;1282;25;3746.00;217
9488;21;22615716;9488;442;10769;10985;5.42;0.33;348.36;13.65;1281;25;3747.00;216
9490;21;22615733;9490;439;10775;10985;5.48;0.34;348.49;13.65;1285;25;3748.00;210
9491;21;22615751;9491;435;10777;10985;5.54;0.34;348.55;13.65;1286;25;3749.00;208
9496;21;22615769;9496;439;10781;10990;5.55;0.34;348.59;13.64;1285;25;3750.00;209
9498;21;22615792;9498;446;10783;10990;5.61;0.34;348.61;13.64;1285;25;3751.00;207
9500;21;22615815;9500;445;10785;10991;5.65;0.35;348.69;13.64;1285;25;3752.00;206
9503;21;22615836;9503;449;10788;10992;5.67;0.35;348.72;13.64;1285;25;3753.00;204
9506;21;22615856;9506;453;10791;10992;5.69;0.35;348.77;13.64;1285;25;3754.00;201
9508;21;22615878;9508;448;10792;10993;5.68;0.35;348.84;13.64;1284;25;3755.00;201
9511;21;22615898;9511;449;10798;10993;5.66;0.35;348.95;13.64;1287;25;3756.00;195
9513;21;22615917;9513;455;10800;10993;5.66;0.35;349.01;13.64;1287;25;3757.00;193
9516;21;22615936;9516;452;10802;10993;5.64;0.34;349.09;13.63;1286;25;3758.00;191
9517;21;22615955;9517;457;10807;10997;5.65;0.35;349.11;13.63;1290;25;3759.00;190
9518;21;22615978;9518;462;10807;10997;5.65;0.34;349.14;13.63;1289;25;3760.00;190
9520;21;22615999;9520;467;10808;10997;5.66;0.34;349.14;13.63;1288;25;3761.00;189
9524;21;22616033;9524;469;10810;11000;5.68;0.35;349.23;13.63;1286;25;3762.00;190
9527;21;22616055;9527;470;10812;11000;5.67;0.35;349.28;13.63;1285;25;3763.00;188
9531;21;22616074;9531;477;10812;11000;5.66;0.34;349.27;13.63;1281;25;3764.00;188
9534;21;22616097;9534;476;10815;11004;5.63;0.34;349.31;13.63;1281;25;3765.00;189
9536;21;22616117;9536;464;10818;11005;5.64;0.34;349.30;13.63;1282;25;3766.00;187
9538;21;22616137;9538;461;10818;11005;5.64;0.34;349.31;13.63;1280;25;3767.00;187
9539;21;22616158;9539;458;10820;11009;5.66;0.34;349.34;13.62;1281;25;3768.00;189
9542;21;22616179;9542;449;10822;11009;5.69;0.35;349.38;13.62;1280;25;3769.00;187
9544;21;22616199;9544;443;10822;11009;5.72;0.35;349.39;13.62;1278;25;3770.00;187
9545;21;22616228;9545;441;10823;11010;5.77;0.35;349.38;13.62;1278;25;3771.00;187
9548;21;22616249;9548;430;10823;11010;5.73;0.35;349.46;13.62;1275;25;3772.00;187
9549;21;22616268;9549;429;10828;11016;5.71;0.35;349.48;13.62;1279;25;3773.00;188
9551;21;22616297;9551;430;10828;11016;5.66;0.34;349.46;13.62;1277;25;3774.00;188
9554;21;22616324;9554;427;10829;11017;5.55;0.34;349.49;13.66;1275;25;3775.00;188
9554;21;22616350;9554;429;10829;11017;5.49;0.33;349.49;13.66;1275;25;3776.00;188
9557;21;22616373;9557;423;10829;11017;5.41;0.33;349.45;13.66;1272;25;3777.00;188
9560;21;22616391;9560;425;10830;11017;5.31;0.32;349.44;13.67;1270;25;3778.00;187
9563;21;22616415;9563;414;10831;11017;5.23;0.32;349.46;13.67;1268;25;3779.00;186
9564;21;22616449;9564;415;10855;11053;5.17;0.31;349.44;13.73;1291;25;3780.00;198
9567;21;22616495;9567;411;10856;11053;5.11;0.31;349.52;13.73;1289;25;3781.00;197
9572;21;22616520;9572;407;10860;11053;5.09;0.31;349.52;13.73;1288;25;3782.00;193
9575;21;22616539;9575;405;10862;11053;5.10;0.31;349.65;13.73;1287;25;3783.00;191
9578;21;22616562;9578;394;10863;11053;5.12;0.31;349.64;13.73;1285;25;3784.00;190
9580;21;22616589;9580;397;10863;11053;5.18;0.31;349.65;13.73;1283;25;3785.00;190
9581;21;22616611;9581;399;10865;11057;5.26;0.32;349.63;13.72;1284;25;3786.00;192
9584;21;22616634;9584;393;10865;11057;5.30;0.32;349.71;13.72;1281;25;3787.00;192
9588;21;22616656;9588;394;10868;11061;5.37;0.33;349.75;13.72;1280;25;3788.00;193
9590;21;22616679;9590;384;10869;11062;5.43;0.33;349.75;13.72;1279;25;3789.00;193
9594;21;22616700;9594;392;10870;11062;5.45;0.33;349.80;13.77;1276;25;3790.00;192
9596;21;22616721;9596;398;10870;11062;5.44;0.33;349.87;13.77;1274;25;3791.00;192
9600;21;22616740;9600;402;10882;11075;5.41;0.33;349.88;13.76;1282;25;3792.00;193
9603;21;22616762;9603;400;10882;11075;5.38;0.33;349.92;13.76;1279;25;3793.00;193
9605;21;22616783;9605;403;10883;11075;5.33;0.33;349.96;13.76;1278;25;3794.00;192
9608;21;22616805;9608;406;10884;11076;5.31;0.32;349.95;13.76;1276;25;3795.00;192
9612;21;22616826;9612;407;10884;11077;5.23;0.32;349.95;13.76;1272;25;3796.00;193
9612;21;22616847;9612;411;10886;11077;5.24;0.32;349.95;13.76;1274;25;3797.00;191
9614;21;22616865;9614;412;10888;11080;5.24;0.32;350.06;13.75;1274;25;3798.00;192
9615;21;22616884;9615;422;10889;11080;5.21;0.32;350.04;13.75;1274;25;3799.00;191
9617;21;22616904;9617;418;10889;11080;5.20;0.32;350.09;13.75;1272;25;3800.00;191
9618;21;22616930;9618;418;10889;11080;5.17;0.31;350.07;13.75;1271;25;3801.00;191
9619;21;22616949;9619;424;10894;11086;5.20;0.32;350.04;13.75;1275;25;3802.00;192
9619;21;22616967;9619;432;10894;11086;5.18;0.32;350.04;13.75;1275;25;3803.00;192
9621;21;22616985;9621;440;10894;11086;5.12;0.31;350.07;13.75;1273;25;3804.00;192
9622;21;22617005;9622;449;10895;11086;5.07;0.31;350.03;13.80;1273;25;3805.00;191
9624;21;22617023;9624;450;10898;11090;5.04;0.31;350.06;13.79;1274;25;3806.00;192
9628;21;22617041;9628;458;10899;11091;4.98;0.30;350.09;13.79;1271;25;3807.00;192
9632;21;22617062;9632;465;10900;11091;4.95;0.30;350.11;13.84;1268;25;3808.00;191
9632;21;22617083;9632;474;10901;11092;4.91;0.30;350.11;13.84;1269;25;3809.00;191
9633;21;22617110;9633;474;10901;11092;4.86;0.30;350.10;13.84;1268;25;3810.00;191
9635;21;22617130;9635;482;10902;11092;4.87;0.30;350.06;13.89;1267;25;3811.00;190
9638;21;22617149;9638;491;10902;11092;4.87;0.30;349.99;13.89;1264;25;3812.00;190
9640;21;22617167;9640;492;10902;11092;4.83;0.29;350.09;13.89;1262;25;3813.00;190
9642;21;22617184;9642;497;10903;11092;4.76;0.29;350.14;13.94;1261;25;3814.00;189
9645;21;22617211;9645;499;10903;11092;4.70;0.29;350.16;13.94;1258;25;3815.00;189
9645;21;22617229;9645;508;10938;11162;4.90;0.30;350.16;13.90;1293;25;3816.00;224
9647;21;22617252;9647;510;10941;11163;4.90;0.30;350.11;13.95;1294;25;3817.00;222
9649;21;22617268;9649;515;10953;11163;4.96;0.30;350.14;14.09;1304;25;3818.00;210
9651;21;22617285;9651;512;10956;11163;4.92;0.30;350.09;14.08;1305;25;3819.00;207
9653;21;22617301;9653;507;10960;11163;4.90;0.30;350.06;14.18;1307;25;3820.00;203
9655;21;22617318;9655;517;10962;11163;4.82;0.29;350.00;14.18;1307;25;3821.00;201
9658;21;22617332;9658;517;10966;11163;4.81;0.29;349.97;14.22;1308;25;3822.00;197
9662;21;22617348;9662;523;10969;11163;4.78;0.29;349.87;14.22;1307;25;3823.00;194
9665;21;22617363;9665;520;10972;11164;4.72;0.29;349.79;14.22;1307;25;3824.00;192
9665;21;22617377;9665;519;10979;11166;4.67;0.28;349.79;14.31;1314;25;3825.00;187
9667;21;22617396;9667;524;10981;11166;4.59;0.28;349.74;14.31;1314;25;3826.00;185
9673;21;22617414;9673;529;10984;11170;4.47;0.27;349.66;14.31;1311;25;3827.00;186
9673;21;22617431;9673;533;10986;11170;4.38;0.27;349.66;14.40;1313;25;3828.00;184
9673;21;22617447;9673;534;10986;11170;4.31;0.26;349.66;14.40;1313;25;3829.00;184
9674;21;22617463;9674;542;10986;11170;4.24;0.26;349.64;14.40;1312;25;3830.00;184
9675;21;22617480;9675;548;10991;11176;4.25;0.26;349.61;14.40;1316;25;3831.00;185
9677;21;22617499;9677;552;10991;11176;4.18;0.26;349.60;14.40;1314;25;3832.00;185
9678;21;22617516;9678;560;10994;11176;4.14;0.25;349.59;14.54;1316;25;3833.00;182
9678;21;22617532;9678;564;10997;11179;4.18;0.26;349.59;14.53;1319;25;3834.00;182
9679;21;22617549;9679;553;10999;11179;4.16;0.25;349.56;14.63;1320;25;3835.00;180
9681;21;22617570;9681;554;10999;11179;4.19;0.26;349.62;14.63;1318;25;3836.00;180
9683;21;22617588;9683;560;10999;11180;4.17;0.26;349.60;14.63;1316;25;3837.00;181
9685;21;22617607;9685;565;11002;11181;4.19;0.26;349.62;14.71;1317;25;3838.00;179
9689;21;22617627;9689;567;11002;11181;4.17;0.25;349.51;14.71;1313;25;3839.00;179
9691;21;22617649;9691;583;11020;11207;4.17;0.25;349.48;14.69;1329;25;3840.00;187
9693;21;22617673;9693;580;11021;11207;4.12;0.25;349.46;14.69;1328;25;3841.00;186
9694;21;22617701;9694;584;11023;11207;4.08;0.25;349.47;14.68;1329;25;3842.00;184
9699;21;22617718;9699;595;11025;11208;4.02;0.24;349.35;14.68;1326;25;3843.00;183
9700;21;22617736;9700;588;11025;11208;4.03;0.25;349.33;14.68;1325;25;3844.00;183
9702;21;22617756;9702;581;11029;11212;4.05;0.25;349.35;14.68;1327;25;3845.00;183
9703;21;22617776;9703;579;11030;11214;4.06;0.25;349.37;14.68;1327;25;3846.00;184
9706;21;22617800;9706;586;11034;11218;4.04;0.25;349.37;14.67;1328;25;3847.00;184
9712;21;22617821;9712;577;11034;11218;3.98;0.24;349.30;14.67;1322;25;3848.00;184
9714;21;22617840;9714;581;11034;11218;3.96;0.24;349.31;14.67;1320;25;3849.00;184
9715;21;22617865;9715;558;11034;11218;3.96;0.24;349.30;14.67;1319;25;3850.00;184
9718;21;22617883;9718;542;11034;11218;4.00;0.24;349.27;14.67;1316;25;3851.00;184
9719;21;22617902;9719;540;11045;11230;4.09;0.25;349.28;14.66;1326;25;3852.00;185
9723;21;22617920;9723;526;11045;11230;4.12;0.25;349.25;14.66;1322;25;3853.00;185
9725;21;22617937;9725;519;11045;11230;4.14;0.25;349.27;14.66;1320;25;3854.00;185
9727;21;22617954;9727;508;11045;11230;4.18;0.26;349.25;14.66;1318;25;3855.00;185
9730;21;22617971;9730;499;11045;11230;4.25;0.26;349.32;14.66;1315;25;3856.00;185
9732;21;22617989;9732;486;11045;11230;4.33;0.26;349.31;14.66;1313;25;3857.00;185
9733;21;22618012;9733;481;11045;11231;4.35;0.27;349.40;14.66;1312;25;3858.00;186
9737;21;22618042;9737;469;11045;11231;4.37;0.27;349.48;14.66;1308;25;3859.00;186
9739;21;22618075;9739;459;11050;11237;4.42;0.27;349.53;14.65;1311;25;3860.00;187
9742;21;22618093;9742;459;11051;11238;4.45;0.27;349.50;14.65;1309;25;3861.00;187
9746;21;22618111;9746;447;11051;11238;4.47;0.27;349.56;14.65;1305;25;3862.00;187
9751;21;22618134;9751;438;11051;11238;4.48;0.27;349.60;14.65;1300;25;3863.00;187
9753;21;22618162;9753;439;11054;11242;4.55;0.28;349.56;14.64;1301;25;3864.00;188
9755;21;22618182;9755;436;11054;11242;4.61;0.28;349.57;14.64;1299;25;3865.00;188
9760;21;22618200;9760;436;11054;11242;4.60;0.28;349.59;14.64;1294;25;3866.00;188
9762;21;22618221;9762;438;11055;11243;4.62;0.28;349.59;14.64;1293;25;3867.00;188
9769;21;22618240;9769;435;11058;11247;4.60;0.28;349.58;14.64;1289;25;3868.00;189
9770;21;22618260;9770;436;11058;11247;4.62;0.28;349.59;14.64;1288;25;3869.00;189
9776;21;22618280;9776;448;11063;11253;4.60;0.28;349.65;14.63;1287;25;3870.00;190
9778;21;22618298;9778;449;11063;11253;4.59;0.28;349.67;14.63;1285;25;3871.00;190
9780;21;22618315;9780;447;11064;11253;4.60;0.28;349.66;14.63;1284;25;3872.00;189
9785;21;22618334;9785;446;11064;11253;4.57;0.28;349.76;14.63;1279;25;3873.00;189
9788;21;22618351;9788;444;11068;11257;4.63;0.28;349.84;14.63;1280;25;3874.00;189
9791;21;22618368;9791;440;11068;11257;4.63;0.28;349.84;14.63;1277;25;3875.00;189
9796;21;22618385;9796;437;11068;11257;4.57;0.28;350.01;14.63;1272;25;3876.00;189
9796;21;22618401;9796;438;11068;11257;4.56;0.28;350.01;14.63;1272;25;3877.00;189
9799;21;22618426;9799;424;11068;11258;4.57;0.28;349.99;14.63;1269;25;3878.00;190
9802;21;22618448;9802;423;11069;11259;4.58;0.28;350.10;14.63;1267;25;3879.00;190
9802;21;22618470;9802;415;11069;11259;4.65;0.28;350.10;14.63;1267;25;3880.00;190
9808;21;22618489;9808;419;11070;11260;4.67;0.28;350.18;14.62;1262;25;3881.00;190
9809;21;22618513;9809;412;11070;11260;4.72;0.29;350.16;14.62;1261;25;3882.00;190
9812;21;22618532;9812;415;11070;11260;4.77;0.29;350.29;14.62;1258;25;3883.00;190
9816;21;22618549;9816;407;11070;11260;4.85;0.29;350.45;14.62;1254;25;3884.00;190
9816;21;22618567;9816;409;11070;11260;4.90;0.30;350.45;14.62;1254;25;3885.00;190
9819;21;22618595;9819;408;11070;11260;4.98;0.30;350.54;14.62;1251;25;3886.00;190
9823;21;22618617;9823;411;11070;11260;5.01;0.30;350.54;14.62;1247;25;3887.00;190
9824;21;22618634;9824;431;11144;11387;5.34;0.33;350.57;14.53;1320;25;3888.00;243
9827;21;22618665;9827;425;11146;11388;5.35;0.33;350.61;14.53;1319;25;3889.00;242
9832;21;22618687;9832;424;11152;11388;5.40;0.33;350.75;14.52;1320;25;3890.00;236
9833;21;22618709;9833;427;11154;11388;5.41;0.33;350.75;14.52;1321;25;3891.00;234
9837;21;22618735;9837;434;11158;11388;5.41;0.33;350.94;14.51;1321;25;3892.00;230
9843;21;22618755;9843;427;11159;11388;5.33;0.33;351.00;14.51;1316;25;3893.00;229
9843;21;22618779;9843;434;11161;11388;5.31;0.33;351.00;14.51;1318;25;3894.00;227
9848;21;22618806;9848;441;11164;11388;5.26;0.32;350.97;14.51;1316;25;3895.00;224
9853;21;22618831;9853;445;11166;11389;5.17;0.32;350.94;14.51;1313;25;3896.00;223
9856;21;22618868;9856;445;11170;11390;5.10;0.31;350.99;14.51;1314;25;3897.00;220
9860;21;22618906;9860;441;11172;11390;5.03;0.31;351.10;14.50;1312;25;3898.00;218
9863;21;22618946;9863;439;11174;11391;4.97;0.30;351.14;14.50;1311;25;3899.00;217
9864;21;22618980;9864;449;11182;11406;4.90;0.30;351.17;14.50;1318;25;3900.00;224
9866;21;22619010;9866;440;11184;11406;4.87;0.30;351.27;14.50;1318;25;3901.00;222
9867;21;22619033;9867;440;11187;11406;4.92;0.30;351.24;14.50;1320;25;3902.00;219
9870;21;22619053;9870;444;11191;11410;4.99;0.30;351.36;14.49;1321;25;3903.00;219
9872;21;22619078;9872;442;11193;11410;5.04;0.31;351.45;14.49;1321;25;3904.00;217
9875;21;22619100;9875;445;11195;11410;5.07;0.31;351.46;14.49;1320;25;3905.00;215
9878;21;22619121;9878;439;11199;11413;5.11;0.31;351.49;14.49;1321;25;3906.00;214
9879;21;22619143;9879;434;11199;11413;5.15;0.32;351.49;14.49;1320;25;3907.00;214
9881;21;22619167;9881;434;11199;11413;5.18;0.32;351.47;14.49;1318;25;3908.00;214
9884;21;22619196;9884;437;11204;11417;5.18;0.32;351.46;14.49;1320;25;3909.00;213
9887;21;22619222;9887;444;11206;11418;5.22;0.32;351.47;14.48;1319;26;3910.00;212
9887;21;22619256;9887;448;11208;11418;5.24;0.32;351.47;14.48;1321;26;3911.00;210
9889;21;22619281;9889;453;11212;11422;5.30;0.32;351.59;14.48;1323;26;3912.00;210
9892;21;22619300;9892;455;11212;11422;5.32;0.33;351.59;14.48;1320;26;3913.00;210
9894;21;22619319;9894;461;11212;11422;5.36;0.33;351.66;14.48;1318;26;3914.00;210
9899;21;22619343;9899;469;11214;11424;5.32;0.32;351.90;14.48;1315;26;3915.00;210
9903;21;22619363;9903;479;11216;11424;5.26;0.32;352.11;14.48;1313;26;3916.00;208
9905;21;22619381;9905;472;11220;11430;5.22;0.32;352.20;14.47;1315;26;3917.00;210
9907;21;22619406;9907;478;11220;11430;5.20;0.32;352.27;14.47;1313;26;3918.00;210
9911;21;22619425;9911;481;11220;11431;5.17;0.32;352.45;14.47;1309;26;3919.00;211
9914;21;22619443;9914;474;11220;11431;5.21;0.32;352.56;14.47;1306;26;3920.00;211
9917;21;22619460;9917;464;11220;11431;5.21;0.32;352.55;14.47;1303;26;3921.00;211
9921;21;22619478;9921;459;11222;11431;5.16;0.31;352.73;14.47;1301;26;3922.00;209
9922;21;22619503;9922;459;11222;11431;5.20;0.32;352.74;14.47;1300;26;3923.00;209
9926;21;22619522;9926;459;11230;11443;5.26;0.32;352.83;14.46;1304;26;3924.00;213
9927;21;22619541;9927;448;11232;11443;5.29;0.32;352.83;14.46;1305;26;3925.00;211
9929;21;22619557;9929;457;11234;11443;5.32;0.32;352.80;14.46;1305;26;3926.00;209
9931;21;22619576;9931;462;11234;11443;5.34;0.33;352.76;14.46;1303;26;3927.00;209
9934;21;22619595;9934;466;11236;11443;5.37;0.33;352.88;14.46;1302;26;3928.00;207
9939;21;22619613;9939;473;11236;11443;5.33;0.32;352.92;14.46;1297;26;3929.00;207
9942;21;22619633;9942;475;11239;11447;5.29;0.32;352.93;14.46;1297;26;3930.00;208
9945;21;22619651;9945;479;11239;11447;5.27;0.32;352.99;14.46;1294;26;3931.00;208
9947;21;22619681;9947;484;11243;11451;5.26;0.32;353.06;14.45;1296;26;3932.00;208
9952;21;22619714;9952;485;11244;11452;5.19;0.32;353.20;14.45;1292;26;3933.00;208
9953;21;22619735;9953;482;11244;11452;5.13;0.31;353.17;14.45;1291;26;3934.00;208
9958;21;22619758;9958;482;11245;11452;5.07;0.31;353.39;14.51;1287;26;3935.00;207
9959;21;22619781;9959;489;11256;11465;5.09;0.31;353.39;14.50;1297;26;3936.00;209
9960;21;22619804;9960;487;11256;11465;5.05;0.31;353.40;14.50;1296;26;3937.00;209
9961;21;22619825;9961;484;11256;11465;5.07;0.31;353.47;14.50;1295;26;3938.00;209
9964;21;22619846;9964;486;11257;11466;5.06;0.31;353.57;14.50;1293;26;3939.00;209
9965;21;22619866;9965;490;11257;11467;5.06;0.31;353.61;14.50;1292;26;3940.00;210
9967;21;22619887;9967;488;11257;11467;5.02;0.31;353.66;14.50;1290;26;3941.00;210
9969;21;22619906;9969;489;11259;11470;5.03;0.31;353.71;14.49;1290;26;3942.00;211
9971;21;22619927;9971;481;11259;11470;5.01;0.31;353.75;14.49;1288;26;3943.00;211
9975;21;22619944;9975;479;11260;11470;5.01;0.31;353.73;14.49;1285;26;3944.00;210
9979;21;22619962;9979;478;11260;11470;5.00;0.30;353.80;14.49;1281;26;3945.00;210
9982;21;22619979;9982;482;11265;11476;5.04;0.31;353.86;14.49;1283;26;3946.00;211
9987;21;22619999;9987;487;11265;11476;5.04;0.31;353.89;14.49;1278;26;3947.00;211
9991;21;22620023;9991;479;11265;11476;4.97;0.30;354.05;14.49;1274;26;3948.00;211
9995;21;22620040;9995;476;11265;11476;4.93;0.30;354.11;14.49;1270;26;3949.00;211
9998;21;22620056;9998;480;11268;11480;4.90;0.30;354.15;14.48;1270;26;3950.00;212
10000;21;22620075;10000;482;11269;11481;4.89;0.30;354.23;14.48;1269;26;3951.00;212
10003;21;22620094;10003;477;11269;11481;4.83;0.29;354.30;14.48;1266;26;3952.00;212
10009;21;22620113;10009;478;11270;11482;4.72;0.29;354.36;14.48;1261;26;3953.00;212
10011;21;22620129;10011;484;11270;11482;4.67;0.28;354.45;14.48;1259;26;3954.00;212
10015;21;22620147;10015;478;11271;11482;4.66;0.28;354.50;14.54;1256;26;3955.00;211
10018;21;22620166;10018;472;11271;11482;4.62;0.28;354.45;14.54;1253;26;3956.00;211
10022;21;22620183;10022;468;11271;11482;4.60;0.28;354.49;14.54;1249;26;3957.00;211
10025;21;22620201;10025;466;11271;11482;4.59;0.28;354.48;14.54;1246;26;3958.00;211
10027;21;22620218;10027;472;11271;11482;4.60;0.28;354.43;14.54;1244;26;3959.00;211
10028;21;22620235;10028;476;11327;11607;4.89;0.30;354.46;14.47;1299;26;3960.00;280
10028;21;22620264;10028;481;11328;11608;4.92;0.31;354.46;14.46;1300;26;3961.00;280
10030;21;22620281;10030;471;11338;11608;5.01;0.31;354.51;14.45;1308;26;3962.00;270
10035;21;22620297;10035;480;11343;11608;5.00;0.31;354.41;14.45;1308;26;3963.00;265
10037;21;22620316;10037;480;11347;11608;4.99;0.31;354.39;14.44;1310;26;3964.00;261
10040;21;22620335;10040;486;11351;11608;4.98;0.31;354.41;14.44;1311;26;3965.00;257
10042;21;22620358;10042;483;11356;11608;5.00;0.31;354.39;14.44;1314;26;3966.00;252
10045;21;22620378;10045;491;11360;11608;4.94;0.31;354.33;14.43;1315;26;3967.00;248
10047;21;22620395;10047;496;11365;11609;4.91;0.30;354.28;14.43;1318;26;3968.00;244
10050;21;22620419;10050;494;11367;11610;4.90;0.30;354.28;14.43;1317;26;3969.00;243
10053;21;22620442;10053;492;11370;11610;4.80;0.30;354.26;14.43;1317;26;3970.00;240
10055;21;22620471;10055;496;11376;11614;4.76;0.29;354.24;14.42;1321;26;3971.00;238
10058;21;22620492;10058;498;11376;11614;4.70;0.29;354.19;14.42;1318;26;3972.00;238
10062;21;22620513;10062;508;11377;11614;4.64;0.29;354.15;14.42;1315;26;3973.00;237
10063;21;22620539;10063;514;11378;11614;4.58;0.28;354.14;14.42;1315;26;3974.00;236
10067;21;22620567;10067;512;11382;11620;4.55;0.28;354.17;14.42;1315;26;3975.00;238
10070;21;22620583;10070;520;11384;11620;4.49;0.28;354.19;14.42;1314;26;3976.00;236
10070;21;22620600;10070;529;11384;11620;4.45;0.27;354.19;14.42;1314;26;3977.00;236
10072;21;22620616;10072;534;11387;11623;4.44;0.27;354.16;14.42;1315;26;3978.00;236
10073;21;22620633;10073;538;11388;11623;4.44;0.27;354.16;14.42;1315;26;3979.00;235
10075;21;22620653;10075;544;11389;11623;4.43;0.27;354.26;14.47;1314;26;3980.00;234
10076;21;22620671;10076;558;11389;11624;4.42;0.27;354.24;14.47;1313;26;3981.00;235
10079;21;22620690;10079;556;11392;11625;4.38;0.27;354.31;14.53;1313;26;3982.00;233
10082;21;22620707;10082;571;11392;11625;4.32;0.27;354.26;14.53;1310;26;3983.00;233
10085;21;22620723;10085;582;11405;11638;4.29;0.26;354.20;14.69;1320;26;3984.00;233
10086;21;22620743;10086;584;11406;11638;4.28;0.26;354.19;14.75;1320;26;3985.00;232
10089;21;22620759;10089;591;11407;11638;4.24;0.26;354.20;14.74;1318;26;3986.00;231
10090;21;22620774;10090;601;11408;11639;4.24;0.26;354.18;14.74;1318;26;3987.00;231
10092;21;22620789;10092;606;11409;11639;4.22;0.26;354.14;14.80;1317;26;3988.00;230
10096;21;22620805;10096;607;11413;11643;4.19;0.26;354.09;14.79;1317;26;3989.00;230
10096;21;22620824;10096;619;11413;11643;4.20;0.26;354.09;14.79;1317;26;3990.00;230
10098;21;22620842;10098;618;11417;11647;4.19;0.26;354.04;14.85;1319;26;3991.00;230
10099;21;22620858;10099;612;11417;11647;4.20;0.26;354.09;14.85;1318;26;3992.00;230
10099;21;22620874;10099;604;11417;11647;4.18;0.26;354.09;14.85;1318;26;3993.00;230
10103;21;22620890;10103;593;11420;11647;4.16;0.26;354.01;15.01;1317;26;3994.00;227
10103;21;22620908;10103;590;11420;11647;4.15;0.25;354.01;15.01;1317;26;3995.00;227
10106;21;22620923;10106;584;11432;11659;4.20;0.26;354.01;15.11;1326;26;3996.00;227
10107;21;22620939;10107;573;11433;11659;4.25;0.26;354.00;15.16;1326;26;3997.00;226
10109;21;22620954;10109;573;11436;11659;4.26;0.26;354.03;15.27;1327;26;3998.00;223
10112;21;22620970;10112;570;11436;11659;4.25;0.26;354.06;15.27;1324;26;3999.00;223
10113;21;22620988;10113;562;11436;11659;4.26;0.26;354.11;15.27;1323;26;4000.00;223
10115;22;22621010;10115;556;11437;11659;4.25;0.26;354.10;15.32;1322;27;4001.00;222
10115;22;22621035;10115;556;11438;11660;4.25;0.26;354.10;15.37;1323;27;4002.00;222
10115;22;22621054;10115;553;11438;11660;4.28;0.26;354.10;15.37;1323;27;4003.00;222
10116;22;22621078;10116;556;11445;11666;4.35;0.27;354.17;15.47;1329;27;4004.00;221
10117;22;22621095;10117;556;11447;11668;4.39;0.27;354.14;15.47;1330;27;4005.00;221
10120;22;22621116;10120;560;11447;11668;4.41;0.27;354.14;15.47;1327;27;4006.00;221
10121;22;22621132;10121;561;11448;11668;4.47;0.27;354.14;15.52;1327;27;4007.00;220
10123;22;22621146;10123;566;11452;11672;4.47;0.27;354.09;15.57;1329;27;4008.00;220
10123;22;22621164;10123;569;11452;11672;4.50;0.28;354.09;15.57;1329;27;4009.00;220
10124;22;22621179;10124;562;11452;11672;4.49;0.28;354.07;15.57;1328;27;4010.00;220
10124;22;22621195;10124;563;11454;11673;4.57;0.28;354.07;15.62;1330;27;4011.00;219
10126;22;22621209;10126;556;11457;11677;4.63;0.28;354.11;15.61;1331;27;4012.00;220
10129;22;22621224;10129;553;11458;11677;4.67;0.29;354.09;15.67;1329;27;4013.00;219
10131;22;22621239;10131;550;11460;11680;4.76;0.29;354.08;15.66;1329;27;4014.00;220
10136;22;22621258;10136;548;11460;11680;4.75;0.29;354.09;15.66;1324;27;4015.00;220
10137;22;22621299;10137;546;11461;11680;4.74;0.29;354.08;15.66;1324;27;4016.00;219
10143;22;22621314;10143;551;11461;11680;4.66;0.29;353.98;15.66;1318;27;4017.00;219
10147;22;22621329;10147;546;11465;11684;4.64;0.28;354.02;15.66;1318;27;4018.00;219
10153;22;22621348;10153;543;11465;11684;4.57;0.28;354.12;15.66;1312;27;4019.00;219
10157;22;22621365;10157;537;11465;11684;4.51;0.28;354.21;15.66;1308;27;4020.00;219
10159;22;22621379;10159;542;11465;11684;4.45;0.27;354.25;15.66;1306;27;4021.00;219
10166;22;22621393;10166;536;11465;11685;4.37;0.27;354.46;15.66;1299;27;4022.00;220
10169;22;22621408;10169;534;11466;11686;4.34;0.27;354.53;15.66;1297;27;4023.00;220
10173;22;22621422;10173;539;11466;11686;4.30;0.26;354.69;15.66;1293;27;4024.00;220
10177;22;22621439;10177;526;11467;11687;4.27;0.26;354.77;15.65;1290;27;4025.00;220
10182;22;22621454;10182;523;11467;11687;4.22;0.26;354.87;15.65;1285;27;4026.00;220
10187;22;22621469;10187;511;11467;11687;4.18;0.26;354.92;15.65;1280;27;4027.00;220
10190;22;22621484;10190;505;11467;11687;4.18;0.26;354.99;15.65;1277;27;4028.00;220
10194;22;22621499;10194;508;11467;11687;4.20;0.26;355.02;15.65;1273;27;4029.00;220
10195;22;22621515;10195;496;11467;11687;4.27;0.26;355.10;15.65;1272;27;4030.00;220
10199;22;22621533;10199;489;11467;11687;4.30;0.26;355.12;15.65;1268;27;4031.00;220
10204;22;22621549;10204;502;11539;11814;4.60;0.29;355.11;15.56;1335;27;4032.00;275
10209;22;22621575;10209;480;11541;11815;4.64;0.29;355.14;15.55;1332;27;4033.00;274
10212;22;22621599;10212;464;11547;11815;4.71;0.29;355.14;15.55;1335;27;4034.00;268
10214;22;22621619;10214;450;11551;11815;4.77;0.29;355.22;15.54;1337;27;4035.00;264
10216;22;22621639;10216;438;11555;11815;4.78;0.30;355.32;15.54;1339;27;4036.00;260
10220;22;22621657;10220;435;11557;11815;4.77;0.30;355.34;15.54;1337;27;4037.00;258
10222;22;22621678;10222;428;11558;11815;4.79;0.30;355.38;15.54;1336;27;4038.00;257
10226;22;22621696;10226;417;11560;11815;4.79;0.30;355.48;15.53;1334;27;4039.00;255
10227;22;22621718;10227;417;11561;11816;4.85;0.30;355.50;15.53;1334;27;4040.00;255
10231;22;22621741;10231;413;11565;11817;4.88;0.30;355.55;15.53;1334;27;4041.00;252
10235;22;22621762;10235;410;11565;11817;4.87;0.30;355.58;15.53;1330;27;4042.00;252
10239;22;22621783;10239;404;11566;11818;4.90;0.30;355.71;15.53;1327;27;4043.00;252
10244;22;22621803;10244;415;11568;11818;4.92;0.30;355.76;15.53;1324;27;4044.00;250
10247;22;22621822;10247;417;11568;11818;4.94;0.30;355.85;15.53;1321;27;4045.00;250
10249;22;22621839;10249;416;11570;11818;4.96;0.30;355.90;15.53;1321;27;4046.00;248
10254;22;22621869;10254;421;11574;11822;4.95;0.30;356.01;15.53;1320;27;4047.00;248
10262;22;22621890;10262;420;11575;11822;4.90;0.30;356.09;15.53;1313;27;4048.00;247
10263;22;22621909;10263;419;11578;11822;4.89;0.30;356.09;15.53;1315;27;4049.00;244
10265;22;22621927;10265;416;11581;11828;4.89;0.30;356.10;15.53;1316;27;4050.00;247
10267;22;22621945;10267;417;11583;11828;4.88;0.30;356.12;15.53;1316;27;4051.00;245
10269;22;22621961;10269;421;11586;11828;4.92;0.30;356.17;15.53;1317;27;4052.00;242
10272;22;22621980;10272;422;11590;11832;4.94;0.30;356.19;15.52;1318;27;4053.00;242
10275;22;22622001;10275;426;11592;11833;4.99;0.30;356.27;15.52;1317;27;4054.00;241
10279;22;22622020;10279;425;11594;11833;4.98;0.30;356.28;15.59;1315;27;4055.00;239
10284;22;22622047;10284;422;11596;11837;4.99;0.30;356.20;15.59;1312;27;4056.00;241
10287;22;22622066;10287;425;11597;11837;4.99;0.30;356.29;15.59;1310;27;4057.00;240
10291;22;22622086;10291;417;11597;11837;5.02;0.30;356.37;15.59;1306;27;4058.00;240
10294;22;22622105;10294;416;11598;11838;5.03;0.31;356.34;15.59;1304;27;4059.00;240
10296;22;22622122;10296;422;11599;11838;5.03;0.31;356.39;15.59;1303;27;4060.00;239
10298;22;22622139;10298;422;11603;11844;5.09;0.31;356.36;15.59;1305;27;4061.00;241
10301;22;22622156;10301;420;11604;11844;5.10;0.31;356.46;15.59;1303;27;4062.00;240
10304;22;22622185;10304;423;11605;11845;5.12;0.31;356.55;15.59;1301;27;4063.00;240
10307;22;22622201;10307;422;11607;11845;5.19;0.32;356.55;15.59;1300;27;4064.00;238
10309;22;22622219;10309;421;11608;11845;5.17;0.31;356.57;15.58;1299;27;4065.00;237
10313;22;22622246;10313;418;11609;11845;5.14;0.31;356.57;15.58;1296;27;4066.00;236
10314;22;22622267;10314;415;11609;11845;5.07;0.31;356.54;15.58;1295;27;4067.00;236
10317;22;22622285;10317;418;11616;11857;5.04;0.31;356.53;15.57;1299;27;4068.00;241
10322;22;22622302;10322;420;11618;11857;4.98;0.30;356.61;15.57;1296;27;4069.00;239
10322;22;22622321;10322;429;11621;11857;4.95;0.30;356.61;15.57;1299;27;4070.00;236
10325;22;22622347;10325;435;11622;11857;4.93;0.30;356.70;15.57;1297;27;4071.00;235
10326;22;22622368;10326;430;11623;11857;4.96;0.30;356.80;15.64;1297;27;4072.00;234
10328;22;22622385;10328;418;11623;11857;4.95;0.30;356.78;15.64;1295;27;4073.00;234
10331;22;22622404;10331;427;11626;11861;4.93;0.30;356.93;15.64;1295;27;4074.00;235
10336;22;22622427;10336;431;11626;11861;4.88;0.30;357.12;15.64;1290;27;4075.00;235
10337;22;22622453;10337;428;11630;11865;4.92;0.30;357.11;15.63;1293;27;4076.00;235
10341;22;22622480;10341;425;11631;11866;4.93;0.30;357.15;15.63;1290;27;4077.00;235
10344;22;22622506;10344;431;11631;11866;4.90;0.30;357.28;15.63;1287;27;4078.00;235
10347;22;22622532;10347;435;11631;11866;4.90;0.30;357.31;15.63;1284;27;4079.00;235
10349;22;22622559;10349;442;11654;11895;4.92;0.30;357.26;15.60;1305;27;4080.00;241
10353;22;22622584;10353;422;11654;11895;4.87;0.30;357.40;15.60;1301;27;4081.00;241
10356;22;22622605;10356;427;11655;11895;4.87;0.30;357.50;15.60;1299;27;4082.00;240
10360;22;22622627;10360;421;11655;11896;4.84;0.29;357.49;15.60;1295;27;4083.00;241
10363;22;22622650;10363;430;11656;11897;4.81;0.29;357.57;15.60;1293;27;4084.00;241
10365;22;22622672;10365;432;11656;11897;4.79;0.29;357.68;15.60;1291;27;4085.00;241
10366;22;22622694;10366;440;11659;11900;4.78;0.29;357.69;15.66;1293;27;4086.00;241
10370;22;22622716;10370;437;11659;11900;4.73;0.29;357.71;15.66;1289;27;4087.00;241
10371;22;22622736;10371;447;11660;11900;4.69;0.29;357.79;15.66;1289;27;4088.00;240
10374;22;22622756;10374;446;11660;11900;4.69;0.29;357.90;15.66;1286;27;4089.00;240
10378;22;22622778;10378;447;11665;11906;4.66;0.28;358.10;15.66;1287;27;4090.00;241
10380;22;22622799;10380;447;11665;11906;4.63;0.28;358.09;15.66;1285;27;4091.00;241
10381;22;22622818;10381;446;11665;11906;4.62;0.28;358.10;15.66;1284;27;4092.00;241
10383;22;22622839;10383;448;11665;11906;4.59;0.28;358.08;15.66;1282;27;4093.00;241
10385;22;22622868;10385;450;11668;11910;4.58;0.28;358.15;15.65;1283;27;4094.00;242
10387;22;22622901;10387;450;11670;11912;4.62;0.28;358.19;15.65;1283;27;4095.00;242
10389;22;22622920;10389;459;11670;11912;4.61;0.28;358.23;15.65;1281;27;4096.00;242
10391;22;22622941;10391;458;11672;11913;4.65;0.28;358.34;15.65;1281;27;4097.00;241
10393;22;22622959;10393;459;11672;11913;4.64;0.28;358.36;15.65;1279;27;4098.00;241
10396;22;22622977;10396;465;11672;11913;4.63;0.28;358.39;15.65;1276;27;4099.00;241
10398;22;22622994;10398;450;11672;11913;4.62;0.28;358.48;15.65;1274;27;4100.00;241
10401;22;22623023;10401;451;11672;11913;4.63;0.28;358.56;15.65;1271;27;4101.00;241
10405;22;22623041;10405;452;11672;11913;4.61;0.28;358.66;15.65;1267;27;4102.00;241
10407;22;22623057;10407;443;11672;11913;4.59;0.28;358.68;15.65;1265;27;4103.00;241
10408;22;22623073;10408;468;11713;11983;4.67;0.28;358.74;15.60;1305;27;4104.00;270
10408;22;22623098;10408;469;11715;11984;4.70;0.29;358.74;15.59;1307;27;4105.00;269
10410;22;22623119;10410;468;11721;11984;4.73;0.29;358.75;15.59;1311;27;4106.00;263
10410;22;22623140;10410;476;11721;11984;4.73;0.29;358.75;15.59;1311;27;4107.00;263
10412;22;22623155;10412;479;11724;11984;4.74;0.29;358.80;15.58;1312;27;4108.00;260
10414;22;22623173;10414;485;11726;11984;4.72;0.29;358.81;15.68;1312;27;4109.00;258
10415;22;22623191;10415;492;11729;11984;4.75;0.29;358.80;15.67;1314;27;4110.00;255
10416;22;22623211;10416;493;11733;11984;4.79;0.29;358.81;15.74;1317;27;4111.00;251
10419;22;22623231;10419;496;11736;11985;4.84;0.30;358.83;15.74;1317;27;4112.00;249
10420;22;22623249;10420;505;11738;11986;4.85;0.30;358.84;15.74;1318;27;4113.00;248
10421;22;22623268;10421;509;11740;11986;4.85;0.30;358.82;15.74;1319;27;4114.00;246
10422;22;22623287;10422;504;11744;11990;4.88;0.30;358.83;15.73;1322;27;4115.00;246
10425;22;22623306;10425;498;11745;11990;4.85;0.30;358.76;15.73;1320;27;4116.00;245
10428;22;22623327;10428;498;11745;11990;4.83;0.29;358.75;15.73;1317;27;4117.00;245
10432;22;22623345;10432;497;11745;11990;4.78;0.29;358.73;15.73;1313;27;4118.00;245
10436;22;22623364;10436;497;11750;11996;4.79;0.29;358.76;15.73;1314;27;4119.00;246
10436;22;22623382;10436;497;11750;11996;4.82;0.30;358.76;15.73;1314;27;4120.00;246
10440;22;22623402;10440;492;11750;11996;4.82;0.29;358.77;15.73;1310;27;4121.00;246
10441;22;22623420;10441;499;11752;11999;4.85;0.30;358.78;15.72;1311;27;4122.00;247
10444;22;22623436;10444;496;11752;11999;4.85;0.30;358.78;15.72;1308;27;4123.00;247
10446;22;22623452;10446;501;11753;11999;4.85;0.30;358.84;15.72;1307;27;4124.00;246
10447;22;22623468;10447;504;11753;12000;4.82;0.29;358.81;15.72;1306;27;4125.00;247
10448;22;22623485;10448;508;11754;12001;4.78;0.29;358.79;15.72;1306;27;4126.00;247
10452;22;22623502;10452;511;11755;12001;4.71;0.29;358.75;15.80;1303;27;4127.00;246
10456;22;22623518;10456;516;11765;12014;4.66;0.28;358.68;15.78;1309;27;4128.00;249
10458;22;22623535;10458;517;11765;12014;4.61;0.28;358.67;15.78;1307;27;4129.00;249
10462;22;22623550;10462;518;11765;12014;4.53;0.28;358.58;15.78;1303;27;4130.00;249
10468;22;22623570;10468;518;11767;12015;4.49;0.27;358.53;15.84;1299;27;4131.00;248
10470;22;22623588;10470;523;11768;12015;4.47;0.27;358.53;15.90;1298;27;4132.00;247
10474;22;22623603;10474;521;11773;12019;4.46;0.27;358.49;15.89;1299;27;4133.00;246
10477;22;22623619;10477;519;11773;12019;4.47;0.27;358.44;15.89;1296;27;4134.00;246
10480;22;22623635;10480;525;11776;12023;4.50;0.27;358.43;15.89;1296;27;4135.00;247
10482;22;22623651;10482;518;11776;12023;4.48;0.27;358.41;15.89;1294;27;4136.00;247
10483;22;22623669;10483;518;11776;12023;4.49;0.27;358.38;15.89;1293;27;4137.00;247
10485;22;22623685;10485;520;11776;12023;4.47;0.27;358.45;15.89;1291;27;4138.00;247
10485;22;22623700;10485;519;11776;12023;4.44;0.27;358.45;15.89;1291;27;4139.00;247
10486;22;22623717;10486;518;11797;12057;4.54;0.28;358.42;15.86;1311;27;4140.00;260
10490;22;22623736;10490;520;11798;12057;4.55;0.28;358.38;15.86;1308;27;4141.00;259
10493;22;22623754;10493;520;11799;12057;4.54;0.28;358.31;15.86;1306;27;4142.00;258
10493;22;22623772;10493;518;11800;12057;4.55;0.28;358.31;15.86;1307;27;4143.00;257
10493;23;22623787;10493;519;11800;12057;4.58;0.28;358.31;15.86;1307;28;4144.00;257
10495;23;22623820;10495;512;11800;12057;4.57;0.28;358.32;15.86;1305;28;4145.00;257
10500;23;22623841;10500;525;11801;12058;4.52;0.28;358.29;15.86;1301;28;4146.00;257
10501;23;22623860;10501;530;11801;12058;4.51;0.28;358.29;15.86;1300;28;4147.00;257
10506;23;22623879;10506;528;11805;12064;4.51;0.28;358.36;15.85;1299;28;4148.00;259
10508;23;22623898;10508;514;11806;12065;4.52;0.28;358.35;15.85;1298;28;4149.00;259
10510;23;22623917;10510;512;11806;12065;4.49;0.27;358.32;15.85;1296;28;4150.00;259
10511;23;22623935;10511;507;11808;12065;4.47;0.27;358.31;15.85;1297;28;4151.00;257
10511;23;22623951;10511;503;11812;12069;4.52;0.28;358.31;15.91;1301;28;4152.00;257
10515;23;22623970;10515;510;11812;12069;4.52;0.27;358.41;15.91;1297;28;4153.00;257
10515;23;22623988;10515;510;11814;12069;4.54;0.28;358.41;15.91;1299;28;4154.00;255
10517;23;22624008;10517;519;11816;12070;4.53;0.27;358.40;15.97;1299;28;4155.00;254
10521;23;22624036;10521;514;11821;12074;4.50;0.27;358.37;16.02;1300;28;4156.00;253
10521;23;22624054;10521;513;11821;12074;4.50;0.27;358.37;16.02;1300;28;4157.00;253
10522;23;22624082;10522;518;11824;12077;4.51;0.27;358.36;16.08;1302;28;4158.00;253
10523;23;22624110;10523;523;11825;12077;4.52;0.27;358.37;16.08;1302;28;4159.00;252
10523;23;22624129;10523;527;11826;12077;4.51;0.27;358.37;16.14;1303;28;4160.00;251
10524;23;22624148;10524;532;11826;12077;4.50;0.27;358.44;16.14;1302;28;4161.00;251
10525;23;22624169;10525;530;11831;12081;4.53;0.27;358.45;16.19;1306;28;4162.00;250
10527;23;22624191;10527;533;11831;12081;4.50;0.27;358.42;16.19;1304;29;4163.00;250
10527;23;22624218;10527;535;11831;12081;4.53;0.28;358.42;16.19;1304;29;4164.00;250
10527;23;22624236;10527;532;11833;12081;4.55;0.28;358.42;16.31;1306;29;4165.00;248
10529;23;22624254;10529;527;11833;12082;4.56;0.28;358.40;16.31;1304;29;4166.00;249
10530;23;22624272;10530;533;11834;12083;4.58;0.28;358.39;16.31;1304;29;4167.00;249
10530;23;22624289;10530;533;11836;12083;4.66;0.28;358.39;16.43;1306;29;4168.00;247
10532;23;22624305;10532;534;11837;12084;4.70;0.29;358.34;16.43;1305;29;4169.00;247
10536;23;22624336;10536;530;11839;12084;4.69;0.29;358.25;16.54;1303;29;4170.00;245
10539;23;22624359;10539;531;11839;12084;4.66;0.28;358.30;16.54;1300;29;4171.00;245
10540;23;22624383;10540;537;11839;12084;4.66;0.28;358.28;16.54;1299;29;4172.00;245
10542;23;22624401;10542;539;11843;12086;4.65;0.28;358.31;16.66;1301;29;4173.00;243
10545;23;22624420;10545;536;11843;12086;4.62;0.28;358.39;16.66;1298;29;4174.00;243
10547;23;22624441;10547;532;11843;12086;4.60;0.28;358.39;16.66;1296;29;4175.00;243
10548;23;22624460;10548;544;11910;12213;4.89;0.30;358.37;16.69;1362;29;4176.00;303
10551;23;22624491;10551;539;11913;12214;4.88;0.30;358.35;16.68;1362;29;4177.00;301
10551;23;22624509;10551;536;11922;12214;4.95;0.31;358.35;16.79;1371;29;4178.00;292
10554;23;22624525;10554;539;11930;12214;4.98;0.31;358.39;16.78;1376;29;4179.00;284
10557;23;22624541;10557;537;11935;12214;5.01;0.31;358.37;16.77;1378;29;4180.00;279
10560;23;22624560;10560;535;11941;12214;5.01;0.31;358.41;16.88;1381;29;4181.00;273
10562;23;22624580;10562;535;11942;12214;5.03;0.31;358.50;16.88;1380;29;4182.00;272
10562;23;22624597;10562;533;11947;12214;5.07;0.31;358.50;16.99;1385;29;4183.00;267
10564;23;22624613;10564;531;11948;12215;5.03;0.31;358.65;16.99;1384;29;4184.00;267
10566;23;22624631;10566;535;11953;12217;5.02;0.31;358.78;17.04;1387;29;4185.00;264
10568;23;22624650;10568;540;11956;12217;5.02;0.31;358.74;17.04;1388;29;4186.00;261
10573;23;22624669;10573;547;11960;12218;4.97;0.30;358.89;17.15;1387;29;4187.00;258
10574;23;22624691;10574;552;11961;12218;4.94;0.30;358.88;17.15;1387;29;4188.00;257
10578;23;22624709;10578;551;11965;12218;4.90;0.30;358.99;17.20;1387;29;4189.00;253
10582;23;22624731;10582;559;11967;12218;4.85;0.30;359.02;17.26;1385;29;4190.00;251
10585;23;22624751;10585;570;11973;12222;4.85;0.30;359.01;17.31;1388;29;4191.00;249
10588;23;22624783;10588;570;11977;12222;4.80;0.29;359.06;17.31;1389;29;4192.00;245
10593;23;22624801;10593;578;11980;12222;4.76;0.29;358.97;17.36;1387;29;4193.00;242
10595;23;22624820;10595;574;11984;12225;4.69;0.29;358.97;17.41;1389;29;4194.00;241
10598;23;22624840;10598;577;11984;12225;4.60;0.28;358.97;17.41;1386;29;4195.00;241
10600;23;22624859;10600;591;11985;12225;4.56;0.28;359.04;17.41;1385;29;4196.00;240
10605;23;22624885;10605;594;11989;12229;4.53;0.28;359.04;17.40;1384;29;4197.00;240
10606;23;22624905;10606;601;11990;12230;4.54;0.28;359.12;17.40;1384;29;4198.00;240
10610;23;22624923;10610;594;11991;12230;4.55;0.28;359.19;17.40;1381;29;4199.00;239
10614;23;22624945;10614;589;12002;12264;4.57;0.28;359.27;17.39;1388;29;4200.00;262
10617;23;22624970;10617;574;12003;12264;4.61;0.28;359.47;17.38;1386;29;4201.00;261
10621;23;22624988;10621;569;12004;12264;4.67;0.28;359.49;17.38;1383;29;4202.00;260
10623;23;22625008;10623;561;12005;12265;4.73;0.29;359.57;17.38;1382;29;4203.00;260
10629;23;22625028;10629;547;12005;12265;4.73;0.29;359.66;17.38;1376;29;4204.00;260
10631;23;22625049;10631;549;12010;12271;4.76;0.29;359.77;17.38;1379;29;4205.00;261
10635;23;22625068;10635;541;12012;12271;4.76;0.29;359.83;17.37;1377;29;4206.00;259
10638;23;22625086;10638;535;12012;12272;4.78;0.29;359.91;17.37;1374;29;4207.00;260
10642;23;22625104;10642;524;12012;12272;4.81;0.29;359.95;17.37;1370;29;4208.00;260
10643;23;22625121;10643;521;12013;12272;4.89;0.30;359.96;17.37;1370;29;4209.00;259
10649;23;22625138;10649;515;12013;12272;4.90;0.30;360.13;17.37;1364;29;4210.00;259
10652;23;22625155;10652;509;12015;12272;4.96;0.30;360.16;17.37;1363;29;4211.00;257
10657;23;22625171;10657;507;12026;12284;4.96;0.30;360.27;17.36;1369;29;4212.00;258
10660;23;22625189;10660;502;12026;12284;4.93;0.30;360.33;17.36;1366;29;4213.00;258
10663;23;22625207;10663;499;12026;12284;4.93;0.30;360.34;17.36;1363;29;4214.00;258
10669;23;22625225;10669;493;12026;12284;4.89;0.30;360.42;17.36;1357;29;4215.00;258
10671;23;22625247;10671;503;12027;12284;4.93;0.30;360.48;17.36;1356;29;4216.00;257
10675;23;22625266;10675;508;12029;12284;4.95;0.30;360.57;17.36;1354;29;4217.00;255
10677;23;22625286;10677;515;12033;12288;5.00;0.30;360.57;17.35;1356;29;4218.00;255
10683;23;22625304;10683;524;12033;12288;4.97;0.30;360.53;17.35;1350;29;4219.00;255
10690;23;22625323;10690;531;12035;12292;4.95;0.30;360.64;17.35;1345;29;4220.00;257
10692;23;22625344;10692;537;12037;12293;4.93;0.30;360.73;17.35;1345;29;4221.00;256
10696;23;22625372;10696;542;12038;12293;4.88;0.30;360.75;17.35;1342;29;4222.00;255
10699;23;22625391;10699;549;12039;12293;4.86;0.30;360.85;17.35;1340;29;4223.00;254
10702;23;22625409;10702;550;12048;12306;4.86;0.30;360.86;17.34;1346;29;4224.00;258
10705;23;22625426;10705;543;12051;12306;4.84;0.30;360.84;17.33;1346;29;4225.00;255
10710;23;22625443;10710;552;12051;12306;4.79;0.29;360.87;17.33;1341;29;4226.00;255
10718;23;22625459;10718;551;12052;12307;4.77;0.29;360.95;17.33;1334;29;4227.00;255
10721;23;22625474;10721;538;12052;12308;4.77;0.29;360.99;17.33;1331;29;4228.00;256
10726;23;22625489;10726;545;12053;12308;4.73;0.29;361.07;17.33;1327;29;4229.00;255
10730;23;22625507;10730;541;12058;12314;4.80;0.29;361.11;17.33;1328;29;4230.00;256
10735;23;22625523;10735;545;12059;12314;4.80;0.29;361.08;17.32;1324;29;4231.00;255
10739;23;22625539;10739;543;12059;12314;4.81;0.29;361.06;17.32;1320;29;4232.00;255
10742;23;22625553;10742;540;12059;12314;4.83;0.30;361.10;17.32;1317;29;4233.00;255
10749;23;22625568;10749;538;12064;12320;4.80;0.29;361.33;17.32;1315;29;4234.00;256
10754;23;22625584;10754;540;12065;12320;4.77;0.29;361.32;17.32;1311;29;4235.00;255
10759;23;22625600;10759;541;12065;12320;4.74;0.29;361.42;17.32;1306;29;4236.00;255
10763;23;22625615;10763;540;12065;12320;4.72;0.29;361.41;17.32;1302;29;4237.00;255
10766;23;22625630;10766;542;12069;12324;4.72;0.29;361.48;17.39;1303;29;4238.00;255
10769;23;22625646;10769;542;12070;12325;4.76;0.29;361.62;17.39;1301;29;4239.00;255
10772;23;22625662;10772;542;12070;12325;4.76;0.29;361.71;17.39;1298;29;4240.00;255
10775;23;22625677;10775;544;12072;12326;4.71;0.29;361.76;17.39;1297;29;4241.00;254
10779;23;22625692;10779;543;12072;12326;4.64;0.28;361.71;17.39;1293;29;4242.00;254
10783;23;22625708;10783;551;12072;12326;4.55;0.28;361.85;17.39;1289;29;4243.00;254
10785;23;22625723;10785;553;12072;12326;4.49;0.27;361.84;17.39;1287;29;4244.00;254
10787;23;22625738;10787;562;12072;12326;4.37;0.27;361.87;17.39;1285;29;4245.00;254
10788;23;22625752;10788;564;12072;12326;4.28;0.26;361.85;17.39;1284;29;4246.00;254
10792;23;22625766;10792;561;12073;12326;4.16;0.25;361.90;17.39;1281;29;4247.00;253
10796;23;22625781;10796;566;12111;12396;4.14;0.25;361.98;17.34;1315;29;4248.00;285
10798;23;22625801;10798;554;12112;12397;4.13;0.25;362.01;17.34;1314;29;4249.00;285
10801;23;22625815;10801;547;12118;12397;4.18;0.25;362.05;17.33;1317;29;4250.00;279
10803;23;22625830;10803;550;12120;12397;4.21;0.26;362.07;17.33;1317;29;4251.00;277
10805;23;22625845;10805;555;12123;12397;4.26;0.26;362.09;17.32;1318;29;4252.00;274
10807;23;22625861;10807;561;12128;12397;4.35;0.26;362.08;17.32;1321;29;4253.00;269
10810;23;22625875;10810;558;12131;12397;4.38;0.27;362.12;17.32;1321;29;4254.00;266
10811;23;22625890;10811;559;12136;12397;4.44;0.27;362.14;17.32;1325;30;4255.00;261
10814;23;22625914;10814;556;12138;12398;4.46;0.27;362.15;17.32;1324;30;4256.00;260
10818;23;22625930;10818;544;12141;12399;4.48;0.27;362.14;17.39;1323;30;4257.00;258
10821;23;22625946;10821;545;12143;12399;4.51;0.27;362.20;17.39;1322;30;4258.00;256
10823;23;22625961;10823;545;12147;12403;4.53;0.27;362.27;17.39;1324;30;4259.00;256
10825;23;22625979;10825;549;12148;12403;4.58;0.28;362.28;17.39;1323;30;4260.00;255
10827;23;22625994;10827;549;12148;12403;4.61;0.28;362.28;17.39;1321;30;4261.00;255
10828;23;22626012;10828;549;12148;12403;4.61;0.28;362.27;17.39;1320;30;4262.00;255
10829;23;22626029;10829;551;12153;12409;4.63;0.28;362.35;17.38;1324;30;4263.00;256
10830;23;22626051;10830;555;12153;12409;4.61;0.28;362.36;17.38;1323;30;4264.00;256
10832;23;22626066;10832;558;12153;12409;4.58;0.28;362.48;17.38;1321;30;4265.00;256
10832;23;22626082;10832;562;12155;12412;4.58;0.28;362.48;17.38;1323;30;4266.00;257
10835;23;22626097;10835;551;12155;12412;4.59;0.28;362.56;17.38;1320;30;4267.00;257
10840;23;22626113;10840;551;12156;12412;4.56;0.28;362.70;17.37;1316;30;4268.00;256
10842;23;22626128;10842;552;12156;12413;4.53;0.28;362.76;17.37;1314;30;4269.00;257
10842;23;22626144;10842;551;12157;12414;4.54;0.28;362.76;17.37;1315;30;4270.00;257
10843;23;22626158;10843;551;12157;12414;4.52;0.28;362.83;17.37;1314;30;4271.00;257
10847;23;22626173;10847;539;12166;12427;4.51;0.27;362.85;17.36;1319;30;4272.00;261
10850;23;22626190;10850;549;12167;12427;4.50;0.27;362.80;17.43;1317;30;4273.00;260
10854;23;22626205;10854;536;12167;12427;4.51;0.28;362.74;17.43;1313;30;4274.00;260
10855;23;22626220;10855;527;12169;12429;4.53;0.28;362.75;17.43;1314;30;4275.00;260
10857;23;22626235;10857;527;12169;12429;4.50;0.28;362.74;17.43;1312;30;4276.00;260
10862;23;22626251;10862;525;12173;12433;4.50;0.28;362.69;17.43;1311;30;4277.00;260
10863;23;22626268;10863;528;12173;12433;4.50;0.27;362.68;17.43;1310;30;4278.00;260
10864;23;22626282;10864;523;12177;12437;4.51;0.28;362.67;17.50;1313;30;4279.00;260
10865;23;22626298;10865;529;12177;12437;4.50;0.28;362.67;17.50;1312;30;4280.00;260
10868;23;22626313;10868;521;12178;12437;4.50;0.28;362.66;17.57;1310;30;4281.00;259
10870;23;22626328;10870;512;12178;12437;4.48;0.27;362.64;17.57;1308;30;4282.00;259
10872;23;22626342;10872;517;12178;12437;4.49;0.27;362.66;17.57;1306;30;4283.00;259
10875;23;22626357;10875;526;12188;12449;4.54;0.28;362.67;17.55;1313;30;4284.00;261
10877;23;22626373;10877;528;12189;12449;4.54;0.28;362.68;17.62;1312;30;4285.00;260
10881;23;22626387;10881;527;12190;12449;4.52;0.28;362.70;17.62;1309;30;4286.00;259
10883;23;22626402;10883;538;12191;12449;4.52;0.28;362.72;17.69;1308;30;4287.00;258
10885;23;22626421;10885;541;12191;12449;4.53;0.28;362.69;17.69;1306;30;4288.00;258
10889;23;22626439;10889;536;12192;12449;4.51;0.27;362.79;17.76;1303;30;4289.00;257
10890;23;22626462;10890;537;12192;12450;4.54;0.28;362.76;17.76;1302;30;4290.00;258
10891;23;22626480;10891;530;12193;12450;4.50;0.27;362.75;17.83;1302;30;4291.00;257
10896;23;22626506;10896;522;12198;12456;4.46;0.27;362.79;17.82;1302;30;4292.00;258
10896;23;22626523;10896;519;12199;12457;4.47;0.27;362.79;17.82;1303;30;4293.00;258
10897;23;22626538;10897;518;12199;12457;4.48;0.27;362.76;17.82;1302;30;4294.00;258
10901;23;22626553;10901;519;12200;12457;4.43;0.27;362.79;17.88;1299;30;4295.00;257
10903;23;22626567;10903;512;12202;12461;4.44;0.27;362.75;17.88;1299;30;4296.00;259
10905;23;22626581;10905;515;12202;12461;4.44;0.27;362.69;17.88;1297;30;4297.00;259
10905;23;22626595;10905;520;12202;12461;4.43;0.27;362.69;17.88;1297;30;4298.00;259
10906;23;22626610;10906;524;12203;12462;4.46;0.27;362.68;17.87;1297;30;4299.00;259
10909;23;22626624;10909;510;12207;12466;4.42;0.27;362.74;17.93;1298;30;4300.00;259
10910;23;22626643;10910;514;12207;12466;4.38;0.27;362.71;17.93;1297;30;4301.00;259
10912;23;22626657;10912;509;12209;12469;4.35;0.26;362.71;17.92;1297;30;4302.00;260
10914;23;22626671;10914;511;12210;12469;4.29;0.26;362.67;17.92;1296;30;4303.00;259
10918;23;22626685;10918;509;12210;12469;4.23;0.26;362.72;17.92;1292;30;4304.00;259
10919;23;22626699;10919;509;12212;12469;4.21;0.26;362.69;18.05;1293;30;4305.00;257
10921;23;22626717;10921;490;12216;12473;4.24;0.26;362.72;18.04;1295;30;4306.00;257
10923;23;22626732;10923;476;12217;12473;4.25;0.26;362.72;18.10;1294;30;4307.00;256
10924;23;22626747;10924;471;12217;12473;4.32;0.26;362.73;18.10;1293;30;4308.00;256
10925;23;22626761;10925;460;12217;12473;4.40;0.27;362.71;18.10;1292;30;4309.00;256
10925;23;22626777;10925;446;12217;12474;4.46;0.27;362.71;18.10;1292;30;4310.00;257
10927;23;22626791;10927;445;12218;12475;4.55;0.27;362.70;18.10;1291;30;4311.00;257
10927;23;22626812;10927;435;12218;12475;4.60;0.28;362.70;18.10;1291;30;4312.00;257
10927;23;22626832;10927;433;12219;12476;4.68;0.28;362.70;18.09;1292;30;4313.00;257
10927;23;22626848;10927;435;12219;12476;4.71;0.29;362.70;18.09;1292;30;4314.00;257
10930;23;22626862;10930;435;12219;12476;4.75;0.29;362.75;18.09;1289;30;4315.00;257
10931;23;22626877;10931;439;12219;12476;4.76;0.29;362.73;18.09;1288;30;4316.00;257
10932;23;22626891;10932;443;12220;12476;4.80;0.29;362.72;18.10;1288;30;4317.00;256
10934;23;22626905;10934;442;12220;12476;4.83;0.29;362.68;18.10;1286;30;4318.00;256
10934;23;22626920;10934;443;12220;12476;4.90;0.30;362.68;18.10;1286;30;4319.00;256
10936;23;22626937;10936;477;12321;12706;5.17;0.32;362.64;17.95;1385;30;4320.00;385
10937;23;22626969;10937;465;12323;12707;5.21;0.32;362.66;17.95;1386;30;4321.00;384
10939;23;22626985;10939;455;12333;12707;5.25;0.33;362.62;17.94;1394;30;4322.00;374
10942;23;22627002;10942;450;12337;12707;5.22;0.32;362.55;17.93;1395;30;4323.00;370
10943;23;22627022;10943;444;12345;12707;5.24;0.32;362.56;17.92;1402;30;4324.00;362
10944;23;22627038;10944;457;12352;12707;5.22;0.32;362.53;17.92;1408;30;4325.00;355
10946;23;22627053;10946;452;12357;12707;5.23;0.32;362.57;17.91;1411;30;4326.00;350
10948;23;22627070;10948;461;12363;12707;5.25;0.32;362.63;17.91;1415;30;4327.00;344
10951;23;22627086;10951;465;12370;12708;5.27;0.32;362.67;17.90;1419;30;4328.00;338
10953;23;22627102;10953;456;12375;12709;5.26;0.32;362.74;17.90;1422;30;4329.00;334
10956;23;22627118;10956;451;12382;12709;5.21;0.32;362.92;17.89;1426;30;4330.00;327
10956;23;22627134;10956;462;12386;12710;5.24;0.32;362.92;17.95;1430;30;4331.00;324
10959;23;22627150;10959;474;12390;12710;5.20;0.32;363.03;17.95;1431;30;4332.00;320
10960;23;22627166;10960;477;12394;12710;5.15;0.32;363.01;18.01;1434;30;4333.00;316
10965;23;22627182;10965;480;12399;12710;5.11;0.31;363.15;18.01;1434;30;4334.00;311
10968;23;22627199;10968;490;12403;12714;5.05;0.31;363.12;18.07;1435;30;4335.00;311
10970;23;22627215;10970;493;12407;12714;5.00;0.31;363.16;18.07;1437;30;4336.00;307
10970;23;22627231;10970;500;12409;12714;4.96;0.30;363.16;18.07;1439;30;4337.00;305
10973;23;22627247;10973;507;12412;12717;4.92;0.30;363.15;18.13;1439;30;4338.00;305
10974;23;22627265;10974;521;12413;12717;4.88;0.30;363.23;18.13;1439;30;4339.00;304
10975;23;22627281;10975;530;12415;12717;4.81;0.29;363.30;18.13;1440;30;4340.00;302
10975;23;22627297;10975;538;12419;12721;4.81;0.29;363.30;18.19;1444;30;4341.00;302
10977;23;22627313;10977;550;12422;12722;4.84;0.30;363.38;18.25;1445;30;4342.00;300
10979;23;22627331;10979;551;12423;12722;4.85;0.30;363.33;18.25;1444;30;4343.00;299
10980;23;22627347;10980;562;12428;12726;4.86;0.30;363.42;18.43;1448;30;4344.00;298
10983;23;22627366;10983;559;12428;12726;4.82;0.29;363.37;18.43;1445;30;4345.00;298
10985;23;22627383;10985;559;12431;12726;4.81;0.29;363.37;18.49;1446;30;4346.00;295
10987;23;22627399;10987;571;12432;12727;4.81;0.29;363.45;18.49;1445;30;4347.00;295
10989;23;22627417;10989;579;12432;12727;4.78;0.29;363.55;18.49;1443;30;4348.00;295
10992;23;22627432;10992;578;12438;12733;4.80;0.29;363.65;18.54;1446;30;4349.00;295
10993;23;22627451;10993;568;12439;12733;4.78;0.29;363.75;18.55;1446;30;4350.00;294
10995;23;22627467;10995;575;12441;12734;4.77;0.29;363.87;18.66;1446;30;4351.00;293
10997;23;22627483;10997;578;12442;12734;4.76;0.29;363.87;18.66;1445;30;4352.00;292
10999;23;22627499;10999;574;12443;12734;4.74;0.29;363.98;18.66;1444;30;4353.00;291
11001;23;22627515;11001;575;12447;12734;4.74;0.29;364.01;18.78;1446;30;4354.00;287
11004;23;22627531;11004;577;12449;12734;4.77;0.29;364.06;18.84;1445;30;4355.00;285
11005;23;22627548;11005;583;12459;12746;4.82;0.30;364.10;18.89;1454;30;4356.00;287
11009;23;22627565;11009;587;12460;12746;4.82;0.29;364.14;18.88;1451;30;4357.00;286
11012;23;22627581;11012;591;12461;12746;4.84;0.29;364.14;18.89;1449;30;4358.00;285
11015;23;22627598;11015;591;12463;12746;4.82;0.29;364.22;19.01;1448;30;4359.00;283
11018;23;22627614;11018;589;12464;12746;4.85;0.30;364.22;19.01;1446;30;4360.00;282
11020;23;22627631;11020;589;12467;12746;4.88;0.30;364.24;19.12;1447;30;4361.00;279
11024;23;22627647;11024;589;12471;12750;4.87;0.30;364.26;19.12;1447;30;4362.00;279
11025;23;22627664;11025;585;12472;12750;4.88;0.30;364.25;19.12;1447;30;4363.00;278
11028;23;22627681;11028;597;12477;12754;4.87;0.30;364.26;19.23;1449;30;4364.00;277
11031;23;22627698;11031;598;12480;12756;4.85;0.30;364.31;19.29;1449;30;4365.00;276
11035;23;22627716;11035;602;12482;12756;4.80;0.29;364.36;19.35;1447;30;4366.00;274
11037;23;22627732;11037;608;12482;12756;4.75;0.29;364.40;19.35;1445;30;4367.00;274
11040;23;22627747;11040;621;12492;12769;4.73;0.29;364.45;19.39;1452;30;4368.00;277
11043;23;22627764;11043;624;12493;12769;4.72;0.29;364.48;19.45;1450;30;4369.00;276
11048;23;22627781;11048;626;12493;12769;4.69;0.29;364.66;19.45;1445;30;4370.00;276
11051;23;22627797;11051;629;12496;12770;4.66;0.29;364.71;19.56;1445;30;4371.00;274
11053;23;22627813;11053;631;12496;12771;4.65;0.28;364.75;19.56;1443;30;4372.00;275
11059;23;22627828;11059;629;12497;12771;4.55;0.28;364.89;19.62;1438;30;4373.00;274
11060;23;22627845;11060;633;12501;12774;4.53;0.28;364.88;19.67;1441;30;4374.00;273
11064;23;22627861;11064;620;12501;12774;4.50;0.28;365.00;19.67;1437;30;4375.00;273
11068;23;22627876;11068;614;12501;12774;4.44;0.27;365.19;19.67;1433;30;4376.00;273
11071;23;22627892;11071;609;12501;12774;4.40;0.27;365.16;19.67;1430;30;4377.00;273
11075;23;22627907;11075;604;12505;12780;4.41;0.27;365.30;19.67;1430;30;4378.00;275
11079;23;22627923;11079;596;12505;12780;4.40;0.27;365.41;19.67;1426;30;4379.00;275
11083;23;22627941;11083;592;12505;12780;4.43;0.27;365.44;19.67;1422;30;4380.00;275
11087;23;22627957;11087;584;12506;12780;4.45;0.27;365.55;19.67;1419;30;4381.00;274
11092;23;22627972;11092;584;12509;12784;4.44;0.27;365.64;19.66;1417;30;4382.00;275
11097;23;22627988;11097;567;12511;12785;4.50;0.28;365.77;19.67;1414;30;4383.00;274
11100;23;22628006;11100;563;12511;12785;4.54;0.28;365.89;19.67;1411;30;4384.00;274
11104;23;22628023;11104;560;12512;12786;4.58;0.28;365.91;19.67;1408;30;4385.00;274
11106;23;22628039;11106;562;12513;12786;4.61;0.28;365.91;19.67;1407;30;4386.00;273
11110;23;22628055;11110;563;12513;12786;4.63;0.29;365.99;19.67;1403;30;4387.00;273
11113;23;22628071;11113;565;12515;12786;4.62;0.29;366.11;19.67;1402;30;4388.00;271
11116;23;22628087;11116;564;12515;12786;4.62;0.28;366.11;19.67;1399;30;4389.00;271
11121;23;22628102;11121;571;12515;12786;4.62;0.29;366.14;19.67;1394;30;4390.00;271
11124;23;22628118;11124;583;12516;12786;4.66;0.29;366.22;19.68;1392;30;4391.00;270
11128;23;22628133;11128;582;12545;12856;4.80;0.30;366.32;19.63;1417;30;4392.00;311
11133;23;22628155;11133;594;12546;12857;4.76;0.29;366.34;19.63;1413;30;4393.00;311
11137;23;22628171;11137;592;12550;12857;4.70;0.29;366.30;19.62;1413;30;4394.00;307
11143;23;22628187;11143;604;12552;12857;4.64;0.29;366.30;19.62;1409;30;4395.00;305
11146;23;22628208;11146;607;12554;12857;4.60;0.28;366.31;19.62;1408;30;4396.00;303
11152;23;22628224;11152;618;12556;12857;4.59;0.28;366.36;19.62;1404;30;4397.00;301
11159;23;22628240;11159;620;12559;12857;4.51;0.28;366.49;19.61;1400;30;4398.00;298
11163;23;22628257;11163;627;12560;12857;4.48;0.28;366.57;19.61;1397;30;4399.00;297
11166;23;22628274;11166;628;12563;12858;4.44;0.27;366.55;19.61;1397;30;4400.00;295
11171;23;22628295;11171;632;12564;12859;4.41;0.27;366.60;19.61;1393;30;4401.00;295
11176;23;22628310;11176;631;12566;12859;4.32;0.27;366.63;19.61;1390;30;4402.00;293
11180;23;22628325;11180;636;12569;12863;4.25;0.26;366.64;19.60;1389;30;4403.00;294
11182;23;22628341;11182;641;12573;12863;4.21;0.26;366.62;19.60;1391;30;4404.00;290
11184;23;22628356;11184;646;12574;12863;4.20;0.26;366.70;19.60;1390;30;4405.00;289
11192;23;22628371;11192;643;12576;12863;4.12;0.25;366.67;19.60;1384;30;4406.00;287
11194;23;22628386;11194;651;12580;12869;4.15;0.25;366.64;19.59;1386;30;4407.00;289
11198;23;22628402;11198;646;12580;12869;4.14;0.25;366.73;19.59;1382;30;4408.00;289
11200;23;22628419;11200;646;12580;12869;4.08;0.25;366.78;19.59;1380;30;4409.00;289
11207;23;22628444;11207;647;12584;12875;4.07;0.25;366.91;19.59;1377;30;4410.00;291
11210;23;22628465;11210;647;12584;12875;4.05;0.25;366.89;19.59;1374;30;4411.00;291
11215;23;22628484;11215;646;12586;12875;3.99;0.24;366.95;19.58;1371;30;4412.00;289
11216;23;22628502;11216;644;12586;12876;3.97;0.24;366.96;19.58;1370;30;4413.00;290
11220;23;22628521;11220;654;12587;12877;3.96;0.24;366.99;19.58;1367;30;4414.00;290
11223;23;22628537;11223;661;12589;12877;3.92;0.24;366.93;19.58;1366;30;4415.00;288
11224;23;22628552;11224;663;12598;12890;3.97;0.24;366.97;19.57;1374;30;4416.00;292
11229;23;22628568;11229;679;12599;12890;3.89;0.24;366.89;19.57;1370;30;4417.00;291
11233;23;22628591;11233;678;12599;12890;3.83;0.23;366.93;19.57;1366;30;4418.00;291
11234;23;22628611;11234;678;12600;12891;3.76;0.23;366.95;19.57;1366;30;4419.00;291
11238;23;22628635;11238;680;12602;12891;3.67;0.22;367.10;19.57;1364;30;4420.00;289
11241;23;22628652;11241;683;12605;12895;3.63;0.22;367.22;19.56;1364;30;4421.00;290
11242;23;22628673;11242;674;12605;12895;3.63;0.22;367.32;19.56;1363;30;4422.00;290
11243;23;22628692;11243;668;12608;12899;3.63;0.22;367.34;19.56;1365;30;4423.00;291
11245;23;22628714;11245;666;12608;12899;3.63;0.22;367.35;19.56;1363;30;4424.00;291
11247;23;22628737;11247;660;12608;12899;3.64;0.22;367.42;19.56;1361;30;4425.00;291
11249;23;22628756;11249;667;12608;12899;3.69;0.22;367.45;19.56;1359;30;4426.00;291
11250;23;22628775;11250;671;12608;12899;3.75;0.23;367.44;19.56;1358;30;4427.00;291
11251;23;22628794;11251;677;12618;12911;3.87;0.23;367.46;19.55;1367;30;4428.00;293
11252;23;22628813;11252;687;12618;12911;3.93;0.24;367.45;19.55;1366;30;4429.00;293
11253;23;22628830;11253;686;12619;12911;4.00;0.24;367.53;19.54;1366;30;4430.00;292
11255;23;22628849;11255;669;12619;12911;4.02;0.24;367.54;19.54;1364;30;4431.00;292
11256;23;22628866;11256;663;12619;12911;4.07;0.25;367.55;19.54;1363;30;4432.00;292
11257;23;22628890;11257;653;12619;12911;4.12;0.25;367.62;19.54;1362;30;4433.00;292
11258;23;22628906;11258;648;12619;12912;4.13;0.25;367.65;19.54;1361;30;4434.00;293
11262;23;22628921;11262;645;12619;12912;4.12;0.25;367.69;19.54;1357;30;4435.00;293
11264;23;22628936;11264;649;12623;12918;4.17;0.25;367.70;19.54;1359;30;4436.00;295
11265;23;22628952;11265;652;12624;12919;4.22;0.26;367.78;19.54;1359;30;4437.00;295
11268;23;22628967;11268;655;12624;12919;4.21;0.26;367.87;19.54;1356;30;4438.00;295
11273;23;22628983;11273;650;12624;12919;4.20;0.25;368.01;19.54;1351;30;4439.00;295
11275;23;22629007;11275;653;12628;12924;4.24;0.26;367.97;19.60;1353;30;4440.00;296
11276;23;22629028;11276;655;12628;12924;4.30;0.26;367.95;19.60;1352;30;4441.00;296
11278;23;22629043;11278;640;12628;12924;4.34;0.26;367.99;19.60;1350;30;4442.00;296
11278;23;22629060;11278;642;12629;12925;4.40;0.27;367.99;19.60;1351;30;4443.00;296
11279;23;22629075;11279;639;12632;12929;4.42;0.27;367.97;19.59;1353;30;4444.00;297
11281;23;22629093;11281;642;12632;12929;4.40;0.27;368.00;19.59;1351;30;4445.00;297
11282;23;22629108;11282;632;12634;12932;4.39;0.27;367.97;19.59;1352;30;4446.00;298
11284;23;22629125;11284;628;12634;12932;4.37;0.27;367.94;19.59;1350;30;4447.00;298
11290;23;22629140;11290;615;12635;12932;4.36;0.27;367.95;19.59;1345;30;4448.00;297
11291;23;22629155;11291;621;12635;12932;4.36;0.27;367.93;19.59;1344;30;4449.00;297
11294;23;22629170;11294;623;12638;12936;4.36;0.27;367.92;19.58;1344;30;4450.00;298
11296;23;22629185;11296;617;12638;12936;4.31;0.26;367.86;19.58;1342;30;4451.00;298
11297;23;22629201;11297;614;12638;12936;4.29;0.26;367.84;19.58;1341;30;4452.00;298
11298;23;22629215;11298;621;12638;12936;4.26;0.26;367.81;19.58;1340;30;4453.00;298
11300;23;22629230;11300;627;12638;12937;4.21;0.26;367.77;19.58;1338;30;4454.00;299
11305;23;22629246;11305;624;12640;12939;4.18;0.25;367.83;19.58;1335;30;4455.00;299
11306;23;22629263;11306;624;12640;12939;4.16;0.25;367.80;19.58;1334;30;4456.00;299
11307;23;22629281;11307;620;12641;12940;4.18;0.25;367.78;19.58;1334;30;4457.00;299
11308;23;22629299;11308;619;12641;12940;4.15;0.25;367.79;19.58;1333;30;4458.00;299
11308;23;22629319;11308;614;12641;12940;4.12;0.25;367.79;19.58;1333;30;4459.00;299
11308;23;22629338;11308;614;12641;12940;4.12;0.25;367.79;19.58;1333;30;4460.00;299
11309;23;22629355;11309;613;12641;12940;4.09;0.25;367.79;19.58;1332;30;4461.00;299
11309;23;22629373;11309;611;12641;12940;4.10;0.25;367.79;19.58;1332;30;4462.00;299
11312;23;22629391;11312;593;12641;12940;4.08;0.25;367.81;19.58;1329;30;4463.00;299
11313;23;22629410;11313;604;12700;13067;4.37;0.27;367.78;19.49;1387;30;4464.00;367
11316;23;22629439;11316;583;12700;13068;4.38;0.27;367.80;19.49;1384;30;4465.00;368
11318;23;22629458;11318;565;12707;13068;4.48;0.28;367.80;19.48;1389;30;4466.00;361
11318;23;22629478;11318;561;12708;13068;4.54;0.28;367.80;19.48;1390;30;4467.00;360
11321;23;22629499;11321;552;12714;13068;4.61;0.28;367.81;19.47;1393;30;4468.00;354
11321;23;22629519;11321;541;12717;13068;4.64;0.28;367.81;19.46;1396;30;4469.00;351
11322;23;22629539;11322;520;12721;13068;4.72;0.29;367.79;19.46;1399;30;4470.00;347
11323;23;22629558;11323;519;12724;13068;4.78;0.29;367.82;19.46;1401;30;4471.00;344
11324;23;22629574;11324;513;12726;13069;4.85;0.30;367.85;19.46;1402;30;4472.00;343
11324;23;22629591;11324;500;12729;13070;4.94;0.30;367.85;19.45;1405;30;4473.00;341
11326;23;22629607;11326;496;12730;13070;5.00;0.30;367.87;19.45;1404;30;4474.00;340
11330;23;22629625;11330;497;12732;13071;5.05;0.31;367.85;19.45;1402;30;4475.00;339
11331;23;22629642;11331;489;12734;13071;5.08;0.31;367.87;19.45;1403;30;4476.00;337
11334;23;22629658;11334;487;12736;13071;5.09;0.31;367.93;19.52;1402;30;4477.00;335
11335;23;22629676;11335;494;12739;13071;5.07;0.31;367.92;19.52;1404;30;4478.00;332
11338;23;22629692;11338;484;12743;13075;5.11;0.31;367.93;19.51;1405;30;4479.00;332
11340;23;22629709;11340;472;12745;13075;5.05;0.31;367.92;19.64;1405;30;4480.00;330
11341;23;22629731;11341;469;12748;13075;4.99;0.30;367.94;19.64;1407;30;4481.00;327
11342;23;22629747;11342;459;12749;13078;4.93;0.30;367.95;19.64;1407;30;4482.00;329
11343;23;22629764;11343;451;12751;13078;4.89;0.30;367.94;19.63;1408;30;4483.00;327
11344;23;22629781;11344;451;12752;13078;4.89;0.30;367.96;19.63;1408;30;4484.00;326
11346;23;22629797;11346;445;12757;13082;4.90;0.30;368.01;19.63;1411;30;4485.00;325
11350;23;22629816;11350;446;12758;13083;4.96;0.30;368.08;19.63;1408;30;4486.00;325
11352;23;22629833;11352;435;12760;13083;5.00;0.30;368.19;19.63;1408;30;4487.00;323
11354;23;22629851;11354;438;12762;13087;5.04;0.31;368.19;19.63;1408;30;4488.00;325
11357;23;22629870;11357;437;12763;13087;5.03;0.31;368.16;19.62;1406;30;4489.00;324
11359;23;22629894;11359;436;12763;13087;5.00;0.30;368.12;19.62;1404;30;4490.00;324
11362;23;22629910;11362;434;12764;13088;5.04;0.31;368.26;19.62;1402;30;4491.00;324
11367;23;22629926;11367;446;12764;13088;5.06;0.31;368.28;19.62;1397;30;4492.00;324
11367;23;22629943;11367;446;12769;13094;5.14;0.31;368.28;19.69;1402;30;4493.00;325
11369;23;22629961;11369;446;12769;13094;5.13;0.31;368.25;19.69;1400;30;4494.00;325
11369;23;22629977;11369;447;12769;13095;5.14;0.31;368.25;19.69;1400;30;4495.00;326
11371;23;22629993;11371;457;12769;13095;5.10;0.31;368.32;19.69;1398;30;4496.00;326
11375;23;22630011;11375;461;12769;13095;5.05;0.31;368.32;19.69;1394;30;4497.00;326
11375;23;22630028;11375;462;12772;13095;5.08;0.31;368.32;19.71;1397;30;4498.00;323
11376;23;22630045;11376;459;12772;13095;5.06;0.31;368.40;19.71;1396;30;4499.00;323
11379;23;22630063;11379;463;12793;13145;5.14;0.31;368.49;19.69;1414;30;4500.00;352
11382;23;22630089;11382;465;12794;13147;5.16;0.31;368.47;19.70;1412;30;4501.00;353
11383;23;22630106;11383;470;12801;13147;5.18;0.32;368.45;19.71;1418;30;4502.00;346
11385;23;22630124;11385;464;12802;13147;5.19;0.32;368.48;19.72;1417;30;4503.00;345
11386;23;22630141;11386;462;12806;13147;5.25;0.32;368.49;19.80;1420;30;4504.00;341
11388;23;22630158;11388;467;12806;13147;5.23;0.32;368.55;19.80;1418;30;4505.00;341
11390;23;22630176;11390;478;12812;13151;5.21;0.32;368.51;19.81;1422;30;4506.00;339
11392;23;22630204;11392;473;12815;13151;5.22;0.32;368.58;19.95;1423;30;4507.00;336
11393;23;22630223;11393;469;12821;13155;5.21;0.32;368.61;19.96;1428;30;4508.00;334
11397;23;22630244;11397;478;12825;13156;5.18;0.32;368.60;20.09;1428;30;4509.00;331
11398;23;22630267;11398;481;12827;13156;5.17;0.31;368.58;20.16;1429;30;4510.00;329
11401;23;22630299;11401;487;12829;13156;5.13;0.31;368.61;20.16;1428;30;4511.00;327
11403;23;22630324;11403;496;12841;13169;5.11;0.31;368.67;20.28;1438;30;4512.00;328
11407;23;22630355;11407;493;12843;13169;5.04;0.31;368.81;20.34;1436;30;4513.00;326
11410;23;22630387;11410;505;12847;13169;5.03;0.31;368.87;20.42;1437;30;4514.00;322
11412;23;22630409;11412;511;12848;13170;5.00;0.30;368.94;20.42;1436;30;4515.00;322
11414;23;22630438;11414;520;12851;13171;4.98;0.30;369.02;20.54;1437;30;4516.00;320
11419;23;22630466;11419;512;12853;13171;4.95;0.30;369.13;20.55;1434;30;4517.00;318
11420;23;22630490;11420;523;12860;13174;5.01;0.31;369.11;20.67;1440;30;4518.00;314
11425;23;22630514;11425;520;12862;13174;4.99;0.30;369.26;20.68;1437;30;4519.00;312
11428;23;22630533;11428;521;12867;13174;4.98;0.30;369.26;20.80;1439;30;4520.00;307
11429;23;22630551;11429;527;12868;13174;4.96;0.30;369.29;20.80;1439;30;4521.00;306
11433;23;22630568;11433;537;12872;13180;4.98;0.30;369.38;20.85;1439;30;4522.00;308
11434;23;22630586;11434;539;12876;13180;4.98;0.30;369.40;20.92;1442;30;4523.00;304
11437;23;22630602;11437;540;12878;13180;4.93;0.30;369.42;20.97;1441;30;4524.00;302
11437;23;22630620;11437;530;12881;13180;4.93;0.30;369.42;21.03;1444;30;4525.00;299
11438;23;22630636;11438;529;12887;13184;4.91;0.30;369.50;21.09;1449;30;4526.00;297
11438;23;22630660;11438;524;12888;13185;4.92;0.30;369.50;21.09;1450;30;4527.00;297
11440;23;22630677;11440;526;12891;13185;4.91;0.30;369.46;21.09;1451;30;4528.00;294
11443;23;22630694;11443;524;12896;13186;4.86;0.30;369.48;21.26;1453;30;4529.00;290
11446;23;22630713;11446;526;12896;13186;4.84;0.30;369.55;21.26;1450;30;4530.00;290
11448;23;22630729;11448;524;12900;13186;4.83;0.30;369.58;21.38;1452;30;4531.00;286
11450;23;22630747;11450;521;12900;13186;4.81;0.29;369.63;21.38;1450;30;4532.00;286
11450;23;22630764;11450;530;12903;13186;4.82;0.30;369.63;21.49;1453;30;4533.00;283
11451;23;22630781;11451;534;12903;13186;4.86;0.30;369.63;21.49;1452;30;4534.00;283
11456;23;22630799;11456;535;12904;13186;4.87;0.30;369.65;21.49;1448;30;4535.00;282
11458;23;22630819;11458;542;12943;13256;4.96;0.30;369.64;21.54;1485;30;4536.00;313
11463;23;22630842;11463;538;12944;13257;4.95;0.30;369.79;21.54;1481;30;4537.00;313
11465;23;22630862;11465;534;12951;13257;4.98;0.30;369.81;21.54;1486;30;4538.00;306
11469;23;22630880;11469;540;12957;13257;4.91;0.30;369.88;21.64;1488;30;4539.00;300
11472;23;22630898;11472;553;12962;13257;4.85;0.30;370.01;21.64;1490;30;4540.00;295
11475;23;22630918;11475;556;12968;13257;4.81;0.29;370.00;21.69;1493;30;4541.00;289
11481;23;22630936;11481;564;12973;13257;4.75;0.29;370.00;21.74;1492;30;4542.00;284
11485;23;22630954;11485;571;12979;13257;4.71;0.29;370.10;21.80;1494;30;4543.00;278
11488;23;22630972;11488;578;12982;13258;4.66;0.28;370.04;21.86;1494;30;4544.00;276
11490;23;22630990;11490;581;12987;13260;4.65;0.28;370.05;21.91;1497;30;4545.00;273
11495;23;22631010;11495;586;12987;13260;4.58;0.28;370.15;21.91;1492;30;4546.00;273
11498;23;22631028;11498;600;12989;13264;4.44;0.27;370.13;21.91;1491;30;4547.00;275
11502;23;22631046;11502;609;12989;13264;4.32;0.26;370.23;21.91;1487;30;4548.00;275
11503;23;22631063;11503;627;12989;13264;4.25;0.26;370.23;21.91;1486;30;4549.00;275
11509;23;22631079;11509;618;12990;13264;4.15;0.25;370.28;21.91;1481;30;4550.00;274
11511;23;22631097;11511;620;12994;13270;4.14;0.25;370.24;21.90;1483;30;4551.00;276
11516;23;22631115;11516;621;12994;13270;4.11;0.25;370.30;21.90;1478;30;4552.00;276
11520;23;22631132;11520;626;12994;13270;4.05;0.25;370.31;21.90;1474;30;4553.00;276
11524;23;22631149;11524;628;12996;13273;4.01;0.24;370.47;21.90;1472;30;4554.00;277
11527;23;22631166;11527;635;12996;13273;3.98;0.24;370.55;21.90;1469;30;4555.00;277
11530;23;22631184;11530;628;12996;13273;3.93;0.24;370.62;21.90;1466;30;4556.00;277
11536;23;22631201;11536;628;12996;13274;3.88;0.24;370.69;21.90;1460;30;4557.00;278
11539;23;22631219;11539;633;12997;13275;3.85;0.23;370.81;21.90;1458;30;4558.00;278
11542;23;22631236;11542;630;12997;13275;3.81;0.23;370.88;21.90;1455;30;4559.00;278
11546;23;22631255;11546;629;13014;13301;3.83;0.23;370.99;21.87;1468;30;4560.00;287
11549;23;22631280;11549;630;13015;13301;3.79;0.23;371.05;21.94;1466;30;4561.00;286
11552;23;22631301;11552;633;13016;13301;3.78;0.23;371.07;21.94;1464;30;4562.00;285
11557;23;22631317;11557;635;13016;13302;3.77;0.23;371.14;21.94;1459;30;4563.00;286
11561;23;22631334;11561;642;13018;13302;3.81;0.23;371.18;21.94;1457;30;4564.00;284
11565;23;22631351;11565;647;13021;13306;3.79;0.23;371.13;21.94;1456;30;4565.00;285
11569;23;22631368;11569;655;13021;13306;3.75;0.23;371.20;21.94;1452;30;4566.00;285
11571;23;22631384;11571;669;13024;13310;3.76;0.23;371.27;21.93;1453;30;4567.00;286
11574;23;22631400;11574;683;13024;13310;3.73;0.23;371.28;21.93;1450;30;4568.00;286
11580;23;22631421;11580;680;13025;13310;3.69;0.23;371.26;21.93;1445;30;4569.00;285
11583;23;22631437;11583;687;13027;13310;3.65;0.22;371.31;21.93;1444;30;4570.00;283
11588;23;22631455;11588;690;13028;13310;3.61;0.22;371.44;21.93;1440;30;4571.00;282
11592;23;22631474;11592;699;13037;13322;3.66;0.22;371.59;21.92;1445;30;4572.00;285
11593;23;22631494;11593;702;13038;13322;3.65;0.22;371.58;21.92;1445;30;4573.00;284
11597;23;22631512;11597;702;13039;13322;3.63;0.22;371.62;21.91;1442;30;4574.00;283
11600;23;22631529;11600;702;13040;13322;3.59;0.22;371.70;21.91;1440;30;4575.00;282
11605;23;22631544;11605;703;13041;13322;3.53;0.22;371.67;21.91;1436;30;4576.00;281
11611;23;22631560;11611;705;13041;13322;3.42;0.21;371.64;21.91;1430;30;4577.00;281
11613;23;22631574;11613;707;13042;13323;3.34;0.20;371.61;21.99;1429;30;4578.00;281
11617;23;22631589;11617;704;13043;13323;3.26;0.20;371.62;21.99;1426;30;4579.00;280
11620;23;22631604;11620;701;13047;13329;3.21;0.20;371.60;21.98;1427;30;4580.00;282
11625;23;22631620;11625;707;13049;13330;3.16;0.19;371.69;21.98;1424;30;4581.00;281
11628;23;22631635;11628;702;13050;13330;3.13;0.19;371.70;21.98;1422;30;4582.00;280
11633;23;22631650;11633;715;13050;13330;3.06;0.19;371.71;21.98;1417;30;4583.00;280
11635;23;22631665;11635;708;13053;13334;3.09;0.19;371.67;21.97;1418;30;4584.00;281
11639;23;22631683;11639;710;13054;13334;3.05;0.19;371.73;21.97;1415;30;4585.00;280
11643;23;22631699;11643;711;13054;13334;2.99;0.18;371.81;21.97;1411;30;4586.00;280
11648;23;22631715;11648;728;13055;13335;2.94;0.18;371.81;21.97;1407;30;4587.00;280
11649;23;22631730;11649;722;13058;13339;2.95;0.18;371.82;21.96;1409;30;4588.00;281
11652;23;22631746;11652;729;13058;13339;2.91;0.18;371.80;21.96;1406;30;4589.00;281
11652;23;22631766;11652;738;13062;13345;2.96;0.18;371.80;21.96;1410;30;4590.00;283
11654;23;22631781;11654;743;13062;13345;2.92;0.18;371.83;21.96;1408;30;4591.00;283
11654;23;22631796;11654;751;13064;13345;2.92;0.18;371.83;21.95;1410;30;4592.00;281
11660;23;22631809;11660;760;13064;13345;2.85;0.17;371.93;21.95;1404;30;4593.00;281
11663;23;22631824;11663;764;13069;13349;2.83;0.17;371.95;22.02;1406;30;4594.00;280
11664;23;22631839;11664;774;13069;13349;2.84;0.17;371.93;22.02;1405;30;4595.00;280
11667;23;22631858;11667;777;13069;13349;2.80;0.17;371.90;22.02;1402;30;4596.00;280
11669;23;22631878;11669;771;13069;13349;2.81;0.17;371.89;22.02;1400;30;4597.00;280
11674;23;22631895;11674;759;13069;13350;2.80;0.17;371.97;22.02;1395;30;4598.00;281
11678;23;22631910;11678;761;13070;13351;2.86;0.18;371.93;22.02;1392;30;4599.00;281
11678;23;22631927;11678;764;13070;13351;2.92;0.18;371.93;22.02;1392;30;4600.00;281
11680;23;22631946;11680;764;13071;13352;2.96;0.18;371.91;22.02;1391;30;4601.00;281
11680;23;22631962;11680;759;13071;13352;3.01;0.19;371.91;22.02;1391;30;4602.00;281
11680;23;22631976;11680;761;13071;13352;3.08;0.19;371.91;22.02;1391;30;4603.00;281
11681;23;22631991;11681;770;13071;13352;3.11;0.19;371.92;22.02;1390;30;4604.00;281
11683;23;22632010;11683;772;13071;13352;3.16;0.19;371.88;22.02;1388;31;4605.00;281
11683;23;22632039;11683;757;13071;13352;3.22;0.20;371.88;22.02;1388;31;4606.00;281
11685;23;22632060;11685;740;13071;13352;3.24;0.20;371.88;22.02;1386;31;4607.00;281
11686;23;22632077;11686;750;13137;13479;3.69;0.23;371.89;21.91;1451;31;4608.00;342
11689;23;22632102;11689;734;13139;13480;3.73;0.23;371.87;21.90;1450;31;4609.00;341
11694;23;22632119;11694;717;13148;13480;3.82;0.24;371.83;21.89;1454;31;4610.00;332
11695;23;22632135;11695;718;13151;13480;3.91;0.24;371.83;21.89;1456;31;4611.00;329
11698;23;22632151;11698;718;13157;13480;3.99;0.25;371.79;21.96;1459;31;4612.00;323
11698;23;22632167;11698;720;13159;13480;4.02;0.25;371.79;21.95;1461;31;4613.00;321
11701;23;22632192;11701;724;13162;13480;4.07;0.25;371.79;21.95;1461;31;4614.00;318
11704;23;22632208;11704;723;13165;13480;4.11;0.25;371.78;21.95;1461;31;4615.00;315
11707;23;22632224;11707;719;13167;13481;4.12;0.25;371.77;21.94;1460;31;4616.00;314
11711;23;22632250;11711;734;13171;13482;4.10;0.25;371.77;21.94;1460;31;4617.00;311
11714;23;22632285;11714;737;13173;13482;4.11;0.25;371.75;21.94;1459;31;4618.00;309
11714;23;22632305;11714;736;13176;13483;4.10;0.25;371.75;21.94;1462;31;4619.00;307
11716;23;22632329;11716;726;13178;13483;4.08;0.25;371.75;21.93;1462;31;4620.00;305
11716;23;22632350;11716;711;13180;13483;4.12;0.25;371.75;21.93;1464;31;4621.00;303
11720;23;22632369;11720;707;13184;13483;4.15;0.25;371.75;21.93;1464;31;4622.00;299
11722;23;22632389;11722;696;13188;13487;4.19;0.26;371.72;21.92;1466;31;4623.00;299
11722;23;22632412;11722;686;13188;13487;4.24;0.26;371.72;21.92;1466;31;4624.00;299
11722;23;22632438;11722;686;13188;13487;4.27;0.26;371.72;21.92;1466;31;4625.00;299
11724;23;22632462;11724;673;13191;13490;4.28;0.26;371.77;21.92;1467;31;4626.00;299
11727;23;22632499;11727;666;13192;13490;4.26;0.26;371.77;21.92;1465;31;4627.00;298
11727;23;22632526;11727;666;13193;13490;4.30;0.26;371.77;22.00;1466;31;4628.00;297
11730;23;22632550;11730;654;13198;13494;4.30;0.26;371.80;21.99;1468;31;4629.00;296
11730;23;22632572;11730;653;13200;13495;4.34;0.26;371.80;21.99;1470;31;4630.00;295
11730;23;22632593;11730;636;13200;13495;4.39;0.27;371.80;21.99;1470;31;4631.00;295
11732;23;22632613;11732;642;13202;13499;4.46;0.27;371.74;21.98;1470;31;4632.00;297
11735;23;22632638;11735;644;13202;13499;4.49;0.27;371.70;21.98;1467;31;4633.00;297
11735;23;22632659;11735;647;13202;13499;4.54;0.28;371.70;21.98;1467;31;4634.00;297
11735;23;22632679;11735;650;13204;13501;4.55;0.28;371.70;21.98;1469;31;4635.00;297
11737;23;22632698;11737;648;13204;13501;4.52;0.28;371.70;21.98;1467;31;4636.00;297
11738;23;22632717;11738;644;13208;13507;4.57;0.28;371.69;21.97;1470;31;4637.00;299
11739;23;22632737;11739;650;13208;13507;4.54;0.28;371.70;21.97;1469;31;4638.00;299
11740;23;22632755;11740;657;13208;13508;4.51;0.28;371.70;21.97;1468;31;4639.00;300
11743;23;22632772;11743;655;13208;13508;4.50;0.27;371.72;21.97;1465;31;4640.00;300
11746;23;22632791;11746;654;13208;13508;4.49;0.27;371.71;21.97;1462;31;4641.00;300
11746;23;22632811;11746;651;13208;13508;4.50;0.27;371.71;21.97;1462;31;4642.00;300
11747;23;22632828;11747;651;13208;13508;4.49;0.27;371.76;21.97;1461;31;4643.00;300
11752;23;22632847;11752;654;13218;13520;4.51;0.28;371.78;21.96;1466;31;4644.00;302
11753;23;22632867;11753;650;13219;13520;4.51;0.28;371.76;22.04;1466;31;4645.00;301
11754;23;22632885;11754;643;13220;13520;4.56;0.28;371.76;22.03;1466;31;4646.00;300
11757;23;22632905;11757;636;13220;13520;4.60;0.28;371.81;22.03;1463;31;4647.00;300
11760;23;22632924;11760;630;13220;13520;4.60;0.28;371.80;22.03;1460;31;4648.00;300
11764;23;22632944;11764;631;13221;13520;4.56;0.28;371.83;22.11;1457;31;4649.00;299
11765;23;22632964;11765;640;13226;13526;4.55;0.28;371.83;22.10;1461;31;4650.00;300
11768;23;22632982;11768;633;13226;13526;4.54;0.28;371.86;22.10;1458;31;4651.00;300
11771;23;22633000;11771;634;13229;13530;4.49;0.27;371.84;22.10;1458;31;4652.00;301
11772;23;22633022;11772;636;13230;13531;4.44;0.27;371.84;22.10;1458;31;4653.00;301
11776;23;22633040;11776;628;13231;13531;4.42;0.27;371.84;22.16;1455;31;4654.00;300
11779;23;22633064;11779;629;13231;13531;4.38;0.27;371.85;22.16;1452;31;4655.00;300
11782;23;22633082;11782;624;13241;13544;4.38;0.27;371.85;22.21;1459;31;4656.00;303
11787;23;22633102;11787;612;13242;13544;4.35;0.27;371.92;22.29;1455;31;4657.00;302
11788;23;22633120;11788;621;13242;13544;4.38;0.27;371.93;22.29;1454;31;4658.00;302
11791;23;22633139;11791;615;13245;13545;4.38;0.27;371.93;22.29;1454;31;4659.00;300
11794;23;22633157;11794;613;13245;13546;4.37;0.27;371.92;22.29;1451;31;4660.00;301
11795;23;22633175;11795;609;13245;13546;4.39;0.27;371.92;22.29;1450;31;4661.00;301
11796;23;22633194;11796;609;13247;13549;4.44;0.27;371.91;22.29;1451;31;4662.00;302
11801;23;22633215;11801;596;13249;13549;4.43;0.27;371.95;22.37;1448;31;4663.00;300
11806;23;22633236;11806;594;13249;13549;4.41;0.27;372.08;22.37;1443;31;4664.00;300
11808;23;22633257;11808;583;13249;13549;4.40;0.27;372.15;22.37;1441;31;4665.00;300
11812;23;22633275;11812;579;13253;13555;4.39;0.27;372.27;22.36;1441;31;4666.00;302
11816;23;22633300;11816;583;13254;13555;4.36;0.27;372.29;22.36;1438;31;4667.00;301
11820;23;22633322;11820;591;13254;13555;4.36;0.27;372.29;22.36;1434;31;4668.00;301
11824;23;22633342;11824;583;13255;13555;4.37;0.27;372.32;22.43;1431;31;4669.00;300
11825;23;22633361;11825;581;13258;13559;4.39;0.27;372.36;22.42;1433;31;4670.00;301
11827;23;22633390;11827;574;13259;13560;4.45;0.27;372.35;22.42;1432;31;4671.00;301
11828;23;22633411;11828;578;13261;13560;4.52;0.28;372.33;22.43;1433;31;4672.00;299
11828;23;22633429;11828;567;13263;13561;4.58;0.28;372.33;22.43;1435;31;4673.00;298
11831;23;22633448;11831;579;13263;13561;4.64;0.28;372.36;22.43;1432;31;4674.00;298
11832;23;22633468;11832;572;13266;13561;4.65;0.28;372.40;22.43;1434;31;4675.00;295
11837;23;22633487;11837;571;13266;13561;4.67;0.28;372.50;22.43;1429;31;4676.00;295
11841;23;22633504;11841;577;13268;13561;4.69;0.28;372.49;22.49;1427;31;4677.00;293
11846;23;22633524;11846;582;13268;13561;4.67;0.28;372.61;22.49;1422;31;4678.00;293
11848;23;22633576;11848;591;13268;13561;4.68;0.28;372.61;22.49;1420;31;4679.00;293
11851;23;22633602;11851;597;13320;13686;4.89;0.30;372.71;22.47;1469;31;4680.00;366
11852;23;22633632;11852;597;13324;13687;4.90;0.30;372.78;22.46;1472;31;4681.00;363
11854;23;22633652;11854;594;13336;13687;5.00;0.31;372.91;22.51;1482;31;4682.00;351
11856;23;22633670;11856;590;13341;13687;4.96;0.30;373.01;22.57;1485;31;4683.00;346
11859;23;22633691;11859;592;13346;13687;4.91;0.30;373.11;22.56;1487;31;4684.00;341
11859;23;22633712;11859;591;13350;13687;4.91;0.30;373.11;22.63;1491;31;4685.00;337
11865;23;22633732;11865;601;13356;13687;4.89;0.30;373.34;22.62;1491;31;4686.00;331
11867;23;22633753;11867;603;13359;13687;4.91;0.30;373.35;22.68;1492;31;4687.00;328
11870;23;22633772;11870;606;13365;13688;4.91;0.30;373.42;22.74;1495;31;4688.00;323
11871;23;22633791;11871;608;13372;13689;4.92;0.30;373.45;22.73;1501;31;4689.00;317
11875;23;22633812;11875;604;13376;13689;4.88;0.30;373.38;22.73;1501;31;4690.00;313
11878;23;22633834;11878;608;13382;13693;4.84;0.30;373.52;22.72;1504;31;4691.00;311
11883;23;22633871;11883;609;13385;13693;4.77;0.29;373.54;22.78;1502;31;4692.00;308
11885;23;22633904;11885;608;13386;13693;4.72;0.29;373.62;22.84;1501;31;4693.00;307
11887;23;22633930;11887;608;13386;13693;4.68;0.29;373.67;22.84;1499;31;4694.00;307
11889;23;22633950;11889;612;13392;13699;4.66;0.28;373.75;22.90;1503;31;4695.00;307
11892;23;22633972;11892;618;13392;13699;4.62;0.28;373.90;22.90;1500;31;4696.00;307
11895;23;22633995;11895;621;13393;13699;4.58;0.28;373.95;22.96;1498;31;4697.00;306
11897;23;22634018;11897;628;13396;13702;4.54;0.28;374.02;22.96;1499;31;4698.00;306
11899;23;22634042;11899;632;13397;13702;4.51;0.28;374.05;23.02;1498;31;4699.00;305
11902;23;22634069;11902;633;13397;13702;4.50;0.28;374.09;23.02;1495;31;4700.00;305
11905;23;22634097;11905;631;13397;13703;4.49;0.27;374.25;23.02;1492;31;4701.00;306
11905;23;22634120;11905;634;13400;13704;4.48;0.27;374.25;23.14;1495;31;4702.00;304
11906;23;22634143;11906;634;13400;13704;4.47;0.27;374.25;23.14;1494;31;4703.00;304
11908;23;22634168;11908;638;13409;13717;4.52;0.28;374.22;23.13;1501;31;4704.00;308
11908;23;22634192;11908;635;13413;13717;4.52;0.28;374.22;23.25;1505;31;4705.00;304
11913;23;22634214;11913;631;13413;13717;4.49;0.27;374.21;23.25;1500;31;4706.00;304
11914;23;22634234;11914;632;13414;13718;4.51;0.28;374.21;23.24;1500;31;4707.00;304
11920;23;22634256;11920;635;13416;13718;4.48;0.27;374.32;23.37;1496;31;4708.00;302
11922;23;22634275;11922;640;13420;13722;4.50;0.27;374.37;23.36;1498;31;4709.00;302
11924;23;22634295;11924;635;13420;13722;4.46;0.27;374.44;23.36;1496;31;4710.00;302
11927;23;22634315;11927;645;13425;13726;4.41;0.27;374.51;23.48;1498;31;4711.00;301
11931;23;22634339;11931;641;13425;13726;4.37;0.27;374.63;23.48;1494;31;4712.00;301
11935;23;22634362;11935;644;13427;13726;4.34;0.26;374.66;23.59;1492;31;4713.00;299
11940;23;22634394;11940;642;13427;13726;4.31;0.26;374.67;23.59;1487;31;4714.00;299
11945;23;22634417;11945;650;13429;13726;4.24;0.26;374.72;23.71;1484;31;4715.00;297
11947;23;22634449;11947;654;13438;13738;4.19;0.26;374.73;23.70;1491;31;4716.00;300
11951;23;22634479;11951;656;13438;13738;4.11;0.25;374.70;23.70;1487;31;4717.00;300
11953;23;22634514;11953;655;13442;13738;4.06;0.25;374.68;23.81;1489;31;4718.00;296
11956;23;22634553;11956;658;13442;13738;4.00;0.25;374.66;23.81;1486;31;4719.00;296
11959;23;22634581;11959;666;13442;13738;3.94;0.24;374.75;23.81;1483;31;4720.00;296
11960;23;22634617;11960;684;13444;13738;3.85;0.24;374.76;23.93;1484;31;4721.00;294
11966;23;22634641;11966;690;13444;13739;3.71;0.23;374.95;23.93;1478;31;4722.00;295
11968;23;22634671;11968;697;13444;13739;3.65;0.23;374.93;23.93;1476;31;4723.00;295
11971;24;22634698;11971;708;13449;13745;3.61;0.22;374.99;23.92;1478;32;4724.00;296
11973;24;22634749;11973;700;13451;13747;3.58;0.22;375.06;23.92;1478;32;4725.00;296
11975;24;22634770;11975;703;13451;13747;3.56;0.22;375.02;23.92;1476;32;4726.00;296
11980;24;22634791;11980;699;13451;13747;3.52;0.22;375.14;23.92;1471;32;4727.00;296
11982;24;22634811;11982;696;13454;13751;3.55;0.22;375.13;23.91;1472;32;4728.00;297
11984;24;22634833;11984;696;13454;13751;3.54;0.22;375.08;23.91;1470;32;4729.00;297
11990;24;22634851;11990;687;13454;13751;3.56;0.22;375.04;23.91;1464;32;4730.00;297
11994;24;22634868;11994;691;13455;13752;3.56;0.22;375.12;23.91;1461;32;4731.00;297
11997;24;22634887;11997;684;13458;13756;3.58;0.22;375.08;23.91;1461;32;4732.00;298
12000;24;22634932;12000;680;13458;13756;3.56;0.22;375.09;23.91;1458;32;4733.00;298
12004;24;22634951;12004;671;13460;13759;3.56;0.22;375.33;23.90;1456;32;4734.00;299
12009;24;22634971;12009;664;13460;13759;3.49;0.22;375.41;23.90;1451;32;4735.00;299
12011;24;22634992;12011;658;13461;13759;3.49;0.22;375.39;23.90;1450;32;4736.00;298
12016;24;22635015;12016;666;13461;13759;3.46;0.21;375.36;23.90;1445;32;4737.00;298
12021;24;22635039;12021;662;13465;13763;3.45;0.21;375.39;23.90;1444;32;4738.00;298
12023;24;22635062;12023;664;13465;13763;3.46;0.21;375.39;23.90;1442;32;4739.00;298
12027;24;22635090;12027;664;13465;13763;3.41;0.21;375.39;23.90;1438;32;4740.00;298
12030;24;22635117;12030;657;13465;13763;3.38;0.21;375.40;23.90;1435;32;4741.00;298
12033;24;22635138;12033;659;13465;13764;3.33;0.20;375.38;23.90;1432;32;4742.00;299
12034;24;22635159;12034;661;13466;13765;3.34;0.21;375.38;23.89;1432;32;4743.00;299
12041;24;22635182;12041;662;13466;13765;3.28;0.20;375.28;23.89;1425;32;4744.00;299
12044;24;22635210;12044;661;13467;13766;3.28;0.20;375.27;23.89;1423;32;4745.00;299
12047;24;22635234;12047;668;13467;13766;3.29;0.20;375.30;23.89;1420;32;4746.00;299
12050;24;22635254;12050;672;13467;13766;3.29;0.20;375.23;23.89;1417;32;4747.00;299
12053;24;22635272;12053;673;13467;13766;3.28;0.20;375.23;23.89;1414;32;4748.00;299
12059;24;22635290;12059;674;13467;13766;3.26;0.20;375.33;23.89;1408;32;4749.00;299
12064;24;22635311;12064;680;13467;13766;3.23;0.20;375.28;23.89;1403;32;4750.00;299
12068;24;22635338;12068;682;13467;13766;3.21;0.20;375.28;23.89;1399;32;4751.00;299
12071;24;22635361;12071;700;13538;13893;3.49;0.22;375.34;23.77;1467;32;4752.00;355
12077;24;22635400;12077;688;13539;13894;3.44;0.22;375.24;23.77;1462;32;4753.00;355
12079;24;22635421;12079;683;13546;13894;3.51;0.22;375.23;23.75;1467;32;4754.00;348
12082;24;22635442;12082;686;13550;13894;3.53;0.22;375.19;23.75;1468;32;4755.00;344
12086;24;22635462;12086;679;13556;13894;3.52;0.22;375.21;23.82;1470;32;4756.00;338
12088;24;22635489;12088;674;13559;13894;3.52;0.22;375.17;23.82;1471;32;4757.00;335
12092;24;22635513;12092;681;13561;13894;3.51;0.22;375.12;23.82;1469;32;4758.00;333
12096;24;22635536;12096;681;13565;13894;3.49;0.22;375.07;23.81;1469;32;4759.00;329
12100;24;22635560;12100;687;13566;13895;3.47;0.22;375.02;23.81;1466;32;4760.00;329
12101;24;22635589;12101;682;13567;13896;3.47;0.22;375.03;23.81;1466;32;4761.00;329
12104;24;22635619;12104;686;13569;13896;3.43;0.21;375.03;23.81;1465;32;4762.00;327
12106;24;22635647;12106;684;13572;13897;3.44;0.21;375.04;23.81;1466;32;4763.00;325
12108;24;22635669;12108;688;13574;13897;3.43;0.21;375.03;23.80;1466;32;4764.00;323
12108;24;22635690;12108;695;13577;13897;3.42;0.21;375.03;23.80;1469;32;4765.00;320
12112;24;22635716;12112;704;13579;13897;3.37;0.21;375.09;23.80;1467;32;4766.00;318
12112;24;22635735;12112;696;13582;13901;3.38;0.21;375.09;23.80;1470;32;4767.00;319
12116;24;22635754;12116;695;13585;13901;3.33;0.21;375.09;23.79;1469;32;4768.00;316
12119;24;22635773;12119;692;13586;13901;3.24;0.20;375.04;23.79;1467;32;4769.00;315
12120;24;22635798;12120;707;13589;13907;3.23;0.20;375.06;23.79;1469;32;4770.00;318
12121;24;22635827;12121;710;13590;13907;3.19;0.20;375.12;23.87;1469;32;4771.00;317
12124;24;22635850;12124;706;13593;13907;3.16;0.20;375.14;23.87;1469;32;4772.00;314
12127;24;22635870;12127;701;13598;13911;3.15;0.19;375.22;23.86;1471;32;4773.00;313
12130;24;22635893;12130;686;13600;13912;3.18;0.20;375.22;23.86;1470;32;4774.00;312
12132;24;22635922;12132;693;13601;13912;3.20;0.20;375.26;23.94;1469;32;4775.00;311
12135;24;22635947;12135;686;13606;13916;3.24;0.20;375.31;23.93;1471;32;4776.00;310
12138;24;22635969;12138;675;13606;13916;3.27;0.20;375.23;23.93;1468;32;4777.00;310
12140;24;22635991;12140;664;13607;13916;3.32;0.20;375.22;23.93;1467;32;4778.00;309
12142;24;22636016;12142;667;13607;13917;3.36;0.21;375.22;23.93;1465;32;4779.00;310
12142;24;22636045;12142;656;13608;13917;3.40;0.21;375.22;23.93;1466;32;4780.00;309
12142;24;22636082;12142;648;13613;13923;3.46;0.21;375.22;23.92;1471;32;4781.00;310
12143;24;22636117;12143;634;13613;13923;3.52;0.22;375.21;23.92;1470;32;4782.00;310
12146;24;22636153;12146;622;13613;13924;3.57;0.22;375.13;23.92;1467;32;4783.00;311
12148;24;22636196;12148;610;13613;13924;3.68;0.23;375.12;23.92;1465;32;4784.00;311
12151;24;22636223;12151;602;13613;13924;3.78;0.23;375.07;23.92;1462;32;4785.00;311
12152;24;22636252;12152;597;13613;13924;3.88;0.24;375.07;23.92;1461;32;4786.00;311
12155;24;22636275;12155;591;13614;13924;3.97;0.24;375.03;24.00;1459;32;4787.00;310
12155;24;22636299;12155;590;13624;13936;4.14;0.25;375.03;23.98;1469;32;4788.00;312
12155;24;22636335;12155;586;13624;13936;4.21;0.26;375.03;23.98;1469;32;4789.00;312
12155;24;22636367;12155;589;13625;13936;4.30;0.26;375.03;23.98;1470;32;4790.00;311
12155;24;22636396;12155;590;13625;13936;4.34;0.27;375.03;23.98;1470;32;4791.00;311
12157;24;22636421;12157;584;13625;13936;4.36;0.27;375.05;23.98;1468;32;4792.00;311
12162;24;22636449;12162;588;13625;13936;4.36;0.27;375.07;23.98;1463;32;4793.00;311
12165;24;22636491;12165;578;13628;13940;4.39;0.27;375.02;23.97;1463;32;4794.00;312
12166;24;22636520;12166;577;13628;13940;4.40;0.27;375.08;23.97;1462;32;4795.00;312
12167;24;22636552;12167;576;13632;13944;4.46;0.27;375.10;23.97;1465;32;4796.00;312
12169;24;22636588;12169;573;13633;13945;4.45;0.27;375.13;23.96;1464;32;4797.00;312
12172;24;22636616;12172;571;13633;13945;4.45;0.27;375.35;23.96;1461;32;4798.00;312
12173;24;22636638;12173;571;13633;13945;4.48;0.27;375.37;23.96;1460;32;4799.00;312
12175;24;22636667;12175;572;13657;13986;4.51;0.27;375.36;23.92;1482;32;4800.00;329
12177;24;22636712;12177;565;13657;13986;4.50;0.27;375.42;23.92;1480;32;4801.00;329
12180;24;22636738;12180;561;13658;13986;4.54;0.28;375.51;23.92;1478;32;4802.00;328
12186;24;22636779;12186;555;13661;13987;4.51;0.27;375.52;23.99;1475;32;4803.00;326
12187;24;22636822;12187;553;13662;13988;4.54;0.28;375.50;23.99;1475;32;4804.00;326
12190;24;22636856;12190;553;13662;13988;4.53;0.27;375.59;23.99;1472;32;4805.00;326
12191;24;22636884;12191;554;13666;13991;4.58;0.28;375.66;23.98;1475;32;4806.00;325
12193;24;22636917;12193;557;13666;13991;4.63;0.28;375.69;23.98;1473;32;4807.00;325
12196;24;22636941;12196;561;13666;13991;4.63;0.28;375.66;23.98;1470;32;4808.00;325
12197;24;22636969;12197;563;13667;13991;4.67;0.28;375.75;23.98;1470;32;4809.00;324
12198;24;22636992;12198;562;13672;13997;4.69;0.28;375.74;23.97;1474;32;4810.00;325
12200;24;22637024;12200;565;13672;13997;4.74;0.29;375.88;23.97;1472;32;4811.00;325
12202;24;22637055;12202;564;13672;13997;4.76;0.29;376.02;23.97;1470;32;4812.00;325
12204;24;22637090;12204;569;13672;13997;4.79;0.29;376.09;23.97;1468;32;4813.00;325
12208;24;22637118;12208;564;13676;14001;4.80;0.29;376.17;23.97;1468;32;4814.00;325
12209;24;22637146;12209;565;13678;14003;4.82;0.29;376.19;23.97;1469;32;4815.00;325
12210;24;22637172;12210;562;13678;14003;4.84;0.29;376.27;23.97;1468;32;4816.00;325
12214;25;22637196;12214;551;13679;14004;4.85;0.29;376.41;23.96;1465;33;4817.00;325
12218;25;22637245;12218;552;13679;14004;4.84;0.29;376.51;23.96;1461;33;4818.00;325
12220;25;22637273;12220;548;13679;14004;4.83;0.29;376.53;23.96;1459;33;4819.00;325
12222;25;22637305;12222;541;13680;14004;4.80;0.29;376.62;23.96;1458;33;4820.00;324
12224;25;22637332;12224;538;13680;14004;4.82;0.29;376.64;23.96;1456;33;4821.00;324
12227;25;22637356;12227;534;13680;14004;4.81;0.29;376.73;23.96;1453;33;4822.00;324
12230;25;22637383;12230;526;13680;14004;4.83;0.29;376.84;23.96;1450;33;4823.00;324
12232;25;22637404;12232;541;13719;14074;4.83;0.29;376.91;23.97;1487;33;4824.00;355
12236;25;22637434;12236;535;13722;14075;4.84;0.29;376.97;23.97;1486;33;4825.00;353
12238;25;22637456;12238;522;13725;14075;4.85;0.29;377.03;23.96;1487;33;4826.00;350
12243;25;22637482;12243;520;13727;14075;4.80;0.29;377.08;23.96;1484;33;4827.00;348
12245;25;22637506;12245;530;13730;14077;4.75;0.29;377.19;23.96;1485;33;4828.00;347
12249;25;22637534;12249;522;13732;14077;4.71;0.29;377.25;23.95;1483;33;4829.00;345
12253;25;22637560;12253;529;13736;14077;4.72;0.29;377.27;24.08;1483;33;4830.00;341
12255;25;22637608;12255;537;13740;14077;4.67;0.28;377.35;24.07;1485;33;4831.00;337
12260;25;22637639;12260;532;13741;14078;4.64;0.28;377.37;24.07;1481;33;4832.00;337
12262;25;22637668;12262;526;13744;14079;4.62;0.28;377.43;24.07;1482;33;4833.00;335
12264;25;22637703;12264;531;13745;14079;4.57;0.28;377.50;24.07;1481;33;4834.00;334
12266;25;22637729;12266;530;13746;14083;4.57;0.28;377.63;24.07;1480;33;4835.00;337
12270;25;22637761;12270;524;13746;14083;4.56;0.28;377.64;24.07;1476;33;4836.00;337
12274;25;22637786;12274;527;13747;14083;4.52;0.27;377.69;24.06;1473;33;4837.00;336
12275;25;22637818;12275;534;13747;14083;4.50;0.27;377.73;24.06;1472;33;4838.00;336
12277;25;22637847;12277;541;13750;14089;4.50;0.27;377.78;24.06;1473;33;4839.00;339
12280;25;22637875;12280;544;13750;14089;4.49;0.27;377.82;24.06;1470;33;4840.00;339
12282;25;22637901;12282;556;13750;14089;4.46;0.27;377.91;24.06;1468;33;4841.00;339
12285;25;22637924;12285;551;13751;14092;4.44;0.27;377.95;24.06;1466;33;4842.00;341
12287;25;22637952;12287;564;13751;14092;4.48;0.27;378.00;24.06;1464;33;4843.00;341
12289;25;22637983;12289;571;13752;14092;4.46;0.27;378.07;24.06;1463;33;4844.00;340
12292;25;22638007;12292;579;13752;14093;4.43;0.27;378.07;24.06;1460;33;4845.00;341
12294;25;22638041;12294;577;13753;14094;4.45;0.27;378.09;24.06;1459;33;4846.00;341
12297;25;22638073;12297;581;13754;14094;4.44;0.27;378.13;24.06;1457;33;4847.00;340
12303;25;22638105;12303;583;13761;14107;4.44;0.27;378.14;24.05;1458;33;4848.00;346
12306;25;22638141;12306;583;13762;14107;4.49;0.27;378.19;24.04;1456;33;4849.00;345
12308;25;22638176;12308;585;13763;14107;4.49;0.27;378.23;24.04;1455;33;4850.00;344
12309;25;22638205;12309;586;13763;14108;4.53;0.27;378.20;24.04;1454;33;4851.00;345
12311;25;22638232;12311;591;13763;14108;4.54;0.28;378.17;24.04;1452;33;4852.00;345
12315;25;22638254;12315;592;13769;14112;4.55;0.28;378.33;24.04;1454;33;4853.00;343
12316;25;22638283;12316;594;13769;14112;4.57;0.28;378.31;24.04;1453;33;4854.00;343
12319;25;22638307;12319;597;13771;14116;4.58;0.28;378.35;24.04;1452;33;4855.00;345
12320;25;22638332;12320;606;13771;14116;4.61;0.28;378.43;24.04;1451;33;4856.00;345
12321;25;22638371;12321;615;13771;14116;4.63;0.28;378.46;24.04;1450;33;4857.00;345
12326;25;22638400;12326;612;13771;14116;4.64;0.28;378.61;24.04;1445;33;4858.00;345
12328;25;22638424;12328;623;13771;14116;4.62;0.28;378.67;24.04;1443;33;4859.00;345
12328;25;22638453;12328;622;13791;14150;4.74;0.29;378.67;24.00;1463;33;4860.00;359
12330;25;22638482;12330;628;13791;14150;4.70;0.29;378.74;24.00;1461;33;4861.00;359
12334;25;22638508;12334;629;13792;14150;4.67;0.29;378.88;24.00;1458;33;4862.00;358
12337;25;22638536;12337;634;13792;14150;4.65;0.28;378.96;24.00;1455;33;4863.00;358
12339;25;22638567;12339;645;13793;14150;4.64;0.28;379.00;24.00;1454;33;4864.00;357
12344;25;22638605;12344;648;13793;14150;4.58;0.28;379.07;24.00;1449;33;4865.00;357
12349;25;22638645;12349;649;13793;14151;4.54;0.28;379.18;24.00;1444;33;4866.00;358
12349;25;22638669;12349;652;13793;14151;4.57;0.28;379.18;24.00;1444;33;4867.00;358
12352;25;22638690;12352;649;13797;14157;4.55;0.28;379.23;23.99;1445;33;4868.00;360
12356;25;22638714;12356;655;13797;14158;4.50;0.27;379.27;23.99;1441;33;4869.00;361
12356;25;22638740;12356;652;13797;14158;4.50;0.28;379.27;23.99;1441;33;4870.00;361
12361;25;22638767;12361;646;13797;14158;4.43;0.27;379.21;23.99;1436;33;4871.00;361
12366;25;22638795;12366;651;13800;14162;4.40;0.27;379.16;23.99;1434;33;4872.00;362
12368;25;22638819;12368;647;13800;14162;4.36;0.27;379.14;23.99;1432;33;4873.00;362
12370;25;22638850;12370;647;13800;14162;4.35;0.27;379.27;23.99;1430;33;4874.00;362
12372;25;22638876;12372;646;13801;14163;4.32;0.26;379.31;23.98;1429;33;4875.00;362
12375;25;22638903;12375;636;13802;14167;4.29;0.26;379.30;23.98;1427;33;4876.00;365
12378;25;22638939;12378;635;13802;14167;4.31;0.26;379.38;23.98;1424;33;4877.00;365
12378;25;22638978;12378;626;13803;14170;4.30;0.26;379.38;23.98;1425;33;4878.00;367
12379;25;22639001;12379;620;13803;14170;4.28;0.26;379.45;23.98;1424;33;4879.00;367
12381;25;22639022;12381;611;13803;14170;4.26;0.26;379.44;23.98;1422;33;4880.00;367
12385;25;22639040;12385;613;13803;14170;4.25;0.26;379.51;23.98;1418;33;4881.00;367
12386;25;22639058;12386;609;13806;14174;4.32;0.26;379.56;23.98;1420;33;4882.00;368
12390;25;22639078;12390;604;13806;14174;4.30;0.26;379.61;23.98;1416;33;4883.00;368
12393;25;22639098;12393;604;13806;14174;4.30;0.26;379.71;23.98;1413;33;4884.00;368
12396;25;22639116;12396;605;13806;14174;4.29;0.26;379.68;23.98;1410;33;4885.00;368
12398;25;22639136;12398;603;13806;14175;4.26;0.26;379.71;23.98;1408;33;4886.00;369
12401;25;22639153;12401;604;13806;14176;4.25;0.26;379.85;23.98;1405;33;4887.00;370
12402;25;22639172;12402;608;13806;14176;4.25;0.26;379.92;23.98;1404;33;4888.00;370
12404;25;22639188;12404;610;13807;14177;4.25;0.26;379.94;23.97;1403;33;4889.00;370
12410;25;22639206;12410;618;13807;14177;4.15;0.25;380.01;23.97;1397;33;4890.00;370
12411;25;22639224;12411;626;13807;14177;4.11;0.25;380.02;23.97;1396;33;4891.00;370
12418;25;22639244;12418;629;13807;14177;4.02;0.24;380.05;23.97;1389;33;4892.00;370
12421;25;22639267;12421;628;13807;14177;3.95;0.24;380.04;23.97;1386;33;4893.00;370
12425;25;22639287;12425;623;13807;14177;3.91;0.24;380.01;23.97;1382;33;4894.00;370
12428;25;22639306;12428;631;13809;14177;3.81;0.23;380.07;23.98;1381;33;4895.00;368
12429;25;22639325;12429;644;13864;14304;4.03;0.25;380.07;23.88;1435;33;4896.00;440
12434;25;22639355;12434;647;13868;14305;3.94;0.24;380.05;23.88;1434;33;4897.00;437
12436;25;22639373;12436;647;13877;14305;3.92;0.24;380.02;23.86;1441;33;4898.00;428
12437;25;22639391;12437;646;13878;14305;3.86;0.24;380.09;23.86;1441;33;4899.00;427
12439;25;22639415;12439;636;13883;14305;3.85;0.24;380.06;23.86;1444;33;4900.00;422
12440;25;22639440;12440;629;13884;14305;3.81;0.24;380.04;23.85;1444;33;4901.00;421
12445;25;22639465;12445;623;13886;14305;3.73;0.23;380.02;23.85;1441;33;4902.00;419
12446;25;22639484;12446;632;13889;14305;3.76;0.23;380.01;23.85;1443;33;4903.00;416
12449;25;22639500;12449;636;13891;14306;3.76;0.23;379.97;23.85;1442;33;4904.00;415
12454;25;22639518;12454;638;13893;14308;3.71;0.23;379.96;23.84;1439;33;4905.00;415
12458;25;22639536;12458;637;13894;14308;3.66;0.23;379.95;23.84;1436;33;4906.00;414
12459;25;22639560;12459;644;13895;14309;3.67;0.23;379.95;23.84;1436;33;4907.00;414
12463;25;22639580;12463;642;13897;14309;3.64;0.23;380.02;23.84;1434;33;4908.00;412
12467;25;22639601;12467;644;13898;14309;3.59;0.22;379.92;23.84;1431;33;4909.00;411
12470;25;22639624;12470;648;13899;14309;3.58;0.22;379.88;23.84;1429;33;4910.00;410
12471;25;22639644;12471;646;13901;14313;3.57;0.22;379.88;23.83;1430;33;4911.00;412
12475;25;22639666;12475;653;13903;14313;3.54;0.22;379.80;23.83;1428;33;4912.00;410
12479;25;22639683;12479;660;13903;14313;3.52;0.22;379.74;23.83;1424;33;4913.00;410
12483;25;22639712;12483;657;13904;14316;3.51;0.22;379.70;23.83;1421;33;4914.00;412
12485;25;22639731;12485;650;13904;14316;3.52;0.22;379.67;23.83;1419;33;4915.00;412
12487;25;22639750;12487;656;13904;14316;3.54;0.22;379.67;23.83;1417;33;4916.00;412
12491;25;22639767;12491;652;13905;14320;3.52;0.22;379.72;23.83;1414;33;4917.00;415
12493;25;22639785;12493;650;13906;14321;3.52;0.22;379.66;23.83;1413;33;4918.00;415
12496;25;22639802;12496;654;13907;14321;3.53;0.22;379.66;23.83;1411;33;4919.00;414
12500;25;22639820;12500;650;13911;14326;3.52;0.22;379.70;23.83;1411;33;4920.00;415
12503;25;22639841;12503;654;13911;14326;3.51;0.21;379.70;23.83;1408;33;4921.00;415
12505;25;22639858;12505;659;13911;14326;3.50;0.21;379.72;23.83;1406;33;4922.00;415
12508;25;22639878;12508;653;13911;14327;3.53;0.22;379.68;23.83;1403;33;4923.00;416
12512;25;22639897;12512;658;13911;14327;3.54;0.22;379.73;23.83;1399;33;4924.00;416
12514;25;22639917;12514;664;13915;14333;3.57;0.22;379.70;23.82;1401;33;4925.00;418
12517;25;22639933;12517;664;13918;14333;3.56;0.22;379.75;23.91;1401;33;4926.00;415
12521;25;22639951;12521;669;13918;14334;3.53;0.22;379.70;23.91;1397;33;4927.00;416
12524;25;22639968;12524;670;13918;14334;3.51;0.21;379.72;23.91;1394;33;4928.00;416
12527;25;22639987;12527;671;13919;14334;3.51;0.21;379.68;23.92;1392;33;4929.00;415
12529;25;22640009;12529;677;13920;14334;3.49;0.21;379.66;23.92;1391;33;4930.00;414
12533;25;22640035;12533;679;13920;14334;3.47;0.21;379.60;23.92;1387;33;4931.00;414
12536;25;22640052;12536;684;13928;14346;3.48;0.21;379.63;23.92;1392;33;4932.00;418
12539;25;22640083;12539;689;13929;14346;3.43;0.21;379.65;23.92;1390;33;4933.00;417
12540;25;22640117;12540;682;13933;14346;3.41;0.21;379.65;23.94;1393;33;4934.00;413
12544;25;22640135;12544;673;13935;14346;3.44;0.21;379.67;23.95;1391;33;4935.00;411
12548;25;22640155;12548;674;13936;14346;3.43;0.21;379.68;23.95;1388;33;4936.00;410
12551;25;22640175;12551;667;13937;14346;3.45;0.21;379.69;23.96;1386;33;4937.00;409
12552;25;22640196;12552;660;13938;14350;3.50;0.21;379.69;23.95;1386;33;4938.00;412
12556;25;22640220;12556;662;13941;14350;3.50;0.21;379.66;23.97;1385;33;4939.00;409
12558;25;22640240;12558;661;13945;14354;3.54;0.21;379.65;23.97;1387;33;4940.00;409
12559;25;22640262;12559;661;13947;14355;3.59;0.22;379.62;23.97;1388;33;4941.00;408
12561;25;22640292;12561;670;13949;14355;3.60;0.22;379.62;23.98;1388;33;4942.00;406
12561;25;22640315;12561;657;13950;14355;3.65;0.22;379.62;23.99;1389;33;4943.00;405
12563;25;22640342;12563;664;13961;14368;3.78;0.23;379.69;23.97;1398;33;4944.00;407
12565;26;22640371;12565;662;13962;14368;3.78;0.23;379.67;23.98;1397;34;4945.00;406
12567;27;22640406;12567;664;13964;14368;3.77;0.23;379.72;23.98;1397;35;4946.00;404
12569;27;22640448;12569;649;13966;14369;3.82;0.23;379.69;23.99;1397;35;4947.00;403
12572;27;22640484;12572;644;13966;14370;3.80;0.23;379.74;23.99;1394;35;4948.00;404
12572;27;22640527;12572;638;13967;14370;3.84;0.23;379.74;23.99;1395;35;4949.00;403
12574;27;22640550;12574;632;13972;14379;3.84;0.23;379.78;23.99;1398;35;4950.00;407
12575;27;22640570;12575;627;13972;14379;3.85;0.23;379.77;23.99;1397;35;4951.00;407
12576;27;22640599;12576;629;13973;14379;3.86;0.23;379.74;23.98;1397;35;4952.00;406
12577;27;22640616;12577;633;13974;14379;3.86;0.23;379.79;23.99;1397;35;4953.00;405
12578;27;22640634;12578;631;13978;14385;3.83;0.23;379.86;23.98;1400;35;4954.00;407
12579;27;22640663;12579;639;13980;14385;3.84;0.23;379.84;23.98;1401;35;4955.00;405
12579;27;22640682;12579;629;13980;14385;3.88;0.24;379.84;23.98;1401;36;4956.00;405
12579;27;22640713;12579;610;13980;14385;3.95;0.24;379.84;23.98;1401;36;4957.00;405
12580;27;22640730;12580;605;13985;14389;3.98;0.24;379.81;23.99;1405;36;4958.00;404
12583;27;22640751;12583;604;13985;14390;4.05;0.25;379.86;23.99;1402;36;4959.00;405
12585;27;22640771;12585;599;13987;14390;4.11;0.25;379.94;24.07;1402;36;4960.00;403
12587;27;22640789;12587;586;13988;14391;4.19;0.26;379.93;24.07;1401;36;4961.00;403
12591;27;22640810;12591;569;13990;14391;4.21;0.26;380.03;24.08;1399;36;4962.00;401
12591;27;22640835;12591;565;13990;14391;4.27;0.26;380.03;24.08;1399;36;4963.00;401
12593;27;22640856;12593;561;13990;14391;4.32;0.26;380.13;24.08;1397;36;4964.00;401
12596;27;22640882;12596;564;13991;14391;4.35;0.26;380.17;24.08;1395;36;4965.00;400
12599;27;22640907;12599;571;13992;14391;4.36;0.26;380.28;24.08;1393;36;4966.00;399
12603;27;22640927;12603;567;13992;14391;4.42;0.27;380.40;24.08;1389;36;4967.00;399
12603;27;22640951;12603;577;14032;14461;4.47;0.27;380.40;24.02;1429;36;4968.00;429
12606;27;22640982;12606;572;14032;14462;4.49;0.27;380.39;24.02;1426;36;4969.00;430
12610;27;22641001;12610;571;14036;14462;4.58;0.28;380.55;24.02;1426;36;4970.00;426
12612;27;22641023;12612;562;14038;14462;4.66;0.28;380.58;24.01;1426;36;4971.00;424
12615;27;22641044;12615;560;14041;14462;4.72;0.29;380.56;24.01;1426;36;4972.00;421
12615;27;22641063;12615;552;14044;14462;4.78;0.29;380.56;24.09;1429;36;4973.00;418
12621;27;22641082;12621;563;14048;14462;4.83;0.29;380.71;24.09;1427;36;4974.00;414
12624;27;22641101;12624;570;14050;14462;4.84;0.29;380.75;24.10;1426;36;4975.00;412
12626;27;22641119;12626;574;14051;14463;4.86;0.30;380.74;24.10;1425;36;4976.00;412
12629;27;22641148;12629;583;14052;14464;4.87;0.30;380.83;24.09;1423;36;4977.00;412
12631;27;22641170;12631;592;14053;14464;4.86;0.30;380.89;24.10;1422;36;4978.00;411
12633;27;22641193;12633;600;14054;14468;4.88;0.30;380.92;24.10;1421;36;4979.00;414
12637;27;22641227;12637;615;14055;14468;4.88;0.30;380.98;24.10;1418;36;4980.00;413
12641;27;22641250;12641;619;14056;14468;4.83;0.29;381.04;24.11;1415;36;4981.00;412
12641;27;22641281;12641;623;14056;14468;4.80;0.29;381.04;24.11;1415;36;4982.00;412
12644;27;22641302;12644;623;14062;14474;4.75;0.29;381.06;24.11;1418;36;4983.00;412
12647;27;22641320;12647;627;14062;14474;4.71;0.29;381.20;24.11;1415;36;4984.00;412
12647;27;22641337;12647;626;14062;14474;4.69;0.29;381.20;24.11;1415;36;4985.00;412
12648;27;22641355;12648;623;14063;14477;4.69;0.29;381.25;24.11;1415;36;4986.00;414
12653;27;22641374;12653;634;14064;14477;4.62;0.28;381.43;24.11;1411;36;4987.00;413
12654;27;22641397;12654;635;14064;14477;4.60;0.28;381.41;24.11;1410;36;4988.00;413
12654;27;22641416;12654;634;14064;14478;4.60;0.28;381.41;24.11;1410;36;4989.00;414
12654;27;22641434;12654;633;14066;14479;4.65;0.28;381.41;24.11;1412;36;4990.00;413
12658;27;22641456;12658;620;14067;14479;4.64;0.28;381.48;24.19;1409;36;4991.00;412
12659;27;22641478;12659;619;14076;14492;4.66;0.28;381.45;24.18;1417;36;4992.00;416
12662;27;22641496;12662;606;14078;14492;4.71;0.29;381.55;24.18;1416;36;4993.00;414
12662;27;22641514;12662;597;14078;14492;4.77;0.29;381.55;24.18;1416;36;4994.00;414
12665;27;22641532;12665;587;14078;14494;4.80;0.29;381.58;24.18;1413;36;4995.00;416
12668;27;22641550;12668;574;14080;14494;4.83;0.29;381.62;24.33;1412;37;4996.00;414
12670;27;22641581;12670;573;14083;14498;4.89;0.30;381.68;24.33;1413;37;4997.00;415
12673;27;22641600;12673;560;14083;14498;4.95;0.30;381.83;24.33;1410;37;4998.00;415
12678;27;22641620;12678;551;14084;14502;4.95;0.30;381.95;24.32;1406;37;4999.00;418
12681;27;22641641;12681;548;14084;14502;4.96;0.30;382.02;24.32;1403;37;5000.00;418
12683;27;22641664;12683;546;14084;14502;4.99;0.30;382.08;24.32;1401;37;5001.00;418
12689;27;22641687;12689;538;14084;14502;5.01;0.30;382.09;24.32;1395;37;5002.00;418
12693;27;22641711;12693;537;14084;14502;5.01;0.30;382.15;24.32;1391;37;5003.00;418
12694;27;22641742;12694;526;14091;14514;5.03;0.31;382.16;24.31;1397;37;5004.00;423
12697;27;22641768;12697;524;14091;14514;4.99;0.30;382.16;24.31;1394;37;5005.00;423
12703;27;22641789;12703;518;14092;14514;4.94;0.30;382.30;24.31;1389;37;5006.00;422
12703;27;22641811;12703;508;14092;14514;4.93;0.30;382.30;24.31;1389;37;5007.00;422
12709;27;22641833;12709;502;14093;14514;4.90;0.30;382.29;24.39;1384;37;5008.00;421
12710;27;22641868;12710;509;14093;14514;4.92;0.30;382.29;24.39;1383;37;5009.00;421
12713;27;22641890;12713;504;14094;14515;4.93;0.30;382.31;24.39;1381;37;5010.00;421
12715;27;22641908;12715;505;14095;14515;4.98;0.30;382.30;24.40;1380;37;5011.00;420
12718;27;22641935;12718;512;14099;14521;5.01;0.30;382.37;24.39;1381;37;5012.00;422
12720;27;22641953;12720;507;14099;14522;5.03;0.31;382.44;24.39;1379;37;5013.00;423
12721;27;22641979;12721;505;14099;14522;5.01;0.30;382.44;24.39;1378;37;5014.00;423
12724;27;22641997;12724;510;14099;14522;5.01;0.30;382.54;24.39;1375;37;5015.00;423
12728;27;22642030;12728;504;14102;14526;5.02;0.30;382.51;24.39;1374;37;5016.00;424
12732;27;22642071;12732;512;14102;14526;4.98;0.30;382.56;24.39;1370;37;5017.00;424
12735;27;22642111;12735;502;14102;14526;4.98;0.30;382.58;24.39;1367;37;5018.00;424
12740;27;22642144;12740;504;14103;14527;4.97;0.30;382.62;24.38;1363;37;5019.00;424
12742;27;22642169;12742;505;14104;14531;4.94;0.30;382.61;24.38;1362;37;5020.00;427
12742;27;22642201;12742;507;14104;14531;5.00;0.30;382.61;24.38;1362;37;5021.00;427
12748;27;22642220;12748;517;14105;14534;4.99;0.30;382.65;24.38;1357;37;5022.00;429
12748;27;22642244;12748;517;14105;14534;4.99;0.30;382.65;24.38;1357;37;5023.00;429
12751;27;22642266;12751;525;14105;14534;4.99;0.30;382.71;24.38;1354;37;5024.00;429
12753;27;22642289;12753;525;14105;14534;4.97;0.30;382.73;24.38;1352;37;5025.00;429
12755;27;22642312;12755;529;14108;14538;4.95;0.30;382.77;24.38;1353;37;5026.00;430
12758;27;22642333;12758;531;14108;14538;4.93;0.30;382.80;24.38;1350;37;5027.00;430
12760;27;22642356;12760;536;14108;14538;4.89;0.30;382.85;24.38;1348;37;5028.00;430
12761;27;22642377;12761;541;14108;14538;4.84;0.30;382.85;24.38;1347;37;5029.00;430
12763;27;22642396;12763;544;14108;14539;4.78;0.29;382.87;24.38;1345;37;5030.00;431
12766;27;22642415;12766;549;14108;14540;4.75;0.29;382.90;24.38;1342;37;5031.00;432
12769;27;22642445;12769;553;14108;14540;4.68;0.29;382.93;24.38;1339;37;5032.00;432
12769;27;22642471;12769;557;14109;14541;4.68;0.29;382.93;24.37;1340;37;5033.00;432
12769;27;22642496;12769;561;14109;14541;4.67;0.29;382.93;24.37;1340;37;5034.00;432
12772;27;22642518;12772;562;14109;14541;4.64;0.28;382.90;24.37;1337;37;5035.00;432
12774;27;22642540;12774;564;14109;14541;4.64;0.28;382.93;24.37;1335;37;5036.00;432
12776;27;22642562;12776;562;14109;14541;4.64;0.28;382.94;24.37;1333;37;5037.00;432
12780;27;22642579;12780;565;14109;14541;4.61;0.28;382.98;24.37;1329;37;5038.00;432
12782;27;22642599;12782;572;14109;14541;4.64;0.28;383.06;24.37;1327;37;5039.00;432
12784;27;22642627;12784;587;14188;14771;5.00;0.31;383.15;24.24;1404;37;5040.00;583
12787;27;22642668;12787;588;14194;14772;4.99;0.31;383.16;24.23;1407;37;5041.00;578
12789;27;22642687;12789;588;14203;14772;5.03;0.32;383.15;24.21;1414;37;5042.00;569
12791;27;22642707;12791;587;14208;14772;5.06;0.32;383.27;24.21;1417;37;5043.00;564
12794;27;22642727;12794;581;14217;14772;5.03;0.31;383.36;24.19;1423;37;5044.00;555
12795;28;22642753;12795;578;14223;14772;5.06;0.32;383.44;24.19;1428;38;5045.00;549
12798;28;22642805;12798;577;14230;14772;5.06;0.32;383.50;24.18;1432;38;5046.00;542
12802;28;22642827;12802;576;14234;14772;5.03;0.31;383.50;24.17;1432;38;5047.00;538
12804;28;22642845;12804;572;14240;14773;5.00;0.31;383.59;24.17;1436;38;5048.00;533
12808;28;22642863;12808;568;14245;14774;4.98;0.31;383.68;24.16;1437;38;5049.00;529
12809;28;22642881;12809;566;14248;14774;4.94;0.31;383.68;24.16;1439;38;5050.00;526
12813;28;22642900;12813;569;14248;14775;4.88;0.30;383.80;24.16;1435;38;5051.00;527
12817;28;22642918;12817;568;14253;14775;4.85;0.30;383.77;24.15;1436;38;5052.00;522
12819;28;22642946;12819;561;14255;14775;4.81;0.30;383.72;24.15;1436;38;5053.00;520
12823;28;22642964;12823;560;14257;14775;4.78;0.30;383.79;24.15;1434;38;5054.00;518
12826;28;22642983;12826;568;14261;14779;4.76;0.29;383.81;24.14;1435;38;5055.00;518
12828;28;22643005;12828;561;14262;14779;4.71;0.29;383.83;24.14;1434;38;5056.00;517
12830;28;22643043;12830;572;14264;14779;4.75;0.29;383.84;24.14;1434;38;5057.00;515
12832;28;22643064;12832;577;14265;14782;4.77;0.29;383.83;24.14;1433;38;5058.00;517
12833;28;22643086;12833;580;14267;14782;4.78;0.29;383.82;24.14;1434;38;5059.00;515
12837;28;22643108;12837;586;14267;14782;4.79;0.29;383.82;24.14;1430;38;5060.00;515
12839;28;22643130;12839;581;14268;14786;4.80;0.30;383.87;24.14;1429;38;5061.00;518
12846;28;22643148;12846;581;14271;14787;4.77;0.29;383.90;24.14;1425;38;5062.00;516
12849;28;22643169;12849;588;14273;14787;4.75;0.29;383.96;24.14;1424;38;5063.00;514
12852;28;22643191;12852;591;14276;14791;4.77;0.29;383.93;24.13;1424;38;5064.00;515
12856;28;22643211;12856;593;14276;14791;4.72;0.29;383.95;24.13;1420;38;5065.00;515
12861;28;22643234;12861;607;14277;14791;4.69;0.29;383.96;24.13;1416;38;5066.00;514
12862;28;22643261;12862;610;14279;14792;4.62;0.28;383.95;24.13;1417;38;5067.00;513
12865;28;22643280;12865;620;14280;14792;4.56;0.28;383.97;24.13;1415;38;5068.00;512
12871;28;22643310;12871;614;14285;14798;4.52;0.28;383.98;24.13;1414;38;5069.00;513
12874;28;22643340;12874;616;14286;14798;4.48;0.27;383.92;24.14;1412;38;5070.00;512
12876;28;22643369;12876;621;14287;14799;4.40;0.27;383.89;24.14;1411;38;5071.00;512
12877;28;22643388;12877;627;14287;14799;4.30;0.26;383.86;24.14;1410;38;5072.00;512
12881;28;22643405;12881;635;14287;14799;4.17;0.26;383.91;24.14;1406;38;5073.00;512
12884;28;22643422;12884;635;14287;14799;4.05;0.25;383.86;24.14;1403;38;5074.00;512
12887;28;22643439;12887;625;14287;14799;3.96;0.24;383.91;24.14;1400;38;5075.00;512
12890;28;22643457;12890;623;14295;14811;3.95;0.24;383.94;24.12;1405;38;5076.00;516
12892;28;22643479;12892;620;14295;14811;3.90;0.24;383.95;24.12;1403;38;5077.00;516
12895;28;22643501;12895;616;14295;14811;3.86;0.24;383.97;24.12;1400;38;5078.00;516
12900;28;22643516;12900;621;14295;14811;3.82;0.24;384.00;24.12;1395;38;5079.00;516
12902;28;22643532;12902;625;14295;14811;3.84;0.24;384.00;24.12;1393;38;5080.00;516
12904;28;22643552;12904;625;14295;14811;3.84;0.24;383.98;24.12;1391;38;5081.00;516
12908;28;22643567;12908;621;14296;14815;3.86;0.24;384.06;24.12;1388;38;5082.00;519
12912;28;22643583;12912;615;14296;14815;3.84;0.24;384.12;24.12;1384;38;5083.00;519
12915;28;22643601;12915;612;14299;14819;3.84;0.24;384.14;24.12;1384;38;5084.00;520
12918;28;22643619;12918;602;14299;14821;3.78;0.23;384.14;24.12;1381;38;5085.00;522
12923;28;22643635;12923;601;14299;14821;3.76;0.23;384.13;24.12;1376;38;5086.00;522
12926;28;22643650;12926;609;14299;14821;3.76;0.23;384.10;24.12;1373;38;5087.00;522
12931;28;22643665;12931;607;14309;14834;3.77;0.23;384.14;24.10;1378;38;5088.00;525
12935;28;22643681;12935;605;14309;14834;3.75;0.23;384.10;24.10;1374;38;5089.00;525
12937;28;22643696;12937;601;14309;14834;3.73;0.23;384.08;24.10;1372;38;5090.00;525
12941;28;22643711;12941;593;14310;14835;3.77;0.23;384.12;24.10;1369;38;5091.00;525
12944;28;22643728;12944;585;14310;14836;3.82;0.23;384.10;24.10;1366;38;5092.00;526
12947;28;22643746;12947;575;14310;14836;3.85;0.24;384.11;24.10;1363;38;5093.00;526
12952;28;22643763;12952;562;14311;14839;3.87;0.24;384.09;24.10;1359;38;5094.00;528
12955;28;22643782;12955;558;14311;14839;3.93;0.24;384.07;24.10;1356;38;5095.00;528
12958;28;22643798;12958;554;14312;14839;3.96;0.24;384.09;24.11;1354;38;5096.00;527
12961;28;22643815;12961;552;14312;14839;3.96;0.24;384.10;24.11;1351;38;5097.00;527
12964;28;22643830;12964;550;14317;14845;4.01;0.24;384.12;24.11;1353;38;5098.00;528
12966;28;22643851;12966;545;14319;14845;4.06;0.25;384.10;24.13;1353;38;5099.00;526
12968;28;22643878;12968;551;14323;14864;4.06;0.25;384.07;24.13;1355;38;5100.00;541
12971;28;22643903;12971;549;14325;14864;4.12;0.25;384.05;24.15;1354;38;5101.00;539
12973;28;22643919;12973;558;14327;14868;4.15;0.25;384.03;24.16;1354;38;5102.00;541
12975;28;22643935;12975;556;14329;14869;4.15;0.25;384.01;24.18;1354;38;5103.00;540
12978;28;22643951;12978;555;14330;14869;4.15;0.25;384.03;24.19;1352;38;5104.00;539
12981;28;22643968;12981;555;14333;14870;4.13;0.25;384.00;24.21;1352;38;5105.00;537
12982;28;22643985;12982;561;14338;14870;4.11;0.25;384.01;24.23;1356;38;5106.00;532
12985;28;22644001;12985;562;14338;14870;4.10;0.25;383.97;24.23;1353;38;5107.00;532
12987;28;22644019;12987;563;14342;14870;4.12;0.25;383.98;24.27;1355;38;5108.00;528
12990;28;22644038;12990;551;14343;14870;4.11;0.25;383.93;24.28;1353;38;5109.00;527
12995;28;22644054;12995;557;14347;14870;4.11;0.25;383.93;24.32;1352;38;5110.00;523
12999;28;22644071;12999;564;14348;14870;4.16;0.25;383.88;24.31;1349;38;5111.00;522
13002;28;22644087;13002;573;14382;14940;4.29;0.26;383.92;24.29;1380;38;5112.00;558
13007;28;22644108;13007;556;14384;14941;4.33;0.26;383.89;24.30;1377;38;5113.00;557
13009;28;22644126;13009;559;14391;14941;4.39;0.27;383.93;24.31;1382;38;5114.00;550
13016;28;22644143;13016;550;14398;14941;4.41;0.27;384.07;24.34;1382;38;5115.00;543
13018;28;22644163;13018;539;14400;14941;4.45;0.27;384.08;24.33;1382;38;5116.00;541
13022;28;22644179;13022;542;14405;14941;4.45;0.27;384.08;24.36;1383;38;5117.00;536
13026;28;22644196;13026;551;14407;14941;4.45;0.27;384.14;24.36;1381;38;5118.00;534
13029;28;22644211;13029;544;14412;14941;4.45;0.27;384.18;24.39;1383;38;5119.00;529
13031;28;22644227;13031;543;14413;14942;4.39;0.27;384.24;24.39;1382;38;5120.00;529
13033;28;22644243;13033;551;14418;14943;4.33;0.26;384.37;24.42;1385;38;5121.00;525
13035;28;22644260;13035;544;14422;14943;4.29;0.26;384.43;24.42;1387;38;5122.00;521
13035;28;22644276;13035;535;14425;14947;4.25;0.26;384.43;24.43;1390;38;5123.00;522
13037;28;22644292;13037;538;14428;14947;4.26;0.26;384.50;24.44;1391;38;5124.00;519
13038;28;22644308;13038;521;14429;14947;4.28;0.26;384.59;24.44;1391;38;5125.00;518
13040;28;22644325;13040;530;14430;14947;4.27;0.26;384.69;24.53;1390;38;5126.00;517
13043;28;22644342;13043;529;14438;14953;4.26;0.26;384.83;24.56;1395;38;5127.00;515
13045;28;22644358;13045;528;14439;14953;4.27;0.26;384.84;24.56;1394;38;5128.00;514
13047;28;22644374;13047;544;14441;14953;4.32;0.26;384.84;24.57;1394;38;5129.00;512
13051;28;22644392;13051;547;14444;14959;4.33;0.26;384.81;24.58;1393;38;5130.00;515
13052;28;22644410;13052;527;14446;14959;4.32;0.26;384.79;24.59;1394;38;5131.00;513
13054;28;22644426;13054;515;14451;14959;4.38;0.27;384.92;24.61;1397;38;5132.00;508
13057;28;22644451;13057;507;14454;14960;4.41;0.27;384.95;24.62;1397;38;5133.00;506
13058;28;22644473;13058;504;14458;14961;4.42;0.27;385.00;24.63;1400;39;5134.00;503
13061;28;22644503;13061;501;14461;14961;4.43;0.27;385.04;24.64;1400;39;5135.00;500
13063;28;22644524;13063;501;14471;14974;4.53;0.28;385.19;24.63;1408;39;5136.00;503
13064;28;22644544;13064;501;14473;14974;4.56;0.28;385.18;24.64;1409;39;5137.00;501
13070;28;22644562;13070;499;14476;14974;4.53;0.27;385.31;24.65;1406;39;5138.00;498
13070;28;22644580;13070;507;14479;14975;4.55;0.28;385.31;24.67;1409;39;5139.00;496
13073;28;22644597;13073;509;14484;14975;4.56;0.28;385.33;24.68;1411;39;5140.00;491
13075;28;22644614;13075;514;14487;14979;4.59;0.28;385.33;24.68;1412;39;5141.00;492
13077;28;22644632;13077;504;14491;14979;4.60;0.28;385.39;24.69;1414;39;5142.00;488
13080;28;22644650;13080;506;14494;14983;4.60;0.28;385.37;24.69;1414;39;5143.00;489
13083;28;22644668;13083;502;14496;14983;4.56;0.28;385.38;24.70;1413;39;5144.00;487
13084;28;22644685;13084;501;14499;14983;4.57;0.28;385.46;24.72;1415;39;5145.00;484
13088;28;22644702;13088;500;14499;14983;4.57;0.28;385.46;24.72;1411;39;5146.00;484
13091;28;22644719;13091;503;14503;14983;4.60;0.28;385.61;24.74;1412;39;5147.00;480
13094;28;22644736;13094;501;14512;14995;4.67;0.28;385.60;24.73;1418;39;5148.00;483
13097;28;22644756;13097;499;14514;14995;4.70;0.28;385.59;24.73;1417;39;5149.00;481
13099;28;22644773;13099;501;14515;14995;4.71;0.29;385.63;24.74;1416;39;5150.00;480
13101;28;22644790;13101;502;14518;14995;4.73;0.29;385.65;24.75;1417;39;5151.00;477
13103;28;22644807;13103;508;14518;14995;4.74;0.29;385.68;24.75;1415;39;5152.00;477
13105;28;22644824;13105;502;14520;14995;4.72;0.29;385.67;24.77;1415;39;5153.00;475
13107;28;22644840;13107;508;14523;14996;4.71;0.29;385.72;24.85;1416;39;5154.00;473
13110;28;22644859;13110;507;14526;14998;4.69;0.28;385.79;24.85;1416;39;5155.00;472
13111;28;22644877;13111;508;14530;15004;4.70;0.29;385.83;24.85;1419;39;5156.00;474
13115;28;22644895;13115;507;14530;15005;4.70;0.28;385.84;24.85;1415;39;5157.00;475
13117;28;22644912;13117;514;14531;15005;4.69;0.28;385.91;24.85;1414;39;5158.00;474
13118;28;22644928;13118;523;14531;15005;4.68;0.28;385.94;24.85;1413;39;5159.00;474
13119;28;22644945;13119;524;14537;15010;4.71;0.29;385.98;24.86;1418;39;5160.00;473
13122;28;22644962;13122;522;14537;15010;4.72;0.29;386.04;24.86;1415;39;5161.00;473
13123;28;22644979;13123;521;14537;15010;4.73;0.29;386.02;24.86;1414;39;5162.00;473
13124;28;22644994;13124;521;14539;15011;4.73;0.29;386.06;24.86;1415;39;5163.00;472
13126;28;22645014;13126;529;14540;15015;4.67;0.28;386.14;24.86;1414;39;5164.00;475
13126;28;22645033;13126;517;14540;15015;4.67;0.28;386.14;24.86;1414;39;5165.00;475
13127;28;22645050;13127;523;14542;15018;4.64;0.28;386.13;24.87;1415;39;5166.00;476
13129;28;22645067;13129;524;14542;15018;4.62;0.28;386.12;24.87;1413;39;5167.00;476
13129;28;22645085;13129;519;14542;15018;4.67;0.28;386.12;24.87;1413;39;5168.00;476
13129;28;22645102;13129;512;14543;15018;4.71;0.29;386.12;24.88;1414;39;5169.00;475
13130;28;22645119;13130;513;14548;15022;4.72;0.29;386.11;24.96;1418;39;5170.00;474
13130;28;22645136;13130;504;14548;15022;4.81;0.29;386.11;24.96;1418;39;5171.00;474
13135;28;22645153;13135;497;14549;15022;4.79;0.29;386.24;24.97;1414;39;5172.00;473
13140;28;22645171;13140;492;14549;15022;4.81;0.29;386.31;24.97;1409;39;5173.00;473
13141;28;22645190;13141;488;14549;15023;4.82;0.29;386.31;24.97;1408;39;5174.00;474
13144;28;22645208;13144;481;14549;15025;4.83;0.29;386.31;24.97;1405;39;5175.00;476
13148;28;22645226;13148;481;14550;15025;4.86;0.30;386.42;24.97;1402;39;5176.00;475
13151;28;22645243;13151;472;14551;15026;4.84;0.29;386.45;24.97;1400;39;5177.00;475
13156;28;22645262;13156;472;14551;15026;4.81;0.29;386.47;24.97;1395;39;5178.00;475
13158;28;22645279;13158;477;14551;15026;4.80;0.29;386.52;24.97;1393;39;5179.00;475
13159;28;22645295;13159;470;14552;15026;4.84;0.29;386.52;24.98;1393;39;5180.00;474
13164;28;22645312;13164;474;14553;15026;4.81;0.29;386.55;24.99;1389;39;5181.00;473
13168;28;22645329;13168;455;14553;15026;4.83;0.29;386.60;24.99;1385;39;5182.00;473
13173;28;22645347;13173;450;14553;15026;4.87;0.30;386.68;24.99;1380;39;5183.00;473
13176;28;22645363;13176;467;14615;15153;4.93;0.30;386.67;24.88;1439;39;5184.00;538
13177;28;22645390;13177;447;14615;15154;4.96;0.31;386.68;24.88;1438;40;5185.00;539
13179;28;22645418;13179;447;14620;15154;4.94;0.31;386.77;24.96;1441;40;5186.00;534
13182;28;22645435;13182;447;14623;15154;4.89;0.30;386.82;24.96;1441;40;5187.00;531
13188;28;22645451;13188;449;14626;15154;4.83;0.30;386.88;24.95;1438;40;5188.00;528
13193;28;22645469;13193;463;14627;15154;4.77;0.29;386.94;24.95;1434;40;5189.00;527
13194;28;22645492;13194;467;14628;15154;4.73;0.29;386.96;24.95;1434;40;5190.00;526
13195;28;22645508;13195;474;14629;15154;4.79;0.29;386.97;24.95;1434;40;5191.00;525
13197;28;22645525;13197;479;14630;15155;4.81;0.30;386.96;24.95;1433;40;5192.00;525
13198;28;22645541;13198;484;14633;15156;4.86;0.30;386.94;24.94;1435;40;5193.00;523
13200;28;22645558;13200;488;14636;15156;4.88;0.30;386.98;24.94;1436;40;5194.00;520
13204;28;22645575;13204;497;14638;15157;4.85;0.30;387.08;24.94;1434;40;5195.00;519
13206;28;22645592;13206;502;14640;15157;4.87;0.30;387.06;24.94;1434;40;5196.00;517
13211;28;22645608;13211;515;14641;15157;4.89;0.30;387.16;24.94;1430;40;5197.00;516
13215;28;22645626;13215;525;14644;15157;4.86;0.30;387.24;24.93;1429;40;5198.00;513
13216;28;22645643;13216;535;14646;15161;4.86;0.30;387.21;24.93;1430;40;5199.00;515
13217;28;22645661;13217;538;14647;15161;4.87;0.30;387.20;24.93;1430;40;5200.00;514
13219;28;22645681;13219;544;14647;15161;4.82;0.30;387.17;24.93;1428;40;5201.00;514
13225;28;22645700;13225;553;14649;15164;4.79;0.29;387.21;24.93;1424;40;5202.00;515
13226;28;22645718;13226;563;14649;15164;4.72;0.29;387.18;24.93;1423;40;5203.00;515
13229;28;22645734;13229;564;14649;15164;4.66;0.29;387.19;24.93;1420;40;5204.00;515
13235;28;22645751;13235;572;14650;15168;4.60;0.28;387.20;24.92;1415;40;5205.00;518
13237;28;22645768;13237;564;14651;15169;4.53;0.28;387.18;24.92;1414;40;5206.00;518
13238;28;22645792;13238;564;14651;15169;4.51;0.28;387.22;24.92;1413;40;5207.00;518
13240;28;22645808;13240;561;14653;15173;4.51;0.28;387.19;24.92;1413;40;5208.00;520
13243;28;22645825;13243;569;14654;15173;4.45;0.27;387.23;24.92;1411;40;5209.00;519
13245;28;22645842;13245;578;14654;15173;4.42;0.27;387.30;24.92;1409;40;5210.00;519
13246;28;22645860;13246;581;14654;15174;4.40;0.27;387.34;24.92;1408;40;5211.00;520
13248;28;22645877;13248;573;14656;15174;4.37;0.27;387.40;25.09;1408;40;5212.00;518
13250;28;22645892;13250;585;14660;15180;4.38;0.27;387.40;25.08;1410;40;5213.00;520
13253;28;22645910;13253;586;14660;15180;4.37;0.27;387.43;25.08;1407;40;5214.00;520
13255;28;22645926;13255;594;14660;15180;4.33;0.26;387.39;25.08;1405;40;5215.00;520
13256;28;22645941;13256;598;14660;15181;4.32;0.26;387.43;25.08;1404;40;5216.00;521
13258;28;22645957;13258;611;14660;15181;4.28;0.26;387.43;25.08;1402;40;5217.00;521
13258;28;22645973;13258;609;14660;15181;4.23;0.26;387.43;25.08;1402;40;5218.00;521
13261;28;22645988;13261;613;14660;15181;4.15;0.25;387.41;25.08;1399;40;5219.00;521
13261;28;22646006;13261;621;14681;15217;4.26;0.26;387.41;25.05;1420;40;5220.00;536
13263;28;22646031;13263;635;14681;15217;4.19;0.26;387.42;25.05;1418;40;5221.00;536
13265;28;22646046;13265;642;14682;15217;4.14;0.26;387.37;25.04;1417;40;5222.00;535
13265;28;22646063;13265;649;14682;15217;4.13;0.26;387.37;25.04;1417;40;5223.00;535
13268;28;22646077;13268;645;14682;15217;4.08;0.25;387.35;25.04;1414;40;5224.00;535
13271;28;22646092;13271;647;14682;15217;4.04;0.25;387.44;25.04;1411;40;5225.00;535
13275;28;22646107;13275;648;14683;15221;4.00;0.25;387.43;25.04;1408;40;5226.00;538
13275;28;22646123;13275;650;14683;15221;3.97;0.24;387.43;25.04;1408;40;5227.00;538
13278;28;22646137;13278;644;14685;15225;3.96;0.24;387.47;25.04;1407;40;5228.00;540
13281;28;22646153;13281;639;14685;15226;3.93;0.24;387.43;25.04;1404;40;5229.00;541
13282;28;22646169;13282;637;14685;15226;3.91;0.24;387.46;25.04;1403;40;5230.00;541
13284;28;22646183;13284;635;14685;15226;3.89;0.24;387.41;25.04;1401;40;5231.00;541
13287;28;22646198;13287;639;14694;15239;3.87;0.24;387.34;25.02;1407;40;5232.00;545
13288;28;22646214;13288;637;14694;15239;3.85;0.24;387.31;25.02;1406;40;5233.00;545
13290;28;22646229;13290;639;14695;15239;3.87;0.24;387.30;25.02;1405;40;5234.00;544
13292;28;22646246;13292;634;14696;15240;3.90;0.24;387.30;25.02;1404;40;5235.00;544
13295;28;22646261;13295;635;14696;15241;3.87;0.24;387.27;25.02;1401;40;5236.00;545
13299;28;22646275;13299;634;14696;15241;3.81;0.23;387.25;25.02;1397;40;5237.00;545
13300;28;22646290;13300;631;14697;15244;3.84;0.23;387.23;25.02;1397;40;5238.00;547
13304;28;22646304;13304;632;14698;15244;3.83;0.23;387.17;25.02;1394;40;5239.00;546
13307;28;22646318;13307;634;14698;15244;3.79;0.23;387.17;25.02;1391;40;5240.00;546
13309;28;22646332;13309;637;14698;15244;3.73;0.23;387.17;25.02;1389;40;5241.00;546
13310;28;22646347;13310;645;14701;15250;3.74;0.23;387.16;25.01;1391;40;5242.00;549
13312;28;22646360;13312;650;14701;15250;3.66;0.22;387.14;25.01;1389;40;5243.00;549
13314;28;22646373;13314;648;14701;15250;3.59;0.22;387.12;25.01;1387;40;5244.00;549
13317;28;22646387;13317;655;14703;15250;3.50;0.21;387.06;25.03;1386;40;5245.00;547
13319;28;22646401;13319;656;14704;15254;3.45;0.21;387.07;25.03;1385;40;5246.00;550
13322;28;22646415;13322;665;14704;15255;3.38;0.21;387.14;25.03;1382;40;5247.00;551
13325;28;22646429;13325;654;14704;15255;3.30;0.20;387.09;25.03;1379;40;5248.00;551
13326;28;22646447;13326;648;14705;15256;3.29;0.20;387.07;25.02;1379;40;5249.00;551
13328;28;22646466;13328;623;14705;15256;3.26;0.20;387.03;25.02;1377;40;5250.00;551
13330;28;22646482;13330;617;14705;15256;3.26;0.20;387.03;25.02;1375;40;5251.00;551
13331;28;22646502;13331;598;14705;15256;3.32;0.20;387.02;25.02;1374;40;5252.00;551
13335;28;22646519;13335;592;14705;15256;3.35;0.21;387.00;25.02;1370;40;5253.00;551
13337;28;22646537;13337;580;14705;15256;3.44;0.21;386.99;25.02;1368;40;5254.00;551
13342;28;22646562;13342;575;14705;15256;3.49;0.21;387.02;25.02;1363;40;5255.00;551
13342;28;22646576;13342;567;14732;15326;3.74;0.23;387.02;24.98;1390;40;5256.00;594
13344;28;22646596;13344;551;14735;15327;3.81;0.23;387.03;24.97;1391;40;5257.00;592
13347;28;22646617;13347;544;14739;15327;3.86;0.24;387.05;24.97;1392;40;5258.00;588
13348;28;22646633;13348;538;14743;15327;3.92;0.24;387.04;24.96;1395;40;5259.00;584
13350;28;22646648;13350;532;14747;15327;3.97;0.24;387.04;24.96;1397;40;5260.00;580
13352;28;22646664;13352;523;14747;15327;3.96;0.24;387.05;24.96;1395;40;5261.00;580
13354;28;22646679;13354;521;14749;15327;4.01;0.24;387.02;24.95;1395;40;5262.00;578
13356;28;22646694;13356;521;14749;15327;4.02;0.24;387.03;24.95;1393;40;5263.00;578
13358;28;22646709;13358;521;14751;15328;4.04;0.25;387.00;24.95;1393;40;5264.00;577
13360;28;22646731;13360;517;14753;15330;4.10;0.25;387.02;24.95;1393;40;5265.00;577
13363;28;22646746;13363;521;14755;15330;4.09;0.25;387.01;24.96;1392;40;5266.00;575
13367;28;22646762;13367;530;14758;15334;4.10;0.25;387.01;24.96;1391;40;5267.00;576
13370;28;22646779;13370;533;14761;15334;4.12;0.25;387.04;24.97;1391;40;5268.00;573
13374;28;22646795;13374;539;14762;15334;4.09;0.25;387.06;24.97;1388;40;5269.00;572
13380;28;22646810;13380;531;14762;15334;4.09;0.25;387.14;24.97;1382;40;5270.00;572
13384;28;22646827;13384;528;14765;15340;4.11;0.25;387.08;24.96;1381;40;5271.00;575
13390;28;22646843;13390;522;14766;15340;4.08;0.25;387.30;25.05;1376;40;5272.00;574
13391;28;22646862;13391;516;14768;15340;4.09;0.25;387.34;25.07;1377;40;5273.00;572
13394;28;22646878;13394;502;14769;15343;4.11;0.25;387.34;25.07;1375;40;5274.00;574
13397;28;22646895;13397;506;14770;15343;4.10;0.25;387.35;25.08;1373;40;5275.00;573
13400;28;22646913;13400;505;14771;15343;4.12;0.25;387.33;25.10;1371;40;5276.00;572
13402;28;22646928;13402;505;14771;15344;4.11;0.25;387.32;25.10;1369;40;5277.00;573
13404;28;22646944;13404;501;14773;15345;4.14;0.25;387.31;25.10;1369;40;5278.00;572
13408;28;22646960;13408;501;14775;15345;4.15;0.25;387.37;25.13;1367;40;5279.00;570
13409;28;22646977;13409;503;14795;15371;4.27;0.26;387.37;25.10;1386;40;5280.00;576
13415;28;22646995;13415;499;14796;15371;4.29;0.26;387.42;25.11;1381;40;5281.00;575
13417;28;22647014;13417;491;14798;15371;4.40;0.27;387.44;25.12;1381;40;5282.00;573
13420;28;22647032;13420;495;14801;15372;4.45;0.27;387.44;25.15;1381;40;5283.00;571
13425;28;22647048;13425;496;14803;15372;4.49;0.27;387.51;25.17;1378;40;5284.00;569
13428;28;22647064;13428;495;14808;15376;4.57;0.28;387.47;25.19;1380;40;5285.00;568
13431;28;22647081;13431;497;14810;15376;4.60;0.28;387.56;25.21;1379;40;5286.00;566
13435;28;22647097;13435;491;14811;15379;4.64;0.28;387.56;25.21;1376;40;5287.00;568
13438;28;22647115;13438;495;14816;15380;4.64;0.28;387.58;25.25;1378;40;5288.00;564
13444;28;22647132;13444;498;14817;15380;4.62;0.28;387.70;25.25;1373;40;5289.00;563
13446;28;22647148;13446;506;14819;15380;4.61;0.28;387.73;25.27;1373;40;5290.00;561
13450;28;22647170;13450;509;14821;15380;4.56;0.28;387.78;25.27;1371;40;5291.00;559
13451;28;22647187;13451;508;14829;15392;4.58;0.28;387.78;25.28;1378;40;5292.00;563
13455;28;22647204;13455;511;14831;15392;4.54;0.28;387.79;25.29;1376;40;5293.00;561
13457;28;22647220;13457;513;14835;15392;4.54;0.28;387.84;25.31;1378;40;5294.00;557
13457;28;22647236;13457;511;14838;15392;4.53;0.28;387.84;25.32;1381;40;5295.00;554
13462;28;22647253;13462;520;14840;15392;4.43;0.27;387.89;25.34;1378;40;5296.00;552
13466;28;22647270;13466;513;14842;15392;4.37;0.27;387.91;25.35;1376;40;5297.00;550
13471;28;22647286;13471;500;14844;15393;4.36;0.27;387.96;25.36;1373;40;5298.00;549
13474;28;22647303;13474;497;14845;15393;4.34;0.27;387.95;25.44;1371;40;5299.00;548
13478;28;22647320;13478;491;14852;15399;4.35;0.27;387.99;25.46;1374;40;5300.00;547
13479;28;22647341;13479;495;14852;15400;4.37;0.27;387.96;25.46;1373;40;5301.00;548
13479;28;22647358;13479;495;14854;15400;4.41;0.27;387.96;25.47;1375;40;5302.00;546
13481;28;22647373;13481;488;14857;15400;4.44;0.27;388.07;25.48;1376;40;5303.00;543
13483;28;22647390;13483;500;14861;15404;4.49;0.28;388.16;25.49;1378;40;5304.00;543
13486;28;22647406;13486;500;14865;15404;4.53;0.28;388.23;25.50;1379;40;5305.00;539
13486;28;22647428;13486;494;14866;15404;4.55;0.28;388.23;25.51;1380;40;5306.00;538
13489;28;22647445;13489;488;14868;15405;4.62;0.28;388.27;25.52;1379;40;5307.00;537
13496;28;22647462;13496;482;14872;15409;4.67;0.28;388.35;25.53;1376;40;5308.00;537
13501;28;22647478;13501;480;14873;15409;4.68;0.29;388.46;25.53;1372;40;5309.00;536
13501;28;22647497;13501;493;14878;15415;4.74;0.29;388.46;25.55;1377;40;5310.00;537
13504;28;22647514;13504;493;14878;15415;4.77;0.29;388.54;25.55;1374;40;5311.00;537
13505;28;22647531;13505;491;14880;15415;4.78;0.29;388.58;25.55;1375;40;5312.00;535
13509;28;22647547;13509;495;14883;15415;4.73;0.29;388.73;25.57;1374;40;5313.00;532
13510;28;22647564;13510;500;14887;15419;4.72;0.29;388.81;25.57;1377;40;5314.00;532
13513;28;22647581;13513;506;14893;15419;4.67;0.28;388.87;25.67;1380;40;5315.00;526
13517;28;22647598;13517;510;14894;15419;4.66;0.28;388.90;25.67;1377;40;5316.00;525
13520;28;22647614;13520;510;14897;15419;4.60;0.28;388.99;25.68;1377;40;5317.00;522
13526;28;22647631;13526;512;14897;15420;4.52;0.27;389.20;25.68;1371;40;5318.00;523
13528;28;22647648;13528;510;14897;15421;4.46;0.27;389.27;25.68;1369;40;5319.00;524
13531;28;22647664;13531;512;14900;15421;4.40;0.27;389.34;25.70;1369;40;5320.00;521
13532;28;22647682;13532;512;14902;15422;4.39;0.27;389.35;25.70;1370;40;5321.00;520
13535;28;22647697;13535;513;14903;15422;4.38;0.27;389.44;25.79;1368;40;5322.00;519
13539;28;22647714;13539;511;14905;15422;4.39;0.27;389.45;25.81;1366;40;5323.00;517
13541;28;22647730;13541;513;14905;15422;4.40;0.27;389.47;25.81;1364;40;5324.00;517
13543;28;22647746;13543;517;14906;15422;4.44;0.27;389.55;25.82;1363;40;5325.00;516
13546;28;22647761;13546;517;14907;15422;4.47;0.27;389.56;25.82;1361;40;5326.00;515
13549;28;22647777;13549;521;14908;15422;4.47;0.27;389.63;25.83;1359;40;5327.00;514
13551;28;22647792;13551;546;14983;15549;4.56;0.28;389.70;25.71;1432;40;5328.00;566
13553;28;22647819;13553;534;14984;15550;4.59;0.28;389.78;25.72;1431;40;5329.00;566
13555;28;22647835;13555;515;14987;15550;4.61;0.28;389.79;25.72;1432;40;5330.00;563
13555;28;22647854;13555;518;14988;15550;4.66;0.29;389.79;25.73;1433;40;5331.00;562
13556;28;22647871;13556;512;14990;15550;4.75;0.29;389.82;25.73;1434;40;5332.00;560
13558;28;22647889;13558;524;14993;15550;4.73;0.29;389.88;25.74;1435;40;5333.00;557
13558;28;22647908;13558;536;14995;15550;4.76;0.29;389.88;25.74;1437;40;5334.00;555
13560;28;22647925;13560;539;14997;15550;4.78;0.29;389.91;25.75;1437;40;5335.00;553
13560;28;22647941;13560;547;14998;15551;4.80;0.29;389.91;25.75;1438;40;5336.00;553
13562;28;22647958;13562;552;14999;15552;4.80;0.29;389.99;25.75;1437;40;5337.00;553
13563;28;22647975;13563;548;15003;15552;4.83;0.30;390.04;25.76;1440;40;5338.00;549
13567;28;22647992;13567;554;15004;15553;4.84;0.29;390.08;25.76;1437;40;5339.00;549
13569;28;22648012;13569;553;15005;15553;4.87;0.30;390.05;25.76;1436;40;5340.00;548
13574;28;22648030;13574;547;15007;15553;4.87;0.30;390.14;25.77;1433;40;5341.00;546
13576;28;22648048;13576;532;15008;15553;4.87;0.30;390.12;25.77;1432;40;5342.00;545
13579;28;22648065;13579;532;15012;15557;4.88;0.30;390.16;25.76;1433;40;5343.00;545
13582;28;22648082;13582;527;15013;15557;4.85;0.30;390.19;25.76;1431;40;5344.00;544
13583;28;22648100;13583;528;15015;15557;4.84;0.29;390.27;25.77;1432;40;5345.00;542
13583;28;22648116;13583;524;15017;15560;4.84;0.29;390.27;25.78;1434;40;5346.00;543
13584;28;22648133;13584;519;15019;15560;4.83;0.29;390.26;25.79;1435;40;5347.00;541
13585;28;22648150;13585;514;15021;15560;4.80;0.29;390.30;25.89;1436;40;5348.00;539
13586;28;22648168;13586;508;15023;15564;4.77;0.29;390.33;25.89;1437;40;5349.00;541
13587;28;22648185;13587;501;15025;15565;4.75;0.29;390.41;25.89;1438;40;5350.00;540
13588;28;22648201;13588;500;15025;15565;4.69;0.29;390.49;25.89;1437;40;5351.00;540
13590;28;22648219;13590;502;15028;15569;4.62;0.28;390.55;25.90;1438;40;5352.00;541
13593;28;22648236;13593;496;15029;15569;4.55;0.28;390.58;25.90;1436;40;5353.00;540
13596;28;22648252;13596;508;15032;15569;4.49;0.28;390.66;25.90;1436;40;5354.00;537
13601;28;22648270;13601;506;15033;15571;4.38;0.27;390.67;25.90;1432;40;5355.00;538
13604;28;22648287;13604;510;15036;15571;4.34;0.27;390.88;26.08;1432;40;5356.00;535
13609;28;22648309;13609;517;15040;15577;4.36;0.27;390.91;26.08;1431;40;5357.00;537
13614;28;22648326;13614;517;15043;15577;4.38;0.27;390.93;26.08;1429;40;5358.00;534
13615;28;22648344;13615;525;15044;15577;4.38;0.27;390.97;26.09;1429;40;5359.00;533
13619;28;22648360;13619;534;15044;15578;4.34;0.27;391.16;26.09;1425;40;5360.00;534
13621;28;22648376;13621;529;15046;15578;4.32;0.26;391.14;26.10;1425;40;5361.00;532
13621;28;22648394;13621;524;15047;15578;4.29;0.26;391.14;26.11;1426;40;5362.00;531
13622;28;22648410;13622;530;15047;15578;4.28;0.26;391.15;26.11;1425;40;5363.00;531
13624;28;22648425;13624;530;15055;15590;4.33;0.27;391.25;26.09;1431;40;5364.00;535
13626;28;22648448;13626;530;15056;15590;4.33;0.27;391.26;26.10;1430;40;5365.00;534
13629;28;22648469;13629;538;15057;15590;4.33;0.27;391.21;26.10;1428;40;5366.00;533
13633;28;22648490;13633;550;15057;15590;4.31;0.26;391.32;26.10;1424;40;5367.00;533
13636;28;22648510;13636;553;15057;15590;4.29;0.26;391.34;26.10;1421;40;5368.00;533
13639;28;22648530;13639;554;15057;15590;4.29;0.26;391.36;26.10;1418;40;5369.00;533
13641;28;22648553;13641;555;15059;15594;4.31;0.26;391.40;26.10;1418;40;5370.00;535
13643;28;22648571;13643;551;15059;15594;4.27;0.26;391.43;26.10;1416;40;5371.00;535
13645;28;22648587;13645;551;15061;15598;4.29;0.26;391.39;26.09;1416;40;5372.00;537
13647;28;22648603;13647;557;15061;15599;4.27;0.26;391.49;26.09;1414;40;5373.00;538
13647;28;22648620;13647;563;15061;15599;4.28;0.26;391.49;26.09;1414;40;5374.00;538
13649;28;22648636;13649;573;15061;15599;4.28;0.26;391.48;26.09;1412;40;5375.00;538
13652;28;22648652;13652;581;15072;15612;4.29;0.26;391.54;26.07;1420;40;5376.00;540
13654;28;22648669;13654;585;15072;15612;4.27;0.26;391.52;26.07;1418;40;5377.00;540
13658;28;22648685;13658;590;15072;15612;4.25;0.26;391.53;26.07;1414;40;5378.00;540
13661;28;22648701;13661;594;15074;15613;4.26;0.26;391.48;26.08;1413;40;5379.00;539
13662;28;22648717;13662;599;15074;15614;4.26;0.26;391.47;26.08;1412;40;5380.00;540
13664;28;22648733;13664;600;15074;15614;4.24;0.26;391.47;26.08;1410;40;5381.00;540
13666;28;22648756;13666;608;15075;15617;4.23;0.26;391.50;26.08;1409;40;5382.00;542
13670;28;22648771;13670;609;15075;15617;4.18;0.26;391.60;26.08;1405;40;5383.00;542
13670;28;22648787;13670;619;15075;15617;4.16;0.26;391.60;26.08;1405;40;5384.00;542
13671;28;22648808;13671;624;15075;15617;4.14;0.25;391.59;26.08;1404;40;5385.00;542
13675;28;22648823;13675;620;15079;15623;4.15;0.26;391.65;26.07;1404;40;5386.00;544
13679;28;22648845;13679;630;15079;15623;4.09;0.25;391.60;26.07;1400;40;5387.00;544
13679;28;22648861;13679;625;15079;15623;4.09;0.25;391.60;26.07;1400;40;5388.00;544
13683;28;22648877;13683;630;15079;15623;4.04;0.25;391.55;26.07;1396;40;5389.00;544
13688;28;22648892;13688;643;15080;15627;3.99;0.24;391.49;26.07;1392;40;5390.00;547
13689;28;22648908;13689;652;15080;15628;3.93;0.24;391.50;26.07;1391;40;5391.00;548
13690;28;22648923;13690;652;15080;15628;3.91;0.24;391.52;26.07;1390;40;5392.00;548
13692;28;22648938;13692;652;15081;15629;3.88;0.24;391.52;26.07;1389;40;5393.00;548
13693;28;22648952;13693;652;15081;15629;3.84;0.23;391.50;26.07;1388;40;5394.00;548
13695;28;22648967;13695;647;15081;15629;3.83;0.23;391.49;26.07;1386;40;5395.00;548
13697;28;22648981;13697;659;15081;15629;3.80;0.23;391.45;26.07;1384;40;5396.00;548
13699;28;22648995;13699;662;15081;15629;3.76;0.23;391.46;26.07;1382;40;5397.00;548
13701;28;22649015;13701;669;15081;15629;3.70;0.23;391.48;26.07;1380;40;5398.00;548
13702;28;22649031;13702;671;15081;15629;3.63;0.22;391.47;26.07;1379;40;5399.00;548
