step_arrived;step_collisions;step_duration;step_ended;step_halting;step_inserted;step_loaded;step_meanSpeed;step_meanSpeedRelative;step_meanTravelTime;step_meanWaitingTime;step_running;step_teleports;step_time;step_waiting
0;0;22101677;0;1;89;245;16.02;1.12;-1.00;0.00;89;0;0.00;156
0;0;22101710;0;0;101;245;15.13;1.05;-1.00;0.12;101;0;1.00;144
0;0;22101712;0;2;123;245;14.22;0.97;-1.00;0.46;123;0;2.00;122
0;0;22101713;0;3;135;245;13.07;0.88;-1.00;0.68;135;0;3.00;110
0;0;22101715;0;4;148;245;12.20;0.82;-1.00;0.97;148;0;4.00;97
0;0;22101716;0;6;155;245;11.33;0.76;-1.00;1.15;155;0;5.00;90
0;0;22101718;0;10;166;245;10.51;0.70;-1.00;1.48;166;0;6.00;79
0;0;22101719;0;13;173;245;9.83;0.65;-1.00;1.70;173;0;7.00;72
0;0;22101721;0;21;178;246;9.43;0.62;-1.00;1.88;178;0;8.00;68
0;0;22101724;0;23;186;247;9.24;0.61;-1.00;2.18;186;0;9.00;61
0;0;22101729;0;27;193;247;9.17;0.61;-1.00;2.47;193;0;10.00;54
0;0;22101731;0;25;201;248;9.00;0.59;-1.00;2.76;201;0;11.00;47
1;0;22101734;1;30;203;248;8.83;0.58;12.00;2.85;202;0;12.00;45
2;0;22101736;2;33;208;248;8.72;0.57;12.50;3.09;206;0;13.00;40
2;0;22101738;2;37;212;248;8.78;0.57;12.50;3.30;210;0;14.00;36
2;0;22101741;2;41;220;252;8.75;0.57;12.50;3.60;218;0;15.00;32
2;0;22101746;2;47;223;252;8.68;0.56;12.50;3.76;221;0;16.00;29
2;0;22101749;2;55;228;252;8.63;0.55;12.50;4.05;226;0;17.00;24
2;0;22101752;2;53;233;255;8.54;0.54;12.50;4.32;231;0;18.00;22
3;0;22101755;3;59;235;255;8.47;0.54;14.67;4.31;232;0;19.00;20
4;0;22101758;4;62;236;255;8.35;0.53;16.00;4.38;232;0;20.00;19
5;0;22101763;5;68;242;259;8.43;0.53;17.00;4.46;237;0;21.00;17
6;0;22101767;6;76;243;260;8.40;0.53;17.67;4.44;237;0;22.00;17
6;0;22101770;6;82;246;260;8.30;0.52;17.67;4.67;240;0;23.00;14
7;0;22101773;7;85;250;264;8.18;0.51;18.57;4.69;243;0;24.00;14
7;0;22101778;7;87;251;264;8.09;0.51;18.57;4.77;244;0;25.00;13
7;0;22101782;7;89;252;264;8.11;0.51;18.57;4.76;245;0;26.00;12
7;0;22101785;7;92;253;265;8.08;0.50;18.57;4.79;246;0;27.00;12
7;0;22101788;7;97;254;265;8.08;0.50;18.57;4.89;247;0;28.00;11
7;0;22101791;7;99;259;271;8.01;0.50;18.57;4.81;252;0;29.00;12
7;0;22101798;7;99;261;271;7.94;0.49;18.57;4.93;254;0;30.00;10
7;0;22101801;7;100;262;272;7.89;0.49;18.57;4.92;255;0;31.00;10
8;0;22101805;8;103;262;272;7.94;0.49;19.88;4.92;254;0;32.00;10
10;0;22101808;10;105;262;272;7.89;0.49;22.50;4.92;252;0;33.00;10
10;0;22101814;10;107;264;272;8.03;0.50;22.50;5.03;254;0;34.00;8
10;0;22101817;10;107;266;272;8.16;0.50;22.50;5.26;256;0;35.00;6
11;0;22101820;11;107;277;284;8.45;0.52;23.09;5.15;266;0;36.00;7
11;0;22101825;11;111;278;284;8.48;0.53;23.09;5.20;267;0;37.00;6
11;0;22101831;11;113;279;284;8.46;0.52;23.09;5.22;268;0;38.00;5
11;0;22101835;11;114;279;284;8.36;0.52;23.09;5.22;268;0;39.00;5
12;0;22101839;12;116;280;284;8.14;0.50;24.08;5.21;268;0;40.00;4
12;0;22101843;12;120;280;284;8.03;0.50;24.08;5.21;268;0;41.00;4
12;0;22101848;12;122;285;288;8.05;0.50;24.08;5.16;273;0;42.00;3
13;0;22101854;13;124;285;288;7.89;0.49;25.23;5.16;272;0;43.00;3
14;0;22101858;14;130;289;292;7.86;0.49;25.07;5.10;275;0;44.00;3
14;0;22101865;14;133;291;294;7.85;0.49;25.07;5.07;277;0;45.00;3
14;0;22101870;14;134;291;294;7.76;0.48;25.07;5.07;277;0;46.00;3
16;0;22101877;16;134;291;294;7.70;0.48;27.63;5.07;275;0;47.00;3
17;0;22101881;17;140;302;307;7.95;0.49;28.71;4.88;285;0;48.00;5
18;0;22101885;18;143;302;307;7.80;0.49;29.44;4.88;284;0;49.00;5
19;0;22101888;19;142;302;307;7.69;0.48;30.21;4.88;283;0;50.00;5
19;0;22101892;19;145;303;308;7.63;0.48;30.21;4.87;284;0;51.00;5
19;0;22101897;19;145;304;309;7.57;0.47;30.21;4.86;285;0;52.00;5
21;0;22101900;21;149;304;309;7.39;0.46;32.33;4.86;283;0;53.00;5
22;0;22101904;22;152;306;312;7.42;0.46;31.68;4.82;284;0;54.00;6
24;0;22101907;24;153;306;312;7.23;0.45;33.50;4.82;282;0;55.00;6
25;0;22101912;25;141;307;312;7.15;0.44;33.48;4.81;282;0;56.00;5
27;0;22101915;27;137;307;312;7.05;0.44;35.15;4.81;280;0;57.00;5
27;0;22101920;27;139;313;318;7.13;0.44;35.15;4.74;286;0;58.00;5
28;0;22101924;28;143;313;318;7.10;0.44;35.18;4.74;285;0;59.00;5
28;0;22101931;28;144;313;318;7.10;0.44;35.18;4.74;285;0;60.00;5
29;0;22101934;29;145;313;318;7.05;0.43;34.62;4.74;284;0;61.00;5
29;0;22101938;29;147;317;322;7.12;0.44;34.62;4.69;288;0;62.00;5
29;0;22101944;29;149;318;323;7.28;0.45;34.62;4.68;289;0;63.00;5
29;0;22101949;29;151;318;323;7.44;0.46;34.62;4.68;289;0;64.00;5
29;0;22101956;29;152;319;324;7.59;0.47;34.62;4.67;290;0;65.00;5
31;0;22101961;31;153;319;324;7.62;0.47;36.55;4.67;288;0;66.00;5
31;0;22101965;31;144;319;324;7.69;0.47;36.55;4.67;288;0;67.00;5
31;0;22101969;31;139;319;324;7.75;0.47;36.55;4.67;288;0;68.00;5
31;0;22101972;31;136;319;324;7.82;0.48;36.55;4.67;288;0;69.00;5
31;0;22101975;31;132;319;324;7.84;0.48;36.55;4.67;288;0;70.00;5
32;0;22101980;32;129;319;324;7.93;0.48;37.63;4.67;287;0;71.00;5
33;0;22101983;33;133;352;394;8.11;0.50;38.39;4.23;319;0;72.00;42
33;0;22101995;33;129;353;395;8.33;0.51;38.39;4.22;320;0;73.00;42
34;0;22101999;34;123;359;395;8.63;0.53;39.44;4.18;325;0;74.00;36
36;0;22102003;36;122;361;395;8.78;0.54;40.83;4.18;325;0;75.00;34
36;0;22102008;36;119;365;395;9.15;0.56;40.83;4.18;329;0;76.00;30
36;0;22102013;36;120;366;395;9.30;0.57;40.83;4.18;330;0;77.00;29
37;0;22102017;37;120;369;395;9.48;0.58;41.70;4.19;332;0;78.00;26
37;0;22102021;37;124;372;395;9.49;0.58;41.70;4.22;335;0;79.00;23
39;0;22102025;39;123;374;396;9.44;0.57;43.23;4.24;335;0;80.00;22
39;0;22102030;39;122;376;397;9.40;0.57;43.23;4.26;337;0;81.00;21
40;0;22102035;40;123;379;397;9.46;0.57;43.98;4.31;339;0;82.00;18
40;0;22102046;40;127;385;401;9.39;0.57;43.98;4.28;345;0;83.00;16
41;0;22102051;41;130;386;401;9.36;0.57;44.95;4.28;345;0;84.00;15
41;0;22102054;41;133;386;401;9.25;0.56;44.95;4.28;345;0;85.00;15
41;0;22102058;41;132;386;401;9.14;0.56;44.95;4.28;345;0;86.00;15
42;0;22102064;42;134;391;407;8.99;0.55;45.95;4.24;349;0;87.00;16
43;0;22102069;43;133;391;407;8.86;0.54;46.91;4.24;348;0;88.00;16
45;0;22102072;45;136;391;407;8.63;0.53;48.78;4.24;346;0;89.00;16
45;0;22102079;45;132;395;413;8.63;0.53;48.78;4.20;350;0;90.00;18
47;0;22102084;47;131;395;413;8.53;0.52;50.57;4.20;348;0;91.00;18
49;0;22102088;49;134;397;413;8.51;0.52;52.27;4.19;348;0;92.00;16
50;0;22102092;50;136;398;414;8.46;0.51;51.64;4.18;348;0;93.00;16
52;0;22102098;52;137;399;415;8.33;0.51;53.19;4.17;347;0;94.00;16
54;0;22102104;54;135;399;415;8.25;0.50;54.74;4.17;345;0;95.00;16
55;0;22102108;55;139;410;428;8.13;0.49;55.49;4.06;355;0;96.00;18
57;0;22102116;57;138;410;428;8.12;0.49;56.86;4.06;353;0;97.00;18
58;0;22102120;58;137;410;428;8.15;0.50;57.57;4.06;352;0;98.00;18
59;0;22102123;59;139;411;429;8.20;0.50;58.27;4.05;352;0;99.00;18
59;0;22102132;59;137;411;429;8.26;0.50;58.27;4.05;352;0;100.00;18
60;0;22102142;60;137;414;433;8.42;0.51;58.95;4.03;354;0;101.00;19
62;0;22102149;62;138;414;433;8.37;0.51;60.27;4.03;352;0;102.00;19
62;0;22102152;62;138;418;437;8.33;0.51;60.27;4.00;356;0;103.00;19
64;0;22102157;64;134;418;437;8.43;0.51;61.55;4.00;354;0;104.00;19
66;0;22102163;66;129;418;437;8.59;0.52;62.83;4.00;352;0;105.00;19
66;0;22102169;66;124;418;437;8.71;0.53;62.83;4.00;352;0;106.00;19
66;0;22102173;66;115;418;437;8.78;0.54;62.83;4.00;352;0;107.00;19
66;0;22102181;66;109;428;449;8.86;0.54;62.83;3.91;362;0;108.00;21
67;0;22102187;67;103;429;449;9.02;0.55;63.49;3.90;362;0;109.00;20
67;0;22102192;67;98;432;449;9.23;0.57;63.49;4.05;365;0;110.00;17
67;0;22102203;67;93;432;449;9.37;0.57;63.49;4.05;365;0;111.00;17
68;0;22102211;68;89;432;449;9.55;0.58;64.16;4.05;364;0;112.00;17
68;0;22102217;68;90;432;449;9.68;0.59;64.16;4.05;364;0;113.00;17
68;0;22102225;68;87;433;450;9.82;0.60;64.16;4.05;365;0;114.00;17
70;0;22102232;70;79;433;450;9.96;0.61;65.59;4.05;363;0;115.00;17
70;0;22102239;70;75;438;456;10.09;0.62;65.59;4.01;368;0;116.00;18
71;0;22102248;71;70;439;457;10.23;0.62;66.31;4.00;368;0;117.00;18
71;0;22102256;71;70;439;457;10.33;0.63;66.31;4.00;368;0;118.00;18
71;0;22102266;71;67;439;457;10.38;0.64;66.31;4.00;368;0;119.00;18
72;0;22102280;72;63;443;462;10.64;0.65;67.00;3.97;371;0;120.00;19
74;0;22102290;74;66;443;462;10.73;0.65;68.41;3.97;369;0;121.00;19
75;0;22102300;75;67;444;462;10.73;0.65;69.12;4.23;369;0;122.00;18
76;0;22102307;76;70;445;463;10.72;0.65;69.36;4.22;369;0;123.00;18
77;0;22102315;77;73;450;467;10.66;0.65;69.99;4.46;373;0;124.00;17
77;0;22102322;77;74;450;467;10.75;0.66;69.99;4.46;373;0;125.00;17
78;0;22102330;78;75;455;470;10.83;0.66;70.71;4.93;377;0;126.00;15
78;0;22102337;78;79;455;470;10.94;0.67;70.71;4.93;377;0;127.00;15
78;0;22102344;78;79;456;470;11.00;0.67;70.71;4.92;378;0;128.00;14
79;0;22102351;79;82;458;470;11.06;0.68;71.39;5.15;379;0;129.00;12
80;0;22102357;80;82;462;474;11.19;0.68;72.09;5.29;382;0;130.00;12
82;0;22102368;82;84;462;474;11.27;0.69;73.30;5.29;380;0;131.00;12
82;0;22102378;82;85;465;474;11.35;0.69;73.30;5.69;383;0;132.00;9
86;0;22102386;86;87;465;474;11.38;0.69;75.26;5.69;379;0;133.00;9
86;0;22102396;86;90;469;475;11.33;0.69;75.26;5.95;383;0;134.00;6
87;0;22102405;87;90;472;477;11.42;0.70;75.94;6.05;385;0;135.00;5
90;0;22102414;90;91;474;477;11.52;0.70;77.86;6.08;384;0;136.00;3
91;0;22102422;91;92;475;478;11.51;0.70;77.71;6.07;384;0;137.00;3
93;0;22102434;93;93;476;478;11.47;0.70;79.00;6.15;383;0;138.00;2
95;0;22102442;95;98;476;478;11.48;0.70;79.89;6.15;381;0;139.00;2
96;0;22102451;96;99;477;478;11.47;0.70;79.77;6.23;381;0;140.00;1
96;0;22102458;96;101;477;478;11.55;0.71;79.77;6.23;381;0;141.00;1
97;0;22102466;97;102;477;478;11.53;0.71;79.67;6.23;380;0;142.00;1
98;0;22102473;98;102;478;478;11.53;0.71;80.32;6.26;380;0;143.00;0
100;0;22102481;100;122;552;605;11.02;0.70;81.57;5.43;452;0;144.00;53
100;0;22102505;100;112;558;606;11.00;0.70;81.57;5.38;458;0;145.00;48
102;0;22102515;102;110;565;606;11.09;0.70;82.57;5.34;463;0;146.00;41
104;0;22102525;104;108;567;606;11.01;0.70;83.35;5.33;463;0;147.00;39
105;0;22102535;105;110;573;606;10.97;0.69;83.90;5.32;468;0;148.00;33
107;0;22102543;107;107;576;606;10.96;0.69;84.56;5.31;469;0;149.00;30
108;0;22102555;108;105;580;611;10.82;0.68;85.15;5.30;472;0;150.00;31
112;0;22102566;112;106;582;611;10.74;0.67;86.15;5.30;470;0;151.00;29
115;0;22102574;115;106;585;612;10.82;0.67;87.10;5.32;470;0;152.00;27
116;0;22102583;116;110;586;613;10.84;0.67;87.17;5.32;470;0;153.00;27
118;0;22102591;118;108;588;613;10.82;0.67;87.32;5.34;470;0;154.00;25
122;0;22102600;122;114;593;614;10.71;0.66;89.04;5.36;471;0;155.00;21
124;0;22102609;124;117;596;614;10.54;0.65;90.12;5.38;472;0;156.00;18
127;0;22102624;127;120;598;614;10.50;0.65;91.66;5.41;471;0;157.00;16
128;0;22102635;128;128;600;614;10.40;0.64;91.60;5.44;472;0;158.00;14
129;0;22102646;129;135;605;618;10.23;0.63;91.01;5.46;476;0;159.00;13
129;0;22102655;129;140;606;618;10.19;0.63;91.01;5.45;477;0;160.00;12
131;0;22102665;131;143;609;618;10.10;0.62;90.98;5.49;478;0;161.00;9
134;0;22102672;134;151;610;621;10.02;0.62;91.90;5.48;476;0;162.00;11
136;0;22102683;136;155;612;621;9.93;0.61;92.93;5.49;476;0;163.00;9
137;0;22102690;137;158;612;621;9.85;0.61;93.45;5.49;475;0;164.00;9
139;0;22102700;139;161;616;625;9.74;0.60;93.40;5.50;477;0;165.00;9
140;0;22102708;140;160;619;626;9.66;0.60;93.89;5.54;479;0;166.00;7
142;0;22102717;142;160;619;626;9.52;0.59;94.63;5.54;477;0;167.00;7
144;0;22102726;144;161;625;630;9.43;0.58;95.60;5.55;481;0;168.00;5
144;0;22102734;144;162;625;630;9.37;0.58;95.60;5.55;481;0;169.00;5
146;0;22102743;146;157;627;630;9.26;0.57;96.39;5.59;481;0;170.00;3
147;0;22102752;147;158;628;631;9.10;0.56;96.83;5.62;481;0;171.00;3
150;0;22102762;150;153;629;631;8.94;0.55;97.20;5.62;479;0;172.00;2
154;0;22102770;154;155;636;637;8.81;0.54;98.96;5.58;482;0;173.00;1
155;0;22102780;155;157;636;637;8.76;0.54;99.44;5.58;481;0;174.00;1
156;0;22102789;156;145;637;638;8.75;0.54;99.15;5.57;481;0;175.00;1
157;0;22102798;157;145;637;638;8.77;0.54;99.55;5.57;480;0;176.00;1
159;0;22102805;159;141;637;638;8.83;0.54;100.43;5.57;478;0;177.00;1
159;0;22102814;159;140;637;638;8.88;0.55;100.43;5.57;478;0;178.00;1
159;0;22102822;159;139;637;638;8.91;0.55;100.43;5.57;478;0;179.00;1
160;0;22102835;160;145;668;672;9.09;0.56;100.46;5.31;508;0;180.00;4
160;0;22102848;160;140;668;672;9.07;0.56;100.46;5.31;508;0;181.00;4
162;0;22102855;162;131;670;672;9.22;0.57;99.77;5.30;508;0;182.00;2
162;0;22102862;162;133;671;672;9.39;0.58;99.77;5.34;509;0;183.00;1
163;0;22102869;163;130;672;672;9.51;0.59;99.75;5.34;509;0;184.00;0
164;0;22102877;164;127;672;672;9.58;0.59;100.20;5.34;508;0;185.00;0
165;0;22102885;165;122;676;676;9.54;0.59;100.70;5.32;511;0;186.00;0
167;0;22102894;167;122;676;676;9.53;0.59;100.27;5.32;509;0;187.00;0
168;0;22102902;168;125;680;680;9.56;0.59;100.42;5.29;512;0;188.00;0
170;0;22102910;170;132;681;681;9.51;0.58;101.18;5.28;511;0;189.00;0
170;0;22102918;170;141;681;681;9.57;0.59;101.18;5.28;511;0;190.00;0
171;0;22102925;171;140;681;681;9.61;0.59;101.43;5.28;510;0;191.00;0
173;0;22102933;173;148;694;694;9.62;0.59;101.68;5.18;521;0;192.00;0
174;0;22102941;174;154;694;694;9.62;0.59;101.68;5.18;520;0;193.00;0
177;0;22102950;177;159;694;694;9.54;0.59;101.47;5.18;517;0;194.00;0
181;0;22102957;181;159;695;695;9.46;0.58;102.17;5.18;514;0;195.00;0
184;0;22102967;184;165;696;696;9.36;0.57;102.91;5.17;512;0;196.00;0
184;0;22102974;184;169;696;696;9.32;0.57;102.91;5.17;512;0;197.00;0
185;0;22102982;185;170;698;699;9.30;0.57;103.03;5.16;513;0;198.00;1
188;0;22102990;188;179;698;699;9.12;0.56;103.57;5.16;510;0;199.00;1
190;0;22102999;190;182;699;699;8.94;0.55;102.79;5.15;509;0;200.00;0
191;0;22103014;191;187;699;699;8.80;0.54;102.54;5.15;508;0;201.00;0
194;0;22103021;194;187;705;705;8.62;0.53;102.17;5.12;511;0;202.00;0
196;0;22103031;196;197;705;705;8.51;0.52;102.40;5.12;509;0;203.00;0
199;0;22103037;199;202;705;705;8.37;0.51;102.00;5.12;506;0;204.00;0
199;0;22103045;199;207;705;705;8.20;0.50;102.00;5.12;506;0;205.00;0
203;0;22103052;203;210;709;709;8.04;0.49;102.09;5.09;506;0;206.00;0
205;0;22103059;205;217;710;710;7.91;0.49;102.40;5.09;505;0;207.00;0
206;0;22103069;206;218;710;710;7.73;0.48;102.89;5.09;504;0;208.00;0
208;0;22103079;208;225;711;711;7.65;0.47;102.86;5.08;503;0;209.00;0
210;0;22103090;210;229;711;711;7.47;0.46;102.14;5.08;501;0;210.00;0
214;0;22103098;214;235;711;711;7.37;0.45;102.79;5.08;497;0;211.00;0
214;0;22103104;214;240;711;711;7.25;0.45;102.79;5.08;497;0;212.00;0
217;0;22103112;217;244;711;711;7.16;0.44;103.22;5.08;494;0;213.00;0
217;0;22103118;217;248;711;711;7.09;0.44;103.22;5.08;494;0;214.00;0
218;0;22103124;218;253;711;711;7.01;0.43;103.65;5.08;493;0;215.00;0
220;0;22103132;220;270;754;781;7.17;0.44;103.80;4.79;534;0;216.00;27
221;0;22103146;221;267;756;782;7.13;0.44;103.96;4.78;535;0;217.00;26
222;0;22103153;222;265;762;782;7.24;0.45;104.23;4.76;540;0;218.00;20
222;0;22103161;222;266;763;782;7.29;0.45;104.23;4.76;541;0;219.00;19
223;0;22103168;223;269;765;782;7.30;0.45;104.33;4.75;542;0;220.00;17
225;0;22103174;225;273;768;782;7.29;0.45;104.62;4.76;543;0;221.00;14
229;0;22103183;229;263;770;782;7.30;0.45;105.33;4.76;541;0;222.00;12
230;0;22103191;230;261;772;782;7.30;0.45;105.22;4.76;542;0;223.00;10
230;0;22103203;230;245;774;783;7.39;0.46;105.22;4.77;544;0;224.00;9
231;0;22103217;231;237;776;785;7.51;0.46;105.47;4.77;545;0;225.00;9
231;0;22103228;231;235;778;785;7.68;0.47;105.47;4.79;547;0;226.00;7
232;0;22103237;232;233;784;789;7.83;0.48;105.95;4.78;552;0;227.00;5
232;0;22103247;232;230;786;789;8.03;0.49;105.95;4.79;554;0;228.00;3
236;0;22103256;236;230;787;789;8.20;0.50;108.00;4.80;551;0;229.00;2
237;0;22103266;237;230;788;789;8.38;0.51;108.19;4.81;551;0;230.00;1
238;0;22103286;238;217;794;795;8.53;0.52;108.36;4.79;556;0;231.00;1
239;0;22103299;239;211;795;795;8.63;0.53;108.01;4.79;556;0;232.00;0
239;0;22103311;239;201;795;795;8.74;0.54;108.01;4.79;556;0;233.00;0
241;0;22103321;241;189;797;798;8.91;0.54;109.06;4.78;556;0;234.00;1
241;0;22103332;241;177;797;798;9.01;0.55;109.06;4.78;556;0;235.00;1
243;0;22103340;243;171;798;798;9.12;0.56;109.71;4.77;555;0;236.00;0
245;0;22103352;245;164;799;799;9.15;0.56;109.27;4.77;554;0;237.00;0
249;0;22103361;249;161;800;800;9.14;0.56;109.12;4.76;551;0;238.00;0
251;0;22103370;251;157;800;800;9.16;0.56;110.11;4.76;549;0;239.00;0
251;0;22103382;251;161;825;826;9.19;0.56;110.11;4.62;574;0;240.00;1
253;0;22103394;253;157;825;826;9.15;0.56;109.88;4.62;572;0;241.00;1
253;0;22103402;253;152;826;826;9.20;0.56;109.88;4.62;573;0;242.00;0
256;0;22103413;256;150;827;827;9.27;0.57;110.74;4.61;571;0;243.00;0
256;0;22103421;256;147;827;827;9.37;0.57;110.74;4.61;571;0;244.00;0
259;0;22103431;259;139;831;831;9.44;0.58;111.60;4.59;572;0;245.00;0
259;0;22103441;259;136;831;831;9.54;0.58;111.60;4.59;572;0;246.00;0
262;0;22103451;262;133;835;835;9.52;0.58;112.32;4.57;573;0;247.00;0
262;0;22103460;262;132;835;835;9.63;0.59;112.32;4.57;573;0;248.00;0
264;0;22103469;264;132;835;835;9.79;0.60;113.30;4.57;571;0;249.00;0
270;0;22103486;270;132;835;835;9.83;0.60;114.66;4.57;565;0;250.00;0
273;0;22103497;273;132;835;835;9.88;0.60;115.85;4.57;562;0;251.00;0
276;0;22103506;276;126;846;847;9.86;0.60;115.68;4.52;570;0;252.00;1
279;0;22103522;279;124;846;847;9.82;0.60;115.81;4.52;567;0;253.00;1
284;0;22103533;284;123;847;847;9.78;0.60;116.56;4.51;563;0;254.00;0
285;0;22103544;285;127;847;847;9.87;0.60;116.39;4.51;562;0;255.00;0
287;0;22103554;287;126;847;847;9.95;0.61;116.90;4.51;560;0;256.00;0
288;0;22103564;288;131;847;847;9.95;0.61;117.39;4.51;559;0;257.00;0
291;0;22103572;291;132;848;848;9.99;0.61;117.80;4.51;557;0;258.00;0
292;0;22103582;292;133;848;848;9.99;0.61;118.28;4.51;556;0;259.00;0
294;0;22103595;294;134;854;854;10.01;0.61;119.17;4.48;560;0;260.00;0
296;0;22103603;296;136;855;855;10.04;0.61;120.04;4.48;559;0;261.00;0
298;1;22103612;298;142;855;855;10.01;0.61;120.63;4.48;557;1;262.00;0
299;1;22103630;299;145;855;855;9.94;0.60;120.78;4.48;556;1;263.00;0
300;1;22103637;300;153;859;859;9.93;0.60;121.21;4.46;559;1;264.00;0
301;1;22103647;301;152;859;859;9.90;0.60;121.09;4.46;558;1;265.00;0
302;1;22103663;302;152;859;859;9.92;0.60;121.16;4.46;557;1;266.00;0
303;1;22103671;303;146;860;860;9.99;0.60;121.01;4.45;557;1;267.00;0
304;1;22103680;304;144;864;864;10.05;0.61;121.18;4.44;560;1;268.00;0
306;1;22103688;306;139;864;864;10.06;0.61;121.02;4.44;558;1;269.00;0
306;1;22103699;306;135;868;870;10.16;0.61;121.02;4.42;562;1;270.00;2
310;1;22103707;310;130;868;870;10.25;0.62;121.31;4.42;558;1;271.00;2
315;1;22103717;315;126;870;870;10.23;0.62;122.39;4.41;555;1;272.00;0
317;1;22103724;317;127;870;870;10.30;0.62;122.96;4.41;553;1;273.00;0
318;1;22103734;318;125;874;874;10.40;0.63;123.44;4.40;556;1;274.00;0
320;1;22103741;320;123;874;874;10.39;0.63;123.74;4.40;554;1;275.00;0
323;1;22103751;323;124;874;874;10.36;0.63;124.07;4.40;551;1;276.00;0
325;1;22103758;325;122;874;874;10.36;0.63;124.58;4.40;549;1;277.00;0
327;1;22103767;327;120;875;875;10.29;0.62;124.53;4.39;548;1;278.00;0
331;2;22103774;331;117;876;876;10.25;0.62;124.93;4.39;545;2;279.00;0
334;2;22103798;334;111;876;876;10.23;0.62;125.03;4.39;542;2;280.00;0
334;2;22103806;334;106;877;877;10.28;0.62;125.03;4.38;543;2;281.00;0
336;2;22103817;336;99;877;877;10.34;0.63;125.19;4.38;541;2;282.00;0
339;2;22103823;339;94;877;877;10.38;0.63;125.31;4.38;538;2;283.00;0
339;2;22103834;339;89;877;877;10.44;0.63;125.31;4.38;538;2;284.00;0
341;2;22103841;341;91;877;877;10.61;0.64;125.51;4.38;536;2;285.00;0
341;2;22103851;341;88;877;877;10.81;0.65;125.51;4.38;536;2;286.00;0
342;2;22103858;342;85;877;877;10.98;0.67;125.95;4.38;535;2;287.00;0
343;2;22103867;343;98;946;1004;10.82;0.67;125.90;4.07;603;2;288.00;58
343;2;22103889;343;84;948;1005;10.93;0.67;125.90;4.06;605;2;289.00;57
344;2;22103899;344;79;955;1005;11.02;0.68;125.75;4.05;611;2;290.00;50
346;2;22103908;346;78;959;1005;10.98;0.68;126.05;4.04;613;2;291.00;46
347;2;22103918;347;77;965;1005;11.07;0.68;125.91;4.04;618;2;292.00;40
348;2;22103928;348;74;965;1005;11.10;0.68;126.38;4.04;617;2;293.00;40
352;3;22103937;352;79;968;1005;11.15;0.68;126.51;4.05;616;3;294.00;37
354;3;22103967;354;79;971;1005;11.32;0.69;126.68;4.06;617;3;295.00;34
354;3;22103984;354;75;973;1006;11.42;0.70;126.68;4.06;619;3;296.00;33
357;3;22103999;357;76;977;1007;11.45;0.70;126.22;4.08;620;3;297.00;30
357;3;22104011;357;72;981;1007;11.49;0.70;126.22;4.11;624;3;298.00;26
359;3;22104021;359;74;983;1008;11.46;0.70;126.31;4.12;624;3;299.00;25
361;3;22104036;361;76;991;1014;11.21;0.69;126.66;4.16;630;3;300.00;23
363;3;22104057;363;75;995;1014;11.11;0.68;126.78;4.20;632;3;301.00;19
363;3;22104069;363;80;996;1014;11.02;0.68;126.78;4.21;633;3;302.00;18
364;3;22104080;364;88;999;1018;10.96;0.67;127.20;4.22;635;3;303.00;19
367;3;22104091;367;92;1003;1018;10.88;0.67;127.86;4.24;636;3;304.00;15
367;3;22104104;367;96;1005;1018;10.81;0.66;127.86;4.26;638;3;305.00;13
370;3;22104118;370;105;1009;1021;10.75;0.66;128.67;4.28;639;3;306.00;12
371;3;22104130;371;104;1011;1021;10.73;0.66;128.50;4.30;640;3;307.00;10
375;3;22104141;375;108;1012;1021;10.67;0.65;129.35;4.32;637;3;308.00;9
375;3;22104153;375;111;1017;1025;10.64;0.65;129.35;4.32;642;3;309.00;8
378;3;22104166;378;119;1019;1026;10.62;0.65;129.83;4.32;641;3;310.00;7
378;3;22104178;378;124;1020;1026;10.61;0.65;129.83;4.32;642;3;311.00;6
381;3;22104188;381;128;1027;1030;10.63;0.66;130.36;4.32;646;3;312.00;3
383;3;22104200;383;128;1027;1030;10.71;0.66;130.69;4.32;644;3;313.00;3
387;3;22104212;387;135;1027;1030;10.79;0.66;131.22;4.32;640;3;314.00;3
390;3;22104233;390;136;1030;1032;10.85;0.66;131.32;4.32;640;3;315.00;2
391;3;22104257;391;140;1030;1032;10.95;0.67;131.33;4.32;639;3;316.00;2
391;3;22104269;391;144;1036;1038;10.99;0.67;131.33;4.30;645;3;317.00;2
396;3;22104282;396;144;1036;1038;10.97;0.67;132.70;4.30;640;3;318.00;2
397;3;22104294;397;148;1037;1039;10.86;0.67;132.65;4.30;640;3;319.00;2
399;3;22104307;399;150;1037;1039;10.69;0.65;133.24;4.30;638;3;320.00;2
401;3;22104319;401;153;1037;1039;10.49;0.64;133.35;4.30;636;3;321.00;2
403;3;22104330;403;158;1037;1039;10.26;0.63;133.86;4.30;634;3;322.00;2
406;3;22104338;406;162;1037;1039;10.09;0.62;134.20;4.30;631;3;323.00;2
408;3;22104350;408;166;1047;1051;9.89;0.61;134.55;4.26;639;3;324.00;4
409;3;22104361;409;163;1047;1051;9.73;0.60;134.98;4.26;638;3;325.00;4
411;3;22104370;411;166;1049;1051;9.55;0.59;135.19;4.25;638;3;326.00;2
412;3;22104383;412;167;1049;1051;9.45;0.58;135.57;4.25;637;3;327.00;2
416;3;22104395;416;167;1049;1051;9.38;0.58;136.50;4.25;633;3;328.00;2
417;3;22104405;417;174;1049;1051;9.36;0.58;136.53;4.25;632;3;329.00;2
420;3;22104416;420;179;1053;1055;9.34;0.57;136.63;4.28;633;3;330.00;2
421;3;22104426;421;176;1053;1055;9.40;0.58;136.66;4.28;632;3;331.00;2
425;3;22104436;425;177;1058;1059;9.54;0.58;137.22;4.30;633;3;332.00;1
428;3;22104447;428;185;1060;1060;9.61;0.59;138.05;4.30;632;3;333.00;0
428;3;22104457;428;188;1060;1060;9.75;0.60;138.05;4.30;632;3;334.00;0
429;3;22104468;429;189;1060;1060;9.80;0.60;138.20;4.30;631;3;335.00;0
431;3;22104478;431;196;1073;1073;9.76;0.60;138.50;4.25;642;3;336.00;0
433;3;22104488;433;194;1073;1073;9.73;0.60;138.36;4.25;640;3;337.00;0
435;3;22104498;435;195;1073;1073;9.63;0.59;138.78;4.25;638;3;338.00;0
437;3;22104506;437;202;1074;1074;9.57;0.59;139.41;4.24;637;3;339.00;0
441;3;22104516;441;205;1075;1075;9.39;0.58;139.63;4.24;634;3;340.00;0
446;3;22104524;446;207;1075;1075;9.21;0.56;140.68;4.24;629;3;341.00;0
451;3;22104534;451;209;1078;1078;9.05;0.55;142.35;4.23;627;3;342.00;0
453;3;22104544;453;215;1078;1078;8.91;0.55;143.24;4.23;625;3;343.00;0
456;3;22104553;456;212;1078;1078;8.78;0.54;144.27;4.23;622;3;344.00;0
459;3;22104563;459;208;1078;1078;8.70;0.54;145.00;4.23;619;3;345.00;0
461;3;22104571;461;208;1084;1084;8.63;0.53;145.72;4.21;623;3;346.00;0
463;3;22104582;463;211;1084;1084;8.41;0.52;146.59;4.21;621;3;347.00;0
468;3;22104590;468;212;1084;1084;8.18;0.50;147.22;4.21;616;3;348.00;0
470;3;22104600;470;213;1084;1084;8.00;0.49;147.66;4.21;614;3;349.00;0
474;3;22104607;474;203;1088;1088;7.90;0.49;148.14;4.20;614;3;350.00;0
475;3;22104617;475;204;1089;1089;7.81;0.48;148.10;4.20;614;3;351.00;0
481;3;22104624;481;198;1089;1089;7.79;0.48;149.18;4.20;608;3;352.00;0
487;3;22104634;487;198;1090;1090;7.83;0.48;149.24;4.19;603;3;353.00;0
487;3;22104647;487;198;1090;1090;7.93;0.49;149.24;4.19;603;3;354.00;0
492;3;22104658;492;197;1090;1090;7.91;0.49;150.06;4.19;598;3;355.00;0
494;3;22104671;494;199;1090;1090;7.96;0.49;149.78;4.19;596;3;356.00;0
498;3;22104681;498;197;1090;1090;7.92;0.49;150.00;4.19;592;3;357.00;0
502;3;22104692;502;197;1090;1090;7.96;0.49;151.00;4.19;588;3;358.00;0
505;3;22104702;505;196;1090;1090;8.06;0.50;151.35;4.19;585;3;359.00;0
508;3;22104715;508;206;1158;1215;8.24;0.52;151.83;3.95;650;3;360.00;57
512;3;22104740;512;205;1163;1216;8.20;0.52;151.94;3.93;651;3;361.00;53
517;3;22104752;517;210;1174;1216;8.23;0.52;152.27;3.92;657;3;362.00;42
521;3;22104774;521;216;1179;1216;8.16;0.51;152.15;3.91;658;3;363.00;37
525;3;22104787;525;216;1187;1216;8.08;0.50;151.86;3.91;662;3;364.00;29
528;3;22104801;528;221;1189;1216;7.96;0.49;151.87;3.91;661;3;365.00;27
529;3;22104815;529;224;1194;1216;7.89;0.49;151.91;3.92;665;3;366.00;22
530;3;22104822;530;231;1199;1216;7.89;0.49;151.96;3.94;669;3;367.00;17
532;3;22104833;532;232;1205;1217;7.78;0.48;151.89;3.96;673;3;368.00;12
537;3;22104841;537;242;1209;1218;7.61;0.47;151.81;3.97;672;3;369.00;9
539;3;22104852;539;244;1213;1218;7.47;0.46;151.88;3.99;674;3;370.00;5
543;3;22104861;543;246;1218;1222;7.30;0.45;151.66;3.98;675;3;371.00;4
543;3;22104872;543;255;1218;1222;7.20;0.45;151.66;3.98;675;3;372.00;4
544;3;22104882;544;265;1218;1222;7.10;0.44;151.43;3.98;674;3;373.00;4
548;3;22104900;548;264;1220;1222;6.97;0.43;151.59;3.99;672;3;374.00;2
548;3;22104911;548;269;1225;1228;6.91;0.43;151.59;3.98;677;3;375.00;3
550;3;22104920;550;278;1226;1228;6.76;0.42;151.45;3.99;676;3;376.00;2
552;3;22104932;552;283;1226;1228;6.69;0.41;151.60;3.99;674;3;377.00;2
553;3;22104944;553;292;1229;1231;6.62;0.41;151.49;3.98;676;3;378.00;2
553;3;22104953;553;298;1230;1231;6.53;0.40;151.49;4.00;677;3;379.00;1
556;3;22104964;556;300;1230;1231;6.42;0.39;151.27;4.00;674;3;380.00;1
557;3;22104973;557;291;1231;1232;6.33;0.39;151.56;3.99;674;3;381.00;1
558;3;22104984;558;284;1233;1233;6.39;0.39;151.64;3.99;675;3;382.00;0
562;3;22104995;562;279;1233;1233;6.40;0.39;151.40;3.99;671;3;383.00;0
562;3;22105006;562;276;1246;1246;6.61;0.41;151.40;3.95;684;3;384.00;0
567;3;22105021;567;276;1246;1246;6.64;0.41;150.83;3.95;679;3;385.00;0
567;3;22105033;567;274;1246;1246;6.82;0.42;150.83;3.95;679;3;386.00;0
568;3;22105042;568;276;1247;1247;6.91;0.42;151.11;3.95;679;3;387.00;0
571;3;22105062;571;280;1247;1247;7.03;0.43;151.62;3.95;676;3;388.00;0
573;3;22105073;573;277;1251;1251;7.18;0.44;151.57;3.94;678;3;389.00;0
576;3;22105089;576;276;1251;1251;7.27;0.44;151.71;3.94;675;3;390.00;0
577;3;22105105;577;278;1255;1255;7.35;0.45;151.50;3.93;678;3;391.00;0
577;3;22105120;577;271;1255;1255;7.37;0.45;151.50;3.93;678;3;392.00;0
578;3;22105133;578;274;1255;1255;7.38;0.45;151.60;3.93;677;3;393.00;0
580;3;22105150;580;272;1255;1255;7.32;0.45;151.51;3.93;675;3;394.00;0
582;3;22105167;582;272;1255;1255;7.34;0.45;151.40;3.93;673;3;395.00;0
583;3;22105181;583;278;1265;1267;7.48;0.46;151.38;3.90;682;3;396.00;2
584;3;22105192;584;263;1266;1267;7.60;0.46;151.61;3.89;682;3;397.00;1
585;3;22105205;585;253;1267;1267;7.71;0.47;151.41;3.89;682;3;398.00;0
585;3;22105217;585;253;1267;1267;7.82;0.48;151.41;3.89;682;3;399.00;0
585;3;22105233;585;244;1267;1267;7.97;0.49;151.41;3.89;682;3;400.00;0
585;3;22105260;585;245;1267;1267;8.05;0.49;151.41;3.89;682;3;401.00;0
586;3;22105273;586;244;1268;1268;8.13;0.50;151.35;3.89;682;3;402.00;0
591;3;22105285;591;244;1268;1268;8.21;0.50;152.21;3.89;677;3;403.00;0
593;3;22105297;593;249;1274;1274;8.30;0.51;152.58;3.88;681;3;404.00;0
595;3;22105310;595;245;1276;1276;8.38;0.51;152.29;3.87;681;3;405.00;0
595;3;22105332;595;229;1276;1276;8.48;0.52;152.29;3.87;681;3;406.00;0
598;3;22105348;598;219;1276;1276;8.55;0.52;152.74;3.87;678;3;407.00;0
602;3;22105362;602;212;1280;1280;8.64;0.53;153.03;3.86;678;3;408.00;0
603;3;22105372;603;207;1280;1280;8.73;0.53;153.44;3.86;677;3;409.00;0
608;3;22105385;608;209;1280;1280;8.72;0.53;154.02;3.86;672;3;410.00;0
609;3;22105397;609;206;1281;1281;8.75;0.53;154.20;3.86;672;3;411.00;0
612;3;22105409;612;206;1285;1285;8.75;0.53;154.64;3.85;673;3;412.00;0
614;3;22105427;614;205;1285;1285;8.75;0.53;155.35;3.85;671;3;413.00;0
614;3;22105437;614;204;1287;1288;8.83;0.54;155.35;3.84;673;3;414.00;1
615;3;22105455;615;208;1287;1288;8.80;0.54;155.38;3.84;672;3;415.00;1
617;3;22105474;617;209;1288;1288;8.86;0.54;155.59;3.84;671;3;416.00;0
619;3;22105489;619;207;1288;1288;8.91;0.54;156.07;3.84;669;3;417.00;0
622;3;22105502;622;200;1292;1292;8.97;0.55;156.79;3.83;670;3;418.00;0
626;3;22105514;626;190;1292;1292;9.02;0.55;157.45;3.83;666;3;419.00;0
627;3;22105529;627;182;1292;1292;9.10;0.56;157.81;3.83;665;3;420.00;0
628;3;22105539;628;179;1292;1292;9.11;0.56;157.77;3.83;664;3;421.00;0
630;3;22105550;630;172;1293;1293;9.12;0.56;158.43;3.83;663;3;422.00;0
632;3;22105561;632;177;1294;1294;9.19;0.56;158.74;3.83;662;3;423.00;0
633;3;22105571;633;176;1294;1294;9.23;0.56;158.92;3.83;661;3;424.00;0
635;3;22105583;635;174;1295;1295;9.22;0.56;159.39;3.82;660;3;425.00;0
641;3;22105593;641;174;1295;1295;9.15;0.56;160.07;3.82;654;3;426.00;0
642;3;22105606;642;174;1295;1295;9.13;0.56;160.11;3.82;653;3;427.00;0
646;3;22105617;646;172;1295;1295;9.11;0.55;160.09;3.82;649;3;428.00;0
650;3;22105628;650;179;1295;1295;9.14;0.56;160.88;3.82;645;3;429.00;0
653;3;22105638;653;179;1295;1295;9.19;0.56;161.29;3.82;642;3;430.00;0
656;3;22105650;656;175;1295;1295;9.19;0.56;161.97;3.82;639;3;431.00;0
657;3;22105661;657;196;1375;1422;9.06;0.56;162.34;3.60;718;3;432.00;47
660;3;22105683;660;185;1375;1423;9.11;0.57;163.05;3.60;715;3;433.00;48
664;3;22105699;664;182;1380;1423;9.24;0.57;164.19;3.60;716;3;434.00;43
666;3;22105710;666;177;1382;1423;9.26;0.57;164.39;3.60;716;3;435.00;41
668;3;22105721;668;175;1386;1423;9.28;0.57;164.27;3.60;718;3;436.00;37
670;3;22105739;670;178;1387;1423;9.24;0.57;164.49;3.60;717;3;437.00;36
672;3;22105751;672;179;1390;1423;9.23;0.57;164.76;3.60;718;3;438.00;33
675;3;22105762;675;186;1392;1423;9.27;0.57;165.11;3.61;717;3;439.00;31
676;3;22105772;676;183;1394;1424;9.37;0.58;165.40;3.61;718;3;440.00;30
678;3;22105785;678;180;1398;1425;9.48;0.58;165.84;3.63;720;3;441.00;27
683;3;22105798;683;173;1400;1425;9.48;0.58;166.21;3.64;717;3;442.00;25
684;3;22105808;684;172;1402;1426;9.62;0.59;166.40;3.65;718;3;443.00;24
689;3;22105820;689;173;1404;1426;9.72;0.60;166.77;3.66;715;3;444.00;22
691;3;22105832;691;170;1407;1426;9.79;0.60;166.96;3.68;716;3;445.00;19
693;3;22105846;693;169;1408;1426;9.84;0.60;167.04;3.69;715;3;446.00;18
694;3;22105857;694;173;1412;1430;9.95;0.61;167.34;3.70;718;3;447.00;18
697;3;22105870;697;173;1413;1430;9.98;0.61;167.52;3.70;716;3;448.00;17
701;3;22105882;701;175;1416;1430;9.92;0.61;167.84;3.72;715;3;449.00;14
706;3;22105896;706;176;1421;1436;9.94;0.61;168.77;3.74;715;3;450.00;15
708;3;22105908;708;173;1421;1436;10.00;0.61;168.83;3.74;713;3;451.00;15
711;3;22105920;711;173;1423;1436;10.04;0.61;169.32;3.75;712;3;452.00;13
713;3;22105933;713;171;1427;1440;10.01;0.61;169.29;3.75;714;3;453.00;13
714;3;22105944;714;164;1430;1441;9.99;0.61;169.49;3.76;716;3;454.00;11
716;3;22105957;716;163;1432;1441;9.90;0.60;169.70;3.78;716;3;455.00;9
721;3;22105970;721;155;1435;1445;9.94;0.60;169.76;3.78;714;3;456.00;10
725;3;22105983;725;152;1435;1445;9.91;0.60;170.41;3.78;710;3;457.00;10
728;3;22105996;728;146;1438;1445;9.89;0.60;171.10;3.81;710;3;458.00;7
732;3;22106009;732;140;1439;1446;9.85;0.60;171.39;3.81;707;3;459.00;7
734;3;22106023;734;142;1439;1446;9.85;0.60;171.94;3.81;705;3;460.00;7
736;3;22106037;736;139;1443;1452;9.90;0.60;172.17;3.80;707;3;461.00;9
737;3;22106051;737;138;1443;1452;9.93;0.60;172.53;3.80;706;3;462.00;9
740;3;22106067;740;136;1443;1453;9.96;0.60;172.88;3.80;703;3;463.00;10
744;3;22106079;744;132;1443;1453;9.94;0.60;173.16;3.80;699;3;464.00;10
747;3;22106097;747;133;1443;1453;9.96;0.60;173.23;3.80;696;3;465.00;10
749;3;22106114;749;130;1443;1453;9.94;0.60;173.43;3.80;694;3;466.00;10
753;3;22106126;753;129;1443;1453;9.89;0.60;173.63;3.80;690;3;467.00;10
754;3;22106138;754;127;1453;1465;9.92;0.60;173.54;3.77;699;3;468.00;12
757;3;22106151;757;133;1454;1465;9.93;0.60;173.89;3.77;697;3;469.00;11
759;3;22106164;759;132;1454;1465;9.97;0.60;174.11;3.77;695;3;470.00;11
761;3;22106175;761;132;1454;1465;9.98;0.60;173.95;3.77;693;3;471.00;11
765;3;22106189;765;134;1454;1465;10.03;0.61;174.42;3.77;689;3;472.00;11
767;3;22106202;767;130;1454;1465;10.11;0.61;174.41;3.77;687;3;473.00;11
768;3;22106214;768;128;1457;1469;10.13;0.61;174.43;3.77;689;3;474.00;12
770;3;22106226;770;129;1457;1469;10.17;0.61;174.67;3.77;687;3;475.00;12
771;3;22106238;771;128;1461;1473;10.21;0.62;174.83;3.79;690;3;476.00;12
773;3;22106251;773;132;1462;1474;10.22;0.62;175.35;3.78;689;3;477.00;12
775;3;22106264;775;135;1463;1474;10.19;0.62;175.43;3.81;688;3;478.00;11
778;3;22106277;778;138;1465;1474;10.14;0.61;175.30;3.86;687;3;479.00;9
780;3;22106290;780;140;1488;1500;10.07;0.61;175.48;3.83;708;3;480.00;12
781;3;22106307;781;136;1491;1500;10.06;0.61;175.50;3.85;710;3;481.00;9
783;3;22106320;783;142;1492;1500;10.15;0.62;175.54;3.85;709;3;482.00;8
784;3;22106334;784;139;1495;1501;10.18;0.62;175.48;3.87;711;3;483.00;6
785;3;22106357;785;140;1495;1502;10.22;0.62;175.41;3.87;710;3;484.00;7
789;3;22106382;789;144;1496;1502;10.18;0.62;175.41;3.88;707;3;485.00;6
790;3;22106401;790;140;1498;1505;10.20;0.62;175.33;3.88;708;3;486.00;7
791;3;22106421;791;143;1501;1505;10.20;0.62;175.27;3.91;710;3;487.00;4
792;3;22106444;792;152;1503;1505;10.23;0.62;175.43;3.91;711;3;488.00;2
794;3;22106464;794;154;1503;1505;10.22;0.62;175.59;3.91;709;3;489.00;2
797;3;22106485;797;163;1509;1511;10.24;0.62;175.70;3.90;712;3;490.00;2
798;3;22106512;798;168;1510;1511;10.18;0.62;175.74;3.90;712;3;491.00;1
799;3;22106539;799;174;1510;1511;10.08;0.61;175.68;3.90;711;3;492.00;1
801;3;22106566;801;179;1511;1511;9.93;0.61;175.75;3.91;710;3;493.00;0
803;3;22106584;803;187;1514;1515;9.74;0.59;175.72;3.90;711;3;494.00;1
805;3;22106612;805;196;1517;1517;9.61;0.59;175.53;3.90;712;3;495.00;0
806;3;22106633;806;203;1517;1517;9.51;0.58;175.40;3.90;711;3;496.00;0
808;3;22106661;808;209;1518;1518;9.41;0.58;175.70;3.89;710;3;497.00;0
812;3;22106687;812;212;1518;1518;9.29;0.57;175.60;3.89;706;3;498.00;0
812;3;22106711;812;213;1518;1518;9.21;0.57;175.60;3.89;706;3;499.00;0
815;3;22106735;815;214;1518;1518;9.15;0.56;175.93;3.89;703;3;500.00;0
816;3;22106755;816;219;1518;1518;9.09;0.56;176.13;3.89;702;3;501.00;0
816;3;22106770;816;221;1518;1518;9.05;0.56;176.13;3.89;702;3;502.00;0
819;3;22106783;819;223;1518;1518;9.01;0.55;176.19;3.89;699;3;503.00;0
821;3;22106796;821;229;1557;1588;9.21;0.57;176.26;3.80;736;3;504.00;31
823;3;22106819;823;231;1560;1589;9.22;0.57;176.36;3.79;737;3;505.00;29
825;3;22106840;825;232;1569;1589;9.29;0.57;176.22;3.78;744;3;506.00;20
830;3;22106861;830;233;1570;1589;9.28;0.57;176.01;3.78;740;3;507.00;19
832;3;22106876;832;236;1573;1589;9.29;0.57;176.21;3.78;741;3;508.00;16
834;3;22106887;834;241;1574;1589;9.29;0.57;176.14;3.78;740;3;509.00;15
838;3;22106903;838;239;1575;1589;9.23;0.57;175.83;3.78;737;3;510.00;14
841;3;22106922;841;241;1580;1589;9.26;0.57;175.66;3.79;739;3;511.00;9
845;3;22106935;845;241;1581;1590;9.20;0.56;175.40;3.80;736;3;512.00;9
848;3;22106950;848;243;1583;1591;9.20;0.56;175.27;3.80;735;3;513.00;8
851;3;22106968;851;248;1586;1591;9.13;0.56;175.42;3.81;735;3;514.00;5
855;3;22106983;855;253;1592;1595;8.98;0.55;174.99;3.81;737;3;515.00;3
859;3;22106996;859;257;1594;1595;8.80;0.54;175.52;3.82;735;3;516.00;1
863;3;22107007;863;260;1595;1595;8.64;0.53;175.27;3.82;732;3;517.00;0
868;3;22107020;868;263;1595;1595;8.42;0.51;176.38;3.82;727;3;518.00;0
873;3;22107033;873;265;1601;1601;8.30;0.51;176.62;3.81;728;3;519.00;0
875;3;22107048;875;266;1601;1601;8.16;0.50;176.96;3.81;726;3;520.00;0
877;3;22107060;877;274;1601;1601;7.95;0.49;177.11;3.81;724;3;521.00;0
881;3;22107072;881;278;1604;1604;7.75;0.47;176.71;3.80;723;3;522.00;0
881;3;22107085;881;285;1604;1604;7.56;0.46;176.71;3.80;723;3;523.00;0
882;3;22107097;882;291;1604;1604;7.35;0.45;177.08;3.80;722;3;524.00;0
883;3;22107107;883;279;1605;1605;7.27;0.45;177.45;3.80;722;3;525.00;0
884;3;22107119;884;283;1606;1606;7.21;0.44;177.49;3.80;722;3;526.00;0
884;3;22107129;884;280;1606;1606;7.18;0.44;177.49;3.80;722;3;527.00;0
887;3;22107139;887;283;1619;1619;7.13;0.44;177.66;3.77;732;3;528.00;0
890;3;22107155;890;281;1619;1619;7.05;0.43;177.68;3.77;729;3;529.00;0
894;3;22107171;894;282;1619;1619;6.96;0.43;177.74;3.77;725;3;530.00;0
897;3;22107191;897;291;1620;1620;6.95;0.43;178.05;3.77;723;3;531.00;0
897;3;22107206;897;289;1620;1620;7.01;0.43;178.05;3.77;723;3;532.00;0
899;3;22107220;899;284;1624;1624;7.09;0.43;178.62;3.76;725;3;533.00;0
903;3;22107234;903;287;1624;1624;7.07;0.43;179.08;3.76;721;3;534.00;0
906;3;22107247;906;284;1628;1628;7.03;0.43;178.94;3.75;722;3;535.00;0
908;3;22107268;908;284;1628;1628;6.92;0.42;179.47;3.75;720;3;536.00;0
912;3;22107294;912;288;1628;1628;6.81;0.42;179.82;3.75;716;3;537.00;0
914;3;22107307;914;274;1628;1628;6.74;0.41;180.15;3.75;714;3;538.00;0
917;3;22107319;917;267;1628;1628;6.74;0.41;180.67;3.75;711;3;539.00;0
922;3;22107332;922;268;1658;1662;6.91;0.43;180.88;3.69;736;3;540.00;4
926;3;22107346;926;261;1659;1662;6.95;0.43;180.94;3.69;733;3;541.00;3
928;3;22107356;928;255;1661;1662;7.04;0.43;181.23;3.68;733;3;542.00;1
929;3;22107368;929;262;1661;1662;7.10;0.44;181.51;3.68;732;3;543.00;1
932;3;22107384;932;256;1662;1662;7.19;0.44;181.45;3.68;730;3;544.00;0
935;3;22107397;935;255;1662;1662;7.26;0.44;181.43;3.68;727;3;545.00;0
935;4;22107409;935;257;1663;1663;7.35;0.45;181.43;3.68;728;4;546.00;0
938;4;22107433;938;258;1663;1663;7.41;0.45;181.70;3.68;725;4;547.00;0
941;4;22107453;941;255;1669;1669;7.35;0.45;182.09;3.67;728;4;548.00;0
943;4;22107481;943;250;1670;1670;7.36;0.45;182.15;3.67;727;4;549.00;0
946;4;22107496;946;251;1670;1670;7.28;0.44;182.32;3.67;724;4;550.00;0
948;4;22107520;948;257;1670;1670;7.19;0.44;182.80;3.67;722;4;551.00;0
948;4;22107534;948;259;1674;1674;7.22;0.44;182.80;3.66;726;4;552.00;0
952;4;22107548;952;267;1674;1674;7.20;0.44;182.94;3.66;722;4;553.00;0
955;4;22107564;955;262;1674;1674;7.19;0.44;183.32;3.66;719;4;554.00;0
956;4;22107574;956;262;1675;1675;7.23;0.44;183.54;3.66;719;4;555.00;0
957;4;22107587;957;258;1678;1679;7.23;0.44;183.48;3.65;721;4;556.00;1
957;4;22107604;957;261;1678;1679;7.21;0.44;183.48;3.65;721;4;557.00;1
958;4;22107620;958;260;1681;1682;7.21;0.44;183.70;3.65;723;4;558.00;1
963;4;22107642;963;260;1681;1682;7.13;0.43;184.02;3.65;718;4;559.00;1
966;4;22107660;966;260;1682;1682;7.14;0.43;184.32;3.65;716;4;560.00;0
968;4;22107673;968;261;1682;1682;7.19;0.44;184.53;3.65;714;4;561.00;0
969;4;22107688;969;258;1686;1686;7.30;0.44;184.47;3.64;717;4;562.00;0
973;4;22107701;973;255;1686;1686;7.33;0.45;184.28;3.64;713;4;563.00;0
975;4;22107715;975;255;1686;1686;7.41;0.45;184.15;3.64;711;4;564.00;0
977;4;22107728;977;255;1686;1686;7.48;0.46;184.29;3.64;709;4;565.00;0
982;4;22107747;982;255;1687;1687;7.46;0.45;184.59;3.64;705;4;566.00;0
983;4;22107765;983;253;1688;1688;7.53;0.46;184.60;3.64;705;4;567.00;0
986;4;22107776;986;252;1688;1688;7.46;0.45;184.83;3.64;702;4;568.00;0
988;4;22107789;988;253;1689;1689;7.46;0.45;185.06;3.64;701;4;569.00;0
990;4;22107804;990;251;1689;1689;7.45;0.45;185.21;3.64;699;4;570.00;0
994;4;22107817;994;254;1689;1689;7.34;0.45;185.86;3.64;695;4;571.00;0
995;4;22107832;995;247;1689;1689;7.35;0.45;186.03;3.64;694;4;572.00;0
999;4;22107845;999;243;1689;1689;7.37;0.45;186.21;3.64;690;4;573.00;0
1002;4;22107856;1002;242;1689;1689;7.39;0.45;186.24;3.64;687;4;574.00;0
1004;4;22107871;1004;235;1689;1689;7.47;0.45;186.34;3.64;685;4;575.00;0
1005;4;22107885;1005;255;1770;1816;7.80;0.48;186.44;3.47;765;4;576.00;46
1008;4;22107919;1008;245;1774;1817;7.87;0.49;186.85;3.47;766;4;577.00;43
1009;4;22107935;1009;238;1782;1817;8.06;0.50;186.95;3.46;773;4;578.00;35
1011;4;22107949;1011;241;1785;1817;8.16;0.50;187.21;3.46;774;4;579.00;32
1013;4;22107963;1013;233;1790;1817;8.28;0.51;187.33;3.46;777;4;580.00;27
1016;4;22107981;1016;215;1792;1817;8.33;0.51;187.93;3.46;776;4;581.00;25
1018;4;22107999;1018;207;1795;1817;8.38;0.52;188.18;3.47;777;4;582.00;22
1020;4;22108016;1020;208;1797;1817;8.38;0.51;188.75;3.47;777;4;583.00;20
1022;4;22108036;1022;206;1799;1818;8.31;0.51;188.91;3.48;777;4;584.00;19
1023;4;22108062;1023;210;1805;1820;8.26;0.51;188.94;3.49;782;4;585.00;15
1025;4;22108077;1025;216;1807;1820;8.22;0.50;189.34;3.50;782;4;586.00;13
1028;4;22108092;1028;217;1810;1821;8.13;0.50;189.81;3.50;782;4;587.00;11
1030;4;22108112;1030;225;1812;1821;8.10;0.50;190.31;3.51;782;4;588.00;9
1034;4;22108128;1034;227;1814;1821;8.10;0.50;190.50;3.52;780;4;589.00;7
1038;4;22108143;1038;236;1815;1821;8.09;0.50;191.13;3.53;777;4;590.00;6
1039;4;22108158;1039;239;1819;1825;8.15;0.50;191.42;3.52;780;4;591.00;6
1041;4;22108173;1041;240;1820;1825;8.17;0.50;191.70;3.53;779;4;592.00;5
1042;4;22108191;1042;238;1822;1825;8.18;0.50;191.74;3.54;780;4;593.00;3
1045;4;22108207;1045;236;1824;1828;8.17;0.50;192.23;3.55;779;4;594.00;4
1046;4;22108222;1046;234;1825;1828;8.23;0.50;192.30;3.56;779;4;595.00;3
1049;4;22108235;1049;233;1825;1828;8.24;0.51;193.10;3.56;776;4;596.00;3
1052;4;22108250;1052;234;1831;1832;8.27;0.51;193.33;3.55;779;4;597.00;1
1056;4;22108266;1056;228;1833;1833;8.39;0.51;193.97;3.55;777;4;598.00;0
1060;4;22108278;1060;230;1833;1833;8.48;0.52;194.64;3.55;773;4;599.00;0
1062;4;22108295;1062;230;1842;1859;8.53;0.52;194.86;3.54;780;4;600.00;17
1066;4;22108323;1066;225;1844;1859;8.59;0.52;195.24;3.53;778;4;601.00;15
1071;4;22108339;1071;225;1845;1859;8.61;0.52;195.75;3.53;774;4;602.00;14
1072;4;22108353;1072;229;1847;1860;8.65;0.53;195.85;3.53;775;4;603.00;13
1076;4;22108367;1076;230;1848;1860;8.66;0.53;196.08;3.53;772;4;604.00;12
1077;4;22108382;1077;219;1852;1866;8.73;0.53;196.11;3.53;775;4;605.00;14
1079;4;22108397;1079;221;1854;1866;8.85;0.54;196.10;3.53;775;4;606.00;12
1079;4;22108419;1079;224;1855;1867;8.90;0.54;196.10;3.53;776;4;607.00;12
1082;4;22108437;1082;221;1856;1867;8.92;0.54;195.98;3.53;774;4;608.00;11
1083;4;22108453;1083;220;1857;1867;8.94;0.54;196.08;3.53;774;4;609.00;10
1086;4;22108469;1086;220;1857;1867;8.95;0.54;196.13;3.53;771;4;610.00;10
1086;4;22108485;1086;220;1857;1867;9.01;0.55;196.13;3.53;771;4;611.00;10
1086;4;22108504;1086;225;1867;1879;9.07;0.55;196.13;3.52;781;4;612.00;12
1088;4;22108537;1088;226;1867;1879;9.08;0.55;196.17;3.52;779;4;613.00;12
1088;4;22108560;1088;232;1869;1879;9.10;0.55;196.17;3.52;781;4;614.00;10
1088;4;22108572;1088;225;1869;1879;9.16;0.56;196.17;3.52;781;4;615.00;10
1089;4;22108587;1089;223;1869;1879;9.20;0.56;196.17;3.52;780;4;616.00;10
1090;4;22108606;1090;219;1869;1879;9.25;0.56;196.41;3.52;779;4;617.00;10
1094;4;22108621;1094;215;1873;1883;9.27;0.56;196.38;3.53;779;4;618.00;10
1094;5;22108636;1094;215;1873;1883;9.41;0.57;196.38;3.53;779;5;619.00;10
1097;5;22108666;1097;210;1877;1887;9.49;0.57;196.62;3.52;780;5;620.00;10
1100;5;22108690;1100;205;1878;1888;9.55;0.58;197.12;3.52;778;5;621.00;10
1101;5;22108708;1101;200;1878;1888;9.62;0.58;197.36;3.52;777;5;622.00;10
1103;5;22108731;1103;199;1879;1888;9.64;0.58;197.67;3.53;776;5;623.00;9
1104;5;22108760;1104;199;1889;1901;9.60;0.58;197.86;3.51;785;5;624.00;12
1108;5;22108775;1108;194;1889;1901;9.60;0.58;198.33;3.51;781;5;625.00;12
1112;5;22108790;1112;192;1889;1901;9.61;0.58;198.39;3.51;777;5;626.00;12
1115;5;22108806;1115;191;1890;1902;9.63;0.58;198.53;3.51;775;5;627.00;12
1117;5;22108820;1117;193;1892;1903;9.62;0.58;198.62;3.53;775;5;628.00;11
1121;5;22108834;1121;191;1892;1903;9.56;0.58;199.12;3.53;771;5;629.00;11
1125;5;22108849;1125;190;1899;1909;9.51;0.58;199.82;3.54;774;5;630.00;10
1130;5;22108865;1130;184;1900;1909;9.45;0.57;200.25;3.54;770;5;631.00;9
1133;5;22108881;1133;180;1901;1909;9.42;0.57;200.79;3.54;768;5;632.00;8
1137;5;22108895;1137;174;1901;1909;9.43;0.57;201.09;3.54;764;5;633.00;8
1140;6;22108908;1140;170;1906;1915;9.43;0.57;201.24;3.53;766;6;634.00;9
1143;6;22108937;1143;163;1906;1915;9.39;0.57;201.53;3.53;763;6;635.00;9
1144;6;22108950;1144;159;1906;1915;9.33;0.57;201.60;3.53;762;6;636.00;9
1146;6;22108963;1146;162;1906;1915;9.27;0.56;201.83;3.53;760;6;637.00;9
1149;6;22108974;1149;162;1909;1919;9.26;0.56;201.85;3.53;760;6;638.00;10
1153;6;22108994;1153;163;1910;1920;9.27;0.56;202.18;3.53;757;6;639.00;10
1154;6;22109010;1154;169;1910;1920;9.21;0.56;202.06;3.53;756;6;640.00;10
1156;6;22109024;1156;169;1911;1921;9.20;0.56;202.33;3.53;755;6;641.00;10
1159;6;22109036;1159;172;1911;1921;9.17;0.55;202.39;3.53;752;6;642.00;10
1160;6;22109050;1160;173;1911;1921;9.08;0.55;202.63;3.53;751;6;643.00;10
1160;6;22109067;1160;173;1911;1921;9.09;0.55;202.63;3.53;751;6;644.00;10
1161;6;22109082;1161;184;1911;1921;9.08;0.55;202.75;3.53;750;6;645.00;10
1164;6;22109098;1164;190;1911;1921;9.07;0.55;203.01;3.53;747;6;646.00;10
1166;6;22109111;1166;188;1912;1921;9.07;0.55;202.82;3.55;746;6;647.00;9
1168;6;22109124;1168;197;1948;1991;9.17;0.56;203.13;3.48;780;6;648.00;43
1170;6;22109150;1170;193;1950;1992;9.10;0.55;203.25;3.48;780;6;649.00;42
1175;6;22109166;1175;193;1958;1992;9.12;0.56;203.33;3.47;783;6;650.00;34
1177;6;22109182;1177;198;1961;1992;9.11;0.56;203.57;3.47;784;6;651.00;31
1179;6;22109199;1179;204;1965;1992;9.05;0.55;203.42;3.47;786;6;652.00;27
1182;6;22109216;1182;207;1967;1992;9.03;0.55;203.41;3.50;785;6;653.00;25
1182;6;22109232;1182;208;1969;1992;9.01;0.55;203.41;3.50;787;6;654.00;23
1183;6;22109246;1183;210;1971;1992;9.02;0.55;203.49;3.51;788;6;655.00;21
1187;6;22109261;1187;210;1974;1993;9.00;0.55;203.15;3.51;787;6;656.00;19
1190;6;22109275;1190;214;1980;1994;8.96;0.54;203.13;3.55;790;6;657.00;14
1193;6;22109288;1193;220;1983;1994;8.95;0.54;203.16;3.59;790;6;658.00;11
1195;6;22109301;1195;226;1989;1998;8.83;0.54;202.92;3.62;794;6;659.00;9
1196;6;22109317;1196;232;1990;1998;8.83;0.54;202.90;3.63;794;6;660.00;8
1196;6;22109331;1196;237;1992;1998;8.77;0.53;202.90;3.64;796;6;661.00;6
1197;6;22109344;1197;242;1992;1998;8.72;0.53;202.82;3.64;795;6;662.00;6
1198;6;22109355;1198;250;1997;2004;8.74;0.53;202.89;3.63;799;6;663.00;7
1201;6;22109368;1201;259;1999;2004;8.69;0.53;202.74;3.64;798;6;664.00;5
1203;6;22109382;1203;266;2001;2004;8.56;0.52;202.55;3.68;798;6;665.00;3
1205;6;22109394;1205;272;2003;2007;8.58;0.52;202.45;3.67;798;6;666.00;4
1207;6;22109406;1207;278;2005;2007;8.52;0.52;202.25;3.69;798;6;667.00;2
1208;6;22109418;1208;284;2007;2007;8.44;0.52;202.34;3.69;799;6;668.00;0
1209;6;22109432;1209;287;2008;2008;8.30;0.51;202.21;3.69;799;6;669.00;0
1210;6;22109441;1210;294;2009;2009;8.17;0.50;202.12;3.69;799;6;670.00;0
1211;6;22109454;1211;297;2009;2009;8.01;0.49;201.98;3.69;798;6;671.00;0
1214;6;22109467;1214;304;2022;2022;7.87;0.48;202.13;3.66;808;6;672.00;0
1217;6;22109480;1217;311;2022;2022;7.80;0.48;202.21;3.66;805;6;673.00;0
1219;6;22109489;1219;311;2022;2022;7.68;0.47;202.13;3.66;803;6;674.00;0
1220;6;22109503;1220;309;2024;2024;7.59;0.46;202.11;3.66;804;6;675.00;0
1221;6;22109520;1221;308;2024;2024;7.57;0.46;202.19;3.66;803;6;676.00;0
1223;6;22109535;1223;309;2028;2028;7.55;0.46;202.08;3.66;805;6;677.00;0
1225;6;22109550;1225;307;2028;2028;7.51;0.46;201.97;3.66;803;6;678.00;0
1228;6;22109565;1228;306;2032;2032;7.44;0.46;201.80;3.65;804;6;679.00;0
1231;6;22109578;1231;307;2032;2032;7.34;0.45;201.77;3.65;801;6;680.00;0
1233;6;22109591;1233;312;2032;2032;7.31;0.45;201.58;3.65;799;6;681.00;0
1239;6;22109604;1239;315;2032;2032;7.18;0.44;201.31;3.65;793;6;682.00;0
1239;6;22109620;1239;317;2032;2032;7.15;0.44;201.31;3.65;793;6;683.00;0
1241;6;22109633;1241;319;2042;2044;7.17;0.44;201.21;3.63;801;6;684.00;2
1245;6;22109646;1245;321;2042;2044;7.14;0.44;200.93;3.63;797;6;685.00;2
1246;6;22109657;1246;323;2044;2044;7.20;0.44;200.93;3.63;798;6;686.00;0
1248;6;22109670;1248;319;2044;2044;7.18;0.44;201.31;3.63;796;6;687.00;0
1250;6;22109684;1250;323;2044;2044;7.12;0.43;201.32;3.63;794;6;688.00;0
1252;6;22109697;1252;322;2044;2044;7.11;0.43;201.43;3.63;792;6;689.00;0
1256;6;22109720;1256;322;2045;2045;6.99;0.43;201.91;3.63;789;6;690.00;0
1256;6;22109738;1256;321;2045;2045;6.92;0.42;201.91;3.63;789;6;691.00;0
1260;6;22109755;1260;326;2051;2051;6.83;0.42;202.02;3.62;791;6;692.00;0
1263;6;22109769;1263;329;2052;2052;6.63;0.40;202.20;3.62;789;6;693.00;0
1263;6;22109781;1263;332;2052;2052;6.50;0.40;202.20;3.62;789;6;694.00;0
1267;6;22109789;1267;324;2052;2052;6.39;0.39;202.57;3.62;785;6;695.00;0
1270;6;22109801;1270;312;2056;2056;6.41;0.39;202.59;3.61;786;6;696.00;0
1271;6;22109811;1271;308;2056;2056;6.42;0.39;202.62;3.61;785;6;697.00;0
1274;6;22109820;1274;307;2056;2056;6.42;0.39;202.79;3.61;782;6;698.00;0
1280;6;22109831;1280;307;2057;2057;6.34;0.39;202.98;3.61;777;6;699.00;0
1281;6;22109840;1281;293;2061;2061;6.36;0.39;203.03;3.61;780;6;700.00;0
1283;6;22109855;1283;287;2061;2061;6.34;0.39;203.10;3.61;778;6;701.00;0
1287;6;22109877;1287;282;2063;2064;6.37;0.39;203.26;3.60;776;6;702.00;1
1288;6;22109889;1288;276;2063;2064;6.42;0.39;203.35;3.60;775;6;703.00;1
1290;6;22109900;1290;277;2064;2064;6.45;0.40;203.39;3.60;774;6;704.00;0
1295;6;22109911;1295;273;2064;2064;6.45;0.40;203.68;3.60;769;6;705.00;0
1297;6;22109930;1297;271;2068;2068;6.55;0.40;203.81;3.60;771;6;706.00;0
1298;6;22109941;1298;268;2068;2068;6.60;0.40;204.05;3.60;770;6;707.00;0
1300;6;22109955;1300;261;2068;2068;6.67;0.41;204.24;3.60;768;6;708.00;0
1302;6;22109970;1302;257;2068;2068;6.74;0.41;204.32;3.60;766;6;709.00;0
1305;6;22109984;1305;251;2069;2069;6.78;0.42;204.38;3.60;764;6;710.00;0
1307;6;22109997;1307;245;2070;2070;6.88;0.42;204.55;3.59;763;6;711.00;0
1308;6;22110010;1308;242;2070;2070;6.95;0.43;204.72;3.59;762;6;712.00;0
1314;6;22110024;1314;240;2071;2071;7.02;0.43;205.01;3.59;757;6;713.00;0
1315;6;22110039;1315;242;2071;2071;7.11;0.44;205.25;3.59;756;6;714.00;0
1320;6;22110053;1320;240;2071;2071;7.20;0.44;205.52;3.59;751;6;715.00;0
1322;6;22110066;1322;238;2071;2071;7.25;0.44;205.88;3.59;749;6;716.00;0
1325;6;22110080;1325;238;2071;2071;7.33;0.45;205.80;3.59;746;6;717.00;0
1331;6;22110094;1331;238;2071;2071;7.41;0.45;206.30;3.59;740;6;718.00;0
1333;6;22110110;1333;233;2071;2071;7.46;0.46;206.43;3.59;738;6;719.00;0
1336;6;22110129;1336;239;2168;2301;8.02;0.51;206.57;3.43;832;6;720.00;133
1340;6;22110165;1340;238;2179;2302;8.04;0.51;206.59;3.42;839;6;721.00;123
1344;6;22110178;1344;230;2196;2302;8.14;0.51;206.99;3.41;852;6;722.00;106
1349;6;22110189;1349;226;2203;2302;8.18;0.51;207.25;3.41;854;6;723.00;99
1354;6;22110203;1354;230;2217;2302;8.17;0.51;207.54;3.41;863;6;724.00;85
1358;6;22110216;1358;229;2225;2302;8.09;0.51;208.01;3.42;867;6;725.00;77
1363;6;22110230;1363;229;2233;2302;7.96;0.50;208.22;3.43;870;6;726.00;69
1365;6;22110240;1365;229;2241;2302;7.91;0.49;208.37;3.44;876;6;727.00;61
1370;6;22110254;1370;232;2250;2303;7.81;0.49;209.18;3.46;880;6;728.00;53
1374;6;22110274;1374;237;2257;2304;7.76;0.48;209.22;3.48;883;6;729.00;47
1377;6;22110295;1377;236;2262;2304;7.71;0.48;209.43;3.49;885;6;730.00;42
1383;6;22110311;1383;240;2266;2305;7.62;0.48;210.00;3.50;883;6;731.00;39
1385;6;22110324;1385;245;2271;2305;7.56;0.47;209.98;3.52;886;6;732.00;34
1390;6;22110339;1390;249;2273;2305;7.48;0.46;210.37;3.53;883;6;733.00;32
1394;6;22110355;1394;257;2276;2305;7.41;0.46;210.75;3.54;882;6;734.00;29
1397;6;22110378;1397;264;2279;2309;7.41;0.46;210.98;3.54;882;6;735.00;30
1402;6;22110393;1402;268;2281;2309;7.35;0.46;211.31;3.55;879;6;736.00;28
1406;6;22110406;1406;267;2284;2309;7.43;0.46;211.31;3.57;878;6;737.00;25
1410;6;22110422;1410;274;2286;2312;7.45;0.46;211.74;3.58;876;6;738.00;26
1414;6;22110439;1414;274;2289;2312;7.39;0.46;212.35;3.60;875;6;739.00;23
1419;6;22110454;1419;279;2291;2312;7.39;0.46;212.61;3.60;872;6;740.00;21
1424;6;22110485;1424;277;2296;2316;7.38;0.45;212.50;3.60;872;6;741.00;20
1428;6;22110510;1428;278;2298;2317;7.39;0.45;212.38;3.61;870;6;742.00;19
1431;6;22110546;1431;283;2300;2317;7.41;0.46;212.46;3.62;869;6;743.00;17
1433;6;22110564;1433;287;2305;2321;7.30;0.45;212.45;3.64;872;6;744.00;16
1433;6;22110598;1433;290;2307;2321;7.29;0.45;212.45;3.65;874;6;745.00;14
1436;6;22110616;1436;291;2308;2321;7.25;0.45;212.72;3.65;872;6;746.00;13
1439;6;22110633;1439;289;2309;2322;7.24;0.44;212.82;3.66;870;6;747.00;13
1443;6;22110652;1443;280;2310;2322;7.26;0.44;212.85;3.67;867;6;748.00;12
1444;6;22110681;1444;272;2315;2328;7.37;0.45;212.87;3.67;871;6;749.00;13
1446;6;22110699;1446;274;2317;2328;7.42;0.45;212.95;3.68;871;6;750.00;11
1451;6;22110716;1451;271;2319;2329;7.44;0.46;213.10;3.68;868;6;751.00;10
1453;6;22110735;1453;271;2320;2329;7.52;0.46;213.07;3.69;867;6;752.00;9
1456;6;22110752;1456;272;2320;2329;7.59;0.46;213.34;3.69;864;6;753.00;9
1457;6;22110767;1457;276;2322;2329;7.72;0.47;213.32;3.72;865;6;754.00;7
1458;6;22110781;1458;281;2322;2329;7.84;0.48;213.32;3.72;864;6;755.00;7
1460;6;22110801;1460;261;2333;2341;7.97;0.49;213.47;3.71;873;6;756.00;8
1462;6;22110816;1462;259;2334;2341;8.04;0.49;213.58;3.70;872;6;757.00;7
1466;6;22110830;1466;251;2335;2341;8.15;0.50;213.66;3.71;869;6;758.00;6
1467;6;22110857;1467;248;2336;2341;8.26;0.50;213.71;3.71;869;6;759.00;5
1469;6;22110876;1469;249;2336;2341;8.31;0.51;213.81;3.71;867;6;760.00;5
1472;6;22110891;1472;252;2336;2341;8.33;0.51;213.78;3.71;864;6;761.00;5
1473;6;22110906;1473;249;2340;2345;8.33;0.51;213.86;3.70;867;6;762.00;5
1475;6;22110921;1475;255;2340;2345;8.36;0.51;213.93;3.70;865;6;763.00;5
1479;6;22110936;1479;258;2344;2349;8.41;0.51;213.99;3.70;865;6;764.00;5
1481;6;22110954;1481;252;2346;2351;8.43;0.52;213.99;3.70;865;6;765.00;5
1482;6;22110971;1482;256;2346;2351;8.39;0.51;214.07;3.70;864;6;766.00;5
1485;6;22110989;1485;253;2346;2351;8.36;0.51;214.22;3.70;861;6;767.00;5
1488;6;22111008;1488;249;2356;2364;8.43;0.52;214.19;3.68;868;6;768.00;8
1488;6;22111030;1488;248;2356;2364;8.37;0.51;214.19;3.68;868;6;769.00;8
1493;6;22111056;1493;248;2356;2364;8.34;0.51;214.88;3.68;863;6;770.00;8
1495;6;22111073;1495;250;2357;2365;8.29;0.51;214.78;3.68;862;6;771.00;8
1497;6;22111091;1497;246;2357;2366;8.28;0.51;214.91;3.68;860;6;772.00;9
1498;6;22111106;1498;245;2357;2366;8.29;0.51;214.80;3.68;859;6;773.00;9
1503;6;22111122;1503;242;2359;2369;8.30;0.51;215.18;3.68;856;6;774.00;10
1504;6;22111140;1504;243;2359;2369;8.29;0.51;215.26;3.68;855;6;775.00;10
1508;7;22111156;1508;241;2360;2369;8.21;0.50;215.62;3.67;852;7;776.00;9
1511;7;22111189;1511;244;2360;2369;8.15;0.50;215.97;3.67;849;7;777.00;9
1514;7;22111203;1514;244;2365;2375;8.12;0.50;216.05;3.67;851;7;778.00;10
1517;7;22111217;1517;240;2365;2375;8.04;0.49;215.87;3.67;848;7;779.00;10
1518;7;22111238;1518;243;2365;2375;8.06;0.49;215.95;3.67;847;7;780.00;10
1518;7;22111252;1518;256;2365;2375;8.01;0.49;215.95;3.67;847;7;781.00;10
1521;7;22111265;1521;257;2368;2379;7.97;0.49;215.81;3.67;847;7;782.00;11
1523;7;22111279;1523;256;2369;2380;8.04;0.49;215.75;3.66;846;7;783.00;11
1525;7;22111292;1525;260;2369;2380;8.11;0.49;216.15;3.66;844;7;784.00;11
1527;7;22111306;1527;259;2370;2381;8.14;0.50;216.23;3.66;843;7;785.00;11
1530;7;22111320;1530;267;2370;2381;8.15;0.50;216.35;3.66;840;7;786.00;11
1532;7;22111333;1532;266;2370;2381;8.13;0.49;216.36;3.66;838;7;787.00;11
1533;7;22111350;1533;265;2370;2381;8.15;0.50;216.34;3.66;837;7;788.00;11
1533;7;22111368;1533;268;2370;2381;8.13;0.49;216.34;3.66;837;7;789.00;11
1533;7;22111383;1533;267;2370;2381;8.07;0.49;216.34;3.66;837;7;790.00;11
1538;7;22111398;1538;263;2370;2381;7.97;0.48;216.36;3.66;832;7;791.00;11
1538;7;22111415;1538;270;2401;2451;7.86;0.48;216.36;3.62;863;7;792.00;50
1539;7;22111437;1539;266;2401;2452;7.78;0.47;216.54;3.62;862;7;793.00;51
1540;7;22111454;1540;261;2406;2452;7.84;0.48;216.63;3.61;866;7;794.00;46
1544;7;22111471;1544;257;2407;2452;7.80;0.47;216.69;3.61;863;7;795.00;45
1548;7;22111488;1548;256;2410;2452;7.85;0.48;217.15;3.61;862;7;796.00;42
1552;7;22111505;1552;253;2411;2452;7.91;0.48;217.20;3.61;859;7;797.00;41
1553;7;22111522;1553;253;2413;2452;7.95;0.48;217.34;3.62;860;7;798.00;39
1557;7;22111542;1557;250;2415;2452;7.95;0.48;217.61;3.62;858;7;799.00;37
1561;7;22111565;1561;254;2417;2453;7.91;0.48;218.03;3.62;856;7;800.00;36
1563;7;22111584;1563;253;2421;2454;7.93;0.48;218.34;3.63;858;7;801.00;33
1568;7;22111598;1568;252;2422;2454;7.89;0.48;218.59;3.63;854;7;802.00;32
1571;7;22111613;1571;262;2425;2458;7.78;0.47;218.98;3.63;854;7;803.00;33
1573;7;22111628;1573;260;2427;2458;7.75;0.47;219.35;3.64;854;7;804.00;31
1575;7;22111640;1575;258;2431;2458;7.67;0.47;219.57;3.67;856;7;805.00;27
1577;7;22111656;1577;260;2432;2458;7.57;0.46;219.91;3.67;855;7;806.00;26
1579;7;22111669;1579;253;2437;2464;7.53;0.46;220.11;3.67;858;7;807.00;27
1581;7;22111683;1581;246;2438;2464;7.48;0.46;220.30;3.67;857;7;808.00;26
1582;7;22111696;1582;250;2438;2464;7.46;0.45;220.51;3.67;856;7;809.00;26
1586;7;22111710;1586;250;2444;2470;7.51;0.46;220.62;3.68;858;7;810.00;26
1586;7;22111724;1586;245;2444;2470;7.58;0.46;220.62;3.68;858;7;811.00;26
1589;7;22111740;1589;243;2446;2470;7.61;0.46;220.84;3.68;857;7;812.00;24
1589;7;22111754;1589;248;2446;2471;7.70;0.47;220.84;3.68;857;7;813.00;25
1591;7;22111767;1591;245;2447;2472;7.73;0.47;220.92;3.68;856;7;814.00;25
1595;7;22111782;1595;246;2447;2472;7.68;0.47;220.84;3.68;852;7;815.00;25
1597;7;22111794;1597;245;2456;2485;7.72;0.47;220.68;3.66;859;7;816.00;29
1599;7;22111807;1599;239;2456;2485;7.72;0.47;220.57;3.66;857;7;817.00;29
1600;7;22111821;1600;242;2456;2485;7.69;0.47;220.58;3.66;856;7;818.00;29
1601;7;22111835;1601;235;2457;2486;7.68;0.47;220.66;3.66;856;7;819.00;29
1602;7;22111848;1602;241;2457;2486;7.64;0.46;220.62;3.66;855;7;820.00;29
1604;7;22111862;1604;246;2460;2490;7.63;0.46;220.55;3.66;856;7;821.00;30
1605;7;22111878;1605;247;2460;2490;7.60;0.46;220.48;3.66;855;7;822.00;30
1607;7;22111889;1607;252;2464;2494;7.63;0.46;220.59;3.70;857;7;823.00;30
1607;7;22111904;1607;258;2464;2494;7.57;0.46;220.59;3.70;857;7;824.00;30
1607;7;22111919;1607;252;2465;2494;7.56;0.46;220.59;3.74;858;7;825.00;29
1609;7;22111932;1609;261;2467;2494;7.53;0.46;220.45;3.76;858;7;826.00;27
1611;7;22111945;1611;266;2468;2494;7.52;0.46;220.37;3.80;857;7;827.00;26
1612;7;22111956;1612;269;2479;2506;7.61;0.47;220.30;3.84;867;7;828.00;27
1616;7;22111972;1616;274;2481;2506;7.61;0.47;220.17;3.86;865;7;829.00;25
1618;7;22111985;1618;279;2484;2506;7.58;0.46;220.08;3.92;866;7;830.00;22
1619;7;22111999;1619;292;2485;2506;7.61;0.47;220.01;3.94;866;7;831.00;21
1621;7;22112012;1621;300;2487;2506;7.60;0.46;219.92;3.97;866;7;832.00;19
1623;7;22112023;1623;306;2490;2506;7.55;0.46;220.09;4.02;867;7;833.00;16
1624;7;22112037;1624;315;2491;2507;7.50;0.46;220.01;4.03;867;7;834.00;16
1626;7;22112050;1626;321;2494;2507;7.42;0.45;219.87;4.06;868;7;835.00;13
1629;7;22112063;1629;324;2501;2513;7.33;0.45;219.63;4.10;872;7;836.00;12
1633;8;22112074;1633;327;2503;2514;7.26;0.44;219.45;4.09;870;8;837.00;11
1635;8;22112110;1635;334;2503;2514;7.21;0.44;219.32;4.09;868;8;838.00;11
1636;8;22112123;1636;337;2505;2514;7.20;0.44;219.26;4.12;869;8;839.00;9
1638;8;22112138;1638;346;2508;2519;7.24;0.44;219.13;4.12;870;8;840.00;11
1640;8;22112153;1640;349;2510;2519;7.23;0.44;218.91;4.14;870;8;841.00;9
1644;8;22112168;1644;351;2513;2519;7.20;0.44;218.84;4.17;869;8;842.00;6
1645;8;22112183;1645;353;2514;2520;7.18;0.44;218.87;4.17;869;8;843.00;6
1646;8;22112197;1646;350;2520;2524;7.15;0.44;218.76;4.18;874;8;844.00;4
1647;8;22112208;1647;352;2520;2524;7.09;0.43;218.79;4.18;873;8;845.00;4
1649;8;22112223;1649;354;2524;2527;7.06;0.43;218.75;4.19;875;8;846.00;3
1653;8;22112236;1653;357;2526;2527;6.96;0.42;218.61;4.19;873;8;847.00;1
1655;8;22112249;1655;360;2527;2527;6.80;0.42;218.52;4.19;872;8;848.00;0
1655;8;22112261;1655;356;2527;2527;6.68;0.41;218.52;4.19;872;8;849.00;0
1658;8;22112272;1658;353;2531;2531;6.61;0.40;218.60;4.18;873;8;850.00;0
1661;8;22112285;1661;360;2531;2531;6.48;0.40;218.49;4.18;870;8;851.00;0
1661;8;22112298;1661;347;2531;2531;6.44;0.39;218.49;4.18;870;8;852.00;0
1661;8;22112312;1661;342;2531;2531;6.39;0.39;218.49;4.18;870;8;853.00;0
1661;8;22112323;1661;328;2532;2532;6.39;0.39;218.49;4.18;871;8;854.00;0
1664;8;22112335;1664;321;2534;2534;6.35;0.39;218.45;4.18;870;8;855.00;0
1665;8;22112348;1665;313;2534;2534;6.39;0.39;218.40;4.18;869;8;856.00;0
1668;8;22112360;1668;309;2535;2535;6.44;0.39;218.41;4.18;867;8;857.00;0
1669;8;22112372;1669;304;2535;2535;6.56;0.40;218.36;4.18;866;8;858.00;0
1669;8;22112397;1669;305;2535;2535;6.69;0.41;218.36;4.18;866;8;859.00;0
1670;8;22112408;1670;302;2535;2535;6.88;0.42;218.45;4.18;865;8;860.00;0
1670;8;22112419;1670;300;2535;2535;7.01;0.43;218.45;4.18;865;8;861.00;0
1673;8;22112431;1673;295;2535;2535;7.10;0.43;218.50;4.18;862;8;862.00;0
1674;8;22112442;1674;294;2535;2535;7.16;0.44;218.45;4.18;861;8;863.00;0
1677;8;22112454;1677;308;2607;2662;7.43;0.46;218.44;4.06;930;8;864.00;55
1680;8;22112478;1680;302;2613;2663;7.42;0.46;218.28;4.06;933;8;865.00;50
1685;8;22112489;1685;297;2624;2663;7.43;0.46;218.37;4.05;939;8;866.00;39
1686;8;22112508;1686;297;2628;2663;7.45;0.46;218.49;4.05;942;8;867.00;35
1689;8;22112521;1689;301;2633;2663;7.44;0.46;218.51;4.05;944;8;868.00;30
1692;8;22112533;1692;304;2635;2663;7.29;0.45;218.58;4.05;943;8;869.00;28
1695;8;22112547;1695;301;2637;2663;7.22;0.45;218.46;4.05;942;8;870.00;26
1700;8;22112558;1700;301;2639;2663;7.12;0.44;218.45;4.05;939;8;871.00;24
1703;8;22112570;1703;301;2642;2664;7.02;0.43;218.70;4.06;939;8;872.00;22
1705;8;22112583;1705;309;2646;2665;6.93;0.43;218.74;4.06;941;8;873.00;19
1712;8;22112595;1712;311;2648;2665;6.79;0.42;219.32;4.07;936;8;874.00;17
1714;8;22112607;1714;300;2651;2666;6.67;0.41;219.24;4.07;937;8;875.00;15
1718;8;22112619;1718;302;2652;2666;6.59;0.40;219.20;4.07;934;8;876.00;14
1720;8;22112632;1720;300;2657;2666;6.53;0.40;219.23;4.09;937;8;877.00;9
1723;8;22112645;1723;295;2658;2666;6.43;0.39;219.56;4.10;935;8;878.00;8
1727;8;22112656;1727;298;2663;2670;6.47;0.40;220.33;4.10;936;8;879.00;7
1730;8;22112670;1730;301;2664;2670;6.50;0.40;220.38;4.10;934;8;880.00;6
1732;8;22112684;1732;303;2666;2670;6.56;0.40;220.51;4.11;934;8;881.00;4
1739;8;22112698;1739;297;2668;2673;6.59;0.40;221.21;4.10;929;8;882.00;5
1741;8;22112715;1741;291;2669;2673;6.63;0.41;221.70;4.11;928;8;883.00;4
1746;8;22112727;1746;292;2669;2673;6.63;0.41;222.08;4.11;923;8;884.00;4
1748;8;22112739;1748;286;2675;2677;6.71;0.41;222.50;4.12;927;8;885.00;2
1751;8;22112752;1751;284;2676;2678;6.77;0.41;222.69;4.12;925;8;886.00;2
1753;8;22112766;1753;284;2677;2678;6.87;0.42;222.95;4.12;924;8;887.00;1
1758;8;22112779;1758;278;2682;2682;6.89;0.42;223.87;4.11;924;8;888.00;0
1760;8;22112791;1760;272;2682;2682;6.99;0.43;223.95;4.11;922;8;889.00;0
1766;8;22112804;1766;265;2682;2682;7.09;0.43;224.45;4.11;916;8;890.00;0
1768;8;22112822;1768;263;2683;2683;7.15;0.44;224.77;4.11;915;8;891.00;0
1770;8;22112835;1770;262;2683;2683;7.25;0.44;224.99;4.11;913;8;892.00;0
1775;8;22112849;1775;268;2689;2689;7.30;0.45;225.19;4.11;914;8;893.00;0
1783;8;22112864;1783;265;2689;2689;7.31;0.45;225.53;4.11;906;8;894.00;0
1785;8;22112877;1785;262;2690;2690;7.33;0.45;225.85;4.10;905;8;895.00;0
1792;8;22112889;1792;264;2690;2690;7.32;0.45;226.10;4.10;898;8;896.00;0
1796;8;22112904;1796;264;2690;2690;7.32;0.45;226.21;4.10;894;8;897.00;0
1799;8;22112919;1799;262;2690;2690;7.34;0.45;226.59;4.10;891;8;898.00;0
1804;8;22112932;1804;263;2690;2690;7.34;0.45;226.90;4.10;886;8;899.00;0
1807;8;22112948;1807;269;2721;2736;7.43;0.46;227.16;4.06;914;8;900.00;15
1810;8;22112977;1810;266;2722;2736;7.46;0.46;227.35;4.06;912;8;901.00;14
1812;8;22112991;1812;263;2726;2736;7.52;0.46;227.48;4.05;914;8;902.00;10
1817;8;22113006;1817;260;2726;2736;7.55;0.46;227.66;4.05;909;8;903.00;10
1820;8;22113020;1820;262;2728;2736;7.54;0.46;227.68;4.05;908;8;904.00;8
1824;8;22113034;1824;259;2728;2736;7.59;0.47;227.72;4.05;904;8;905.00;8
1829;8;22113048;1829;261;2733;2740;7.61;0.47;227.90;4.05;904;8;906.00;7
1833;8;22113062;1833;262;2734;2740;7.59;0.47;228.24;4.05;901;8;907.00;6
1838;8;22113074;1838;263;2737;2744;7.56;0.46;228.61;4.05;899;8;908.00;7
1843;8;22113090;1843;270;2738;2745;7.59;0.47;228.94;4.05;895;8;909.00;7
1848;8;22113106;1848;269;2738;2745;7.64;0.47;228.94;4.05;890;8;910.00;7
1850;8;22113123;1850;274;2739;2745;7.66;0.47;229.05;4.05;889;8;911.00;6
1857;8;22113140;1857;282;2750;2758;7.61;0.46;229.51;4.04;893;8;912.00;8
1861;8;22113158;1861;282;2750;2758;7.60;0.46;229.93;4.04;889;8;913.00;8
1864;8;22113178;1864;284;2750;2758;7.57;0.46;230.00;4.04;886;8;914.00;8
1868;8;22113197;1868;289;2750;2759;7.50;0.46;230.22;4.04;882;8;915.00;9
1872;8;22113215;1872;295;2751;2760;7.39;0.45;230.58;4.04;879;8;916.00;9
1875;8;22113232;1875;296;2753;2760;7.30;0.45;230.74;4.04;878;8;917.00;7
1877;8;22113252;1877;302;2755;2763;7.27;0.44;230.82;4.04;878;8;918.00;8
1882;8;22113276;1882;311;2755;2763;7.13;0.43;231.29;4.04;873;8;919.00;8
1884;8;22113297;1884;310;2756;2763;7.06;0.43;231.46;4.04;872;8;920.00;7
1887;8;22113315;1887;314;2757;2763;6.98;0.43;231.78;4.04;870;8;921.00;6
1889;8;22113335;1889;310;2762;2769;6.85;0.42;232.12;4.05;873;8;922.00;7
1893;8;22113353;1893;300;2763;2769;6.82;0.42;232.20;4.05;870;8;923.00;6
1897;8;22113378;1897;301;2766;2769;6.79;0.41;232.39;4.06;869;8;924.00;3
1900;8;22113400;1900;298;2768;2769;6.82;0.42;232.83;4.06;868;8;925.00;1
1900;8;22113421;1900;302;2773;2773;6.92;0.42;232.83;4.06;873;8;926.00;0
1906;8;22113441;1906;301;2774;2774;6.93;0.42;233.08;4.06;868;8;927.00;0
1914;8;22113459;1914;296;2774;2774;6.91;0.42;233.45;4.06;860;8;928.00;0
1914;8;22113482;1914;302;2775;2775;7.00;0.42;233.45;4.06;861;8;929.00;0
1916;8;22113511;1916;302;2775;2775;6.97;0.42;233.50;4.06;859;8;930.00;0
1918;8;22113530;1918;284;2775;2775;7.01;0.43;233.37;4.06;857;8;931.00;0
1920;8;22113547;1920;280;2775;2775;7.07;0.43;233.47;4.06;855;8;932.00;0
1922;8;22113565;1922;276;2775;2775;7.14;0.43;233.59;4.06;853;8;933.00;0
1925;8;22113585;1925;272;2775;2775;7.23;0.44;233.63;4.06;850;8;934.00;0
1929;8;22113607;1929;267;2775;2775;7.32;0.44;233.78;4.06;846;8;935.00;0
1930;8;22113626;1930;284;2820;2845;7.31;0.45;233.76;3.99;890;8;936.00;25
1932;8;22113653;1932;280;2820;2846;7.40;0.45;234.00;3.99;888;8;937.00;26
1938;8;22113672;1938;280;2826;2846;7.45;0.45;234.48;3.99;888;8;938.00;20
1939;8;22113690;1939;278;2828;2846;7.53;0.46;234.47;3.99;889;8;939.00;18
1945;8;22113708;1945;286;2830;2846;7.56;0.46;234.89;3.99;885;8;940.00;16
1947;8;22113728;1947;291;2832;2846;7.61;0.46;234.92;3.99;885;8;941.00;14
1948;8;22113747;1948;289;2835;2846;7.71;0.47;234.88;3.99;887;8;942.00;11
1950;8;22113766;1950;290;2838;2846;7.73;0.47;234.79;3.99;888;8;943.00;8
1950;8;22113784;1950;289;2839;2847;7.79;0.48;234.79;4.00;889;8;944.00;8
1950;8;22113803;1950;283;2842;2849;7.83;0.48;234.79;4.00;892;8;945.00;7
1953;8;22113820;1953;286;2845;2849;7.83;0.48;234.89;4.00;892;8;946.00;4
1956;8;22113837;1956;283;2849;2853;7.81;0.48;235.00;4.00;893;8;947.00;4
1958;8;22113855;1958;283;2850;2853;7.83;0.48;235.04;4.00;892;8;948.00;3
1959;8;22113872;1959;286;2850;2853;7.85;0.48;235.11;4.00;891;8;949.00;3
1960;8;22113893;1960;283;2850;2853;7.93;0.48;235.15;4.00;890;8;950.00;3
1965;8;22113911;1965;281;2855;2859;7.94;0.48;235.24;4.00;890;8;951.00;4
1965;8;22113929;1965;279;2855;2859;7.94;0.48;235.24;4.00;890;8;952.00;4
1967;8;22113941;1967;277;2855;2859;7.90;0.48;235.22;4.00;888;8;953.00;4
1969;8;22113955;1969;272;2857;2862;7.93;0.48;235.26;4.00;888;8;954.00;5
1971;8;22113971;1971;272;2858;2862;7.91;0.48;235.24;4.00;887;8;955.00;4
1973;8;22113985;1973;278;2859;2862;7.91;0.48;235.34;4.00;886;8;956.00;3
1976;8;22114000;1976;275;2859;2863;7.84;0.48;235.35;4.00;883;8;957.00;4
1978;8;22114024;1978;282;2860;2864;7.82;0.47;235.39;4.00;882;8;958.00;4
1982;8;22114051;1982;277;2861;2864;7.78;0.47;235.42;4.00;879;8;959.00;3
1984;9;22114069;1984;283;2882;2890;7.73;0.47;235.44;3.97;898;9;960.00;8
1984;9;22114098;1984;286;2882;2890;7.73;0.47;235.44;3.97;898;9;961.00;8
1986;9;22114112;1986;293;2884;2890;7.75;0.47;235.34;3.97;898;9;962.00;6
1986;9;22114124;1986;296;2886;2891;7.80;0.47;235.34;3.97;900;9;963.00;5
1987;9;22114140;1987;298;2886;2891;7.80;0.47;235.41;3.97;899;9;964.00;5
1988;9;22114155;1988;294;2890;2895;7.93;0.48;235.41;3.97;902;9;965.00;5
1990;9;22114183;1990;289;2890;2895;7.97;0.48;235.52;3.97;900;9;966.00;5
1992;9;22114216;1992;290;2893;2899;7.93;0.48;235.51;3.96;901;9;967.00;6
1993;9;22114231;1993;278;2893;2899;7.92;0.48;235.51;3.96;900;9;968.00;6
1994;9;22114245;1994;275;2893;2899;7.93;0.48;235.47;3.96;899;9;969.00;6
1995;9;22114258;1995;274;2893;2899;7.85;0.48;235.58;3.96;898;9;970.00;6
1997;9;22114272;1997;271;2893;2899;7.80;0.47;235.83;3.96;896;9;971.00;6
1997;9;22114286;1997;278;2902;2911;7.79;0.47;235.83;3.95;905;9;972.00;9
1998;9;22114306;1998;277;2902;2911;7.72;0.47;235.83;3.95;904;9;973.00;9
1999;9;22114320;1999;278;2904;2911;7.72;0.47;235.77;3.95;905;9;974.00;7
2001;9;22114335;2001;282;2904;2911;7.66;0.46;235.63;3.95;903;9;975.00;7
2001;9;22114347;2001;280;2904;2911;7.61;0.46;235.63;3.95;903;9;976.00;7
2003;9;22114358;2003;279;2904;2911;7.52;0.46;235.75;3.95;901;9;977.00;7
2004;9;22114372;2004;287;2904;2912;7.44;0.45;235.84;3.95;900;9;978.00;8
2008;9;22114386;2008;289;2904;2912;7.40;0.45;235.80;3.95;896;9;979.00;8
2010;9;22114400;2010;288;2910;2918;7.39;0.45;235.74;3.95;900;9;980.00;8
2013;9;22114417;2013;291;2912;2919;7.29;0.44;235.93;3.96;899;9;981.00;7
2016;9;22114431;2016;282;2912;2919;7.19;0.44;235.89;3.96;896;9;982.00;7
2017;9;22114445;2017;276;2912;2919;7.11;0.43;236.00;3.96;895;9;983.00;7
2018;9;22114461;2018;276;2914;2923;7.12;0.43;236.06;3.96;896;9;984.00;9
2021;9;22114478;2021;279;2914;2923;7.11;0.43;236.14;3.96;893;9;985.00;9
2023;9;22114492;2023;280;2914;2923;7.12;0.43;236.04;3.96;891;9;986.00;9
2023;9;22114507;2023;281;2915;2924;7.20;0.44;236.04;3.96;892;9;987.00;9
2026;9;22114524;2026;279;2918;2928;7.17;0.44;236.02;3.95;892;9;988.00;10
2031;9;22114543;2031;270;2918;2928;7.11;0.43;235.95;3.95;887;9;989.00;10
2036;9;22114567;2036;275;2922;2934;7.15;0.43;235.90;3.95;886;9;990.00;12
2037;9;22114586;2037;277;2923;2934;7.17;0.44;235.83;3.95;886;9;991.00;11
2042;9;22114605;2042;278;2924;2934;7.15;0.43;235.49;3.95;882;9;992.00;10
2045;9;22114622;2045;276;2925;2934;7.18;0.44;235.45;3.95;880;9;993.00;9
2048;9;22114639;2048;278;2929;2938;7.25;0.44;235.28;3.94;881;9;994.00;9
2050;9;22114658;2050;285;2929;2938;7.20;0.44;235.14;3.94;879;9;995.00;9
2051;9;22114674;2051;290;2929;2938;7.20;0.44;235.07;3.94;878;9;996.00;9
2052;9;22114690;2052;287;2929;2938;7.19;0.44;235.06;3.94;877;9;997.00;9
2056;9;22114703;2056;291;2929;2939;7.11;0.43;235.00;3.94;873;9;998.00;10
2056;9;22114719;2056;289;2930;2940;7.12;0.43;235.00;3.94;874;9;999.00;10
2059;9;22114737;2059;294;2930;2940;7.05;0.43;234.96;3.94;871;9;1000.00;10
2059;9;22114758;2059;290;2931;2941;6.98;0.42;234.96;3.94;872;9;1001.00;10
2059;9;22114774;2059;297;2931;2941;6.97;0.42;234.96;3.94;872;9;1002.00;10
2060;9;22114789;2060;303;2931;2941;6.93;0.42;234.95;3.94;871;9;1003.00;10
2061;9;22114804;2061;308;2931;2941;6.93;0.42;234.93;3.94;870;9;1004.00;10
2062;9;22114820;2062;313;2931;2941;6.92;0.42;234.88;3.94;869;9;1005.00;10
2063;9;22114839;2063;316;2933;2941;6.89;0.42;234.79;3.97;870;9;1006.00;8
2064;9;22114856;2064;323;2933;2941;6.86;0.42;234.75;3.97;869;9;1007.00;8
2065;9;22114874;2065;347;3001;3068;7.13;0.44;234.84;3.89;936;9;1008.00;67
2066;9;22114904;2066;330;3007;3069;7.13;0.44;234.81;3.91;941;9;1009.00;62
2069;9;22114921;2069;320;3018;3069;7.16;0.44;234.80;3.90;949;9;1010.00;51
2069;9;22114941;2069;314;3023;3069;7.20;0.45;234.80;3.92;954;9;1011.00;46
2069;9;22114957;2069;309;3030;3069;7.24;0.45;234.80;3.93;961;9;1012.00;39
2069;9;22114974;2069;310;3034;3069;7.19;0.45;234.80;3.94;965;9;1013.00;35
2073;9;22114993;2073;310;3036;3069;7.22;0.45;234.90;3.95;963;9;1014.00;33
2074;9;22115011;2074;302;3039;3069;7.21;0.45;234.97;3.96;965;9;1015.00;30
2078;9;22115033;2078;301;3042;3070;7.21;0.44;235.04;3.96;964;9;1016.00;28
2079;9;22115050;2079;300;3047;3071;7.25;0.45;235.06;3.97;968;9;1017.00;24
2079;9;22115067;2079;301;3052;3071;7.29;0.45;235.06;3.98;973;9;1018.00;19
2081;9;22115082;2081;303;3055;3072;7.27;0.45;235.07;3.99;974;9;1019.00;17
2085;9;22115102;2085;305;3059;3072;7.18;0.44;235.07;4.00;974;9;1020.00;13
2085;9;22115120;2085;308;3060;3072;7.10;0.44;235.07;4.00;975;9;1021.00;12
2088;9;22115138;2088;312;3063;3072;6.93;0.43;234.99;4.01;975;9;1022.00;9
2092;9;22115155;2092;324;3070;3076;6.76;0.42;234.82;4.02;978;9;1023.00;6
2092;9;22115180;2092;320;3071;3076;6.66;0.41;234.82;4.02;979;9;1024.00;5
2094;9;22115196;2094;321;3071;3076;6.55;0.40;234.77;4.02;977;9;1025.00;5
2095;9;22115211;2095;319;3074;3079;6.48;0.40;234.73;4.02;979;9;1026.00;5
2097;9;22115229;2097;314;3075;3079;6.40;0.39;234.72;4.03;978;9;1027.00;4
2099;9;22115245;2099;312;3075;3079;6.32;0.39;234.65;4.03;976;9;1028.00;4
2101;9;22115262;2101;320;3080;3083;6.28;0.39;234.70;4.03;979;9;1029.00;3
2104;9;22115281;2104;317;3082;3084;6.23;0.39;234.57;4.03;978;9;1030.00;2
2108;9;22115295;2108;319;3082;3084;6.26;0.39;234.50;4.03;974;9;1031.00;2
2112;9;22115313;2112;322;3087;3088;6.21;0.38;234.59;4.03;975;9;1032.00;1
2113;9;22115329;2113;321;3087;3088;6.27;0.39;234.54;4.03;974;9;1033.00;1
2115;9;22115346;2115;321;3088;3088;6.34;0.39;234.45;4.03;973;9;1034.00;0
2117;9;22115357;2117;322;3090;3090;6.38;0.39;234.54;4.02;973;9;1035.00;0
2120;9;22115372;2120;317;3090;3090;6.42;0.39;234.67;4.02;970;9;1036.00;0
2123;9;22115385;2123;318;3096;3096;6.47;0.40;234.69;4.02;973;9;1037.00;0
2125;9;22115399;2125;311;3096;3096;6.50;0.40;234.76;4.02;971;9;1038.00;0
2130;9;22115414;2130;313;3097;3097;6.43;0.39;234.98;4.02;967;9;1039.00;0
2134;9;22115427;2134;309;3097;3097;6.43;0.39;235.15;4.02;963;9;1040.00;0
2137;9;22115443;2137;312;3097;3097;6.36;0.39;235.33;4.02;960;9;1041.00;0
2141;9;22115457;2141;309;3097;3097;6.28;0.38;235.53;4.02;956;9;1042.00;0
2143;9;22115472;2143;317;3097;3097;6.24;0.38;235.63;4.02;954;9;1043.00;0
2147;9;22115486;2147;316;3109;3109;6.17;0.38;235.93;4.00;962;9;1044.00;0
2149;9;22115501;2149;314;3109;3109;6.16;0.38;235.96;4.00;960;9;1045.00;0
2151;9;22115515;2151;317;3109;3109;6.18;0.38;236.09;4.00;958;9;1046.00;0
2154;9;22115528;2154;315;3109;3109;6.21;0.38;236.08;4.00;955;9;1047.00;0
2158;9;22115546;2158;321;3109;3109;6.23;0.38;236.31;4.00;951;9;1048.00;0
2163;9;22115558;2163;324;3109;3109;6.20;0.38;236.37;4.00;946;9;1049.00;0
2163;9;22115574;2163;307;3115;3115;6.23;0.38;236.37;4.00;952;9;1050.00;0
2168;9;22115588;2168;294;3115;3115;6.25;0.38;236.48;4.00;947;9;1051.00;0
2169;9;22115601;2169;289;3119;3119;6.32;0.39;236.59;3.99;950;9;1052.00;0
2173;9;22115615;2173;285;3120;3120;6.31;0.39;236.67;3.99;947;9;1053.00;0
2176;9;22115630;2176;289;3120;3120;6.33;0.39;236.94;3.99;944;9;1054.00;0
2180;9;22115642;2180;288;3120;3120;6.37;0.39;237.05;3.99;940;9;1055.00;0
2184;9;22115656;2184;294;3133;3133;6.41;0.39;237.06;3.97;949;9;1056.00;0
2189;9;22115671;2189;283;3133;3133;6.52;0.40;237.22;3.97;944;9;1057.00;0
2191;9;22115685;2191;274;3133;3133;6.64;0.41;237.26;3.97;942;9;1058.00;0
2195;9;22115698;2195;258;3134;3134;6.75;0.41;237.52;3.97;939;9;1059.00;0
2198;9;22115712;2198;249;3135;3135;6.87;0.42;237.69;3.97;937;9;1060.00;0
2205;9;22115724;2205;248;3135;3135;6.94;0.42;238.01;3.97;930;9;1061.00;0
2208;9;22115739;2208;243;3138;3138;7.02;0.43;238.27;3.97;930;9;1062.00;0
2212;9;22115753;2212;243;3138;3138;7.04;0.43;238.67;3.97;926;9;1063.00;0
2215;9;22115767;2215;249;3138;3138;7.01;0.43;238.81;3.97;923;9;1064.00;0
2219;9;22115784;2219;255;3138;3138;7.01;0.43;238.79;3.97;919;9;1065.00;0
2225;9;22115800;2225;251;3144;3144;7.03;0.43;238.85;3.96;919;9;1066.00;0
2229;9;22115817;2229;259;3144;3144;6.99;0.43;239.11;3.96;915;9;1067.00;0
2234;9;22115841;2234;258;3144;3144;6.97;0.42;239.25;3.96;910;9;1068.00;0
2238;9;22115864;2238;265;3144;3144;6.94;0.42;239.72;3.96;906;9;1069.00;0
2241;9;22115880;2241;274;3148;3148;6.95;0.42;239.98;3.96;907;9;1070.00;0
2243;9;22115894;2243;279;3149;3149;7.00;0.43;239.99;3.96;906;9;1071.00;0
2249;9;22115908;2249;282;3149;3149;7.03;0.43;240.50;3.96;900;9;1072.00;0
2252;9;22115921;2252;284;3150;3150;7.09;0.43;240.60;3.96;898;9;1073.00;0
2257;9;22115936;2257;289;3150;3150;7.11;0.43;240.66;3.96;893;9;1074.00;0
2262;9;22115950;2262;288;3150;3150;7.14;0.43;241.17;3.96;888;9;1075.00;0
2264;9;22115965;2264;286;3150;3150;7.20;0.44;241.13;3.96;886;9;1076.00;0
2269;9;22115978;2269;284;3150;3150;7.24;0.44;241.42;3.96;881;9;1077.00;0
2272;9;22115991;2272;280;3150;3150;7.27;0.44;241.47;3.96;878;9;1078.00;0
2275;9;22116004;2275;281;3150;3150;7.28;0.44;241.37;3.96;875;9;1079.00;0
2280;9;22116021;2280;304;3229;3275;7.42;0.46;241.74;3.86;949;9;1080.00;46
2283;9;22116048;2283;293;3233;3276;7.45;0.46;242.00;3.86;950;9;1081.00;43
2287;9;22116063;2287;283;3242;3276;7.57;0.47;242.18;3.85;955;9;1082.00;34
2290;9;22116077;2290;280;3246;3276;7.63;0.47;242.50;3.85;956;9;1083.00;30
2294;9;22116091;2294;277;3250;3276;7.70;0.47;242.74;3.85;956;9;1084.00;26
2298;9;22116106;2298;280;3252;3276;7.69;0.47;243.11;3.85;954;9;1085.00;24
2302;9;22116121;2302;277;3256;3276;7.73;0.48;243.26;3.85;954;9;1086.00;20
2304;9;22116135;2304;278;3260;3276;7.73;0.48;243.53;3.86;956;9;1087.00;16
2308;9;22116151;2308;281;3265;3277;7.67;0.47;243.88;3.86;957;9;1088.00;12
2314;9;22116166;2314;284;3268;3278;7.57;0.46;244.24;3.87;954;9;1089.00;10
2318;9;22116181;2318;287;3271;3278;7.44;0.46;244.22;3.87;953;9;1090.00;7
2323;9;22116196;2323;289;3275;3282;7.31;0.45;244.71;3.87;952;9;1091.00;7
2324;9;22116214;2324;288;3275;3282;7.27;0.44;244.70;3.87;951;9;1092.00;7
2330;9;22116231;2330;293;3276;3282;7.14;0.44;245.02;3.87;946;9;1093.00;6
2334;9;22116246;2334;310;3276;3282;7.06;0.43;245.51;3.87;942;9;1094.00;6
2336;9;22116273;2336;314;3283;3288;6.93;0.42;245.56;3.87;947;9;1095.00;5
2339;9;22116292;2339;320;3283;3288;6.92;0.42;245.81;3.87;944;9;1096.00;5
2342;9;22116315;2342;315;3283;3288;6.93;0.42;245.87;3.87;941;9;1097.00;5
2347;9;22116331;2347;310;3285;3291;6.98;0.43;246.15;3.87;938;9;1098.00;6
2351;9;22116347;2351;312;3286;3291;7.03;0.43;246.36;3.87;935;9;1099.00;5
2353;9;22116362;2353;309;3288;3291;7.04;0.43;246.50;3.88;935;9;1100.00;3
2356;9;22116381;2356;307;3289;3292;7.03;0.43;246.62;3.88;933;9;1101.00;3
2359;9;22116397;2359;303;3290;3293;7.07;0.43;246.91;3.88;931;9;1102.00;3
2364;9;22116413;2364;301;3291;3293;7.10;0.43;247.05;3.88;927;9;1103.00;2
2367;9;22116427;2367;306;3303;3306;7.20;0.44;247.38;3.87;936;9;1104.00;3
2368;9;22116442;2368;305;3303;3306;7.20;0.44;247.29;3.87;935;9;1105.00;3
2375;9;22116456;2375;299;3304;3306;7.11;0.43;247.80;3.87;929;9;1106.00;2
2377;9;22116472;2377;298;3304;3307;7.12;0.43;247.99;3.87;927;9;1107.00;3
2379;9;22116487;2379;296;3305;3307;7.21;0.44;248.01;3.87;926;9;1108.00;2
2379;9;22116501;2379;291;3310;3311;7.25;0.44;248.01;3.87;931;9;1109.00;1
2380;9;22116519;2380;284;3310;3311;7.31;0.45;248.14;3.87;930;9;1110.00;1
2384;9;22116534;2384;282;3312;3315;7.34;0.45;248.49;3.87;928;9;1111.00;3
2385;9;22116551;2385;280;3312;3315;7.44;0.45;248.64;3.87;927;9;1112.00;3
2388;9;22116565;2388;279;3313;3315;7.50;0.46;248.73;3.87;925;9;1113.00;2
2392;9;22116580;2392;281;3313;3315;7.56;0.46;248.99;3.87;921;9;1114.00;2
2395;9;22116595;2395;291;3313;3315;7.58;0.46;249.01;3.87;918;9;1115.00;2
2398;9;22116608;2398;292;3324;3327;7.67;0.47;249.28;3.86;926;9;1116.00;3
2402;9;22116624;2402;289;3325;3327;7.70;0.47;249.59;3.86;923;9;1117.00;2
2406;9;22116640;2406;289;3325;3327;7.67;0.47;249.84;3.86;919;9;1118.00;2
2410;9;22116656;2410;284;3325;3327;7.64;0.46;250.00;3.86;915;9;1119.00;2
2411;9;22116670;2411;287;3325;3327;7.61;0.46;250.02;3.86;914;9;1120.00;2
2412;9;22116684;2412;285;3325;3327;7.63;0.47;250.17;3.86;913;9;1121.00;2
2415;9;22116699;2415;280;3325;3328;7.67;0.47;250.18;3.86;910;9;1122.00;3
2417;9;22116713;2417;279;3325;3328;7.67;0.47;250.21;3.86;908;9;1123.00;3
2421;9;22116726;2421;281;3330;3334;7.64;0.47;250.40;3.86;909;9;1124.00;4
2424;9;22116740;2424;278;3332;3336;7.64;0.47;250.44;3.86;908;9;1125.00;4
2427;9;22116754;2427;278;3332;3336;7.66;0.47;250.49;3.86;905;9;1126.00;4
2429;9;22116769;2429;280;3332;3336;7.62;0.46;250.63;3.86;903;9;1127.00;4
2433;9;22116786;2433;278;3335;3340;7.60;0.46;250.65;3.85;902;9;1128.00;5
2436;9;22116801;2436;283;3335;3340;7.57;0.46;250.80;3.85;899;9;1129.00;5
2439;9;22116815;2439;286;3335;3340;7.58;0.46;250.80;3.85;896;9;1130.00;5
2441;9;22116828;2441;283;3336;3341;7.55;0.46;250.90;3.85;895;9;1131.00;5
2442;9;22116840;2442;287;3339;3345;7.55;0.46;250.88;3.85;897;9;1132.00;6
2444;9;22116854;2444;292;3339;3345;7.46;0.45;251.01;3.85;895;9;1133.00;6
2449;9;22116869;2449;293;3341;3348;7.38;0.45;251.13;3.85;892;9;1134.00;7
2450;9;22116883;2450;296;3341;3348;7.31;0.45;251.08;3.85;891;9;1135.00;7
2451;9;22116896;2451;304;3342;3348;7.26;0.44;251.03;3.85;891;9;1136.00;6
2453;9;22116910;2453;302;3342;3348;7.20;0.44;251.05;3.85;889;9;1137.00;6
2455;10;22116922;2455;306;3346;3352;7.21;0.44;251.11;3.84;891;10;1138.00;6
2458;10;22116950;2458;307;3346;3352;7.22;0.44;250.96;3.84;888;10;1139.00;6
2458;10;22116965;2458;306;3346;3352;7.21;0.44;250.96;3.84;888;10;1140.00;6
2462;10;22116976;2462;297;3346;3352;7.13;0.43;251.03;3.84;884;10;1141.00;6
2464;10;22116988;2464;301;3346;3353;7.19;0.44;251.06;3.84;882;10;1142.00;7
2467;10;22117001;2467;290;3347;3354;7.24;0.44;250.93;3.84;880;10;1143.00;7
2472;10;22117015;2472;292;3347;3354;7.26;0.44;250.77;3.84;875;10;1144.00;7
2475;10;22117028;2475;291;3348;3355;7.28;0.44;250.99;3.84;873;10;1145.00;7
2477;10;22117040;2477;288;3348;3355;7.25;0.44;250.88;3.84;871;10;1146.00;7
2478;10;22117053;2478;289;3348;3355;7.24;0.44;250.93;3.84;870;10;1147.00;7
2482;10;22117066;2482;286;3348;3355;7.25;0.44;250.83;3.84;866;10;1148.00;7
2483;10;22117078;2483;286;3348;3355;7.24;0.44;250.77;3.84;865;10;1149.00;7
2485;10;22117089;2485;288;3348;3355;7.20;0.44;250.77;3.84;863;10;1150.00;7
2488;10;22117102;2488;286;3348;3355;7.12;0.44;250.72;3.84;860;10;1151.00;7
2492;10;22117115;2492;308;3415;3482;7.11;0.44;250.69;3.77;923;10;1152.00;67
2493;10;22117137;2493;301;3415;3483;7.07;0.44;250.61;3.77;922;10;1153.00;68
2499;10;22117152;2499;292;3423;3483;7.11;0.44;250.47;3.76;924;10;1154.00;60
2501;10;22117167;2501;287;3427;3483;7.08;0.44;250.52;3.78;926;10;1155.00;56
2505;10;22117181;2505;282;3432;3483;7.10;0.44;250.42;3.78;927;10;1156.00;51
2508;10;22117194;2508;276;3434;3483;7.08;0.44;250.37;3.78;926;10;1157.00;49
2513;10;22117206;2513;271;3440;3483;7.06;0.44;250.43;3.79;927;10;1158.00;43
2513;10;22117220;2513;270;3442;3483;7.11;0.44;250.43;3.79;929;10;1159.00;41
2514;10;22117233;2514;266;3445;3484;7.20;0.44;250.43;3.79;931;10;1160.00;39
2517;10;22117247;2517;267;3450;3485;7.28;0.45;250.36;3.81;933;10;1161.00;35
2517;10;22117261;2517;267;3453;3485;7.33;0.45;250.36;3.82;936;10;1162.00;32
2518;10;22117273;2518;258;3454;3486;7.34;0.45;250.29;3.82;936;10;1163.00;32
2521;10;22117288;2521;259;3459;3486;7.33;0.45;250.28;3.83;938;10;1164.00;27
2523;10;22117301;2523;261;3461;3486;7.26;0.44;250.26;3.83;938;10;1165.00;25
2524;10;22117315;2524;250;3461;3486;7.27;0.44;250.27;3.83;937;10;1166.00;25
2524;10;22117329;2524;242;3465;3490;7.35;0.45;250.27;3.84;941;10;1167.00;25
2528;10;22117346;2528;236;3465;3490;7.35;0.45;250.25;3.84;937;10;1168.00;25
2530;10;22117359;2530;228;3467;3490;7.38;0.45;250.35;3.84;937;10;1169.00;23
2530;10;22117374;2530;229;3470;3496;7.47;0.46;250.35;3.84;940;10;1170.00;26
2533;10;22117389;2533;232;3473;3496;7.50;0.46;250.26;3.85;940;10;1171.00;23
2534;10;22117403;2534;232;3475;3496;7.62;0.46;250.20;3.85;941;10;1172.00;21
2537;10;22117424;2537;227;3478;3500;7.67;0.47;250.26;3.85;941;10;1173.00;22
2538;10;22117439;2538;223;3481;3501;7.75;0.47;250.22;3.85;943;10;1174.00;20
2539;10;22117453;2539;223;3482;3501;7.77;0.47;250.24;3.85;943;10;1175.00;19
2541;10;22117468;2541;230;3486;3505;7.88;0.48;250.17;3.86;945;10;1176.00;19
2544;10;22117483;2544;229;3487;3505;7.88;0.48;250.07;3.86;943;10;1177.00;18
2545;10;22117498;2545;231;3487;3505;7.91;0.48;250.03;3.86;942;10;1178.00;18
2547;10;22117511;2547;235;3489;3506;7.97;0.49;249.88;3.87;942;10;1179.00;17
2548;10;22117524;2548;240;3492;3506;7.96;0.49;249.82;3.90;944;10;1180.00;14
2550;10;22117549;2550;244;3497;3512;8.01;0.49;249.71;3.90;947;10;1181.00;15
2553;10;22117565;2553;247;3499;3512;7.94;0.48;249.55;3.92;946;10;1182.00;13
2553;10;22117579;2553;254;3500;3513;7.86;0.48;249.55;3.93;947;10;1183.00;13
2558;10;22117591;2558;254;3500;3513;7.72;0.47;249.64;3.93;942;10;1184.00;13
2559;10;22117606;2559;258;3502;3513;7.67;0.47;249.64;3.94;943;10;1185.00;11
2559;10;22117620;2559;266;3502;3513;7.60;0.46;249.64;3.94;943;10;1186.00;11
2560;10;22117634;2560;266;3504;3513;7.53;0.46;249.55;3.95;944;10;1187.00;9
2564;10;22117648;2564;273;3514;3525;7.48;0.46;249.49;3.94;950;10;1188.00;11
2567;10;22117663;2567;279;3515;3525;7.37;0.45;249.36;3.95;948;10;1189.00;10
2570;10;22117676;2570;282;3516;3525;7.29;0.44;249.41;3.95;946;10;1190.00;9
2572;10;22117690;2572;284;3517;3525;7.23;0.44;249.37;3.96;945;10;1191.00;8
2574;10;22117703;2574;288;3520;3525;7.24;0.44;249.36;3.99;946;10;1192.00;5
2577;10;22117717;2577;280;3520;3525;7.24;0.44;249.49;3.99;943;10;1193.00;5
2579;10;22117731;2579;281;3523;3529;7.30;0.45;249.51;3.99;944;10;1194.00;6
2580;10;22117745;2580;278;3524;3529;7.36;0.45;249.46;4.00;944;10;1195.00;5
2581;10;22117757;2581;278;3529;3533;7.41;0.46;249.46;4.00;948;10;1196.00;4
2586;10;22117772;2586;284;3531;3534;7.36;0.45;249.55;4.00;945;10;1197.00;3
2589;10;22117786;2589;284;3534;3534;7.34;0.45;249.58;4.01;945;10;1198.00;0
2592;10;22117800;2592;279;3534;3534;7.30;0.45;249.74;4.01;942;10;1199.00;0
2596;10;22117816;2596;280;3558;3575;7.26;0.45;249.65;3.98;962;10;1200.00;17
2597;10;22117844;2597;270;3560;3575;7.20;0.44;249.74;3.98;963;10;1201.00;15
2599;10;22117856;2599;270;3563;3575;7.17;0.44;249.89;3.98;964;10;1202.00;12
2602;10;22117871;2602;262;3564;3576;7.19;0.44;250.04;3.98;962;10;1203.00;12
2604;10;22117885;2604;269;3568;3577;7.17;0.44;250.08;3.98;964;10;1204.00;9
2605;10;22117900;2605;266;3569;3577;7.20;0.44;250.06;3.98;964;10;1205.00;8
2610;10;22117914;2610;268;3573;3580;7.19;0.44;250.10;3.98;963;10;1206.00;7
2612;10;22117928;2612;266;3573;3580;7.25;0.44;250.02;3.98;961;10;1207.00;7
2615;10;22117941;2615;268;3574;3580;7.33;0.45;250.21;3.98;959;10;1208.00;6
2616;10;22117955;2616;264;3574;3580;7.45;0.46;250.29;3.98;958;10;1209.00;6
2618;10;22117970;2618;267;3582;3586;7.58;0.46;250.47;3.97;964;10;1210.00;4
2621;10;22117984;2621;269;3582;3586;7.64;0.47;250.69;3.97;961;10;1211.00;4
2625;10;22117998;2625;271;3582;3586;7.67;0.47;250.81;3.97;957;10;1212.00;4
2627;10;22118012;2627;273;3582;3586;7.70;0.47;250.82;3.97;955;10;1213.00;4
2629;10;22118024;2629;277;3586;3590;7.67;0.47;250.75;3.97;957;10;1214.00;4
2636;10;22118039;2636;279;3589;3592;7.63;0.47;250.90;3.97;953;10;1215.00;3
2640;10;22118054;2640;281;3589;3592;7.65;0.47;250.92;3.97;949;10;1216.00;3
2645;10;22118068;2645;280;3590;3593;7.63;0.47;251.11;3.97;945;10;1217.00;3
2648;10;22118083;2648;284;3590;3593;7.61;0.47;251.08;3.97;942;10;1218.00;3
2654;10;22118097;2654;286;3590;3593;7.59;0.46;251.19;3.97;936;10;1219.00;3
2658;10;22118111;2658;290;3590;3593;7.58;0.46;251.63;3.97;932;10;1220.00;3
2661;10;22118123;2661;291;3591;3593;7.57;0.46;251.73;3.98;930;10;1221.00;2
2665;10;22118139;2665;293;3591;3593;7.46;0.46;251.82;3.98;926;10;1222.00;2
2668;10;22118152;2668;291;3591;3593;7.40;0.45;251.89;3.98;923;10;1223.00;2
2673;10;22118165;2673;304;3629;3663;7.41;0.46;251.84;3.93;956;10;1224.00;34
2680;10;22118185;2680;289;3635;3664;7.27;0.45;252.09;3.93;955;10;1225.00;29
2680;10;22118208;2680;288;3642;3664;7.28;0.45;252.09;3.93;962;10;1226.00;22
2687;10;22118221;2687;291;3643;3664;7.18;0.44;252.24;3.93;956;10;1227.00;21
2691;10;22118235;2691;284;3649;3666;7.12;0.43;252.43;3.93;958;10;1228.00;17
2695;10;22118249;2695;282;3650;3666;7.02;0.43;252.56;3.93;955;10;1229.00;16
2700;10;22118267;2700;285;3652;3666;6.96;0.42;253.05;3.93;952;10;1230.00;14
2703;10;22118282;2703;286;3655;3666;6.92;0.42;253.26;3.94;952;10;1231.00;11
2708;10;22118296;2708;283;3658;3667;6.94;0.42;253.42;3.94;950;10;1232.00;9
2709;10;22118312;2709;280;3665;3668;6.96;0.42;253.49;3.95;956;10;1233.00;3
2711;10;22118324;2711;282;3666;3668;7.00;0.43;253.76;3.95;955;10;1234.00;2
2715;10;22118339;2715;284;3671;3672;6.97;0.43;254.08;3.95;956;10;1235.00;1
2720;10;22118354;2720;279;3671;3672;6.98;0.43;254.37;3.95;951;10;1236.00;1
2722;10;22118368;2722;284;3671;3672;7.07;0.43;254.61;3.95;949;10;1237.00;1
2725;10;22118382;2725;280;3672;3672;7.09;0.43;254.78;3.95;947;10;1238.00;0
2729;10;22118397;2729;280;3678;3678;7.16;0.44;255.00;3.95;949;10;1239.00;0
2733;10;22118411;2733;282;3678;3678;7.22;0.44;255.23;3.95;945;10;1240.00;0
2735;10;22118424;2735;280;3678;3678;7.30;0.45;255.50;3.95;943;10;1241.00;0
2740;10;22118440;2740;281;3680;3681;7.36;0.45;255.62;3.95;940;10;1242.00;1
2743;10;22118454;2743;279;3681;3681;7.42;0.45;255.85;3.95;938;10;1243.00;0
2750;10;22118481;2750;283;3681;3681;7.33;0.45;256.01;3.95;931;10;1244.00;0
2757;10;22118497;2757;286;3682;3682;7.24;0.44;256.13;3.94;925;10;1245.00;0
2760;10;22118512;2760;291;3683;3683;7.23;0.44;256.31;3.94;923;10;1246.00;0
2768;10;22118527;2768;295;3683;3683;7.15;0.44;256.46;3.94;915;10;1247.00;0
2771;10;22118541;2771;304;3695;3696;7.15;0.44;256.55;3.93;924;10;1248.00;1
2777;10;22118557;2777;304;3696;3696;7.10;0.43;256.76;3.93;919;10;1249.00;0
2780;10;22118572;2780;306;3696;3696;7.13;0.43;256.76;3.93;916;10;1250.00;0
2786;10;22118587;2786;313;3697;3697;7.06;0.43;256.93;3.93;911;10;1251.00;0
2790;10;22118609;2790;311;3697;3697;7.01;0.43;257.08;3.93;907;10;1252.00;0
2793;10;22118622;2793;312;3701;3701;7.03;0.43;257.22;3.93;908;10;1253.00;0
2799;10;22118643;2799;313;3701;3701;6.95;0.42;257.42;3.93;902;10;1254.00;0
2801;10;22118656;2801;317;3705;3705;6.92;0.42;257.38;3.92;904;10;1255.00;0
2806;10;22118674;2806;320;3705;3705;6.78;0.41;257.52;3.92;899;10;1256.00;0
2809;10;22118694;2809;325;3705;3705;6.68;0.41;257.68;3.92;896;10;1257.00;0
2812;10;22118711;2812;326;3705;3705;6.67;0.41;257.82;3.92;893;10;1258.00;0
2817;10;22118730;2817;333;3705;3705;6.60;0.40;258.05;3.92;888;10;1259.00;0
2820;10;22118750;2820;336;3736;3739;6.64;0.41;258.14;3.89;916;10;1260.00;3
2824;10;22118771;2824;335;3736;3739;6.60;0.41;258.33;3.89;912;10;1261.00;3
2826;10;22118790;2826;334;3738;3739;6.61;0.41;258.47;3.89;912;10;1262.00;1
2827;10;22118807;2827;343;3738;3739;6.65;0.41;258.39;3.89;911;10;1263.00;1
2832;10;22118824;2832;345;3739;3739;6.68;0.41;258.79;3.89;907;10;1264.00;0
2834;10;22118845;2834;350;3739;3739;6.62;0.41;258.90;3.89;905;10;1265.00;0
2839;10;22118862;2839;358;3740;3740;6.53;0.40;258.90;3.89;901;10;1266.00;0
2840;10;22118882;2840;362;3740;3740;6.42;0.39;258.99;3.89;900;10;1267.00;0
2843;10;22118900;2843;359;3746;3746;6.37;0.39;259.14;3.88;903;10;1268.00;0
2847;10;22118918;2847;370;3747;3747;6.27;0.38;259.28;3.88;900;10;1269.00;0
2849;10;22118932;2849;372;3747;3747;6.22;0.38;259.50;3.88;898;10;1270.00;0
2850;10;22118945;2850;382;3747;3747;6.16;0.38;259.52;3.88;897;10;1271.00;0
2851;10;22118957;2851;372;3750;3751;6.18;0.38;259.56;3.88;899;10;1272.00;1
2852;10;22118971;2852;376;3750;3751;6.25;0.38;259.57;3.88;898;10;1273.00;1
2854;10;22118986;2854;373;3750;3751;6.27;0.38;259.63;3.88;896;10;1274.00;1
2856;10;22119001;2856;366;3751;3752;6.33;0.39;259.65;3.88;895;10;1275.00;1
2857;10;22119021;2857;364;3754;3756;6.40;0.39;259.70;3.88;897;10;1276.00;2
2861;10;22119036;2861;363;3754;3756;6.45;0.39;259.90;3.88;893;10;1277.00;2
2864;10;22119050;2864;368;3756;3759;6.51;0.40;259.85;3.87;892;10;1278.00;3
2867;10;22119065;2867;367;3756;3759;6.50;0.40;259.84;3.87;889;10;1279.00;3
2869;10;22119081;2869;369;3757;3759;6.51;0.40;259.77;3.87;888;10;1280.00;2
2870;10;22119099;2870;359;3757;3759;6.55;0.40;259.89;3.87;887;10;1281.00;2
2873;10;22119116;2873;347;3761;3763;6.63;0.41;259.99;3.87;888;10;1282.00;2
2875;10;22119134;2875;339;3761;3763;6.68;0.41;260.13;3.87;886;10;1283.00;2
2876;10;22119152;2876;340;3761;3763;6.73;0.41;260.23;3.87;885;10;1284.00;2
2881;10;22119170;2881;334;3761;3763;6.72;0.41;260.31;3.87;880;10;1285.00;2
2882;10;22119188;2882;331;3761;3764;6.78;0.41;260.46;3.87;879;10;1286.00;3
2886;10;22119206;2886;331;3762;3765;6.81;0.42;260.48;3.87;876;10;1287.00;3
2890;10;22119224;2890;330;3762;3765;6.85;0.42;260.41;3.87;872;10;1288.00;3
2891;10;22119242;2891;326;3763;3766;6.92;0.42;260.42;3.87;872;10;1289.00;3
2898;10;22119265;2898;328;3763;3766;6.94;0.42;260.68;3.87;865;10;1290.00;3
2898;10;22119284;2898;330;3763;3766;6.98;0.42;260.68;3.87;865;10;1291.00;3
2903;10;22119301;2903;325;3763;3766;6.95;0.42;260.98;3.87;860;10;1292.00;3
2906;10;22119320;2906;321;3763;3766;7.01;0.43;261.15;3.87;857;10;1293.00;3
2908;10;22119338;2908;321;3763;3766;7.03;0.43;261.17;3.87;855;10;1294.00;3
2911;10;22119355;2911;315;3763;3766;7.05;0.43;261.24;3.87;852;10;1295.00;3
2912;10;22119373;2912;327;3829;3893;7.43;0.46;261.20;3.80;917;10;1296.00;64
2916;10;22119407;2916;313;3831;3894;7.48;0.46;261.09;3.80;915;10;1297.00;63
2918;10;22119428;2918;309;3839;3894;7.64;0.47;261.23;3.80;921;10;1298.00;55
2918;10;22119446;2918;299;3840;3894;7.71;0.48;261.23;3.80;922;10;1299.00;54
2921;10;22119464;2921;296;3845;3894;7.75;0.48;261.37;3.80;924;10;1300.00;49
2922;10;22119488;2922;298;3846;3894;7.72;0.48;261.31;3.80;924;10;1301.00;48
2926;10;22119507;2926;304;3851;3894;7.66;0.47;261.23;3.80;925;10;1302.00;43
2927;10;22119526;2927;309;3853;3894;7.63;0.47;261.27;3.80;926;10;1303.00;41
2930;10;22119547;2930;309;3854;3895;7.53;0.46;261.32;3.80;924;10;1304.00;41
2932;10;22119569;2932;313;3860;3897;7.43;0.45;261.42;3.81;928;10;1305.00;37
2937;10;22119594;2937;315;3861;3897;7.25;0.44;261.24;3.81;924;10;1306.00;36
2940;10;22119611;2940;324;3864;3898;7.14;0.44;261.07;3.82;924;10;1307.00;34
2943;10;22119625;2943;333;3866;3898;7.06;0.43;261.10;3.82;923;10;1308.00;32
2944;10;22119658;2944;335;3872;3898;7.00;0.43;261.04;3.84;928;10;1309.00;26
2946;10;22119676;2946;333;3874;3898;6.95;0.42;261.02;3.84;928;10;1310.00;24
2946;10;22119700;2946;340;3878;3902;6.98;0.42;261.02;3.85;932;10;1311.00;24
2947;10;22119718;2947;343;3880;3902;6.97;0.43;261.03;3.85;933;10;1312.00;22
2949;10;22119733;2949;351;3882;3902;6.93;0.42;261.00;3.86;933;10;1313.00;20
2950;10;22119761;2950;358;3884;3905;6.90;0.42;261.01;3.87;934;10;1314.00;21
2950;10;22119779;2950;351;3885;3905;6.90;0.42;261.01;3.87;935;10;1315.00;20
2951;10;22119797;2951;347;3886;3905;6.90;0.42;260.95;3.87;935;10;1316.00;19
2954;10;22119823;2954;348;3891;3909;6.93;0.42;260.97;3.87;937;10;1317.00;18
2955;10;22119843;2955;343;3893;3910;6.99;0.42;261.01;3.87;938;10;1318.00;17
2958;10;22119861;2958;331;3893;3910;6.98;0.42;260.93;3.87;935;10;1319.00;17
2959;10;22119882;2959;327;3896;3915;7.01;0.42;260.85;3.87;937;10;1320.00;19
2961;10;22119900;2961;316;3899;3915;7.01;0.42;260.93;3.87;938;10;1321.00;16
2961;10;22119918;2961;313;3899;3915;7.06;0.43;260.93;3.87;938;10;1322.00;16
2964;10;22119938;2964;295;3900;3916;7.13;0.43;260.96;3.87;936;10;1323.00;16
2967;10;22119955;2967;280;3900;3916;7.17;0.43;260.83;3.87;933;10;1324.00;16
2968;10;22119972;2968;269;3904;3922;7.23;0.44;260.75;3.87;936;10;1325.00;18
2969;10;22119992;2969;259;3904;3922;7.29;0.44;260.72;3.87;935;10;1326.00;18
2971;10;22120016;2971;255;3904;3923;7.24;0.44;260.72;3.87;933;10;1327.00;19
2973;10;22120039;2973;253;3904;3923;7.28;0.44;260.78;3.87;931;10;1328.00;19
2976;10;22120061;2976;246;3906;3923;7.28;0.44;260.78;3.89;930;10;1329.00;17
2976;10;22120109;2976;240;3906;3923;7.24;0.44;260.78;3.89;930;10;1330.00;17
2978;10;22120135;2978;236;3906;3923;7.17;0.43;260.91;3.89;928;10;1331.00;17
2979;10;22120158;2979;231;3916;3935;7.22;0.44;260.94;3.88;937;10;1332.00;19
2981;10;22120184;2981;225;3917;3935;7.24;0.44;260.95;3.88;936;10;1333.00;18
2984;10;22120202;2984;222;3917;3935;7.23;0.44;261.02;3.88;933;10;1334.00;18
2985;10;22120222;2985;214;3917;3935;7.25;0.44;261.04;3.88;932;10;1335.00;18
2986;10;22120240;2986;214;3917;3935;7.31;0.44;261.03;3.88;931;10;1336.00;18
2987;10;22120258;2987;207;3917;3935;7.43;0.45;261.05;3.88;930;10;1337.00;18
2988;10;22120279;2988;207;3920;3939;7.56;0.46;261.02;3.87;932;10;1338.00;19
2990;10;22120293;2990;200;3920;3939;7.62;0.46;260.95;3.87;930;10;1339.00;19
2992;10;22120314;2992;197;3923;3943;7.73;0.47;260.98;3.87;931;10;1340.00;20
2995;10;22120333;2995;191;3923;3944;7.89;0.48;260.89;3.87;928;10;1341.00;21
2995;10;22120350;2995;185;3924;3944;8.09;0.49;260.89;3.87;929;10;1342.00;20
2997;10;22120368;2997;182;3924;3944;8.16;0.50;260.83;3.87;927;10;1343.00;20
3000;10;22120384;3000;184;3934;3957;8.29;0.50;260.82;3.86;934;10;1344.00;23
3003;10;22120404;3003;175;3935;3957;8.32;0.50;260.87;3.86;932;10;1345.00;22
3006;10;22120421;3006;167;3935;3957;8.40;0.51;260.96;3.86;929;10;1346.00;22
3008;10;22120437;3008;165;3937;3958;8.42;0.51;260.90;3.87;929;10;1347.00;21
3011;10;22120454;3011;162;3938;3959;8.48;0.52;261.23;3.88;927;10;1348.00;21
3011;10;22120477;3011;155;3938;3959;8.57;0.52;261.23;3.88;927;10;1349.00;21
3016;10;22120497;3016;158;3946;3968;8.56;0.52;261.21;3.88;930;10;1350.00;22
3017;10;22120516;3017;161;3947;3968;8.60;0.52;261.15;3.88;930;10;1351.00;21
3019;10;22120534;3019;159;3949;3968;8.61;0.52;261.15;3.90;930;10;1352.00;19
3020;10;22120560;3020;162;3950;3968;8.65;0.53;261.17;3.90;930;10;1353.00;18
3021;10;22120584;3021;166;3955;3974;8.75;0.53;261.12;3.90;934;10;1354.00;19
3021;10;22120601;3021;167;3957;3974;8.76;0.53;261.12;3.93;936;10;1355.00;17
3025;10;22120617;3025;175;3957;3974;8.73;0.53;261.18;3.93;932;10;1356.00;17
3028;10;22120636;3028;178;3958;3974;8.70;0.53;261.20;3.94;930;10;1357.00;16
3030;10;22120655;3030;181;3961;3978;8.67;0.53;261.21;3.94;931;10;1358.00;17
3033;10;22120674;3033;188;3963;3979;8.69;0.53;261.36;3.95;930;10;1359.00;16
3035;10;22120692;3035;190;3964;3979;8.70;0.53;261.44;3.97;929;10;1360.00;15
3039;10;22120707;3039;195;3966;3980;8.69;0.53;261.48;3.98;927;10;1361.00;14
3041;10;22120731;3041;198;3967;3980;8.66;0.53;261.68;4.00;926;10;1362.00;13
3045;10;22120746;3045;205;3968;3980;8.61;0.52;261.72;4.01;923;10;1363.00;12
3048;10;22120761;3048;205;3968;3980;8.62;0.52;261.70;4.01;920;10;1364.00;12
3049;10;22120774;3049;209;3970;3980;8.65;0.53;261.73;4.04;921;10;1365.00;10
3054;10;22120789;3054;210;3970;3980;8.63;0.53;261.77;4.04;916;10;1366.00;10
3055;10;22120804;3055;210;3972;3980;8.57;0.52;261.82;4.05;917;10;1367.00;8
3056;10;22120824;3056;222;4011;4050;8.60;0.53;261.82;4.02;955;10;1368.00;39
3059;10;22120848;3059;212;4013;4051;8.58;0.53;261.81;4.02;954;10;1369.00;38
3066;10;22120867;3066;210;4022;4051;8.54;0.52;262.02;4.02;956;10;1370.00;29
3068;10;22120883;3068;213;4027;4051;8.44;0.52;262.15;4.04;959;10;1371.00;24
3071;10;22120899;3071;213;4030;4051;8.43;0.52;262.13;4.04;959;10;1372.00;21
3078;10;22120918;3078;212;4033;4051;8.31;0.51;262.30;4.04;955;10;1373.00;18
3082;10;22120940;3082;212;4038;4051;8.23;0.50;262.28;4.06;956;10;1374.00;13
3083;11;22120965;3083;210;4040;4051;8.21;0.50;262.35;4.06;957;11;1375.00;11
3084;11;22120999;3084;210;4043;4052;8.22;0.50;262.39;4.07;959;11;1376.00;9
3089;11;22121020;3089;205;4047;4053;8.18;0.50;262.42;4.08;958;11;1377.00;6
3091;11;22121039;3091;203;4048;4053;8.15;0.50;262.30;4.07;957;11;1378.00;5
3093;11;22121056;3093;202;4055;4057;8.11;0.50;262.36;4.08;962;11;1379.00;2
3094;11;22121081;3094;203;4055;4057;8.09;0.49;262.49;4.08;961;11;1380.00;2
3096;11;22121102;3096;202;4057;4057;8.10;0.49;262.42;4.08;961;11;1381.00;0
3098;11;22121122;3098;207;4057;4057;8.10;0.49;262.48;4.08;959;11;1382.00;0
3102;11;22121141;3102;212;4063;4063;8.15;0.50;262.37;4.07;961;11;1383.00;0
3105;11;22121163;3105;216;4063;4063;8.16;0.50;262.34;4.07;958;11;1384.00;0
3106;11;22121194;3106;224;4063;4063;8.16;0.50;262.49;4.07;957;11;1385.00;0
3108;11;22121212;3108;227;4066;4066;8.13;0.50;262.65;4.07;958;11;1386.00;0
3110;11;22121230;3110;235;4066;4066;8.10;0.50;262.68;4.07;956;11;1387.00;0
3116;11;22121246;3116;238;4066;4066;8.02;0.49;262.51;4.07;950;11;1388.00;0
3120;11;22121265;3120;242;4067;4067;7.98;0.49;262.62;4.07;947;11;1389.00;0
3123;11;22121282;3123;246;4068;4068;7.90;0.48;262.58;4.07;945;11;1390.00;0
3124;11;22121300;3124;249;4068;4068;7.86;0.48;262.66;4.07;944;11;1391.00;0
3129;11;22121327;3129;255;4080;4081;7.76;0.47;262.72;4.06;951;11;1392.00;1
3136;11;22121351;3136;266;4081;4081;7.68;0.47;262.64;4.06;945;11;1393.00;0
3139;11;22121372;3139;260;4081;4081;7.62;0.46;262.71;4.06;942;11;1394.00;0
3143;11;22121391;3143;266;4083;4083;7.57;0.46;262.92;4.06;940;11;1395.00;0
3148;11;22121415;3148;269;4083;4083;7.47;0.45;263.24;4.06;935;11;1396.00;0
3151;11;22121440;3151;269;4087;4087;7.45;0.45;263.44;4.05;936;11;1397.00;0
3153;11;22121469;3153;270;4087;4087;7.35;0.45;263.56;4.05;934;11;1398.00;0
3160;11;22121485;3160;273;4091;4091;7.18;0.44;263.65;4.05;931;11;1399.00;0
3165;11;22121503;3165;260;4091;4091;7.10;0.43;263.84;4.05;926;11;1400.00;0
3167;11;22121528;3167;253;4091;4091;7.07;0.43;263.80;4.05;924;11;1401.00;0
3170;11;22121547;3170;258;4091;4091;6.98;0.42;263.96;4.05;921;11;1402.00;0
3172;11;22121566;3172;254;4091;4091;6.97;0.42;264.15;4.05;919;11;1403.00;0
3178;11;22121587;3178;254;4102;4103;6.97;0.42;264.44;4.04;924;11;1404.00;1
3182;11;22121605;3182;252;4102;4103;6.89;0.42;264.80;4.04;920;11;1405.00;1
3184;11;22121618;3184;251;4103;4103;6.91;0.42;264.99;4.04;919;11;1406.00;0
3187;11;22121632;3187;245;4103;4103;6.90;0.42;265.27;4.04;916;11;1407.00;0
3192;11;22121649;3192;238;4103;4103;6.93;0.42;265.43;4.04;911;11;1408.00;0
3195;11;22121663;3195;238;4103;4103;6.95;0.42;265.77;4.04;908;11;1409.00;0
3199;11;22121680;3199;237;4104;4104;6.87;0.42;265.89;4.04;905;11;1410.00;0
3202;11;22121697;3202;233;4104;4104;6.80;0.41;266.14;4.04;902;11;1411.00;0
3207;11;22121711;3207;238;4110;4110;6.80;0.41;266.23;4.03;903;11;1412.00;0
3208;11;22121723;3208;248;4111;4111;6.81;0.42;266.23;4.03;903;11;1413.00;0
3211;11;22121736;3211;244;4111;4111;6.77;0.41;266.40;4.03;900;11;1414.00;0
3212;11;22121749;3212;248;4111;4111;6.75;0.41;266.45;4.03;899;11;1415.00;0
3215;11;22121762;3215;252;4115;4115;6.71;0.41;266.57;4.03;900;11;1416.00;0
3221;11;22121775;3221;255;4115;4115;6.64;0.41;266.54;4.03;894;11;1417.00;0
3226;11;22121788;3226;267;4115;4115;6.54;0.40;266.52;4.03;889;11;1418.00;0
3235;11;22121802;3235;270;4116;4116;6.41;0.39;266.55;4.03;881;11;1419.00;0
3238;11;22121819;3238;271;4120;4120;6.34;0.39;266.57;4.02;882;11;1420.00;0
3242;11;22121834;3242;279;4120;4120;6.24;0.38;266.65;4.02;878;11;1421.00;0
3248;11;22121851;3248;280;4122;4123;6.18;0.38;266.79;4.02;874;11;1422.00;1
3251;11;22121867;3251;290;4122;4123;6.15;0.37;266.78;4.02;871;11;1423.00;1
3254;11;22121882;3254;289;4123;4123;6.09;0.37;266.77;4.02;869;11;1424.00;0
3256;11;22121899;3256;291;4123;4123;6.07;0.37;266.99;4.02;867;11;1425.00;0
3259;11;22121919;3259;298;4127;4127;6.10;0.37;266.94;4.02;868;11;1426.00;0
3262;11;22121933;3262;301;4127;4127;6.05;0.37;267.04;4.02;865;11;1427.00;0
3267;11;22121951;3267;304;4127;4127;6.02;0.37;267.20;4.02;860;11;1428.00;0
3270;11;22121974;3270;300;4127;4127;6.07;0.37;267.39;4.02;857;11;1429.00;0
3278;11;22121988;3278;308;4128;4128;5.99;0.37;267.69;4.02;850;11;1430.00;0
3282;11;22122002;3282;319;4129;4129;5.94;0.36;267.87;4.02;847;11;1431.00;0
3286;11;22122017;3286;319;4129;4129;5.91;0.36;267.91;4.02;843;11;1432.00;0
3292;11;22122029;3292;322;4130;4130;5.91;0.36;268.05;4.02;838;11;1433.00;0
3296;11;22122040;3296;326;4130;4130;5.92;0.36;268.02;4.02;834;11;1434.00;0
3300;11;22122052;3300;326;4130;4130;5.91;0.36;268.02;4.02;830;11;1435.00;0
3304;11;22122065;3304;327;4130;4130;5.90;0.36;267.98;4.02;826;11;1436.00;0
3310;11;22122075;3310;331;4130;4130;5.91;0.36;268.08;4.02;820;11;1437.00;0
3313;11;22122088;3313;329;4130;4130;5.89;0.36;268.07;4.02;817;11;1438.00;0
3318;11;22122102;3318;325;4130;4130;5.85;0.36;268.04;4.02;812;11;1439.00;0
3319;11;22122118;3319;364;4237;4360;6.41;0.41;268.11;3.92;918;11;1440.00;123
3321;11;22122158;3321;356;4246;4361;6.42;0.41;268.25;3.91;925;11;1441.00;115
3324;11;22122171;3324;355;4260;4361;6.49;0.41;268.19;3.90;936;11;1442.00;101
3329;11;22122184;3329;353;4266;4361;6.43;0.41;268.19;3.90;937;11;1443.00;95
3332;11;22122197;3332;356;4280;4361;6.44;0.41;268.32;3.90;948;11;1444.00;81
3334;11;22122211;3334;356;4286;4361;6.37;0.40;268.39;3.90;952;11;1445.00;75
3337;11;22122223;3337;359;4297;4361;6.29;0.39;268.50;3.91;960;11;1446.00;64
3340;11;22122236;3340;348;4302;4361;6.27;0.39;268.50;3.91;962;11;1447.00;59
3342;11;22122250;3342;349;4310;4362;6.25;0.39;268.43;3.92;968;11;1448.00;52
3345;11;22122265;3345;347;4312;4363;6.25;0.39;268.45;3.92;967;11;1449.00;51
3347;11;22122278;3347;349;4319;4363;6.24;0.39;268.42;3.93;972;11;1450.00;44
3348;11;22122290;3348;356;4321;4364;6.22;0.39;268.42;3.94;973;11;1451.00;43
3349;11;22122304;3349;356;4326;4364;6.18;0.39;268.35;3.95;977;11;1452.00;38
3350;11;22122319;3350;362;4327;4364;6.18;0.38;268.39;3.95;977;11;1453.00;37
3351;11;22122339;3351;376;4329;4364;6.21;0.39;268.41;3.95;978;11;1454.00;35
3353;11;22122354;3353;372;4333;4368;6.22;0.39;268.39;3.96;980;12;1455.00;35
3353;11;22122396;3353;366;4334;4368;6.29;0.39;268.39;3.96;981;12;1456.00;34
3354;11;22122418;3354;358;4336;4368;6.37;0.40;268.42;3.96;982;12;1457.00;32
3357;11;22122450;3357;356;4337;4371;6.49;0.40;268.24;3.97;980;12;1458.00;34
3360;11;22122466;3360;360;4340;4371;6.59;0.41;268.16;3.97;980;12;1459.00;31
3364;11;22122481;3364;354;4341;4371;6.65;0.41;267.92;3.97;977;12;1460.00;30
3365;11;22122496;3365;358;4345;4375;6.67;0.41;267.86;3.97;980;12;1461.00;30
3366;11;22122512;3366;365;4346;4376;6.72;0.41;267.96;3.97;980;12;1462.00;30
3369;11;22122533;3369;368;4349;4376;6.71;0.41;267.85;3.98;980;12;1463.00;27
3371;11;22122553;3371;374;4352;4380;6.75;0.42;267.85;3.98;981;12;1464.00;28
3375;11;22122571;3375;375;4352;4380;6.73;0.41;267.71;3.98;977;12;1465.00;28
3375;11;22122588;3375;380;4353;4380;6.72;0.41;267.71;3.99;978;12;1466.00;27
3378;11;22122606;3378;372;4354;4381;6.74;0.41;267.63;3.99;976;12;1467.00;27
3379;11;22122623;3379;372;4354;4381;6.75;0.41;267.64;3.99;975;12;1468.00;27
3380;11;22122641;3380;372;4359;4387;6.80;0.42;267.65;3.99;979;12;1469.00;28
3380;11;22122662;3380;367;4359;4387;6.83;0.42;267.65;3.99;979;12;1470.00;28
3383;11;22122681;3383;367;4359;4388;6.84;0.42;267.76;3.99;976;12;1471.00;29
3386;11;22122696;3386;365;4359;4388;6.85;0.42;267.74;3.99;973;12;1472.00;29
3390;11;22122710;3390;366;4360;4388;6.82;0.42;267.56;4.00;970;12;1473.00;28
3390;11;22122724;3390;369;4361;4388;6.85;0.42;267.56;4.00;971;12;1474.00;27
3391;11;22122746;3391;369;4362;4388;6.88;0.42;267.57;4.00;971;12;1475.00;26
3393;11;22122763;3393;376;4372;4400;6.90;0.42;267.52;4.00;979;12;1476.00;28
3394;11;22122781;3394;382;4373;4400;6.90;0.42;267.50;4.00;979;12;1477.00;27
3396;11;22122797;3396;384;4374;4400;6.87;0.42;267.44;4.01;978;12;1478.00;26
3398;11;22122818;3398;381;4374;4400;6.82;0.42;267.55;4.01;976;12;1479.00;26
3401;11;22122834;3401;376;4375;4400;6.84;0.42;267.44;4.02;974;12;1480.00;25
3403;11;22122850;3403;366;4378;4400;6.83;0.42;267.41;4.02;975;12;1481.00;22
3406;11;22122867;3406;361;4381;4404;6.87;0.42;267.46;4.02;975;12;1482.00;23
3407;11;22122885;3407;352;4381;4404;6.91;0.42;267.50;4.02;974;12;1483.00;23
3409;11;22122901;3409;350;4385;4408;6.99;0.42;267.41;4.02;976;12;1484.00;23
3409;11;22122917;3409;342;4387;4410;7.07;0.43;267.41;4.02;978;12;1485.00;23
3410;11;22122932;3410;342;4387;4410;7.11;0.43;267.43;4.02;977;12;1486.00;23
3410;11;22122947;3410;341;4387;4410;7.15;0.44;267.43;4.02;977;12;1487.00;23
3411;11;22122961;3411;334;4396;4423;7.23;0.44;267.44;4.01;985;12;1488.00;27
3411;11;22122977;3411;335;4396;4423;7.28;0.44;267.44;4.01;985;12;1489.00;27
3413;11;22122998;3413;327;4396;4423;7.30;0.45;267.46;4.01;983;12;1490.00;27
3413;11;22123022;3413;323;4397;4424;7.35;0.45;267.46;4.01;984;12;1491.00;27
3417;11;22123042;3417;315;4397;4425;7.36;0.45;267.48;4.01;980;12;1492.00;28
3417;11;22123059;3417;306;4397;4425;7.42;0.45;267.48;4.01;980;12;1493.00;28
3419;11;22123088;3419;301;4399;4428;7.49;0.46;267.48;4.01;980;12;1494.00;29
3420;11;22123105;3420;294;4399;4428;7.48;0.45;267.50;4.01;979;12;1495.00;29
3422;11;22123120;3422;290;4400;4428;7.56;0.46;267.45;4.01;978;12;1496.00;28
3423;11;22123136;3423;283;4400;4428;7.59;0.46;267.38;4.01;977;12;1497.00;28
3425;11;22123151;3425;278;4405;4434;7.66;0.46;267.41;4.00;980;12;1498.00;29
3426;11;22123167;3426;271;4405;4434;7.66;0.46;267.41;4.00;979;12;1499.00;29
3429;11;22123187;3429;269;4409;4453;7.62;0.46;267.49;4.00;980;12;1500.00;44
3431;11;22123215;3431;267;4409;4453;7.64;0.46;267.51;4.00;978;12;1501.00;44
3435;11;22123230;3435;267;4412;4457;7.59;0.46;267.49;4.00;977;12;1502.00;45
3438;11;22123245;3438;261;4413;4458;7.60;0.46;267.50;4.00;975;12;1503.00;45
3441;11;22123259;3441;258;4413;4458;7.56;0.46;267.69;4.00;972;12;1504.00;45
3445;11;22123273;3445;248;4416;4459;7.49;0.45;267.89;4.01;971;12;1505.00;43
3449;11;22123292;3449;244;4418;4459;7.41;0.45;267.88;4.02;969;12;1506.00;41
3454;11;22123310;3454;237;4418;4459;7.31;0.44;268.07;4.02;964;12;1507.00;41
3457;11;22123328;3457;231;4418;4459;7.27;0.44;268.03;4.02;961;12;1508.00;41
3461;11;22123344;3461;225;4418;4459;7.25;0.44;268.21;4.02;957;12;1509.00;41
3463;11;22123360;3463;228;4418;4459;7.28;0.44;268.29;4.02;955;12;1510.00;41
3467;11;22123374;3467;228;4419;4459;7.32;0.44;268.33;4.03;952;12;1511.00;40
3468;11;22123389;3468;236;4452;4529;7.34;0.45;268.33;4.00;984;12;1512.00;77
3468;11;22123412;3468;226;4452;4530;7.46;0.45;268.33;4.00;984;12;1513.00;78
3471;11;22123427;3471;221;4458;4530;7.55;0.46;268.38;4.00;987;12;1514.00;72
3472;11;22123446;3472;217;4460;4530;7.62;0.46;268.50;4.00;988;12;1515.00;70
3473;11;22123473;3473;219;4463;4530;7.73;0.47;268.49;4.00;990;12;1516.00;67
3474;11;22123491;3474;216;4468;4530;7.84;0.48;268.60;4.00;994;12;1517.00;62
3475;11;22123508;3475;217;4471;4530;7.90;0.48;268.62;4.00;996;12;1518.00;59
3477;11;22123528;3477;217;4473;4530;7.96;0.48;268.71;4.00;996;12;1519.00;57
3481;11;22123542;3481;209;4475;4531;7.99;0.48;268.94;4.01;994;12;1520.00;56
3484;11;22123563;3484;211;4477;4532;8.04;0.49;269.21;4.01;993;12;1521.00;55
3485;11;22123582;3485;210;4480;4532;8.06;0.49;269.26;4.01;995;12;1522.00;52
3487;11;22123599;3487;213;4488;4536;8.02;0.49;269.44;4.04;1001;12;1523.00;48
3487;11;22123617;3487;212;4489;4536;8.04;0.49;269.44;4.04;1002;12;1524.00;47
3489;11;22123632;3489;209;4490;4536;8.04;0.49;269.57;4.06;1001;12;1525.00;46
3491;11;22123648;3491;213;4490;4536;8.08;0.49;269.55;4.06;999;12;1526.00;46
3493;11;22123663;3493;211;4495;4542;8.08;0.49;269.47;4.06;1002;12;1527.00;47
3496;11;22123682;3496;217;4497;4542;8.09;0.49;269.66;4.08;1001;12;1528.00;45
3499;11;22123700;3499;224;4498;4542;8.14;0.49;269.73;4.09;999;12;1529.00;44
3500;12;22123723;3500;226;4501;4548;8.18;0.49;269.86;4.09;1001;13;1530.00;47
3502;12;22123764;3502;232;4506;4548;8.18;0.50;269.94;4.15;1004;13;1531.00;42
3505;12;22123780;3505;239;4509;4548;8.19;0.50;270.04;4.17;1004;13;1532.00;39
3506;12;22123795;3506;242;4511;4549;8.20;0.50;270.15;4.21;1005;13;1533.00;38
3509;12;22123808;3509;242;4514;4550;8.19;0.50;270.09;4.22;1005;13;1534.00;36
3513;12;22123823;3513;244;4518;4550;8.15;0.49;270.07;4.27;1005;13;1535.00;32
3518;12;22123838;3518;246;4526;4563;8.06;0.49;270.30;4.29;1008;13;1536.00;37
3518;12;22123855;3518;247;4529;4563;8.06;0.49;270.30;4.31;1011;13;1537.00;34
3519;12;22123869;3519;253;4531;4563;8.03;0.49;270.40;4.34;1012;13;1538.00;32
3520;12;22123891;3520;255;4537;4564;7.95;0.48;270.50;4.39;1017;13;1539.00;27
3521;12;22123906;3521;259;4538;4564;7.88;0.48;270.48;4.41;1017;13;1540.00;26
3524;12;22123921;3524;258;4545;4568;7.85;0.48;270.57;4.42;1021;13;1541.00;23
3528;12;22123938;3528;267;4545;4568;7.80;0.47;270.47;4.42;1017;13;1542.00;23
3531;12;22123953;3531;268;4550;4572;7.76;0.47;270.61;4.45;1019;13;1543.00;22
3535;12;22123969;3535;273;4551;4572;7.71;0.47;270.46;4.45;1016;13;1544.00;21
3538;12;22123994;3538;275;4551;4572;7.66;0.47;270.63;4.45;1013;13;1545.00;21
3542;12;22124007;3542;273;4555;4572;7.60;0.46;270.53;4.49;1013;13;1546.00;17
3544;12;22124022;3544;278;4555;4572;7.54;0.46;270.55;4.49;1011;13;1547.00;17
3547;12;22124037;3547;275;4566;4584;7.53;0.46;270.57;4.49;1019;13;1548.00;18
3549;12;22124053;3549;272;4566;4584;7.50;0.46;270.76;4.49;1017;13;1549.00;18
3551;12;22124068;3551;267;4568;4584;7.52;0.46;270.80;4.50;1017;13;1550.00;16
3554;12;22124083;3554;267;4568;4584;7.53;0.46;271.01;4.50;1014;13;1551.00;16
3560;12;22124100;3560;269;4571;4584;7.55;0.46;271.23;4.53;1011;13;1552.00;13
3561;12;22124117;3561;269;4571;4584;7.64;0.47;271.21;4.53;1010;13;1553.00;13
3565;12;22124132;3565;273;4574;4585;7.66;0.47;271.36;4.55;1009;13;1554.00;11
3569;12;22124148;3569;278;4577;4587;7.64;0.47;271.55;4.55;1008;13;1555.00;10
3572;12;22124163;3572;275;4584;4593;7.72;0.47;271.74;4.56;1012;13;1556.00;9
3576;12;22124181;3576;274;4585;4594;7.73;0.48;271.90;4.56;1009;13;1557.00;9
3577;12;22124200;3577;279;4585;4594;7.72;0.47;271.92;4.56;1008;13;1558.00;9
3580;12;22124215;3580;285;4586;4594;7.71;0.47;271.93;4.57;1006;13;1559.00;8
3585;12;22124231;3585;288;4592;4599;7.78;0.48;272.03;4.58;1007;13;1560.00;7
3589;12;22124249;3589;288;4593;4599;7.74;0.48;271.94;4.58;1004;13;1561.00;6
3592;12;22124266;3592;291;4593;4599;7.75;0.48;272.06;4.58;1001;13;1562.00;6
3598;12;22124283;3598;289;4594;4600;7.71;0.47;271.90;4.58;996;13;1563.00;6
3603;12;22124299;3603;288;4598;4604;7.61;0.47;272.11;4.59;995;13;1564.00;6
3604;12;22124314;3604;290;4600;4604;7.59;0.47;272.17;4.60;996;13;1565.00;4
3611;12;22124328;3611;295;4603;4607;7.55;0.46;272.16;4.60;992;13;1566.00;4
3614;12;22124342;3614;299;4603;4607;7.50;0.46;272.12;4.60;989;13;1567.00;4
3618;12;22124357;3618;301;4605;4607;7.42;0.45;272.24;4.60;987;13;1568.00;2
3623;12;22124371;3623;303;4607;4607;7.37;0.45;272.28;4.60;984;13;1569.00;0
3626;12;22124386;3626;306;4611;4611;7.36;0.45;272.25;4.60;985;13;1570.00;0
3632;12;22124400;3632;303;4611;4611;7.22;0.44;272.49;4.60;979;13;1571.00;0
3635;12;22124415;3635;311;4611;4611;7.11;0.43;272.68;4.60;976;13;1572.00;0
3637;12;22124427;3637;308;4611;4611;6.98;0.43;272.63;4.60;974;13;1573.00;0
3642;12;22124439;3642;313;4612;4612;6.76;0.41;272.79;4.60;970;13;1574.00;0
3645;12;22124452;3645;304;4614;4614;6.64;0.41;272.82;4.59;969;13;1575.00;0
3646;12;22124473;3646;299;4614;4614;6.58;0.40;272.78;4.59;968;13;1576.00;0
3655;12;22124487;3655;291;4615;4615;6.43;0.39;273.01;4.59;960;13;1577.00;0
3659;12;22124500;3659;295;4615;4615;6.34;0.39;272.92;4.59;956;13;1578.00;0
3663;12;22124513;3663;290;4615;4615;6.27;0.39;272.86;4.59;952;13;1579.00;0
3668;12;22124524;3668;297;4615;4615;6.25;0.38;272.96;4.59;947;13;1580.00;0
3673;12;22124538;3673;300;4615;4615;6.27;0.38;272.99;4.59;942;13;1581.00;0
3677;12;22124551;3677;287;4615;4615;6.27;0.38;273.18;4.59;938;13;1582.00;0
3681;12;22124564;3681;282;4615;4615;6.22;0.38;273.43;4.59;934;13;1583.00;0
3684;12;22124577;3684;292;4686;4742;6.39;0.40;273.44;4.52;1002;13;1584.00;56
3686;12;22124600;3686;290;4691;4743;6.34;0.39;273.60;4.52;1005;13;1585.00;52
3690;12;22124614;3690;282;4702;4743;6.33;0.39;273.75;4.51;1012;13;1586.00;41
3695;12;22124627;3695;281;4705;4743;6.25;0.39;273.82;4.51;1010;13;1587.00;38
3698;12;22124647;3698;290;4709;4743;6.27;0.39;273.95;4.51;1011;13;1588.00;34
3704;12;22124659;3704;289;4711;4743;6.24;0.39;274.14;4.51;1007;13;1589.00;32
3710;12;22124674;3710;301;4713;4743;6.17;0.38;274.44;4.51;1003;13;1590.00;30
3715;12;22124688;3715;312;4715;4743;6.15;0.38;274.49;4.51;1000;13;1591.00;28
3720;12;22124708;3720;314;4716;4744;6.09;0.38;274.59;4.52;996;13;1592.00;28
3723;12;22124722;3723;320;4718;4745;6.03;0.37;274.61;4.52;995;13;1593.00;27
3730;12;22124737;3730;332;4719;4745;5.93;0.37;274.75;4.52;989;13;1594.00;26
3735;12;22124751;3735;330;4721;4746;5.80;0.36;274.94;4.52;986;13;1595.00;25
3741;12;22124765;3741;340;4724;4746;5.75;0.36;275.09;4.53;983;13;1596.00;22
3746;12;22124779;3746;340;4726;4746;5.75;0.36;275.19;4.53;980;13;1597.00;20
3749;12;22124791;3749;353;4735;4746;5.72;0.36;275.26;4.55;986;13;1598.00;11
3753;12;22124804;3753;351;4739;4750;5.66;0.35;275.31;4.55;986;13;1599.00;11
3755;12;22124819;3755;351;4740;4750;5.62;0.35;275.29;4.55;985;13;1600.00;10
3761;12;22124839;3761;355;4741;4750;5.55;0.34;275.40;4.56;980;13;1601.00;9
3767;12;22124854;3767;357;4742;4753;5.49;0.34;275.39;4.56;975;13;1602.00;11
3771;12;22124867;3771;364;4744;4753;5.51;0.34;275.32;4.56;973;13;1603.00;9
3773;12;22124880;3773;364;4746;4753;5.53;0.34;275.39;4.56;973;13;1604.00;7
3778;12;22124893;3778;369;4749;4757;5.52;0.34;275.37;4.56;971;13;1605.00;8
3780;12;22124908;3780;371;4750;4758;5.56;0.34;275.31;4.56;970;13;1606.00;8
3785;12;22124921;3785;385;4751;4758;5.57;0.34;275.23;4.56;966;13;1607.00;7
3789;12;22124935;3789;379;4755;4762;5.60;0.35;275.21;4.56;966;13;1608.00;7
3791;12;22124949;3791;384;4756;4762;5.65;0.35;275.15;4.56;965;13;1609.00;6
3793;12;22124962;3793;390;4757;4762;5.68;0.35;275.25;4.57;964;13;1610.00;5
3798;12;22124973;3798;391;4758;4763;5.67;0.35;275.11;4.56;960;13;1611.00;5
3801;12;22124988;3801;393;4759;4763;5.68;0.35;275.17;4.57;958;13;1612.00;4
3808;12;22125001;3808;395;4763;4769;5.62;0.34;275.10;4.56;955;13;1613.00;6
3808;12;22125016;3808;396;4764;4769;5.59;0.34;275.10;4.56;956;13;1614.00;5
3811;12;22125030;3811;395;4764;4770;5.46;0.33;275.08;4.56;953;13;1615.00;6
3814;12;22125046;3814;400;4764;4770;5.45;0.34;275.07;4.56;950;13;1616.00;6
3817;12;22125058;3817;405;4764;4770;5.45;0.33;275.05;4.56;947;13;1617.00;6
3822;12;22125072;3822;412;4764;4770;5.38;0.33;274.88;4.56;942;13;1618.00;6
3823;12;22125086;3823;415;4764;4770;5.39;0.33;274.88;4.56;941;13;1619.00;6
3826;12;22125100;3826;420;4792;4806;5.61;0.35;274.73;4.54;966;13;1620.00;14
3829;12;22125116;3829;414;4793;4806;5.60;0.34;274.76;4.53;964;13;1621.00;13
3833;12;22125129;3833;406;4795;4806;5.56;0.34;274.61;4.53;962;13;1622.00;11
3835;12;22125141;3835;405;4796;4806;5.58;0.34;274.57;4.53;961;13;1623.00;10
3836;12;22125157;3836;400;4796;4806;5.58;0.34;274.50;4.53;960;13;1624.00;10
3836;12;22125172;3836;401;4797;4806;5.59;0.34;274.50;4.53;961;13;1625.00;9
3837;12;22125187;3837;392;4800;4810;5.65;0.35;274.45;4.53;963;13;1626.00;10
3838;12;22125201;3838;400;4800;4810;5.65;0.35;274.46;4.53;962;13;1627.00;10
3839;12;22125215;3839;396;4804;4814;5.68;0.35;274.47;4.53;965;13;1628.00;10
3841;12;22125229;3841;401;4805;4815;5.72;0.35;274.57;4.53;964;13;1629.00;10
3843;12;22125240;3843;407;4805;4815;5.72;0.35;274.55;4.53;962;13;1630.00;10
3845;12;22125263;3845;398;4805;4815;5.73;0.35;274.56;4.53;960;13;1631.00;10
3845;12;22125285;3845;390;4816;4828;5.85;0.36;274.56;4.52;971;13;1632.00;12
3845;12;22125299;3845;382;4816;4828;5.92;0.36;274.56;4.52;971;13;1633.00;12
3847;12;22125313;3847;377;4816;4828;5.96;0.36;274.55;4.52;969;13;1634.00;12
3848;12;22125326;3848;373;4817;4829;6.03;0.37;274.56;4.52;969;13;1635.00;12
3850;12;22125340;3850;371;4817;4830;6.11;0.37;274.52;4.52;967;13;1636.00;13
3850;12;22125355;3850;358;4817;4830;6.16;0.38;274.52;4.52;967;13;1637.00;13
3852;12;22125370;3852;347;4819;4833;6.28;0.38;274.53;4.51;967;13;1638.00;14
3854;12;22125385;3854;346;4819;4833;6.36;0.39;274.58;4.51;965;13;1639.00;14
3854;12;22125400;3854;341;4820;4833;6.49;0.40;274.58;4.51;966;13;1640.00;13
3854;12;22125415;3854;334;4820;4833;6.58;0.40;274.58;4.51;966;13;1641.00;13
3856;12;22125429;3856;329;4825;4839;6.71;0.41;274.57;4.51;969;13;1642.00;14
3857;12;22125446;3857;326;4825;4839;6.80;0.41;274.51;4.51;968;13;1643.00;14
3861;12;22125478;3861;323;4825;4839;6.87;0.42;274.54;4.51;964;13;1644.00;14
3862;12;22125494;3862;321;4825;4839;6.95;0.42;274.52;4.51;963;13;1645.00;14
3863;12;22125511;3863;315;4828;4843;7.00;0.42;274.54;4.51;965;13;1646.00;15
3867;12;22125530;3867;309;4829;4844;7.04;0.43;274.58;4.51;962;13;1647.00;15
3867;12;22125547;3867;314;4829;4844;7.09;0.43;274.58;4.51;962;13;1648.00;15
3867;12;22125565;3867;320;4830;4845;7.15;0.43;274.58;4.51;963;13;1649.00;15
3870;12;22125582;3870;315;4830;4845;7.17;0.43;274.58;4.51;960;13;1650.00;15
3871;12;22125598;3871;319;4830;4845;7.20;0.44;274.51;4.51;959;13;1651.00;15
3871;12;22125615;3871;319;4830;4845;7.22;0.44;274.51;4.51;959;13;1652.00;15
3871;12;22125631;3871;312;4830;4845;7.20;0.44;274.51;4.51;959;13;1653.00;15
3871;12;22125648;3871;312;4830;4845;7.19;0.44;274.51;4.51;959;13;1654.00;15
3873;12;22125663;3873;309;4830;4845;7.17;0.43;274.55;4.51;957;13;1655.00;15
3874;12;22125678;3874;324;4866;4915;7.14;0.43;274.53;4.47;992;13;1656.00;49
3877;12;22125700;3877;316;4866;4916;7.14;0.43;274.61;4.47;989;13;1657.00;50
3880;12;22125718;3880;307;4872;4916;7.19;0.44;274.71;4.47;992;13;1658.00;44
3882;12;22125734;3882;314;4874;4916;7.21;0.44;274.71;4.47;992;13;1659.00;42
3883;12;22125751;3883;309;4877;4916;7.25;0.44;274.75;4.47;994;13;1660.00;39
3884;12;22125768;3884;312;4879;4916;7.31;0.45;274.86;4.47;995;13;1661.00;37
3885;12;22125785;3885;316;4882;4916;7.38;0.45;274.91;4.47;997;13;1662.00;34
3889;12;22125800;3889;318;4884;4916;7.41;0.45;275.27;4.47;995;13;1663.00;32
3895;12;22125816;3895;325;4885;4917;7.40;0.45;275.21;4.47;990;13;1664.00;32
3897;12;22125838;3897;320;4888;4919;7.46;0.45;275.26;4.47;991;13;1665.00;31
3899;12;22125854;3899;309;4890;4919;7.43;0.45;275.37;4.48;991;13;1666.00;29
3900;12;22125869;3900;307;4896;4923;7.48;0.45;275.48;4.48;996;13;1667.00;27
3901;12;22125884;3901;309;4897;4923;7.53;0.46;275.58;4.48;996;13;1668.00;26
3905;12;22125900;3905;300;4898;4923;7.57;0.46;275.67;4.48;993;13;1669.00;25
3906;12;22125916;3906;303;4899;4923;7.63;0.46;275.63;4.48;993;13;1670.00;24
3910;12;22125931;3910;296;4904;4929;7.70;0.47;275.78;4.48;994;13;1671.00;25
3914;12;22125947;3914;296;4905;4929;7.77;0.47;275.82;4.48;991;13;1672.00;24
3918;12;22125961;3918;295;4906;4929;7.81;0.47;276.13;4.48;988;13;1673.00;23
3922;12;22125977;3922;294;4908;4932;7.88;0.48;276.31;4.48;986;13;1674.00;24
3923;12;22125991;3923;291;4908;4932;7.96;0.48;276.30;4.48;985;13;1675.00;24
3927;12;22126006;3927;289;4909;4932;7.97;0.48;276.42;4.48;982;13;1676.00;23
3931;12;22126022;3931;291;4909;4933;7.95;0.48;276.52;4.48;978;13;1677.00;24
3934;12;22126037;3934;290;4910;4934;7.96;0.48;276.68;4.48;976;13;1678.00;24
3936;12;22126053;3936;283;4911;4934;7.92;0.48;276.68;4.50;975;13;1679.00;23
3938;12;22126070;3938;285;4932;4960;7.87;0.48;276.81;4.50;994;13;1680.00;28
3942;12;22126088;3942;279;4932;4960;7.78;0.47;276.95;4.50;990;13;1681.00;28
3946;12;22126104;3946;273;4933;4960;7.80;0.47;276.89;4.50;987;13;1682.00;27
3949;12;22126119;3949;263;4935;4961;7.80;0.47;276.98;4.50;986;13;1683.00;26
3953;12;22126134;3953;262;4935;4961;7.77;0.47;277.08;4.50;982;13;1684.00;26
3955;13;22126149;3955;260;4938;4965;7.83;0.47;277.08;4.49;983;14;1685.00;27
3956;13;22126193;3956;262;4938;4965;7.86;0.48;277.10;4.49;982;14;1686.00;27
3959;13;22126214;3959;262;4941;4969;7.79;0.47;277.16;4.49;982;14;1687.00;28
3960;13;22126229;3960;253;4941;4969;7.82;0.47;277.13;4.49;981;14;1688.00;28
3962;13;22126243;3962;252;4941;4969;7.86;0.48;277.25;4.49;979;14;1689.00;28
3965;13;22126257;3965;246;4941;4969;7.88;0.48;277.31;4.49;976;14;1690.00;28
3969;13;22126273;3969;246;4942;4969;7.87;0.48;277.50;4.51;973;14;1691.00;27
3972;13;22126298;3972;246;4951;4981;7.92;0.48;277.36;4.50;979;14;1692.00;30
3974;13;22126315;3974;242;4952;4981;7.93;0.48;277.49;4.50;978;14;1693.00;29
3980;13;22126330;3980;240;4953;4981;7.92;0.48;277.59;4.50;973;14;1694.00;28
3985;13;22126347;3985;237;4953;4981;7.93;0.48;277.57;4.50;968;14;1695.00;28
3986;13;22126364;3986;237;4953;4981;7.95;0.48;277.57;4.50;967;14;1696.00;28
3988;13;22126382;3988;233;4954;4981;7.93;0.48;277.67;4.50;966;14;1697.00;27
3989;13;22126398;3989;232;4954;4982;7.91;0.48;277.77;4.50;965;14;1698.00;28
3990;13;22126413;3990;230;4954;4982;7.88;0.48;277.81;4.50;964;14;1699.00;28
3994;13;22126427;3994;235;4959;4988;7.94;0.48;278.10;4.50;965;14;1700.00;29
3997;14;22126448;3997;241;4962;4989;7.92;0.48;278.16;4.51;965;15;1701.00;27
3999;14;22126491;3999;241;4963;4989;7.92;0.48;278.13;4.53;964;15;1702.00;26
4001;14;22126506;4001;244;4963;4989;7.94;0.48;278.19;4.53;962;15;1703.00;26
4002;14;22126521;4002;249;4968;4993;7.93;0.48;278.13;4.53;966;15;1704.00;25
4004;14;22126536;4004;246;4970;4993;7.90;0.48;278.27;4.56;966;15;1705.00;23
4007;14;22126562;4007;253;4970;4993;7.87;0.48;278.35;4.56;963;15;1706.00;23
4009;14;22126577;4009;255;4972;4994;7.89;0.48;278.39;4.58;963;15;1707.00;22
4013;14;22126590;4013;256;4976;4998;7.89;0.48;278.55;4.59;963;15;1708.00;22
4015;14;22126606;4015;252;4976;4998;7.90;0.48;278.56;4.59;961;15;1709.00;22
4018;14;22126622;4018;252;4981;5004;7.95;0.48;278.63;4.61;963;15;1710.00;23
4020;14;22126638;4020;254;4983;5004;7.96;0.48;278.67;4.62;963;15;1711.00;21
4023;14;22126654;4023;254;4984;5004;7.97;0.49;278.74;4.62;961;15;1712.00;20
4026;14;22126669;4026;259;4986;5004;7.98;0.49;278.76;4.64;960;15;1713.00;18
4028;14;22126688;4028;262;4990;5008;8.01;0.49;278.76;4.64;962;15;1714.00;18
4032;15;22126704;4032;257;4992;5008;7.97;0.49;278.79;4.66;960;16;1715.00;16
4034;15;22126741;4034;259;4992;5008;7.95;0.49;278.81;4.66;958;16;1716.00;16
4036;15;22126763;4036;255;4993;5008;7.95;0.49;278.78;4.67;957;16;1717.00;15
4038;15;22126778;4038;256;4993;5009;7.86;0.48;278.87;4.67;955;16;1718.00;16
4040;15;22126806;4040;256;4994;5010;7.79;0.48;278.87;4.67;954;16;1719.00;16
4041;15;22126822;4041;258;4995;5010;7.74;0.47;278.85;4.69;954;16;1720.00;15
4044;15;22126836;4044;257;4996;5011;7.64;0.47;278.99;4.69;952;16;1721.00;15
4048;15;22126851;4048;265;4996;5011;7.57;0.46;279.07;4.69;948;16;1722.00;15
4050;15;22126866;4050;267;4997;5011;7.56;0.46;279.26;4.71;947;16;1723.00;14
4054;15;22126879;4054;270;5000;5011;7.53;0.46;279.22;4.75;946;16;1724.00;11
4058;15;22126895;4058;271;5000;5011;7.49;0.46;279.14;4.75;942;16;1725.00;11
4060;15;22126909;4060;265;5003;5011;7.54;0.46;279.20;4.78;943;16;1726.00;8
4061;15;22126923;4061;266;5003;5011;7.60;0.47;279.23;4.78;942;16;1727.00;8
4065;15;22126938;4065;282;5072;5138;7.70;0.48;279.28;4.71;1007;16;1728.00;66
4069;15;22126966;4069;274;5078;5139;7.78;0.48;279.36;4.72;1009;16;1729.00;61
4073;15;22126982;4073;269;5084;5139;7.84;0.48;279.44;4.72;1011;16;1730.00;55
4076;15;22126996;4076;265;5088;5139;7.92;0.49;279.50;4.72;1012;16;1731.00;51
4078;15;22127011;4078;264;5092;5139;7.95;0.49;279.44;4.72;1014;16;1732.00;47
4081;15;22127024;4081;263;5094;5139;8.03;0.50;279.48;4.72;1013;16;1733.00;45
4083;16;22127038;4083;262;5097;5139;8.00;0.49;279.50;4.72;1014;17;1734.00;42
4084;16;22127075;4084;265;5101;5139;8.02;0.49;279.46;4.73;1017;17;1735.00;38
4086;16;22127099;4086;261;5104;5140;8.03;0.49;279.61;4.74;1018;17;1736.00;36
4090;16;22127114;4090;260;5110;5141;8.00;0.49;279.65;4.76;1020;17;1737.00;31
4092;16;22127128;4092;257;5112;5141;7.97;0.49;279.74;4.76;1020;17;1738.00;29
4097;16;22127141;4097;265;5115;5142;7.85;0.48;279.74;4.77;1018;17;1739.00;27
4102;16;22127158;4102;282;5119;5142;7.76;0.48;279.66;4.77;1017;17;1740.00;23
4110;16;22127175;4110;286;5122;5142;7.53;0.46;279.75;4.78;1012;17;1741.00;20
4112;16;22127192;4112;287;5127;5142;7.38;0.45;279.73;4.79;1015;17;1742.00;15
4116;16;22127207;4116;304;5130;5146;7.29;0.45;279.78;4.79;1014;17;1743.00;16
4120;16;22127222;4120;313;5132;5146;7.20;0.44;279.79;4.79;1012;17;1744.00;14
4127;16;22127237;4127;320;5135;5146;7.06;0.43;279.57;4.80;1008;17;1745.00;11
4129;16;22127252;4129;329;5137;5149;7.04;0.43;279.50;4.80;1008;17;1746.00;12
4135;16;22127266;4135;338;5142;5149;6.88;0.42;279.71;4.81;1007;17;1747.00;7
4137;16;22127280;4137;354;5143;5149;6.68;0.41;279.72;4.82;1006;17;1748.00;6
4139;17;22127293;4139;367;5146;5153;6.52;0.40;279.66;4.81;1007;18;1749.00;7
4143;17;22127321;4143;357;5148;5154;6.37;0.39;279.64;4.82;1005;18;1750.00;6
4149;17;22127336;4149;350;5150;5154;6.22;0.38;279.73;4.82;1001;18;1751.00;4
4152;17;22127351;4152;359;5155;5158;6.15;0.38;279.75;4.82;1003;18;1752.00;3
4155;17;22127387;4155;359;5156;5158;6.08;0.37;279.87;4.82;1001;18;1753.00;2
4159;17;22127407;4159;359;5158;5158;6.10;0.37;279.91;4.82;999;18;1754.00;0
4161;17;22127420;4161;366;5159;5160;6.07;0.37;279.90;4.82;998;18;1755.00;1
4167;17;22127434;4167;369;5160;5160;6.05;0.37;279.96;4.82;993;18;1756.00;0
4170;17;22127448;4170;364;5166;5166;6.07;0.37;280.00;4.81;996;18;1757.00;0
4173;17;22127468;4173;364;5166;5166;6.08;0.37;280.07;4.81;993;18;1758.00;0
4174;17;22127481;4174;363;5167;5167;6.12;0.37;280.20;4.81;993;18;1759.00;0
4179;17;22127494;4179;360;5167;5167;6.05;0.37;280.24;4.81;988;18;1760.00;0
4180;17;22127506;4180;357;5167;5167;6.04;0.37;280.28;4.81;987;18;1761.00;0
4183;17;22127520;4183;364;5167;5167;5.96;0.36;280.26;4.81;984;18;1762.00;0
4187;17;22127534;4187;370;5167;5167;5.90;0.36;280.28;4.81;980;18;1763.00;0
4191;17;22127548;4191;377;5177;5179;5.90;0.36;280.19;4.80;986;18;1764.00;2
4195;17;22127570;4195;379;5177;5179;5.88;0.36;280.19;4.80;982;18;1765.00;2
4198;17;22127584;4198;392;5179;5179;5.86;0.36;280.23;4.80;981;18;1766.00;0
4200;17;22127597;4200;390;5179;5179;5.78;0.35;280.17;4.80;979;18;1767.00;0
4204;17;22127608;4204;400;5179;5179;5.66;0.35;280.21;4.80;975;18;1768.00;0
4206;17;22127622;4206;399;5179;5179;5.59;0.34;280.22;4.80;973;18;1769.00;0
4212;17;22127639;4212;412;5183;5183;5.47;0.33;280.21;4.80;971;18;1770.00;0
4216;17;22127655;4216;417;5183;5183;5.38;0.33;280.19;4.80;967;18;1771.00;0
4217;17;22127668;4217;419;5187;5187;5.44;0.33;280.25;4.80;970;18;1772.00;0
4224;17;22127681;4224;426;5188;5188;5.41;0.33;280.14;4.80;964;18;1773.00;0
4227;17;22127694;4227;427;5188;5188;5.41;0.33;280.11;4.80;961;18;1774.00;0
4229;17;22127707;4229;429;5188;5188;5.42;0.33;280.12;4.80;959;18;1775.00;0
4234;17;22127720;4234;436;5199;5201;5.45;0.33;280.09;4.79;965;18;1776.00;2
4237;17;22127735;4237;434;5199;5201;5.40;0.33;279.97;4.79;962;18;1777.00;2
4241;17;22127748;4241;438;5199;5201;5.33;0.33;280.07;4.79;958;18;1778.00;2
4244;17;22127762;4244;442;5200;5202;5.30;0.32;280.03;4.78;956;18;1779.00;2
4249;17;22127774;4249;442;5200;5203;5.21;0.32;279.98;4.78;951;18;1780.00;3
4252;17;22127788;4252;448;5200;5203;5.17;0.32;279.91;4.78;948;18;1781.00;3
4254;17;22127800;4254;456;5202;5206;5.18;0.32;280.07;4.78;948;18;1782.00;4
4255;17;22127815;4255;456;5202;5206;5.21;0.32;280.02;4.78;947;18;1783.00;4
4259;17;22127827;4259;463;5203;5206;5.17;0.32;279.96;4.78;944;18;1784.00;3
4264;17;22127839;4264;467;5203;5206;5.08;0.31;280.00;4.78;939;18;1785.00;3
4268;17;22127854;4268;472;5208;5212;5.05;0.31;279.91;4.78;940;18;1786.00;4
4270;17;22127867;4270;476;5208;5212;5.04;0.31;279.91;4.78;938;18;1787.00;4
4273;17;22127879;4273;474;5208;5212;5.00;0.31;279.90;4.78;935;18;1788.00;4
4275;17;22127890;4275;479;5208;5212;4.99;0.30;279.86;4.78;933;18;1789.00;4
4277;17;22127902;4277;479;5211;5216;5.01;0.31;279.87;4.78;934;18;1790.00;5
4279;17;22127915;4279;482;5212;5217;4.98;0.30;279.89;4.78;933;18;1791.00;5
4282;17;22127926;4282;486;5212;5217;4.95;0.30;279.80;4.78;930;18;1792.00;5
4284;17;22127938;4284;489;5213;5218;4.92;0.30;279.84;4.77;929;18;1793.00;5
4288;17;22127950;4288;479;5213;5218;4.84;0.29;279.75;4.77;925;18;1794.00;5
4291;17;22127962;4291;477;5213;5218;4.87;0.30;279.69;4.77;922;18;1795.00;5
4292;17;22127974;4292;476;5213;5218;4.89;0.30;279.83;4.77;921;18;1796.00;5
4294;17;22127986;4294;460;5213;5218;4.97;0.30;279.87;4.77;919;18;1797.00;5
4295;17;22127999;4295;439;5213;5218;5.09;0.31;279.87;4.77;918;18;1798.00;5
4295;17;22128016;4295;429;5213;5218;5.23;0.32;279.87;4.77;918;18;1799.00;5
4297;17;22128031;4297;430;5280;5356;5.62;0.35;279.88;4.71;983;18;1800.00;76
4299;17;22128075;4299;424;5283;5357;5.71;0.35;279.93;4.71;984;18;1801.00;74
4301;17;22128090;4301;414;5293;5357;5.87;0.36;279.91;4.71;992;18;1802.00;64
4302;17;22128106;4302;408;5304;5357;5.95;0.37;279.93;4.70;1002;18;1803.00;53
4302;17;22128121;4302;402;5310;5357;6.05;0.37;279.93;4.70;1008;18;1804.00;47
4305;17;22128137;4305;395;5312;5357;6.14;0.38;280.09;4.70;1007;18;1805.00;45
4307;17;22128158;4307;390;5319;5357;6.24;0.38;280.11;4.70;1012;18;1806.00;38
4308;17;22128173;4308;368;5323;5357;6.33;0.39;280.13;4.71;1015;18;1807.00;34
4310;17;22128188;4310;361;5328;5358;6.39;0.39;280.13;4.71;1018;18;1808.00;30
4310;17;22128209;4310;355;5332;5359;6.43;0.39;280.13;4.71;1022;18;1809.00;27
4312;17;22128224;4312;352;5333;5359;6.43;0.39;280.18;4.71;1021;18;1810.00;26
4312;17;22128239;4312;353;5339;5363;6.45;0.40;280.18;4.71;1027;18;1811.00;24
4313;17;22128256;4313;359;5340;5363;6.51;0.40;280.21;4.71;1027;18;1812.00;23
4313;17;22128272;4313;359;5340;5363;6.60;0.40;280.21;4.71;1027;18;1813.00;23
4314;17;22128295;4314;358;5341;5363;6.67;0.41;280.23;4.71;1027;18;1814.00;22
4315;17;22128312;4315;364;5345;5369;6.73;0.41;280.25;4.71;1030;18;1815.00;24
4319;17;22128327;4319;369;5345;5369;6.80;0.41;280.40;4.71;1026;18;1816.00;24
4323;17;22128344;4323;361;5346;5369;6.83;0.42;280.57;4.71;1023;18;1817.00;23
4325;17;22128366;4325;364;5348;5372;6.91;0.42;280.68;4.71;1023;18;1818.00;24
4328;17;22128382;4328;365;5348;5372;6.96;0.42;280.90;4.71;1020;18;1819.00;24
4330;17;22128397;4330;365;5349;5372;7.01;0.43;280.96;4.72;1019;18;1820.00;23
4334;17;22128414;4334;357;5350;5373;7.03;0.43;280.92;4.72;1016;18;1821.00;23
4335;17;22128431;4335;354;5351;5374;7.13;0.43;280.96;4.72;1016;18;1822.00;23
4341;17;22128447;4341;351;5351;5374;7.15;0.43;281.14;4.72;1010;18;1823.00;23
4342;17;22128464;4342;349;5359;5387;7.21;0.44;281.25;4.71;1017;18;1824.00;28
4346;17;22128484;4346;344;5360;5387;7.24;0.44;281.37;4.71;1014;18;1825.00;27
4350;17;22128501;4350;343;5362;5387;7.30;0.44;281.54;4.72;1012;18;1826.00;25
4351;17;22128517;4351;343;5364;5388;7.33;0.45;281.58;4.72;1013;18;1827.00;24
4354;17;22128535;4354;341;5364;5388;7.38;0.45;281.69;4.72;1010;18;1828.00;24
4358;17;22128553;4358;340;5369;5392;7.45;0.45;281.81;4.72;1011;18;1829.00;23
4361;17;22128572;4361;337;5369;5392;7.51;0.46;281.95;4.72;1008;18;1830.00;23
4364;17;22128590;4364;340;5374;5396;7.52;0.46;282.09;4.72;1010;18;1831.00;22
4366;17;22128608;4366;338;5374;5396;7.61;0.46;282.19;4.72;1008;18;1832.00;22
4371;17;22128625;4371;330;5374;5396;7.63;0.46;282.40;4.72;1003;18;1833.00;22
4373;17;22128644;4373;333;5375;5396;7.64;0.47;282.49;4.72;1002;18;1834.00;21
4375;17;22128661;4375;330;5375;5396;7.56;0.46;282.49;4.72;1000;18;1835.00;21
4379;17;22128676;4379;333;5385;5408;7.55;0.46;282.64;4.71;1006;18;1836.00;23
4381;17;22128697;4381;337;5385;5408;7.49;0.46;282.69;4.71;1004;18;1837.00;23
4383;17;22128714;4383;331;5386;5408;7.42;0.45;282.80;4.71;1003;18;1838.00;22
4384;17;22128729;4384;336;5386;5408;7.33;0.45;282.76;4.71;1002;18;1839.00;22
4385;17;22128742;4385;329;5386;5408;7.28;0.44;282.89;4.71;1001;18;1840.00;22
4391;17;22128759;4391;322;5386;5408;7.23;0.44;283.15;4.71;995;18;1841.00;22
4394;17;22128775;4394;323;5386;5409;7.15;0.43;283.22;4.71;992;18;1842.00;23
4395;17;22128790;4395;322;5386;5409;7.17;0.44;283.20;4.71;991;18;1843.00;23
4399;17;22128805;4399;320;5391;5415;7.18;0.44;283.43;4.71;992;18;1844.00;24
4399;17;22128821;4399;320;5393;5417;7.21;0.44;283.43;4.71;994;18;1845.00;24
4401;17;22128837;4401;319;5393;5417;7.21;0.44;283.47;4.71;992;18;1846.00;24
4403;17;22128854;4403;310;5393;5417;7.32;0.45;283.47;4.71;990;18;1847.00;24
4405;17;22128870;4405;305;5396;5421;7.41;0.45;283.49;4.70;991;18;1848.00;25
4407;17;22128887;4407;302;5396;5421;7.45;0.45;283.56;4.70;989;18;1849.00;25
4412;17;22128903;4412;300;5396;5421;7.40;0.45;283.53;4.70;984;18;1850.00;25
4413;17;22128919;4413;305;5397;5422;7.40;0.45;283.52;4.70;984;18;1851.00;25
4418;17;22128936;4418;308;5400;5426;7.34;0.45;283.75;4.70;982;18;1852.00;26
4423;17;22128951;4423;299;5400;5426;7.31;0.44;283.90;4.70;977;18;1853.00;26
4424;17;22128968;4424;292;5402;5429;7.35;0.45;283.93;4.70;978;18;1854.00;27
4428;17;22128983;4428;290;5404;5429;7.27;0.44;284.01;4.71;976;18;1855.00;25
4431;17;22129001;4431;277;5404;5429;7.28;0.44;284.06;4.71;973;18;1856.00;25
4433;17;22129017;4433;276;5405;5429;7.27;0.44;284.10;4.73;972;18;1857.00;24
4437;17;22129033;4437;266;5409;5433;7.26;0.44;284.22;4.72;972;18;1858.00;24
4440;17;22129048;4440;262;5409;5433;7.29;0.44;284.24;4.72;969;18;1859.00;24
4442;17;22129065;4442;262;5409;5433;7.36;0.45;284.23;4.72;967;18;1860.00;24
4446;17;22129079;4446;257;5409;5433;7.38;0.45;284.38;4.72;963;18;1861.00;24
4447;17;22129094;4447;255;5409;5434;7.41;0.45;284.49;4.72;962;18;1862.00;25
4450;17;22129106;4450;254;5410;5435;7.50;0.46;284.60;4.72;960;18;1863.00;25
4453;17;22129122;4453;251;5410;5435;7.49;0.46;284.59;4.72;957;18;1864.00;25
4455;17;22129136;4455;243;5411;5436;7.44;0.46;284.64;4.72;956;18;1865.00;25
4456;17;22129151;4456;238;5411;5436;7.53;0.46;284.64;4.72;955;18;1866.00;25
4461;17;22129166;4461;236;5411;5436;7.52;0.46;284.72;4.72;950;18;1867.00;25
4463;17;22129204;4463;230;5411;5436;7.55;0.46;284.77;4.72;948;18;1868.00;25
4469;17;22129220;4469;229;5411;5436;7.48;0.46;284.81;4.72;942;18;1869.00;25
4473;17;22129234;4473;230;5411;5436;7.54;0.46;284.75;4.72;938;18;1870.00;25
4475;17;22129248;4475;231;5411;5436;7.57;0.46;284.84;4.72;936;18;1871.00;25
4476;17;22129262;4476;255;5477;5563;7.66;0.47;284.80;4.68;1001;18;1872.00;86
4478;17;22129288;4478;239;5480;5564;7.76;0.48;284.97;4.68;1002;18;1873.00;84
4481;17;22129304;4481;237;5487;5564;7.88;0.49;285.06;4.67;1006;18;1874.00;77
4482;17;22129319;4482;228;5488;5564;7.93;0.49;285.10;4.67;1006;18;1875.00;76
4486;17;22129335;4486;226;5493;5564;7.98;0.49;285.15;4.67;1007;18;1876.00;71
4492;17;22129350;4492;230;5494;5564;7.96;0.49;285.11;4.67;1002;18;1877.00;70
4492;17;22129366;4492;229;5501;5564;8.00;0.49;285.11;4.67;1009;18;1878.00;63
4495;17;22129382;4495;230;5502;5564;8.02;0.49;285.32;4.68;1007;18;1879.00;62
4497;17;22129399;4497;229;5506;5565;8.06;0.50;285.50;4.68;1009;18;1880.00;59
4503;17;22129424;4503;234;5511;5566;8.10;0.50;285.37;4.71;1008;18;1881.00;55
4506;17;22129441;4506;239;5516;5568;8.13;0.50;285.36;4.72;1010;18;1882.00;52
4507;17;22129457;4507;240;5521;5569;8.12;0.50;285.30;4.72;1014;18;1883.00;48
4508;17;22129473;4508;241;5525;5569;8.06;0.50;285.28;4.74;1017;18;1884.00;44
4514;17;22129489;4514;236;5528;5569;7.90;0.49;285.40;4.75;1014;18;1885.00;41
4516;17;22129506;4516;243;5529;5569;7.86;0.48;285.39;4.75;1013;18;1886.00;40
4520;17;22129522;4520;243;5534;5573;7.77;0.48;285.50;4.77;1014;18;1887.00;39
4524;17;22129537;4524;259;5536;5573;7.69;0.47;285.65;4.77;1012;18;1888.00;37
4525;17;22129552;4525;266;5537;5573;7.61;0.47;285.60;4.77;1012;18;1889.00;36
4529;17;22129569;4529;270;5544;5579;7.52;0.46;285.64;4.78;1015;18;1890.00;35
4530;17;22129585;4530;279;5545;5579;7.38;0.45;285.74;4.78;1015;18;1891.00;34
4532;17;22129606;4532;282;5547;5579;7.28;0.44;285.74;4.80;1015;18;1892.00;32
4534;17;22129620;4534;286;5549;5583;7.15;0.44;285.71;4.80;1015;18;1893.00;34
4536;17;22129636;4536;289;5552;5584;7.15;0.44;285.72;4.82;1016;18;1894.00;32
4538;17;22129651;4538;298;5553;5584;7.09;0.43;285.87;4.82;1015;18;1895.00;31
4540;17;22129669;4540;296;5558;5588;7.09;0.43;285.90;4.85;1018;18;1896.00;30
4546;17;22129684;4546;305;5560;5588;6.99;0.43;285.82;4.85;1014;18;1897.00;28
4548;17;22129701;4548;312;5562;5588;6.92;0.42;285.88;4.88;1014;18;1898.00;26
4549;17;22129717;4549;305;5564;5589;6.86;0.42;285.89;4.89;1015;18;1899.00;25
4552;17;22129734;4552;305;5564;5589;6.84;0.42;285.96;4.89;1012;18;1900.00;25
4553;17;22129755;4553;308;5572;5595;6.85;0.42;285.97;4.92;1019;18;1901.00;23
4554;17;22129772;4554;311;5572;5595;6.83;0.42;285.95;4.92;1018;18;1902.00;23
4555;17;22129789;4555;313;5572;5596;6.84;0.42;285.99;4.92;1017;18;1903.00;24
4557;17;22129805;4557;323;5572;5596;6.76;0.42;286.01;4.92;1015;18;1904.00;24
4559;17;22129822;4559;321;5575;5596;6.73;0.41;286.10;4.96;1016;18;1905.00;21
4560;17;22129838;4560;328;5576;5596;6.72;0.41;286.12;4.98;1016;18;1906.00;20
4564;17;22129853;4564;330;5578;5596;6.70;0.41;286.24;5.00;1014;18;1907.00;18
4566;17;22129868;4566;338;5588;5608;6.76;0.42;286.32;5.00;1022;18;1908.00;20
4570;17;22129884;4570;341;5588;5608;6.74;0.42;286.40;5.00;1018;18;1909.00;20
4573;17;22129899;4573;350;5592;5608;6.77;0.42;286.40;5.01;1019;18;1910.00;16
4580;17;22129916;4580;355;5592;5608;6.71;0.41;286.43;5.01;1012;18;1911.00;16
4583;17;22129932;4583;358;5593;5608;6.70;0.41;286.40;5.03;1010;18;1912.00;15
4587;17;22129947;4587;365;5594;5608;6.68;0.41;286.33;5.03;1007;18;1913.00;14
4596;17;22129961;4596;373;5598;5612;6.58;0.40;286.39;5.04;1002;18;1914.00;14
4599;17;22129977;4599;383;5598;5612;6.47;0.40;286.51;5.04;999;18;1915.00;14
4600;17;22129989;4600;390;5602;5616;6.41;0.39;286.50;5.03;1002;18;1916.00;14
4603;17;22130004;4603;394;5604;5617;6.28;0.39;286.52;5.04;1001;18;1917.00;13
4604;17;22130018;4604;398;5604;5617;6.16;0.38;286.53;5.04;1000;18;1918.00;13
4609;17;22130032;4609;403;5605;5617;6.02;0.37;286.48;5.05;996;18;1919.00;12
4611;17;22130047;4611;408;5628;5646;6.00;0.37;286.47;5.03;1017;18;1920.00;18
4619;17;22130062;4619;413;5631;5646;5.87;0.36;286.28;5.05;1012;18;1921.00;15
4623;17;22130073;4623;418;5635;5646;5.81;0.36;286.21;5.05;1012;18;1922.00;11
4625;17;22130085;4625;414;5636;5647;5.75;0.36;286.16;5.05;1011;18;1923.00;11
4629;17;22130097;4629;423;5636;5648;5.65;0.35;286.16;5.05;1007;18;1924.00;12
4635;17;22130108;4635;412;5637;5648;5.54;0.34;286.14;5.06;1002;18;1925.00;11
4638;17;22130121;4638;408;5640;5651;5.47;0.34;286.17;5.06;1002;18;1926.00;11
4642;17;22130135;4642;406;5640;5651;5.40;0.33;286.18;5.06;998;18;1927.00;11
4644;17;22130148;4644;413;5640;5651;5.32;0.33;286.14;5.06;996;18;1928.00;11
4647;17;22130162;4647;411;5640;5651;5.27;0.32;286.07;5.06;993;18;1929.00;11
4650;17;22130174;4650;412;5645;5657;5.31;0.33;286.06;5.06;995;18;1930.00;12
4652;17;22130190;4652;416;5645;5657;5.33;0.33;286.07;5.06;993;18;1931.00;12
4655;17;22130203;4655;412;5645;5657;5.37;0.33;286.09;5.06;990;18;1932.00;12
4656;17;22130218;4656;415;5645;5657;5.38;0.33;286.06;5.06;989;18;1933.00;12
4661;17;22130233;4661;412;5648;5661;5.33;0.33;285.99;5.05;987;18;1934.00;13
4665;17;22130249;4665;411;5650;5663;5.26;0.32;285.98;5.05;985;18;1935.00;13
4668;17;22130263;4668;411;5650;5663;5.19;0.32;286.04;5.05;982;18;1936.00;13
4669;17;22130275;4669;411;5651;5664;5.12;0.32;285.99;5.05;982;18;1937.00;13
4670;17;22130288;4670;413;5651;5664;5.12;0.32;286.02;5.05;981;18;1938.00;13
4675;17;22130301;4675;419;5651;5664;5.07;0.31;286.00;5.05;976;18;1939.00;13
4680;17;22130315;4680;427;5651;5664;4.98;0.31;285.89;5.05;971;18;1940.00;13
4683;17;22130329;4683;430;5651;5664;4.90;0.30;285.97;5.05;968;18;1941.00;13
4684;17;22130341;4684;433;5651;5664;4.88;0.30;286.01;5.05;967;18;1942.00;13
4690;17;22130355;4690;439;5651;5664;4.81;0.30;285.94;5.05;961;18;1943.00;13
4692;17;22130368;4692;442;5688;5734;4.99;0.31;286.06;5.02;996;18;1944.00;46
4694;17;22130387;4694;438;5689;5735;5.01;0.31;286.14;5.02;995;18;1945.00;46
4697;17;22130400;4697;442;5698;5735;5.08;0.31;286.00;5.01;1001;18;1946.00;37
4700;17;22130414;4700;439;5700;5735;5.13;0.32;286.04;5.01;1000;18;1947.00;35
4705;17;22130425;4705;446;5702;5735;5.11;0.31;286.06;5.01;997;18;1948.00;33
4708;17;22130438;4708;447;5702;5735;5.10;0.31;285.97;5.01;994;18;1949.00;33
4712;17;22130452;4712;452;5708;5737;5.06;0.31;286.10;5.01;996;18;1950.00;29
4715;17;22130465;4715;443;5711;5737;5.10;0.31;286.11;5.01;996;18;1951.00;26
4718;17;22130479;4718;435;5713;5738;5.11;0.31;286.06;5.01;995;18;1952.00;25
4720;17;22130490;4720;428;5715;5739;5.11;0.31;286.13;5.01;995;18;1953.00;24
4723;17;22130503;4723;429;5720;5739;5.15;0.31;286.13;5.02;997;18;1954.00;19
4725;17;22130518;4725;439;5725;5743;5.23;0.32;286.12;5.02;1000;18;1955.00;18
4729;17;22130534;4729;440;5725;5743;5.27;0.32;286.04;5.02;996;18;1956.00;18
4735;17;22130551;4735;443;5725;5743;5.27;0.32;286.00;5.02;990;18;1957.00;18
4738;17;22130575;4738;442;5725;5743;5.34;0.33;286.01;5.02;987;18;1958.00;18
4740;17;22130590;4740;445;5730;5749;5.40;0.33;285.99;5.01;990;18;1959.00;19
4745;17;22130605;4745;441;5730;5749;5.39;0.33;285.97;5.01;985;18;1960.00;19
4745;17;22130619;4745;441;5730;5749;5.42;0.33;285.97;5.01;985;18;1961.00;19
4748;17;22130632;4748;438;5732;5752;5.53;0.34;286.02;5.01;984;18;1962.00;20
4748;17;22130647;4748;438;5733;5752;5.66;0.35;286.02;5.01;985;18;1963.00;19
4750;17;22130661;4750;437;5733;5752;5.72;0.35;286.05;5.01;983;18;1964.00;19
4752;17;22130679;4752;437;5733;5753;5.78;0.35;286.00;5.01;981;18;1965.00;20
4755;17;22130710;4755;441;5734;5754;5.82;0.35;285.95;5.01;979;18;1966.00;20
4755;17;22130731;4755;434;5734;5754;5.85;0.36;285.95;5.01;979;18;1967.00;20
4757;17;22130749;4757;436;5745;5767;5.99;0.36;285.94;5.00;988;18;1968.00;22
4760;17;22130768;4760;432;5745;5767;5.94;0.36;285.89;5.00;985;18;1969.00;22
4760;17;22130783;4760;435;5745;5767;5.97;0.36;285.89;5.00;985;18;1970.00;22
4764;17;22130797;4764;439;5746;5768;5.96;0.36;285.88;5.00;982;18;1971.00;22
4767;17;22130810;4767;434;5746;5768;5.97;0.36;285.91;5.00;979;18;1972.00;22
4768;17;22130823;4768;422;5750;5772;6.06;0.37;285.94;5.00;982;18;1973.00;22
4769;17;22130838;4769;418;5750;5772;6.07;0.37;285.97;5.00;981;18;1974.00;22
4770;17;22130853;4770;412;5753;5776;6.13;0.37;286.00;4.99;983;18;1975.00;23
4772;17;22130867;4772;415;5753;5776;6.14;0.37;286.08;4.99;981;18;1976.00;23
4774;17;22130882;4774;415;5753;5776;6.11;0.37;286.06;4.99;979;18;1977.00;23
4776;17;22130910;4776;417;5753;5776;6.10;0.37;286.16;4.99;977;18;1978.00;23
4778;17;22130923;4778;413;5753;5776;6.14;0.37;286.10;4.99;975;18;1979.00;23
4780;17;22130941;4780;417;5781;5810;6.31;0.38;286.12;4.97;1001;18;1980.00;29
4782;17;22130967;4782;401;5781;5810;6.36;0.39;286.04;4.97;999;18;1981.00;29
4782;17;22130982;4782;394;5783;5810;6.46;0.39;286.04;4.97;1001;18;1982.00;27
4783;17;22130997;4783;383;5783;5810;6.56;0.40;286.08;4.97;1000;18;1983.00;27
4784;17;22131012;4784;373;5784;5810;6.68;0.41;286.09;4.97;1000;18;1984.00;26
4786;17;22131026;4786;369;5784;5810;6.76;0.41;286.10;4.97;998;18;1985.00;26
4788;17;22131040;4788;367;5784;5811;6.76;0.41;286.22;4.97;996;18;1986.00;27
4792;17;22131055;4792;367;5784;5811;6.73;0.41;286.29;4.97;992;18;1987.00;27
4795;17;22131070;4795;371;5789;5817;6.72;0.41;286.38;4.96;994;18;1988.00;28
4796;17;22131086;4796;373;5790;5818;6.69;0.41;286.36;4.96;994;18;1989.00;28
4797;17;22131101;4797;373;5790;5818;6.65;0.41;286.43;4.96;993;18;1990.00;28
4799;17;22131116;4799;376;5790;5818;6.63;0.40;286.45;4.96;991;18;1991.00;28
4801;17;22131131;4801;374;5793;5822;6.62;0.40;286.55;4.96;992;18;1992.00;29
4803;17;22131149;4803;375;5793;5822;6.58;0.40;286.71;4.96;990;18;1993.00;29
4808;17;22131168;4808;367;5793;5822;6.55;0.40;286.75;4.96;985;18;1994.00;29
4810;17;22131185;4810;363;5794;5823;6.57;0.40;286.90;4.96;984;18;1995.00;29
4813;17;22131200;4813;365;5797;5827;6.52;0.39;286.98;4.96;984;18;1996.00;30
4818;17;22131217;4818;359;5797;5827;6.51;0.39;287.16;4.96;979;18;1997.00;30
4820;17;22131231;4820;364;5799;5830;6.58;0.40;287.18;4.96;979;18;1998.00;31
4821;17;22131246;4821;362;5799;5830;6.60;0.40;287.27;4.96;978;18;1999.00;31
4824;17;22131261;4824;364;5800;5830;6.64;0.40;287.32;4.96;976;18;2000.00;30
4829;17;22131281;4829;365;5800;5830;6.63;0.40;287.48;4.96;971;18;2001.00;30
4831;17;22131296;4831;369;5804;5834;6.73;0.41;287.48;4.95;973;18;2002.00;30
4832;17;22131312;4832;367;5804;5834;6.72;0.41;287.59;4.95;972;18;2003.00;30
4835;17;22131324;4835;363;5804;5834;6.77;0.41;287.74;4.95;969;18;2004.00;30
4837;17;22131339;4837;363;5804;5834;6.84;0.42;287.77;4.95;967;18;2005.00;30
4837;17;22131354;4837;362;5804;5835;6.85;0.42;287.77;4.95;967;18;2006.00;31
4840;17;22131368;4840;366;5805;5836;6.84;0.42;287.97;4.95;965;18;2007.00;31
4840;17;22131383;4840;370;5805;5836;6.82;0.41;287.97;4.95;965;18;2008.00;31
4843;17;22131405;4843;373;5806;5837;6.76;0.41;288.07;4.95;963;18;2009.00;31
4844;17;22131430;4844;375;5806;5837;6.83;0.41;288.13;4.95;962;18;2010.00;31
4846;17;22131443;4846;369;5806;5837;6.82;0.41;288.21;4.95;960;18;2011.00;31
4849;17;22131470;4849;370;5806;5837;6.80;0.41;288.26;4.95;957;18;2012.00;31
4851;17;22131485;4851;372;5806;5837;6.78;0.41;288.29;4.95;955;18;2013.00;31
4855;17;22131500;4855;372;5806;5837;6.74;0.41;288.33;4.95;951;18;2014.00;31
4857;17;22131514;4857;364;5806;5837;6.72;0.41;288.38;4.95;949;18;2015.00;31
4858;17;22131529;4858;384;5880;5964;6.79;0.42;288.44;4.89;1022;18;2016.00;84
4859;17;22131555;4859;364;5880;5965;6.80;0.42;288.45;4.89;1021;18;2017.00;85
4860;17;22131571;4860;355;5885;5965;6.99;0.43;288.55;4.89;1025;18;2018.00;80
4861;17;22131586;4861;351;5887;5965;7.09;0.44;288.52;4.89;1026;18;2019.00;78
4862;17;22131601;4862;353;5892;5965;7.17;0.44;288.56;4.89;1030;18;2020.00;73
4863;17;22131622;4863;343;5894;5965;7.23;0.44;288.57;4.89;1031;18;2021.00;71
4864;17;22131638;4864;347;5897;5965;7.31;0.45;288.57;4.89;1033;18;2022.00;68
4864;17;22131654;4864;347;5899;5965;7.35;0.45;288.57;4.89;1035;18;2023.00;66
4866;17;22131677;4866;346;5901;5966;7.35;0.45;288.63;4.89;1035;18;2024.00;65
4867;17;22131692;4867;341;5907;5968;7.34;0.45;288.69;4.89;1040;18;2025.00;61
4869;17;22131707;4869;339;5909;5968;7.31;0.45;288.71;4.89;1040;18;2026.00;59
4875;17;22131723;4875;336;5911;5969;7.18;0.44;288.98;4.89;1036;18;2027.00;58
4879;17;22131746;4879;335;5913;5969;7.11;0.44;289.20;4.90;1034;18;2028.00;56
4881;17;22131761;4881;332;5914;5969;7.06;0.43;289.26;4.90;1033;18;2029.00;55
4886;17;22131780;4886;329;5916;5969;6.96;0.43;289.60;4.90;1030;18;2030.00;53
4892;17;22131794;4892;325;5922;5973;6.85;0.42;289.72;4.93;1030;18;2031.00;51
4894;17;22131810;4894;323;5922;5973;6.82;0.42;289.75;4.93;1028;18;2032.00;51
4897;17;22131824;4897;320;5927;5973;6.76;0.41;289.87;4.96;1030;18;2033.00;46
4900;17;22131839;4900;324;5928;5976;6.83;0.42;289.98;4.96;1028;18;2034.00;48
4903;17;22131855;4903;320;5929;5976;6.88;0.42;290.04;4.96;1026;18;2035.00;47
4905;17;22131871;4905;318;5930;5976;6.94;0.42;290.15;4.97;1025;18;2036.00;46
4908;17;22131886;4908;316;5933;5980;7.00;0.43;290.31;4.97;1025;18;2037.00;47
4908;17;22131905;4908;316;5934;5981;7.07;0.43;290.31;4.97;1026;18;2038.00;47
4912;17;22131923;4912;311;5935;5981;7.12;0.43;290.30;4.97;1023;18;2039.00;46
4915;17;22131941;4915;316;5940;5986;7.21;0.44;290.37;4.97;1025;18;2040.00;46
4918;17;22131958;4918;316;5940;5986;7.25;0.44;290.46;4.97;1022;18;2041.00;46
4920;17;22131980;4920;313;5941;5986;7.29;0.44;290.48;4.97;1021;18;2042.00;45
4922;17;22131995;4922;310;5942;5987;7.33;0.44;290.55;4.97;1020;18;2043.00;45
4925;17;22132011;4925;305;5942;5987;7.31;0.44;290.54;4.97;1017;18;2044.00;45
4926;17;22132026;4926;304;5946;5993;7.33;0.44;290.65;4.96;1020;18;2045.00;47
4932;17;22132045;4932;304;5946;5993;7.25;0.44;290.63;4.96;1014;18;2046.00;47
4937;17;22132067;4937;300;5946;5994;7.17;0.43;290.71;4.96;1009;18;2047.00;48
4939;17;22132088;4939;299;5946;5994;7.09;0.43;290.82;4.96;1007;18;2048.00;48
4942;17;22132106;4942;300;5946;5994;7.02;0.43;290.72;4.96;1004;18;2049.00;48
4944;17;22132122;4944;304;5946;5994;6.99;0.42;290.65;4.96;1002;18;2050.00;48
4944;17;22132140;4944;308;5950;5994;6.91;0.42;290.65;5.01;1006;18;2051.00;44
4947;17;22132156;4947;310;5960;6006;6.98;0.42;290.71;5.00;1013;18;2052.00;46
4947;17;22132172;4947;317;5962;6006;6.93;0.42;290.71;5.00;1015;18;2053.00;44
4953;17;22132187;4953;325;5963;6006;6.84;0.42;290.83;5.00;1010;18;2054.00;43
4957;17;22132202;4957;334;5966;6006;6.78;0.41;290.88;5.05;1009;18;2055.00;40
4957;17;22132218;4957;338;5966;6006;6.83;0.41;290.88;5.05;1009;18;2056.00;40
4961;17;22132234;4961;346;5966;6006;6.80;0.41;290.93;5.05;1005;18;2057.00;40
4962;17;22132250;4962;349;5972;6010;6.76;0.41;291.02;5.09;1010;18;2058.00;38
4963;18;22132268;4963;352;5972;6010;6.73;0.41;291.03;5.09;1009;19;2059.00;38
4966;18;22132297;4966;361;5978;6014;6.69;0.41;291.24;5.13;1012;19;2060.00;36
4968;18;22132313;4968;370;5979;6015;6.67;0.40;291.23;5.13;1011;19;2061.00;36
4972;18;22132331;4972;379;5981;6015;6.60;0.40;291.26;5.17;1009;19;2062.00;34
4974;18;22132350;4974;379;5981;6015;6.59;0.40;291.38;5.17;1007;19;2063.00;34
4977;18;22132369;4977;386;5994;6028;6.52;0.40;291.35;5.19;1017;19;2064.00;34
4979;18;22132389;4979;387;5995;6028;6.49;0.39;291.31;5.21;1016;19;2065.00;33
4980;18;22132406;4980;396;5996;6028;6.54;0.40;291.29;5.22;1016;19;2066.00;32
4982;18;22132423;4982;392;5998;6029;6.53;0.40;291.26;5.24;1016;19;2067.00;31
4985;18;22132439;4985;394;5999;6030;6.52;0.40;291.25;5.25;1014;19;2068.00;31
4986;18;22132454;4986;401;6000;6030;6.53;0.40;291.24;5.27;1014;19;2069.00;30
4988;18;22132470;4988;394;6004;6036;6.53;0.40;291.33;5.27;1016;19;2070.00;32
4989;18;22132485;4989;398;6004;6036;6.49;0.40;291.37;5.27;1015;19;2071.00;32
4992;18;22132499;4992;399;6007;6036;6.42;0.39;291.41;5.29;1015;19;2072.00;29
4992;18;22132513;4992;397;6007;6036;6.38;0.39;291.41;5.29;1015;19;2073.00;29
4995;18;22132526;4995;402;6013;6042;6.33;0.39;291.54;5.29;1018;19;2074.00;29
4997;18;22132541;4997;396;6014;6042;6.22;0.38;291.57;5.31;1017;19;2075.00;28
4997;18;22132555;4997;396;6015;6042;6.12;0.37;291.57;5.33;1018;19;2076.00;27
4999;18;22132569;4999;402;6015;6042;6.04;0.37;291.59;5.33;1016;19;2077.00;27
5001;18;22132582;5001;401;6021;6046;5.98;0.37;291.77;5.39;1020;19;2078.00;25
5005;18;22132596;5005;404;6022;6047;5.96;0.36;291.77;5.39;1017;19;2079.00;25
5006;18;22132614;5006;407;6022;6047;5.99;0.37;291.74;5.39;1016;19;2080.00;25
5009;18;22132626;5009;410;6024;6048;5.96;0.36;291.73;5.41;1015;19;2081.00;24
5012;18;22132641;5012;411;6024;6048;5.96;0.36;291.80;5.41;1012;19;2082.00;24
5015;18;22132655;5015;410;6024;6048;5.95;0.36;291.72;5.41;1009;19;2083.00;24
5018;18;22132669;5018;410;6027;6048;5.96;0.36;291.60;5.46;1009;19;2084.00;21
5021;18;22132682;5021;412;6027;6048;5.97;0.36;291.62;5.46;1006;19;2085.00;21
5023;18;22132696;5023;418;6028;6048;5.97;0.36;291.62;5.48;1005;19;2086.00;20
5025;18;22132707;5025;411;6028;6048;5.95;0.36;291.59;5.48;1003;19;2087.00;20
5027;18;22132720;5027;423;6071;6118;6.13;0.38;291.57;5.49;1044;19;2088.00;47
5028;18;22132740;5028;428;6071;6119;6.08;0.37;291.54;5.49;1043;19;2089.00;48
5031;18;22132756;5031;425;6079;6119;6.05;0.37;291.45;5.48;1048;19;2090.00;40
5037;18;22132771;5037;424;6086;6119;5.99;0.37;291.39;5.49;1049;19;2091.00;33
5040;18;22132788;5040;425;6089;6119;5.89;0.36;291.29;5.49;1049;19;2092.00;30
5042;18;22132801;5042;433;6093;6119;5.73;0.35;291.22;5.50;1051;19;2093.00;26
5045;18;22132818;5045;433;6095;6119;5.60;0.34;291.14;5.50;1050;19;2094.00;24
5047;18;22132834;5047;442;6098;6119;5.48;0.33;291.15;5.51;1051;19;2095.00;21
5050;18;22132850;5050;445;6103;6120;5.30;0.32;291.19;5.54;1053;19;2096.00;17
5055;18;22132868;5055;454;6104;6121;5.16;0.31;291.07;5.54;1049;19;2097.00;17
5058;18;22132882;5058;463;6104;6121;5.04;0.31;291.03;5.54;1046;19;2098.00;17
5060;18;22132896;5060;474;6108;6125;4.88;0.30;291.05;5.55;1048;19;2099.00;17
5065;18;22132912;5065;471;6112;6140;4.69;0.29;290.96;5.55;1047;19;2100.00;28
5066;18;22132933;5066;473;6112;6140;4.65;0.28;290.99;5.55;1046;19;2101.00;28
5070;18;22132946;5070;474;6117;6140;4.60;0.28;290.90;5.58;1047;19;2102.00;23
5072;18;22132957;5072;476;6120;6146;4.62;0.28;290.81;5.58;1048;19;2103.00;26
5074;18;22132971;5074;485;6120;6146;4.58;0.28;290.78;5.58;1046;19;2104.00;26
5077;18;22132984;5077;495;6123;6146;4.52;0.28;290.78;5.59;1046;19;2105.00;23
5077;18;22132997;5077;510;6126;6149;4.55;0.28;290.78;5.59;1049;19;2106.00;23
5079;18;22133011;5079;499;6126;6149;4.56;0.28;290.83;5.59;1047;19;2107.00;23
5084;18;22133022;5084;487;6127;6149;4.57;0.28;290.92;5.59;1043;19;2108.00;22
5084;18;22133037;5084;480;6127;6150;4.64;0.28;290.92;5.59;1043;19;2109.00;23
5086;18;22133050;5086;472;6129;6151;4.70;0.29;290.97;5.59;1043;19;2110.00;22
5092;18;22133063;5092;468;6129;6151;4.74;0.29;291.05;5.59;1037;19;2111.00;22
5095;18;22133076;5095;455;6140;6164;4.87;0.30;290.99;5.58;1045;19;2112.00;24
5099;18;22133090;5099;450;6140;6164;4.96;0.30;291.01;5.58;1041;19;2113.00;24
5101;18;22133105;5101;447;6140;6164;5.08;0.31;290.96;5.58;1039;19;2114.00;24
5104;18;22133119;5104;449;6142;6166;5.16;0.31;290.95;5.58;1038;19;2115.00;24
5106;18;22133133;5106;443;6143;6166;5.26;0.32;290.99;5.58;1037;19;2116.00;23
5109;18;22133148;5109;444;6146;6170;5.33;0.32;291.07;5.58;1037;19;2117.00;24
5112;18;22133175;5112;443;6147;6170;5.35;0.33;291.00;5.58;1035;19;2118.00;23
5114;18;22133195;5114;449;6150;6174;5.46;0.33;290.99;5.58;1036;19;2119.00;24
5115;18;22133213;5115;446;6150;6174;5.51;0.34;291.01;5.58;1035;19;2120.00;24
5118;18;22133227;5118;446;6150;6174;5.55;0.34;291.04;5.58;1032;19;2121.00;24
5121;18;22133241;5121;447;6151;6174;5.56;0.34;291.19;5.58;1030;19;2122.00;23
5123;18;22133258;5123;444;6151;6174;5.57;0.34;291.19;5.58;1028;19;2123.00;23
5127;18;22133273;5127;446;6162;6186;5.64;0.34;291.20;5.58;1035;19;2124.00;24
5130;18;22133291;5130;445;6163;6186;5.72;0.35;291.22;5.58;1033;19;2125.00;23
5132;18;22133307;5132;453;6164;6186;5.79;0.35;291.22;5.58;1032;19;2126.00;22
5135;18;22133321;5135;456;6164;6186;5.80;0.35;291.27;5.58;1029;19;2127.00;22
5136;18;22133337;5136;454;6164;6186;5.85;0.36;291.30;5.58;1028;19;2128.00;22
5138;18;22133352;5138;451;6164;6186;5.87;0.36;291.30;5.58;1026;19;2129.00;22
5142;18;22133368;5142;453;6166;6187;5.83;0.35;291.39;5.58;1024;19;2130.00;21
5144;18;22133383;5144;439;6166;6187;5.84;0.35;291.39;5.58;1022;19;2131.00;21
5149;18;22133398;5149;434;6172;6193;5.84;0.35;291.49;5.58;1023;19;2132.00;21
5153;18;22133413;5153;433;6173;6194;5.84;0.35;291.53;5.58;1020;19;2133.00;21
5156;18;22133428;5156;429;6173;6194;5.81;0.35;291.43;5.58;1017;19;2134.00;21
5161;18;22133441;5161;424;6173;6194;5.72;0.35;291.35;5.58;1012;19;2135.00;21
5165;18;22133455;5165;425;6175;6198;5.68;0.35;291.39;5.58;1010;19;2136.00;23
5166;18;22133470;5166;424;6176;6198;5.71;0.35;291.41;5.58;1010;19;2137.00;22
5172;18;22133484;5172;426;6176;6198;5.67;0.35;291.49;5.58;1004;19;2138.00;22
5173;18;22133499;5173;428;6177;6199;5.64;0.34;291.51;5.58;1004;19;2139.00;22
5176;18;22133514;5176;427;6180;6203;5.58;0.34;291.59;5.58;1004;19;2140.00;23
5181;18;22133528;5181;429;6180;6203;5.50;0.34;291.64;5.58;999;19;2141.00;23
5184;18;22133540;5184;434;6182;6206;5.45;0.33;291.63;5.57;998;19;2142.00;24
5187;18;22133555;5187;440;6182;6206;5.39;0.33;291.73;5.57;995;19;2143.00;24
5188;18;22133569;5188;444;6183;6206;5.38;0.33;291.76;5.57;995;19;2144.00;23
5190;18;22133583;5190;448;6183;6206;5.36;0.33;291.83;5.57;993;19;2145.00;23
5192;18;22133598;5192;453;6187;6210;5.39;0.33;291.85;5.57;995;19;2146.00;23
5197;18;22133611;5197;439;6187;6210;5.43;0.33;291.90;5.57;990;19;2147.00;23
5199;18;22133624;5199;427;6187;6210;5.50;0.34;291.90;5.57;988;19;2148.00;23
5203;18;22133640;5203;419;6187;6210;5.56;0.34;291.94;5.57;984;19;2149.00;23
5206;18;22133666;5206;415;6187;6211;5.61;0.34;291.99;5.57;981;19;2150.00;24
5208;18;22133681;5208;408;6188;6212;5.74;0.35;291.99;5.57;980;19;2151.00;24
5212;18;22133698;5212;403;6188;6212;5.82;0.36;292.03;5.57;976;19;2152.00;24
5214;18;22133716;5214;398;6189;6213;5.92;0.36;292.15;5.57;975;19;2153.00;24
5217;18;22133732;5217;395;6189;6213;6.00;0.37;292.17;5.57;972;19;2154.00;24
5220;18;22133746;5220;391;6189;6213;6.01;0.37;292.22;5.57;969;19;2155.00;24
5225;18;22133759;5225;382;6189;6213;6.01;0.37;292.32;5.57;964;19;2156.00;24
5226;18;22133774;5226;368;6189;6213;6.10;0.37;292.31;5.57;963;19;2157.00;24
5228;18;22133789;5228;361;6189;6213;6.21;0.38;292.39;5.57;961;19;2158.00;24
5231;18;22133805;5231;357;6189;6213;6.30;0.38;292.59;5.57;958;19;2159.00;24
5235;18;22133823;5235;403;6311;6443;6.46;0.41;292.59;5.46;1076;19;2160.00;132
5237;18;22133868;5237;401;6316;6444;6.53;0.41;292.72;5.46;1079;19;2161.00;128
5243;18;22133886;5243;381;6325;6444;6.62;0.41;292.84;5.45;1082;19;2162.00;119
5243;18;22133907;5243;377;6329;6444;6.67;0.42;292.84;5.45;1086;19;2163.00;115
5246;18;22133926;5246;376;6338;6444;6.69;0.42;292.92;5.45;1092;19;2164.00;106
5247;18;22133954;5247;376;6343;6444;6.68;0.42;292.94;5.45;1096;19;2165.00;101
5250;18;22133970;5250;373;6349;6444;6.66;0.41;293.08;5.45;1099;19;2166.00;95
5252;18;22133986;5252;380;6354;6444;6.63;0.41;293.12;5.45;1102;19;2167.00;90
5254;18;22134003;5254;388;6363;6445;6.53;0.41;293.14;5.45;1109;19;2168.00;82
5259;18;22134022;5259;393;6366;6446;6.41;0.40;293.29;5.46;1107;19;2169.00;80
5262;18;22134048;5262;398;6374;6446;6.30;0.39;293.49;5.46;1112;19;2170.00;72
5269;18;22134067;5269;411;6377;6447;6.20;0.38;293.67;5.46;1108;19;2171.00;70
5270;18;22134085;5270;410;6380;6447;6.14;0.38;293.64;5.47;1110;19;2172.00;67
5271;18;22134101;5271;419;6381;6447;6.10;0.38;293.67;5.47;1110;19;2173.00;66
5273;18;22134117;5273;423;6384;6447;5.98;0.37;293.72;5.47;1111;19;2174.00;63
5275;18;22134133;5275;428;6387;6451;5.90;0.36;293.68;5.47;1112;19;2175.00;64
5275;18;22134149;5275;437;6388;6451;5.91;0.36;293.68;5.47;1113;19;2176.00;63
5277;18;22134164;5277;440;6389;6451;5.90;0.36;293.69;5.47;1112;19;2177.00;62
5280;18;22134179;5280;439;6390;6454;5.87;0.36;293.70;5.47;1110;19;2178.00;64
5282;18;22134195;5282;438;6392;6454;5.81;0.36;293.74;5.48;1110;19;2179.00;62
5283;18;22134211;5283;437;6392;6454;5.81;0.36;293.75;5.48;1109;19;2180.00;62
5285;18;22134227;5285;431;6395;6458;5.81;0.36;293.71;5.47;1110;19;2181.00;63
5286;18;22134241;5286;428;6398;6459;5.84;0.36;293.78;5.48;1112;19;2182.00;61
5287;18;22134257;5287;434;6398;6459;5.91;0.36;293.78;5.48;1111;19;2183.00;61
5288;18;22134272;5288;436;6400;6463;5.96;0.37;293.80;5.47;1112;19;2184.00;63
5290;18;22134289;5290;442;6402;6463;5.99;0.37;293.86;5.48;1112;19;2185.00;61
5290;18;22134305;5290;446;6403;6463;6.06;0.37;293.86;5.48;1113;19;2186.00;60
5290;18;22134320;5290;448;6405;6464;6.09;0.37;293.86;5.48;1115;19;2187.00;59
5293;18;22134336;5293;450;6406;6464;6.10;0.37;293.95;5.49;1113;19;2188.00;58
5294;18;22134352;5294;456;6411;6470;6.14;0.38;293.96;5.48;1117;19;2189.00;59
5296;18;22134370;5296;454;6412;6470;6.18;0.38;294.01;5.49;1116;19;2190.00;58
5298;18;22134386;5298;443;6412;6471;6.15;0.38;293.93;5.49;1114;19;2191.00;59
5300;18;22134402;5300;440;6414;6471;6.15;0.37;294.00;5.50;1114;19;2192.00;57
5301;18;22134418;5301;431;6415;6471;6.16;0.38;293.99;5.50;1114;19;2193.00;56
5303;18;22134433;5303;426;6416;6471;6.18;0.38;294.04;5.50;1113;19;2194.00;55
5304;18;22134450;5304;428;6417;6471;6.20;0.38;294.08;5.51;1113;19;2195.00;54
5304;18;22134466;5304;427;6426;6483;6.27;0.38;294.08;5.50;1122;19;2196.00;57
5306;18;22134486;5306;426;6427;6483;6.30;0.38;294.20;5.50;1121;19;2197.00;56
5307;18;22134501;5307;416;6428;6483;6.34;0.39;294.19;5.50;1121;19;2198.00;55
5309;18;22134517;5309;414;6429;6483;6.35;0.39;294.18;5.50;1120;19;2199.00;54
5313;18;22134533;5313;406;6429;6483;6.37;0.39;294.23;5.50;1116;19;2200.00;54
5316;18;22134553;5316;398;6430;6483;6.35;0.39;294.27;5.50;1114;19;2201.00;53
5319;18;22134569;5319;389;6433;6487;6.28;0.38;294.34;5.50;1114;19;2202.00;54
5322;18;22134591;5322;389;6433;6487;6.21;0.38;294.36;5.50;1111;19;2203.00;54
5324;18;22134615;5324;379;6437;6491;6.18;0.38;294.44;5.50;1113;19;2204.00;54
5330;18;22134632;5330;374;6441;6493;6.08;0.37;294.68;5.54;1111;19;2205.00;52
5331;18;22134649;5331;381;6441;6493;6.02;0.37;294.66;5.54;1110;19;2206.00;52
5337;18;22134664;5337;373;6441;6493;5.90;0.36;294.87;5.54;1104;19;2207.00;52
5340;18;22134679;5340;367;6450;6506;5.89;0.36;294.98;5.53;1110;19;2208.00;56
5340;18;22134696;5340;368;6450;6506;5.90;0.36;294.98;5.53;1110;19;2209.00;56
5342;18;22134710;5342;364;6452;6508;5.94;0.36;295.13;5.53;1110;19;2210.00;56
5346;18;22134725;5346;354;6453;6509;5.96;0.36;295.32;5.53;1107;19;2211.00;56
5347;18;22134741;5347;351;6453;6510;6.02;0.37;295.36;5.53;1106;19;2212.00;57
5350;18;22134756;5350;349;6453;6510;6.07;0.37;295.40;5.53;1103;19;2213.00;57
5353;18;22134772;5353;343;6455;6513;6.15;0.38;295.48;5.53;1102;19;2214.00;58
5356;18;22134788;5356;351;6456;6513;6.18;0.38;295.52;5.53;1100;19;2215.00;57
5359;18;22134803;5359;348;6456;6513;6.24;0.38;295.60;5.53;1097;19;2216.00;57
5363;18;22134818;5363;351;6456;6513;6.30;0.38;295.70;5.53;1093;19;2217.00;57
5365;18;22134833;5365;344;6461;6519;6.40;0.39;295.74;5.53;1096;19;2218.00;58
5368;18;22134851;5368;348;6461;6519;6.43;0.39;295.83;5.53;1093;19;2219.00;58
5371;18;22134874;5371;352;6461;6519;6.43;0.39;295.91;5.53;1090;19;2220.00;58
5372;18;22134890;5372;352;6462;6519;6.42;0.39;295.90;5.54;1090;19;2221.00;57
5376;18;22134905;5376;352;6465;6523;6.38;0.39;296.04;5.53;1089;19;2222.00;58
5379;18;22134921;5379;353;6466;6524;6.32;0.38;295.99;5.53;1087;19;2223.00;58
5381;18;22134939;5381;350;6467;6524;6.32;0.38;295.95;5.54;1086;19;2224.00;57
5385;18;22134954;5385;354;6468;6525;6.29;0.38;295.92;5.54;1083;19;2225.00;57
5386;18;22134971;5386;354;6469;6525;6.29;0.38;295.92;5.55;1083;19;2226.00;56
5390;18;22134987;5390;357;6469;6525;6.22;0.38;295.98;5.55;1079;19;2227.00;56
5392;18;22135002;5392;349;6470;6525;6.21;0.38;295.98;5.56;1078;19;2228.00;55
5395;18;22135017;5395;356;6471;6525;6.22;0.38;296.03;5.57;1076;19;2229.00;54
5399;18;22135031;5399;362;6473;6525;6.18;0.38;296.06;5.61;1074;19;2230.00;52
5401;18;22135046;5401;363;6473;6525;6.13;0.37;296.02;5.61;1072;19;2231.00;52
5405;18;22135060;5405;369;6508;6595;6.29;0.38;295.99;5.59;1103;19;2232.00;87
5407;18;22135082;5407;371;6513;6596;6.24;0.38;295.97;5.62;1106;19;2233.00;83
5409;18;22135098;5409;367;6522;6596;6.22;0.38;295.96;5.61;1113;19;2234.00;74
5410;18;22135113;5410;376;6527;6596;6.19;0.38;295.92;5.61;1117;19;2235.00;69
5411;18;22135127;5411;377;6532;6596;6.12;0.38;295.88;5.65;1121;19;2236.00;64
5414;18;22135140;5414;385;6534;6596;6.05;0.37;295.82;5.67;1120;19;2237.00;62
5418;18;22135156;5418;394;6537;6596;5.93;0.36;295.76;5.67;1119;19;2238.00;59
5419;18;22135171;5419;396;6542;6596;5.81;0.36;295.74;5.73;1123;19;2239.00;54
5421;18;22135194;5421;398;6545;6597;5.75;0.35;295.70;5.73;1124;19;2240.00;52
5425;18;22135222;5425;406;6547;6598;5.65;0.35;295.55;5.73;1122;19;2241.00;51
5426;18;22135241;5426;416;6551;6598;5.55;0.34;295.51;5.79;1125;19;2242.00;47
5428;18;22135261;5428;424;6555;6602;5.49;0.34;295.42;5.79;1127;19;2243.00;47
5433;18;22135276;5433;424;6557;6602;5.40;0.33;295.25;5.83;1124;19;2244.00;45
5434;18;22135292;5434;434;6558;6602;5.37;0.33;295.23;5.83;1124;19;2245.00;44
5437;18;22135307;5437;442;6558;6602;5.31;0.33;295.14;5.83;1121;19;2246.00;44
5439;18;22135322;5439;451;6566;6608;5.29;0.32;295.09;5.84;1127;19;2247.00;42
5440;18;22135337;5440;452;6566;6608;5.28;0.32;295.04;5.84;1126;19;2248.00;42
5440;18;22135352;5440;452;6569;6608;5.27;0.32;295.04;5.90;1129;19;2249.00;39
5442;18;22135368;5442;453;6574;6614;5.30;0.33;294.98;5.89;1132;19;2250.00;40
5444;18;22135384;5444;453;6575;6614;5.26;0.32;294.94;5.91;1131;19;2251.00;39
5445;18;22135398;5445;454;6576;6614;5.26;0.32;294.92;5.91;1131;19;2252.00;38
5447;18;22135413;5447;454;6579;6615;5.26;0.32;294.86;5.97;1132;19;2253.00;36
5449;18;22135427;5449;455;6580;6616;5.26;0.32;294.81;5.97;1131;19;2254.00;36
5449;18;22135441;5449;459;6581;6616;5.23;0.32;294.81;5.99;1132;19;2255.00;35
5451;18;22135455;5451;462;6593;6629;5.28;0.32;294.76;6.00;1142;19;2256.00;36
5452;18;22135471;5452;463;6594;6629;5.27;0.32;294.71;6.02;1142;19;2257.00;35
5455;18;22135485;5455;463;6596;6629;5.25;0.32;294.59;6.05;1141;19;2258.00;33
5456;18;22135500;5456;470;6597;6630;5.25;0.32;294.62;6.05;1141;19;2259.00;33
5458;18;22135515;5458;472;6597;6630;5.26;0.32;294.54;6.05;1139;19;2260.00;33
5462;18;22135529;5462;476;6603;6634;5.26;0.32;294.59;6.08;1141;19;2261.00;31
5467;18;22135544;5467;476;6603;6634;5.19;0.32;294.59;6.08;1136;19;2262.00;31
5467;18;22135558;5467;482;6607;6638;5.16;0.32;294.59;6.09;1140;19;2263.00;31
5471;18;22135572;5471;490;6607;6638;5.09;0.31;294.61;6.09;1136;19;2264.00;31
5473;18;22135586;5473;481;6607;6638;5.00;0.30;294.57;6.09;1134;19;2265.00;31
5476;18;22135600;5476;477;6607;6638;4.93;0.30;294.58;6.09;1131;19;2266.00;31
5477;18;22135617;5477;481;6607;6638;4.90;0.30;294.55;6.09;1130;19;2267.00;31
5481;18;22135632;5481;481;6616;6650;4.90;0.30;294.50;6.08;1135;19;2268.00;34
5486;18;22135648;5486;478;6616;6650;4.87;0.30;294.39;6.08;1130;19;2269.00;34
5487;18;22135662;5487;486;6616;6650;4.91;0.30;294.37;6.08;1129;19;2270.00;34
5491;18;22135675;5491;485;6616;6650;4.85;0.29;294.29;6.08;1125;19;2271.00;34
5493;18;22135706;5493;488;6616;6650;4.77;0.29;294.27;6.08;1123;19;2272.00;34
5496;18;22135723;5496;495;6616;6650;4.74;0.29;294.23;6.08;1120;19;2273.00;34
5498;18;22135741;5498;496;6616;6651;4.73;0.29;294.21;6.08;1118;19;2274.00;35
5499;18;22135756;5499;480;6618;6651;4.75;0.29;294.24;6.08;1119;19;2275.00;33
5501;18;22135783;5501;473;6623;6657;4.86;0.30;294.30;6.08;1122;19;2276.00;34
5503;18;22135798;5503;465;6624;6658;4.88;0.30;294.29;6.08;1121;19;2277.00;34
5504;18;22135813;5504;453;6624;6658;4.94;0.30;294.31;6.08;1120;19;2278.00;34
5505;18;22135825;5505;445;6624;6658;4.99;0.31;294.33;6.08;1119;19;2279.00;34
5506;18;22135850;5506;441;6628;6663;5.06;0.31;294.36;6.07;1122;19;2280.00;35
5510;18;22135865;5510;434;6628;6663;5.10;0.31;294.36;6.07;1118;19;2281.00;35
5512;18;22135879;5512;422;6628;6663;5.19;0.32;294.42;6.07;1116;19;2282.00;35
5513;18;22135895;5513;415;6629;6664;5.28;0.32;294.45;6.07;1116;19;2283.00;35
5515;18;22135914;5515;409;6632;6668;5.36;0.33;294.43;6.07;1117;19;2284.00;36
5520;18;22135929;5520;397;6632;6668;5.36;0.33;294.61;6.07;1112;19;2285.00;36
5522;18;22135944;5522;388;6634;6671;5.40;0.33;294.52;6.07;1112;19;2286.00;37
5527;18;22135958;5527;390;6634;6671;5.39;0.33;294.57;6.07;1107;19;2287.00;37
5532;18;22135973;5532;380;6634;6671;5.37;0.33;294.58;6.07;1102;19;2288.00;37
5533;18;22135989;5533;381;6634;6671;5.35;0.33;294.68;6.07;1101;19;2289.00;37
5537;18;22136004;5537;382;6637;6675;5.36;0.33;294.74;6.07;1100;19;2290.00;38
5543;18;22136022;5543;377;6637;6675;5.30;0.32;294.80;6.07;1094;19;2291.00;38
5544;18;22136039;5544;377;6637;6675;5.31;0.33;294.84;6.07;1093;19;2292.00;38
5547;18;22136054;5547;372;6638;6675;5.30;0.32;294.90;6.07;1091;19;2293.00;37
5550;18;22136070;5550;368;6638;6676;5.33;0.33;294.99;6.07;1088;19;2294.00;38
5554;18;22136087;5554;366;6639;6678;5.35;0.33;295.07;6.06;1085;19;2295.00;39
5556;18;22136105;5556;367;6640;6678;5.39;0.33;295.07;6.06;1084;19;2296.00;38
5559;18;22136120;5559;366;6642;6679;5.41;0.33;295.02;6.06;1083;19;2297.00;37
5563;18;22136135;5563;368;6642;6679;5.42;0.33;295.13;6.06;1079;19;2298.00;37
5569;18;22136150;5569;363;6642;6679;5.41;0.33;295.12;6.06;1073;19;2299.00;37
5574;18;22136167;5574;362;6642;6679;5.39;0.33;295.28;6.06;1068;19;2300.00;37
5584;18;22136187;5584;359;6642;6679;5.33;0.32;295.30;6.06;1058;19;2301.00;37
5585;18;22136202;5585;358;6642;6679;5.36;0.33;295.32;6.06;1057;19;2302.00;37
5586;18;22136218;5586;355;6642;6679;5.39;0.33;295.34;6.06;1056;19;2303.00;37
5588;18;22136235;5588;367;6707;6806;5.74;0.36;295.38;6.01;1119;19;2304.00;99
5591;18;22136279;5591;365;6710;6807;5.79;0.36;295.39;6.00;1119;19;2305.00;97
5594;18;22136296;5594;363;6717;6807;5.90;0.37;295.40;6.00;1123;19;2306.00;90
5596;18;22136312;5596;359;6719;6807;5.98;0.37;295.39;6.00;1123;19;2307.00;88
5598;18;22136336;5598;356;6724;6807;6.05;0.37;295.38;6.00;1126;19;2308.00;83
5600;18;22136352;5600;356;6728;6807;6.07;0.37;295.35;6.00;1128;19;2309.00;79
5602;18;22136370;5602;359;6730;6807;6.09;0.37;295.35;6.00;1128;19;2310.00;77
5607;18;22136386;5607;364;6733;6807;6.04;0.37;295.49;6.00;1126;19;2311.00;74
5610;18;22136402;5610;367;6736;6808;6.01;0.37;295.61;6.00;1126;19;2312.00;72
5613;18;22136423;5613;371;6738;6809;6.00;0.37;295.74;6.00;1125;19;2313.00;71
5618;18;22136441;5618;374;6741;6809;5.96;0.37;295.86;6.00;1123;19;2314.00;68
5621;18;22136462;5621;372;6741;6810;5.95;0.36;295.91;6.00;1120;19;2315.00;69
5622;18;22136480;5622;378;6743;6810;5.96;0.37;295.91;6.00;1121;19;2316.00;67
5626;18;22136496;5626;385;6744;6810;5.95;0.37;296.16;6.00;1118;19;2317.00;66
5631;18;22136514;5631;388;6746;6810;5.96;0.37;296.32;6.00;1115;19;2318.00;64
5633;18;22136531;5633;388;6751;6814;6.02;0.37;296.50;6.01;1118;19;2319.00;63
5635;18;22136547;5635;389;6754;6814;6.05;0.37;296.54;6.01;1119;19;2320.00;60
5640;18;22136564;5640;395;6756;6814;6.06;0.37;296.73;6.01;1116;19;2321.00;58
5642;18;22136580;5642;382;6757;6817;6.09;0.37;296.67;6.01;1115;19;2322.00;60
5644;18;22136598;5644;378;6760;6817;6.09;0.37;296.74;6.02;1116;19;2323.00;57
5644;18;22136615;5644;378;6761;6817;6.18;0.38;296.74;6.02;1117;19;2324.00;56
5645;18;22136631;5645;373;6764;6821;6.31;0.39;296.85;6.02;1119;19;2325.00;57
5652;18;22136648;5652;374;6766;6822;6.37;0.39;296.96;6.02;1114;19;2326.00;56
5655;18;22136665;5655;376;6768;6822;6.44;0.39;297.06;6.02;1113;19;2327.00;54
5661;18;22136683;5661;378;6769;6826;6.49;0.40;297.15;6.02;1108;19;2328.00;57
5663;18;22136707;5663;383;6770;6826;6.55;0.40;297.25;6.02;1107;19;2329.00;56
5665;18;22136723;5665;382;6770;6826;6.56;0.40;297.28;6.02;1105;19;2330.00;56
5670;18;22136748;5670;378;6773;6827;6.60;0.40;297.32;6.02;1103;20;2331.00;54
5673;18;22136781;5673;369;6774;6827;6.57;0.40;297.47;6.02;1101;20;2332.00;53
5674;18;22136799;5674;366;6779;6833;6.62;0.40;297.48;6.02;1105;20;2333.00;54
5678;18;22136817;5678;369;6779;6833;6.61;0.40;297.49;6.02;1101;20;2334.00;54
5679;18;22136833;5679;369;6780;6834;6.59;0.40;297.59;6.02;1101;20;2335.00;54
5680;18;22136851;5680;372;6780;6834;6.51;0.40;297.62;6.02;1100;20;2336.00;54
5683;18;22136869;5683;371;6781;6834;6.45;0.39;297.55;6.02;1098;20;2337.00;53
5686;18;22136888;5686;382;6781;6834;6.40;0.39;297.59;6.02;1095;20;2338.00;53
5686;18;22136906;5686;387;6782;6834;6.33;0.38;297.59;6.03;1096;20;2339.00;52
5693;18;22136927;5693;395;6806;6870;6.29;0.38;297.65;6.00;1113;20;2340.00;64
5696;18;22136947;5696;395;6808;6870;6.27;0.38;297.63;6.00;1112;20;2341.00;62
5699;18;22136964;5699;402;6812;6870;6.25;0.38;297.67;6.01;1113;20;2342.00;58
5700;18;22136982;5700;398;6812;6870;6.26;0.38;297.71;6.01;1112;20;2343.00;58
5703;18;22137000;5703;396;6813;6870;6.20;0.38;297.83;6.01;1110;20;2344.00;57
5704;18;22137017;5704;389;6814;6870;6.19;0.38;297.85;6.01;1110;20;2345.00;56
5706;18;22137036;5706;390;6818;6874;6.19;0.38;297.86;6.01;1112;20;2346.00;56
5708;18;22137053;5708;391;6818;6874;6.15;0.37;297.95;6.01;1110;20;2347.00;56
5708;18;22137069;5708;385;6823;6878;6.19;0.38;297.95;6.01;1115;20;2348.00;55
5710;18;22137087;5710;389;6824;6879;6.16;0.38;298.07;6.01;1114;20;2349.00;55
5711;18;22137105;5711;396;6825;6879;6.10;0.37;298.02;6.01;1114;20;2350.00;54
5715;18;22137121;5715;395;6825;6879;6.07;0.37;298.10;6.01;1110;20;2351.00;54
5717;18;22137137;5717;405;6834;6892;6.12;0.37;298.11;6.00;1117;20;2352.00;58
5719;18;22137154;5719;414;6836;6892;6.12;0.37;298.19;6.00;1117;20;2353.00;56
5721;18;22137169;5721;411;6836;6892;6.14;0.37;298.23;6.00;1115;20;2354.00;56
5724;18;22137185;5724;413;6837;6893;6.13;0.37;298.33;6.00;1113;20;2355.00;56
5726;18;22137201;5726;413;6837;6894;6.08;0.37;298.37;6.00;1111;20;2356.00;57
5726;18;22137217;5726;417;6837;6894;6.08;0.37;298.37;6.00;1111;20;2357.00;57
5728;18;22137234;5728;423;6839;6897;6.05;0.37;298.43;5.99;1111;20;2358.00;58
5731;18;22137250;5731;429;6839;6897;5.98;0.36;298.52;5.99;1108;20;2359.00;58
5734;18;22137268;5734;434;6840;6897;5.92;0.36;298.59;5.99;1106;20;2360.00;57
5735;18;22137284;5735;446;6840;6897;5.83;0.35;298.71;5.99;1105;20;2361.00;57
5736;18;22137300;5736;450;6845;6903;5.76;0.35;298.76;5.99;1109;20;2362.00;58
5740;18;22137318;5740;457;6845;6903;5.71;0.35;298.93;5.99;1105;20;2363.00;58
5745;18;22137335;5745;459;6845;6903;5.62;0.34;299.14;5.99;1100;20;2364.00;58
5746;18;22137353;5746;459;6845;6903;5.60;0.34;299.15;5.99;1099;20;2365.00;58
5748;18;22137370;5748;464;6848;6907;5.57;0.34;299.36;5.99;1100;20;2366.00;59
5752;18;22137388;5752;463;6849;6908;5.53;0.33;299.42;5.99;1097;20;2367.00;59
5752;18;22137406;5752;455;6849;6908;5.50;0.33;299.42;5.99;1097;20;2368.00;59
5755;18;22137421;5755;452;6850;6909;5.47;0.33;299.55;5.99;1095;20;2369.00;59
5755;18;22137440;5755;454;6850;6909;5.53;0.33;299.55;5.99;1095;20;2370.00;59
5756;18;22137456;5756;457;6850;6909;5.54;0.34;299.56;5.99;1094;20;2371.00;59
5758;18;22137473;5758;454;6850;6909;5.57;0.34;299.58;5.99;1092;20;2372.00;59
5761;18;22137489;5761;451;6850;6909;5.54;0.34;299.61;5.99;1089;20;2373.00;59
5762;18;22137505;5762;450;6850;6909;5.55;0.34;299.62;5.99;1088;20;2374.00;59
5767;18;22137520;5767;452;6850;6909;5.56;0.34;299.66;5.99;1083;20;2375.00;59
5770;18;22137536;5770;461;6883;6979;5.63;0.34;299.71;5.96;1113;20;2376.00;96
5772;18;22137558;5772;454;6883;6980;5.64;0.34;299.75;5.96;1111;20;2377.00;97
5775;18;22137574;5775;456;6888;6980;5.68;0.35;299.82;5.95;1113;20;2378.00;92
5780;18;22137590;5780;449;6889;6980;5.67;0.35;299.85;5.95;1109;20;2379.00;91
5783;18;22137605;5783;450;6892;6980;5.63;0.34;299.95;5.98;1109;20;2380.00;88
5788;18;22137621;5788;450;6895;6980;5.59;0.34;300.02;6.02;1107;20;2381.00;85
5791;18;22137636;5791;442;6897;6980;5.57;0.34;300.02;6.02;1106;20;2382.00;83
5794;18;22137652;5794;435;6901;6980;5.51;0.34;300.04;6.02;1107;20;2383.00;79
5797;18;22137668;5797;437;6901;6981;5.43;0.33;300.15;6.02;1104;20;2384.00;80
5798;18;22137684;5798;442;6905;6983;5.40;0.33;300.11;6.02;1107;20;2385.00;78
5799;18;22137699;5799;440;6909;6983;5.46;0.33;300.15;6.02;1110;20;2386.00;74
5799;18;22137716;5799;439;6914;6987;5.49;0.33;300.15;6.02;1115;20;2387.00;73
5800;18;22137734;5800;440;6916;6987;5.47;0.33;300.12;6.02;1116;20;2388.00;71
5802;18;22137750;5802;442;6919;6987;5.50;0.33;300.19;6.02;1117;20;2389.00;68
5808;18;22137765;5808;443;6919;6987;5.40;0.33;300.17;6.02;1111;20;2390.00;68
5811;18;22137780;5811;442;6923;6993;5.36;0.33;300.08;6.02;1112;20;2391.00;70
5811;18;22137795;5811;431;6923;6993;5.35;0.33;300.08;6.02;1112;20;2392.00;70
5814;18;22137812;5814;433;6923;6993;5.28;0.32;299.97;6.02;1109;20;2393.00;70
5817;18;22137826;5817;430;6925;6996;5.25;0.32;299.97;6.02;1108;20;2394.00;71
5817;18;22137843;5817;435;6925;6996;5.24;0.32;299.97;6.02;1108;20;2395.00;71
5818;18;22137858;5818;433;6926;6996;5.23;0.32;299.96;6.02;1108;20;2396.00;70
5819;18;22137874;5819;434;6926;6997;5.17;0.31;300.04;6.02;1107;20;2397.00;71
5821;18;22137891;5821;436;6928;6998;5.11;0.31;299.99;6.05;1107;20;2398.00;70
5823;18;22137907;5823;436;6928;6998;5.03;0.31;299.90;6.05;1105;20;2399.00;70
5824;18;22137925;5824;440;6950;7057;5.03;0.31;299.86;6.03;1126;20;2400.00;107
5826;18;22137957;5826;431;6955;7057;4.99;0.30;299.95;6.07;1129;20;2401.00;102
5829;18;22137973;5829;438;6959;7057;4.98;0.30;299.86;6.10;1130;20;2402.00;98
5830;18;22137989;5830;434;6961;7058;4.98;0.30;299.82;6.10;1131;20;2403.00;97
5830;18;22138006;5830;441;6964;7058;4.99;0.30;299.82;6.13;1134;20;2404.00;94
5832;18;22138022;5832;440;6967;7062;5.03;0.31;299.77;6.17;1135;20;2405.00;95
5834;18;22138039;5834;448;6972;7062;4.98;0.30;299.68;6.20;1138;20;2406.00;90
5835;18;22138054;5835;451;6976;7066;4.94;0.30;299.66;6.20;1141;20;2407.00;90
5836;18;22138071;5836;457;6976;7066;4.91;0.30;299.63;6.20;1140;20;2408.00;90
5837;18;22138089;5837;462;6978;7066;4.91;0.30;299.74;6.27;1141;20;2409.00;88
5837;18;22138105;5837;470;6979;7066;4.92;0.30;299.74;6.27;1142;20;2410.00;87
5840;18;22138122;5840;474;6981;7066;4.91;0.30;299.75;6.27;1141;20;2411.00;85
5842;18;22138148;5842;474;6989;7078;4.92;0.30;299.71;6.30;1147;20;2412.00;89
5843;18;22138166;5843;474;6989;7078;4.95;0.30;299.73;6.30;1146;20;2413.00;89
5845;18;22138182;5845;478;6991;7078;4.96;0.30;299.68;6.33;1146;20;2414.00;87
5847;18;22138197;5847;479;6991;7078;4.93;0.30;299.65;6.33;1144;20;2415.00;87
5851;18;22138213;5851;486;6993;7078;4.90;0.30;299.61;6.36;1142;20;2416.00;85
5851;18;22138228;5851;494;6995;7078;4.83;0.30;299.61;6.37;1144;20;2417.00;83
5853;18;22138244;5853;492;6997;7079;4.79;0.29;299.58;6.40;1144;20;2418.00;82
5853;18;22138258;5853;493;6997;7079;4.74;0.29;299.58;6.40;1144;20;2419.00;82
5853;18;22138273;5853;498;7003;7085;4.76;0.29;299.58;6.46;1150;20;2420.00;82
5854;18;22138290;5854;501;7005;7086;4.72;0.29;299.53;6.49;1151;20;2421.00;81
5856;18;22138305;5856;503;7007;7086;4.66;0.29;299.44;6.52;1151;20;2422.00;79
5856;18;22138320;5856;499;7010;7086;4.63;0.28;299.44;6.55;1154;20;2423.00;76
5859;18;22138334;5859;484;7015;7090;4.63;0.28;299.35;6.58;1156;20;2424.00;75
5860;18;22138350;5860;478;7015;7090;4.66;0.29;299.34;6.58;1155;20;2425.00;75
5862;18;22138366;5862;471;7019;7090;4.67;0.29;299.29;6.64;1157;20;2426.00;71
5863;18;22138382;5863;468;7021;7091;4.72;0.29;299.27;6.64;1158;20;2427.00;70
5863;18;22138397;5863;458;7024;7095;4.81;0.29;299.27;6.64;1161;20;2428.00;71
5866;18;22138414;5866;453;7028;7095;4.84;0.30;299.19;6.70;1162;20;2429.00;67
5867;18;22138431;5867;451;7033;7101;4.90;0.30;299.16;6.69;1166;20;2430.00;68
5869;18;22138446;5869;453;7033;7101;4.94;0.30;299.13;6.69;1164;20;2431.00;68
5871;18;22138468;5871;453;7036;7101;4.97;0.30;299.11;6.74;1165;20;2432.00;65
5871;18;22138483;5871;449;7037;7101;5.02;0.31;299.11;6.75;1166;20;2433.00;64
5873;18;22138498;5873;453;7041;7105;5.10;0.31;299.12;6.74;1168;20;2434.00;64
5875;18;22138513;5875;454;7043;7105;5.13;0.31;299.24;6.80;1168;20;2435.00;62
5877;18;22138527;5877;458;7043;7105;5.09;0.31;299.23;6.80;1166;20;2436.00;62
5877;18;22138552;5877;449;7045;7105;5.06;0.31;299.23;6.84;1168;20;2437.00;60
5880;18;22138567;5880;449;7045;7106;5.07;0.31;299.19;6.84;1165;20;2438.00;61
5883;18;22138582;5883;455;7047;7107;5.09;0.31;299.19;6.85;1164;20;2439.00;60
5886;18;22138597;5886;462;7049;7107;5.09;0.31;299.19;6.90;1163;20;2440.00;58
5887;18;22138611;5887;466;7050;7108;5.06;0.31;299.17;6.90;1163;20;2441.00;58
5888;18;22138624;5888;469;7050;7108;5.03;0.31;299.15;6.90;1162;20;2442.00;58
5894;18;22138638;5894;474;7052;7108;4.95;0.30;299.26;6.94;1158;20;2443.00;56
5896;18;22138652;5896;474;7052;7108;5.00;0.30;299.24;6.94;1156;20;2444.00;56
5900;18;22138667;5900;483;7055;7108;4.97;0.30;299.16;6.99;1155;20;2445.00;53
5903;18;22138681;5903;476;7055;7108;4.99;0.30;299.06;6.99;1152;20;2446.00;53
5907;18;22138695;5907;479;7057;7108;4.98;0.30;299.21;7.03;1150;20;2447.00;51
5911;18;22138712;5911;488;7116;7235;5.25;0.33;299.27;6.97;1205;20;2448.00;119
5916;18;22138740;5916;477;7119;7236;5.25;0.32;299.29;6.97;1203;20;2449.00;117
5921;18;22138757;5921;461;7126;7236;5.28;0.33;299.38;6.97;1205;20;2450.00;110
5925;18;22138774;5925;452;7133;7236;5.30;0.33;299.43;6.97;1208;20;2451.00;103
5928;18;22138790;5928;441;7139;7236;5.33;0.33;299.69;6.97;1211;20;2452.00;97
5932;18;22138806;5932;436;7140;7236;5.30;0.33;299.81;6.97;1208;20;2453.00;96
5935;18;22138822;5935;431;7143;7236;5.28;0.33;299.91;6.97;1208;20;2454.00;93
5938;18;22138841;5938;434;7146;7236;5.25;0.32;300.06;6.97;1208;20;2455.00;90
5942;18;22138863;5942;434;7149;7237;5.26;0.32;300.20;6.97;1207;20;2456.00;88
5943;18;22138893;5943;428;7152;7238;5.26;0.32;300.23;6.97;1209;20;2457.00;86
5946;18;22138914;5946;426;7154;7238;5.23;0.32;300.38;6.97;1208;20;2458.00;84
5952;18;22138934;5952;422;7157;7239;5.22;0.32;300.61;6.98;1205;20;2459.00;82
5955;18;22138955;5955;426;7158;7239;5.27;0.32;300.67;6.98;1203;20;2460.00;81
5957;18;22138974;5957;428;7159;7239;5.29;0.33;300.82;6.98;1202;20;2461.00;80
5961;18;22138991;5961;424;7160;7239;5.31;0.33;300.94;6.98;1199;20;2462.00;79
5963;18;22139007;5963;426;7163;7243;5.33;0.33;301.07;6.98;1200;20;2463.00;80
5966;18;22139024;5966;424;7164;7243;5.33;0.33;301.16;6.99;1198;20;2464.00;79
5970;18;22139041;5970;426;7165;7243;5.30;0.33;301.25;6.98;1195;20;2465.00;78
5973;18;22139058;5973;424;7166;7246;5.36;0.33;301.28;6.98;1193;20;2466.00;80
5978;18;22139074;5978;420;7167;7246;5.38;0.33;301.45;6.99;1189;20;2467.00;79
5980;18;22139090;5980;429;7167;7246;5.44;0.34;301.58;6.99;1187;20;2468.00;79
5985;18;22139107;5985;424;7172;7250;5.49;0.34;301.56;7.00;1187;20;2469.00;78
5988;18;22139123;5988;422;7173;7251;5.52;0.34;301.58;7.00;1185;20;2470.00;78
5993;18;22139140;5993;418;7175;7251;5.54;0.34;301.62;7.00;1182;20;2471.00;76
5996;18;22139157;5996;424;7178;7255;5.60;0.34;301.66;7.00;1182;20;2472.00;77
6003;18;22139174;6003;424;7179;7255;5.63;0.35;301.87;7.00;1176;20;2473.00;76
6005;18;22139191;6005;426;7181;7255;5.64;0.35;301.88;7.00;1176;20;2474.00;74
6011;18;22139208;6011;428;7183;7257;5.62;0.34;301.92;7.01;1172;20;2475.00;74
6014;18;22139225;6014;428;7183;7257;5.63;0.35;302.07;7.01;1169;20;2476.00;74
6018;18;22139242;6018;427;7188;7263;5.62;0.34;302.07;7.01;1170;20;2477.00;75
6024;18;22139263;6024;427;7189;7263;5.61;0.34;302.19;7.01;1165;20;2478.00;74
6027;18;22139286;6027;424;7191;7264;5.58;0.34;302.35;7.01;1164;20;2479.00;73
6027;18;22139305;6027;419;7192;7264;5.62;0.35;302.35;7.01;1165;20;2480.00;72
6030;18;22139322;6030;407;7193;7264;5.67;0.35;302.49;7.01;1163;20;2481.00;71
6033;18;22139339;6033;410;7193;7264;5.70;0.35;302.60;7.01;1160;20;2482.00;71
6036;18;22139355;6036;415;7193;7264;5.72;0.35;302.58;7.01;1157;20;2483.00;71
6041;18;22139372;6041;409;7198;7276;5.73;0.35;302.59;7.01;1157;20;2484.00;78
6049;18;22139390;6049;406;7199;7276;5.73;0.35;302.82;7.02;1150;20;2485.00;77
6052;18;22139408;6052;409;7201;7276;5.80;0.36;302.93;7.04;1149;20;2486.00;75
6055;18;22139423;6055;415;7201;7276;5.84;0.36;303.05;7.04;1146;20;2487.00;75
6058;18;22139441;6058;416;7202;7276;5.83;0.36;303.03;7.05;1144;20;2488.00;74
6063;18;22139457;6063;417;7202;7276;5.80;0.36;303.19;7.05;1139;20;2489.00;74
6067;18;22139477;6067;421;7206;7280;5.79;0.35;303.33;7.05;1139;20;2490.00;74
6070;18;22139494;6070;430;7207;7280;5.76;0.35;303.38;7.06;1137;20;2491.00;73
6073;18;22139515;6073;427;7212;7284;5.70;0.35;303.60;7.06;1139;20;2492.00;72
6078;18;22139533;6078;429;7212;7285;5.70;0.35;303.80;7.06;1134;20;2493.00;73
6081;18;22139556;6081;438;7215;7285;5.67;0.35;303.98;7.07;1134;20;2494.00;70
6084;18;22139580;6084;443;7215;7285;5.65;0.35;304.11;7.07;1131;20;2495.00;70
6090;18;22139600;6090;452;7223;7298;5.58;0.34;304.45;7.06;1133;20;2496.00;75
6090;18;22139619;6090;443;7225;7298;5.54;0.34;304.45;7.07;1135;20;2497.00;73
6094;18;22139635;6094;433;7225;7298;5.52;0.34;304.66;7.07;1131;20;2498.00;73
6096;18;22139654;6096;437;7225;7299;5.52;0.34;304.68;7.07;1129;20;2499.00;74
6098;18;22139671;6098;432;7227;7300;5.55;0.34;304.81;7.09;1129;20;2500.00;73
6103;18;22139696;6103;437;7228;7300;5.55;0.34;304.90;7.08;1125;20;2501.00;72
6106;18;22139717;6106;437;7229;7303;5.60;0.34;304.90;7.08;1123;20;2502.00;74
6108;18;22139735;6108;438;7235;7303;5.61;0.34;304.95;7.11;1127;20;2503.00;68
6110;18;22139752;6110;442;7235;7303;5.57;0.34;304.99;7.11;1125;20;2504.00;68
6113;18;22139768;6113;449;7236;7303;5.55;0.34;305.05;7.12;1123;20;2505.00;67
6119;18;22139786;6119;441;7242;7309;5.51;0.34;305.15;7.12;1123;20;2506.00;67
6121;18;22139805;6121;442;7242;7309;5.50;0.33;305.17;7.12;1121;20;2507.00;67
6124;18;22139822;6124;447;7242;7309;5.44;0.33;305.28;7.12;1118;20;2508.00;67
6127;18;22139839;6127;449;7242;7309;5.40;0.33;305.27;7.12;1115;20;2509.00;67
6129;18;22139859;6129;457;7246;7313;5.33;0.32;305.31;7.13;1117;20;2510.00;67
6134;18;22139881;6134;459;7247;7314;5.30;0.32;305.34;7.13;1113;20;2511.00;67
6138;18;22139898;6138;455;7248;7314;5.25;0.32;305.50;7.14;1110;20;2512.00;66
6139;18;22139915;6139;453;7249;7315;5.30;0.32;305.55;7.13;1110;20;2513.00;66
6142;18;22139934;6142;468;7249;7315;5.29;0.32;305.60;7.13;1107;20;2514.00;66
6144;18;22139952;6144;476;7250;7315;5.26;0.32;305.67;7.14;1106;20;2515.00;65
6145;18;22139972;6145;482;7250;7315;5.22;0.32;305.78;7.14;1105;20;2516.00;65
6147;18;22140002;6147;482;7251;7315;5.18;0.31;305.83;7.15;1104;20;2517.00;64
6149;18;22140026;6149;474;7251;7315;5.14;0.31;305.95;7.15;1102;20;2518.00;64
6152;18;22140045;6152;473;7252;7315;5.09;0.31;306.09;7.16;1100;20;2519.00;63
6155;18;22140063;6155;504;7316;7440;5.14;0.32;306.28;7.11;1161;20;2520.00;124
6157;18;22140093;6157;491;7318;7441;5.14;0.32;306.32;7.11;1161;20;2521.00;123
6158;18;22140113;6158;477;7326;7441;5.24;0.32;306.33;7.10;1168;20;2522.00;115
6159;18;22140129;6159;468;7329;7441;5.33;0.33;306.33;7.10;1170;20;2523.00;112
6163;18;22140145;6163;462;7335;7441;5.37;0.33;306.50;7.10;1172;20;2524.00;106
6166;18;22140163;6166;464;7337;7441;5.40;0.33;306.45;7.10;1171;20;2525.00;104
6167;18;22140179;6167;466;7342;7441;5.44;0.33;306.45;7.10;1175;20;2526.00;99
6167;18;22140195;6167;482;7346;7441;5.48;0.34;306.45;7.10;1179;20;2527.00;95
6168;18;22140212;6168;485;7351;7442;5.54;0.34;306.47;7.11;1183;20;2528.00;91
6169;18;22140231;6169;492;7356;7443;5.58;0.34;306.48;7.11;1187;20;2529.00;87
6171;18;22140249;6171;486;7359;7443;5.57;0.34;306.45;7.11;1188;20;2530.00;84
6173;18;22140267;6173;490;7364;7447;5.55;0.34;306.49;7.11;1191;20;2531.00;83
6176;18;22140284;6176;499;7366;7447;5.48;0.34;306.59;7.11;1190;20;2532.00;81
6178;18;22140300;6178;503;7368;7447;5.43;0.33;306.73;7.11;1190;20;2533.00;79
6180;18;22140316;6180;511;7370;7447;5.38;0.33;306.78;7.12;1190;20;2534.00;77
6183;18;22140333;6183;520;7373;7453;5.33;0.33;306.80;7.11;1190;20;2535.00;80
6185;18;22140350;6185;520;7373;7453;5.27;0.32;306.81;7.11;1188;20;2536.00;80
6186;18;22140370;6186;526;7374;7455;5.20;0.32;306.84;7.11;1188;20;2537.00;81
6186;18;22140389;6186;527;7377;7458;5.16;0.31;306.84;7.11;1191;20;2538.00;81
6188;18;22140408;6188;534;7378;7458;5.11;0.31;306.86;7.11;1190;20;2539.00;80
6191;18;22140428;6191;539;7379;7458;5.05;0.31;306.85;7.11;1188;20;2540.00;79
6192;18;22140446;6192;533;7379;7459;5.01;0.30;306.84;7.11;1187;20;2541.00;80
6192;18;22140464;6192;530;7380;7460;5.03;0.31;306.84;7.11;1188;20;2542.00;80
6193;18;22140480;6193;528;7380;7460;4.99;0.30;306.87;7.11;1187;20;2543.00;80
6195;18;22140496;6195;524;7387;7473;5.03;0.31;306.85;7.10;1192;20;2544.00;86
6198;18;22140514;6198;526;7387;7473;5.06;0.31;306.85;7.10;1189;20;2545.00;86
6199;18;22140530;6199;522;7388;7473;5.10;0.31;306.82;7.10;1189;20;2546.00;85
6200;18;22140550;6200;523;7389;7474;5.16;0.32;306.83;7.10;1189;20;2547.00;85
6203;18;22140568;6203;518;7389;7474;5.22;0.32;306.90;7.10;1186;20;2548.00;85
6203;18;22140586;6203;511;7392;7478;5.34;0.33;306.90;7.10;1189;20;2549.00;86
6207;18;22140606;6207;516;7394;7481;5.29;0.32;306.91;7.10;1187;20;2550.00;87
6211;18;22140627;6211;519;7398;7485;5.22;0.32;306.97;7.09;1187;20;2551.00;87
6212;18;22140647;6212;518;7398;7485;5.15;0.31;306.99;7.09;1186;20;2552.00;87
6215;18;22140662;6215;527;7398;7485;5.03;0.31;306.92;7.09;1183;20;2553.00;87
6218;18;22140675;6218;526;7398;7485;4.89;0.30;306.84;7.09;1180;20;2554.00;87
6219;18;22140693;6219;530;7400;7485;4.80;0.29;306.81;7.16;1181;20;2555.00;85
6225;18;22140709;6225;522;7408;7497;4.75;0.29;306.82;7.15;1183;20;2556.00;89
6227;18;22140727;6227;522;7409;7497;4.71;0.29;306.83;7.15;1182;20;2557.00;88
6228;18;22140741;6228;517;7412;7497;4.73;0.29;306.78;7.16;1184;20;2558.00;85
6230;18;22140756;6230;508;7412;7497;4.74;0.29;306.83;7.16;1182;20;2559.00;85
6233;18;22140773;6233;503;7412;7497;4.74;0.29;306.76;7.16;1179;20;2560.00;85
6234;18;22140789;6234;499;7412;7497;4.82;0.30;306.77;7.16;1178;20;2561.00;85
6236;18;22140803;6236;501;7412;7498;4.89;0.30;306.71;7.16;1176;20;2562.00;86
6236;18;22140819;6236;503;7412;7498;4.96;0.30;306.71;7.16;1176;20;2563.00;86
6237;18;22140834;6237;499;7416;7504;5.05;0.31;306.69;7.16;1179;20;2564.00;88
6238;18;22140850;6238;492;7418;7506;5.03;0.31;306.66;7.16;1180;20;2565.00;88
6241;18;22140866;6241;491;7418;7506;4.99;0.30;306.56;7.16;1177;20;2566.00;88
6244;18;22140882;6244;487;7418;7506;4.96;0.30;306.51;7.16;1174;20;2567.00;88
6244;18;22140899;6244;492;7420;7510;5.00;0.31;306.51;7.15;1176;20;2568.00;90
6246;18;22140914;6246;491;7420;7510;4.99;0.30;306.44;7.15;1174;20;2569.00;90
6247;18;22140931;6247;492;7420;7510;4.94;0.30;306.40;7.15;1173;20;2570.00;90
6248;18;22140948;6248;488;7421;7511;4.95;0.30;306.41;7.15;1173;20;2571.00;90
6248;18;22140964;6248;493;7425;7515;4.98;0.30;306.41;7.15;1177;20;2572.00;90
6249;18;22140978;6249;500;7427;7515;4.98;0.30;306.37;7.17;1178;20;2573.00;88
6250;18;22140994;6250;500;7430;7518;5.00;0.31;306.32;7.16;1180;20;2574.00;88
6251;18;22141012;6251;504;7431;7518;5.00;0.31;306.28;7.16;1180;20;2575.00;87
6252;18;22141027;6252;512;7433;7518;4.99;0.31;306.35;7.17;1181;20;2576.00;85
6256;18;22141041;6256;520;7433;7518;4.89;0.30;306.24;7.17;1177;20;2577.00;85
6257;18;22141057;6257;524;7438;7522;4.86;0.30;306.26;7.17;1181;20;2578.00;84
6257;18;22141075;6257;518;7438;7522;4.80;0.29;306.26;7.17;1181;20;2579.00;84
6257;18;22141097;6257;510;7439;7522;4.78;0.29;306.26;7.20;1182;20;2580.00;83
6260;18;22141114;6260;507;7440;7522;4.71;0.29;306.32;7.24;1180;20;2581.00;82
6262;18;22141129;6262;502;7440;7523;4.72;0.29;306.35;7.24;1178;20;2582.00;83
6264;18;22141144;6264;494;7442;7524;4.76;0.29;306.36;7.28;1178;20;2583.00;82
6266;18;22141160;6266;495;7442;7524;4.78;0.29;306.37;7.28;1176;20;2584.00;82
6268;18;22141174;6268;491;7444;7525;4.83;0.30;306.32;7.31;1176;20;2585.00;81
6270;18;22141199;6270;482;7444;7525;4.84;0.30;306.29;7.31;1174;20;2586.00;81
6272;18;22141220;6272;481;7444;7525;4.86;0.30;306.28;7.31;1172;20;2587.00;81
6277;18;22141239;6277;477;7445;7525;4.87;0.30;306.24;7.35;1168;20;2588.00;80
6278;18;22141256;6278;475;7445;7525;4.89;0.30;306.24;7.35;1167;20;2589.00;80
6278;18;22141275;6278;467;7446;7525;4.92;0.30;306.24;7.39;1168;20;2590.00;79
6280;18;22141306;6280;469;7446;7525;4.93;0.30;306.22;7.39;1166;20;2591.00;79
6283;18;22141322;6283;477;7502;7652;5.29;0.33;306.12;7.37;1219;20;2592.00;150
6283;18;22141355;6283;479;7504;7653;5.30;0.33;306.12;7.36;1221;20;2593.00;149
6285;18;22141372;6285;475;7515;7653;5.38;0.33;306.11;7.39;1230;20;2594.00;138
6286;18;22141392;6286;474;7521;7653;5.39;0.33;306.08;7.39;1235;20;2595.00;132
6289;18;22141416;6289;477;7530;7653;5.41;0.34;306.03;7.45;1241;20;2596.00;123
6290;18;22141436;6290;480;7535;7653;5.41;0.34;306.02;7.48;1245;20;2597.00;118
6290;18;22141453;6290;482;7538;7653;5.38;0.33;306.02;7.52;1248;20;2598.00;115
6291;18;22141482;6291;478;7540;7653;5.34;0.33;306.00;7.52;1249;20;2599.00;113
6292;18;22141508;6292;479;7545;7654;5.32;0.33;305.98;7.58;1253;20;2600.00;109
6296;18;22141538;6296;475;7550;7655;5.26;0.32;305.85;7.62;1254;20;2601.00;105
6299;18;22141562;6299;479;7553;7655;5.23;0.32;305.80;7.65;1254;20;2602.00;102
6302;18;22141594;6302;478;7556;7656;5.20;0.32;305.72;7.65;1254;20;2603.00;100
6303;18;22141622;6303;481;7559;7656;5.16;0.32;305.83;7.71;1256;20;2604.00;97
6306;18;22141649;6306;472;7560;7656;5.14;0.32;305.84;7.71;1254;20;2605.00;96
6309;18;22141672;6309;477;7562;7656;5.14;0.32;305.82;7.72;1253;20;2606.00;94
6309;18;22141702;6309;477;7568;7660;5.17;0.32;305.82;7.77;1259;20;2607.00;92
6312;18;22141733;6312;481;7571;7660;5.19;0.32;305.77;7.83;1259;20;2608.00;89
6313;18;22141761;6313;475;7571;7660;5.20;0.32;305.80;7.83;1258;20;2609.00;89
6315;18;22141787;6315;473;7578;7666;5.25;0.32;305.76;7.89;1263;20;2610.00;88
6319;18;22141806;6319;473;7578;7666;5.26;0.32;305.80;7.89;1259;20;2611.00;88
6320;18;22141822;6320;479;7579;7666;5.30;0.33;305.84;7.89;1259;20;2612.00;87
6320;18;22141839;6320;473;7585;7670;5.30;0.33;305.84;7.95;1265;20;2613.00;85
6324;18;22141856;6324;477;7586;7671;5.27;0.32;305.94;7.94;1262;20;2614.00;85
6328;18;22141873;6328;474;7590;7671;5.23;0.32;305.99;8.00;1262;20;2615.00;81
6328;18;22141891;6328;480;7593;7675;5.26;0.32;305.99;8.00;1265;20;2616.00;82
6332;18;22141907;6332;482;7593;7675;5.23;0.32;306.04;8.00;1261;20;2617.00;82
6336;18;22141923;6336;475;7593;7675;5.23;0.32;306.16;8.00;1257;21;2618.00;82
6339;18;22141947;6339;473;7594;7676;5.21;0.32;306.09;8.00;1255;21;2619.00;82
6343;18;22141963;6343;471;7594;7676;5.18;0.32;306.14;8.00;1251;21;2620.00;82
6347;18;22141979;6347;465;7600;7682;5.11;0.31;306.25;8.00;1253;21;2621.00;82
6352;18;22141996;6352;473;7604;7682;5.00;0.31;306.40;8.10;1252;21;2622.00;78
6359;18;22142012;6359;474;7604;7683;4.91;0.30;306.47;8.10;1245;21;2623.00;79
6363;18;22142028;6363;476;7604;7683;4.89;0.30;306.42;8.10;1241;21;2624.00;79
6366;18;22142043;6366;451;7606;7683;4.89;0.30;306.47;8.13;1240;21;2625.00;77
6370;18;22142060;6370;441;7606;7683;4.89;0.30;306.52;8.13;1236;21;2626.00;77
6373;18;22142077;6373;429;7606;7683;4.92;0.30;306.56;8.13;1233;21;2627.00;77
6376;18;22142098;6376;436;7613;7695;5.00;0.31;306.66;8.12;1237;21;2628.00;82
6380;18;22142119;6380;432;7613;7695;5.04;0.31;306.68;8.12;1233;21;2629.00;82
6383;18;22142137;6383;430;7613;7695;5.09;0.31;306.64;8.12;1230;21;2630.00;82
6387;18;22142153;6387;431;7613;7695;5.14;0.31;306.80;8.12;1226;21;2631.00;82
6392;18;22142170;6392;416;7613;7695;5.21;0.32;307.03;8.12;1221;21;2632.00;82
6394;18;22142187;6394;410;7613;7695;5.29;0.32;307.05;8.12;1219;21;2633.00;82
6399;18;22142202;6399;397;7616;7699;5.35;0.33;307.31;8.12;1217;21;2634.00;83
6404;18;22142220;6404;379;7616;7699;5.46;0.33;307.48;8.12;1212;21;2635.00;83
6409;18;22142237;6409;377;7619;7703;5.58;0.34;307.54;8.11;1210;21;2636.00;84
6413;18;22142255;6413;373;7619;7704;5.64;0.35;307.80;8.11;1206;21;2637.00;85
6419;18;22142272;6419;364;7619;7704;5.68;0.35;308.04;8.11;1200;21;2638.00;85
6422;18;22142289;6422;358;7620;7704;5.70;0.35;308.15;8.12;1198;21;2639.00;84
6429;18;22142315;6429;367;7640;7733;5.76;0.35;308.39;8.10;1211;21;2640.00;93
6433;18;22142335;6433;369;7642;7733;5.74;0.35;308.33;8.10;1209;21;2641.00;91
6439;18;22142352;6439;363;7644;7733;5.74;0.35;308.46;8.09;1205;21;2642.00;89
6443;18;22142370;6443;364;7645;7734;5.79;0.35;308.46;8.09;1202;21;2643.00;89
6451;18;22142390;6451;364;7645;7735;5.77;0.35;308.80;8.09;1194;21;2644.00;90
6452;18;22142411;6452;365;7646;7735;5.79;0.35;308.83;8.09;1194;21;2645.00;89
6457;18;22142431;6457;372;7647;7738;5.78;0.35;308.94;8.09;1190;21;2646.00;91
6462;18;22142452;6462;368;7648;7738;5.76;0.35;308.95;8.09;1186;21;2647.00;90
6467;18;22142473;6467;369;7649;7738;5.74;0.35;309.02;8.10;1182;21;2648.00;89
6471;18;22142493;6471;370;7650;7738;5.77;0.35;309.14;8.10;1179;21;2649.00;88
6472;18;22142511;6472;372;7655;7744;5.89;0.36;309.16;8.09;1183;21;2650.00;89
6476;18;22142542;6476;377;7655;7744;5.86;0.36;309.32;8.09;1179;21;2651.00;89
6482;18;22142566;6482;377;7656;7744;5.87;0.36;309.42;8.09;1174;21;2652.00;88
6488;18;22142584;6488;385;7656;7744;5.84;0.35;309.67;8.09;1168;21;2653.00;88
6489;18;22142602;6489;387;7660;7748;5.87;0.36;309.71;8.09;1171;21;2654.00;88
6493;18;22142619;6493;390;7664;7750;5.90;0.36;309.72;8.11;1171;21;2655.00;86
6497;18;22142637;6497;391;7665;7750;5.94;0.36;309.77;8.11;1168;21;2656.00;85
6499;18;22142654;6499;397;7666;7751;5.97;0.36;309.77;8.11;1167;21;2657.00;85
6505;18;22142673;6505;403;7666;7751;5.92;0.36;309.95;8.11;1161;21;2658.00;85
6506;18;22142696;6506;402;7668;7751;5.93;0.36;309.97;8.14;1162;21;2659.00;83
6510;18;22142717;6510;405;7668;7751;5.93;0.36;310.00;8.14;1158;21;2660.00;83
6512;18;22142735;6512;409;7668;7751;5.97;0.36;310.00;8.14;1156;21;2661.00;83
6513;18;22142751;6513;410;7668;7751;6.05;0.37;310.02;8.14;1155;21;2662.00;83
6515;18;22142768;6515;413;7668;7751;6.06;0.37;310.02;8.14;1153;21;2663.00;83
6517;18;22142785;6517;425;7705;7821;6.11;0.37;310.11;8.12;1188;21;2664.00;116
6519;18;22142815;6519;424;7705;7822;6.07;0.37;310.17;8.12;1186;21;2665.00;117
6523;18;22142843;6523;422;7712;7822;6.09;0.37;310.22;8.14;1189;21;2666.00;110
6525;18;22142867;6525;419;7712;7822;6.06;0.37;310.31;8.14;1187;21;2667.00;110
6530;18;22142886;6530;429;7717;7822;6.08;0.37;310.47;8.13;1187;21;2668.00;105
6532;18;22142907;6532;433;7717;7822;6.07;0.37;310.49;8.13;1185;21;2669.00;105
6538;18;22142934;6538;440;7720;7822;6.01;0.37;310.77;8.13;1182;21;2670.00;102
6540;18;22142955;6540;451;7724;7822;5.95;0.36;310.83;8.15;1184;21;2671.00;98
6543;18;22142979;6543;448;7727;7823;5.90;0.36;310.87;8.15;1184;21;2672.00;96
6548;18;22143001;6548;454;7731;7824;5.77;0.35;310.94;8.16;1183;21;2673.00;93
6551;18;22143021;6551;457;7734;7824;5.63;0.34;311.05;8.18;1183;21;2674.00;90
6554;18;22143040;6554;464;7738;7828;5.49;0.33;311.10;8.18;1184;21;2675.00;90
6558;18;22143058;6558;468;7739;7828;5.34;0.33;311.28;8.19;1181;21;2676.00;89
6562;18;22143075;6562;473;7743;7828;5.23;0.32;311.37;8.23;1181;21;2677.00;85
6564;18;22143095;6564;476;7743;7828;5.20;0.32;311.35;8.23;1179;21;2678.00;85
6567;18;22143118;6567;479;7749;7834;5.24;0.32;311.44;8.23;1182;21;2679.00;85
6568;18;22143138;6568;482;7750;7834;5.26;0.32;311.45;8.24;1182;21;2680.00;84
6569;18;22143156;6569;481;7751;7834;5.28;0.32;311.55;8.25;1182;21;2681.00;83
6571;18;22143173;6571;479;7754;7837;5.37;0.33;311.68;8.25;1183;21;2682.00;83
6573;18;22143190;6573;478;7755;7837;5.39;0.33;311.70;8.26;1182;21;2683.00;82
6576;18;22143207;6576;477;7756;7837;5.42;0.33;311.82;8.26;1180;21;2684.00;81
6578;18;22143230;6578;474;7757;7838;5.40;0.33;311.87;8.26;1179;21;2685.00;81
6581;18;22143251;6581;474;7758;7839;5.39;0.33;312.03;8.26;1177;21;2686.00;81
6585;18;22143279;6585;482;7759;7839;5.36;0.33;312.10;8.26;1174;21;2687.00;80
6590;18;22143302;6590;492;7771;7852;5.38;0.33;312.20;8.26;1181;21;2688.00;81
6595;18;22143327;6595;497;7771;7852;5.35;0.33;312.29;8.26;1176;21;2689.00;81
6598;18;22143351;6598;489;7772;7852;5.36;0.33;312.28;8.26;1174;21;2690.00;80
6601;18;22143369;6601;501;7775;7853;5.34;0.32;312.33;8.27;1174;21;2691.00;78
6605;18;22143386;6605;497;7775;7853;5.29;0.32;312.51;8.27;1170;21;2692.00;78
6605;18;22143403;6605;489;7779;7857;5.34;0.33;312.51;8.27;1174;21;2693.00;78
6610;18;22143420;6610;489;7781;7857;5.32;0.32;312.66;8.27;1171;21;2694.00;76
6613;18;22143438;6613;488;7784;7861;5.34;0.33;312.75;8.27;1171;21;2695.00;77
6614;18;22143454;6614;484;7785;7861;5.37;0.33;312.76;8.27;1171;21;2696.00;76
6617;18;22143481;6617;494;7785;7861;5.39;0.33;312.92;8.27;1168;21;2697.00;76
6617;18;22143500;6617;492;7785;7861;5.42;0.33;312.92;8.27;1168;21;2698.00;76
6620;18;22143520;6620;489;7786;7861;5.38;0.33;313.05;8.27;1166;21;2699.00;75
6622;18;22143551;6622;495;7814;7910;5.37;0.33;313.09;8.24;1192;21;2700.00;96
6623;18;22143586;6623;492;7815;7910;5.31;0.32;313.12;8.25;1192;21;2701.00;95
6624;18;22143606;6624;494;7818;7910;5.31;0.32;313.09;8.24;1194;21;2702.00;92
6629;18;22143622;6629;501;7818;7910;5.22;0.32;313.10;8.24;1189;21;2703.00;92
6631;18;22143639;6631;511;7821;7910;5.21;0.32;313.18;8.24;1190;21;2704.00;89
6632;18;22143661;6632;515;7821;7910;5.19;0.32;313.23;8.24;1189;21;2705.00;89
6634;18;22143677;6634;515;7822;7911;5.15;0.31;313.28;8.24;1188;21;2706.00;89
6636;18;22143692;6636;521;7822;7911;5.14;0.31;313.26;8.24;1186;21;2707.00;89
6640;18;22143708;6640;527;7827;7917;5.15;0.31;313.30;8.24;1187;21;2708.00;90
6642;18;22143724;6642;536;7828;7918;5.14;0.31;313.26;8.24;1186;21;2709.00;90
6644;18;22143740;6644;543;7828;7918;5.10;0.31;313.26;8.24;1184;21;2710.00;90
6646;18;22143756;6646;546;7828;7918;5.04;0.31;313.20;8.24;1182;21;2711.00;90
6647;18;22143772;6647;551;7832;7922;5.02;0.31;313.17;8.23;1185;21;2712.00;90
6647;18;22143788;6647;559;7833;7922;4.93;0.30;313.17;8.23;1186;21;2713.00;89
6649;18;22143804;6649;559;7833;7922;4.88;0.30;313.09;8.23;1184;21;2714.00;89
6650;18;22143819;6650;560;7834;7923;4.88;0.30;313.14;8.23;1184;21;2715.00;89
6653;18;22143835;6653;558;7837;7927;4.86;0.30;313.02;8.23;1184;21;2716.00;90
6657;18;22143851;6657;560;7837;7927;4.83;0.30;312.92;8.23;1180;21;2717.00;90
6660;18;22143870;6660;552;7840;7930;4.89;0.30;312.90;8.23;1180;21;2718.00;90
6663;18;22143886;6663;550;7841;7930;4.87;0.30;312.94;8.23;1178;21;2719.00;89
6667;18;22143904;6667;550;7842;7930;4.90;0.30;312.88;8.23;1175;21;2720.00;88
6669;18;22143921;6669;546;7842;7930;4.93;0.30;312.85;8.23;1173;21;2721.00;88
6672;18;22143937;6672;548;7845;7934;4.96;0.30;312.83;8.23;1173;21;2722.00;89
6675;18;22143953;6675;546;7846;7934;4.96;0.30;312.79;8.23;1171;21;2723.00;88
6678;18;22143969;6678;546;7846;7934;5.00;0.30;312.83;8.23;1168;21;2724.00;88
6680;18;22143990;6680;542;7847;7934;5.01;0.31;312.80;8.23;1167;21;2725.00;87
6685;18;22144017;6685;538;7847;7935;4.99;0.30;312.74;8.23;1162;21;2726.00;88
6687;18;22144041;6687;541;7848;7936;5.01;0.30;312.71;8.23;1161;21;2727.00;88
6691;18;22144070;6691;535;7848;7936;4.97;0.30;312.68;8.23;1157;21;2728.00;88
6693;18;22144090;6693;530;7851;7937;4.94;0.30;312.66;8.27;1158;21;2729.00;86
6693;18;22144115;6693;527;7852;7937;4.91;0.30;312.66;8.31;1159;21;2730.00;85
6695;18;22144130;6695;524;7855;7937;4.89;0.30;312.72;8.31;1160;21;2731.00;82
6696;18;22144145;6696;517;7855;7937;4.87;0.30;312.69;8.31;1159;21;2732.00;82
6699;18;22144158;6699;515;7855;7937;4.86;0.30;312.68;8.31;1156;21;2733.00;82
6699;18;22144175;6699;517;7855;7937;4.91;0.30;312.68;8.31;1156;21;2734.00;82
6700;18;22144190;6700;520;7855;7937;4.96;0.30;312.65;8.31;1155;21;2735.00;82
6703;18;22144213;6703;518;7917;8064;5.19;0.32;312.71;8.25;1214;21;2736.00;147
6704;18;22144239;6704;505;7920;8065;5.23;0.32;312.71;8.25;1216;21;2737.00;145
6705;18;22144255;6705;485;7928;8065;5.34;0.33;312.69;8.24;1223;21;2738.00;137
6707;18;22144271;6707;483;7933;8065;5.42;0.33;312.67;8.24;1226;21;2739.00;132
6707;18;22144288;6707;472;7937;8065;5.54;0.34;312.67;8.24;1230;21;2740.00;128
6708;18;22144306;6708;467;7940;8065;5.61;0.34;312.75;8.24;1232;21;2741.00;125
6711;18;22144323;6711;465;7942;8065;5.65;0.34;312.75;8.24;1231;21;2742.00;123
6712;18;22144362;6712;456;7945;8065;5.65;0.34;312.71;8.24;1233;21;2743.00;120
6713;18;22144378;6713;465;7948;8066;5.68;0.35;312.68;8.24;1235;21;2744.00;118
6715;18;22144395;6715;459;7951;8068;5.66;0.34;312.63;8.24;1236;21;2745.00;117
6716;18;22144412;6716;466;7952;8068;5.63;0.34;312.67;8.24;1236;21;2746.00;116
6716;18;22144430;6716;468;7954;8069;5.62;0.34;312.67;8.24;1238;21;2747.00;115
6718;18;22144446;6718;465;7958;8069;5.60;0.34;312.68;8.24;1240;21;2748.00;111
6718;18;22144463;6718;467;7963;8069;5.55;0.34;312.68;8.25;1245;21;2749.00;106
6720;18;22144479;6720;476;7964;8069;5.49;0.34;312.64;8.25;1244;21;2750.00;105
6721;18;22144496;6721;471;7969;8073;5.47;0.33;312.63;8.28;1248;21;2751.00;104
6722;18;22144521;6722;475;7974;8073;5.43;0.33;312.59;8.29;1252;21;2752.00;99
6723;18;22144539;6723;483;7975;8073;5.45;0.33;312.58;8.29;1252;21;2753.00;98
6724;18;22144556;6724;494;7978;8076;5.40;0.33;312.57;8.32;1254;21;2754.00;98
6727;18;22144581;6727;499;7981;8076;5.36;0.33;312.60;8.37;1254;21;2755.00;95
6728;18;22144605;6728;501;7983;8076;5.36;0.33;312.58;8.37;1255;21;2756.00;93
6730;18;22144622;6730;508;7988;8080;5.32;0.32;312.55;8.40;1258;21;2757.00;92
6732;18;22144648;6732;502;7990;8081;5.36;0.33;312.62;8.44;1258;21;2758.00;91
6733;18;22144665;6733;497;7993;8081;5.36;0.33;312.60;8.48;1260;21;2759.00;88
6735;18;22144683;6735;499;7998;8086;5.34;0.32;312.64;8.48;1263;21;2760.00;88
6735;18;22144702;6735;502;7999;8086;5.34;0.32;312.64;8.48;1264;21;2761.00;87
6739;18;22144727;6739;499;8000;8086;5.35;0.33;312.67;8.51;1261;21;2762.00;86
6739;18;22144744;6739;496;8001;8087;5.40;0.33;312.67;8.51;1262;21;2763.00;86
6742;18;22144761;6742;497;8002;8087;5.39;0.33;312.62;8.55;1260;21;2764.00;85
6743;18;22144779;6743;502;8009;8093;5.48;0.33;312.72;8.62;1266;21;2765.00;84
6743;18;22144798;6743;502;8010;8093;5.50;0.33;312.72;8.66;1267;21;2766.00;83
6745;18;22144815;6745;504;8010;8094;5.51;0.33;312.78;8.66;1265;21;2767.00;84
6746;18;22144839;6746;507;8012;8094;5.51;0.34;312.76;8.74;1266;21;2768.00;82
6749;18;22144857;6749;506;8012;8094;5.51;0.33;312.74;8.74;1263;21;2769.00;82
6752;18;22144874;6752;503;8013;8094;5.48;0.33;312.74;8.77;1261;21;2770.00;81
6753;18;22144891;6753;511;8014;8094;5.46;0.33;312.74;8.81;1261;21;2771.00;80
6755;18;22144908;6755;507;8023;8106;5.52;0.34;312.75;8.83;1268;21;2772.00;83
6758;18;22144928;6758;515;8024;8106;5.51;0.33;312.87;8.87;1266;21;2773.00;82
6759;18;22144944;6759;513;8025;8106;5.51;0.34;312.90;8.87;1266;21;2774.00;81
6760;18;22144962;6760;505;8026;8106;5.52;0.34;312.95;8.90;1266;21;2775.00;80
6762;18;22144979;6762;504;8026;8106;5.52;0.34;312.97;8.90;1264;21;2776.00;80
6766;18;22145002;6766;494;8026;8106;5.48;0.34;313.09;8.90;1260;21;2777.00;80
6772;18;22145020;6772;497;8032;8110;5.39;0.33;313.23;9.00;1260;21;2778.00;78
6773;18;22145037;6773;491;8032;8110;5.42;0.33;313.20;9.00;1259;21;2779.00;78
6774;18;22145054;6774;488;8036;8114;5.48;0.33;313.24;8.99;1262;21;2780.00;78
6775;18;22145070;6775;481;8039;8115;5.48;0.33;313.22;9.06;1264;21;2781.00;76
6779;18;22145087;6779;479;8039;8115;5.51;0.34;313.30;9.06;1260;21;2782.00;76
6781;18;22145104;6781;485;8039;8115;5.54;0.34;313.35;9.06;1258;21;2783.00;76
6782;18;22145120;6782;495;8050;8128;5.57;0.34;313.39;9.11;1268;21;2784.00;78
6787;18;22145138;6787;482;8050;8128;5.63;0.34;313.44;9.11;1263;21;2785.00;78
6790;18;22145155;6790;475;8050;8128;5.68;0.35;313.49;9.11;1260;21;2786.00;78
6792;18;22145172;6792;473;8053;8129;5.68;0.35;313.54;9.17;1261;21;2787.00;76
6794;18;22145189;6794;481;8054;8130;5.67;0.35;313.58;9.20;1260;21;2788.00;76
6797;18;22145206;6797;478;8055;8130;5.63;0.34;313.63;9.24;1258;21;2789.00;75
6803;18;22145227;6803;488;8060;8136;5.58;0.34;313.64;9.23;1257;21;2790.00;76
6808;18;22145246;6808;497;8060;8136;5.51;0.34;313.74;9.23;1252;21;2791.00;76
6812;18;22145264;6812;504;8061;8136;5.45;0.33;313.87;9.23;1249;21;2792.00;75
6815;18;22145282;6815;512;8063;8136;5.39;0.33;313.92;9.29;1248;21;2793.00;73
6818;18;22145298;6818;504;8068;8142;5.37;0.33;314.02;9.29;1250;21;2794.00;74
6821;18;22145315;6821;501;8070;8142;5.30;0.32;314.08;9.35;1249;21;2795.00;72
6823;18;22145331;6823;498;8070;8142;5.21;0.32;314.12;9.35;1247;21;2796.00;72
6823;18;22145347;6823;499;8070;8142;5.17;0.32;314.12;9.35;1247;21;2797.00;72
6825;18;22145362;6825;507;8073;8146;5.06;0.31;314.19;9.35;1248;21;2798.00;73
6826;18;22145379;6826;508;8074;8147;5.00;0.30;314.18;9.35;1248;21;2799.00;73
6830;18;22145396;6830;501;8074;8147;4.96;0.30;314.19;9.35;1244;21;2800.00;73
6835;18;22145416;6835;494;8075;8148;4.92;0.30;314.17;9.35;1240;21;2801.00;73
6836;18;22145433;6836;482;8075;8148;4.95;0.30;314.13;9.35;1239;21;2802.00;73
6842;18;22145449;6842;486;8075;8148;4.91;0.30;314.34;9.35;1233;21;2803.00;73
6844;18;22145473;6844;473;8075;8148;4.96;0.30;314.37;9.35;1231;21;2804.00;73
6846;18;22145489;6846;464;8075;8148;5.03;0.31;314.53;9.35;1229;21;2805.00;73
6848;18;22145515;6848;455;8075;8148;5.10;0.31;314.62;9.35;1227;21;2806.00;73
6851;18;22145532;6851;440;8075;8148;5.11;0.31;314.72;9.35;1224;21;2807.00;73
6853;18;22145548;6853;433;8105;8218;5.29;0.33;314.79;9.31;1252;21;2808.00;113
6859;18;22145572;6859;427;8108;8219;5.31;0.33;314.80;9.31;1249;21;2809.00;111
6863;18;22145590;6863;424;8113;8219;5.38;0.33;314.87;9.30;1250;21;2810.00;106
6867;18;22145616;6867;427;8115;8219;5.40;0.33;314.97;9.30;1248;21;2811.00;104
6870;18;22145633;6870;434;8117;8219;5.37;0.33;315.11;9.30;1247;21;2812.00;102
6873;18;22145650;6873;432;8119;8219;5.36;0.33;315.22;9.30;1246;21;2813.00;100
6877;18;22145668;6877;430;8121;8219;5.40;0.33;315.30;9.30;1244;21;2814.00;98
6882;18;22145685;6882;426;8121;8219;5.43;0.33;315.37;9.30;1239;21;2815.00;98
6885;18;22145702;6885;427;8123;8220;5.45;0.33;315.41;9.30;1238;21;2816.00;97
6890;18;22145720;6890;431;8124;8221;5.45;0.33;315.56;9.30;1234;21;2817.00;97
6892;18;22145738;6892;429;8125;8221;5.49;0.34;315.56;9.30;1233;21;2818.00;96
6898;18;22145755;6898;430;8129;8225;5.48;0.34;315.64;9.30;1231;21;2819.00;96
6905;18;22145777;6905;427;8129;8225;5.48;0.33;315.88;9.30;1224;21;2820.00;96
6910;18;22145796;6910;423;8129;8225;5.51;0.34;315.96;9.30;1219;21;2821.00;96
6914;18;22145814;6914;424;8129;8225;5.56;0.34;316.03;9.30;1215;21;2822.00;96
6922;18;22145851;6922;425;8133;8231;5.56;0.34;316.15;9.29;1211;21;2823.00;98
6922;18;22145871;6922;419;8134;8231;5.65;0.35;316.15;9.29;1212;21;2824.00;97
6926;18;22145899;6926;424;8134;8231;5.67;0.35;316.27;9.29;1208;21;2825.00;97
6932;18;22145919;6932;421;8135;8234;5.73;0.35;316.28;9.29;1203;21;2826.00;99
6937;18;22145937;6937;418;8136;8234;5.76;0.35;316.42;9.29;1199;21;2827.00;98
6943;18;22145954;6943;427;8137;8234;5.76;0.35;316.57;9.29;1194;21;2828.00;97
6947;18;22145971;6947;422;8138;8235;5.77;0.35;316.60;9.30;1191;21;2829.00;97
6952;18;22145989;6952;426;8142;8236;5.73;0.35;316.73;9.31;1190;21;2830.00;94
6957;18;22146005;6957;427;8143;8236;5.64;0.34;316.90;9.31;1186;21;2831.00;93
6962;18;22146022;6962;431;8151;8249;5.60;0.34;316.99;9.30;1189;21;2832.00;98
6964;18;22146040;6964;433;8152;8249;5.53;0.34;317.12;9.32;1188;21;2833.00;97
6969;18;22146056;6969;443;8153;8249;5.48;0.33;317.37;9.32;1184;21;2834.00;96
6972;18;22146072;6972;451;8155;8251;5.45;0.33;317.46;9.32;1183;21;2835.00;96
6973;18;22146089;6973;459;8157;8251;5.40;0.33;317.55;9.33;1184;21;2836.00;94
6980;18;22146106;6980;460;8161;8255;5.39;0.33;317.66;9.33;1181;21;2837.00;94
6982;18;22146124;6982;456;8163;8255;5.39;0.33;317.74;9.33;1181;21;2838.00;92
6983;18;22146140;6983;458;8168;8259;5.39;0.33;317.85;9.34;1185;21;2839.00;91
6986;18;22146165;6986;462;8169;8259;5.35;0.33;317.87;9.34;1183;21;2840.00;90
6988;18;22146181;6988;461;8172;8259;5.27;0.32;318.07;9.34;1184;21;2841.00;87
6990;18;22146198;6990;463;8172;8259;5.19;0.32;318.11;9.34;1182;21;2842.00;87
6994;18;22146214;6994;475;8175;8259;5.09;0.31;318.22;9.35;1181;21;2843.00;84
6998;18;22146229;6998;478;8183;8271;5.08;0.31;318.27;9.34;1185;21;2844.00;88
7001;18;22146246;7001;483;8184;8271;5.03;0.31;318.34;9.34;1183;21;2845.00;87
7004;18;22146262;7004;488;8185;8271;4.96;0.30;318.59;9.34;1181;21;2846.00;86
7006;18;22146278;7006;489;8186;8271;4.98;0.30;318.56;9.34;1180;21;2847.00;85
7008;18;22146294;7008;484;8187;8271;5.03;0.31;318.63;9.34;1179;21;2848.00;84
7011;18;22146310;7011;482;8187;8271;5.05;0.31;318.70;9.34;1176;21;2849.00;84
7014;18;22146329;7014;479;8190;8274;5.06;0.31;318.93;9.35;1176;21;2850.00;84
7016;18;22146347;7016;484;8190;8274;5.04;0.31;318.95;9.35;1174;21;2851.00;84
7019;18;22146366;7019;483;8196;8280;5.08;0.31;318.88;9.34;1177;21;2852.00;84
7022;18;22146383;7022;484;8197;8281;5.09;0.31;318.90;9.34;1175;21;2853.00;84
7025;18;22146404;7025;490;8200;8281;5.07;0.31;318.96;9.35;1175;21;2854.00;81
7028;18;22146426;7028;494;8200;8281;5.05;0.31;318.92;9.35;1172;21;2855.00;81
7029;18;22146454;7029;489;8204;8285;5.11;0.31;318.97;9.34;1175;21;2856.00;81
7031;18;22146481;7031;484;8204;8285;5.12;0.31;318.97;9.34;1173;21;2857.00;81
7036;18;22146504;7036;485;8204;8285;5.12;0.31;318.97;9.34;1168;21;2858.00;81
7036;18;22146524;7036;465;8205;8286;5.20;0.32;318.97;9.34;1169;21;2859.00;81
7039;18;22146541;7039;463;8208;8290;5.26;0.32;318.97;9.34;1169;21;2860.00;82
7040;18;22146561;7040;457;8208;8290;5.32;0.32;318.99;9.34;1168;21;2861.00;82
7042;18;22146578;7042;463;8210;8293;5.40;0.33;319.01;9.34;1168;21;2862.00;83
7044;18;22146595;7044;462;8211;8293;5.44;0.33;319.07;9.34;1167;21;2863.00;82
7047;18;22146614;7047;457;8213;8295;5.41;0.33;319.01;9.33;1166;21;2864.00;82
7047;18;22146630;7047;455;8213;8295;5.43;0.33;319.01;9.33;1166;21;2865.00;82
7051;18;22146648;7051;462;8217;8299;5.46;0.33;319.07;9.33;1166;21;2866.00;82
7056;18;22146669;7056;456;8217;8299;5.49;0.33;319.13;9.33;1161;21;2867.00;82
7057;18;22146687;7057;451;8217;8299;5.55;0.34;319.12;9.33;1160;21;2868.00;82
7057;18;22146703;7057;458;8217;8299;5.58;0.34;319.12;9.33;1160;21;2869.00;82
7060;18;22146722;7060;456;8217;8300;5.53;0.34;319.18;9.33;1157;21;2870.00;83
7061;18;22146739;7061;452;8218;8301;5.50;0.34;319.17;9.33;1157;21;2871.00;83
7063;18;22146757;7063;449;8218;8301;5.41;0.33;319.13;9.33;1155;21;2872.00;83
7068;18;22146775;7068;445;8219;8302;5.34;0.32;319.09;9.33;1151;21;2873.00;83
7069;18;22146796;7069;454;8219;8302;5.32;0.32;319.07;9.33;1150;21;2874.00;83
7073;18;22146812;7073;463;8219;8302;5.19;0.32;319.06;9.33;1146;21;2875.00;83
7075;18;22146829;7075;460;8219;8302;5.10;0.31;319.04;9.33;1144;21;2876.00;83
7077;18;22146847;7077;461;8219;8302;5.04;0.31;319.05;9.33;1142;21;2877.00;83
7080;18;22146866;7080;462;8219;8302;4.99;0.30;318.98;9.33;1139;21;2878.00;83
7083;18;22146883;7083;463;8219;8302;4.99;0.30;318.90;9.33;1136;21;2879.00;83
7083;18;22146902;7083;521;8340;8532;5.17;0.32;318.90;9.19;1257;21;2880.00;192
7083;18;22146940;7083;509;8343;8533;5.22;0.33;318.90;9.19;1260;21;2881.00;190
7083;18;22146957;7083;493;8353;8533;5.32;0.33;318.90;9.18;1270;21;2882.00;180
7089;18;22146975;7089;493;8357;8533;5.34;0.34;318.99;9.18;1268;21;2883.00;176
7091;18;22146995;7091;490;8365;8533;5.37;0.34;319.00;9.17;1274;21;2884.00;168
7095;18;22147013;7095;486;8369;8533;5.34;0.34;319.05;9.17;1274;21;2885.00;164
7095;18;22147031;7095;486;8377;8533;5.39;0.34;319.05;9.17;1282;21;2886.00;156
7099;18;22147047;7099;490;8381;8533;5.34;0.33;319.09;9.17;1282;21;2887.00;152
7100;18;22147064;7100;496;8387;8534;5.31;0.33;319.10;9.17;1287;21;2888.00;147
7102;18;22147080;7102;498;8392;8535;5.25;0.33;319.10;9.17;1290;21;2889.00;143
7105;18;22147098;7105;495;8398;8535;5.17;0.32;319.10;9.17;1293;21;2890.00;137
7107;18;22147118;7107;496;8399;8536;5.14;0.32;319.20;9.17;1292;21;2891.00;137
7109;18;22147136;7109;494;8404;8536;5.07;0.32;319.18;9.17;1295;21;2892.00;132
7111;18;22147155;7111;482;8404;8536;5.01;0.31;319.24;9.17;1293;21;2893.00;132
7112;18;22147173;7112;479;8407;8536;4.97;0.31;319.23;9.17;1295;21;2894.00;129
7114;18;22147191;7114;470;8412;8540;4.95;0.31;319.29;9.17;1298;21;2895.00;128
7116;18;22147213;7116;465;8412;8540;4.98;0.31;319.32;9.17;1296;21;2896.00;128
7121;18;22147234;7121;461;8413;8540;5.01;0.31;319.34;9.17;1292;21;2897.00;127
7125;18;22147261;7125;461;8414;8543;5.09;0.31;319.45;9.17;1289;21;2898.00;129
7125;18;22147281;7125;459;8415;8543;5.17;0.32;319.45;9.17;1290;21;2899.00;128
7126;18;22147315;7126;465;8415;8543;5.24;0.32;319.44;9.17;1289;21;2900.00;128
7128;18;22147343;7128;464;8418;8547;5.32;0.33;319.41;9.17;1290;21;2901.00;129
7133;18;22147364;7133;462;8419;8548;5.38;0.33;319.47;9.17;1286;21;2902.00;129
7136;18;22147407;7136;452;8420;8548;5.38;0.33;319.43;9.17;1284;21;2903.00;128
7137;18;22147433;7137;443;8423;8552;5.39;0.33;319.43;9.17;1286;21;2904.00;129
7137;18;22147467;7137;439;8427;8552;5.43;0.33;319.43;9.26;1290;21;2905.00;125
7138;18;22147490;7138;434;8428;8552;5.44;0.33;319.44;9.26;1290;21;2906.00;124
7138;18;22147512;7138;436;8428;8553;5.44;0.33;319.44;9.26;1290;21;2907.00;125
7139;18;22147536;7139;425;8434;8553;5.45;0.33;319.44;9.27;1295;21;2908.00;119
7143;18;22147556;7143;421;8437;8559;5.44;0.33;319.34;9.27;1294;21;2909.00;122
7145;18;22147582;7145;414;8438;8559;5.41;0.33;319.28;9.26;1293;21;2910.00;121
7146;18;22147600;7146;411;8439;8560;5.39;0.33;319.30;9.27;1293;21;2911.00;121
7149;18;22147624;7149;398;8440;8560;5.45;0.33;319.23;9.27;1291;21;2912.00;120
7150;18;22147644;7150;401;8440;8560;5.48;0.33;319.25;9.27;1290;21;2913.00;120
7154;18;22147661;7154;405;8442;8560;5.57;0.34;319.34;9.28;1288;21;2914.00;118
7156;18;22147679;7156;388;8442;8560;5.66;0.34;319.30;9.28;1286;21;2915.00;118
7157;18;22147697;7157;382;8451;8572;5.77;0.35;319.34;9.27;1294;21;2916.00;121
7159;18;22147716;7159;378;8452;8572;5.83;0.36;319.49;9.27;1293;21;2917.00;120
7164;18;22147734;7164;383;8454;8572;5.90;0.36;319.38;9.27;1290;21;2918.00;118
7166;18;22147752;7166;382;8455;8572;5.90;0.36;319.30;9.27;1289;21;2919.00;117
7168;18;22147770;7168;383;8456;8572;5.90;0.36;319.27;9.27;1288;21;2920.00;116
7170;18;22147802;7170;386;8457;8572;5.91;0.36;319.30;9.27;1287;21;2921.00;115
7173;18;22147819;7173;384;8460;8576;5.89;0.36;319.36;9.27;1287;21;2922.00;116
7175;18;22147837;7175;378;8460;8576;5.89;0.36;319.38;9.27;1285;21;2923.00;116
7176;18;22147856;7176;382;8464;8580;5.93;0.36;319.44;9.27;1288;21;2924.00;116
7180;18;22147874;7180;375;8465;8582;5.91;0.36;319.37;9.27;1285;21;2925.00;117
7181;18;22147900;7181;384;8468;8582;5.89;0.36;319.35;9.28;1287;21;2926.00;114
7184;18;22147919;7184;378;8470;8582;5.87;0.36;319.48;9.28;1286;21;2927.00;112
7186;18;22147939;7186;393;8480;8595;5.86;0.36;319.52;9.28;1294;21;2928.00;115
7189;18;22147961;7189;391;8481;8595;5.84;0.35;319.58;9.28;1292;21;2929.00;114
7189;18;22147981;7189;399;8482;8595;5.89;0.36;319.58;9.28;1293;21;2930.00;113
7190;18;22148000;7190;404;8485;8596;5.95;0.36;319.60;9.37;1295;21;2931.00;111
7192;18;22148029;7192;405;8486;8597;5.94;0.36;319.59;9.37;1294;21;2932.00;111
7194;18;22148047;7194;411;8487;8597;5.91;0.36;319.58;9.41;1293;21;2933.00;110
7197;18;22148066;7197;416;8490;8600;5.84;0.35;319.59;9.42;1293;21;2934.00;110
7199;18;22148086;7199;422;8490;8600;5.82;0.35;319.63;9.42;1291;21;2935.00;110
7201;18;22148106;7201;428;8492;8600;5.79;0.35;319.69;9.46;1291;21;2936.00;108
7201;18;22148125;7201;431;8493;8600;5.79;0.35;319.69;9.46;1292;21;2937.00;107
7203;18;22148145;7203;438;8498;8606;5.83;0.35;319.63;9.46;1295;21;2938.00;108
7203;18;22148165;7203;440;8498;8606;5.87;0.36;319.63;9.46;1295;21;2939.00;108
7205;18;22148186;7205;441;8499;8606;5.87;0.36;319.73;9.46;1294;21;2940.00;107
7208;18;22148205;7208;441;8500;8606;5.88;0.36;319.68;9.51;1292;21;2941.00;106
7209;18;22148226;7209;446;8504;8610;5.88;0.36;319.70;9.55;1295;21;2942.00;106
7212;18;22148246;7212;448;8507;8611;5.87;0.36;319.72;9.59;1295;21;2943.00;104
7214;18;22148265;7214;451;8507;8611;5.88;0.36;319.72;9.59;1293;21;2944.00;104
7215;18;22148283;7215;450;8510;8612;5.93;0.36;319.71;9.64;1295;21;2945.00;102
7221;18;22148301;7221;445;8510;8612;5.93;0.36;319.72;9.64;1289;21;2946.00;102
7222;18;22148319;7222;445;8511;8612;5.93;0.36;319.71;9.65;1289;21;2947.00;101
7227;18;22148337;7227;450;8515;8612;5.90;0.36;319.86;9.81;1288;21;2948.00;97
7229;18;22148355;7229;434;8517;8612;5.90;0.36;319.93;9.86;1288;21;2949.00;95
7234;18;22148380;7234;435;8519;8612;5.88;0.36;319.98;9.90;1285;21;2950.00;93
7235;18;22148406;7235;429;8519;8612;5.90;0.36;319.97;9.90;1284;21;2951.00;93
7237;18;22148429;7237;439;8567;8682;5.91;0.36;320.10;9.93;1330;21;2952.00;115
7239;18;22148462;7239;427;8568;8683;5.93;0.36;320.14;9.93;1329;21;2953.00;115
7243;18;22148483;7243;425;8571;8683;5.97;0.36;320.21;9.93;1328;21;2954.00;112
7245;18;22148504;7245;423;8576;8683;6.03;0.37;320.29;10.04;1331;21;2955.00;107
7246;18;22148526;7246;419;8577;8683;6.06;0.37;320.31;10.08;1331;21;2956.00;106
7251;18;22148548;7251;418;8580;8683;6.12;0.37;320.53;10.08;1329;21;2957.00;103
7256;18;22148569;7256;419;8582;8683;6.12;0.37;320.61;10.15;1326;21;2958.00;101
7259;18;22148590;7259;423;8585;8683;6.16;0.37;320.63;10.15;1326;21;2959.00;98
7262;18;22148611;7262;428;8587;8684;6.16;0.38;320.75;10.15;1325;21;2960.00;97
7266;18;22148630;7266;430;8591;8685;6.17;0.38;320.70;10.23;1325;21;2961.00;94
7269;18;22148649;7269;434;8593;8685;6.18;0.38;320.65;10.22;1324;21;2962.00;92
7274;18;22148668;7274;428;8600;8689;6.11;0.37;320.78;10.29;1326;21;2963.00;89
7278;18;22148688;7278;436;8601;8689;6.08;0.37;320.99;10.33;1323;21;2964.00;88
7280;18;22148707;7280;442;8602;8689;6.04;0.37;320.95;10.36;1322;21;2965.00;87
7285;18;22148729;7285;451;8602;8689;5.96;0.36;321.06;10.36;1317;21;2966.00;87
7288;18;22148749;7288;448;8606;8695;5.93;0.36;321.18;10.36;1318;21;2967.00;89
7292;18;22148770;7292;451;8608;8695;5.89;0.36;321.17;10.43;1316;21;2968.00;87
7297;18;22148790;7297;451;8608;8695;5.87;0.36;321.39;10.43;1311;21;2969.00;87
7300;18;22148813;7300;448;8613;8701;5.85;0.36;321.38;10.49;1313;21;2970.00;88
7303;18;22148833;7303;449;8613;8701;5.79;0.35;321.55;10.49;1310;21;2971.00;88
7308;18;22148851;7308;445;8614;8701;5.68;0.35;321.73;10.49;1306;21;2972.00;87
7312;18;22148869;7312;441;8615;8702;5.58;0.34;321.76;10.52;1303;21;2973.00;87
7316;18;22148887;7316;446;8617;8703;5.46;0.33;321.85;10.55;1301;21;2974.00;86
7320;18;22148905;7320;443;8618;8703;5.35;0.33;321.94;10.58;1298;21;2975.00;85
7326;18;22148924;7326;440;8629;8716;5.30;0.32;322.04;10.60;1303;21;2976.00;87
7329;18;22148945;7329;446;8630;8716;5.21;0.32;322.14;10.60;1301;21;2977.00;86
7335;18;22148965;7335;450;8631;8716;5.14;0.31;322.26;10.61;1296;21;2978.00;85
7336;18;22148983;7336;455;8631;8717;5.13;0.31;322.27;10.61;1295;21;2979.00;86
7338;18;22149001;7338;455;8631;8717;5.09;0.31;322.36;10.61;1293;21;2980.00;86
7340;18;22149021;7340;454;8634;8721;5.12;0.31;322.42;10.60;1294;21;2981.00;87
7341;18;22149040;7341;453;8634;8721;5.14;0.31;322.44;10.60;1293;21;2982.00;87
7343;18;22149058;7343;449;8638;8725;5.18;0.32;322.50;10.60;1295;21;2983.00;87
7346;18;22149084;7346;438;8638;8725;5.19;0.32;322.56;10.60;1292;21;2984.00;87
7348;18;22149101;7348;437;8638;8725;5.23;0.32;322.55;10.60;1290;21;2985.00;87
7353;18;22149122;7353;439;8638;8725;5.25;0.32;322.59;10.60;1285;21;2986.00;87
7355;18;22149142;7355;435;8638;8725;5.25;0.32;322.62;10.60;1283;21;2987.00;87
7359;18;22149161;7359;438;8645;8737;5.26;0.32;322.64;10.59;1286;21;2988.00;92
7362;18;22149180;7362;447;8646;8737;5.22;0.32;322.69;10.59;1284;21;2989.00;91
7369;18;22149198;7369;449;8647;8737;5.16;0.32;322.81;10.59;1278;21;2990.00;90
7373;18;22149216;7373;456;8648;8737;5.12;0.31;322.89;10.59;1275;21;2991.00;89
7377;18;22149233;7377;465;8649;8737;5.11;0.31;322.93;10.60;1272;21;2992.00;88
7382;18;22149251;7382;471;8649;8737;5.10;0.31;323.06;10.60;1267;21;2993.00;88
7384;18;22149268;7384;467;8649;8738;5.12;0.31;323.06;10.60;1265;21;2994.00;89
7389;18;22149286;7389;474;8650;8738;5.10;0.31;323.22;10.60;1261;21;2995.00;88
7396;18;22149306;7396;479;8654;8744;5.11;0.31;323.36;10.59;1258;21;2996.00;90
7401;18;22149325;7401;481;8655;8745;5.12;0.31;323.40;10.60;1254;21;2997.00;90
7402;18;22149344;7402;483;8655;8745;5.20;0.32;323.47;10.60;1253;21;2998.00;90
7410;18;22149362;7410;486;8655;8745;5.17;0.32;323.55;10.60;1245;21;2999.00;90
7415;18;22149384;7415;487;8664;8765;5.19;0.32;323.58;10.59;1249;21;3000.00;101
7418;18;22149414;7418;487;8664;8765;5.19;0.32;323.65;10.59;1246;21;3001.00;101
7423;18;22149432;7423;482;8665;8765;5.17;0.32;323.70;10.59;1242;21;3002.00;100
7425;18;22149451;7425;490;8668;8766;5.16;0.32;323.75;10.59;1243;21;3003.00;98
7429;18;22149468;7429;494;8674;8770;5.17;0.32;323.88;10.59;1245;21;3004.00;96
7433;18;22149486;7433;494;8675;8770;5.12;0.31;324.00;10.59;1242;21;3005.00;95
7439;18;22149503;7439;497;8679;8773;5.08;0.31;323.99;10.59;1240;21;3006.00;94
7445;18;22149527;7445;505;8680;8773;5.06;0.31;324.05;10.59;1235;21;3007.00;93
7448;18;22149552;7448;510;8680;8773;5.01;0.31;324.14;10.59;1232;21;3008.00;93
7450;18;22149571;7450;520;8681;8773;4.94;0.30;324.16;10.59;1231;21;3009.00;92
7455;18;22149593;7455;528;8684;8777;4.88;0.30;324.29;10.58;1229;21;3010.00;93
7457;18;22149613;7457;537;8684;8777;4.87;0.30;324.30;10.58;1227;21;3011.00;93
7461;18;22149635;7461;546;8686;8777;4.79;0.29;324.32;10.58;1225;21;3012.00;91
7464;18;22149652;7464;548;8686;8777;4.70;0.29;324.45;10.58;1222;21;3013.00;91
7466;18;22149669;7466;557;8686;8778;4.66;0.29;324.41;10.58;1220;21;3014.00;92
7467;18;22149686;7467;557;8689;8780;4.61;0.28;324.42;10.58;1222;21;3015.00;91
7472;18;22149702;7472;562;8689;8780;4.54;0.28;324.56;10.58;1217;21;3016.00;91
7475;18;22149719;7475;573;8690;8781;4.48;0.27;324.51;10.58;1215;21;3017.00;91
7478;18;22149740;7478;574;8691;8781;4.40;0.27;324.57;10.58;1213;21;3018.00;90
7485;18;22149758;7485;579;8691;8781;4.29;0.26;324.79;10.58;1206;21;3019.00;90
7488;18;22149776;7488;585;8691;8781;4.21;0.26;324.79;10.58;1203;21;3020.00;90
7493;18;22149792;7493;587;8691;8781;4.13;0.25;324.74;10.58;1198;21;3021.00;90
7494;18;22149809;7494;575;8691;8781;4.12;0.25;324.73;10.58;1197;21;3022.00;90
7496;18;22149826;7496;566;8691;8781;4.14;0.25;324.78;10.58;1195;21;3023.00;90
7498;18;22149840;7498;577;8765;8908;4.43;0.28;324.77;10.49;1267;21;3024.00;143
7502;18;22149869;7502;565;8765;8909;4.41;0.27;324.72;10.49;1263;21;3025.00;144
7503;18;22149886;7503;561;8773;8909;4.51;0.28;324.68;10.49;1270;21;3026.00;136
7505;18;22149902;7505;562;8775;8909;4.57;0.28;324.68;10.48;1270;21;3027.00;134
7508;18;22149919;7508;552;8780;8909;4.61;0.29;324.65;10.48;1272;21;3028.00;129
7511;18;22149936;7511;558;8783;8909;4.67;0.29;324.66;10.48;1272;21;3029.00;126
7513;18;22149968;7513;554;8786;8909;4.71;0.29;324.63;10.48;1273;21;3030.00;123
7514;18;22149986;7514;547;8790;8909;4.74;0.29;324.59;10.48;1276;21;3031.00;119
7516;18;22150005;7516;535;8793;8910;4.80;0.30;324.61;10.48;1277;21;3032.00;117
7519;18;22150025;7519;530;8797;8911;4.81;0.30;324.63;10.48;1278;21;3033.00;114
7520;18;22150046;7520;521;8799;8911;4.78;0.30;324.61;10.48;1279;21;3034.00;112
7522;18;22150065;7522;521;8804;8912;4.78;0.30;324.62;10.48;1282;21;3035.00;108
7522;18;22150087;7522;523;8806;8912;4.80;0.30;324.62;10.48;1284;21;3036.00;106
7525;18;22150106;7525;522;8808;8912;4.77;0.29;324.68;10.48;1283;21;3037.00;104
7527;18;22150128;7527;523;8808;8912;4.77;0.29;324.62;10.48;1281;21;3038.00;104
7530;18;22150151;7530;537;8815;8916;4.76;0.29;324.67;10.48;1285;21;3039.00;101
7530;18;22150171;7530;537;8815;8916;4.79;0.29;324.67;10.48;1285;21;3040.00;101
7530;18;22150189;7530;534;8816;8916;4.83;0.30;324.67;10.48;1286;21;3041.00;100
7532;18;22150208;7532;527;8818;8919;4.83;0.30;324.75;10.48;1286;21;3042.00;101
7535;18;22150229;7535;535;8818;8919;4.82;0.30;324.80;10.48;1283;21;3043.00;101
7536;18;22150248;7536;539;8820;8919;4.85;0.30;324.84;10.48;1284;21;3044.00;99
7537;18;22150267;7537;544;8823;8923;4.87;0.30;324.81;10.47;1286;21;3045.00;100
7539;18;22150288;7539;535;8825;8924;4.92;0.30;324.82;10.47;1286;21;3046.00;99
7541;18;22150314;7541;534;8825;8924;4.93;0.30;324.80;10.47;1284;21;3047.00;99
7543;18;22150336;7543;535;8827;8928;4.96;0.30;324.72;10.47;1284;21;3048.00;101
7546;18;22150357;7546;541;8829;8928;5.01;0.31;324.77;10.47;1283;21;3049.00;99
7549;18;22150382;7549;527;8829;8928;5.05;0.31;324.82;10.47;1280;21;3050.00;99
7550;18;22150408;7550;526;8830;8929;5.06;0.31;324.79;10.47;1280;21;3051.00;99
7552;18;22150432;7552;517;8830;8929;5.10;0.31;324.89;10.47;1278;21;3052.00;99
7554;18;22150454;7554;516;8834;8935;5.15;0.31;324.89;10.47;1280;21;3053.00;101
7556;18;22150480;7556;516;8834;8935;5.14;0.31;324.82;10.47;1278;21;3054.00;101
7557;18;22150507;7557;516;8834;8936;5.19;0.32;324.80;10.47;1277;21;3055.00;102
7558;18;22150538;7558;512;8834;8936;5.26;0.32;324.76;10.47;1276;21;3056.00;102
7558;18;22150559;7558;513;8834;8936;5.31;0.32;324.76;10.47;1276;21;3057.00;102
7559;18;22150582;7559;515;8834;8936;5.31;0.32;324.72;10.47;1275;21;3058.00;102
7563;18;22150601;7563;518;8834;8936;5.27;0.32;324.65;10.47;1271;21;3059.00;102
7563;18;22150620;7563;523;8855;8972;5.34;0.33;324.65;10.44;1292;21;3060.00;117
7566;18;22150644;7566;520;8856;8972;5.29;0.32;324.59;10.44;1290;21;3061.00;116
7567;18;22150663;7567;529;8858;8972;5.35;0.33;324.56;10.44;1291;21;3062.00;114
7568;18;22150681;7568;527;8858;8972;5.35;0.33;324.57;10.44;1290;21;3063.00;114
7569;18;22150700;7569;516;8859;8972;5.37;0.33;324.57;10.44;1290;21;3064.00;113
7571;18;22150727;7571;513;8859;8972;5.38;0.33;324.57;10.44;1288;21;3065.00;113
7572;18;22150747;7572;508;8863;8976;5.39;0.33;324.62;10.43;1291;21;3066.00;113
7572;18;22150766;7572;497;8863;8976;5.41;0.33;324.62;10.43;1291;21;3067.00;113
7573;18;22150786;7573;494;8866;8980;5.46;0.33;324.60;10.43;1293;21;3068.00;114
7575;18;22150805;7575;487;8867;8981;5.49;0.33;324.63;10.43;1292;21;3069.00;114
7577;18;22150824;7577;479;8867;8981;5.49;0.33;324.67;10.43;1290;21;3070.00;114
7579;18;22150845;7579;475;8867;8981;5.50;0.33;324.73;10.43;1288;21;3071.00;114
7581;18;22150866;7581;465;8876;8994;5.56;0.34;324.72;10.42;1295;21;3072.00;118
7583;18;22150885;7583;464;8877;8994;5.58;0.34;324.73;10.42;1294;21;3073.00;117
7587;18;22150905;7587;467;8877;8994;5.60;0.34;324.90;10.42;1290;21;3074.00;117
7589;18;22150938;7589;461;8878;8995;5.65;0.34;325.03;10.42;1289;21;3075.00;117
7593;18;22150960;7593;458;8878;8996;5.65;0.34;325.17;10.42;1285;21;3076.00;118
7595;18;22150983;7595;457;8878;8996;5.62;0.34;325.26;10.42;1283;21;3077.00;118
7597;18;22151006;7597;458;8880;8999;5.64;0.34;325.30;10.42;1283;21;3078.00;119
7600;18;22151029;7600;453;8881;8999;5.67;0.34;325.27;10.41;1281;21;3079.00;118
7603;18;22151050;7603;449;8883;8999;5.60;0.34;325.29;10.50;1280;21;3080.00;116
7605;18;22151072;7605;448;8883;8999;5.61;0.34;325.27;10.50;1278;21;3081.00;116
7606;18;22151090;7606;445;8887;9005;5.65;0.34;325.29;10.50;1281;21;3082.00;118
7608;18;22151110;7608;441;8887;9005;5.67;0.34;325.33;10.50;1279;21;3083.00;118
7609;18;22151128;7609;439;8889;9005;5.67;0.34;325.36;10.50;1280;21;3084.00;116
7612;18;22151147;7612;436;8889;9005;5.71;0.35;325.39;10.50;1277;21;3085.00;116
7615;18;22151166;7615;441;8892;9009;5.72;0.35;325.41;10.50;1277;21;3086.00;117
7619;18;22151186;7619;444;8893;9010;5.74;0.35;325.36;10.50;1274;21;3087.00;117
7621;18;22151203;7621;445;8894;9010;5.78;0.35;325.46;10.50;1273;21;3088.00;116
7625;18;22151225;7625;443;8895;9011;5.83;0.35;325.44;10.50;1270;21;3089.00;116
7627;18;22151266;7627;435;8895;9011;5.84;0.35;325.40;10.50;1268;21;3090.00;116
7633;18;22151294;7633;428;8895;9011;5.80;0.35;325.45;10.50;1262;21;3091.00;116
7635;18;22151317;7635;425;8895;9011;5.81;0.35;325.43;10.50;1260;21;3092.00;116
7637;18;22151335;7637;419;8896;9011;5.86;0.35;325.41;10.50;1259;21;3093.00;115
7639;18;22151354;7639;417;8896;9011;5.83;0.35;325.43;10.50;1257;21;3094.00;115
7640;18;22151374;7640;410;8896;9011;5.88;0.36;325.52;10.50;1256;21;3095.00;115
7641;18;22151395;7641;417;8929;9081;5.97;0.36;325.54;10.46;1288;21;3096.00;152
7643;18;22151422;7643;422;8930;9082;5.94;0.36;325.64;10.47;1287;21;3097.00;152
7645;18;22151443;7645;411;8936;9082;5.98;0.36;325.75;10.47;1291;21;3098.00;146
7648;18;22151464;7648;420;8938;9082;5.97;0.36;325.88;10.47;1290;21;3099.00;144
7650;18;22151484;7650;418;8942;9082;5.96;0.36;325.97;10.47;1292;21;3100.00;140
7655;18;22151511;7655;415;8946;9082;5.97;0.36;325.98;10.47;1291;21;3101.00;136
7660;18;22151531;7660;411;8950;9082;5.95;0.36;326.10;10.47;1290;21;3102.00;132
7661;18;22151553;7661;417;8953;9082;6.01;0.37;326.08;10.47;1292;21;3103.00;129
7665;18;22151572;7665;418;8956;9083;6.01;0.37;326.06;10.47;1291;21;3104.00;127
7670;18;22151592;7670;431;8960;9085;5.96;0.36;326.12;10.47;1290;21;3105.00;125
7672;18;22151612;7672;436;8965;9085;5.94;0.36;326.12;10.51;1293;21;3106.00;120
7674;18;22151633;7674;446;8971;9089;5.89;0.36;326.23;10.51;1297;21;3107.00;118
7676;18;22151656;7676;455;8975;9089;5.84;0.36;326.28;10.55;1299;21;3108.00;114
7679;18;22151677;7679;461;8975;9089;5.79;0.35;326.27;10.55;1296;21;3109.00;114
7681;18;22151698;7681;479;8975;9089;5.76;0.35;326.27;10.55;1294;21;3110.00;114
7684;18;22151718;7684;482;8981;9095;5.77;0.35;326.34;10.59;1297;21;3111.00;114
7689;18;22151739;7689;497;8983;9095;5.73;0.35;326.50;10.68;1294;21;3112.00;112
7692;18;22151758;7692;501;8984;9095;5.69;0.35;326.60;10.68;1292;21;3113.00;111
7695;18;22151780;7695;500;8988;9098;5.68;0.34;326.58;10.76;1293;21;3114.00;110
7697;18;22151800;7697;503;8989;9098;5.69;0.34;326.60;10.76;1292;21;3115.00;109
7698;18;22151821;7698;499;8993;9098;5.64;0.34;326.65;10.84;1295;21;3116.00;105
7699;18;22151843;7699;500;8994;9099;5.66;0.34;326.65;10.89;1295;21;3117.00;105
7700;18;22151866;7700;500;8996;9100;5.70;0.35;326.75;10.93;1296;21;3118.00;104
7705;18;22151886;7705;501;8997;9100;5.64;0.34;326.67;10.97;1292;21;3119.00;103
7709;18;22151907;7709;507;9017;9126;5.64;0.34;326.86;10.99;1308;21;3120.00;109
7711;18;22151930;7711;504;9019;9126;5.65;0.34;326.99;11.03;1308;21;3121.00;107
7714;18;22151958;7714;507;9020;9126;5.62;0.34;327.09;11.03;1306;21;3122.00;106
7716;18;22151981;7716;509;9023;9127;5.62;0.34;327.15;11.06;1307;21;3123.00;104
7717;18;22152004;7717;501;9024;9127;5.60;0.34;327.24;11.10;1307;21;3124.00;103
7718;18;22152024;7718;502;9029;9131;5.61;0.34;327.33;11.13;1311;21;3125.00;102
7718;18;22152047;7718;492;9029;9131;5.62;0.34;327.33;11.13;1311;21;3126.00;102
7721;18;22152067;7721;491;9033;9135;5.57;0.34;327.41;11.17;1312;21;3127.00;102
7723;18;22152088;7723;496;9034;9135;5.59;0.34;327.33;11.21;1311;21;3128.00;101
7725;18;22152108;7725;499;9035;9135;5.61;0.34;327.40;11.25;1310;21;3129.00;100
7729;18;22152129;7729;498;9036;9135;5.58;0.34;327.45;11.28;1307;21;3130.00;99
7733;18;22152149;7733;501;9036;9135;5.54;0.34;327.42;11.28;1303;21;3131.00;99
7736;18;22152168;7736;505;9047;9147;5.56;0.34;327.38;11.31;1311;21;3132.00;100
7741;18;22152190;7741;508;9048;9147;5.54;0.34;327.65;11.34;1307;21;3133.00;99
7742;18;22152213;7742;520;9049;9147;5.56;0.34;327.70;11.34;1307;21;3134.00;98
7744;18;22152234;7744;515;9049;9147;5.58;0.34;327.73;11.34;1305;21;3135.00;98
7748;18;22152254;7748;518;9049;9147;5.55;0.34;327.84;11.34;1301;21;3136.00;98
7751;18;22152273;7751;530;9050;9147;5.55;0.34;327.86;11.38;1299;21;3137.00;97
7754;18;22152294;7754;530;9050;9148;5.56;0.34;327.85;11.38;1296;21;3138.00;98
7759;18;22152315;7759;534;9050;9148;5.55;0.34;327.96;11.38;1291;21;3139.00;98
7763;18;22152333;7763;536;9055;9154;5.58;0.34;327.99;11.37;1292;21;3140.00;99
7765;18;22152352;7765;534;9056;9155;5.55;0.34;327.99;11.37;1291;21;3141.00;99
7769;18;22152372;7769;540;9056;9155;5.49;0.34;328.02;11.37;1287;21;3142.00;99
7773;18;22152392;7773;543;9056;9155;5.43;0.33;327.96;11.37;1283;21;3143.00;99
7776;18;22152414;7776;538;9059;9159;5.42;0.33;327.94;11.36;1283;21;3144.00;100
7779;18;22152431;7779;537;9059;9159;5.36;0.33;328.01;11.36;1280;21;3145.00;100
7783;18;22152447;7783;541;9059;9159;5.27;0.32;328.07;11.36;1276;21;3146.00;100
7787;18;22152463;7787;545;9060;9160;5.17;0.32;328.19;11.36;1273;21;3147.00;100
7787;18;22152480;7787;545;9063;9164;5.07;0.31;328.19;11.36;1276;21;3148.00;101
7793;18;22152496;7793;542;9063;9164;4.99;0.31;328.33;11.36;1270;21;3149.00;101
7801;18;22152515;7801;532;9067;9170;4.93;0.30;328.36;11.35;1266;21;3150.00;103
7804;18;22152532;7804;530;9067;9170;4.92;0.30;328.46;11.35;1263;21;3151.00;103
7808;18;22152555;7808;512;9069;9170;4.91;0.30;328.55;11.35;1261;21;3152.00;101
7812;18;22152577;7812;513;9069;9170;4.91;0.30;328.57;11.35;1257;21;3153.00;101
7815;18;22152593;7815;515;9073;9174;4.95;0.30;328.65;11.35;1258;21;3154.00;101
7816;18;22152609;7816;518;9073;9174;5.00;0.31;328.65;11.35;1257;21;3155.00;101
7819;18;22152626;7819;524;9073;9174;5.00;0.31;328.68;11.35;1254;21;3156.00;101
7822;18;22152642;7822;520;9073;9174;5.01;0.31;328.73;11.35;1251;21;3157.00;101
7824;18;22152661;7824;514;9073;9175;5.05;0.31;328.68;11.35;1249;21;3158.00;102
7828;18;22152679;7828;503;9074;9176;5.06;0.31;328.85;11.35;1246;21;3159.00;102
7835;18;22152696;7835;499;9074;9176;5.01;0.31;328.99;11.35;1239;21;3160.00;102
7835;18;22152715;7835;500;9075;9177;5.05;0.31;328.99;11.35;1240;21;3161.00;102
7841;18;22152731;7841;499;9075;9177;5.05;0.31;329.07;11.35;1234;21;3162.00;102
7845;18;22152749;7845;490;9075;9177;5.06;0.31;329.24;11.35;1230;21;3163.00;102
7849;18;22152766;7849;494;9075;9177;5.01;0.31;329.40;11.35;1226;21;3164.00;102
7852;18;22152782;7852;495;9075;9177;4.99;0.31;329.46;11.35;1223;21;3165.00;102
7857;18;22152799;7857;490;9075;9177;4.99;0.31;329.61;11.35;1218;21;3166.00;102
7862;18;22152816;7862;489;9075;9177;4.93;0.30;329.71;11.35;1213;21;3167.00;102
7865;18;22152833;7865;500;9138;9304;5.25;0.33;329.72;11.27;1273;21;3168.00;166
7869;18;22152864;7869;486;9141;9305;5.20;0.32;329.68;11.26;1272;21;3169.00;164
7871;18;22152881;7871;491;9151;9305;5.20;0.32;329.70;11.25;1280;21;3170.00;154
7873;18;22152898;7873;482;9154;9305;5.20;0.32;329.70;11.25;1281;21;3171.00;151
7877;18;22152916;7877;487;9163;9305;5.15;0.32;329.68;11.24;1286;21;3172.00;142
7884;18;22152933;7884;492;9165;9305;5.07;0.31;329.72;11.24;1281;21;3173.00;140
7887;18;22152950;7887;489;9168;9305;5.03;0.31;329.82;11.24;1281;21;3174.00;137
7893;18;22152968;7893;496;9172;9305;4.99;0.31;329.83;11.24;1279;21;3175.00;133
7894;18;22152985;7894;494;9174;9306;4.98;0.31;329.83;11.24;1280;21;3176.00;132
7899;18;22153008;7899;509;9177;9307;4.94;0.31;329.93;11.24;1278;21;3177.00;130
7904;18;22153026;7904;515;9179;9307;4.86;0.30;329.84;11.24;1275;21;3178.00;128
7912;18;22153043;7912;517;9180;9308;4.74;0.29;329.80;11.24;1268;21;3179.00;128
7917;18;22153065;7917;526;9182;9308;4.65;0.29;329.82;11.24;1265;21;3180.00;126
7919;18;22153082;7919;532;9183;9308;4.63;0.29;329.83;11.24;1264;21;3181.00;125
7921;18;22153100;7921;537;9187;9308;4.61;0.29;329.86;11.24;1266;21;3182.00;121
7927;18;22153116;7927;545;9191;9312;4.55;0.28;329.80;11.24;1264;21;3183.00;121
7931;18;22153132;7931;556;9193;9312;4.56;0.28;329.76;11.24;1262;21;3184.00;119
7933;18;22153149;7933;556;9194;9312;4.52;0.28;329.75;11.24;1261;21;3185.00;118
7937;18;22153166;7937;558;9196;9315;4.44;0.28;329.76;11.24;1259;21;3186.00;119
7944;18;22153190;7944;563;9197;9315;4.35;0.27;329.69;11.24;1253;21;3187.00;118
7950;18;22153208;7950;571;9199;9315;4.27;0.26;329.62;11.25;1249;21;3188.00;116
7951;18;22153224;7951;580;9203;9319;4.29;0.26;329.58;11.24;1252;21;3189.00;116
7953;18;22153241;7953;581;9205;9320;4.25;0.26;329.55;11.24;1252;21;3190.00;115
7955;18;22153257;7955;583;9208;9322;4.19;0.26;329.53;11.24;1253;21;3191.00;114
7956;18;22153274;7956;586;9212;9326;4.17;0.26;329.49;11.24;1256;21;3192.00;114
7960;18;22153292;7960;580;9212;9326;4.11;0.25;329.53;11.24;1252;21;3193.00;114
7963;18;22153314;7963;579;9212;9326;4.03;0.25;329.47;11.24;1249;21;3194.00;114
7965;18;22153329;7965;573;9214;9328;3.98;0.24;329.49;11.23;1249;21;3195.00;114
7965;18;22153346;7965;570;9214;9328;3.92;0.24;329.49;11.23;1249;21;3196.00;114
7967;18;22153365;7967;563;9219;9334;3.95;0.24;329.45;11.23;1252;21;3197.00;115
7968;18;22153383;7968;556;9219;9334;4.02;0.25;329.51;11.23;1251;21;3198.00;115
7970;18;22153399;7970;547;9219;9335;4.04;0.25;329.49;11.23;1249;21;3199.00;116
7973;18;22153416;7973;545;9219;9335;4.05;0.25;329.49;11.23;1246;21;3200.00;116
7974;18;22153437;7974;543;9219;9335;4.11;0.25;329.47;11.23;1245;21;3201.00;116
7975;18;22153453;7975;545;9219;9335;4.14;0.25;329.51;11.23;1244;21;3202.00;116
7977;18;22153470;7977;544;9219;9335;4.19;0.26;329.43;11.23;1242;21;3203.00;116
7979;18;22153486;7979;551;9228;9347;4.28;0.26;329.40;11.22;1249;21;3204.00;119
7980;18;22153504;7980;550;9229;9347;4.29;0.26;329.39;11.22;1249;21;3205.00;118
7982;18;22153520;7982;541;9231;9347;4.38;0.27;329.42;11.22;1249;22;3206.00;116
7985;18;22153548;7985;521;9231;9347;4.40;0.27;329.42;11.22;1246;22;3207.00;116
7988;18;22153567;7988;509;9231;9347;4.47;0.27;329.46;11.22;1243;22;3208.00;116
7988;18;22153587;7988;498;9231;9347;4.56;0.28;329.46;11.22;1243;22;3209.00;116
7989;18;22153607;7989;491;9234;9351;4.65;0.28;329.46;11.22;1245;22;3210.00;117
7991;18;22153625;7991;487;9234;9351;4.70;0.29;329.42;11.22;1243;22;3211.00;117
7994;18;22153651;7994;482;9238;9355;4.84;0.30;329.45;11.21;1244;22;3212.00;117
7995;18;22153670;7995;475;9239;9356;4.93;0.30;329.46;11.21;1244;22;3213.00;117
7998;18;22153696;7998;467;9239;9356;4.99;0.30;329.46;11.21;1241;22;3214.00;117
8000;18;22153717;8000;469;9240;9356;5.06;0.31;329.48;11.22;1240;22;3215.00;116
8001;18;22153737;8001;460;9251;9369;5.13;0.31;329.47;11.21;1250;22;3216.00;118
8002;18;22153783;8002;455;9251;9369;5.19;0.32;329.49;11.21;1249;22;3217.00;118
8004;18;22153805;8004;443;9251;9369;5.24;0.32;329.46;11.21;1247;22;3218.00;118
8005;18;22153824;8005;443;9252;9370;5.33;0.32;329.47;11.21;1247;22;3219.00;118
8007;18;22153846;8007;436;9252;9371;5.39;0.33;329.43;11.21;1245;22;3220.00;119
8008;18;22153865;8008;422;9252;9371;5.47;0.33;329.43;11.21;1244;22;3221.00;119
8011;18;22153883;8011;417;9254;9374;5.57;0.34;329.44;11.21;1243;22;3222.00;120
8012;18;22153908;8012;417;9254;9374;5.64;0.34;329.41;11.21;1242;22;3223.00;120
8012;18;22153928;8012;422;9255;9374;5.71;0.35;329.41;11.20;1243;22;3224.00;119
8014;18;22153945;8014;411;9255;9374;5.68;0.34;329.39;11.20;1241;22;3225.00;119
8015;18;22153963;8015;418;9260;9380;5.75;0.35;329.40;11.20;1245;22;3226.00;120
8016;18;22153983;8016;413;9260;9380;5.78;0.35;329.41;11.20;1244;22;3227.00;120
8019;18;22154002;8019;412;9260;9380;5.74;0.35;329.43;11.20;1241;22;3228.00;120
8022;18;22154028;8022;410;9260;9380;5.70;0.35;329.62;11.20;1238;22;3229.00;120
8022;18;22154047;8022;414;9263;9384;5.73;0.35;329.62;11.20;1241;22;3230.00;121
8022;18;22154066;8022;414;9264;9385;5.74;0.35;329.62;11.19;1242;22;3231.00;121
8027;18;22154084;8027;423;9264;9385;5.73;0.35;329.63;11.19;1237;22;3232.00;121
8030;18;22154102;8030;419;9265;9386;5.78;0.35;329.67;11.19;1235;22;3233.00;121
8037;18;22154120;8037;421;9265;9386;5.76;0.35;329.74;11.19;1228;22;3234.00;121
8038;18;22154138;8038;419;9265;9386;5.77;0.35;329.84;11.19;1227;22;3235.00;121
8042;18;22154156;8042;424;9265;9386;5.72;0.35;329.98;11.19;1223;22;3236.00;121
8049;18;22154174;8049;423;9265;9386;5.68;0.34;330.15;11.19;1216;22;3237.00;121
8050;18;22154195;8050;413;9265;9386;5.72;0.35;330.14;11.19;1215;22;3238.00;121
8051;18;22154213;8051;412;9265;9386;5.75;0.35;330.11;11.19;1214;22;3239.00;121
8051;18;22154231;8051;424;9331;9511;5.92;0.36;330.11;11.11;1280;22;3240.00;180
8054;18;22154261;8054;406;9331;9512;5.98;0.37;330.13;11.11;1277;22;3241.00;181
8057;18;22154286;8057;399;9338;9512;6.09;0.37;330.23;11.11;1281;22;3242.00;174
8060;18;22154305;8060;384;9341;9512;6.19;0.38;330.29;11.11;1281;22;3243.00;171
8061;18;22154324;8061;379;9346;9512;6.33;0.39;330.37;11.10;1285;22;3244.00;166
8063;18;22154345;8063;372;9347;9512;6.37;0.39;330.43;11.10;1284;22;3245.00;165
8066;18;22154365;8066;374;9353;9512;6.44;0.39;330.47;11.10;1287;22;3246.00;159
8070;18;22154384;8070;380;9354;9512;6.47;0.40;330.64;11.10;1284;22;3247.00;158
8072;18;22154404;8072;387;9357;9513;6.54;0.40;330.64;11.10;1285;22;3248.00;156
8075;18;22154423;8075;396;9360;9514;6.57;0.40;330.67;11.10;1285;22;3249.00;154
8080;18;22154443;8080;405;9364;9514;6.52;0.40;330.85;11.09;1284;22;3250.00;150
8083;18;22154470;8083;402;9368;9518;6.44;0.39;330.87;11.09;1285;22;3251.00;150
8086;18;22154489;8086;407;9369;9518;6.36;0.39;330.84;11.09;1283;22;3252.00;149
8090;18;22154507;8090;411;9370;9518;6.24;0.38;330.99;11.09;1280;22;3253.00;148
8093;18;22154528;8093;410;9370;9518;6.16;0.37;331.00;11.09;1277;22;3254.00;148
8095;18;22154548;8095;411;9376;9524;6.07;0.37;331.00;11.19;1281;22;3255.00;148
8096;18;22154570;8096;407;9376;9524;6.05;0.37;330.97;11.19;1280;22;3256.00;148
8098;18;22154589;8098;400;9376;9524;5.99;0.36;331.03;11.19;1278;22;3257.00;148
8101;18;22154608;8101;407;9379;9527;5.97;0.36;331.04;11.19;1278;22;3258.00;148
8102;18;22154628;8102;409;9380;9527;5.93;0.36;331.09;11.19;1278;22;3259.00;147
8104;18;22154648;8104;405;9380;9527;5.91;0.36;331.11;11.19;1276;22;3260.00;147
8105;18;22154669;8105;394;9380;9528;5.90;0.36;331.16;11.19;1275;22;3261.00;148
8106;18;22154689;8106;389;9381;9529;5.98;0.36;331.20;11.18;1275;22;3262.00;148
8110;18;22154708;8110;384;9381;9529;6.03;0.37;331.30;11.18;1271;22;3263.00;148
8114;18;22154728;8114;381;9391;9542;6.07;0.37;331.46;11.17;1277;22;3264.00;151
8114;18;22154749;8114;378;9391;9542;6.06;0.37;331.46;11.17;1277;22;3265.00;151
8119;18;22154768;8119;375;9391;9542;6.00;0.36;331.54;11.17;1272;22;3266.00;151
8123;18;22154786;8123;371;9392;9543;5.94;0.36;331.62;11.17;1269;22;3267.00;151
8126;18;22154806;8126;374;9392;9543;5.93;0.36;331.58;11.17;1266;22;3268.00;151
8130;18;22154824;8130;379;9394;9547;5.97;0.36;331.65;11.17;1264;22;3269.00;153
8132;18;22154847;8132;382;9395;9547;5.98;0.36;331.70;11.17;1263;22;3270.00;152
8134;18;22154866;8134;387;9398;9551;6.00;0.37;331.67;11.17;1264;22;3271.00;153
8138;18;22154884;8138;387;9399;9551;5.97;0.36;331.73;11.17;1261;22;3272.00;152
8142;18;22154903;8142;382;9400;9551;5.94;0.36;331.82;11.16;1258;22;3273.00;151
8144;18;22154921;8144;391;9400;9551;5.90;0.36;331.83;11.16;1256;22;3274.00;151
8147;18;22154939;8147;393;9400;9551;5.91;0.36;332.01;11.16;1253;22;3275.00;151
8151;18;22154958;8151;394;9412;9563;5.93;0.36;332.08;11.15;1261;22;3276.00;151
8153;18;22154979;8153;398;9413;9563;5.94;0.36;332.11;11.16;1260;22;3277.00;150
8157;18;22154997;8157;398;9413;9563;5.93;0.36;332.32;11.16;1256;22;3278.00;150
8159;18;22155016;8159;403;9415;9563;5.92;0.36;332.40;11.16;1256;22;3279.00;148
8162;18;22155034;8162;410;9417;9563;5.91;0.36;332.36;11.25;1255;22;3280.00;146
8163;18;22155052;8163;418;9417;9563;5.89;0.36;332.36;11.25;1254;22;3281.00;146
8164;18;22155071;8164;426;9418;9564;5.92;0.36;332.45;11.25;1254;22;3282.00;146
8164;18;22155089;8164;426;9420;9564;5.93;0.36;332.45;11.36;1256;22;3283.00;144
8168;18;22155107;8168;427;9425;9570;5.99;0.37;332.48;11.35;1257;22;3284.00;145
8169;18;22155126;8169;426;9428;9572;6.00;0.37;332.58;11.40;1259;22;3285.00;144
8171;18;22155145;8171;434;9428;9572;5.90;0.36;332.59;11.40;1257;22;3286.00;144
8174;18;22155163;8174;434;9429;9572;5.88;0.36;332.67;11.45;1255;22;3287.00;143
8178;18;22155182;8178;444;9435;9576;5.91;0.36;332.83;11.59;1257;22;3288.00;141
8179;18;22155200;8179;441;9435;9576;5.86;0.36;332.87;11.59;1256;22;3289.00;141
8184;18;22155218;8184;445;9436;9576;5.83;0.36;332.87;11.64;1252;22;3290.00;140
8186;18;22155235;8186;452;9438;9577;5.87;0.36;332.92;11.69;1252;22;3291.00;139
8189;18;22155253;8189;455;9441;9581;5.87;0.36;332.94;11.68;1252;22;3292.00;140
8191;18;22155270;8191;458;9442;9581;5.86;0.36;332.96;11.73;1251;22;3293.00;139
8195;18;22155287;8195;460;9444;9584;5.89;0.36;333.12;11.73;1249;22;3294.00;140
8198;18;22155306;8198;467;9445;9584;5.85;0.36;333.17;11.78;1247;22;3295.00;139
8200;18;22155322;8200;468;9446;9584;5.80;0.35;333.28;11.78;1246;22;3296.00;138
8202;18;22155339;8202;471;9447;9584;5.69;0.35;333.35;11.82;1245;22;3297.00;137
8205;18;22155357;8205;472;9451;9588;5.66;0.35;333.43;11.82;1246;22;3298.00;137
8211;18;22155376;8211;469;9451;9588;5.60;0.34;333.63;11.82;1240;22;3299.00;137
8212;18;22155399;8212;468;9458;9607;5.57;0.34;333.69;11.90;1246;22;3300.00;149
8216;18;22155422;8216;463;9459;9607;5.51;0.34;333.76;11.95;1243;22;3301.00;148
8218;18;22155439;8218;459;9460;9608;5.43;0.33;333.77;11.99;1242;22;3302.00;148
8221;18;22155457;8221;455;9461;9609;5.37;0.33;333.86;11.99;1240;22;3303.00;148
8222;18;22155473;8222;452;9461;9609;5.34;0.33;333.93;11.99;1239;22;3304.00;148
8227;18;22155490;8227;450;9465;9610;5.28;0.32;333.94;12.08;1238;22;3305.00;145
8231;18;22155507;8231;453;9467;9610;5.28;0.32;333.92;12.12;1236;22;3306.00;143
8233;18;22155524;8233;442;9468;9610;5.31;0.32;333.94;12.17;1235;22;3307.00;142
8233;18;22155546;8233;439;9468;9610;5.39;0.33;333.94;12.17;1235;22;3308.00;142
8235;18;22155563;8235;434;9470;9610;5.45;0.33;334.12;12.25;1235;22;3309.00;140
8239;18;22155580;8239;434;9471;9610;5.50;0.34;334.20;12.25;1232;22;3310.00;139
8242;18;22155604;8242;433;9472;9610;5.51;0.34;334.28;12.25;1230;22;3311.00;138
8245;18;22155632;8245;445;9537;9737;5.68;0.35;334.28;12.26;1292;22;3312.00;200
8247;18;22155667;8247;441;9540;9738;5.71;0.35;334.32;12.26;1293;22;3313.00;198
8251;18;22155685;8251;445;9549;9738;5.72;0.35;334.55;12.25;1298;22;3314.00;189
8255;18;22155702;8255;447;9552;9738;5.73;0.35;334.68;12.33;1297;22;3315.00;186
8260;18;22155721;8260;459;9558;9738;5.70;0.35;334.72;12.33;1298;22;3316.00;180
8260;18;22155737;8260;466;9561;9738;5.66;0.35;334.72;12.41;1301;22;3317.00;177
8265;18;22155754;8265;464;9564;9738;5.60;0.34;334.82;12.41;1299;22;3318.00;174
8268;18;22155771;8268;469;9567;9738;5.55;0.34;334.84;12.46;1299;22;3319.00;171
8271;18;22155796;8271;482;9570;9739;5.46;0.33;334.83;12.50;1299;22;3320.00;169
8272;18;22155816;8272;478;9573;9740;5.42;0.33;334.85;12.50;1301;22;3321.00;167
8277;18;22155833;8277;483;9580;9740;5.34;0.33;334.97;12.54;1303;22;3322.00;160
8280;18;22155850;8280;490;9583;9741;5.28;0.32;335.10;12.58;1303;22;3323.00;158
8284;18;22155866;8284;503;9586;9741;5.19;0.32;335.11;12.58;1302;22;3324.00;155
8289;18;22155882;8289;493;9589;9741;5.10;0.31;335.28;12.58;1300;22;3325.00;152
8294;18;22155900;8294;492;9591;9741;5.01;0.31;335.25;12.58;1297;22;3326.00;150
8299;18;22155921;8299;495;9594;9745;4.92;0.30;335.37;12.58;1295;22;3327.00;151
8304;18;22155945;8304;508;9598;9745;4.86;0.30;335.56;12.58;1294;22;3328.00;147
8308;18;22155963;8308;518;9599;9745;4.78;0.29;335.59;12.58;1291;22;3329.00;146
8311;18;22155981;8311;522;9602;9751;4.71;0.29;335.67;12.58;1291;22;3330.00;149
8315;18;22155999;8315;523;9605;9751;4.64;0.28;335.73;12.58;1290;22;3331.00;146
8318;18;22156016;8318;521;9607;9751;4.58;0.28;335.75;12.59;1289;22;3332.00;144
8320;18;22156034;8320;517;9611;9755;4.61;0.28;335.82;12.58;1291;22;3333.00;144
8323;18;22156055;8323;515;9613;9756;4.62;0.28;335.77;12.58;1290;22;3334.00;143
8325;18;22156072;8325;514;9614;9756;4.63;0.28;335.75;12.58;1289;22;3335.00;142
8328;18;22156090;8328;510;9618;9760;4.63;0.28;335.73;12.58;1290;22;3336.00;142
8333;18;22156118;8333;507;9618;9760;4.58;0.28;335.74;12.58;1285;22;3337.00;142
8337;18;22156136;8337;503;9622;9760;4.54;0.28;335.78;12.58;1285;22;3338.00;138
8339;18;22156155;8339;503;9623;9761;4.51;0.28;335.73;12.59;1284;22;3339.00;138
8344;18;22156172;8344;500;9623;9761;4.51;0.28;335.65;12.59;1279;22;3340.00;138
8345;18;22156191;8345;510;9628;9767;4.58;0.28;335.65;12.58;1283;22;3341.00;139
8349;18;22156212;8349;508;9628;9767;4.56;0.28;335.63;12.58;1279;22;3342.00;139
8352;18;22156231;8352;512;9630;9768;4.55;0.28;335.70;12.58;1278;22;3343.00;138
8354;18;22156250;8354;511;9630;9768;4.56;0.28;335.66;12.58;1276;22;3344.00;138
8359;18;22156269;8359;514;9630;9768;4.55;0.28;335.65;12.58;1271;22;3345.00;138
8360;18;22156287;8360;523;9630;9768;4.54;0.28;335.61;12.58;1270;22;3346.00;138
8365;18;22156305;8365;529;9632;9768;4.49;0.27;335.60;12.58;1267;22;3347.00;136
8368;18;22156324;8368;527;9640;9780;4.50;0.27;335.65;12.57;1272;22;3348.00;140
8370;18;22156345;8370;533;9641;9780;4.49;0.27;335.60;12.57;1271;22;3349.00;139
8374;18;22156363;8374;540;9643;9780;4.48;0.27;335.67;12.57;1269;22;3350.00;137
8378;18;22156381;8378;546;9643;9780;4.45;0.27;335.85;12.57;1265;22;3351.00;137
8381;18;22156400;8381;546;9644;9780;4.39;0.27;335.89;12.57;1263;22;3352.00;136
8383;18;22156419;8383;549;9644;9780;4.38;0.27;335.90;12.57;1261;22;3353.00;136
8388;18;22156447;8388;557;9647;9784;4.36;0.27;335.87;12.56;1259;22;3354.00;137
8390;18;22156465;8390;561;9647;9784;4.31;0.26;335.90;12.56;1257;22;3355.00;137
8393;18;22156483;8393;561;9651;9788;4.25;0.26;335.85;12.56;1258;22;3356.00;137
8397;18;22156502;8397;565;9652;9789;4.20;0.26;335.81;12.56;1255;22;3357.00;137
8400;18;22156522;8400;568;9652;9789;4.17;0.26;335.75;12.56;1252;22;3358.00;137
8404;18;22156540;8404;570;9652;9789;4.12;0.25;335.77;12.56;1248;22;3359.00;137
8407;18;22156560;8407;577;9675;9818;4.17;0.26;335.76;12.53;1268;22;3360.00;143
8409;18;22156580;8409;570;9675;9818;4.17;0.26;335.71;12.53;1266;22;3361.00;143
8415;18;22156598;8415;572;9677;9818;4.11;0.25;335.64;12.53;1262;22;3362.00;141
8415;18;22156616;8415;580;9678;9819;4.08;0.25;335.64;12.52;1263;22;3363.00;141
8420;18;22156634;8420;576;9678;9820;4.02;0.24;335.56;12.52;1258;22;3364.00;142
8422;18;22156652;8422;571;9678;9820;3.98;0.24;335.56;12.52;1256;22;3365.00;142
8427;18;22156670;8427;572;9680;9823;4.01;0.24;335.60;12.52;1253;22;3366.00;143
8429;18;22156688;8429;575;9680;9823;4.04;0.25;335.63;12.52;1251;22;3367.00;143
8433;18;22156706;8433;578;9681;9823;4.05;0.25;335.65;12.52;1248;22;3368.00;142
8434;18;22156724;8434;572;9681;9823;4.07;0.25;335.67;12.52;1247;22;3369.00;142
8436;18;22156743;8436;566;9686;9829;4.08;0.25;335.69;12.51;1250;22;3370.00;143
8440;18;22156762;8440;570;9686;9829;4.07;0.25;335.66;12.51;1246;22;3371.00;143
8441;18;22156781;8441;561;9686;9829;4.07;0.25;335.67;12.51;1245;22;3372.00;143
8443;18;22156797;8443;549;9686;9829;4.08;0.25;335.69;12.51;1243;22;3373.00;143
8447;18;22156816;8447;533;9690;9833;4.17;0.25;335.76;12.53;1243;22;3374.00;143
8450;18;22156833;8450;522;9692;9835;4.25;0.26;335.73;12.53;1242;22;3375.00;143
8453;18;22156851;8453;514;9692;9835;4.31;0.26;335.84;12.53;1239;22;3376.00;143
8456;18;22156867;8456;510;9693;9836;4.36;0.27;335.84;12.53;1237;22;3377.00;143
8459;18;22156896;8459;504;9693;9836;4.38;0.27;335.82;12.53;1234;22;3378.00;143
8459;18;22156914;8459;499;9693;9836;4.43;0.27;335.82;12.53;1234;22;3379.00;143
8461;18;22156931;8461;493;9693;9836;4.50;0.27;335.82;12.53;1232;22;3380.00;143
8464;18;22156955;8464;482;9693;9836;4.54;0.28;335.82;12.53;1229;22;3381.00;143
8466;18;22156974;8466;473;9693;9836;4.60;0.28;335.87;12.53;1227;22;3382.00;143
8466;18;22156995;8466;463;9693;9836;4.69;0.28;335.87;12.53;1227;22;3383.00;143
8468;18;22157014;8468;466;9734;9906;4.91;0.30;335.84;12.47;1266;22;3384.00;172
8472;18;22157045;8472;455;9735;9907;4.94;0.30;335.97;12.47;1263;22;3385.00;172
8474;18;22157066;8474;454;9740;9907;5.03;0.31;336.03;12.47;1266;22;3386.00;167
8475;18;22157092;8475;440;9742;9907;5.14;0.31;336.05;12.47;1267;22;3387.00;165
8476;18;22157115;8476;438;9744;9907;5.25;0.32;336.04;12.46;1268;22;3388.00;163
8477;18;22157132;8477;439;9746;9907;5.34;0.32;336.04;12.46;1269;22;3389.00;161
8478;18;22157152;8478;437;9749;9907;5.42;0.33;336.00;12.46;1271;22;3390.00;158
8479;18;22157170;8479;445;9752;9907;5.47;0.33;335.98;12.48;1273;22;3391.00;155
8482;18;22157189;8482;437;9753;9908;5.44;0.33;336.07;12.48;1271;22;3392.00;155
8483;18;22157208;8483;445;9755;9909;5.43;0.33;336.11;12.48;1272;22;3393.00;154
8485;18;22157232;8485;444;9757;9909;5.42;0.33;336.08;12.48;1272;22;3394.00;152
8487;18;22157254;8487;439;9763;9913;5.40;0.33;336.06;12.48;1276;22;3395.00;150
8490;18;22157273;8490;443;9765;9913;5.38;0.33;336.09;12.47;1275;22;3396.00;148
8493;18;22157295;8493;441;9765;9913;5.36;0.33;336.25;12.47;1272;22;3397.00;148
8496;19;22157317;8496;450;9765;9913;5.34;0.32;336.35;12.47;1269;23;3398.00;148
8498;19;22157353;8498;449;9770;9919;5.36;0.33;336.39;12.47;1272;23;3399.00;149
8500;19;22157373;8500;447;9770;9919;5.37;0.33;336.43;12.47;1270;23;3400.00;149
8503;19;22157398;8503;448;9770;9919;5.37;0.33;336.52;12.47;1267;23;3401.00;149
8506;19;22157418;8506;441;9772;9922;5.42;0.33;336.57;12.47;1266;23;3402.00;150
8508;19;22157439;8508;455;9772;9922;5.47;0.33;336.64;12.47;1264;23;3403.00;150
8509;19;22157458;8509;448;9773;9922;5.53;0.34;336.61;12.46;1264;23;3404.00;149
8509;19;22157479;8509;444;9773;9923;5.53;0.34;336.61;12.46;1264;23;3405.00;150
8513;19;22157505;8513;443;9774;9924;5.52;0.34;336.70;12.46;1261;23;3406.00;150
8515;19;22157524;8515;440;9775;9924;5.54;0.34;336.72;12.48;1260;23;3407.00;149
8519;19;22157543;8519;446;9785;9937;5.61;0.34;336.81;12.47;1266;23;3408.00;152
8520;19;22157564;8520;437;9786;9937;5.63;0.34;336.77;12.47;1266;23;3409.00;151
8522;19;22157582;8522;435;9786;9937;5.65;0.34;336.78;12.47;1264;23;3410.00;151
8522;19;22157600;8522;433;9787;9938;5.72;0.35;336.78;12.46;1265;23;3411.00;151
8524;19;22157618;8524;427;9787;9938;5.77;0.35;336.84;12.46;1263;23;3412.00;151
8526;19;22157637;8526;434;9791;9942;5.80;0.35;336.88;12.46;1265;23;3413.00;151
8526;19;22157656;8526;439;9791;9942;5.82;0.35;336.88;12.46;1265;23;3414.00;151
8531;19;22157675;8531;435;9794;9946;5.78;0.35;336.92;12.46;1263;23;3415.00;152
8533;19;22157698;8533;428;9794;9946;5.83;0.35;336.94;12.46;1261;23;3416.00;152
8536;19;22157730;8536;423;9794;9946;5.82;0.35;337.01;12.46;1258;23;3417.00;152
8538;19;22157748;8538;417;9794;9946;5.85;0.35;337.11;12.46;1256;23;3418.00;152
8543;19;22157767;8543;411;9794;9946;5.81;0.35;337.20;12.46;1251;23;3419.00;152
8547;19;22157788;8547;406;9820;9980;5.86;0.36;337.20;12.42;1273;23;3420.00;160
8547;19;22157840;8547;407;9820;9980;5.92;0.36;337.20;12.42;1273;23;3421.00;160
8549;19;22157861;8549;402;9822;9980;5.95;0.36;337.21;12.42;1273;23;3422.00;158
8551;19;22157881;8551;404;9822;9980;5.99;0.37;337.21;12.42;1271;23;3423.00;158
8553;19;22157900;8553;400;9823;9980;6.02;0.37;337.35;12.42;1270;23;3424.00;157
8555;19;22157922;8555;390;9823;9980;6.06;0.37;337.30;12.42;1268;23;3425.00;157
8557;19;22157947;8557;387;9823;9981;6.10;0.37;337.38;12.42;1266;23;3426.00;158
8558;19;22157971;8558;391;9823;9981;6.09;0.37;337.40;12.42;1265;23;3427.00;158
8563;19;22157996;8563;387;9828;9987;6.06;0.37;337.60;12.41;1265;23;3428.00;159
8567;19;22158020;8567;386;9829;9988;6.03;0.37;337.78;12.41;1262;23;3429.00;159
8569;19;22158043;8569;374;9831;9988;6.00;0.37;337.80;12.52;1262;23;3430.00;157
8573;19;22158068;8573;374;9831;9988;5.94;0.36;337.89;12.52;1258;23;3431.00;157
8575;19;22158089;8575;370;9834;9992;5.92;0.36;337.94;12.51;1259;23;3432.00;158
8577;19;22158111;8577;363;9834;9992;5.90;0.36;337.98;12.51;1257;23;3433.00;158
8583;19;22158132;8583;364;9834;9992;5.89;0.36;338.09;12.51;1251;23;3434.00;158
8585;19;22158152;8585;362;9835;9993;5.91;0.36;338.13;12.51;1250;23;3435.00;158
8588;19;22158171;8588;358;9838;9997;5.95;0.36;338.28;12.51;1250;23;3436.00;159
8592;19;22158193;8592;366;9838;9997;5.98;0.37;338.27;12.51;1246;23;3437.00;159
8595;19;22158212;8595;365;9840;10000;6.01;0.37;338.38;12.50;1245;23;3438.00;160
8600;19;22158234;8600;365;9841;10000;5.97;0.36;338.37;12.50;1241;23;3439.00;159
8605;19;22158253;8605;359;9841;10000;5.96;0.36;338.40;12.50;1236;23;3440.00;159
8607;19;22158274;8607;354;9841;10000;5.97;0.36;338.41;12.50;1234;23;3441.00;159
8610;19;22158311;8610;360;9845;10004;6.05;0.37;338.45;12.50;1235;23;3442.00;159
8614;19;22158335;8614;358;9845;10004;6.06;0.37;338.58;12.50;1231;23;3443.00;159
8618;19;22158362;8618;364;9845;10004;6.08;0.37;338.55;12.50;1227;23;3444.00;159
8624;19;22158391;8624;362;9845;10004;6.03;0.37;338.64;12.50;1221;23;3445.00;159
8628;19;22158424;8628;367;9845;10005;5.98;0.36;338.76;12.50;1217;23;3446.00;160
8630;19;22158444;8630;367;9846;10006;5.96;0.36;338.78;12.50;1216;23;3447.00;160
8632;19;22158464;8632;368;9846;10006;5.91;0.36;338.92;12.50;1214;23;3448.00;160
8634;19;22158483;8634;375;9847;10007;5.92;0.36;338.99;12.50;1213;23;3449.00;160
8637;19;22158503;8637;378;9847;10007;5.89;0.36;338.96;12.50;1210;23;3450.00;160
8640;19;22158521;8640;381;9847;10007;5.87;0.36;338.96;12.50;1207;23;3451.00;160
8644;19;22158538;8644;384;9847;10007;5.82;0.35;339.11;12.50;1203;23;3452.00;160
8648;19;22158556;8648;394;9847;10007;5.75;0.35;339.21;12.50;1199;23;3453.00;160
8651;19;22158574;8651;403;9847;10007;5.68;0.34;339.43;12.50;1196;23;3454.00;160
8653;19;22158593;8653;409;9848;10007;5.60;0.34;339.57;12.55;1195;23;3455.00;159
8653;19;22158611;8653;429;9913;10134;5.77;0.36;339.57;12.52;1260;23;3456.00;221
8656;19;22158639;8656;425;9914;10135;5.78;0.36;339.61;12.52;1258;23;3457.00;221
8661;19;22158658;8661;423;9923;10135;5.76;0.35;339.79;12.61;1262;23;3458.00;212
8662;19;22158679;8662;422;9927;10135;5.72;0.35;339.84;12.61;1265;23;3459.00;208
8662;19;22158699;8662;424;9934;10135;5.73;0.35;339.84;12.66;1272;23;3460.00;201
8664;19;22158718;8664;428;9937;10135;5.68;0.35;340.02;12.65;1273;23;3461.00;198
8665;19;22158736;8665;429;9940;10135;5.69;0.35;340.05;12.65;1275;23;3462.00;195
8670;19;22158766;8670;426;9945;10135;5.67;0.35;340.06;12.75;1275;23;3463.00;190
8671;19;22158788;8671;431;9948;10136;5.71;0.35;340.09;12.75;1277;23;3464.00;188
8672;19;22158816;8672;436;9952;10138;5.74;0.35;340.08;12.75;1280;23;3465.00;186
8676;19;22158836;8676;432;9957;10138;5.75;0.35;340.18;12.85;1281;23;3466.00;181
8679;19;22158855;8679;438;9959;10139;5.75;0.35;340.25;12.90;1280;23;3467.00;180
8680;19;22158874;8680;448;9963;10139;5.77;0.35;340.33;12.94;1283;23;3468.00;176
8684;19;22158896;8684;447;9964;10139;5.75;0.35;340.48;12.94;1280;23;3469.00;175
8685;19;22158917;8685;457;9967;10139;5.76;0.35;340.47;12.94;1282;23;3470.00;172
8690;19;22158936;8690;464;9973;10143;5.71;0.35;340.46;13.04;1283;23;3471.00;170
8693;19;22158956;8693;466;9977;10143;5.72;0.35;340.62;13.04;1284;23;3472.00;166
8694;19;22158977;8694;473;9979;10143;5.69;0.35;340.59;13.04;1285;23;3473.00;164
8696;19;22158997;8696;482;9982;10146;5.62;0.34;340.71;13.13;1286;23;3474.00;164
8699;19;22159017;8699;485;9984;10146;5.56;0.34;340.74;13.13;1285;23;3475.00;162
8703;19;22159037;8703;489;9987;10146;5.53;0.34;340.86;13.23;1284;23;3476.00;159
8706;19;22159056;8706;492;9991;10150;5.45;0.33;340.86;13.23;1285;23;3477.00;159
8707;19;22159075;8707;500;9993;10151;5.37;0.33;340.94;13.23;1286;23;3478.00;158
8711;19;22159096;8711;509;9996;10151;5.30;0.32;341.07;13.32;1285;23;3479.00;155
8715;19;22159122;8715;502;10001;10156;5.32;0.32;341.16;13.31;1286;23;3480.00;155
8716;19;22159146;8716;505;10002;10156;5.32;0.32;341.15;13.31;1286;23;3481.00;154
8718;19;22159166;8718;508;10004;10156;5.29;0.32;341.18;13.41;1286;23;3482.00;152
8721;19;22159196;8721;507;10005;10157;5.26;0.32;341.21;13.40;1284;23;3483.00;152
8722;19;22159214;8722;506;10005;10157;5.24;0.32;341.25;13.40;1283;23;3484.00;152
8725;19;22159231;8725;511;10010;10163;5.28;0.32;341.22;13.40;1285;23;3485.00;153
8726;19;22159249;8726;510;10010;10163;5.22;0.32;341.20;13.40;1284;23;3486.00;153
8730;19;22159270;8730;513;10010;10164;5.16;0.31;341.22;13.40;1280;23;3487.00;154
8730;19;22159289;8730;523;10010;10164;5.12;0.31;341.22;13.40;1280;23;3488.00;154
8731;19;22159307;8731;527;10010;10164;5.07;0.31;341.20;13.40;1279;23;3489.00;154
8735;19;22159324;8735;531;10010;10164;4.98;0.30;341.14;13.40;1275;23;3490.00;154
8737;19;22159342;8737;544;10010;10164;4.93;0.30;341.12;13.40;1273;23;3491.00;154
8743;19;22159360;8743;546;10021;10176;4.86;0.30;341.15;13.38;1278;23;3492.00;155
8747;19;22159381;8747;559;10021;10176;4.80;0.29;341.10;13.38;1274;23;3493.00;155
8750;19;22159398;8750;559;10021;10176;4.73;0.29;341.19;13.38;1271;23;3494.00;155
8753;19;22159417;8753;561;10021;10176;4.68;0.29;341.18;13.38;1268;23;3495.00;155
8754;19;22159434;8754;567;10021;10176;4.65;0.28;341.16;13.38;1267;23;3496.00;155
8757;19;22159452;8757;573;10021;10176;4.60;0.28;341.11;13.38;1264;23;3497.00;155
8763;19;22159469;8763;574;10024;10180;4.51;0.27;341.01;13.38;1261;23;3498.00;156
8766;19;22159485;8766;577;10024;10180;4.42;0.27;340.94;13.38;1258;23;3499.00;156
8769;19;22159502;8769;564;10027;10184;4.40;0.27;340.88;13.38;1258;23;3500.00;157
8770;19;22159524;8770;570;10028;10185;4.37;0.27;340.86;13.37;1258;23;3501.00;157
8771;19;22159544;8771;569;10028;10185;4.33;0.27;340.85;13.37;1257;23;3502.00;157
8774;19;22159562;8774;564;10028;10185;4.30;0.26;340.81;13.37;1254;23;3503.00;157
8776;19;22159580;8776;569;10038;10198;4.33;0.27;340.76;13.36;1262;23;3504.00;160
8780;19;22159601;8780;570;10038;10198;4.29;0.26;340.71;13.36;1258;23;3505.00;160
8785;19;22159618;8785;567;10038;10198;4.28;0.26;340.64;13.36;1253;23;3506.00;160
8787;19;22159635;8787;562;10039;10199;4.30;0.26;340.63;13.36;1252;23;3507.00;160
8791;19;22159652;8791;552;10039;10200;4.29;0.26;340.56;13.36;1248;23;3508.00;161
8793;19;22159668;8793;547;10039;10200;4.29;0.26;340.50;13.36;1246;23;3509.00;161
8797;19;22159686;8797;539;10043;10206;4.28;0.26;340.56;13.35;1246;23;3510.00;163
8800;19;22159702;8800;532;10043;10206;4.24;0.26;340.55;13.35;1243;23;3511.00;163
8803;19;22159719;8803;528;10044;10206;4.23;0.26;340.56;13.35;1241;23;3512.00;162
8807;19;22159735;8807;535;10044;10206;4.20;0.26;340.54;13.35;1237;23;3513.00;162
8808;19;22159751;8808;545;10048;10212;4.26;0.26;340.52;13.35;1240;23;3514.00;164
8812;19;22159767;8812;545;10048;10212;4.25;0.26;340.57;13.35;1236;23;3515.00;164
8814;19;22159785;8814;548;10048;10212;4.25;0.26;340.57;13.35;1234;23;3516.00;164
8817;19;22159804;8817;552;10048;10212;4.22;0.26;340.55;13.35;1231;23;3517.00;164
8819;19;22159822;8819;565;10051;10216;4.26;0.26;340.58;13.34;1232;23;3518.00;165
8824;19;22159839;8824;562;10054;10219;4.22;0.26;340.56;13.34;1230;23;3519.00;165
8826;19;22159857;8826;566;10055;10219;4.21;0.26;340.57;13.34;1229;23;3520.00;164
8831;19;22159873;8831;550;10056;10220;4.16;0.25;340.58;13.34;1225;23;3521.00;164
8833;19;22159891;8833;551;10056;10220;4.17;0.25;340.58;13.34;1223;23;3522.00;164
8837;19;22159912;8837;550;10058;10220;4.17;0.25;340.56;13.37;1221;23;3523.00;162
8839;19;22159929;8839;533;10058;10220;4.15;0.25;340.57;13.37;1219;23;3524.00;162
8842;19;22159945;8842;530;10060;10220;4.15;0.25;340.54;13.37;1218;23;3525.00;160
8846;19;22159962;8846;534;10060;10220;4.13;0.25;340.56;13.37;1214;23;3526.00;160
8849;19;22159979;8849;525;10060;10220;4.14;0.25;340.54;13.37;1211;23;3527.00;160
8850;19;22160005;8850;531;10097;10290;4.30;0.26;340.53;13.32;1247;23;3528.00;193
8853;19;22160031;8853;515;10100;10291;4.33;0.26;340.51;13.32;1247;23;3529.00;191
8856;19;22160049;8856;505;10104;10291;4.36;0.27;340.57;13.31;1248;23;3530.00;187
8857;19;22160068;8857;495;10108;10291;4.42;0.27;340.62;13.31;1251;23;3531.00;183
8861;19;22160086;8861;500;10109;10291;4.50;0.27;340.62;13.31;1248;23;3532.00;182
8863;19;22160104;8863;490;10110;10291;4.57;0.28;340.61;13.31;1247;23;3533.00;181
8864;19;22160122;8864;487;10111;10291;4.69;0.29;340.60;13.30;1247;23;3534.00;180
8868;19;22160141;8868;487;10113;10291;4.69;0.29;340.73;13.30;1245;23;3535.00;178
8871;19;22160169;8871;482;10115;10292;4.72;0.29;340.73;13.30;1244;23;3536.00;177
8872;19;22160187;8872;478;10117;10293;4.74;0.29;340.71;13.30;1245;23;3537.00;176
8875;19;22160203;8875;489;10120;10293;4.71;0.29;340.76;13.33;1245;23;3538.00;173
8880;19;22160220;8880;495;10124;10297;4.70;0.29;340.78;13.32;1244;23;3539.00;173
8881;19;22160238;8881;499;10127;10297;4.72;0.29;340.77;13.32;1246;23;3540.00;170
8884;19;22160255;8884;507;10128;10297;4.71;0.29;340.77;13.32;1244;23;3541.00;169
8887;19;22160272;8887;513;10130;10297;4.69;0.29;340.80;13.32;1243;23;3542.00;167
8889;19;22160289;8889;522;10135;10303;4.70;0.29;340.82;13.32;1246;23;3543.00;168
8891;19;22160306;8891;522;10136;10303;4.68;0.29;340.87;13.32;1245;23;3544.00;167
8891;19;22160322;8891;529;10137;10303;4.68;0.29;340.87;13.32;1246;23;3545.00;166
8894;19;22160341;8894;530;10139;10306;4.66;0.28;340.88;13.31;1245;23;3546.00;167
8896;19;22160359;8896;518;10140;10306;4.66;0.28;340.88;13.31;1244;23;3547.00;166
8898;19;22160376;8898;508;10140;10306;4.67;0.29;340.93;13.31;1242;23;3548.00;166
8900;19;22160397;8900;510;10141;10307;4.70;0.29;340.95;13.34;1241;23;3549.00;166
8903;19;22160415;8903;508;10142;10308;4.70;0.29;340.91;13.34;1239;23;3550.00;166
8905;19;22160431;8905;507;10142;10308;4.69;0.29;340.93;13.34;1237;23;3551.00;166
8906;19;22160449;8906;514;10152;10321;4.81;0.29;341.00;13.33;1246;23;3552.00;169
8910;19;22160469;8910;509;10152;10321;4.78;0.29;341.03;13.33;1242;23;3553.00;169
8912;19;22160487;8912;504;10153;10321;4.74;0.29;341.05;13.33;1241;23;3554.00;168
8915;19;22160504;8915;501;10155;10323;4.75;0.29;341.08;13.32;1240;23;3555.00;168
8917;19;22160521;8917;484;10155;10323;4.75;0.29;341.10;13.32;1238;23;3556.00;168
8920;19;22160539;8920;478;10159;10327;4.79;0.29;341.10;13.32;1239;23;3557.00;168
8922;19;22160557;8922;462;10159;10327;4.82;0.29;341.17;13.32;1237;23;3558.00;168
8923;19;22160574;8923;454;10162;10331;4.85;0.30;341.22;13.32;1239;23;3559.00;169
8928;19;22160601;8928;447;10162;10331;4.83;0.29;341.41;13.32;1234;23;3560.00;169
8929;19;22160618;8929;445;10162;10331;4.86;0.30;341.50;13.32;1233;23;3561.00;169
8932;19;22160635;8932;452;10162;10331;4.88;0.30;341.48;13.32;1230;23;3562.00;169
8934;19;22160653;8934;458;10162;10331;4.89;0.30;341.56;13.32;1228;23;3563.00;169
8935;19;22160670;8935;462;10171;10343;4.94;0.30;341.59;13.30;1236;23;3564.00;172
8938;19;22160689;8938;470;10171;10343;4.95;0.30;341.56;13.30;1233;23;3565.00;172
8940;19;22160708;8940;475;10173;10343;4.97;0.30;341.64;13.30;1233;23;3566.00;170
8944;19;22160726;8944;477;10173;10343;4.96;0.30;341.66;13.30;1229;23;3567.00;170
8945;19;22160744;8945;473;10173;10343;5.04;0.31;341.63;13.30;1228;23;3568.00;170
8947;19;22160761;8947;470;10173;10343;5.07;0.31;341.71;13.30;1226;23;3569.00;170
8951;19;22160781;8951;470;10173;10344;5.09;0.31;341.91;13.30;1222;23;3570.00;171
8954;19;22160799;8954;465;10173;10344;5.11;0.31;341.86;13.30;1219;23;3571.00;171
8955;19;22160817;8955;465;10178;10350;5.20;0.32;341.95;13.30;1223;23;3572.00;172
8957;19;22160835;8957;466;10180;10351;5.25;0.32;341.96;13.35;1223;23;3573.00;171
8957;19;22160852;8957;466;10180;10351;5.29;0.32;341.96;13.35;1223;23;3574.00;171
8958;19;22160869;8958;472;10181;10351;5.31;0.32;341.96;13.38;1223;23;3575.00;170
8959;19;22160886;8959;470;10184;10355;5.33;0.32;342.00;13.38;1225;23;3576.00;171
8964;19;22160904;8964;473;10184;10355;5.28;0.32;341.94;13.38;1220;23;3577.00;171
8968;19;22160922;8968;473;10184;10355;5.26;0.32;342.00;13.38;1216;23;3578.00;171
8970;19;22160939;8970;462;10185;10356;5.30;0.32;342.15;13.38;1215;23;3579.00;171
8974;19;22160957;8974;470;10188;10360;5.27;0.32;342.24;13.37;1214;23;3580.00;172
8977;19;22160975;8977;463;10188;10360;5.26;0.32;342.35;13.37;1211;23;3581.00;172
8979;19;22160994;8979;458;10190;10363;5.27;0.32;342.33;13.37;1211;23;3582.00;173
8980;19;22161014;8980;460;10191;10363;5.28;0.32;342.37;13.40;1211;23;3583.00;172
8980;19;22161032;8980;464;10192;10363;5.31;0.32;342.37;13.40;1212;23;3584.00;171
8982;19;22161049;8982;461;10192;10363;5.36;0.32;342.44;13.40;1210;23;3585.00;171
8983;19;22161066;8983;462;10196;10367;5.43;0.33;342.43;13.40;1213;23;3586.00;171
8987;19;22161084;8987;460;10196;10367;5.40;0.33;342.52;13.40;1209;23;3587.00;171
8988;19;22161101;8988;462;10196;10367;5.43;0.33;342.51;13.40;1208;23;3588.00;171
8989;19;22161117;8989;462;10196;10367;5.42;0.33;342.49;13.40;1207;23;3589.00;171
8991;19;22161134;8991;456;10196;10368;5.42;0.33;342.51;13.40;1205;23;3590.00;172
8993;19;22161151;8993;446;10197;10369;5.48;0.33;342.58;13.40;1204;23;3591.00;172
8995;19;22161168;8995;437;10197;10369;5.50;0.33;342.61;13.40;1202;23;3592.00;172
8999;19;22161186;8999;438;10198;10370;5.46;0.33;342.65;13.39;1199;23;3593.00;172
9000;19;22161203;9000;433;10198;10370;5.51;0.33;342.63;13.39;1198;23;3594.00;172
9003;19;22161220;9003;425;10198;10370;5.53;0.33;342.59;13.39;1195;23;3595.00;172
9005;19;22161237;9005;418;10198;10370;5.60;0.34;342.67;13.39;1193;23;3596.00;172
9005;19;22161254;9005;412;10198;10370;5.70;0.35;342.67;13.39;1193;23;3597.00;172
9007;19;22161271;9007;409;10198;10370;5.78;0.35;342.75;13.39;1191;23;3598.00;172
9010;19;22161288;9010;408;10198;10370;5.83;0.35;342.81;13.39;1188;23;3599.00;172
9011;19;22161309;9011;464;10321;10623;5.79;0.36;342.81;13.23;1310;23;3600.00;302
9013;19;22161354;9013;445;10321;10624;5.81;0.36;342.92;13.23;1308;23;3601.00;303
9017;19;22161373;9017;424;10329;10624;5.86;0.36;343.01;13.23;1312;23;3602.00;295
9020;19;22161392;9020;400;10330;10624;5.90;0.37;342.98;13.22;1310;23;3603.00;294
9025;19;22161413;9025;399;10335;10624;5.93;0.37;343.10;13.22;1310;23;3604.00;289
9027;19;22161431;9027;393;10338;10624;5.96;0.37;343.22;13.33;1311;23;3605.00;286
9029;19;22161453;9029;386;10344;10624;5.98;0.37;343.28;13.33;1315;23;3606.00;280
9033;19;22161471;9033;375;10349;10624;5.99;0.37;343.40;13.32;1316;23;3607.00;275
9035;19;22161490;9035;381;10358;10625;6.00;0.37;343.44;13.32;1323;23;3608.00;267
9038;19;22161510;9038;382;10361;10626;6.01;0.37;343.58;13.32;1323;23;3609.00;265
9041;19;22161529;9041;378;10366;10626;5.99;0.37;343.65;13.31;1325;23;3610.00;260
9043;19;22161549;9043;386;10368;10627;5.98;0.37;343.65;13.31;1325;23;3611.00;259
9044;19;22161581;9044;393;10372;10627;5.98;0.37;343.74;13.31;1328;23;3612.00;255
9048;19;22161606;9048;402;10375;10627;5.93;0.37;343.81;13.31;1327;23;3613.00;252
9050;19;22161628;9050;405;10376;10627;5.86;0.36;343.85;13.31;1326;23;3614.00;251
9055;19;22161648;9055;402;10380;10631;5.76;0.36;343.88;13.31;1325;23;3615.00;251
9056;19;22161678;9056;400;10381;10631;5.69;0.35;343.92;13.31;1325;23;3616.00;250
9057;19;22161697;9057;399;10383;10631;5.62;0.35;343.89;13.31;1326;23;3617.00;248
9059;19;22161716;9059;406;10386;10634;5.57;0.34;343.89;13.32;1327;23;3618.00;248
9061;19;22161736;9061;411;10389;10634;5.54;0.34;343.82;13.32;1328;23;3619.00;245
9066;19;22161754;9066;412;10391;10634;5.56;0.34;343.83;13.32;1325;23;3620.00;243
9067;19;22161772;9067;411;10394;10638;5.64;0.35;343.87;13.31;1327;23;3621.00;244
9069;19;22161795;9069;415;10396;10639;5.73;0.35;343.93;13.31;1327;23;3622.00;243
9070;19;22161818;9070;418;10397;10639;5.80;0.36;343.98;13.31;1327;23;3623.00;242
9073;19;22161838;9073;427;10401;10643;5.82;0.36;344.04;13.31;1328;23;3624.00;242
9076;19;22161858;9076;429;10404;10643;5.84;0.36;344.12;13.31;1328;23;3625.00;239
9078;19;22161880;9078;423;10407;10643;5.77;0.35;344.08;13.32;1329;23;3626.00;236
9083;19;22161900;9083;434;10409;10644;5.73;0.35;344.13;13.32;1326;23;3627.00;235
9087;19;22161919;9087;440;10411;10644;5.67;0.35;344.22;13.32;1324;23;3628.00;233
9088;19;22161938;9088;445;10417;10650;5.67;0.35;344.27;13.33;1329;23;3629.00;233
9092;19;22161960;9092;452;10421;10650;5.61;0.34;344.29;13.33;1329;23;3630.00;229
9094;19;22161981;9094;456;10423;10651;5.58;0.34;344.35;13.33;1329;23;3631.00;228
9096;19;22161999;9096;464;10424;10651;5.53;0.34;344.37;13.33;1328;23;3632.00;227
9100;19;22162018;9100;478;10431;10651;5.44;0.33;344.58;13.45;1331;23;3633.00;220
9103;19;22162036;9103;484;10433;10651;5.35;0.33;344.60;13.51;1330;23;3634.00;218
9106;19;22162055;9106;494;10439;10651;5.22;0.32;344.70;13.63;1333;23;3635.00;212
9106;19;22162074;9106;510;10449;10663;5.13;0.31;344.70;13.62;1343;23;3636.00;214
9109;19;22162094;9109;511;10450;10663;5.04;0.31;344.73;13.62;1341;23;3637.00;213
9111;19;22162114;9111;524;10452;10663;4.98;0.31;344.75;13.68;1341;23;3638.00;211
9115;19;22162131;9115;530;10454;10663;4.95;0.30;344.79;13.74;1339;23;3639.00;209
9118;19;22162148;9118;539;10454;10663;4.91;0.30;344.94;13.74;1336;23;3640.00;209
9123;19;22162166;9123;553;10459;10663;4.83;0.30;344.94;13.80;1336;23;3641.00;204
9125;19;22162184;9125;561;10462;10667;4.84;0.30;344.99;13.80;1337;23;3642.00;205
9126;19;22162202;9126;573;10465;10667;4.80;0.29;345.03;13.91;1339;23;3643.00;202
9127;19;22162219;9127;581;10470;10671;4.83;0.30;345.00;13.96;1343;23;3644.00;201
9130;20;22162237;9130;589;10473;10673;4.80;0.29;345.10;13.96;1343;24;3645.00;200
9131;20;22162274;9131;588;10475;10673;4.80;0.29;345.08;14.02;1344;24;3646.00;198
9134;20;22162291;9134;592;10477;10673;4.76;0.29;345.04;14.08;1343;24;3647.00;196
9135;20;22162308;9135;599;10487;10686;4.75;0.29;345.06;14.12;1352;24;3648.00;199
9138;20;22162329;9138;600;10488;10686;4.74;0.29;345.12;14.18;1350;24;3649.00;198
9139;20;22162347;9139;600;10490;10686;4.73;0.29;345.16;14.23;1351;24;3650.00;196
9142;20;22162364;9142;601;10492;10687;4.70;0.29;345.28;14.29;1350;24;3651.00;195
9146;20;22162382;9146;593;10493;10688;4.64;0.29;345.47;14.34;1347;24;3652.00;195
9147;20;22162401;9147;591;10494;10688;4.61;0.28;345.46;14.39;1347;24;3653.00;194
9148;20;22162418;9148;589;10497;10691;4.62;0.28;345.43;14.39;1349;24;3654.00;194
9150;20;22162436;9150;596;10500;10691;4.58;0.28;345.39;14.45;1350;24;3655.00;191
9152;20;22162453;9152;598;10501;10691;4.53;0.28;345.33;14.50;1349;24;3656.00;190
9157;20;22162470;9157;599;10503;10691;4.49;0.28;345.32;14.55;1346;24;3657.00;188
9158;20;22162488;9158;603;10509;10697;4.52;0.28;345.30;14.55;1351;24;3658.00;188
9161;20;22162505;9161;613;10511;10697;4.50;0.28;345.36;14.65;1350;24;3659.00;186
9163;20;22162523;9163;617;10511;10697;4.49;0.28;345.35;14.65;1348;24;3660.00;186
9165;20;22162540;9165;620;10513;10697;4.49;0.27;345.35;14.75;1348;24;3661.00;184
9171;20;22162556;9171;631;10516;10701;4.40;0.27;345.36;14.75;1345;24;3662.00;185
9176;20;22162573;9176;635;10519;10702;4.33;0.26;345.42;14.84;1343;24;3663.00;183
9178;20;22162590;9178;638;10519;10702;4.32;0.26;345.36;14.84;1341;24;3664.00;183
9183;20;22162606;9183;638;10520;10703;4.26;0.26;345.35;14.84;1337;24;3665.00;183
9187;20;22162624;9187;640;10521;10703;4.19;0.26;345.35;14.88;1334;24;3666.00;182
9190;20;22162640;9190;651;10522;10703;4.15;0.25;345.30;14.93;1332;24;3667.00;181
9192;20;22162656;9192;657;10522;10703;4.09;0.25;345.25;14.93;1330;24;3668.00;181
9195;20;22162672;9195;659;10522;10703;4.03;0.25;345.23;14.93;1327;24;3669.00;181
9200;20;22162688;9200;664;10522;10703;3.99;0.24;345.13;14.93;1322;24;3670.00;181
9203;20;22162705;9203;668;10522;10703;3.93;0.24;345.09;14.93;1319;24;3671.00;181
9205;20;22162721;9205;677;10558;10773;4.12;0.25;345.09;14.88;1353;24;3672.00;215
9207;20;22162748;9207;681;10558;10774;4.04;0.25;345.17;14.88;1351;24;3673.00;216
9209;20;22162765;9209;681;10564;10774;3.97;0.24;345.17;14.87;1355;24;3674.00;210
9211;20;22162781;9211;678;10573;10774;3.95;0.24;345.15;14.86;1362;24;3675.00;201
9213;20;22162796;9213;671;10577;10774;3.85;0.24;345.10;14.86;1364;24;3676.00;197
9218;20;22162812;9218;667;10578;10774;3.78;0.23;345.01;14.86;1360;24;3677.00;196
9221;20;22162829;9221;653;10580;10774;3.77;0.23;345.03;14.86;1359;24;3678.00;194
9223;20;22162846;9223;631;10581;10774;3.79;0.23;345.01;14.86;1358;24;3679.00;193
9227;20;22162862;9227;624;10584;10775;3.82;0.23;344.91;14.85;1357;24;3680.00;191
9230;20;22162879;9230;615;10585;10776;3.88;0.24;344.86;14.85;1355;24;3681.00;191
9232;20;22162900;9232;607;10587;10776;3.94;0.24;344.85;14.85;1355;24;3682.00;189
9235;20;22162920;9235;601;10590;10780;3.96;0.24;344.90;14.85;1355;24;3683.00;190
9236;20;22162939;9236;593;10590;10780;3.99;0.24;344.91;14.85;1354;24;3684.00;190
9239;20;22162969;9239;571;10590;10780;4.06;0.25;344.88;14.85;1351;24;3685.00;190
9241;20;22162989;9241;570;10590;10780;4.10;0.25;344.86;14.85;1349;24;3686.00;190
9244;20;22163008;9244;576;10594;10786;4.16;0.25;344.86;14.84;1350;24;3687.00;192
9246;20;22163026;9246;565;10594;10786;4.21;0.26;344.87;14.84;1348;24;3688.00;192
9248;20;22163044;9248;562;10595;10786;4.23;0.26;344.86;14.84;1347;24;3689.00;191
9251;20;22163064;9251;557;10598;10792;4.32;0.26;344.86;14.84;1347;24;3690.00;194
9252;20;22163082;9252;552;10598;10792;4.45;0.27;344.87;14.84;1346;24;3691.00;194
9256;20;22163100;9256;550;10599;10792;4.47;0.27;344.89;14.84;1343;24;3692.00;193
9257;20;22163124;9257;536;10600;10793;4.52;0.28;344.89;14.84;1343;24;3693.00;193
9260;20;22163141;9260;542;10601;10794;4.54;0.28;344.87;14.84;1341;24;3694.00;193
9264;20;22163160;9264;542;10601;10794;4.57;0.28;344.84;14.84;1337;24;3695.00;193
9267;20;22163180;9267;544;10611;10807;4.69;0.29;344.79;14.82;1344;24;3696.00;196
9269;20;22163199;9269;549;10611;10807;4.71;0.29;344.77;14.82;1342;24;3697.00;196
9273;20;22163218;9273;548;10614;10807;4.69;0.29;344.78;14.82;1341;24;3698.00;193
9277;20;22163236;9277;547;10615;10808;4.72;0.29;344.79;14.82;1338;24;3699.00;193
9281;20;22163255;9281;545;10615;10808;4.73;0.29;344.87;14.82;1334;24;3700.00;193
9285;20;22163280;9285;548;10618;10812;4.77;0.29;344.92;14.82;1333;24;3701.00;194
9289;20;22163299;9289;550;10619;10812;4.78;0.29;344.97;14.82;1330;24;3702.00;193
9293;20;22163318;9293;552;10623;10816;4.80;0.29;345.11;14.81;1330;24;3703.00;193
9298;20;22163336;9298;553;10623;10816;4.79;0.29;345.08;14.81;1325;24;3704.00;193
9301;20;22163355;9301;555;10623;10816;4.80;0.29;345.14;14.81;1322;24;3705.00;193
9303;20;22163372;9303;550;10624;10816;4.79;0.29;345.14;14.81;1321;24;3706.00;192
9307;20;22163391;9307;545;10624;10816;4.79;0.29;345.24;14.81;1317;24;3707.00;192
9310;20;22163411;9310;546;10635;10828;4.86;0.30;345.33;14.80;1325;24;3708.00;193
9316;20;22163431;9316;540;10635;10828;4.85;0.29;345.39;14.80;1319;24;3709.00;193
9319;20;22163449;9319;541;10635;10828;4.88;0.30;345.43;14.80;1316;24;3710.00;193
9325;20;22163467;9325;533;10635;10828;4.83;0.29;345.60;14.80;1310;24;3711.00;193
9328;20;22163485;9328;531;10635;10828;4.84;0.29;345.66;14.80;1307;24;3712.00;193
9332;20;22163503;9332;527;10635;10828;4.86;0.29;345.73;14.80;1303;24;3713.00;193
9334;20;22163521;9334;523;10635;10829;4.84;0.29;345.80;14.80;1301;24;3714.00;194
9339;20;22163539;9339;524;10635;10829;4.78;0.29;345.96;14.80;1296;24;3715.00;194
9342;20;22163566;9342;528;10640;10835;4.76;0.29;345.97;14.79;1298;24;3716.00;195
9344;20;22163583;9344;535;10641;10836;4.71;0.29;346.04;14.79;1297;24;3717.00;195
9348;20;22163600;9348;530;10641;10836;4.59;0.28;346.05;14.79;1293;24;3718.00;195
9354;20;22163626;9354;538;10641;10836;4.53;0.27;346.08;14.79;1287;24;3719.00;195
9357;20;22163655;9357;539;10645;10841;4.49;0.27;346.09;14.78;1288;24;3720.00;196
9358;20;22163676;9358;542;10645;10841;4.45;0.27;346.06;14.78;1287;24;3721.00;196
9362;20;22163696;9362;528;10645;10841;4.41;0.27;346.08;14.78;1283;24;3722.00;196
9365;20;22163715;9365;518;10646;10842;4.40;0.27;346.15;14.78;1281;24;3723.00;196
9366;20;22163733;9366;508;10649;10846;4.41;0.27;346.13;14.78;1283;24;3724.00;197
9371;20;22163751;9371;492;10649;10846;4.43;0.27;346.21;14.78;1278;24;3725.00;197
9373;20;22163771;9373;485;10652;10849;4.46;0.27;346.27;14.82;1279;24;3726.00;197
9375;20;22163790;9375;482;10652;10849;4.47;0.27;346.28;14.82;1277;24;3727.00;197
9378;20;22163809;9378;481;10653;10849;4.48;0.27;346.39;14.82;1275;24;3728.00;196
9380;20;22163830;9380;483;10653;10849;4.49;0.27;346.47;14.82;1273;24;3729.00;196
9384;20;22163848;9384;477;10657;10853;4.53;0.28;346.60;14.81;1273;24;3730.00;196
9386;20;22163867;9386;463;10657;10853;4.53;0.28;346.75;14.81;1271;24;3731.00;196
9387;20;22163885;9387;452;10657;10853;4.58;0.28;346.83;14.81;1270;24;3732.00;196
9388;20;22163903;9388;448;10657;10853;4.60;0.28;346.87;14.81;1269;24;3733.00;196
9389;20;22163922;9389;441;10657;10854;4.61;0.28;346.97;14.81;1268;24;3734.00;197
9393;20;22163940;9393;431;10659;10856;4.64;0.28;346.97;14.81;1266;24;3735.00;197
9394;20;22163962;9394;429;10659;10856;4.67;0.28;346.96;14.81;1265;24;3736.00;197
9397;20;22163981;9397;426;10660;10857;4.70;0.29;347.13;14.81;1263;24;3737.00;197
9400;20;22164001;9400;426;10660;10857;4.67;0.28;347.27;14.81;1260;24;3738.00;197
9402;20;22164021;9402;432;10660;10857;4.70;0.29;347.27;14.81;1258;24;3739.00;197
9403;20;22164039;9403;439;10660;10857;4.67;0.28;347.25;14.81;1257;24;3740.00;197
9406;20;22164057;9406;441;10660;10857;4.67;0.28;347.30;14.81;1254;24;3741.00;197
9408;20;22164075;9408;444;10660;10857;4.69;0.28;347.34;14.81;1252;24;3742.00;197
9409;20;22164096;9409;434;10660;10857;4.71;0.29;347.40;14.81;1251;24;3743.00;197
9412;20;22164114;9412;466;10737;10984;4.87;0.30;347.38;14.70;1325;24;3744.00;247
9413;20;22164144;9413;443;10737;10985;4.94;0.31;347.36;14.70;1324;24;3745.00;248
9415;20;22164163;9415;432;10741;10985;5.04;0.31;347.49;14.70;1326;24;3746.00;244
9417;20;22164183;9417;420;10741;10985;5.12;0.32;347.51;14.70;1324;24;3747.00;244
9417;20;22164202;9417;422;10745;10985;5.22;0.32;347.51;14.69;1328;24;3748.00;240
9418;20;22164221;9418;412;10746;10985;5.26;0.32;347.52;14.69;1328;24;3749.00;239
9419;20;22164242;9419;412;10750;10990;5.24;0.32;347.51;14.69;1331;24;3750.00;240
9420;20;22164265;9420;409;10752;10990;5.25;0.32;347.49;14.69;1332;24;3751.00;238
9423;20;22164284;9423;414;10754;10991;5.22;0.32;347.48;14.69;1331;24;3752.00;237
9424;20;22164302;9424;426;10757;10992;5.23;0.32;347.48;14.68;1333;24;3753.00;235
9427;20;22164321;9427;426;10759;10992;5.21;0.32;347.46;14.68;1332;24;3754.00;233
9429;20;22164342;9429;429;10762;10993;5.17;0.32;347.50;14.68;1333;24;3755.00;231
9433;20;22164364;9433;441;10766;10993;5.12;0.31;347.51;14.68;1333;24;3756.00;227
9433;20;22164382;9433;444;10768;10993;5.11;0.31;347.51;14.68;1335;24;3757.00;225
9435;20;22164401;9435;447;10770;10993;5.12;0.31;347.50;14.68;1335;24;3758.00;223
9436;20;22164423;9436;457;10775;10997;5.10;0.31;347.48;14.68;1339;24;3759.00;222
9438;20;22164446;9438;452;10777;10997;5.10;0.31;347.46;14.68;1339;24;3760.00;220
9439;20;22164467;9439;455;10778;10997;5.13;0.31;347.44;14.68;1339;24;3761.00;219
9441;20;22164487;9441;460;10781;11000;5.10;0.31;347.41;14.68;1340;24;3762.00;219
9441;20;22164508;9441;459;10783;11000;5.12;0.31;347.41;14.68;1342;24;3763.00;217
9441;20;22164531;9441;463;10784;11000;5.12;0.31;347.41;14.68;1343;24;3764.00;216
9443;20;22164551;9443;462;10788;11004;5.11;0.31;347.47;14.68;1345;24;3765.00;216
9447;20;22164572;9447;454;10789;11005;5.12;0.31;347.43;14.68;1342;24;3766.00;216
9447;20;22164595;9447;445;10793;11005;5.15;0.32;347.43;14.72;1346;24;3767.00;212
9450;20;22164618;9450;441;10795;11009;5.18;0.32;347.59;14.72;1345;24;3768.00;214
9451;20;22164643;9451;437;10796;11009;5.24;0.32;347.57;14.72;1345;24;3769.00;213
9452;20;22164666;9452;429;10797;11009;5.30;0.32;347.66;14.72;1345;24;3770.00;212
9453;20;22164687;9453;425;10798;11010;5.37;0.33;347.64;14.71;1345;24;3771.00;212
9454;20;22164711;9454;421;10798;11010;5.40;0.33;347.62;14.71;1344;24;3772.00;212
9454;20;22164738;9454;419;10803;11016;5.44;0.33;347.62;14.71;1349;24;3773.00;213
9456;20;22164775;9456;422;10803;11016;5.39;0.33;347.62;14.71;1347;24;3774.00;213
9458;20;22164800;9458;414;10803;11017;5.31;0.33;347.67;14.71;1345;24;3775.00;214
9461;20;22164827;9461;418;10803;11017;5.24;0.32;347.78;14.71;1342;24;3776.00;214
9466;20;22164851;9466;421;10803;11017;5.17;0.32;347.81;14.71;1337;24;3777.00;214
9469;20;22164873;9469;414;10804;11017;5.11;0.31;347.77;14.71;1335;24;3778.00;213
9475;20;22164897;9475;417;10805;11017;5.07;0.31;347.96;14.71;1330;24;3779.00;212
9481;20;22164932;9481;410;10830;11053;5.13;0.31;347.96;14.74;1349;24;3780.00;223
9486;20;22164969;9486;415;10832;11053;5.11;0.31;348.02;14.73;1346;24;3781.00;221
9491;20;22164992;9491;402;10833;11053;5.13;0.31;348.19;14.73;1342;24;3782.00;220
9494;20;22165018;9494;412;10833;11053;5.14;0.31;348.24;14.73;1339;24;3783.00;220
9496;20;22165037;9496;412;10834;11053;5.17;0.32;348.35;14.73;1338;24;3784.00;219
9499;20;22165065;9499;401;10834;11053;5.18;0.32;348.35;14.73;1335;24;3785.00;219
9503;20;22165092;9503;400;10837;11057;5.12;0.31;348.50;14.73;1334;24;3786.00;220
9507;20;22165113;9507;406;10838;11057;5.12;0.31;348.68;14.78;1331;24;3787.00;219
9511;20;22165132;9511;407;10843;11061;5.12;0.31;348.68;14.78;1332;24;3788.00;218
9513;20;22165161;9513;399;10844;11062;5.13;0.31;348.74;14.78;1331;24;3789.00;218
9517;20;22165184;9517;407;10844;11062;5.11;0.31;348.79;14.78;1327;24;3790.00;218
9520;20;22165203;9520;414;10844;11062;5.09;0.31;348.95;14.78;1324;24;3791.00;218
9525;20;22165221;9525;411;10853;11075;5.11;0.31;348.96;14.77;1328;24;3792.00;222
9527;20;22165241;9527;416;10855;11075;5.15;0.32;348.92;14.77;1328;24;3793.00;220
9528;20;22165263;9528;414;10855;11075;5.15;0.32;348.96;14.77;1327;24;3794.00;220
9532;20;22165281;9532;411;10856;11076;5.15;0.32;348.97;14.76;1324;24;3795.00;220
9535;20;22165300;9535;412;10856;11077;5.13;0.31;349.05;14.76;1321;24;3796.00;221
9535;20;22165319;9535;410;10856;11077;5.11;0.31;349.05;14.76;1321;24;3797.00;221
9541;20;22165338;9541;411;10860;11080;5.04;0.31;349.15;14.76;1319;24;3798.00;220
9543;20;22165357;9543;413;10861;11080;5.01;0.31;349.13;14.76;1318;24;3799.00;219
9546;20;22165377;9546;416;10862;11080;4.95;0.30;349.12;14.76;1316;24;3800.00;218
9550;20;22165402;9550;428;10863;11080;4.93;0.30;349.08;14.82;1313;24;3801.00;217
9550;20;22165420;9550;444;10868;11086;4.98;0.31;349.08;14.81;1318;24;3802.00;218
9553;20;22165439;9553;448;10868;11086;4.96;0.30;349.06;14.81;1315;24;3803.00;218
9556;20;22165458;9556;454;10868;11086;4.94;0.30;349.10;14.81;1312;24;3804.00;218
9562;20;22165478;9562;455;10870;11086;4.86;0.30;349.06;14.92;1308;24;3805.00;216
9562;21;22165498;9562;464;10873;11090;4.84;0.30;349.06;14.92;1311;25;3806.00;217
9565;21;22165539;9565;473;10874;11091;4.81;0.29;349.15;14.92;1309;25;3807.00;217
9566;21;22165558;9566;483;10876;11091;4.78;0.29;349.17;15.03;1310;25;3808.00;215
9566;21;22165579;9566;476;10877;11092;4.78;0.29;349.17;15.03;1311;25;3809.00;215
9568;21;22165599;9568;487;10878;11092;4.75;0.29;349.24;15.08;1310;25;3810.00;214
9571;21;22165621;9571;488;10879;11092;4.70;0.29;349.34;15.14;1308;25;3811.00;213
9573;21;22165655;9573;500;10880;11092;4.65;0.28;349.32;15.19;1307;25;3812.00;212
9574;21;22165678;9574;499;10880;11092;4.66;0.28;349.29;15.19;1306;25;3813.00;212
9577;21;22165702;9577;513;10880;11092;4.62;0.28;349.29;15.19;1303;25;3814.00;212
9579;21;22165723;9579;518;10881;11092;4.61;0.28;349.34;15.25;1302;25;3815.00;211
9580;21;22165746;9580;520;10918;11162;4.84;0.30;349.35;15.20;1338;25;3816.00;244
9581;21;22165779;9581;524;10920;11163;4.81;0.29;349.36;15.20;1339;25;3817.00;243
9585;21;22165801;9585;520;10928;11163;4.81;0.29;349.38;15.25;1343;25;3818.00;235
9586;21;22165819;9586;520;10933;11163;4.76;0.29;349.34;15.25;1347;25;3819.00;230
9586;21;22165837;9586;524;10935;11163;4.73;0.29;349.34;15.24;1349;25;3820.00;228
9592;21;22165853;9592;528;10938;11163;4.64;0.28;349.37;15.30;1346;25;3821.00;225
9593;21;22165871;9593;532;10940;11163;4.56;0.28;349.35;15.30;1347;25;3822.00;223
9596;21;22165889;9596;531;10944;11163;4.47;0.27;349.33;15.42;1348;25;3823.00;219
9598;21;22165907;9598;522;10948;11164;4.45;0.27;349.26;15.48;1350;25;3824.00;216
9599;21;22165926;9599;525;10952;11166;4.42;0.27;349.26;15.53;1353;25;3825.00;214
9600;21;22165946;9600;533;10955;11166;4.41;0.27;349.26;15.53;1355;25;3826.00;211
9602;21;22165964;9602;530;10961;11170;4.36;0.26;349.21;15.64;1359;25;3827.00;209
9602;21;22165982;9602;523;10961;11170;4.33;0.26;349.21;15.64;1359;25;3828.00;209
9605;21;22166000;9605;529;10961;11170;4.30;0.26;349.24;15.64;1356;25;3829.00;209
9607;21;22166019;9607;530;10963;11170;4.26;0.26;349.18;15.76;1356;25;3830.00;207
9608;21;22166037;9608;529;10968;11176;4.27;0.26;349.24;15.75;1360;25;3831.00;208
9610;21;22166054;9610;533;10968;11176;4.23;0.26;349.22;15.75;1358;25;3832.00;208
9610;21;22166072;9610;546;10970;11176;4.20;0.26;349.22;15.87;1360;25;3833.00;206
9612;21;22166092;9612;556;10973;11179;4.19;0.25;349.17;15.92;1361;25;3834.00;206
9612;21;22166114;9612;548;10974;11179;4.17;0.25;349.17;15.98;1362;25;3835.00;205
9614;21;22166132;9614;540;10975;11179;4.19;0.25;349.13;15.98;1361;25;3836.00;204
9618;21;22166151;9618;535;10977;11180;4.17;0.25;349.07;16.09;1359;25;3837.00;203
9620;21;22166172;9620;537;10978;11181;4.20;0.26;349.12;16.09;1358;25;3838.00;203
9622;21;22166192;9622;543;10978;11181;4.21;0.26;349.09;16.09;1356;25;3839.00;203
9624;21;22166213;9624;546;10998;11207;4.25;0.26;349.07;16.17;1374;25;3840.00;209
9628;21;22166235;9628;551;10999;11207;4.18;0.25;349.01;16.17;1371;25;3841.00;208
9633;21;22166261;9633;559;11004;11207;4.13;0.25;348.88;16.28;1371;25;3842.00;203
9635;21;22166281;9635;564;11005;11208;4.11;0.25;348.92;16.28;1370;25;3843.00;203
9637;21;22166299;9637;565;11006;11208;4.09;0.25;348.88;16.33;1369;25;3844.00;202
9638;21;22166318;9638;558;11011;11212;4.09;0.25;348.89;16.38;1373;25;3845.00;201
9640;21;22166345;9640;563;11013;11214;4.04;0.25;348.90;16.43;1373;25;3846.00;201
9640;22;22166371;9640;562;11018;11218;4.05;0.25;348.90;16.48;1378;26;3847.00;200
9642;22;22166400;9642;560;11018;11218;3.99;0.24;348.92;16.48;1376;26;3848.00;200
9645;22;22166422;9645;565;11018;11218;3.92;0.24;348.89;16.48;1373;26;3849.00;200
9647;22;22166448;9647;561;11020;11218;3.90;0.24;348.87;16.58;1373;26;3850.00;198
9650;22;22166482;9650;562;11020;11218;3.90;0.24;348.84;16.58;1370;26;3851.00;198
9651;22;22166507;9651;560;11029;11230;3.96;0.24;348.85;16.57;1378;26;3852.00;201
9653;22;22166532;9653;559;11029;11230;4.00;0.24;348.83;16.57;1376;26;3853.00;201
9656;22;22166552;9656;556;11029;11230;4.05;0.25;348.85;16.57;1373;26;3854.00;201
9657;22;22166573;9657;556;11029;11230;4.12;0.25;348.86;16.57;1372;26;3855.00;201
9660;22;22166596;9660;555;11029;11230;4.14;0.25;348.84;16.57;1369;26;3856.00;201
9662;22;22166617;9662;552;11029;11230;4.15;0.25;348.83;16.57;1367;26;3857.00;201
9665;22;22166639;9665;550;11030;11231;4.18;0.25;348.92;16.57;1365;26;3858.00;201
9666;22;22166663;9666;535;11030;11231;4.20;0.26;348.94;16.57;1364;26;3859.00;201
9671;22;22166685;9671;534;11035;11237;4.23;0.26;348.90;16.56;1364;26;3860.00;202
9673;22;22166705;9673;528;11036;11238;4.25;0.26;348.88;16.56;1363;26;3861.00;202
9679;22;22166727;9679;523;11036;11238;4.23;0.26;348.90;16.56;1357;26;3862.00;202
9681;22;22166750;9681;520;11036;11238;4.26;0.26;348.93;16.56;1355;26;3863.00;202
9687;22;22166770;9687;514;11039;11242;4.31;0.26;349.00;16.56;1352;26;3864.00;203
9693;22;22166790;9693;517;11039;11242;4.33;0.26;349.09;16.56;1346;26;3865.00;203
9695;22;22166812;9695;514;11039;11242;4.33;0.26;349.15;16.56;1344;26;3866.00;203
9701;22;22166831;9701;511;11040;11243;4.36;0.27;349.27;16.55;1339;26;3867.00;203
9705;22;22166850;9705;512;11043;11247;4.41;0.27;349.40;16.55;1338;26;3868.00;204
9708;22;22166869;9708;512;11043;11247;4.43;0.27;349.37;16.55;1335;26;3869.00;204
9713;22;22166889;9713;513;11047;11253;4.48;0.27;349.40;16.54;1334;26;3870.00;206
9720;22;22166910;9720;509;11047;11253;4.46;0.27;349.67;16.54;1327;26;3871.00;206
9723;22;22166930;9723;507;11049;11253;4.49;0.27;349.67;16.54;1326;26;3872.00;204
9727;22;22166948;9727;500;11049;11253;4.48;0.27;349.80;16.54;1322;26;3873.00;204
9731;22;22166966;9731;494;11053;11257;4.48;0.27;349.90;16.54;1322;26;3874.00;204
9734;22;22166986;9734;496;11053;11257;4.49;0.27;349.90;16.54;1319;26;3875.00;204
9738;22;22167004;9738;480;11053;11257;4.47;0.27;349.94;16.54;1315;26;3876.00;204
9740;22;22167021;9740;475;11053;11257;4.46;0.27;349.90;16.54;1313;26;3877.00;204
9740;22;22167040;9740;479;11053;11258;4.54;0.28;349.90;16.54;1313;26;3878.00;205
9744;22;22167058;9744;470;11054;11259;4.56;0.28;349.91;16.53;1310;26;3879.00;205
9746;22;22167079;9746;471;11054;11259;4.58;0.28;350.00;16.53;1308;26;3880.00;205
9748;22;22167097;9748;471;11055;11260;4.64;0.28;350.01;16.53;1307;26;3881.00;205
9750;22;22167116;9750;468;11055;11260;4.66;0.28;350.00;16.53;1305;26;3882.00;205
9754;22;22167134;9754;464;11055;11260;4.65;0.28;349.97;16.53;1301;26;3883.00;205
9759;22;22167153;9759;458;11055;11260;4.70;0.29;350.13;16.53;1296;26;3884.00;205
9759;22;22167172;9759;466;11055;11260;4.74;0.29;350.13;16.53;1296;26;3885.00;205
9764;22;22167193;9764;464;11055;11260;4.77;0.29;350.17;16.53;1291;26;3886.00;205
9768;22;22167214;9768;468;11055;11260;4.82;0.29;350.20;16.53;1287;26;3887.00;205
9771;22;22167233;9771;489;11127;11387;5.08;0.31;350.24;16.43;1356;26;3888.00;260
9773;22;22167265;9773;475;11129;11388;5.06;0.31;350.22;16.42;1356;26;3889.00;259
9776;22;22167283;9776;472;11133;11388;5.08;0.31;350.29;16.42;1357;26;3890.00;255
9779;22;22167303;9779;479;11135;11388;5.06;0.31;350.33;16.42;1356;26;3891.00;253
9784;22;22167323;9784;470;11139;11388;5.06;0.31;350.48;16.41;1355;26;3892.00;249
9785;22;22167346;9785;474;11139;11388;5.05;0.31;350.51;16.41;1354;26;3893.00;249
9788;22;22167368;9788;477;11141;11388;5.00;0.31;350.55;16.41;1353;26;3894.00;247
9792;23;22167397;9792;485;11143;11388;4.93;0.30;350.71;16.41;1351;27;3895.00;245
9796;23;22167431;9796;490;11145;11389;4.82;0.30;350.76;16.41;1349;27;3896.00;244
9801;23;22167451;9801;488;11151;11390;4.75;0.29;350.82;16.46;1350;27;3897.00;239
9804;23;22167471;9804;485;11153;11390;4.70;0.29;350.89;16.46;1349;27;3898.00;237
9806;23;22167492;9806;485;11155;11391;4.68;0.29;350.89;16.46;1349;27;3899.00;236
9807;23;22167518;9807;496;11161;11406;4.65;0.29;350.93;16.51;1354;27;3900.00;245
9812;23;22167547;9812;488;11163;11406;4.60;0.28;351.02;16.51;1351;27;3901.00;243
9813;23;22167567;9813;490;11167;11406;4.60;0.28;350.99;16.57;1354;27;3902.00;239
9816;23;22167587;9816;489;11170;11410;4.63;0.28;351.17;16.57;1354;27;3903.00;240
9817;23;22167607;9817;499;11171;11410;4.69;0.29;351.20;16.57;1354;27;3904.00;239
9819;23;22167628;9819;508;11174;11410;4.74;0.29;351.25;16.56;1355;28;3905.00;236
9820;23;22167666;9820;501;11176;11413;4.78;0.29;351.22;16.56;1356;28;3906.00;237
9822;23;22167687;9822;488;11180;11413;4.85;0.30;351.22;16.56;1358;28;3907.00;233
9824;23;22167708;9824;481;11182;11413;4.91;0.30;351.35;16.62;1358;28;3908.00;231
9825;23;22167729;9825;478;11187;11417;4.97;0.30;351.35;16.61;1362;28;3909.00;230
9826;23;22167757;9826;479;11189;11418;5.02;0.31;351.33;16.61;1363;28;3910.00;229
9831;23;22167778;9831;484;11193;11418;5.05;0.31;351.40;16.61;1362;28;3911.00;225
9833;23;22167799;9833;479;11196;11422;5.13;0.31;351.49;16.61;1363;28;3912.00;226
9837;23;22167822;9837;485;11197;11422;5.15;0.31;351.60;16.61;1360;28;3913.00;225
9837;23;22167850;9837;488;11198;11422;5.18;0.32;351.60;16.61;1361;28;3914.00;224
9841;23;22167878;9841;490;11201;11424;5.21;0.32;351.60;16.61;1360;28;3915.00;223
9843;23;22167899;9843;494;11202;11424;5.15;0.31;351.64;16.61;1359;28;3916.00;222
9845;23;22167921;9845;491;11208;11430;5.17;0.31;351.77;16.60;1363;28;3917.00;222
9847;23;22167944;9847;492;11208;11430;5.18;0.31;351.83;16.60;1361;28;3918.00;222
9849;23;22167966;9849;488;11208;11431;5.22;0.32;351.95;16.60;1359;28;3919.00;223
9854;23;22167986;9854;487;11209;11431;5.20;0.32;352.03;16.60;1355;28;3920.00;222
9856;23;22168006;9856;487;11209;11431;5.18;0.31;352.04;16.60;1353;28;3921.00;222
9860;23;22168028;9860;480;11211;11431;5.17;0.31;352.12;16.66;1351;28;3922.00;220
9863;23;22168048;9863;480;11213;11431;5.17;0.31;352.17;16.66;1350;28;3923.00;218
9865;23;22168068;9865;478;11221;11443;5.23;0.32;352.18;16.65;1356;28;3924.00;222
9867;23;22168088;9867;488;11222;11443;5.23;0.32;352.25;16.65;1355;28;3925.00;221
9869;23;22168108;9869;491;11225;11443;5.22;0.32;352.33;16.65;1356;28;3926.00;218
9870;23;22168129;9870;490;11225;11443;5.22;0.32;352.32;16.65;1355;28;3927.00;218
9872;23;22168148;9872;486;11227;11443;5.20;0.32;352.39;16.65;1355;28;3928.00;216
9876;23;22168169;9876;495;11227;11443;5.16;0.31;352.50;16.65;1351;28;3929.00;216
9877;23;22168191;9877;497;11230;11447;5.09;0.31;352.52;16.65;1353;28;3930.00;217
9879;23;22168212;9879;497;11230;11447;4.97;0.30;352.62;16.65;1351;28;3931.00;217
9881;23;22168233;9881;495;11234;11451;4.83;0.29;352.60;16.64;1353;28;3932.00;217
9887;23;22168252;9887;502;11235;11452;4.74;0.29;352.59;16.64;1348;28;3933.00;217
9888;23;22168271;9888;509;11235;11452;4.64;0.28;352.64;16.64;1347;28;3934.00;217
9893;23;22168289;9893;512;11235;11452;4.53;0.27;352.74;16.64;1342;28;3935.00;217
9893;23;22168308;9893;520;11246;11465;4.59;0.28;352.74;16.62;1353;28;3936.00;219
9895;23;22168331;9895;517;11246;11465;4.55;0.28;352.77;16.62;1351;28;3937.00;219
9895;23;22168350;9895;512;11246;11465;4.60;0.28;352.77;16.62;1351;28;3938.00;219
9895;23;22168367;9895;509;11248;11466;4.63;0.28;352.77;16.68;1353;28;3939.00;218
9896;23;22168386;9896;505;11248;11467;4.61;0.28;352.81;16.68;1352;28;3940.00;219
9897;23;22168404;9897;506;11248;11467;4.63;0.28;352.80;16.68;1351;28;3941.00;219
9898;23;22168424;9898;501;11250;11470;4.65;0.28;352.81;16.67;1352;28;3942.00;220
9901;23;22168445;9901;509;11250;11470;4.64;0.28;352.80;16.67;1349;28;3943.00;220
9901;23;22168463;9901;505;11251;11470;4.66;0.28;352.80;16.67;1350;28;3944.00;219
9904;23;22168483;9904;499;11251;11470;4.64;0.28;352.86;16.67;1347;28;3945.00;219
9907;23;22168502;9907;505;11256;11476;4.65;0.28;352.88;16.66;1349;28;3946.00;220
9909;23;22168522;9909;506;11256;11476;4.65;0.28;352.92;16.66;1347;28;3947.00;220
9912;23;22168540;9912;507;11257;11476;4.64;0.28;352.92;16.72;1345;28;3948.00;219
9914;23;22168559;9914;508;11257;11476;4.66;0.28;352.94;16.72;1343;28;3949.00;219
9916;23;22168581;9916;510;11260;11480;4.66;0.28;352.98;16.72;1344;28;3950.00;220
9917;23;22168601;9917;517;11261;11481;4.66;0.28;353.02;16.71;1344;28;3951.00;220
9921;23;22168620;9921;517;11262;11481;4.60;0.28;352.98;16.76;1341;28;3952.00;219
9921;23;22168639;9921;515;11263;11482;4.60;0.28;352.98;16.76;1342;28;3953.00;219
9924;23;22168657;9924;515;11263;11482;4.54;0.28;353.01;16.76;1339;28;3954.00;219
9927;23;22168677;9927;518;11265;11482;4.51;0.27;353.00;16.88;1338;28;3955.00;217
9928;23;22168699;9928;519;11265;11482;4.45;0.27;352.99;16.88;1337;28;3956.00;217
9930;23;22168718;9930;520;11265;11482;4.40;0.27;353.00;16.88;1335;28;3957.00;217
9932;23;22168736;9932;519;11265;11482;4.36;0.27;352.96;16.88;1333;28;3958.00;217
9932;23;22168754;9932;516;11265;11482;4.38;0.27;352.96;16.88;1333;28;3959.00;217
9935;23;22168773;9935;523;11323;11607;4.61;0.29;352.94;16.79;1388;28;3960.00;284
9939;23;22168802;9939;512;11323;11608;4.61;0.28;352.96;16.79;1384;28;3961.00;285
9941;23;22168821;9941;517;11331;11608;4.62;0.29;352.94;16.78;1390;28;3962.00;277
9943;23;22168839;9943;516;11333;11608;4.62;0.29;352.95;16.78;1390;28;3963.00;275
9946;23;22168858;9946;530;11339;11608;4.62;0.29;352.90;16.77;1393;28;3964.00;269
9951;23;22168878;9951;529;11340;11608;4.58;0.28;352.85;16.77;1389;28;3965.00;268
9953;23;22168897;9953;544;11346;11608;4.56;0.28;352.81;16.77;1393;28;3966.00;262
9955;23;22168916;9955;555;11349;11608;4.51;0.28;352.79;16.76;1394;28;3967.00;259
9957;23;22168936;9957;558;11354;11609;4.52;0.28;352.78;16.76;1397;28;3968.00;255
9960;23;22168955;9960;553;11358;11610;4.49;0.28;352.69;16.76;1398;28;3969.00;252
9961;23;22168976;9961;562;11361;11610;4.49;0.28;352.66;16.76;1400;28;3970.00;249
9964;23;22168995;9964;560;11367;11614;4.50;0.28;352.68;16.75;1403;28;3971.00;247
9964;23;22169015;9964;565;11369;11614;4.49;0.27;352.68;16.75;1405;28;3972.00;245
9966;23;22169033;9966;558;11369;11614;4.45;0.27;352.64;16.75;1403;28;3973.00;245
9967;23;22169052;9967;566;11369;11614;4.41;0.27;352.60;16.75;1402;28;3974.00;245
9970;23;22169070;9970;572;11374;11620;4.36;0.27;352.64;16.74;1404;28;3975.00;246
9973;23;22169090;9973;579;11375;11620;4.30;0.26;352.63;16.74;1402;28;3976.00;245
9973;23;22169109;9973;591;11375;11620;4.26;0.26;352.63;16.74;1402;28;3977.00;245
9974;23;22169129;9974;595;11377;11623;4.25;0.26;352.64;16.74;1403;28;3978.00;246
9975;23;22169147;9975;600;11377;11623;4.23;0.26;352.63;16.74;1402;28;3979.00;246
9975;23;22169167;9975;607;11379;11623;4.19;0.26;352.63;16.74;1404;28;3980.00;244
9975;23;22169185;9975;605;11379;11624;4.17;0.26;352.63;16.74;1404;28;3981.00;245
9976;23;22169204;9976;615;11380;11625;4.14;0.25;352.63;16.74;1404;28;3982.00;245
9978;23;22169222;9978;619;11383;11625;4.12;0.25;352.64;16.74;1405;28;3983.00;242
9982;23;22169240;9982;623;11392;11638;4.10;0.25;352.58;16.85;1410;28;3984.00;246
9983;23;22169262;9983;625;11392;11638;4.08;0.25;352.54;16.85;1409;28;3985.00;246
9985;23;22169281;9985;632;11394;11638;4.02;0.25;352.55;16.91;1409;28;3986.00;244
9987;23;22169300;9987;639;11396;11639;3.96;0.24;352.56;16.91;1409;28;3987.00;243
9989;23;22169318;9989;642;11398;11639;3.91;0.24;352.59;17.03;1409;28;3988.00;241
9991;23;22169336;9991;649;11401;11643;3.88;0.24;352.63;17.03;1410;28;3989.00;242
9991;23;22169357;9991;652;11402;11643;3.83;0.24;352.63;17.02;1411;28;3990.00;241
9993;23;22169383;9993;663;11407;11647;3.79;0.23;352.62;17.14;1414;28;3991.00;240
9997;23;22169402;9997;651;11407;11647;3.75;0.23;352.56;17.14;1410;28;3992.00;240
9997;23;22169421;9997;649;11407;11647;3.75;0.23;352.56;17.14;1410;28;3993.00;240
9999;23;22169440;9999;648;11409;11647;3.81;0.23;352.61;17.26;1410;28;3994.00;238
9999;23;22169460;9999;646;11409;11647;3.82;0.23;352.61;17.26;1410;28;3995.00;238
10004;23;22169480;10004;646;11417;11659;3.86;0.24;352.50;17.25;1413;28;3996.00;242
10005;23;22169499;10005;638;11417;11659;3.85;0.24;352.50;17.25;1412;28;3997.00;242
10006;23;22169517;10006;642;11421;11659;3.87;0.24;352.57;17.42;1415;28;3998.00;238
10008;23;22169542;10008;639;11421;11659;3.87;0.24;352.54;17.42;1413;28;3999.00;238
10008;23;22169562;10008;637;11422;11659;3.90;0.24;352.54;17.48;1414;28;4000.00;237
10008;23;22169585;10008;634;11422;11659;3.94;0.24;352.54;17.48;1414;28;4001.00;237
10011;23;22169603;10011;631;11422;11660;3.95;0.24;352.51;17.48;1411;28;4002.00;238
10013;23;22169622;10013;631;11422;11660;3.96;0.24;352.53;17.48;1409;28;4003.00;238
10014;23;22169641;10014;623;11429;11666;4.02;0.25;352.53;17.59;1415;28;4004.00;237
10015;23;22169661;10015;626;11431;11668;4.03;0.25;352.55;17.59;1416;28;4005.00;237
10016;23;22169680;10016;622;11433;11668;4.06;0.25;352.53;17.71;1417;28;4006.00;235
10016;23;22169699;10016;620;11433;11668;4.11;0.25;352.53;17.71;1417;28;4007.00;235
10018;23;22169717;10018;613;11437;11672;4.13;0.25;352.48;17.76;1419;28;4008.00;235
10020;23;22169735;10020;615;11437;11672;4.13;0.25;352.45;17.76;1417;28;4009.00;235
10020;23;22169753;10020;614;11437;11672;4.19;0.26;352.45;17.76;1417;28;4010.00;235
10022;23;22169771;10022;610;11438;11673;4.22;0.26;352.55;17.76;1416;28;4011.00;235
10026;23;22169790;10026;613;11441;11677;4.20;0.26;352.54;17.76;1415;28;4012.00;236
10027;23;22169812;10027;615;11441;11677;4.20;0.26;352.55;17.76;1414;28;4013.00;236
10033;23;22169829;10033;612;11443;11680;4.19;0.26;352.75;17.75;1410;28;4014.00;237
10035;23;22169849;10035;612;11443;11680;4.13;0.25;352.80;17.75;1408;28;4015.00;237
10038;23;22169867;10038;610;11444;11680;4.11;0.25;352.78;17.75;1406;28;4016.00;236
10042;23;22169884;10042;605;11444;11680;4.09;0.25;352.72;17.75;1402;28;4017.00;236
10043;23;22169902;10043;612;11448;11684;4.07;0.25;352.70;17.75;1405;28;4018.00;236
10045;23;22169921;10045;613;11448;11684;4.01;0.25;352.72;17.75;1403;28;4019.00;236
10049;23;22169940;10049;610;11448;11684;3.96;0.24;352.67;17.75;1399;28;4020.00;236
10054;23;22169957;10054;615;11448;11684;3.91;0.24;352.84;17.75;1394;28;4021.00;236
10055;23;22169975;10055;611;11448;11685;3.90;0.24;352.82;17.75;1393;28;4022.00;237
10062;23;22169995;10062;617;11449;11686;3.85;0.24;352.79;17.75;1387;28;4023.00;237
10065;23;22170015;10065;613;11449;11686;3.84;0.24;352.87;17.75;1384;28;4024.00;237
10066;23;22170032;10066;601;11450;11687;3.89;0.24;352.88;17.74;1384;28;4025.00;237
10070;23;22170051;10070;591;11450;11687;3.92;0.24;352.86;17.74;1380;28;4026.00;237
10073;23;22170071;10073;591;11450;11687;3.97;0.24;352.84;17.74;1377;28;4027.00;237
10073;23;22170097;10073;584;11451;11687;4.02;0.25;352.84;17.75;1378;28;4028.00;236
10077;23;22170121;10077;572;11451;11687;4.06;0.25;352.92;17.75;1374;28;4029.00;236
10081;23;22170139;10081;574;11451;11687;4.05;0.25;353.05;17.75;1370;28;4030.00;236
10087;23;22170157;10087;567;11451;11687;4.07;0.25;353.10;17.75;1364;28;4031.00;236
10090;23;22170175;10090;559;11511;11814;4.45;0.28;353.19;17.65;1421;28;4032.00;303
10095;23;22170208;10095;547;11515;11815;4.48;0.28;353.27;17.65;1420;28;4033.00;300
10102;23;22170228;10102;539;11523;11815;4.48;0.28;353.41;17.64;1421;28;4034.00;292
10104;23;22170247;10104;525;11528;11815;4.49;0.28;353.47;17.63;1424;28;4035.00;287
10107;23;22170266;10107;516;11533;11815;4.52;0.28;353.49;17.63;1426;28;4036.00;282
10112;23;22170285;10112;506;11534;11815;4.51;0.28;353.66;17.62;1422;28;4037.00;281
10116;23;22170304;10116;509;11537;11815;4.49;0.28;353.67;17.62;1421;28;4038.00;278
10119;23;22170324;10119;513;11539;11815;4.49;0.28;353.72;17.62;1420;28;4039.00;276
10123;23;22170345;10123;516;11540;11816;4.50;0.28;353.86;17.62;1417;28;4040.00;276
10126;23;22170366;10126;513;11541;11817;4.52;0.28;353.96;17.62;1415;28;4041.00;276
10126;23;22170386;10126;513;11541;11817;4.57;0.28;353.96;17.62;1415;28;4042.00;276
10131;23;22170406;10131;523;11543;11818;4.59;0.28;354.08;17.62;1412;28;4043.00;275
10137;23;22170427;10137;523;11544;11818;4.59;0.28;354.17;17.62;1407;28;4044.00;274
10139;23;22170447;10139;522;11546;11818;4.62;0.29;354.13;17.62;1407;28;4045.00;272
10143;23;22170467;10143;528;11548;11818;4.60;0.28;354.12;17.67;1405;28;4046.00;270
10147;23;22170487;10147;519;11552;11822;4.61;0.28;354.11;17.67;1405;28;4047.00;270
10150;23;22170508;10150;511;11553;11822;4.59;0.28;354.19;17.67;1403;28;4048.00;269
10154;23;22170529;10154;515;11554;11822;4.54;0.28;354.37;17.67;1400;28;4049.00;268
10160;23;22170551;10160;506;11557;11828;4.56;0.28;354.55;17.66;1397;28;4050.00;271
10166;23;22170571;10166;497;11557;11828;4.57;0.28;354.79;17.66;1391;28;4051.00;271
10172;23;22170592;10172;496;11562;11828;4.57;0.28;354.82;17.66;1390;28;4052.00;266
10176;23;22170614;10176;503;11567;11832;4.55;0.28;354.85;17.66;1391;28;4053.00;265
10178;23;22170633;10178;504;11568;11833;4.57;0.28;354.92;17.66;1390;28;4054.00;265
10181;23;22170653;10181;512;11570;11833;4.58;0.28;355.02;17.66;1389;28;4055.00;263
10187;23;22170672;10187;505;11572;11837;4.59;0.28;355.14;17.66;1385;28;4056.00;265
10190;23;22170692;10190;508;11573;11837;4.62;0.28;355.35;17.66;1383;28;4057.00;264
10194;23;22170712;10194;503;11576;11837;4.61;0.28;355.41;17.66;1382;28;4058.00;261
10196;23;22170732;10196;502;11578;11838;4.67;0.28;355.45;17.66;1382;28;4059.00;260
10202;23;22170752;10202;491;11579;11838;4.67;0.28;355.61;17.66;1377;28;4060.00;259
10205;23;22170771;10205;492;11583;11844;4.72;0.29;355.72;17.65;1378;28;4061.00;261
10209;23;22170791;10209;495;11586;11844;4.74;0.29;355.79;17.71;1377;28;4062.00;258
10213;23;22170813;10213;498;11588;11845;4.78;0.29;355.94;17.72;1375;28;4063.00;257
10217;23;22170832;10217;498;11589;11845;4.74;0.29;356.13;17.72;1372;28;4064.00;256
10223;23;22170852;10223;495;11589;11845;4.66;0.28;356.29;17.72;1366;28;4065.00;256
10225;23;22170872;10225;502;11590;11845;4.63;0.28;356.46;17.72;1365;28;4066.00;255
10227;23;22170891;10227;503;11591;11845;4.56;0.28;356.54;17.72;1364;28;4067.00;254
10230;23;22170913;10230;510;11600;11857;4.53;0.28;356.59;17.71;1370;28;4068.00;257
10231;23;22170933;10231;516;11600;11857;4.48;0.27;356.62;17.71;1369;28;4069.00;257
10235;23;22170952;10235;523;11601;11857;4.41;0.27;356.82;17.71;1366;28;4070.00;256
10238;23;22170970;10238;526;11601;11857;4.40;0.27;356.79;17.71;1363;28;4071.00;256
10242;23;22170990;10242;524;11603;11857;4.41;0.27;356.91;17.77;1361;28;4072.00;254
10244;23;22171011;10244;531;11603;11857;4.40;0.27;356.95;17.77;1359;28;4073.00;254
10247;23;22171031;10247;535;11607;11861;4.43;0.27;357.14;17.77;1360;28;4074.00;254
10250;23;22171050;10250;541;11607;11861;4.45;0.27;357.18;17.77;1357;28;4075.00;254
10254;23;22171069;10254;545;11611;11865;4.44;0.27;357.17;17.76;1357;28;4076.00;254
10257;23;22171090;10257;543;11614;11866;4.42;0.27;357.28;17.76;1357;28;4077.00;252
10258;23;22171110;10258;546;11614;11866;4.40;0.27;357.32;17.76;1356;28;4078.00;252
10260;23;22171130;10260;556;11614;11866;4.43;0.27;357.35;17.76;1354;28;4079.00;252
10264;23;22171150;10264;566;11635;11895;4.48;0.27;357.50;17.74;1371;28;4080.00;260
10267;23;22171171;10267;557;11635;11895;4.51;0.27;357.53;17.74;1368;28;4081.00;260
10271;23;22171190;10271;541;11636;11895;4.56;0.28;357.51;17.74;1365;28;4082.00;259
10272;23;22171212;10272;536;11639;11896;4.62;0.28;357.55;17.79;1367;28;4083.00;257
10274;23;22171232;10274;530;11639;11897;4.63;0.28;357.59;17.79;1365;28;4084.00;258
10275;23;22171251;10275;531;11640;11897;4.63;0.28;357.62;17.80;1365;28;4085.00;257
10278;23;22171270;10278;536;11642;11900;4.58;0.28;357.60;17.79;1364;28;4086.00;258
10279;23;22171290;10279;537;11642;11900;4.52;0.28;357.63;17.79;1363;28;4087.00;258
10283;23;22171309;10283;543;11644;11900;4.43;0.27;357.63;17.79;1361;28;4088.00;256
10285;23;22171330;10285;549;11645;11900;4.38;0.27;357.67;17.79;1360;28;4089.00;255
10285;23;22171349;10285;553;11650;11906;4.39;0.27;357.67;17.79;1365;28;4090.00;256
10290;23;22171368;10290;564;11651;11906;4.32;0.26;357.83;17.79;1361;28;4091.00;255
10292;23;22171388;10292;554;11651;11906;4.28;0.26;357.87;17.79;1359;28;4092.00;255
10295;23;22171407;10295;549;11652;11906;4.28;0.26;357.85;17.79;1357;28;4093.00;254
10297;23;22171429;10297;556;11654;11910;4.32;0.26;357.86;17.78;1357;28;4094.00;256
10297;23;22171449;10297;560;11657;11912;4.31;0.26;357.86;17.78;1360;28;4095.00;255
10301;23;22171467;10301;561;11658;11912;4.29;0.26;357.92;17.78;1357;28;4096.00;254
10303;23;22171486;10303;553;11660;11913;4.31;0.26;357.97;17.78;1357;28;4097.00;253
10307;23;22171504;10307;552;11661;11913;4.32;0.26;358.18;17.78;1354;28;4098.00;252
10310;23;22171525;10310;554;11661;11913;4.32;0.26;358.34;17.78;1351;28;4099.00;252
10313;23;22171548;10313;553;11661;11913;4.34;0.26;358.36;17.78;1348;28;4100.00;252
10314;23;22171573;10314;552;11661;11913;4.33;0.26;358.38;17.78;1347;28;4101.00;252
10316;23;22171591;10316;550;11661;11913;4.29;0.26;358.42;17.78;1345;28;4102.00;252
10318;23;22171612;10318;559;11661;11913;4.26;0.26;358.41;17.78;1343;28;4103.00;252
10320;23;22171630;10320;574;11702;11983;4.35;0.26;358.54;17.72;1382;28;4104.00;281
10323;23;22171655;10323;561;11703;11984;4.34;0.26;358.57;17.71;1380;28;4105.00;281
10325;23;22171674;10325;566;11709;11984;4.41;0.27;358.62;17.71;1384;28;4106.00;275
10327;23;22171695;10327;571;11709;11984;4.47;0.27;358.68;17.71;1382;28;4107.00;275
10329;23;22171714;10329;574;11714;11984;4.53;0.27;358.70;17.70;1385;28;4108.00;270
10329;23;22171733;10329;571;11714;11984;4.55;0.28;358.70;17.70;1385;28;4109.00;270
10330;23;22171754;10330;579;11717;11984;4.62;0.28;358.70;17.70;1387;28;4110.00;267
10330;23;22171772;10330;580;11720;11984;4.67;0.28;358.70;17.69;1390;28;4111.00;264
10332;23;22171791;10332;588;11723;11985;4.66;0.28;358.71;17.69;1391;28;4112.00;262
10333;23;22171812;10333;586;11729;11986;4.66;0.28;358.70;17.74;1396;28;4113.00;257
10337;23;22171833;10337;583;11730;11986;4.64;0.28;358.68;17.74;1393;28;4114.00;256
10341;23;22171852;10341;577;11733;11990;4.62;0.28;358.72;17.74;1392;28;4115.00;257
10342;23;22171871;10342;575;11733;11990;4.61;0.28;358.70;17.74;1391;28;4116.00;257
10345;23;22171890;10345;577;11733;11990;4.61;0.28;358.75;17.74;1388;28;4117.00;257
10348;23;22171911;10348;570;11733;11990;4.61;0.28;358.74;17.74;1385;28;4118.00;257
10348;23;22171931;10348;570;11738;11996;4.65;0.28;358.74;17.73;1390;28;4119.00;258
10349;23;22171950;10349;568;11738;11996;4.69;0.29;358.72;17.73;1389;28;4120.00;258
10350;23;22171969;10350;573;11738;11996;4.74;0.29;358.74;17.73;1388;28;4121.00;258
10352;23;22171987;10352;569;11740;11999;4.76;0.29;358.72;17.73;1388;28;4122.00;259
10354;23;22172006;10354;568;11740;11999;4.78;0.29;358.71;17.73;1386;28;4123.00;259
10354;23;22172024;10354;560;11741;11999;4.84;0.30;358.71;17.73;1387;28;4124.00;258
10357;23;22172045;10357;556;11741;12000;4.84;0.30;358.71;17.73;1384;28;4125.00;259
10359;23;22172065;10359;567;11742;12001;4.80;0.29;358.69;17.72;1383;28;4126.00;259
10361;23;22172084;10361;564;11742;12001;4.73;0.29;358.69;17.72;1381;28;4127.00;259
10363;23;22172111;10363;565;11752;12014;4.68;0.29;358.79;17.71;1389;28;4128.00;262
10367;23;22172130;10367;565;11753;12014;4.56;0.28;358.79;17.78;1386;28;4129.00;261
10372;23;22172157;10372;570;11754;12014;4.48;0.27;358.73;17.84;1382;28;4130.00;260
10376;23;22172178;10376;571;11755;12015;4.43;0.27;358.72;17.84;1379;28;4131.00;260
10379;23;22172197;10379;573;11756;12015;4.38;0.27;358.74;17.90;1377;28;4132.00;259
10384;23;22172216;10384;569;11761;12019;4.35;0.27;358.82;17.89;1377;28;4133.00;258
10387;23;22172235;10387;570;11762;12019;4.29;0.26;358.80;17.96;1375;28;4134.00;257
10392;23;22172253;10392;569;11765;12023;4.27;0.26;358.74;17.95;1373;28;4135.00;258
10397;23;22172271;10397;567;11765;12023;4.21;0.26;358.71;17.95;1368;28;4136.00;258
10397;23;22172291;10397;569;11765;12023;4.22;0.26;358.71;17.95;1368;28;4137.00;258
10400;23;22172308;10400;570;11765;12023;4.21;0.26;358.71;17.95;1365;28;4138.00;258
10401;23;22172328;10401;564;11765;12023;4.20;0.26;358.78;17.95;1364;28;4139.00;258
10405;23;22172347;10405;563;11783;12057;4.25;0.26;358.75;17.92;1378;28;4140.00;274
10406;23;22172368;10406;565;11784;12057;4.25;0.26;358.75;17.92;1378;28;4141.00;273
10410;23;22172393;10410;565;11787;12057;4.26;0.26;358.74;17.92;1377;28;4142.00;270
10412;23;22172413;10412;566;11789;12057;4.26;0.26;358.81;17.97;1377;28;4143.00;268
10415;23;22172431;10415;555;11789;12057;4.25;0.26;358.88;17.97;1374;28;4144.00;268
10415;23;22172449;10415;556;11789;12057;4.25;0.26;358.88;17.97;1374;28;4145.00;268
10421;23;22172467;10421;560;11789;12058;4.20;0.26;358.84;17.97;1368;28;4146.00;269
10423;23;22172485;10423;564;11789;12058;4.16;0.25;358.79;17.97;1366;28;4147.00;269
10425;23;22172502;10425;565;11793;12064;4.20;0.26;358.74;17.96;1368;28;4148.00;271
10426;23;22172521;10426;557;11793;12065;4.18;0.26;358.71;17.96;1367;28;4149.00;272
10426;23;22172539;10426;556;11797;12065;4.19;0.26;358.71;18.09;1371;28;4150.00;268
10427;23;22172557;10427;552;11798;12065;4.16;0.26;358.68;18.09;1371;28;4151.00;267
10429;23;22172575;10429;554;11801;12069;4.20;0.26;358.69;18.09;1372;28;4152.00;268
10431;23;22172596;10431;554;11803;12069;4.18;0.26;358.65;18.16;1372;28;4153.00;266
10434;23;22172614;10434;552;11804;12069;4.15;0.25;358.66;18.16;1370;28;4154.00;265
10435;24;22172639;10435;559;11805;12070;4.16;0.26;358.66;18.15;1370;29;4155.00;265
10438;24;22172673;10438;573;11810;12074;4.17;0.26;358.74;18.22;1372;29;4156.00;264
10438;24;22172701;10438;570;11810;12074;4.21;0.26;358.74;18.22;1372;29;4157.00;264
10438;24;22172720;10438;573;11813;12077;4.26;0.26;358.74;18.28;1375;29;4158.00;264
10440;24;22172738;10440;574;11814;12077;4.27;0.26;358.71;18.28;1374;29;4159.00;263
10445;24;22172758;10445;573;11814;12077;4.24;0.26;358.79;18.28;1369;29;4160.00;263
10446;24;22172777;10446;580;11815;12077;4.26;0.26;358.80;18.34;1369;29;4161.00;262
10447;24;22172795;10447;581;11820;12081;4.30;0.26;358.83;18.40;1373;29;4162.00;261
10448;24;22172815;10448;580;11820;12081;4.33;0.26;358.89;18.40;1372;29;4163.00;261
10450;24;22172833;10450;582;11821;12081;4.34;0.26;358.92;18.47;1371;29;4164.00;260
10451;24;22172851;10451;588;11823;12081;4.35;0.26;358.93;18.60;1372;29;4165.00;258
10452;24;22172869;10452;586;11824;12082;4.36;0.27;358.95;18.66;1372;29;4166.00;258
10455;24;22172887;10455;580;11825;12083;4.36;0.26;358.97;18.66;1370;29;4167.00;258
10456;24;22172905;10456;584;11825;12083;4.36;0.26;358.96;18.66;1369;29;4168.00;258
10461;24;22172923;10461;581;11827;12084;4.34;0.26;358.90;18.73;1366;29;4169.00;257
10461;24;22172944;10461;587;11829;12084;4.38;0.27;358.90;18.85;1368;29;4170.00;255
10463;24;22172962;10463;586;11830;12084;4.39;0.27;358.90;18.92;1367;29;4171.00;254
10467;24;22172980;10467;586;11830;12084;4.39;0.27;358.88;18.92;1363;29;4172.00;254
10469;24;22172997;10469;591;11832;12086;4.38;0.27;359.00;18.91;1363;29;4173.00;254
10473;24;22173017;10473;580;11832;12086;4.34;0.26;359.00;18.91;1359;29;4174.00;254
10475;24;22173035;10475;577;11832;12086;4.34;0.26;359.10;18.91;1357;29;4175.00;254
10478;24;22173053;10478;586;11886;12213;4.64;0.29;359.22;18.83;1408;29;4176.00;327
10479;24;22173089;10479;577;11891;12214;4.68;0.29;359.32;18.82;1412;29;4177.00;323
10483;24;22173108;10483;573;11900;12214;4.70;0.29;359.53;18.81;1417;29;4178.00;314
10486;24;22173128;10486;564;11905;12214;4.71;0.29;359.48;18.80;1419;29;4179.00;309
10489;24;22173147;10489;559;11908;12214;4.74;0.29;359.50;18.80;1419;29;4180.00;306
10489;24;22173165;10489;560;11911;12214;4.75;0.29;359.50;18.80;1422;29;4181.00;303
10491;24;22173185;10491;559;11915;12214;4.76;0.29;359.49;18.79;1424;29;4182.00;299
10492;24;22173208;10492;561;11916;12214;4.78;0.29;359.56;18.79;1424;29;4183.00;298
10494;25;22173235;10494;561;11918;12215;4.81;0.29;359.73;18.79;1424;30;4184.00;297
10496;25;22173267;10496;558;11921;12217;4.82;0.30;359.70;18.78;1425;30;4185.00;296
10498;25;22173286;10498;562;11923;12217;4.82;0.30;359.80;18.78;1425;30;4186.00;294
10500;25;22173305;10500;559;11924;12218;4.82;0.30;359.84;18.78;1424;30;4187.00;294
10502;25;22173322;10502;567;11927;12218;4.80;0.29;359.87;18.78;1425;30;4188.00;291
10506;25;22173341;10506;568;11928;12218;4.75;0.29;359.81;18.78;1422;30;4189.00;290
10508;25;22173361;10508;573;11932;12218;4.68;0.29;359.96;18.78;1424;30;4190.00;286
10510;25;22173390;10510;576;11936;12222;4.62;0.28;359.97;18.77;1426;30;4191.00;286
10516;25;22173416;10516;580;11938;12222;4.50;0.28;360.05;18.77;1422;30;4192.00;284
10521;25;22173435;10521;589;11941;12222;4.42;0.27;360.18;18.77;1420;30;4193.00;281
10526;25;22173453;10526;595;11944;12225;4.32;0.26;360.23;18.77;1418;30;4194.00;281
10528;25;22173472;10528;597;11946;12225;4.27;0.26;360.22;18.77;1418;30;4195.00;279
10533;25;22173490;10533;604;11947;12225;4.20;0.26;360.17;18.77;1414;30;4196.00;278
10535;25;22173508;10535;610;11950;12229;4.16;0.25;360.24;18.76;1415;30;4197.00;279
10537;25;22173528;10537;611;11952;12230;4.12;0.25;360.21;18.76;1415;30;4198.00;278
10539;25;22173546;10539;607;11952;12230;4.13;0.25;360.18;18.76;1413;30;4199.00;278
10542;25;22173566;10542;600;11965;12264;4.15;0.25;360.19;18.75;1423;30;4200.00;299
10546;25;22173598;10546;588;11968;12264;4.17;0.25;360.24;18.75;1422;30;4201.00;296
10549;25;22173621;10549;574;11968;12264;4.21;0.26;360.31;18.75;1419;30;4202.00;296
10551;25;22173640;10551;571;11969;12265;4.21;0.26;360.30;18.75;1418;30;4203.00;296
10554;25;22173659;10554;571;11969;12265;4.27;0.26;360.40;18.75;1415;30;4204.00;296
10557;25;22173680;10557;569;11973;12271;4.33;0.27;360.47;18.74;1416;30;4205.00;298
10559;25;22173701;10559;574;11977;12271;4.36;0.27;360.55;18.74;1418;30;4206.00;294
10562;25;22173721;10562;558;11977;12272;4.40;0.27;360.67;18.74;1415;30;4207.00;295
10567;25;22173743;10567;553;11977;12272;4.42;0.27;360.73;18.74;1410;30;4208.00;295
10570;25;22173769;10570;547;11977;12272;4.47;0.27;360.76;18.74;1407;30;4209.00;295
10574;25;22173787;10574;540;11977;12272;4.47;0.27;360.84;18.74;1403;30;4210.00;295
10577;25;22173806;10577;535;11979;12272;4.44;0.27;361.00;18.73;1402;30;4211.00;293
10581;25;22173828;10581;536;11986;12284;4.45;0.27;361.06;18.73;1405;30;4212.00;298
10587;25;22173849;10587;530;11987;12284;4.43;0.27;361.13;18.72;1400;30;4213.00;297
10589;25;22173874;10589;528;11988;12284;4.46;0.27;361.22;18.72;1399;30;4214.00;296
10593;25;22173894;10593;524;11988;12284;4.46;0.27;361.20;18.72;1395;30;4215.00;296
10594;25;22173915;10594;529;11989;12284;4.49;0.27;361.28;18.72;1395;30;4216.00;295
10598;25;22173938;10598;537;11991;12284;4.47;0.27;361.36;18.72;1393;30;4217.00;293
10602;25;22173957;10602;538;11995;12288;4.50;0.27;361.35;18.72;1393;30;4218.00;293
10606;25;22173978;10606;536;11995;12288;4.53;0.27;361.49;18.72;1389;30;4219.00;293
10608;25;22173997;10608;540;11997;12292;4.56;0.28;361.55;18.71;1389;30;4220.00;295
10611;25;22174017;10611;539;11998;12293;4.56;0.28;361.64;18.71;1387;30;4221.00;295
10616;25;22174036;10616;540;11998;12293;4.58;0.28;361.77;18.71;1382;30;4222.00;295
10620;25;22174055;10620;536;12000;12293;4.56;0.28;361.84;18.71;1380;30;4223.00;293
10624;25;22174074;10624;533;12007;12306;4.60;0.28;361.96;18.70;1383;30;4224.00;299
10627;25;22174096;10627;529;12008;12306;4.62;0.28;362.04;18.70;1381;30;4225.00;298
10630;25;22174116;10630;531;12009;12306;4.62;0.28;362.06;18.70;1379;30;4226.00;297
10634;25;22174134;10634;539;12010;12307;4.63;0.28;362.08;18.70;1376;30;4227.00;297
10640;25;22174153;10640;544;12011;12308;4.58;0.28;362.20;18.70;1371;30;4228.00;297
10645;25;22174194;10645;539;12013;12308;4.56;0.28;362.25;18.70;1368;30;4229.00;295
10647;26;22174215;10647;541;12018;12314;4.57;0.28;362.29;18.69;1371;31;4230.00;296
10654;26;22174249;10654;542;12020;12314;4.49;0.27;362.40;18.70;1366;31;4231.00;294
10657;26;22174273;10657;546;12020;12314;4.45;0.27;362.50;18.70;1363;31;4232.00;294
10660;26;22174306;10660;552;12020;12314;4.43;0.27;362.54;18.70;1360;31;4233.00;294
10664;26;22174334;10664;559;12026;12320;4.39;0.27;362.57;18.69;1362;31;4234.00;294
10665;26;22174360;10665;557;12027;12320;4.41;0.27;362.56;18.69;1362;31;4235.00;293
10668;26;22174384;10668;563;12027;12320;4.39;0.27;362.58;18.69;1359;31;4236.00;293
10669;26;22174404;10669;560;12029;12320;4.36;0.26;362.56;18.70;1360;31;4237.00;291
10673;26;22174423;10673;562;12032;12324;4.29;0.26;362.61;18.70;1359;31;4238.00;292
10674;26;22174445;10674;555;12033;12325;4.35;0.26;362.69;18.69;1359;31;4239.00;292
10677;26;22174463;10677;557;12034;12325;4.29;0.26;362.81;18.70;1357;31;4240.00;291
10680;26;22174484;10680;560;12036;12326;4.24;0.26;362.78;18.70;1356;31;4241.00;290
10684;26;22174503;10684;566;12036;12326;4.17;0.25;362.73;18.70;1352;31;4242.00;290
10685;26;22174521;10685;568;12037;12326;4.15;0.25;362.72;18.70;1352;31;4243.00;289
10691;26;22174538;10691;566;12037;12326;4.03;0.24;362.69;18.70;1346;31;4244.00;289
10694;26;22174556;10694;573;12038;12326;3.94;0.24;362.86;18.71;1344;31;4245.00;288
10694;26;22174580;10694;570;12039;12326;3.88;0.24;362.86;18.71;1345;31;4246.00;287
10698;26;22174601;10698;565;12041;12326;3.83;0.23;363.03;18.72;1343;31;4247.00;285
10701;26;22174624;10701;582;12074;12396;3.91;0.24;363.04;18.67;1373;31;4248.00;322
10703;26;22174651;10703;567;12076;12397;3.96;0.24;363.10;18.67;1373;31;4249.00;321
10708;26;22174669;10708;560;12080;12397;3.97;0.24;363.16;18.66;1372;31;4250.00;317
10711;26;22174688;10711;558;12080;12397;4.02;0.24;363.23;18.66;1369;31;4251.00;317
10712;26;22174706;10712;553;12083;12397;4.07;0.25;363.21;18.66;1371;31;4252.00;314
10713;26;22174725;10713;557;12087;12397;4.14;0.25;363.30;18.67;1374;31;4253.00;310
10716;26;22174744;10716;558;12092;12397;4.13;0.25;363.42;18.67;1376;31;4254.00;305
10719;26;22174763;10719;567;12096;12397;4.15;0.25;363.49;18.66;1377;32;4255.00;301
10721;26;22174796;10721;557;12099;12398;4.16;0.25;363.52;18.66;1378;32;4256.00;299
10723;26;22174816;10723;550;12101;12399;4.18;0.25;363.52;18.66;1378;32;4257.00;298
10726;26;22174836;10726;552;12104;12399;4.17;0.25;363.61;18.66;1378;32;4258.00;295
10727;26;22174856;10727;554;12109;12403;4.20;0.26;363.66;18.65;1382;32;4259.00;294
10730;26;22174880;10730;552;12111;12403;4.26;0.26;363.74;18.65;1381;32;4260.00;292
10731;26;22174906;10731;554;12112;12403;4.34;0.26;363.75;18.65;1381;32;4261.00;291
10733;26;22174930;10733;550;12114;12403;4.36;0.27;363.85;18.65;1381;32;4262.00;289
10735;26;22174958;10735;554;12120;12409;4.41;0.27;363.89;18.64;1385;32;4263.00;289
10738;26;22174988;10738;550;12121;12409;4.43;0.27;363.99;18.64;1383;32;4264.00;288
10742;26;22175019;10742;556;12122;12409;4.44;0.27;364.19;18.64;1380;32;4265.00;287
10745;26;22175039;10745;558;12124;12412;4.49;0.27;364.25;18.64;1379;32;4266.00;288
10748;26;22175058;10748;557;12125;12412;4.52;0.27;364.34;18.64;1377;32;4267.00;287
10751;26;22175080;10751;553;12126;12412;4.52;0.27;364.46;18.64;1375;32;4268.00;286
10753;26;22175100;10753;543;12126;12413;4.56;0.28;364.46;18.64;1373;32;4269.00;287
10755;26;22175119;10755;543;12127;12414;4.57;0.28;364.46;18.64;1372;32;4270.00;287
10757;26;22175138;10757;536;12127;12414;4.60;0.28;364.57;18.64;1370;32;4271.00;287
10757;26;22175157;10757;539;12135;12427;4.71;0.29;364.57;18.62;1378;32;4272.00;292
10760;26;22175179;10760;528;12136;12427;4.72;0.29;364.58;18.62;1376;32;4273.00;291
10761;26;22175198;10761;533;12136;12427;4.72;0.29;364.58;18.62;1375;32;4274.00;291
10764;26;22175217;10764;530;12139;12429;4.68;0.28;364.69;18.67;1375;32;4275.00;290
10766;26;22175237;10766;520;12139;12429;4.68;0.28;364.76;18.67;1373;32;4276.00;290
10769;26;22175256;10769;519;12143;12433;4.68;0.28;364.77;18.67;1374;32;4277.00;290
10772;26;22175274;10772;520;12143;12433;4.62;0.28;364.78;18.67;1371;32;4278.00;290
10775;26;22175293;10775;518;12146;12437;4.62;0.28;364.80;18.66;1371;32;4279.00;291
10779;26;22175313;10779;524;12146;12437;4.57;0.28;364.70;18.66;1367;32;4280.00;291
10779;26;22175331;10779;518;12146;12437;4.53;0.28;364.70;18.66;1367;32;4281.00;291
10781;26;22175349;10781;520;12146;12437;4.51;0.27;364.70;18.66;1365;32;4282.00;291
10782;26;22175367;10782;528;12146;12437;4.46;0.27;364.67;18.66;1364;32;4283.00;291
10786;26;22175385;10786;531;12156;12449;4.46;0.27;364.67;18.65;1370;32;4284.00;293
10787;26;22175405;10787;541;12156;12449;4.46;0.27;364.65;18.65;1369;32;4285.00;293
10791;26;22175422;10791;551;12157;12449;4.45;0.27;364.66;18.65;1366;32;4286.00;292
10793;26;22175440;10793;556;12157;12449;4.41;0.27;364.68;18.65;1364;32;4287.00;292
10795;26;22175457;10795;562;12157;12449;4.40;0.27;364.68;18.65;1362;32;4288.00;292
10796;26;22175475;10796;569;12157;12449;4.37;0.27;364.73;18.65;1361;32;4289.00;292
10798;26;22175495;10798;555;12157;12450;4.31;0.26;364.70;18.65;1359;32;4290.00;293
10801;27;22175513;10801;552;12157;12450;4.27;0.26;364.72;18.65;1356;33;4291.00;293
10805;27;22175539;10805;554;12162;12456;4.26;0.26;364.76;18.64;1357;33;4292.00;294
10806;27;22175559;10806;552;12163;12457;4.27;0.26;364.75;18.64;1357;33;4293.00;294
10807;27;22175579;10807;547;12163;12457;4.28;0.26;364.75;18.64;1356;33;4294.00;294
10808;27;22175596;10808;546;12163;12457;4.31;0.26;364.76;18.64;1355;33;4295.00;294
10808;27;22175614;10808;542;12165;12461;4.38;0.27;364.76;18.64;1357;33;4296.00;296
10811;27;22175631;10811;545;12165;12461;4.34;0.26;364.75;18.64;1354;33;4297.00;296
10812;27;22175649;10812;547;12165;12461;4.36;0.26;364.77;18.64;1353;33;4298.00;296
10814;27;22175666;10814;545;12166;12462;4.41;0.27;364.76;18.63;1352;33;4299.00;296
10816;27;22175685;10816;542;12169;12466;4.39;0.27;364.77;18.63;1353;33;4300.00;297
10816;27;22175710;10816;540;12169;12466;4.38;0.27;364.77;18.63;1353;33;4301.00;297
10818;27;22175728;10818;537;12171;12469;4.39;0.27;364.75;18.63;1353;33;4302.00;298
10821;27;22175746;10821;529;12172;12469;4.33;0.26;364.72;18.62;1351;33;4303.00;297
10823;27;22175763;10823;520;12172;12469;4.30;0.26;364.70;18.62;1349;33;4304.00;297
10824;27;22175780;10824;522;12174;12469;4.27;0.26;364.69;18.75;1350;33;4305.00;295
10828;27;22175811;10828;506;12179;12473;4.26;0.26;364.63;18.82;1351;33;4306.00;294
10829;27;22175829;10829;487;12179;12473;4.27;0.26;364.62;18.82;1350;33;4307.00;294
10830;27;22175847;10830;478;12179;12473;4.33;0.26;364.60;18.82;1349;33;4308.00;294
10833;27;22175865;10833;476;12179;12473;4.31;0.26;364.60;18.82;1346;33;4309.00;294
10836;27;22175883;10836;461;12179;12474;4.35;0.27;364.60;18.82;1343;33;4310.00;295
10837;27;22175901;10837;458;12180;12475;4.42;0.27;364.60;18.82;1343;33;4311.00;295
10842;27;22175920;10842;445;12181;12475;4.42;0.27;364.65;18.89;1339;33;4312.00;294
10842;27;22175948;10842;447;12183;12476;4.46;0.27;364.65;18.89;1341;33;4313.00;293
10844;27;22175977;10844;438;12183;12476;4.49;0.27;364.63;18.89;1339;33;4314.00;293
10846;27;22175997;10846;433;12183;12476;4.54;0.27;364.70;18.89;1337;33;4315.00;293
10847;27;22176016;10847;440;12183;12476;4.60;0.28;364.68;18.89;1336;33;4316.00;293
10849;27;22176036;10849;436;12184;12476;4.68;0.28;364.78;18.90;1335;33;4317.00;292
10852;27;22176056;10852;444;12184;12476;4.70;0.29;364.75;18.90;1332;33;4318.00;292
10852;28;22176076;10852;441;12185;12476;4.76;0.29;364.75;18.90;1333;34;4319.00;291
10855;28;22176116;10855;482;12280;12706;5.10;0.32;364.75;18.76;1425;34;4320.00;426
10856;28;22176160;10856;469;12284;12707;5.14;0.32;364.75;18.81;1428;34;4321.00;423
10858;28;22176182;10858;466;12295;12707;5.18;0.32;364.71;18.80;1437;34;4322.00;412
10859;28;22176213;10859;450;12300;12707;5.21;0.33;364.68;18.80;1441;34;4323.00;407
10860;28;22176235;10860;448;12309;12707;5.20;0.32;364.69;18.79;1449;34;4324.00;398
10864;28;22176254;10864;444;12315;12707;5.18;0.32;364.63;18.78;1451;34;4325.00;392
10866;28;22176275;10866;440;12323;12707;5.19;0.32;364.72;18.85;1457;34;4326.00;384
10868;28;22176298;10868;442;12331;12707;5.22;0.32;364.69;18.84;1463;34;4327.00;376
10869;28;22176319;10869;448;12337;12708;5.23;0.32;364.70;18.83;1468;34;4328.00;371
10871;28;22176341;10871;446;12347;12709;5.19;0.32;364.82;18.90;1476;34;4329.00;362
10874;28;22176367;10874;454;12355;12709;5.10;0.32;364.80;18.89;1481;34;4330.00;354
10880;28;22176393;10880;467;12356;12710;5.00;0.31;364.81;18.89;1476;34;4331.00;354
10882;28;22176421;10882;478;12359;12710;4.96;0.31;364.90;18.96;1477;34;4332.00;351
10886;28;22176448;10886;494;12362;12710;4.92;0.30;364.83;18.96;1476;34;4333.00;348
10888;28;22176483;10888;500;12365;12710;4.84;0.30;364.87;19.03;1477;34;4334.00;345
10888;28;22176508;10888;498;12370;12714;4.84;0.30;364.87;19.03;1482;34;4335.00;344
10894;28;22176538;10894;507;12372;12714;4.81;0.30;365.00;19.03;1478;34;4336.00;342
10895;28;22176566;10895;528;12374;12714;4.79;0.29;364.99;19.10;1479;34;4337.00;340
10896;28;22176592;10896;535;12377;12717;4.75;0.29;365.03;19.10;1481;34;4338.00;340
10899;28;22176620;10899;543;12380;12717;4.74;0.29;365.07;19.17;1481;34;4339.00;337
10900;28;22176662;10900;541;12380;12717;4.76;0.29;365.09;19.17;1480;34;4340.00;337
10901;28;22176694;10901;550;12386;12721;4.76;0.29;365.09;19.31;1485;34;4341.00;335
10903;28;22176729;10903;559;12387;12722;4.78;0.29;365.22;19.31;1484;34;4342.00;335
10904;28;22176771;10904;558;12391;12722;4.76;0.29;365.23;19.45;1487;34;4343.00;331
10904;28;22176799;10904;564;12392;12726;4.77;0.29;365.23;19.45;1488;34;4344.00;334
10906;28;22176822;10906;570;12395;12726;4.76;0.29;365.28;19.59;1489;34;4345.00;331
10910;28;22176845;10910;573;12399;12726;4.75;0.29;365.29;19.59;1489;34;4346.00;327
10914;28;22176865;10914;578;12399;12727;4.71;0.29;365.33;19.59;1485;34;4347.00;328
10916;28;22176924;10916;579;12401;12727;4.75;0.29;365.32;19.73;1485;34;4348.00;326
10918;28;22176950;10918;574;12407;12733;4.79;0.29;365.38;19.72;1489;34;4349.00;326
10921;28;22176974;10921;577;12408;12733;4.80;0.29;365.39;19.72;1487;34;4350.00;325
10923;28;22176996;10923;572;12410;12734;4.82;0.29;365.41;19.86;1487;34;4351.00;324
10925;28;22177018;10925;564;12412;12734;4.81;0.29;365.49;19.87;1487;34;4352.00;322
10925;28;22177038;10925;561;12412;12734;4.82;0.29;365.49;19.87;1487;34;4353.00;322
10928;28;22177061;10928;562;12417;12734;4.82;0.29;365.54;20.01;1489;34;4354.00;317
10930;28;22177081;10930;562;12417;12734;4.81;0.29;365.64;20.01;1487;34;4355.00;317
10935;28;22177103;10935;568;12425;12746;4.86;0.30;365.85;19.99;1490;34;4356.00;321
10937;28;22177127;10937;564;12430;12746;4.85;0.30;365.99;20.14;1493;34;4357.00;316
10938;28;22177149;10938;560;12432;12746;4.85;0.30;366.02;20.14;1494;34;4358.00;314
10939;28;22177169;10939;564;12434;12746;4.82;0.29;366.04;20.14;1495;34;4359.00;312
10941;28;22177191;10941;566;12436;12746;4.76;0.29;366.12;20.14;1495;34;4360.00;310
10942;28;22177216;10942;575;12437;12746;4.76;0.29;366.16;20.14;1495;34;4361.00;309
10948;28;22177236;10948;584;12441;12750;4.76;0.29;366.22;20.13;1493;34;4362.00;309
10953;28;22177257;10953;591;12443;12750;4.74;0.29;366.32;20.14;1490;34;4363.00;307
10958;28;22177279;10958;594;12447;12754;4.74;0.29;366.29;20.13;1489;34;4364.00;307
10962;28;22177301;10962;605;12449;12756;4.71;0.29;366.37;20.13;1487;34;4365.00;307
10963;28;22177328;10963;616;12450;12756;4.70;0.29;366.45;20.13;1487;34;4366.00;306
10971;28;22177354;10971;626;12452;12756;4.61;0.28;366.52;20.13;1481;34;4367.00;304
10973;28;22177377;10973;627;12459;12769;4.59;0.28;366.55;20.12;1486;34;4368.00;310
10978;28;22177401;10978;625;12459;12769;4.59;0.28;366.65;20.12;1481;34;4369.00;310
10982;28;22177425;10982;634;12460;12769;4.59;0.28;366.62;20.12;1478;34;4370.00;309
10987;28;22177446;10987;634;12461;12770;4.58;0.28;366.64;20.12;1474;34;4371.00;309
10990;28;22177466;10990;638;12462;12771;4.55;0.28;366.67;20.12;1472;34;4372.00;309
10993;28;22177486;10993;638;12462;12771;4.52;0.28;366.73;20.12;1469;34;4373.00;309
10997;28;22177507;10997;637;12466;12774;4.47;0.28;366.80;20.12;1469;34;4374.00;308
11002;28;22177527;11002;629;12468;12774;4.41;0.27;367.05;20.11;1466;34;4375.00;306
11006;28;22177553;11006;626;12469;12774;4.34;0.27;367.03;20.11;1463;34;4376.00;305
11012;28;22177572;11012;611;12469;12774;4.28;0.26;367.10;20.11;1457;34;4377.00;305
11016;28;22177593;11016;612;12473;12780;4.26;0.26;367.29;20.11;1457;34;4378.00;307
11020;28;22177616;11020;612;12473;12780;4.21;0.26;367.38;20.11;1453;34;4379.00;307
11028;28;22177639;11028;605;12473;12780;4.16;0.26;367.62;20.11;1445;34;4380.00;307
11029;28;22177663;11029;609;12473;12780;4.16;0.26;367.60;20.11;1444;34;4381.00;307
11034;28;22177684;11034;598;12476;12784;4.15;0.26;367.71;20.10;1442;34;4382.00;308
11039;28;22177708;11039;600;12477;12785;4.14;0.25;367.83;20.10;1438;34;4383.00;308
11042;28;22177735;11042;600;12477;12785;4.13;0.25;367.81;20.10;1435;34;4384.00;308
11047;28;22177760;11047;600;12478;12786;4.15;0.25;367.95;20.10;1431;34;4385.00;308
11051;28;22177788;11051;593;12478;12786;4.16;0.26;367.94;20.10;1427;34;4386.00;308
11056;28;22177818;11056;590;12478;12786;4.17;0.26;367.92;20.10;1422;34;4387.00;308
11059;28;22177845;11059;588;12478;12786;4.22;0.26;367.96;20.10;1419;34;4388.00;308
11063;28;22177869;11063;587;12478;12786;4.24;0.26;367.97;20.10;1415;34;4389.00;308
11067;28;22177892;11067;588;12479;12786;4.28;0.26;368.06;20.10;1412;34;4390.00;307
11070;28;22177919;11070;596;12479;12786;4.27;0.26;368.14;20.10;1409;34;4391.00;307
11073;28;22177943;11073;597;12509;12856;4.36;0.27;368.15;20.11;1436;34;4392.00;347
11078;28;22177982;11078;598;12510;12857;4.35;0.27;368.21;20.11;1432;34;4393.00;347
11082;28;22178004;11082;598;12512;12857;4.37;0.27;368.17;20.11;1430;34;4394.00;345
11087;28;22178026;11087;586;12513;12857;4.36;0.27;368.29;20.11;1426;34;4395.00;344
11093;28;22178051;11093;594;12514;12857;4.30;0.26;368.35;20.11;1421;34;4396.00;343
11096;28;22178071;11096;586;12516;12857;4.26;0.26;368.34;20.10;1420;34;4397.00;341
11098;28;22178091;11098;583;12517;12857;4.28;0.26;368.32;20.10;1419;34;4398.00;340
11103;28;22178112;11103;591;12519;12857;4.27;0.26;368.32;20.10;1416;34;4399.00;338
11105;28;22178133;11105;593;12520;12858;4.26;0.26;368.39;20.10;1415;34;4400.00;338
11108;28;22178157;11108;594;12523;12859;4.27;0.26;368.41;20.10;1415;34;4401.00;336
11110;28;22178178;11110;592;12527;12859;4.23;0.26;368.48;20.09;1417;34;4402.00;332
11116;28;22178197;11116;593;12533;12863;4.18;0.26;368.60;20.09;1417;34;4403.00;330
11120;28;22178216;11120;598;12535;12863;4.14;0.25;368.60;20.09;1415;34;4404.00;328
11120;28;22178235;11120;600;12537;12863;4.16;0.25;368.60;20.09;1417;34;4405.00;326
11124;28;22178254;11124;602;12541;12863;4.12;0.25;368.63;20.08;1417;34;4406.00;322
11127;28;22178272;11127;597;12546;12869;4.12;0.25;368.60;20.08;1419;34;4407.00;323
11128;28;22178296;11128;596;12546;12869;4.11;0.25;368.58;20.08;1418;34;4408.00;323
11132;28;22178318;11132;598;12548;12869;4.09;0.25;368.60;20.08;1416;34;4409.00;321
11132;28;22178344;11132;600;12553;12875;4.16;0.25;368.60;20.07;1421;34;4410.00;322
11136;28;22178369;11136;613;12553;12875;4.10;0.25;368.75;20.07;1417;34;4411.00;322
11138;28;22178390;11138;602;12554;12875;4.08;0.25;368.75;20.07;1416;34;4412.00;321
11140;28;22178413;11140;612;12554;12876;4.03;0.25;368.79;20.07;1414;34;4413.00;322
11141;28;22178437;11141;609;12557;12877;4.01;0.24;368.78;20.06;1416;34;4414.00;320
11146;28;22178458;11146;615;12558;12877;3.96;0.24;368.77;20.06;1412;34;4415.00;319
11149;28;22178482;11149;621;12568;12890;3.98;0.24;368.83;20.05;1419;34;4416.00;322
11151;28;22178502;11151;625;12569;12890;3.94;0.24;368.80;20.05;1418;34;4417.00;321
11153;28;22178520;11153;625;12571;12890;3.88;0.24;368.90;20.05;1418;34;4418.00;319
11154;28;22178539;11154;626;12573;12891;3.88;0.24;368.91;20.05;1419;34;4419.00;318
11155;28;22178557;11155;629;12574;12891;3.79;0.23;368.91;20.05;1419;34;4420.00;317
11158;28;22178575;11158;639;12579;12895;3.81;0.23;368.97;20.04;1421;34;4421.00;316
11161;28;22178597;11161;630;12579;12895;3.76;0.23;369.04;20.04;1418;34;4422.00;316
11163;28;22178618;11163;629;12582;12899;3.77;0.23;369.04;20.04;1419;34;4423.00;317
11166;28;22178638;11166;633;12582;12899;3.72;0.23;369.10;20.04;1416;34;4424.00;317
11173;28;22178668;11173;637;12582;12899;3.66;0.22;369.13;20.04;1409;34;4425.00;317
11174;28;22178687;11174;634;12582;12899;3.68;0.22;369.12;20.04;1408;34;4426.00;317
11176;28;22178706;11176;632;12582;12899;3.66;0.22;369.22;20.04;1406;34;4427.00;317
11178;28;22178724;11178;630;12592;12911;3.73;0.23;369.24;20.02;1414;34;4428.00;319
11179;28;22178745;11179;637;12592;12911;3.78;0.23;369.22;20.02;1413;34;4429.00;319
11181;28;22178764;11181;638;12593;12911;3.81;0.23;369.17;20.02;1412;34;4430.00;318
11184;28;22178783;11184;621;12593;12911;3.86;0.24;369.15;20.02;1409;34;4431.00;318
11185;28;22178803;11185;603;12593;12911;3.93;0.24;369.20;20.02;1408;34;4432.00;318
11186;28;22178822;11186;591;12593;12911;4.02;0.25;369.17;20.02;1407;34;4433.00;318
11188;28;22178841;11188;589;12593;12912;4.06;0.25;369.12;20.02;1405;34;4434.00;319
11190;28;22178862;11190;583;12593;12912;4.13;0.25;369.07;20.02;1403;34;4435.00;319
11193;28;22178881;11193;572;12597;12918;4.23;0.26;369.06;20.01;1404;34;4436.00;321
11193;28;22178908;11193;569;12598;12919;4.30;0.26;369.06;20.01;1405;34;4437.00;321
11197;28;22178929;11197;570;12598;12919;4.30;0.26;369.00;20.01;1401;34;4438.00;321
11198;28;22178949;11198;567;12598;12919;4.35;0.27;369.03;20.01;1400;34;4439.00;321
11201;28;22178972;11201;576;12602;12924;4.34;0.26;369.03;20.01;1401;34;4440.00;322
11204;28;22178994;11204;576;12602;12924;4.35;0.26;368.96;20.01;1398;34;4441.00;322
11206;28;22179017;11206;573;12602;12924;4.36;0.26;368.94;20.01;1396;34;4442.00;322
11206;28;22179039;11206;575;12603;12925;4.39;0.27;368.94;20.00;1397;34;4443.00;322
11206;28;22179058;11206;571;12606;12929;4.42;0.27;368.94;20.00;1400;34;4444.00;323
11209;28;22179080;11209;578;12606;12929;4.41;0.27;368.95;20.00;1397;34;4445.00;323
11209;28;22179100;11209;575;12608;12932;4.46;0.27;368.95;20.00;1399;34;4446.00;324
11210;28;22179120;11210;577;12608;12932;4.43;0.27;368.93;20.00;1398;34;4447.00;324
11215;28;22179140;11215;574;12609;12932;4.40;0.27;368.87;20.00;1394;34;4448.00;323
11220;28;22179162;11220;570;12609;12932;4.34;0.26;368.77;20.00;1389;34;4449.00;323
11221;28;22179182;11221;570;12612;12936;4.33;0.26;368.86;19.99;1391;34;4450.00;324
11225;28;22179203;11225;582;12612;12936;4.26;0.26;368.85;19.99;1387;34;4451.00;324
11226;28;22179222;11226;581;12612;12936;4.22;0.26;368.83;19.99;1386;34;4452.00;324
11230;28;22179241;11230;585;12612;12936;4.19;0.25;368.86;19.99;1382;34;4453.00;324
11231;28;22179263;11231;585;12613;12937;4.20;0.25;368.86;20.06;1382;34;4454.00;324
11232;28;22179283;11232;586;12615;12939;4.18;0.25;368.86;20.05;1383;34;4455.00;324
11232;28;22179302;11232;584;12615;12939;4.19;0.25;368.86;20.05;1383;34;4456.00;324
11234;28;22179320;11234;586;12616;12940;4.16;0.25;368.83;20.05;1382;34;4457.00;324
11236;28;22179341;11236;595;12616;12940;4.10;0.25;368.84;20.05;1380;34;4458.00;324
11237;28;22179362;11237;592;12616;12940;4.04;0.24;368.84;20.05;1379;34;4459.00;324
11239;28;22179381;11239;593;12616;12940;4.01;0.24;368.88;20.05;1377;34;4460.00;324
11239;28;22179399;11239;597;12616;12940;4.01;0.24;368.88;20.05;1377;34;4461.00;324
11240;28;22179417;11240;589;12616;12940;4.02;0.24;368.87;20.05;1376;34;4462.00;324
11241;28;22179434;11241;577;12616;12940;4.02;0.24;368.86;20.05;1375;34;4463.00;324
11241;28;22179452;11241;577;12677;13067;4.35;0.27;368.86;19.96;1436;34;4464.00;390
11243;28;22179482;11243;555;12677;13068;4.36;0.27;368.94;19.96;1434;34;4465.00;391
11243;28;22179501;11243;541;12686;13068;4.51;0.28;368.94;19.94;1443;34;4466.00;382
11245;28;22179520;11245;525;12689;13068;4.58;0.28;368.89;19.94;1444;34;4467.00;379
11246;28;22179539;11246;521;12694;13068;4.64;0.29;368.97;19.93;1448;34;4468.00;374
11246;28;22179561;11246;508;12696;13068;4.69;0.29;368.97;19.93;1450;34;4469.00;372
11248;28;22179588;11248;499;12699;13068;4.76;0.29;368.97;20.00;1451;34;4470.00;369
11248;28;22179610;11248;497;12702;13068;4.85;0.30;368.97;19.99;1454;34;4471.00;366
11249;28;22179630;11249;495;12704;13069;4.89;0.30;368.98;19.99;1455;34;4472.00;365
11254;28;22179656;11254;487;12708;13070;4.94;0.30;368.92;19.99;1454;34;4473.00;362
11255;28;22179678;11255;491;12711;13070;4.97;0.30;368.94;19.98;1456;34;4474.00;359
11258;28;22179704;11258;483;12713;13071;4.94;0.30;368.98;20.05;1455;34;4475.00;358
11260;28;22179725;11260;495;12716;13071;4.89;0.30;368.96;20.05;1456;34;4476.00;355
11260;28;22179746;11260;500;12718;13071;4.87;0.30;368.96;20.05;1458;34;4477.00;353
11260;28;22179772;11260;505;12720;13071;4.83;0.30;368.96;20.05;1460;34;4478.00;351
11262;28;22179792;11262;501;12723;13075;4.82;0.30;368.97;20.04;1461;34;4479.00;352
11266;28;22179813;11266;493;12725;13075;4.79;0.29;368.94;20.12;1459;34;4480.00;350
11268;28;22179839;11268;495;12726;13075;4.82;0.29;368.94;20.12;1458;34;4481.00;349
11270;28;22179860;11270;483;12729;13078;4.84;0.30;368.95;20.19;1459;34;4482.00;349
11270;28;22179883;11270;477;12730;13078;4.88;0.30;368.95;20.19;1460;34;4483.00;348
11271;28;22179912;11271;468;12732;13078;4.88;0.30;368.95;20.19;1461;34;4484.00;346
11273;28;22179932;11273;466;12736;13082;4.92;0.30;369.01;20.19;1463;34;4485.00;346
11275;28;22179953;11275;462;12738;13083;4.95;0.30;369.04;20.18;1463;34;4486.00;345
11278;28;22179973;11278;455;12739;13083;4.93;0.30;369.01;20.18;1461;34;4487.00;344
11281;28;22180002;11281;455;12740;13087;4.91;0.30;369.02;20.18;1459;34;4488.00;347
11284;28;22180023;11284;457;12741;13087;4.91;0.30;369.01;20.18;1457;34;4489.00;346
11288;28;22180045;11288;461;12741;13087;4.87;0.30;369.02;20.18;1453;34;4490.00;346
11288;28;22180066;11288;460;12742;13088;4.94;0.30;369.02;20.18;1454;34;4491.00;346
11294;28;22180094;11294;458;12742;13088;4.91;0.30;369.04;20.18;1448;34;4492.00;346
11296;28;22180115;11296;461;12746;13094;4.95;0.30;369.01;20.17;1450;34;4493.00;348
11298;28;22180135;11298;451;12746;13094;4.95;0.30;368.99;20.17;1448;34;4494.00;348
11300;28;22180155;11300;452;12746;13095;4.96;0.30;369.08;20.17;1446;34;4495.00;349
11301;28;22180174;11301;448;12746;13095;4.95;0.30;369.10;20.17;1445;34;4496.00;349
11302;28;22180196;11302;453;12747;13095;4.92;0.30;369.07;20.17;1445;34;4497.00;348
11304;28;22180216;11304;448;12749;13095;4.93;0.30;369.06;20.18;1445;34;4498.00;346
11305;28;22180236;11305;452;12749;13095;4.92;0.30;369.08;20.18;1444;34;4499.00;346
11306;28;22180259;11306;455;12770;13145;5.00;0.30;369.16;20.15;1464;34;4500.00;375
11309;28;22180293;11309;450;12772;13147;4.96;0.30;369.16;20.15;1463;34;4501.00;375
11309;28;22180315;11309;454;12777;13147;5.03;0.31;369.16;20.14;1468;34;4502.00;370
11311;28;22180335;11311;456;12778;13147;5.02;0.31;369.29;20.14;1467;34;4503.00;369
11312;28;22180356;11312;451;12780;13147;5.05;0.31;369.37;20.14;1468;34;4504.00;367
11314;28;22180378;11314;457;12783;13147;5.06;0.31;369.56;20.30;1469;34;4505.00;364
11318;28;22180399;11318;461;12787;13151;5.12;0.31;369.66;20.29;1469;34;4506.00;364
11319;28;22180420;11319;467;12790;13151;5.17;0.32;369.65;20.45;1471;34;4507.00;361
11324;28;22180441;11324;478;12795;13155;5.19;0.32;369.63;20.45;1471;34;4508.00;360
11327;28;22180469;11327;484;12798;13156;5.21;0.32;369.86;20.44;1471;34;4509.00;358
11329;28;22180489;11329;489;12800;13156;5.21;0.32;369.91;20.60;1471;34;4510.00;356
11332;28;22180510;11332;491;12803;13156;5.16;0.31;369.90;20.60;1471;34;4511.00;353
11335;28;22180531;11335;499;12814;13169;5.09;0.31;370.00;20.59;1479;34;4512.00;355
11337;28;22180553;11337;493;12817;13169;5.01;0.30;370.00;20.74;1480;34;4513.00;352
11338;28;22180574;11338;499;12819;13169;4.95;0.30;370.04;20.74;1481;34;4514.00;350
11342;28;22180599;11342;501;12821;13170;4.86;0.30;370.17;20.81;1479;34;4515.00;349
11343;28;22180621;11343;507;12823;13171;4.85;0.30;370.27;20.89;1480;34;4516.00;348
11345;28;22180641;11345;511;12826;13171;4.78;0.29;370.31;20.96;1481;34;4517.00;345
11349;28;22180663;11349;515;12829;13174;4.82;0.29;370.39;20.96;1480;34;4518.00;345
11349;28;22180683;11349;520;12831;13174;4.81;0.29;370.39;21.03;1482;34;4519.00;343
11351;28;22180703;11351;523;12835;13174;4.78;0.29;370.55;21.18;1484;34;4520.00;339
11351;28;22180724;11351;527;12836;13174;4.76;0.29;370.55;21.18;1485;34;4521.00;338
11355;28;22180745;11355;542;12840;13180;4.77;0.29;370.66;21.17;1485;34;4522.00;340
11358;28;22180767;11358;530;12843;13180;4.73;0.29;370.71;21.32;1485;34;4523.00;337
11359;28;22180787;11359;532;12843;13180;4.71;0.29;370.75;21.32;1484;34;4524.00;337
11362;28;22180806;11362;531;12846;13180;4.67;0.29;370.82;21.47;1484;34;4525.00;334
11367;28;22180829;11367;519;12850;13184;4.64;0.28;370.99;21.54;1483;34;4526.00;334
11369;28;22180850;11369;506;12851;13185;4.65;0.29;370.96;21.54;1482;34;4527.00;334
11373;28;22180871;11373;508;12852;13185;4.60;0.28;371.29;21.61;1479;34;4528.00;333
11375;28;22180891;11375;505;12854;13186;4.58;0.28;371.41;21.61;1479;34;4529.00;332
11375;28;22180914;11375;505;12854;13186;4.61;0.28;371.41;21.61;1479;34;4530.00;332
11379;28;22180935;11379;507;12857;13186;4.56;0.28;371.52;21.75;1478;34;4531.00;329
11382;28;22180955;11382;509;12858;13186;4.57;0.28;371.58;21.82;1476;34;4532.00;328
11387;28;22180976;11387;502;12859;13186;4.55;0.28;371.63;21.90;1472;34;4533.00;327
11388;28;22180996;11388;507;12859;13186;4.56;0.28;371.71;21.90;1471;34;4534.00;327
11391;28;22181016;11391;507;12860;13186;4.56;0.28;371.83;21.90;1469;34;4535.00;326
11396;28;22181036;11396;527;12902;13256;4.60;0.28;371.96;21.97;1506;34;4536.00;354
11400;28;22181063;11400;524;12903;13257;4.59;0.28;371.96;21.97;1503;34;4537.00;354
11403;28;22181085;11403;517;12907;13257;4.60;0.28;372.03;21.97;1504;34;4538.00;350
11404;28;22181104;11404;523;12913;13257;4.59;0.28;372.01;22.10;1509;34;4539.00;344
11410;28;22181123;11410;533;12915;13257;4.59;0.28;372.09;22.10;1505;34;4540.00;342
11414;28;22181150;11414;539;12915;13257;4.58;0.28;372.18;22.10;1501;34;4541.00;342
11417;28;22181168;11417;552;12921;13257;4.51;0.28;372.31;22.24;1504;34;4542.00;336
11424;28;22181188;11424;549;12924;13257;4.46;0.27;372.39;22.24;1500;34;4543.00;333
11429;28;22181207;11429;547;12927;13258;4.43;0.27;372.48;22.38;1498;34;4544.00;331
11433;28;22181229;11433;552;12929;13260;4.41;0.27;372.45;22.38;1496;34;4545.00;331
11436;28;22181249;11436;553;12930;13260;4.37;0.27;372.51;22.38;1494;34;4546.00;330
11442;28;22181269;11442;558;12936;13264;4.26;0.26;372.47;22.51;1494;34;4547.00;328
11447;28;22181288;11447;567;12938;13264;4.15;0.25;372.42;22.51;1491;34;4548.00;326
11452;28;22181308;11452;569;12942;13264;4.05;0.25;372.54;22.65;1490;34;4549.00;322
11456;28;22181328;11456;564;12945;13264;4.01;0.25;372.54;22.65;1489;34;4550.00;319
11460;28;22181348;11460;562;12949;13270;3.96;0.24;372.59;22.64;1489;34;4551.00;321
11464;28;22181368;11464;561;12952;13270;3.92;0.24;372.62;22.78;1488;34;4552.00;318
11470;28;22181387;11470;555;12952;13270;3.86;0.24;372.62;22.78;1482;34;4553.00;318
11473;28;22181406;11473;559;12954;13273;3.85;0.24;372.69;22.78;1481;34;4554.00;319
11476;28;22181427;11476;562;12954;13273;3.86;0.24;372.69;22.78;1478;34;4555.00;319
11478;28;22181446;11478;564;12954;13273;3.91;0.24;372.76;22.78;1476;34;4556.00;319
11481;28;22181465;11481;563;12954;13274;3.95;0.24;372.78;22.78;1473;34;4557.00;320
11488;28;22181484;11488;556;12955;13275;3.94;0.24;372.84;22.78;1467;34;4558.00;320
11489;28;22181504;11489;564;12955;13275;3.96;0.24;372.85;22.78;1466;34;4559.00;320
11491;28;22181525;11491;565;12971;13301;4.08;0.25;372.86;22.75;1480;34;4560.00;330
11495;28;22181547;11495;561;12972;13301;4.03;0.25;372.97;22.75;1477;34;4561.00;329
11496;28;22181567;11496;560;12974;13301;4.00;0.24;372.99;22.75;1478;34;4562.00;327
11504;28;22181585;11504;560;12974;13302;3.95;0.24;372.94;22.75;1470;34;4563.00;328
11507;28;22181605;11507;570;12974;13302;3.91;0.24;372.94;22.75;1467;34;4564.00;328
11512;28;22181624;11512;571;12977;13306;3.85;0.23;372.94;22.74;1465;34;4565.00;329
11516;28;22181645;11516;561;12977;13306;3.79;0.23;372.98;22.74;1461;34;4566.00;329
11519;28;22181666;11519;574;12980;13310;3.73;0.23;372.97;22.74;1461;34;4567.00;330
11523;28;22181685;11523;571;12981;13310;3.64;0.22;373.07;22.74;1458;34;4568.00;329
11527;28;22181705;11527;585;12981;13310;3.58;0.22;373.14;22.74;1454;34;4569.00;329
11529;28;22181729;11529;596;12982;13310;3.58;0.22;373.16;22.74;1453;34;4570.00;328
11533;28;22181752;11533;602;12982;13310;3.54;0.22;373.28;22.74;1449;34;4571.00;328
11538;28;22181774;11538;594;12992;13322;3.57;0.22;373.47;22.72;1454;34;4572.00;330
11540;28;22181800;11540;591;12993;13322;3.56;0.22;373.47;22.72;1453;34;4573.00;329
11544;28;22181821;11544;593;12997;13322;3.55;0.22;373.56;22.79;1453;34;4574.00;325
11546;28;22181848;11546;588;12999;13322;3.50;0.22;373.58;22.79;1453;34;4575.00;323
11548;28;22181876;11548;585;12999;13322;3.49;0.22;373.57;22.79;1451;34;4576.00;323
11552;28;22181903;11552;598;12999;13322;3.48;0.21;373.57;22.79;1447;34;4577.00;323
11561;28;22181932;11561;597;13000;13323;3.39;0.21;373.68;22.79;1439;34;4578.00;323
11566;28;22181956;11566;600;13000;13323;3.34;0.21;373.61;22.79;1434;34;4579.00;323
11570;28;22181980;11570;599;13005;13329;3.32;0.20;373.67;22.78;1435;34;4580.00;324
11574;28;22182001;11574;599;13007;13330;3.32;0.20;373.69;22.78;1433;34;4581.00;323
11578;28;22182022;11578;588;13008;13330;3.34;0.20;373.75;22.78;1430;34;4582.00;322
11581;28;22182043;11581;595;13008;13330;3.37;0.21;373.78;22.78;1427;34;4583.00;322
11587;28;22182062;11587;607;13011;13334;3.34;0.21;373.84;22.77;1424;34;4584.00;323
11590;28;22182081;11590;612;13011;13334;3.32;0.20;373.91;22.77;1421;34;4585.00;323
11596;28;22182099;11596;616;13011;13334;3.25;0.20;373.90;22.77;1415;34;4586.00;323
11598;28;22182117;11598;614;13012;13335;3.24;0.20;373.86;22.77;1414;34;4587.00;323
11601;28;22182134;11601;623;13015;13339;3.19;0.19;373.99;22.77;1414;34;4588.00;324
11604;28;22182152;11604;620;13015;13339;3.17;0.19;373.98;22.77;1411;34;4589.00;324
11606;28;22182170;11606;624;13019;13345;3.22;0.20;373.96;22.76;1413;34;4590.00;326
11611;28;22182189;11611;635;13019;13345;3.19;0.19;374.09;22.76;1408;34;4591.00;326
11615;28;22182207;11615;633;13021;13345;3.19;0.19;374.14;22.76;1406;34;4592.00;324
11617;28;22182225;11617;639;13021;13345;3.16;0.19;374.11;22.76;1404;34;4593.00;324
11619;28;22182244;11619;647;13025;13349;3.15;0.19;374.21;22.75;1406;34;4594.00;324
11624;28;22182263;11624;656;13025;13349;3.13;0.19;374.35;22.75;1401;34;4595.00;324
11627;28;22182280;11627;652;13025;13349;3.12;0.19;374.33;22.75;1398;34;4596.00;324
11628;28;22182297;11628;645;13025;13349;3.16;0.19;374.36;22.75;1397;34;4597.00;324
11629;28;22182314;11629;640;13025;13350;3.20;0.19;374.35;22.75;1396;34;4598.00;325
11630;28;22182331;11630;634;13026;13351;3.24;0.20;374.33;22.75;1396;34;4599.00;325
11632;28;22182369;11632;635;13026;13351;3.30;0.20;374.33;22.75;1394;34;4600.00;325
11637;28;22182395;11637;632;13027;13352;3.34;0.20;374.28;22.75;1390;34;4601.00;325
11637;28;22182415;11637;632;13027;13352;3.38;0.21;374.28;22.75;1390;34;4602.00;325
11641;28;22182434;11641;635;13027;13352;3.38;0.21;374.32;22.75;1386;34;4603.00;325
11643;28;22182452;11643;627;13027;13352;3.41;0.21;374.28;22.75;1384;34;4604.00;325
11646;28;22182470;11646;631;13027;13352;3.39;0.21;374.25;22.75;1381;34;4605.00;325
11648;28;22182487;11648;622;13027;13352;3.42;0.21;374.25;22.75;1379;34;4606.00;325
11651;28;22182505;11651;616;13027;13352;3.43;0.21;374.18;22.75;1376;34;4607.00;325
11654;28;22182524;11654;623;13097;13479;3.73;0.23;374.10;22.62;1443;34;4608.00;382
11655;28;22182557;11655;618;13097;13480;3.77;0.23;374.07;22.62;1442;34;4609.00;383
11656;28;22182582;11656;605;13104;13480;3.88;0.24;374.04;22.61;1448;34;4610.00;376
11656;28;22182608;11656;604;13104;13480;3.95;0.24;374.04;22.61;1448;34;4611.00;376
11656;28;22182633;11656;604;13109;13480;4.04;0.25;374.04;22.61;1453;34;4612.00;371
11657;28;22182655;11657;615;13111;13480;4.06;0.25;374.07;22.60;1454;34;4613.00;369
11659;28;22182681;11659;622;13117;13480;4.11;0.25;374.10;22.60;1458;34;4614.00;363
11659;28;22182703;11659;625;13118;13480;4.13;0.25;374.10;22.60;1459;34;4615.00;362
11659;28;22182737;11659;627;13121;13481;4.19;0.26;374.10;22.59;1462;34;4616.00;360
11660;28;22182759;11660;629;13124;13482;4.20;0.26;374.09;22.59;1464;34;4617.00;358
11661;28;22182786;11661;633;13127;13482;4.20;0.26;374.08;22.59;1466;34;4618.00;355
11663;28;22182807;11663;637;13132;13483;4.15;0.25;374.17;22.58;1469;34;4619.00;351
11664;28;22182833;11664;631;13136;13483;4.13;0.25;374.21;22.58;1472;34;4620.00;347
11665;28;22182865;11665;620;13139;13483;4.14;0.25;374.21;22.58;1474;34;4621.00;344
11666;28;22182887;11666;622;13139;13483;4.13;0.25;374.21;22.58;1473;34;4622.00;344
11668;28;22182907;11668;609;13143;13487;4.14;0.25;374.26;22.57;1475;34;4623.00;344
11669;28;22182933;11669;612;13144;13487;4.14;0.25;374.26;22.57;1475;34;4624.00;343
11669;28;22182954;11669;602;13146;13487;4.15;0.25;374.26;22.57;1477;34;4625.00;341
11670;28;22182977;11670;597;13149;13490;4.19;0.26;374.26;22.57;1479;34;4626.00;341
11671;29;22183015;11671;594;13150;13490;4.30;0.26;374.24;22.56;1479;35;4627.00;340
11671;29;22183052;11671;590;13151;13490;4.32;0.26;374.24;22.56;1480;35;4628.00;339
11671;29;22183072;11671;591;13154;13494;4.36;0.27;374.24;22.56;1483;35;4629.00;340
11674;29;22183096;11674;583;13156;13495;4.42;0.27;374.21;22.56;1482;35;4630.00;339
11675;29;22183118;11675;578;13157;13495;4.48;0.27;374.24;22.56;1482;35;4631.00;338
11676;29;22183140;11676;574;13160;13499;4.55;0.28;374.24;22.63;1484;35;4632.00;339
11680;29;22183163;11680;567;13161;13499;4.57;0.28;374.16;22.63;1481;35;4633.00;338
11682;29;22183186;11682;567;13161;13499;4.56;0.28;374.14;22.63;1479;35;4634.00;338
11682;29;22183219;11682;572;13163;13501;4.58;0.28;374.14;22.62;1481;35;4635.00;338
11684;29;22183241;11684;573;13163;13501;4.53;0.28;374.13;22.62;1479;35;4636.00;338
11685;29;22183264;11685;576;13167;13507;4.57;0.28;374.16;22.62;1482;35;4637.00;340
11685;29;22183285;11685;583;13167;13507;4.62;0.28;374.16;22.62;1482;35;4638.00;340
11687;29;22183304;11687;592;13167;13508;4.61;0.28;374.18;22.62;1480;35;4639.00;341
11688;29;22183325;11688;591;13167;13508;4.60;0.28;374.18;22.62;1479;35;4640.00;341
11691;29;22183348;11691;583;13167;13508;4.63;0.28;374.16;22.62;1476;35;4641.00;341
11693;29;22183370;11693;587;13167;13508;4.68;0.28;374.19;22.62;1474;35;4642.00;341
11697;29;22183391;11697;572;13167;13508;4.67;0.28;374.14;22.62;1470;35;4643.00;341
11697;29;22183416;11697;564;13176;13520;4.74;0.29;374.14;22.60;1479;35;4644.00;344
11699;29;22183440;11699;561;13177;13520;4.79;0.29;374.22;22.60;1478;35;4645.00;343
11702;29;22183465;11702;551;13178;13520;4.85;0.30;374.21;22.60;1476;35;4646.00;342
11705;29;22183488;11705;547;13178;13520;4.88;0.30;374.23;22.60;1473;35;4647.00;342
11710;29;22183511;11710;540;13178;13520;4.89;0.30;374.25;22.60;1468;35;4648.00;342
11712;29;22183534;11712;540;13178;13520;4.91;0.30;374.31;22.60;1466;35;4649.00;342
11716;29;22183557;11716;538;13184;13526;4.88;0.30;374.37;22.67;1468;35;4650.00;342
11721;29;22183584;11721;534;13184;13526;4.84;0.29;374.42;22.67;1463;35;4651.00;342
11721;29;22183606;11721;532;13187;13530;4.84;0.29;374.42;22.66;1466;35;4652.00;343
11724;29;22183632;11724;528;13188;13531;4.83;0.29;374.41;22.66;1464;35;4653.00;343
11727;29;22183654;11727;530;13188;13531;4.80;0.29;374.45;22.66;1461;35;4654.00;343
11730;29;22183680;11730;527;13189;13531;4.76;0.29;374.46;22.74;1459;35;4655.00;342
11733;29;22183706;11733;529;13199;13544;4.73;0.29;374.49;22.72;1466;35;4656.00;345
11736;29;22183731;11736;531;13199;13544;4.70;0.29;374.47;22.72;1463;35;4657.00;345
11739;29;22183752;11739;530;13200;13544;4.67;0.28;374.51;22.72;1461;35;4658.00;344
11741;29;22183772;11741;535;13202;13545;4.68;0.28;374.48;22.80;1461;35;4659.00;343
11746;29;22183793;11746;541;13202;13546;4.66;0.28;374.59;22.80;1456;35;4660.00;344
11748;29;22183814;11748;537;13202;13546;4.69;0.28;374.63;22.80;1454;35;4661.00;344
11750;29;22183835;11750;538;13204;13549;4.74;0.29;374.61;22.79;1454;35;4662.00;345
11752;29;22183856;11752;546;13205;13549;4.77;0.29;374.69;22.79;1453;35;4663.00;344
11756;29;22183878;11756;552;13205;13549;4.81;0.29;374.70;22.79;1449;35;4664.00;344
11758;29;22183899;11758;554;13205;13549;4.83;0.29;374.76;22.79;1447;35;4665.00;344
11760;29;22183920;11760;552;13209;13555;4.89;0.30;374.86;22.79;1449;35;4666.00;346
11762;29;22183944;11762;557;13209;13555;4.92;0.30;374.86;22.79;1447;35;4667.00;346
11764;29;22183967;11764;561;13209;13555;4.89;0.30;374.94;22.79;1445;35;4668.00;346
11767;29;22183988;11767;563;13209;13555;4.84;0.29;374.91;22.79;1442;35;4669.00;346
11768;29;22184012;11768;562;13212;13559;4.81;0.29;374.95;22.78;1444;35;4670.00;347
11771;29;22184035;11771;565;13213;13560;4.79;0.29;374.90;22.78;1442;35;4671.00;347
11775;29;22184055;11775;562;13213;13560;4.78;0.29;374.95;22.78;1438;35;4672.00;347
11778;29;22184074;11778;563;13216;13561;4.77;0.29;375.04;22.78;1438;35;4673.00;345
11781;29;22184098;11781;557;13217;13561;4.75;0.29;375.03;22.86;1436;35;4674.00;344
11783;29;22184119;11783;557;13217;13561;4.74;0.29;375.08;22.86;1434;35;4675.00;344
11784;29;22184140;11784;563;13219;13561;4.76;0.29;375.15;22.86;1435;35;4676.00;342
11788;30;22184162;11788;563;13219;13561;4.75;0.29;375.20;22.86;1431;36;4677.00;342
11791;30;22184204;11791;572;13219;13561;4.74;0.29;375.24;22.86;1428;36;4678.00;342
11792;30;22184226;11792;571;13219;13561;4.72;0.29;375.28;22.86;1427;36;4679.00;342
11793;30;22184255;11793;583;13277;13686;4.87;0.30;375.27;22.76;1484;36;4680.00;409
11796;30;22184293;11796;577;13281;13687;4.87;0.30;375.36;22.75;1485;36;4681.00;406
11798;30;22184317;11798;581;13289;13687;4.89;0.30;375.37;22.74;1491;36;4682.00;398
11800;30;22184338;11800;580;13291;13687;4.86;0.30;375.49;22.74;1491;36;4683.00;396
11802;30;22184362;11802;578;13295;13687;4.89;0.30;375.58;22.73;1493;36;4684.00;392
11802;30;22184382;11802;576;13297;13687;4.86;0.30;375.58;22.73;1495;36;4685.00;390
11806;30;22184402;11806;594;13301;13687;4.84;0.30;375.72;22.72;1495;36;4686.00;386
11808;31;22184422;11808;586;13306;13687;4.83;0.30;375.80;22.72;1498;37;4687.00;381
11812;31;22184457;11812;594;13309;13688;4.81;0.30;375.98;22.71;1497;37;4688.00;379
11813;31;22184480;11813;606;13312;13689;4.82;0.30;375.98;22.71;1499;37;4689.00;377
11818;31;22184501;11818;594;13316;13689;4.78;0.29;376.02;22.71;1498;37;4690.00;373
11822;31;22184526;11822;597;13320;13693;4.71;0.29;376.16;22.70;1498;37;4691.00;373
11824;31;22184549;11824;595;13322;13693;4.68;0.29;376.15;22.70;1498;37;4692.00;371
11828;31;22184571;11828;584;13322;13693;4.64;0.28;376.27;22.70;1494;37;4693.00;371
11832;31;22184592;11832;588;13324;13693;4.60;0.28;376.34;22.70;1492;37;4694.00;369
11838;31;22184615;11838;587;13328;13699;4.52;0.28;376.44;22.69;1490;37;4695.00;371
11840;31;22184635;11840;583;13330;13699;4.51;0.27;376.51;22.69;1490;37;4696.00;369
11843;31;22184654;11843;595;13332;13699;4.47;0.27;376.60;22.69;1489;37;4697.00;367
11846;31;22184674;11846;599;13333;13702;4.44;0.27;376.63;22.69;1487;37;4698.00;369
11850;31;22184695;11850;595;13334;13702;4.44;0.27;376.80;22.69;1484;37;4699.00;368
11850;31;22184717;11850;596;13335;13702;4.44;0.27;376.80;22.68;1485;37;4700.00;367
11853;31;22184741;11853;594;13336;13703;4.41;0.27;376.87;22.77;1483;37;4701.00;367
11855;31;22184762;11855;597;13338;13704;4.40;0.27;376.92;22.76;1483;37;4702.00;366
11856;31;22184782;11856;595;13339;13704;4.38;0.27;376.94;22.84;1483;37;4703.00;365
11857;31;22184801;11857;609;13349;13717;4.39;0.27;376.93;22.82;1492;37;4704.00;368
11859;31;22184822;11859;600;13349;13717;4.42;0.27;376.94;22.82;1490;37;4705.00;368
11861;31;22184844;11861;604;13350;13717;4.47;0.27;377.03;22.82;1489;37;4706.00;367
11864;31;22184872;11864;608;13352;13718;4.46;0.27;377.06;22.82;1488;37;4707.00;366
11865;31;22184895;11865;616;13352;13718;4.45;0.27;377.04;22.82;1487;37;4708.00;366
11867;31;22184916;11867;613;13355;13722;4.45;0.27;377.11;22.81;1488;37;4709.00;367
11871;31;22184938;11871;614;13356;13722;4.44;0.27;377.17;22.81;1485;37;4710.00;366
11871;31;22184958;11871;620;13359;13726;4.46;0.27;377.17;22.81;1488;37;4711.00;367
11876;31;22184979;11876;619;13359;13726;4.42;0.27;377.22;22.81;1483;37;4712.00;367
11879;31;22184999;11879;619;13359;13726;4.41;0.27;377.25;22.81;1480;37;4713.00;367
11884;31;22185019;11884;621;13359;13726;4.38;0.27;377.28;22.81;1475;37;4714.00;367
11887;31;22185038;11887;620;13359;13726;4.34;0.27;377.38;22.81;1472;37;4715.00;367
11892;31;22185056;11892;624;13369;13738;4.28;0.26;377.35;22.79;1477;37;4716.00;369
11896;31;22185078;11896;628;13369;13738;4.19;0.26;377.47;22.79;1473;37;4717.00;369
11902;31;22185097;11902;632;13370;13738;4.10;0.25;377.46;22.79;1468;37;4718.00;368
11905;31;22185116;11905;636;13370;13738;4.08;0.25;377.50;22.79;1465;37;4719.00;368
11913;31;22185135;11913;645;13370;13738;4.01;0.25;377.46;22.79;1457;37;4720.00;368
11914;31;22185154;11914;650;13370;13738;4.01;0.25;377.45;22.79;1456;37;4721.00;368
11920;31;22185172;11920;652;13370;13739;3.96;0.24;377.47;22.79;1450;37;4722.00;369
11922;31;22185190;11922;657;13370;13739;3.91;0.24;377.55;22.79;1448;37;4723.00;369
11926;31;22185209;11926;658;13375;13745;3.89;0.24;377.54;22.78;1449;37;4724.00;370
11929;31;22185228;11929;648;13377;13747;3.86;0.24;377.67;22.78;1448;37;4725.00;370
11931;31;22185247;11931;639;13377;13747;3.84;0.23;377.75;22.78;1446;37;4726.00;370
11935;31;22185265;11935;639;13377;13747;3.76;0.23;377.89;22.78;1442;37;4727.00;370
11938;31;22185283;11938;637;13380;13751;3.74;0.23;377.93;22.77;1442;37;4728.00;371
11941;31;22185301;11941;628;13380;13751;3.70;0.23;377.89;22.77;1439;37;4729.00;371
11944;31;22185319;11944;627;13380;13751;3.67;0.22;378.00;22.77;1436;37;4730.00;371
11946;31;22185337;11946;631;13381;13752;3.71;0.23;378.06;22.77;1435;37;4731.00;371
11951;31;22185355;11951;616;13384;13756;3.73;0.23;378.08;22.77;1433;37;4732.00;372
11953;31;22185374;11953;613;13384;13756;3.73;0.23;378.09;22.77;1431;37;4733.00;372
11955;31;22185393;11955;609;13387;13759;3.73;0.23;378.19;22.76;1432;37;4734.00;372
11961;31;22185412;11961;610;13387;13759;3.69;0.23;378.18;22.76;1426;37;4735.00;372
11963;31;22185431;11963;607;13387;13759;3.68;0.23;378.21;22.76;1424;37;4736.00;372
11966;31;22185449;11966;601;13387;13759;3.64;0.22;378.19;22.76;1421;37;4737.00;372
11969;31;22185467;11969;592;13391;13763;3.68;0.23;378.21;22.75;1422;37;4738.00;372
11971;31;22185485;11971;596;13391;13763;3.69;0.23;378.20;22.75;1420;37;4739.00;372
11976;31;22185505;11976;599;13391;13763;3.68;0.23;378.25;22.75;1415;37;4740.00;372
11978;31;22185528;11978;598;13391;13763;3.68;0.23;378.29;22.75;1413;37;4741.00;372
11981;31;22185547;11981;595;13391;13764;3.66;0.23;378.33;22.75;1410;37;4742.00;373
11983;31;22185567;11983;589;13392;13765;3.65;0.22;378.45;22.75;1409;37;4743.00;373
11989;31;22185586;11989;597;13392;13765;3.59;0.22;378.48;22.75;1403;37;4744.00;373
11994;31;22185607;11994;605;13393;13766;3.57;0.22;378.68;22.75;1399;37;4745.00;373
12001;31;22185628;12001;603;13393;13766;3.50;0.21;378.93;22.75;1392;37;4746.00;373
12004;31;22185649;12004;607;13393;13766;3.48;0.21;378.95;22.75;1389;37;4747.00;373
12007;31;22185668;12007;611;13393;13766;3.46;0.21;378.96;22.75;1386;37;4748.00;373
12014;31;22185688;12014;613;13393;13766;3.38;0.21;378.87;22.75;1379;37;4749.00;373
12020;31;22185708;12020;619;13393;13766;3.36;0.21;378.99;22.75;1373;37;4750.00;373
12023;31;22185729;12023;629;13393;13766;3.35;0.21;378.98;22.75;1370;37;4751.00;373
12023;31;22185748;12023;641;13459;13893;3.72;0.23;378.98;22.64;1436;37;4752.00;434
12031;31;22185780;12031;644;13462;13894;3.66;0.23;378.93;22.64;1431;37;4753.00;432
12033;31;22185801;12033;648;13470;13894;3.72;0.23;378.94;22.62;1437;37;4754.00;424
12033;31;22185821;12033;650;13475;13894;3.76;0.23;378.94;22.62;1442;37;4755.00;419
12037;31;22185840;12037;649;13480;13894;3.71;0.23;378.92;22.61;1443;37;4756.00;414
12042;31;22185864;12042;652;13484;13894;3.70;0.23;378.92;22.60;1442;37;4757.00;410
12047;31;22185887;12047;658;13487;13894;3.66;0.23;378.94;22.69;1440;37;4758.00;407
12049;31;22185911;12049;660;13491;13894;3.64;0.23;378.94;22.68;1442;37;4759.00;403
12054;31;22185936;12054;659;13493;13895;3.61;0.22;378.91;22.68;1439;37;4760.00;402
12057;31;22185958;12057;656;13495;13896;3.56;0.22;378.97;22.68;1438;37;4761.00;401
12062;31;22185987;12062;657;13498;13896;3.53;0.22;378.92;22.67;1436;37;4762.00;398
12062;31;22186008;12062;659;13499;13897;3.54;0.22;378.92;22.67;1437;37;4763.00;398
12065;31;22186036;12065;670;13501;13897;3.48;0.22;378.88;22.67;1436;37;4764.00;396
12068;31;22186065;12068;675;13502;13897;3.45;0.21;378.87;22.67;1434;37;4765.00;395
12070;31;22186091;12070;672;13504;13897;3.45;0.21;378.87;22.67;1434;37;4766.00;393
12073;31;22186117;12073;673;13507;13901;3.42;0.21;378.87;22.67;1434;37;4767.00;394
12074;31;22186137;12074;675;13508;13901;3.43;0.21;378.88;22.66;1434;37;4768.00;393
12076;31;22186155;12076;680;13509;13901;3.44;0.21;378.85;22.66;1433;37;4769.00;392
12076;31;22186175;12076;685;13512;13907;3.48;0.21;378.85;22.66;1436;37;4770.00;395
12079;31;22186194;12079;686;13513;13907;3.45;0.21;378.86;22.66;1434;37;4771.00;394
12082;31;22186212;12082;679;13514;13907;3.44;0.21;378.85;22.66;1432;37;4772.00;393
12082;31;22186231;12082;673;13517;13911;3.45;0.21;378.85;22.65;1435;37;4773.00;394
12086;31;22186249;12086;679;13519;13912;3.46;0.21;378.87;22.65;1433;37;4774.00;393
12088;31;22186268;12088;677;13519;13912;3.46;0.21;378.85;22.65;1431;37;4775.00;393
12089;31;22186289;12089;679;13523;13916;3.47;0.21;378.84;22.64;1434;37;4776.00;393
12094;31;22186312;12094;670;13523;13916;3.48;0.21;378.80;22.64;1429;37;4777.00;393
12094;31;22186336;12094;667;13524;13916;3.51;0.22;378.80;22.65;1430;37;4778.00;392
12094;31;22186357;12094;661;13524;13917;3.52;0.22;378.80;22.65;1430;37;4779.00;393
12095;31;22186383;12095;663;13526;13917;3.52;0.22;378.79;22.73;1431;37;4780.00;391
12098;31;22186415;12098;644;13530;13923;3.55;0.22;378.75;22.72;1432;38;4781.00;393
12100;31;22186456;12100;631;13531;13923;3.64;0.22;378.76;22.73;1431;38;4782.00;392
12101;31;22186483;12101;617;13531;13924;3.67;0.23;378.76;22.73;1430;38;4783.00;393
12102;31;22186511;12102;601;13532;13924;3.77;0.23;378.80;22.73;1430;38;4784.00;392
12103;31;22186538;12103;594;13532;13924;3.84;0.24;378.78;22.73;1429;38;4785.00;392
12104;31;22186566;12104;592;13532;13924;3.88;0.24;378.75;22.73;1428;38;4786.00;392
12106;31;22186585;12106;577;13532;13924;3.93;0.24;378.72;22.73;1426;38;4787.00;392
12109;31;22186605;12109;577;13541;13936;4.03;0.25;378.76;22.71;1432;38;4788.00;395
12110;31;22186627;12110;567;13541;13936;4.10;0.25;378.79;22.71;1431;38;4789.00;395
12111;31;22186647;12111;566;13541;13936;4.17;0.25;378.76;22.71;1430;38;4790.00;395
12112;31;22186666;12112;568;13541;13936;4.24;0.26;378.76;22.71;1429;38;4791.00;395
12113;31;22186686;12113;558;13541;13936;4.34;0.26;378.80;22.71;1428;38;4792.00;395
12114;31;22186705;12114;557;13543;13936;4.42;0.27;378.85;22.80;1429;38;4793.00;393
12117;31;22186728;12117;551;13546;13940;4.51;0.27;378.84;22.79;1429;38;4794.00;394
12120;31;22186749;12120;552;13546;13940;4.55;0.28;378.87;22.79;1426;38;4795.00;394
12122;31;22186769;12122;543;13549;13944;4.59;0.28;378.91;22.79;1427;38;4796.00;395
12125;32;22186791;12125;541;13549;13945;4.64;0.28;379.02;22.79;1424;39;4797.00;396
12129;32;22186838;12129;538;13549;13945;4.65;0.28;379.09;22.79;1420;39;4798.00;396
12132;32;22186865;12132;538;13549;13945;4.68;0.28;379.17;22.79;1417;39;4799.00;396
12132;32;22186895;12132;549;13571;13986;4.74;0.29;379.17;22.75;1439;39;4800.00;415
12135;32;22186935;12135;542;13571;13986;4.76;0.29;379.35;22.75;1436;39;4801.00;415
12137;32;22186958;12137;540;13572;13986;4.78;0.29;379.42;22.75;1435;39;4802.00;414
12137;32;22186984;12137;530;13575;13987;4.84;0.29;379.42;22.75;1438;39;4803.00;412
12141;32;22187006;12141;536;13576;13988;4.86;0.30;379.46;22.75;1435;39;4804.00;412
12143;32;22187033;12143;540;13577;13988;4.87;0.30;379.58;22.74;1434;39;4805.00;411
12143;32;22187055;12143;524;13579;13991;4.88;0.30;379.58;22.74;1436;39;4806.00;412
12147;32;22187081;12147;530;13579;13991;4.84;0.29;379.73;22.74;1432;39;4807.00;412
12149;32;22187104;12149;529;13579;13991;4.88;0.30;379.77;22.74;1430;39;4808.00;412
12151;32;22187124;12151;545;13579;13991;4.85;0.29;379.88;22.74;1428;39;4809.00;412
12154;32;22187145;12154;559;13585;13997;4.81;0.29;379.88;22.73;1431;39;4810.00;412
12156;32;22187166;12156;565;13585;13997;4.81;0.29;379.94;22.73;1429;39;4811.00;412
12160;32;22187187;12160;558;13585;13997;4.76;0.29;380.07;22.73;1425;39;4812.00;412
12162;32;22187206;12162;555;13585;13997;4.78;0.29;380.09;22.73;1423;39;4813.00;412
12166;32;22187228;12166;562;13588;14001;4.74;0.29;380.24;22.73;1422;39;4814.00;413
12171;32;22187248;12171;552;13589;14003;4.75;0.29;380.36;22.73;1418;39;4815.00;414
12172;32;22187269;12172;551;13591;14003;4.77;0.29;380.40;22.73;1419;39;4816.00;412
12174;32;22187290;12174;550;13592;14004;4.82;0.29;380.47;22.73;1418;39;4817.00;412
12178;32;22187316;12178;544;13593;14004;4.80;0.29;380.56;22.81;1415;39;4818.00;411
12181;32;22187341;12181;536;13593;14004;4.83;0.29;380.64;22.81;1412;39;4819.00;411
12185;32;22187368;12185;532;13593;14004;4.83;0.29;380.72;22.81;1408;39;4820.00;411
12187;32;22187391;12187;527;13593;14004;4.85;0.29;380.72;22.81;1406;39;4821.00;411
12187;32;22187418;12187;528;13594;14004;4.94;0.30;380.72;22.81;1407;39;4822.00;410
12190;32;22187441;12190;521;13594;14004;4.95;0.30;380.71;22.81;1404;39;4823.00;410
12192;32;22187468;12192;530;13630;14074;4.98;0.30;380.75;22.75;1438;39;4824.00;444
12192;32;22187500;12192;522;13632;14075;5.01;0.31;380.75;22.75;1440;39;4825.00;443
12192;32;22187524;12192;504;13635;14075;5.07;0.31;380.75;22.75;1443;39;4826.00;440
12193;32;22187549;12193;502;13635;14075;5.05;0.31;380.75;22.75;1442;39;4827.00;440
12198;32;22187568;12198;504;13639;14077;5.04;0.31;380.71;22.83;1441;39;4828.00;438
12199;32;22187588;12199;497;13639;14077;5.03;0.31;380.74;22.83;1440;39;4829.00;438
12202;32;22187611;12202;493;13642;14077;5.07;0.31;380.79;22.83;1440;39;4830.00;435
12205;32;22187632;12205;498;13642;14077;5.09;0.31;380.79;22.83;1437;39;4831.00;435
12208;32;22187651;12208;488;13644;14078;5.07;0.31;380.84;22.83;1436;39;4832.00;434
12210;32;22187672;12210;478;13646;14079;5.03;0.31;380.82;22.83;1436;39;4833.00;433
12213;32;22187692;12213;484;13650;14079;5.00;0.30;380.91;22.82;1437;39;4834.00;429
12215;32;22187714;12215;481;13655;14083;4.97;0.30;380.93;22.82;1440;39;4835.00;428
12218;32;22187737;12218;483;13657;14083;4.95;0.30;380.94;22.82;1439;39;4836.00;426
12220;32;22187760;12220;480;13658;14083;4.96;0.30;381.01;22.82;1438;39;4837.00;425
12221;32;22187780;12221;487;13658;14083;4.97;0.30;381.06;22.82;1437;39;4838.00;425
12224;32;22187802;12224;485;13662;14089;4.97;0.30;381.07;22.81;1438;39;4839.00;427
12229;32;22187823;12229;481;13663;14089;4.93;0.30;381.12;22.81;1434;39;4840.00;426
12232;32;22187848;12232;492;13664;14089;4.90;0.30;381.19;22.89;1432;39;4841.00;425
12234;32;22187882;12234;493;13665;14092;4.88;0.30;381.20;22.89;1431;39;4842.00;427
12237;32;22187904;12237;487;13665;14092;4.84;0.29;381.19;22.89;1428;39;4843.00;427
12239;32;22187929;12239;498;13665;14092;4.80;0.29;381.24;22.89;1426;39;4844.00;427
12240;32;22187952;12240;497;13665;14093;4.80;0.29;381.23;22.89;1425;39;4845.00;428
12242;32;22187974;12242;496;13667;14094;4.79;0.29;381.37;22.98;1425;39;4846.00;427
12244;32;22187998;12244;490;13667;14094;4.81;0.29;381.45;22.98;1423;39;4847.00;427
12246;32;22188020;12246;505;13676;14107;4.86;0.30;381.46;22.97;1430;39;4848.00;431
12249;32;22188041;12249;496;13677;14107;4.91;0.30;381.49;23.05;1428;39;4849.00;430
12253;32;22188063;12253;506;13677;14107;4.95;0.30;381.58;23.05;1424;39;4850.00;430
12255;32;22188082;12255;498;13677;14108;5.01;0.31;381.66;23.05;1422;39;4851.00;431
12260;32;22188101;12260;496;13677;14108;5.04;0.31;381.76;23.05;1417;39;4852.00;431
12263;32;22188121;12263;497;13680;14112;5.10;0.31;381.89;23.04;1417;39;4853.00;432
12267;32;22188141;12267;495;13682;14112;5.12;0.31;381.91;23.05;1415;39;4854.00;430
12268;32;22188162;12268;497;13685;14116;5.11;0.31;381.93;23.04;1417;39;4855.00;431
12271;32;22188182;12271;501;13686;14116;5.07;0.31;381.93;23.04;1415;39;4856.00;430
12273;32;22188202;12273;500;13686;14116;5.07;0.31;382.05;23.04;1413;39;4857.00;430
12276;32;22188221;12276;493;13686;14116;5.03;0.31;382.15;23.04;1410;39;4858.00;430
12277;32;22188241;12277;491;13686;14116;5.03;0.31;382.13;23.04;1409;39;4859.00;430
12285;32;22188264;12285;503;13710;14150;5.07;0.31;382.47;23.00;1425;39;4860.00;440
12287;32;22188287;12287;507;13710;14150;5.07;0.31;382.55;23.00;1423;39;4861.00;440
12288;32;22188310;12288;509;13711;14150;5.09;0.31;382.59;23.00;1423;39;4862.00;439
12292;33;22188332;12292;510;13712;14150;5.08;0.31;382.75;23.00;1420;40;4863.00;438
12293;33;22188368;12293;516;13713;14150;5.08;0.31;382.78;23.00;1420;40;4864.00;437
12296;33;22188389;12296;516;13713;14150;5.10;0.31;382.80;23.00;1417;40;4865.00;437
12297;33;22188412;12297;518;13713;14151;5.07;0.31;382.87;23.00;1416;40;4866.00;438
12300;33;22188434;12300;525;13713;14151;4.98;0.30;383.00;23.00;1413;40;4867.00;438
12305;33;22188455;12305;529;13717;14157;4.98;0.30;383.22;22.99;1412;40;4868.00;440
12307;33;22188480;12307;536;13717;14158;4.95;0.30;383.25;22.99;1410;40;4869.00;441
12311;33;22188502;12311;538;13717;14158;4.90;0.30;383.44;22.99;1406;40;4870.00;441
12314;33;22188531;12314;538;13718;14158;4.88;0.30;383.52;23.08;1404;40;4871.00;440
12314;33;22188552;12314;540;13721;14162;4.87;0.30;383.52;23.07;1407;40;4872.00;441
12317;33;22188572;12317;548;13721;14162;4.80;0.29;383.54;23.07;1404;40;4873.00;441
12318;33;22188592;12318;542;13722;14162;4.73;0.29;383.52;23.16;1404;40;4874.00;440
12322;33;22188614;12322;548;13723;14163;4.65;0.28;383.53;23.16;1401;40;4875.00;440
12325;33;22188634;12325;548;13726;14167;4.57;0.28;383.61;23.15;1401;40;4876.00;441
12327;33;22188655;12327;555;13726;14167;4.53;0.28;383.68;23.15;1399;40;4877.00;441
12330;33;22188674;12330;551;13727;14170;4.49;0.27;383.64;23.15;1397;40;4878.00;443
12332;33;22188695;12332;547;13727;14170;4.45;0.27;383.68;23.15;1395;40;4879.00;443
12337;33;22188713;12337;543;13727;14170;4.42;0.27;383.85;23.15;1390;40;4880.00;443
12338;33;22188731;12338;540;13727;14170;4.43;0.27;383.86;23.15;1389;40;4881.00;443
12341;33;22188749;12341;540;13730;14174;4.45;0.27;383.90;23.15;1389;40;4882.00;444
12346;33;22188767;12346;543;13730;14174;4.43;0.27;384.00;23.15;1384;40;4883.00;444
12346;33;22188784;12346;534;13730;14174;4.45;0.27;384.00;23.15;1384;40;4884.00;444
12350;33;22188802;12350;538;13730;14174;4.46;0.27;384.04;23.15;1380;40;4885.00;444
12353;33;22188820;12353;538;13730;14175;4.50;0.27;384.05;23.15;1377;40;4886.00;445
12353;33;22188838;12353;542;13730;14176;4.52;0.27;384.05;23.15;1377;40;4887.00;446
12356;33;22188856;12356;545;13730;14176;4.51;0.27;384.12;23.15;1374;40;4888.00;446
12362;33;22188877;12362;549;13731;14177;4.46;0.27;384.13;23.14;1369;40;4889.00;446
12364;33;22188899;12364;551;13731;14177;4.41;0.27;384.13;23.14;1367;40;4890.00;446
12368;33;22188917;12368;552;13731;14177;4.34;0.26;384.10;23.14;1363;40;4891.00;446
12371;33;22188938;12371;559;13731;14177;4.26;0.26;384.15;23.14;1360;40;4892.00;446
12375;33;22188955;12375;567;13731;14177;4.20;0.25;384.21;23.14;1356;40;4893.00;446
12379;33;22188974;12379;566;13731;14177;4.14;0.25;384.24;23.14;1352;40;4894.00;446
12381;33;22188992;12381;562;13731;14177;4.09;0.25;384.27;23.14;1350;40;4895.00;446
12383;33;22189011;12383;578;13788;14304;4.32;0.27;384.30;23.05;1405;40;4896.00;516
12384;33;22189038;12384;579;13791;14305;4.26;0.26;384.32;23.04;1407;40;4897.00;514
12388;33;22189055;12388;582;13798;14305;4.21;0.26;384.33;23.03;1410;40;4898.00;507
12390;33;22189072;12390;579;13800;14305;4.11;0.26;384.33;23.03;1410;40;4899.00;505
12394;33;22189089;12394;569;13805;14305;4.02;0.25;384.28;23.02;1411;40;4900.00;500
12398;33;22189113;12398;566;13807;14305;3.95;0.25;384.22;23.02;1409;40;4901.00;498
12400;33;22189133;12400;563;13809;14305;3.92;0.24;384.24;23.02;1409;40;4902.00;496
12403;33;22189153;12403;561;13809;14305;3.88;0.24;384.33;23.02;1406;40;4903.00;496
12407;33;22189183;12407;564;13811;14306;3.88;0.24;384.37;23.02;1404;40;4904.00;495
12409;33;22189202;12409;562;13813;14308;3.89;0.24;384.40;23.01;1404;40;4905.00;495
12410;33;22189221;12410;559;13815;14308;3.92;0.24;384.39;23.01;1405;40;4906.00;493
12412;33;22189240;12412;548;13817;14309;3.94;0.24;384.48;23.01;1405;40;4907.00;492
12413;33;22189258;12413;543;13819;14309;4.00;0.25;384.47;23.01;1406;40;4908.00;490
12415;33;22189280;12415;542;13820;14309;3.98;0.25;384.49;23.01;1405;40;4909.00;489
12421;33;22189299;12421;537;13821;14309;3.92;0.24;384.46;23.01;1400;40;4910.00;488
12423;33;22189318;12423;540;13824;14313;3.87;0.24;384.43;23.00;1401;40;4911.00;489
12428;33;22189337;12428;537;13825;14313;3.83;0.24;384.52;23.00;1397;40;4912.00;488
12433;33;22189356;12433;545;13825;14313;3.76;0.23;384.46;23.00;1392;40;4913.00;488
12437;33;22189373;12437;538;13826;14316;3.76;0.23;384.41;23.00;1389;40;4914.00;490
12443;33;22189393;12443;540;13826;14316;3.76;0.23;384.34;23.00;1383;40;4915.00;490
12448;33;22189413;12448;544;13826;14316;3.76;0.23;384.25;23.00;1378;40;4916.00;490
12450;33;22189432;12450;552;13827;14320;3.81;0.23;384.29;23.00;1377;40;4917.00;493
12452;33;22189451;12452;552;13828;14321;3.85;0.24;384.27;23.00;1376;40;4918.00;493
12458;33;22189472;12458;556;13828;14321;3.87;0.24;384.31;23.00;1370;40;4919.00;493
12462;33;22189498;12462;558;13831;14326;3.86;0.24;384.30;22.99;1369;40;4920.00;495
12470;33;22189520;12470;560;13832;14326;3.83;0.23;384.35;22.99;1362;40;4921.00;494
12472;33;22189542;12472;555;13832;14326;3.80;0.23;384.33;22.99;1360;40;4922.00;494
12476;34;22189566;12476;561;13832;14327;3.77;0.23;384.31;22.99;1356;41;4923.00;495
12478;34;22189616;12478;562;13832;14327;3.74;0.23;384.29;22.99;1354;41;4924.00;495
12481;34;22189638;12481;560;13836;14333;3.73;0.23;384.24;22.98;1355;41;4925.00;497
12485;34;22189659;12485;557;13837;14333;3.65;0.22;384.26;22.98;1352;41;4926.00;496
12487;34;22189682;12487;564;13840;14334;3.65;0.22;384.24;23.00;1353;41;4927.00;494
12490;34;22189700;12490;571;13840;14334;3.60;0.22;384.22;23.00;1350;41;4928.00;494
12493;34;22189719;12493;574;13841;14334;3.53;0.22;384.20;23.01;1348;41;4929.00;493
12494;34;22189736;12494;573;13843;14334;3.49;0.21;384.24;23.01;1349;41;4930.00;491
12497;34;22189754;12497;575;13844;14334;3.47;0.21;384.26;23.02;1347;41;4931.00;490
12499;34;22189772;12499;577;13852;14346;3.54;0.22;384.24;23.00;1353;41;4932.00;494
12502;34;22189791;12502;578;13854;14346;3.51;0.21;384.25;23.02;1352;41;4933.00;492
12504;34;22189813;12504;569;13854;14346;3.52;0.21;384.24;23.02;1350;41;4934.00;492
12507;34;22189836;12507;556;13856;14346;3.53;0.21;384.21;23.02;1349;41;4935.00;490
12509;34;22189855;12509;549;13856;14346;3.57;0.22;384.21;23.02;1347;41;4936.00;490
12512;34;22189877;12512;543;13857;14346;3.57;0.22;384.22;23.02;1345;41;4937.00;489
12515;34;22189900;12515;532;13860;14350;3.62;0.22;384.16;23.03;1345;41;4938.00;490
12516;34;22189923;12516;533;13860;14350;3.70;0.23;384.16;23.03;1344;41;4939.00;490
12518;34;22189946;12518;534;13865;14354;3.73;0.23;384.16;23.04;1347;41;4940.00;489
12519;34;22189970;12519;526;13866;14355;3.75;0.23;384.16;23.04;1347;41;4941.00;489
12521;34;22189991;12521;520;13867;14355;3.78;0.23;384.19;23.05;1346;41;4942.00;488
12523;34;22190015;12523;512;13868;14355;3.87;0.24;384.20;23.05;1345;41;4943.00;487
12525;34;22190037;12525;514;13879;14368;3.97;0.24;384.22;23.04;1354;41;4944.00;489
12526;34;22190057;12526;520;13880;14368;4.00;0.25;384.25;23.04;1354;41;4945.00;488
12529;34;22190075;12529;522;13882;14368;4.04;0.25;384.23;23.06;1353;41;4946.00;486
12534;34;22190094;12534;509;13885;14369;4.09;0.25;384.30;23.14;1351;41;4947.00;484
12535;34;22190121;12535;497;13885;14370;4.12;0.25;384.31;23.14;1350;41;4948.00;485
12538;34;22190147;12538;490;13887;14370;4.17;0.25;384.32;23.15;1349;41;4949.00;483
12539;34;22190167;12539;492;13892;14379;4.22;0.26;384.32;23.15;1353;41;4950.00;487
12540;34;22190187;12540;488;13892;14379;4.27;0.26;384.29;23.15;1352;41;4951.00;487
12543;34;22190206;12543;492;13895;14379;4.29;0.26;384.28;23.16;1352;41;4952.00;484
12544;34;22190225;12544;492;13897;14379;4.32;0.26;384.26;23.18;1353;41;4953.00;482
12546;34;22190246;12546;498;13901;14385;4.33;0.26;384.37;23.17;1355;41;4954.00;484
12550;34;22190267;12550;503;13903;14385;4.33;0.26;384.39;23.18;1353;41;4955.00;482
12552;34;22190285;12552;493;13905;14385;4.36;0.26;384.44;23.27;1353;41;4956.00;480
12554;34;22190315;12554;493;13906;14385;4.40;0.27;384.48;23.28;1352;41;4957.00;479
12554;34;22190333;12554;489;13910;14389;4.46;0.27;384.48;23.28;1356;41;4958.00;479
12554;34;22190353;12554;479;13911;14390;4.56;0.28;384.48;23.29;1357;41;4959.00;479
12559;34;22190372;12559;485;13913;14390;4.61;0.28;384.57;23.30;1354;41;4960.00;477
12561;34;22190391;12561;483;13914;14391;4.71;0.29;384.62;23.30;1353;41;4961.00;477
12564;34;22190412;12564;487;13914;14391;4.80;0.29;384.69;23.30;1350;41;4962.00;477
12566;34;22190432;12566;489;13914;14391;4.88;0.30;384.69;23.30;1348;41;4963.00;477
12568;34;22190452;12568;490;13916;14391;4.93;0.30;384.82;23.31;1348;41;4964.00;475
12570;34;22190472;12570;495;13918;14391;4.91;0.30;384.89;23.32;1348;41;4965.00;473
12575;34;22190491;12575;495;13918;14391;4.92;0.30;384.91;23.32;1343;41;4966.00;473
12576;34;22190512;12576;495;13919;14391;4.92;0.30;384.92;23.33;1343;41;4967.00;472
12579;34;22190536;12579;506;13959;14461;4.95;0.30;384.96;23.26;1380;41;4968.00;502
12582;34;22190562;12582;496;13960;14462;4.92;0.30;385.05;23.27;1378;41;4969.00;502
12584;34;22190582;12584;493;13962;14462;4.95;0.30;385.04;23.27;1378;41;4970.00;500
12586;34;22190602;12586;490;13963;14462;5.01;0.31;385.08;23.27;1377;41;4971.00;499
12590;34;22190624;12590;481;13967;14462;5.04;0.31;385.16;23.28;1377;41;4972.00;495
12591;34;22190650;12591;483;13969;14462;5.14;0.31;385.18;23.28;1378;41;4973.00;493
12591;34;22190672;12591;483;13971;14462;5.21;0.32;385.18;23.29;1380;41;4974.00;491
12595;35;22190697;12595;483;13972;14462;5.22;0.32;385.32;23.28;1377;42;4975.00;490
12597;35;22190732;12597;487;13974;14463;5.30;0.32;385.33;23.28;1377;42;4976.00;489
12600;35;22190761;12600;488;13977;14464;5.32;0.32;385.43;23.29;1377;42;4977.00;487
12603;35;22190795;12603;491;13978;14464;5.35;0.33;385.50;23.28;1375;42;4978.00;486
12605;35;22190819;12605;497;13983;14468;5.36;0.33;385.53;23.28;1378;42;4979.00;485
12607;35;22190844;12607;498;13986;14468;5.38;0.33;385.59;23.29;1379;42;4980.00;482
12609;35;22190865;12609;506;13987;14468;5.37;0.33;385.63;23.28;1378;42;4981.00;481
12610;35;22190883;12610;513;13987;14468;5.40;0.33;385.63;23.28;1377;42;4982.00;481
12613;35;22190903;12613;517;13992;14474;5.39;0.33;385.75;23.28;1379;42;4983.00;482
12616;35;22190923;12616;517;13992;14474;5.38;0.33;385.80;23.28;1376;42;4984.00;482
12619;35;22190945;12619;518;13992;14474;5.37;0.33;385.94;23.28;1373;42;4985.00;482
12622;35;22190966;12622;519;13993;14477;5.36;0.33;385.98;23.28;1371;42;4986.00;484
12625;35;22190987;12625;522;13994;14477;5.34;0.32;386.09;23.37;1369;42;4987.00;483
12628;35;22191006;12628;519;13994;14477;5.32;0.32;386.15;23.37;1366;42;4988.00;483
12631;35;22191026;12631;523;13994;14478;5.36;0.33;386.30;23.37;1363;42;4989.00;484
12633;35;22191049;12633;515;13995;14479;5.36;0.33;386.28;23.36;1362;42;4990.00;484
12636;35;22191068;12636;510;13995;14479;5.35;0.33;386.34;23.36;1359;42;4991.00;484
12640;35;22191087;12640;505;14005;14492;5.42;0.33;386.39;23.35;1365;42;4992.00;487
12641;35;22191108;12641;502;14005;14492;5.48;0.33;386.36;23.35;1364;42;4993.00;487
12644;35;22191131;12644;492;14006;14492;5.51;0.34;386.42;23.35;1362;42;4994.00;486
12649;35;22191153;12649;487;14007;14494;5.50;0.33;386.43;23.35;1358;42;4995.00;487
12654;35;22191176;12654;484;14007;14494;5.49;0.33;386.41;23.35;1353;42;4996.00;487
12659;35;22191197;12659;478;14010;14498;5.48;0.33;386.59;23.35;1351;42;4997.00;488
12666;35;22191218;12666;468;14010;14498;5.44;0.33;386.75;23.35;1344;42;4998.00;488
12667;35;22191247;12667;465;14013;14502;5.44;0.33;386.74;23.34;1346;42;4999.00;489
12670;35;22191268;12670;463;14014;14502;5.41;0.33;386.81;23.35;1344;42;5000.00;488
12673;35;22191294;12673;465;14014;14502;5.34;0.32;386.90;23.35;1341;42;5001.00;488
12674;35;22191315;12674;464;14014;14502;5.33;0.32;386.90;23.35;1340;42;5002.00;488
12676;35;22191334;12676;464;14014;14502;5.28;0.32;386.96;23.35;1338;42;5003.00;488
12680;35;22191353;12680;462;14023;14514;5.25;0.32;387.01;23.33;1343;42;5004.00;491
12685;35;22191373;12685;459;14023;14514;5.15;0.31;387.06;23.33;1338;42;5005.00;491
12687;35;22191400;12687;452;14023;14514;5.11;0.31;387.06;23.33;1336;42;5006.00;491
12692;35;22191419;12692;447;14023;14514;5.05;0.31;387.18;23.33;1331;42;5007.00;491
12695;35;22191439;12695;434;14023;14514;5.03;0.31;387.21;23.33;1328;42;5008.00;491
12696;35;22191467;12696;430;14023;14514;5.03;0.31;387.23;23.33;1327;42;5009.00;491
12699;35;22191488;12699;441;14024;14515;5.03;0.31;387.24;23.34;1325;42;5010.00;491
12702;35;22191506;12702;441;14024;14515;5.04;0.31;387.30;23.34;1322;42;5011.00;491
12703;35;22191527;12703;438;14030;14521;5.08;0.31;387.30;23.52;1327;42;5012.00;491
12705;35;22191553;12705;436;14030;14522;5.13;0.31;387.28;23.52;1325;42;5013.00;492
12708;35;22191572;12708;428;14030;14522;5.13;0.31;387.35;23.52;1322;42;5014.00;492
12713;35;22191590;12713;425;14030;14522;5.16;0.31;387.32;23.52;1317;42;5015.00;492
12716;35;22191612;12716;433;14033;14526;5.20;0.32;387.45;23.52;1317;42;5016.00;493
12721;35;22191635;12721;428;14033;14526;5.19;0.32;387.41;23.52;1312;42;5017.00;493
12725;35;22191654;12725;419;14033;14526;5.20;0.32;387.44;23.52;1308;42;5018.00;493
12727;35;22191674;12727;424;14034;14527;5.24;0.32;387.46;23.51;1307;42;5019.00;493
12731;35;22191694;12731;429;14037;14531;5.21;0.32;387.48;23.51;1306;42;5020.00;494
12733;35;22191715;12733;428;14037;14531;5.27;0.32;387.61;23.51;1304;42;5021.00;494
12735;35;22191733;12735;423;14038;14534;5.34;0.33;387.59;23.51;1303;42;5022.00;496
12737;35;22191754;12737;432;14038;14534;5.36;0.33;387.57;23.51;1301;42;5023.00;496
12739;35;22191773;12739;434;14038;14534;5.36;0.33;387.59;23.51;1299;42;5024.00;496
12740;35;22191793;12740;436;14038;14534;5.38;0.33;387.62;23.51;1298;42;5025.00;496
12743;35;22191813;12743;436;14041;14538;5.40;0.33;387.73;23.50;1298;42;5026.00;497
12745;35;22191834;12745;434;14041;14538;5.40;0.33;387.73;23.50;1296;42;5027.00;497
12746;35;22191853;12746;438;14041;14538;5.39;0.33;387.72;23.50;1295;42;5028.00;497
12748;35;22191871;12748;439;14041;14538;5.36;0.33;387.75;23.50;1293;42;5029.00;497
12751;35;22191891;12751;444;14041;14539;5.30;0.32;387.82;23.50;1290;42;5030.00;498
12755;35;22191911;12755;449;14041;14540;5.24;0.32;387.88;23.50;1286;42;5031.00;499
12755;35;22191930;12755;458;14041;14540;5.23;0.32;387.88;23.50;1286;42;5032.00;499
12757;35;22191948;12757;466;14042;14541;5.21;0.32;387.87;23.50;1285;42;5033.00;499
12760;35;22191966;12760;467;14042;14541;5.21;0.32;387.91;23.50;1282;42;5034.00;499
12763;35;22191986;12763;470;14042;14541;5.20;0.32;388.00;23.50;1279;42;5035.00;499
12766;35;22192005;12766;472;14042;14541;5.20;0.32;388.02;23.50;1276;42;5036.00;499
12768;35;22192023;12768;474;14042;14541;5.16;0.32;388.10;23.50;1274;42;5037.00;499
12775;35;22192040;12775;473;14042;14541;5.12;0.31;388.12;23.50;1267;42;5038.00;499
12776;35;22192058;12776;478;14042;14541;5.10;0.31;388.11;23.50;1266;42;5039.00;499
12780;35;22192081;12780;512;14139;14771;5.40;0.34;388.19;23.34;1359;42;5040.00;632
12782;35;22192131;12782;509;14145;14772;5.36;0.34;388.23;23.33;1363;42;5041.00;627
12783;35;22192151;12783;501;14154;14772;5.38;0.34;388.22;23.32;1371;42;5042.00;618
12789;35;22192169;12789;507;14159;14772;5.36;0.33;388.20;23.31;1370;42;5043.00;613
12790;35;22192188;12790;505;14165;14772;5.34;0.33;388.28;23.30;1375;42;5044.00;607
12791;35;22192207;12791;499;14170;14772;5.35;0.33;388.33;23.30;1379;42;5045.00;602
12792;35;22192229;12792;499;14179;14772;5.34;0.33;388.33;23.28;1387;42;5046.00;593
12797;35;22192249;12797;495;14183;14772;5.34;0.33;388.33;23.28;1386;42;5047.00;589
12798;35;22192267;12798;500;14190;14773;5.36;0.33;388.31;23.27;1392;42;5048.00;583
12800;35;22192285;12800;495;14193;14774;5.38;0.33;388.31;23.27;1393;42;5049.00;581
12803;35;22192305;12803;492;14197;14774;5.35;0.33;388.45;23.27;1394;42;5050.00;577
12807;35;22192331;12807;497;14200;14775;5.30;0.33;388.44;23.26;1393;42;5051.00;575
12811;35;22192355;12811;496;14203;14775;5.23;0.32;388.49;23.26;1392;42;5052.00;572
12813;35;22192380;12813;493;14204;14775;5.18;0.32;388.52;23.26;1391;42;5053.00;571
12814;35;22192402;12814;504;14207;14775;5.14;0.32;388.54;23.26;1393;42;5054.00;568
12815;35;22192425;12815;509;14210;14779;5.12;0.32;388.57;23.25;1395;42;5055.00;569
12818;35;22192450;12818;516;14212;14779;5.09;0.31;388.58;23.25;1394;42;5056.00;567
12820;35;22192472;12820;526;14213;14779;5.07;0.31;388.56;23.25;1393;42;5057.00;566
12824;35;22192497;12824;530;14215;14782;5.05;0.31;388.54;23.25;1391;42;5058.00;567
12825;35;22192519;12825;535;14216;14782;5.08;0.31;388.59;23.25;1391;42;5059.00;566
12826;35;22192541;12826;531;14219;14782;5.09;0.31;388.57;23.25;1393;42;5060.00;563
12826;35;22192561;12826;532;14223;14786;5.09;0.31;388.57;23.24;1397;42;5061.00;563
12832;35;22192579;12832;536;14225;14787;5.02;0.31;388.57;23.24;1393;42;5062.00;562
12835;35;22192599;12835;542;14226;14787;5.00;0.31;388.63;23.24;1391;42;5063.00;561
12839;35;22192619;12839;546;14229;14791;4.95;0.30;388.65;23.24;1390;42;5064.00;562
12842;35;22192649;12842;554;14231;14791;4.93;0.30;388.60;23.24;1389;42;5065.00;560
12846;35;22192669;12846;559;14231;14791;4.87;0.30;388.67;23.24;1385;42;5066.00;560
12850;35;22192689;12850;565;14232;14792;4.75;0.29;388.64;23.24;1382;42;5067.00;560
12852;35;22192708;12852;570;14233;14792;4.66;0.28;388.64;23.24;1381;42;5068.00;559
12854;35;22192728;12854;579;14237;14798;4.61;0.28;388.59;23.23;1383;42;5069.00;561
12856;35;22192753;12856;588;14237;14798;4.55;0.28;388.59;23.23;1381;42;5070.00;561
12860;35;22192774;12860;596;14237;14799;4.45;0.27;388.58;23.23;1377;42;5071.00;562
12862;35;22192798;12862;599;14237;14799;4.34;0.27;388.54;23.23;1375;42;5072.00;562
12867;35;22192819;12867;609;14237;14799;4.22;0.26;388.62;23.23;1370;42;5073.00;562
12871;35;22192841;12871;615;14237;14799;4.10;0.25;388.58;23.23;1366;42;5074.00;562
12875;35;22192864;12875;611;14237;14799;4.03;0.25;388.51;23.23;1362;42;5075.00;562
12876;35;22192886;12876;610;14245;14811;4.04;0.25;388.51;23.22;1369;42;5076.00;566
12881;35;22192907;12881;600;14245;14811;3.99;0.25;388.43;23.22;1364;42;5077.00;566
12886;35;22192931;12886;598;14246;14811;3.95;0.24;388.35;23.22;1360;42;5078.00;565
12887;35;22192951;12887;597;14246;14811;3.95;0.24;388.36;23.22;1359;42;5079.00;565
12892;35;22192976;12892;601;14246;14811;3.96;0.24;388.30;23.22;1354;42;5080.00;565
12895;35;22192995;12895;602;14246;14811;3.96;0.24;388.38;23.22;1351;42;5081.00;565
12896;35;22193014;12896;593;14248;14815;3.97;0.24;388.35;23.21;1352;42;5082.00;567
12899;35;22193031;12899;592;14249;14815;3.94;0.24;388.35;23.21;1350;42;5083.00;566
12901;35;22193049;12901;584;14252;14819;3.97;0.24;388.33;23.21;1351;42;5084.00;567
12903;35;22193066;12903;574;14252;14821;3.95;0.24;388.32;23.21;1349;42;5085.00;569
12904;35;22193083;12904;575;14252;14821;3.96;0.24;388.34;23.21;1348;42;5086.00;569
12908;35;22193100;12908;561;14252;14821;3.91;0.24;388.31;23.21;1344;42;5087.00;569
12910;35;22193118;12910;560;14263;14834;3.97;0.24;388.26;23.20;1353;42;5088.00;571
12915;35;22193137;12915;556;14263;14834;3.95;0.24;388.25;23.20;1348;42;5089.00;571
12920;35;22193155;12920;560;14264;14834;3.93;0.24;388.22;23.22;1344;42;5090.00;570
12923;35;22193172;12923;543;14265;14835;3.99;0.24;388.17;23.21;1342;42;5091.00;570
12926;35;22193190;12926;525;14265;14836;4.03;0.25;388.16;23.21;1339;42;5092.00;571
12931;35;22193207;12931;523;14265;14836;4.03;0.24;388.14;23.21;1334;42;5093.00;571
12934;35;22193226;12934;513;14268;14839;4.06;0.25;388.20;23.24;1334;42;5094.00;571
12938;35;22193245;12938;507;14268;14839;4.06;0.25;388.19;23.24;1330;42;5095.00;571
12940;35;22193264;12940;507;14269;14839;4.07;0.25;388.20;23.25;1329;42;5096.00;570
12941;35;22193283;12941;507;14270;14839;4.11;0.25;388.21;23.26;1329;42;5097.00;569
12946;35;22193308;12946;500;14275;14845;4.15;0.25;388.21;23.27;1329;42;5098.00;570
12948;35;22193328;12948;494;14275;14845;4.19;0.25;388.18;23.27;1327;42;5099.00;570
12951;35;22193349;12951;493;14281;14864;4.18;0.25;388.17;23.29;1330;42;5100.00;583
12952;35;22193377;12952;492;14282;14864;4.19;0.26;388.16;23.30;1330;42;5101.00;582
12955;35;22193395;12955;492;14285;14868;4.20;0.26;388.12;23.32;1330;42;5102.00;583
12958;35;22193414;12958;497;14286;14869;4.19;0.25;388.14;23.34;1328;42;5103.00;583
12962;35;22193433;12962;497;14288;14869;4.19;0.25;388.15;23.35;1326;42;5104.00;581
12968;36;22193451;12968;492;14291;14870;4.18;0.25;388.07;23.36;1323;43;5105.00;579
12968;36;22193493;12968;497;14294;14870;4.17;0.25;388.07;23.37;1326;43;5106.00;576
12970;37;22193512;12970;489;14296;14870;4.17;0.25;388.05;23.37;1326;44;5107.00;574
12972;37;22193545;12972;484;14297;14870;4.17;0.25;388.05;23.38;1325;44;5108.00;573
12973;37;22193563;12973;482;14301;14870;4.20;0.25;388.05;23.41;1328;44;5109.00;569
12973;37;22193586;12973;481;14301;14870;4.20;0.25;388.05;23.41;1328;44;5110.00;569
12976;37;22193608;12976;482;14303;14870;4.21;0.26;388.05;23.42;1327;44;5111.00;567
12979;37;22193627;12979;488;14337;14940;4.34;0.26;388.08;23.37;1358;44;5112.00;603
12983;37;22193652;12983;478;14339;14941;4.36;0.27;388.10;23.38;1356;44;5113.00;602
12984;37;22193670;12984;481;14344;14941;4.41;0.27;388.07;23.38;1360;44;5114.00;597
12990;37;22193688;12990;476;14347;14941;4.39;0.27;388.20;23.39;1357;44;5115.00;594
12991;37;22193707;12991;474;14351;14941;4.43;0.27;388.20;23.41;1360;44;5116.00;590
12993;37;22193725;12993;485;14355;14941;4.46;0.27;388.15;23.42;1362;44;5117.00;586
12997;37;22193745;12997;482;14359;14941;4.42;0.27;388.23;23.42;1362;44;5118.00;582
12998;37;22193763;12998;489;14363;14941;4.39;0.27;388.20;23.44;1365;44;5119.00;578
12999;37;22193780;12999;494;14365;14942;4.33;0.26;388.23;23.44;1366;44;5120.00;577
13002;37;22193799;13002;496;14368;14943;4.26;0.26;388.28;23.46;1366;44;5121.00;575
13005;37;22193818;13005;496;14369;14943;4.22;0.26;388.29;23.45;1364;44;5122.00;574
13010;37;22193837;13010;495;14374;14947;4.20;0.26;388.31;23.45;1364;44;5123.00;573
13012;37;22193864;13012;492;14377;14947;4.21;0.26;388.38;23.47;1365;44;5124.00;570
13013;37;22193884;13013;495;14377;14947;4.25;0.26;388.36;23.47;1364;44;5125.00;570
13018;37;22193902;13018;496;14377;14947;4.26;0.26;388.48;23.47;1359;44;5126.00;570
13020;37;22193920;13020;493;14382;14953;4.28;0.26;388.56;23.48;1362;44;5127.00;571
13023;37;22193940;13023;494;14383;14953;4.29;0.26;388.61;23.57;1360;44;5128.00;570
13024;37;22193961;13024;503;14384;14953;4.32;0.26;388.64;23.57;1360;44;5129.00;569
13025;37;22193981;13025;506;14389;14959;4.36;0.27;388.65;23.59;1364;44;5130.00;570
13029;37;22194001;13029;485;14391;14959;4.41;0.27;388.74;23.61;1362;44;5131.00;568
13031;37;22194020;13031;482;14393;14959;4.45;0.27;388.70;23.61;1362;44;5132.00;566
13035;37;22194039;13035;464;14395;14960;4.46;0.27;388.70;23.63;1360;44;5133.00;565
13037;37;22194059;13037;452;14397;14961;4.48;0.27;388.74;23.63;1360;44;5134.00;564
13042;37;22194087;13042;455;14399;14961;4.52;0.28;388.73;23.64;1357;44;5135.00;562
13046;37;22194106;13046;451;14410;14974;4.62;0.28;388.78;23.64;1364;44;5136.00;564
13047;37;22194128;13047;454;14411;14974;4.65;0.28;388.83;23.64;1364;44;5137.00;563
13051;37;22194148;13051;457;14412;14974;4.64;0.28;388.84;23.65;1361;44;5138.00;562
13053;37;22194167;13053;455;14413;14975;4.66;0.28;388.86;23.65;1360;44;5139.00;562
13055;37;22194189;13055;460;14414;14975;4.68;0.28;388.87;23.66;1359;44;5140.00;561
13058;37;22194207;13058;463;14417;14979;4.67;0.28;388.94;23.66;1359;44;5141.00;562
13059;37;22194229;13059;469;14420;14979;4.69;0.29;388.97;23.67;1361;44;5142.00;559
13060;37;22194249;13060;467;14425;14983;4.66;0.28;389.07;23.76;1365;44;5143.00;558
13064;37;22194268;13064;472;14427;14983;4.67;0.28;389.32;23.76;1363;44;5144.00;556
13065;37;22194287;13065;467;14428;14983;4.72;0.29;389.36;23.77;1363;44;5145.00;555
13067;37;22194307;13067;474;14429;14983;4.76;0.29;389.39;23.77;1362;44;5146.00;554
13069;37;22194327;13069;473;14429;14983;4.79;0.29;389.48;23.77;1360;44;5147.00;554
13073;37;22194349;13073;475;14438;14995;4.83;0.29;389.58;23.78;1365;44;5148.00;557
13074;37;22194369;13074;482;14439;14995;4.87;0.30;389.57;23.77;1365;44;5149.00;556
13078;37;22194389;13078;478;14440;14995;4.87;0.30;389.63;23.77;1362;44;5150.00;555
13081;37;22194409;13081;472;14442;14995;4.88;0.30;389.62;23.79;1361;44;5151.00;553
13083;37;22194428;13083;470;14442;14995;4.90;0.30;389.66;23.79;1359;44;5152.00;553
13084;37;22194448;13084;468;14444;14995;4.92;0.30;389.68;23.80;1360;44;5153.00;551
13087;37;22194467;13087;467;14446;14996;4.92;0.30;389.78;23.81;1359;44;5154.00;550
13090;37;22194487;13090;474;14448;14998;4.90;0.30;389.79;23.81;1358;44;5155.00;550
13092;37;22194506;13092;475;14453;15004;4.88;0.30;389.87;23.81;1361;44;5156.00;551
13094;37;22194529;13094;476;14455;15005;4.87;0.30;389.96;23.91;1361;44;5157.00;550
13095;37;22194548;13095;484;14457;15005;4.91;0.30;389.99;23.92;1362;44;5158.00;548
13097;37;22194567;13097;478;14457;15005;4.94;0.30;390.01;23.92;1360;44;5159.00;548
13098;37;22194587;13098;481;14462;15010;4.96;0.30;390.00;23.92;1364;44;5160.00;548
13100;37;22194607;13100;481;14462;15010;4.96;0.30;390.02;23.92;1362;44;5161.00;548
13101;37;22194639;13101;487;14462;15010;4.99;0.30;390.08;23.92;1361;45;5162.00;548
13104;37;22194667;13104;484;14464;15011;5.01;0.30;390.10;23.92;1360;45;5163.00;547
13106;37;22194687;13106;484;14468;15015;5.04;0.31;390.14;23.93;1362;45;5164.00;547
13109;37;22194706;13109;482;14469;15015;5.05;0.31;390.31;23.93;1360;45;5165.00;546
13110;37;22194728;13110;481;14470;15018;5.08;0.31;390.35;23.93;1360;45;5166.00;548
13113;37;22194748;13113;486;14471;15018;5.08;0.31;390.40;23.94;1358;45;5167.00;547
13114;37;22194768;13114;479;14471;15018;5.12;0.31;390.44;23.94;1357;45;5168.00;547
13115;37;22194788;13115;475;14471;15018;5.16;0.31;390.46;23.94;1356;45;5169.00;547
13118;37;22194807;13118;470;14474;15022;5.17;0.31;390.43;23.93;1356;45;5170.00;548
13121;37;22194829;13121;465;14474;15022;5.20;0.32;390.43;23.93;1353;45;5171.00;548
13123;37;22194850;13123;467;14474;15022;5.25;0.32;390.41;23.93;1351;45;5172.00;548
13124;37;22194870;13124;462;14475;15022;5.30;0.32;390.41;23.94;1351;45;5173.00;547
13130;37;22194889;13130;450;14475;15023;5.33;0.32;390.40;23.94;1345;45;5174.00;548
13130;37;22194910;13130;450;14476;15025;5.39;0.33;390.40;23.94;1346;45;5175.00;549
13132;37;22194930;13132;442;14476;15025;5.40;0.33;390.41;23.94;1344;45;5176.00;549
13136;37;22194950;13136;439;14477;15026;5.39;0.33;390.51;23.94;1341;45;5177.00;549
13138;37;22194970;13138;442;14477;15026;5.40;0.33;390.56;23.94;1339;45;5178.00;549
13140;37;22194988;13140;423;14478;15026;5.40;0.33;390.53;23.95;1338;45;5179.00;548
13141;37;22195008;13141;419;14478;15026;5.37;0.33;390.52;23.95;1337;45;5180.00;548
13145;37;22195028;13145;417;14478;15026;5.30;0.32;390.59;23.95;1333;45;5181.00;548
13150;37;22195048;13150;408;14478;15026;5.24;0.32;390.56;23.95;1328;45;5182.00;548
13155;37;22195067;13155;396;14479;15026;5.20;0.32;390.63;23.95;1324;45;5183.00;547
13159;37;22195086;13159;416;14550;15153;5.19;0.32;390.80;23.85;1391;45;5184.00;603
13162;37;22195117;13162;409;14550;15154;5.18;0.32;390.84;23.85;1388;45;5185.00;604
13163;37;22195137;13163;398;14552;15154;5.16;0.32;390.94;23.84;1389;45;5186.00;602
13163;37;22195157;13163;405;14552;15154;5.12;0.31;390.94;23.84;1389;45;5187.00;602
13164;37;22195176;13164;416;14554;15154;5.12;0.31;391.02;23.84;1390;45;5188.00;600
13169;37;22195197;13169;431;14556;15154;5.07;0.31;391.14;23.84;1387;45;5189.00;598
13171;37;22195219;13171;437;14556;15154;5.06;0.31;391.20;23.84;1385;45;5190.00;598
13174;37;22195239;13174;453;14558;15154;5.07;0.31;391.33;23.84;1384;45;5191.00;596
13176;37;22195259;13176;459;14559;15155;5.05;0.31;391.49;23.84;1383;45;5192.00;596
13176;37;22195280;13176;464;14562;15156;5.11;0.31;391.49;23.83;1386;45;5193.00;594
13179;37;22195299;13179;467;14566;15156;5.12;0.31;391.65;23.83;1387;45;5194.00;590
13179;37;22195319;13179;472;14568;15157;5.13;0.32;391.65;23.83;1389;45;5195.00;589
13184;37;22195337;13184;470;14570;15157;5.07;0.31;391.72;23.83;1386;45;5196.00;587
13186;37;22195364;13186;477;14572;15157;4.99;0.31;391.72;23.82;1386;45;5197.00;585
13189;37;22195383;13189;479;14574;15157;4.95;0.30;391.90;23.82;1385;45;5198.00;583
13190;37;22195402;13190;490;14577;15161;4.89;0.30;391.92;23.82;1387;45;5199.00;584
13192;37;22195422;13192;495;14578;15161;4.78;0.29;391.92;23.82;1386;45;5200.00;583
13194;37;22195448;13194;502;14579;15161;4.71;0.29;391.96;23.82;1385;45;5201.00;582
13198;37;22195467;13198;501;14580;15164;4.67;0.29;392.07;23.82;1382;45;5202.00;584
13200;37;22195486;13200;511;14580;15164;4.61;0.28;392.14;23.82;1380;45;5203.00;584
13205;37;22195506;13205;517;14580;15164;4.57;0.28;392.15;23.82;1375;45;5204.00;584
13208;37;22195525;13208;523;14583;15168;4.52;0.28;392.11;23.81;1375;45;5205.00;585
13213;37;22195546;13213;527;14584;15169;4.47;0.27;392.08;23.81;1371;45;5206.00;585
13214;37;22195565;13214;530;14584;15169;4.48;0.28;392.07;23.81;1370;45;5207.00;585
13216;37;22195583;13216;535;14587;15173;4.47;0.28;392.06;23.80;1371;45;5208.00;586
13218;37;22195602;13218;548;14587;15173;4.45;0.27;392.08;23.80;1369;45;5209.00;586
13221;37;22195620;13221;556;14587;15173;4.45;0.27;392.14;23.80;1366;45;5210.00;586
13225;37;22195639;13225;563;14587;15174;4.41;0.27;392.08;23.80;1362;45;5211.00;587
13226;37;22195657;13226;570;14587;15174;4.41;0.27;392.11;23.80;1361;45;5212.00;587
13228;37;22195678;13228;574;14590;15180;4.41;0.27;392.15;23.80;1362;45;5213.00;590
13233;37;22195699;13233;579;14590;15180;4.35;0.27;392.12;23.80;1357;45;5214.00;590
13234;37;22195720;13234;574;14590;15180;4.34;0.27;392.14;23.80;1356;45;5215.00;590
13240;37;22195740;13240;583;14590;15181;4.28;0.26;392.19;23.80;1350;45;5216.00;591
13243;37;22195759;13243;588;14590;15181;4.25;0.26;392.21;23.80;1347;45;5217.00;591
13245;37;22195780;13245;588;14590;15181;4.22;0.26;392.24;23.80;1345;45;5218.00;591
13248;37;22195802;13248;591;14590;15181;4.18;0.26;392.26;23.80;1342;45;5219.00;591
13250;37;22195825;13250;612;14614;15217;4.28;0.26;392.26;23.76;1364;45;5220.00;603
13252;37;22195850;13252;610;14615;15217;4.24;0.26;392.30;23.76;1363;45;5221.00;602
13255;37;22195869;13255;610;14615;15217;4.22;0.26;392.24;23.76;1360;45;5222.00;602
13258;37;22195887;13258;612;14615;15217;4.22;0.26;392.21;23.76;1357;45;5223.00;602
13260;37;22195905;13260;601;14615;15217;4.17;0.26;392.17;23.76;1355;45;5224.00;602
13262;37;22195927;13262;601;14615;15217;4.17;0.26;392.12;23.76;1353;45;5225.00;602
13266;37;22195945;13266;601;14618;15221;4.19;0.26;392.06;23.75;1352;45;5226.00;603
13267;37;22195966;13267;598;14618;15221;4.19;0.26;392.09;23.75;1351;45;5227.00;603
13269;37;22195988;13269;604;14620;15225;4.23;0.26;392.11;23.75;1351;45;5228.00;605
13270;37;22196006;13270;602;14620;15226;4.23;0.26;392.10;23.75;1350;45;5229.00;606
13273;37;22196025;13273;599;14620;15226;4.18;0.26;392.11;23.75;1347;45;5230.00;606
13276;37;22196046;13276;600;14620;15226;4.15;0.26;392.05;23.75;1344;45;5231.00;606
13278;37;22196064;13278;596;14630;15239;4.16;0.26;392.11;23.73;1352;45;5232.00;609
13282;37;22196082;13282;593;14630;15239;4.10;0.25;392.16;23.73;1348;45;5233.00;609
13286;37;22196101;13286;592;14630;15239;4.07;0.25;392.12;23.73;1344;45;5234.00;609
13288;37;22196119;13288;591;14631;15240;4.09;0.25;392.18;23.73;1343;45;5235.00;609
13292;37;22196136;13292;587;14631;15241;4.06;0.25;392.14;23.73;1339;45;5236.00;610
13293;37;22196154;13293;591;14631;15241;4.02;0.25;392.14;23.73;1338;45;5237.00;610
13297;37;22196172;13297;588;14632;15244;3.99;0.24;392.08;23.73;1335;45;5238.00;612
13301;37;22196190;13301;586;14634;15244;3.96;0.24;392.06;23.74;1333;45;5239.00;610
13303;37;22196209;13303;588;14634;15244;3.95;0.24;392.06;23.74;1331;45;5240.00;610
13306;37;22196229;13306;594;14634;15244;3.87;0.24;392.04;23.74;1328;45;5241.00;610
13307;37;22196248;13307;606;14637;15250;3.84;0.23;392.02;23.74;1330;45;5242.00;613
13310;37;22196266;13310;604;14637;15250;3.77;0.23;392.00;23.74;1327;45;5243.00;613
13310;37;22196283;13310;614;14637;15250;3.71;0.23;392.00;23.74;1327;45;5244.00;613
13312;37;22196301;13312;615;14637;15250;3.64;0.22;391.98;23.74;1325;45;5245.00;613
13315;37;22196318;13315;624;14640;15254;3.59;0.22;391.93;23.74;1325;45;5246.00;614
13318;37;22196336;13318;626;14640;15255;3.53;0.21;391.90;23.74;1322;45;5247.00;615
13320;37;22196354;13320;620;14640;15255;3.50;0.21;391.86;23.74;1320;45;5248.00;615
13322;37;22196372;13322;611;14641;15256;3.49;0.21;391.87;23.73;1319;45;5249.00;615
13324;37;22196391;13324;587;14641;15256;3.44;0.21;391.85;23.73;1317;45;5250.00;615
13325;37;22196418;13325;572;14641;15256;3.49;0.21;391.84;23.73;1316;45;5251.00;615
13327;37;22196436;13327;570;14641;15256;3.53;0.22;391.80;23.73;1314;45;5252.00;615
13328;37;22196453;13328;565;14641;15256;3.55;0.22;391.80;23.73;1313;45;5253.00;615
13331;37;22196472;13331;563;14641;15256;3.56;0.22;391.81;23.73;1310;45;5254.00;615
13332;37;22196506;13332;557;14641;15256;3.60;0.22;391.81;23.73;1309;45;5255.00;615
13334;37;22196524;13334;558;14673;15326;3.86;0.24;391.84;23.68;1339;45;5256.00;653
13337;37;22196549;13337;546;14676;15327;3.91;0.24;391.82;23.68;1339;45;5257.00;651
13338;37;22196568;13338;521;14684;15327;4.04;0.25;391.82;23.68;1346;45;5258.00;643
13340;37;22196587;13340;519;14688;15327;4.13;0.25;391.83;23.68;1348;45;5259.00;639
13343;37;22196605;13343;501;14688;15327;4.18;0.26;391.86;23.68;1345;45;5260.00;639
13344;37;22196624;13344;500;14689;15327;4.21;0.26;391.86;23.68;1345;45;5261.00;638
13349;37;22196644;13349;492;14691;15327;4.22;0.26;391.84;23.67;1342;45;5262.00;636
13351;37;22196665;13351;493;14692;15327;4.25;0.26;391.83;23.67;1341;45;5263.00;635
13353;37;22196686;13353;489;14694;15328;4.34;0.27;391.82;23.67;1341;45;5264.00;634
13359;37;22196705;13359;490;14697;15330;4.37;0.27;391.91;23.67;1338;45;5265.00;633
13359;37;22196725;13359;489;14698;15330;4.41;0.27;391.91;23.67;1339;45;5266.00;632
13361;37;22196746;13361;485;14703;15334;4.43;0.27;391.90;23.68;1342;45;5267.00;631
13365;37;22196766;13365;493;14703;15334;4.41;0.27;391.86;23.68;1338;45;5268.00;631
13368;37;22196787;13368;489;14703;15334;4.40;0.27;391.89;23.68;1335;45;5269.00;631
13369;37;22196806;13369;482;14704;15334;4.38;0.27;391.90;23.68;1335;45;5270.00;630
13375;37;22196827;13375;493;14707;15340;4.36;0.27;391.90;23.67;1332;45;5271.00;633
13377;37;22196849;13377;482;14709;15340;4.37;0.27;391.90;23.78;1332;45;5272.00;631
13381;37;22196870;13381;469;14709;15340;4.34;0.26;391.87;23.78;1328;45;5273.00;631
13385;37;22196889;13385;475;14710;15343;4.36;0.27;391.88;23.78;1325;45;5274.00;633
13388;37;22196911;13388;466;14713;15343;4.39;0.27;391.84;23.81;1325;45;5275.00;630
13394;37;22196932;13394;464;14713;15343;4.43;0.27;391.83;23.81;1319;45;5276.00;630
13397;37;22196954;13397;461;14713;15344;4.45;0.27;391.88;23.81;1316;45;5277.00;631
13401;37;22196973;13401;458;14714;15345;4.42;0.27;391.87;23.81;1313;45;5278.00;631
13405;37;22196992;13405;452;14715;15345;4.41;0.27;391.86;23.82;1310;45;5279.00;630
13409;37;22197016;13409;456;14735;15371;4.50;0.27;391.88;23.79;1326;45;5280.00;636
13413;37;22197039;13413;450;14736;15371;4.52;0.27;391.93;23.81;1323;45;5281.00;635
13415;37;22197064;13415;440;14739;15371;4.58;0.28;391.92;23.83;1324;45;5282.00;632
13419;37;22197084;13419;440;14739;15372;4.61;0.28;391.98;23.83;1320;45;5283.00;633
13421;37;22197104;13421;435;14740;15372;4.64;0.28;391.98;23.85;1319;45;5284.00;632
13424;37;22197122;13424;425;14744;15376;4.67;0.28;392.03;23.87;1320;45;5285.00;632
13428;37;22197141;13428;418;14744;15376;4.67;0.28;392.07;23.87;1316;45;5286.00;632
13430;37;22197161;13430;414;14748;15379;4.71;0.29;392.07;23.88;1318;45;5287.00;631
13432;37;22197180;13432;420;14751;15380;4.71;0.29;392.09;23.99;1319;45;5288.00;629
13435;37;22197199;13435;420;14753;15380;4.70;0.29;392.08;24.01;1318;45;5289.00;627
13440;37;22197218;13440;441;14755;15380;4.61;0.28;392.07;24.03;1315;45;5290.00;625
13444;37;22197237;13444;438;14756;15380;4.59;0.28;392.17;24.04;1312;45;5291.00;624
13448;37;22197256;13448;444;14766;15392;4.62;0.28;392.14;24.03;1318;45;5292.00;626
13455;37;22197276;13455;443;14767;15392;4.53;0.28;392.33;24.05;1312;45;5293.00;625
13456;37;22197296;13456;449;14770;15392;4.54;0.28;392.31;24.07;1314;45;5294.00;622
13460;37;22197314;13460;457;14771;15392;4.50;0.28;392.46;24.08;1311;45;5295.00;621
13463;37;22197333;13463;455;14772;15392;4.47;0.28;392.48;24.09;1309;45;5296.00;620
13464;37;22197352;13464;452;14774;15392;4.54;0.28;392.51;24.11;1310;45;5297.00;618
13467;37;22197375;13467;443;14774;15393;4.53;0.28;392.48;24.11;1307;45;5298.00;619
13470;37;22197396;13470;442;14776;15393;4.56;0.28;392.58;24.12;1306;45;5299.00;617
13474;37;22197418;13474;435;14779;15399;4.59;0.28;392.71;24.11;1305;45;5300.00;620
13476;37;22197444;13476;443;14781;15400;4.63;0.28;392.72;24.12;1305;45;5301.00;619
13477;37;22197465;13477;447;14783;15400;4.67;0.29;392.81;24.23;1306;45;5302.00;617
13481;37;22197485;13481;447;14784;15400;4.65;0.29;392.82;24.24;1303;45;5303.00;616
13484;37;22197506;13484;448;14789;15404;4.69;0.29;392.98;24.25;1305;45;5304.00;615
13486;37;22197529;13486;446;14790;15404;4.73;0.29;393.00;24.26;1304;45;5305.00;614
13490;37;22197555;13490;430;14791;15404;4.74;0.29;393.11;24.27;1301;45;5306.00;613
13492;37;22197577;13492;434;14792;15405;4.77;0.29;393.24;24.27;1300;45;5307.00;613
13492;37;22197597;13492;441;14797;15409;4.82;0.29;393.24;24.29;1305;45;5308.00;612
13495;37;22197617;13495;435;14798;15409;4.83;0.29;393.21;24.37;1303;45;5309.00;611
13498;37;22197639;13498;432;14801;15415;4.81;0.29;393.38;24.38;1303;45;5310.00;614
13500;37;22197662;13500;431;14802;15415;4.80;0.29;393.44;24.38;1302;45;5311.00;613
13505;37;22197683;13505;434;14803;15415;4.77;0.29;393.56;24.39;1298;45;5312.00;612
13507;37;22197705;13507;433;14803;15415;4.81;0.29;393.64;24.39;1296;45;5313.00;612
13509;37;22197725;13509;433;14808;15419;4.87;0.30;393.78;24.41;1299;45;5314.00;611
13513;37;22197747;13513;436;14808;15419;4.94;0.30;393.95;24.41;1295;45;5315.00;611
13514;37;22197769;13514;440;14812;15419;5.01;0.31;394.04;24.75;1298;46;5316.00;607
13517;37;22197812;13517;436;14814;15419;5.06;0.31;394.10;24.85;1297;46;5317.00;605
13522;37;22197833;13522;430;14815;15420;5.09;0.31;394.21;24.85;1293;46;5318.00;605
13524;37;22197855;13524;430;14815;15421;5.14;0.31;394.23;24.85;1291;46;5319.00;606
13525;37;22197876;13525;426;14816;15421;5.19;0.32;394.22;24.86;1291;46;5320.00;605
13528;37;22197900;13528;419;14819;15422;5.23;0.32;394.26;24.87;1291;46;5321.00;603
13531;37;22197924;13531;419;14821;15422;5.23;0.32;394.29;24.89;1290;46;5322.00;601
13535;37;22197945;13535;409;14822;15422;5.21;0.32;394.32;24.89;1287;46;5323.00;600
13538;37;22197965;13538;415;14824;15422;5.20;0.32;394.45;24.91;1286;46;5324.00;598
13539;37;22197985;13539;418;14824;15422;5.22;0.32;394.48;24.91;1285;46;5325.00;598
13543;37;22198006;13543;415;14825;15422;5.25;0.32;394.68;24.91;1282;46;5326.00;597
13544;37;22198026;13544;410;14826;15422;5.29;0.32;394.68;24.92;1282;46;5327.00;596
13545;37;22198048;13545;438;14899;15549;5.39;0.33;394.67;24.81;1354;46;5328.00;650
13548;37;22198080;13548;423;14899;15550;5.42;0.34;394.76;24.81;1351;46;5329.00;651
13550;37;22198111;13550;423;14904;15550;5.44;0.34;394.84;24.82;1354;46;5330.00;646
13552;37;22198134;13552;422;14908;15550;5.49;0.34;394.89;24.82;1356;46;5331.00;642
13557;37;22198155;13557;419;14909;15550;5.48;0.34;394.86;24.82;1352;46;5332.00;641
13561;37;22198178;13561;424;14912;15550;5.45;0.34;394.90;24.84;1351;46;5333.00;638
13563;37;22198204;13563;428;14913;15550;5.44;0.34;394.91;24.84;1350;46;5334.00;637
13568;37;22198230;13568;435;14915;15550;5.44;0.33;395.02;24.84;1347;46;5335.00;635
13571;37;22198250;13571;437;14916;15551;5.47;0.34;395.00;24.84;1345;46;5336.00;635
13573;37;22198270;13573;442;14917;15552;5.47;0.34;395.04;24.84;1344;46;5337.00;635
13575;37;22198290;13575;450;14919;15552;5.48;0.34;395.05;24.85;1344;46;5338.00;633
13577;37;22198312;13577;455;14921;15553;5.45;0.34;395.01;24.86;1344;46;5339.00;632
13580;37;22198334;13580;453;14922;15553;5.43;0.33;395.06;24.86;1342;46;5340.00;631
13583;37;22198354;13583;456;14925;15553;5.38;0.33;395.04;24.87;1342;46;5341.00;628
13585;37;22198373;13585;455;14926;15553;5.35;0.33;395.16;24.87;1341;46;5342.00;627
13587;37;22198393;13587;459;14931;15557;5.33;0.33;395.13;24.89;1344;46;5343.00;626
13590;37;22198414;13590;452;14933;15557;5.29;0.32;395.18;24.90;1343;46;5344.00;624
13595;37;22198434;13595;449;14935;15557;5.23;0.32;395.17;24.90;1340;46;5345.00;622
13596;37;22198454;13596;452;14936;15560;5.24;0.32;395.17;24.90;1340;46;5346.00;624
13599;37;22198473;13599;442;14937;15560;5.26;0.32;395.18;24.90;1338;46;5347.00;623
13601;37;22198495;13601;437;14939;15560;5.28;0.32;395.22;24.91;1338;46;5348.00;621
13604;37;22198515;13604;421;14943;15564;5.32;0.33;395.39;24.93;1339;46;5349.00;621
13608;37;22198535;13608;419;14945;15565;5.33;0.33;395.44;25.02;1337;46;5350.00;620
13610;37;22198555;13610;414;14946;15565;5.36;0.33;395.41;25.02;1336;46;5351.00;619
13612;37;22198574;13612;415;14948;15569;5.33;0.33;395.49;25.02;1336;46;5352.00;621
13613;37;22198594;13613;415;14953;15569;5.32;0.33;395.52;25.05;1340;46;5353.00;616
13618;37;22198614;13618;407;14954;15569;5.27;0.32;395.64;25.05;1336;47;5354.00;615
13620;37;22198656;13620;411;14957;15571;5.24;0.32;395.63;25.05;1337;47;5355.00;614
13623;37;22198677;13623;405;14958;15571;5.17;0.32;395.65;25.06;1335;47;5356.00;613
13625;37;22198696;13625;414;14962;15577;5.21;0.32;395.74;25.06;1337;47;5357.00;615
13628;37;22198731;13628;411;14965;15577;5.20;0.32;395.83;25.06;1337;47;5358.00;612
13632;37;22198752;13632;418;14965;15577;5.12;0.31;395.82;25.06;1333;47;5359.00;612
13636;37;22198771;13636;425;14965;15578;5.05;0.31;395.96;25.06;1329;47;5360.00;613
13637;37;22198791;13637;434;14965;15578;5.03;0.31;396.05;25.06;1328;47;5361.00;613
13638;37;22198811;13638;435;14966;15578;4.99;0.31;396.04;25.07;1328;47;5362.00;612
13641;37;22198830;13641;434;14966;15578;4.94;0.30;396.13;25.07;1325;47;5363.00;612
13645;37;22198849;13645;451;14976;15590;4.91;0.30;396.25;25.07;1331;47;5364.00;614
13647;37;22198870;13647;451;14977;15590;4.86;0.30;396.25;25.16;1330;47;5365.00;613
13649;37;22198889;13649;463;14978;15590;4.82;0.29;396.30;25.17;1329;47;5366.00;612
13653;37;22198907;13653;465;14978;15590;4.77;0.29;396.24;25.17;1325;47;5367.00;612
13656;37;22198927;13656;465;14978;15590;4.72;0.29;396.26;25.17;1322;47;5368.00;612
13659;37;22198947;13659;473;14981;15590;4.73;0.29;396.27;25.27;1322;47;5369.00;609
13662;37;22198968;13662;475;14984;15594;4.73;0.29;396.22;25.27;1322;47;5370.00;610
13664;37;22198988;13664;479;14986;15594;4.73;0.29;396.24;25.28;1322;47;5371.00;608
13667;37;22199016;13667;478;14988;15598;4.71;0.29;396.25;25.28;1321;47;5372.00;610
13668;37;22199035;13668;480;14988;15599;4.70;0.29;396.28;25.28;1320;47;5373.00;611
13668;37;22199053;13668;485;14988;15599;4.69;0.29;396.28;25.28;1320;47;5374.00;611
13670;37;22199071;13670;492;14989;15599;4.70;0.29;396.30;25.29;1319;47;5375.00;610
13673;37;22199089;13673;498;15000;15612;4.65;0.28;396.28;25.38;1327;47;5376.00;612
13677;37;22199117;13677;504;15001;15612;4.62;0.28;396.30;25.38;1324;47;5377.00;611
13678;37;22199136;13678;521;15002;15612;4.63;0.28;396.29;25.39;1324;47;5378.00;610
13683;37;22199156;13683;529;15003;15613;4.60;0.28;396.24;25.39;1320;47;5379.00;610
13686;37;22199178;13686;539;15004;15614;4.56;0.28;396.29;25.50;1318;47;5380.00;610
13686;37;22199198;13686;548;15004;15614;4.54;0.28;396.29;25.50;1318;47;5381.00;610
13688;37;22199218;13688;557;15005;15617;4.53;0.28;396.28;25.50;1317;47;5382.00;612
13689;37;22199239;13689;567;15006;15617;4.48;0.28;396.25;25.61;1317;47;5383.00;611
13690;37;22199258;13690;577;15006;15617;4.46;0.27;396.24;25.61;1316;47;5384.00;611
13692;37;22199286;13692;586;15007;15617;4.41;0.27;396.20;25.72;1315;47;5385.00;610
13695;37;22199305;13695;594;15011;15623;4.42;0.27;396.21;25.71;1316;47;5386.00;612
13697;37;22199328;13697;596;15011;15623;4.41;0.27;396.16;25.71;1314;47;5387.00;612
13699;37;22199347;13699;607;15012;15623;4.38;0.27;396.13;25.82;1313;47;5388.00;611
13701;37;22199367;13701;611;15012;15623;4.32;0.26;396.09;25.82;1311;47;5389.00;611
13702;37;22199386;13702;616;15016;15627;4.27;0.26;396.07;25.93;1314;47;5390.00;611
13708;37;22199406;13708;624;15016;15628;4.20;0.26;396.04;25.93;1308;47;5391.00;612
13709;37;22199426;13709;627;15016;15628;4.16;0.25;396.03;25.93;1307;47;5392.00;612
13710;37;22199446;13710;629;15017;15629;4.14;0.25;396.00;25.93;1307;47;5393.00;612
13711;37;22199464;13711;635;15017;15629;4.09;0.25;395.97;25.93;1306;47;5394.00;612
13713;37;22199483;13713;628;15017;15629;4.04;0.25;395.94;25.93;1304;47;5395.00;612
13713;37;22199500;13713;628;15017;15629;4.02;0.25;395.94;25.93;1304;47;5396.00;612
13714;37;22199526;13714;631;15017;15629;4.02;0.25;395.92;25.93;1303;47;5397.00;612
13718;37;22199542;13718;629;15017;15629;3.96;0.24;395.88;25.93;1299;47;5398.00;612
13719;37;22199559;13719;630;15017;15629;3.94;0.24;395.92;25.93;1298;47;5399.00;612
