step_arrived;step_collisions;step_duration;step_ended;step_halting;step_inserted;step_loaded;step_meanSpeed;step_meanSpeedRelative;step_meanTravelTime;step_meanWaitingTime;step_running;step_teleports;step_time;step_waiting
0;0;22200391;0;1;88;245;16.08;1.13;-1.00;0.00;88;0;0.00;157
0;0;22200420;0;1;103;245;15.05;1.04;-1.00;0.15;103;0;1.00;142
0;0;22200422;0;0;124;245;14.22;0.97;-1.00;0.46;124;0;2.00;121
0;0;22200423;0;2;135;245;13.45;0.91;-1.00;0.67;135;0;3.00;110
0;0;22200424;0;4;151;245;12.14;0.82;-1.00;1.02;151;0;4.00;94
0;0;22200425;0;4;158;245;11.34;0.76;-1.00;1.20;158;0;5.00;87
0;0;22200428;0;9;168;245;10.71;0.71;-1.00;1.48;168;0;6.00;77
0;0;22200430;0;14;178;245;9.92;0.66;-1.00;1.79;178;0;7.00;67
0;0;22200432;0;19;185;246;9.51;0.63;-1.00;2.03;185;0;8.00;61
0;0;22200434;0;23;191;247;9.18;0.61;-1.00;2.25;191;0;9.00;56
0;0;22200436;0;25;198;247;9.04;0.60;-1.00;2.52;198;0;10.00;49
1;0;22200438;1;32;203;248;8.95;0.59;11.00;2.68;202;0;11.00;45
2;0;22200440;2;31;207;248;8.77;0.57;11.50;2.86;205;0;12.00;41
2;0;22200445;2;38;211;248;8.50;0.56;11.50;3.05;209;0;13.00;37
2;0;22200448;2;41;214;248;8.42;0.55;11.50;3.21;212;0;14.00;34
2;0;22200451;2;46;221;252;8.27;0.53;11.50;3.45;219;0;15.00;31
2;0;22200454;2;51;225;252;8.22;0.53;11.50;3.68;223;0;16.00;27
2;0;22200457;2;56;228;252;8.04;0.51;11.50;3.82;226;0;17.00;24
2;0;22200460;2;60;231;255;7.95;0.51;11.50;3.94;229;0;18.00;24
3;0;22200464;3;65;232;255;8.03;0.51;14.00;3.93;229;0;19.00;23
3;0;22200467;3;67;234;255;8.07;0.51;14.00;4.07;231;0;20.00;21
5;0;22200469;5;68;239;259;8.17;0.51;16.80;4.09;234;0;21.00;20
5;0;22200472;5;70;242;260;8.23;0.52;16.80;4.22;237;0;22.00;18
6;0;22200477;6;76;244;260;8.13;0.51;17.67;4.38;238;0;23.00;16
6;0;22200481;6;76;249;264;8.14;0.51;17.67;4.48;243;0;24.00;15
6;0;22200484;6;83;251;264;8.19;0.52;17.67;4.65;245;0;25.00;13
6;0;22200487;6;83;252;264;8.33;0.52;17.67;4.63;246;0;26.00;12
6;0;22200490;6;88;253;265;8.49;0.53;17.67;4.72;247;0;27.00;12
6;0;22200495;6;87;254;265;8.53;0.53;17.67;4.81;248;0;28.00;11
6;0;22200499;6;89;259;271;8.58;0.53;17.67;4.74;253;0;29.00;12
6;0;22200506;6;91;261;271;8.67;0.54;17.67;4.88;255;0;30.00;10
6;0;22200511;6;93;263;272;8.70;0.54;17.67;4.97;257;0;31.00;9
7;0;22200515;7;95;263;272;8.73;0.54;19.29;4.97;256;0;32.00;9
8;0;22200518;8;97;264;272;8.69;0.54;21.00;5.00;256;0;33.00;8
10;0;22200521;10;100;266;272;8.71;0.54;23.60;5.12;256;0;34.00;6
10;0;22200524;10;105;266;272;8.77;0.54;23.60;5.12;256;0;35.00;6
11;0;22200530;11;108;278;284;8.98;0.56;24.09;4.99;267;0;36.00;6
11;0;22200535;11;107;278;284;8.94;0.55;24.09;4.99;267;0;37.00;6
11;0;22200538;11;111;279;284;8.89;0.55;24.09;5.05;268;0;38.00;5
12;0;22200541;12;111;279;284;8.71;0.54;24.92;5.05;267;0;39.00;5
13;0;22200546;13;114;281;284;8.62;0.53;25.77;5.07;268;0;40.00;3
13;0;22200550;13;116;281;284;8.53;0.53;25.77;5.07;268;0;41.00;3
13;0;22200553;13;121;285;288;8.50;0.53;25.77;5.01;272;0;42.00;3
15;0;22200557;15;123;285;288;8.28;0.51;26.53;5.01;270;0;43.00;3
16;0;22200561;16;126;289;292;8.11;0.50;27.44;4.96;273;0;44.00;3
16;0;22200566;16;131;291;294;7.94;0.49;27.44;4.92;275;0;45.00;3
19;0;22200569;19;134;291;294;7.64;0.47;29.68;4.92;272;0;46.00;3
19;0;22200572;19;135;291;294;7.56;0.47;29.68;4.92;272;0;47.00;3
19;0;22200574;19;140;302;307;7.79;0.48;29.68;4.75;283;0;48.00;5
19;0;22200580;19;141;302;307;7.62;0.47;29.68;4.75;283;0;49.00;5
19;0;22200583;19;142;302;307;7.49;0.47;29.68;4.75;283;0;50.00;5
19;0;22200586;19;144;303;308;7.44;0.46;29.68;4.73;284;0;51.00;5
20;0;22200589;20;146;304;309;7.33;0.46;30.75;4.72;284;0;52.00;5
20;0;22200592;20;150;304;309;7.26;0.45;30.75;4.72;284;0;53.00;5
20;0;22200596;20;153;306;312;7.31;0.45;30.75;4.69;286;0;54.00;6
22;0;22200600;22;156;306;312;7.06;0.44;31.14;4.69;284;0;55.00;6
23;0;22200603;23;146;307;312;7.11;0.44;31.22;4.68;284;0;56.00;5
26;0;22200606;26;143;307;312;7.02;0.43;34.12;4.68;281;0;57.00;5
27;0;22200611;27;142;312;318;7.06;0.43;34.07;4.62;285;0;58.00;6
28;0;22200616;28;141;313;318;7.08;0.43;34.96;4.61;285;0;59.00;5
28;0;22200623;28;142;313;318;7.25;0.45;34.96;4.61;285;0;60.00;5
28;0;22200628;28;147;313;318;7.38;0.45;34.96;4.61;285;0;61.00;5
29;0;22200632;29;149;317;322;7.43;0.45;35.72;4.57;288;0;62.00;5
29;0;22200636;29;151;318;323;7.54;0.46;35.72;4.55;289;0;63.00;5
29;0;22200638;29;152;318;323;7.61;0.47;35.72;4.55;289;0;64.00;5
30;0;22200641;30;153;319;324;7.67;0.47;36.57;4.54;289;0;65.00;5
31;0;22200647;31;154;319;324;7.60;0.47;36.16;4.54;288;0;66.00;5
31;0;22200650;31;142;319;324;7.64;0.47;36.16;4.54;288;0;67.00;5
31;0;22200652;31;139;319;324;7.74;0.47;36.16;4.54;288;0;68.00;5
32;0;22200656;32;137;319;324;7.84;0.48;37.19;4.54;287;0;69.00;5
32;0;22200660;32;133;319;324;7.96;0.49;37.19;4.54;287;0;70.00;5
33;0;22200664;33;128;319;324;8.13;0.50;38.00;4.54;286;0;71.00;5
34;0;22200667;34;132;351;394;8.32;0.51;39.00;4.13;317;0;72.00;43
34;0;22200679;34;126;352;395;8.50;0.52;39.00;4.12;318;0;73.00;43
36;0;22200683;36;119;359;395;8.81;0.54;40.36;4.08;323;0;74.00;36
36;1;22200687;36;117;361;395;9.00;0.55;40.36;4.07;325;1;75.00;34
36;1;22200702;36;116;364;395;9.19;0.56;40.36;4.07;328;1;76.00;31
36;1;22200706;36;116;364;395;9.26;0.57;40.36;4.07;328;1;77.00;31
37;1;22200712;37;116;369;395;9.43;0.58;40.92;4.10;332;1;78.00;26
38;1;22200716;38;119;369;395;9.39;0.57;41.92;4.10;331;1;79.00;26
38;1;22200730;38;122;372;396;9.41;0.57;41.92;4.13;334;1;80.00;24
39;1;22200734;39;123;375;397;9.41;0.57;42.92;4.17;336;1;81.00;22
40;1;22200739;40;125;377;397;9.37;0.57;43.90;4.20;337;1;82.00;20
41;1;22200743;41;130;385;401;9.17;0.56;44.85;4.21;344;1;83.00;16
41;1;22200749;41;129;386;401;9.16;0.56;44.85;4.22;345;1;84.00;15
41;1;22200753;41;130;386;401;9.15;0.56;44.85;4.22;345;1;85.00;15
42;1;22200756;42;129;386;401;9.16;0.56;45.62;4.22;344;1;86.00;15
43;1;22200762;43;130;391;407;9.10;0.56;46.56;4.17;348;1;87.00;16
47;1;22200767;47;132;391;407;8.93;0.54;50.09;4.17;344;1;88.00;16
47;1;22200770;47;135;391;407;8.90;0.54;50.09;4.17;344;1;89.00;16
47;1;22200777;47;130;395;413;8.95;0.54;50.09;4.13;348;1;90.00;18
47;1;22200782;47;129;395;413;8.90;0.54;50.09;4.13;348;1;91.00;18
50;1;22200786;50;132;397;413;8.87;0.54;52.50;4.12;347;1;92.00;16
50;1;22200790;50;131;398;414;8.88;0.54;52.50;4.11;348;1;93.00;16
52;1;22200795;52;130;399;415;8.91;0.54;53.98;4.11;347;1;94.00;16
54;1;22200800;54;133;399;415;8.80;0.54;55.50;4.11;345;1;95.00;16
55;1;22200805;55;136;409;428;8.63;0.53;56.24;4.00;354;1;96.00;19
58;1;22200811;58;133;410;428;8.63;0.52;57.10;4.00;352;1;97.00;18
59;1;22200816;59;136;410;428;8.58;0.52;57.80;4.00;351;1;98.00;18
62;1;22200820;62;137;411;429;8.53;0.52;59.45;3.99;349;1;99.00;18
63;1;22200825;63;135;411;429;8.55;0.52;60.06;3.99;348;1;100.00;18
63;1;22200837;63;134;414;433;8.65;0.53;60.06;3.97;351;1;101.00;19
63;1;22200842;63;137;414;433;8.61;0.52;60.06;3.97;351;1;102.00;19
64;1;22200848;64;138;418;437;8.55;0.52;60.73;3.94;354;1;103.00;19
65;1;22200852;65;135;418;437;8.64;0.53;61.34;3.94;353;1;104.00;19
66;1;22200856;66;132;418;437;8.75;0.53;61.98;3.94;352;1;105.00;19
67;1;22200862;67;126;418;437;8.86;0.54;62.52;3.94;351;1;106.00;19
68;1;22200867;68;119;418;437;8.91;0.54;63.13;3.94;350;1;107.00;19
68;1;22200871;68;109;429;449;9.00;0.55;63.13;3.84;361;1;108.00;20
68;1;22200878;68;105;430;449;9.06;0.55;63.13;3.83;362;1;109.00;19
69;1;22200883;69;101;432;449;9.10;0.55;63.78;3.99;363;1;110.00;17
69;1;22200890;69;97;432;449;9.19;0.56;63.78;3.99;363;1;111.00;17
69;1;22200897;69;96;432;449;9.33;0.57;63.78;3.99;363;1;112.00;17
69;1;22200902;69;94;432;449;9.50;0.58;63.78;3.99;363;1;113.00;17
69;1;22200907;69;88;433;450;9.68;0.60;63.78;3.98;364;1;114.00;17
70;1;22200914;70;82;433;450;9.88;0.61;64.51;3.98;363;1;115.00;17
71;1;22200918;71;79;438;456;10.10;0.62;65.24;3.95;367;1;116.00;18
73;1;22200924;73;76;438;457;10.23;0.63;66.58;3.95;365;1;117.00;19
74;1;22200932;74;71;439;457;10.31;0.63;66.78;3.94;365;1;118.00;18
76;1;22200937;76;70;439;457;10.38;0.63;68.05;3.94;363;1;119.00;18
77;1;22200946;77;68;443;462;10.50;0.64;68.69;3.91;366;1;120.00;19
77;1;22200953;77;74;443;462;10.60;0.65;68.69;3.91;366;1;121.00;19
77;1;22200960;77;70;443;462;10.66;0.65;68.69;3.91;366;1;122.00;19
79;1;22200966;79;74;445;463;10.70;0.65;69.76;4.17;366;1;123.00;18
80;1;22200972;80;78;449;467;10.71;0.65;70.44;4.14;369;1;124.00;18
80;1;22200980;80;80;449;467;10.82;0.66;70.44;4.14;369;1;125.00;18
80;1;22200986;80;79;454;470;10.98;0.67;70.44;4.61;374;1;126.00;16
80;1;22200992;80;80;455;470;11.13;0.68;70.44;4.60;375;1;127.00;15
80;1;22201000;80;81;456;470;11.22;0.68;70.44;4.87;376;1;128.00;14
81;1;22201006;81;82;456;470;11.43;0.70;71.12;4.87;375;1;129.00;14
82;1;22201014;82;85;461;474;11.55;0.71;71.83;5.13;379;1;130.00;13
83;1;22201021;83;86;462;474;11.64;0.71;72.53;5.24;379;1;131.00;12
86;1;22201028;86;87;465;474;11.73;0.72;74.53;5.65;379;1;132.00;9
86;1;22201035;86;87;467;474;11.82;0.72;74.53;5.80;381;1;133.00;7
87;1;22201041;87;88;469;475;11.79;0.72;74.80;5.91;382;1;134.00;6
89;1;22201050;89;90;471;477;11.84;0.72;75.30;5.88;382;1;135.00;6
89;1;22201056;89;90;474;477;11.79;0.72;75.30;6.04;385;1;136.00;3
90;1;22201065;90;91;475;478;11.84;0.73;75.19;6.03;385;1;137.00;3
92;1;22201071;92;96;476;478;11.79;0.72;75.77;6.10;384;1;138.00;2
94;1;22201079;94;96;476;478;11.82;0.72;76.94;6.10;382;1;139.00;2
95;1;22201086;95;97;477;478;11.88;0.73;77.48;6.18;382;1;140.00;1
95;1;22201092;95;99;477;478;11.87;0.73;77.48;6.18;382;1;141.00;1
96;1;22201100;96;99;478;478;11.98;0.73;77.80;6.22;382;1;142.00;0
99;1;22201106;99;99;478;478;11.94;0.73;79.20;6.22;379;1;143.00;0
103;1;22201116;103;117;552;605;11.51;0.72;81.41;5.39;449;1;144.00;53
103;1;22201138;103;112;559;606;11.42;0.72;81.41;5.33;456;1;145.00;47
106;1;22201154;106;111;564;606;11.36;0.71;82.22;5.30;458;1;146.00;42
108;1;22201162;108;112;569;606;11.15;0.70;83.42;5.28;461;1;147.00;37
110;1;22201169;110;114;574;606;11.02;0.69;84.49;5.27;464;1;148.00;32
114;1;22201176;114;116;576;606;10.81;0.68;86.46;5.27;462;1;149.00;30
116;1;22201186;116;118;582;611;10.56;0.66;87.16;5.26;466;1;150.00;29
118;1;22201197;118;114;584;611;10.47;0.65;87.27;5.26;466;1;151.00;27
120;1;22201204;120;116;586;612;10.48;0.65;88.31;5.27;466;1;152.00;26
122;1;22201212;122;118;589;613;10.51;0.65;87.91;5.29;467;1;153.00;24
123;1;22201219;123;119;591;613;10.50;0.65;88.40;5.31;468;1;154.00;22
124;1;22201226;124;122;596;614;10.40;0.64;88.94;5.32;472;1;155.00;18
127;1;22201235;127;123;601;614;10.25;0.63;89.39;5.37;474;1;156.00;13
128;1;22201241;128;127;602;614;10.25;0.63;89.91;5.39;474;1;157.00;12
131;1;22201250;131;131;604;614;10.20;0.63;91.45;5.42;473;1;158.00;10
132;1;22201257;132;135;608;618;10.24;0.63;91.95;5.42;476;1;159.00;10
135;1;22201267;135;139;611;618;10.19;0.63;92.23;5.43;476;1;160.00;7
136;1;22201273;136;146;611;618;10.15;0.63;92.56;5.43;475;1;161.00;7
136;1;22201282;136;153;613;621;10.19;0.63;92.56;5.41;477;1;162.00;8
136;1;22201289;136;157;614;621;10.21;0.63;92.56;5.43;478;1;163.00;7
137;1;22201297;137;158;614;621;10.18;0.63;93.08;5.43;477;1;164.00;7
139;1;22201303;139;164;619;625;10.00;0.62;93.40;5.46;480;1;165.00;6
140;1;22201311;140;162;620;626;10.02;0.62;93.80;5.45;480;1;166.00;6
143;1;22201318;143;165;621;626;9.96;0.61;94.31;5.47;478;1;167.00;5
145;1;22201324;145;159;626;630;9.97;0.61;94.46;5.43;481;1;168.00;4
146;1;22201333;146;157;626;630;9.90;0.61;94.93;5.43;480;1;169.00;4
147;1;22201340;147;159;627;630;9.84;0.61;95.28;5.47;480;1;170.00;3
147;1;22201348;147;155;628;631;9.68;0.60;95.28;5.46;481;1;171.00;3
150;1;22201354;150;157;629;631;9.50;0.59;96.28;5.49;479;1;172.00;2
154;1;22201362;154;157;635;637;9.37;0.58;97.55;5.45;481;1;173.00;2
154;1;22201369;154;160;635;637;9.21;0.57;97.55;5.45;481;1;174.00;2
154;1;22201376;154;149;636;638;9.09;0.56;97.55;5.44;482;1;175.00;2
155;1;22201384;155;146;636;638;8.98;0.56;98.06;5.44;481;1;176.00;2
157;1;22201390;157;140;637;638;8.93;0.55;98.54;5.48;480;1;177.00;1
160;1;22201399;160;134;637;638;8.87;0.55;99.30;5.48;477;1;178.00;1
161;1;22201407;161;137;638;638;8.93;0.55;99.70;5.49;477;1;179.00;0
162;1;22201417;162;138;665;672;9.14;0.57;99.31;5.27;503;1;180.00;7
162;1;22201431;162;134;667;672;9.20;0.57;99.31;5.26;505;1;181.00;5
164;1;22201438;164;127;670;672;9.32;0.58;99.78;5.24;506;1;182.00;2
164;1;22201446;164;126;671;672;9.39;0.58;99.78;5.24;507;1;183.00;1
165;1;22201453;165;121;672;672;9.47;0.59;99.62;5.24;507;1;184.00;0
166;1;22201461;166;123;672;672;9.49;0.59;100.12;5.24;506;1;185.00;0
166;1;22201469;166;116;676;676;9.48;0.59;100.12;5.21;510;1;186.00;0
167;1;22201477;167;113;676;676;9.44;0.58;100.19;5.21;509;1;187.00;0
169;1;22201485;169;114;680;680;9.54;0.59;100.68;5.19;511;1;188.00;0
170;1;22201492;170;122;681;681;9.62;0.59;101.20;5.18;511;1;189.00;0
171;1;22201501;171;129;681;681;9.67;0.60;101.44;5.18;510;1;190.00;0
173;1;22201508;173;139;681;681;9.62;0.59;101.84;5.18;508;1;191.00;0
174;1;22201523;174;145;694;694;9.63;0.59;101.93;5.08;520;1;192.00;0
177;1;22201533;177;144;694;694;9.53;0.59;102.19;5.08;517;1;193.00;0
178;1;22201541;178;148;694;694;9.44;0.58;102.30;5.08;516;1;194.00;0
181;1;22201550;181;152;695;695;9.40;0.58;102.69;5.08;514;1;195.00;0
183;1;22201559;183;157;696;696;9.25;0.57;103.25;5.07;513;1;196.00;0
184;1;22201568;184;164;696;696;9.13;0.56;103.50;5.07;512;1;197.00;0
189;1;22201575;189;172;698;699;9.06;0.56;103.05;5.06;509;1;198.00;1
191;1;22201584;191;173;698;699;9.05;0.56;102.91;5.06;507;1;199.00;1
193;1;22201592;193;178;699;699;9.09;0.56;102.42;5.05;506;1;200.00;0
196;1;22201607;196;182;699;699;8.92;0.55;101.93;5.05;503;1;201.00;0
197;1;22201616;197;187;705;705;8.84;0.54;102.27;5.02;508;1;202.00;0
200;1;22201623;200;191;705;705;8.68;0.53;101.97;5.02;505;1;203.00;0
202;1;22201632;202;196;705;705;8.49;0.52;102.79;5.02;503;1;204.00;0
205;1;22201638;205;207;705;705;8.28;0.51;102.80;5.02;500;1;205.00;0
206;1;22201653;206;210;709;709;8.16;0.50;102.57;4.99;503;1;206.00;0
210;1;22201668;210;213;710;710;8.03;0.49;102.83;4.99;500;1;207.00;0
212;1;22201676;212;220;710;710;7.91;0.48;102.66;4.99;498;1;208.00;0
213;1;22201684;213;221;711;711;7.75;0.47;103.15;4.98;498;1;209.00;0
213;1;22201693;213;227;711;711;7.57;0.46;103.15;4.98;498;1;210.00;0
216;1;22201701;216;227;711;711;7.30;0.45;103.03;4.98;495;1;211.00;0
217;1;22201709;217;233;711;711;7.21;0.44;102.87;4.98;494;1;212.00;0
220;1;22201717;220;235;711;711;7.14;0.44;102.71;4.98;491;1;213.00;0
224;1;22201723;224;238;711;711;7.04;0.43;102.52;4.98;487;1;214.00;0
226;1;22201731;226;244;711;711;6.98;0.43;102.64;4.98;485;1;215.00;0
226;1;22201738;226;260;755;781;7.30;0.45;102.64;4.69;529;1;216.00;26
228;1;22201752;228;259;757;782;7.29;0.45;103.19;4.68;529;1;217.00;25
229;1;22201760;229;261;764;782;7.35;0.45;103.07;4.66;535;1;218.00;18
230;1;22201768;230;263;767;782;7.40;0.45;103.54;4.65;537;1;219.00;15
230;1;22201775;230;269;770;782;7.42;0.46;103.54;4.65;540;1;220.00;12
230;1;22201784;230;265;771;782;7.41;0.46;103.54;4.65;541;1;221.00;11
231;1;22201791;231;255;773;782;7.39;0.46;104.03;4.65;542;1;222.00;9
233;1;22201801;233;253;775;782;7.38;0.45;104.84;4.66;542;1;223.00;7
233;1;22201809;233;238;778;783;7.46;0.46;104.84;4.67;545;1;224.00;5
234;1;22201818;234;230;783;785;7.44;0.46;105.32;4.68;549;1;225.00;2
237;1;22201827;237;229;784;785;7.47;0.46;106.81;4.68;547;1;226.00;1
238;1;22201837;238;226;789;789;7.55;0.46;107.05;4.66;551;1;227.00;0
239;1;22201847;239;223;789;789;7.67;0.47;107.55;4.66;550;1;228.00;0
240;1;22201855;240;221;789;789;7.76;0.47;107.20;4.66;549;1;229.00;0
244;1;22201866;244;223;789;789;7.87;0.48;108.56;4.66;545;1;230.00;0
247;1;22201873;247;211;795;795;8.07;0.49;109.13;4.64;548;1;231.00;0
247;1;22201884;247;198;795;795;8.30;0.51;109.13;4.64;548;1;232.00;0
247;1;22201894;247;186;795;795;8.43;0.52;109.13;4.64;548;1;233.00;0
248;1;22201904;248;177;797;798;8.72;0.54;109.60;4.62;549;1;234.00;1
248;1;22201927;248;169;798;798;8.85;0.54;109.60;4.62;550;1;235.00;0
250;1;22201940;250;164;798;798;8.95;0.55;110.03;4.62;548;1;236.00;0
251;1;22201953;251;162;799;799;9.11;0.56;109.83;4.61;548;1;237.00;0
252;1;22201965;252;155;800;800;9.26;0.57;109.48;4.61;548;1;238.00;0
256;1;22201975;256;153;800;800;9.37;0.57;110.30;4.61;544;1;239.00;0
257;1;22201991;257;155;825;826;9.53;0.59;109.96;4.47;568;1;240.00;1
258;1;22202005;258;149;825;826;9.58;0.59;110.07;4.47;567;1;241.00;1
258;1;22202018;258;142;826;826;9.67;0.59;110.07;4.47;568;1;242.00;0
261;1;22202031;261;140;827;827;9.76;0.60;110.57;4.46;566;1;243.00;0
262;1;22202041;262;133;827;827;9.84;0.60;111.08;4.46;565;1;244.00;0
263;1;22202054;263;126;831;831;9.86;0.61;111.55;4.45;568;1;245.00;0
267;1;22202068;267;127;831;831;9.85;0.60;112.25;4.45;564;1;246.00;0
268;1;22202078;268;125;835;835;9.83;0.60;112.49;4.43;567;1;247.00;0
271;1;22202090;271;123;835;835;9.85;0.60;113.24;4.43;564;1;248.00;0
274;1;22202104;274;120;835;835;9.92;0.61;113.68;4.43;561;1;249.00;0
275;1;22202116;275;118;835;835;9.92;0.61;113.65;4.43;560;1;250.00;0
280;1;22202124;280;124;835;835;9.97;0.61;114.87;4.43;555;1;251.00;0
280;1;22202137;280;119;845;847;10.10;0.62;114.87;4.38;565;1;252.00;2
288;1;22202149;288;126;845;847;10.16;0.62;116.84;4.38;557;1;253.00;2
291;1;22202159;291;127;847;847;10.27;0.63;118.16;4.37;556;1;254.00;0
294;1;22202172;294;128;847;847;10.40;0.63;118.37;4.37;553;1;255.00;0
297;1;22202184;297;127;847;847;10.48;0.64;118.54;4.37;550;1;256.00;0
297;1;22202195;297;132;847;847;10.48;0.64;118.54;4.37;550;1;257.00;0
300;1;22202205;300;134;848;848;10.38;0.63;119.37;4.37;548;1;258.00;0
301;1;22202217;301;137;848;848;10.35;0.63;119.80;4.37;547;1;259.00;0
301;2;22202227;301;138;854;854;10.24;0.62;119.80;4.34;553;2;260.00;0
301;2;22202265;301;140;855;855;10.19;0.62;119.80;4.34;554;2;261.00;0
301;2;22202275;301;145;855;855;10.09;0.61;119.80;4.34;554;2;262.00;0
304;2;22202284;304;150;855;855;9.98;0.61;120.43;4.34;551;2;263.00;0
305;2;22202291;305;150;859;859;9.99;0.61;120.27;4.32;554;2;264.00;0
306;2;22202308;306;150;859;859;9.97;0.61;120.47;4.32;553;2;265.00;0
307;2;22202317;307;146;859;859;9.94;0.60;120.36;4.32;552;2;266.00;0
308;2;22202324;308;146;860;860;9.96;0.60;120.57;4.31;552;2;267.00;0
310;2;22202334;310;142;864;864;9.94;0.60;120.75;4.30;554;2;268.00;0
310;2;22202342;310;140;864;864;9.99;0.61;120.75;4.30;554;2;269.00;0
311;2;22202353;311;138;868;870;10.07;0.61;120.84;4.28;557;2;270.00;2
314;2;22202363;314;132;868;870;10.13;0.61;120.81;4.28;554;2;271.00;2
318;2;22202371;318;132;870;870;10.19;0.62;121.84;4.27;552;2;272.00;0
319;2;22202380;319;129;870;870;10.25;0.62;121.86;4.27;551;2;273.00;0
320;2;22202390;320;128;874;874;10.34;0.63;122.24;4.26;554;2;274.00;0
321;2;22202400;321;129;874;874;10.37;0.63;122.72;4.26;553;2;275.00;0
326;2;22202409;326;125;874;874;10.28;0.62;123.30;4.26;548;2;276.00;0
330;2;22202419;330;126;874;874;10.24;0.62;124.01;4.26;544;2;277.00;0
332;2;22202429;332;125;875;875;10.20;0.62;124.48;4.25;543;2;278.00;0
333;2;22202439;333;120;876;876;10.24;0.62;124.39;4.25;543;2;279.00;0
335;2;22202449;335;115;876;876;10.25;0.62;124.46;4.25;541;2;280.00;0
336;2;22202456;336;111;877;877;10.24;0.62;124.49;4.25;541;2;281.00;0
337;2;22202467;337;108;877;877;10.27;0.62;124.79;4.25;540;2;282.00;0
340;2;22202474;340;100;877;877;10.29;0.62;125.13;4.25;537;2;283.00;0
341;2;22202483;341;95;877;877;10.33;0.62;125.06;4.25;536;2;284.00;0
342;2;22202491;342;91;877;877;10.46;0.63;125.11;4.25;535;2;285.00;0
342;2;22202499;342;89;877;877;10.58;0.64;125.11;4.25;535;2;286.00;0
342;2;22202507;342;85;877;877;10.71;0.65;125.11;4.25;535;2;287.00;0
343;2;22202518;343;100;943;1004;10.56;0.65;125.06;3.95;600;2;288.00;61
343;2;22202539;343;88;946;1005;10.61;0.66;125.06;3.94;603;2;289.00;59
343;2;22202555;343;84;952;1005;10.73;0.66;125.06;3.93;609;2;290.00;53
348;2;22202574;348;77;955;1005;10.74;0.66;125.43;3.93;607;2;291.00;50
350;2;22202588;350;79;962;1005;10.91;0.67;125.36;3.93;612;2;292.00;43
350;2;22202601;350;81;962;1005;10.95;0.68;125.36;3.93;612;2;293.00;43
355;2;22202616;355;79;965;1005;11.00;0.68;125.78;3.93;610;2;294.00;40
356;2;22202641;356;81;968;1005;11.16;0.69;125.85;3.94;612;2;295.00;37
359;2;22202654;359;79;970;1006;11.31;0.69;126.54;3.95;611;2;296.00;36
361;2;22202668;361;80;975;1007;11.43;0.70;126.39;3.98;614;2;297.00;32
365;2;22202682;365;77;980;1007;11.46;0.70;126.63;4.01;615;2;298.00;27
366;2;22202696;366;77;982;1008;11.51;0.70;126.64;4.02;616;2;299.00;26
367;2;22202715;367;78;987;1014;11.42;0.70;126.46;4.04;620;2;300.00;27
369;2;22202737;369;78;989;1014;11.40;0.70;126.43;4.06;620;2;301.00;25
370;2;22202750;370;84;996;1014;11.28;0.69;126.61;4.13;626;2;302.00;18
371;2;22202764;371;87;1000;1018;11.21;0.69;127.05;4.15;629;2;303.00;18
373;2;22202778;373;89;1002;1018;11.06;0.68;127.22;4.16;629;2;304.00;16
376;2;22202812;376;94;1003;1018;11.06;0.68;127.53;4.17;627;2;305.00;15
376;2;22202824;376;109;1008;1021;10.93;0.67;127.53;4.20;632;2;306.00;13
377;2;22202839;377;113;1008;1021;10.90;0.67;127.79;4.20;631;2;307.00;13
378;2;22202853;378;118;1009;1021;10.88;0.67;127.70;4.22;631;2;308.00;12
380;2;22202867;380;123;1013;1025;10.73;0.66;128.32;4.23;633;2;309.00;12
381;2;22202880;381;128;1015;1026;10.72;0.66;128.77;4.25;634;2;310.00;11
383;2;22202891;383;137;1018;1026;10.71;0.66;128.78;4.27;635;2;311.00;8
387;2;22202905;387;133;1023;1030;10.67;0.65;128.83;4.26;636;2;312.00;7
389;2;22202919;389;134;1024;1030;10.69;0.65;129.26;4.26;635;2;313.00;6
392;2;22202934;392;133;1026;1030;10.75;0.66;129.57;4.27;634;2;314.00;4
393;2;22202946;393;136;1029;1032;10.80;0.66;130.03;4.27;636;2;315.00;3
394;2;22202968;394;140;1029;1032;10.88;0.66;129.98;4.27;635;2;316.00;3
396;2;22202979;396;140;1034;1038;10.92;0.67;130.44;4.25;638;2;317.00;4
399;2;22202989;399;144;1035;1038;10.88;0.66;131.74;4.25;636;2;318.00;3
400;2;22203001;400;148;1036;1039;10.78;0.66;132.02;4.25;636;2;319.00;3
401;2;22203012;401;150;1036;1039;10.64;0.65;132.49;4.25;635;2;320.00;3
403;2;22203021;403;155;1036;1039;10.44;0.64;132.95;4.25;633;2;321.00;3
404;2;22203031;404;158;1036;1039;10.28;0.63;133.17;4.25;632;2;322.00;3
408;2;22203039;408;159;1036;1039;10.11;0.62;134.24;4.25;628;2;323.00;3
410;2;22203050;410;164;1047;1051;9.99;0.61;134.84;4.23;637;2;324.00;4
411;2;22203061;411;159;1047;1051;9.91;0.61;134.95;4.23;636;2;325.00;4
411;2;22203070;411;165;1049;1051;9.89;0.61;134.95;4.23;638;2;326.00;2
413;2;22203080;413;163;1049;1051;9.83;0.60;135.22;4.23;636;2;327.00;2
415;2;22203088;415;168;1049;1051;9.83;0.61;135.10;4.23;634;2;328.00;2
418;2;22203099;418;166;1050;1051;9.75;0.60;135.65;4.27;632;2;329.00;1
421;2;22203111;421;172;1053;1055;9.68;0.60;136.08;4.26;632;2;330.00;2
426;2;22203120;426;169;1053;1055;9.69;0.59;136.27;4.26;627;2;331.00;2
428;2;22203130;428;174;1057;1059;9.81;0.60;136.56;4.24;629;2;332.00;2
432;2;22203140;432;175;1059;1060;9.84;0.60;136.66;4.26;627;2;333.00;1
432;2;22203150;432;175;1059;1060;9.83;0.60;136.66;4.26;627;2;334.00;1
435;2;22203159;435;181;1060;1060;9.88;0.61;136.69;4.26;625;2;335.00;0
439;2;22203169;439;183;1073;1073;9.78;0.60;137.26;4.21;634;2;336.00;0
444;2;22203180;444;189;1073;1073;9.76;0.60;137.55;4.21;629;2;337.00;0
450;2;22203189;450;195;1073;1073;9.82;0.60;138.86;4.21;623;2;338.00;0
453;2;22203201;453;192;1074;1074;9.84;0.60;139.55;4.21;621;2;339.00;0
454;2;22203212;454;194;1075;1075;9.84;0.60;139.99;4.20;621;2;340.00;0
458;2;22203221;458;194;1075;1075;9.67;0.59;140.70;4.20;617;2;341.00;0
461;2;22203232;461;196;1078;1078;9.51;0.58;141.70;4.19;617;2;342.00;0
462;2;22203240;462;201;1078;1078;9.36;0.57;141.43;4.19;616;2;343.00;0
464;2;22203251;464;202;1078;1078;9.20;0.56;141.84;4.19;614;2;344.00;0
466;2;22203261;466;208;1078;1078;9.14;0.56;142.00;4.19;612;2;345.00;0
469;2;22203272;469;209;1084;1084;9.03;0.55;142.80;4.17;615;2;346.00;0
470;2;22203285;470;211;1084;1084;8.85;0.54;143.24;4.17;614;2;347.00;0
473;2;22203295;473;215;1084;1084;8.55;0.53;144.07;4.17;611;2;348.00;0
479;2;22203305;479;223;1084;1084;8.32;0.51;144.75;4.17;605;2;349.00;0
480;2;22203316;480;213;1088;1088;8.17;0.50;145.18;4.16;608;2;350.00;0
481;2;22203326;481;209;1089;1089;8.05;0.50;145.60;4.16;608;2;351.00;0
483;2;22203338;483;205;1089;1089;7.97;0.49;145.76;4.16;606;2;352.00;0
485;2;22203349;485;200;1090;1090;7.88;0.49;146.02;4.16;605;2;353.00;0
487;2;22203358;487;200;1090;1090;7.87;0.49;146.41;4.16;603;2;354.00;0
488;2;22203370;488;201;1090;1090;7.92;0.49;146.80;4.16;602;2;355.00;0
492;2;22203381;492;207;1090;1090;7.92;0.49;146.81;4.16;598;2;356.00;0
497;2;22203390;497;204;1090;1090;7.91;0.49;147.06;4.16;593;2;357.00;0
500;2;22203401;500;200;1090;1090;7.92;0.49;147.12;4.16;590;2;358.00;0
501;2;22203411;501;205;1090;1090;7.93;0.49;147.46;4.16;589;2;359.00;0
503;2;22203423;503;215;1156;1215;8.08;0.51;148.16;3.92;653;2;360.00;59
507;2;22203449;507;211;1162;1216;7.99;0.50;148.79;3.90;655;2;361.00;54
510;2;22203459;510;213;1175;1216;8.04;0.51;149.37;3.88;665;2;362.00;41
515;2;22203482;515;213;1176;1216;7.88;0.50;149.54;3.88;661;2;363.00;40
520;2;22203492;520;220;1185;1216;7.78;0.49;149.75;3.88;665;2;364.00;31
524;2;22203504;524;224;1187;1216;7.71;0.48;150.07;3.88;663;2;365.00;29
529;2;22203517;529;230;1194;1216;7.62;0.48;150.26;3.90;665;2;366.00;22
531;2;22203528;531;233;1196;1216;7.58;0.47;150.73;3.90;665;2;367.00;20
534;2;22203537;534;240;1201;1217;7.55;0.47;151.33;3.92;667;2;368.00;16
537;2;22203547;537;249;1206;1218;7.44;0.46;151.20;3.94;669;2;369.00;12
540;2;22203556;540;253;1209;1218;7.32;0.45;151.11;3.96;669;2;370.00;9
544;2;22203566;544;256;1214;1222;7.21;0.44;151.35;3.95;670;2;371.00;8
544;2;22203576;544;259;1217;1222;7.06;0.44;151.35;3.96;673;2;372.00;5
545;2;22203586;545;262;1219;1222;6.94;0.43;151.14;3.97;674;2;373.00;3
545;2;22203596;545;276;1220;1222;6.82;0.42;151.14;3.98;675;2;374.00;2
548;2;22203604;548;285;1225;1228;6.74;0.42;150.76;3.97;677;2;375.00;3
549;2;22203616;549;283;1226;1228;6.67;0.41;150.81;3.98;677;2;376.00;2
550;2;22203624;550;289;1226;1228;6.63;0.41;150.69;3.98;676;2;377.00;2
551;2;22203634;551;294;1229;1231;6.64;0.41;150.52;3.98;678;2;378.00;2
552;2;22203645;552;296;1229;1231;6.64;0.41;150.76;3.98;677;2;379.00;2
555;2;22203653;555;298;1229;1231;6.54;0.40;150.48;3.98;674;2;380.00;2
557;2;22203663;557;287;1231;1232;6.52;0.40;150.15;3.98;674;2;381.00;1
560;2;22203680;560;282;1232;1233;6.58;0.40;149.83;3.98;672;2;382.00;1
563;2;22203690;563;277;1232;1233;6.59;0.40;149.90;3.98;669;2;383.00;1
564;2;22203701;564;275;1244;1246;6.76;0.41;149.99;3.94;680;2;384.00;2
565;2;22203711;565;274;1244;1246;6.85;0.42;149.77;3.94;679;2;385.00;2
565;2;22203721;565;278;1244;1246;6.96;0.43;149.77;3.94;679;2;386.00;2
566;3;22203732;566;274;1245;1247;7.11;0.44;149.55;3.94;679;3;387.00;2
568;3;22203757;568;266;1246;1247;7.25;0.44;149.74;3.94;678;3;388.00;1
570;3;22203769;570;267;1249;1251;7.39;0.45;149.63;3.94;679;3;389.00;2
572;3;22203788;572;265;1249;1251;7.41;0.45;149.69;3.94;677;3;390.00;2
572;3;22203800;572;262;1254;1255;7.49;0.46;149.69;3.93;682;3;391.00;1
574;3;22203811;574;263;1255;1255;7.51;0.46;149.94;3.93;681;3;392.00;0
575;3;22203820;575;264;1255;1255;7.46;0.46;149.71;3.93;680;3;393.00;0
576;3;22203831;576;264;1255;1255;7.42;0.45;149.64;3.93;679;3;394.00;0
579;3;22203856;579;263;1255;1255;7.41;0.45;149.52;3.93;676;3;395.00;0
581;3;22203867;581;262;1266;1267;7.54;0.46;149.70;3.90;685;3;396.00;1
582;3;22203885;582;252;1266;1267;7.58;0.46;149.86;3.90;684;3;397.00;1
584;3;22203897;584;250;1267;1267;7.69;0.47;149.89;3.90;683;3;398.00;0
585;3;22203906;585;248;1267;1267;7.75;0.47;150.01;3.90;682;3;399.00;0
585;3;22203919;585;248;1267;1267;7.86;0.48;150.01;3.90;682;3;400.00;0
586;3;22203934;586;251;1267;1267;7.94;0.48;150.13;3.90;681;3;401.00;0
589;3;22203946;589;253;1268;1268;7.97;0.49;150.49;3.89;679;3;402.00;0
591;3;22203956;591;257;1268;1268;7.95;0.48;150.51;3.89;677;3;403.00;0
592;3;22203968;592;259;1274;1274;7.98;0.49;150.45;3.88;682;3;404.00;0
593;3;22203980;593;257;1276;1276;8.08;0.49;150.58;3.87;683;3;405.00;0
594;3;22203998;594;240;1276;1276;8.17;0.50;150.64;3.87;682;3;406.00;0
595;3;22204008;595;230;1276;1276;8.25;0.50;150.85;3.87;681;3;407.00;0
598;3;22204021;598;222;1280;1280;8.35;0.51;151.02;3.86;682;3;408.00;0
598;3;22204033;598;214;1280;1280;8.50;0.52;151.02;3.86;682;3;409.00;0
600;3;22204044;600;212;1280;1280;8.64;0.53;151.64;3.86;680;3;410.00;0
601;3;22204055;601;211;1281;1281;8.86;0.54;151.59;3.86;680;3;411.00;0
603;3;22204067;603;209;1285;1285;8.96;0.55;152.20;3.85;682;3;412.00;0
604;3;22204079;604;204;1285;1285;9.07;0.56;152.43;3.85;681;3;413.00;0
608;3;22204091;608;203;1287;1288;9.13;0.56;152.95;3.84;679;3;414.00;1
608;3;22204104;608;200;1287;1288;9.18;0.56;152.95;3.84;679;3;415.00;1
612;3;22204116;612;198;1288;1288;9.18;0.56;154.00;3.84;676;3;416.00;0
613;3;22204129;613;194;1288;1288;9.17;0.56;153.84;3.84;675;3;417.00;0
617;3;22204139;617;187;1292;1292;9.19;0.56;154.71;3.83;675;3;418.00;0
618;3;22204151;618;184;1292;1292;9.21;0.56;154.55;3.83;674;3;419.00;0
620;3;22204166;620;180;1292;1292;9.22;0.56;154.60;3.83;672;3;420.00;0
622;3;22204177;622;176;1292;1292;9.32;0.57;154.94;3.83;670;3;421.00;0
626;3;22204188;626;169;1293;1293;9.30;0.57;155.56;3.83;667;3;422.00;0
629;3;22204200;629;169;1294;1294;9.36;0.57;155.97;3.83;665;3;423.00;0
634;3;22204212;634;173;1294;1294;9.38;0.57;157.31;3.83;660;3;424.00;0
636;3;22204222;636;172;1295;1295;9.44;0.57;157.67;3.83;659;3;425.00;0
640;3;22204233;640;168;1295;1295;9.56;0.58;158.55;3.83;655;3;426.00;0
642;3;22204244;642;165;1295;1295;9.64;0.59;159.27;3.83;653;3;427.00;0
643;3;22204255;643;169;1295;1295;9.74;0.59;159.24;3.83;652;3;428.00;0
645;3;22204267;645;168;1295;1295;9.85;0.60;159.42;3.83;650;3;429.00;0
648;3;22204277;648;166;1295;1295;9.98;0.61;159.63;3.83;647;3;430.00;0
649;3;22204288;649;165;1295;1295;9.99;0.61;159.70;3.83;646;3;431.00;0
655;3;22204300;655;192;1377;1422;9.77;0.60;160.94;3.60;722;3;432.00;45
656;3;22204322;656;182;1377;1423;9.84;0.61;160.85;3.60;721;3;433.00;46
657;3;22204340;657;171;1382;1423;9.92;0.61;161.25;3.59;725;3;434.00;41
659;3;22204353;659;175;1382;1423;9.93;0.61;161.23;3.59;723;3;435.00;41
662;3;22204366;662;170;1386;1423;9.86;0.61;161.88;3.60;724;3;436.00;37
665;3;22204377;665;176;1387;1423;9.77;0.60;161.86;3.60;722;3;437.00;36
667;3;22204388;667;178;1389;1423;9.75;0.60;162.11;3.60;722;3;438.00;34
670;3;22204399;670;184;1391;1423;9.69;0.59;162.66;3.61;721;3;439.00;32
672;3;22204410;672;182;1393;1424;9.66;0.59;162.57;3.61;721;3;440.00;31
674;3;22204421;674;179;1397;1425;9.58;0.59;162.61;3.63;723;3;441.00;28
675;3;22204438;675;173;1399;1425;9.57;0.59;163.02;3.64;724;3;442.00;26
675;3;22204450;675;171;1401;1426;9.51;0.58;163.02;3.65;726;3;443.00;25
677;3;22204462;677;173;1403;1426;9.57;0.59;163.31;3.66;726;3;444.00;23
680;3;22204473;680;175;1404;1426;9.55;0.59;163.82;3.67;724;3;445.00;22
680;3;22204485;680;172;1405;1426;9.57;0.59;163.82;3.67;725;3;446.00;21
685;3;22204497;685;169;1409;1430;9.60;0.59;164.66;3.69;724;3;447.00;21
689;3;22204508;689;168;1413;1430;9.68;0.59;164.93;3.72;724;3;448.00;17
694;3;22204521;694;172;1416;1430;9.65;0.59;165.13;3.74;722;3;449.00;14
695;3;22204535;695;172;1419;1436;9.77;0.60;165.20;3.74;724;3;450.00;17
699;3;22204548;699;175;1420;1436;9.77;0.60;165.62;3.74;721;3;451.00;16
703;3;22204558;703;175;1423;1436;9.77;0.60;166.46;3.74;720;3;452.00;13
705;3;22204570;705;178;1428;1440;9.78;0.60;166.96;3.76;723;3;453.00;12
707;3;22204582;707;172;1429;1441;9.81;0.60;167.32;3.76;722;3;454.00;12
714;3;22204593;714;171;1431;1441;9.73;0.59;168.68;3.79;717;3;455.00;10
718;3;22204613;718;163;1433;1445;9.75;0.59;169.00;3.78;715;3;456.00;12
723;3;22204623;723;165;1435;1445;9.68;0.59;169.46;3.79;712;3;457.00;10
726;3;22204636;726;156;1437;1445;9.59;0.58;170.06;3.81;711;3;458.00;8
728;3;22204647;728;151;1438;1446;9.62;0.58;170.42;3.81;710;3;459.00;8
731;3;22204657;731;143;1438;1446;9.65;0.59;171.15;3.81;707;3;460.00;8
733;3;22204670;733;146;1443;1452;9.77;0.59;171.68;3.81;710;3;461.00;9
735;3;22204683;735;142;1443;1452;9.84;0.60;172.03;3.81;708;3;462.00;9
737;3;22204694;737;141;1443;1453;9.94;0.60;172.40;3.81;706;3;463.00;10
740;3;22204705;740;140;1443;1453;9.95;0.60;172.99;3.81;703;3;464.00;10
743;3;22204717;743;136;1443;1453;9.97;0.61;173.12;3.81;700;3;465.00;10
745;3;22204730;745;134;1443;1453;10.06;0.61;173.43;3.81;698;3;466.00;10
747;3;22204740;747;127;1443;1453;10.11;0.61;173.41;3.81;696;3;467.00;10
749;3;22204752;749;127;1453;1465;10.16;0.62;173.27;3.78;704;3;468.00;12
750;3;22204765;750;125;1454;1465;10.27;0.62;173.42;3.78;704;3;469.00;11
753;3;22204778;753;125;1454;1465;10.32;0.63;173.73;3.78;701;3;470.00;11
759;3;22204789;759;124;1454;1465;10.34;0.63;173.88;3.78;695;3;471.00;11
764;3;22204801;764;126;1454;1465;10.39;0.63;173.84;3.78;690;3;472.00;11
767;3;22204814;767;125;1455;1465;10.46;0.63;174.03;3.81;688;3;473.00;10
772;3;22204824;772;125;1458;1469;10.48;0.63;174.26;3.80;686;3;474.00;11
774;4;22204837;774;121;1459;1469;10.46;0.63;174.20;3.83;685;4;475.00;10
775;4;22204863;775;122;1464;1473;10.43;0.63;174.36;3.88;689;4;476.00;9
778;4;22204874;778;123;1466;1474;10.32;0.62;174.58;3.89;688;4;477.00;8
780;4;22204886;780;127;1466;1474;10.25;0.62;174.79;3.89;686;4;478.00;8
783;4;22204898;783;130;1466;1474;10.15;0.61;174.66;3.89;683;4;479.00;8
783;4;22204912;783;137;1491;1500;10.04;0.61;174.66;3.88;708;4;480.00;9
784;4;22204925;784;137;1492;1500;10.07;0.61;174.64;3.87;708;4;481.00;8
786;4;22204937;786;138;1494;1500;10.14;0.62;174.73;3.89;708;4;482.00;6
787;4;22204949;787;145;1497;1501;10.25;0.62;174.66;3.90;710;4;483.00;4
788;4;22204961;788;149;1497;1502;10.28;0.63;174.69;3.90;709;4;484.00;5
790;4;22204972;790;150;1498;1502;10.32;0.63;175.11;3.90;708;4;485.00;4
792;4;22204984;792;148;1501;1505;10.39;0.63;174.89;3.91;709;4;486.00;4
793;4;22204996;793;151;1501;1505;10.42;0.64;174.83;3.91;708;4;487.00;4
794;4;22205006;794;157;1503;1505;10.44;0.64;174.95;3.91;709;4;488.00;2
794;4;22205018;794;159;1503;1505;10.40;0.63;174.95;3.91;709;4;489.00;2
796;4;22205029;796;164;1511;1511;10.31;0.63;174.99;3.90;715;4;490.00;0
798;4;22205040;798;172;1511;1511;10.18;0.62;175.15;3.90;713;4;491.00;0
799;4;22205053;799;176;1511;1511;10.04;0.61;175.19;3.90;712;4;492.00;0
802;4;22205065;802;180;1511;1511;9.89;0.61;175.24;3.90;709;4;493.00;0
805;4;22205074;805;186;1515;1515;9.73;0.60;175.04;3.89;710;4;494.00;0
808;4;22205087;808;189;1517;1517;9.72;0.60;175.40;3.89;709;4;495.00;0
810;4;22205099;810;199;1517;1517;9.67;0.59;175.63;3.89;707;4;496.00;0
812;4;22205109;812;204;1518;1518;9.63;0.59;175.70;3.89;706;4;497.00;0
812;4;22205120;812;202;1518;1518;9.55;0.59;175.70;3.89;706;4;498.00;0
816;4;22205131;816;201;1518;1518;9.53;0.58;175.40;3.89;702;4;499.00;0
818;4;22205143;818;207;1518;1518;9.49;0.58;175.50;3.89;700;4;500.00;0
818;4;22205157;818;209;1518;1518;9.39;0.58;175.50;3.89;700;4;501.00;0
820;4;22205169;820;213;1518;1518;9.35;0.57;175.59;3.89;698;4;502.00;0
822;4;22205180;822;217;1518;1518;9.32;0.57;175.49;3.89;696;4;503.00;0
822;4;22205190;822;221;1559;1588;9.47;0.59;175.49;3.78;737;4;504.00;29
824;4;22205207;824;223;1562;1589;9.47;0.58;175.27;3.78;738;4;505.00;27
828;4;22205219;828;222;1571;1589;9.48;0.58;175.24;3.77;743;4;506.00;18
831;4;22205230;831;224;1574;1589;9.48;0.58;175.22;3.77;743;4;507.00;15
833;4;22205240;833;227;1577;1589;9.45;0.58;175.29;3.77;744;4;508.00;12
834;4;22205251;834;232;1578;1589;9.42;0.58;175.20;3.77;744;4;509.00;11
840;4;22205265;840;232;1580;1589;9.37;0.57;175.11;3.77;740;4;510.00;9
842;4;22205275;842;236;1584;1589;9.30;0.57;175.17;3.78;742;4;511.00;5
844;4;22205286;844;238;1587;1590;9.29;0.57;174.83;3.79;743;4;512.00;3
847;4;22205298;847;239;1589;1591;9.28;0.57;175.21;3.79;742;4;513.00;2
853;4;22205308;853;245;1590;1591;9.16;0.56;175.26;3.79;737;4;514.00;1
857;4;22205320;857;246;1595;1595;9.11;0.56;175.25;3.79;738;4;515.00;0
862;4;22205332;862;251;1595;1595;8.95;0.55;175.53;3.79;733;4;516.00;0
865;4;22205341;865;256;1595;1595;8.83;0.54;175.47;3.79;730;4;517.00;0
868;4;22205353;868;259;1595;1595;8.68;0.53;175.78;3.79;727;4;518.00;0
870;4;22205364;870;265;1601;1601;8.57;0.52;176.04;3.78;731;4;519.00;0
875;4;22205374;875;273;1601;1601;8.37;0.51;176.53;3.78;726;4;520.00;0
876;4;22205385;876;274;1601;1601;8.22;0.50;176.51;3.78;725;4;521.00;0
880;4;22205396;880;277;1604;1604;8.03;0.49;177.07;3.77;724;4;522.00;0
882;4;22205406;882;279;1604;1604;7.87;0.48;177.48;3.77;722;4;523.00;0
887;4;22205416;887;286;1604;1604;7.65;0.47;177.71;3.77;717;4;524.00;0
889;4;22205426;889;276;1605;1605;7.48;0.46;177.89;3.77;716;4;525.00;0
890;4;22205436;890;269;1606;1606;7.37;0.45;178.20;3.76;716;4;526.00;0
892;4;22205447;892;268;1606;1606;7.29;0.45;178.50;3.76;714;4;527.00;0
897;4;22205456;897;268;1619;1619;7.22;0.44;178.52;3.73;722;4;528.00;0
901;4;22205469;901;269;1619;1619;7.14;0.44;178.64;3.73;718;4;529.00;0
902;4;22205479;902;274;1619;1619;7.07;0.43;178.55;3.73;717;4;530.00;0
904;4;22205488;904;283;1620;1620;7.01;0.43;178.24;3.73;716;4;531.00;0
905;4;22205499;905;278;1620;1620;6.94;0.43;178.57;3.73;715;4;532.00;0
906;4;22205508;906;279;1624;1624;6.96;0.43;178.58;3.73;718;4;533.00;0
908;4;22205520;908;286;1624;1624;6.94;0.42;178.91;3.73;716;4;534.00;0
910;4;22205529;910;283;1628;1628;6.91;0.42;179.22;3.72;718;4;535.00;0
912;4;22205539;912;287;1628;1628;6.85;0.42;179.59;3.72;716;4;536.00;0
913;4;22205550;913;292;1628;1628;6.80;0.42;179.72;3.72;715;4;537.00;0
914;4;22205559;914;275;1628;1628;6.73;0.41;179.55;3.72;714;4;538.00;0
915;4;22205569;915;267;1628;1628;6.73;0.41;179.85;3.72;713;4;539.00;0
920;4;22205581;920;266;1655;1662;6.99;0.43;180.17;3.66;735;4;540.00;7
924;4;22205595;924;266;1657;1662;7.07;0.43;180.36;3.65;733;4;541.00;5
927;4;22205604;927;267;1660;1662;7.18;0.44;180.62;3.65;733;4;542.00;2
930;4;22205616;930;263;1661;1662;7.20;0.44;180.62;3.65;731;4;543.00;1
933;4;22205625;933;260;1662;1662;7.31;0.45;181.21;3.65;729;4;544.00;0
936;4;22205644;936;261;1662;1662;7.43;0.46;181.44;3.65;726;4;545.00;0
936;4;22205655;936;261;1663;1663;7.50;0.46;181.44;3.65;727;4;546.00;0
939;4;22205667;939;251;1663;1663;7.50;0.46;181.57;3.65;724;4;547.00;0
944;4;22205678;944;254;1669;1669;7.49;0.46;182.07;3.64;725;4;548.00;0
945;4;22205689;945;255;1670;1670;7.48;0.46;182.00;3.64;725;4;549.00;0
948;4;22205700;948;257;1670;1670;7.41;0.45;182.40;3.64;722;4;550.00;0
950;4;22205712;950;257;1670;1670;7.40;0.45;182.53;3.64;720;4;551.00;0
951;4;22205721;951;256;1674;1674;7.36;0.45;182.69;3.63;723;4;552.00;0
954;4;22205733;954;260;1674;1674;7.33;0.45;183.20;3.63;720;4;553.00;0
956;4;22205744;956;262;1674;1674;7.33;0.45;183.60;3.63;718;4;554.00;0
959;4;22205755;959;266;1675;1675;7.25;0.44;183.82;3.63;716;4;555.00;0
963;4;22205768;963;264;1679;1679;7.27;0.44;184.29;3.62;716;4;556.00;0
965;4;22205781;965;258;1679;1679;7.28;0.44;184.68;3.62;714;4;557.00;0
969;4;22205791;969;261;1681;1682;7.35;0.45;184.85;3.62;712;4;558.00;1
971;4;22205805;971;265;1681;1682;7.34;0.45;184.58;3.62;710;4;559.00;1
974;4;22205818;974;264;1682;1682;7.32;0.45;184.79;3.62;708;4;560.00;0
977;4;22205832;977;265;1682;1682;7.27;0.44;184.91;3.62;705;4;561.00;0
983;4;22205844;983;261;1686;1686;7.28;0.44;185.54;3.61;703;4;562.00;0
984;4;22205859;984;261;1686;1686;7.31;0.44;185.37;3.61;702;4;563.00;0
987;4;22205873;987;259;1686;1686;7.27;0.44;185.41;3.61;699;4;564.00;0
987;4;22205886;987;257;1686;1686;7.24;0.44;185.41;3.61;699;4;565.00;0
989;4;22205899;989;253;1687;1687;7.21;0.44;185.45;3.61;698;4;566.00;0
991;4;22205912;991;258;1688;1688;7.15;0.44;185.74;3.61;697;4;567.00;0
991;4;22205925;991;261;1688;1688;7.15;0.44;185.74;3.61;697;4;568.00;0
994;4;22205939;994;260;1689;1689;7.13;0.43;186.00;3.61;695;4;569.00;0
995;4;22205954;995;259;1689;1689;7.02;0.43;186.11;3.61;694;4;570.00;0
995;4;22205968;995;269;1689;1689;6.98;0.43;186.11;3.61;694;4;571.00;0
998;4;22205982;998;262;1689;1689;6.97;0.43;186.25;3.61;691;4;572.00;0
1000;4;22205996;1000;256;1689;1689;6.99;0.43;186.45;3.61;689;4;573.00;0
1002;4;22206008;1002;253;1689;1689;7.06;0.43;186.50;3.61;687;4;574.00;0
1004;4;22206022;1004;239;1689;1689;7.18;0.44;186.80;3.61;685;4;575.00;0
1006;4;22206037;1006;258;1769;1816;7.52;0.47;186.94;3.44;763;4;576.00;47
1008;4;22206066;1008;246;1775;1817;7.70;0.48;187.05;3.44;767;4;577.00;42
1013;4;22206081;1013;239;1781;1817;7.80;0.48;187.38;3.43;768;4;578.00;36
1014;4;22206096;1014;235;1784;1817;7.91;0.49;187.49;3.43;770;4;579.00;33
1017;4;22206108;1017;227;1790;1817;7.99;0.49;187.53;3.43;773;4;580.00;27
1018;4;22206124;1018;210;1792;1817;8.05;0.50;187.87;3.43;774;4;581.00;25
1020;4;22206140;1020;199;1795;1817;8.08;0.50;188.23;3.44;775;4;582.00;22
1022;4;22206155;1022;203;1797;1817;8.04;0.49;188.26;3.44;775;4;583.00;20
1025;4;22206170;1025;201;1800;1818;7.96;0.49;188.45;3.45;775;4;584.00;18
1027;5;22206190;1027;207;1805;1820;7.94;0.49;188.51;3.46;778;5;585.00;15
1030;5;22206220;1030;207;1808;1820;7.89;0.48;188.92;3.47;778;5;586.00;12
1032;5;22206234;1032;210;1810;1821;7.85;0.48;189.25;3.47;778;5;587.00;11
1034;5;22206248;1034;217;1814;1821;7.87;0.48;189.47;3.49;780;5;588.00;7
1038;5;22206260;1038;225;1815;1821;7.95;0.49;190.03;3.49;777;5;589.00;6
1039;5;22206273;1039;232;1816;1821;8.03;0.49;190.28;3.50;777;5;590.00;5
1040;5;22206285;1040;235;1821;1825;8.12;0.50;190.46;3.50;781;5;591.00;4
1043;5;22206299;1043;229;1821;1825;8.13;0.50;190.96;3.50;778;5;592.00;4
1047;5;22206312;1047;228;1821;1825;8.14;0.50;191.53;3.50;774;5;593.00;4
1050;5;22206323;1050;226;1823;1828;8.16;0.50;191.66;3.50;773;5;594.00;5
1054;5;22206337;1054;223;1825;1828;8.14;0.50;191.82;3.51;771;5;595.00;3
1055;5;22206351;1055;217;1827;1828;8.19;0.50;191.87;3.53;772;5;596.00;1
1058;5;22206364;1058;215;1831;1832;8.21;0.50;191.82;3.52;773;5;597.00;1
1059;5;22206378;1059;214;1833;1833;8.31;0.51;191.79;3.52;774;5;598.00;0
1061;5;22206390;1061;205;1833;1833;8.35;0.51;192.18;3.52;772;5;599.00;0
1063;5;22206406;1063;206;1844;1859;8.38;0.51;192.29;3.50;781;5;600.00;15
1066;5;22206429;1066;201;1845;1859;8.42;0.51;192.54;3.50;779;5;601.00;14
1069;5;22206440;1069;202;1845;1859;8.47;0.52;193.35;3.50;776;5;602.00;14
1071;5;22206455;1071;205;1847;1860;8.58;0.52;193.63;3.50;776;5;603.00;13
1073;5;22206468;1073;207;1848;1860;8.65;0.53;193.77;3.50;775;5;604.00;12
1075;5;22206480;1075;209;1855;1866;8.69;0.53;193.98;3.49;780;5;605.00;11
1077;5;22206493;1077;210;1855;1866;8.70;0.53;194.35;3.49;778;5;606.00;11
1080;5;22206505;1080;210;1856;1867;8.74;0.53;194.48;3.49;776;5;607.00;11
1083;5;22206519;1083;210;1857;1867;8.80;0.54;194.86;3.49;774;5;608.00;10
1086;5;22206532;1086;213;1858;1867;8.81;0.54;195.22;3.49;772;5;609.00;9
1093;5;22206545;1093;213;1858;1867;8.87;0.54;195.84;3.49;765;5;610.00;9
1097;5;22206557;1097;215;1859;1867;8.91;0.54;196.41;3.50;762;5;611.00;8
1099;5;22206569;1099;220;1868;1879;8.94;0.54;196.68;3.48;769;5;612.00;11
1100;5;22206582;1100;216;1868;1879;9.00;0.55;196.67;3.48;768;5;613.00;11
1102;5;22206595;1102;222;1868;1879;9.03;0.55;196.74;3.48;766;5;614.00;11
1104;5;22206616;1104;222;1870;1879;9.10;0.55;196.84;3.49;766;5;615.00;9
1106;5;22206629;1106;217;1870;1879;9.23;0.56;196.96;3.49;764;5;616.00;9
1106;5;22206640;1106;215;1871;1879;9.34;0.57;196.96;3.49;765;5;617.00;8
1106;5;22206653;1106;212;1874;1883;9.46;0.57;196.96;3.49;768;5;618.00;9
1109;5;22206666;1109;211;1874;1883;9.60;0.58;196.92;3.49;765;5;619.00;9
1110;5;22206679;1110;205;1878;1887;9.70;0.59;197.12;3.48;768;5;620.00;9
1112;5;22206700;1112;199;1879;1888;9.74;0.59;197.18;3.48;767;5;621.00;9
1114;5;22206714;1114;193;1879;1888;9.76;0.59;197.53;3.48;765;5;622.00;9
1115;5;22206728;1115;192;1880;1888;9.75;0.59;197.76;3.49;765;5;623.00;8
1120;5;22206741;1120;195;1890;1901;9.64;0.58;198.25;3.47;770;5;624.00;11
1121;5;22206756;1121;188;1890;1901;9.64;0.58;198.47;3.47;769;5;625.00;11
1126;5;22206770;1126;192;1890;1901;9.57;0.58;199.18;3.47;764;5;626.00;11
1127;5;22206784;1127;190;1891;1902;9.57;0.58;199.24;3.47;764;5;627.00;11
1131;5;22206798;1131;190;1891;1903;9.52;0.58;199.41;3.47;760;5;628.00;12
1137;5;22206811;1137;192;1893;1903;9.39;0.57;200.23;3.49;756;5;629.00;10
1140;5;22206824;1140;188;1899;1909;9.35;0.57;200.79;3.50;759;5;630.00;10
1141;5;22206838;1141;188;1901;1909;9.39;0.57;200.97;3.50;760;5;631.00;8
1146;5;22206851;1146;182;1902;1909;9.44;0.57;201.36;3.50;756;5;632.00;7
1150;5;22206864;1150;177;1902;1909;9.53;0.58;201.81;3.50;752;5;633.00;7
1153;5;22206879;1153;173;1907;1915;9.58;0.58;201.91;3.49;754;5;634.00;8
1155;5;22206890;1155;164;1907;1915;9.57;0.58;202.03;3.49;752;5;635.00;8
1155;5;22206903;1155;165;1907;1915;9.61;0.58;202.03;3.49;752;5;636.00;8
1158;5;22206916;1158;162;1907;1915;9.65;0.59;202.50;3.49;749;5;637.00;8
1160;5;22206929;1160;161;1910;1919;9.68;0.59;202.35;3.49;750;5;638.00;9
1162;5;22206939;1162;158;1911;1920;9.75;0.59;202.60;3.49;749;5;639.00;9
1164;5;22206952;1164;159;1911;1920;9.79;0.59;202.55;3.49;747;5;640.00;9
1169;5;22206965;1169;163;1912;1921;9.84;0.60;202.59;3.48;743;5;641.00;9
1171;5;22206978;1171;158;1912;1921;9.87;0.60;202.65;3.48;741;5;642.00;9
1172;5;22206988;1172;156;1912;1921;9.85;0.60;202.91;3.48;740;5;643.00;9
1173;5;22207000;1173;154;1912;1921;9.81;0.59;203.15;3.48;739;5;644.00;9
1175;5;22207012;1175;157;1912;1921;9.74;0.59;203.50;3.48;737;5;645.00;9
1177;5;22207022;1177;164;1912;1921;9.72;0.59;203.76;3.48;735;5;646.00;9
1180;5;22207035;1180;165;1913;1921;9.69;0.59;204.27;3.51;733;5;647.00;8
1182;5;22207047;1182;167;1947;1991;9.63;0.59;204.33;3.45;765;5;648.00;44
1186;5;22207065;1186;166;1948;1992;9.53;0.58;204.48;3.44;762;5;649.00;44
1191;5;22207077;1191;163;1954;1992;9.48;0.57;204.73;3.44;763;5;650.00;38
1193;5;22207088;1193;168;1955;1992;9.42;0.57;204.83;3.44;762;5;651.00;37
1193;5;22207101;1193;169;1961;1992;9.43;0.57;204.83;3.44;768;5;652.00;31
1195;5;22207119;1195;176;1963;1992;9.43;0.57;204.65;3.47;768;5;653.00;29
1196;5;22207132;1196;183;1966;1992;9.51;0.58;204.58;3.47;770;5;654.00;26
1196;5;22207144;1196;184;1970;1992;9.53;0.58;204.58;3.49;774;5;655.00;22
1198;5;22207155;1198;192;1973;1993;9.47;0.58;204.73;3.51;775;5;656.00;20
1199;5;22207167;1199;195;1977;1994;9.37;0.57;204.56;3.53;778;5;657.00;17
1200;5;22207178;1200;200;1981;1994;9.29;0.57;204.57;3.55;781;5;658.00;13
1202;5;22207189;1202;208;1987;1998;9.19;0.56;204.58;3.58;785;5;659.00;11
1203;5;22207203;1203;211;1991;1998;9.17;0.56;204.50;3.60;788;5;660.00;7
1204;5;22207217;1204;218;1991;1998;9.08;0.56;204.34;3.60;787;5;661.00;7
1206;5;22207229;1206;219;1993;1998;9.03;0.55;204.33;3.61;787;5;662.00;5
1207;5;22207240;1207;232;1998;2004;9.10;0.56;204.36;3.60;791;5;663.00;6
1212;5;22207253;1212;242;2000;2004;9.09;0.56;204.16;3.61;788;5;664.00;4
1215;5;22207266;1215;248;2003;2004;9.06;0.56;204.27;3.65;788;5;665.00;1
1217;6;22207278;1217;250;2005;2007;9.01;0.55;204.26;3.64;788;6;666.00;2
1220;6;22207309;1220;254;2006;2007;8.95;0.55;204.08;3.65;786;6;667.00;1
1221;6;22207321;1221;254;2007;2007;8.85;0.54;204.06;3.65;786;6;668.00;0
1225;6;22207334;1225;255;2008;2008;8.67;0.53;203.86;3.65;783;6;669.00;0
1229;6;22207348;1229;259;2009;2009;8.51;0.52;203.67;3.65;780;6;670.00;0
1231;6;22207358;1231;266;2009;2009;8.36;0.51;203.64;3.65;778;6;671.00;0
1232;6;22207370;1232;273;2021;2022;8.25;0.51;203.67;3.63;789;6;672.00;1
1232;6;22207384;1232;280;2022;2022;8.17;0.50;203.67;3.62;790;6;673.00;0
1233;6;22207396;1233;285;2022;2022;8.03;0.49;203.61;3.62;789;6;674.00;0
1234;6;22207408;1234;281;2024;2024;7.85;0.48;203.57;3.62;790;6;675.00;0
1238;6;22207425;1238;280;2024;2024;7.77;0.48;203.35;3.62;786;6;676.00;0
1242;6;22207439;1242;279;2028;2028;7.75;0.48;203.06;3.62;786;6;677.00;0
1246;6;22207454;1246;279;2028;2028;7.66;0.47;202.98;3.62;782;6;678.00;0
1248;6;22207470;1248;284;2032;2032;7.59;0.47;202.77;3.61;784;6;679.00;0
1249;6;22207486;1249;289;2032;2032;7.58;0.47;202.63;3.61;783;6;680.00;0
1252;6;22207499;1252;292;2032;2032;7.57;0.46;202.58;3.61;780;6;681.00;0
1256;6;22207512;1256;293;2032;2032;7.56;0.46;202.41;3.61;776;6;682.00;0
1257;6;22207527;1257;298;2032;2032;7.62;0.47;202.35;3.61;775;6;683.00;0
1262;6;22207542;1262;298;2043;2044;7.63;0.47;202.30;3.59;781;6;684.00;1
1264;6;22207557;1264;305;2043;2044;7.59;0.46;202.46;3.59;779;6;685.00;1
1265;6;22207571;1265;309;2044;2044;7.59;0.46;202.45;3.59;779;6;686.00;0
1268;6;22207585;1268;307;2044;2044;7.53;0.46;202.82;3.59;776;6;687.00;0
1270;6;22207598;1270;309;2044;2044;7.54;0.46;202.76;3.59;774;6;688.00;0
1273;6;22207610;1273;314;2044;2044;7.45;0.45;203.16;3.59;771;6;689.00;0
1275;6;22207624;1275;316;2045;2045;7.37;0.45;203.09;3.59;770;6;690.00;0
1279;6;22207636;1279;319;2045;2045;7.20;0.44;203.53;3.59;766;6;691.00;0
1280;6;22207647;1280;320;2051;2051;7.16;0.43;203.56;3.58;771;6;692.00;0
1283;6;22207656;1283;330;2052;2052;6.97;0.42;203.80;3.58;769;6;693.00;0
1286;6;22207667;1286;333;2052;2052;6.78;0.41;203.91;3.58;766;6;694.00;0
1288;6;22207675;1288;320;2052;2052;6.66;0.41;203.83;3.58;764;6;695.00;0
1293;6;22207686;1293;311;2056;2056;6.58;0.40;203.58;3.57;763;6;696.00;0
1294;6;22207697;1294;308;2056;2056;6.48;0.39;203.66;3.57;762;6;697.00;0
1295;6;22207708;1295;302;2056;2056;6.37;0.39;203.82;3.57;761;6;698.00;0
1297;6;22207720;1297;303;2057;2057;6.31;0.39;203.92;3.57;760;6;699.00;0
1299;6;22207732;1299;289;2061;2061;6.32;0.39;203.99;3.57;762;6;700.00;0
1302;6;22207748;1302;284;2061;2061;6.30;0.39;204.06;3.57;759;6;701.00;0
1306;6;22207765;1306;283;2063;2064;6.39;0.39;204.35;3.56;757;6;702.00;1
1308;6;22207774;1308;275;2063;2064;6.46;0.40;204.75;3.56;755;6;703.00;1
1309;6;22207786;1309;275;2064;2064;6.63;0.41;204.63;3.56;755;6;704.00;0
1313;6;22207803;1313;269;2064;2064;6.70;0.41;204.98;3.56;751;6;705.00;0
1313;6;22207814;1313;268;2068;2068;6.84;0.42;204.98;3.56;755;6;706.00;0
1316;6;22207823;1316;259;2068;2068;6.95;0.43;205.03;3.56;752;6;707.00;0
1318;6;22207841;1318;251;2068;2068;7.02;0.43;205.41;3.56;750;6;708.00;0
1318;6;22207853;1318;245;2068;2068;7.11;0.44;205.41;3.56;750;6;709.00;0
1322;6;22207864;1322;246;2069;2069;7.09;0.43;205.63;3.56;747;6;710.00;0
1323;6;22207874;1323;243;2070;2070;7.13;0.44;205.79;3.55;747;6;711.00;0
1324;6;22207886;1324;238;2070;2070;7.19;0.44;205.81;3.55;746;6;712.00;0
1328;6;22207898;1328;237;2071;2071;7.26;0.44;206.18;3.55;743;6;713.00;0
1331;6;22207908;1331;233;2071;2071;7.38;0.45;206.18;3.55;740;6;714.00;0
1332;6;22207923;1332;233;2071;2071;7.48;0.46;206.17;3.55;739;6;715.00;0
1336;6;22207938;1336;229;2071;2071;7.55;0.46;206.18;3.55;735;6;716.00;0
1341;6;22207951;1341;226;2071;2071;7.58;0.46;206.32;3.55;730;6;717.00;0
1342;6;22207967;1342;225;2071;2071;7.63;0.47;206.44;3.55;729;6;718.00;0
1346;6;22207982;1346;223;2071;2071;7.62;0.47;206.26;3.55;725;6;719.00;0
1349;6;22207998;1349;228;2170;2301;8.07;0.51;206.65;3.39;821;6;720.00;131
1352;6;22208036;1352;230;2180;2302;8.07;0.51;206.78;3.38;828;6;721.00;122
1357;6;22208052;1357;226;2195;2302;8.13;0.51;207.09;3.37;838;6;722.00;107
1360;6;22208068;1360;230;2208;2302;8.11;0.51;207.49;3.37;848;6;723.00;94
1365;6;22208084;1365;223;2219;2302;8.02;0.50;207.19;3.37;854;6;724.00;83
1372;6;22208099;1372;234;2226;2302;7.97;0.50;207.38;3.38;854;6;725.00;76
1374;6;22208116;1374;233;2235;2302;7.90;0.49;207.58;3.39;861;6;726.00;67
1379;6;22208133;1379;231;2244;2302;7.78;0.48;207.83;3.40;865;6;727.00;58
1382;6;22208149;1382;232;2255;2303;7.73;0.48;208.11;3.43;873;6;728.00;48
1387;6;22208165;1387;235;2262;2304;7.57;0.47;208.58;3.44;875;6;729.00;42
1390;6;22208180;1390;238;2267;2304;7.51;0.47;208.92;3.46;877;6;730.00;37
1393;6;22208194;1393;233;2270;2305;7.48;0.46;208.98;3.46;877;6;731.00;35
1396;6;22208207;1396;235;2273;2305;7.43;0.46;208.90;3.47;877;6;732.00;32
1399;6;22208229;1399;241;2275;2305;7.45;0.46;208.97;3.48;876;6;733.00;30
1400;6;22208243;1400;241;2276;2305;7.48;0.46;209.00;3.49;876;6;734.00;29
1406;6;22208256;1406;248;2280;2309;7.44;0.46;209.74;3.49;874;6;735.00;29
1413;6;22208270;1413;249;2281;2309;7.44;0.46;209.89;3.50;868;6;736.00;28
1415;6;22208285;1415;256;2283;2309;7.43;0.46;209.98;3.51;868;6;737.00;26
1420;6;22208298;1420;264;2285;2312;7.39;0.45;210.70;3.52;865;6;738.00;27
1425;6;22208312;1425;271;2287;2312;7.35;0.45;211.04;3.53;862;6;739.00;25
1428;6;22208325;1428;276;2290;2312;7.31;0.45;210.86;3.54;862;6;740.00;22
1432;6;22208338;1432;279;2295;2316;7.29;0.45;211.07;3.55;863;6;741.00;21
1433;6;22208353;1433;280;2296;2317;7.23;0.44;211.06;3.54;863;6;742.00;21
1435;6;22208367;1435;285;2298;2317;7.18;0.44;211.23;3.56;863;6;743.00;19
1436;6;22208392;1436;283;2302;2321;7.19;0.44;211.30;3.56;866;6;744.00;19
1438;6;22208407;1438;291;2302;2321;7.21;0.44;211.37;3.56;864;6;745.00;19
1439;6;22208421;1439;289;2305;2321;7.18;0.44;211.39;3.58;866;6;746.00;16
1439;6;22208439;1439;283;2306;2322;7.18;0.44;211.39;3.58;867;6;747.00;16
1442;6;22208473;1442;275;2306;2322;7.18;0.44;211.54;3.58;864;6;748.00;16
1445;6;22208497;1445;272;2312;2328;7.19;0.44;211.46;3.59;867;6;749.00;16
1446;6;22208518;1446;265;2313;2328;7.33;0.45;211.43;3.59;867;6;750.00;15
1451;6;22208536;1451;266;2315;2329;7.43;0.45;211.79;3.60;864;6;751.00;14
1452;6;22208553;1452;269;2315;2329;7.53;0.46;211.72;3.60;863;6;752.00;14
1455;6;22208570;1455;264;2316;2329;7.57;0.46;211.75;3.61;861;6;753.00;13
1457;6;22208588;1457;267;2317;2329;7.62;0.47;211.68;3.62;860;6;754.00;12
1458;6;22208605;1458;273;2318;2329;7.59;0.46;211.72;3.64;860;6;755.00;11
1458;6;22208629;1458;257;2329;2341;7.68;0.47;211.72;3.63;871;6;756.00;12
1461;6;22208652;1461;254;2330;2341;7.71;0.47;211.96;3.64;869;6;757.00;11
1463;6;22208671;1463;248;2331;2341;7.80;0.48;212.25;3.65;868;6;758.00;10
1466;6;22208688;1466;245;2332;2341;7.89;0.48;212.50;3.66;866;6;759.00;9
1467;6;22208702;1467;240;2334;2341;7.94;0.48;212.46;3.67;867;6;760.00;7
1468;6;22208718;1468;243;2334;2341;8.02;0.49;212.50;3.67;866;6;761.00;7
1468;6;22208733;1468;243;2339;2345;8.03;0.49;212.50;3.67;871;6;762.00;6
1471;6;22208748;1471;241;2339;2345;8.04;0.49;212.71;3.67;868;6;763.00;6
1473;6;22208762;1473;246;2343;2349;8.14;0.50;212.88;3.66;870;6;764.00;6
1475;6;22208777;1475;243;2345;2351;8.19;0.50;213.09;3.66;870;6;765.00;6
1476;6;22208792;1476;247;2345;2351;8.23;0.50;213.07;3.66;869;6;766.00;6
1477;6;22208807;1477;247;2345;2351;8.28;0.51;213.10;3.66;868;6;767.00;6
1481;6;22208821;1481;244;2357;2364;8.38;0.51;213.21;3.66;876;6;768.00;7
1486;6;22208837;1486;232;2357;2364;8.39;0.51;213.56;3.66;871;6;769.00;7
1489;6;22208851;1489;230;2357;2364;8.43;0.52;213.61;3.66;868;6;770.00;7
1490;6;22208866;1490;229;2358;2365;8.51;0.52;213.78;3.66;868;6;771.00;7
1495;6;22208880;1495;227;2359;2366;8.45;0.52;214.39;3.66;864;6;772.00;7
1499;6;22208895;1499;229;2359;2366;8.45;0.51;214.67;3.66;860;6;773.00;7
1499;6;22208908;1499;231;2361;2369;8.45;0.51;214.67;3.66;862;6;774.00;8
1503;6;22208924;1503;229;2361;2369;8.45;0.51;214.82;3.66;858;6;775.00;8
1504;6;22208942;1504;222;2362;2369;8.45;0.52;214.99;3.66;858;6;776.00;7
1505;6;22208958;1505;224;2362;2369;8.53;0.52;214.96;3.66;857;6;777.00;7
1508;6;22208975;1508;227;2367;2375;8.58;0.52;215.29;3.65;859;6;778.00;8
1513;6;22209004;1513;227;2367;2375;8.57;0.52;215.06;3.65;854;6;779.00;8
1515;6;22209022;1515;229;2367;2375;8.57;0.52;215.04;3.65;852;6;780.00;8
1518;6;22209040;1518;231;2367;2375;8.58;0.52;215.16;3.65;849;6;781.00;8
1521;6;22209059;1521;239;2371;2379;8.51;0.52;215.29;3.65;850;6;782.00;8
1522;6;22209084;1522;243;2372;2380;8.55;0.52;215.29;3.64;850;6;783.00;8
1523;6;22209100;1523;246;2372;2380;8.56;0.52;215.38;3.64;849;6;784.00;8
1526;6;22209118;1526;250;2373;2381;8.62;0.52;215.45;3.64;847;6;785.00;8
1527;6;22209135;1527;253;2373;2381;8.59;0.52;215.45;3.64;846;6;786.00;8
1531;6;22209151;1531;257;2373;2381;8.59;0.52;215.47;3.64;842;6;787.00;8
1533;6;22209167;1533;260;2373;2381;8.59;0.52;215.55;3.64;840;6;788.00;8
1536;6;22209184;1536;262;2373;2381;8.55;0.52;215.97;3.64;837;6;789.00;8
1537;6;22209200;1537;261;2373;2381;8.40;0.51;216.06;3.64;836;6;790.00;8
1539;6;22209217;1539;258;2373;2381;8.24;0.50;215.95;3.64;834;6;791.00;8
1541;6;22209233;1541;263;2404;2451;8.05;0.49;216.33;3.60;863;6;792.00;47
1542;6;22209255;1542;260;2405;2452;7.95;0.49;216.46;3.59;863;6;793.00;47
1544;6;22209271;1544;254;2409;2452;7.98;0.49;216.62;3.59;865;6;794.00;43
1546;6;22209287;1546;256;2410;2452;7.91;0.48;216.69;3.59;864;6;795.00;42
1550;6;22209302;1550;248;2414;2452;7.88;0.48;216.58;3.59;864;6;796.00;38
1550;6;22209319;1550;249;2417;2452;7.89;0.48;216.58;3.59;867;6;797.00;35
1552;6;22209334;1552;249;2419;2452;7.91;0.48;216.66;3.60;867;6;798.00;33
1555;6;22209349;1555;257;2421;2452;7.84;0.48;216.72;3.60;866;6;799.00;31
1558;6;22209366;1558;252;2424;2453;7.89;0.48;216.86;3.60;866;6;800.00;29
1560;6;22209388;1560;246;2426;2454;7.93;0.48;217.19;3.61;866;6;801.00;28
1565;6;22209404;1565;248;2427;2454;7.88;0.48;217.37;3.61;862;6;802.00;27
1569;6;22209420;1569;252;2431;2458;7.81;0.48;217.46;3.61;862;6;803.00;27
1572;6;22209435;1572;255;2432;2458;7.78;0.48;217.80;3.61;860;6;804.00;26
1575;6;22209449;1575;247;2435;2458;7.73;0.47;218.13;3.63;860;6;805.00;23
1578;6;22209461;1578;248;2436;2458;7.69;0.47;218.55;3.63;858;6;806.00;22
1581;6;22209480;1581;242;2440;2464;7.67;0.47;218.48;3.63;859;6;807.00;24
1585;6;22209497;1585;248;2441;2464;7.60;0.46;218.84;3.63;856;6;808.00;23
1586;6;22209513;1586;245;2441;2464;7.56;0.46;219.00;3.63;855;6;809.00;23
1589;6;22209530;1589;247;2445;2470;7.59;0.46;219.08;3.62;856;6;810.00;25
1590;6;22209549;1590;249;2448;2470;7.59;0.46;219.27;3.64;858;6;811.00;22
1592;6;22209566;1592;250;2449;2470;7.60;0.46;219.37;3.64;857;6;812.00;21
1596;6;22209579;1596;255;2449;2471;7.56;0.46;219.44;3.64;853;6;813.00;22
1598;6;22209593;1598;252;2450;2472;7.53;0.46;219.30;3.63;852;6;814.00;22
1601;6;22209607;1601;252;2450;2472;7.51;0.46;219.29;3.63;849;6;815.00;22
1603;6;22209623;1603;251;2458;2485;7.52;0.46;219.15;3.62;855;6;816.00;27
1605;6;22209653;1605;252;2459;2485;7.55;0.46;219.04;3.62;854;6;817.00;26
1608;6;22209670;1608;251;2459;2485;7.64;0.46;219.01;3.62;851;6;818.00;26
1610;6;22209687;1610;249;2460;2486;7.71;0.47;218.95;3.62;850;6;819.00;26
1610;6;22209703;1610;249;2460;2486;7.76;0.47;218.95;3.62;850;6;820.00;26
1611;6;22209721;1611;250;2463;2490;7.85;0.48;218.97;3.62;852;6;821.00;27
1612;6;22209740;1612;251;2463;2490;7.87;0.48;219.10;3.62;851;6;822.00;27
1613;6;22209756;1613;252;2467;2494;7.84;0.48;219.33;3.65;854;6;823.00;27
1616;6;22209778;1616;251;2467;2494;7.79;0.48;219.11;3.65;851;6;824.00;27
1619;6;22209796;1619;254;2467;2494;7.70;0.47;219.19;3.65;848;6;825.00;27
1619;6;22209813;1619;252;2470;2494;7.66;0.47;219.19;3.72;851;6;826.00;24
1623;6;22209827;1623;257;2470;2494;7.62;0.46;219.27;3.72;847;6;827.00;24
1626;6;22209841;1626;268;2480;2506;7.62;0.46;219.19;3.75;854;6;828.00;26
1630;6;22209857;1630;279;2484;2506;7.62;0.46;219.26;3.79;854;6;829.00;22
1631;6;22209870;1631;280;2487;2506;7.56;0.46;219.19;3.84;856;6;830.00;19
1636;6;22209884;1636;285;2487;2506;7.50;0.46;219.13;3.84;851;6;831.00;19
1641;6;22209897;1641;291;2491;2506;7.42;0.45;218.68;3.92;850;6;832.00;15
1642;6;22209908;1642;296;2492;2506;7.33;0.45;218.62;3.94;850;6;833.00;14
1646;6;22209929;1646;305;2494;2507;7.29;0.45;218.28;3.97;848;6;834.00;13
1647;6;22209940;1647;307;2497;2507;7.23;0.44;218.21;4.02;850;6;835.00;10
1649;6;22209953;1649;309;2503;2513;7.24;0.44;218.39;4.01;854;6;836.00;10
1651;6;22209967;1651;308;2506;2514;7.19;0.44;218.39;4.03;855;6;837.00;8
1656;6;22209978;1656;321;2506;2514;7.15;0.44;218.10;4.03;850;6;838.00;8
1656;6;22209989;1656;323;2507;2514;7.11;0.44;218.10;4.05;851;6;839.00;7
1657;6;22210004;1657;324;2512;2519;7.13;0.44;218.05;4.06;855;6;840.00;7
1657;6;22210016;1657;332;2512;2519;7.12;0.44;218.05;4.06;855;6;841.00;7
1660;6;22210028;1660;337;2514;2519;7.10;0.44;218.06;4.07;854;6;842.00;5
1662;6;22210039;1662;341;2516;2520;7.03;0.43;218.04;4.08;854;6;843.00;4
1662;6;22210052;1662;341;2520;2524;7.01;0.43;218.04;4.08;858;6;844.00;4
1664;6;22210065;1664;339;2523;2524;7.01;0.43;217.96;4.09;859;6;845.00;1
1667;6;22210077;1667;341;2526;2527;6.96;0.43;217.99;4.08;859;6;846.00;1
1669;6;22210089;1669;341;2526;2527;6.90;0.42;217.96;4.08;857;6;847.00;1
1671;6;22210102;1671;341;2527;2527;6.91;0.42;217.90;4.08;856;6;848.00;0
1672;6;22210115;1672;336;2527;2527;6.82;0.42;217.85;4.08;855;6;849.00;0
1672;6;22210125;1672;337;2531;2531;6.87;0.42;217.85;4.08;859;6;850.00;0
1675;6;22210139;1675;337;2531;2531;6.86;0.42;218.15;4.08;856;6;851.00;0
1678;6;22210152;1678;320;2531;2531;6.85;0.42;218.31;4.08;853;6;852.00;0
1680;6;22210166;1680;303;2531;2531;6.83;0.42;218.14;4.08;851;6;853.00;0
1682;6;22210182;1682;297;2532;2532;6.82;0.42;218.14;4.08;850;6;854.00;0
1682;6;22210197;1682;290;2534;2534;6.86;0.42;218.14;4.07;852;6;855.00;0
1682;6;22210212;1682;284;2534;2534;6.93;0.42;218.14;4.07;852;6;856.00;0
1684;6;22210228;1684;277;2535;2535;6.97;0.43;218.12;4.07;851;6;857.00;0
1685;6;22210244;1685;279;2535;2535;7.07;0.43;218.12;4.07;850;6;858.00;0
1686;6;22210272;1686;277;2535;2535;7.26;0.44;218.08;4.07;849;6;859.00;0
1687;6;22210288;1687;279;2535;2535;7.38;0.45;218.06;4.07;848;6;860.00;0
1689;6;22210302;1689;276;2535;2535;7.48;0.46;218.09;4.07;846;6;861.00;0
1691;6;22210318;1691;277;2535;2535;7.51;0.46;218.18;4.07;844;6;862.00;0
1693;6;22210342;1693;280;2535;2535;7.61;0.46;218.09;4.07;842;6;863.00;0
1697;6;22210356;1697;293;2608;2662;7.88;0.49;218.09;3.96;911;6;864.00;54
1699;6;22210383;1699;287;2613;2663;7.85;0.49;218.14;3.95;914;6;865.00;50
1704;6;22210398;1704;281;2622;2663;7.88;0.49;218.10;3.95;918;6;866.00;41
1705;6;22210410;1705;279;2624;2663;7.80;0.48;218.06;3.95;919;6;867.00;39
1708;6;22210422;1708;282;2630;2663;7.70;0.48;218.11;3.95;922;6;868.00;33
1711;6;22210435;1711;278;2632;2663;7.61;0.47;217.91;3.95;921;6;869.00;31
1713;6;22210450;1713;280;2634;2663;7.52;0.47;217.87;3.95;921;6;870.00;29
1716;6;22210463;1716;277;2635;2663;7.43;0.46;218.00;3.95;919;6;871.00;28
1717;6;22210475;1717;276;2636;2664;7.43;0.46;217.96;3.95;919;6;872.00;28
1721;6;22210496;1721;275;2639;2665;7.32;0.45;218.40;3.96;918;6;873.00;26
1728;6;22210509;1728;276;2640;2665;7.16;0.44;218.66;3.96;912;6;874.00;25
1732;6;22210522;1732;274;2643;2666;7.08;0.44;219.00;3.96;911;6;875.00;23
1736;6;22210536;1736;276;2645;2666;7.03;0.43;219.17;3.97;909;6;876.00;21
1741;6;22210549;1741;278;2647;2666;6.96;0.43;219.33;3.98;906;6;877.00;19
1745;6;22210563;1745;277;2648;2666;6.86;0.42;219.55;3.98;903;6;878.00;18
1748;6;22210576;1748;274;2653;2670;6.90;0.43;219.64;3.99;905;6;879.00;17
1752;6;22210591;1752;280;2655;2670;6.91;0.43;219.99;4.00;903;6;880.00;15
1754;6;22210605;1754;281;2658;2670;6.92;0.43;220.27;4.01;904;6;881.00;12
1756;6;22210619;1756;270;2660;2673;7.00;0.43;220.46;4.02;904;6;882.00;13
1761;6;22210635;1761;266;2664;2673;7.04;0.43;220.82;4.04;903;6;883.00;9
1762;6;22210650;1762;258;2665;2673;7.12;0.44;220.91;4.04;903;6;884.00;8
1766;6;22210664;1766;252;2671;2677;7.19;0.44;221.34;4.05;905;6;885.00;6
1773;6;22210680;1773;256;2672;2678;7.17;0.44;221.47;4.05;899;6;886.00;6
1775;6;22210697;1775;252;2676;2678;7.23;0.44;221.73;4.06;901;6;887.00;2
1780;6;22210714;1780;244;2679;2682;7.25;0.44;222.02;4.06;899;6;888.00;3
1781;6;22210740;1781;242;2680;2682;7.36;0.45;222.04;4.06;899;6;889.00;2
1786;6;22210756;1786;243;2682;2682;7.41;0.45;222.38;4.06;896;6;890.00;0
1792;6;22210773;1792;243;2683;2683;7.45;0.45;222.82;4.06;891;6;891.00;0
1795;6;22210791;1795;241;2683;2683;7.49;0.46;222.81;4.06;888;6;892.00;0
1798;6;22210807;1798;245;2689;2689;7.55;0.46;223.15;4.05;891;6;893.00;0
1801;6;22210826;1801;244;2689;2689;7.65;0.47;223.61;4.05;888;6;894.00;0
1806;6;22210844;1806;248;2690;2690;7.69;0.47;224.19;4.05;884;6;895.00;0
1812;6;22210871;1812;245;2690;2690;7.76;0.48;224.70;4.05;878;6;896.00;0
1816;6;22210888;1816;243;2690;2690;7.80;0.48;224.99;4.05;874;6;897.00;0
1820;6;22210903;1820;243;2690;2690;7.84;0.48;225.09;4.05;870;6;898.00;0
1826;6;22210919;1826;240;2690;2690;7.86;0.48;225.52;4.05;864;6;899.00;0
1833;6;22210937;1833;241;2719;2736;7.91;0.48;225.77;4.01;886;6;900.00;17
1835;6;22210962;1835;237;2721;2736;7.95;0.49;226.02;4.01;886;6;901.00;15
1843;6;22210977;1843;235;2726;2736;7.96;0.49;226.38;4.00;883;6;902.00;10
1847;6;22210992;1847;237;2726;2736;8.01;0.49;226.56;4.00;879;6;903.00;10
1853;6;22211006;1853;240;2728;2736;8.03;0.49;227.02;4.00;875;6;904.00;8
1856;6;22211021;1856;233;2728;2736;8.10;0.49;227.21;4.00;872;6;905.00;8
1861;6;22211035;1861;238;2732;2740;8.11;0.49;227.54;4.00;871;6;906.00;8
1866;6;22211051;1866;237;2733;2740;8.11;0.49;227.88;4.00;867;6;907.00;7
1866;6;22211065;1866;238;2736;2744;8.14;0.50;227.88;4.00;870;6;908.00;8
1872;6;22211079;1872;245;2738;2745;8.02;0.49;228.36;4.00;866;6;909.00;7
1877;6;22211094;1877;252;2738;2745;8.01;0.49;228.35;4.00;861;6;910.00;7
1879;6;22211107;1879;252;2738;2745;8.01;0.49;228.31;4.00;859;6;911.00;7
1885;6;22211122;1885;259;2751;2758;8.03;0.49;228.91;3.98;866;6;912.00;7
1885;6;22211146;1885;258;2752;2758;8.05;0.49;228.91;3.99;867;6;913.00;6
1889;6;22211169;1889;259;2752;2758;8.05;0.49;229.28;3.99;863;6;914.00;6
1892;6;22211183;1892;264;2753;2759;7.97;0.49;229.38;3.99;861;6;915.00;6
1894;6;22211198;1894;265;2754;2760;7.88;0.48;229.59;3.98;860;6;916.00;6
1897;6;22211212;1897;270;2754;2760;7.78;0.48;229.76;3.98;857;6;917.00;6
1901;6;22211224;1901;282;2757;2763;7.65;0.47;229.77;3.99;856;6;918.00;6
1906;6;22211238;1906;285;2758;2763;7.51;0.46;230.08;3.99;852;6;919.00;5
1908;6;22211252;1908;291;2759;2763;7.38;0.45;230.32;3.99;851;6;920.00;4
1914;6;22211267;1914;298;2759;2763;7.25;0.44;230.58;3.99;845;6;921.00;4
1916;6;22211280;1916;291;2764;2769;7.15;0.44;230.67;3.99;848;6;922.00;5
1919;6;22211301;1919;282;2764;2769;7.16;0.44;230.93;3.99;845;6;923.00;5
1921;6;22211315;1921;284;2767;2769;7.14;0.44;231.04;4.00;846;6;924.00;2
1924;6;22211329;1924;278;2767;2769;7.15;0.44;231.19;4.00;843;6;925.00;2
1924;6;22211341;1924;275;2771;2773;7.22;0.44;231.19;4.00;847;6;926.00;2
1927;6;22211355;1927;274;2773;2774;7.25;0.44;231.19;4.00;846;6;927.00;1
1930;6;22211369;1930;276;2774;2774;7.31;0.45;231.20;4.00;844;6;928.00;0
1932;6;22211384;1932;281;2775;2775;7.34;0.45;231.29;4.00;843;6;929.00;0
1938;6;22211400;1938;286;2775;2775;7.34;0.45;231.13;4.00;837;6;930.00;0
1942;6;22211416;1942;272;2775;2775;7.39;0.45;231.31;4.00;833;6;931.00;0
1943;6;22211430;1943;263;2775;2775;7.45;0.45;231.41;4.00;832;6;932.00;0
1946;6;22211443;1946;261;2775;2775;7.54;0.46;231.59;4.00;829;6;933.00;0
1948;6;22211457;1948;261;2775;2775;7.56;0.46;231.70;4.00;827;6;934.00;0
1950;6;22211471;1950;260;2775;2775;7.62;0.46;231.85;4.00;825;6;935.00;0
1952;6;22211486;1952;274;2820;2845;7.65;0.47;231.87;3.94;868;6;936.00;25
1957;6;22211507;1957;271;2822;2846;7.65;0.47;232.19;3.94;865;6;937.00;24
1959;6;22211522;1959;269;2826;2846;7.76;0.47;232.13;3.93;867;6;938.00;20
1963;6;22211536;1963;274;2826;2846;7.77;0.47;232.51;3.93;863;6;939.00;20
1965;6;22211551;1965;269;2830;2846;7.84;0.48;232.61;3.93;865;6;940.00;16
1966;6;22211567;1966;280;2831;2846;7.87;0.48;232.64;3.94;865;6;941.00;15
1969;6;22211582;1969;270;2834;2846;7.87;0.48;232.75;3.94;865;6;942.00;12
1972;6;22211597;1972;274;2837;2846;7.89;0.48;232.75;3.94;865;6;943.00;9
1975;6;22211614;1975;273;2840;2847;7.85;0.48;232.82;3.95;865;6;944.00;7
1977;6;22211632;1977;269;2843;2849;7.85;0.48;232.87;3.95;866;6;945.00;6
1978;6;22211649;1978;268;2846;2849;7.87;0.48;232.94;3.95;868;6;946.00;3
1979;6;22211666;1979;267;2850;2853;7.85;0.48;233.01;3.95;871;6;947.00;3
1981;6;22211683;1981;266;2851;2853;7.88;0.48;233.03;3.95;870;6;948.00;2
1982;6;22211701;1982;266;2851;2853;7.89;0.48;233.00;3.95;869;6;949.00;2
1983;6;22211718;1983;266;2851;2853;7.88;0.48;233.07;3.95;868;6;950.00;2
1984;6;22211735;1984;261;2856;2859;7.98;0.49;233.07;3.95;872;6;951.00;3
1986;6;22211752;1986;260;2856;2859;7.94;0.48;233.06;3.95;870;6;952.00;3
1986;6;22211769;1986;258;2856;2859;7.96;0.48;233.06;3.95;870;6;953.00;3
1989;6;22211787;1989;253;2858;2862;7.97;0.49;233.06;3.94;869;6;954.00;4
1989;6;22211814;1989;254;2858;2862;7.99;0.49;233.06;3.94;869;6;955.00;4
1991;6;22211825;1991;254;2859;2862;7.99;0.49;233.09;3.94;868;6;956.00;3
1994;6;22211841;1994;257;2861;2863;7.95;0.48;233.12;3.95;867;6;957.00;2
1994;6;22211859;1994;261;2862;2864;7.97;0.48;233.12;3.95;868;6;958.00;2
1996;6;22211875;1996;254;2863;2864;7.95;0.48;233.24;3.95;867;6;959.00;1
1998;6;22211894;1998;263;2883;2890;7.94;0.48;233.31;3.92;885;6;960.00;7
1999;6;22211915;1999;271;2884;2890;7.91;0.48;233.32;3.92;885;6;961.00;6
2001;6;22211931;2001;273;2887;2890;7.91;0.48;233.21;3.92;886;6;962.00;3
2002;6;22211947;2002;277;2888;2891;7.91;0.48;233.22;3.92;886;6;963.00;3
2004;6;22211963;2004;283;2888;2891;7.90;0.48;233.26;3.92;884;6;964.00;3
2005;6;22211980;2005;277;2892;2895;7.97;0.48;233.47;3.91;887;6;965.00;3
2008;6;22211996;2008;276;2892;2895;7.97;0.48;233.37;3.91;884;6;966.00;3
2008;6;22212013;2008;277;2895;2899;7.98;0.48;233.37;3.91;887;6;967.00;4
2010;6;22212030;2010;277;2895;2899;7.99;0.48;233.38;3.91;885;6;968.00;4
2010;6;22212049;2010;272;2895;2899;7.94;0.48;233.38;3.91;885;6;969.00;4
2013;6;22212072;2013;273;2895;2899;7.89;0.48;233.56;3.91;882;6;970.00;4
2013;6;22212091;2013;274;2895;2899;7.82;0.47;233.56;3.91;882;6;971.00;4
2015;6;22212118;2015;273;2905;2911;7.79;0.47;233.63;3.90;890;6;972.00;6
2016;6;22212136;2016;274;2905;2911;7.77;0.47;233.63;3.90;889;6;973.00;6
2019;6;22212151;2019;281;2906;2911;7.74;0.47;233.72;3.90;887;6;974.00;5
2022;6;22212167;2022;282;2906;2911;7.67;0.47;233.79;3.90;884;6;975.00;5
2026;6;22212184;2026;283;2906;2911;7.63;0.46;234.12;3.90;880;6;976.00;5
2027;6;22212200;2027;281;2906;2911;7.53;0.46;234.12;3.90;879;6;977.00;5
2031;6;22212217;2031;284;2906;2912;7.45;0.45;234.19;3.90;875;6;978.00;6
2035;6;22212233;2035;285;2906;2912;7.43;0.45;234.01;3.90;871;6;979.00;6
2037;6;22212249;2037;282;2913;2918;7.37;0.45;233.99;3.91;876;6;980.00;5
2037;6;22212266;2037;284;2913;2919;7.29;0.44;233.99;3.91;876;6;981.00;6
2039;6;22212281;2039;277;2914;2919;7.20;0.44;233.99;3.90;875;6;982.00;5
2042;6;22212296;2042;273;2914;2919;7.15;0.44;234.00;3.90;872;6;983.00;5
2044;6;22212310;2044;274;2916;2923;7.18;0.44;234.04;3.90;872;6;984.00;7
2046;6;22212324;2046;275;2916;2923;7.22;0.44;233.94;3.90;870;6;985.00;7
2046;6;22212338;2046;280;2917;2923;7.23;0.44;233.94;3.91;871;6;986.00;6
2048;6;22212350;2048;280;2918;2924;7.26;0.44;233.88;3.91;870;6;987.00;6
2051;6;22212363;2051;282;2921;2928;7.27;0.44;233.73;3.91;870;6;988.00;7
2056;6;22212376;2056;287;2921;2928;7.23;0.44;233.52;3.91;865;6;989.00;7
2058;6;22212390;2058;286;2925;2934;7.30;0.44;233.35;3.90;867;6;990.00;9
2059;6;22212403;2059;288;2926;2934;7.39;0.45;233.25;3.90;867;6;991.00;8
2063;6;22212416;2063;291;2927;2934;7.42;0.45;233.06;3.90;864;6;992.00;7
2066;6;22212428;2066;288;2928;2934;7.47;0.45;232.89;3.90;862;6;993.00;6
2067;6;22212440;2067;293;2932;2938;7.51;0.46;232.82;3.90;865;6;994.00;6
2070;6;22212452;2070;288;2932;2938;7.46;0.45;232.65;3.90;862;6;995.00;6
2072;6;22212465;2072;289;2932;2938;7.40;0.45;232.58;3.90;860;6;996.00;6
2073;6;22212476;2073;287;2932;2938;7.34;0.45;232.60;3.90;859;6;997.00;6
2073;6;22212488;2073;294;2932;2939;7.28;0.44;232.60;3.90;859;6;998.00;7
2073;6;22212500;2073;296;2933;2940;7.26;0.44;232.60;3.89;860;6;999.00;7
2074;6;22212513;2074;294;2933;2940;7.21;0.44;232.62;3.89;859;6;1000.00;7
2076;6;22212529;2076;298;2934;2941;7.17;0.44;232.71;3.89;858;6;1001.00;7
2077;6;22212546;2077;300;2934;2941;7.12;0.43;232.73;3.89;857;6;1002.00;7
2077;6;22212562;2077;299;2934;2941;7.12;0.44;232.73;3.89;857;6;1003.00;7
2078;6;22212574;2078;308;2935;2941;7.10;0.43;232.74;3.90;857;6;1004.00;6
2081;6;22212587;2081;312;2936;2941;7.09;0.43;232.76;3.91;855;6;1005.00;5
2081;6;22212599;2081;316;2936;2941;7.12;0.43;232.76;3.91;855;6;1006.00;5
2082;6;22212611;2082;328;2936;2941;7.10;0.43;232.77;3.91;854;6;1007.00;5
2086;6;22212622;2086;344;3004;3068;7.32;0.45;232.64;3.85;918;6;1008.00;64
2088;6;22212647;2088;330;3008;3069;7.30;0.45;232.67;3.84;920;6;1009.00;61
2089;6;22212658;2089;321;3021;3069;7.40;0.46;232.57;3.85;932;6;1010.00;48
2090;7;22212672;2090;314;3022;3069;7.45;0.46;232.63;3.85;932;7;1011.00;47
2091;7;22212708;2091;314;3030;3069;7.49;0.46;232.60;3.85;939;7;1012.00;39
2092;7;22212720;2092;309;3033;3069;7.44;0.46;232.60;3.86;941;7;1013.00;36
2093;7;22212734;2093;313;3037;3069;7.40;0.46;232.66;3.86;944;7;1014.00;32
2095;7;22212748;2095;308;3038;3069;7.39;0.46;232.74;3.86;943;7;1015.00;31
2096;7;22212762;2096;311;3041;3070;7.39;0.46;232.75;3.86;945;7;1016.00;29
2097;8;22212774;2097;301;3046;3071;7.37;0.45;232.74;3.87;949;8;1017.00;25
2098;8;22212804;2098;301;3049;3071;7.42;0.46;232.75;3.88;951;8;1018.00;22
2100;8;22212819;2100;298;3052;3072;7.44;0.46;232.63;3.88;952;8;1019.00;20
2100;8;22212835;2100;304;3055;3072;7.34;0.45;232.63;3.89;955;8;1020.00;17
2101;8;22212850;2101;305;3059;3072;7.22;0.45;232.62;3.90;958;8;1021.00;13
2104;8;22212865;2104;309;3060;3072;7.09;0.44;232.66;3.90;956;8;1022.00;12
2108;8;22212878;2108;319;3064;3076;7.09;0.44;232.51;3.91;956;8;1023.00;12
2110;8;22212891;2110;314;3066;3076;7.00;0.43;232.40;3.91;956;8;1024.00;10
2113;8;22212905;2113;318;3068;3076;6.94;0.43;232.36;3.92;955;8;1025.00;8
2116;8;22212920;2116;316;3070;3079;6.90;0.42;232.37;3.93;954;8;1026.00;9
2117;8;22212935;2117;313;3071;3079;6.86;0.42;232.33;3.93;954;8;1027.00;8
2117;8;22212952;2117;309;3073;3079;6.81;0.42;232.33;3.94;956;8;1028.00;6
2120;8;22212968;2120;314;3079;3083;6.73;0.41;232.27;3.94;959;8;1029.00;4
2123;8;22212986;2123;320;3081;3084;6.70;0.41;232.34;3.95;958;8;1030.00;3
2125;8;22213012;2125;323;3082;3084;6.71;0.41;232.28;3.95;957;8;1031.00;2
2127;8;22213028;2127;322;3086;3088;6.73;0.41;232.24;3.95;959;8;1032.00;2
2129;8;22213047;2129;326;3087;3088;6.71;0.41;232.34;3.95;958;8;1033.00;1
2131;8;22213064;2131;322;3087;3088;6.68;0.41;232.37;3.95;956;8;1034.00;1
2132;8;22213080;2132;325;3089;3090;6.65;0.41;232.41;3.95;957;8;1035.00;1
2134;8;22213097;2134;322;3089;3090;6.64;0.41;232.26;3.95;955;8;1036.00;1
2137;8;22213113;2137;328;3095;3096;6.64;0.41;232.29;3.94;958;8;1037.00;1
2140;8;22213131;2140;325;3095;3096;6.64;0.41;232.39;3.94;955;8;1038.00;1
2143;8;22213146;2143;325;3096;3097;6.62;0.40;232.46;3.94;953;8;1039.00;1
2147;8;22213161;2147;331;3096;3097;6.56;0.40;232.76;3.94;949;8;1040.00;1
2153;8;22213178;2153;327;3097;3097;6.46;0.39;232.82;3.94;944;8;1041.00;0
2156;8;22213194;2156;328;3097;3097;6.37;0.39;232.85;3.94;941;8;1042.00;0
2158;8;22213208;2158;326;3097;3097;6.31;0.38;233.00;3.94;939;8;1043.00;0
2159;8;22213224;2159;331;3108;3109;6.32;0.39;232.97;3.93;949;8;1044.00;1
2162;8;22213239;2162;330;3108;3109;6.28;0.38;233.27;3.93;946;8;1045.00;1
2166;8;22213252;2166;331;3109;3109;6.25;0.38;233.33;3.93;943;8;1046.00;0
2168;8;22213266;2168;327;3109;3109;6.22;0.38;233.31;3.93;941;8;1047.00;0
2170;8;22213278;2170;330;3109;3109;6.19;0.38;233.44;3.93;939;8;1048.00;0
2172;8;22213289;2172;331;3109;3109;6.11;0.38;233.44;3.93;937;8;1049.00;0
2178;8;22213312;2178;314;3115;3115;6.03;0.37;233.62;3.92;937;8;1050.00;0
2181;8;22213324;2181;299;3115;3115;6.02;0.37;233.87;3.92;934;8;1051.00;0
2186;8;22213338;2186;300;3119;3119;6.02;0.37;233.91;3.92;933;8;1052.00;0
2189;8;22213352;2189;294;3120;3120;6.03;0.37;234.04;3.91;931;8;1053.00;0
2193;8;22213367;2193;291;3120;3120;6.10;0.37;234.43;3.91;927;8;1054.00;0
2198;8;22213383;2198;294;3120;3120;6.17;0.38;234.51;3.91;922;8;1055.00;0
2201;8;22213399;2201;295;3133;3133;6.24;0.38;234.92;3.90;932;8;1056.00;0
2206;8;22213416;2206;275;3133;3133;6.28;0.38;235.42;3.90;927;8;1057.00;0
2210;8;22213434;2210;266;3133;3133;6.34;0.39;235.73;3.90;923;8;1058.00;0
2212;8;22213449;2212;263;3134;3134;6.43;0.39;235.86;3.90;922;8;1059.00;0
2216;8;22213466;2216;261;3135;3135;6.51;0.40;236.16;3.90;919;8;1060.00;0
2220;8;22213483;2220;260;3135;3135;6.66;0.41;236.02;3.90;915;8;1061.00;0
2224;8;22213499;2224;258;3137;3138;6.77;0.41;236.07;3.89;913;8;1062.00;1
2227;8;22213515;2227;257;3137;3138;6.86;0.42;236.32;3.89;910;8;1063.00;1
2230;8;22213533;2230;262;3138;3138;6.93;0.42;236.50;3.89;908;8;1064.00;0
2238;8;22213550;2238;264;3138;3138;6.92;0.42;236.72;3.89;900;8;1065.00;0
2241;8;22213569;2241;262;3144;3144;7.10;0.43;236.80;3.89;903;8;1066.00;0
2249;8;22213586;2249;265;3144;3144;7.12;0.44;237.42;3.89;895;8;1067.00;0
2252;8;22213602;2252;267;3144;3144;7.13;0.44;237.89;3.89;892;8;1068.00;0
2257;8;22213620;2257;267;3144;3144;7.18;0.44;237.94;3.89;887;8;1069.00;0
2262;8;22213635;2262;270;3148;3148;7.18;0.44;238.29;3.88;886;8;1070.00;0
2266;8;22213649;2266;278;3149;3149;7.25;0.44;238.81;3.88;883;8;1071.00;0
2269;9;22213664;2269;281;3149;3149;7.33;0.45;239.12;3.88;880;9;1072.00;0
2275;9;22213689;2275;280;3150;3150;7.38;0.45;239.41;3.88;875;9;1073.00;0
2278;9;22213703;2278;280;3150;3150;7.45;0.46;239.44;3.88;872;9;1074.00;0
2283;9;22213718;2283;276;3150;3150;7.52;0.46;239.89;3.88;867;9;1075.00;0
2289;9;22213734;2289;273;3150;3150;7.53;0.46;239.74;3.88;861;9;1076.00;0
2290;10;22213750;2290;270;3150;3150;7.58;0.46;239.85;3.88;860;10;1077.00;0
2296;10;22213773;2296;269;3150;3150;7.63;0.47;240.19;3.88;854;10;1078.00;0
2299;10;22213790;2299;268;3150;3150;7.67;0.47;240.43;3.88;851;10;1079.00;0
2303;10;22213810;2303;290;3227;3275;7.71;0.48;240.50;3.79;924;10;1080.00;48
2307;10;22213849;2307;278;3233;3276;7.70;0.48;240.87;3.78;926;10;1081.00;43
2312;10;22213869;2312;272;3240;3276;7.75;0.48;241.11;3.78;928;10;1082.00;36
2314;10;22213888;2314;265;3242;3276;7.82;0.48;241.09;3.78;928;10;1083.00;34
2323;10;22213903;2323;266;3247;3276;7.83;0.48;241.46;3.78;924;10;1084.00;29
2328;10;22213922;2328;259;3248;3276;7.88;0.48;241.71;3.78;920;10;1085.00;28
2329;10;22213939;2329;258;3253;3276;7.93;0.49;241.79;3.78;924;10;1086.00;23
2334;10;22213956;2334;261;3255;3276;7.87;0.48;242.00;3.79;921;10;1087.00;21
2338;10;22213974;2338;273;3259;3277;7.79;0.48;242.27;3.79;921;10;1088.00;18
2345;10;22213991;2345;276;3264;3278;7.72;0.47;242.58;3.80;919;10;1089.00;14
2347;10;22214010;2347;276;3267;3278;7.64;0.47;242.80;3.80;920;10;1090.00;11
2350;10;22214041;2350;282;3273;3282;7.56;0.46;243.02;3.81;923;10;1091.00;9
2355;10;22214057;2355;288;3274;3282;7.48;0.46;243.22;3.81;919;10;1092.00;8
2357;10;22214072;2357;294;3275;3282;7.36;0.45;243.28;3.81;918;10;1093.00;7
2358;10;22214088;2358;300;3276;3282;7.34;0.45;243.27;3.81;918;10;1094.00;6
2363;10;22214102;2363;314;3282;3288;7.34;0.45;243.76;3.81;919;10;1095.00;6
2367;10;22214119;2367;328;3283;3288;7.24;0.44;244.03;3.81;916;10;1096.00;5
2368;10;22214136;2368;327;3283;3288;7.19;0.44;244.08;3.81;915;10;1097.00;5
2372;10;22214151;2372;322;3286;3291;7.14;0.44;244.33;3.81;914;10;1098.00;5
2374;10;22214166;2374;312;3286;3291;7.11;0.43;244.51;3.81;912;10;1099.00;5
2374;10;22214190;2374;312;3286;3291;7.12;0.43;244.51;3.81;912;10;1100.00;5
2378;10;22214211;2378;314;3288;3292;7.07;0.43;244.86;3.82;910;10;1101.00;4
2378;10;22214225;2378;314;3290;3293;7.16;0.44;244.86;3.82;912;10;1102.00;3
2383;10;22214240;2383;309;3290;3293;7.18;0.44;245.15;3.82;907;10;1103.00;3
2390;10;22214254;2390;315;3302;3306;7.26;0.44;245.64;3.80;912;10;1104.00;4
2393;10;22214270;2393;312;3302;3306;7.26;0.44;245.75;3.80;909;10;1105.00;4
2396;10;22214284;2396;298;3302;3306;7.29;0.44;245.76;3.80;906;10;1106.00;4
2400;10;22214298;2400;298;3303;3307;7.26;0.44;245.73;3.80;903;10;1107.00;4
2403;10;22214314;2403;295;3303;3307;7.33;0.45;245.74;3.80;900;10;1108.00;4
2407;10;22214329;2407;299;3307;3311;7.39;0.45;245.81;3.80;900;10;1109.00;4
2408;10;22214345;2408;285;3307;3311;7.43;0.45;245.82;3.80;899;10;1110.00;4
2409;10;22214361;2409;293;3311;3315;7.43;0.45;246.00;3.80;902;10;1111.00;4
2413;10;22214376;2413;291;3312;3315;7.53;0.46;246.26;3.80;899;10;1112.00;3
2414;10;22214390;2414;287;3312;3315;7.61;0.46;246.45;3.80;898;10;1113.00;3
2418;10;22214405;2418;293;3312;3315;7.65;0.46;246.47;3.80;894;10;1114.00;3
2422;10;22214430;2422;293;3312;3315;7.66;0.46;246.38;3.80;890;10;1115.00;3
2424;10;22214443;2424;300;3323;3327;7.78;0.47;246.44;3.79;899;10;1116.00;4
2427;10;22214459;2427;296;3324;3327;7.78;0.47;246.81;3.80;897;10;1117.00;3
2429;10;22214479;2429;297;3325;3327;7.77;0.47;246.89;3.80;896;10;1118.00;2
2430;10;22214494;2430;292;3325;3327;7.78;0.47;246.84;3.80;895;10;1119.00;2
2433;10;22214507;2433;288;3326;3327;7.80;0.47;247.07;3.81;893;10;1120.00;1
2435;10;22214521;2435;279;3326;3327;7.84;0.48;247.20;3.81;891;10;1121.00;1
2436;10;22214537;2436;280;3327;3328;7.89;0.48;247.34;3.81;891;10;1122.00;1
2437;10;22214551;2437;273;3327;3328;7.86;0.48;247.48;3.81;890;10;1123.00;1
2439;10;22214565;2439;270;3332;3334;7.89;0.48;247.67;3.81;893;10;1124.00;2
2443;10;22214578;2443;275;3334;3336;7.86;0.48;247.91;3.81;891;10;1125.00;2
2444;10;22214591;2444;270;3334;3336;7.83;0.48;247.85;3.81;890;10;1126.00;2
2446;10;22214604;2446;272;3334;3336;7.78;0.47;247.93;3.81;888;10;1127.00;2
2448;10;22214619;2448;271;3336;3340;7.77;0.47;247.99;3.80;888;10;1128.00;4
2452;10;22214634;2452;270;3337;3340;7.69;0.47;248.07;3.80;885;10;1129.00;3
2457;10;22214648;2457;272;3337;3340;7.64;0.46;248.09;3.80;880;10;1130.00;3
2461;10;22214662;2461;275;3338;3341;7.58;0.46;248.05;3.80;877;10;1131.00;3
2461;10;22214675;2461;279;3341;3345;7.60;0.46;248.05;3.80;880;10;1132.00;4
2462;10;22214688;2462;286;3341;3345;7.49;0.45;248.14;3.80;879;10;1133.00;4
2465;10;22214701;2465;283;3343;3348;7.46;0.45;248.06;3.80;878;10;1134.00;5
2465;10;22214716;2465;281;3343;3348;7.39;0.45;248.06;3.80;878;10;1135.00;5
2467;10;22214728;2467;286;3344;3348;7.37;0.45;248.18;3.80;877;10;1136.00;4
2468;10;22214740;2468;285;3344;3348;7.35;0.45;248.19;3.80;876;10;1137.00;4
2470;10;22214754;2470;289;3348;3352;7.34;0.45;248.17;3.79;878;10;1138.00;4
2475;10;22214767;2475;295;3348;3352;7.28;0.44;248.01;3.79;873;10;1139.00;4
2476;10;22214782;2476;285;3348;3352;7.27;0.44;247.96;3.79;872;10;1140.00;4
2479;10;22214796;2479;281;3348;3352;7.33;0.45;247.77;3.79;869;10;1141.00;4
2479;10;22214808;2479;280;3348;3353;7.34;0.45;247.77;3.79;869;10;1142.00;5
2481;10;22214820;2481;274;3349;3354;7.36;0.45;247.87;3.79;868;10;1143.00;5
2482;10;22214835;2482;270;3349;3354;7.36;0.45;247.91;3.79;867;10;1144.00;5
2484;10;22214849;2484;266;3350;3355;7.36;0.45;247.82;3.79;866;10;1145.00;5
2487;10;22214863;2487;265;3350;3355;7.36;0.45;247.86;3.79;863;10;1146.00;5
2490;10;22214875;2490;269;3350;3355;7.39;0.45;247.85;3.79;860;10;1147.00;5
2495;10;22214888;2495;267;3350;3355;7.33;0.45;248.08;3.79;855;10;1148.00;5
2499;10;22214901;2499;265;3350;3355;7.30;0.45;247.98;3.79;851;10;1149.00;5
2504;10;22214915;2504;270;3350;3355;7.28;0.45;248.04;3.79;846;10;1150.00;5
2505;10;22214927;2505;273;3350;3355;7.29;0.45;247.97;3.79;845;10;1151.00;5
2506;10;22214940;2506;299;3416;3482;7.30;0.45;248.01;3.72;910;10;1152.00;66
2508;10;22214965;2508;287;3416;3483;7.29;0.45;247.93;3.72;908;10;1153.00;67
2510;10;22214978;2510;276;3423;3483;7.37;0.46;247.82;3.71;913;10;1154.00;60
2513;10;22214999;2513;273;3427;3483;7.37;0.46;247.81;3.73;914;10;1155.00;56
2514;10;22215013;2514;273;3433;3483;7.42;0.46;247.83;3.73;919;10;1156.00;50
2515;10;22215024;2515;263;3437;3483;7.41;0.46;247.84;3.73;922;10;1157.00;46
2516;10;22215037;2516;259;3443;3483;7.36;0.46;247.86;3.74;927;10;1158.00;40
2519;10;22215058;2519;257;3445;3483;7.34;0.45;247.87;3.74;926;10;1159.00;38
2522;10;22215071;2522;258;3447;3484;7.30;0.45;247.90;3.74;925;10;1160.00;37
2524;10;22215086;2524;256;3452;3485;7.38;0.45;247.77;3.75;928;10;1161.00;33
2524;10;22215099;2524;255;3453;3485;7.41;0.45;247.77;3.75;929;10;1162.00;32
2526;10;22215119;2526;253;3456;3486;7.42;0.46;247.71;3.76;930;10;1163.00;30
2527;10;22215133;2527;249;3456;3486;7.37;0.45;247.71;3.76;929;10;1164.00;30
2529;10;22215146;2529;249;3457;3486;7.34;0.45;247.69;3.76;928;10;1165.00;29
2530;10;22215158;2530;239;3458;3486;7.33;0.45;247.71;3.76;928;10;1166.00;28
2533;10;22215173;2533;231;3464;3490;7.32;0.45;247.76;3.77;931;10;1167.00;26
2534;10;22215189;2534;228;3465;3490;7.37;0.45;247.70;3.78;931;10;1168.00;25
2540;10;22215204;2540;226;3468;3490;7.40;0.45;247.82;3.78;928;10;1169.00;22
2542;10;22215223;2542;215;3472;3496;7.54;0.46;247.72;3.78;930;10;1170.00;24
2542;10;22215240;2542;216;3472;3496;7.66;0.47;247.72;3.78;930;10;1171.00;24
2544;10;22215256;2544;210;3475;3496;7.76;0.47;247.82;3.79;931;10;1172.00;21
2544;10;22215277;2544;212;3479;3500;7.86;0.48;247.82;3.79;935;10;1173.00;21
2545;10;22215290;2545;211;3481;3501;7.92;0.48;247.82;3.79;936;10;1174.00;20
2546;10;22215305;2546;211;3482;3501;7.95;0.48;247.73;3.80;936;10;1175.00;19
2550;10;22215319;2550;211;3487;3505;7.96;0.48;247.60;3.80;937;10;1176.00;18
2552;10;22215342;2552;209;3488;3505;7.98;0.49;247.55;3.81;936;10;1177.00;17
2554;10;22215356;2554;214;3488;3505;8.00;0.49;247.42;3.81;934;10;1178.00;17
2556;10;22215370;2556;220;3491;3506;7.98;0.49;247.44;3.82;935;10;1179.00;15
2558;10;22215385;2558;227;3493;3506;7.95;0.49;247.27;3.85;935;10;1180.00;13
2561;10;22215400;2561;221;3499;3512;8.02;0.49;247.35;3.84;938;10;1181.00;13
2565;10;22215416;2565;223;3499;3512;8.00;0.49;247.08;3.84;934;10;1182.00;13
2568;11;22215438;2568;231;3501;3513;7.95;0.48;247.15;3.86;933;11;1183.00;12
2569;11;22215465;2569;234;3501;3513;7.89;0.48;247.10;3.86;932;11;1184.00;12
2571;11;22215479;2571;227;3501;3513;7.89;0.48;247.05;3.86;930;11;1185.00;12
2572;11;22215492;2572;229;3503;3513;7.86;0.48;246.99;3.88;931;11;1186.00;10
2574;11;22215506;2574;228;3503;3513;7.88;0.48;246.94;3.88;929;11;1187.00;10
2576;11;22215521;2576;231;3512;3525;7.92;0.48;246.87;3.87;936;11;1188.00;13
2579;11;22215537;2579;238;3513;3525;7.92;0.48;246.79;3.88;934;11;1189.00;12
2582;11;22215551;2582;236;3517;3525;7.95;0.49;246.84;3.90;935;11;1190.00;8
2584;11;22215565;2584;235;3518;3525;7.93;0.48;246.75;3.91;934;11;1191.00;7
2587;11;22215579;2587;243;3518;3525;7.96;0.49;246.87;3.91;931;11;1192.00;7
2589;11;22215591;2589;242;3520;3525;7.98;0.49;246.79;3.92;931;11;1193.00;5
2593;11;22215605;2593;247;3523;3529;7.90;0.48;246.93;3.92;930;11;1194.00;6
2594;12;22215619;2594;243;3524;3529;7.89;0.48;246.96;3.93;930;12;1195.00;5
2596;12;22215649;2596;241;3530;3533;7.90;0.48;247.02;3.93;934;12;1196.00;3
2599;12;22215670;2599;246;3533;3534;7.81;0.48;247.21;3.94;934;12;1197.00;1
2601;12;22215683;2601;239;3533;3534;7.74;0.47;247.27;3.94;932;12;1198.00;1
2603;12;22215697;2603;236;3534;3534;7.66;0.47;247.42;3.94;931;12;1199.00;0
2606;12;22215713;2606;239;3559;3575;7.61;0.47;247.75;3.91;953;12;1200.00;16
2609;12;22215737;2609;231;3559;3575;7.59;0.47;247.64;3.91;950;12;1201.00;16
2612;12;22215751;2612;236;3561;3575;7.64;0.47;247.92;3.91;949;12;1202.00;14
2614;12;22215766;2614;232;3565;3576;7.71;0.47;247.97;3.91;951;12;1203.00;11
2616;12;22215780;2616;228;3568;3577;7.71;0.47;247.92;3.91;952;12;1204.00;9
2618;12;22215802;2618;225;3568;3577;7.71;0.47;247.98;3.91;950;12;1205.00;9
2620;12;22215817;2620;229;3572;3580;7.71;0.47;248.02;3.91;952;12;1206.00;8
2624;12;22215832;2624;227;3572;3580;7.64;0.47;248.25;3.91;948;12;1207.00;8
2627;12;22215845;2627;227;3573;3580;7.64;0.47;248.25;3.91;946;12;1208.00;7
2628;12;22215859;2628;233;3574;3580;7.65;0.47;248.34;3.91;946;12;1209.00;6
2630;12;22215872;2630;232;3581;3586;7.67;0.47;248.33;3.90;951;12;1210.00;5
2633;12;22215888;2633;238;3581;3586;7.68;0.47;248.39;3.90;948;12;1211.00;5
2636;12;22215902;2636;240;3582;3586;7.72;0.47;248.51;3.91;946;12;1212.00;4
2640;12;22215917;2640;234;3582;3586;7.77;0.48;248.73;3.91;942;12;1213.00;4
2646;12;22215931;2646;237;3586;3590;7.72;0.47;248.86;3.90;940;12;1214.00;4
2650;12;22215947;2650;234;3589;3592;7.74;0.47;248.98;3.90;939;12;1215.00;3
2656;12;22215961;2656;236;3589;3592;7.69;0.47;249.12;3.90;933;12;1216.00;3
2661;12;22215983;2661;239;3590;3593;7.66;0.47;249.39;3.90;929;12;1217.00;3
2666;12;22215997;2666;245;3590;3593;7.62;0.47;249.31;3.90;924;12;1218.00;3
2669;12;22216010;2669;248;3590;3593;7.59;0.47;249.46;3.90;921;12;1219.00;3
2674;12;22216022;2674;251;3591;3593;7.54;0.46;249.49;3.91;917;12;1220.00;2
2678;12;22216036;2678;254;3591;3593;7.56;0.47;249.45;3.91;913;12;1221.00;2
2682;12;22216049;2682;261;3591;3593;7.54;0.46;249.49;3.91;909;12;1222.00;2
2688;12;22216062;2688;260;3591;3593;7.42;0.46;249.81;3.91;903;12;1223.00;2
2691;12;22216073;2691;274;3632;3663;7.48;0.46;250.00;3.86;941;12;1224.00;31
2694;12;22216092;2694;264;3635;3664;7.44;0.46;250.11;3.86;941;12;1225.00;29
2702;12;22216106;2702;255;3644;3664;7.43;0.46;250.15;3.86;942;12;1226.00;20
2705;12;22216120;2705;250;3645;3664;7.38;0.45;250.20;3.86;940;12;1227.00;19
2710;12;22216134;2710;253;3648;3666;7.29;0.45;250.52;3.86;938;12;1228.00;18
2716;12;22216148;2716;258;3650;3666;7.26;0.44;250.72;3.86;934;12;1229.00;16
2722;12;22216164;2722;260;3651;3666;7.14;0.44;251.08;3.86;929;12;1230.00;15
2725;12;22216178;2725;263;3654;3666;7.16;0.44;251.02;3.87;929;12;1231.00;12
2732;12;22216190;2732;263;3659;3667;7.19;0.44;251.28;3.88;927;12;1232.00;8
2735;12;22216205;2735;256;3662;3668;7.16;0.43;251.61;3.88;927;12;1233.00;6
2738;12;22216219;2738;261;3664;3668;7.20;0.44;251.65;3.89;926;12;1234.00;4
2741;12;22216233;2741;260;3670;3672;7.19;0.44;251.91;3.88;929;12;1235.00;2
2743;12;22216247;2743;262;3671;3672;7.17;0.44;252.10;3.88;928;12;1236.00;1
2746;12;22216261;2746;261;3671;3672;7.20;0.44;252.12;3.88;925;12;1237.00;1
2749;12;22216282;2749;262;3672;3672;7.20;0.44;252.37;3.89;923;12;1238.00;0
2752;12;22216296;2752;256;3678;3678;7.23;0.44;252.60;3.88;926;12;1239.00;0
2755;12;22216311;2755;261;3678;3678;7.25;0.44;252.54;3.88;923;12;1240.00;0
2760;12;22216323;2760;264;3678;3678;7.24;0.44;252.67;3.88;918;12;1241.00;0
2765;12;22216338;2765;268;3680;3681;7.28;0.44;252.85;3.88;915;12;1242.00;1
2768;12;22216353;2768;270;3680;3681;7.29;0.44;252.84;3.88;912;12;1243.00;1
2772;12;22216367;2772;271;3681;3681;7.30;0.44;252.95;3.88;909;12;1244.00;0
2776;12;22216381;2776;271;3682;3682;7.25;0.44;253.04;3.88;906;12;1245.00;0
2779;12;22216396;2779;276;3683;3683;7.28;0.44;253.14;3.88;904;12;1246.00;0
2781;12;22216408;2781;276;3683;3683;7.26;0.44;253.23;3.88;902;12;1247.00;0
2784;12;22216424;2784;282;3696;3696;7.26;0.44;253.56;3.86;912;12;1248.00;0
2788;12;22216449;2788;282;3696;3696;7.26;0.44;253.57;3.86;908;12;1249.00;0
2794;12;22216464;2794;283;3696;3696;7.23;0.44;253.52;3.86;902;12;1250.00;0
2799;12;22216481;2799;288;3697;3697;7.18;0.44;253.97;3.86;898;12;1251.00;0
2802;12;22216497;2802;290;3697;3697;7.16;0.43;254.06;3.86;895;12;1252.00;0
2808;12;22216511;2808;289;3701;3701;7.10;0.43;254.39;3.86;893;12;1253.00;0
2812;12;22216529;2812;291;3701;3701;7.09;0.43;254.61;3.86;889;12;1254.00;0
2815;12;22216542;2815;296;3705;3705;7.09;0.43;254.72;3.86;890;12;1255.00;0
2817;12;22216556;2817;298;3705;3705;7.07;0.43;254.73;3.86;888;12;1256.00;0
2823;12;22216570;2823;301;3705;3705;7.06;0.43;255.03;3.86;882;12;1257.00;0
2828;12;22216584;2828;299;3705;3705;7.07;0.43;255.31;3.86;877;12;1258.00;0
2831;12;22216598;2831;299;3705;3705;7.12;0.43;255.56;3.86;874;12;1259.00;0
2835;12;22216613;2835;302;3736;3739;7.29;0.45;255.60;3.82;901;12;1260.00;3
2837;12;22216630;2837;301;3736;3739;7.30;0.45;255.75;3.82;899;12;1261.00;3
2839;12;22216643;2839;306;3738;3739;7.35;0.45;255.79;3.82;899;12;1262.00;1
2841;12;22216656;2841;304;3738;3739;7.34;0.45;255.93;3.82;897;12;1263.00;1
2844;12;22216669;2844;305;3739;3739;7.28;0.44;256.15;3.82;895;12;1264.00;0
2845;12;22216683;2845;313;3739;3739;7.18;0.44;256.17;3.82;894;12;1265.00;0
2847;12;22216697;2847;318;3740;3740;7.06;0.43;256.35;3.82;893;12;1266.00;0
2850;12;22216708;2850;317;3740;3740;6.95;0.43;256.25;3.82;890;12;1267.00;0
2854;12;22216721;2854;322;3746;3746;6.88;0.42;256.47;3.82;892;12;1268.00;0
2856;12;22216737;2856;332;3747;3747;6.80;0.42;256.52;3.82;891;12;1269.00;0
2858;12;22216751;2858;338;3747;3747;6.75;0.41;256.74;3.82;889;12;1270.00;0
2861;12;22216765;2861;339;3747;3747;6.74;0.41;257.12;3.82;886;12;1271.00;0
2862;12;22216779;2862;338;3751;3751;6.75;0.41;257.25;3.81;889;12;1272.00;0
2863;12;22216793;2863;332;3751;3751;6.78;0.42;257.33;3.81;888;12;1273.00;0
2867;12;22216806;2867;333;3751;3751;6.73;0.41;257.59;3.81;884;12;1274.00;0
2871;12;22216819;2871;324;3752;3752;6.76;0.42;257.65;3.81;881;12;1275.00;0
2872;12;22216834;2872;324;3756;3756;6.77;0.42;257.71;3.81;884;12;1276.00;0
2875;12;22216850;2875;330;3756;3756;6.72;0.41;257.88;3.81;881;12;1277.00;0
2880;12;22216875;2880;329;3758;3759;6.68;0.41;257.76;3.81;878;12;1278.00;1
2882;12;22216890;2882;332;3758;3759;6.66;0.41;257.70;3.81;876;12;1279.00;1
2885;12;22216903;2885;335;3759;3759;6.68;0.41;257.82;3.81;874;12;1280.00;0
2888;12;22216916;2888;324;3759;3759;6.76;0.41;257.75;3.81;871;12;1281.00;0
2889;12;22216930;2889;311;3763;3763;6.89;0.42;257.76;3.80;874;12;1282.00;0
2894;12;22216944;2894;306;3763;3763;6.93;0.42;257.65;3.80;869;12;1283.00;0
2898;12;22216957;2898;304;3763;3763;7.00;0.43;257.66;3.80;865;12;1284.00;0
2901;12;22216972;2901;299;3763;3763;7.05;0.43;257.75;3.80;862;12;1285.00;0
2903;12;22216986;2903;293;3763;3764;7.09;0.43;257.85;3.80;860;12;1286.00;1
2905;12;22217001;2905;292;3764;3765;7.19;0.44;257.84;3.80;859;12;1287.00;1
2906;12;22217016;2906;295;3764;3765;7.26;0.44;257.79;3.80;858;12;1288.00;1
2907;12;22217030;2907;294;3765;3766;7.32;0.45;257.86;3.80;858;12;1289.00;1
2910;12;22217045;2910;295;3765;3766;7.35;0.45;257.97;3.80;855;12;1290.00;1
2913;12;22217058;2913;301;3765;3766;7.37;0.45;258.11;3.80;852;12;1291.00;1
2914;12;22217071;2914;291;3765;3766;7.38;0.45;258.12;3.80;851;12;1292.00;1
2915;12;22217085;2915;286;3765;3766;7.47;0.45;258.17;3.80;850;12;1293.00;1
2918;12;22217099;2918;286;3765;3766;7.49;0.46;258.35;3.80;847;12;1294.00;1
2921;12;22217114;2921;278;3765;3766;7.47;0.45;258.29;3.80;844;12;1295.00;1
2923;12;22217128;2923;300;3831;3893;7.75;0.48;258.34;3.74;908;12;1296.00;62
2927;13;22217152;2927;283;3833;3894;7.85;0.48;258.40;3.74;906;13;1297.00;61
2931;13;22217180;2931;275;3841;3894;7.88;0.48;258.22;3.73;910;13;1298.00;53
2932;13;22217195;2932;277;3844;3894;7.88;0.48;258.16;3.73;912;13;1299.00;50
2934;13;22217208;2934;278;3851;3894;7.82;0.48;258.15;3.73;917;13;1300.00;43
2937;13;22217228;2937;280;3855;3894;7.76;0.48;258.15;3.73;918;13;1301.00;39
2938;13;22217240;2938;284;3859;3894;7.79;0.48;258.23;3.74;921;13;1302.00;35
2943;13;22217255;2943;287;3862;3894;7.72;0.47;258.19;3.74;919;13;1303.00;32
2945;13;22217272;2945;289;3864;3895;7.70;0.47;258.12;3.74;919;13;1304.00;31
2947;13;22217287;2947;299;3870;3897;7.61;0.46;258.21;3.75;923;13;1305.00;27
2949;13;22217302;2949;299;3871;3897;7.50;0.46;258.08;3.75;922;13;1306.00;26
2951;13;22217323;2951;300;3874;3898;7.38;0.45;258.18;3.75;923;13;1307.00;24
2951;13;22217338;2951;312;3874;3898;7.28;0.45;258.18;3.75;923;13;1308.00;24
2956;13;22217359;2956;318;3879;3898;7.18;0.44;258.07;3.77;923;13;1309.00;19
2957;13;22217372;2957;335;3880;3898;7.11;0.43;258.13;3.77;923;13;1310.00;18
2959;13;22217387;2959;333;3883;3902;7.08;0.43;258.06;3.77;924;13;1311.00;19
2959;13;22217402;2959;331;3884;3902;7.03;0.43;258.06;3.77;925;13;1312.00;18
2961;13;22217417;2961;336;3885;3902;6.95;0.42;258.13;3.77;924;13;1313.00;17
2963;13;22217432;2963;341;3888;3905;6.90;0.42;258.17;3.77;925;13;1314.00;17
2964;13;22217446;2964;338;3889;3905;6.87;0.42;258.12;3.78;925;13;1315.00;16
2966;13;22217461;2966;338;3889;3905;6.83;0.42;258.10;3.78;923;13;1316.00;16
2966;13;22217477;2966;334;3894;3909;6.81;0.41;258.10;3.78;928;13;1317.00;15
2968;13;22217494;2968;333;3895;3910;6.85;0.42;258.04;3.78;927;13;1318.00;15
2969;13;22217509;2969;331;3896;3910;6.93;0.42;257.96;3.79;927;13;1319.00;14
2971;13;22217528;2971;328;3901;3915;6.99;0.42;258.02;3.78;930;13;1320.00;14
2972;13;22217543;2972;324;3901;3915;7.10;0.43;258.10;3.78;929;13;1321.00;14
2972;13;22217558;2972;322;3901;3915;7.18;0.44;258.10;3.78;929;13;1322.00;14
2975;13;22217574;2975;306;3902;3916;7.21;0.44;258.20;3.78;927;13;1323.00;14
2976;13;22217589;2976;291;3902;3916;7.27;0.44;258.20;3.78;926;13;1324.00;14
2978;13;22217605;2978;277;3906;3922;7.32;0.45;258.29;3.78;928;13;1325.00;16
2981;13;22217621;2981;273;3906;3922;7.34;0.45;258.24;3.78;925;13;1326.00;16
2983;13;22217637;2983;264;3906;3923;7.38;0.45;258.18;3.78;923;13;1327.00;17
2985;13;22217652;2985;258;3906;3923;7.40;0.45;258.17;3.78;921;13;1328.00;17
2986;13;22217666;2986;251;3906;3923;7.36;0.45;258.18;3.78;920;13;1329.00;17
2987;13;22217690;2987;243;3907;3923;7.37;0.45;258.24;3.79;920;13;1330.00;16
2990;13;22217705;2990;248;3908;3923;7.30;0.44;258.27;3.80;918;13;1331.00;15
2993;13;22217721;2993;246;3917;3935;7.32;0.44;258.31;3.79;924;13;1332.00;18
2995;13;22217746;2995;243;3918;3935;7.31;0.44;258.35;3.79;923;13;1333.00;17
2996;13;22217768;2996;246;3919;3935;7.37;0.45;258.37;3.79;923;13;1334.00;16
2997;13;22217783;2997;241;3919;3935;7.36;0.45;258.35;3.79;922;13;1335.00;16
2999;13;22217797;2999;233;3919;3935;7.38;0.45;258.44;3.79;920;13;1336.00;16
3001;13;22217811;3001;231;3919;3935;7.46;0.45;258.46;3.79;918;13;1337.00;16
3002;13;22217823;3002;225;3922;3939;7.47;0.45;258.46;3.78;920;13;1338.00;17
3005;13;22217837;3005;221;3922;3939;7.51;0.45;258.41;3.78;917;13;1339.00;17
3006;13;22217851;3006;224;3925;3943;7.58;0.46;258.40;3.78;919;13;1340.00;18
3007;13;22217866;3007;220;3925;3944;7.69;0.47;258.36;3.78;918;13;1341.00;19
3010;13;22217879;3010;208;3926;3944;7.73;0.47;258.26;3.78;916;13;1342.00;18
3011;13;22217891;3011;204;3926;3944;7.72;0.47;258.24;3.78;915;13;1343.00;18
3015;13;22217904;3015;200;3936;3957;7.77;0.47;258.27;3.77;921;13;1344.00;21
3018;13;22217919;3018;194;3936;3957;7.74;0.47;258.13;3.77;918;13;1345.00;21
3022;13;22217935;3022;190;3936;3957;7.76;0.47;258.38;3.77;914;13;1346.00;21
3025;13;22217949;3025;182;3938;3958;7.83;0.47;258.22;3.77;913;13;1347.00;20
3026;13;22217964;3026;179;3939;3959;7.88;0.48;258.20;3.78;913;13;1348.00;20
3028;13;22217981;3028;177;3940;3959;7.98;0.48;258.06;3.79;912;13;1349.00;19
3029;13;22217997;3029;181;3947;3968;8.08;0.49;258.08;3.79;918;13;1350.00;21
3031;13;22218015;3031;176;3950;3968;8.13;0.49;258.10;3.81;919;13;1351.00;18
3032;13;22218029;3032;177;3952;3968;8.16;0.49;258.13;3.81;920;13;1352.00;16
3033;13;22218042;3033;175;3952;3968;8.23;0.50;258.10;3.81;919;13;1353.00;16
3034;13;22218057;3034;180;3958;3974;8.26;0.50;258.11;3.82;924;13;1354.00;16
3036;13;22218088;3036;189;3959;3974;8.25;0.50;258.09;3.83;923;13;1355.00;15
3042;13;22218105;3042;189;3959;3974;8.22;0.50;258.24;3.83;917;13;1356.00;15
3042;13;22218122;3042;189;3961;3974;8.22;0.50;258.24;3.85;919;13;1357.00;13
3044;13;22218140;3044;195;3964;3978;8.11;0.49;258.27;3.85;920;13;1358.00;14
3046;13;22218157;3046;203;3967;3979;8.06;0.49;258.26;3.86;921;13;1359.00;12
3046;13;22218174;3046;203;3967;3979;8.03;0.49;258.26;3.86;921;13;1360.00;12
3047;13;22218193;3047;207;3969;3980;7.98;0.49;258.32;3.88;922;13;1361.00;11
3050;13;22218213;3050;210;3969;3980;7.90;0.48;258.50;3.88;919;13;1362.00;11
3052;13;22218233;3052;217;3969;3980;7.90;0.48;258.55;3.88;917;13;1363.00;11
3056;13;22218258;3056;221;3972;3980;7.91;0.48;258.58;3.92;916;13;1364.00;8
3058;13;22218275;3058;219;3972;3980;7.93;0.48;258.51;3.92;914;13;1365.00;8
3058;13;22218293;3058;223;3973;3980;7.98;0.49;258.51;3.93;915;13;1366.00;7
3060;13;22218308;3060;223;3974;3980;8.02;0.49;258.61;3.94;914;13;1367.00;6
3061;13;22218322;3061;225;4015;4050;8.14;0.50;258.67;3.91;954;13;1368.00;35
3065;13;22218345;3065;223;4018;4051;8.11;0.50;258.58;3.91;953;13;1369.00;33
3066;13;22218359;3066;221;4024;4051;8.03;0.49;258.63;3.92;958;13;1370.00;27
3070;13;22218371;3070;220;4028;4051;7.97;0.49;258.72;3.92;958;13;1371.00;23
3071;13;22218386;3071;223;4030;4051;7.91;0.49;258.76;3.93;959;13;1372.00;21
3076;14;22218400;3076;225;4033;4051;7.79;0.48;258.79;3.93;957;14;1373.00;18
3079;14;22218422;3079;221;4039;4051;7.71;0.47;258.99;3.93;960;14;1374.00;12
3080;14;22218436;3080;221;4041;4051;7.63;0.47;259.07;3.94;961;14;1375.00;10
3082;14;22218450;3082;225;4043;4052;7.61;0.47;259.02;3.94;961;14;1376.00;9
3085;14;22218465;3085;224;4046;4053;7.58;0.46;259.00;3.94;961;14;1377.00;7
3088;14;22218479;3088;226;4049;4053;7.59;0.46;258.97;3.95;961;14;1378.00;4
3091;14;22218493;3091;223;4056;4057;7.56;0.46;259.06;3.95;965;14;1379.00;1
3093;14;22218511;3093;220;4057;4057;7.57;0.46;259.07;3.95;964;14;1380.00;0
3094;14;22218525;3094;214;4057;4057;7.58;0.46;259.13;3.95;963;14;1381.00;0
3100;14;22218540;3100;212;4057;4057;7.55;0.46;259.31;3.95;957;14;1382.00;0
3102;14;22218556;3102;220;4063;4063;7.55;0.46;259.35;3.94;961;14;1383.00;0
3106;14;22218572;3106;224;4063;4063;7.51;0.46;259.46;3.94;957;14;1384.00;0
3107;14;22218588;3107;223;4063;4063;7.48;0.46;259.57;3.94;956;14;1385.00;0
3107;14;22218603;3107;232;4065;4066;7.46;0.46;259.57;3.94;958;14;1386.00;1
3112;14;22218619;3112;233;4065;4066;7.39;0.45;259.63;3.94;953;14;1387.00;1
3121;14;22218633;3121;236;4066;4066;7.31;0.44;259.52;3.94;945;14;1388.00;0
3126;14;22218648;3126;244;4067;4067;7.27;0.44;259.68;3.94;941;14;1389.00;0
3127;14;22218663;3127;246;4068;4068;7.33;0.45;259.64;3.94;941;14;1390.00;0
3131;14;22218686;3131;252;4068;4068;7.33;0.45;259.93;3.94;937;14;1391.00;0
3136;14;22218704;3136;255;4080;4081;7.25;0.44;260.06;3.93;944;14;1392.00;1
3137;14;22218727;3137;261;4081;4081;7.29;0.44;260.08;3.93;944;14;1393.00;0
3142;14;22218746;3142;262;4081;4081;7.29;0.44;260.31;3.93;939;14;1394.00;0
3147;14;22218761;3147;260;4083;4083;7.27;0.44;260.29;3.92;936;14;1395.00;0
3149;14;22218778;3149;264;4083;4083;7.24;0.44;260.28;3.92;934;14;1396.00;0
3152;14;22218795;3152;264;4087;4087;7.27;0.44;260.41;3.92;935;14;1397.00;0
3159;14;22218812;3159;261;4087;4087;7.14;0.43;260.49;3.92;928;14;1398.00;0
3160;14;22218829;3160;267;4091;4091;7.05;0.43;260.51;3.92;931;14;1399.00;0
3165;14;22218848;3165;251;4091;4091;6.98;0.43;260.61;3.92;926;14;1400.00;0
3170;14;22218869;3170;252;4091;4091;6.88;0.42;260.80;3.92;921;14;1401.00;0
3173;14;22218886;3173;250;4091;4091;6.86;0.42;260.83;3.92;918;14;1402.00;0
3179;14;22218900;3179;252;4091;4091;6.77;0.41;261.17;3.92;912;14;1403.00;0
3183;14;22218914;3183;251;4102;4103;6.84;0.42;261.27;3.91;919;14;1404.00;1
3186;14;22218928;3186;255;4103;4103;6.87;0.42;261.31;3.91;917;14;1405.00;0
3190;14;22218940;3190;258;4103;4103;6.88;0.42;261.66;3.91;913;14;1406.00;0
3194;14;22218954;3194;252;4103;4103;6.94;0.42;261.84;3.91;909;14;1407.00;0
3197;14;22218968;3197;244;4103;4103;6.99;0.43;261.99;3.91;906;14;1408.00;0
3202;14;22218981;3202;250;4103;4103;6.94;0.42;262.25;3.91;901;14;1409.00;0
3206;14;22218995;3206;244;4104;4104;6.88;0.42;262.61;3.91;898;14;1410.00;0
3208;14;22219008;3208;240;4104;4104;6.80;0.42;262.72;3.91;896;14;1411.00;0
3211;14;22219021;3211;238;4110;4110;6.85;0.42;262.73;3.90;899;14;1412.00;0
3213;14;22219035;3213;234;4110;4111;6.88;0.42;262.91;3.90;897;14;1413.00;1
3216;14;22219049;3216;240;4111;4111;6.90;0.42;263.01;3.90;895;14;1414.00;0
3221;14;22219062;3221;245;4111;4111;6.89;0.42;263.26;3.90;890;14;1415.00;0
3225;14;22219073;3225;250;4115;4115;6.91;0.42;263.47;3.90;890;14;1416.00;0
3230;14;22219088;3230;256;4115;4115;6.88;0.42;263.62;3.90;885;14;1417.00;0
3236;14;22219101;3236;253;4115;4115;6.82;0.42;263.73;3.90;879;14;1418.00;0
3239;14;22219115;3239;254;4116;4116;6.77;0.41;263.87;3.90;877;14;1419.00;0
3242;14;22219128;3242;256;4120;4120;6.75;0.41;264.00;3.89;878;14;1420.00;0
3248;14;22219141;3248;250;4120;4120;6.74;0.41;264.10;3.89;872;14;1421.00;0
3251;14;22219168;3251;249;4122;4123;6.71;0.41;264.10;3.89;871;14;1422.00;1
3259;14;22219185;3259;257;4122;4123;6.65;0.41;264.08;3.89;863;14;1423.00;1
3266;14;22219200;3266;253;4123;4123;6.60;0.40;264.17;3.89;857;14;1424.00;0
3267;14;22219213;3267;258;4123;4123;6.59;0.40;264.19;3.89;856;14;1425.00;0
3273;14;22219224;3273;256;4127;4127;6.58;0.40;264.20;3.89;854;14;1426.00;0
3277;14;22219237;3277;259;4127;4127;6.56;0.40;264.48;3.89;850;14;1427.00;0
3277;14;22219250;3277;264;4127;4127;6.61;0.40;264.48;3.89;850;14;1428.00;0
3280;14;22219262;3280;268;4127;4127;6.58;0.40;264.62;3.89;847;14;1429.00;0
3283;14;22219273;3283;278;4128;4128;6.58;0.40;264.58;3.89;845;14;1430.00;0
3288;14;22219286;3288;280;4129;4129;6.54;0.40;264.76;3.89;841;14;1431.00;0
3290;14;22219299;3290;283;4129;4129;6.54;0.40;264.82;3.89;839;14;1432.00;0
3294;14;22219312;3294;282;4130;4130;6.53;0.40;264.97;3.89;836;14;1433.00;0
3297;14;22219325;3297;288;4130;4130;6.45;0.40;265.02;3.89;833;14;1434.00;0
3300;14;22219342;3300;293;4130;4130;6.40;0.39;265.15;3.89;830;14;1435.00;0
3303;14;22219356;3303;296;4130;4130;6.32;0.39;265.09;3.89;827;14;1436.00;0
3305;14;22219371;3305;299;4130;4130;6.25;0.38;265.06;3.89;825;14;1437.00;0
3309;14;22219386;3309;308;4130;4130;6.14;0.38;265.12;3.89;821;14;1438.00;0
3313;14;22219401;3313;306;4130;4130;6.05;0.37;265.19;3.89;817;14;1439.00;0
3319;14;22219418;3319;341;4241;4360;6.51;0.41;265.14;3.78;922;14;1440.00;119
3322;14;22219458;3322;343;4250;4361;6.49;0.41;265.16;3.78;928;14;1441.00;111
3326;14;22219474;3326;333;4262;4361;6.53;0.41;265.17;3.77;936;14;1442.00;99
3329;14;22219490;3329;332;4271;4361;6.47;0.41;265.14;3.77;942;14;1443.00;90
3334;14;22219505;3334;333;4284;4361;6.43;0.40;265.25;3.77;950;14;1444.00;77
3335;14;22219521;3335;336;4290;4361;6.40;0.40;265.26;3.77;955;14;1445.00;71
3337;14;22219535;3337;331;4296;4361;6.38;0.40;265.34;3.78;959;14;1446.00;65
3338;14;22219549;3338;323;4303;4361;6.48;0.41;265.40;3.78;965;14;1447.00;58
3342;14;22219562;3342;323;4312;4362;6.52;0.41;265.53;3.79;970;14;1448.00;50
3346;14;22219576;3346;330;4317;4363;6.53;0.41;265.51;3.80;971;14;1449.00;46
3349;14;22219590;3349;329;4324;4363;6.51;0.41;265.42;3.81;975;14;1450.00;39
3352;14;22219605;3352;330;4327;4364;6.50;0.41;265.74;3.81;975;14;1451.00;37
3355;14;22219620;3355;335;4329;4364;6.47;0.40;265.64;3.82;974;14;1452.00;35
3357;14;22219635;3357;331;4333;4364;6.50;0.40;265.67;3.83;976;14;1453.00;31
3358;14;22219649;3358;331;4334;4364;6.46;0.40;265.62;3.83;976;14;1454.00;30
3363;14;22219671;3363;347;4337;4368;6.46;0.40;265.77;3.83;974;15;1455.00;31
3364;14;22219698;3364;343;4339;4368;6.47;0.40;265.70;3.83;975;15;1456.00;29
3367;14;22219712;3367;344;4339;4368;6.54;0.40;265.60;3.83;972;15;1457.00;29
3371;14;22219726;3371;342;4340;4371;6.56;0.41;265.38;3.83;969;15;1458.00;31
3374;14;22219741;3374;332;4341;4371;6.61;0.41;265.21;3.83;967;15;1459.00;30
3374;14;22219756;3374;337;4342;4371;6.75;0.42;265.21;3.84;968;15;1460.00;29
3376;14;22219771;3376;333;4346;4375;6.86;0.42;265.13;3.84;970;15;1461.00;29
3378;14;22219798;3378;339;4348;4376;6.90;0.42;265.09;3.84;970;15;1462.00;28
3380;14;22219814;3380;338;4349;4376;6.95;0.43;265.07;3.85;969;15;1463.00;27
3381;14;22219828;3381;339;4352;4380;6.99;0.43;265.10;3.84;971;15;1464.00;28
3383;14;22219843;3383;342;4353;4380;6.97;0.43;265.06;3.85;970;15;1465.00;27
3387;14;22219858;3387;346;4353;4380;7.00;0.43;264.99;3.85;966;15;1466.00;27
3387;14;22219874;3387;350;4355;4381;7.02;0.43;264.99;3.86;968;15;1467.00;26
3388;14;22219889;3388;348;4355;4381;7.07;0.43;264.97;3.86;967;15;1468.00;26
3393;14;22219904;3393;349;4359;4387;7.12;0.44;264.91;3.86;966;15;1469.00;28
3396;14;22219922;3396;357;4360;4387;7.17;0.44;264.90;3.86;964;15;1470.00;27
3398;14;22219937;3398;359;4361;4388;7.19;0.44;264.85;3.87;963;15;1471.00;27
3400;14;22219952;3400;362;4362;4388;7.19;0.44;264.79;3.87;962;15;1472.00;26
3402;14;22219967;3402;365;4363;4388;7.20;0.44;264.84;3.88;961;15;1473.00;25
3403;14;22219982;3403;365;4363;4388;7.18;0.44;264.89;3.88;960;15;1474.00;25
3404;14;22219997;3404;370;4365;4388;7.14;0.43;264.93;3.89;961;15;1475.00;23
3406;14;22220016;3406;366;4374;4400;7.17;0.44;264.94;3.89;968;15;1476.00;26
3406;14;22220033;3406;368;4375;4400;7.19;0.44;264.94;3.89;969;15;1477.00;25
3408;14;22220047;3408;372;4376;4400;7.20;0.44;264.96;3.89;968;15;1478.00;24
3410;14;22220066;3410;382;4377;4400;7.14;0.43;264.89;3.90;967;15;1479.00;23
3413;14;22220081;3413;367;4379;4400;7.20;0.44;264.82;3.90;966;15;1480.00;21
3414;14;22220097;3414;359;4380;4400;7.26;0.44;264.80;3.90;966;15;1481.00;20
3415;14;22220111;3415;355;4384;4404;7.29;0.44;264.73;3.90;969;15;1482.00;20
3419;14;22220133;3419;345;4384;4404;7.33;0.45;264.62;3.90;965;15;1483.00;20
3421;14;22220150;3421;342;4388;4408;7.36;0.45;264.73;3.90;967;15;1484.00;20
3422;14;22220166;3422;341;4390;4410;7.43;0.45;264.71;3.90;968;15;1485.00;20
3422;14;22220181;3422;347;4390;4410;7.49;0.45;264.71;3.90;968;15;1486.00;20
3422;14;22220196;3422;345;4390;4410;7.53;0.46;264.71;3.90;968;15;1487.00;20
3422;14;22220210;3422;341;4399;4423;7.66;0.46;264.71;3.89;977;15;1488.00;24
3423;14;22220225;3423;336;4399;4423;7.70;0.47;264.69;3.89;976;15;1489.00;24
3428;14;22220239;3428;328;4399;4423;7.69;0.47;264.64;3.89;971;15;1490.00;24
3428;14;22220256;3428;324;4400;4424;7.75;0.47;264.64;3.89;972;15;1491.00;24
3428;14;22220278;3428;323;4400;4425;7.82;0.47;264.64;3.89;972;15;1492.00;25
3429;14;22220292;3429;316;4400;4425;7.88;0.48;264.63;3.89;971;15;1493.00;25
3431;14;22220307;3431;309;4402;4428;7.94;0.48;264.62;3.89;971;15;1494.00;26
3433;14;22220322;3433;301;4402;4428;7.92;0.48;264.61;3.89;969;15;1495.00;26
3435;14;22220337;3435;301;4403;4428;7.96;0.48;264.74;3.89;968;15;1496.00;25
3436;14;22220352;3436;299;4403;4428;7.94;0.48;264.68;3.89;967;15;1497.00;25
3439;14;22220366;3439;303;4408;4434;7.96;0.48;264.71;3.88;969;15;1498.00;26
3441;14;22220382;3441;300;4408;4434;7.95;0.48;264.71;3.88;967;15;1499.00;26
3442;14;22220401;3442;298;4412;4453;7.93;0.48;264.78;3.88;970;15;1500.00;41
3446;14;22220426;3446;290;4412;4453;7.85;0.48;264.81;3.88;966;15;1501.00;41
3449;14;22220440;3449;288;4415;4457;7.80;0.47;264.90;3.88;966;15;1502.00;42
3452;14;22220455;3452;285;4416;4458;7.77;0.47;265.01;3.88;964;15;1503.00;42
3455;14;22220470;3455;278;4416;4458;7.71;0.47;265.12;3.88;961;15;1504.00;42
3457;14;22220485;3457;270;4419;4459;7.67;0.47;265.13;3.90;962;15;1505.00;40
3460;14;22220501;3460;268;4421;4459;7.66;0.46;265.19;3.90;961;15;1506.00;38
3463;14;22220516;3463;262;4421;4459;7.61;0.46;265.25;3.90;958;15;1507.00;38
3467;14;22220532;3467;258;4421;4459;7.55;0.46;265.47;3.90;954;15;1508.00;38
3470;14;22220547;3470;252;4421;4459;7.59;0.46;265.58;3.90;951;15;1509.00;38
3474;14;22220561;3474;256;4421;4459;7.65;0.46;265.75;3.90;947;15;1510.00;38
3476;14;22220575;3476;249;4422;4459;7.72;0.47;265.78;3.90;946;15;1511.00;37
3479;14;22220589;3479;254;4455;4529;7.75;0.47;265.80;3.88;976;15;1512.00;74
3482;14;22220612;3482;237;4455;4530;7.86;0.48;265.90;3.88;973;15;1513.00;75
3485;14;22220625;3485;231;4461;4530;7.94;0.48;265.99;3.87;976;15;1514.00;69
3489;14;22220640;3489;230;4461;4530;7.99;0.49;266.15;3.87;972;15;1515.00;69
3492;14;22220655;3492;225;4466;4530;8.04;0.49;266.13;3.88;974;15;1516.00;64
3495;14;22220671;3495;224;4467;4530;8.06;0.49;266.18;3.88;972;15;1517.00;63
3498;14;22220695;3498;222;4471;4530;8.13;0.49;266.13;3.88;973;15;1518.00;59
3500;14;22220711;3500;216;4474;4530;8.20;0.50;266.24;3.88;974;15;1519.00;56
3501;14;22220724;3501;207;4476;4531;8.28;0.50;266.27;3.89;975;15;1520.00;55
3504;14;22220740;3504;205;4479;4532;8.26;0.50;266.33;3.89;975;15;1521.00;53
3506;14;22220763;3506;208;4484;4532;8.24;0.50;266.43;3.91;978;15;1522.00;48
3507;14;22220776;3507;214;4489;4536;8.25;0.50;266.60;3.91;982;15;1523.00;47
3510;14;22220791;3510;224;4491;4536;8.25;0.50;266.63;3.92;981;15;1524.00;45
3512;14;22220806;3512;216;4492;4536;8.25;0.50;266.61;3.92;980;15;1525.00;44
3514;14;22220821;3514;215;4493;4536;8.19;0.50;266.73;3.94;979;15;1526.00;43
3516;14;22220836;3516;225;4498;4542;8.18;0.49;266.81;3.94;982;15;1527.00;44
3519;14;22220852;3519;229;4500;4542;8.16;0.49;267.06;3.97;981;15;1528.00;42
3524;14;22220875;3524;224;4500;4542;8.15;0.49;267.19;3.97;976;15;1529.00;42
3526;14;22220894;3526;223;4507;4548;8.14;0.49;267.27;4.02;981;15;1530.00;41
3528;14;22220912;3528;223;4511;4548;8.10;0.49;267.22;4.03;983;15;1531.00;37
3531;14;22220927;3531;231;4513;4548;8.03;0.49;267.25;4.05;982;15;1532.00;35
3533;14;22220942;3533;231;4516;4549;7.99;0.48;267.22;4.07;983;15;1533.00;33
3533;14;22220959;3533;230;4518;4550;8.01;0.49;267.22;4.08;985;15;1534.00;32
3535;14;22220975;3535;236;4519;4550;7.98;0.48;267.22;4.11;984;15;1535.00;31
3536;15;22220999;3536;243;4531;4563;7.97;0.48;267.28;4.14;995;16;1536.00;32
3539;15;22221022;3539;240;4532;4563;7.95;0.48;267.32;4.16;993;16;1537.00;31
3540;15;22221038;3540;247;4535;4563;7.88;0.48;267.30;4.21;995;16;1538.00;28
3544;15;22221054;3544;245;4538;4564;7.81;0.47;267.41;4.23;994;16;1539.00;26
3546;15;22221069;3546;251;4540;4564;7.70;0.47;267.42;4.26;994;16;1540.00;24
3547;15;22221084;3547;263;4546;4568;7.66;0.47;267.45;4.28;999;16;1541.00;22
3551;15;22221099;3551;274;4549;4568;7.57;0.46;267.53;4.30;998;16;1542.00;19
3554;15;22221114;3554;274;4552;4572;7.53;0.46;267.51;4.30;998;16;1543.00;20
3558;15;22221133;3558;286;4555;4572;7.45;0.45;267.40;4.32;997;16;1544.00;17
3559;15;22221148;3559;286;4557;4572;7.41;0.45;267.46;4.34;998;16;1545.00;15
3564;15;22221163;3564;287;4559;4572;7.30;0.45;267.67;4.35;995;16;1546.00;13
3566;15;22221179;3566;286;4560;4572;7.30;0.45;267.68;4.35;994;16;1547.00;12
3569;15;22221195;3569;290;4570;4584;7.35;0.45;267.84;4.34;1001;16;1548.00;14
3573;15;22221213;3573;292;4572;4584;7.36;0.45;267.89;4.36;999;16;1549.00;12
3573;15;22221230;3573;291;4573;4584;7.44;0.46;267.89;4.36;1000;16;1550.00;11
3579;15;22221246;3579;285;4574;4584;7.46;0.46;267.91;4.36;995;16;1551.00;10
3581;15;22221263;3581;288;4574;4584;7.46;0.46;267.99;4.36;993;16;1552.00;10
3582;15;22221279;3582;285;4574;4584;7.50;0.46;268.06;4.36;992;16;1553.00;10
3583;15;22221294;3583;286;4577;4585;7.51;0.46;268.10;4.39;994;16;1554.00;8
3584;15;22221314;3584;292;4582;4587;7.51;0.46;268.21;4.39;998;16;1555.00;5
3588;15;22221338;3588;291;4588;4593;7.52;0.46;268.28;4.40;1000;16;1556.00;5
3590;15;22221356;3590;288;4593;4594;7.48;0.46;268.34;4.41;1003;16;1557.00;1
3592;15;22221373;3592;292;4593;4594;7.46;0.46;268.36;4.41;1001;16;1558.00;1
3599;15;22221391;3599;291;4594;4594;7.37;0.45;268.38;4.41;995;16;1559.00;0
3602;15;22221416;3602;292;4599;4599;7.36;0.45;268.43;4.40;997;16;1560.00;0
3606;15;22221434;3606;295;4599;4599;7.32;0.45;268.55;4.40;993;16;1561.00;0
3610;15;22221449;3610;302;4599;4599;7.27;0.44;268.68;4.40;989;16;1562.00;0
3614;15;22221465;3614;300;4600;4600;7.28;0.44;269.05;4.40;986;16;1563.00;0
3618;15;22221481;3618;307;4604;4604;7.22;0.44;269.12;4.40;986;16;1564.00;0
3622;15;22221498;3622;310;4604;4604;7.19;0.44;269.27;4.40;982;16;1565.00;0
3623;15;22221514;3623;318;4606;4607;7.23;0.44;269.23;4.40;983;16;1566.00;1
3628;15;22221531;3628;318;4607;4607;7.20;0.44;269.32;4.39;979;16;1567.00;0
3632;15;22221548;3632;330;4607;4607;7.12;0.43;269.46;4.39;975;16;1568.00;0
3637;15;22221564;3637;326;4607;4607;7.05;0.43;269.41;4.39;970;16;1569.00;0
3641;15;22221581;3641;332;4611;4611;6.97;0.42;269.59;4.39;970;16;1570.00;0
3646;15;22221596;3646;327;4611;4611;6.81;0.42;269.64;4.39;965;16;1571.00;0
3647;15;22221611;3647;322;4611;4611;6.67;0.41;269.72;4.39;964;16;1572.00;0
3652;15;22221626;3652;317;4611;4611;6.54;0.40;269.80;4.39;959;16;1573.00;0
3654;15;22221641;3654;327;4612;4612;6.38;0.39;269.81;4.39;958;16;1574.00;0
3658;15;22221656;3658;317;4614;4614;6.24;0.38;269.85;4.39;956;16;1575.00;0
3662;15;22221669;3662;313;4614;4614;6.14;0.37;269.80;4.39;952;16;1576.00;0
3665;15;22221683;3665;309;4615;4615;6.07;0.37;269.79;4.39;950;16;1577.00;0
3667;15;22221707;3667;305;4615;4615;6.00;0.37;269.84;4.39;948;16;1578.00;0
3670;15;22221721;3670;309;4615;4615;5.93;0.36;269.83;4.39;945;16;1579.00;0
3674;15;22221736;3674;317;4615;4615;5.91;0.36;269.96;4.39;941;16;1580.00;0
3677;15;22221750;3677;315;4615;4615;5.89;0.36;270.03;4.39;938;16;1581.00;0
3680;15;22221764;3680;308;4615;4615;5.93;0.36;270.09;4.39;935;16;1582.00;0
3683;15;22221780;3683;307;4615;4615;5.96;0.36;270.25;4.39;932;16;1583.00;0
3685;15;22221795;3685;317;4689;4742;6.34;0.40;270.33;4.32;1004;16;1584.00;53
3689;15;22221823;3689;312;4697;4743;6.36;0.40;270.51;4.31;1008;16;1585.00;46
3690;15;22221839;3690;315;4704;4743;6.44;0.40;270.58;4.31;1014;16;1586.00;39
3694;15;22221855;3694;317;4709;4743;6.45;0.40;270.69;4.31;1015;16;1587.00;34
3698;15;22221872;3698;323;4715;4743;6.48;0.41;270.71;4.31;1017;16;1588.00;28
3700;15;22221895;3700;321;4716;4743;6.50;0.41;270.81;4.31;1016;16;1589.00;27
3711;15;22221919;3711;327;4718;4743;6.41;0.40;271.07;4.31;1007;16;1590.00;25
3713;15;22221940;3713;331;4721;4743;6.44;0.40;271.09;4.31;1008;16;1591.00;22
3719;15;22221957;3719;336;4723;4744;6.42;0.40;271.35;4.31;1004;16;1592.00;21
3721;15;22221976;3721;336;4726;4745;6.39;0.40;271.27;4.32;1005;16;1593.00;19
3725;15;22221996;3725;333;4729;4745;6.34;0.40;271.38;4.32;1004;16;1594.00;16
3731;15;22222013;3731;342;4731;4746;6.28;0.39;271.56;4.32;1000;16;1595.00;15
3738;15;22222028;3738;341;4735;4746;6.23;0.39;271.75;4.33;997;16;1596.00;11
3742;15;22222044;3742;346;4736;4746;6.22;0.39;271.85;4.33;994;16;1597.00;10
3750;15;22222059;3750;356;4737;4746;6.16;0.38;271.93;4.33;987;16;1598.00;9
3757;15;22222079;3757;360;4742;4750;6.11;0.38;272.04;4.33;985;16;1599.00;8
3760;15;22222101;3760;365;4743;4750;6.11;0.38;272.19;4.33;983;16;1600.00;7
3762;15;22222123;3762;371;4744;4750;6.12;0.38;272.29;4.33;982;16;1601.00;6
3769;15;22222140;3769;370;4746;4753;6.02;0.37;272.51;4.33;977;16;1602.00;7
3776;15;22222158;3776;374;4747;4753;5.95;0.37;272.49;4.33;971;16;1603.00;6
3780;15;22222178;3780;379;4748;4753;5.94;0.37;272.62;4.34;968;16;1604.00;5
3785;15;22222196;3785;388;4751;4757;5.86;0.36;272.70;4.34;966;16;1605.00;6
3789;15;22222213;3789;392;4753;4758;5.79;0.36;272.63;4.34;964;16;1606.00;5
3791;15;22222229;3791;391;4753;4758;5.77;0.36;272.66;4.34;962;16;1607.00;5
3795;15;22222244;3795;403;4756;4762;5.74;0.35;272.69;4.34;961;16;1608.00;6
3799;15;22222261;3799;405;4757;4762;5.70;0.35;272.60;4.34;958;16;1609.00;5
3805;15;22222277;3805;409;4759;4762;5.67;0.35;272.47;4.35;954;16;1610.00;3
3810;15;22222295;3810;414;4760;4763;5.63;0.35;272.53;4.35;950;16;1611.00;3
3814;15;22222314;3814;414;4761;4763;5.56;0.34;272.51;4.35;947;16;1612.00;2
3820;15;22222331;3820;422;4766;4769;5.52;0.34;272.59;4.34;946;16;1613.00;3
3821;15;22222348;3821;419;4766;4769;5.56;0.34;272.60;4.34;945;16;1614.00;3
3828;15;22222363;3828;417;4766;4770;5.53;0.34;272.52;4.34;938;16;1615.00;4
3834;15;22222379;3834;414;4766;4770;5.48;0.34;272.36;4.34;932;16;1616.00;4
3836;15;22222393;3836;413;4766;4770;5.58;0.34;272.41;4.34;930;16;1617.00;4
3839;15;22222406;3839;416;4766;4770;5.58;0.34;272.38;4.34;927;16;1618.00;4
3843;15;22222421;3843;413;4766;4770;5.59;0.34;272.45;4.34;923;16;1619.00;4
3846;15;22222438;3846;419;4794;4806;5.78;0.36;272.37;4.32;948;16;1620.00;12
3849;15;22222456;3849;424;4796;4806;5.79;0.36;272.30;4.32;947;16;1621.00;10
3850;15;22222480;3850;415;4797;4806;5.84;0.36;272.26;4.32;947;16;1622.00;9
3851;15;22222493;3851;405;4798;4806;5.94;0.37;272.20;4.32;947;16;1623.00;8
3854;15;22222507;3854;406;4798;4806;5.94;0.37;272.12;4.32;944;16;1624.00;8
3855;15;22222521;3855;402;4799;4806;6.00;0.37;272.17;4.32;944;16;1625.00;7
3856;15;22222537;3856;406;4802;4810;6.05;0.37;272.11;4.32;946;16;1626.00;8
3858;15;22222553;3858;401;4802;4810;6.09;0.37;272.09;4.32;944;16;1627.00;8
3860;15;22222568;3860;405;4806;4814;6.16;0.38;272.12;4.31;946;16;1628.00;8
3861;15;22222584;3861;411;4807;4815;6.19;0.38;272.06;4.31;946;16;1629.00;8
3863;15;22222599;3863;420;4807;4815;6.12;0.37;272.11;4.31;944;16;1630.00;8
3863;15;22222622;3863;409;4807;4815;6.13;0.38;272.11;4.31;944;16;1631.00;8
3864;15;22222648;3864;398;4818;4828;6.22;0.38;272.08;4.30;954;16;1632.00;10
3866;15;22222673;3866;385;4818;4828;6.23;0.38;272.18;4.30;952;16;1633.00;10
3868;15;22222689;3868;384;4818;4828;6.32;0.39;272.18;4.30;950;16;1634.00;10
3870;15;22222704;3870;380;4819;4829;6.38;0.39;272.15;4.30;949;16;1635.00;10
3873;15;22222728;3873;380;4819;4830;6.37;0.39;272.07;4.30;946;16;1636.00;11
3874;15;22222747;3874;364;4819;4830;6.33;0.39;272.08;4.30;945;16;1637.00;11
3875;15;22222765;3875;350;4821;4833;6.41;0.39;272.07;4.30;946;16;1638.00;12
3876;15;22222785;3876;347;4821;4833;6.41;0.39;272.05;4.30;945;16;1639.00;12
3876;15;22222807;3876;344;4822;4833;6.49;0.40;272.05;4.30;946;16;1640.00;11
3878;15;22222828;3878;342;4822;4833;6.58;0.40;272.02;4.30;944;16;1641.00;11
3878;15;22222849;3878;342;4827;4839;6.71;0.41;272.02;4.30;949;16;1642.00;12
3881;15;22222868;3881;333;4827;4839;6.72;0.41;272.11;4.30;946;16;1643.00;12
3882;15;22222885;3882;331;4827;4839;6.75;0.41;272.14;4.30;945;16;1644.00;12
3884;15;22222902;3884;328;4827;4839;6.79;0.41;272.08;4.30;943;16;1645.00;12
3884;15;22222918;3884;322;4830;4843;6.86;0.42;272.08;4.29;946;16;1646.00;13
3885;15;22222936;3885;321;4831;4844;6.97;0.42;272.06;4.29;946;16;1647.00;13
3887;15;22222952;3887;317;4831;4844;7.07;0.43;272.01;4.29;944;16;1648.00;13
3890;15;22222968;3890;311;4832;4845;7.13;0.43;272.09;4.29;942;16;1649.00;13
3891;15;22222986;3891;309;4832;4845;7.18;0.44;272.11;4.29;941;16;1650.00;13
3891;15;22223017;3891;309;4832;4845;7.26;0.44;272.11;4.29;941;16;1651.00;13
3893;15;22223035;3893;302;4832;4845;7.34;0.45;272.11;4.29;939;16;1652.00;13
3894;15;22223052;3894;300;4832;4845;7.37;0.45;272.12;4.29;938;16;1653.00;13
3898;15;22223068;3898;298;4832;4845;7.41;0.45;272.08;4.29;934;16;1654.00;13
3899;15;22223084;3899;301;4832;4845;7.44;0.45;272.15;4.29;933;16;1655.00;13
3900;15;22223101;3900;306;4868;4915;7.41;0.45;272.20;4.26;968;16;1656.00;47
3900;15;22223124;3900;297;4868;4916;7.49;0.46;272.20;4.26;968;16;1657.00;48
3904;15;22223146;3904;293;4875;4916;7.61;0.46;272.10;4.26;971;16;1658.00;41
3906;15;22223171;3906;292;4879;4916;7.61;0.46;272.14;4.26;973;16;1659.00;37
3909;15;22223189;3909;286;4882;4916;7.60;0.46;272.14;4.26;973;16;1660.00;34
3913;15;22223205;3913;286;4887;4916;7.64;0.46;272.28;4.26;974;16;1661.00;29
3915;15;22223221;3915;285;4890;4916;7.64;0.46;272.40;4.26;975;16;1662.00;26
3917;15;22223247;3917;289;4893;4916;7.67;0.47;272.51;4.26;976;16;1663.00;23
3919;15;22223265;3919;296;4895;4917;7.71;0.47;272.50;4.26;976;16;1664.00;22
3920;15;22223288;3920;292;4897;4919;7.76;0.47;272.45;4.26;977;16;1665.00;22
3923;15;22223305;3923;288;4899;4919;7.75;0.47;272.46;4.26;976;16;1666.00;20
3927;15;22223322;3927;286;4903;4923;7.71;0.47;272.51;4.26;976;16;1667.00;20
3928;15;22223341;3928;281;4904;4923;7.83;0.48;272.55;4.26;976;16;1668.00;19
3932;15;22223357;3932;276;4904;4923;7.84;0.48;272.60;4.26;972;16;1669.00;19
3936;15;22223375;3936;268;4904;4923;7.83;0.48;272.85;4.26;968;16;1670.00;19
3938;15;22223393;3938;268;4908;4929;7.89;0.48;272.77;4.26;970;16;1671.00;21
3939;15;22223412;3939;264;4908;4929;7.92;0.48;272.80;4.26;969;16;1672.00;21
3939;16;22223426;3939;265;4908;4929;7.98;0.48;272.80;4.26;969;17;1673.00;21
3940;16;22223458;3940;261;4910;4932;8.01;0.49;272.81;4.26;970;17;1674.00;22
3943;16;22223477;3943;264;4910;4932;8.05;0.49;272.99;4.26;967;17;1675.00;22
3950;16;22223493;3950;266;4911;4932;8.02;0.48;273.09;4.26;961;17;1676.00;21
3951;16;22223512;3951;264;4911;4933;7.99;0.48;273.11;4.26;960;17;1677.00;22
3955;16;22223528;3955;260;4912;4934;7.93;0.48;273.09;4.26;957;17;1678.00;22
3958;16;22223545;3958;247;4913;4934;7.84;0.47;273.19;4.27;955;17;1679.00;21
3963;16;22223570;3963;251;4933;4960;7.77;0.47;273.39;4.25;970;17;1680.00;27
3967;16;22223591;3967;245;4934;4960;7.75;0.47;273.53;4.27;967;17;1681.00;26
3969;16;22223607;3969;235;4935;4960;7.74;0.47;273.62;4.27;966;17;1682.00;25
3971;16;22223622;3971;226;4937;4961;7.82;0.47;273.75;4.26;966;17;1683.00;24
3973;16;22223639;3973;227;4937;4961;7.89;0.48;273.94;4.26;964;17;1684.00;24
3975;16;22223654;3975;222;4940;4965;7.94;0.48;273.99;4.26;965;17;1685.00;25
3977;16;22223670;3977;220;4940;4965;7.91;0.48;273.95;4.26;963;17;1686.00;25
3979;16;22223686;3979;221;4943;4969;7.92;0.48;274.06;4.26;964;17;1687.00;26
3980;16;22223702;3980;217;4943;4969;7.93;0.48;274.06;4.26;963;17;1688.00;26
3981;16;22223718;3981;213;4943;4969;7.96;0.48;274.07;4.26;962;17;1689.00;26
3982;16;22223732;3982;211;4943;4969;7.99;0.48;274.03;4.26;961;17;1690.00;26
3985;16;22223752;3985;209;4944;4969;8.00;0.48;274.09;4.28;959;17;1691.00;25
3989;16;22223768;3989;207;4953;4981;8.05;0.49;274.11;4.27;964;17;1692.00;28
3989;16;22223783;3989;208;4955;4981;8.08;0.49;274.11;4.28;966;17;1693.00;26
3991;16;22223797;3991;206;4956;4981;8.14;0.49;274.01;4.28;965;17;1694.00;25
3992;16;22223813;3992;207;4956;4981;8.16;0.49;273.95;4.28;964;17;1695.00;25
3993;16;22223825;3993;212;4956;4981;8.17;0.49;273.94;4.28;963;17;1696.00;25
3995;16;22223839;3995;215;4957;4981;8.14;0.49;273.95;4.28;962;17;1697.00;24
3996;16;22223855;3996;215;4957;4982;8.10;0.49;273.91;4.28;961;17;1698.00;25
3998;16;22223870;3998;218;4957;4982;8.02;0.49;273.98;4.28;959;17;1699.00;25
4000;16;22223887;4000;220;4963;4988;8.06;0.49;274.14;4.30;963;17;1700.00;25
4001;16;22223907;4001;220;4965;4989;8.05;0.49;274.18;4.31;964;17;1701.00;24
4003;16;22223935;4003;224;4965;4989;8.02;0.49;274.23;4.31;962;17;1702.00;24
4003;16;22223951;4003;221;4966;4989;8.00;0.49;274.23;4.31;963;17;1703.00;23
4003;16;22223966;4003;226;4972;4993;8.02;0.49;274.23;4.32;969;17;1704.00;21
4005;16;22223982;4005;229;4973;4993;7.96;0.48;274.24;4.34;968;17;1705.00;20
4008;16;22223997;4008;228;4973;4993;7.96;0.48;274.25;4.34;965;17;1706.00;20
4011;16;22224020;4011;225;4976;4994;8.01;0.49;274.30;4.37;965;17;1707.00;18
4015;16;22224036;4015;233;4979;4998;7.98;0.48;274.22;4.37;964;17;1708.00;19
4016;16;22224052;4016;232;4980;4998;7.97;0.49;274.23;4.37;964;17;1709.00;18
4018;16;22224070;4018;236;4985;5004;8.01;0.49;274.35;4.39;967;17;1710.00;19
4021;16;22224086;4021;236;4986;5004;8.02;0.49;274.40;4.38;965;17;1711.00;18
4024;16;22224102;4024;237;4987;5004;8.03;0.49;274.36;4.38;963;17;1712.00;17
4025;16;22224118;4025;236;4989;5004;8.01;0.49;274.35;4.40;964;17;1713.00;15
4027;16;22224141;4027;232;4993;5008;8.06;0.49;274.44;4.40;966;17;1714.00;15
4028;16;22224157;4028;232;4994;5008;7.99;0.49;274.48;4.41;966;17;1715.00;14
4032;16;22224181;4032;235;4994;5008;7.96;0.49;274.38;4.41;962;17;1716.00;14
4035;16;22224196;4035;234;4995;5008;7.89;0.48;274.39;4.43;960;17;1717.00;13
4037;16;22224212;4037;234;4995;5009;7.89;0.48;274.52;4.43;958;17;1718.00;14
4039;16;22224226;4039;242;4999;5010;7.86;0.48;274.66;4.47;960;17;1719.00;11
4041;16;22224239;4041;241;4999;5010;7.79;0.48;274.73;4.47;958;17;1720.00;11
4041;16;22224254;4041;246;5001;5011;7.75;0.48;274.73;4.48;960;17;1721.00;10
4043;16;22224268;4043;250;5004;5011;7.62;0.47;274.79;4.50;961;17;1722.00;7
4046;16;22224282;4046;253;5004;5011;7.51;0.46;274.94;4.50;958;17;1723.00;7
4050;16;22224295;4050;250;5005;5011;7.44;0.46;274.87;4.51;955;17;1724.00;6
4055;16;22224317;4055;249;5005;5011;7.37;0.45;274.92;4.51;950;17;1725.00;6
4060;16;22224331;4060;250;5005;5011;7.33;0.45;274.90;4.51;945;17;1726.00;6
4063;16;22224347;4063;250;5006;5011;7.32;0.45;274.93;4.52;943;17;1727.00;5
4066;16;22224362;4066;265;5075;5138;7.51;0.47;275.00;4.47;1009;17;1728.00;63
4070;16;22224387;4070;251;5080;5139;7.54;0.47;275.11;4.46;1010;17;1729.00;59
4072;16;22224403;4072;246;5090;5139;7.66;0.47;275.13;4.46;1018;17;1730.00;49
4074;16;22224418;4074;241;5090;5139;7.62;0.47;275.04;4.46;1016;17;1731.00;49
4075;16;22224432;4075;247;5098;5139;7.63;0.47;275.07;4.47;1023;17;1732.00;41
4078;16;22224447;4078;247;5098;5139;7.58;0.47;275.10;4.47;1020;17;1733.00;41
4078;16;22224461;4078;249;5101;5139;7.71;0.47;275.10;4.47;1023;17;1734.00;38
4082;16;22224474;4082;254;5107;5139;7.74;0.48;275.06;4.48;1025;17;1735.00;32
4086;16;22224489;4086;257;5110;5140;7.78;0.48;275.15;4.48;1024;17;1736.00;30
4089;16;22224505;4089;257;5113;5141;7.86;0.48;275.23;4.48;1024;17;1737.00;28
4092;16;22224521;4092;249;5116;5141;7.90;0.48;275.23;4.49;1024;17;1738.00;25
4097;16;22224535;4097;247;5122;5142;7.85;0.48;275.37;4.49;1025;17;1739.00;20
4098;16;22224560;4098;246;5125;5142;7.77;0.48;275.31;4.50;1027;17;1740.00;17
4105;16;22224573;4105;254;5127;5142;7.62;0.47;275.66;4.50;1022;17;1741.00;15
4109;16;22224602;4109;256;5132;5142;7.45;0.46;275.68;4.51;1023;17;1742.00;10
4112;16;22224623;4112;263;5136;5146;7.28;0.45;275.68;4.51;1024;17;1743.00;10
4116;16;22224643;4116;275;5137;5146;7.14;0.44;275.80;4.51;1021;17;1744.00;9
4121;16;22224667;4121;288;5138;5146;7.01;0.43;275.93;4.51;1017;17;1745.00;8
4125;16;22224681;4125;298;5140;5149;6.90;0.42;276.00;4.51;1015;17;1746.00;9
4128;16;22224697;4128;310;5142;5149;6.78;0.42;276.05;4.52;1014;17;1747.00;7
4133;16;22224710;4133;324;5144;5149;6.64;0.41;276.15;4.52;1011;17;1748.00;5
4136;16;22224724;4136;335;5149;5153;6.47;0.40;276.22;4.52;1013;17;1749.00;4
4138;16;22224739;4138;326;5151;5154;6.39;0.39;276.21;4.53;1013;17;1750.00;3
4143;16;22224760;4143;331;5151;5154;6.33;0.39;276.32;4.53;1008;17;1751.00;3
4146;16;22224789;4146;333;5155;5158;6.33;0.39;276.33;4.52;1009;17;1752.00;3
4149;16;22224817;4149;335;5158;5158;6.31;0.39;276.40;4.52;1009;17;1753.00;0
4153;16;22224837;4153;343;5158;5158;6.28;0.39;276.49;4.52;1005;17;1754.00;0
4157;16;22224863;4157;347;5160;5160;6.18;0.38;276.64;4.52;1003;17;1755.00;0
4161;16;22224887;4161;360;5160;5160;6.09;0.37;276.75;4.52;999;17;1756.00;0
4164;16;22224906;4164;362;5166;5166;6.08;0.37;276.93;4.52;1002;17;1757.00;0
4165;16;22224927;4165;362;5166;5166;6.06;0.37;276.99;4.52;1001;17;1758.00;0
4171;16;22224947;4171;360;5167;5167;6.04;0.37;276.94;4.52;996;17;1759.00;0
4174;16;22224967;4174;357;5167;5167;6.06;0.37;277.05;4.52;993;17;1760.00;0
4177;16;22224984;4177;358;5167;5167;6.02;0.37;277.13;4.52;990;17;1761.00;0
4180;16;22225006;4180;358;5167;5167;5.94;0.36;277.13;4.52;987;17;1762.00;0
4184;16;22225025;4184;366;5167;5167;5.87;0.36;277.22;4.52;983;17;1763.00;0
4185;16;22225049;4185;373;5178;5179;5.94;0.36;277.27;4.51;993;17;1764.00;1
4189;16;22225076;4189;375;5179;5179;5.91;0.36;277.37;4.51;990;17;1765.00;0
4193;16;22225098;4193;387;5179;5179;5.85;0.36;277.43;4.51;986;17;1766.00;0
4197;16;22225118;4197;385;5179;5179;5.79;0.36;277.38;4.51;982;17;1767.00;0
4205;16;22225133;4205;390;5179;5179;5.69;0.35;277.50;4.51;974;17;1768.00;0
4207;16;22225149;4207;393;5179;5179;5.66;0.35;277.51;4.51;972;17;1769.00;0
4213;16;22225168;4213;401;5183;5183;5.58;0.34;277.55;4.51;970;17;1770.00;0
4217;16;22225189;4217;409;5183;5183;5.50;0.34;277.64;4.51;966;17;1771.00;0
4222;16;22225206;4222;410;5187;5187;5.47;0.34;277.56;4.50;965;17;1772.00;0
4226;16;22225227;4226;423;5188;5188;5.38;0.33;277.59;4.50;962;17;1773.00;0
4231;16;22225244;4231;427;5188;5188;5.29;0.32;277.58;4.50;957;17;1774.00;0
4236;16;22225267;4236;435;5188;5188;5.14;0.32;277.53;4.50;952;17;1775.00;0
4239;16;22225289;4239;441;5201;5201;5.21;0.32;277.58;4.49;962;17;1776.00;0
4242;16;22225310;4242;445;5201;5201;5.19;0.32;277.51;4.49;959;17;1777.00;0
4245;16;22225334;4245;453;5201;5201;5.20;0.32;277.52;4.49;956;17;1778.00;0
4248;16;22225353;4248;454;5202;5202;5.20;0.32;277.45;4.49;954;17;1779.00;0
4252;16;22225373;4252;460;5203;5203;5.14;0.32;277.37;4.49;951;17;1780.00;0
4257;16;22225392;4257;465;5203;5203;5.11;0.31;277.30;4.49;946;17;1781.00;0
4262;16;22225414;4262;466;5205;5206;5.09;0.31;277.24;4.49;943;17;1782.00;1
4264;16;22225434;4264;469;5205;5206;5.01;0.31;277.23;4.49;941;17;1783.00;1
4267;16;22225453;4267;472;5206;5206;5.00;0.31;277.13;4.49;939;17;1784.00;0
4272;16;22225474;4272;473;5206;5206;4.88;0.30;277.18;4.49;934;17;1785.00;0
4273;16;22225495;4273;482;5211;5212;4.91;0.30;277.17;4.48;938;17;1786.00;1
4276;16;22225517;4276;488;5211;5212;4.85;0.29;277.15;4.48;935;17;1787.00;1
4280;16;22225534;4280;491;5211;5212;4.81;0.29;277.13;4.48;931;17;1788.00;1
4282;16;22225556;4282;492;5211;5212;4.77;0.29;277.17;4.48;929;17;1789.00;1
4285;16;22225572;4285;492;5214;5216;4.80;0.29;277.10;4.48;929;17;1790.00;2
4286;16;22225589;4286;495;5215;5217;4.81;0.29;277.21;4.48;929;17;1791.00;2
4287;16;22225607;4287;501;5215;5217;4.76;0.29;277.23;4.48;928;17;1792.00;2
4290;16;22225627;4290;502;5216;5218;4.73;0.29;277.26;4.48;926;17;1793.00;2
4291;16;22225649;4291;499;5216;5218;4.73;0.29;277.40;4.48;925;17;1794.00;2
4293;16;22225671;4293;497;5216;5218;4.74;0.29;277.36;4.48;923;17;1795.00;2
4295;16;22225697;4295;489;5216;5218;4.78;0.29;277.33;4.48;921;17;1796.00;2
4296;16;22225728;4296;472;5216;5218;4.80;0.29;277.28;4.48;920;17;1797.00;2
4297;16;22225757;4297;458;5216;5218;4.86;0.30;277.28;4.48;919;17;1798.00;2
4297;16;22225774;4297;441;5216;5218;5.01;0.31;277.28;4.48;919;17;1799.00;2
4298;16;22225803;4298;445;5287;5356;5.52;0.34;277.28;4.42;989;17;1800.00;69
4301;16;22225851;4301;431;5291;5357;5.67;0.35;277.38;4.42;990;17;1801.00;66
4302;16;22225876;4302;418;5302;5357;5.89;0.36;277.36;4.41;1000;17;1802.00;55
4303;16;22225893;4303;419;5307;5357;6.07;0.37;277.38;4.41;1004;17;1803.00;50
4304;16;22225918;4304;418;5312;5357;6.21;0.38;277.36;4.41;1008;17;1804.00;45
4306;16;22225935;4306;410;5313;5357;6.28;0.39;277.40;4.41;1007;17;1805.00;44
4307;16;22225950;4307;397;5320;5357;6.34;0.39;277.41;4.41;1013;17;1806.00;37
4309;16;22225968;4309;386;5324;5357;6.36;0.39;277.42;4.41;1015;17;1807.00;33
4311;17;22225984;4311;376;5331;5358;6.41;0.39;277.46;4.42;1020;18;1808.00;27
4312;17;22226016;4312;371;5334;5359;6.42;0.39;277.46;4.42;1022;18;1809.00;25
4312;17;22226032;4312;368;5337;5359;6.44;0.40;277.46;4.42;1025;18;1810.00;22
4313;17;22226049;4313;366;5340;5363;6.46;0.40;277.43;4.42;1027;18;1811.00;23
4313;18;22226064;4313;368;5343;5363;6.50;0.40;277.43;4.42;1030;19;1812.00;20
4315;18;22226095;4315;373;5343;5363;6.52;0.40;277.48;4.42;1028;19;1813.00;20
4316;20;22226107;4316;371;5344;5363;6.57;0.40;277.62;4.43;1028;21;1814.00;19
4318;20;22226152;4318;378;5349;5369;6.62;0.41;277.69;4.42;1031;21;1815.00;20
4320;20;22226169;4320;383;5351;5369;6.69;0.41;277.67;4.43;1031;21;1816.00;18
4324;20;22226186;4324;386;5351;5369;6.77;0.41;277.80;4.43;1027;21;1817.00;18
4326;20;22226211;4326;388;5354;5372;6.88;0.42;277.84;4.43;1028;21;1818.00;18
4330;20;22226233;4330;383;5354;5372;6.96;0.43;277.90;4.43;1024;21;1819.00;18
4334;20;22226251;4334;380;5354;5372;6.95;0.42;277.99;4.43;1020;21;1820.00;18
4336;20;22226269;4336;381;5355;5373;6.99;0.43;277.99;4.43;1019;21;1821.00;18
4337;20;22226285;4337;376;5358;5374;7.07;0.43;277.99;4.43;1021;21;1822.00;16
4339;20;22226308;4339;373;5358;5374;7.11;0.43;278.22;4.43;1019;21;1823.00;16
4340;20;22226325;4340;371;5366;5387;7.13;0.44;278.27;4.43;1026;21;1824.00;21
4340;20;22226345;4340;368;5367;5387;7.18;0.44;278.27;4.43;1027;21;1825.00;20
4344;20;22226359;4344;361;5367;5387;7.16;0.44;278.55;4.43;1023;21;1826.00;20
4344;20;22226374;4344;361;5368;5388;7.18;0.44;278.55;4.43;1024;21;1827.00;20
4348;20;22226390;4348;358;5369;5388;7.14;0.44;278.68;4.43;1021;21;1828.00;19
4350;20;22226419;4350;356;5372;5392;7.25;0.44;278.76;4.43;1022;21;1829.00;20
4352;20;22226443;4352;359;5372;5392;7.31;0.45;278.67;4.43;1020;21;1830.00;20
4355;20;22226463;4355;353;5377;5396;7.27;0.44;278.85;4.43;1022;21;1831.00;19
4356;20;22226483;4356;357;5378;5396;7.32;0.45;278.93;4.43;1022;21;1832.00;18
4359;20;22226504;4359;356;5378;5396;7.38;0.45;278.98;4.43;1019;21;1833.00;18
4362;20;22226523;4362;351;5378;5396;7.34;0.45;279.00;4.43;1016;21;1834.00;18
4363;20;22226543;4363;350;5378;5396;7.34;0.45;279.09;4.43;1015;21;1835.00;18
4368;20;22226568;4368;350;5388;5408;7.36;0.45;279.22;4.42;1020;21;1836.00;20
4370;20;22226590;4370;351;5388;5408;7.36;0.45;279.27;4.42;1018;21;1837.00;20
4376;20;22226610;4376;352;5389;5408;7.34;0.45;279.31;4.42;1013;21;1838.00;19
4379;20;22226632;4379;352;5389;5408;7.33;0.45;279.45;4.42;1010;21;1839.00;19
4384;20;22226650;4384;338;5389;5408;7.36;0.45;279.67;4.42;1005;21;1840.00;19
4388;20;22226671;4388;336;5389;5408;7.45;0.45;279.84;4.42;1001;21;1841.00;19
4390;20;22226689;4390;333;5389;5409;7.49;0.46;279.91;4.42;999;21;1842.00;20
4394;20;22226707;4394;334;5389;5409;7.52;0.46;280.02;4.42;995;21;1843.00;20
4396;20;22226724;4396;324;5394;5415;7.58;0.46;280.06;4.42;998;21;1844.00;21
4399;20;22226741;4399;317;5396;5417;7.58;0.46;280.09;4.41;997;21;1845.00;21
4404;20;22226758;4404;313;5396;5417;7.58;0.46;280.26;4.41;992;21;1846.00;21
4406;20;22226779;4406;314;5396;5417;7.59;0.46;280.31;4.41;990;21;1847.00;21
4410;20;22226802;4410;309;5399;5421;7.63;0.46;280.38;4.41;989;21;1848.00;22
4412;20;22226819;4412;307;5399;5421;7.68;0.47;280.43;4.41;987;21;1849.00;22
4416;20;22226837;4416;304;5399;5421;7.69;0.47;280.51;4.41;983;21;1850.00;22
4417;20;22226854;4417;304;5400;5422;7.68;0.47;280.56;4.41;983;21;1851.00;22
4420;20;22226869;4420;304;5403;5426;7.61;0.46;280.64;4.41;983;21;1852.00;23
4423;20;22226887;4423;301;5403;5426;7.59;0.46;280.61;4.41;980;21;1853.00;23
4423;20;22226903;4423;292;5405;5429;7.63;0.46;280.61;4.41;982;21;1854.00;24
4427;20;22226918;4427;287;5408;5429;7.62;0.46;280.62;4.43;981;21;1855.00;21
4432;20;22226934;4432;280;5408;5429;7.58;0.46;280.67;4.43;976;21;1856.00;21
4434;20;22226954;4434;274;5408;5429;7.59;0.46;280.70;4.43;974;21;1857.00;21
4438;20;22226969;4438;269;5412;5433;7.65;0.47;280.78;4.42;974;21;1858.00;21
4445;20;22226983;4445;261;5412;5433;7.65;0.47;280.98;4.42;967;21;1859.00;21
4447;20;22227000;4447;260;5412;5433;7.71;0.47;280.97;4.42;965;21;1860.00;21
4449;20;22227015;4449;261;5412;5433;7.74;0.47;281.10;4.42;963;21;1861.00;21
4451;20;22227029;4451;260;5412;5434;7.80;0.48;281.13;4.42;961;21;1862.00;22
4456;20;22227045;4456;253;5413;5435;7.85;0.48;281.05;4.42;957;21;1863.00;22
4460;20;22227058;4460;248;5413;5435;7.93;0.48;280.98;4.42;953;21;1864.00;22
4466;20;22227073;4466;254;5414;5436;7.93;0.48;281.09;4.42;948;21;1865.00;22
4469;20;22227091;4469;253;5414;5436;7.90;0.48;281.19;4.42;945;21;1866.00;22
4472;20;22227106;4472;247;5414;5436;7.93;0.48;281.21;4.42;942;21;1867.00;22
4477;20;22227121;4477;248;5414;5436;7.90;0.48;281.36;4.42;937;21;1868.00;22
4481;20;22227135;4481;251;5414;5436;7.89;0.48;281.46;4.42;933;21;1869.00;22
4483;20;22227150;4483;252;5414;5436;7.93;0.48;281.44;4.42;931;21;1870.00;22
4487;20;22227164;4487;256;5414;5436;7.93;0.48;281.50;4.42;927;21;1871.00;22
4491;20;22227178;4491;279;5479;5563;7.91;0.49;281.53;4.38;988;21;1872.00;84
4493;20;22227204;4493;260;5482;5564;7.90;0.49;281.68;4.38;989;21;1873.00;82
4497;20;22227220;4497;256;5488;5564;8.00;0.49;281.73;4.38;991;21;1874.00;76
4498;20;22227234;4498;255;5492;5564;8.03;0.50;281.79;4.38;994;21;1875.00;72
4500;20;22227249;4500;258;5495;5564;8.06;0.50;281.89;4.38;995;21;1876.00;69
4504;20;22227265;4504;256;5500;5564;8.09;0.50;281.97;4.38;996;21;1877.00;64
4509;20;22227282;4509;256;5501;5564;8.05;0.49;281.99;4.38;992;21;1878.00;63
4511;20;22227300;4511;247;5505;5564;8.12;0.50;282.07;4.38;994;21;1879.00;59
4515;20;22227317;4515;250;5512;5565;8.07;0.49;282.00;4.41;997;21;1880.00;53
4517;20;22227333;4517;253;5516;5566;8.10;0.50;282.13;4.42;999;21;1881.00;50
4521;20;22227350;4521;256;5521;5568;8.13;0.50;282.13;4.43;1000;21;1882.00;47
4522;20;22227367;4522;253;5525;5569;8.10;0.50;282.11;4.45;1003;21;1883.00;44
4526;20;22227384;4526;256;5527;5569;8.03;0.49;282.18;4.47;1001;21;1884.00;42
4526;20;22227401;4526;254;5530;5569;8.04;0.49;282.18;4.50;1004;21;1885.00;39
4529;20;22227431;4529;255;5537;5569;7.99;0.49;282.29;4.51;1008;21;1886.00;32
4532;20;22227453;4532;253;5541;5573;7.92;0.48;282.31;4.52;1009;21;1887.00;32
4534;20;22227477;4534;259;5544;5573;7.85;0.48;282.37;4.54;1010;21;1888.00;29
4538;20;22227498;4538;272;5547;5573;7.75;0.47;282.56;4.55;1009;21;1889.00;26
4538;20;22227518;4538;280;5552;5579;7.68;0.47;282.56;4.57;1014;21;1890.00;27
4541;20;22227535;4541;281;5553;5579;7.59;0.46;282.66;4.56;1012;21;1891.00;26
4543;20;22227552;4543;288;5555;5579;7.46;0.46;282.66;4.59;1012;21;1892.00;24
4544;20;22227568;4544;291;5558;5583;7.33;0.45;282.76;4.59;1014;21;1893.00;25
4547;20;22227584;4547;296;5563;5584;7.27;0.45;282.75;4.63;1016;21;1894.00;21
4550;20;22227608;4550;303;5563;5584;7.20;0.44;282.90;4.63;1013;21;1895.00;21
4556;20;22227626;4556;303;5568;5588;7.14;0.44;282.90;4.64;1012;21;1896.00;20
4557;20;22227647;4557;308;5572;5588;7.10;0.44;282.95;4.65;1015;21;1897.00;16
4560;20;22227665;4560;316;5573;5588;7.07;0.43;282.92;4.65;1013;21;1898.00;15
4560;20;22227684;4560;313;5575;5589;7.01;0.43;282.92;4.66;1015;21;1899.00;14
4564;20;22227702;4564;307;5578;5589;6.97;0.43;282.92;4.68;1014;21;1900.00;11
4566;20;22227722;4566;312;5582;5595;6.97;0.43;282.98;4.67;1016;21;1901.00;13
4571;20;22227741;4571;309;5585;5595;6.93;0.43;283.07;4.68;1014;21;1902.00;10
4573;20;22227760;4573;314;5586;5596;6.92;0.42;283.01;4.69;1013;21;1903.00;10
4578;20;22227776;4578;314;5587;5596;6.90;0.42;283.15;4.69;1009;21;1904.00;9
4581;20;22227791;4581;317;5588;5596;6.90;0.42;283.36;4.70;1007;21;1905.00;8
4585;20;22227804;4585;320;5588;5596;6.79;0.42;283.39;4.70;1003;21;1906.00;8
4589;20;22227819;4589;324;5589;5596;6.67;0.41;283.55;4.70;1000;21;1907.00;7
4592;20;22227833;4592;328;5601;5608;6.70;0.41;283.67;4.70;1009;21;1908.00;7
4594;20;22227847;4594;329;5601;5608;6.73;0.41;283.77;4.70;1007;21;1909.00;7
4597;20;22227859;4597;334;5603;5608;6.67;0.41;283.80;4.70;1006;21;1910.00;5
4600;20;22227873;4600;335;5603;5608;6.70;0.41;283.75;4.70;1003;21;1911.00;5
4604;20;22227890;4604;337;5603;5608;6.70;0.41;283.73;4.70;999;21;1912.00;5
4609;20;22227906;4609;340;5604;5608;6.65;0.41;283.76;4.71;995;21;1913.00;4
4613;20;22227921;4613;350;5607;5612;6.58;0.40;283.73;4.71;994;21;1914.00;5
4617;20;22227937;4617;351;5607;5612;6.52;0.40;283.79;4.71;990;21;1915.00;5
4622;20;22227949;4622;361;5614;5616;6.42;0.39;283.73;4.71;992;21;1916.00;2
4625;20;22227965;4625;370;5615;5617;6.33;0.39;283.69;4.71;990;21;1917.00;2
4629;20;22227984;4629;377;5616;5617;6.22;0.38;283.64;4.71;987;21;1918.00;1
4631;20;22227997;4631;383;5617;5617;6.14;0.38;283.58;4.71;986;21;1919.00;0
4634;20;22228011;4634;389;5638;5646;6.12;0.38;283.55;4.70;1004;21;1920.00;8
4638;20;22228026;4638;388;5639;5646;6.05;0.37;283.44;4.69;1001;21;1921.00;7
4642;20;22228037;4642;391;5642;5646;5.93;0.37;283.38;4.69;1000;21;1922.00;4
4646;20;22228050;4646;394;5645;5647;5.85;0.36;283.39;4.69;999;21;1923.00;2
4649;20;22228061;4649;395;5646;5648;5.74;0.35;283.27;4.69;997;21;1924.00;2
4653;20;22228072;4653;388;5646;5648;5.67;0.35;283.23;4.69;993;21;1925.00;2
4657;20;22228085;4657;387;5649;5651;5.64;0.35;283.19;4.69;992;21;1926.00;2
4659;20;22228097;4659;380;5649;5651;5.59;0.35;283.19;4.69;990;21;1927.00;2
4663;20;22228107;4663;377;5649;5651;5.53;0.34;283.22;4.69;986;21;1928.00;2
4664;20;22228120;4664;381;5649;5651;5.49;0.34;283.26;4.69;985;21;1929.00;2
4668;20;22228132;4668;386;5653;5657;5.45;0.34;283.29;4.69;985;21;1930.00;4
4673;20;22228147;4673;392;5654;5657;5.40;0.33;283.17;4.69;981;21;1931.00;3
4678;20;22228164;4678;388;5654;5657;5.30;0.33;283.03;4.69;976;21;1932.00;3
4681;20;22228179;4681;384;5654;5657;5.22;0.32;283.04;4.69;973;21;1933.00;3
4684;20;22228190;4684;385;5657;5661;5.18;0.32;282.98;4.68;973;21;1934.00;4
4686;20;22228202;4686;386;5659;5663;5.11;0.31;282.95;4.68;973;21;1935.00;4
4692;20;22228215;4692;385;5659;5663;5.01;0.31;282.93;4.68;967;21;1936.00;4
4694;20;22228227;4694;394;5660;5664;4.98;0.31;282.84;4.68;966;21;1937.00;4
4695;20;22228238;4695;403;5660;5664;4.98;0.31;282.79;4.68;965;21;1938.00;4
4700;20;22228251;4700;406;5660;5664;4.92;0.30;282.68;4.68;960;21;1939.00;4
4701;20;22228263;4701;405;5660;5664;4.95;0.30;282.70;4.68;959;21;1940.00;4
4702;20;22228273;4702;418;5660;5664;4.97;0.31;282.73;4.68;958;21;1941.00;4
4702;20;22228285;4702;418;5660;5664;5.03;0.31;282.73;4.68;958;21;1942.00;4
4706;20;22228296;4706;428;5660;5664;5.02;0.31;282.77;4.68;954;21;1943.00;4
4711;20;22228306;4711;438;5702;5734;5.15;0.32;282.77;4.65;991;21;1944.00;32
4711;20;22228324;4711;441;5702;5735;5.24;0.32;282.77;4.65;991;21;1945.00;33
4716;20;22228337;4716;440;5708;5735;5.28;0.32;282.85;4.64;992;21;1946.00;27
4719;20;22228349;4719;445;5709;5735;5.32;0.33;282.96;4.64;990;21;1947.00;26
4726;20;22228361;4726;443;5711;5735;5.32;0.33;282.89;4.64;985;21;1948.00;24
4732;20;22228373;4732;442;5712;5735;5.31;0.33;282.96;4.64;980;21;1949.00;23
4737;20;22228388;4737;448;5718;5737;5.28;0.32;282.95;4.64;981;21;1950.00;19
4739;20;22228402;4739;430;5719;5737;5.25;0.32;282.99;4.64;980;21;1951.00;18
4740;20;22228416;4740;424;5721;5738;5.30;0.32;283.03;4.65;981;21;1952.00;17
4743;20;22228430;4743;415;5724;5739;5.30;0.32;283.10;4.65;981;21;1953.00;15
4745;20;22228442;4745;415;5726;5739;5.39;0.33;283.16;4.65;981;21;1954.00;13
4748;20;22228456;4748;413;5731;5743;5.48;0.34;283.17;4.65;983;21;1955.00;12
4752;20;22228470;4752;414;5731;5743;5.52;0.34;283.13;4.65;979;21;1956.00;12
4754;20;22228484;4754;412;5733;5743;5.66;0.35;283.15;4.65;979;21;1957.00;10
4759;20;22228497;4759;414;5733;5743;5.65;0.34;283.16;4.65;974;21;1958.00;10
4760;20;22228511;4760;417;5738;5749;5.76;0.35;283.12;4.65;978;21;1959.00;11
4762;20;22228524;4762;419;5738;5749;5.82;0.36;283.04;4.65;976;21;1960.00;11
4764;20;22228547;4764;413;5739;5749;5.87;0.36;282.97;4.65;975;21;1961.00;10
4765;20;22228563;4765;412;5740;5752;5.91;0.36;282.92;4.65;975;21;1962.00;12
4769;20;22228577;4769;413;5741;5752;5.94;0.36;282.93;4.65;972;21;1963.00;11
4774;20;22228591;4774;412;5742;5752;5.90;0.36;282.90;4.65;968;21;1964.00;10
4775;20;22228607;4775;412;5742;5753;5.88;0.36;282.95;4.65;967;21;1965.00;11
4776;20;22228621;4776;409;5743;5754;5.92;0.36;282.98;4.65;967;21;1966.00;11
4778;20;22228634;4778;418;5743;5754;5.92;0.36;282.87;4.65;965;21;1967.00;11
4780;20;22228647;4780;418;5753;5767;5.98;0.36;282.89;4.64;973;21;1968.00;14
4781;20;22228660;4781;420;5754;5767;5.93;0.36;282.92;4.64;973;21;1969.00;13
4782;20;22228673;4782;427;5754;5767;5.90;0.36;282.86;4.64;972;21;1970.00;13
4782;20;22228689;4782;434;5755;5768;5.91;0.36;282.86;4.64;973;21;1971.00;13
4784;20;22228703;4784;427;5755;5768;5.95;0.36;282.88;4.64;971;21;1972.00;13
4786;20;22228717;4786;422;5759;5772;5.97;0.36;283.00;4.63;973;21;1973.00;13
4788;20;22228730;4788;411;5759;5772;5.93;0.36;282.98;4.63;971;21;1974.00;13
4789;20;22228745;4789;410;5762;5776;5.89;0.36;282.98;4.63;973;21;1975.00;14
4791;20;22228757;4791;403;5762;5776;5.90;0.36;282.98;4.63;971;21;1976.00;14
4791;20;22228771;4791;401;5762;5776;5.95;0.36;282.98;4.63;971;21;1977.00;14
4792;20;22228788;4792;403;5762;5776;6.02;0.37;282.98;4.63;970;21;1978.00;14
4795;20;22228802;4795;407;5762;5776;6.07;0.37;283.20;4.63;967;21;1979.00;14
4796;20;22228818;4796;403;5789;5810;6.26;0.38;283.16;4.61;993;21;1980.00;21
4800;20;22228833;4800;388;5790;5810;6.34;0.39;283.28;4.61;990;21;1981.00;20
4801;20;22228849;4801;379;5792;5810;6.46;0.39;283.24;4.61;991;21;1982.00;18
4804;20;22228862;4804;365;5792;5810;6.52;0.40;283.33;4.61;988;21;1983.00;18
4805;20;22228878;4805;360;5793;5810;6.62;0.40;283.34;4.61;988;21;1984.00;17
4810;20;22228891;4810;358;5793;5810;6.68;0.41;283.59;4.61;983;21;1985.00;17
4811;20;22228906;4811;359;5793;5811;6.68;0.41;283.65;4.61;982;21;1986.00;18
4811;20;22228921;4811;357;5793;5811;6.71;0.41;283.65;4.61;982;21;1987.00;18
4813;20;22228936;4813;354;5798;5817;6.72;0.41;283.67;4.61;985;21;1988.00;19
4815;20;22228952;4815;357;5799;5818;6.72;0.41;283.72;4.61;984;21;1989.00;19
4817;20;22228974;4817;357;5799;5818;6.72;0.41;283.80;4.61;982;21;1990.00;19
4819;20;22228989;4819;364;5799;5818;6.68;0.41;283.92;4.61;980;21;1991.00;19
4822;20;22229004;4822;359;5801;5822;6.65;0.40;283.97;4.60;979;21;1992.00;21
4825;20;22229026;4825;358;5802;5822;6.63;0.40;284.07;4.60;977;21;1993.00;20
4829;20;22229040;4829;357;5802;5822;6.72;0.41;284.03;4.60;973;21;1994.00;20
4831;20;22229056;4831;356;5803;5823;6.73;0.41;284.15;4.60;972;21;1995.00;20
4833;20;22229070;4833;357;5806;5827;6.81;0.41;284.17;4.60;973;21;1996.00;21
4836;20;22229088;4836;353;5806;5827;6.85;0.41;284.26;4.60;970;21;1997.00;21
4837;20;22229103;4837;344;5808;5830;6.89;0.42;284.36;4.60;971;21;1998.00;22
4837;20;22229118;4837;345;5808;5830;6.95;0.42;284.36;4.60;971;21;1999.00;22
4840;20;22229135;4840;346;5809;5830;6.98;0.42;284.55;4.60;969;21;2000.00;21
4841;20;22229157;4841;341;5809;5830;7.04;0.43;284.54;4.60;968;21;2001.00;21
4843;20;22229175;4843;349;5813;5834;7.15;0.43;284.68;4.60;970;21;2002.00;21
4844;20;22229193;4844;345;5813;5834;7.21;0.44;284.74;4.60;969;21;2003.00;21
4848;20;22229213;4848;345;5813;5834;7.25;0.44;284.84;4.60;965;21;2004.00;21
4849;20;22229232;4849;349;5813;5834;7.23;0.44;284.88;4.60;964;21;2005.00;21
4851;20;22229251;4851;349;5813;5835;7.24;0.44;284.93;4.60;962;21;2006.00;22
4851;20;22229279;4851;349;5814;5836;7.30;0.44;284.93;4.60;963;21;2007.00;22
4852;20;22229296;4852;357;5814;5836;7.28;0.44;284.98;4.60;962;21;2008.00;22
4854;20;22229313;4854;351;5815;5837;7.21;0.44;285.14;4.59;961;21;2009.00;22
4856;20;22229333;4856;360;5815;5837;7.14;0.43;285.18;4.59;959;21;2010.00;22
4859;20;22229353;4859;363;5815;5837;7.01;0.42;285.19;4.59;956;21;2011.00;22
4862;20;22229370;4862;366;5815;5837;6.94;0.42;285.26;4.59;953;21;2012.00;22
4862;20;22229388;4862;368;5815;5837;6.89;0.42;285.26;4.59;953;21;2013.00;22
4865;20;22229405;4865;374;5815;5837;6.85;0.41;285.33;4.59;950;21;2014.00;22
4866;20;22229421;4866;370;5815;5837;6.84;0.42;285.31;4.59;949;21;2015.00;22
4869;20;22229439;4869;388;5889;5964;6.76;0.42;285.36;4.54;1020;21;2016.00;75
4869;20;22229471;4869;370;5889;5965;6.79;0.42;285.36;4.54;1020;21;2017.00;76
4870;20;22229489;4870;354;5895;5965;6.90;0.43;285.39;4.53;1025;21;2018.00;70
4874;20;22229506;4874;347;5898;5965;6.97;0.43;285.54;4.53;1024;21;2019.00;67
4877;20;22229525;4877;339;5902;5965;7.12;0.44;285.59;4.53;1025;21;2020.00;63
4879;20;22229545;4879;336;5903;5965;7.20;0.44;285.60;4.53;1024;21;2021.00;62
4881;20;22229564;4881;333;5905;5965;7.33;0.45;285.59;4.53;1024;21;2022.00;60
4883;20;22229583;4883;335;5908;5965;7.46;0.46;285.64;4.54;1025;21;2023.00;57
4885;20;22229602;4885;333;5910;5966;7.60;0.46;285.69;4.54;1025;21;2024.00;56
4886;20;22229620;4886;336;5914;5968;7.65;0.47;285.72;4.54;1028;21;2025.00;54
4890;20;22229638;4890;330;5917;5968;7.67;0.47;285.87;4.54;1027;21;2026.00;51
4891;20;22229658;4891;325;5919;5969;7.65;0.47;285.88;4.54;1028;21;2027.00;50
4895;20;22229688;4895;323;5924;5969;7.54;0.46;285.96;4.55;1029;21;2028.00;45
4899;20;22229718;4899;321;5926;5969;7.43;0.45;286.14;4.57;1027;21;2029.00;43
4901;20;22229739;4901;317;5926;5969;7.33;0.45;286.21;4.57;1025;21;2030.00;43
4906;20;22229757;4906;319;5930;5973;7.24;0.44;286.40;4.59;1024;21;2031.00;43
4906;20;22229778;4906;313;5931;5973;7.14;0.44;286.40;4.59;1025;21;2032.00;42
4912;20;22229798;4912;312;5934;5973;7.03;0.43;286.46;4.59;1022;21;2033.00;39
4917;20;22229824;4917;306;5936;5976;6.97;0.43;286.65;4.59;1019;21;2034.00;40
4919;20;22229846;4919;307;5937;5976;6.90;0.42;286.73;4.60;1018;21;2035.00;39
4921;20;22229866;4921;307;5938;5976;6.87;0.42;286.82;4.60;1017;21;2036.00;38
4922;20;22229885;4922;300;5942;5980;6.90;0.42;286.80;4.60;1020;21;2037.00;38
4926;20;22229903;4926;293;5943;5981;6.90;0.42;286.95;4.60;1017;21;2038.00;38
4928;20;22229919;4928;297;5944;5981;6.90;0.42;287.02;4.60;1016;21;2039.00;37
4931;20;22229939;4931;296;5949;5986;6.95;0.42;287.08;4.59;1018;21;2040.00;37
4934;20;22229956;4934;297;5950;5986;7.03;0.43;287.07;4.61;1016;21;2041.00;36
4935;20;22229971;4935;298;5950;5986;7.06;0.43;287.13;4.61;1015;21;2042.00;36
4941;20;22229986;4941;294;5951;5987;7.11;0.43;287.23;4.61;1010;21;2043.00;36
4943;20;22230000;4943;289;5951;5987;7.18;0.44;287.36;4.61;1008;21;2044.00;36
4946;20;22230017;4946;289;5955;5993;7.30;0.44;287.34;4.61;1009;21;2045.00;38
4950;20;22230032;4950;288;5955;5993;7.22;0.44;287.41;4.61;1005;21;2046.00;38
4953;20;22230049;4953;296;5955;5994;7.16;0.43;287.49;4.61;1002;21;2047.00;39
4956;20;22230064;4956;302;5957;5994;7.06;0.43;287.51;4.62;1001;21;2048.00;37
4958;20;22230078;4958;307;5957;5994;6.96;0.42;287.43;4.62;999;21;2049.00;37
4961;20;22230091;4961;314;5958;5994;6.94;0.42;287.47;4.62;997;21;2050.00;36
4965;20;22230105;4965;312;5960;5994;6.87;0.42;287.44;4.64;995;21;2051.00;34
4969;20;22230119;4969;307;5969;6006;6.83;0.42;287.59;4.64;1000;21;2052.00;37
4970;20;22230134;4970;320;5971;6006;6.81;0.41;287.62;4.65;1001;21;2053.00;35
4973;20;22230149;4973;324;5973;6006;6.77;0.41;287.68;4.65;1000;21;2054.00;33
4974;20;22230163;4974;331;5975;6006;6.79;0.41;287.79;4.68;1001;21;2055.00;31
4975;20;22230177;4975;333;5975;6006;6.78;0.41;287.83;4.68;1000;21;2056.00;31
4977;20;22230192;4977;330;5976;6006;6.80;0.41;287.87;4.68;999;21;2057.00;30
4980;20;22230213;4980;334;5980;6010;6.80;0.41;288.02;4.71;1000;21;2058.00;30
4981;20;22230227;4981;343;5981;6010;6.79;0.41;288.09;4.71;1000;21;2059.00;29
4984;21;22230241;4984;350;5986;6014;6.82;0.41;288.09;4.72;1002;22;2060.00;28
4985;21;22230289;4985;357;5988;6015;6.85;0.42;288.12;4.74;1003;22;2061.00;27
4988;21;22230307;4988;362;5988;6015;6.85;0.42;288.01;4.74;1000;22;2062.00;27
4992;21;22230324;4992;366;5989;6015;6.81;0.41;288.10;4.75;997;22;2063.00;26
4994;21;22230342;4994;367;6001;6028;6.82;0.41;288.05;4.76;1007;22;2064.00;27
4996;21;22230362;4996;370;6001;6028;6.79;0.41;288.04;4.76;1005;22;2065.00;27
4997;21;22230381;4997;375;6002;6028;6.75;0.41;288.03;4.78;1005;22;2066.00;26
5003;21;22230399;5003;382;6004;6029;6.70;0.41;288.06;4.79;1001;22;2067.00;25
5004;21;22230418;5004;380;6005;6030;6.63;0.40;288.09;4.80;1001;22;2068.00;25
5005;21;22230435;5005;385;6006;6030;6.56;0.40;288.10;4.82;1001;22;2069.00;24
5005;21;22230456;5005;387;6010;6036;6.54;0.40;288.10;4.82;1005;22;2070.00;26
5007;21;22230474;5007;388;6012;6036;6.50;0.40;288.18;4.84;1005;22;2071.00;24
5010;21;22230491;5010;393;6014;6036;6.48;0.40;288.24;4.84;1004;22;2072.00;22
5013;21;22230507;5013;398;6016;6036;6.47;0.40;288.29;4.86;1003;22;2073.00;20
5014;21;22230522;5014;399;6021;6042;6.51;0.40;288.32;4.86;1007;22;2074.00;21
5015;21;22230537;5015;396;6023;6042;6.47;0.40;288.29;4.87;1008;22;2075.00;19
5017;21;22230552;5017;398;6023;6042;6.40;0.39;288.30;4.87;1006;22;2076.00;19
5018;21;22230568;5018;399;6023;6042;6.35;0.39;288.29;4.87;1005;22;2077.00;19
5025;21;22230583;5025;397;6027;6046;6.22;0.38;288.24;4.88;1002;22;2078.00;19
5028;21;22230600;5028;397;6028;6047;6.12;0.37;288.30;4.88;1000;22;2079.00;19
5031;21;22230619;5031;400;6031;6047;6.08;0.37;288.23;4.92;1000;22;2080.00;16
5032;21;22230634;5032;405;6032;6048;6.09;0.37;288.22;4.92;1000;22;2081.00;16
5034;21;22230651;5034;406;6033;6048;6.08;0.37;288.20;4.93;999;22;2082.00;15
5036;21;22230668;5036;407;6033;6048;6.08;0.37;288.21;4.93;997;22;2083.00;15
5038;21;22230685;5038;412;6033;6048;6.07;0.37;288.14;4.93;995;22;2084.00;15
5040;21;22230701;5040;415;6036;6048;6.03;0.37;288.07;4.96;996;22;2085.00;12
5042;21;22230717;5042;411;6036;6048;5.99;0.37;288.05;4.96;994;22;2086.00;12
5047;21;22230731;5047;412;6036;6048;5.95;0.36;288.12;4.96;989;22;2087.00;12
5049;21;22230747;5049;417;6074;6118;6.11;0.38;288.05;4.94;1025;22;2088.00;44
5050;21;22230765;5050;416;6076;6119;6.04;0.37;288.08;4.94;1026;22;2089.00;43
5055;21;22230778;5055;420;6085;6119;5.97;0.37;288.02;4.94;1030;22;2090.00;34
5059;21;22230790;5059;423;6091;6119;5.90;0.36;287.94;4.95;1032;22;2091.00;28
5061;21;22230805;5061;433;6095;6119;5.81;0.36;287.94;4.95;1034;22;2092.00;24
5065;21;22230819;5065;441;6100;6119;5.67;0.35;287.91;4.97;1035;22;2093.00;19
5067;21;22230834;5067;450;6103;6119;5.60;0.34;287.86;4.97;1036;22;2094.00;16
5070;21;22230851;5070;452;6105;6119;5.54;0.34;287.80;4.97;1035;22;2095.00;14
5073;21;22230866;5073;451;6107;6120;5.42;0.33;287.71;4.98;1034;22;2096.00;13
5075;21;22230885;5075;453;6110;6121;5.28;0.32;287.70;4.98;1035;22;2097.00;11
5077;21;22230901;5077;464;6111;6121;5.16;0.32;287.65;4.98;1034;22;2098.00;10
5083;21;22230915;5083;467;6118;6125;5.00;0.31;287.60;5.00;1035;22;2099.00;7
5086;21;22230932;5086;467;6122;6140;4.87;0.30;287.60;5.00;1036;22;2100.00;18
5087;21;22230955;5087;460;6122;6140;4.82;0.29;287.60;5.00;1035;22;2101.00;18
5090;21;22230967;5090;464;6123;6140;4.75;0.29;287.57;5.00;1033;22;2102.00;17
5091;21;22230979;5091;457;6127;6146;4.71;0.29;287.58;5.00;1036;22;2103.00;19
5094;21;22230991;5094;458;6129;6146;4.67;0.29;287.56;5.01;1035;22;2104.00;17
5097;21;22231004;5097;462;6129;6146;4.61;0.28;287.54;5.01;1032;22;2105.00;17
5099;21;22231017;5099;464;6134;6149;4.54;0.28;287.56;5.01;1035;22;2106.00;15
5101;21;22231029;5101;467;6136;6149;4.51;0.28;287.63;5.01;1035;22;2107.00;13
5104;21;22231045;5104;456;6136;6149;4.51;0.28;287.60;5.01;1032;22;2108.00;13
5105;21;22231057;5105;443;6136;6150;4.56;0.28;287.60;5.01;1031;22;2109.00;14
5107;21;22231072;5107;436;6137;6151;4.65;0.28;287.60;5.01;1030;22;2110.00;14
5111;21;22231086;5111;433;6137;6151;4.73;0.29;287.59;5.01;1026;22;2111.00;14
5114;21;22231101;5114;435;6149;6164;4.83;0.29;287.67;5.00;1035;22;2112.00;15
5118;21;22231116;5118;427;6149;6164;4.88;0.30;287.64;5.00;1031;22;2113.00;15
5120;21;22231130;5120;425;6149;6164;4.98;0.30;287.60;5.00;1029;22;2114.00;15
5123;21;22231144;5123;424;6151;6166;5.08;0.31;287.65;5.00;1028;22;2115.00;15
5127;21;22231157;5127;423;6151;6166;5.16;0.31;287.67;5.00;1024;22;2116.00;15
5131;21;22231179;5131;427;6155;6170;5.24;0.32;287.60;5.00;1024;22;2117.00;15
5134;21;22231200;5134;435;6156;6170;5.29;0.32;287.60;5.00;1022;22;2118.00;14
5136;21;22231213;5136;436;6159;6174;5.41;0.33;287.56;5.00;1023;22;2119.00;15
5137;21;22231226;5137;438;6159;6174;5.49;0.34;287.51;5.00;1022;22;2120.00;15
5141;21;22231239;5141;438;6159;6174;5.53;0.34;287.73;5.00;1018;22;2121.00;15
5143;21;22231256;5143;430;6159;6174;5.55;0.34;287.72;5.00;1016;22;2122.00;15
5144;21;22231273;5144;427;6160;6174;5.55;0.34;287.73;5.00;1016;22;2123.00;14
5148;21;22231287;5148;429;6169;6186;5.62;0.34;287.72;5.00;1021;22;2124.00;17
5150;21;22231302;5150;438;6170;6186;5.69;0.35;287.70;5.00;1020;22;2125.00;16
5152;21;22231316;5152;435;6171;6186;5.79;0.35;287.72;5.00;1019;22;2126.00;15
5155;21;22231330;5155;433;6173;6186;5.83;0.36;287.76;5.00;1018;22;2127.00;13
5157;21;22231349;5157;433;6173;6186;5.87;0.36;287.70;5.00;1016;22;2128.00;13
5160;21;22231364;5160;433;6175;6186;5.92;0.36;287.69;5.01;1015;22;2129.00;11
5162;21;22231381;5162;431;6176;6187;5.95;0.36;287.74;5.01;1014;22;2130.00;11
5164;21;22231396;5164;431;6176;6187;5.92;0.36;287.75;5.01;1012;22;2131.00;11
5168;21;22231412;5168;431;6181;6193;5.87;0.36;287.89;5.01;1013;22;2132.00;12
5171;21;22231427;5171;433;6182;6194;5.86;0.36;288.02;5.01;1011;22;2133.00;12
5174;21;22231446;5174;436;6182;6194;5.86;0.36;287.99;5.01;1008;22;2134.00;12
5177;21;22231469;5177;436;6182;6194;5.89;0.36;288.05;5.01;1005;22;2135.00;12
5181;21;22231489;5181;434;6184;6198;5.93;0.36;287.99;5.00;1003;22;2136.00;14
5184;21;22231507;5184;439;6185;6198;5.92;0.36;287.97;5.00;1001;22;2137.00;13
5187;21;22231522;5187;436;6185;6198;5.97;0.36;287.96;5.00;998;22;2138.00;13
5188;21;22231539;5188;438;6186;6199;5.98;0.36;287.99;5.00;998;22;2139.00;13
5192;21;22231554;5192;432;6189;6203;5.95;0.36;288.06;5.00;997;22;2140.00;14
5194;21;22231570;5194;431;6189;6203;5.93;0.36;288.09;5.00;995;22;2141.00;14
5197;22;22231586;5197;435;6191;6206;5.90;0.36;288.12;5.00;994;23;2142.00;15
5201;22;22231613;5201;437;6191;6206;5.88;0.36;288.20;5.00;990;23;2143.00;15
5206;22;22231633;5206;435;6192;6206;5.84;0.36;288.26;5.00;986;23;2144.00;14
5209;22;22231654;5209;434;6192;6206;5.77;0.35;288.43;5.00;983;23;2145.00;14
5213;22;22231671;5213;434;6196;6210;5.71;0.35;288.52;5.00;983;23;2146.00;14
5217;22;22231688;5217;422;6196;6210;5.66;0.34;288.57;5.00;979;23;2147.00;14
5219;22;22231711;5219;413;6196;6210;5.64;0.34;288.59;5.00;977;23;2148.00;14
5220;22;22231726;5220;406;6196;6210;5.65;0.34;288.61;5.00;976;23;2149.00;14
5223;22;22231741;5223;401;6196;6211;5.72;0.35;288.66;5.00;973;23;2150.00;15
5224;22;22231757;5224;394;6197;6212;5.81;0.35;288.69;5.00;973;23;2151.00;15
5228;22;22231773;5228;391;6197;6212;5.89;0.36;288.85;5.00;969;23;2152.00;15
5232;22;22231790;5232;388;6198;6213;5.99;0.36;288.87;5.00;966;23;2153.00;15
5234;22;22231812;5234;386;6198;6213;6.16;0.37;288.85;5.00;964;23;2154.00;15
5235;22;22231829;5235;386;6198;6213;6.28;0.38;288.89;5.00;963;23;2155.00;15
5238;22;22231848;5238;376;6198;6213;6.39;0.39;288.98;5.00;960;23;2156.00;15
5240;22;22231869;5240;366;6198;6213;6.51;0.40;289.06;5.00;958;23;2157.00;15
5243;22;22231899;5243;358;6198;6213;6.54;0.40;289.06;5.00;955;23;2158.00;15
5247;22;22231914;5247;351;6198;6213;6.58;0.40;289.18;5.00;951;23;2159.00;15
5249;22;22231932;5249;406;6322;6443;6.67;0.42;289.24;4.90;1073;23;2160.00;121
5249;22;22231976;5249;396;6327;6444;6.69;0.42;289.24;4.89;1078;23;2161.00;117
5253;22;22231992;5253;373;6337;6444;6.78;0.42;289.48;4.89;1084;23;2162.00;107
5255;22;22232011;5255;376;6339;6444;6.78;0.42;289.58;4.89;1084;23;2163.00;105
5259;22;22232026;5259;381;6347;6444;6.74;0.42;289.58;4.89;1088;23;2164.00;97
5260;22;22232051;5260;379;6351;6444;6.71;0.42;289.69;4.89;1091;23;2165.00;93
5262;22;22232069;5262;387;6358;6444;6.73;0.42;289.72;4.89;1096;23;2166.00;86
5265;22;22232086;5265;389;6362;6444;6.72;0.42;289.80;4.89;1097;23;2167.00;82
5269;22;22232120;5269;397;6368;6445;6.70;0.42;289.93;4.89;1099;23;2168.00;77
5271;22;22232138;5271;395;6372;6446;6.64;0.41;289.94;4.90;1101;23;2169.00;74
5274;22;22232155;5274;389;6376;6446;6.55;0.41;290.10;4.90;1102;23;2170.00;70
5277;22;22232171;5277;399;6380;6447;6.46;0.40;290.25;4.90;1103;23;2171.00;67
5277;22;22232188;5277;400;6383;6447;6.40;0.40;290.25;4.91;1106;23;2172.00;64
5279;22;22232204;5279;406;6385;6447;6.35;0.39;290.28;4.91;1106;23;2173.00;62
5280;22;22232220;5280;415;6387;6447;6.31;0.39;290.29;4.91;1107;23;2174.00;60
5282;22;22232237;5282;426;6391;6451;6.20;0.38;290.37;4.91;1109;23;2175.00;60
5286;22;22232253;5286;434;6393;6451;6.12;0.38;290.47;4.92;1107;23;2176.00;58
5291;22;22232269;5291;436;6394;6451;6.08;0.37;290.46;4.92;1103;23;2177.00;57
5294;22;22232284;5294;437;6397;6454;5.99;0.37;290.59;4.93;1103;23;2178.00;57
5298;22;22232300;5298;438;6398;6454;5.97;0.37;290.70;4.93;1100;23;2179.00;56
5302;22;22232315;5302;438;6400;6454;5.95;0.37;290.85;4.93;1098;23;2180.00;54
5303;22;22232330;5303;434;6404;6458;5.92;0.36;290.92;4.93;1101;23;2181.00;54
5306;22;22232348;5306;428;6406;6459;5.93;0.36;290.87;4.93;1100;23;2182.00;53
5306;22;22232365;5306;438;6408;6459;5.96;0.37;290.87;4.94;1102;23;2183.00;51
5307;22;22232383;5307;440;6411;6463;5.97;0.37;290.90;4.93;1104;23;2184.00;52
5308;22;22232410;5308;441;6412;6463;5.93;0.36;290.88;4.94;1104;23;2185.00;51
5311;22;22232427;5311;446;6412;6463;5.96;0.36;290.88;4.94;1101;23;2186.00;51
5313;22;22232443;5313;437;6412;6464;5.94;0.36;290.92;4.94;1099;23;2187.00;52
5314;22;22232462;5314;447;6412;6464;5.97;0.36;290.94;4.94;1098;23;2188.00;52
5315;22;22232479;5315;450;6419;6470;6.02;0.37;290.95;4.94;1104;23;2189.00;51
5316;22;22232500;5316;445;6419;6470;6.05;0.37;290.98;4.94;1103;23;2190.00;51
5317;22;22232516;5317;444;6421;6471;6.07;0.37;291.01;4.95;1104;23;2191.00;50
5318;22;22232533;5318;439;6421;6471;6.12;0.37;291.00;4.95;1103;23;2192.00;50
5319;22;22232549;5319;432;6421;6471;6.22;0.38;290.97;4.95;1102;23;2193.00;50
5322;22;22232564;5322;426;6423;6471;6.27;0.38;291.01;4.96;1101;23;2194.00;48
5325;22;22232619;5325;423;6423;6471;6.33;0.39;291.14;4.96;1098;23;2195.00;48
5329;22;22232635;5329;415;6433;6483;6.38;0.39;291.22;4.95;1104;23;2196.00;50
5330;22;22232652;5330;408;6434;6483;6.40;0.39;291.25;4.96;1104;23;2197.00;49
5336;22;22232668;5336;404;6434;6483;6.42;0.39;291.31;4.96;1098;23;2198.00;49
5337;22;22232685;5337;399;6434;6483;6.43;0.39;291.26;4.96;1097;23;2199.00;49
5341;22;22232703;5341;402;6436;6483;6.36;0.39;291.35;4.96;1095;23;2200.00;47
5346;22;22232722;5346;393;6437;6483;6.34;0.39;291.43;4.96;1091;23;2201.00;46
5346;22;22232737;5346;391;6441;6487;6.33;0.39;291.43;4.96;1095;23;2202.00;46
5352;22;22232752;5352;380;6442;6487;6.19;0.38;291.60;4.96;1090;23;2203.00;45
5353;22;22232768;5353;368;6446;6491;6.11;0.37;291.58;4.96;1093;23;2204.00;45
5358;22;22232790;5358;360;6450;6493;5.97;0.36;291.77;4.99;1092;23;2205.00;43
5360;22;22232809;5360;361;6450;6493;5.86;0.36;291.84;4.99;1090;23;2206.00;43
5364;22;22232823;5364;355;6450;6493;5.77;0.35;292.02;4.99;1086;23;2207.00;43
5366;22;22232838;5366;359;6459;6506;5.73;0.35;292.18;4.98;1093;23;2208.00;47
5368;22;22232854;5368;357;6459;6506;5.74;0.35;292.25;4.98;1091;23;2209.00;47
5369;22;22232868;5369;356;6461;6508;5.79;0.35;292.31;4.98;1092;23;2210.00;47
5371;22;22232884;5371;350;6462;6509;5.90;0.36;292.44;4.98;1091;23;2211.00;47
5373;22;22232902;5373;348;6462;6510;5.96;0.36;292.53;4.98;1089;23;2212.00;48
5376;22;22232932;5376;358;6462;6510;6.00;0.37;292.62;4.98;1086;23;2213.00;48
5379;22;22232954;5379;345;6464;6513;6.07;0.37;292.61;4.98;1085;23;2214.00;49
5382;22;22232970;5382;349;6465;6513;6.13;0.37;292.70;4.98;1083;23;2215.00;48
5385;22;22232986;5385;351;6465;6513;6.14;0.38;292.84;4.98;1080;23;2216.00;48
5386;22;22233009;5386;358;6465;6513;6.14;0.38;292.83;4.98;1079;23;2217.00;48
5388;22;22233025;5388;360;6470;6519;6.18;0.38;292.92;4.98;1082;23;2218.00;49
5393;22;22233050;5393;363;6470;6519;6.14;0.37;293.08;4.98;1077;23;2219.00;49
5395;22;22233066;5395;364;6470;6519;6.15;0.38;293.00;4.98;1075;23;2220.00;49
5398;22;22233088;5398;357;6470;6519;6.17;0.38;293.13;4.98;1072;23;2221.00;49
5399;22;22233106;5399;361;6474;6523;6.18;0.38;293.12;4.98;1075;23;2222.00;49
5400;22;22233121;5400;361;6475;6524;6.19;0.38;293.10;4.98;1075;23;2223.00;49
5401;22;22233138;5401;362;6475;6524;6.14;0.37;293.08;4.98;1074;23;2224.00;49
5405;22;22233154;5405;361;6477;6525;6.09;0.37;293.02;4.99;1072;23;2225.00;48
5405;22;22233170;5405;364;6477;6525;6.04;0.37;293.02;4.99;1072;23;2226.00;48
5408;22;22233187;5408;376;6477;6525;5.99;0.36;293.01;4.99;1069;23;2227.00;48
5413;22;22233202;5413;374;6479;6525;5.91;0.36;292.93;5.01;1066;23;2228.00;46
5415;22;22233217;5415;384;6479;6525;5.86;0.36;292.89;5.01;1064;23;2229.00;46
5415;22;22233233;5415;391;6481;6525;5.82;0.35;292.89;5.04;1066;23;2230.00;44
5418;22;22233247;5418;401;6482;6525;5.78;0.35;292.77;5.05;1064;23;2231.00;43
5419;22;22233262;5419;407;6517;6595;5.96;0.36;292.74;5.04;1098;23;2232.00;78
5420;22;22233281;5420;408;6521;6596;5.95;0.36;292.69;5.07;1101;23;2233.00;75
5421;22;22233297;5421;407;6530;6596;6.00;0.37;292.65;5.07;1109;23;2234.00;66
5423;22;22233311;5423;408;6533;6596;5.96;0.36;292.59;5.09;1110;23;2235.00;63
5424;22;22233325;5424;417;6538;6596;5.94;0.36;292.60;5.09;1114;23;2236.00;58
5425;22;22233339;5425;416;6541;6596;5.88;0.36;292.56;5.11;1116;23;2237.00;55
5426;22;22233353;5426;418;6546;6596;5.82;0.36;292.52;5.12;1120;23;2238.00;50
5427;22;22233367;5427;428;6550;6596;5.75;0.35;292.48;5.18;1123;23;2239.00;46
5428;22;22233381;5428;433;6554;6597;5.65;0.35;292.48;5.21;1126;23;2240.00;43
5432;22;22233395;5432;438;6558;6598;5.53;0.34;292.32;5.23;1126;23;2241.00;40
5432;22;22233409;5432;439;6563;6598;5.48;0.34;292.32;5.26;1131;23;2242.00;35
5433;22;22233422;5433;446;6568;6602;5.40;0.33;292.27;5.26;1135;23;2243.00;34
5433;22;22233439;5433;450;6570;6602;5.35;0.33;292.27;5.28;1137;23;2244.00;32
5435;22;22233455;5435;463;6571;6602;5.29;0.33;292.22;5.29;1136;23;2245.00;31
5436;22;22233472;5436;475;6572;6602;5.25;0.32;292.18;5.30;1136;23;2246.00;30
5437;22;22233490;5437;482;6578;6608;5.23;0.32;292.17;5.31;1141;23;2247.00;30
5440;22;22233509;5440;489;6579;6608;5.18;0.32;292.13;5.31;1139;23;2248.00;29
5440;22;22233526;5440;487;6582;6608;5.15;0.32;292.13;5.35;1142;23;2249.00;26
5444;22;22233549;5444;486;6588;6614;5.14;0.32;292.01;5.35;1144;23;2250.00;26
5447;22;22233584;5447;481;6589;6614;5.10;0.31;291.92;5.36;1142;23;2251.00;25
5448;22;22233601;5448;485;6591;6614;5.07;0.31;291.88;5.37;1143;23;2252.00;23
5451;22;22233616;5451;482;6591;6615;5.05;0.31;291.86;5.37;1140;23;2253.00;24
5453;22;22233632;5453;481;6594;6616;5.03;0.31;291.79;5.39;1141;23;2254.00;22
5455;22;22233650;5455;482;6594;6616;4.97;0.31;291.85;5.39;1139;23;2255.00;22
5458;22;22233666;5458;488;6606;6629;4.94;0.30;291.87;5.38;1148;23;2256.00;23
5462;22;22233683;5462;484;6606;6629;4.91;0.30;291.81;5.38;1144;23;2257.00;23
5462;22;22233699;5462;491;6608;6629;4.94;0.30;291.81;5.40;1146;23;2258.00;21
5465;22;22233715;5465;494;6609;6630;4.92;0.30;291.74;5.40;1144;23;2259.00;21
5467;22;22233731;5467;490;6610;6630;4.92;0.30;291.68;5.41;1143;23;2260.00;20
5469;22;22233746;5469;492;6615;6634;4.90;0.30;291.72;5.42;1146;23;2261.00;19
5470;22;22233761;5470;494;6616;6634;4.86;0.30;291.71;5.44;1146;23;2262.00;18
5473;22;22233774;5473;505;6619;6638;4.83;0.30;291.70;5.43;1146;23;2263.00;19
5476;22;22233789;5476;511;6620;6638;4.78;0.29;291.64;5.45;1144;23;2264.00;18
5480;22;22233803;5480;506;6621;6638;4.70;0.29;291.55;5.46;1141;23;2265.00;17
5480;22;22233816;5480;506;6622;6638;4.68;0.28;291.55;5.48;1142;23;2266.00;16
5484;22;22233829;5484;506;6622;6638;4.63;0.28;291.49;5.48;1138;23;2267.00;16
5488;22;22233843;5488;512;6633;6650;4.59;0.28;291.40;5.48;1145;23;2268.00;17
5490;22;22233857;5490;508;6634;6650;4.57;0.28;291.35;5.49;1144;23;2269.00;16
5492;22;22233870;5492;511;6636;6650;4.58;0.28;291.36;5.50;1144;23;2270.00;14
5498;22;22233884;5498;512;6636;6650;4.57;0.28;291.30;5.50;1138;23;2271.00;14
5501;22;22233913;5501;513;6636;6650;4.58;0.28;291.27;5.50;1135;23;2272.00;14
5503;22;22233926;5503;515;6636;6650;4.55;0.28;291.27;5.50;1133;23;2273.00;14
5508;22;22233940;5508;514;6636;6651;4.49;0.27;291.30;5.50;1128;23;2274.00;15
5509;22;22233954;5509;506;6636;6651;4.49;0.27;291.33;5.50;1127;23;2275.00;15
5511;22;22233968;5511;494;6641;6657;4.50;0.28;291.37;5.50;1130;23;2276.00;16
5512;22;22233986;5512;489;6642;6658;4.56;0.28;291.40;5.50;1130;23;2277.00;16
5517;22;22234004;5517;487;6642;6658;4.59;0.28;291.41;5.50;1125;23;2278.00;16
5518;22;22234029;5518;481;6642;6658;4.63;0.28;291.39;5.50;1124;23;2279.00;16
5522;22;22234044;5522;485;6646;6663;4.69;0.29;291.43;5.49;1124;23;2280.00;17
5523;22;22234065;5523;480;6646;6663;4.74;0.29;291.45;5.49;1123;23;2281.00;17
5526;22;22234084;5526;463;6646;6663;4.77;0.29;291.43;5.49;1120;23;2282.00;17
5529;22;22234103;5529;454;6647;6664;4.83;0.30;291.48;5.49;1118;23;2283.00;17
5532;22;22234121;5532;443;6650;6668;4.91;0.30;291.48;5.49;1118;23;2284.00;18
5534;22;22234141;5534;435;6650;6668;4.97;0.30;291.47;5.49;1116;23;2285.00;18
5536;22;22234164;5536;426;6653;6671;5.01;0.31;291.46;5.49;1117;23;2286.00;18
5542;22;22234180;5542;416;6653;6671;5.02;0.31;291.71;5.49;1111;23;2287.00;18
5544;22;22234197;5544;418;6653;6671;5.06;0.31;291.70;5.49;1109;23;2288.00;18
5548;22;22234212;5548;415;6653;6671;5.07;0.31;291.74;5.49;1105;23;2289.00;18
5550;22;22234227;5550;407;6656;6675;5.10;0.31;291.76;5.49;1106;23;2290.00;19
5555;22;22234242;5555;404;6657;6675;5.12;0.31;291.86;5.48;1102;23;2291.00;18
5560;22;22234260;5560;402;6657;6675;5.15;0.31;291.87;5.48;1097;23;2292.00;18
5564;22;22234278;5564;395;6657;6675;5.17;0.32;292.04;5.48;1093;23;2293.00;18
5567;22;22234299;5567;394;6657;6676;5.21;0.32;292.08;5.48;1090;23;2294.00;19
5568;22;22234316;5568;388;6659;6678;5.27;0.32;292.12;5.48;1091;23;2295.00;19
5571;22;22234335;5571;385;6659;6678;5.28;0.32;292.22;5.48;1088;23;2296.00;19
5572;22;22234353;5572;383;6660;6679;5.35;0.33;292.30;5.48;1088;23;2297.00;19
5576;22;22234371;5576;387;6660;6679;5.41;0.33;292.40;5.48;1084;23;2298.00;19
5582;22;22234392;5582;387;6660;6679;5.44;0.33;292.51;5.48;1078;23;2299.00;19
5587;22;22234414;5587;378;6660;6679;5.45;0.33;292.59;5.48;1073;23;2300.00;19
5590;22;22234439;5590;370;6660;6679;5.53;0.34;292.62;5.48;1070;23;2301.00;19
5593;22;22234454;5593;369;6660;6679;5.61;0.34;292.62;5.48;1067;23;2302.00;19
5596;22;22234470;5596;362;6660;6679;5.64;0.34;292.60;5.48;1064;23;2303.00;19
5600;22;22234484;5600;377;6733;6806;5.85;0.36;292.68;5.42;1133;23;2304.00;73
5603;22;22234513;5603;372;6735;6807;5.90;0.36;292.65;5.42;1132;23;2305.00;72
5609;22;22234529;5609;363;6742;6807;5.89;0.36;292.73;5.42;1133;23;2306.00;65
5613;22;22234545;5613;359;6744;6807;5.89;0.36;292.89;5.42;1131;23;2307.00;63
5615;22;22234563;5615;357;6749;6807;5.92;0.36;292.93;5.42;1134;23;2308.00;58
5617;22;22234579;5617;357;6753;6807;5.93;0.37;292.94;5.42;1136;23;2309.00;54
5620;22;22234602;5620;359;6756;6807;5.91;0.36;292.91;5.42;1136;23;2310.00;51
5623;22;22234620;5623;363;6757;6807;5.90;0.36;292.95;5.42;1134;23;2311.00;50
5625;22;22234640;5625;365;6760;6808;5.84;0.36;293.09;5.42;1135;23;2312.00;48
5630;22;22234657;5630;366;6761;6809;5.86;0.36;293.08;5.42;1131;23;2313.00;48
5632;22;22234675;5632;370;6762;6809;5.86;0.36;293.14;5.42;1130;23;2314.00;47
5635;22;22234695;5635;378;6764;6810;5.79;0.36;293.22;5.42;1129;23;2315.00;46
5637;22;22234711;5637;381;6764;6810;5.72;0.35;293.21;5.42;1127;23;2316.00;46
5640;22;22234728;5640;388;6766;6810;5.70;0.35;293.20;5.42;1126;23;2317.00;44
5642;22;22234743;5642;395;6769;6810;5.68;0.35;293.25;5.43;1127;23;2318.00;41
5645;22;22234757;5645;401;6772;6814;5.69;0.35;293.33;5.43;1127;23;2319.00;42
5649;22;22234777;5649;408;6773;6814;5.66;0.35;293.53;5.43;1124;23;2320.00;41
5652;22;22234796;5652;412;6774;6814;5.69;0.35;293.68;5.43;1122;23;2321.00;40
5652;22;22234813;5652;408;6775;6817;5.72;0.35;293.68;5.43;1123;23;2322.00;42
5656;22;22234829;5656;393;6776;6817;5.76;0.35;293.73;5.43;1120;23;2323.00;41
5659;22;22234845;5659;389;6778;6817;5.81;0.36;293.78;5.44;1119;23;2324.00;39
5663;22;22234860;5663;384;6781;6821;5.83;0.36;293.86;5.43;1118;23;2325.00;40
5665;23;22234878;5665;389;6782;6822;5.87;0.36;293.89;5.44;1117;24;2326.00;40
5667;23;22234918;5667;386;6782;6822;5.90;0.36;294.03;5.44;1115;24;2327.00;40
5670;23;22234937;5670;389;6786;6826;5.93;0.36;294.15;5.44;1116;24;2328.00;40
5672;23;22234953;5672;389;6786;6826;5.99;0.37;294.26;5.44;1114;24;2329.00;40
5674;23;22234970;5674;389;6788;6826;6.02;0.37;294.40;5.44;1114;24;2330.00;38
5677;23;22234985;5677;388;6789;6827;6.05;0.37;294.38;5.44;1112;25;2331.00;38
5680;23;22235015;5680;387;6790;6827;6.06;0.37;294.49;5.44;1110;25;2332.00;37
5682;23;22235032;5682;383;6798;6833;6.07;0.37;294.51;5.44;1116;25;2333.00;35
5684;23;22235051;5684;378;6798;6833;6.05;0.37;294.56;5.44;1114;25;2334.00;35
5687;23;22235076;5687;382;6799;6834;6.05;0.37;294.70;5.44;1112;25;2335.00;35
5690;23;22235103;5690;390;6800;6834;6.04;0.37;294.74;5.45;1110;25;2336.00;34
5694;23;22235120;5694;389;6800;6834;5.96;0.36;294.89;5.45;1106;25;2337.00;34
5696;23;22235137;5696;392;6800;6834;5.93;0.36;294.95;5.45;1104;25;2338.00;34
5698;23;22235154;5698;402;6801;6834;5.90;0.36;295.04;5.45;1103;25;2339.00;33
5700;23;22235174;5700;412;6827;6870;5.88;0.36;295.11;5.43;1127;25;2340.00;43
5704;23;22235197;5704;409;6829;6870;5.84;0.36;295.16;5.43;1125;25;2341.00;41
5707;23;22235214;5707;405;6831;6870;5.89;0.36;295.30;5.43;1124;25;2342.00;39
5708;23;22235232;5708;399;6831;6870;5.96;0.36;295.40;5.43;1123;25;2343.00;39
5711;23;22235250;5711;393;6834;6870;5.99;0.36;295.52;5.43;1123;25;2344.00;36
5715;23;22235269;5715;405;6834;6870;6.03;0.37;295.57;5.43;1119;25;2345.00;36
5717;23;22235290;5717;400;6838;6874;5.99;0.36;295.57;5.43;1121;25;2346.00;36
5720;23;22235308;5720;404;6838;6874;5.98;0.36;295.79;5.43;1118;25;2347.00;36
5722;23;22235329;5722;404;6842;6878;6.02;0.37;295.72;5.43;1120;25;2348.00;36
5725;23;22235348;5725;399;6843;6879;6.06;0.37;295.84;5.43;1118;25;2349.00;36
5726;23;22235369;5726;404;6843;6879;6.07;0.37;295.82;5.43;1117;25;2350.00;36
5727;23;22235388;5727;399;6843;6879;6.10;0.37;295.88;5.43;1116;25;2351.00;36
5727;23;22235406;5727;407;6854;6892;6.14;0.37;295.88;5.42;1127;25;2352.00;38
5727;23;22235429;5727;404;6854;6892;6.19;0.38;295.88;5.42;1127;25;2353.00;38
5729;23;22235449;5729;406;6854;6892;6.17;0.38;295.91;5.42;1125;25;2354.00;38
5730;23;22235469;5730;410;6855;6893;6.17;0.38;296.00;5.42;1125;25;2355.00;38
5732;23;22235487;5732;413;6855;6894;6.16;0.38;296.00;5.42;1123;25;2356.00;39
5732;23;22235530;5732;414;6855;6894;6.14;0.37;296.00;5.42;1123;25;2357.00;39
5733;23;22235550;5733;413;6857;6897;6.10;0.37;296.03;5.41;1124;25;2358.00;40
5735;23;22235568;5735;421;6857;6897;6.05;0.37;296.03;5.41;1122;25;2359.00;40
5739;23;22235586;5739;424;6858;6897;6.00;0.37;296.10;5.41;1119;25;2360.00;39
5740;23;22235605;5740;435;6858;6897;5.88;0.36;296.09;5.41;1118;25;2361.00;39
5742;23;22235623;5742;430;6863;6903;5.84;0.36;296.10;5.41;1121;25;2362.00;40
5743;23;22235642;5743;438;6863;6903;5.77;0.35;296.08;5.41;1120;25;2363.00;40
5744;23;22235662;5744;439;6863;6903;5.68;0.35;296.09;5.41;1119;25;2364.00;40
5746;23;22235681;5746;434;6863;6903;5.58;0.34;296.11;5.41;1117;25;2365.00;40
5747;23;22235698;5747;427;6866;6907;5.52;0.34;296.09;5.41;1119;25;2366.00;41
5747;23;22235718;5747;427;6867;6908;5.55;0.34;296.09;5.41;1120;25;2367.00;41
5749;23;22235737;5749;422;6867;6908;5.59;0.34;296.15;5.41;1118;25;2368.00;41
5752;23;22235756;5752;422;6868;6909;5.63;0.34;296.12;5.41;1116;25;2369.00;41
5755;23;22235774;5755;417;6868;6909;5.68;0.35;296.19;5.41;1113;25;2370.00;41
5756;23;22235799;5756;410;6868;6909;5.71;0.35;296.22;5.41;1112;25;2371.00;41
5759;23;22235817;5759;404;6868;6909;5.72;0.35;296.41;5.41;1109;25;2372.00;41
5763;23;22235836;5763;402;6868;6909;5.71;0.35;296.49;5.41;1105;25;2373.00;41
5767;23;22235856;5767;401;6868;6909;5.70;0.35;296.64;5.41;1101;25;2374.00;41
5773;23;22235875;5773;394;6868;6909;5.61;0.34;296.72;5.41;1095;25;2375.00;41
5774;23;22235895;5774;398;6897;6979;5.68;0.35;296.73;5.39;1123;25;2376.00;82
5777;23;22235920;5777;391;6898;6980;5.65;0.34;296.77;5.38;1121;25;2377.00;82
5779;23;22235940;5779;400;6904;6980;5.64;0.34;296.76;5.38;1125;25;2378.00;76
5781;23;22235959;5781;399;6905;6980;5.59;0.34;296.90;5.41;1124;25;2379.00;75
5782;23;22235978;5782;392;6908;6980;5.55;0.34;296.91;5.43;1126;25;2380.00;72
5785;23;22235993;5785;401;6909;6980;5.54;0.34;296.91;5.43;1124;25;2381.00;71
5788;23;22236008;5788;404;6911;6980;5.53;0.34;296.94;5.43;1123;25;2382.00;69
5790;23;22236022;5790;401;6915;6980;5.50;0.33;296.95;5.43;1125;25;2383.00;65
5793;23;22236037;5793;409;6916;6981;5.48;0.33;296.92;5.43;1123;25;2384.00;65
5795;23;22236061;5795;407;6920;6983;5.50;0.33;296.91;5.45;1125;25;2385.00;63
5796;23;22236078;5796;409;6924;6983;5.50;0.33;296.89;5.45;1128;25;2386.00;59
5797;23;22236095;5797;410;6930;6987;5.55;0.34;296.86;5.45;1133;25;2387.00;57
5797;23;22236108;5797;410;6933;6987;5.60;0.34;296.86;5.45;1136;25;2388.00;54
5799;23;22236122;5799;404;6934;6987;5.57;0.34;296.80;5.45;1135;25;2389.00;53
5800;23;22236146;5800;411;6934;6987;5.53;0.34;296.76;5.45;1134;25;2390.00;53
5806;23;22236160;5806;409;6938;6993;5.52;0.34;296.59;5.45;1132;25;2391.00;55
5806;23;22236178;5806;407;6938;6993;5.55;0.34;296.59;5.45;1132;25;2392.00;55
5806;23;22236191;5806;416;6938;6993;5.55;0.34;296.59;5.45;1132;25;2393.00;55
5808;23;22236206;5808;422;6940;6996;5.58;0.34;296.51;5.45;1132;25;2394.00;56
5810;23;22236222;5810;414;6940;6996;5.54;0.34;296.47;5.45;1130;25;2395.00;56
5812;23;22236238;5812;415;6941;6996;5.54;0.34;296.46;5.45;1129;25;2396.00;55
5818;23;22236253;5818;415;6941;6997;5.49;0.33;296.47;5.45;1123;25;2397.00;56
5818;23;22236269;5818;415;6942;6998;5.50;0.33;296.47;5.45;1124;25;2398.00;56
5818;23;22236283;5818;416;6942;6998;5.51;0.33;296.47;5.45;1124;25;2399.00;56
5819;23;22236301;5819;430;6963;7057;5.49;0.33;296.43;5.43;1144;25;2400.00;94
5820;23;22236328;5820;424;6968;7057;5.47;0.33;296.42;5.46;1148;25;2401.00;89
5823;23;22236342;5823;432;6971;7057;5.45;0.33;296.35;5.46;1148;25;2402.00;86
5824;23;22236356;5824;446;6974;7058;5.43;0.33;296.30;5.46;1150;25;2403.00;84
5824;23;22236371;5824;448;6976;7058;5.44;0.33;296.30;5.46;1152;25;2404.00;82
5825;23;22236385;5825;450;6981;7062;5.45;0.33;296.26;5.50;1156;25;2405.00;81
5828;23;22236401;5828;463;6985;7062;5.35;0.33;296.20;5.50;1157;25;2406.00;77
5828;23;22236416;5828;461;6988;7066;5.40;0.33;296.20;5.50;1160;25;2407.00;78
5829;23;22236431;5829;461;6989;7066;5.31;0.32;296.17;5.53;1160;25;2408.00;77
5831;23;22236446;5831;467;6990;7066;5.27;0.32;296.09;5.54;1159;25;2409.00;76
5833;23;22236461;5833;470;6992;7066;5.24;0.32;296.06;5.55;1159;25;2410.00;74
5834;23;22236475;5834;476;6994;7066;5.17;0.32;296.08;5.58;1160;25;2411.00;72
5837;23;22236489;5837;478;7002;7078;5.20;0.32;295.99;5.58;1165;25;2412.00;76
5839;23;22236513;5839;477;7003;7078;5.20;0.32;296.05;5.58;1164;25;2413.00;75
5841;23;22236527;5841;479;7006;7078;5.22;0.32;296.06;5.62;1165;25;2414.00;72
5843;23;22236541;5843;487;7007;7078;5.18;0.32;296.00;5.62;1164;25;2415.00;71
5844;23;22236555;5844;480;7009;7078;5.13;0.31;295.99;5.65;1165;25;2416.00;69
5845;23;22236569;5845;481;7011;7078;5.15;0.31;296.02;5.66;1166;25;2417.00;67
5848;23;22236582;5848;481;7014;7079;5.10;0.31;295.97;5.69;1166;25;2418.00;65
5849;23;22236597;5849;484;7015;7079;5.06;0.31;295.92;5.71;1166;25;2419.00;64
5850;23;22236609;5850;488;7020;7085;5.09;0.31;295.91;5.71;1170;25;2420.00;65
5854;23;22236623;5854;495;7024;7086;4.98;0.30;295.80;5.73;1170;25;2421.00;62
5855;23;22236637;5855;484;7024;7086;4.89;0.30;295.78;5.73;1169;25;2422.00;62
5856;23;22236651;5856;480;7028;7086;4.84;0.30;295.73;5.78;1172;25;2423.00;58
5856;23;22236665;5856;472;7031;7090;4.85;0.30;295.73;5.79;1175;25;2424.00;59
5857;23;22236679;5857;472;7033;7090;4.84;0.30;295.69;5.83;1176;25;2425.00;57
5858;23;22236691;5858;461;7033;7090;4.85;0.30;295.66;5.83;1175;25;2426.00;57
5861;23;22236706;5861;453;7036;7091;4.92;0.30;295.58;5.83;1175;25;2427.00;55
5861;23;22236720;5861;450;7041;7095;4.96;0.30;295.58;5.87;1180;25;2428.00;54
5863;23;22236750;5863;453;7044;7095;4.98;0.30;295.51;5.87;1181;25;2429.00;51
5863;23;22236766;5863;440;7051;7101;5.10;0.31;295.51;5.91;1188;25;2430.00;50
5865;23;22236781;5865;439;7051;7101;5.17;0.32;295.49;5.91;1186;25;2431.00;50
5867;23;22236797;5867;440;7054;7101;5.20;0.32;295.45;5.94;1187;25;2432.00;47
5870;23;22236811;5870;432;7054;7101;5.24;0.32;295.43;5.94;1184;25;2433.00;47
5871;23;22236827;5871;429;7059;7105;5.30;0.32;295.42;5.94;1188;25;2434.00;46
5871;23;22236841;5871;431;7061;7105;5.30;0.32;295.42;5.98;1190;25;2435.00;44
5872;23;22236855;5872;430;7061;7105;5.35;0.33;295.40;5.98;1189;25;2436.00;44
5874;23;22236870;5874;434;7063;7105;5.33;0.32;295.40;6.01;1189;25;2437.00;42
5875;23;22236884;5875;440;7063;7106;5.33;0.32;295.40;6.01;1188;25;2438.00;43
5878;23;22236900;5878;445;7064;7107;5.31;0.32;295.39;6.01;1186;25;2439.00;43
5881;23;22236914;5881;445;7067;7107;5.19;0.32;295.32;6.05;1186;25;2440.00;40
5883;23;22236928;5883;453;7068;7108;5.10;0.31;295.28;6.04;1185;25;2441.00;40
5884;23;22236941;5884;456;7070;7108;5.03;0.31;295.29;6.07;1186;25;2442.00;38
5890;23;22236955;5890;464;7070;7108;4.94;0.30;295.19;6.07;1180;25;2443.00;38
5893;23;22236969;5893;464;7071;7108;4.88;0.30;295.28;6.09;1178;25;2444.00;37
5897;23;22236982;5897;465;7072;7108;4.84;0.29;295.17;6.10;1175;25;2445.00;36
5898;23;22236997;5898;467;7073;7108;4.83;0.29;295.15;6.10;1175;25;2446.00;35
5899;23;22237010;5899;463;7075;7108;4.79;0.29;295.17;6.13;1176;25;2447.00;33
5903;23;22237022;5903;481;7134;7235;5.02;0.31;295.19;6.08;1231;25;2448.00;101
5905;23;22237048;5905;475;7139;7236;5.03;0.31;295.20;6.08;1234;25;2449.00;97
5906;23;22237062;5906;470;7148;7236;5.03;0.31;295.19;6.08;1242;25;2450.00;88
5908;23;22237077;5908;460;7150;7236;5.05;0.31;295.27;6.08;1242;25;2451.00;86
5912;23;22237090;5912;459;7156;7236;5.06;0.31;295.26;6.09;1244;25;2452.00;80
5914;23;22237106;5914;445;7157;7236;5.03;0.31;295.32;6.09;1243;25;2453.00;79
5915;23;22237120;5915;442;7160;7236;5.00;0.31;295.34;6.09;1245;25;2454.00;76
5918;23;22237135;5918;444;7162;7236;4.92;0.30;295.48;6.09;1244;25;2455.00;74
5921;23;22237150;5921;453;7165;7237;4.87;0.30;295.51;6.09;1244;25;2456.00;72
5923;23;22237165;5923;443;7170;7238;4.82;0.30;295.65;6.11;1247;25;2457.00;68
5926;23;22237181;5926;442;7171;7238;4.80;0.30;295.80;6.11;1245;25;2458.00;67
5927;23;22237197;5927;446;7174;7239;4.79;0.30;295.84;6.11;1247;25;2459.00;65
5931;23;22237214;5931;445;7177;7239;4.76;0.30;295.99;6.12;1246;25;2460.00;62
5933;23;22237230;5933;436;7178;7239;4.79;0.30;296.12;6.12;1245;25;2461.00;61
5939;23;22237244;5939;433;7181;7239;4.81;0.30;296.27;6.13;1242;25;2462.00;58
5943;23;22237259;5943;435;7183;7243;4.88;0.30;296.37;6.13;1240;25;2463.00;60
5946;23;22237282;5946;433;7185;7243;4.97;0.31;296.45;6.14;1239;25;2464.00;58
5948;23;22237298;5948;433;7187;7243;5.06;0.31;296.51;6.14;1239;25;2465.00;56
5954;23;22237313;5954;432;7187;7246;5.07;0.31;296.64;6.14;1233;25;2466.00;59
5957;23;22237330;5957;433;7189;7246;5.13;0.32;296.71;6.14;1232;25;2467.00;57
5961;23;22237347;5961;436;7193;7246;5.14;0.32;296.77;6.16;1232;25;2468.00;53
5968;23;22237362;5968;436;7197;7250;5.11;0.31;296.93;6.16;1229;25;2469.00;53
5971;23;22237379;5971;442;7200;7251;5.14;0.32;296.84;6.16;1229;25;2470.00;51
5975;23;22237397;5975;457;7202;7251;5.18;0.32;297.02;6.17;1227;25;2471.00;49
5980;23;22237414;5980;456;7204;7255;5.17;0.32;297.17;6.17;1224;25;2472.00;51
5982;23;22237430;5982;459;7204;7255;5.21;0.32;297.26;6.17;1222;25;2473.00;51
5985;23;22237445;5985;461;7206;7255;5.24;0.32;297.46;6.17;1221;25;2474.00;49
5989;23;22237461;5989;458;7208;7257;5.23;0.32;297.58;6.16;1219;25;2475.00;49
5995;23;22237478;5995;455;7208;7257;5.28;0.32;297.60;6.16;1213;25;2476.00;49
6003;23;22237495;6003;454;7212;7263;5.27;0.32;297.68;6.16;1209;25;2477.00;51
6007;23;22237512;6007;452;7212;7263;5.29;0.32;297.75;6.16;1205;25;2478.00;51
6011;23;22237529;6011;437;7212;7264;5.29;0.32;297.85;6.16;1201;25;2479.00;52
6015;23;22237550;6015;439;7212;7264;5.30;0.32;297.90;6.16;1197;25;2480.00;52
6016;23;22237567;6016;435;7212;7264;5.33;0.33;297.93;6.16;1196;25;2481.00;52
6020;23;22237582;6020;438;7212;7264;5.37;0.33;298.06;6.16;1192;25;2482.00;52
6023;23;22237598;6023;438;7212;7264;5.43;0.33;298.07;6.16;1189;25;2483.00;52
6028;23;22237613;6028;436;7217;7276;5.50;0.34;298.08;6.16;1189;25;2484.00;59
6031;23;22237632;6031;430;7218;7276;5.54;0.34;298.18;6.16;1187;25;2485.00;58
6034;23;22237648;6034;433;7218;7276;5.59;0.34;298.40;6.16;1184;25;2486.00;58
6035;23;22237663;6035;436;7219;7276;5.58;0.34;298.52;6.16;1184;25;2487.00;57
6038;23;22237679;6038;438;7220;7276;5.58;0.34;298.70;6.17;1182;25;2488.00;56
6042;23;22237695;6042;434;7221;7276;5.55;0.34;298.85;6.17;1179;25;2489.00;55
6047;23;22237713;6047;438;7226;7280;5.55;0.34;298.99;6.18;1179;25;2490.00;54
6053;23;22237730;6053;437;7229;7280;5.51;0.34;299.19;6.21;1176;25;2491.00;51
6054;23;22237747;6054;441;7232;7284;5.56;0.34;299.30;6.20;1178;25;2492.00;52
6057;23;22237766;6057;444;7234;7285;5.55;0.34;299.38;6.20;1177;25;2493.00;51
6062;23;22237785;6062;452;7235;7285;5.50;0.34;299.55;6.20;1173;25;2494.00;50
6066;23;22237803;6066;456;7235;7285;5.46;0.33;299.75;6.20;1169;25;2495.00;50
6068;23;22237821;6068;471;7244;7298;5.41;0.33;299.84;6.20;1176;25;2496.00;54
6071;23;22237839;6071;455;7247;7298;5.38;0.33;299.88;6.22;1176;25;2497.00;51
6074;23;22237856;6074;457;7248;7298;5.41;0.33;300.11;6.22;1174;25;2498.00;50
6075;23;22237872;6075;453;7249;7299;5.44;0.33;300.12;6.22;1174;25;2499.00;50
6080;23;22237892;6080;459;7251;7300;5.45;0.33;300.34;6.25;1171;25;2500.00;49
6085;23;22237929;6085;445;7251;7300;5.46;0.33;300.55;6.25;1166;25;2501.00;49
6085;23;22237949;6085;446;7253;7303;5.54;0.34;300.55;6.25;1168;25;2502.00;50
6088;23;22237968;6088;452;7254;7303;5.56;0.34;300.59;6.26;1166;25;2503.00;49
6091;23;22237987;6091;457;7257;7303;5.58;0.34;300.61;6.28;1166;25;2504.00;46
6093;23;22238004;6093;460;7258;7303;5.56;0.34;300.63;6.30;1165;25;2505.00;45
6098;23;22238022;6098;453;7263;7309;5.54;0.34;300.73;6.29;1165;25;2506.00;46
6101;23;22238041;6101;451;7263;7309;5.57;0.34;300.83;6.29;1162;25;2507.00;46
6104;23;22238059;6104;446;7264;7309;5.58;0.34;300.90;6.30;1160;25;2508.00;45
6104;23;22238075;6104;455;7264;7309;5.64;0.34;300.90;6.30;1160;25;2509.00;45
6107;23;22238091;6107;457;7266;7313;5.62;0.34;300.91;6.30;1159;25;2510.00;47
6111;23;22238109;6111;463;7267;7314;5.57;0.34;300.87;6.30;1156;25;2511.00;47
6115;23;22238125;6115;466;7267;7314;5.57;0.34;300.97;6.30;1152;25;2512.00;47
6118;23;22238141;6118;465;7268;7315;5.62;0.34;300.94;6.30;1150;25;2513.00;47
6121;23;22238157;6121;469;7269;7315;5.61;0.34;300.99;6.31;1148;25;2514.00;46
6122;23;22238174;6122;470;7269;7315;5.64;0.34;301.02;6.31;1147;25;2515.00;46
6123;23;22238190;6123;476;7269;7315;5.65;0.34;301.00;6.31;1146;25;2516.00;46
6130;23;22238214;6130;482;7272;7315;5.56;0.34;301.23;6.34;1142;25;2517.00;43
6132;23;22238231;6132;478;7272;7315;5.53;0.34;301.30;6.34;1140;25;2518.00;43
6134;23;22238255;6134;477;7272;7315;5.53;0.34;301.36;6.34;1138;25;2519.00;43
6135;23;22238273;6135;504;7336;7440;5.62;0.35;301.41;6.29;1201;25;2520.00;104
6137;23;22238301;6137;492;7338;7441;5.63;0.35;301.47;6.29;1201;25;2521.00;103
6137;23;22238316;6137;480;7344;7441;5.74;0.35;301.47;6.28;1207;25;2522.00;97
6138;23;22238332;6138;470;7346;7441;5.77;0.36;301.51;6.29;1208;25;2523.00;95
6139;23;22238348;6139;472;7351;7441;5.81;0.36;301.57;6.29;1212;25;2524.00;90
6140;23;22238364;6140;466;7353;7441;5.81;0.36;301.60;6.30;1213;25;2525.00;88
6143;23;22238379;6143;471;7357;7441;5.79;0.36;301.65;6.30;1214;25;2526.00;84
6145;23;22238397;6145;469;7360;7441;5.75;0.35;301.78;6.30;1215;25;2527.00;81
6145;23;22238412;6145;482;7367;7442;5.73;0.35;301.78;6.32;1222;25;2528.00;75
6149;23;22238428;6149;490;7374;7443;5.68;0.35;301.86;6.33;1225;25;2529.00;69
6153;23;22238444;6153;493;7379;7443;5.60;0.34;301.97;6.33;1226;25;2530.00;64
6156;23;22238462;6156;501;7385;7447;5.53;0.34;302.01;6.33;1229;25;2531.00;62
6158;23;22238479;6158;501;7390;7447;5.49;0.34;302.08;6.34;1232;25;2532.00;57
6158;23;22238495;6158;505;7390;7447;5.48;0.34;302.08;6.34;1232;25;2533.00;57
6162;23;22238511;6162;511;7391;7447;5.43;0.33;302.35;6.34;1229;25;2534.00;56
6164;23;22238526;6164;518;7396;7453;5.41;0.33;302.43;6.33;1232;25;2535.00;57
6166;23;22238543;6166;520;7397;7453;5.41;0.33;302.47;6.34;1231;25;2536.00;56
6171;23;22238558;6171;524;7399;7455;5.37;0.33;302.67;6.34;1228;25;2537.00;56
6173;23;22238575;6173;525;7403;7458;5.35;0.33;302.68;6.33;1230;25;2538.00;55
6178;23;22238590;6178;538;7404;7458;5.31;0.33;302.73;6.34;1226;25;2539.00;54
6180;23;22238607;6180;538;7405;7458;5.27;0.32;302.85;6.34;1225;25;2540.00;53
6185;23;22238623;6185;547;7405;7459;5.21;0.32;302.94;6.34;1220;25;2541.00;54
6186;23;22238641;6186;541;7406;7460;5.19;0.32;303.06;6.33;1220;25;2542.00;54
6188;23;22238656;6188;532;7406;7460;5.17;0.32;303.22;6.33;1218;25;2543.00;54
6192;23;22238672;6192;523;7413;7473;5.14;0.31;303.29;6.33;1221;25;2544.00;60
6196;23;22238689;6196;523;7414;7473;5.14;0.31;303.42;6.33;1218;25;2545.00;59
6200;23;22238705;6200;521;7415;7473;5.15;0.32;303.64;6.33;1215;25;2546.00;58
6204;23;22238720;6204;514;7416;7474;5.16;0.32;303.65;6.33;1212;25;2547.00;58
6204;23;22238736;6204;513;7416;7474;5.20;0.32;303.65;6.33;1212;25;2548.00;58
6206;23;22238751;6206;517;7419;7478;5.16;0.32;303.67;6.32;1213;25;2549.00;59
6209;23;22238769;6209;519;7421;7481;5.11;0.31;303.71;6.32;1212;25;2550.00;60
6212;23;22238786;6212;521;7425;7485;5.01;0.31;303.68;6.32;1213;25;2551.00;60
6212;23;22238802;6212;520;7425;7485;4.95;0.30;303.68;6.32;1213;25;2552.00;60
6216;23;22238818;6216;527;7425;7485;4.85;0.30;303.64;6.32;1209;25;2553.00;60
6219;23;22238834;6219;524;7425;7485;4.76;0.29;303.56;6.32;1206;25;2554.00;60
6223;23;22238850;6223;519;7427;7485;4.73;0.29;303.60;6.37;1204;25;2555.00;58
6227;23;22238866;6227;518;7435;7497;4.77;0.29;303.69;6.36;1208;25;2556.00;62
6231;23;22238882;6231;519;7436;7497;4.73;0.29;303.66;6.36;1205;25;2557.00;61
6236;23;22238897;6236;521;7436;7497;4.75;0.29;303.71;6.36;1200;25;2558.00;61
6238;23;22238912;6238;520;7436;7497;4.78;0.29;303.69;6.36;1198;25;2559.00;61
6239;23;22238928;6239;524;7436;7497;4.84;0.30;303.65;6.36;1197;25;2560.00;61
6240;23;22238941;6240;518;7436;7497;4.87;0.30;303.73;6.36;1196;25;2561.00;61
6241;23;22238955;6241;516;7436;7498;4.88;0.30;303.74;6.36;1195;25;2562.00;62
6242;23;22238970;6242;518;7436;7498;4.89;0.30;303.72;6.36;1194;25;2563.00;62
6245;23;22238984;6245;509;7440;7504;4.95;0.30;303.66;6.36;1195;25;2564.00;64
6247;23;22238999;6247;501;7442;7506;5.01;0.30;303.64;6.35;1195;25;2565.00;64
6250;23;22239017;6250;503;7442;7506;5.02;0.30;303.59;6.35;1192;25;2566.00;64
6255;23;22239032;6255;499;7442;7506;4.96;0.30;303.46;6.35;1187;25;2567.00;64
6257;23;22239047;6257;496;7445;7510;4.96;0.30;303.38;6.35;1188;25;2568.00;65
6259;23;22239062;6259;497;7445;7510;4.96;0.30;303.31;6.35;1186;25;2569.00;65
6260;23;22239076;6260;503;7445;7510;4.94;0.30;303.29;6.35;1185;25;2570.00;65
6263;23;22239089;6263;491;7446;7511;4.94;0.30;303.34;6.35;1183;25;2571.00;65
6263;23;22239104;6263;492;7449;7515;4.97;0.30;303.34;6.35;1186;25;2572.00;66
6263;23;22239118;6263;493;7451;7515;4.98;0.30;303.34;6.36;1188;25;2573.00;64
6267;23;22239131;6267;499;7453;7518;4.99;0.30;303.35;6.36;1186;25;2574.00;65
6270;23;22239146;6270;504;7454;7518;4.92;0.30;303.25;6.36;1184;25;2575.00;64
6271;23;22239159;6271;503;7456;7518;4.91;0.30;303.23;6.37;1185;25;2576.00;62
6273;23;22239173;6273;514;7456;7518;4.90;0.30;303.19;6.37;1183;25;2577.00;62
6274;23;22239188;6274;514;7461;7522;4.90;0.30;303.17;6.37;1187;25;2578.00;61
6275;23;22239202;6275;506;7461;7522;4.91;0.30;303.17;6.37;1186;25;2579.00;61
6275;23;22239219;6275;500;7462;7522;4.93;0.30;303.17;6.39;1187;25;2580.00;60
6275;23;22239235;6275;500;7462;7522;4.95;0.30;303.17;6.39;1187;25;2581.00;60
6279;23;22239249;6279;497;7464;7523;4.95;0.30;303.16;6.44;1185;25;2582.00;59
6280;23;22239264;6280;492;7465;7524;4.99;0.30;303.14;6.44;1185;26;2583.00;59
6282;23;22239294;6282;487;7465;7524;5.01;0.31;303.08;6.44;1183;26;2584.00;59
6282;24;22239308;6282;481;7467;7525;5.07;0.31;303.08;6.46;1185;27;2585.00;58
6282;24;22239337;6282;484;7469;7525;5.10;0.31;303.08;6.51;1187;27;2586.00;56
6284;24;22239350;6284;484;7470;7525;5.12;0.31;303.02;6.52;1186;27;2587.00;55
6285;24;22239373;6285;471;7471;7525;5.14;0.31;302.99;6.55;1186;27;2588.00;54
6285;24;22239395;6285;463;7472;7525;5.19;0.32;302.99;6.56;1187;27;2589.00;53
6285;24;22239409;6285;462;7474;7525;5.23;0.32;302.99;6.60;1189;27;2590.00;51
6286;24;22239424;6286;460;7474;7525;5.27;0.32;302.97;6.60;1188;27;2591.00;51
6287;24;22239439;6287;471;7530;7652;5.57;0.35;302.96;6.57;1243;27;2592.00;122
6288;24;22239470;6288;465;7533;7653;5.56;0.35;302.94;6.58;1245;27;2593.00;120
6289;24;22239489;6289;453;7543;7653;5.66;0.35;302.92;6.60;1254;27;2594.00;110
6290;24;22239506;6290;460;7548;7653;5.68;0.35;302.94;6.59;1258;27;2595.00;105
6293;24;22239521;6293;455;7556;7653;5.69;0.35;302.88;6.62;1263;27;2596.00;97
6295;24;22239538;6295;449;7559;7653;5.69;0.35;302.98;6.62;1264;27;2597.00;94
6298;24;22239554;6298;448;7564;7653;5.63;0.35;302.95;6.65;1266;27;2598.00;89
6302;24;22239578;6302;447;7567;7653;5.60;0.35;302.84;6.65;1265;27;2599.00;86
6305;24;22239633;6305;445;7571;7654;5.55;0.34;302.82;6.66;1266;27;2600.00;83
6308;24;22239654;6308;442;7574;7655;5.49;0.34;302.90;6.68;1266;27;2601.00;81
6312;24;22239670;6312;436;7577;7655;5.43;0.33;303.12;6.69;1265;27;2602.00;78
6314;24;22239686;6314;436;7581;7656;5.41;0.33;303.16;6.72;1267;27;2603.00;75
6317;24;22239702;6317;436;7584;7656;5.37;0.33;303.17;6.73;1267;27;2604.00;72
6319;24;22239718;6319;436;7588;7656;5.36;0.33;303.14;6.75;1269;27;2605.00;68
6322;24;22239734;6322;431;7591;7656;5.34;0.33;303.14;6.75;1269;27;2606.00;65
6324;24;22239750;6324;422;7596;7660;5.40;0.33;303.13;6.76;1272;27;2607.00;64
6325;24;22239772;6325;433;7598;7660;5.41;0.33;303.08;6.78;1273;27;2608.00;62
6329;24;22239788;6329;432;7600;7660;5.40;0.33;303.11;6.80;1271;27;2609.00;60
6329;24;22239806;6329;425;7604;7666;5.39;0.33;303.11;6.80;1275;27;2610.00;62
6332;24;22239830;6332;434;7604;7666;5.38;0.33;303.22;6.80;1272;27;2611.00;62
6336;24;22239846;6336;444;7608;7666;5.40;0.33;303.27;6.82;1272;27;2612.00;58
6339;24;22239862;6339;446;7612;7670;5.40;0.33;303.29;6.82;1273;27;2613.00;58
6343;25;22239879;6343;451;7614;7671;5.38;0.33;303.30;6.84;1271;28;2614.00;57
6348;25;22239911;6348;464;7615;7671;5.35;0.33;303.36;6.84;1267;28;2615.00;56
6351;25;22239927;6351;468;7620;7675;5.34;0.33;303.41;6.86;1269;28;2616.00;55
6354;25;22239955;6354;481;7622;7675;5.30;0.33;303.55;6.90;1268;28;2617.00;53
6359;25;22239973;6359;490;7622;7675;5.23;0.32;303.57;6.90;1263;28;2618.00;53
6361;25;22239989;6361;497;7623;7676;5.23;0.32;303.66;6.91;1262;28;2619.00;53
6364;25;22240007;6364;492;7623;7676;5.21;0.32;303.76;6.91;1259;28;2620.00;53
6370;25;22240024;6370;496;7629;7682;5.15;0.32;303.89;6.93;1259;28;2621.00;53
6372;25;22240041;6372;499;7629;7682;5.11;0.31;303.92;6.93;1257;28;2622.00;53
6379;25;22240058;6379;505;7630;7683;5.04;0.31;304.02;6.93;1251;28;2623.00;53
6382;25;22240074;6382;503;7631;7683;5.01;0.31;304.12;6.94;1249;28;2624.00;52
6385;25;22240089;6385;484;7633;7683;5.00;0.31;304.20;6.97;1248;28;2625.00;50
6388;25;22240105;6388;477;7633;7683;5.02;0.31;304.28;6.97;1245;28;2626.00;50
6394;25;22240121;6394;463;7633;7683;4.98;0.30;304.38;6.97;1239;28;2627.00;50
6396;25;22240137;6396;456;7640;7695;5.05;0.31;304.41;6.97;1244;28;2628.00;55
6402;25;22240153;6402;453;7641;7695;5.10;0.31;304.56;6.97;1239;28;2629.00;54
6406;25;22240175;6406;450;7641;7695;5.16;0.32;304.71;6.97;1235;28;2630.00;54
6408;25;22240191;6408;441;7641;7695;5.26;0.32;304.79;6.97;1233;28;2631.00;54
6412;25;22240208;6412;435;7641;7695;5.32;0.32;304.85;6.97;1229;28;2632.00;54
6416;25;22240224;6416;420;7641;7695;5.34;0.33;304.93;6.97;1225;28;2633.00;54
6420;25;22240240;6420;412;7644;7699;5.38;0.33;305.16;6.97;1224;28;2634.00;55
6422;25;22240257;6422;401;7644;7699;5.41;0.33;305.25;6.97;1222;28;2635.00;55
6426;25;22240273;6426;391;7647;7703;5.47;0.33;305.28;6.96;1221;28;2636.00;56
6429;25;22240290;6429;387;7647;7704;5.47;0.33;305.30;6.96;1218;28;2637.00;57
6435;25;22240308;6435;384;7648;7704;5.41;0.33;305.36;6.97;1213;28;2638.00;56
6438;25;22240327;6438;389;7648;7704;5.36;0.33;305.46;6.97;1210;28;2639.00;56
6441;25;22240346;6441;393;7665;7733;5.37;0.33;305.49;6.95;1224;28;2640.00;68
6442;25;22240365;6442;395;7666;7733;5.39;0.33;305.52;6.95;1224;28;2641.00;67
6444;25;22240382;6444;401;7668;7733;5.46;0.33;305.55;6.95;1224;28;2642.00;65
6455;25;22240399;6455;404;7671;7734;5.45;0.33;305.66;6.95;1216;28;2643.00;63
6457;25;22240417;6457;404;7671;7735;5.46;0.33;305.69;6.95;1214;28;2644.00;64
6461;25;22240433;6461;408;7671;7735;5.48;0.33;305.81;6.95;1210;28;2645.00;64
6467;25;22240450;6467;418;7672;7738;5.44;0.33;305.82;6.95;1205;28;2646.00;66
6469;25;22240467;6469;415;7673;7738;5.46;0.33;305.80;6.95;1204;28;2647.00;65
6473;25;22240483;6473;412;7673;7738;5.45;0.33;305.92;6.95;1200;28;2648.00;65
6475;25;22240500;6475;410;7674;7738;5.44;0.33;306.04;6.95;1199;28;2649.00;64
6477;25;22240517;6477;420;7678;7744;5.45;0.33;306.16;6.95;1201;28;2650.00;66
6481;25;22240533;6481;415;7679;7744;5.46;0.33;306.34;6.95;1198;28;2651.00;65
6486;25;22240550;6486;418;7679;7744;5.48;0.33;306.59;6.95;1193;28;2652.00;65
6488;25;22240566;6488;415;7680;7744;5.59;0.34;306.58;6.95;1192;28;2653.00;64
6492;25;22240582;6492;412;7684;7748;5.62;0.34;306.70;6.95;1192;28;2654.00;64
6494;25;22240600;6494;408;7687;7750;5.68;0.35;306.71;6.96;1193;28;2655.00;63
6499;25;22240617;6499;410;7688;7750;5.65;0.35;306.81;6.97;1189;28;2656.00;62
6501;25;22240642;6501;414;7689;7751;5.65;0.35;306.88;6.97;1188;28;2657.00;62
6505;25;22240657;6505;419;7689;7751;5.66;0.35;306.92;6.97;1184;28;2658.00;62
6509;25;22240674;6509;422;7691;7751;5.63;0.34;307.00;6.98;1182;28;2659.00;60
6514;25;22240690;6514;424;7692;7751;5.58;0.34;307.15;6.98;1178;28;2660.00;59
6517;25;22240707;6517;430;7694;7751;5.60;0.34;307.17;6.99;1177;28;2661.00;57
6521;25;22240722;6521;434;7695;7751;5.61;0.34;307.34;7.01;1174;28;2662.00;56
6524;25;22240740;6524;436;7695;7751;5.62;0.34;307.39;7.01;1171;28;2663.00;56
6530;25;22240757;6530;446;7726;7821;5.64;0.34;307.65;7.00;1196;28;2664.00;95
6533;25;22240780;6533;444;7729;7822;5.65;0.34;307.61;7.00;1196;28;2665.00;93
6539;25;22240797;6539;448;7733;7822;5.62;0.34;307.70;7.02;1194;28;2666.00;89
6543;25;22240813;6543;453;7734;7822;5.59;0.34;307.83;7.02;1191;28;2667.00;88
6544;25;22240829;6544;453;7736;7822;5.61;0.34;307.92;7.02;1192;28;2668.00;86
6548;25;22240844;6548;458;7739;7822;5.59;0.34;308.05;7.03;1191;28;2669.00;83
6551;25;22240861;6551;463;7740;7822;5.58;0.34;308.14;7.03;1189;28;2670.00;82
6552;25;22240878;6552;466;7743;7822;5.57;0.34;308.22;7.03;1191;28;2671.00;79
6554;25;22240900;6554;467;7746;7823;5.55;0.34;308.29;7.05;1192;28;2672.00;77
6557;25;22240916;6557;461;7747;7824;5.50;0.33;308.44;7.05;1190;28;2673.00;77
6558;25;22240934;6558;463;7749;7824;5.44;0.33;308.50;7.06;1191;28;2674.00;75
6563;25;22240950;6563;468;7753;7828;5.36;0.33;308.58;7.06;1190;28;2675.00;75
6563;25;22240980;6563;474;7756;7828;5.36;0.33;308.58;7.08;1193;28;2676.00;72
6565;25;22240996;6565;482;7758;7828;5.34;0.33;308.68;7.08;1193;28;2677.00;70
6569;25;22241012;6569;481;7761;7828;5.39;0.33;308.78;7.09;1192;28;2678.00;67
6570;25;22241036;6570;490;7767;7834;5.44;0.33;308.83;7.09;1197;28;2679.00;67
6576;25;22241052;6576;494;7768;7834;5.38;0.33;309.04;7.09;1192;28;2680.00;66
6579;25;22241075;6579;489;7770;7834;5.42;0.33;309.12;7.10;1191;28;2681.00;64
6580;25;22241090;6580;492;7773;7837;5.54;0.34;309.16;7.10;1193;29;2682.00;64
6582;25;22241120;6582;488;7774;7837;5.57;0.34;309.22;7.10;1192;29;2683.00;63
6584;25;22241136;6584;486;7775;7837;5.59;0.34;309.40;7.11;1191;29;2684.00;62
6588;25;22241151;6588;488;7776;7838;5.59;0.34;309.32;7.12;1188;29;2685.00;62
6590;25;22241168;6590;489;7777;7839;5.62;0.34;309.39;7.12;1187;29;2686.00;62
6595;25;22241183;6595;493;7779;7839;5.62;0.34;309.52;7.14;1184;29;2687.00;60
6599;25;22241200;6599;508;7790;7852;5.61;0.34;309.71;7.14;1191;29;2688.00;62
6600;25;22241219;6600;508;7791;7852;5.58;0.34;309.75;7.15;1191;29;2689.00;61
6605;25;22241235;6605;509;7795;7852;5.53;0.34;310.10;7.17;1190;29;2690.00;57
6608;25;22241251;6608;512;7796;7853;5.53;0.34;310.33;7.17;1188;29;2691.00;57
6611;25;22241268;6611;512;7798;7853;5.51;0.33;310.44;7.19;1187;29;2692.00;55
6615;25;22241284;6615;507;7803;7857;5.54;0.34;310.51;7.19;1188;29;2693.00;54
6617;25;22241301;6617;511;7805;7857;5.55;0.34;310.66;7.19;1188;29;2694.00;52
6619;25;22241317;6619;510;7809;7861;5.50;0.33;310.72;7.20;1190;29;2695.00;52
6621;25;22241333;6621;514;7809;7861;5.48;0.33;310.73;7.20;1188;29;2696.00;52
6624;25;22241350;6624;523;7809;7861;5.44;0.33;310.83;7.20;1185;29;2697.00;52
6625;25;22241366;6625;520;7812;7861;5.39;0.33;310.85;7.21;1187;29;2698.00;49
6627;25;22241384;6627;512;7812;7861;5.33;0.32;310.92;7.21;1185;29;2699.00;49
6629;25;22241403;6629;519;7837;7910;5.34;0.33;310.91;7.19;1208;29;2700.00;73
6630;25;22241432;6630;525;7838;7910;5.27;0.32;310.91;7.19;1208;29;2701.00;72
6635;25;22241448;6635;533;7842;7910;5.17;0.31;310.98;7.19;1207;29;2702.00;68
6638;25;22241464;6638;531;7845;7910;5.11;0.31;310.93;7.19;1207;29;2703.00;65
6640;25;22241479;6640;543;7848;7910;5.03;0.31;310.96;7.19;1208;29;2704.00;62
6641;25;22241494;6641;554;7850;7910;4.95;0.30;310.93;7.19;1209;29;2705.00;60
6643;25;22241517;6643;546;7850;7911;4.90;0.30;310.95;7.19;1207;29;2706.00;61
6643;25;22241533;6643;545;7850;7911;4.86;0.30;310.95;7.19;1207;29;2707.00;61
6644;25;22241548;6644;553;7857;7917;4.81;0.29;310.97;7.20;1213;29;2708.00;60
6644;25;22241563;6644;553;7858;7918;4.82;0.29;310.97;7.20;1214;29;2709.00;60
6645;25;22241578;6645;562;7858;7918;4.81;0.29;310.94;7.20;1213;29;2710.00;60
6646;25;22241591;6646;564;7859;7918;4.79;0.29;310.94;7.20;1213;29;2711.00;59
6648;25;22241606;6648;577;7862;7922;4.81;0.29;310.97;7.19;1214;29;2712.00;60
6650;25;22241622;6650;579;7862;7922;4.76;0.29;310.95;7.19;1212;29;2713.00;60
6650;25;22241637;6650;584;7863;7922;4.76;0.29;310.95;7.19;1213;29;2714.00;59
6651;25;22241651;6651;581;7864;7923;4.76;0.29;311.04;7.19;1213;29;2715.00;59
6653;25;22241666;6653;580;7868;7927;4.74;0.29;311.05;7.19;1215;29;2716.00;59
6657;25;22241682;6657;576;7868;7927;4.73;0.29;311.03;7.19;1211;29;2717.00;59
6657;25;22241697;6657;569;7870;7930;4.76;0.29;311.03;7.19;1213;29;2718.00;60
6661;25;22241711;6661;570;7870;7930;4.75;0.29;310.98;7.19;1209;29;2719.00;60
6664;25;22241725;6664;569;7872;7930;4.80;0.29;310.90;7.19;1208;29;2720.00;58
6665;25;22241740;6665;564;7873;7930;4.89;0.30;310.97;7.19;1208;29;2721.00;57
6669;25;22241755;6669;562;7876;7934;4.94;0.30;310.90;7.19;1207;29;2722.00;58
6674;25;22241771;6674;557;7876;7934;4.94;0.30;310.82;7.19;1202;29;2723.00;58
6677;25;22241787;6677;554;7876;7934;4.95;0.30;310.78;7.19;1199;29;2724.00;58
6680;25;22241802;6680;554;7876;7934;4.93;0.30;310.78;7.19;1196;29;2725.00;58
6683;25;22241818;6683;553;7877;7935;4.84;0.30;310.75;7.19;1194;29;2726.00;58
6686;25;22241832;6686;549;7879;7936;4.79;0.29;310.74;7.19;1193;29;2727.00;57
6688;25;22241847;6688;553;7879;7936;4.77;0.29;310.74;7.19;1191;29;2728.00;57
6689;25;22241862;6689;543;7881;7937;4.76;0.29;310.77;7.22;1192;29;2729.00;56
6692;25;22241880;6692;541;7883;7937;4.72;0.29;310.71;7.22;1191;29;2730.00;54
6695;25;22241895;6695;538;7885;7937;4.69;0.29;310.64;7.26;1190;29;2731.00;52
6698;25;22241909;6698;532;7885;7937;4.70;0.29;310.58;7.26;1187;29;2732.00;52
6699;25;22241923;6699;533;7885;7937;4.73;0.29;310.56;7.26;1186;29;2733.00;52
6701;25;22241938;6701;523;7885;7937;4.76;0.29;310.56;7.26;1184;29;2734.00;52
6702;25;22241953;6702;520;7886;7937;4.81;0.29;310.54;7.27;1184;29;2735.00;51
6703;25;22241968;6703;520;7947;8064;5.03;0.31;310.55;7.21;1244;29;2736.00;117
6703;25;22241996;6703;514;7949;8065;5.09;0.32;310.55;7.21;1246;29;2737.00;116
6708;25;22242011;6708;500;7958;8065;5.17;0.32;310.54;7.21;1250;29;2738.00;107
6710;25;22242026;6710;496;7960;8065;5.20;0.32;310.61;7.21;1250;29;2739.00;105
6711;25;22242041;6711;489;7965;8065;5.32;0.33;310.63;7.20;1254;29;2740.00;100
6714;25;22242057;6714;491;7967;8065;5.36;0.33;310.63;7.20;1253;29;2741.00;98
6715;25;22242073;6715;480;7969;8065;5.38;0.33;310.63;7.20;1254;29;2742.00;96
6718;25;22242097;6718;479;7972;8065;5.38;0.33;310.65;7.20;1254;29;2743.00;93
6719;25;22242113;6719;484;7974;8066;5.40;0.33;310.62;7.20;1255;29;2744.00;92
6721;25;22242136;6721;478;7979;8068;5.46;0.33;310.56;7.20;1258;29;2745.00;89
6723;25;22242153;6723;474;7980;8068;5.53;0.34;310.54;7.20;1257;29;2746.00;88
6724;25;22242169;6724;464;7984;8069;5.56;0.34;310.59;7.21;1260;29;2747.00;85
6725;25;22242186;6725;476;7988;8069;5.57;0.34;310.55;7.21;1263;29;2748.00;81
6727;25;22242203;6727;482;7992;8069;5.61;0.34;310.53;7.22;1265;29;2749.00;77
6730;25;22242221;6730;488;7996;8069;5.57;0.34;310.45;7.22;1266;29;2750.00;73
6731;25;22242246;6731;492;7998;8073;5.59;0.34;310.43;7.23;1267;29;2751.00;75
6731;25;22242264;6731;483;8005;8073;5.60;0.34;310.43;7.23;1274;29;2752.00;68
6734;25;22242280;6734;480;8005;8073;5.62;0.34;310.40;7.23;1271;29;2753.00;68
6734;25;22242296;6734;489;8007;8076;5.64;0.34;310.40;7.23;1273;29;2754.00;69
6736;25;22242313;6736;486;8013;8076;5.66;0.34;310.47;7.27;1277;29;2755.00;63
6737;25;22242330;6737;483;8014;8076;5.71;0.35;310.45;7.28;1277;29;2756.00;62
6740;25;22242346;6740;490;8019;8080;5.66;0.34;310.61;7.31;1279;29;2757.00;61
6742;25;22242363;6742;489;8022;8081;5.69;0.35;310.59;7.31;1280;29;2758.00;59
6746;25;22242380;6746;493;8023;8081;5.69;0.35;310.64;7.31;1277;29;2759.00;58
6749;25;22242400;6749;492;8028;8086;5.75;0.35;310.58;7.35;1279;29;2760.00;58
6752;25;22242418;6752;488;8030;8086;5.78;0.35;310.70;7.35;1278;29;2761.00;56
6755;25;22242436;6755;489;8033;8086;5.79;0.35;310.69;7.39;1278;29;2762.00;53
6756;25;22242452;6756;492;8034;8087;5.81;0.35;310.65;7.39;1278;29;2763.00;53
6759;25;22242470;6759;495;8035;8087;5.84;0.35;310.65;7.42;1276;29;2764.00;52
6763;25;22242489;6763;497;8041;8093;5.83;0.35;310.85;7.42;1278;29;2765.00;52
6763;25;22242508;6763;494;8043;8093;5.79;0.35;310.85;7.44;1280;29;2766.00;50
6766;25;22242536;6766;495;8045;8094;5.75;0.35;311.08;7.45;1279;29;2767.00;49
6769;25;22242563;6769;500;8047;8094;5.70;0.35;311.28;7.47;1278;29;2768.00;47
6771;25;22242588;6771;504;8048;8094;5.66;0.34;311.23;7.50;1277;29;2769.00;46
6773;25;22242614;6773;499;8048;8094;5.64;0.34;311.25;7.50;1275;29;2770.00;46
6773;25;22242644;6773;500;8049;8094;5.62;0.34;311.25;7.53;1276;29;2771.00;45
6775;25;22242662;6775;503;8059;8106;5.65;0.34;311.29;7.55;1284;29;2772.00;47
6776;25;22242680;6776;511;8061;8106;5.65;0.34;311.26;7.60;1285;29;2773.00;45
6777;25;22242696;6777;511;8061;8106;5.64;0.34;311.25;7.60;1284;30;2774.00;45
6778;25;22242719;6778;503;8063;8106;5.58;0.34;311.27;7.65;1285;30;2775.00;43
6782;25;22242736;6782;496;8063;8106;5.49;0.33;311.26;7.65;1281;30;2776.00;43
6785;25;22242753;6785;489;8065;8106;5.44;0.33;311.24;7.69;1280;30;2777.00;41
6787;25;22242770;6787;490;8068;8110;5.39;0.33;311.30;7.69;1281;30;2778.00;42
6791;25;22242788;6791;488;8068;8110;5.35;0.33;311.41;7.69;1277;30;2779.00;42
6794;25;22242812;6794;487;8074;8114;5.37;0.33;311.55;7.73;1280;30;2780.00;40
6797;25;22242828;6797;486;8075;8115;5.34;0.33;311.50;7.73;1278;30;2781.00;40
6799;25;22242845;6799;481;8075;8115;5.34;0.33;311.54;7.73;1276;30;2782.00;40
6803;25;22242859;6803;479;8077;8115;5.34;0.33;311.49;7.78;1274;30;2783.00;38
6804;25;22242876;6804;481;8086;8128;5.40;0.33;311.48;7.77;1282;30;2784.00;42
6808;25;22242892;6808;480;8088;8128;5.40;0.33;311.61;7.81;1280;30;2785.00;40
6808;25;22242909;6808;482;8088;8128;5.47;0.33;311.61;7.81;1280;30;2786.00;40
6813;25;22242924;6813;487;8089;8129;5.49;0.34;311.68;7.81;1276;30;2787.00;40
6817;25;22242942;6817;485;8091;8130;5.47;0.33;311.76;7.85;1274;30;2788.00;39
6821;25;22242957;6821;490;8091;8130;5.44;0.33;311.81;7.85;1270;30;2789.00;39
6822;25;22242978;6822;497;8098;8136;5.40;0.33;311.91;7.89;1276;30;2790.00;38
6828;25;22242996;6828;503;8098;8136;5.30;0.32;311.99;7.89;1270;30;2791.00;38
6832;25;22243012;6832;503;8099;8136;5.25;0.32;312.04;7.88;1267;30;2792.00;37
6834;25;22243028;6834;507;8101;8136;5.21;0.32;312.14;7.92;1267;30;2793.00;35
6838;25;22243049;6838;509;8106;8142;5.18;0.32;312.37;7.92;1268;30;2794.00;36
6843;25;22243066;6843;509;8106;8142;5.10;0.31;312.61;7.92;1263;30;2795.00;36
6845;25;22243081;6845;512;8106;8142;5.08;0.31;312.55;7.92;1261;30;2796.00;36
6850;25;22243097;6850;514;8108;8142;4.99;0.30;312.59;7.95;1258;30;2797.00;34
6852;25;22243111;6852;521;8111;8146;4.94;0.30;312.65;7.95;1259;30;2798.00;35
6855;25;22243127;6855;516;8114;8147;4.85;0.30;312.66;7.98;1259;30;2799.00;33
6859;25;22243143;6859;504;8115;8147;4.79;0.29;312.77;7.99;1256;30;2800.00;32
6862;25;22243163;6862;502;8116;8148;4.75;0.29;312.81;7.98;1254;30;2801.00;32
6864;25;22243180;6864;489;8116;8148;4.71;0.29;312.85;7.98;1252;30;2802.00;32
6867;25;22243198;6867;490;8116;8148;4.73;0.29;312.92;7.98;1249;30;2803.00;32
6870;25;22243214;6870;489;8116;8148;4.75;0.29;313.04;7.98;1246;30;2804.00;32
6872;25;22243232;6872;480;8116;8148;4.79;0.29;313.05;7.98;1244;30;2805.00;32
6876;25;22243247;6876;475;8116;8148;4.80;0.30;313.14;7.98;1240;30;2806.00;32
6877;25;22243303;6877;461;8116;8148;4.90;0.30;313.10;7.98;1239;30;2807.00;32
6882;25;22243329;6882;456;8151;8218;5.05;0.31;313.27;7.95;1269;30;2808.00;67
6889;25;22243351;6889;448;8152;8219;5.09;0.31;313.40;7.95;1263;30;2809.00;67
6892;25;22243369;6892;434;8157;8219;5.23;0.32;313.49;7.95;1265;30;2810.00;62
6896;25;22243385;6896;442;8161;8219;5.32;0.33;313.69;7.94;1265;30;2811.00;58
6901;25;22243402;6901;430;8164;8219;5.35;0.33;313.84;7.94;1263;30;2812.00;55
6905;25;22243418;6905;424;8165;8219;5.37;0.33;313.94;7.94;1260;30;2813.00;54
6906;25;22243436;6906;424;8167;8219;5.43;0.33;314.01;7.94;1261;30;2814.00;52
6909;25;22243452;6909;423;8168;8219;5.50;0.34;314.10;7.94;1259;30;2815.00;51
6911;25;22243469;6911;432;8170;8220;5.60;0.35;314.20;7.94;1259;30;2816.00;50
6913;25;22243487;6913;426;8171;8221;5.64;0.35;314.28;7.94;1258;30;2817.00;50
6918;25;22243504;6918;422;8172;8221;5.67;0.35;314.41;7.94;1254;30;2818.00;49
6925;25;22243521;6925;415;8175;8225;5.70;0.35;314.51;7.94;1250;30;2819.00;50
6929;25;22243540;6929;418;8176;8225;5.72;0.35;314.64;7.94;1247;30;2820.00;49
6935;25;22243556;6935;409;8176;8225;5.70;0.35;314.79;7.94;1241;30;2821.00;49
6938;25;22243574;6938;409;8177;8225;5.75;0.35;314.87;7.94;1239;30;2822.00;48
6945;25;22243590;6945;406;8182;8231;5.79;0.36;315.05;7.94;1237;30;2823.00;49
6950;25;22243608;6950;401;8182;8231;5.80;0.36;315.06;7.94;1232;30;2824.00;49
6955;25;22243626;6955;398;8184;8231;5.82;0.36;315.13;7.94;1229;30;2825.00;47
6958;25;22243644;6958;397;8186;8234;5.85;0.36;315.24;7.94;1228;30;2826.00;48
6962;25;22243662;6962;398;8186;8234;5.86;0.36;315.28;7.94;1224;30;2827.00;48
6966;25;22243679;6966;397;8187;8234;5.86;0.36;315.40;7.93;1221;30;2828.00;47
6973;25;22243704;6973;401;8187;8235;5.82;0.35;315.45;7.93;1214;30;2829.00;48
6976;25;22243722;6976;404;8188;8236;5.80;0.35;315.45;7.93;1212;30;2830.00;48
6981;25;22243739;6981;407;8190;8236;5.75;0.35;315.56;7.94;1209;30;2831.00;46
6987;26;22243755;6987;411;8199;8249;5.68;0.35;315.67;7.93;1212;31;2832.00;50
6992;26;22243781;6992;427;8199;8249;5.59;0.34;315.78;7.93;1207;31;2833.00;50
6997;26;22243803;6997;428;8201;8249;5.50;0.33;315.95;7.94;1204;31;2834.00;48
7000;26;22243820;7000;424;8203;8251;5.43;0.33;316.07;7.94;1203;31;2835.00;48
7003;26;22243837;7003;434;8203;8251;5.33;0.32;316.12;7.94;1200;31;2836.00;48
7007;26;22243852;7007;432;8209;8255;5.29;0.32;316.15;7.94;1202;31;2837.00;46
7012;26;22243869;7012;435;8209;8255;5.25;0.32;316.32;7.94;1197;31;2838.00;46
7012;26;22243884;7012;448;8211;8259;5.24;0.32;316.32;7.94;1199;31;2839.00;48
7014;26;22243901;7014;444;8212;8259;5.20;0.32;316.43;7.94;1198;31;2840.00;47
7017;26;22243916;7017;450;8212;8259;5.15;0.31;316.52;7.94;1195;31;2841.00;47
7019;26;22243932;7019;455;8214;8259;5.08;0.31;316.62;7.95;1195;31;2842.00;45
7025;26;22243948;7025;454;8214;8259;5.01;0.31;316.74;7.95;1189;31;2843.00;45
7028;26;22243963;7028;462;8222;8271;5.02;0.31;316.80;7.94;1194;31;2844.00;49
7031;26;22243980;7031;469;8224;8271;5.00;0.31;316.90;7.95;1193;31;2845.00;47
7034;26;22243997;7034;474;8225;8271;5.01;0.31;316.87;7.94;1191;31;2846.00;46
7036;26;22244014;7036;471;8226;8271;5.00;0.31;316.86;7.95;1190;31;2847.00;45
7040;26;22244031;7040;464;8226;8271;4.97;0.30;316.91;7.95;1186;31;2848.00;45
7044;26;22244046;7044;465;8227;8271;4.96;0.30;316.96;7.95;1183;31;2849.00;44
7048;26;22244065;7048;460;8229;8274;4.95;0.30;316.94;7.95;1181;31;2850.00;45
7049;26;22244083;7049;457;8230;8274;4.96;0.30;316.93;7.95;1181;31;2851.00;44
7050;26;22244100;7050;458;8235;8280;5.01;0.30;316.94;7.95;1185;31;2852.00;45
7052;26;22244118;7052;454;8237;8281;5.03;0.31;316.94;7.95;1185;31;2853.00;44
7052;26;22244135;7052;458;8237;8281;5.10;0.31;316.94;7.95;1185;31;2854.00;44
7055;26;22244151;7055;459;8239;8281;5.09;0.31;316.99;7.95;1184;31;2855.00;42
7057;26;22244174;7057;448;8242;8285;5.11;0.31;317.00;7.95;1185;31;2856.00;43
7057;26;22244191;7057;450;8242;8285;5.15;0.31;317.00;7.95;1185;31;2857.00;43
7059;26;22244208;7059;439;8242;8285;5.20;0.32;317.05;7.95;1183;31;2858.00;43
7062;26;22244224;7062;437;8243;8286;5.25;0.32;317.00;7.95;1181;31;2859.00;43
7062;26;22244241;7062;439;8246;8290;5.30;0.32;317.00;7.94;1184;31;2860.00;44
7064;26;22244258;7064;441;8246;8290;5.34;0.32;317.01;7.94;1182;31;2861.00;44
7065;26;22244277;7065;443;8248;8293;5.37;0.33;316.98;7.94;1183;31;2862.00;45
7066;26;22244294;7066;454;8248;8293;5.36;0.33;316.98;7.94;1182;31;2863.00;45
7068;26;22244310;7068;463;8251;8295;5.34;0.33;316.93;7.94;1183;31;2864.00;44
7069;26;22244325;7069;464;8251;8295;5.33;0.33;316.93;7.94;1182;31;2865.00;44
7072;26;22244343;7072;477;8255;8299;5.32;0.32;316.91;7.93;1183;31;2866.00;44
7073;26;22244359;7073;476;8255;8299;5.33;0.33;316.87;7.93;1182;31;2867.00;44
7078;26;22244376;7078;477;8255;8299;5.32;0.32;316.89;7.93;1177;31;2868.00;44
7082;26;22244392;7082;481;8255;8299;5.23;0.32;316.92;7.93;1173;31;2869.00;44
7085;26;22244408;7085;475;8255;8300;5.16;0.31;316.88;7.93;1170;31;2870.00;45
7087;26;22244424;7087;472;8256;8301;5.13;0.31;316.89;7.93;1169;31;2871.00;45
7087;26;22244441;7087;473;8256;8301;5.11;0.31;316.89;7.93;1169;31;2872.00;45
7089;26;22244455;7089;478;8257;8302;5.05;0.31;316.85;7.93;1168;31;2873.00;45
7090;26;22244472;7090;477;8257;8302;5.00;0.30;316.82;7.93;1167;31;2874.00;45
7094;26;22244486;7094;479;8257;8302;4.92;0.30;316.81;7.93;1163;31;2875.00;45
7096;26;22244502;7096;482;8257;8302;4.86;0.30;316.75;7.93;1161;31;2876.00;45
7099;26;22244519;7099;478;8257;8302;4.83;0.29;316.71;7.93;1158;31;2877.00;45
7100;26;22244535;7100;487;8257;8302;4.80;0.29;316.73;7.93;1157;31;2878.00;45
7101;26;22244549;7101;493;8257;8302;4.79;0.29;316.75;7.93;1156;31;2879.00;45
7104;26;22244566;7104;557;8383;8532;4.89;0.31;316.82;7.81;1279;31;2880.00;149
7104;26;22244603;7104;548;8383;8533;4.86;0.30;316.82;7.81;1279;31;2881.00;150
7110;26;22244619;7110;532;8393;8533;4.89;0.31;316.83;7.81;1283;31;2882.00;140
7111;26;22244635;7111;528;8395;8533;4.93;0.31;316.85;7.81;1284;31;2883.00;138
7111;26;22244651;7111;532;8401;8533;4.96;0.31;316.85;7.80;1290;31;2884.00;132
7112;26;22244666;7112;530;8405;8533;5.00;0.31;316.81;7.80;1293;31;2885.00;128
7112;26;22244682;7112;529;8412;8533;5.06;0.32;316.81;7.80;1300;31;2886.00;121
7112;26;22244698;7112;537;8417;8533;5.13;0.32;316.81;7.80;1305;31;2887.00;116
7113;26;22244720;7113;543;8422;8534;5.11;0.32;316.82;7.80;1309;31;2888.00;112
7115;26;22244736;7115;547;8426;8535;5.06;0.31;316.81;7.80;1311;31;2889.00;109
7117;26;22244752;7117;537;8431;8535;5.02;0.31;316.80;7.80;1314;31;2890.00;104
7120;26;22244769;7120;536;8435;8536;4.93;0.31;316.85;7.80;1315;31;2891.00;101
7121;26;22244786;7121;525;8438;8536;4.85;0.30;316.84;7.81;1317;31;2892.00;98
7124;26;22244801;7124;510;8440;8536;4.80;0.30;316.91;7.81;1316;31;2893.00;96
7125;26;22244828;7125;497;8443;8536;4.81;0.30;316.92;7.81;1318;31;2894.00;93
7126;26;22244844;7126;491;8446;8540;4.81;0.30;316.93;7.81;1320;31;2895.00;94
7126;26;22244860;7126;481;8447;8540;4.84;0.30;316.93;7.81;1321;31;2896.00;93
7128;26;22244878;7128;477;8448;8540;4.87;0.30;316.94;7.81;1320;31;2897.00;92
7128;26;22244896;7128;480;8450;8543;4.94;0.30;316.94;7.81;1322;31;2898.00;93
7129;26;22244913;7129;471;8452;8543;4.95;0.30;316.96;7.81;1323;31;2899.00;91
7131;26;22244938;7131;471;8453;8543;4.96;0.30;316.92;7.81;1322;31;2900.00;90
7131;26;22244960;7131;470;8457;8547;5.02;0.31;316.92;7.81;1326;31;2901.00;90
7133;26;22244977;7133;478;8458;8548;5.06;0.31;316.91;7.81;1325;31;2902.00;90
7134;26;22244994;7134;475;8458;8548;5.09;0.31;316.90;7.81;1324;31;2903.00;90
7139;26;22245019;7139;468;8460;8552;5.09;0.31;316.81;7.81;1321;31;2904.00;92
7142;26;22245037;7142;465;8462;8552;5.14;0.31;316.77;7.85;1320;31;2905.00;90
7144;26;22245069;7144;471;8463;8552;5.18;0.32;316.78;7.85;1319;31;2906.00;89
7145;26;22245096;7145;462;8463;8553;5.24;0.32;316.80;7.85;1318;31;2907.00;90
7147;26;22245113;7147;452;8466;8553;5.28;0.32;316.74;7.86;1319;31;2908.00;87
7153;26;22245132;7153;449;8470;8559;5.26;0.32;316.67;7.86;1317;31;2909.00;89
7153;26;22245152;7153;444;8470;8559;5.35;0.33;316.67;7.86;1317;31;2910.00;89
7155;26;22245169;7155;440;8470;8560;5.39;0.33;316.69;7.86;1315;31;2911.00;90
7155;26;22245187;7155;435;8471;8560;5.46;0.33;316.69;7.86;1316;31;2912.00;89
7157;26;22245204;7157;432;8472;8560;5.51;0.34;316.67;7.86;1315;31;2913.00;88
7160;26;22245230;7160;432;8472;8560;5.53;0.34;316.66;7.86;1312;31;2914.00;88
7163;26;22245247;7163;423;8473;8560;5.56;0.34;316.61;7.86;1310;31;2915.00;87
7166;26;22245267;7166;417;8482;8572;5.63;0.34;316.68;7.86;1316;31;2916.00;90
7168;26;22245287;7168;415;8483;8572;5.69;0.35;316.64;7.86;1315;31;2917.00;89
7171;26;22245307;7171;411;8485;8572;5.75;0.35;316.61;7.86;1314;31;2918.00;87
7174;26;22245325;7174;411;8486;8572;5.77;0.35;316.60;7.87;1312;31;2919.00;86
7175;26;22245346;7175;404;8486;8572;5.78;0.35;316.69;7.87;1311;31;2920.00;86
7178;26;22245367;7178;409;8488;8572;5.78;0.35;316.72;7.87;1310;31;2921.00;84
7181;26;22245386;7181;408;8492;8576;5.81;0.35;316.74;7.87;1311;31;2922.00;84
7185;26;22245405;7185;406;8493;8576;5.82;0.35;316.79;7.88;1308;31;2923.00;83
7188;26;22245422;7188;395;8495;8580;5.81;0.35;316.73;7.87;1307;31;2924.00;85
7190;26;22245441;7190;393;8499;8582;5.79;0.35;316.78;7.88;1309;31;2925.00;83
7192;26;22245461;7192;391;8503;8582;5.81;0.35;316.96;7.89;1311;31;2926.00;79
7193;26;22245479;7193;400;8504;8582;5.84;0.35;317.06;7.89;1311;31;2927.00;78
7195;26;22245506;7195;407;8515;8595;5.82;0.35;317.15;7.89;1320;31;2928.00;80
7196;26;22245528;7196;408;8517;8595;5.85;0.36;317.25;7.89;1321;31;2929.00;78
7200;26;22245546;7200;411;8518;8595;5.85;0.36;317.51;7.92;1318;31;2930.00;77
7202;26;22245564;7202;420;8522;8596;5.84;0.36;317.59;7.96;1320;31;2931.00;74
7208;26;22245580;7208;427;8523;8597;5.81;0.35;317.82;7.96;1315;31;2932.00;74
7209;26;22245598;7209;426;8525;8597;5.83;0.36;317.80;8.02;1316;31;2933.00;72
7212;26;22245630;7212;428;8528;8600;5.81;0.35;317.92;8.02;1316;31;2934.00;72
7213;26;22245650;7213;438;8530;8600;5.79;0.35;317.89;8.04;1317;31;2935.00;70
7213;26;22245675;7213;443;8532;8600;5.82;0.36;317.89;8.07;1319;31;2936.00;68
7217;26;22245699;7217;444;8532;8600;5.78;0.35;317.85;8.07;1315;31;2937.00;68
7220;26;22245720;7220;444;8539;8606;5.77;0.35;317.86;8.11;1319;31;2938.00;67
7223;26;22245747;7223;450;8540;8606;5.70;0.35;317.91;8.11;1317;31;2939.00;66
7224;26;22245770;7224;447;8542;8606;5.73;0.35;317.93;8.15;1318;31;2940.00;64
7227;26;22245789;7227;452;8542;8606;5.73;0.35;318.05;8.15;1315;31;2941.00;64
7229;26;22245808;7229;455;8547;8610;5.71;0.35;317.99;8.18;1318;31;2942.00;63
7231;26;22245831;7231;455;8549;8611;5.71;0.35;317.94;8.20;1318;31;2943.00;62
7233;26;22245852;7233;459;8550;8611;5.70;0.35;317.96;8.21;1317;31;2944.00;61
7236;26;22245870;7236;461;8552;8612;5.69;0.35;317.98;8.22;1316;31;2945.00;60
7237;26;22245889;7237;466;8553;8612;5.69;0.35;317.96;8.22;1316;31;2946.00;59
7239;26;22245912;7239;466;8558;8612;5.68;0.35;317.98;8.32;1319;31;2947.00;54
7242;26;22245933;7242;464;8559;8612;5.69;0.35;317.97;8.32;1317;31;2948.00;53
7244;26;22245954;7244;467;8561;8612;5.68;0.35;317.96;8.37;1317;31;2949.00;51
7246;26;22245973;7246;460;8562;8612;5.65;0.35;318.03;8.38;1316;31;2950.00;50
7247;26;22245992;7247;461;8564;8612;5.62;0.34;318.09;8.41;1317;31;2951.00;48
7254;26;22246012;7254;480;8609;8682;5.59;0.34;318.10;8.36;1355;31;2952.00;73
7254;26;22246036;7254;474;8611;8683;5.61;0.34;318.10;8.37;1357;31;2953.00;72
7258;26;22246053;7258;471;8614;8683;5.66;0.35;318.31;8.39;1356;31;2954.00;69
7260;26;22246072;7260;467;8614;8683;5.73;0.35;318.30;8.39;1354;31;2955.00;69
7261;26;22246094;7261;465;8615;8683;5.80;0.36;318.39;8.39;1354;31;2956.00;68
7264;26;22246111;7264;464;8618;8683;5.87;0.36;318.51;8.43;1354;31;2957.00;65
7268;26;22246129;7268;466;8621;8683;5.91;0.36;318.72;8.43;1353;31;2958.00;62
7270;26;22246147;7270;466;8623;8683;5.91;0.36;318.67;8.46;1353;31;2959.00;60
7272;26;22246164;7272;466;8625;8684;5.89;0.36;318.70;8.46;1353;31;2960.00;59
7277;26;22246182;7277;470;8628;8685;5.89;0.36;318.78;8.47;1351;31;2961.00;57
7280;26;22246202;7280;473;8631;8685;5.89;0.36;318.83;8.49;1351;31;2962.00;54
7283;26;22246221;7283;480;8636;8689;5.87;0.36;318.90;8.49;1353;31;2963.00;53
7289;26;22246239;7289;484;8640;8689;5.87;0.36;318.90;8.51;1351;31;2964.00;49
7294;26;22246256;7294;487;8640;8689;5.81;0.35;318.97;8.51;1346;31;2965.00;49
7299;26;22246275;7299;492;8641;8689;5.73;0.35;319.06;8.51;1342;31;2966.00;48
7303;26;22246293;7303;499;8645;8695;5.71;0.35;319.15;8.51;1342;31;2967.00;50
7309;26;22246312;7309;508;8646;8695;5.64;0.34;319.12;8.53;1337;31;2968.00;49
7313;26;22246330;7313;513;8647;8695;5.56;0.34;319.12;8.53;1334;31;2969.00;48
7318;26;22246349;7318;508;8651;8701;5.49;0.34;319.22;8.55;1333;31;2970.00;50
7323;26;22246368;7323;508;8651;8701;5.40;0.33;319.34;8.55;1328;31;2971.00;50
7325;26;22246386;7325;519;8655;8701;5.34;0.33;319.43;8.59;1330;31;2972.00;46
7330;26;22246405;7330;528;8655;8702;5.23;0.32;319.66;8.59;1325;31;2973.00;47
7331;26;22246423;7331;528;8656;8703;5.17;0.32;319.70;8.59;1325;31;2974.00;47
7335;26;22246441;7335;526;8658;8703;5.15;0.32;319.76;8.63;1323;31;2975.00;45
7337;26;22246459;7337;518;8668;8716;5.18;0.32;319.84;8.62;1331;31;2976.00;48
7340;26;22246481;7340;512;8668;8716;5.22;0.32;319.91;8.62;1328;31;2977.00;48
7346;26;22246505;7346;509;8669;8716;5.24;0.32;320.05;8.62;1323;31;2978.00;47
7350;26;22246529;7350;515;8669;8717;5.26;0.32;320.05;8.62;1319;31;2979.00;48
7355;26;22246550;7355;515;8670;8717;5.24;0.32;320.17;8.62;1315;31;2980.00;47
7360;26;22246571;7360;506;8673;8721;5.26;0.32;320.19;8.62;1313;31;2981.00;48
7364;26;22246595;7364;501;8673;8721;5.26;0.32;320.32;8.62;1309;31;2982.00;48
7367;26;22246621;7367;489;8676;8725;5.27;0.32;320.37;8.62;1309;31;2983.00;49
7367;26;22246647;7367;477;8677;8725;5.32;0.32;320.37;8.62;1310;31;2984.00;48
7371;26;22246670;7371;474;8677;8725;5.30;0.32;320.59;8.62;1306;31;2985.00;48
7374;26;22246692;7374;467;8677;8725;5.31;0.32;320.61;8.62;1303;31;2986.00;48
7376;26;22246716;7376;458;8678;8725;5.29;0.32;320.61;8.62;1302;31;2987.00;47
7381;26;22246738;7381;452;8686;8737;5.32;0.32;320.72;8.62;1305;31;2988.00;51
7386;26;22246760;7386;443;8687;8737;5.31;0.32;320.84;8.62;1301;31;2989.00;50
7389;26;22246782;7389;438;8687;8737;5.28;0.32;320.85;8.62;1298;31;2990.00;50
7395;26;22246803;7395;434;8687;8737;5.23;0.32;321.08;8.62;1292;31;2991.00;50
7399;26;22246823;7399;442;8687;8737;5.21;0.32;321.08;8.62;1288;31;2992.00;50
7403;26;22246847;7403;443;8687;8737;5.16;0.31;321.13;8.62;1284;31;2993.00;50
7406;26;22246866;7406;452;8688;8738;5.11;0.31;321.17;8.62;1282;31;2994.00;50
7411;26;22246886;7411;446;8688;8738;5.07;0.31;321.30;8.62;1277;31;2995.00;50
7413;26;22246906;7413;451;8692;8744;5.10;0.31;321.36;8.62;1279;31;2996.00;52
7417;26;22246928;7417;450;8692;8745;5.08;0.31;321.40;8.62;1275;31;2997.00;53
7422;26;22246946;7422;454;8692;8745;5.09;0.31;321.38;8.62;1270;31;2998.00;53
7428;26;22246964;7428;463;8692;8745;5.08;0.31;321.50;8.62;1264;31;2999.00;53
7430;26;22246987;7430;471;8700;8765;5.05;0.31;321.56;8.61;1270;31;3000.00;65
7434;26;22247014;7434;472;8701;8765;4.97;0.30;321.68;8.61;1267;31;3001.00;64
7438;26;22247034;7438;477;8701;8765;4.93;0.30;321.77;8.61;1263;31;3002.00;64
7440;26;22247051;7440;476;8703;8766;4.92;0.30;321.78;8.62;1263;31;3003.00;63
7444;26;22247071;7444;479;8709;8770;4.91;0.30;321.86;8.62;1265;31;3004.00;61
7449;26;22247093;7449;479;8711;8770;4.87;0.30;322.00;8.62;1262;31;3005.00;59
7455;26;22247110;7455;487;8715;8773;4.82;0.29;322.00;8.62;1260;31;3006.00;58
7459;26;22247129;7459;479;8716;8773;4.76;0.29;322.02;8.62;1257;31;3007.00;57
7463;26;22247146;7463;480;8716;8773;4.73;0.29;322.10;8.62;1253;31;3008.00;57
7465;26;22247163;7465;485;8716;8773;4.75;0.29;322.10;8.62;1251;31;3009.00;57
7469;26;22247179;7469;490;8721;8777;4.75;0.29;322.22;8.62;1252;31;3010.00;56
7471;26;22247197;7471;489;8723;8777;4.75;0.29;322.31;8.62;1252;31;3011.00;54
7472;26;22247212;7472;492;8725;8777;4.79;0.29;322.33;8.62;1253;31;3012.00;52
7476;26;22247228;7476;497;8725;8777;4.75;0.29;322.37;8.62;1249;31;3013.00;52
7479;26;22247244;7479;506;8726;8778;4.79;0.29;322.40;8.62;1247;31;3014.00;52
7483;26;22247260;7483;514;8728;8780;4.82;0.29;322.58;8.62;1245;31;3015.00;52
7487;26;22247277;7487;516;8728;8780;4.78;0.29;322.72;8.62;1241;31;3016.00;52
7487;26;22247294;7487;525;8730;8781;4.76;0.29;322.72;8.62;1243;31;3017.00;51
7492;26;22247313;7492;528;8730;8781;4.69;0.29;322.76;8.62;1238;31;3018.00;51
7495;26;22247330;7495;534;8730;8781;4.60;0.28;322.87;8.62;1235;31;3019.00;51
7497;26;22247347;7497;545;8730;8781;4.52;0.28;322.86;8.62;1233;31;3020.00;51
7499;26;22247370;7499;547;8730;8781;4.43;0.27;322.83;8.62;1231;31;3021.00;51
7501;26;22247387;7501;540;8730;8781;4.40;0.27;322.87;8.62;1229;31;3022.00;51
7501;26;22247407;7501;542;8731;8781;4.35;0.27;322.87;8.62;1230;31;3023.00;50
7507;26;22247440;7507;550;8802;8908;4.60;0.29;322.89;8.55;1295;31;3024.00;106
7509;26;22247472;7509;544;8803;8909;4.58;0.29;322.95;8.55;1294;31;3025.00;106
7511;26;22247489;7511;546;8810;8909;4.64;0.29;323.01;8.54;1299;31;3026.00;99
7513;26;22247506;7513;539;8813;8909;4.64;0.29;322.98;8.54;1300;31;3027.00;96
7516;26;22247523;7516;541;8818;8909;4.63;0.29;323.00;8.54;1302;31;3028.00;91
7520;26;22247541;7520;546;8821;8909;4.57;0.28;322.97;8.54;1301;31;3029.00;88
7522;26;22247568;7522;553;8824;8909;4.57;0.28;322.91;8.54;1302;31;3030.00;85
7525;26;22247584;7525;545;8826;8909;4.58;0.28;322.87;8.54;1301;31;3031.00;83
7527;26;22247601;7527;540;8828;8910;4.61;0.28;322.90;8.54;1301;31;3032.00;82
7529;26;22247618;7529;538;8831;8911;4.61;0.28;322.83;8.54;1302;31;3033.00;80
7533;26;22247635;7533;541;8835;8911;4.61;0.28;322.79;8.54;1302;31;3034.00;76
7537;26;22247651;7537;532;8837;8912;4.60;0.28;322.90;8.54;1300;31;3035.00;75
7539;26;22247668;7539;536;8842;8912;4.60;0.28;322.85;8.54;1303;31;3036.00;70
7540;26;22247685;7540;535;8844;8912;4.62;0.28;322.92;8.54;1304;31;3037.00;68
7542;26;22247701;7542;537;8845;8912;4.65;0.29;322.97;8.55;1303;31;3038.00;67
7543;26;22247719;7543;541;8849;8916;4.73;0.29;322.99;8.54;1306;31;3039.00;67
7545;26;22247738;7545;548;8850;8916;4.78;0.29;322.96;8.54;1305;31;3040.00;66
7546;26;22247756;7546;557;8850;8916;4.84;0.30;322.93;8.54;1304;31;3041.00;66
7551;26;22247775;7551;558;8854;8919;4.89;0.30;323.06;8.55;1303;31;3042.00;65
7553;26;22247795;7553;565;8854;8919;4.95;0.30;323.08;8.55;1301;31;3043.00;65
7553;26;22247817;7553;567;8854;8919;5.03;0.31;323.08;8.55;1301;31;3044.00;65
7553;26;22247836;7553;572;8859;8923;5.10;0.31;323.08;8.54;1306;31;3045.00;64
7553;26;22247854;7553;570;8860;8924;5.15;0.32;323.08;8.54;1307;31;3046.00;64
7554;26;22247872;7554;572;8861;8924;5.20;0.32;323.09;8.54;1307;31;3047.00;63
7557;26;22247893;7557;575;8863;8928;5.22;0.32;323.06;8.54;1306;31;3048.00;65
7560;26;22247913;7560;575;8863;8928;5.20;0.32;323.02;8.54;1303;31;3049.00;65
7561;26;22247933;7561;570;8864;8928;5.17;0.32;323.05;8.54;1303;31;3050.00;64
7564;26;22247952;7564;558;8865;8929;5.14;0.31;323.01;8.54;1301;31;3051.00;64
7566;26;22247971;7566;551;8866;8929;5.09;0.31;322.94;8.54;1300;31;3052.00;63
7569;26;22247989;7569;547;8870;8935;5.10;0.31;322.96;8.54;1301;31;3053.00;65
7570;26;22248009;7570;547;8870;8935;5.06;0.31;322.92;8.54;1300;31;3054.00;65
7573;26;22248027;7573;546;8870;8936;5.05;0.31;322.87;8.54;1297;31;3055.00;66
7574;26;22248047;7574;542;8870;8936;5.04;0.31;322.85;8.54;1296;31;3056.00;66
7575;26;22248065;7575;537;8870;8936;5.04;0.31;322.81;8.54;1295;31;3057.00;66
7576;26;22248084;7576;539;8870;8936;5.02;0.30;322.81;8.54;1294;31;3058.00;66
7576;26;22248110;7576;540;8870;8936;5.04;0.31;322.81;8.54;1294;31;3059.00;66
7577;26;22248139;7577;542;8890;8972;5.16;0.32;322.77;8.52;1313;31;3060.00;82
7578;26;22248161;7578;539;8890;8972;5.20;0.32;322.77;8.52;1312;31;3061.00;82
7578;26;22248180;7578;540;8894;8972;5.28;0.32;322.77;8.52;1316;31;3062.00;78
7580;26;22248198;7580;539;8894;8972;5.29;0.32;322.77;8.52;1314;31;3063.00;78
7582;26;22248220;7582;539;8895;8972;5.34;0.33;322.82;8.52;1313;31;3064.00;77
7584;26;22248252;7584;532;8895;8972;5.39;0.33;322.83;8.52;1311;31;3065.00;77
7586;26;22248275;7586;523;8899;8976;5.41;0.33;322.84;8.51;1313;31;3066.00;77
7586;26;22248299;7586;520;8899;8976;5.45;0.33;322.84;8.51;1313;31;3067.00;77
7587;26;22248320;7587;516;8902;8980;5.52;0.34;322.92;8.51;1315;31;3068.00;78
7589;26;22248343;7589;516;8903;8981;5.49;0.33;322.93;8.51;1314;31;3069.00;78
7591;26;22248364;7591;508;8903;8981;5.47;0.33;322.97;8.51;1312;31;3070.00;78
7594;26;22248384;7594;496;8903;8981;5.46;0.33;322.96;8.51;1309;31;3071.00;78
7598;26;22248410;7598;492;8912;8994;5.48;0.33;322.95;8.50;1314;31;3072.00;82
7598;26;22248431;7598;489;8912;8994;5.56;0.34;322.95;8.50;1314;31;3073.00;82
7601;26;22248450;7601;487;8912;8994;5.62;0.34;323.02;8.50;1311;31;3074.00;82
7603;26;22248469;7603;480;8913;8995;5.65;0.34;323.01;8.50;1310;31;3075.00;82
7607;26;22248487;7607;477;8913;8996;5.66;0.34;322.96;8.50;1306;31;3076.00;83
7610;26;22248507;7610;482;8913;8996;5.66;0.34;323.00;8.50;1303;31;3077.00;83
7614;26;22248529;7614;483;8915;8999;5.71;0.35;323.04;8.50;1301;31;3078.00;84
7615;26;22248552;7615;474;8915;8999;5.69;0.35;323.05;8.50;1300;31;3079.00;84
7618;26;22248576;7618;470;8918;8999;5.71;0.35;323.12;8.56;1300;31;3080.00;81
7622;26;22248602;7622;475;8918;8999;5.72;0.35;323.08;8.56;1296;31;3081.00;81
7624;26;22248621;7624;467;8922;9005;5.76;0.35;323.07;8.55;1298;31;3082.00;83
7628;26;22248651;7628;465;8922;9005;5.77;0.35;323.19;8.55;1294;31;3083.00;83
7631;26;22248670;7631;455;8924;9005;5.79;0.35;323.23;8.56;1293;31;3084.00;81
7635;26;22248690;7635;455;8924;9005;5.81;0.35;323.25;8.56;1289;31;3085.00;81
7635;26;22248709;7635;458;8927;9009;5.86;0.36;323.25;8.56;1292;31;3086.00;82
7638;26;22248735;7638;455;8928;9010;5.94;0.36;323.28;8.56;1290;31;3087.00;82
7641;26;22248753;7641;458;8929;9010;5.90;0.36;323.29;8.56;1288;31;3088.00;81
7642;26;22248774;7642;457;8930;9011;5.94;0.36;323.26;8.56;1288;31;3089.00;81
7645;26;22248798;7645;460;8930;9011;5.97;0.36;323.28;8.56;1285;31;3090.00;81
7649;26;22248819;7649;463;8930;9011;5.95;0.36;323.34;8.56;1281;31;3091.00;81
7654;26;22248839;7654;464;8930;9011;5.94;0.36;323.30;8.56;1276;31;3092.00;81
7657;26;22248862;7657;476;8931;9011;5.95;0.36;323.39;8.56;1274;31;3093.00;80
7660;26;22248895;7660;473;8931;9011;5.92;0.36;323.35;8.56;1271;31;3094.00;80
7660;26;22248916;7660;469;8931;9011;5.92;0.36;323.35;8.56;1271;31;3095.00;80
7660;26;22248938;7660;480;8965;9081;6.03;0.37;323.35;8.53;1305;31;3096.00;116
7663;26;22248966;7663;478;8967;9082;6.00;0.37;323.33;8.54;1304;31;3097.00;115
7665;26;22248987;7665;478;8973;9082;6.04;0.37;323.41;8.53;1308;31;3098.00;109
7667;26;22249005;7667;479;8976;9082;5.99;0.36;323.40;8.54;1309;31;3099.00;106
7670;26;22249028;7670;481;8979;9082;5.93;0.36;323.57;8.53;1309;31;3100.00;103
7673;26;22249057;7673;482;8982;9082;5.83;0.35;323.59;8.54;1309;31;3101.00;100
7675;26;22249080;7675;481;8986;9082;5.81;0.35;323.67;8.54;1311;31;3102.00;96
7677;26;22249101;7677;482;8988;9082;5.77;0.35;323.74;8.54;1311;31;3103.00;94
7680;26;22249120;7680;483;8992;9083;5.72;0.35;323.75;8.54;1312;31;3104.00;91
7684;26;22249141;7684;494;8997;9085;5.66;0.34;323.80;8.54;1313;31;3105.00;88
7688;26;22249161;7688;499;9001;9085;5.61;0.34;323.77;8.58;1313;31;3106.00;84
7690;26;22249180;7690;504;9006;9089;5.61;0.34;323.77;8.60;1316;31;3107.00;83
7691;26;22249201;7691;509;9007;9089;5.64;0.34;323.87;8.60;1316;31;3108.00;82
7693;26;22249220;7693;516;9009;9089;5.64;0.34;323.82;8.63;1316;31;3109.00;80
7694;26;22249240;7694;523;9010;9089;5.68;0.35;323.81;8.63;1316;31;3110.00;79
7698;26;22249263;7698;528;9014;9095;5.72;0.35;323.88;8.63;1316;31;3111.00;81
7699;26;22249287;7699;534;9016;9095;5.72;0.35;323.98;8.66;1317;31;3112.00;79
7700;26;22249309;7700;541;9016;9095;5.69;0.35;324.03;8.66;1316;31;3113.00;79
7703;26;22249330;7703;543;9019;9098;5.74;0.35;324.12;8.66;1316;31;3114.00;79
7706;26;22249351;7706;553;9022;9098;5.73;0.35;324.23;8.72;1316;31;3115.00;76
7709;26;22249372;7709;557;9024;9098;5.70;0.35;324.23;8.72;1315;31;3116.00;74
7711;26;22249395;7711;562;9027;9099;5.69;0.35;324.35;8.78;1316;31;3117.00;72
7714;26;22249416;7714;564;9028;9100;5.67;0.34;324.35;8.78;1314;31;3118.00;72
7716;26;22249438;7716;570;9030;9100;5.64;0.34;324.29;8.84;1314;31;3119.00;70
7720;26;22249461;7720;580;9052;9126;5.65;0.34;324.50;8.87;1332;31;3120.00;74
7722;26;22249484;7722;575;9053;9126;5.63;0.34;324.68;8.87;1331;31;3121.00;73
7723;26;22249506;7723;580;9054;9126;5.63;0.34;324.67;8.87;1331;31;3122.00;72
7727;26;22249527;7727;581;9057;9127;5.61;0.34;324.91;8.92;1330;31;3123.00;70
7729;26;22249547;7729;575;9057;9127;5.61;0.34;324.91;8.92;1328;31;3124.00;70
7732;26;22249566;7732;568;9063;9131;5.61;0.34;325.04;8.97;1331;31;3125.00;68
7736;26;22249586;7736;561;9063;9131;5.58;0.34;325.10;8.97;1327;31;3126.00;68
7738;26;22249605;7738;568;9066;9135;5.58;0.34;325.09;8.96;1328;31;3127.00;69
7741;26;22249625;7741;565;9068;9135;5.58;0.34;325.21;9.02;1327;31;3128.00;67
7745;26;22249649;7745;563;9069;9135;5.61;0.34;325.31;9.04;1324;31;3129.00;66
7746;26;22249672;7746;558;9070;9135;5.63;0.34;325.29;9.06;1324;31;3130.00;65
7748;26;22249695;7748;557;9070;9135;5.63;0.34;325.41;9.06;1322;31;3131.00;65
7749;26;22249716;7749;562;9079;9147;5.67;0.35;325.49;9.05;1330;31;3132.00;68
7750;26;22249739;7750;559;9081;9147;5.68;0.35;325.55;9.10;1331;31;3133.00;66
7756;26;22249760;7756;562;9083;9147;5.65;0.34;325.52;9.10;1327;31;3134.00;64
7759;26;22249778;7759;563;9083;9147;5.67;0.35;325.62;9.10;1324;31;3135.00;64
7764;26;22249796;7764;565;9085;9147;5.60;0.34;325.82;9.14;1321;31;3136.00;62
7768;26;22249815;7768;564;9085;9147;5.57;0.34;326.02;9.14;1317;31;3137.00;62
7770;26;22249832;7770;577;9085;9148;5.53;0.34;326.12;9.14;1315;31;3138.00;63
7776;26;22249851;7776;580;9087;9148;5.44;0.33;326.20;9.19;1311;31;3139.00;61
7782;26;22249870;7782;585;9092;9154;5.48;0.33;326.37;9.18;1310;31;3140.00;62
7784;26;22249891;7784;586;9095;9155;5.48;0.33;326.43;9.22;1311;31;3141.00;60
7788;26;22249911;7788;587;9095;9155;5.44;0.33;326.55;9.22;1307;31;3142.00;60
7792;26;22249929;7792;595;9095;9155;5.42;0.33;326.64;9.22;1303;31;3143.00;60
7796;26;22249951;7796;591;9098;9159;5.42;0.33;326.73;9.22;1302;31;3144.00;61
7800;26;22249970;7800;594;9098;9159;5.35;0.33;326.75;9.22;1298;31;3145.00;61
7804;26;22249988;7804;598;9098;9159;5.28;0.32;326.81;9.22;1294;31;3146.00;61
7808;26;22250004;7808;607;9099;9160;5.18;0.31;326.88;9.22;1291;31;3147.00;61
7810;26;22250020;7810;612;9102;9164;5.09;0.31;326.93;9.22;1292;31;3148.00;62
7812;26;22250037;7812;614;9102;9164;4.98;0.30;327.03;9.22;1290;31;3149.00;62
7820;26;22250053;7820;608;9106;9170;4.88;0.30;327.19;9.21;1286;31;3150.00;64
7824;26;22250070;7824;605;9106;9170;4.81;0.29;327.32;9.21;1282;31;3151.00;64
7827;26;22250089;7827;600;9108;9170;4.72;0.29;327.38;9.21;1281;31;3152.00;62
7828;26;22250107;7828;598;9108;9170;4.68;0.29;327.39;9.21;1280;31;3153.00;62
7832;26;22250122;7832;593;9112;9174;4.64;0.28;327.42;9.21;1280;31;3154.00;62
7837;26;22250139;7837;594;9112;9174;4.60;0.28;327.58;9.21;1275;31;3155.00;62
7839;26;22250157;7839;590;9112;9174;4.61;0.28;327.58;9.21;1273;31;3156.00;62
7843;26;22250173;7843;583;9112;9174;4.62;0.28;327.59;9.21;1269;31;3157.00;62
7846;26;22250189;7846;583;9112;9175;4.64;0.28;327.63;9.21;1266;31;3158.00;63
7849;26;22250206;7849;581;9113;9176;4.64;0.28;327.70;9.21;1264;31;3159.00;63
7851;26;22250224;7851;580;9113;9176;4.62;0.28;327.73;9.21;1262;31;3160.00;63
7855;26;22250247;7855;568;9114;9177;4.64;0.28;327.78;9.21;1259;31;3161.00;63
7859;26;22250266;7859;573;9114;9177;4.63;0.28;327.93;9.21;1255;31;3162.00;63
7862;26;22250282;7862;575;9114;9177;4.64;0.28;328.02;9.21;1252;31;3163.00;63
7867;26;22250299;7867;570;9114;9177;4.66;0.28;328.13;9.21;1247;31;3164.00;63
7871;26;22250315;7871;571;9114;9177;4.67;0.29;328.21;9.21;1243;31;3165.00;63
7872;26;22250332;7872;570;9114;9177;4.69;0.29;328.24;9.21;1242;31;3166.00;63
7875;26;22250349;7875;579;9114;9177;4.67;0.29;328.27;9.21;1239;31;3167.00;63
7879;26;22250365;7879;584;9171;9304;5.07;0.32;328.28;9.15;1292;31;3168.00;133
7882;26;22250392;7882;586;9175;9305;5.07;0.31;328.27;9.15;1293;31;3169.00;130
7887;26;22250409;7887;595;9185;9305;5.06;0.31;328.31;9.14;1298;31;3170.00;120
7894;26;22250425;7894;597;9190;9305;4.98;0.31;328.30;9.13;1296;31;3171.00;115
7896;26;22250443;7896;605;9196;9305;4.99;0.31;328.38;9.13;1300;31;3172.00;109
7900;26;22250460;7900;606;9199;9305;4.90;0.30;328.42;9.13;1299;31;3173.00;106
7904;26;22250478;7904;616;9203;9305;4.78;0.30;328.39;9.13;1299;31;3174.00;102
7909;26;22250496;7909;624;9206;9305;4.66;0.29;328.36;9.13;1297;31;3175.00;99
7914;26;22250521;7914;637;9207;9306;4.53;0.28;328.46;9.13;1293;31;3176.00;99
7919;26;22250539;7919;645;9212;9307;4.41;0.27;328.48;9.16;1293;31;3177.00;95
7920;26;22250556;7920;651;9214;9307;4.41;0.27;328.44;9.16;1294;31;3178.00;93
7925;26;22250572;7925;654;9217;9308;4.35;0.27;328.45;9.16;1292;31;3179.00;91
7930;26;22250590;7930;653;9219;9308;4.31;0.27;328.43;9.16;1289;31;3180.00;89
7933;26;22250608;7933;654;9221;9308;4.32;0.27;328.42;9.16;1288;31;3181.00;87
7938;26;22250624;7938;651;9223;9308;4.30;0.27;328.45;9.16;1285;31;3182.00;85
7943;26;22250643;7943;653;9229;9312;4.25;0.26;328.44;9.16;1286;31;3183.00;83
7948;26;22250658;7948;654;9230;9312;4.19;0.26;328.39;9.16;1282;31;3184.00;82
7952;26;22250676;7952;661;9231;9312;4.13;0.26;328.43;9.16;1279;31;3185.00;81
7954;26;22250691;7954;653;9234;9315;4.08;0.25;328.47;9.16;1280;31;3186.00;81
7958;26;22250708;7958;653;9236;9315;4.03;0.25;328.40;9.16;1278;31;3187.00;79
7960;26;22250724;7960;654;9237;9315;3.99;0.25;328.39;9.16;1277;31;3188.00;78
7966;26;22250741;7966;649;9242;9319;3.97;0.24;328.41;9.16;1276;31;3189.00;77
7972;26;22250761;7972;652;9244;9320;3.93;0.24;328.24;9.16;1272;31;3190.00;76
7972;26;22250777;7972;651;9248;9322;3.95;0.24;328.24;9.16;1276;31;3191.00;74
7974;26;22250792;7974;655;9252;9326;3.97;0.24;328.17;9.19;1278;31;3192.00;74
7976;26;22250809;7976;650;9252;9326;3.95;0.24;328.14;9.19;1276;31;3193.00;74
7976;26;22250824;7976;652;9252;9326;3.96;0.24;328.14;9.19;1276;31;3194.00;74
7976;26;22250839;7976;649;9254;9328;3.99;0.24;328.14;9.19;1278;31;3195.00;74
7976;26;22250855;7976;641;9255;9328;3.99;0.24;328.14;9.21;1279;31;3196.00;73
7977;26;22250871;7977;630;9260;9334;3.99;0.24;328.11;9.21;1283;31;3197.00;74
7979;26;22250888;7979;621;9260;9334;3.97;0.24;328.03;9.21;1281;31;3198.00;74
7981;26;22250904;7981;619;9261;9335;3.99;0.24;328.09;9.23;1280;31;3199.00;74
7983;26;22250921;7983;612;9261;9335;3.97;0.24;328.08;9.23;1278;31;3200.00;74
7984;26;22250941;7984;600;9261;9335;3.97;0.24;328.04;9.23;1277;31;3201.00;74
7989;26;22250957;7989;599;9261;9335;3.95;0.24;328.01;9.23;1272;31;3202.00;74
7990;26;22250973;7990;597;9261;9335;3.95;0.24;328.01;9.23;1271;31;3203.00;74
7990;26;22250989;7990;597;9270;9347;3.99;0.24;328.01;9.22;1280;31;3204.00;77
7991;26;22251005;7991;601;9270;9347;3.99;0.24;328.03;9.22;1279;31;3205.00;77
7992;26;22251020;7992;587;9272;9347;4.04;0.25;328.03;9.22;1280;32;3206.00;75
7994;26;22251047;7994;570;9272;9347;4.05;0.25;328.05;9.22;1278;32;3207.00;75
7994;26;22251063;7994;549;9272;9347;4.10;0.25;328.05;9.22;1278;32;3208.00;75
7997;26;22251079;7997;531;9272;9347;4.17;0.25;328.06;9.22;1275;32;3209.00;75
7998;26;22251098;7998;523;9275;9351;4.25;0.26;328.02;9.21;1277;32;3210.00;76
7998;26;22251115;7998;524;9275;9351;4.37;0.27;328.02;9.21;1277;32;3211.00;76
7998;26;22251131;7998;516;9279;9355;4.52;0.28;328.02;9.21;1281;32;3212.00;76
8001;26;22251148;8001;508;9281;9356;4.58;0.28;328.02;9.23;1280;32;3213.00;75
8002;26;22251166;8002;506;9281;9356;4.70;0.29;328.02;9.23;1279;32;3214.00;75
8004;26;22251183;8004;505;9281;9356;4.75;0.29;328.04;9.23;1277;32;3215.00;75
8005;26;22251207;8005;497;9292;9369;4.85;0.30;328.04;9.22;1287;32;3216.00;77
8006;26;22251226;8006;486;9292;9369;4.89;0.30;328.12;9.22;1286;32;3217.00;77
8007;26;22251245;8007;474;9293;9369;4.97;0.30;328.15;9.23;1286;32;3218.00;76
8009;26;22251263;8009;478;9294;9370;5.06;0.31;328.22;9.23;1285;32;3219.00;76
8010;26;22251280;8010;480;9294;9371;5.13;0.31;328.21;9.23;1284;32;3220.00;77
8012;26;22251300;8012;475;9294;9371;5.17;0.31;328.25;9.23;1282;32;3221.00;77
8013;26;22251318;8013;470;9296;9374;5.23;0.32;328.32;9.23;1283;32;3222.00;78
8015;27;22251336;8015;466;9296;9374;5.25;0.32;328.35;9.23;1281;33;3223.00;78
8016;27;22251375;8016;460;9297;9374;5.28;0.32;328.38;9.23;1281;33;3224.00;77
8016;27;22251395;8016;459;9297;9374;5.30;0.32;328.38;9.23;1281;33;3225.00;77
8019;27;22251415;8019;456;9302;9380;5.27;0.32;328.48;9.23;1283;33;3226.00;78
8020;27;22251435;8020;454;9302;9380;5.29;0.32;328.47;9.23;1282;33;3227.00;78
8022;27;22251453;8022;456;9302;9380;5.27;0.32;328.53;9.23;1280;33;3228.00;78
8026;27;22251472;8026;458;9302;9380;5.23;0.32;328.66;9.23;1276;33;3229.00;78
8027;27;22251491;8027;451;9305;9384;5.31;0.32;328.64;9.22;1278;33;3230.00;79
8030;27;22251515;8030;453;9306;9385;5.34;0.32;328.59;9.22;1276;33;3231.00;79
8030;27;22251532;8030;442;9306;9385;5.39;0.33;328.59;9.22;1276;33;3232.00;79
8031;27;22251552;8031;440;9308;9386;5.46;0.33;328.60;9.24;1277;33;3233.00;78
8032;27;22251571;8032;437;9308;9386;5.49;0.33;328.63;9.24;1276;33;3234.00;78
8033;27;22251590;8033;425;9308;9386;5.54;0.34;328.65;9.24;1275;33;3235.00;78
8034;27;22251610;8034;424;9308;9386;5.61;0.34;328.63;9.24;1274;33;3236.00;78
8036;27;22251630;8036;421;9308;9386;5.66;0.34;328.63;9.24;1272;33;3237.00;78
8039;27;22251649;8039;426;9308;9386;5.70;0.35;328.63;9.24;1269;33;3238.00;78
8042;27;22251678;8042;428;9308;9386;5.74;0.35;328.64;9.24;1266;33;3239.00;78
8045;27;22251700;8045;443;9373;9511;5.81;0.36;328.69;9.18;1328;33;3240.00;138
8046;27;22251735;8046;421;9373;9512;5.91;0.36;328.69;9.18;1327;33;3241.00;139
8048;27;22251756;8048;408;9379;9512;6.01;0.37;328.69;9.17;1331;33;3242.00;133
8049;27;22251778;8049;404;9380;9512;6.11;0.37;328.78;9.17;1331;33;3243.00;132
8051;27;22251813;8051;401;9385;9512;6.13;0.38;328.83;9.17;1334;33;3244.00;127
8054;27;22251836;8054;389;9385;9512;6.15;0.38;328.96;9.17;1331;33;3245.00;127
8056;27;22251859;8056;397;9391;9512;6.20;0.38;328.97;9.17;1335;33;3246.00;121
8056;27;22251883;8056;394;9396;9512;6.24;0.38;328.97;9.16;1340;33;3247.00;116
8060;28;22251907;8060;395;9400;9513;6.22;0.38;329.15;9.16;1340;34;3248.00;113
8064;28;22251969;8064;400;9404;9514;6.16;0.38;329.11;9.16;1340;34;3249.00;110
8067;29;22251995;8067;398;9407;9514;6.14;0.37;329.23;9.16;1340;35;3250.00;107
8071;29;22252026;8071;399;9413;9518;6.11;0.37;329.34;9.18;1342;35;3251.00;105
8074;30;22252048;8074;393;9414;9518;6.07;0.37;329.37;9.18;1340;36;3252.00;104
8079;30;22252075;8079;390;9415;9518;6.07;0.37;329.56;9.18;1336;36;3253.00;103
8083;30;22252095;8083;389;9415;9518;6.08;0.37;329.60;9.18;1332;36;3254.00;103
8087;30;22252118;8087;394;9420;9524;6.11;0.37;329.67;9.24;1333;36;3255.00;104
8090;30;22252143;8090;393;9420;9524;6.14;0.37;329.68;9.24;1330;36;3256.00;104
8092;30;22252162;8092;382;9420;9524;6.17;0.38;329.71;9.24;1328;36;3257.00;104
8096;30;22252181;8096;385;9421;9527;6.17;0.38;329.72;9.24;1325;36;3258.00;106
8101;30;22252207;8101;385;9422;9527;6.22;0.38;329.70;9.23;1321;36;3259.00;105
8101;30;22252229;8101;391;9422;9527;6.26;0.38;329.70;9.23;1321;36;3260.00;105
8102;30;22252248;8102;389;9423;9528;6.30;0.38;329.75;9.23;1321;36;3261.00;105
8105;30;22252267;8105;382;9424;9529;6.33;0.39;329.84;9.23;1319;36;3262.00;105
8108;30;22252290;8108;394;9425;9529;6.30;0.38;329.95;9.23;1317;36;3263.00;104
8111;30;22252309;8111;392;9435;9542;6.25;0.38;330.00;9.23;1324;36;3264.00;107
8113;30;22252337;8113;393;9435;9542;6.22;0.38;330.02;9.23;1322;36;3265.00;107
8116;30;22252356;8116;388;9436;9542;6.20;0.38;330.04;9.22;1320;36;3266.00;106
8120;30;22252378;8120;388;9437;9543;6.15;0.37;329.95;9.22;1317;36;3267.00;106
8123;30;22252397;8123;383;9438;9543;6.11;0.37;329.95;9.22;1315;36;3268.00;105
8127;30;22252416;8127;381;9440;9547;6.13;0.37;329.89;9.22;1313;36;3269.00;107
8130;30;22252438;8130;383;9440;9547;6.17;0.38;330.06;9.22;1310;36;3270.00;107
8130;30;22252456;8130;385;9444;9551;6.18;0.38;330.06;9.22;1314;36;3271.00;107
8134;30;22252474;8134;386;9444;9551;6.17;0.38;330.17;9.22;1310;36;3272.00;107
8138;30;22252493;8138;396;9444;9551;6.18;0.38;330.20;9.22;1306;36;3273.00;107
8140;30;22252513;8140;393;9444;9551;6.18;0.38;330.18;9.22;1304;36;3274.00;107
8142;30;22252531;8142;401;9444;9551;6.11;0.37;330.15;9.22;1302;36;3275.00;107
8146;30;22252557;8146;407;9456;9563;6.12;0.37;330.29;9.21;1310;36;3276.00;107
8148;30;22252580;8148;406;9456;9563;6.08;0.37;330.25;9.21;1308;36;3277.00;107
8151;30;22252601;8151;411;9457;9563;6.02;0.37;330.37;9.21;1306;36;3278.00;106
8155;30;22252623;8155;422;9457;9563;5.95;0.36;330.60;9.21;1302;36;3279.00;106
8156;30;22252649;8156;428;9458;9563;5.90;0.36;330.56;9.25;1302;36;3280.00;105
8159;30;22252670;8159;436;9461;9563;5.84;0.36;330.65;9.25;1302;36;3281.00;102
8163;30;22252689;8163;439;9461;9564;5.79;0.35;330.78;9.25;1298;36;3282.00;103
8165;30;22252714;8165;446;9463;9564;5.75;0.35;330.79;9.32;1298;36;3283.00;101
8166;30;22252734;8166;458;9468;9570;5.78;0.35;330.84;9.31;1302;36;3284.00;102
8170;30;22252754;8170;459;9472;9572;5.76;0.35;330.79;9.37;1302;36;3285.00;100
8172;30;22252774;8172;469;9472;9572;5.71;0.35;330.79;9.37;1300;36;3286.00;100
8175;30;22252796;8175;476;9474;9572;5.68;0.35;330.90;9.43;1299;36;3287.00;98
8177;30;22252815;8177;474;9477;9576;5.68;0.35;330.97;9.43;1300;36;3288.00;99
8183;30;22252833;8183;486;9477;9576;5.63;0.34;331.14;9.43;1294;36;3289.00;99
8186;30;22252850;8186;494;9479;9576;5.55;0.34;331.18;9.49;1293;36;3290.00;97
8188;30;22252868;8188;501;9480;9577;5.51;0.34;331.25;9.49;1292;36;3291.00;97
8190;30;22252885;8190;502;9483;9581;5.45;0.33;331.38;9.49;1293;36;3292.00;98
8191;30;22252902;8191;508;9483;9581;5.43;0.33;331.39;9.49;1292;36;3293.00;98
8195;30;22252920;8195;512;9488;9584;5.44;0.33;331.48;9.57;1293;36;3294.00;96
8197;30;22252938;8197;510;9488;9584;5.43;0.33;331.57;9.57;1291;36;3295.00;96
8198;30;22252954;8198;514;9492;9584;5.44;0.33;331.59;9.65;1294;36;3296.00;92
8201;30;22252970;8201;518;9492;9584;5.41;0.33;331.72;9.65;1291;36;3297.00;92
8203;30;22252988;8203;526;9497;9588;5.41;0.33;331.73;9.68;1294;36;3298.00;91
8205;30;22253007;8205;525;9498;9588;5.44;0.33;331.69;9.70;1293;36;3299.00;90
8210;30;22253031;8210;527;9503;9607;5.39;0.33;331.79;9.70;1293;36;3300.00;104
8214;30;22253062;8214;513;9504;9607;5.34;0.33;331.90;9.73;1290;36;3301.00;103
8215;30;22253081;8215;509;9504;9608;5.33;0.33;331.89;9.73;1289;36;3302.00;104
8218;30;22253100;8218;501;9507;9609;5.28;0.32;332.01;9.78;1289;36;3303.00;102
8220;30;22253118;8220;503;9507;9609;5.25;0.32;332.07;9.78;1287;36;3304.00;102
8223;30;22253138;8223;506;9509;9610;5.21;0.32;332.10;9.78;1286;36;3305.00;101
8228;30;22253155;8228;507;9511;9610;5.18;0.32;332.12;9.80;1283;36;3306.00;99
8229;30;22253184;8229;507;9512;9610;5.17;0.32;332.13;9.83;1283;36;3307.00;98
8232;30;22253203;8232;504;9512;9610;5.14;0.31;332.29;9.83;1280;36;3308.00;98
8235;30;22253220;8235;506;9512;9610;5.15;0.31;332.33;9.83;1277;36;3309.00;98
8238;30;22253251;8238;502;9513;9610;5.15;0.31;332.44;9.83;1275;36;3310.00;97
8243;30;22253270;8243;500;9514;9610;5.10;0.31;332.58;9.83;1271;36;3311.00;96
8246;30;22253286;8246;523;9574;9737;5.27;0.33;332.63;9.76;1328;36;3312.00;163
8249;30;22253313;8249;521;9576;9738;5.29;0.33;332.66;9.76;1327;36;3313.00;162
8252;30;22253330;8252;519;9584;9738;5.33;0.33;332.79;9.76;1332;36;3314.00;154
8255;30;22253346;8255;517;9589;9738;5.29;0.33;332.75;9.75;1334;36;3315.00;149
8261;30;22253363;8261;512;9595;9738;5.31;0.33;332.77;9.75;1334;36;3316.00;143
8263;30;22253380;8263;525;9600;9738;5.32;0.33;332.82;9.75;1337;36;3317.00;138
8266;30;22253397;8266;526;9604;9738;5.32;0.33;332.97;9.75;1338;36;3318.00;134
8270;30;22253414;8270;529;9606;9738;5.27;0.32;333.10;9.75;1336;36;3319.00;132
8273;30;22253430;8273;530;9610;9739;5.21;0.32;333.10;9.75;1337;36;3320.00;129
8276;30;22253446;8276;526;9614;9740;5.15;0.32;333.09;9.75;1338;36;3321.00;126
8278;30;22253463;8278;528;9616;9740;5.11;0.31;333.08;9.75;1338;36;3322.00;124
8281;30;22253479;8281;526;9620;9741;5.03;0.31;333.11;9.75;1339;36;3323.00;121
8282;30;22253495;8282;532;9621;9741;5.01;0.31;333.13;9.75;1339;36;3324.00;120
8288;30;22253511;8288;531;9624;9741;4.95;0.31;333.33;9.75;1336;36;3325.00;117
8290;30;22253528;8290;526;9626;9741;4.91;0.30;333.33;9.75;1336;36;3326.00;115
8293;30;22253545;8293;524;9630;9745;4.89;0.30;333.39;9.75;1337;36;3327.00;115
8299;30;22253562;8299;523;9632;9745;4.79;0.29;333.52;9.75;1333;36;3328.00;113
8304;30;22253578;8304;532;9633;9745;4.71;0.29;333.59;9.75;1329;36;3329.00;112
8310;30;22253598;8310;534;9637;9751;4.68;0.29;333.71;9.75;1327;36;3330.00;114
8314;30;22253615;8314;534;9637;9751;4.67;0.29;333.84;9.75;1323;36;3331.00;114
8317;30;22253631;8317;531;9638;9751;4.64;0.28;333.87;9.76;1321;36;3332.00;113
8320;30;22253647;8320;532;9641;9755;4.61;0.28;333.87;9.75;1321;36;3333.00;114
8322;30;22253663;8322;524;9642;9756;4.60;0.28;333.85;9.75;1320;36;3334.00;114
8326;30;22253679;8326;520;9644;9756;4.56;0.28;333.76;9.76;1318;36;3335.00;112
8328;30;22253696;8328;519;9648;9760;4.60;0.28;333.82;9.75;1320;36;3336.00;112
8332;30;22253713;8332;513;9648;9760;4.54;0.28;333.81;9.75;1316;36;3337.00;112
8334;30;22253729;8334;510;9649;9760;4.51;0.28;333.78;9.75;1315;36;3338.00;111
8337;30;22253745;8337;512;9650;9761;4.49;0.28;333.80;9.75;1313;36;3339.00;111
8342;30;22253761;8342;514;9652;9761;4.45;0.27;333.75;9.76;1310;36;3340.00;109
8343;30;22253778;8343;508;9656;9767;4.50;0.28;333.81;9.75;1313;36;3341.00;111
8346;30;22253795;8346;506;9657;9767;4.51;0.28;333.80;9.76;1311;36;3342.00;110
8354;30;22253810;8354;510;9657;9768;4.50;0.28;333.68;9.76;1303;36;3343.00;111
8359;30;22253828;8359;512;9657;9768;4.48;0.28;333.70;9.76;1298;36;3344.00;111
8361;30;22253844;8361;512;9657;9768;4.46;0.27;333.70;9.76;1296;36;3345.00;111
8367;30;22253860;8367;522;9658;9768;4.40;0.27;333.60;9.76;1291;36;3346.00;110
8373;30;22253877;8373;526;9659;9768;4.36;0.27;333.84;9.76;1286;36;3347.00;109
8378;30;22253897;8378;538;9669;9780;4.35;0.27;333.79;9.75;1291;36;3348.00;111
8381;30;22253916;8381;538;9670;9780;4.34;0.27;333.75;9.75;1289;36;3349.00;110
8388;30;22253941;8388;547;9671;9780;4.27;0.26;333.70;9.76;1283;36;3350.00;109
8389;30;22253958;8389;557;9672;9780;4.21;0.26;333.72;9.76;1283;36;3351.00;108
8395;30;22253975;8395;563;9673;9780;4.15;0.25;333.68;9.76;1278;36;3352.00;107
8397;30;22253995;8397;574;9674;9780;4.12;0.25;333.66;9.76;1277;36;3353.00;106
8401;30;22254011;8401;586;9678;9784;4.08;0.25;333.67;9.75;1277;36;3354.00;106
8402;30;22254028;8402;590;9678;9784;4.05;0.25;333.69;9.75;1276;36;3355.00;106
8405;30;22254046;8405;587;9681;9788;4.00;0.25;333.68;9.75;1276;36;3356.00;107
8408;30;22254062;8408;593;9684;9789;3.97;0.24;333.69;9.75;1276;36;3357.00;105
8410;30;22254078;8410;598;9684;9789;3.94;0.24;333.71;9.75;1274;36;3358.00;105
8413;30;22254093;8413;605;9684;9789;3.89;0.24;333.82;9.75;1271;36;3359.00;105
8416;30;22254110;8416;612;9707;9818;3.97;0.24;333.83;9.73;1291;36;3360.00;111
8420;30;22254128;8420;609;9707;9818;3.93;0.24;333.86;9.73;1287;36;3361.00;111
8422;30;22254144;8422;614;9709;9818;3.94;0.24;333.81;9.73;1287;36;3362.00;109
8424;30;22254158;8424;622;9710;9819;3.92;0.24;333.83;9.72;1286;36;3363.00;109
8428;30;22254174;8428;611;9710;9820;3.89;0.24;333.82;9.72;1282;36;3364.00;110
8428;30;22254189;8428;607;9710;9820;3.90;0.24;333.82;9.72;1282;36;3365.00;110
8431;30;22254205;8431;604;9712;9823;3.90;0.24;333.78;9.72;1281;36;3366.00;111
8434;30;22254221;8434;603;9713;9823;3.88;0.24;333.75;9.72;1279;36;3367.00;110
8437;30;22254237;8437;599;9713;9823;3.83;0.23;333.80;9.72;1276;36;3368.00;110
8439;30;22254252;8439;600;9713;9823;3.85;0.24;333.83;9.72;1274;36;3369.00;110
8444;30;22254269;8444;600;9718;9829;3.86;0.24;333.97;9.72;1274;36;3370.00;111
8445;30;22254285;8445;594;9718;9829;3.91;0.24;333.97;9.72;1273;36;3371.00;111
8446;30;22254300;8446;577;9718;9829;4.00;0.24;334.00;9.72;1272;36;3372.00;111
8447;30;22254316;8447;567;9718;9829;4.08;0.25;334.01;9.72;1271;36;3373.00;111
8450;30;22254332;8450;560;9721;9833;4.19;0.26;334.00;9.71;1271;36;3374.00;112
8452;30;22254350;8452;549;9723;9835;4.26;0.26;334.00;9.71;1271;36;3375.00;112
8456;30;22254369;8456;537;9723;9835;4.29;0.26;333.93;9.71;1267;36;3376.00;112
8458;30;22254386;8458;535;9724;9836;4.36;0.27;333.94;9.71;1266;36;3377.00;112
8460;30;22254411;8460;538;9724;9836;4.39;0.27;333.91;9.71;1264;36;3378.00;112
8463;30;22254435;8463;530;9724;9836;4.43;0.27;333.96;9.71;1261;36;3379.00;112
8464;30;22254450;8464;526;9724;9836;4.50;0.27;333.92;9.71;1260;36;3380.00;112
8466;30;22254467;8466;518;9724;9836;4.55;0.28;333.95;9.71;1258;36;3381.00;112
8469;30;22254483;8469;495;9724;9836;4.60;0.28;334.05;9.71;1255;36;3382.00;112
8470;30;22254507;8470;484;9724;9836;4.68;0.29;334.06;9.71;1254;36;3383.00;112
8472;30;22254525;8472;496;9766;9906;4.75;0.29;334.15;9.67;1294;36;3384.00;140
8476;30;22254556;8476;480;9767;9907;4.75;0.29;334.25;9.70;1291;36;3385.00;140
8478;30;22254583;8478;472;9772;9907;4.86;0.30;334.24;9.69;1294;36;3386.00;135
8481;30;22254602;8481;470;9772;9907;4.92;0.30;334.28;9.69;1291;36;3387.00;135
8485;30;22254622;8485;463;9774;9907;5.01;0.31;334.31;9.69;1289;36;3388.00;133
8488;30;22254652;8488;462;9777;9907;5.12;0.31;334.37;9.69;1289;36;3389.00;130
8489;30;22254671;8489;464;9779;9907;5.24;0.32;334.38;9.69;1290;36;3390.00;128
8493;30;22254688;8493;472;9781;9907;5.31;0.32;334.45;9.69;1288;36;3391.00;126
8496;30;22254706;8496;467;9782;9908;5.37;0.33;334.55;9.69;1286;36;3392.00;126
8498;30;22254724;8498;468;9784;9909;5.44;0.33;334.54;9.69;1286;36;3393.00;125
8500;30;22254744;8500;463;9786;9909;5.41;0.33;334.60;9.69;1286;36;3394.00;123
8501;30;22254761;8501;466;9791;9913;5.42;0.33;334.68;9.69;1290;36;3395.00;122
8504;30;22254780;8504;475;9793;9913;5.42;0.33;334.75;9.68;1289;36;3396.00;120
8507;30;22254798;8507;474;9795;9913;5.38;0.33;334.90;9.69;1288;36;3397.00;118
8510;31;22254816;8510;480;9796;9913;5.34;0.32;334.97;9.69;1286;37;3398.00;117
8513;31;22254849;8513;485;9801;9919;5.34;0.32;335.13;9.68;1288;37;3399.00;118
8515;31;22254868;8515;488;9801;9919;5.34;0.32;335.10;9.68;1286;37;3400.00;118
8515;32;22254890;8515;491;9801;9919;5.37;0.33;335.10;9.68;1286;38;3401.00;118
8516;32;22254920;8516;497;9803;9922;5.38;0.33;335.09;9.68;1287;38;3402.00;119
8520;32;22254938;8520;495;9803;9922;5.34;0.32;335.22;9.68;1283;38;3403.00;119
8523;32;22254954;8523;497;9805;9922;5.34;0.32;335.33;9.71;1282;38;3404.00;117
8525;32;22254972;8525;503;9805;9923;5.35;0.32;335.34;9.71;1280;38;3405.00;118
8527;32;22254996;8527;496;9806;9924;5.37;0.33;335.39;9.71;1279;38;3406.00;118
8530;32;22255018;8530;501;9806;9924;5.34;0.32;335.42;9.71;1276;38;3407.00;118
8532;32;22255036;8532;509;9816;9937;5.36;0.32;335.46;9.70;1284;38;3408.00;121
8532;32;22255053;8532;505;9817;9937;5.38;0.33;335.46;9.69;1285;38;3409.00;120
8534;32;22255070;8534;509;9817;9937;5.37;0.33;335.59;9.69;1283;38;3410.00;120
8534;32;22255087;8534;509;9818;9938;5.41;0.33;335.59;9.69;1284;38;3411.00;120
8538;32;22255105;8538;513;9818;9938;5.40;0.33;335.73;9.69;1280;38;3412.00;120
8541;32;22255122;8541;515;9822;9942;5.43;0.33;335.83;9.69;1281;38;3413.00;120
8542;32;22255141;8542;510;9822;9942;5.44;0.33;335.89;9.69;1280;38;3414.00;120
8544;32;22255158;8544;499;9825;9946;5.45;0.33;335.89;9.69;1281;38;3415.00;121
8549;32;22255177;8549;496;9825;9946;5.44;0.33;335.96;9.69;1276;38;3416.00;121
8552;32;22255195;8552;494;9825;9946;5.46;0.33;336.06;9.69;1273;38;3417.00;121
8554;32;22255211;8554;490;9825;9946;5.48;0.33;336.12;9.69;1271;38;3418.00;121
8558;32;22255230;8558;480;9825;9946;5.51;0.33;336.16;9.69;1267;38;3419.00;121
8559;32;22255249;8559;484;9850;9980;5.62;0.34;336.17;9.66;1291;38;3420.00;130
8562;32;22255270;8562;465;9850;9980;5.65;0.34;336.21;9.66;1288;38;3421.00;130
8565;32;22255288;8565;460;9853;9980;5.72;0.35;336.32;9.66;1288;38;3422.00;127
8566;32;22255306;8566;456;9853;9980;5.79;0.35;336.38;9.66;1287;38;3423.00;127
8567;32;22255323;8567;455;9854;9980;5.85;0.36;336.40;9.66;1287;38;3424.00;126
8568;32;22255342;8568;449;9854;9980;5.84;0.36;336.41;9.66;1286;38;3425.00;126
8572;32;22255361;8572;448;9854;9981;5.80;0.35;336.57;9.66;1282;38;3426.00;127
8576;32;22255380;8576;447;9854;9981;5.70;0.35;336.70;9.66;1278;38;3427.00;127
8579;32;22255398;8579;436;9860;9987;5.71;0.35;336.85;9.70;1281;38;3428.00;127
8584;32;22255418;8584;428;9861;9988;5.68;0.35;336.93;9.70;1277;38;3429.00;127
8588;32;22255443;8588;422;9862;9988;5.62;0.34;336.95;9.74;1274;38;3430.00;126
8591;32;22255462;8591;419;9863;9988;5.55;0.34;337.18;9.76;1272;38;3431.00;125
8594;32;22255480;8594;411;9866;9992;5.58;0.34;337.19;9.76;1272;38;3432.00;126
8596;32;22255498;8596;405;9866;9992;5.56;0.34;337.29;9.76;1270;38;3433.00;126
8602;32;22255515;8602;404;9866;9992;5.56;0.34;337.28;9.76;1264;38;3434.00;126
8606;32;22255533;8606;397;9867;9993;5.58;0.34;337.37;9.76;1261;38;3435.00;126
8607;32;22255551;8607;391;9870;9997;5.57;0.34;337.42;9.76;1263;38;3436.00;127
8611;32;22255569;8611;390;9870;9997;5.60;0.34;337.53;9.76;1259;38;3437.00;127
8613;32;22255586;8613;382;9872;10000;5.66;0.35;337.59;9.75;1259;38;3438.00;128
8615;32;22255604;8615;379;9873;10000;5.69;0.35;337.57;9.75;1258;38;3439.00;127
8618;32;22255621;8618;373;9874;10000;5.69;0.35;337.69;9.78;1256;38;3440.00;126
8621;32;22255640;8621;375;9874;10000;5.72;0.35;337.69;9.78;1253;38;3441.00;126
8622;32;22255656;8622;376;9878;10004;5.80;0.35;337.69;9.78;1256;38;3442.00;126
8628;32;22255675;8628;374;9878;10004;5.80;0.35;337.83;9.78;1250;38;3443.00;126
8631;32;22255693;8631;373;9878;10004;5.83;0.35;337.83;9.78;1247;38;3444.00;126
8638;32;22255711;8638;373;9878;10004;5.80;0.35;337.94;9.78;1240;38;3445.00;126
8642;32;22255730;8642;372;9878;10005;5.80;0.35;338.10;9.78;1236;38;3446.00;127
8645;32;22255747;8645;377;9879;10006;5.77;0.35;338.13;9.78;1234;38;3447.00;127
8650;32;22255765;8650;380;9879;10006;5.74;0.35;338.21;9.78;1229;38;3448.00;127
8651;32;22255781;8651;382;9880;10007;5.69;0.35;338.21;9.77;1229;38;3449.00;127
8654;32;22255802;8654;380;9880;10007;5.67;0.35;338.31;9.77;1226;38;3450.00;127
8657;32;22255819;8657;388;9881;10007;5.70;0.35;338.43;9.81;1224;38;3451.00;126
8660;32;22255836;8660;398;9881;10007;5.69;0.35;338.60;9.81;1221;38;3452.00;126
8662;32;22255863;8662;400;9881;10007;5.72;0.35;338.59;9.81;1219;38;3453.00;126
8664;32;22255887;8664;406;9882;10007;5.70;0.35;338.63;9.85;1218;38;3454.00;125
8666;32;22255904;8666;409;9883;10007;5.72;0.35;338.61;9.90;1217;38;3455.00;124
8672;32;22255920;8672;427;9948;10134;5.84;0.36;338.71;9.83;1276;38;3456.00;186
8677;32;22255951;8677;418;9952;10135;5.82;0.36;338.82;9.87;1275;38;3457.00;183
8679;32;22255972;8679;419;9960;10135;5.85;0.36;338.85;9.86;1281;38;3458.00;175
8686;32;22255989;8686;420;9962;10135;5.78;0.36;339.01;9.86;1276;38;3459.00;173
8687;32;22256007;8687;423;9969;10135;5.82;0.36;339.05;9.94;1282;38;3460.00;166
8688;32;22256023;8688;425;9971;10135;5.83;0.36;339.08;9.94;1283;38;3461.00;164
8690;32;22256047;8690;435;9974;10135;5.86;0.36;339.10;9.93;1284;38;3462.00;161
8693;32;22256064;8693;434;9978;10135;5.90;0.36;339.16;9.97;1285;38;3463.00;157
8695;32;22256081;8695;433;9981;10136;5.93;0.36;339.23;9.97;1286;38;3464.00;155
8698;32;22256099;8698;432;9988;10138;5.94;0.36;339.29;10.01;1290;38;3465.00;150
8702;32;22256116;8702;429;9990;10138;5.91;0.36;339.29;10.01;1288;38;3466.00;148
8705;32;22256133;8705;439;9992;10139;5.87;0.36;339.50;10.01;1287;38;3467.00;147
8707;32;22256150;8707;442;9995;10139;5.84;0.36;339.55;10.05;1288;38;3468.00;144
8707;32;22256168;8707;443;9995;10139;5.84;0.36;339.55;10.05;1288;38;3469.00;144
8707;32;22256185;8707;450;10002;10139;5.81;0.36;339.55;10.09;1295;38;3470.00;137
8712;32;22256202;8712;460;10004;10143;5.76;0.35;339.65;10.09;1292;38;3471.00;139
8715;32;22256220;8715;467;10008;10143;5.68;0.35;339.71;10.12;1293;38;3472.00;135
8716;32;22256244;8716;473;10009;10143;5.61;0.34;339.68;10.12;1293;38;3473.00;134
8717;32;22256261;8717;472;10014;10146;5.53;0.34;339.75;10.20;1297;38;3474.00;132
8719;32;22256278;8719;477;10018;10146;5.41;0.33;339.87;10.24;1299;38;3475.00;128
8723;32;22256295;8723;479;10019;10146;5.32;0.32;339.94;10.27;1296;38;3476.00;127
8723;32;22256312;8723;485;10023;10150;5.31;0.32;339.94;10.27;1300;38;3477.00;127
8729;32;22256329;8729;481;10026;10151;5.24;0.32;340.15;10.34;1297;38;3478.00;125
8730;32;22256347;8730;485;10027;10151;5.25;0.32;340.11;10.34;1297;38;3479.00;124
8733;32;22256365;8733;498;10032;10156;5.26;0.32;340.14;10.34;1299;38;3480.00;124
8734;32;22256383;8734;492;10035;10156;5.23;0.32;340.23;10.41;1301;38;3481.00;121
8736;32;22256400;8736;493;10035;10156;5.17;0.32;340.30;10.41;1299;38;3482.00;121
8736;32;22256416;8736;498;10038;10157;5.11;0.31;340.30;10.48;1302;38;3483.00;119
8740;32;22256432;8740;495;10038;10157;5.10;0.31;340.36;10.48;1298;38;3484.00;119
8743;32;22256449;8743;499;10044;10163;5.12;0.31;340.42;10.51;1301;38;3485.00;119
8747;32;22256466;8747;497;10045;10163;5.07;0.31;340.46;10.54;1298;38;3486.00;118
8749;32;22256481;8749;503;10045;10164;5.04;0.31;340.54;10.54;1296;38;3487.00;119
8753;32;22256498;8753;502;10047;10164;4.97;0.30;340.60;10.61;1294;38;3488.00;117
8757;32;22256515;8757;518;10047;10164;4.88;0.30;340.59;10.61;1290;38;3489.00;117
8758;32;22256532;8758;523;10047;10164;4.84;0.30;340.57;10.61;1289;38;3490.00;117
8761;32;22256548;8761;530;10047;10164;4.74;0.29;340.61;10.61;1286;38;3491.00;117
8763;32;22256565;8763;535;10062;10176;4.71;0.29;340.60;10.72;1299;38;3492.00;114
8766;32;22256581;8766;553;10062;10176;4.60;0.28;340.61;10.72;1296;38;3493.00;114
8770;32;22256597;8770;557;10064;10176;4.51;0.28;340.64;10.79;1294;38;3494.00;112
8772;32;22256613;8772;555;10064;10176;4.46;0.27;340.66;10.79;1292;38;3495.00;112
8777;32;22256628;8777;555;10064;10176;4.40;0.27;340.61;10.79;1287;38;3496.00;112
8782;32;22256643;8782;562;10066;10176;4.34;0.27;340.59;10.85;1284;38;3497.00;110
8786;32;22256657;8786;578;10069;10180;4.23;0.26;340.48;10.85;1283;38;3498.00;111
8788;32;22256672;8788;578;10069;10180;4.15;0.25;340.43;10.85;1281;38;3499.00;111
8790;32;22256689;8790;566;10073;10184;4.13;0.25;340.39;10.84;1283;38;3500.00;111
8794;32;22256710;8794;565;10074;10185;4.07;0.25;340.34;10.84;1280;38;3501.00;111
8795;32;22256725;8795;565;10074;10185;4.04;0.25;340.32;10.84;1279;38;3502.00;111
8797;32;22256740;8797;573;10074;10185;3.99;0.24;340.27;10.84;1277;38;3503.00;111
8802;32;22256755;8802;562;10084;10198;4.02;0.25;340.24;10.83;1282;38;3504.00;114
8804;32;22256771;8804;566;10084;10198;4.02;0.25;340.17;10.83;1280;38;3505.00;114
8805;32;22256787;8805;570;10084;10198;4.02;0.25;340.16;10.83;1279;38;3506.00;114
8809;32;22256803;8809;564;10085;10199;4.02;0.25;340.06;10.83;1276;38;3507.00;114
8812;32;22256819;8812;565;10085;10200;4.02;0.25;340.06;10.83;1273;38;3508.00;115
8815;32;22256835;8815;554;10085;10200;4.00;0.24;340.03;10.83;1270;38;3509.00;115
8820;32;22256852;8820;552;10088;10206;4.01;0.24;340.11;10.83;1268;38;3510.00;118
8821;32;22256869;8821;551;10088;10206;3.98;0.24;340.08;10.83;1267;38;3511.00;118
8824;32;22256884;8824;555;10089;10206;3.95;0.24;340.08;10.83;1265;38;3512.00;117
8826;32;22256899;8826;546;10089;10206;3.93;0.24;340.06;10.83;1263;38;3513.00;117
8829;32;22256915;8829;551;10093;10212;3.95;0.24;340.05;10.82;1264;38;3514.00;119
8832;32;22256931;8832;549;10093;10212;3.90;0.24;340.01;10.82;1261;38;3515.00;119
8833;32;22256946;8833;550;10093;10212;3.89;0.24;340.02;10.82;1260;38;3516.00;119
8834;32;22256961;8834;556;10094;10212;3.87;0.24;340.07;10.82;1260;38;3517.00;118
8836;32;22256977;8836;560;10097;10216;3.87;0.24;340.08;10.82;1261;38;3518.00;119
8840;32;22256991;8840;569;10099;10219;3.87;0.24;340.12;10.82;1259;38;3519.00;120
8843;32;22257008;8843;564;10099;10219;3.83;0.23;340.06;10.82;1256;38;3520.00;120
8844;32;22257023;8844;550;10101;10220;3.83;0.23;340.05;10.82;1257;38;3521.00;119
8846;32;22257038;8846;550;10101;10220;3.83;0.23;340.02;10.82;1255;38;3522.00;119
8850;32;22257053;8850;549;10102;10220;3.82;0.23;339.97;10.82;1252;38;3523.00;118
8853;32;22257070;8853;550;10103;10220;3.86;0.23;339.94;10.82;1250;38;3524.00;117
8856;32;22257085;8856;550;10103;10220;3.87;0.24;339.92;10.82;1247;38;3525.00;117
8857;33;22257101;8857;559;10104;10220;3.94;0.24;339.91;10.82;1247;39;3526.00;116
8860;34;22257131;8860;552;10104;10220;3.96;0.24;339.91;10.82;1244;40;3527.00;116
8862;34;22257163;8862;558;10141;10290;4.15;0.25;339.94;10.78;1279;40;3528.00;149
8866;34;22257185;8866;552;10143;10291;4.15;0.25;339.95;10.78;1277;40;3529.00;148
8867;34;22257207;8867;549;10148;10291;4.21;0.26;339.93;10.77;1281;40;3530.00;143
8870;34;22257231;8870;547;10151;10291;4.24;0.26;339.92;10.77;1281;40;3531.00;140
8871;34;22257247;8871;544;10154;10291;4.34;0.27;339.92;10.77;1283;40;3532.00;137
8873;34;22257264;8873;536;10155;10291;4.44;0.27;340.01;10.77;1282;40;3533.00;136
8876;34;22257279;8876;531;10157;10291;4.50;0.28;339.99;10.77;1281;40;3534.00;134
8878;34;22257296;8878;530;10159;10291;4.51;0.28;339.99;10.77;1281;40;3535.00;132
8879;34;22257313;8879;530;10161;10292;4.54;0.28;340.00;10.76;1282;40;3536.00;131
8881;34;22257329;8881;524;10162;10293;4.56;0.28;339.99;10.76;1281;40;3537.00;131
8885;34;22257346;8885;521;10164;10293;4.54;0.28;340.04;10.76;1279;40;3538.00;129
8887;34;22257362;8887;522;10169;10297;4.58;0.28;340.08;10.76;1282;40;3539.00;128
8891;34;22257381;8891;519;10170;10297;4.57;0.28;340.07;10.76;1279;40;3540.00;127
8894;34;22257398;8894;526;10171;10297;4.58;0.28;340.04;10.76;1277;40;3541.00;126
8899;34;22257414;8899;519;10172;10297;4.57;0.28;340.11;10.76;1273;40;3542.00;125
8904;34;22257431;8904;529;10179;10303;4.56;0.28;340.16;10.79;1275;40;3543.00;124
8908;34;22257448;8908;535;10181;10303;4.56;0.28;340.28;10.79;1273;40;3544.00;122
8911;34;22257466;8911;536;10181;10303;4.52;0.27;340.30;10.79;1270;40;3545.00;122
8911;34;22257482;8911;543;10184;10306;4.56;0.28;340.30;10.78;1273;40;3546.00;122
8915;34;22257499;8915;531;10184;10306;4.57;0.28;340.38;10.78;1269;40;3547.00;122
8918;34;22257517;8918;521;10184;10306;4.56;0.28;340.40;10.78;1266;40;3548.00;122
8919;34;22257535;8919;508;10184;10307;4.59;0.28;340.41;10.78;1265;40;3549.00;123
8922;34;22257552;8922;512;10185;10308;4.67;0.28;340.42;10.78;1263;40;3550.00;123
8924;34;22257569;8924;514;10185;10308;4.69;0.29;340.41;10.78;1261;40;3551.00;123
8927;34;22257585;8927;509;10195;10321;4.75;0.29;340.47;10.77;1268;40;3552.00;126
8931;34;22257603;8931;510;10195;10321;4.75;0.29;340.48;10.77;1264;40;3553.00;126
8935;34;22257620;8935;512;10196;10321;4.76;0.29;340.53;10.77;1261;40;3554.00;125
8940;34;22257637;8940;510;10198;10323;4.76;0.29;340.61;10.77;1258;40;3555.00;125
8941;34;22257663;8941;499;10198;10323;4.79;0.29;340.60;10.77;1257;40;3556.00;125
8945;34;22257681;8945;490;10202;10327;4.82;0.29;340.65;10.76;1257;40;3557.00;125
8948;34;22257698;8948;485;10202;10327;4.84;0.29;340.68;10.76;1254;40;3558.00;125
8951;34;22257714;8951;488;10206;10331;4.86;0.29;340.74;10.79;1255;40;3559.00;125
8952;34;22257740;8952;479;10206;10331;4.84;0.29;340.83;10.79;1254;40;3560.00;125
8953;34;22257757;8953;475;10206;10331;4.83;0.29;340.88;10.79;1253;40;3561.00;125
8955;34;22257774;8955;479;10206;10331;4.84;0.29;340.97;10.79;1251;40;3562.00;125
8955;34;22257791;8955;474;10206;10331;4.86;0.29;340.97;10.79;1251;40;3563.00;125
8958;34;22257808;8958;483;10216;10343;4.92;0.30;341.10;10.78;1258;40;3564.00;127
8959;34;22257828;8959;488;10216;10343;4.93;0.30;341.19;10.78;1257;40;3565.00;127
8960;34;22257846;8960;491;10218;10343;4.93;0.30;341.24;10.81;1258;40;3566.00;125
8963;34;22257862;8963;483;10218;10343;4.89;0.30;341.30;10.81;1255;40;3567.00;125
8966;34;22257880;8966;486;10218;10343;4.91;0.30;341.42;10.81;1252;40;3568.00;125
8968;34;22257898;8968;479;10218;10343;4.92;0.30;341.50;10.81;1250;40;3569.00;125
8969;34;22257917;8969;478;10218;10344;4.94;0.30;341.50;10.81;1249;40;3570.00;126
8969;34;22257934;8969;471;10218;10344;4.99;0.30;341.50;10.81;1249;40;3571.00;126
8972;34;22257950;8972;466;10223;10350;5.02;0.31;341.61;10.81;1251;40;3572.00;127
8974;34;22257969;8974;468;10224;10351;5.05;0.31;341.73;10.81;1250;40;3573.00;127
8976;34;22257985;8976;471;10224;10351;5.07;0.31;341.69;10.81;1248;40;3574.00;127
8979;34;22258002;8979;468;10224;10351;5.08;0.31;341.82;10.81;1245;40;3575.00;127
8980;34;22258019;8980;466;10227;10355;5.09;0.31;341.86;10.80;1247;40;3576.00;128
8981;34;22258036;8981;466;10227;10355;5.12;0.31;341.91;10.80;1246;40;3577.00;128
8983;34;22258060;8983;466;10227;10355;5.15;0.31;341.95;10.80;1244;40;3578.00;128
8983;34;22258078;8983;463;10228;10356;5.20;0.31;341.95;10.80;1245;40;3579.00;128
8985;34;22258096;8985;470;10232;10360;5.15;0.31;341.99;10.83;1247;40;3580.00;128
8988;34;22258114;8988;465;10232;10360;5.17;0.31;342.11;10.83;1244;40;3581.00;128
8989;34;22258131;8989;468;10234;10363;5.20;0.32;342.13;10.83;1245;40;3582.00;129
8992;34;22258148;8992;469;10234;10363;5.19;0.31;342.10;10.83;1242;40;3583.00;129
8994;34;22258166;8994;476;10235;10363;5.24;0.32;342.16;10.83;1241;40;3584.00;128
8998;34;22258183;8998;480;10235;10363;5.24;0.32;342.26;10.83;1237;40;3585.00;128
9001;34;22258201;9001;480;10239;10367;5.24;0.32;342.37;10.82;1238;40;3586.00;128
9003;34;22258218;9003;487;10240;10367;5.22;0.32;342.49;10.86;1237;40;3587.00;127
9004;34;22258237;9004;488;10240;10367;5.24;0.32;342.55;10.86;1236;40;3588.00;127
9006;34;22258254;9006;489;10240;10367;5.24;0.32;342.69;10.86;1234;40;3589.00;127
9006;34;22258271;9006;487;10240;10368;5.27;0.32;342.69;10.86;1234;40;3590.00;128
9009;34;22258289;9009;477;10241;10369;5.31;0.32;342.67;10.86;1232;40;3591.00;128
9011;34;22258306;9011;467;10241;10369;5.33;0.32;342.69;10.86;1230;40;3592.00;128
9014;34;22258323;9014;462;10242;10370;5.30;0.32;342.76;10.85;1228;40;3593.00;128
9018;34;22258342;9018;452;10243;10370;5.34;0.32;342.87;10.89;1225;40;3594.00;127
9019;34;22258358;9019;453;10243;10370;5.35;0.32;342.88;10.89;1224;40;3595.00;127
9022;34;22258377;9022;447;10243;10370;5.40;0.33;342.87;10.89;1221;40;3596.00;127
9023;34;22258395;9023;442;10243;10370;5.49;0.33;342.88;10.89;1220;40;3597.00;127
9025;34;22258412;9025;435;10243;10370;5.58;0.34;342.90;10.89;1218;40;3598.00;127
9026;34;22258429;9026;433;10243;10370;5.65;0.34;342.90;10.89;1217;40;3599.00;127
9028;34;22258449;9028;491;10369;10623;5.66;0.35;342.91;10.79;1341;40;3600.00;254
9030;34;22258496;9030;472;10369;10624;5.71;0.36;342.92;10.79;1339;40;3601.00;255
9035;34;22258514;9035;446;10377;10624;5.74;0.36;343.01;10.78;1342;40;3602.00;247
9037;34;22258533;9037;437;10379;10624;5.73;0.36;343.05;10.78;1342;40;3603.00;245
9040;34;22258551;9040;418;10384;10624;5.76;0.36;343.19;10.78;1344;40;3604.00;240
9043;34;22258571;9043;412;10388;10624;5.75;0.36;343.26;10.86;1345;40;3605.00;236
9047;34;22258592;9047;409;10395;10624;5.77;0.36;343.29;10.86;1348;40;3606.00;229
9050;34;22258611;9050;407;10399;10624;5.77;0.36;343.33;10.86;1349;40;3607.00;225
9056;34;22258629;9056;397;10406;10625;5.76;0.36;343.54;10.85;1350;40;3608.00;219
9060;34;22258648;9060;405;10412;10626;5.78;0.36;343.72;10.85;1352;40;3609.00;214
9062;34;22258666;9062;395;10418;10626;5.83;0.36;343.76;10.85;1356;40;3610.00;208
9065;34;22258685;9065;393;10421;10627;5.82;0.36;343.82;10.85;1356;40;3611.00;206
9066;34;22258704;9066;404;10424;10627;5.76;0.36;343.88;10.85;1358;40;3612.00;203
9071;34;22258722;9071;393;10426;10627;5.75;0.35;343.87;10.85;1355;40;3613.00;201
9073;34;22258741;9073;397;10430;10627;5.71;0.35;343.87;10.89;1357;40;3614.00;197
9076;34;22258758;9076;396;10432;10631;5.63;0.35;343.97;10.89;1356;40;3615.00;199
9079;34;22258785;9079;402;10433;10631;5.57;0.34;343.96;10.89;1354;40;3616.00;198
9080;34;22258804;9080;401;10437;10631;5.49;0.34;344.02;10.89;1357;40;3617.00;194
9083;34;22258821;9083;405;10438;10634;5.44;0.33;344.04;10.89;1355;40;3618.00;196
9086;34;22258850;9086;411;10439;10634;5.39;0.33;344.04;10.89;1353;40;3619.00;195
9088;34;22258871;9088;418;10440;10634;5.41;0.33;344.09;10.89;1352;40;3620.00;194
9091;34;22258892;9091;420;10442;10638;5.41;0.33;344.16;10.89;1351;40;3621.00;196
9093;34;22258913;9093;423;10444;10639;5.45;0.33;344.16;10.89;1351;40;3622.00;195
9096;34;22258933;9096;434;10444;10639;5.45;0.33;344.23;10.89;1348;40;3623.00;195
9098;34;22258952;9098;442;10449;10643;5.43;0.33;344.24;10.89;1351;40;3624.00;194
9101;34;22258971;9101;447;10452;10643;5.37;0.33;344.31;10.89;1351;40;3625.00;191
9105;34;22258989;9105;446;10453;10643;5.32;0.33;344.27;10.89;1348;40;3626.00;190
9109;34;22259009;9109;462;10454;10644;5.26;0.32;344.40;10.89;1345;40;3627.00;190
9111;34;22259034;9111;465;10457;10644;5.20;0.32;344.54;10.90;1346;40;3628.00;187
9115;34;22259052;9115;475;10461;10650;5.22;0.32;344.56;10.90;1346;40;3629.00;189
9116;34;22259079;9116;488;10464;10650;5.19;0.32;344.65;10.98;1348;40;3630.00;186
9121;34;22259098;9121;493;10469;10651;5.16;0.32;344.71;10.99;1348;40;3631.00;182
9122;34;22259123;9122;506;10470;10651;5.19;0.32;344.73;10.99;1348;40;3632.00;181
9125;34;22259141;9125;508;10474;10651;5.17;0.32;344.71;11.03;1349;40;3633.00;177
9127;34;22259161;9127;520;10475;10651;5.16;0.32;344.84;11.03;1348;40;3634.00;176
9130;34;22259178;9130;531;10478;10651;5.13;0.31;344.87;11.12;1348;40;3635.00;173
9135;34;22259197;9135;538;10490;10663;5.07;0.31;344.85;11.16;1355;40;3636.00;173
9137;34;22259216;9137;542;10493;10663;5.01;0.31;344.85;11.21;1356;40;3637.00;170
9139;34;22259234;9139;556;10495;10663;5.02;0.31;344.94;11.21;1356;40;3638.00;168
9139;34;22259251;9139;561;10498;10663;5.01;0.31;344.94;11.29;1359;40;3639.00;165
9145;34;22259269;9145;564;10501;10663;4.92;0.30;344.87;11.29;1356;40;3640.00;162
9147;34;22259286;9147;578;10501;10663;4.86;0.30;344.92;11.29;1354;40;3641.00;162
9151;34;22259304;9151;588;10510;10667;4.82;0.29;344.98;11.37;1359;40;3642.00;157
9152;34;22259320;9152;597;10514;10667;4.77;0.29;344.98;11.38;1362;40;3643.00;153
9153;34;22259345;9153;595;10518;10671;4.74;0.29;344.95;11.38;1365;40;3644.00;153
9156;34;22259362;9156;598;10524;10673;4.65;0.28;344.96;11.46;1368;40;3645.00;149
9157;34;22259379;9157;613;10524;10673;4.56;0.28;345.01;11.46;1367;40;3646.00;149
9160;34;22259396;9160;620;10526;10673;4.47;0.27;344.97;11.53;1366;40;3647.00;147
9162;34;22259411;9162;627;10536;10686;4.40;0.27;344.99;11.52;1374;40;3648.00;150
9165;34;22259429;9165;626;10536;10686;4.33;0.26;345.04;11.52;1371;40;3649.00;150
9167;34;22259447;9167;631;10538;10686;4.31;0.26;344.98;11.53;1371;40;3650.00;148
9170;34;22259463;9170;628;10541;10687;4.30;0.26;344.97;11.60;1371;40;3651.00;146
9170;34;22259480;9170;636;10543;10688;4.33;0.27;344.97;11.60;1373;40;3652.00;145
9173;34;22259496;9173;637;10543;10688;4.32;0.27;344.92;11.60;1370;40;3653.00;145
9173;34;22259513;9173;647;10546;10691;4.37;0.27;344.92;11.60;1373;40;3654.00;145
9173;34;22259530;9173;649;10546;10691;4.42;0.27;344.92;11.60;1373;40;3655.00;145
9175;34;22259546;9175;641;10546;10691;4.42;0.27;344.95;11.60;1371;40;3656.00;145
9178;34;22259563;9178;647;10548;10691;4.42;0.27;344.91;11.68;1370;40;3657.00;143
9178;34;22259579;9178;652;10553;10697;4.48;0.28;344.91;11.67;1375;40;3658.00;144
9180;34;22259597;9180;652;10553;10697;4.45;0.27;344.87;11.67;1373;40;3659.00;144
9182;34;22259615;9182;656;10553;10697;4.46;0.27;344.84;11.67;1371;40;3660.00;144
9185;34;22259632;9185;659;10553;10697;4.46;0.27;344.75;11.67;1368;40;3661.00;144
9189;34;22259648;9189;670;10556;10701;4.39;0.27;344.71;11.67;1367;40;3662.00;145
9190;34;22259664;9190;669;10557;10702;4.38;0.27;344.71;11.67;1367;40;3663.00;145
9194;34;22259680;9194;666;10557;10702;4.36;0.27;344.64;11.67;1363;40;3664.00;145
9198;34;22259697;9198;665;10558;10703;4.31;0.26;344.53;11.66;1360;40;3665.00;145
9203;34;22259712;9203;660;10558;10703;4.22;0.26;344.46;11.66;1355;40;3666.00;145
9206;34;22259728;9206;658;10558;10703;4.17;0.26;344.51;11.66;1352;40;3667.00;145
9208;34;22259744;9208;655;10558;10703;4.13;0.25;344.45;11.66;1350;40;3668.00;145
9213;34;22259758;9213;656;10558;10703;4.06;0.25;344.38;11.66;1345;40;3669.00;145
9215;34;22259773;9215;652;10558;10703;4.03;0.25;344.35;11.66;1343;40;3670.00;145
9220;34;22259788;9220;657;10558;10703;3.96;0.24;344.28;11.66;1338;40;3671.00;145
9224;34;22259804;9224;676;10598;10773;4.05;0.25;344.37;11.62;1374;40;3672.00;175
9229;34;22259824;9229;670;10600;10774;3.95;0.24;344.29;11.62;1371;40;3673.00;174
9231;34;22259840;9231;672;10607;10774;3.90;0.24;344.30;11.61;1376;40;3674.00;167
9234;34;22259854;9234;667;10610;10774;3.85;0.24;344.25;11.61;1376;40;3675.00;164
9235;34;22259870;9235;661;10611;10774;3.79;0.23;344.26;11.61;1376;40;3676.00;163
9238;34;22259885;9238;653;10612;10774;3.72;0.23;344.36;11.61;1374;40;3677.00;162
9243;34;22259901;9243;635;10614;10774;3.67;0.23;344.36;11.61;1371;40;3678.00;160
9244;34;22259916;9244;628;10616;10774;3.70;0.23;344.38;11.61;1372;40;3679.00;158
9245;34;22259931;9245;621;10618;10775;3.73;0.23;344.39;11.61;1373;40;3680.00;157
9247;34;22259948;9247;610;10619;10776;3.76;0.23;344.45;11.61;1372;40;3681.00;157
9251;34;22259965;9251;607;10620;10776;3.85;0.24;344.40;11.61;1369;40;3682.00;156
9255;34;22259980;9255;602;10624;10780;3.93;0.24;344.44;11.60;1369;40;3683.00;156
9256;34;22259998;9256;596;10624;10780;3.97;0.24;344.45;11.60;1368;40;3684.00;156
9258;34;22260034;9258;590;10624;10780;4.05;0.25;344.47;11.60;1366;40;3685.00;156
9261;34;22260050;9261;584;10624;10780;4.10;0.25;344.48;11.60;1363;40;3686.00;156
9262;34;22260068;9262;577;10628;10786;4.16;0.26;344.49;11.60;1366;40;3687.00;158
9266;34;22260085;9266;573;10629;10786;4.17;0.26;344.52;11.60;1363;40;3688.00;157
9267;34;22260103;9267;563;10629;10786;4.20;0.26;344.52;11.60;1362;40;3689.00;157
9270;34;22260121;9270;563;10632;10792;4.26;0.26;344.55;11.60;1362;40;3690.00;160
9274;34;22260140;9274;561;10632;10792;4.29;0.26;344.50;11.60;1358;40;3691.00;160
9276;34;22260157;9276;564;10634;10792;4.30;0.26;344.47;11.60;1358;40;3692.00;158
9278;34;22260174;9278;562;10634;10793;4.34;0.27;344.49;11.60;1356;40;3693.00;159
9283;34;22260191;9283;557;10635;10794;4.32;0.26;344.51;11.59;1352;40;3694.00;159
9287;34;22260210;9287;558;10635;10794;4.34;0.26;344.53;11.59;1348;40;3695.00;159
9290;34;22260229;9290;551;10647;10807;4.46;0.27;344.55;11.59;1357;40;3696.00;160
9294;34;22260248;9294;552;10647;10807;4.48;0.27;344.49;11.59;1353;40;3697.00;160
9296;34;22260267;9296;548;10648;10807;4.51;0.27;344.43;11.59;1352;40;3698.00;159
9303;34;22260284;9303;545;10649;10808;4.49;0.27;344.54;11.59;1346;40;3699.00;159
9307;34;22260305;9307;551;10650;10808;4.51;0.27;344.58;11.59;1343;40;3700.00;158
9311;34;22260328;9311;550;10654;10812;4.56;0.28;344.59;11.58;1343;40;3701.00;158
9313;34;22260347;9313;548;10655;10812;4.57;0.28;344.60;11.58;1342;40;3702.00;157
9317;34;22260364;9317;550;10659;10816;4.56;0.28;344.65;11.58;1342;40;3703.00;157
9319;34;22260382;9319;553;10659;10816;4.55;0.28;344.64;11.58;1340;40;3704.00;157
9325;34;22260399;9325;555;10659;10816;4.50;0.27;344.67;11.58;1334;40;3705.00;157
9328;34;22260416;9328;551;10660;10816;4.46;0.27;344.75;11.58;1332;40;3706.00;156
9332;34;22260433;9332;549;10660;10816;4.41;0.27;344.79;11.58;1328;40;3707.00;156
9334;34;22260451;9334;548;10671;10828;4.49;0.28;344.85;11.57;1337;40;3708.00;157
9337;34;22260470;9337;545;10671;10828;4.46;0.27;344.86;11.57;1334;40;3709.00;157
9341;34;22260486;9341;540;10671;10828;4.47;0.27;344.83;11.57;1330;40;3710.00;157
9342;34;22260503;9342;544;10671;10828;4.49;0.28;344.81;11.57;1329;40;3711.00;157
9344;34;22260519;9344;536;10671;10828;4.50;0.27;344.89;11.57;1327;40;3712.00;157
9347;34;22260538;9347;523;10671;10828;4.49;0.27;344.93;11.57;1324;40;3713.00;157
9347;34;22260554;9347;528;10671;10829;4.48;0.27;344.93;11.57;1324;40;3714.00;158
9351;34;22260571;9351;525;10671;10829;4.47;0.27;345.00;11.57;1320;40;3715.00;158
9353;34;22260588;9353;528;10676;10835;4.45;0.27;345.06;11.56;1323;40;3716.00;159
9354;34;22260605;9354;519;10677;10836;4.46;0.27;345.07;11.56;1323;40;3717.00;159
9358;34;22260622;9358;525;10677;10836;4.41;0.27;345.13;11.56;1319;40;3718.00;159
9360;34;22260639;9360;530;10677;10836;4.36;0.27;345.17;11.56;1317;40;3719.00;159
9365;34;22260657;9365;537;10681;10841;4.33;0.27;345.21;11.56;1316;40;3720.00;160
9367;34;22260675;9367;538;10681;10841;4.31;0.26;345.31;11.56;1314;40;3721.00;160
9368;34;22260692;9368;530;10681;10841;4.30;0.26;345.38;11.56;1313;40;3722.00;160
9373;34;22260709;9373;520;10683;10842;4.27;0.26;345.52;11.60;1310;40;3723.00;159
9374;34;22260728;9374;518;10686;10846;4.31;0.26;345.59;11.60;1312;40;3724.00;160
9375;34;22260745;9375;505;10686;10846;4.33;0.27;345.69;11.60;1311;40;3725.00;160
9377;34;22260761;9377;502;10688;10849;4.36;0.27;345.78;11.59;1311;40;3726.00;161
9377;34;22260780;9377;501;10688;10849;4.40;0.27;345.78;11.59;1311;40;3727.00;161
9383;34;22260797;9383;497;10689;10849;4.39;0.27;345.87;11.59;1306;40;3728.00;160
9386;34;22260815;9386;500;10689;10849;4.37;0.27;346.01;11.59;1303;40;3729.00;160
9390;34;22260833;9390;504;10693;10853;4.42;0.27;346.14;11.59;1303;40;3730.00;160
9395;34;22260850;9395;493;10693;10853;4.41;0.27;346.35;11.59;1298;40;3731.00;160
9397;34;22260867;9397;484;10693;10853;4.46;0.27;346.49;11.59;1296;40;3732.00;160
9399;34;22260884;9399;473;10693;10853;4.52;0.28;346.60;11.59;1294;40;3733.00;160
9402;34;22260901;9402;463;10693;10854;4.56;0.28;346.63;11.59;1291;40;3734.00;161
9403;34;22260919;9403;459;10695;10856;4.65;0.29;346.62;11.59;1292;40;3735.00;161
9409;34;22260937;9409;456;10695;10856;4.63;0.28;346.88;11.59;1286;40;3736.00;161
9410;34;22260954;9410;446;10697;10857;4.70;0.29;346.87;11.63;1287;40;3737.00;160
9413;34;22260972;9413;443;10697;10857;4.73;0.29;346.92;11.63;1284;40;3738.00;160
9416;34;22260989;9416;450;10697;10857;4.75;0.29;347.03;11.63;1281;40;3739.00;160
9417;34;22261008;9417;448;10697;10857;4.70;0.29;347.05;11.63;1280;40;3740.00;160
9421;34;22261025;9421;452;10698;10857;4.68;0.29;347.27;11.68;1277;40;3741.00;159
9424;34;22261044;9424;445;10698;10857;4.69;0.29;347.27;11.68;1274;40;3742.00;159
9426;34;22261062;9426;442;10698;10857;4.71;0.29;347.34;11.68;1272;40;3743.00;159
9430;34;22261080;9430;477;10774;10984;4.86;0.30;347.49;11.60;1344;40;3744.00;210
9431;34;22261108;9431;466;10774;10985;4.92;0.31;347.54;11.60;1343;40;3745.00;211
9435;34;22261127;9435;451;10780;10985;5.00;0.31;347.65;11.59;1345;40;3746.00;205
9440;34;22261145;9440;436;10783;10985;5.05;0.31;347.69;11.63;1343;40;3747.00;202
9441;34;22261162;9441;429;10787;10985;5.10;0.32;347.67;11.63;1346;40;3748.00;198
9441;34;22261180;9441;426;10788;10985;5.13;0.32;347.67;11.63;1347;40;3749.00;197
9443;34;22261201;9443;422;10794;10990;5.18;0.32;347.63;11.63;1351;40;3750.00;196
9444;34;22261219;9444;428;10796;10990;5.24;0.32;347.61;11.63;1352;40;3751.00;194
9444;34;22261238;9444;433;10798;10991;5.25;0.32;347.61;11.62;1354;40;3752.00;193
9446;34;22261256;9446;441;10802;10992;5.25;0.32;347.63;11.62;1356;40;3753.00;190
9449;34;22261274;9449;438;10804;10992;5.24;0.32;347.69;11.62;1355;40;3754.00;188
9451;34;22261291;9451;449;10808;10993;5.21;0.32;347.75;11.67;1357;40;3755.00;185
9454;34;22261311;9454;455;10812;10993;5.21;0.32;347.76;11.67;1358;40;3756.00;181
9454;34;22261330;9454;459;10814;10993;5.20;0.32;347.76;11.67;1360;40;3757.00;179
9455;34;22261348;9455;460;10817;10993;5.18;0.32;347.75;11.67;1362;40;3758.00;176
9458;34;22261366;9458;475;10821;10997;5.13;0.32;347.75;11.67;1363;40;3759.00;176
9461;34;22261391;9461;479;10823;10997;5.15;0.32;347.74;11.67;1362;40;3760.00;174
9462;34;22261414;9462;476;10824;10997;5.18;0.32;347.76;11.67;1362;40;3761.00;173
9462;34;22261432;9462;475;10826;11000;5.24;0.32;347.76;11.67;1364;40;3762.00;174
9464;34;22261450;9464;479;10826;11000;5.22;0.32;347.84;11.67;1362;40;3763.00;174
9465;34;22261469;9465;478;10828;11000;5.22;0.32;347.82;11.67;1363;40;3764.00;172
9465;34;22261487;9465;467;10831;11004;5.24;0.32;347.82;11.66;1366;40;3765.00;173
9469;34;22261506;9469;469;10833;11005;5.26;0.32;347.98;11.66;1364;40;3766.00;172
9470;34;22261525;9470;463;10833;11005;5.28;0.32;347.98;11.66;1363;40;3767.00;172
9471;34;22261545;9471;453;10836;11009;5.31;0.32;347.96;11.66;1365;40;3768.00;173
9475;34;22261573;9475;440;10836;11009;5.32;0.32;348.14;11.66;1361;40;3769.00;173
9477;34;22261591;9477;443;10836;11009;5.32;0.32;348.14;11.66;1359;40;3770.00;173
9478;34;22261611;9478;432;10837;11010;5.39;0.33;348.21;11.66;1359;40;3771.00;173
9484;34;22261632;9484;428;10837;11010;5.36;0.32;348.19;11.66;1353;40;3772.00;173
9485;34;22261650;9485;423;10842;11016;5.32;0.32;348.17;11.65;1357;40;3773.00;174
9485;34;22261669;9485;419;10842;11016;5.29;0.32;348.17;11.65;1357;40;3774.00;174
9487;34;22261687;9487;422;10842;11017;5.21;0.32;348.19;11.65;1355;40;3775.00;175
9490;34;22261706;9490;409;10842;11017;5.11;0.31;348.20;11.65;1352;40;3776.00;175
9493;34;22261723;9493;418;10842;11017;5.02;0.30;348.24;11.65;1349;40;3777.00;175
9495;34;22261740;9495;412;10842;11017;4.94;0.30;348.23;11.65;1347;40;3778.00;175
9496;34;22261758;9496;410;10843;11017;4.86;0.29;348.21;11.66;1347;40;3779.00;174
9499;34;22261778;9499;412;10867;11053;4.88;0.30;348.30;11.68;1368;40;3780.00;186
9500;34;22261811;9500;406;10869;11053;4.86;0.30;348.34;11.68;1369;40;3781.00;184
9504;34;22261838;9504;405;10872;11053;4.82;0.29;348.43;11.68;1368;40;3782.00;181
9510;34;22261856;9510;400;10873;11053;4.77;0.29;348.51;11.68;1363;40;3783.00;180
9511;34;22261874;9511;413;10874;11053;4.81;0.29;348.53;11.67;1363;40;3784.00;179
9517;34;22261892;9517;414;10875;11053;4.81;0.29;348.61;11.67;1358;40;3785.00;178
9518;34;22261911;9518;423;10877;11057;4.78;0.29;348.60;11.67;1359;40;3786.00;180
9519;34;22261931;9519;413;10877;11057;4.76;0.29;348.63;11.67;1358;40;3787.00;180
9520;34;22261948;9520;423;10880;11061;4.73;0.29;348.65;11.67;1360;40;3788.00;181
9523;34;22261966;9523;430;10883;11062;4.69;0.29;348.73;11.67;1360;40;3789.00;179
9525;34;22261984;9525;431;10883;11062;4.70;0.29;348.71;11.67;1358;40;3790.00;179
9527;34;22262002;9527;421;10883;11062;4.69;0.29;348.77;11.67;1356;40;3791.00;179
9529;34;22262020;9529;426;10893;11075;4.68;0.29;348.78;11.66;1364;40;3792.00;182
9533;34;22262039;9533;426;10894;11075;4.68;0.29;348.86;11.66;1361;40;3793.00;181
9536;34;22262057;9536;430;10894;11075;4.66;0.28;348.98;11.66;1358;40;3794.00;181
9539;34;22262076;9539;431;10895;11076;4.66;0.28;349.05;11.66;1356;40;3795.00;181
9542;34;22262095;9542;438;10895;11077;4.61;0.28;349.09;11.66;1353;40;3796.00;182
9545;34;22262113;9545;448;10895;11077;4.61;0.28;349.03;11.66;1350;40;3797.00;182
9546;34;22262131;9546;453;10898;11080;4.61;0.28;349.04;11.66;1352;40;3798.00;182
9547;34;22262149;9547;453;10900;11080;4.60;0.28;349.10;11.70;1353;40;3799.00;180
9549;34;22262168;9549;453;10901;11080;4.62;0.28;349.10;11.70;1352;40;3800.00;179
9549;34;22262191;9549;455;10901;11080;4.64;0.28;349.10;11.70;1352;40;3801.00;179
9550;34;22262209;9550;470;10906;11086;4.70;0.29;349.09;11.69;1356;40;3802.00;180
9552;34;22262229;9552;472;10906;11086;4.70;0.29;349.04;11.69;1354;40;3803.00;180
9555;34;22262247;9555;479;10906;11086;4.67;0.29;348.97;11.69;1351;40;3804.00;180
9555;34;22262265;9555;488;10906;11086;4.61;0.28;348.97;11.69;1351;40;3805.00;180
9556;34;22262282;9556;487;10910;11090;4.60;0.28;349.02;11.74;1354;40;3806.00;180
9557;34;22262301;9557;498;10911;11091;4.54;0.28;349.02;11.74;1354;40;3807.00;180
9558;34;22262327;9558;493;10911;11091;4.52;0.28;349.01;11.74;1353;40;3808.00;180
9559;34;22262346;9559;503;10912;11092;4.48;0.27;348.99;11.74;1353;40;3809.00;180
9563;34;22262365;9563;506;10912;11092;4.44;0.27;349.04;11.74;1349;40;3810.00;180
9567;34;22262382;9567;511;10912;11092;4.38;0.27;348.98;11.74;1345;40;3811.00;180
9567;34;22262400;9567;513;10912;11092;4.37;0.27;348.98;11.74;1345;40;3812.00;180
9568;34;22262417;9568;525;10912;11092;4.37;0.27;349.04;11.74;1344;40;3813.00;180
9571;34;22262434;9571;533;10914;11092;4.32;0.26;349.00;11.84;1343;40;3814.00;178
9573;34;22262453;9573;543;10914;11092;4.32;0.26;348.94;11.84;1341;40;3815.00;178
9575;34;22262469;9575;550;10951;11162;4.48;0.27;348.99;11.80;1376;40;3816.00;211
9576;34;22262492;9576;556;10953;11163;4.41;0.27;348.99;11.80;1377;40;3817.00;210
9577;34;22262509;9577;562;10962;11163;4.42;0.27;348.97;11.79;1385;40;3818.00;201
9580;34;22262525;9580;557;10963;11163;4.35;0.27;348.99;11.79;1383;40;3819.00;200
9583;34;22262544;9583;563;10967;11163;4.27;0.26;349.04;11.79;1384;40;3820.00;196
9584;34;22262562;9584;566;10967;11163;4.18;0.26;349.01;11.79;1383;40;3821.00;196
9585;34;22262578;9585;577;10971;11163;4.15;0.25;348.99;11.78;1386;40;3822.00;192
9588;34;22262595;9588;583;10973;11163;4.09;0.25;349.02;11.78;1385;40;3823.00;190
9592;34;22262618;9592;584;10976;11164;4.03;0.25;348.91;11.78;1384;40;3824.00;188
9594;34;22262635;9594;583;10980;11166;3.96;0.24;348.85;11.78;1386;40;3825.00;186
9596;34;22262652;9596;583;10982;11166;3.92;0.24;348.81;11.78;1386;40;3826.00;184
9597;34;22262669;9597;587;10986;11170;3.89;0.24;348.82;11.77;1389;40;3827.00;184
9599;34;22262684;9599;587;10986;11170;3.84;0.23;348.77;11.77;1387;40;3828.00;184
9599;34;22262702;9599;588;10986;11170;3.83;0.23;348.77;11.77;1387;40;3829.00;184
9601;34;22262719;9601;598;10986;11170;3.79;0.23;348.74;11.77;1385;40;3830.00;184
9602;34;22262735;9602;602;10991;11176;3.76;0.23;348.72;11.77;1389;40;3831.00;185
9603;34;22262751;9603;610;10991;11176;3.74;0.23;348.73;11.77;1388;40;3832.00;185
9604;34;22262768;9604;614;10991;11176;3.71;0.23;348.70;11.77;1387;40;3833.00;185
9607;34;22262783;9607;616;10994;11179;3.69;0.22;348.67;11.77;1387;40;3834.00;185
9607;34;22262800;9607;609;10994;11179;3.70;0.23;348.67;11.77;1387;40;3835.00;185
9607;34;22262816;9607;598;10994;11179;3.72;0.23;348.67;11.77;1387;40;3836.00;185
9610;34;22262833;9610;587;10994;11180;3.72;0.23;348.66;11.77;1384;40;3837.00;186
9613;34;22262849;9613;583;10995;11181;3.74;0.23;348.73;11.77;1382;40;3838.00;186
9617;34;22262866;9617;586;10995;11181;3.77;0.23;348.69;11.77;1378;40;3839.00;186
9620;34;22262884;9620;591;11013;11207;3.84;0.23;348.68;11.75;1393;40;3840.00;194
9622;34;22262903;9622;593;11014;11207;3.85;0.23;348.64;11.75;1392;40;3841.00;193
9626;34;22262928;9626;597;11017;11207;3.87;0.24;348.55;11.74;1391;40;3842.00;190
9627;34;22262945;9627;598;11018;11208;3.90;0.24;348.55;11.74;1391;40;3843.00;190
9631;34;22262961;9631;590;11018;11208;3.85;0.24;348.47;11.74;1387;40;3844.00;190
9635;34;22262977;9635;599;11021;11212;3.83;0.23;348.39;11.74;1386;40;3845.00;191
9636;34;22262993;9636;597;11022;11214;3.79;0.23;348.41;11.74;1386;40;3846.00;192
9638;34;22263010;9638;599;11026;11218;3.76;0.23;348.40;11.73;1388;40;3847.00;192
9639;34;22263025;9639;604;11026;11218;3.75;0.23;348.47;11.73;1387;40;3848.00;192
9642;34;22263041;9642;598;11026;11218;3.69;0.23;348.51;11.73;1384;40;3849.00;192
9645;35;22263055;9645;588;11026;11218;3.67;0.22;348.43;11.73;1381;41;3850.00;192
9649;35;22263086;9649;581;11026;11218;3.69;0.22;348.36;11.73;1377;41;3851.00;192
9652;35;22263103;9652;578;11035;11230;3.77;0.23;348.36;11.72;1383;41;3852.00;195
9654;35;22263126;9654;568;11036;11230;3.83;0.23;348.34;11.72;1382;41;3853.00;194
9658;35;22263143;9658;561;11036;11230;3.86;0.23;348.35;11.72;1378;41;3854.00;194
9659;35;22263158;9659;560;11036;11230;3.91;0.24;348.36;11.72;1377;41;3855.00;194
9661;35;22263175;9661;554;11036;11230;3.93;0.24;348.33;11.72;1375;41;3856.00;194
9663;35;22263191;9663;540;11036;11230;3.96;0.24;348.34;11.72;1373;41;3857.00;194
9668;35;22263207;9668;526;11036;11231;3.95;0.24;348.36;11.72;1368;41;3858.00;195
9669;35;22263230;9669;521;11036;11231;3.98;0.24;348.33;11.72;1367;41;3859.00;195
9674;35;22263247;9674;517;11040;11237;4.08;0.25;348.25;11.72;1366;41;3860.00;197
9675;35;22263264;9675;512;11041;11238;4.13;0.25;348.21;11.72;1366;41;3861.00;197
9676;35;22263281;9676;506;11041;11238;4.20;0.26;348.23;11.72;1365;41;3862.00;197
9679;35;22263297;9679;502;11041;11238;4.26;0.26;348.26;11.72;1362;41;3863.00;197
9681;35;22263314;9681;499;11043;11242;4.35;0.26;348.29;11.72;1362;41;3864.00;199
9685;35;22263331;9685;480;11044;11242;4.41;0.27;348.34;11.72;1359;41;3865.00;198
9687;35;22263348;9687;477;11044;11242;4.44;0.27;348.30;11.72;1357;41;3866.00;198
9692;35;22263365;9692;479;11045;11243;4.41;0.27;348.37;11.71;1353;41;3867.00;198
9693;35;22263383;9693;470;11048;11247;4.48;0.27;348.39;11.71;1355;41;3868.00;199
9697;35;22263402;9697;463;11048;11247;4.51;0.27;348.38;11.71;1351;41;3869.00;199
9702;35;22263420;9702;466;11052;11253;4.55;0.28;348.42;11.71;1350;41;3870.00;201
9705;35;22263439;9705;464;11052;11253;4.55;0.28;348.45;11.71;1347;41;3871.00;201
9710;35;22263457;9710;460;11054;11253;4.57;0.28;348.61;11.71;1344;41;3872.00;199
9714;35;22263476;9714;461;11054;11253;4.57;0.28;348.68;11.71;1340;41;3873.00;199
9718;35;22263495;9718;459;11058;11257;4.61;0.28;348.74;11.75;1340;41;3874.00;199
9721;35;22263515;9721;463;11059;11257;4.57;0.28;348.75;11.76;1338;41;3875.00;198
9724;35;22263533;9724;457;11060;11257;4.57;0.28;348.78;11.76;1336;41;3876.00;197
9731;35;22263550;9731;463;11060;11257;4.51;0.27;348.78;11.76;1329;41;3877.00;197
9733;35;22263569;9733;461;11061;11258;4.52;0.27;348.79;11.76;1328;41;3878.00;197
9735;35;22263586;9735;460;11063;11259;4.55;0.28;348.76;11.75;1328;41;3879.00;196
9739;35;22263604;9739;450;11063;11259;4.55;0.28;348.94;11.75;1324;41;3880.00;196
9743;35;22263621;9743;455;11064;11260;4.56;0.28;348.93;11.75;1321;41;3881.00;196
9745;35;22263640;9745;450;11064;11260;4.60;0.28;348.89;11.75;1319;41;3882.00;196
9748;35;22263657;9748;458;11064;11260;4.61;0.28;349.00;11.75;1316;41;3883.00;196
9752;35;22263683;9752;450;11064;11260;4.64;0.28;348.96;11.75;1312;41;3884.00;196
9754;35;22263700;9754;453;11064;11260;4.67;0.28;348.96;11.75;1310;41;3885.00;196
9759;35;22263718;9759;451;11064;11260;4.70;0.28;348.90;11.75;1305;41;3886.00;196
9761;36;22263735;9761;450;11064;11260;4.73;0.29;348.91;11.75;1303;42;3887.00;196
9764;36;22263769;9764;466;11130;11387;5.01;0.31;348.93;11.68;1366;42;3888.00;257
9768;36;22263801;9768;461;11134;11388;5.01;0.31;349.06;11.68;1366;42;3889.00;254
9771;36;22263820;9771;460;11139;11388;5.02;0.31;349.14;11.68;1368;42;3890.00;249
9774;36;22263838;9774;456;11141;11388;5.02;0.31;349.13;11.67;1367;42;3891.00;247
9778;36;22263857;9778;454;11145;11388;4.99;0.31;349.18;11.72;1367;42;3892.00;243
9781;36;22263876;9781;458;11147;11388;4.94;0.30;349.28;11.72;1366;42;3893.00;241
9783;36;22263894;9783;460;11150;11388;4.92;0.30;349.32;11.72;1367;42;3894.00;238
9788;36;22263912;9788;469;11153;11388;4.88;0.30;349.42;11.71;1365;42;3895.00;235
9792;36;22263937;9792;476;11154;11389;4.77;0.29;349.49;11.71;1362;42;3896.00;235
9794;36;22263955;9794;478;11156;11390;4.81;0.30;349.57;11.71;1362;42;3897.00;234
9798;36;22263974;9798;482;11158;11390;4.78;0.29;349.70;11.71;1360;42;3898.00;232
9800;36;22263994;9800;484;11162;11391;4.79;0.29;349.82;11.71;1362;42;3899.00;229
9803;36;22264015;9803;495;11169;11406;4.73;0.29;349.91;11.71;1366;42;3900.00;237
9805;36;22264047;9805;490;11173;11406;4.74;0.29;349.98;11.71;1368;42;3901.00;233
9807;36;22264066;9807;492;11174;11406;4.74;0.29;350.12;11.71;1367;42;3902.00;232
9810;36;22264083;9810;496;11180;11410;4.78;0.29;350.13;11.71;1370;42;3903.00;230
9812;36;22264103;9812;500;11182;11410;4.81;0.30;350.17;11.71;1370;42;3904.00;228
9816;36;22264121;9816;506;11185;11410;4.81;0.30;350.29;11.71;1369;42;3905.00;225
9817;36;22264139;9817;489;11191;11413;4.85;0.30;350.27;11.71;1374;42;3906.00;222
9823;36;22264157;9823;474;11191;11413;4.86;0.30;350.47;11.71;1368;42;3907.00;222
9825;36;22264184;9825;472;11193;11413;4.92;0.30;350.57;11.76;1368;42;3908.00;220
9827;36;22264211;9827;468;11199;11417;4.99;0.31;350.63;11.75;1372;42;3909.00;218
9833;36;22264231;9833;459;11201;11418;5.00;0.31;350.83;11.75;1368;42;3910.00;217
9838;36;22264250;9838;464;11204;11418;5.05;0.31;351.00;11.75;1366;42;3911.00;214
9841;36;22264270;9841;456;11207;11422;5.05;0.31;351.08;11.75;1366;42;3912.00;215
9845;36;22264289;9845;455;11207;11422;5.10;0.31;351.14;11.75;1362;42;3913.00;215
9848;36;22264311;9848;452;11208;11422;5.11;0.31;351.20;11.75;1360;42;3914.00;214
9854;36;22264330;9854;454;11210;11424;5.09;0.31;351.25;11.75;1356;42;3915.00;214
9855;36;22264350;9855;459;11210;11424;5.09;0.31;351.32;11.75;1355;42;3916.00;214
9858;36;22264369;9858;454;11216;11430;5.07;0.31;351.53;11.75;1358;42;3917.00;214
9862;36;22264389;9862;451;11216;11430;5.06;0.31;351.56;11.75;1354;42;3918.00;214
9865;36;22264407;9865;459;11217;11431;5.14;0.31;351.52;11.79;1352;42;3919.00;214
9866;36;22264429;9866;454;11217;11431;5.18;0.32;351.53;11.79;1351;42;3920.00;214
9870;36;22264447;9870;451;11217;11431;5.16;0.31;351.63;11.79;1347;42;3921.00;214
9873;36;22264466;9873;457;11217;11431;5.14;0.31;351.76;11.79;1344;42;3922.00;214
9874;36;22264485;9874;464;11219;11431;5.10;0.31;351.86;11.79;1345;42;3923.00;212
9875;36;22264504;9875;464;11228;11443;5.07;0.31;351.95;11.79;1353;42;3924.00;215
9877;36;22264523;9877;462;11229;11443;5.05;0.31;352.02;11.78;1352;42;3925.00;214
9879;36;22264545;9879;468;11231;11443;5.03;0.31;352.08;11.79;1352;42;3926.00;212
9881;36;22264563;9881;473;11231;11443;4.94;0.30;352.18;11.79;1350;42;3927.00;212
9883;36;22264581;9883;480;11231;11443;4.89;0.30;352.26;11.79;1348;42;3928.00;212
9885;36;22264601;9885;481;11233;11443;4.90;0.30;352.33;11.79;1348;42;3929.00;210
9886;36;22264623;9886;476;11236;11447;4.85;0.30;352.41;11.78;1350;42;3930.00;211
9890;36;22264643;9890;486;11236;11447;4.79;0.29;352.40;11.78;1346;42;3931.00;211
9891;36;22264661;9891;487;11240;11451;4.79;0.29;352.37;11.78;1349;42;3932.00;211
9892;36;22264680;9892;492;11241;11452;4.73;0.29;352.35;11.78;1349;42;3933.00;211
9893;36;22264699;9893;499;11241;11452;4.65;0.28;352.35;11.78;1348;42;3934.00;211
9895;36;22264717;9895;505;11241;11452;4.61;0.28;352.41;11.78;1346;42;3935.00;211
9898;36;22264736;9898;501;11252;11465;4.62;0.28;352.51;11.77;1354;42;3936.00;213
9899;36;22264755;9899;498;11252;11465;4.63;0.28;352.58;11.77;1353;42;3937.00;213
9902;36;22264773;9902;499;11253;11465;4.63;0.28;352.58;11.81;1351;42;3938.00;212
9905;36;22264792;9905;494;11254;11466;4.59;0.28;352.63;11.81;1349;42;3939.00;212
9907;36;22264811;9907;497;11254;11467;4.63;0.28;352.63;11.81;1347;42;3940.00;213
9908;36;22264830;9908;490;11254;11467;4.65;0.28;352.66;11.81;1346;42;3941.00;213
9910;36;22264855;9910;488;11256;11470;4.66;0.28;352.77;11.81;1346;42;3942.00;214
9912;36;22264876;9912;482;11256;11470;4.67;0.28;352.79;11.81;1344;42;3943.00;214
9914;36;22264894;9914;485;11257;11470;4.68;0.28;352.88;11.81;1343;42;3944.00;213
9918;36;22264912;9918;482;11257;11470;4.68;0.28;353.00;11.81;1339;42;3945.00;213
9920;36;22264931;9920;481;11262;11476;4.75;0.29;353.00;11.80;1342;42;3946.00;214
9922;36;22264950;9922;478;11262;11476;4.76;0.29;353.01;11.80;1340;42;3947.00;214
9926;36;22264969;9926;482;11262;11476;4.78;0.29;353.03;11.80;1336;42;3948.00;214
9930;36;22264986;9930;482;11262;11476;4.82;0.29;353.11;11.80;1332;42;3949.00;214
9935;36;22265005;9935;485;11265;11480;4.84;0.29;353.21;11.80;1330;42;3950.00;215
9937;36;22265024;9937;476;11266;11481;4.90;0.30;353.23;11.80;1329;42;3951.00;215
9941;36;22265042;9941;484;11266;11481;4.89;0.30;353.21;11.80;1325;42;3952.00;215
9941;36;22265060;9941;482;11267;11482;4.88;0.30;353.21;11.80;1326;42;3953.00;215
9943;36;22265079;9943;481;11267;11482;4.83;0.29;353.23;11.80;1324;42;3954.00;215
9945;36;22265097;9945;484;11269;11482;4.77;0.29;353.25;11.92;1324;42;3955.00;213
9945;36;22265117;9945;483;11269;11482;4.76;0.29;353.25;11.92;1324;42;3956.00;213
9946;36;22265135;9946;482;11269;11482;4.70;0.29;353.30;11.92;1323;42;3957.00;213
9949;36;22265151;9949;482;11269;11482;4.65;0.28;353.24;11.92;1320;42;3958.00;213
9951;36;22265168;9951;485;11269;11482;4.65;0.29;353.22;11.92;1318;42;3959.00;213
9958;36;22265187;9958;503;11329;11607;4.84;0.30;353.17;11.86;1371;42;3960.00;278
9958;36;22265216;9958;494;11330;11608;4.84;0.30;353.17;11.85;1372;42;3961.00;278
9961;36;22265233;9961;495;11340;11608;4.85;0.30;353.13;11.85;1379;42;3962.00;268
9964;36;22265251;9964;495;11343;11608;4.82;0.30;353.12;11.84;1379;42;3963.00;265
9968;36;22265269;9968;500;11347;11608;4.80;0.30;353.13;11.84;1379;42;3964.00;261
9970;36;22265286;9970;505;11349;11608;4.80;0.30;353.08;11.84;1379;42;3965.00;259
9972;36;22265304;9972;507;11354;11608;4.79;0.30;353.03;11.84;1382;42;3966.00;254
9974;36;22265321;9974;505;11356;11608;4.78;0.30;353.00;11.84;1382;42;3967.00;252
9979;36;22265338;9979;513;11360;11609;4.77;0.29;353.09;11.84;1381;42;3968.00;249
9983;36;22265356;9983;507;11366;11610;4.80;0.30;353.08;11.83;1383;42;3969.00;244
9984;36;22265375;9984;518;11369;11610;4.78;0.29;353.05;11.83;1385;42;3970.00;241
9986;36;22265393;9986;516;11373;11614;4.77;0.29;353.09;11.83;1387;42;3971.00;241
9988;36;22265412;9988;525;11375;11614;4.69;0.29;353.07;11.83;1387;42;3972.00;239
9990;36;22265431;9990;524;11375;11614;4.66;0.29;353.08;11.83;1385;42;3973.00;239
9995;36;22265450;9995;530;11375;11614;4.58;0.28;353.04;11.83;1380;42;3974.00;239
9995;36;22265468;9995;533;11381;11620;4.61;0.28;353.04;11.83;1386;42;3975.00;239
9999;36;22265486;9999;529;11381;11620;4.56;0.28;352.96;11.83;1382;42;3976.00;239
10002;36;22265505;10002;550;11381;11620;4.53;0.28;353.07;11.83;1379;42;3977.00;239
10003;36;22265522;10003;556;11383;11623;4.51;0.28;353.07;11.82;1380;42;3978.00;240
10006;36;22265543;10006;566;11384;11623;4.44;0.27;353.11;11.82;1378;42;3979.00;239
10006;36;22265561;10006;571;11387;11623;4.39;0.27;353.11;11.89;1381;42;3980.00;236
10009;36;22265578;10009;572;11388;11624;4.34;0.27;353.12;11.88;1379;42;3981.00;236
10011;36;22265595;10011;574;11390;11625;4.29;0.26;353.15;11.94;1379;42;3982.00;235
10012;36;22265611;10012;591;11390;11625;4.28;0.26;353.14;11.94;1378;42;3983.00;235
10015;36;22265628;10015;594;11400;11638;4.29;0.26;353.13;11.93;1385;42;3984.00;238
10017;36;22265647;10017;598;11401;11638;4.26;0.26;353.07;12.00;1384;42;3985.00;237
10018;36;22265664;10018;602;11402;11638;4.28;0.26;353.07;11.99;1384;42;3986.00;236
10019;36;22265682;10019;603;11404;11639;4.25;0.26;353.07;12.05;1385;42;3987.00;235
10020;36;22265700;10020;609;11404;11639;4.25;0.26;353.13;12.05;1384;42;3988.00;235
10022;36;22265717;10022;606;11409;11643;4.25;0.26;353.08;12.11;1387;42;3989.00;234
10024;36;22265735;10024;615;11409;11643;4.26;0.26;353.13;12.11;1385;42;3990.00;234
10025;36;22265752;10025;628;11412;11647;4.24;0.26;353.13;12.11;1387;42;3991.00;235
10027;36;22265770;10027;616;11413;11647;4.19;0.26;353.17;12.17;1386;42;3992.00;234
10028;36;22265787;10028;613;11413;11647;4.21;0.26;353.15;12.17;1385;42;3993.00;234
10031;36;22265805;10031;608;11413;11647;4.19;0.26;353.13;12.17;1382;42;3994.00;234
10032;36;22265821;10032;602;11413;11647;4.16;0.26;353.14;12.17;1381;42;3995.00;234
10035;36;22265838;10035;605;11422;11659;4.20;0.26;353.10;12.16;1387;42;3996.00;237
10036;36;22265856;10036;606;11425;11659;4.17;0.26;353.10;12.34;1389;42;3997.00;234
10038;36;22265874;10038;606;11427;11659;4.18;0.26;353.11;12.34;1389;42;3998.00;232
10039;36;22265899;10039;600;11428;11659;4.17;0.25;353.16;12.39;1389;42;3999.00;231
10040;36;22265915;10040;594;11428;11659;4.14;0.25;353.18;12.39;1388;42;4000.00;231
10040;36;22265938;10040;601;11428;11659;4.14;0.25;353.18;12.39;1388;42;4001.00;231
10042;36;22265954;10042;596;11428;11660;4.12;0.25;353.18;12.39;1386;42;4002.00;232
10042;36;22265972;10042;602;11428;11660;4.11;0.25;353.18;12.39;1386;42;4003.00;232
10042;36;22265988;10042;592;11433;11666;4.15;0.25;353.18;12.39;1391;42;4004.00;233
10043;36;22266013;10043;599;11435;11668;4.13;0.25;353.16;12.39;1392;42;4005.00;233
10044;36;22266030;10044;596;11435;11668;4.16;0.26;353.13;12.39;1391;42;4006.00;233
10045;36;22266047;10045;602;11435;11668;4.17;0.26;353.10;12.39;1390;42;4007.00;233
10046;36;22266064;10046;597;11438;11672;4.25;0.26;353.11;12.38;1392;42;4008.00;234
10046;36;22266081;10046;593;11438;11672;4.29;0.26;353.11;12.38;1392;42;4009.00;234
10047;36;22266104;10047;592;11438;11672;4.31;0.26;353.09;12.38;1391;42;4010.00;234
10049;36;22266119;10049;590;11439;11673;4.34;0.27;353.06;12.38;1390;42;4011.00;234
10051;36;22266137;10051;590;11442;11677;4.38;0.27;353.04;12.38;1391;42;4012.00;235
10054;36;22266153;10054;589;11442;11677;4.40;0.27;353.00;12.38;1388;42;4013.00;235
10058;36;22266170;10058;595;11444;11680;4.36;0.27;353.08;12.38;1386;42;4014.00;236
10062;36;22266187;10062;595;11444;11680;4.29;0.26;353.14;12.38;1382;42;4015.00;236
10065;36;22266203;10065;595;11445;11680;4.23;0.26;353.21;12.38;1380;42;4016.00;235
10069;36;22266220;10069;593;11445;11680;4.22;0.26;353.19;12.38;1376;42;4017.00;235
10073;36;22266235;10073;597;11449;11684;4.25;0.26;353.17;12.37;1376;42;4018.00;235
10078;36;22266252;10078;597;11449;11684;4.21;0.26;353.26;12.37;1371;42;4019.00;235
10084;36;22266278;10084;592;11449;11684;4.14;0.25;353.46;12.37;1365;42;4020.00;235
10087;36;22266296;10087;589;11449;11684;4.13;0.25;353.51;12.37;1362;42;4021.00;235
10092;36;22266312;10092;589;11449;11685;4.07;0.25;353.57;12.37;1357;42;4022.00;236
10094;36;22266328;10094;594;11450;11686;4.02;0.24;353.57;12.37;1356;42;4023.00;236
10095;36;22266345;10095;592;11450;11686;4.03;0.25;353.59;12.37;1355;42;4024.00;236
10098;36;22266358;10098;576;11451;11687;4.04;0.25;353.59;12.37;1353;42;4025.00;236
10103;36;22266375;10103;569;11451;11687;4.03;0.25;353.65;12.37;1348;42;4026.00;236
10103;36;22266391;10103;561;11451;11687;4.06;0.25;353.65;12.37;1348;42;4027.00;236
10107;36;22266407;10107;553;11451;11687;4.07;0.25;353.74;12.37;1344;42;4028.00;236
10111;36;22266424;10111;541;11451;11687;4.09;0.25;353.80;12.37;1340;42;4029.00;236
10112;36;22266441;10112;538;11451;11687;4.15;0.25;353.77;12.37;1339;42;4030.00;236
10118;36;22266457;10118;528;11451;11687;4.16;0.25;353.89;12.37;1333;42;4031.00;236
10121;36;22266474;10121;529;11510;11814;4.48;0.28;353.89;12.31;1389;42;4032.00;304
10124;36;22266503;10124;509;11514;11815;4.52;0.28;354.00;12.30;1390;42;4033.00;301
10128;36;22266520;10128;498;11521;11815;4.54;0.28;354.04;12.30;1393;42;4034.00;294
10128;36;22266538;10128;494;11527;11815;4.58;0.28;354.04;12.29;1399;42;4035.00;288
10133;36;22266555;10133;489;11533;11815;4.57;0.28;354.07;12.29;1400;42;4036.00;282
10136;36;22266573;10136;488;11536;11815;4.54;0.28;354.08;12.29;1400;42;4037.00;279
10139;36;22266591;10139;490;11539;11815;4.48;0.28;354.15;12.28;1400;42;4038.00;276
10141;36;22266610;10141;489;11540;11815;4.50;0.28;354.16;12.28;1399;42;4039.00;275
10146;36;22266628;10146;489;11542;11816;4.47;0.27;354.24;12.28;1396;42;4040.00;274
10148;36;22266647;10148;488;11543;11817;4.50;0.28;354.24;12.28;1395;42;4041.00;274
10150;36;22266666;10150;486;11546;11817;4.53;0.28;354.27;12.28;1396;42;4042.00;271
10153;36;22266683;10153;492;11546;11818;4.58;0.28;354.27;12.28;1393;42;4043.00;272
10154;36;22266702;10154;483;11548;11818;4.61;0.28;354.28;12.28;1394;42;4044.00;270
10157;36;22266720;10157;478;11548;11818;4.58;0.28;354.37;12.28;1391;42;4045.00;270
10161;36;22266739;10161;479;11549;11818;4.54;0.28;354.37;12.28;1388;42;4046.00;269
10165;36;22266758;10165;483;11554;11822;4.51;0.28;354.58;12.28;1389;42;4047.00;268
10168;36;22266779;10168;486;11555;11822;4.50;0.28;354.58;12.28;1387;42;4048.00;267
10173;36;22266798;10173;482;11558;11822;4.47;0.27;354.59;12.28;1385;42;4049.00;264
10175;36;22266818;10175;492;11564;11828;4.48;0.27;354.64;12.33;1389;42;4050.00;264
10178;36;22266840;10178;484;11565;11828;4.49;0.27;354.66;12.33;1387;42;4051.00;263
10182;36;22266861;10182;474;11567;11828;4.48;0.27;354.73;12.33;1385;42;4052.00;261
10183;36;22266880;10183;481;11571;11832;4.53;0.28;354.71;12.33;1388;42;4053.00;261
10189;36;22266899;10189;473;11573;11833;4.53;0.28;354.75;12.33;1384;42;4054.00;260
10192;36;22266917;10192;470;11575;11833;4.53;0.28;354.72;12.33;1383;42;4055.00;258
10197;36;22266937;10197;477;11577;11837;4.50;0.27;354.98;12.33;1380;42;4056.00;260
10198;36;22266955;10198;470;11579;11837;4.50;0.27;355.02;12.33;1381;42;4057.00;258
10200;36;22266975;10200;467;11579;11837;4.53;0.28;355.06;12.33;1379;42;4058.00;258
10205;36;22267000;10205;476;11582;11838;4.52;0.28;355.15;12.33;1377;42;4059.00;256
10210;36;22267019;10210;477;11582;11838;4.52;0.27;355.22;12.33;1372;42;4060.00;256
10212;36;22267039;10212;482;11587;11844;4.54;0.28;355.21;12.33;1375;42;4061.00;257
10215;36;22267058;10215;486;11589;11844;4.54;0.28;355.36;12.33;1374;42;4062.00;255
10218;36;22267077;10218;480;11589;11845;4.55;0.28;355.42;12.33;1371;42;4063.00;256
10221;36;22267097;10221;489;11590;11845;4.57;0.28;355.54;12.33;1369;42;4064.00;255
10222;36;22267116;10222;490;11591;11845;4.57;0.28;355.61;12.33;1369;42;4065.00;254
10227;36;22267135;10227;490;11592;11845;4.56;0.28;355.68;12.33;1365;42;4066.00;253
10229;36;22267153;10229;493;11593;11845;4.59;0.28;355.72;12.33;1364;42;4067.00;252
10231;36;22267172;10231;492;11598;11857;4.61;0.28;355.89;12.33;1367;42;4068.00;259
10237;36;22267191;10237;494;11602;11857;4.60;0.28;355.96;12.38;1365;42;4069.00;255
10243;36;22267211;10243;501;11604;11857;4.61;0.28;356.10;12.38;1361;42;4070.00;253
10247;36;22267230;10247;500;11605;11857;4.59;0.28;356.18;12.38;1358;42;4071.00;252
10249;36;22267249;10249;495;11605;11857;4.63;0.28;356.22;12.38;1356;42;4072.00;252
10252;36;22267269;10252;484;11606;11857;4.61;0.28;356.40;12.38;1354;42;4073.00;251
10255;36;22267287;10255;482;11610;11861;4.63;0.28;356.46;12.38;1355;42;4074.00;251
10257;36;22267307;10257;479;11610;11861;4.68;0.28;356.50;12.38;1353;42;4075.00;251
10259;36;22267325;10259;478;11614;11865;4.72;0.29;356.56;12.37;1355;42;4076.00;251
10264;36;22267346;10264;487;11615;11866;4.71;0.29;356.74;12.37;1351;42;4077.00;251
10266;36;22267365;10266;485;11615;11866;4.69;0.28;356.74;12.37;1349;42;4078.00;251
10269;36;22267383;10269;490;11615;11866;4.65;0.28;356.95;12.37;1346;42;4079.00;251
10271;36;22267403;10271;502;11637;11895;4.65;0.28;356.94;12.35;1366;42;4080.00;258
10274;36;22267424;10274;503;11638;11895;4.62;0.28;357.08;12.35;1364;42;4081.00;257
10276;36;22267451;10276;500;11639;11895;4.63;0.28;357.22;12.34;1363;42;4082.00;256
10276;36;22267471;10276;496;11640;11896;4.67;0.28;357.22;12.34;1364;42;4083.00;256
10280;36;22267488;10280;492;11641;11897;4.67;0.28;357.37;12.40;1361;42;4084.00;256
10282;36;22267506;10282;496;11641;11897;4.64;0.28;357.41;12.40;1359;42;4085.00;256
10284;36;22267531;10284;497;11643;11900;4.64;0.28;357.37;12.39;1359;42;4086.00;257
10287;36;22267551;10287;502;11643;11900;4.59;0.28;357.48;12.39;1356;42;4087.00;257
10288;36;22267570;10288;502;11644;11900;4.64;0.28;357.58;12.39;1356;42;4088.00;256
10290;36;22267588;10290;504;11644;11900;4.64;0.28;357.54;12.39;1354;42;4089.00;256
10292;36;22267605;10292;516;11649;11906;4.64;0.28;357.53;12.39;1357;42;4090.00;257
10295;36;22267623;10295;514;11649;11906;4.63;0.28;357.70;12.39;1354;42;4091.00;257
10299;36;22267642;10299;507;11650;11906;4.59;0.28;357.71;12.44;1351;42;4092.00;256
10300;36;22267661;10300;500;11650;11906;4.55;0.28;357.80;12.44;1350;42;4093.00;256
10303;36;22267680;10303;503;11653;11910;4.56;0.28;357.98;12.43;1350;42;4094.00;257
10304;36;22267700;10304;503;11655;11912;4.61;0.28;357.99;12.43;1351;42;4095.00;257
10305;36;22267719;10305;508;11655;11912;4.64;0.28;358.03;12.43;1350;42;4096.00;257
10306;36;22267737;10306;504;11656;11913;4.68;0.29;358.07;12.43;1350;42;4097.00;257
10309;36;22267754;10309;490;11657;11913;4.72;0.29;358.08;12.43;1348;42;4098.00;256
10311;36;22267772;10311;494;11657;11913;4.80;0.29;358.16;12.43;1346;42;4099.00;256
10312;36;22267790;10312;494;11657;11913;4.82;0.29;358.14;12.43;1345;42;4100.00;256
10316;36;22267815;10316;493;11657;11913;4.81;0.29;358.16;12.43;1341;42;4101.00;256
10318;36;22267841;10318;499;11658;11913;4.80;0.29;358.26;12.47;1340;42;4102.00;255
10320;36;22267866;10320;492;11658;11913;4.80;0.29;358.40;12.47;1338;42;4103.00;255
10323;36;22267883;10323;513;11698;11983;4.82;0.29;358.57;12.43;1375;42;4104.00;285
10324;36;22267908;10324;507;11700;11984;4.82;0.29;358.62;12.43;1376;42;4105.00;284
10327;36;22267928;10327;501;11706;11984;4.87;0.30;358.72;12.42;1379;42;4106.00;278
10329;36;22267947;10329;499;11706;11984;4.90;0.30;358.74;12.42;1377;42;4107.00;278
10331;36;22267965;10331;505;11710;11984;4.91;0.30;358.77;12.42;1379;42;4108.00;274
10332;36;22267983;10332;507;11711;11984;4.91;0.30;358.82;12.42;1379;42;4109.00;273
10336;36;22268003;10336;511;11714;11984;4.91;0.30;358.76;12.42;1378;42;4110.00;270
10339;36;22268021;10339;518;11717;11984;4.92;0.30;358.89;12.42;1378;42;4111.00;267
10341;36;22268039;10341;525;11719;11985;4.92;0.30;359.11;12.42;1378;42;4112.00;266
10342;36;22268056;10342;534;11722;11986;4.88;0.30;359.13;12.41;1380;42;4113.00;264
10343;36;22268074;10343;542;11724;11986;4.90;0.30;359.24;12.41;1381;42;4114.00;262
10348;36;22268091;10348;541;11727;11990;4.85;0.30;359.38;12.41;1379;42;4115.00;263
10351;36;22268109;10351;543;11728;11990;4.85;0.30;359.36;12.41;1377;42;4116.00;262
10356;36;22268128;10356;541;11729;11990;4.80;0.29;359.37;12.41;1373;42;4117.00;261
10359;36;22268145;10359;545;11729;11990;4.77;0.29;359.41;12.41;1370;42;4118.00;261
10361;36;22268162;10361;546;11734;11996;4.79;0.29;359.39;12.40;1373;42;4119.00;262
10362;36;22268181;10362;540;11734;11996;4.80;0.29;359.50;12.40;1372;42;4120.00;262
10367;36;22268200;10367;533;11734;11996;4.78;0.29;359.77;12.40;1367;42;4121.00;262
10370;36;22268217;10370;537;11738;11999;4.80;0.29;359.74;12.45;1368;42;4122.00;261
10374;36;22268235;10374;540;11738;11999;4.78;0.29;359.77;12.45;1364;42;4123.00;261
10381;36;22268262;10381;529;11738;11999;4.77;0.29;359.82;12.45;1357;42;4124.00;261
10384;36;22268280;10384;525;11738;12000;4.78;0.29;359.85;12.45;1354;42;4125.00;262
10387;36;22268297;10387;529;11739;12001;4.78;0.29;359.86;12.44;1352;42;4126.00;262
10387;36;22268315;10387;525;11739;12001;4.80;0.29;359.86;12.44;1352;42;4127.00;262
10391;36;22268331;10391;532;11749;12014;4.75;0.29;359.92;12.43;1358;42;4128.00;265
10394;36;22268350;10394;531;11750;12014;4.68;0.29;359.94;12.50;1356;42;4129.00;264
10396;36;22268371;10396;522;11751;12014;4.61;0.28;359.93;12.57;1355;42;4130.00;263
10403;36;22268388;10403;525;11752;12015;4.55;0.28;359.92;12.57;1349;42;4131.00;263
10404;36;22268406;10404;519;11752;12015;4.49;0.27;359.91;12.57;1348;42;4132.00;263
10407;36;22268423;10407;514;11757;12019;4.48;0.27;359.90;12.57;1350;42;4133.00;262
10409;36;22268442;10409;515;11757;12019;4.43;0.27;359.90;12.57;1348;42;4134.00;262
10410;36;22268459;10410;520;11760;12023;4.41;0.27;359.87;12.56;1350;42;4135.00;263
10411;36;22268478;10411;514;11760;12023;4.41;0.27;359.84;12.56;1349;42;4136.00;263
10414;36;22268494;10414;520;11760;12023;4.37;0.27;359.87;12.56;1346;42;4137.00;263
10415;36;22268512;10415;526;11761;12023;4.35;0.26;359.90;12.61;1346;42;4138.00;262
10420;36;22268529;10420;530;11761;12023;4.31;0.26;359.80;12.61;1341;42;4139.00;262
10422;36;22268548;10422;533;11781;12057;4.38;0.27;359.76;12.59;1359;42;4140.00;276
10423;36;22268569;10423;540;11783;12057;4.36;0.27;359.74;12.58;1360;42;4141.00;274
10426;36;22268586;10426;534;11785;12057;4.39;0.27;359.69;12.58;1359;42;4142.00;272
10427;36;22268603;10427;547;11786;12057;4.44;0.27;359.70;12.58;1359;42;4143.00;271
10429;36;22268620;10429;540;11786;12057;4.48;0.27;359.68;12.58;1357;42;4144.00;271
10431;36;22268637;10431;545;11786;12057;4.48;0.27;359.64;12.58;1355;42;4145.00;271
10433;36;22268654;10433;546;11786;12058;4.50;0.28;359.66;12.58;1353;42;4146.00;272
10436;36;22268671;10436;555;11786;12058;4.49;0.27;359.62;12.58;1350;42;4147.00;272
10439;36;22268689;10439;556;11791;12064;4.48;0.27;359.57;12.58;1352;42;4148.00;273
10441;36;22268707;10441;556;11792;12065;4.47;0.27;359.57;12.58;1351;42;4149.00;273
10444;36;22268724;10444;544;11792;12065;4.42;0.27;359.58;12.58;1348;42;4150.00;273
10446;36;22268743;10446;540;11793;12065;4.38;0.27;359.57;12.58;1347;42;4151.00;272
10446;36;22268761;10446;547;11797;12069;4.38;0.27;359.57;12.57;1351;42;4152.00;272
10449;36;22268779;10449;547;11797;12069;4.32;0.26;359.52;12.57;1348;42;4153.00;272
10453;37;22268797;10453;544;11799;12069;4.28;0.26;359.53;12.57;1346;43;4154.00;270
10454;37;22268831;10454;540;11800;12070;4.33;0.26;359.50;12.57;1346;43;4155.00;270
10457;37;22268857;10457;543;11805;12074;4.34;0.26;359.50;12.71;1348;43;4156.00;269
10458;37;22268877;10458;541;11805;12074;4.36;0.27;359.51;12.71;1347;43;4157.00;269
10459;37;22268902;10459;538;11808;12077;4.42;0.27;359.53;12.78;1349;43;4158.00;269
10460;37;22268920;10460;539;11810;12077;4.43;0.27;359.52;12.85;1350;43;4159.00;267
10462;37;22268938;10462;540;11810;12077;4.43;0.27;359.53;12.85;1348;43;4160.00;267
10462;37;22268955;10462;542;11811;12077;4.45;0.27;359.53;12.92;1349;43;4161.00;266
10462;37;22268973;10462;542;11815;12081;4.55;0.28;359.53;12.91;1353;43;4162.00;266
10463;37;22268989;10463;540;11816;12081;4.55;0.28;359.54;12.98;1353;43;4163.00;265
10465;37;22269016;10465;538;11816;12081;4.56;0.28;359.57;12.98;1351;43;4164.00;265
10465;37;22269033;10465;536;11817;12081;4.60;0.28;359.57;13.05;1352;43;4165.00;264
10466;37;22269050;10466;530;11817;12082;4.58;0.28;359.59;13.05;1351;43;4166.00;265
10467;38;22269067;10467;532;11818;12083;4.59;0.28;359.59;13.05;1351;44;4167.00;265
10468;38;22269104;10468;534;11819;12083;4.58;0.28;359.57;13.12;1351;44;4168.00;264
10471;38;22269124;10471;537;11821;12084;4.60;0.28;359.57;13.19;1350;44;4169.00;263
10473;38;22269145;10473;537;11823;12084;4.58;0.28;359.54;13.33;1350;44;4170.00;261
10478;38;22269166;10478;541;11823;12084;4.52;0.28;359.48;13.33;1345;44;4171.00;261
10482;38;22269191;10482;541;11823;12084;4.52;0.28;359.46;13.33;1341;44;4172.00;261
10486;38;22269220;10486;545;11826;12086;4.51;0.27;359.51;13.39;1340;44;4173.00;260
10488;38;22269255;10488;540;11826;12086;4.49;0.27;359.58;13.39;1338;44;4174.00;260
10490;38;22269276;10490;541;11827;12086;4.48;0.27;359.65;13.46;1337;44;4175.00;259
10493;38;22269301;10493;555;11892;12213;4.74;0.29;359.59;13.39;1399;44;4176.00;321
10496;38;22269341;10496;545;11898;12214;4.75;0.29;359.61;13.45;1402;44;4177.00;316
10498;38;22269358;10498;537;11908;12214;4.75;0.29;359.60;13.51;1410;44;4178.00;306
10498;38;22269377;10498;536;11912;12214;4.79;0.30;359.60;13.51;1414;44;4179.00;302
10500;38;22269396;10500;538;11917;12214;4.84;0.30;359.57;13.50;1417;44;4180.00;297
10502;38;22269413;10502;536;11920;12214;4.84;0.30;359.65;13.50;1418;44;4181.00;294
10505;38;22269432;10505;536;11923;12214;4.84;0.30;359.92;13.50;1418;44;4182.00;291
10506;38;22269456;10506;533;11926;12214;4.84;0.30;360.03;13.50;1420;44;4183.00;288
10510;38;22269476;10510;535;11929;12215;4.89;0.30;360.07;13.49;1419;44;4184.00;286
10512;38;22269501;10512;537;11930;12217;4.92;0.30;360.16;13.49;1418;44;4185.00;287
10516;38;22269519;10516;543;11933;12217;4.93;0.30;360.32;13.49;1417;44;4186.00;284
10520;38;22269538;10520;547;11935;12218;4.91;0.30;360.43;13.49;1415;44;4187.00;283
10524;38;22269562;10524;544;11936;12218;4.86;0.30;360.45;13.49;1412;44;4188.00;282
10527;38;22269586;10527;548;11939;12218;4.81;0.29;360.49;13.49;1412;44;4189.00;279
10529;38;22269605;10529;549;11940;12218;4.77;0.29;360.47;13.49;1411;44;4190.00;278
10533;38;22269622;10533;547;11943;12222;4.70;0.29;360.54;13.49;1410;44;4191.00;279
10536;38;22269642;10536;553;11945;12222;4.62;0.28;360.47;13.49;1409;44;4192.00;277
10541;38;22269659;10541;560;11945;12222;4.55;0.28;360.49;13.49;1404;44;4193.00;277
10544;38;22269678;10544;565;11949;12225;4.50;0.28;360.60;13.49;1405;44;4194.00;276
10546;38;22269698;10546;557;11951;12225;4.44;0.27;360.60;13.49;1405;44;4195.00;274
10549;38;22269719;10549;570;11952;12225;4.40;0.27;360.62;13.49;1403;44;4196.00;273
10551;38;22269738;10551;568;11956;12229;4.36;0.27;360.75;13.49;1405;44;4197.00;273
10553;38;22269756;10553;575;11959;12230;4.35;0.27;360.72;13.49;1406;44;4198.00;271
10556;38;22269774;10556;581;11959;12230;4.28;0.26;360.76;13.49;1403;44;4199.00;271
10557;38;22269796;10557;574;11970;12264;4.28;0.26;360.76;13.47;1413;44;4200.00;294
10559;38;22269822;10559;564;11973;12264;4.26;0.26;360.80;13.47;1414;44;4201.00;291
10564;38;22269841;10564;560;11974;12264;4.27;0.26;360.79;13.47;1410;44;4202.00;290
10566;38;22269858;10566;556;11974;12265;4.28;0.26;360.87;13.47;1408;44;4203.00;291
10570;38;22269877;10570;551;11974;12265;4.33;0.27;360.93;13.47;1404;44;4204.00;291
10574;38;22269896;10574;542;11978;12271;4.39;0.27;361.02;13.47;1404;44;4205.00;293
10575;38;22269914;10575;540;11981;12271;4.48;0.27;360.99;13.46;1406;44;4206.00;290
10578;38;22269935;10578;526;11982;12272;4.54;0.28;361.04;13.46;1404;44;4207.00;290
10582;38;22269951;10582;524;11982;12272;4.59;0.28;361.12;13.46;1400;44;4208.00;290
10588;38;22269971;10588;512;11982;12272;4.60;0.28;361.22;13.46;1394;44;4209.00;290
10591;38;22269989;10591;504;11982;12272;4.61;0.28;361.33;13.46;1391;44;4210.00;290
10593;38;22270010;10593;499;11984;12272;4.63;0.28;361.35;13.46;1391;44;4211.00;288
10597;38;22270029;10597;493;11993;12284;4.67;0.29;361.51;13.45;1396;44;4212.00;291
10598;38;22270047;10598;486;11995;12284;4.70;0.29;361.50;13.45;1397;44;4213.00;289
10604;38;22270066;10604;476;11995;12284;4.72;0.29;361.69;13.45;1391;44;4214.00;289
10608;38;22270084;10608;481;11995;12284;4.77;0.29;361.80;13.45;1387;44;4215.00;289
10614;38;22270103;10614;472;11995;12284;4.76;0.29;361.94;13.45;1381;44;4216.00;289
10617;38;22270121;10617;476;11996;12284;4.77;0.29;362.04;13.45;1379;44;4217.00;288
10622;38;22270139;10622;478;12000;12288;4.79;0.29;361.98;13.45;1378;44;4218.00;288
10627;38;22270157;10627;477;12001;12288;4.81;0.29;362.03;13.45;1374;44;4219.00;287
10630;38;22270176;10630;474;12004;12292;4.85;0.29;362.05;13.45;1374;44;4220.00;288
10632;38;22270196;10632;479;12004;12293;4.87;0.30;362.03;13.45;1372;44;4221.00;289
10636;38;22270213;10636;476;12004;12293;4.86;0.30;362.04;13.45;1368;44;4222.00;289
10640;38;22270231;10640;480;12007;12293;4.85;0.30;362.08;13.45;1367;44;4223.00;286
10647;38;22270250;10647;478;12014;12306;4.85;0.29;362.23;13.44;1367;44;4224.00;292
10650;38;22270270;10650;474;12014;12306;4.83;0.29;362.24;13.44;1364;44;4225.00;292
10656;38;22270288;10656;473;12016;12306;4.80;0.29;362.31;13.44;1360;44;4226.00;290
10660;38;22270306;10660;470;12018;12307;4.81;0.29;362.27;13.44;1358;44;4227.00;289
10662;38;22270324;10662;477;12018;12308;4.83;0.29;362.30;13.44;1356;44;4228.00;290
10665;38;22270344;10665;478;12020;12308;4.82;0.29;362.44;13.44;1355;44;4229.00;288
10667;38;22270363;10667;483;12025;12314;4.87;0.30;362.51;13.44;1358;44;4230.00;289
10674;38;22270381;10674;478;12027;12314;4.87;0.30;362.66;13.44;1353;44;4231.00;287
10675;38;22270401;10675;480;12028;12314;4.89;0.30;362.66;13.43;1353;44;4232.00;286
10678;38;22270419;10678;482;12028;12314;4.87;0.30;362.72;13.43;1350;44;4233.00;286
10681;38;22270438;10681;491;12033;12320;4.85;0.30;362.72;13.43;1352;44;4234.00;287
10683;38;22270456;10683;495;12034;12320;4.85;0.30;362.77;13.43;1351;44;4235.00;286
10688;38;22270474;10688;495;12034;12320;4.79;0.29;362.92;13.43;1346;44;4236.00;286
10695;38;22270491;10695;495;12034;12320;4.74;0.29;362.91;13.43;1339;44;4237.00;286
10699;38;22270509;10699;494;12037;12324;4.73;0.29;363.05;13.43;1338;44;4238.00;287
10704;38;22270528;10704;495;12039;12325;4.72;0.29;363.23;13.43;1335;44;4239.00;286
10708;38;22270548;10708;498;12039;12325;4.68;0.29;363.31;13.43;1331;44;4240.00;286
10715;38;22270580;10715;495;12040;12326;4.63;0.28;363.37;13.43;1325;44;4241.00;286
10722;38;22270601;10722;500;12040;12326;4.56;0.28;363.44;13.43;1318;44;4242.00;286
10726;38;22270621;10726;500;12040;12326;4.49;0.27;363.46;13.43;1314;44;4243.00;286
10731;38;22270640;10731;491;12040;12326;4.38;0.27;363.60;13.43;1309;44;4244.00;286
10734;38;22270657;10734;504;12041;12326;4.29;0.26;363.61;13.43;1307;44;4245.00;285
10738;38;22270674;10738;510;12041;12326;4.18;0.26;363.67;13.43;1303;44;4246.00;285
10741;38;22270691;10741;502;12041;12326;4.14;0.25;363.69;13.43;1300;44;4247.00;285
10745;38;22270708;10745;509;12080;12396;4.18;0.26;363.78;13.39;1335;44;4248.00;316
10748;38;22270732;10748;505;12081;12397;4.19;0.26;363.93;13.39;1333;44;4249.00;316
10754;38;22270750;10754;504;12086;12397;4.24;0.26;363.98;13.38;1332;44;4250.00;311
10756;38;22270767;10756;507;12088;12397;4.33;0.27;364.12;13.39;1332;44;4251.00;309
10759;38;22270784;10759;516;12091;12397;4.43;0.27;364.23;13.38;1332;44;4252.00;306
10761;38;22270802;10761;514;12095;12397;4.50;0.28;364.23;13.44;1334;44;4253.00;302
10764;38;22270820;10764;520;12097;12397;4.57;0.28;364.24;13.44;1333;44;4254.00;300
10769;38;22270838;10769;527;12099;12397;4.57;0.28;364.24;13.44;1330;44;4255.00;298
10770;38;22270855;10770;522;12101;12398;4.59;0.28;364.21;13.43;1331;44;4256.00;297
10775;38;22270873;10775;515;12105;12399;4.56;0.28;364.30;13.43;1330;44;4257.00;294
10776;38;22270891;10776;515;12107;12399;4.56;0.28;364.32;13.43;1331;44;4258.00;292
10778;38;22270910;10778;518;12113;12403;4.54;0.28;364.33;13.43;1335;44;4259.00;290
10782;38;22270931;10782;521;12114;12403;4.54;0.28;364.34;13.43;1332;44;4260.00;289
10786;38;22270950;10786;519;12114;12403;4.52;0.28;364.36;13.43;1328;44;4261.00;289
10790;38;22270970;10790;521;12114;12403;4.54;0.28;364.39;13.43;1324;44;4262.00;289
10794;38;22270989;10794;526;12119;12409;4.54;0.28;364.53;13.42;1325;44;4263.00;290
10794;38;22271009;10794;524;12119;12409;4.61;0.28;364.53;13.42;1325;44;4264.00;290
10796;38;22271027;10796;524;12119;12409;4.64;0.28;364.55;13.42;1323;44;4265.00;290
10798;38;22271046;10798;526;12121;12412;4.70;0.29;364.67;13.42;1323;44;4266.00;291
10799;38;22271065;10799;525;12121;12412;4.74;0.29;364.66;13.42;1322;44;4267.00;291
10801;38;22271084;10801;522;12122;12412;4.77;0.29;364.67;13.42;1321;44;4268.00;290
10805;38;22271103;10805;514;12122;12413;4.76;0.29;364.69;13.42;1317;44;4269.00;291
10807;38;22271121;10807;509;12123;12414;4.80;0.29;364.82;13.42;1316;44;4270.00;291
10812;38;22271140;10812;507;12123;12414;4.78;0.29;364.88;13.42;1311;44;4271.00;291
10815;38;22271159;10815;504;12131;12427;4.86;0.30;365.04;13.41;1316;44;4272.00;296
10818;38;22271180;10818;496;12132;12427;4.84;0.29;365.11;13.41;1314;44;4273.00;295
10820;38;22271200;10820;499;12132;12427;4.81;0.29;365.08;13.41;1312;44;4274.00;295
10821;38;22271218;10821;494;12134;12429;4.81;0.29;365.16;13.41;1313;44;4275.00;295
10823;38;22271236;10823;501;12134;12429;4.72;0.29;365.19;13.41;1311;44;4276.00;295
10825;38;22271253;10825;496;12138;12433;4.72;0.29;365.18;13.40;1313;44;4277.00;295
10828;38;22271272;10828;506;12138;12433;4.73;0.29;365.17;13.40;1310;44;4278.00;295
10831;38;22271289;10831;501;12141;12437;4.71;0.29;365.21;13.40;1310;44;4279.00;296
10831;38;22271306;10831;499;12141;12437;4.69;0.28;365.21;13.40;1310;44;4280.00;296
10831;38;22271323;10831;496;12141;12437;4.70;0.29;365.21;13.40;1310;44;4281.00;296
10834;38;22271339;10834;502;12141;12437;4.68;0.28;365.21;13.40;1307;44;4282.00;296
10836;38;22271356;10836;506;12141;12437;4.65;0.28;365.18;13.40;1305;44;4283.00;296
10837;38;22271373;10837;513;12151;12449;4.65;0.28;365.16;13.39;1314;44;4284.00;298
10838;38;22271390;10838;516;12151;12449;4.65;0.28;365.13;13.39;1313;44;4285.00;298
10842;38;22271408;10842;521;12152;12449;4.64;0.28;365.12;13.39;1310;44;4286.00;297
10845;38;22271426;10845;523;12152;12449;4.61;0.28;365.05;13.39;1307;44;4287.00;297
10847;38;22271442;10847;525;12152;12449;4.58;0.28;364.99;13.39;1305;44;4288.00;297
10847;38;22271459;10847;523;12152;12449;4.61;0.28;364.99;13.39;1305;44;4289.00;297
10850;38;22271478;10850;525;12152;12450;4.55;0.28;364.96;13.39;1302;44;4290.00;298
10851;38;22271495;10851;525;12152;12450;4.50;0.27;364.94;13.39;1301;44;4291.00;298
10851;38;22271511;10851;514;12157;12456;4.49;0.27;364.94;13.38;1306;44;4292.00;299
10855;38;22271528;10855;517;12158;12457;4.47;0.27;364.99;13.38;1303;44;4293.00;299
10856;38;22271545;10856;515;12158;12457;4.45;0.27;364.96;13.38;1302;44;4294.00;299
10857;38;22271562;10857;515;12158;12457;4.43;0.27;364.93;13.38;1301;44;4295.00;299
10858;38;22271579;10858;512;12160;12461;4.47;0.27;364.94;13.38;1302;44;4296.00;301
10861;38;22271595;10861;520;12160;12461;4.50;0.27;364.91;13.38;1299;44;4297.00;301
10864;38;22271611;10864;529;12160;12461;4.52;0.27;364.86;13.38;1296;44;4298.00;301
10866;38;22271628;10866;530;12161;12462;4.54;0.27;364.87;13.38;1295;44;4299.00;301
10869;38;22271645;10869;521;12164;12466;4.52;0.27;364.86;13.37;1295;44;4300.00;302
10869;38;22271668;10869;518;12164;12466;4.53;0.27;364.86;13.37;1295;44;4301.00;302
10873;38;22271684;10873;516;12166;12469;4.51;0.27;364.89;13.37;1293;44;4302.00;303
10875;38;22271700;10875;513;12167;12469;4.50;0.27;364.85;13.37;1292;44;4303.00;302
10877;38;22271716;10877;516;12168;12469;4.47;0.27;364.83;13.45;1291;44;4304.00;301
10878;38;22271736;10878;514;12169;12469;4.44;0.27;364.81;13.52;1291;44;4305.00;300
10880;38;22271752;10880;496;12173;12473;4.47;0.27;364.81;13.52;1293;44;4306.00;300
10882;38;22271769;10882;482;12173;12473;4.47;0.27;364.82;13.52;1291;44;4307.00;300
10884;38;22271786;10884;466;12173;12473;4.47;0.27;364.78;13.52;1289;44;4308.00;300
10889;38;22271803;10889;454;12173;12473;4.50;0.27;364.87;13.52;1284;44;4309.00;300
10890;38;22271820;10890;450;12173;12474;4.54;0.27;364.86;13.52;1283;44;4310.00;301
10890;38;22271837;10890;440;12174;12475;4.58;0.28;364.86;13.52;1284;44;4311.00;301
10892;39;22271853;10892;439;12175;12475;4.63;0.28;364.94;13.52;1283;45;4312.00;300
10895;39;22271882;10895;441;12176;12476;4.70;0.28;364.95;13.52;1281;45;4313.00;300
10896;39;22271900;10896;436;12177;12476;4.78;0.29;364.93;13.60;1281;45;4314.00;299
10896;39;22271930;10896;425;12177;12476;4.85;0.29;364.93;13.60;1281;45;4315.00;299
10897;39;22271948;10897;428;12178;12476;4.94;0.30;364.99;13.60;1281;45;4316.00;298
10897;39;22271974;10897;430;12178;12476;4.98;0.30;364.99;13.60;1281;45;4317.00;298
10900;39;22271991;10900;437;12179;12476;5.00;0.30;364.95;13.61;1279;45;4318.00;297
10900;39;22272011;10900;439;12179;12476;5.05;0.31;364.95;13.61;1279;45;4319.00;297
10905;39;22272031;10905;473;12273;12706;5.35;0.33;364.86;13.50;1368;45;4320.00;433
10906;39;22272078;10906;469;12278;12707;5.35;0.33;364.83;13.50;1372;45;4321.00;429
10906;39;22272097;10906;460;12287;12707;5.40;0.34;364.83;13.49;1381;45;4322.00;420
10908;39;22272115;10908;463;12297;12707;5.41;0.34;364.79;13.49;1389;45;4323.00;410
10909;39;22272132;10909;466;12304;12707;5.43;0.34;364.76;13.48;1395;45;4324.00;403
10910;39;22272156;10910;463;12312;12707;5.47;0.34;364.72;13.48;1402;45;4325.00;395
10912;39;22272176;10912;453;12319;12707;5.51;0.34;364.79;13.55;1407;45;4326.00;388
10916;39;22272195;10916;455;12326;12707;5.51;0.34;364.89;13.55;1410;45;4327.00;381
10918;39;22272213;10918;454;12332;12708;5.56;0.35;364.85;13.54;1414;45;4328.00;376
10920;40;22272236;10920;457;12338;12709;5.60;0.35;364.83;13.62;1418;46;4329.00;371
10921;40;22272262;10921;461;12343;12709;5.65;0.35;364.81;13.62;1422;46;4330.00;366
10926;40;22272282;10926;469;12349;12710;5.62;0.35;364.86;13.69;1423;46;4331.00;361
10928;40;22272301;10928;479;12352;12710;5.59;0.35;364.94;13.69;1424;46;4332.00;358
10930;40;22272323;10930;473;12354;12710;5.54;0.34;364.91;13.69;1424;46;4333.00;356
10930;40;22272341;10930;482;12360;12710;5.51;0.34;364.91;13.91;1430;46;4334.00;350
10933;40;22272365;10933;499;12364;12714;5.48;0.34;364.95;13.91;1431;46;4335.00;350
10934;40;22272385;10934;502;12366;12714;5.43;0.33;364.92;13.91;1432;46;4336.00;348
10938;40;22272403;10938;504;12370;12714;5.34;0.33;364.87;13.99;1432;46;4337.00;344
10942;40;22272422;10942;519;12371;12717;5.29;0.32;364.92;13.99;1429;46;4338.00;346
10946;40;22272441;10946;520;12374;12717;5.24;0.32;365.02;13.99;1428;46;4339.00;343
10948;40;22272461;10948;527;12376;12717;5.20;0.32;365.01;14.13;1428;46;4340.00;341
10953;40;22272480;10953;534;12380;12721;5.13;0.31;365.12;14.20;1427;46;4341.00;341
10955;40;22272500;10955;543;12384;12722;5.12;0.31;365.32;14.28;1429;46;4342.00;338
10957;40;22272519;10957;552;12385;12722;5.13;0.31;365.29;14.28;1428;46;4343.00;337
10959;40;22272537;10959;552;12390;12726;5.14;0.31;365.42;14.43;1431;46;4344.00;336
10961;40;22272557;10961;555;12390;12726;5.11;0.31;365.49;14.43;1429;46;4345.00;336
10963;40;22272577;10963;558;12395;12726;5.14;0.31;365.57;14.57;1432;46;4346.00;331
10966;40;22272596;10966;557;12397;12727;5.13;0.31;365.64;14.57;1431;46;4347.00;330
10967;40;22272615;10967;563;12398;12727;5.13;0.31;365.65;14.57;1431;46;4348.00;329
10967;40;22272634;10967;558;12404;12733;5.10;0.31;365.65;14.71;1437;46;4349.00;329
10971;40;22272654;10971;554;12405;12733;5.04;0.31;365.64;14.71;1434;46;4350.00;328
10972;40;22272674;10972;556;12408;12734;5.01;0.31;365.64;14.86;1436;46;4351.00;326
10974;40;22272692;10974;559;12409;12734;5.00;0.31;365.70;14.86;1435;46;4352.00;325
10977;40;22272713;10977;561;12410;12734;4.99;0.31;365.74;14.86;1433;46;4353.00;324
10978;40;22272733;10978;557;12411;12734;4.98;0.30;365.76;14.86;1433;46;4354.00;323
10979;40;22272751;10979;555;12414;12734;4.95;0.30;365.76;15.00;1435;46;4355.00;320
10980;40;22272770;10980;563;12423;12746;4.96;0.30;365.79;15.00;1443;46;4356.00;323
10983;40;22272790;10983;562;12427;12746;4.91;0.30;365.90;15.14;1444;46;4357.00;319
10983;40;22272810;10983;568;12428;12746;4.94;0.30;365.90;15.14;1445;46;4358.00;318
10986;40;22272830;10986;572;12431;12746;4.94;0.30;366.03;15.14;1445;46;4359.00;315
10991;40;22272849;10991;568;12433;12746;4.93;0.30;366.05;15.29;1442;46;4360.00;313
10992;40;22272868;10992;569;12435;12746;4.92;0.30;366.02;15.29;1443;46;4361.00;311
10996;40;22272886;10996;574;12439;12750;4.93;0.30;366.18;15.28;1443;46;4362.00;311
10998;40;22272906;10998;570;12442;12750;4.91;0.30;366.19;15.43;1444;46;4363.00;308
11000;40;22272924;11000;581;12446;12754;4.90;0.30;366.25;15.42;1446;46;4364.00;308
11002;40;22272945;11002;588;12448;12756;4.87;0.30;366.33;15.42;1446;46;4365.00;308
11007;40;22272963;11007;599;12449;12756;4.78;0.29;366.32;15.42;1442;46;4366.00;307
11011;40;22272981;11011;607;12450;12756;4.71;0.29;366.36;15.42;1439;46;4367.00;306
11018;40;22273001;11018;614;12459;12769;4.67;0.29;366.50;15.41;1441;46;4368.00;310
11022;40;22273021;11022;608;12460;12769;4.63;0.28;366.53;15.41;1438;46;4369.00;309
11025;40;22273039;11025;608;12460;12769;4.61;0.28;366.64;15.41;1435;46;4370.00;309
11029;40;22273057;11029;611;12462;12770;4.57;0.28;366.81;15.42;1433;46;4371.00;308
11035;40;22273076;11035;614;12462;12771;4.50;0.28;366.95;15.42;1427;46;4372.00;309
11037;40;22273095;11037;615;12463;12771;4.44;0.27;366.99;15.42;1426;46;4373.00;308
11041;40;22273114;11041;620;12465;12774;4.38;0.27;367.08;15.42;1424;46;4374.00;309
11045;40;22273132;11045;614;12465;12774;4.38;0.27;367.12;15.42;1420;46;4375.00;309
11046;40;22273150;11046;607;12467;12774;4.42;0.27;367.17;15.42;1421;46;4376.00;307
11049;40;22273168;11049;610;12467;12774;4.43;0.27;367.22;15.42;1418;46;4377.00;307
11053;40;22273186;11053;610;12472;12780;4.44;0.27;367.29;15.41;1419;46;4378.00;308
11055;40;22273205;11055;603;12473;12780;4.48;0.28;367.27;15.41;1418;46;4379.00;307
11060;40;22273224;11060;602;12473;12780;4.49;0.28;367.36;15.41;1413;46;4380.00;307
11063;40;22273244;11063;594;12473;12780;4.51;0.28;367.41;15.41;1410;46;4381.00;307
11068;40;22273268;11068;586;12477;12784;4.50;0.28;367.50;15.41;1409;46;4382.00;307
11072;40;22273286;11072;587;12478;12785;4.50;0.28;367.69;15.41;1406;46;4383.00;307
11076;40;22273304;11076;576;12478;12785;4.48;0.27;367.74;15.41;1402;46;4384.00;307
11079;40;22273321;11079;571;12479;12786;4.48;0.27;367.79;15.40;1400;46;4385.00;307
11082;40;22273340;11082;569;12479;12786;4.49;0.27;367.85;15.40;1397;46;4386.00;307
11085;40;22273358;11085;570;12479;12786;4.44;0.27;367.92;15.40;1394;46;4387.00;307
11089;40;22273378;11089;573;12479;12786;4.42;0.27;368.05;15.40;1390;46;4388.00;307
11093;40;22273396;11093;565;12479;12786;4.42;0.27;368.03;15.40;1386;46;4389.00;307
11100;40;22273414;11100;562;12479;12786;4.37;0.27;368.14;15.40;1379;46;4390.00;307
11102;40;22273433;11102;570;12479;12786;4.36;0.27;368.21;15.40;1377;46;4391.00;307
11104;40;22273451;11104;578;12517;12856;4.44;0.27;368.24;15.36;1413;46;4392.00;339
11106;40;22273475;11106;572;12518;12857;4.47;0.27;368.29;15.36;1412;46;4393.00;339
11113;40;22273493;11113;568;12520;12857;4.50;0.28;368.32;15.35;1407;46;4394.00;337
11119;40;22273512;11119;573;12520;12857;4.50;0.27;368.24;15.35;1401;46;4395.00;337
11121;40;22273531;11121;576;12522;12857;4.53;0.28;368.23;15.35;1401;46;4396.00;335
11124;40;22273550;11124;590;12524;12857;4.53;0.28;368.28;15.35;1400;46;4397.00;333
11127;40;22273569;11127;592;12526;12857;4.53;0.28;368.37;15.35;1399;46;4398.00;331
11130;40;22273589;11130;595;12529;12857;4.51;0.28;368.36;15.35;1399;46;4399.00;328
11135;40;22273609;11135;599;12532;12858;4.48;0.27;368.47;15.35;1397;46;4400.00;326
11139;40;22273634;11139;600;12534;12859;4.42;0.27;368.47;15.34;1395;46;4401.00;325
11144;40;22273652;11144;611;12538;12859;4.33;0.26;368.47;15.34;1394;46;4402.00;321
11149;40;22273675;11149;614;12540;12863;4.25;0.26;368.58;15.34;1391;46;4403.00;323
11149;40;22273695;11149;625;12541;12863;4.22;0.26;368.58;15.34;1392;46;4404.00;322
11155;40;22273711;11155;620;12542;12863;4.17;0.25;368.65;15.34;1387;46;4405.00;321
11161;40;22273730;11161;619;12544;12863;4.12;0.25;368.73;15.34;1383;46;4406.00;319
11163;40;22273749;11163;629;12549;12869;4.15;0.25;368.70;15.33;1386;46;4407.00;320
11165;40;22273769;11165;627;12550;12869;4.17;0.25;368.67;15.33;1385;46;4408.00;319
11167;40;22273786;11167;618;12551;12869;4.19;0.26;368.67;15.33;1384;46;4409.00;318
11173;40;22273806;11173;620;12554;12875;4.19;0.25;368.78;15.33;1381;46;4410.00;321
11173;40;22273825;11173;619;12556;12875;4.20;0.26;368.78;15.33;1383;46;4411.00;319
11174;40;22273844;11174;622;12557;12875;4.20;0.26;368.83;15.33;1383;46;4412.00;318
11180;40;22273862;11180;625;12557;12876;4.15;0.25;369.00;15.33;1377;46;4413.00;319
11182;40;22273880;11182;631;12558;12877;4.09;0.25;369.00;15.32;1376;46;4414.00;319
11186;40;22273897;11186;637;12559;12877;4.03;0.25;368.98;15.33;1373;46;4415.00;318
11188;40;22273913;11188;646;12571;12890;4.08;0.25;368.99;15.31;1383;46;4416.00;319
11192;40;22273932;11192;641;12572;12890;3.98;0.24;368.98;15.31;1380;46;4417.00;318
11194;40;22273950;11194;631;12573;12890;3.94;0.24;369.01;15.31;1379;46;4418.00;317
11195;40;22273968;11195;638;12574;12891;3.87;0.24;368.99;15.31;1379;46;4419.00;317
11197;40;22273985;11197;648;12574;12891;3.83;0.23;369.12;15.31;1377;46;4420.00;317
11198;40;22274002;11198;652;12578;12895;3.85;0.23;369.16;15.31;1380;46;4421.00;317
11201;40;22274020;11201;638;12579;12895;3.82;0.23;369.27;15.37;1378;46;4422.00;316
11202;40;22274039;11202;634;12582;12899;3.85;0.23;369.27;15.37;1380;46;4423.00;317
11204;40;22274056;11204;633;12582;12899;3.82;0.23;369.34;15.37;1378;46;4424.00;317
11206;40;22274074;11206;632;12582;12899;3.80;0.23;369.31;15.37;1376;46;4425.00;317
11209;40;22274091;11209;627;12582;12899;3.80;0.23;369.36;15.37;1373;46;4426.00;317
11210;40;22274109;11210;621;12582;12899;3.79;0.23;369.36;15.37;1372;46;4427.00;317
11213;40;22274127;11213;622;12592;12911;3.83;0.23;369.48;15.36;1379;46;4428.00;319
11215;40;22274145;11215;631;12592;12911;3.80;0.23;369.48;15.36;1377;46;4429.00;319
11216;40;22274162;11216;635;12593;12911;3.80;0.23;369.49;15.36;1377;46;4430.00;318
11216;40;22274180;11216;624;12593;12911;3.82;0.23;369.49;15.36;1377;46;4431.00;318
11216;40;22274198;11216;612;12593;12911;3.87;0.24;369.49;15.36;1377;46;4432.00;318
11216;40;22274215;11216;605;12593;12911;3.93;0.24;369.49;15.36;1377;46;4433.00;318
11218;40;22274233;11218;596;12593;12912;3.97;0.24;369.44;15.36;1375;46;4434.00;319
11222;40;22274250;11222;592;12593;12912;3.97;0.24;369.44;15.36;1371;46;4435.00;319
11224;40;22274268;11224;596;12598;12918;4.05;0.25;369.41;15.35;1374;46;4436.00;320
11227;40;22274297;11227;589;12599;12919;4.09;0.25;369.49;15.35;1372;46;4437.00;320
11230;40;22274316;11230;596;12599;12919;4.10;0.25;369.48;15.35;1369;46;4438.00;320
11232;40;22274336;11232;595;12599;12919;4.12;0.25;369.45;15.35;1367;46;4439.00;320
11234;40;22274354;11234;592;12603;12924;4.11;0.25;369.51;15.34;1369;46;4440.00;321
11237;40;22274381;11237;603;12603;12924;4.08;0.25;369.56;15.34;1366;46;4441.00;321
11239;40;22274399;11239;606;12603;12924;4.11;0.25;369.56;15.34;1364;46;4442.00;321
11240;40;22274416;11240;601;12604;12925;4.20;0.25;369.54;15.34;1364;46;4443.00;321
11241;40;22274434;11241;606;12607;12929;4.24;0.26;369.53;15.34;1366;46;4444.00;322
11242;40;22274451;11242;603;12607;12929;4.24;0.26;369.51;15.34;1365;46;4445.00;322
11245;40;22274469;11245;606;12609;12932;4.22;0.26;369.53;15.34;1364;46;4446.00;323
11247;40;22274486;11247;608;12609;12932;4.17;0.25;369.60;15.34;1362;46;4447.00;323
11247;40;22274504;11247;609;12610;12932;4.18;0.25;369.60;15.34;1363;46;4448.00;322
11248;40;22274520;11248;607;12610;12932;4.17;0.25;369.57;15.34;1362;46;4449.00;322
11250;40;22274537;11250;610;12613;12936;4.18;0.25;369.55;15.33;1363;46;4450.00;323
11253;40;22274555;11253;610;12613;12936;4.16;0.25;369.50;15.33;1360;46;4451.00;323
11256;40;22274575;11256;615;12613;12936;4.17;0.25;369.42;15.33;1357;46;4452.00;323
11256;40;22274593;11256;613;12613;12936;4.19;0.25;369.42;15.33;1357;46;4453.00;323
11259;40;22274609;11259;606;12613;12937;4.20;0.25;369.35;15.33;1354;46;4454.00;324
11259;40;22274628;11259;598;12615;12939;4.21;0.26;369.35;15.33;1356;46;4455.00;324
11260;40;22274645;11260;600;12615;12939;4.20;0.25;369.34;15.33;1355;46;4456.00;324
11262;40;22274663;11262;604;12616;12940;4.22;0.26;369.31;15.33;1354;46;4457.00;324
11264;40;22274680;11264;599;12617;12940;4.21;0.26;369.26;15.40;1353;46;4458.00;323
11266;40;22274701;11266;607;12617;12940;4.24;0.26;369.23;15.40;1351;46;4459.00;323
11267;40;22274723;11267;614;12617;12940;4.24;0.26;369.27;15.40;1350;46;4460.00;323
11268;40;22274741;11268;610;12617;12940;4.27;0.26;369.27;15.40;1349;46;4461.00;323
11271;40;22274759;11271;600;12617;12940;4.27;0.26;369.25;15.40;1346;46;4462.00;323
11271;40;22274777;11271;586;12617;12940;4.29;0.26;369.25;15.40;1346;46;4463.00;323
11273;40;22274794;11273;593;12677;13067;4.54;0.28;369.21;15.32;1404;46;4464.00;390
11275;40;22274822;11275;570;12677;13068;4.56;0.28;369.18;15.32;1402;46;4465.00;391
11276;40;22274841;11276;546;12684;13068;4.66;0.29;369.16;15.32;1408;46;4466.00;384
11277;40;22274859;11277;539;12687;13068;4.75;0.29;369.15;15.31;1410;46;4467.00;381
11278;40;22274878;11278;535;12693;13068;4.85;0.30;369.15;15.31;1415;46;4468.00;375
11279;40;22274898;11279;522;12696;13068;4.88;0.30;369.15;15.30;1417;46;4469.00;372
11280;40;22274933;11280;520;12699;13068;4.95;0.30;369.12;15.30;1419;46;4470.00;369
11282;40;22274951;11282;518;12701;13068;5.05;0.31;369.19;15.30;1419;46;4471.00;367
11283;40;22274971;11283;509;12703;13069;5.12;0.31;369.20;15.30;1420;46;4472.00;366
11285;40;22274990;11285;501;12707;13070;5.13;0.31;369.22;15.30;1422;46;4473.00;363
11286;40;22275010;11286;504;12708;13070;5.17;0.32;369.20;15.30;1422;46;4474.00;362
11288;40;22275030;11288;504;12710;13071;5.18;0.32;369.20;15.30;1422;46;4475.00;361
11290;40;22275049;11290;501;12714;13071;5.15;0.31;369.19;15.30;1424;46;4476.00;357
11291;40;22275069;11291;499;12716;13071;5.13;0.31;369.19;15.30;1425;46;4477.00;355
11293;40;22275087;11293;496;12717;13071;5.09;0.31;369.18;15.30;1424;46;4478.00;354
11296;40;22275105;11296;486;12721;13075;5.05;0.31;369.17;15.29;1425;46;4479.00;354
11298;40;22275133;11298;485;12723;13075;4.98;0.31;369.14;15.45;1425;46;4480.00;352
11301;40;22275155;11301;475;12725;13075;4.94;0.30;369.27;15.45;1424;46;4481.00;350
11304;40;22275175;11304;476;12727;13078;4.99;0.30;369.21;15.45;1423;46;4482.00;351
11304;40;22275195;11304;476;12729;13078;5.01;0.31;369.21;15.45;1425;46;4483.00;349
11307;40;22275214;11307;471;12730;13078;5.05;0.31;369.20;15.45;1423;46;4484.00;348
11309;40;22275234;11309;470;12734;13082;5.09;0.31;369.23;15.44;1425;46;4485.00;348
11312;40;22275254;11312;471;12736;13083;5.12;0.31;369.43;15.44;1424;46;4486.00;347
11312;40;22275275;11312;464;12737;13083;5.18;0.32;369.43;15.44;1425;46;4487.00;346
11316;40;22275300;11316;468;12739;13087;5.24;0.32;369.36;15.44;1423;46;4488.00;348
11318;40;22275320;11318;461;12739;13087;5.30;0.32;369.39;15.44;1421;46;4489.00;348
11321;40;22275340;11321;463;12739;13087;5.31;0.32;369.38;15.44;1418;46;4490.00;348
11326;40;22275360;11326;464;12741;13088;5.33;0.32;369.41;15.44;1415;46;4491.00;347
11328;40;22275381;11328;462;12741;13088;5.31;0.32;369.37;15.44;1413;46;4492.00;347
11333;40;22275401;11333;452;12745;13094;5.34;0.32;369.42;15.43;1412;46;4493.00;349
11337;40;22275420;11337;451;12745;13094;5.30;0.32;369.42;15.43;1408;46;4494.00;349
11339;40;22275439;11339;456;12745;13095;5.27;0.32;369.47;15.43;1406;46;4495.00;350
11341;40;22275458;11341;453;12745;13095;5.25;0.32;369.47;15.43;1404;46;4496.00;350
11342;40;22275478;11342;454;12746;13095;5.27;0.32;369.44;15.43;1404;46;4497.00;349
11344;40;22275497;11344;457;12748;13095;5.25;0.32;369.41;15.44;1404;46;4498.00;347
11345;40;22275515;11345;449;12748;13095;5.26;0.32;369.39;15.44;1403;46;4499.00;347
11348;40;22275536;11348;454;12769;13145;5.31;0.32;369.41;15.42;1421;46;4500.00;376
11349;40;22275566;11349;449;12772;13147;5.25;0.32;369.40;15.42;1423;46;4501.00;375
11352;40;22275585;11352;464;12776;13147;5.26;0.32;369.43;15.41;1424;46;4502.00;371
11358;40;22275605;11358;466;12779;13147;5.19;0.32;369.45;15.42;1421;46;4503.00;368
11361;40;22275623;11361;469;12780;13147;5.15;0.31;369.51;15.42;1419;46;4504.00;367
11363;40;22275644;11363;466;12781;13147;5.15;0.31;369.52;15.42;1418;46;4505.00;366
11365;40;22275664;11365;472;12788;13151;5.13;0.31;369.53;15.57;1423;46;4506.00;363
11368;40;22275683;11368;477;12790;13151;5.12;0.31;369.68;15.65;1422;46;4507.00;361
11369;40;22275702;11369;485;12793;13155;5.13;0.31;369.71;15.65;1424;46;4508.00;362
11370;40;22275721;11370;492;12796;13156;5.11;0.31;369.74;15.72;1426;46;4509.00;360
11372;40;22275740;11372;497;12799;13156;5.08;0.31;369.84;15.80;1427;46;4510.00;357
11374;40;22275761;11374;512;12800;13156;5.05;0.31;369.91;15.88;1426;46;4511.00;356
11378;40;22275780;11378;513;12814;13169;5.03;0.31;369.95;15.94;1436;46;4512.00;355
11379;40;22275801;11379;516;12815;13169;5.01;0.30;369.93;15.94;1436;46;4513.00;354
11382;40;22275820;11382;524;12818;13169;4.98;0.30;369.98;16.10;1436;46;4514.00;351
11382;40;22275848;11382;524;12819;13170;5.04;0.31;369.98;16.10;1437;46;4515.00;351
11385;40;22275867;11385;526;12822;13171;5.01;0.30;370.09;16.25;1437;46;4516.00;349
11386;40;22275886;11386;532;12823;13171;5.01;0.30;370.07;16.25;1437;46;4517.00;348
11389;40;22275908;11389;537;12828;13174;5.01;0.30;370.15;16.32;1439;46;4518.00;346
11389;40;22275936;11389;534;12829;13174;5.01;0.30;370.15;16.32;1440;46;4519.00;345
11392;40;22275956;11392;539;12832;13174;4.98;0.30;370.26;16.47;1440;46;4520.00;342
11393;40;22275977;11393;538;12834;13174;4.99;0.30;370.29;16.55;1441;46;4521.00;340
11394;40;22275996;11394;547;12837;13180;4.99;0.30;370.30;16.54;1443;46;4522.00;343
11397;40;22276016;11397;548;12839;13180;4.93;0.30;370.41;16.62;1442;46;4523.00;341
11397;40;22276036;11397;550;12845;13180;4.90;0.30;370.41;16.84;1448;46;4524.00;335
11398;40;22276054;11398;542;12846;13180;4.87;0.30;370.42;16.91;1448;46;4525.00;334
11401;40;22276073;11401;541;12849;13184;4.83;0.29;370.44;16.91;1448;46;4526.00;335
11403;40;22276092;11403;537;12852;13185;4.86;0.30;370.47;17.05;1449;46;4527.00;333
11407;40;22276112;11407;531;12852;13185;4.86;0.30;370.47;17.05;1445;46;4528.00;333
11407;40;22276132;11407;526;12854;13186;4.89;0.30;370.47;17.05;1447;46;4529.00;332
11411;40;22276152;11411;519;12857;13186;4.89;0.30;370.52;17.20;1446;46;4530.00;329
11414;40;22276172;11414;509;12857;13186;4.88;0.30;370.71;17.20;1443;46;4531.00;329
11418;40;22276190;11418;507;12857;13186;4.86;0.30;370.78;17.20;1439;46;4532.00;329
11418;40;22276209;11418;510;12859;13186;4.88;0.30;370.78;17.34;1441;46;4533.00;327
11423;40;22276234;11423;508;12859;13186;4.88;0.30;370.83;17.34;1436;46;4534.00;327
11425;40;22276253;11425;522;12860;13186;4.89;0.30;370.91;17.34;1435;46;4535.00;326
11427;40;22276272;11427;527;12902;13256;4.96;0.30;370.98;17.43;1475;46;4536.00;354
11430;40;22276298;11430;523;12904;13257;4.95;0.30;370.99;17.50;1474;46;4537.00;353
11434;40;22276317;11434;529;12910;13257;4.95;0.30;371.04;17.57;1476;46;4538.00;347
11438;40;22276337;11438;536;12912;13257;4.92;0.30;371.15;17.57;1474;46;4539.00;345
11442;40;22276355;11442;542;12918;13257;4.88;0.30;371.10;17.71;1476;46;4540.00;339
11445;40;22276377;11445;550;12925;13257;4.84;0.30;371.33;17.71;1480;46;4541.00;332
11452;40;22276397;11452;547;12930;13257;4.74;0.29;371.56;17.85;1478;46;4542.00;327
11455;40;22276416;11455;559;12935;13257;4.70;0.29;371.57;17.84;1480;46;4543.00;322
11458;40;22276434;11458;568;12936;13258;4.66;0.28;371.59;17.84;1478;46;4544.00;322
11463;40;22276453;11463;570;12939;13260;4.60;0.28;371.63;17.84;1476;46;4545.00;321
11468;40;22276472;11468;576;12939;13260;4.51;0.27;371.68;17.84;1471;46;4546.00;321
11473;40;22276490;11473;586;12945;13264;4.40;0.27;371.74;18.12;1472;46;4547.00;319
11478;40;22276509;11478;588;12945;13264;4.30;0.26;371.90;18.12;1467;46;4548.00;319
11482;40;22276528;11482;597;12945;13264;4.19;0.26;371.93;18.12;1463;46;4549.00;319
11485;40;22276545;11485;595;12947;13264;4.13;0.25;372.04;18.26;1462;46;4550.00;317
11488;40;22276565;11488;604;12951;13270;4.10;0.25;372.16;18.26;1463;46;4551.00;319
11490;40;22276585;11490;601;12952;13270;4.08;0.25;372.14;18.26;1462;46;4552.00;318
11492;40;22276603;11492;614;12952;13270;4.09;0.25;372.25;18.26;1460;46;4553.00;318
11497;40;22276621;11497;618;12953;13273;4.09;0.25;372.31;18.25;1456;46;4554.00;320
11500;40;22276640;11500;616;12954;13273;4.06;0.25;372.35;18.25;1454;46;4555.00;319
11503;40;22276658;11503;628;12954;13273;4.05;0.25;372.43;18.25;1451;46;4556.00;319
11507;40;22276677;11507;625;12954;13274;4.03;0.25;372.51;18.25;1447;46;4557.00;320
11508;40;22276696;11508;631;12956;13275;4.02;0.25;372.59;18.25;1448;46;4558.00;319
11512;40;22276713;11512;630;12957;13275;3.97;0.24;372.69;18.25;1445;46;4559.00;318
11517;40;22276733;11517;628;12974;13301;4.01;0.25;372.72;18.23;1457;46;4560.00;327
11520;40;22276753;11520;626;12975;13301;3.96;0.24;372.75;18.23;1455;46;4561.00;326
11524;40;22276771;11524;627;12977;13301;3.91;0.24;372.81;18.22;1453;46;4562.00;324
11528;40;22276789;11528;632;12978;13302;3.86;0.24;372.98;18.22;1450;46;4563.00;324
11532;40;22276808;11532;642;12978;13302;3.84;0.23;373.14;18.22;1446;46;4564.00;324
11537;40;22276827;11537;643;12982;13306;3.77;0.23;373.14;18.22;1445;46;4565.00;324
11542;40;22276847;11542;649;12982;13306;3.71;0.23;373.14;18.22;1440;46;4566.00;324
11544;40;22276866;11544;647;12985;13310;3.66;0.22;373.19;18.21;1441;46;4567.00;325
11550;40;22276884;11550;657;12986;13310;3.59;0.22;373.16;18.22;1436;46;4568.00;324
11555;40;22276903;11555;660;12986;13310;3.52;0.21;373.10;18.22;1431;46;4569.00;324
11557;40;22276921;11557;677;12988;13310;3.48;0.21;373.12;18.29;1431;46;4570.00;322
11562;40;22276941;11562;675;12989;13310;3.43;0.21;373.13;18.29;1427;46;4571.00;321
11564;40;22276958;11564;668;13000;13322;3.45;0.21;373.11;18.27;1436;46;4572.00;322
11566;40;22276978;11566;673;13000;13322;3.47;0.21;373.15;18.27;1434;46;4573.00;322
11568;40;22276996;11568;684;13001;13322;3.45;0.21;373.13;18.27;1433;46;4574.00;321
11571;40;22277012;11571;685;13002;13322;3.42;0.21;373.12;18.27;1431;46;4575.00;320
11573;40;22277029;11573;685;13002;13322;3.39;0.21;373.12;18.27;1429;46;4576.00;320
11577;40;22277045;11577;703;13002;13322;3.32;0.20;373.14;18.27;1425;46;4577.00;320
11578;40;22277062;11578;700;13002;13323;3.30;0.20;373.22;18.27;1424;46;4578.00;321
11580;40;22277079;11580;701;13002;13323;3.28;0.20;373.35;18.27;1422;46;4579.00;321
11584;40;22277095;11584;704;13007;13329;3.27;0.20;373.40;18.26;1423;46;4580.00;322
11588;40;22277112;11588;702;13008;13330;3.24;0.20;373.38;18.26;1420;46;4581.00;322
11590;40;22277129;11590;709;13008;13330;3.22;0.20;373.48;18.26;1418;46;4582.00;322
11593;40;22277146;11593;707;13008;13330;3.20;0.20;373.49;18.26;1415;46;4583.00;322
11599;40;22277161;11599;710;13011;13334;3.18;0.20;373.50;18.26;1412;46;4584.00;323
11603;40;22277180;11603;716;13011;13334;3.15;0.19;373.54;18.26;1408;46;4585.00;323
11606;40;22277197;11606;719;13011;13334;3.11;0.19;373.56;18.26;1405;46;4586.00;323
11610;40;22277213;11610;717;13012;13335;3.13;0.19;373.57;18.26;1402;46;4587.00;323
11613;40;22277229;11613;730;13015;13339;3.15;0.19;373.68;18.25;1402;46;4588.00;324
11615;40;22277246;11615;727;13015;13339;3.16;0.19;373.66;18.25;1400;46;4589.00;324
11619;40;22277265;11619;737;13019;13345;3.16;0.19;373.65;18.25;1400;46;4590.00;326
11622;40;22277284;11622;745;13020;13345;3.15;0.19;373.71;18.25;1398;46;4591.00;325
11626;40;22277300;11626;740;13022;13345;3.11;0.19;373.77;18.32;1396;46;4592.00;323
11627;40;22277318;11627;744;13022;13345;3.11;0.19;373.74;18.32;1395;46;4593.00;323
11628;40;22277333;11628;749;13026;13349;3.13;0.19;373.72;18.31;1398;46;4594.00;323
11629;40;22277350;11629;756;13026;13349;3.12;0.19;373.71;18.31;1397;46;4595.00;323
11634;40;22277367;11634;751;13026;13349;3.06;0.19;373.70;18.31;1392;46;4596.00;323
11635;40;22277383;11635;733;13026;13349;3.05;0.19;373.68;18.31;1391;46;4597.00;323
11639;40;22277399;11639;721;13026;13350;3.01;0.18;373.72;18.31;1387;46;4598.00;324
11644;40;22277417;11644;719;13027;13351;3.00;0.18;373.71;18.31;1383;46;4599.00;324
11646;40;22277435;11646;714;13027;13351;3.00;0.18;373.74;18.31;1381;46;4600.00;324
11647;40;22277457;11647;714;13028;13352;3.04;0.19;373.73;18.31;1381;46;4601.00;324
11650;40;22277474;11650;715;13028;13352;3.04;0.19;373.71;18.31;1378;46;4602.00;324
11652;40;22277493;11652;717;13028;13352;3.06;0.19;373.68;18.31;1376;46;4603.00;324
11655;40;22277510;11655;713;13028;13352;3.07;0.19;373.77;18.31;1373;46;4604.00;324
11655;40;22277526;11655;710;13028;13352;3.13;0.19;373.77;18.31;1373;46;4605.00;324
11655;40;22277546;11655;690;13028;13352;3.21;0.20;373.77;18.31;1373;46;4606.00;324
11655;40;22277572;11655;677;13029;13352;3.26;0.20;373.77;18.39;1374;46;4607.00;323
11657;40;22277596;11657;685;13095;13479;3.68;0.23;373.74;18.29;1438;46;4608.00;384
11659;40;22277632;11659;664;13097;13480;3.71;0.23;373.74;18.29;1438;46;4609.00;383
11663;40;22277650;11663;651;13107;13480;3.80;0.24;373.66;18.28;1444;46;4610.00;373
11665;40;22277668;11665;648;13109;13480;3.85;0.24;373.64;18.28;1444;46;4611.00;371
11666;40;22277686;11666;656;13115;13480;3.91;0.24;373.63;18.27;1449;46;4612.00;365
11668;40;22277704;11668;656;13117;13480;3.91;0.24;373.57;18.27;1449;46;4613.00;363
11668;40;22277721;11668;662;13121;13480;4.01;0.25;373.57;18.27;1453;46;4614.00;359
11670;40;22277740;11670;664;13125;13480;4.10;0.25;373.67;18.26;1455;46;4615.00;355
11673;40;22277758;11673;668;13128;13481;4.14;0.25;373.70;18.26;1455;46;4616.00;353
11674;40;22277779;11674;676;13131;13482;4.17;0.26;373.67;18.26;1457;46;4617.00;351
11676;40;22277798;11676;676;13133;13482;4.17;0.26;373.69;18.26;1457;46;4618.00;349
11677;40;22277818;11677;675;13135;13483;4.17;0.26;373.69;18.25;1458;46;4619.00;348
11680;40;22277843;11680;655;13139;13483;4.17;0.25;373.71;18.25;1459;46;4620.00;344
11680;40;22277863;11680;648;13141;13483;4.22;0.26;373.71;18.25;1461;46;4621.00;342
11682;40;22277883;11682;638;13142;13483;4.27;0.26;373.72;18.25;1460;46;4622.00;341
11683;40;22277903;11683;627;13146;13487;4.37;0.27;373.71;18.25;1463;46;4623.00;341
11683;40;22277922;11683;622;13146;13487;4.43;0.27;373.71;18.25;1463;46;4624.00;341
11685;41;22277943;11685;614;13147;13487;4.50;0.27;373.73;18.25;1462;47;4625.00;340
11685;41;22277980;11685;616;13150;13490;4.53;0.28;373.73;18.24;1465;47;4626.00;340
11685;41;22278007;11685;612;13150;13490;4.59;0.28;373.73;18.24;1465;47;4627.00;340
11686;41;22278028;11686;617;13151;13490;4.63;0.28;373.79;18.24;1465;47;4628.00;339
11688;41;22278048;11688;611;13154;13494;4.65;0.28;373.77;18.24;1466;47;4629.00;340
11688;41;22278068;11688;611;13155;13495;4.72;0.29;373.77;18.24;1467;47;4630.00;340
11692;41;22278087;11692;612;13155;13495;4.73;0.29;373.74;18.24;1463;47;4631.00;340
11694;41;22278107;11694;606;13160;13499;4.77;0.29;373.72;18.24;1466;47;4632.00;339
11695;41;22278127;11695;603;13162;13499;4.80;0.29;373.71;18.31;1467;47;4633.00;337
11695;41;22278154;11695;600;13163;13499;4.83;0.29;373.71;18.31;1468;47;4634.00;336
11697;41;22278179;11697;604;13165;13501;4.83;0.29;373.77;18.31;1468;47;4635.00;336
11697;41;22278198;11697;598;13165;13501;4.84;0.30;373.77;18.31;1468;47;4636.00;336
11698;41;22278217;11698;599;13169;13507;4.90;0.30;373.78;18.30;1471;47;4637.00;338
11700;41;22278238;11700;596;13169;13507;4.89;0.30;373.85;18.30;1469;47;4638.00;338
11701;41;22278257;11701;603;13169;13508;4.88;0.30;373.91;18.30;1468;47;4639.00;339
11702;41;22278284;11702;602;13169;13508;4.87;0.30;373.89;18.30;1467;47;4640.00;339
11702;41;22278303;11702;601;13169;13508;4.89;0.30;373.89;18.30;1467;47;4641.00;339
11706;41;22278322;11706;596;13169;13508;4.87;0.30;373.90;18.30;1463;47;4642.00;339
11706;41;22278343;11706;592;13169;13508;4.85;0.30;373.90;18.30;1463;47;4643.00;339
11706;41;22278363;11706;575;13179;13520;4.85;0.30;373.90;18.29;1473;47;4644.00;341
11708;41;22278383;11708;572;13179;13520;4.84;0.30;373.95;18.29;1471;47;4645.00;341
11708;41;22278404;11708;571;13180;13520;4.86;0.30;373.95;18.29;1472;47;4646.00;340
11709;41;22278423;11709;559;13180;13520;4.90;0.30;373.93;18.29;1471;47;4647.00;340
11714;41;22278444;11714;557;13180;13520;4.95;0.30;374.01;18.29;1466;47;4648.00;340
11719;41;22278470;11719;551;13181;13520;4.96;0.30;374.03;18.37;1462;47;4649.00;339
11720;41;22278491;11720;550;13186;13526;4.97;0.30;374.04;18.36;1466;47;4650.00;340
11723;41;22278513;11723;550;13186;13526;4.98;0.30;374.01;18.36;1463;47;4651.00;340
11728;41;22278533;11728;561;13189;13530;4.98;0.30;373.95;18.36;1461;47;4652.00;341
11730;41;22278553;11730;564;13190;13531;4.99;0.30;374.02;18.36;1460;47;4653.00;341
11737;41;22278573;11737;562;13190;13531;4.95;0.30;374.00;18.36;1453;47;4654.00;341
11739;41;22278592;11739;559;13192;13531;4.92;0.30;374.00;18.51;1453;47;4655.00;339
11743;41;22278619;11743;557;13202;13544;4.91;0.30;374.04;18.49;1459;47;4656.00;342
11749;41;22278641;11749;559;13202;13544;4.90;0.30;374.11;18.49;1453;47;4657.00;342
11753;41;22278661;11753;570;13203;13544;4.89;0.30;374.17;18.57;1450;47;4658.00;341
11757;41;22278682;11757;570;13205;13545;4.85;0.30;374.20;18.57;1448;47;4659.00;340
11761;41;22278703;11761;566;13205;13546;4.80;0.29;374.27;18.57;1444;47;4660.00;341
11764;41;22278723;11764;561;13205;13546;4.84;0.29;374.29;18.57;1441;47;4661.00;341
11767;41;22278744;11767;556;13207;13549;4.84;0.29;374.31;18.57;1440;47;4662.00;342
11768;41;22278765;11768;561;13207;13549;4.83;0.29;374.34;18.57;1439;47;4663.00;342
11773;41;22278792;11773;558;13208;13549;4.82;0.29;374.31;18.57;1435;47;4664.00;341
11777;41;22278814;11777;560;13208;13549;4.78;0.29;374.34;18.57;1431;47;4665.00;341
11777;41;22278834;11777;560;13212;13555;4.84;0.29;374.34;18.56;1435;47;4666.00;343
11779;41;22278854;11779;557;13212;13555;4.83;0.29;374.34;18.56;1433;47;4667.00;343
11783;41;22278873;11783;555;13212;13555;4.79;0.29;374.43;18.56;1429;47;4668.00;343
11786;41;22278894;11786;553;13212;13555;4.76;0.29;374.38;18.56;1426;47;4669.00;343
11789;41;22278912;11789;550;13215;13559;4.72;0.29;374.49;18.56;1426;47;4670.00;344
11791;41;22278933;11791;549;13216;13560;4.73;0.29;374.47;18.55;1425;47;4671.00;344
11795;41;22278952;11795;552;13216;13560;4.70;0.29;374.60;18.55;1421;47;4672.00;344
11797;41;22278972;11797;544;13219;13561;4.68;0.29;374.67;18.56;1422;47;4673.00;342
11800;41;22278990;11800;544;13219;13561;4.65;0.28;374.80;18.56;1419;47;4674.00;342
11801;41;22279009;11801;551;13219;13561;4.67;0.28;374.83;18.56;1418;47;4675.00;342
11806;41;22279029;11806;543;13221;13561;4.64;0.28;374.90;18.56;1415;47;4676.00;340
11809;41;22279054;11809;541;13221;13561;4.62;0.28;374.97;18.56;1412;47;4677.00;340
11810;41;22279075;11810;540;13221;13561;4.62;0.28;374.97;18.56;1411;47;4678.00;340
11815;41;22279095;11815;548;13221;13561;4.60;0.28;375.02;18.56;1406;47;4679.00;340
11818;41;22279118;11818;559;13279;13686;4.80;0.30;375.17;18.48;1461;47;4680.00;407
11820;41;22279161;11820;557;13283;13687;4.82;0.30;375.18;18.47;1463;47;4681.00;404
11821;41;22279181;11821;554;13291;13687;4.87;0.30;375.25;18.46;1470;47;4682.00;396
11823;41;22279201;11823;559;13296;13687;4.83;0.30;375.25;18.54;1473;47;4683.00;391
11824;41;22279220;11824;565;13301;13687;4.83;0.30;375.28;18.53;1477;47;4684.00;386
11830;41;22279239;11830;557;13305;13687;4.77;0.29;375.42;18.68;1475;47;4685.00;382
11830;41;22279260;11830;565;13310;13687;4.75;0.29;375.42;18.68;1480;47;4686.00;377
11833;41;22279279;11833;568;13312;13687;4.75;0.29;375.47;18.68;1479;47;4687.00;375
11834;41;22279306;11834;566;13318;13688;4.76;0.29;375.45;18.67;1484;47;4688.00;370
11840;41;22279327;11840;570;13324;13689;4.72;0.29;375.42;18.67;1484;47;4689.00;365
11845;41;22279347;11845;560;13331;13689;4.69;0.29;375.56;18.82;1486;47;4690.00;358
11845;41;22279367;11845;562;13335;13693;4.70;0.29;375.56;18.81;1490;47;4691.00;358
11848;41;22279386;11848;558;13337;13693;4.66;0.29;375.61;18.89;1489;47;4692.00;356
11849;41;22279414;11849;560;13338;13693;4.68;0.29;375.63;18.96;1489;47;4693.00;355
11853;41;22279442;11853;563;13339;13693;4.64;0.28;375.71;19.04;1486;47;4694.00;354
11858;41;22279461;11858;565;13344;13699;4.63;0.28;375.80;19.03;1486;47;4695.00;355
11860;41;22279482;11860;567;13344;13699;4.62;0.28;375.86;19.03;1484;47;4696.00;355
11864;41;22279502;11864;567;13347;13699;4.61;0.28;376.05;19.26;1483;47;4697.00;352
11865;41;22279521;11865;576;13350;13702;4.60;0.28;376.09;19.25;1485;47;4698.00;352
11869;41;22279539;11869;571;13350;13702;4.56;0.28;376.15;19.25;1481;47;4699.00;352
11873;41;22279560;11873;572;13351;13702;4.54;0.28;376.18;19.33;1478;47;4700.00;351
11877;41;22279585;11877;577;13351;13703;4.52;0.28;376.17;19.33;1474;47;4701.00;352
11880;41;22279607;11880;574;13352;13704;4.50;0.27;376.34;19.33;1472;47;4702.00;352
11885;41;22279628;11885;579;13354;13704;4.49;0.27;376.34;19.47;1469;47;4703.00;350
11888;41;22279647;11888;587;13366;13717;4.50;0.27;376.45;19.53;1478;47;4704.00;351
11890;41;22279672;11890;594;13366;13717;4.50;0.27;376.47;19.53;1476;47;4705.00;351
11892;41;22279693;11892;596;13367;13717;4.49;0.27;376.52;19.61;1475;47;4706.00;350
11894;41;22279760;11894;599;13368;13718;4.52;0.27;376.64;19.61;1474;47;4707.00;350
11895;41;22279785;11895;597;13370;13718;4.54;0.28;376.74;19.75;1475;47;4708.00;348
11897;41;22279805;11897;601;13374;13722;4.59;0.28;376.73;19.75;1477;47;4709.00;348
11899;41;22279834;11899;603;13374;13722;4.57;0.28;376.92;19.75;1475;47;4710.00;348
11902;41;22279853;11902;611;13379;13726;4.55;0.28;377.04;19.89;1477;47;4711.00;347
11905;41;22279872;11905;604;13379;13726;4.56;0.28;377.14;19.89;1474;47;4712.00;347
11909;41;22279890;11909;608;13379;13726;4.51;0.28;377.31;19.89;1470;47;4713.00;347
11914;41;22279909;11914;614;13379;13726;4.46;0.27;377.47;19.89;1465;47;4714.00;347
11918;41;22279928;11918;617;13379;13726;4.39;0.27;377.48;19.89;1461;47;4715.00;347
11922;41;22279946;11922;623;13388;13738;4.32;0.26;377.67;19.87;1466;47;4716.00;350
11926;41;22279965;11926;622;13388;13738;4.21;0.26;377.71;19.87;1462;47;4717.00;350
11927;41;22279981;11927;623;13390;13738;4.17;0.26;377.79;19.87;1463;47;4718.00;348
11937;41;22279999;11937;619;13390;13738;4.03;0.25;377.83;19.87;1453;47;4719.00;348
11940;41;22280016;11940;629;13390;13738;3.97;0.24;377.84;19.87;1450;47;4720.00;348
11943;41;22280033;11943;623;13390;13738;3.91;0.24;377.93;19.87;1447;47;4721.00;348
11949;41;22280050;11949;626;13390;13739;3.82;0.23;377.89;19.87;1441;47;4722.00;349
11953;41;22280068;11953;621;13390;13739;3.75;0.23;377.84;19.87;1437;47;4723.00;349
11956;41;22280085;11956;623;13395;13745;3.76;0.23;377.95;19.86;1439;47;4724.00;350
11959;41;22280102;11959;622;13397;13747;3.72;0.23;377.99;19.86;1438;47;4725.00;350
11963;41;22280120;11963;618;13397;13747;3.68;0.23;377.98;19.86;1434;47;4726.00;350
11965;41;22280137;11965;618;13397;13747;3.69;0.23;377.95;19.86;1432;47;4727.00;350
11967;41;22280154;11967;612;13400;13751;3.71;0.23;378.04;19.86;1433;47;4728.00;351
11972;41;22280171;11972;613;13400;13751;3.67;0.23;378.22;19.86;1428;47;4729.00;351
11975;41;22280188;11975;608;13400;13751;3.66;0.22;378.30;19.86;1425;47;4730.00;351
11978;41;22280206;11978;604;13401;13752;3.63;0.22;378.41;19.86;1423;47;4731.00;351
11980;41;22280223;11980;600;13404;13756;3.61;0.22;378.50;19.85;1424;47;4732.00;352
11984;41;22280241;11984;588;13404;13756;3.59;0.22;378.55;19.85;1420;47;4733.00;352
11987;41;22280258;11987;583;13407;13759;3.60;0.22;378.53;19.85;1420;47;4734.00;352
11990;41;22280276;11990;587;13407;13759;3.58;0.22;378.63;19.85;1417;47;4735.00;352
11992;41;22280293;11992;586;13407;13759;3.55;0.22;378.75;19.85;1415;47;4736.00;352
11994;41;22280312;11994;574;13407;13759;3.60;0.22;378.75;19.85;1413;47;4737.00;352
11997;41;22280330;11997;570;13411;13763;3.66;0.22;378.75;19.84;1414;47;4738.00;352
12001;41;22280349;12001;578;13411;13763;3.65;0.22;378.73;19.84;1410;47;4739.00;352
12005;41;22280368;12005;568;13411;13763;3.66;0.22;378.66;19.84;1406;47;4740.00;352
12008;41;22280386;12008;576;13411;13763;3.63;0.22;378.62;19.84;1403;47;4741.00;352
12010;41;22280405;12010;583;13411;13764;3.57;0.22;378.60;19.84;1401;47;4742.00;353
12016;41;22280422;12016;584;13412;13765;3.49;0.21;378.65;19.84;1396;47;4743.00;353
12018;41;22280441;12018;584;13412;13765;3.46;0.21;378.60;19.84;1394;47;4744.00;353
12023;41;22280458;12023;597;13413;13766;3.41;0.21;378.56;19.84;1390;47;4745.00;353
12027;41;22280478;12027;600;13413;13766;3.39;0.21;378.64;19.84;1386;47;4746.00;353
12029;41;22280496;12029;602;13413;13766;3.42;0.21;378.63;19.84;1384;47;4747.00;353
12033;41;22280514;12033;591;13413;13766;3.39;0.21;378.66;19.84;1380;47;4748.00;353
12036;41;22280531;12036;583;13414;13766;3.35;0.21;378.65;19.92;1378;47;4749.00;352
12038;41;22280550;12038;583;13414;13766;3.34;0.21;378.59;19.92;1376;47;4750.00;352
12042;41;22280569;12042;587;13414;13766;3.30;0.20;378.58;19.92;1372;47;4751.00;352
12048;41;22280587;12048;598;13486;13893;3.57;0.22;378.55;19.82;1438;47;4752.00;407
12050;41;22280617;12050;594;13487;13894;3.55;0.22;378.53;19.81;1437;47;4753.00;407
12054;41;22280635;12054;591;13495;13894;3.58;0.22;378.51;19.80;1441;47;4754.00;399
12055;41;22280651;12055;591;13497;13894;3.59;0.22;378.48;19.80;1442;47;4755.00;397
12059;41;22280669;12059;594;13502;13894;3.62;0.23;378.52;19.80;1443;47;4756.00;392
12059;41;22280688;12059;596;13504;13894;3.66;0.23;378.52;19.79;1445;47;4757.00;390
12064;41;22280706;12064;599;13508;13894;3.66;0.23;378.52;19.79;1444;47;4758.00;386
12068;41;22280723;12068;590;13511;13894;3.64;0.23;378.46;19.79;1443;47;4759.00;383
12072;41;22280743;12072;589;13514;13895;3.63;0.22;378.41;19.78;1442;47;4760.00;381
12075;41;22280761;12075;599;13516;13896;3.59;0.22;378.52;19.78;1441;47;4761.00;380
12075;41;22280779;12075;601;13520;13896;3.58;0.22;378.52;19.78;1445;47;4762.00;376
12079;41;22280797;12079;601;13522;13897;3.53;0.22;378.50;19.78;1443;47;4763.00;375
12083;41;22280815;12083;605;13526;13897;3.50;0.22;378.50;19.78;1443;47;4764.00;371
12085;41;22280834;12085;616;13527;13897;3.50;0.22;378.48;19.86;1442;47;4765.00;370
12086;41;22280852;12086;621;13528;13897;3.51;0.22;378.47;19.86;1442;47;4766.00;369
12087;41;22280870;12087;629;13531;13901;3.53;0.22;378.48;19.86;1444;47;4767.00;370
12089;41;22280888;12089;639;13531;13901;3.53;0.22;378.46;19.86;1442;47;4768.00;370
12090;41;22280906;12090;648;13532;13901;3.55;0.22;378.46;19.86;1442;47;4769.00;369
12096;41;22280925;12096;657;13536;13907;3.50;0.22;378.48;19.85;1440;47;4770.00;371
12098;41;22280945;12098;657;13536;13907;3.50;0.22;378.52;19.85;1438;47;4771.00;371
12102;41;22280962;12102;654;13538;13907;3.49;0.22;378.57;19.85;1436;47;4772.00;369
12106;41;22280981;12106;641;13541;13911;3.44;0.21;378.59;19.85;1435;47;4773.00;370
12109;41;22280999;12109;647;13542;13912;3.46;0.21;378.65;19.84;1433;47;4774.00;370
12110;41;22281017;12110;646;13544;13912;3.46;0.21;378.62;19.84;1434;47;4775.00;368
12110;41;22281035;12110;637;13547;13916;3.53;0.22;378.62;19.84;1437;47;4776.00;369
12111;41;22281052;12111;625;13547;13916;3.57;0.22;378.59;19.84;1436;47;4777.00;369
12113;41;22281070;12113;611;13547;13916;3.57;0.22;378.61;19.84;1434;47;4778.00;369
12114;41;22281087;12114;604;13547;13917;3.63;0.22;378.63;19.84;1433;47;4779.00;370
12119;41;22281114;12119;602;13549;13917;3.64;0.22;378.64;19.93;1430;47;4780.00;368
12120;41;22281134;12120;588;13556;13923;3.73;0.23;378.63;19.92;1436;47;4781.00;367
12124;41;22281153;12124;577;13556;13923;3.79;0.23;378.60;19.92;1432;47;4782.00;367
12129;41;22281172;12129;570;13557;13924;3.85;0.24;378.56;19.92;1428;47;4783.00;367
12129;41;22281191;12129;551;13557;13924;3.96;0.24;378.56;19.92;1428;47;4784.00;367
12130;41;22281210;12130;553;13558;13924;4.10;0.25;378.59;19.92;1428;47;4785.00;366
12132;41;22281230;12132;540;13558;13924;4.23;0.26;378.58;19.92;1426;47;4786.00;366
12133;41;22281249;12133;531;13559;13924;4.32;0.26;378.56;19.92;1426;47;4787.00;365
12134;41;22281268;12134;535;13568;13936;4.39;0.27;378.58;19.90;1434;47;4788.00;368
12134;41;22281287;12134;533;13568;13936;4.46;0.27;378.58;19.90;1434;47;4789.00;368
12136;41;22281306;12136;534;13569;13936;4.48;0.27;378.64;19.90;1433;47;4790.00;367
12136;41;22281333;12136;532;13569;13936;4.49;0.27;378.64;19.90;1433;47;4791.00;367
12136;41;22281351;12136;530;13569;13936;4.56;0.28;378.64;19.90;1433;47;4792.00;367
12138;41;22281370;12138;534;13570;13936;4.58;0.28;378.66;19.90;1432;47;4793.00;366
12139;41;22281389;12139;527;13573;13940;4.61;0.28;378.64;19.90;1434;47;4794.00;367
12140;41;22281411;12140;529;13573;13940;4.58;0.28;378.64;19.90;1433;47;4795.00;367
12141;41;22281431;12141;518;13576;13944;4.60;0.28;378.63;19.89;1435;47;4796.00;368
12141;41;22281451;12141;518;13576;13945;4.62;0.28;378.63;19.89;1435;47;4797.00;369
12144;41;22281471;12144;513;13576;13945;4.58;0.28;378.76;19.89;1432;47;4798.00;369
12148;41;22281490;12148;519;13578;13945;4.58;0.28;378.76;19.89;1430;47;4799.00;367
12150;41;22281513;12150;524;13600;13986;4.64;0.28;378.76;19.86;1450;47;4800.00;386
12151;41;22281541;12151;524;13601;13986;4.64;0.28;378.75;19.86;1450;47;4801.00;385
12153;41;22281567;12153;514;13602;13986;4.68;0.28;378.73;19.86;1449;47;4802.00;384
12154;41;22281596;12154;516;13604;13987;4.76;0.29;378.75;19.85;1450;47;4803.00;383
12155;41;22281617;12155;526;13605;13988;4.80;0.29;378.73;19.85;1450;47;4804.00;383
12156;41;22281638;12156;522;13607;13988;4.84;0.29;378.77;19.85;1451;47;4805.00;381
12160;41;22281658;12160;522;13609;13991;4.85;0.30;378.86;19.85;1449;47;4806.00;382
12161;41;22281682;12161;525;13609;13991;4.90;0.30;378.92;19.85;1448;47;4807.00;382
12163;41;22281703;12163;526;13610;13991;4.93;0.30;379.03;19.85;1447;47;4808.00;381
12167;41;22281727;12167;523;13610;13991;4.93;0.30;379.07;19.85;1443;47;4809.00;381
12171;41;22281747;12171;526;13614;13997;4.95;0.30;379.09;19.84;1443;47;4810.00;383
12174;41;22281770;12174;528;13615;13997;4.97;0.30;379.20;19.84;1441;47;4811.00;382
12176;41;22281791;12176;532;13615;13997;4.98;0.30;379.31;19.84;1439;47;4812.00;382
12180;41;22281816;12180;542;13615;13997;4.96;0.30;379.34;19.84;1435;47;4813.00;382
12182;41;22281851;12182;539;13618;14001;4.94;0.30;379.35;19.84;1436;47;4814.00;383
12185;41;22281876;12185;530;13619;14003;4.92;0.30;379.56;19.83;1434;47;4815.00;384
12188;41;22281910;12188;525;13619;14003;4.88;0.30;379.67;19.83;1431;47;4816.00;384
12189;41;22281936;12189;529;13621;14004;4.90;0.30;379.70;19.83;1432;47;4817.00;383
12192;41;22281956;12192;525;13622;14004;4.89;0.30;379.77;19.92;1430;47;4818.00;382
12195;41;22281977;12195;515;13622;14004;4.89;0.30;379.85;19.92;1427;47;4819.00;382
12198;41;22281998;12198;504;13622;14004;4.86;0.29;379.91;19.92;1424;47;4820.00;382
12201;41;22282024;12201;505;13622;14004;4.85;0.29;380.01;19.92;1421;47;4821.00;382
12204;41;22282044;12204;503;13623;14004;4.85;0.29;380.04;19.92;1419;47;4822.00;381
12205;41;22282064;12205;507;13623;14004;4.93;0.30;380.06;19.92;1418;47;4823.00;381
12211;41;22282089;12211;513;13657;14074;4.92;0.30;380.19;19.87;1446;47;4824.00;417
12215;41;22282116;12215;505;13660;14075;4.94;0.30;380.21;19.87;1445;47;4825.00;415
12218;41;22282136;12218;503;13663;14075;4.96;0.30;380.27;19.86;1445;47;4826.00;412
12224;41;22282154;12224;494;13666;14075;4.96;0.30;380.32;19.86;1442;47;4827.00;409
12228;41;22282173;12228;499;13669;14077;4.95;0.30;380.28;19.86;1441;47;4828.00;408
12231;41;22282193;12231;502;13671;14077;4.99;0.30;380.28;19.85;1440;47;4829.00;406
12235;41;22282215;12235;503;13672;14077;5.02;0.30;380.33;19.85;1437;47;4830.00;405
12237;41;22282235;12237;501;13673;14077;5.04;0.31;380.34;19.85;1436;47;4831.00;404
12242;41;22282255;12242;501;13674;14078;5.00;0.30;380.35;19.85;1432;47;4832.00;404
12243;41;22282276;12243;496;13680;14079;4.97;0.30;380.35;19.85;1437;47;4833.00;399
12244;41;22282297;12244;504;13681;14079;4.94;0.30;380.36;19.85;1437;47;4834.00;398
12244;41;22282316;12244;505;13685;14083;4.94;0.30;380.36;19.84;1441;47;4835.00;398
12247;41;22282336;12247;506;13685;14083;4.92;0.30;380.40;19.84;1438;47;4836.00;398
12250;41;22282355;12250;509;13685;14083;4.88;0.30;380.46;19.84;1435;47;4837.00;398
12252;41;22282381;12252;511;13685;14083;4.89;0.30;380.49;19.84;1433;47;4838.00;398
12253;41;22282400;12253;525;13689;14089;4.91;0.30;380.48;19.84;1436;47;4839.00;400
12258;41;22282419;12258;533;13689;14089;4.87;0.30;380.56;19.84;1431;47;4840.00;400
12262;41;22282439;12262;533;13689;14089;4.84;0.30;380.68;19.84;1427;47;4841.00;400
12266;41;22282456;12266;540;13690;14092;4.84;0.29;380.75;19.84;1424;47;4842.00;402
12267;41;22282477;12267;544;13690;14092;4.83;0.29;380.74;19.84;1423;47;4843.00;402
12272;41;22282497;12272;555;13690;14092;4.78;0.29;380.81;19.84;1418;47;4844.00;402
12274;41;22282516;12274;551;13690;14093;4.80;0.29;380.96;19.84;1416;47;4845.00;403
12275;41;22282535;12275;548;13691;14094;4.84;0.29;380.97;19.84;1416;47;4846.00;403
12279;41;22282553;12279;555;13692;14094;4.84;0.30;381.19;19.84;1413;47;4847.00;402
12280;41;22282572;12280;562;13700;14107;4.90;0.30;381.17;19.83;1420;47;4848.00;407
12283;41;22282591;12283;561;13700;14107;4.97;0.30;381.23;19.83;1417;47;4849.00;407
12287;41;22282611;12287;561;13700;14107;5.01;0.31;381.29;19.83;1413;47;4850.00;407
12293;41;22282632;12293;565;13701;14108;5.03;0.31;381.32;19.83;1408;47;4851.00;407
12294;41;22282651;12294;573;13701;14108;5.08;0.31;381.32;19.83;1407;47;4852.00;407
12299;41;22282671;12299;568;13706;14112;5.07;0.31;381.45;19.82;1407;47;4853.00;406
12301;41;22282691;12301;563;13706;14112;5.08;0.31;381.52;19.82;1405;47;4854.00;406
12305;41;22282711;12305;556;13708;14116;5.05;0.31;381.64;19.82;1403;47;4855.00;408
12307;41;22282731;12307;555;13708;14116;5.07;0.31;381.62;19.82;1401;47;4856.00;408
12308;41;22282750;12308;554;13708;14116;5.06;0.31;381.63;19.82;1400;47;4857.00;408
12312;41;22282769;12312;555;13708;14116;5.01;0.31;381.68;19.82;1396;47;4858.00;408
12315;41;22282788;12315;550;13708;14116;4.97;0.30;381.76;19.82;1393;47;4859.00;408
12316;41;22282810;12316;550;13727;14150;5.07;0.31;381.79;19.79;1411;47;4860.00;423
12319;41;22282832;12319;549;13728;14150;5.01;0.31;381.83;19.79;1409;47;4861.00;422
12321;41;22282851;12321;556;13729;14150;5.01;0.31;381.91;19.79;1408;47;4862.00;421
12324;41;22282871;12324;560;13729;14150;4.99;0.31;381.99;19.79;1405;47;4863.00;421
12327;41;22282890;12327;556;13730;14150;4.96;0.30;382.12;19.79;1403;47;4864.00;420
12329;41;22282910;12329;554;13730;14150;4.94;0.30;382.15;19.79;1401;47;4865.00;420
12332;41;22282936;12332;554;13730;14151;4.89;0.30;382.27;19.79;1398;47;4866.00;421
12335;41;22282958;12335;548;13730;14151;4.87;0.30;382.43;19.79;1395;47;4867.00;421
12337;41;22282980;12337;551;13734;14157;4.92;0.30;382.39;19.78;1397;47;4868.00;423
12340;41;22283001;12340;559;13734;14158;4.85;0.30;382.45;19.78;1394;47;4869.00;424
12342;41;22283021;12342;558;13734;14158;4.82;0.29;382.45;19.78;1392;47;4870.00;424
12344;41;22283040;12344;560;13734;14158;4.79;0.29;382.44;19.78;1390;47;4871.00;424
12347;41;22283060;12347;567;13737;14162;4.76;0.29;382.48;19.78;1390;47;4872.00;425
12349;41;22283083;12349;568;13737;14162;4.70;0.29;382.48;19.78;1388;47;4873.00;425
12350;41;22283102;12350;568;13737;14162;4.65;0.28;382.55;19.78;1387;47;4874.00;425
12351;41;22283121;12351;569;13738;14163;4.56;0.28;382.58;19.78;1387;47;4875.00;425
12352;41;22283141;12352;562;13739;14167;4.54;0.28;382.60;19.78;1387;47;4876.00;428
12354;41;22283159;12354;561;13739;14167;4.51;0.27;382.65;19.78;1385;47;4877.00;428
12357;41;22283178;12357;561;13740;14170;4.50;0.27;382.65;19.77;1383;47;4878.00;430
12360;41;22283198;12360;552;13740;14170;4.48;0.27;382.61;19.77;1380;47;4879.00;430
12365;41;22283235;12365;549;13740;14170;4.46;0.27;382.63;19.77;1375;47;4880.00;430
12367;41;22283252;12367;541;13740;14170;4.44;0.27;382.76;19.77;1373;47;4881.00;430
12370;41;22283270;12370;545;13743;14174;4.49;0.27;382.89;19.77;1373;47;4882.00;431
12374;41;22283287;12374;542;13743;14174;4.51;0.27;383.02;19.77;1369;47;4883.00;431
12375;41;22283305;12375;545;13743;14174;4.56;0.28;383.00;19.77;1368;47;4884.00;431
12377;41;22283321;12377;544;13743;14174;4.59;0.28;383.17;19.77;1366;47;4885.00;431
12380;41;22283339;12380;550;13743;14175;4.63;0.28;383.34;19.77;1363;47;4886.00;432
12383;41;22283355;12383;553;13743;14176;4.63;0.28;383.38;19.77;1360;47;4887.00;433
12385;41;22283372;12385;550;13743;14176;4.62;0.28;383.42;19.77;1358;47;4888.00;433
12389;41;22283389;12389;552;13744;14177;4.61;0.28;383.47;19.77;1355;47;4889.00;433
12392;41;22283409;12392;556;13744;14177;4.60;0.28;383.47;19.77;1352;47;4890.00;433
12396;41;22283425;12396;558;13744;14177;4.57;0.28;383.60;19.77;1348;47;4891.00;433
12400;41;22283443;12400;567;13744;14177;4.52;0.28;383.83;19.77;1344;47;4892.00;433
12404;41;22283458;12404;580;13744;14177;4.49;0.27;383.97;19.77;1340;47;4893.00;433
12408;41;22283474;12408;586;13744;14177;4.46;0.27;384.09;19.77;1336;47;4894.00;433
12415;41;22283490;12415;588;13746;14177;4.37;0.27;384.19;19.77;1331;47;4895.00;431
12418;41;22283507;12418;606;13800;14304;4.61;0.28;384.26;19.69;1382;47;4896.00;504
12421;41;22283534;12421;607;13801;14305;4.51;0.28;384.36;19.69;1380;47;4897.00;504
12424;41;22283551;12424;604;13809;14305;4.49;0.28;384.36;19.68;1385;47;4898.00;496
12431;41;22283568;12431;610;13814;14305;4.37;0.27;384.61;19.68;1383;47;4899.00;491
12433;41;22283585;12433;591;13820;14305;4.28;0.26;384.57;19.67;1387;47;4900.00;485
12438;41;22283606;12438;573;13824;14305;4.15;0.26;384.59;19.67;1386;47;4901.00;481
12439;41;22283622;12439;570;13826;14305;4.11;0.25;384.63;19.66;1387;47;4902.00;479
12445;41;22283638;12445;567;13828;14305;4.04;0.25;384.61;19.66;1383;47;4903.00;477
12446;41;22283655;12446;567;13829;14306;4.02;0.25;384.62;19.66;1383;47;4904.00;477
12450;41;22283671;12450;568;13831;14308;4.03;0.25;384.60;19.66;1381;47;4905.00;477
12453;41;22283689;12453;571;13831;14308;4.06;0.25;384.65;19.66;1378;47;4906.00;477
12453;41;22283705;12453;570;13831;14309;4.13;0.26;384.65;19.66;1378;47;4907.00;478
12455;41;22283722;12455;574;13832;14309;4.20;0.26;384.64;19.66;1377;47;4908.00;477
12459;41;22283738;12459;562;13833;14309;4.23;0.26;384.59;19.66;1374;47;4909.00;476
12461;41;22283755;12461;551;13836;14309;4.27;0.26;384.62;19.66;1375;47;4910.00;473
12463;41;22283772;12463;543;13838;14313;4.27;0.26;384.70;19.65;1375;47;4911.00;475
12465;41;22283789;12465;540;13840;14313;4.27;0.26;384.72;19.65;1375;47;4912.00;473
12472;41;22283807;12472;534;13840;14313;4.21;0.26;384.64;19.65;1368;47;4913.00;473
12474;41;22283824;12474;531;13841;14316;4.25;0.26;384.71;19.65;1367;47;4914.00;475
12483;41;22283843;12483;530;13841;14316;4.20;0.26;384.66;19.65;1358;47;4915.00;475
12489;41;22283860;12489;523;13841;14316;4.17;0.25;384.68;19.65;1352;47;4916.00;475
12492;41;22283878;12492;529;13842;14320;4.17;0.25;384.64;19.65;1350;47;4917.00;478
12495;41;22283895;12495;529;13843;14321;4.10;0.25;384.62;19.65;1348;47;4918.00;478
12501;41;22283912;12501;538;13843;14321;4.05;0.25;384.53;19.65;1342;47;4919.00;478
12504;41;22283932;12504;534;13846;14326;3.98;0.24;384.54;19.64;1342;47;4920.00;480
12506;41;22283951;12506;547;13847;14326;3.92;0.24;384.52;19.65;1341;47;4921.00;479
12507;41;22283968;12507;547;13848;14326;3.93;0.24;384.52;19.65;1341;47;4922.00;478
12511;41;22283985;12511;553;13848;14327;3.88;0.24;384.51;19.65;1337;47;4923.00;479
12513;41;22284003;12513;552;13848;14327;3.85;0.23;384.49;19.65;1335;47;4924.00;479
12515;41;22284019;12515;557;13852;14333;3.82;0.23;384.45;19.64;1337;47;4925.00;481
12518;41;22284037;12518;557;13853;14333;3.75;0.23;384.42;19.65;1335;47;4926.00;480
12522;41;22284053;12522;563;13853;14334;3.67;0.22;384.37;19.65;1331;47;4927.00;481
12525;41;22284070;12525;570;13854;14334;3.61;0.22;384.32;19.66;1329;47;4928.00;480
12527;41;22284086;12527;576;13855;14334;3.56;0.22;384.30;19.66;1328;47;4929.00;479
12529;41;22284111;12529;581;13856;14334;3.51;0.21;384.31;19.67;1327;47;4930.00;478
12533;41;22284129;12533;582;13857;14334;3.49;0.21;384.26;19.68;1324;47;4931.00;477
12534;41;22284147;12534;585;13865;14346;3.56;0.22;384.27;19.67;1331;47;4932.00;481
12536;41;22284166;12536;596;13866;14346;3.54;0.22;384.26;19.68;1330;47;4933.00;480
12539;41;22284184;12539;585;13869;14346;3.55;0.22;384.29;19.69;1330;47;4934.00;477
12540;41;22284202;12540;572;13870;14346;3.59;0.22;384.29;19.69;1330;47;4935.00;476
12545;41;22284219;12545;563;13871;14346;3.62;0.22;384.30;19.70;1326;47;4936.00;475
12545;41;22284236;12545;554;13873;14346;3.70;0.22;384.30;19.71;1328;47;4937.00;473
12549;41;22284252;12549;561;13876;14350;3.77;0.23;384.30;19.72;1327;47;4938.00;474
12552;41;22284269;12552;554;13876;14350;3.80;0.23;384.28;19.72;1324;47;4939.00;474
12554;41;22284286;12554;544;13881;14354;3.90;0.24;384.32;19.72;1327;47;4940.00;473
12554;41;22284313;12554;545;13882;14355;3.98;0.24;384.32;19.73;1328;47;4941.00;473
12556;41;22284332;12556;548;13883;14355;3.97;0.24;384.31;19.82;1327;47;4942.00;472
12559;41;22284349;12559;542;13886;14355;3.99;0.24;384.39;19.83;1327;47;4943.00;469
12559;41;22284366;12559;542;13899;14368;4.13;0.25;384.39;19.83;1340;47;4944.00;469
12563;41;22284384;12563;547;13901;14368;4.12;0.25;384.44;19.84;1338;47;4945.00;467
12563;42;22284403;12563;544;13902;14368;4.16;0.25;384.44;19.85;1339;48;4946.00;466
12565;42;22284429;12565;532;13905;14369;4.20;0.26;384.45;19.85;1340;48;4947.00;464
12567;42;22284446;12567;531;13909;14370;4.26;0.26;384.47;19.87;1342;48;4948.00;461
12569;42;22284464;12569;533;13910;14370;4.31;0.26;384.47;19.87;1341;48;4949.00;460
12570;43;22284483;12570;528;13916;14379;4.34;0.26;384.45;19.87;1346;49;4950.00;463
12571;43;22284519;12571;528;13917;14379;4.39;0.27;384.44;19.87;1346;49;4951.00;462
12572;43;22284537;12572;529;13920;14379;4.39;0.27;384.43;19.88;1348;49;4952.00;459
12573;43;22284567;12573;526;13921;14379;4.38;0.27;384.40;19.88;1348;49;4953.00;458
12575;43;22284585;12575;526;13926;14385;4.36;0.27;384.49;19.88;1351;49;4954.00;459
12578;43;22284603;12578;526;13930;14385;4.36;0.27;384.59;19.88;1352;49;4955.00;455
12581;43;22284620;12581;512;13932;14385;4.40;0.27;384.55;19.89;1351;49;4956.00;453
12585;43;22284649;12585;495;13932;14385;4.41;0.27;384.70;19.89;1347;49;4957.00;453
12587;43;22284673;12587;484;13938;14389;4.48;0.27;384.75;19.98;1351;49;4958.00;451
12591;43;22284691;12591;481;13939;14390;4.52;0.27;384.79;19.98;1348;49;4959.00;451
12595;43;22284711;12595;471;13940;14390;4.54;0.28;384.84;19.98;1345;49;4960.00;450
12596;43;22284729;12596;472;13941;14391;4.60;0.28;384.87;19.98;1345;49;4961.00;450
12598;43;22284753;12598;471;13941;14391;4.63;0.28;384.90;19.98;1343;49;4962.00;450
12602;43;22284772;12602;468;13944;14391;4.65;0.28;384.93;19.99;1342;49;4963.00;447
12605;43;22284798;12605;469;13945;14391;4.65;0.28;385.00;20.00;1340;49;4964.00;446
12606;43;22284815;12606;470;13947;14391;4.64;0.28;385.03;20.09;1341;49;4965.00;444
12609;43;22284833;12609;477;13948;14391;4.63;0.28;385.04;20.09;1339;49;4966.00;443
12611;43;22284851;12611;469;13948;14391;4.63;0.28;385.18;20.09;1337;49;4967.00;443
12614;43;22284869;12614;480;13990;14461;4.65;0.28;385.19;20.04;1376;49;4968.00;471
12616;43;22284895;12616;476;13990;14462;4.69;0.29;385.29;20.04;1374;49;4969.00;472
12620;43;22284912;12620;476;13994;14462;4.72;0.29;385.30;20.04;1374;49;4970.00;468
12620;43;22284931;12620;475;13998;14462;4.81;0.29;385.30;20.04;1378;49;4971.00;464
12624;43;22284951;12624;477;14000;14462;4.82;0.29;385.27;20.04;1376;49;4972.00;462
12629;43;22284970;12629;479;14002;14462;4.88;0.30;385.43;20.04;1373;49;4973.00;460
12630;43;22284988;12630;478;14004;14462;4.92;0.30;385.54;20.04;1374;49;4974.00;458
12631;43;22285008;12631;477;14010;14462;4.91;0.30;385.57;20.23;1379;50;4975.00;452
12631;43;22285039;12631;485;14012;14463;4.96;0.30;385.57;20.23;1381;50;4976.00;451
12636;43;22285057;12636;493;14015;14464;4.97;0.30;385.66;20.23;1379;50;4977.00;449
12636;43;22285078;12636;495;14016;14464;5.02;0.31;385.66;20.24;1380;50;4978.00;448
12640;43;22285096;12640;507;14020;14468;5.02;0.31;385.84;20.23;1380;50;4979.00;448
12642;43;22285118;12642;512;14023;14468;5.01;0.31;385.88;20.32;1381;50;4980.00;445
12643;43;22285137;12643;520;14023;14468;5.02;0.31;385.91;20.32;1380;50;4981.00;445
12645;43;22285154;12645;520;14025;14468;4.99;0.31;385.97;20.33;1380;50;4982.00;443
12646;43;22285173;12646;516;14029;14474;5.03;0.31;385.99;20.33;1383;50;4983.00;445
12648;43;22285192;12648;515;14029;14474;5.04;0.31;386.02;20.33;1381;50;4984.00;445
12652;43;22285210;12652;513;14030;14474;5.01;0.31;386.12;20.33;1378;50;4985.00;444
12656;43;22285230;12656;521;14031;14477;5.01;0.31;386.11;20.33;1375;50;4986.00;446
12658;43;22285253;12658;521;14031;14477;5.00;0.31;386.19;20.33;1373;50;4987.00;446
12661;43;22285271;12661;522;14032;14477;4.99;0.31;386.26;20.33;1371;50;4988.00;445
12662;43;22285290;12662;519;14032;14478;4.98;0.31;386.26;20.33;1370;50;4989.00;446
12664;43;22285309;12664;515;14033;14479;5.00;0.31;386.36;20.33;1369;50;4990.00;446
12668;43;22285329;12668;514;14034;14479;4.99;0.31;386.36;20.34;1366;51;4991.00;445
12673;43;22285355;12673;509;14044;14492;4.99;0.31;386.48;20.33;1371;51;4992.00;448
12679;43;22285375;12679;504;14044;14492;4.99;0.30;386.62;20.33;1365;51;4993.00;448
12680;43;22285395;12680;495;14046;14492;5.00;0.31;386.65;20.33;1366;51;4994.00;446
12683;43;22285413;12683;489;14047;14494;5.07;0.31;386.64;20.33;1364;51;4995.00;447
12684;43;22285435;12684;485;14047;14494;5.09;0.31;386.64;20.33;1363;51;4996.00;447
12686;43;22285454;12686;480;14050;14498;5.19;0.32;386.69;20.32;1364;51;4997.00;448
12687;43;22285474;12687;483;14051;14498;5.26;0.32;386.76;20.33;1364;51;4998.00;447
12691;43;22285493;12691;474;14055;14502;5.29;0.32;386.87;20.33;1364;51;4999.00;447
12694;43;22285514;12694;469;14055;14502;5.33;0.32;386.89;20.33;1361;51;5000.00;447
12696;43;22285536;12696;471;14055;14502;5.37;0.33;386.89;20.33;1359;51;5001.00;447
12700;43;22285554;12700;466;14055;14502;5.40;0.33;386.96;20.33;1355;51;5002.00;447
12703;43;22285573;12703;461;14055;14502;5.39;0.33;386.96;20.33;1352;51;5003.00;447
12707;43;22285592;12707;449;14064;14514;5.42;0.33;386.97;20.31;1357;51;5004.00;450
12711;43;22285619;12711;452;14064;14514;5.38;0.33;387.04;20.31;1353;51;5005.00;450
12715;43;22285644;12715;445;14064;14514;5.35;0.33;387.07;20.31;1349;51;5006.00;450
12721;43;22285663;12721;443;14064;14514;5.30;0.32;387.15;20.31;1343;51;5007.00;450
12725;43;22285682;12725;441;14064;14514;5.33;0.32;387.23;20.31;1339;51;5008.00;450
12728;43;22285702;12728;441;14064;14514;5.41;0.33;387.28;20.31;1336;51;5009.00;450
12732;43;22285722;12732;434;14064;14515;5.44;0.33;387.33;20.31;1332;51;5010.00;451
12734;43;22285741;12734;445;14064;14515;5.46;0.33;387.38;20.31;1330;51;5011.00;451
12736;43;22285761;12736;438;14069;14521;5.51;0.33;387.44;20.31;1333;51;5012.00;452
12738;43;22285780;12738;448;14069;14522;5.50;0.33;387.45;20.31;1331;51;5013.00;453
12741;44;22285799;12741;443;14069;14522;5.45;0.33;387.45;20.31;1328;52;5014.00;453
12742;44;22285830;12742;449;14069;14522;5.46;0.33;387.43;20.31;1327;52;5015.00;453
12743;44;22285856;12743;441;14072;14526;5.47;0.33;387.45;20.31;1329;52;5016.00;454
12747;44;22285876;12747;445;14072;14526;5.45;0.33;387.49;20.31;1325;52;5017.00;454
12748;44;22285894;12748;455;14072;14526;5.47;0.33;387.46;20.31;1324;52;5018.00;454
12751;44;22285912;12751;463;14073;14527;5.46;0.33;387.59;20.31;1322;52;5019.00;454
12760;44;22285932;12760;459;14076;14531;5.41;0.33;387.66;20.30;1316;52;5020.00;455
12763;44;22285968;12763;464;14076;14531;5.45;0.33;387.67;20.30;1313;52;5021.00;455
12767;44;22285987;12767;467;14077;14534;5.46;0.33;387.76;20.30;1310;52;5022.00;457
12770;44;22286013;12770;478;14077;14534;5.43;0.33;387.81;20.30;1307;52;5023.00;457
12773;44;22286031;12773;483;14077;14534;5.42;0.33;387.91;20.30;1304;52;5024.00;457
12776;44;22286050;12776;483;14077;14534;5.39;0.33;387.93;20.30;1301;52;5025.00;457
12778;44;22286069;12778;492;14080;14538;5.39;0.33;387.96;20.30;1302;52;5026.00;458
12780;44;22286087;12780;496;14080;14538;5.37;0.33;387.98;20.30;1300;52;5027.00;458
12782;44;22286105;12782;499;14080;14538;5.34;0.33;387.99;20.30;1298;52;5028.00;458
12785;44;22286123;12785;503;14080;14538;5.30;0.32;388.01;20.30;1295;52;5029.00;458
12788;44;22286141;12788;502;14080;14539;5.25;0.32;388.02;20.30;1292;52;5030.00;459
12789;44;22286158;12789;507;14080;14540;5.22;0.32;388.00;20.30;1291;52;5031.00;460
12791;44;22286177;12791;518;14080;14540;5.18;0.32;388.12;20.30;1289;52;5032.00;460
12794;44;22286194;12794;517;14081;14541;5.16;0.32;388.13;20.29;1287;52;5033.00;460
12796;44;22286211;12796;519;14081;14541;5.16;0.32;388.15;20.29;1285;52;5034.00;460
12799;44;22286229;12799;522;14081;14541;5.15;0.31;388.20;20.29;1282;52;5035.00;460
12801;44;22286246;12801;526;14081;14541;5.15;0.32;388.23;20.29;1280;52;5036.00;460
12806;44;22286263;12806;525;14081;14541;5.13;0.31;388.38;20.29;1275;52;5037.00;460
12808;44;22286280;12808;527;14081;14541;5.14;0.32;388.42;20.29;1273;52;5038.00;460
12813;44;22286297;12813;530;14081;14541;5.04;0.31;388.47;20.29;1268;52;5039.00;460
12814;44;22286317;12814;558;14167;14771;5.35;0.34;388.48;20.17;1353;52;5040.00;604
12817;44;22286352;12817;553;14174;14772;5.29;0.33;388.55;20.16;1357;52;5041.00;598
12820;44;22286370;12820;561;14182;14772;5.27;0.33;388.53;20.15;1362;52;5042.00;590
12822;44;22286387;12822;562;14187;14772;5.26;0.33;388.55;20.15;1365;52;5043.00;585
12828;45;22286404;12828;563;14194;14772;5.21;0.33;388.71;20.14;1366;53;5044.00;578
12831;45;22286431;12831;566;14199;14772;5.19;0.32;388.86;20.13;1368;53;5045.00;573
12832;45;22286452;12832;566;14206;14772;5.23;0.33;388.86;20.13;1374;53;5046.00;566
12835;45;22286470;12835;571;14210;14772;5.24;0.33;388.95;20.12;1375;53;5047.00;562
12837;45;22286494;12837;572;14216;14773;5.27;0.33;389.07;20.12;1379;53;5048.00;557
12839;45;22286511;12839;574;14220;14774;5.29;0.33;389.05;20.11;1381;53;5049.00;554
12841;45;22286529;12841;569;14225;14774;5.31;0.33;389.14;20.11;1384;53;5050.00;549
12842;45;22286552;12842;562;14228;14775;5.34;0.33;389.18;20.11;1386;53;5051.00;547
12846;45;22286570;12846;566;14230;14775;5.32;0.33;389.19;20.11;1384;53;5052.00;545
12848;45;22286588;12848;571;14234;14775;5.27;0.33;389.21;20.10;1386;53;5053.00;541
12853;45;22286606;12853;584;14235;14775;5.17;0.32;389.21;20.10;1382;53;5054.00;540
12857;45;22286630;12857;578;14237;14779;5.15;0.32;389.29;20.10;1380;53;5055.00;542
12861;45;22286647;12861;578;14241;14779;5.08;0.31;389.28;20.10;1380;53;5056.00;538
12862;45;22286665;12862;580;14241;14779;5.04;0.31;389.27;20.10;1379;53;5057.00;538
12862;45;22286688;12862;583;14242;14782;5.05;0.31;389.27;20.10;1380;53;5058.00;540
12865;45;22286707;12865;589;14244;14782;5.01;0.31;389.27;20.10;1379;53;5059.00;538
12866;45;22286724;12866;590;14245;14782;5.02;0.31;389.25;20.10;1379;53;5060.00;537
12868;45;22286742;12868;588;14247;14786;5.01;0.31;389.24;20.10;1379;53;5061.00;539
12871;45;22286760;12871;592;14249;14787;5.00;0.31;389.32;20.09;1378;53;5062.00;538
12874;45;22286779;12874;588;14250;14787;4.97;0.30;389.29;20.10;1376;53;5063.00;537
12877;45;22286797;12877;592;14253;14791;4.98;0.30;389.30;20.09;1376;53;5064.00;538
12879;45;22286815;12879;599;14255;14791;4.98;0.30;389.29;20.09;1376;53;5065.00;536
12879;45;22286832;12879;614;14257;14791;4.91;0.30;389.29;20.09;1378;53;5066.00;534
12879;45;22286849;12879;623;14257;14792;4.88;0.30;389.29;20.09;1378;53;5067.00;535
12883;45;22286867;12883;631;14258;14792;4.81;0.29;389.23;20.09;1375;53;5068.00;534
12887;45;22286884;12887;640;14263;14798;4.78;0.29;389.27;20.09;1376;53;5069.00;535
12889;45;22286905;12889;643;14263;14798;4.69;0.29;389.27;20.09;1374;53;5070.00;535
12893;45;22286923;12893;649;14263;14799;4.61;0.28;389.24;20.09;1370;53;5071.00;536
12898;45;22286941;12898;648;14263;14799;4.50;0.27;389.28;20.09;1365;53;5072.00;536
12901;45;22286957;12901;653;14263;14799;4.40;0.27;389.25;20.09;1362;53;5073.00;536
12904;45;22286974;12904;656;14263;14799;4.30;0.26;389.23;20.09;1359;53;5074.00;536
12908;45;22286990;12908;649;14263;14799;4.23;0.26;389.20;20.09;1355;53;5075.00;536
12909;45;22287007;12909;651;14271;14811;4.26;0.26;389.18;20.08;1362;53;5076.00;540
12913;45;22287024;12913;654;14271;14811;4.19;0.26;389.16;20.08;1358;53;5077.00;540
12914;45;22287041;12914;651;14271;14811;4.16;0.26;389.13;20.08;1357;53;5078.00;540
12917;45;22287057;12917;649;14271;14811;4.09;0.25;389.09;20.08;1354;53;5079.00;540
12919;45;22287074;12919;656;14271;14811;4.04;0.25;389.05;20.08;1352;53;5080.00;540
12921;45;22287090;12921;647;14271;14811;4.03;0.25;389.11;20.08;1350;53;5081.00;540
12925;45;22287107;12925;641;14272;14815;3.99;0.25;389.05;20.08;1347;53;5082.00;543
12927;45;22287132;12927;638;14272;14815;3.98;0.24;389.03;20.08;1345;53;5083.00;543
12934;45;22287148;12934;633;14275;14819;3.95;0.24;388.92;20.07;1341;53;5084.00;544
12937;45;22287165;12937;631;14276;14821;3.92;0.24;388.89;20.07;1339;53;5085.00;545
12939;45;22287181;12939;626;14276;14821;3.89;0.24;388.86;20.07;1337;53;5086.00;545
12941;45;22287198;12941;618;14276;14821;3.87;0.24;388.85;20.07;1335;53;5087.00;545
12944;45;22287213;12944;624;14286;14834;3.91;0.24;388.80;20.06;1342;53;5088.00;548
12949;45;22287231;12949;624;14286;14834;3.91;0.24;388.79;20.06;1337;53;5089.00;548
12953;45;22287246;12953;620;14286;14834;3.90;0.24;388.76;20.06;1333;53;5090.00;548
12956;45;22287262;12956;607;14287;14835;3.90;0.24;388.73;20.06;1331;53;5091.00;548
12960;45;22287278;12960;601;14287;14836;3.90;0.24;388.72;20.06;1327;53;5092.00;549
12965;45;22287296;12965;593;14287;14836;3.91;0.24;388.70;20.06;1322;53;5093.00;549
12966;45;22287321;12966;583;14288;14839;3.97;0.24;388.75;20.06;1322;53;5094.00;551
12968;45;22287339;12968;581;14288;14839;4.01;0.24;388.76;20.06;1320;53;5095.00;551
12970;46;22287355;12970;571;14289;14839;4.05;0.25;388.74;20.07;1319;54;5096.00;550
12973;46;22287387;12973;572;14289;14839;4.10;0.25;388.75;20.07;1316;54;5097.00;550
12977;46;22287405;12977;563;14294;14845;4.15;0.25;388.70;20.07;1317;54;5098.00;551
12979;46;22287423;12979;565;14295;14845;4.18;0.25;388.70;20.08;1316;54;5099.00;550
12982;46;22287444;12982;569;14299;14864;4.21;0.25;388.68;20.07;1317;54;5100.00;565
12984;46;22287468;12984;560;14300;14864;4.21;0.25;388.67;20.08;1316;54;5101.00;564
12987;46;22287485;12987;556;14303;14868;4.25;0.26;388.66;20.09;1316;54;5102.00;565
12989;46;22287503;12989;554;14304;14869;4.28;0.26;388.72;20.10;1315;54;5103.00;565
12992;46;22287520;12992;553;14307;14869;4.31;0.26;388.67;20.12;1315;54;5104.00;562
12996;46;22287538;12996;554;14308;14870;4.34;0.26;388.67;20.12;1312;54;5105.00;562
12996;46;22287555;12996;552;14314;14870;4.35;0.26;388.67;20.13;1318;54;5106.00;556
12998;46;22287572;12998;549;14316;14870;4.38;0.27;388.67;20.14;1318;54;5107.00;554
13000;46;22287588;13000;549;14318;14870;4.42;0.27;388.65;20.16;1318;54;5108.00;552
13002;46;22287613;13002;552;14321;14870;4.44;0.27;388.62;20.17;1319;54;5109.00;549
13004;46;22287630;13004;549;14322;14870;4.46;0.27;388.59;20.18;1318;54;5110.00;548
13008;46;22287647;13008;549;14323;14870;4.50;0.27;388.64;20.18;1315;54;5111.00;547
13011;46;22287663;13011;553;14359;14940;4.67;0.29;388.67;20.15;1348;54;5112.00;581
13016;46;22287687;13016;544;14362;14941;4.68;0.29;388.74;20.16;1346;54;5113.00;579
13020;46;22287704;13020;547;14370;14941;4.69;0.29;388.81;20.17;1350;54;5114.00;571
13023;46;22287721;13023;541;14374;14941;4.73;0.29;388.80;20.17;1351;54;5115.00;567
13025;46;22287738;13025;532;14377;14941;4.76;0.29;388.84;20.18;1352;54;5116.00;564
13030;46;22287754;13030;533;14380;14941;4.76;0.29;388.92;20.19;1350;54;5117.00;561
13034;46;22287774;13034;530;14386;14941;4.74;0.29;388.92;20.20;1352;54;5118.00;555
13038;46;22287793;13038;537;14391;14941;4.66;0.28;388.99;20.30;1353;54;5119.00;550
13045;46;22287811;13045;547;14393;14942;4.60;0.28;389.06;20.30;1348;54;5120.00;549
13045;46;22287830;13045;553;14397;14943;4.57;0.28;389.06;20.31;1352;54;5121.00;546
13049;46;22287847;13049;548;14400;14943;4.51;0.28;389.14;20.32;1351;54;5122.00;543
13051;46;22287865;13051;546;14407;14947;4.48;0.27;389.14;20.32;1356;54;5123.00;540
13055;46;22287884;13055;545;14409;14947;4.46;0.27;389.21;20.33;1354;54;5124.00;538
13056;46;22287902;13056;546;14411;14947;4.47;0.27;389.29;20.33;1355;54;5125.00;536
13060;46;22287920;13060;544;14412;14947;4.47;0.27;389.41;20.34;1352;54;5126.00;535
13061;46;22287939;13061;541;14416;14953;4.49;0.27;389.43;20.34;1355;54;5127.00;537
13062;46;22287957;13062;549;14419;14953;4.48;0.27;389.50;20.35;1357;54;5128.00;534
13063;46;22287977;13063;558;14419;14953;4.50;0.27;389.48;20.35;1356;54;5129.00;534
13065;46;22287997;13065;559;14424;14959;4.48;0.27;389.58;20.36;1359;54;5130.00;535
13069;46;22288016;13069;541;14425;14959;4.48;0.27;389.62;20.36;1356;54;5131.00;534
13069;46;22288036;13069;523;14429;14959;4.55;0.28;389.62;20.37;1360;54;5132.00;530
13072;46;22288053;13072;522;14432;14960;4.58;0.28;389.73;20.38;1360;54;5133.00;528
13076;46;22288072;13076;512;14434;14961;4.63;0.28;389.79;20.39;1358;54;5134.00;527
13077;46;22288100;13077;524;14435;14961;4.66;0.28;389.78;20.39;1358;54;5135.00;526
13078;46;22288118;13078;510;14446;14974;4.76;0.29;389.83;20.38;1368;54;5136.00;528
13082;46;22288140;13082;509;14448;14974;4.70;0.29;389.84;20.39;1366;54;5137.00;526
13083;46;22288158;13083;512;14449;14974;4.71;0.29;389.86;20.39;1366;54;5138.00;525
13086;46;22288178;13086;518;14452;14975;4.71;0.29;389.89;20.40;1366;54;5139.00;523
13088;46;22288199;13088;517;14454;14975;4.68;0.28;389.84;20.41;1366;54;5140.00;521
13088;46;22288218;13088;520;14458;14979;4.68;0.28;389.84;20.41;1370;54;5141.00;521
13090;46;22288237;13090;520;14458;14979;4.67;0.28;389.81;20.41;1368;54;5142.00;521
13093;46;22288256;13093;531;14463;14983;4.68;0.28;389.80;20.41;1370;54;5143.00;520
13097;46;22288276;13097;524;14464;14983;4.68;0.28;389.96;20.41;1367;54;5144.00;519
13098;46;22288295;13098;524;14465;14983;4.70;0.29;389.98;20.42;1367;54;5145.00;518
13101;46;22288313;13101;527;14465;14983;4.68;0.28;390.04;20.42;1364;54;5146.00;518
13101;46;22288331;13101;530;14466;14983;4.69;0.29;390.04;20.42;1365;54;5147.00;517
13108;46;22288349;13108;530;14476;14995;4.67;0.28;390.31;20.41;1368;54;5148.00;519
13112;46;22288369;13112;541;14477;14995;4.68;0.28;390.37;20.42;1365;54;5149.00;518
13112;46;22288388;13112;540;14477;14995;4.68;0.28;390.37;20.42;1365;54;5150.00;518
13116;46;22288406;13116;543;14478;14995;4.67;0.28;390.39;20.42;1362;54;5151.00;517
13120;46;22288424;13120;543;14478;14995;4.67;0.28;390.42;20.42;1358;54;5152.00;517
13121;46;22288444;13121;537;14478;14995;4.66;0.28;390.45;20.42;1357;54;5153.00;517
13127;46;22288463;13127;540;14480;14996;4.63;0.28;390.46;20.43;1353;54;5154.00;516
13128;46;22288482;13128;543;14482;14998;4.64;0.28;390.47;20.43;1354;54;5155.00;516
13130;46;22288502;13130;531;14485;15004;4.66;0.28;390.44;20.42;1355;54;5156.00;519
13133;46;22288521;13133;532;14486;15005;4.69;0.28;390.46;20.42;1353;54;5157.00;519
13135;46;22288540;13135;526;14488;15005;4.70;0.29;390.46;20.44;1353;54;5158.00;517
13137;46;22288559;13137;528;14489;15005;4.71;0.29;390.47;20.44;1352;54;5159.00;516
13138;46;22288581;13138;527;14494;15010;4.73;0.29;390.53;20.45;1356;54;5160.00;516
13138;46;22288601;13138;528;14495;15010;4.78;0.29;390.53;20.45;1357;54;5161.00;515
13140;46;22288620;13140;526;14497;15010;4.84;0.29;390.56;20.55;1357;54;5162.00;513
13142;46;22288639;13142;523;14500;15011;4.86;0.30;390.55;20.56;1358;54;5163.00;511
13145;46;22288657;13145;523;14503;15015;4.88;0.30;390.58;20.56;1358;54;5164.00;512
13147;46;22288678;13147;515;14503;15015;4.89;0.30;390.65;20.56;1356;54;5165.00;512
13148;46;22288697;13148;501;14506;15018;4.93;0.30;390.63;20.56;1358;54;5166.00;512
13149;46;22288716;13149;499;14507;15018;4.99;0.30;390.64;20.57;1358;54;5167.00;511
13152;46;22288735;13152;501;14507;15018;4.99;0.30;390.75;20.57;1355;54;5168.00;511
13153;46;22288754;13153;486;14509;15018;5.03;0.31;390.74;20.58;1356;54;5169.00;509
13154;46;22288772;13154;482;14513;15022;5.06;0.31;390.75;20.58;1359;54;5170.00;509
13158;46;22288792;13158;479;14514;15022;5.07;0.31;390.74;20.58;1356;54;5171.00;508
13159;46;22288813;13159;471;14515;15022;5.14;0.31;390.74;20.58;1356;54;5172.00;507
13161;46;22288831;13161;463;14516;15022;5.14;0.31;390.75;20.59;1355;54;5173.00;506
13165;46;22288850;13165;467;14516;15023;5.12;0.31;390.73;20.59;1351;54;5174.00;507
13168;46;22288869;13168;467;14518;15025;5.07;0.31;390.81;20.59;1350;54;5175.00;507
13170;46;22288887;13170;462;14518;15025;5.06;0.31;390.79;20.59;1348;54;5176.00;507
13173;46;22288907;13173;471;14519;15026;5.03;0.31;390.92;20.59;1346;54;5177.00;507
13179;46;22288928;13179;473;14521;15026;4.97;0.30;391.06;20.68;1342;54;5178.00;505
13182;46;22288948;13182;464;14522;15026;4.92;0.30;391.10;20.68;1340;54;5179.00;504
13186;46;22288967;13186;455;14522;15026;4.90;0.30;391.09;20.68;1336;54;5180.00;504
13190;46;22288985;13190;456;14522;15026;4.85;0.30;391.06;20.68;1332;54;5181.00;504
13194;46;22289003;13194;456;14522;15026;4.83;0.29;391.13;20.68;1328;54;5182.00;504
13197;46;22289021;13197;453;14522;15026;4.86;0.29;391.17;20.68;1325;54;5183.00;504
13200;46;22289038;13200;474;14591;15153;4.89;0.30;391.15;20.59;1391;54;5184.00;562
13201;46;22289068;13201;459;14591;15154;4.91;0.30;391.17;20.59;1390;54;5185.00;563
13204;46;22289085;13204;449;14593;15154;4.95;0.30;391.26;20.58;1389;54;5186.00;561
13207;46;22289103;13207;458;14596;15154;5.01;0.31;391.25;20.58;1389;54;5187.00;558
13210;47;22289120;13210;461;14598;15154;5.01;0.31;391.26;20.58;1388;55;5188.00;556
13211;47;22289148;13211;462;14602;15154;5.01;0.31;391.24;20.58;1391;55;5189.00;552
13212;47;22289169;13212;455;14604;15154;5.06;0.31;391.26;20.58;1392;55;5190.00;550
13212;47;22289188;13212;468;14605;15154;5.11;0.31;391.26;20.58;1393;55;5191.00;549
13214;47;22289207;13214;479;14606;15155;5.13;0.31;391.25;20.57;1392;55;5192.00;549
13218;47;22289227;13218;484;14610;15156;5.11;0.31;391.29;20.57;1392;55;5193.00;546
13220;47;22289253;13220;487;14611;15156;5.13;0.31;391.29;20.57;1391;55;5194.00;545
13223;47;22289272;13223;492;14614;15157;5.15;0.32;391.34;20.57;1391;55;5195.00;543
13226;47;22289289;13226;500;14616;15157;5.11;0.31;391.43;20.57;1390;55;5196.00;541
13230;47;22289313;13230;504;14616;15157;5.07;0.31;391.43;20.57;1386;55;5197.00;541
13232;47;22289331;13232;510;14617;15157;5.03;0.31;391.50;20.57;1385;55;5198.00;540
13235;47;22289348;13235;518;14622;15161;4.96;0.30;391.53;20.56;1387;55;5199.00;539
13236;47;22289368;13236;535;14623;15161;4.91;0.30;391.57;20.56;1387;55;5200.00;538
13240;47;22289390;13240;529;14623;15161;4.84;0.30;391.50;20.56;1383;55;5201.00;538
13242;47;22289408;13242;539;14624;15164;4.79;0.29;391.48;20.56;1382;55;5202.00;540
13243;47;22289428;13243;544;14624;15164;4.77;0.29;391.54;20.56;1381;55;5203.00;540
13245;47;22289445;13245;550;14624;15164;4.71;0.29;391.54;20.56;1379;55;5204.00;540
13246;47;22289470;13246;562;14627;15168;4.69;0.29;391.58;20.56;1381;55;5205.00;541
13251;47;22289488;13251;564;14628;15169;4.66;0.29;391.63;20.55;1377;55;5206.00;541
13251;47;22289506;13251;566;14628;15169;4.63;0.28;391.63;20.55;1377;55;5207.00;541
13253;47;22289523;13253;579;14631;15173;4.59;0.28;391.64;20.55;1378;55;5208.00;542
13257;47;22289543;13257;591;14631;15173;4.51;0.28;391.85;20.55;1374;55;5209.00;542
13259;47;22289562;13259;594;14631;15173;4.45;0.27;391.87;20.55;1372;55;5210.00;542
13261;47;22289580;13261;602;14631;15174;4.41;0.27;391.83;20.55;1370;55;5211.00;543
13265;47;22289599;13265;608;14631;15174;4.36;0.27;391.90;20.55;1366;55;5212.00;543
13266;47;22289616;13266;615;14635;15180;4.39;0.27;391.90;20.54;1369;55;5213.00;545
13268;47;22289633;13268;623;14635;15180;4.35;0.27;391.87;20.54;1367;55;5214.00;545
13270;47;22289650;13270;618;14635;15180;4.31;0.26;391.91;20.54;1365;55;5215.00;545
13271;47;22289667;13271;627;14635;15181;4.28;0.26;391.91;20.54;1364;55;5216.00;546
13273;47;22289684;13273;626;14635;15181;4.26;0.26;391.91;20.54;1362;55;5217.00;546
13274;47;22289710;13274;631;14635;15181;4.22;0.26;391.97;20.54;1361;55;5218.00;546
13275;47;22289729;13275;635;14635;15181;4.19;0.26;392.01;20.54;1360;55;5219.00;546
13275;47;22289749;13275;648;14659;15217;4.31;0.26;392.01;20.51;1384;55;5220.00;558
13276;47;22289771;13276;647;14659;15217;4.30;0.26;392.03;20.51;1383;55;5221.00;558
13281;47;22289789;13281;654;14660;15217;4.23;0.26;391.98;20.51;1379;55;5222.00;557
13283;47;22289807;13283;653;14660;15217;4.22;0.26;391.98;20.51;1377;55;5223.00;557
13286;47;22289825;13286;655;14660;15217;4.20;0.26;391.94;20.51;1374;55;5224.00;557
13288;47;22289849;13288;656;14660;15217;4.20;0.26;391.89;20.51;1372;55;5225.00;557
13289;47;22289867;13289;649;14662;15221;4.16;0.26;391.87;20.51;1373;55;5226.00;559
13291;47;22289883;13291;646;14663;15221;4.16;0.26;391.86;20.51;1372;55;5227.00;558
13292;47;22289900;13292;654;14665;15225;4.19;0.26;391.84;20.50;1373;55;5228.00;560
13293;47;22289918;13293;657;14665;15226;4.17;0.26;391.84;20.50;1372;55;5229.00;561
13294;47;22289934;13294;662;14665;15226;4.17;0.26;391.82;20.50;1371;55;5230.00;561
13295;47;22289950;13295;669;14665;15226;4.13;0.25;391.82;20.50;1370;55;5231.00;561
13298;47;22289967;13298;666;14675;15239;4.15;0.25;391.78;20.49;1377;55;5232.00;564
13300;47;22289984;13300;664;14675;15239;4.12;0.25;391.72;20.49;1375;55;5233.00;564
13305;47;22290001;13305;666;14675;15239;4.10;0.25;391.79;20.49;1370;55;5234.00;564
13309;47;22290018;13309;666;14676;15240;4.09;0.25;391.72;20.49;1367;55;5235.00;564
13314;47;22290051;13314;664;14676;15241;4.06;0.25;391.64;20.49;1362;55;5236.00;565
13316;47;22290069;13316;668;14676;15241;4.05;0.25;391.63;20.49;1360;55;5237.00;565
13319;47;22290085;13319;666;14677;15244;4.04;0.25;391.59;20.49;1358;55;5238.00;567
13321;47;22290103;13321;664;14678;15244;4.01;0.24;391.57;20.49;1357;55;5239.00;566
13324;47;22290119;13324;668;14678;15244;3.97;0.24;391.56;20.49;1354;55;5240.00;566
13325;47;22290136;13325;684;14678;15244;3.90;0.24;391.55;20.49;1353;55;5241.00;566
13328;47;22290151;13328;690;14681;15250;3.87;0.24;391.53;20.48;1353;55;5242.00;569
13331;47;22290167;13331;700;14681;15250;3.82;0.23;391.52;20.48;1350;55;5243.00;569
13332;47;22290183;13332;699;14681;15250;3.77;0.23;391.49;20.48;1349;55;5244.00;569
13336;47;22290199;13336;702;14681;15250;3.66;0.22;391.45;20.48;1345;55;5245.00;569
13338;47;22290214;13338;709;14684;15254;3.58;0.22;391.43;20.48;1346;55;5246.00;570
13339;47;22290230;13339;706;14684;15255;3.48;0.21;391.41;20.48;1345;55;5247.00;571
13341;47;22290245;13341;693;14684;15255;3.39;0.21;391.39;20.48;1343;55;5248.00;571
13345;47;22290261;13345;685;14685;15256;3.27;0.20;391.41;20.48;1340;55;5249.00;571
13349;47;22290279;13349;677;14685;15256;3.21;0.19;391.34;20.48;1336;55;5250.00;571
13350;47;22290295;13350;669;14685;15256;3.20;0.19;391.33;20.48;1335;55;5251.00;571
13352;47;22290311;13352;657;14685;15256;3.23;0.20;391.29;20.48;1333;55;5252.00;571
13356;47;22290327;13356;652;14685;15256;3.26;0.20;391.32;20.48;1329;55;5253.00;571
13358;47;22290344;13358;643;14685;15256;3.31;0.20;391.34;20.48;1327;55;5254.00;571
13359;47;22290359;13359;638;14685;15256;3.37;0.21;391.33;20.48;1326;55;5255.00;571
13363;47;22290375;13363;641;14716;15326;3.63;0.22;391.38;20.43;1353;55;5256.00;610
13364;47;22290397;13364;627;14720;15327;3.73;0.23;391.37;20.43;1356;55;5257.00;607
13365;47;22290422;13365;612;14727;15327;3.82;0.23;391.36;20.42;1362;55;5258.00;600
13366;47;22290440;13366;608;14731;15327;3.91;0.24;391.37;20.42;1365;55;5259.00;596
13368;47;22290457;13368;602;14732;15327;3.97;0.24;391.36;20.42;1364;55;5260.00;595
13372;47;22290473;13372;590;14733;15327;3.97;0.24;391.32;20.42;1361;55;5261.00;594
13372;47;22290499;13372;585;14734;15327;4.00;0.24;391.32;20.41;1362;55;5262.00;593
13374;47;22290516;13374;585;14735;15327;4.00;0.24;391.33;20.41;1361;55;5263.00;592
13376;47;22290534;13376;580;14737;15328;4.02;0.24;391.31;20.41;1361;55;5264.00;591
13377;47;22290552;13377;575;14739;15330;4.07;0.25;391.29;20.41;1362;55;5265.00;591
13379;47;22290574;13379;572;14741;15330;4.12;0.25;391.30;20.41;1362;55;5266.00;589
13380;47;22290591;13380;571;14745;15334;4.19;0.25;391.31;20.42;1365;55;5267.00;589
13383;47;22290611;13383;569;14746;15334;4.20;0.26;391.36;20.42;1363;55;5268.00;588
13387;47;22290631;13387;566;14746;15334;4.20;0.26;391.32;20.42;1359;55;5269.00;588
13391;47;22290650;13391;561;14746;15334;4.18;0.25;391.34;20.42;1355;55;5270.00;588
13393;47;22290669;13393;571;14749;15340;4.20;0.26;391.31;20.41;1356;55;5271.00;591
13397;47;22290688;13397;571;14751;15340;4.18;0.25;391.29;20.52;1354;55;5272.00;589
13400;47;22290708;13400;563;14752;15340;4.16;0.25;391.22;20.52;1352;55;5273.00;588
13406;47;22290728;13406;552;14753;15343;4.16;0.25;391.27;20.52;1347;55;5274.00;590
13408;47;22290747;13408;545;14754;15343;4.20;0.25;391.29;20.53;1346;55;5275.00;589
13413;47;22290766;13413;542;14754;15343;4.25;0.26;391.30;20.53;1341;56;5276.00;589
13416;47;22290796;13416;544;14756;15344;4.30;0.26;391.32;20.55;1340;56;5277.00;588
13418;47;22290813;13418;541;14757;15345;4.33;0.26;391.40;20.55;1339;56;5278.00;588
13421;47;22290831;13421;542;14757;15345;4.39;0.27;391.44;20.55;1336;56;5279.00;588
13424;47;22290850;13424;543;14776;15371;4.49;0.27;391.44;20.52;1352;56;5280.00;595
13428;47;22290870;13428;544;14779;15371;4.52;0.28;391.44;20.55;1351;56;5281.00;592
13429;47;22290887;13429;543;14782;15371;4.59;0.28;391.43;20.55;1353;56;5282.00;589
13432;47;22290905;13432;542;14782;15372;4.64;0.28;391.42;20.55;1350;56;5283.00;590
13438;48;22290923;13438;548;14785;15372;4.60;0.28;391.43;20.57;1347;57;5284.00;587
13439;48;22290957;13439;546;14787;15376;4.65;0.28;391.41;20.57;1348;57;5285.00;589
13445;48;22290977;13445;547;14788;15376;4.65;0.28;391.48;20.58;1343;57;5286.00;588
13449;48;22290995;13449;548;14791;15379;4.69;0.29;391.49;20.57;1342;57;5287.00;588
13452;48;22291020;13452;549;14794;15380;4.71;0.29;391.52;20.59;1342;57;5288.00;586
13456;48;22291040;13456;552;14794;15380;4.71;0.29;391.55;20.59;1338;57;5289.00;586
13460;48;22291061;13460;554;14796;15380;4.70;0.29;391.63;20.60;1336;57;5290.00;584
13465;48;22291082;13465;557;14797;15380;4.67;0.29;391.71;20.61;1332;57;5291.00;583
13469;48;22291103;13469;553;14809;15392;4.64;0.28;391.82;20.70;1340;57;5292.00;583
13473;48;22291125;13473;552;14812;15392;4.64;0.28;392.02;20.72;1339;57;5293.00;580
13478;48;22291150;13478;555;14812;15392;4.56;0.28;392.09;20.72;1334;57;5294.00;580
13480;48;22291169;13480;552;14813;15392;4.54;0.28;392.06;20.72;1333;57;5295.00;579
13483;48;22291186;13483;556;14817;15392;4.49;0.28;392.07;20.94;1334;58;5296.00;575
13490;48;22291217;13490;559;14819;15392;4.45;0.27;392.14;20.94;1329;58;5297.00;573
13492;48;22291235;13492;560;14821;15393;4.46;0.27;392.20;20.96;1329;58;5298.00;572
13494;48;22291252;13494;555;14821;15393;4.46;0.27;392.26;20.96;1327;58;5299.00;572
13497;48;22291271;13497;558;14825;15399;4.47;0.27;392.26;20.95;1328;58;5300.00;574
13500;48;22291295;13500;558;14827;15400;4.46;0.27;392.47;20.96;1327;58;5301.00;573
13503;48;22291313;13503;557;14827;15400;4.43;0.27;392.64;20.96;1324;58;5302.00;573
13506;48;22291330;13506;561;14827;15400;4.46;0.27;392.62;20.96;1321;58;5303.00;573
13508;48;22291348;13508;563;14832;15404;4.50;0.28;392.66;20.97;1324;58;5304.00;572
13511;48;22291366;13511;565;14833;15404;4.48;0.27;392.67;20.98;1322;58;5305.00;571
13517;48;22291390;13517;562;14834;15404;4.48;0.27;392.83;20.99;1317;58;5306.00;570
13518;48;22291416;13518;557;14836;15405;4.52;0.28;392.86;20.99;1318;58;5307.00;569
13519;48;22291433;13519;555;14840;15409;4.56;0.28;392.90;21.00;1321;58;5308.00;569
13524;48;22291452;13524;552;14841;15409;4.58;0.28;393.07;21.00;1317;58;5309.00;568
13527;48;22291474;13527;554;14844;15415;4.58;0.28;393.25;21.00;1317;58;5310.00;571
13530;48;22291493;13530;557;14846;15415;4.54;0.28;393.34;21.01;1316;58;5311.00;569
13533;48;22291511;13533;563;14847;15415;4.52;0.28;393.41;21.01;1314;58;5312.00;568
13535;48;22291529;13535;563;14848;15415;4.54;0.28;393.51;21.02;1313;58;5313.00;567
13537;48;22291547;13537;561;14850;15419;4.57;0.28;393.57;21.02;1313;58;5314.00;569
13538;48;22291566;13538;565;14852;15419;4.58;0.28;393.63;21.03;1314;58;5315.00;567
13540;48;22291584;13540;561;14852;15419;4.56;0.28;393.65;21.03;1312;58;5316.00;567
13541;48;22291603;13541;561;14853;15419;4.60;0.28;393.68;21.03;1312;58;5317.00;566
13541;48;22291620;13541;552;14854;15420;4.64;0.28;393.68;21.04;1313;58;5318.00;566
13544;48;22291639;13544;550;14855;15421;4.66;0.29;393.82;21.04;1311;58;5319.00;566
13545;48;22291656;13545;539;14856;15421;4.68;0.29;393.90;21.05;1311;58;5320.00;565
13549;48;22291674;13549;533;14858;15422;4.73;0.29;394.00;21.06;1309;58;5321.00;564
13550;48;22291693;13550;531;14858;15422;4.77;0.29;394.02;21.06;1308;58;5322.00;564
13552;48;22291711;13552;532;14861;15422;4.81;0.29;394.06;21.17;1309;58;5323.00;561
13554;48;22291730;13554;534;14861;15422;4.88;0.30;394.08;21.17;1307;58;5324.00;561
13557;48;22291747;13557;532;14861;15422;4.92;0.30;394.10;21.17;1304;58;5325.00;561
13559;48;22291766;13559;532;14863;15422;5.00;0.31;394.14;21.18;1304;58;5326.00;559
13560;48;22291784;13560;524;14865;15422;5.06;0.31;394.17;21.19;1305;58;5327.00;557
13564;48;22291802;13564;551;14936;15549;5.14;0.32;394.25;21.09;1372;58;5328.00;613
13565;48;22291833;13565;543;14937;15550;5.17;0.32;394.28;21.10;1372;58;5329.00;613
13567;48;22291851;13567;523;14942;15550;5.24;0.32;394.30;21.10;1375;58;5330.00;608
13571;48;22291870;13571;521;14943;15550;5.24;0.32;394.27;21.10;1372;58;5331.00;607
13575;48;22291889;13575;517;14947;15550;5.27;0.33;394.39;21.11;1372;58;5332.00;603
13577;48;22291908;13577;516;14947;15550;5.26;0.32;394.45;21.11;1370;58;5333.00;603
13580;48;22291928;13580;528;14949;15550;5.24;0.32;394.51;21.12;1369;58;5334.00;601
13581;48;22291946;13581;529;14952;15550;5.24;0.32;394.53;21.21;1371;58;5335.00;598
13584;48;22291966;13584;534;14952;15551;5.20;0.32;394.52;21.21;1368;58;5336.00;599
13586;48;22291984;13586;540;14956;15552;5.22;0.32;394.55;21.30;1370;58;5337.00;596
13588;48;22292003;13588;533;14958;15552;5.20;0.32;394.55;21.31;1370;58;5338.00;594
13589;48;22292021;13589;542;14960;15553;5.18;0.32;394.54;21.31;1371;58;5339.00;593
13591;48;22292042;13591;542;14964;15553;5.16;0.32;394.52;21.40;1373;58;5340.00;589
13593;48;22292061;13593;539;14967;15553;5.16;0.32;394.59;21.41;1374;58;5341.00;586
13593;48;22292082;13593;534;14970;15553;5.16;0.32;394.59;21.50;1377;58;5342.00;583
13595;48;22292101;13595;534;14974;15557;5.15;0.32;394.63;21.49;1379;58;5343.00;583
13595;48;22292121;13595;534;14977;15557;5.14;0.31;394.63;21.50;1382;58;5344.00;580
13596;48;22292140;13596;536;14980;15557;5.12;0.31;394.63;21.60;1384;58;5345.00;577
13598;48;22292160;13598;534;14983;15560;5.08;0.31;394.64;21.61;1385;58;5346.00;577
13600;48;22292179;13600;533;14984;15560;5.08;0.31;394.64;21.60;1384;58;5347.00;576
13603;48;22292199;13603;529;14986;15560;5.05;0.31;394.68;21.61;1383;58;5348.00;574
13606;48;22292219;13606;525;14990;15564;5.06;0.31;394.67;21.71;1384;58;5349.00;574
13609;48;22292238;13609;522;14991;15565;5.04;0.31;394.71;21.70;1382;58;5350.00;574
13612;48;22292257;13612;521;14992;15565;5.03;0.31;394.68;21.71;1380;58;5351.00;573
13615;48;22292276;13615;506;14996;15569;4.97;0.30;394.79;21.71;1381;58;5352.00;573
13617;48;22292296;13617;498;14998;15569;4.93;0.30;394.79;21.72;1381;58;5353.00;571
13620;48;22292315;13620;499;15000;15569;4.89;0.30;394.83;21.72;1380;58;5354.00;569
13623;48;22292334;13623;498;15002;15571;4.78;0.29;394.92;21.71;1379;58;5355.00;569
13625;48;22292352;13625;498;15003;15571;4.75;0.29;394.98;21.72;1378;58;5356.00;568
13631;48;22292371;13631;492;15009;15577;4.75;0.29;395.08;21.72;1378;58;5357.00;568
13633;48;22292399;13633;485;15011;15577;4.77;0.29;395.18;21.72;1378;58;5358.00;566
13638;48;22292418;13638;490;15011;15577;4.68;0.28;395.33;21.72;1373;58;5359.00;566
13643;48;22292437;13643;501;15012;15578;4.62;0.28;395.52;21.72;1369;58;5360.00;566
13644;48;22292455;13644;502;15015;15578;4.58;0.28;395.51;21.73;1371;58;5361.00;563
13648;48;22292482;13648;494;15015;15578;4.53;0.28;395.66;21.73;1367;58;5362.00;563
13650;48;22292502;13650;499;15016;15578;4.48;0.27;395.66;21.73;1366;58;5363.00;562
13650;48;22292519;13650;504;15025;15590;4.53;0.28;395.66;21.72;1375;59;5364.00;565
13652;48;22292545;13652;511;15025;15590;4.53;0.28;395.65;21.72;1373;59;5365.00;565
13652;48;22292563;13652;509;15026;15590;4.52;0.28;395.65;21.72;1374;59;5366.00;564
13655;48;22292583;13655;510;15026;15590;4.52;0.28;395.62;21.72;1371;59;5367.00;564
13657;48;22292602;13657;517;15027;15590;4.53;0.28;395.64;21.72;1370;59;5368.00;563
13659;48;22292620;13659;512;15027;15590;4.54;0.28;395.61;21.72;1368;59;5369.00;563
13663;48;22292641;13663;518;15030;15594;4.58;0.28;395.60;21.72;1367;59;5370.00;564
13663;48;22292660;13663;514;15031;15594;4.63;0.28;395.60;21.72;1368;59;5371.00;563
13666;48;22292679;13666;511;15033;15598;4.64;0.29;395.59;21.72;1367;59;5372.00;565
13666;48;22292706;13666;517;15034;15599;4.65;0.29;395.59;21.72;1368;59;5373.00;565
13667;48;22292725;13667;521;15034;15599;4.64;0.29;395.60;21.72;1367;59;5374.00;565
13671;48;22292744;13671;533;15035;15599;4.57;0.28;395.58;21.72;1364;59;5375.00;564
13674;48;22292766;13674;535;15046;15612;4.55;0.28;395.60;21.81;1372;59;5376.00;566
13676;48;22292791;13676;546;15048;15612;4.53;0.28;395.55;21.81;1372;59;5377.00;564
13679;48;22292809;13679;543;15048;15612;4.46;0.27;395.57;21.81;1369;59;5378.00;564
13683;48;22292828;13683;560;15050;15613;4.43;0.27;395.66;21.81;1367;59;5379.00;563
13685;48;22292847;13685;563;15051;15614;4.36;0.27;395.64;21.92;1366;59;5380.00;563
13685;48;22292866;13685;572;15051;15614;4.33;0.27;395.64;21.92;1366;59;5381.00;563
13688;48;22292884;13688;576;15052;15617;4.28;0.26;395.63;21.92;1364;59;5382.00;565
13689;48;22292902;13689;585;15053;15617;4.23;0.26;395.63;22.03;1364;59;5383.00;564
13690;48;22292920;13690;587;15054;15617;4.23;0.26;395.62;22.13;1364;59;5384.00;563
13691;48;22292938;13691;594;15055;15617;4.21;0.26;395.61;22.24;1364;59;5385.00;562
13692;48;22292955;13692;598;15059;15623;4.24;0.26;395.58;22.24;1367;59;5386.00;564
13697;48;22292974;13697;611;15059;15623;4.20;0.26;395.60;22.24;1362;59;5387.00;564
13699;48;22292991;13699;615;15060;15623;4.16;0.25;395.56;22.34;1361;59;5388.00;563
13701;48;22293010;13701;618;15061;15623;4.12;0.25;395.52;22.45;1360;59;5389.00;562
13704;48;22293027;13704;622;15064;15627;4.08;0.25;395.46;22.45;1360;59;5390.00;563
13708;48;22293044;13708;623;15065;15628;4.03;0.25;395.44;22.55;1357;59;5391.00;563
13711;48;22293062;13711;629;15065;15628;3.96;0.24;395.38;22.55;1354;59;5392.00;563
13715;48;22293086;13715;626;15066;15629;3.89;0.24;395.32;22.55;1351;59;5393.00;563
13716;48;22293104;13716;636;15066;15629;3.86;0.24;395.32;22.55;1350;59;5394.00;563
13718;48;22293120;13718;641;15066;15629;3.83;0.23;395.33;22.55;1348;59;5395.00;563
13721;48;22293137;13721;649;15066;15629;3.80;0.23;395.34;22.55;1345;59;5396.00;563
13723;48;22293152;13723;646;15066;15629;3.76;0.23;395.34;22.55;1343;59;5397.00;563
13723;48;22293169;13723;651;15066;15629;3.77;0.23;395.34;22.55;1343;59;5398.00;563
13723;48;22293184;13723;654;15066;15629;3.74;0.23;395.34;22.55;1343;59;5399.00;563
