step_arrived;step_collisions;step_duration;step_ended;step_halting;step_inserted;step_loaded;step_meanSpeed;step_meanSpeedRelative;step_meanTravelTime;step_meanWaitingTime;step_running;step_teleports;step_time;step_waiting
0;0;21830466;0;1;85;245;16.47;1.16;-1.00;0.00;85;0;0.00;160
0;0;21830496;0;1;100;245;15.49;1.07;-1.00;0.15;100;0;1.00;145
0;0;21830497;0;0;119;245;14.65;1.00;-1.00;0.45;119;0;2.00;126
0;0;21830498;0;1;133;245;13.66;0.92;-1.00;0.71;133;0;3.00;112
0;0;21830500;0;3;148;245;12.39;0.83;-1.00;1.05;148;0;4.00;97
0;0;21830501;0;4;153;245;11.58;0.78;-1.00;1.18;153;0;5.00;92
0;0;21830502;0;4;168;245;10.72;0.71;-1.00;1.61;168;0;6.00;77
0;0;21830504;0;14;175;245;10.24;0.68;-1.00;1.82;175;0;7.00;70
0;0;21830505;0;19;187;246;9.54;0.63;-1.00;2.22;187;0;8.00;59
0;0;21830508;0;21;192;247;9.31;0.62;-1.00;2.40;192;0;9.00;55
0;0;21830512;0;21;201;247;9.08;0.60;-1.00;2.74;201;0;10.00;46
0;0;21830514;0;23;204;248;9.06;0.60;-1.00;2.81;204;0;11.00;44
2;0;21830516;2;28;208;248;8.77;0.57;12.00;2.99;206;0;12.00;40
2;0;21830519;2;30;212;248;8.53;0.56;12.00;3.17;210;0;13.00;36
2;0;21830521;2;38;216;248;8.49;0.55;12.00;3.38;214;0;14.00;32
2;0;21830523;2;46;220;252;8.36;0.54;12.00;3.46;218;0;15.00;32
2;0;21830527;2;46;225;252;8.22;0.53;12.00;3.64;223;0;16.00;27
2;0;21830530;2;50;227;252;8.15;0.52;12.00;3.76;225;0;17.00;25
2;0;21830532;2;60;229;255;8.12;0.52;12.00;3.81;227;0;18.00;26
3;0;21830535;3;64;234;255;7.98;0.51;14.33;4.13;231;0;19.00;21
5;0;21830538;5;67;236;255;8.01;0.51;16.60;4.27;231;0;20.00;19
5;0;21830541;5;70;241;259;8.18;0.52;16.60;4.28;236;0;21.00;18
6;0;21830545;6;74;242;260;8.20;0.52;17.33;4.27;236;0;22.00;18
6;0;21830549;6;78;244;260;8.13;0.51;17.33;4.42;238;0;23.00;16
6;0;21830551;6;81;247;264;8.11;0.51;17.33;4.47;241;0;24.00;17
6;0;21830555;6;84;250;264;8.04;0.50;17.33;4.62;244;0;25.00;14
6;0;21830557;6;86;250;264;8.14;0.51;17.33;4.62;244;0;26.00;14
6;0;21830562;6;84;251;265;8.22;0.51;17.33;4.71;245;0;27.00;14
6;0;21830566;6;87;252;265;8.28;0.51;17.33;4.70;246;0;28.00;13
6;0;21830569;6;89;257;271;8.31;0.51;17.33;4.63;251;0;29.00;14
7;0;21830574;7;90;259;271;8.42;0.52;19.14;4.77;252;0;30.00;12
8;0;21830579;8;92;260;272;8.44;0.52;20.25;4.76;252;0;31.00;12
8;0;21830582;8;94;260;272;8.57;0.53;20.25;4.76;252;0;32.00;12
9;0;21830585;9;96;261;272;8.62;0.53;21.67;4.87;252;0;33.00;11
9;0;21830589;9;100;263;272;8.67;0.54;21.67;5.02;254;0;34.00;9
10;0;21830592;10;105;264;272;8.69;0.54;23.00;5.13;254;0;35.00;8
11;0;21830597;11;107;274;284;8.87;0.55;23.55;4.95;263;0;36.00;10
11;0;21830602;11;109;275;284;8.83;0.55;23.55;4.96;264;0;37.00;9
12;0;21830605;12;110;276;284;8.70;0.54;24.33;5.08;264;0;38.00;8
12;0;21830609;12;112;276;284;8.55;0.53;24.33;5.08;264;0;39.00;8
14;0;21830614;14;116;277;284;8.28;0.52;26.07;5.17;263;0;40.00;7
14;0;21830617;14;120;278;284;8.11;0.51;26.07;5.24;264;0;41.00;6
15;0;21830620;15;123;284;288;8.04;0.50;26.67;5.21;269;0;42.00;4
16;0;21830625;16;127;285;288;7.88;0.49;27.31;5.22;269;0;43.00;3
18;0;21830629;18;133;288;292;7.72;0.48;28.00;5.18;270;0;44.00;4
19;0;21830634;19;134;290;294;7.60;0.47;28.79;5.14;271;0;45.00;4
19;0;21830637;19;135;290;294;7.36;0.46;28.79;5.14;271;0;46.00;4
19;0;21830640;19;139;291;294;7.32;0.46;28.79;5.14;272;0;47.00;3
19;0;21830644;19;143;302;307;7.60;0.47;28.79;4.95;283;0;48.00;5
19;0;21830649;19;145;302;307;7.48;0.47;28.79;4.95;283;0;49.00;5
19;0;21830651;19;145;302;307;7.43;0.47;28.79;4.95;283;0;50.00;5
19;0;21830655;19;146;303;308;7.46;0.47;28.79;4.94;284;0;51.00;5
20;0;21830657;20;146;304;309;7.46;0.47;29.90;4.92;284;0;52.00;5
21;0;21830663;21;150;304;309;7.43;0.46;30.10;4.92;283;0;53.00;5
23;0;21830666;23;153;306;312;7.45;0.46;30.52;4.89;283;0;54.00;6
24;0;21830670;24;153;306;312;7.42;0.46;31.54;4.89;282;0;55.00;6
25;0;21830672;25;141;307;312;7.44;0.46;32.52;4.88;282;0;56.00;5
26;0;21830677;26;139;307;312;7.38;0.46;32.54;4.88;281;0;57.00;5
28;0;21830680;28;139;312;318;7.38;0.45;34.21;4.82;284;0;58.00;6
28;0;21830684;28;141;312;318;7.43;0.46;34.21;4.82;284;0;59.00;6
28;0;21830689;28;143;312;318;7.46;0.46;34.21;4.82;284;0;60.00;6
29;0;21830694;29;146;313;318;7.44;0.46;35.14;4.82;284;0;61.00;5
29;0;21830696;29;149;317;322;7.43;0.46;35.14;4.77;288;0;62.00;5
29;0;21830699;29;153;318;323;7.57;0.47;35.14;4.75;289;0;63.00;5
31;0;21830702;31;155;318;323;7.59;0.46;36.65;4.75;287;0;64.00;5
31;0;21830705;31;156;319;324;7.63;0.47;36.65;4.74;288;0;65.00;5
31;0;21830709;31;157;319;324;7.67;0.47;36.65;4.74;288;0;66.00;5
32;0;21830713;32;145;319;324;7.73;0.47;37.34;4.74;287;0;67.00;5
34;0;21830717;34;140;319;324;7.81;0.47;37.91;4.74;285;0;68.00;5
35;0;21830720;35;136;319;324;7.89;0.48;38.80;4.74;284;0;69.00;5
35;0;21830723;35;133;319;324;8.07;0.49;38.80;4.74;284;0;70.00;5
37;0;21830727;37;131;319;324;8.23;0.50;39.97;4.74;282;0;71.00;5
37;0;21830730;37;136;351;394;8.44;0.52;39.97;4.31;314;0;72.00;43
37;0;21830739;37;129;352;395;8.59;0.52;39.97;4.30;315;0;73.00;43
37;0;21830743;37;120;358;395;8.94;0.55;39.97;4.26;321;0;74.00;37
37;0;21830748;37;120;360;395;9.14;0.56;39.97;4.26;323;0;75.00;35
38;0;21830751;38;117;363;395;9.37;0.57;40.92;4.25;325;0;76.00;32
38;0;21830755;38;117;364;395;9.56;0.58;40.92;4.26;326;0;77.00;31
38;0;21830760;38;118;367;395;9.73;0.59;40.92;4.27;329;0;78.00;28
38;0;21830765;38;119;368;395;9.74;0.59;40.92;4.28;330;0;79.00;27
38;0;21830768;38;119;371;396;9.78;0.60;40.92;4.31;333;0;80.00;25
38;0;21830772;38;119;373;397;9.81;0.60;40.92;4.33;335;0;81.00;24
39;0;21830778;39;120;376;397;9.82;0.60;41.62;4.38;337;0;82.00;21
39;0;21830782;39;122;383;401;9.65;0.59;41.62;4.39;344;0;83.00;18
40;0;21830786;40;127;385;401;9.54;0.58;42.67;4.41;345;0;84.00;16
41;0;21830790;41;128;386;401;9.46;0.57;43.71;4.41;345;0;85.00;15
42;0;21830795;42;130;386;401;9.28;0.56;44.69;4.41;344;0;86.00;15
43;0;21830800;43;128;391;407;9.11;0.55;45.67;4.37;348;0;87.00;16
44;0;21830805;44;130;391;407;8.99;0.55;46.64;4.37;347;0;88.00;16
47;0;21830810;47;131;391;407;8.86;0.54;49.34;4.37;344;0;89.00;16
48;0;21830817;48;130;395;413;8.88;0.54;50.06;4.33;347;0;90.00;18
49;0;21830821;49;130;395;413;8.90;0.54;50.78;4.33;346;0;91.00;18
50;0;21830826;50;132;397;413;8.98;0.54;51.60;4.31;347;0;92.00;16
52;0;21830830;52;134;398;414;8.86;0.54;53.19;4.31;346;0;93.00;16
54;0;21830834;54;133;399;415;8.77;0.53;54.70;4.30;345;0;94.00;16
54;0;21830838;54;133;399;415;8.77;0.53;54.70;4.30;345;0;95.00;16
56;0;21830842;56;137;410;428;8.67;0.53;56.18;4.18;354;0;96.00;18
56;0;21830847;56;135;410;428;8.68;0.53;56.18;4.18;354;0;97.00;18
60;0;21830851;60;136;410;428;8.58;0.52;58.80;4.18;350;0;98.00;18
60;0;21830855;60;136;411;429;8.63;0.53;58.80;4.17;351;0;99.00;18
60;0;21830859;60;137;411;429;8.64;0.53;58.80;4.17;351;0;100.00;18
61;0;21830867;61;137;414;433;8.79;0.54;58.31;4.15;353;0;101.00;19
62;0;21830871;62;136;414;433;8.84;0.54;58.98;4.15;352;0;102.00;19
65;0;21830875;65;137;418;437;8.73;0.53;60.91;4.12;353;0;103.00;19
65;0;21830880;65;135;418;437;8.82;0.54;60.91;4.12;353;0;104.00;19
67;0;21830883;67;132;418;437;8.95;0.55;61.90;4.12;351;0;105.00;19
68;0;21830887;68;127;418;437;9.04;0.55;62.43;4.12;350;0;106.00;19
69;0;21830891;69;118;418;437;9.14;0.56;63.03;4.12;349;0;107.00;19
69;0;21830896;69;111;429;449;9.29;0.57;63.03;4.01;360;0;108.00;20
69;0;21830901;69;108;430;449;9.43;0.58;63.03;4.01;361;0;109.00;19
69;0;21830906;69;104;432;449;9.45;0.58;63.03;4.16;363;0;110.00;17
69;0;21830912;69;97;432;449;9.57;0.58;63.03;4.16;363;0;111.00;17
69;0;21830916;69;94;432;449;9.71;0.59;63.03;4.16;363;0;112.00;17
69;0;21830920;69;89;432;449;9.77;0.60;63.03;4.16;363;0;113.00;17
69;0;21830925;69;89;433;450;9.85;0.60;63.03;4.16;364;0;114.00;17
69;0;21830930;69;86;433;450;9.97;0.61;63.03;4.16;364;0;115.00;17
71;0;21830934;71;82;438;456;10.10;0.62;64.52;4.12;367;0;116.00;18
71;0;21830939;71;80;438;457;10.22;0.63;64.52;4.12;367;0;117.00;19
73;0;21830944;73;75;439;457;10.27;0.63;65.47;4.11;366;0;118.00;18
75;0;21830950;75;74;439;457;10.44;0.64;66.52;4.11;364;0;119.00;18
76;0;21830956;76;76;443;462;10.65;0.65;67.22;4.08;367;0;120.00;19
77;0;21830962;77;74;443;462;10.77;0.66;67.90;4.08;366;0;121.00;19
77;0;21830967;77;72;444;462;10.77;0.66;67.90;4.34;367;0;122.00;18
79;0;21830973;79;73;445;463;10.89;0.66;69.18;4.33;366;0;123.00;18
81;0;21830979;81;74;449;467;10.83;0.66;70.49;4.31;368;0;124.00;18
81;0;21830985;81;75;450;467;10.89;0.66;70.49;4.57;369;0;125.00;17
81;0;21830990;81;75;454;470;10.99;0.67;70.49;4.77;373;0;126.00;16
83;0;21830996;83;78;455;470;11.01;0.67;71.78;5.04;372;0;127.00;15
83;0;21831002;83;80;456;470;11.07;0.67;71.78;5.03;373;0;128.00;14
84;0;21831008;84;81;459;470;11.08;0.68;72.45;5.42;375;0;129.00;11
87;0;21831014;87;84;463;474;11.17;0.68;74.28;5.56;376;0;130.00;11
89;0;21831020;89;86;463;474;11.31;0.69;75.53;5.56;374;0;131.00;11
90;0;21831026;90;87;465;474;11.42;0.70;76.14;5.80;375;0;132.00;9
92;0;21831032;92;88;466;474;11.48;0.70;76.18;5.91;374;0;133.00;8
92;0;21831037;92;91;468;475;11.54;0.70;76.18;5.99;376;0;134.00;7
92;0;21831043;92;92;472;477;11.50;0.70;76.18;6.15;380;0;135.00;5
92;0;21831049;92;92;473;477;11.51;0.70;76.18;6.18;381;0;136.00;4
93;0;21831054;93;94;475;478;11.58;0.71;76.06;6.17;382;0;137.00;3
94;0;21831061;94;95;476;478;11.61;0.71;75.96;6.25;382;0;138.00;2
96;0;21831066;96;100;476;478;11.68;0.72;77.24;6.25;380;0;139.00;2
97;0;21831072;97;101;476;478;11.73;0.72;77.89;6.25;379;0;140.00;2
98;0;21831078;98;101;477;478;11.72;0.72;78.53;6.33;379;0;141.00;1
101;0;21831083;101;102;477;478;11.65;0.71;79.32;6.33;376;0;142.00;1
103;0;21831088;103;102;478;478;11.61;0.71;80.52;6.37;375;0;143.00;0
105;0;21831095;105;124;553;605;11.20;0.70;81.34;5.51;448;0;144.00;52
106;0;21831113;106;117;559;606;11.08;0.69;81.49;5.46;453;0;145.00;47
107;0;21831120;107;112;568;606;10.96;0.69;82.09;5.40;461;0;146.00;38
108;0;21831127;108;110;571;606;10.86;0.68;82.69;5.39;463;0;147.00;35
110;0;21831133;110;113;575;606;10.72;0.67;83.41;5.38;465;0;148.00;31
111;0;21831140;111;113;577;606;10.60;0.66;83.88;5.38;466;0;149.00;29
112;0;21831149;112;113;582;611;10.45;0.65;84.34;5.37;470;0;150.00;29
114;0;21831157;114;111;585;611;10.48;0.65;84.45;5.37;471;0;151.00;26
117;0;21831164;117;111;588;612;10.41;0.65;84.85;5.39;471;0;152.00;24
117;0;21831171;117;115;592;613;10.38;0.65;84.85;5.41;475;0;153.00;21
119;0;21831179;119;117;593;613;10.38;0.64;85.50;5.42;474;0;154.00;20
121;0;21831188;121;119;597;614;10.28;0.64;86.50;5.43;476;0;155.00;17
122;0;21831196;122;121;601;614;10.15;0.63;87.07;5.46;479;0;156.00;13
126;0;21831205;126;123;602;614;10.06;0.63;88.12;5.48;476;0;157.00;12
128;0;21831212;128;126;603;614;10.04;0.62;89.19;5.49;475;0;158.00;11
131;0;21831219;131;134;608;618;9.93;0.62;89.54;5.49;477;0;159.00;10
132;0;21831227;132;139;609;618;9.97;0.62;90.08;5.48;477;0;160.00;9
134;0;21831233;134;143;610;618;9.98;0.62;90.52;5.50;476;0;161.00;8
136;0;21831239;136;151;612;621;10.01;0.62;91.54;5.48;476;0;162.00;9
138;0;21831246;138;156;613;621;9.98;0.62;92.39;5.51;475;0;163.00;8
139;0;21831252;139;159;613;621;9.90;0.61;92.91;5.51;474;0;164.00;8
139;0;21831259;139;166;617;625;9.74;0.60;92.91;5.51;478;0;165.00;8
140;0;21831265;140;165;619;626;9.72;0.60;92.74;5.53;479;0;166.00;7
140;1;21831272;140;163;620;626;9.62;0.60;92.74;5.56;480;1;167.00;6
142;1;21831293;142;163;623;630;9.61;0.59;92.94;5.53;481;1;168.00;7
144;1;21831300;144;161;625;630;9.47;0.58;92.99;5.55;481;1;169.00;5
147;1;21831306;147;160;627;630;9.47;0.58;94.44;5.58;480;1;170.00;3
149;1;21831312;149;161;628;631;9.45;0.58;95.38;5.57;479;1;171.00;3
150;1;21831318;150;160;629;631;9.34;0.58;95.83;5.60;479;1;172.00;2
152;1;21831324;152;161;634;637;9.31;0.57;96.20;5.57;482;1;173.00;3
154;1;21831331;154;160;636;637;9.13;0.56;96.88;5.57;482;1;174.00;1
155;1;21831340;155;149;637;638;9.11;0.56;97.28;5.56;482;1;175.00;1
159;1;21831347;159;144;637;638;9.08;0.56;98.30;5.56;478;1;176.00;1
160;1;21831353;160;141;637;638;9.06;0.56;98.66;5.56;477;1;177.00;1
162;1;21831360;162;137;637;638;9.09;0.56;99.14;5.56;475;1;178.00;1
163;1;21831366;163;132;637;638;9.11;0.56;99.61;5.56;474;1;179.00;1
163;1;21831375;163;135;668;672;9.25;0.57;99.61;5.30;505;1;180.00;4
163;1;21831384;163;134;668;672;9.34;0.58;99.61;5.30;505;1;181.00;4
163;1;21831391;163;130;670;672;9.50;0.59;99.61;5.29;507;1;182.00;2
164;1;21831398;164;128;670;672;9.52;0.59;99.57;5.29;506;1;183.00;2
166;1;21831404;166;126;672;672;9.52;0.59;99.73;5.33;506;1;184.00;0
168;1;21831411;168;125;672;672;9.48;0.58;99.37;5.33;504;1;185.00;0
168;1;21831417;168;120;676;676;9.36;0.58;99.37;5.31;508;1;186.00;0
169;1;21831423;169;119;676;676;9.29;0.57;99.24;5.31;507;1;187.00;0
171;1;21831430;171;126;680;680;9.26;0.57;99.47;5.28;509;1;188.00;0
172;1;21831436;172;129;681;681;9.24;0.57;99.63;5.27;509;1;189.00;0
173;1;21831443;173;133;681;681;9.33;0.57;100.16;5.27;508;1;190.00;0
174;1;21831449;174;144;681;681;9.36;0.58;100.40;5.27;507;1;191.00;0
176;1;21831454;176;150;694;694;9.34;0.58;100.74;5.18;518;1;192.00;0
179;1;21831462;179;154;694;694;9.27;0.57;101.44;5.18;515;1;193.00;0
181;1;21831468;181;160;694;694;9.16;0.57;101.17;5.18;513;1;194.00;0
185;1;21831474;185;162;695;695;9.05;0.56;101.74;5.17;510;1;195.00;0
188;1;21831480;188;162;696;696;8.79;0.54;100.80;5.16;508;1;196.00;0
189;1;21831486;189;166;696;696;8.68;0.54;101.28;5.16;507;1;197.00;0
191;1;21831493;191;170;698;699;8.66;0.53;101.01;5.15;507;1;198.00;1
194;1;21831499;194;178;698;699;8.60;0.53;100.84;5.15;504;1;199.00;1
197;1;21831506;197;185;699;699;8.57;0.53;101.35;5.14;502;1;200.00;0
200;1;21831516;200;185;699;699;8.44;0.52;101.86;5.14;499;1;201.00;0
202;1;21831522;202;186;705;705;8.38;0.51;101.41;5.11;503;1;202.00;0
202;1;21831529;202;193;705;705;8.33;0.51;101.41;5.11;503;1;203.00;0
204;1;21831535;204;198;705;705;8.25;0.51;101.80;5.11;501;1;204.00;0
207;1;21831541;207;200;705;705;8.11;0.50;101.41;5.11;498;1;205.00;0
209;1;21831547;209;201;709;709;8.00;0.49;101.03;5.09;500;1;206.00;0
211;1;21831553;211;202;710;710;7.88;0.48;100.67;5.08;499;1;207.00;0
214;1;21831559;214;204;710;710;7.74;0.48;100.78;5.08;496;1;208.00;0
217;1;21831565;217;212;711;711;7.60;0.47;100.69;5.07;494;1;209.00;0
218;1;21831573;218;212;711;711;7.52;0.46;101.19;5.07;493;1;210.00;0
218;1;21831579;218;216;711;711;7.48;0.46;101.19;5.07;493;1;211.00;0
219;1;21831585;219;223;711;711;7.44;0.46;100.90;5.07;492;1;212.00;0
219;1;21831591;219;224;711;711;7.42;0.45;100.90;5.07;492;1;213.00;0
222;1;21831596;222;227;711;711;7.29;0.45;100.81;5.07;489;1;214.00;0
223;1;21831602;223;233;711;711;7.19;0.44;100.97;5.07;488;1;215.00;0
225;1;21831607;225;249;754;781;7.39;0.45;101.93;4.78;529;1;216.00;27
227;1;21831618;227;248;756;782;7.29;0.45;102.81;4.77;529;1;217.00;26
227;1;21831625;227;251;763;782;7.37;0.45;102.81;4.75;536;1;218.00;19
229;1;21831631;229;251;766;782;7.32;0.45;102.83;4.74;537;1;219.00;16
229;1;21831637;229;253;768;782;7.28;0.45;102.83;4.74;539;1;220.00;14
229;1;21831643;229;256;771;782;7.28;0.45;102.83;4.74;542;1;221.00;11
229;1;21831649;229;247;774;782;7.33;0.45;102.83;4.75;545;1;222.00;8
230;1;21831655;230;249;777;782;7.36;0.45;103.17;4.75;547;1;223.00;5
232;1;21831661;232;231;778;783;7.40;0.46;104.21;4.76;546;1;224.00;5
234;1;21831668;234;223;781;785;7.44;0.46;105.23;4.76;547;1;225.00;4
235;1;21831675;235;223;783;785;7.54;0.46;105.33;4.77;548;1;226.00;2
235;1;21831682;235;222;787;789;7.60;0.47;105.33;4.75;552;1;227.00;2
236;1;21831689;236;222;788;789;7.73;0.47;105.59;4.76;552;1;228.00;1
237;1;21831696;237;223;789;789;7.83;0.48;106.10;4.76;552;1;229.00;0
237;1;21831703;237;226;789;789;8.01;0.49;106.10;4.76;552;1;230.00;0
237;1;21831710;237;214;795;795;8.20;0.50;106.10;4.73;558;1;231.00;0
239;1;21831718;239;205;795;795;8.35;0.51;106.91;4.73;556;1;232.00;0
243;1;21831726;243;193;795;795;8.46;0.52;107.76;4.73;552;1;233.00;0
245;1;21831733;245;184;798;798;8.63;0.52;108.75;4.71;553;1;234.00;0
246;1;21831741;246;173;798;798;8.84;0.54;109.26;4.71;552;1;235.00;0
246;1;21831748;246;169;798;798;8.89;0.54;109.26;4.71;552;1;236.00;0
248;1;21831756;248;162;799;799;8.86;0.54;108.54;4.71;551;1;237.00;0
249;1;21831764;249;156;800;800;8.95;0.55;108.65;4.70;551;1;238.00;0
249;1;21831771;249;154;800;800;9.01;0.55;108.65;4.70;551;1;239.00;0
249;1;21831782;249;158;825;826;9.09;0.56;108.65;4.56;576;1;240.00;1
251;1;21831792;251;154;825;826;9.19;0.57;108.11;4.56;574;1;241.00;1
254;1;21831800;254;146;826;826;9.34;0.57;109.08;4.56;572;1;242.00;0
254;1;21831812;254;142;827;827;9.51;0.58;109.08;4.55;573;1;243.00;0
256;1;21831821;256;136;827;827;9.64;0.59;109.28;4.55;571;1;244.00;0
261;1;21831832;261;134;831;831;9.68;0.59;110.80;4.53;570;1;245.00;0
263;1;21831842;263;129;831;831;9.71;0.59;111.25;4.53;568;1;246.00;0
265;1;21831854;265;131;835;835;9.71;0.59;112.09;4.52;570;1;247.00;0
270;1;21831864;270;131;835;835;9.77;0.60;112.98;4.52;565;1;248.00;0
272;1;21831873;272;127;835;835;9.83;0.60;113.79;4.52;563;1;249.00;0
274;1;21831882;274;128;835;835;9.85;0.60;114.26;4.52;561;1;250.00;0
276;1;21831891;276;129;835;835;9.89;0.60;115.05;4.52;559;1;251.00;0
279;1;21831900;279;129;846;847;9.93;0.61;115.68;4.46;567;1;252.00;1
281;1;21831910;281;128;846;847;10.01;0.61;115.78;4.46;565;1;253.00;1
286;1;21831917;286;127;847;847;10.08;0.61;117.11;4.45;561;1;254.00;0
288;1;21831926;288;127;847;847;10.19;0.62;117.17;4.45;559;1;255.00;0
290;1;21831934;290;126;847;847;10.26;0.63;117.61;4.45;557;1;256.00;0
292;1;21831943;292;131;847;847;10.26;0.62;118.07;4.45;555;1;257.00;0
293;1;21831950;293;133;848;848;10.25;0.62;118.24;4.45;555;1;258.00;0
294;1;21831957;294;133;848;848;10.15;0.62;118.23;4.45;554;1;259.00;0
296;1;21831964;296;136;854;854;10.05;0.61;118.71;4.43;558;1;260.00;0
296;1;21831972;296;142;855;855;10.04;0.61;118.71;4.42;559;1;261.00;0
298;1;21831979;298;142;855;855;10.02;0.61;119.22;4.42;557;1;262.00;0
303;1;21831986;303;151;855;855;9.91;0.60;120.55;4.42;552;1;263.00;0
303;1;21831993;303;160;859;859;9.87;0.60;120.55;4.40;556;1;264.00;0
304;1;21832000;304;153;859;859;9.81;0.59;120.39;4.40;555;1;265.00;0
304;1;21832007;304;152;859;859;9.83;0.59;120.39;4.40;555;1;266.00;0
304;1;21832019;304;147;860;860;9.89;0.60;120.39;4.40;556;1;267.00;0
304;1;21832026;304;144;864;864;9.91;0.60;120.39;4.38;560;1;268.00;0
304;1;21832032;304;141;864;864;10.00;0.60;120.39;4.38;560;1;269.00;0
304;1;21832040;304;138;868;870;10.06;0.61;120.39;4.36;564;1;270.00;2
306;1;21832048;306;138;868;870;10.01;0.61;120.78;4.36;562;1;271.00;2
309;1;21832054;309;134;870;870;10.05;0.61;121.08;4.36;561;1;272.00;0
312;1;21832062;312;130;870;870;10.08;0.61;122.18;4.36;558;1;273.00;0
316;1;21832068;316;132;874;874;10.22;0.62;122.65;4.34;558;1;274.00;0
318;1;21832076;318;129;874;874;10.24;0.62;123.38;4.34;556;1;275.00;0
322;1;21832082;322;127;874;874;10.24;0.62;123.88;4.34;552;1;276.00;0
325;1;21832089;325;125;874;874;10.28;0.62;123.90;4.34;549;1;277.00;0
325;1;21832096;325;124;875;875;10.30;0.62;123.90;4.34;550;1;278.00;0
325;1;21832102;325;120;876;876;10.35;0.63;123.90;4.33;551;1;279.00;0
327;1;21832109;327;116;876;876;10.44;0.63;124.27;4.33;549;1;280.00;0
327;1;21832116;327;112;877;877;10.59;0.64;124.27;4.33;550;1;281.00;0
330;1;21832122;330;105;877;877;10.67;0.65;124.47;4.33;547;1;282.00;0
332;1;21832129;332;105;877;877;10.74;0.65;124.55;4.33;545;1;283.00;0
333;1;21832136;333;98;877;877;10.90;0.66;125.02;4.33;544;1;284.00;0
334;1;21832143;334;94;877;877;11.06;0.67;125.19;4.33;543;1;285.00;0
336;1;21832150;336;90;877;877;11.20;0.68;125.29;4.33;541;1;286.00;0
336;1;21832157;336;87;877;877;11.34;0.69;125.29;4.33;541;1;287.00;0
337;1;21832164;337;103;944;1004;11.11;0.69;125.56;4.02;607;1;288.00;60
340;1;21832181;340;97;946;1005;11.22;0.69;125.63;4.02;606;1;289.00;59
343;1;21832189;343;87;954;1005;11.27;0.69;125.88;4.00;611;1;290.00;51
344;1;21832197;344;84;959;1005;11.28;0.69;125.83;3.99;615;1;291.00;46
347;1;21832204;347;84;964;1005;11.28;0.69;126.00;3.99;617;1;292.00;41
348;1;21832213;348;81;966;1005;11.26;0.69;126.43;4.00;618;1;293.00;39
350;1;21832220;350;85;969;1005;11.18;0.69;126.05;4.00;619;1;294.00;36
351;1;21832228;351;85;972;1005;11.18;0.68;125.85;4.01;621;1;295.00;33
351;1;21832236;351;87;976;1006;11.19;0.68;125.85;4.03;625;1;296.00;30
355;1;21832244;355;88;980;1007;11.23;0.69;125.97;4.05;625;1;297.00;27
356;1;21832253;356;88;984;1007;11.29;0.69;126.43;4.07;628;1;298.00;23
356;1;21832261;356;90;985;1008;11.22;0.69;126.43;4.08;629;1;299.00;23
358;1;21832272;358;94;987;1014;11.15;0.68;126.34;4.07;629;1;300.00;27
362;1;21832286;362;88;991;1014;11.14;0.68;125.98;4.11;629;1;301.00;23
362;1;21832295;362;97;992;1014;11.12;0.68;125.98;4.12;630;1;302.00;22
364;1;21832303;364;100;995;1018;11.09;0.68;126.80;4.14;631;1;303.00;23
365;1;21832313;365;103;998;1018;11.02;0.68;127.08;4.15;633;1;304.00;20
368;1;21832321;368;110;1005;1018;10.94;0.67;127.70;4.21;637;1;305.00;13
368;1;21832330;368;116;1007;1021;10.94;0.67;127.70;4.21;639;1;306.00;14
368;1;21832339;368;121;1009;1021;10.95;0.67;127.70;4.22;641;1;307.00;12
370;1;21832347;370;122;1011;1021;10.95;0.67;128.02;4.26;641;1;308.00;10
373;1;21832356;373;126;1014;1025;10.94;0.67;128.88;4.27;641;1;309.00;11
376;1;21832366;376;133;1017;1026;10.93;0.67;129.49;4.29;641;1;310.00;9
379;1;21832375;379;136;1018;1026;10.92;0.67;130.13;4.29;639;1;311.00;8
383;1;21832389;383;138;1024;1030;10.92;0.67;130.09;4.31;641;1;312.00;6
383;1;21832398;383;139;1026;1030;10.95;0.67;130.09;4.32;643;1;313.00;4
389;1;21832407;389;144;1027;1030;10.97;0.67;131.52;4.32;638;1;314.00;3
391;1;21832416;391;144;1030;1032;10.94;0.67;132.25;4.32;639;1;315.00;2
392;1;21832431;392;149;1030;1032;10.90;0.67;132.35;4.32;638;1;316.00;2
395;1;21832439;395;150;1036;1038;10.85;0.66;132.61;4.30;641;1;317.00;2
397;1;21832449;397;152;1036;1038;10.76;0.66;133.04;4.30;639;1;318.00;2
397;1;21832457;397;157;1037;1039;10.65;0.65;133.04;4.30;640;1;319.00;2
397;1;21832466;397;159;1037;1039;10.45;0.64;133.04;4.30;640;1;320.00;2
397;1;21832474;397;161;1037;1039;10.27;0.63;133.04;4.30;640;1;321.00;2
398;1;21832482;398;169;1037;1039;10.06;0.62;133.15;4.30;639;1;322.00;2
401;1;21832489;401;178;1037;1039;9.92;0.61;133.83;4.30;636;1;323.00;2
404;1;21832497;404;183;1047;1051;9.78;0.60;134.69;4.26;643;1;324.00;4
405;1;21832506;405;179;1047;1051;9.69;0.60;134.45;4.26;642;1;325.00;4
406;1;21832514;406;180;1049;1051;9.68;0.60;134.81;4.25;643;1;326.00;2
410;1;21832521;410;181;1049;1051;9.61;0.59;135.60;4.25;639;1;327.00;2
413;1;21832530;413;183;1049;1051;9.60;0.59;136.18;4.25;636;1;328.00;2
416;1;21832538;416;183;1049;1051;9.60;0.59;136.60;4.25;633;1;329.00;2
418;1;21832548;418;184;1053;1055;9.54;0.59;137.44;4.28;635;1;330.00;2
419;1;21832556;419;193;1053;1055;9.48;0.58;137.47;4.28;634;1;331.00;2
419;1;21832564;419;196;1058;1059;9.58;0.59;137.47;4.28;639;1;332.00;1
419;1;21832572;419;192;1060;1060;9.58;0.59;137.47;4.28;641;1;333.00;0
421;1;21832580;421;194;1060;1060;9.55;0.59;137.72;4.28;639;1;334.00;0
427;1;21832587;427;195;1060;1060;9.53;0.59;138.40;4.28;633;1;335.00;0
430;1;21832596;430;199;1073;1073;9.51;0.58;138.34;4.23;643;1;336.00;0
431;1;21832611;431;194;1073;1073;9.56;0.59;138.19;4.23;642;1;337.00;0
436;1;21832618;436;197;1073;1073;9.53;0.58;139.14;4.23;637;1;338.00;0
440;1;21832626;440;202;1074;1074;9.57;0.59;139.92;4.23;634;1;339.00;0
445;1;21832634;445;202;1075;1075;9.55;0.59;141.16;4.22;630;1;340.00;0
448;1;21832641;448;205;1075;1075;9.46;0.58;141.70;4.22;627;1;341.00;0
450;1;21832649;450;203;1078;1078;9.38;0.58;142.21;4.21;628;1;342.00;0
453;1;21832656;453;206;1078;1078;9.30;0.57;142.64;4.21;625;1;343.00;0
456;1;21832664;456;214;1078;1078;9.24;0.57;143.57;4.21;622;1;344.00;0
460;1;21832671;460;215;1078;1078;9.09;0.56;144.08;4.21;618;1;345.00;0
465;1;21832678;465;217;1084;1084;8.92;0.55;145.44;4.19;619;1;346.00;0
470;1;21832686;470;220;1084;1084;8.67;0.53;146.04;4.19;614;1;347.00;0
473;1;21832693;473;221;1084;1084;8.41;0.51;146.60;4.19;611;1;348.00;0
476;1;21832699;476;227;1084;1084;8.09;0.50;147.26;4.19;608;1;349.00;0
479;1;21832705;479;219;1088;1088;7.84;0.48;147.73;4.18;609;1;350.00;0
480;1;21832713;480;216;1089;1089;7.65;0.47;148.15;4.18;609;1;351.00;0
485;1;21832719;485;216;1089;1089;7.43;0.46;147.95;4.18;604;1;352.00;0
487;1;21832726;487;215;1090;1090;7.38;0.45;148.30;4.17;603;1;353.00;0
491;1;21832733;491;216;1090;1090;7.39;0.45;147.84;4.17;599;1;354.00;0
494;1;21832739;494;210;1090;1090;7.42;0.46;148.08;4.17;596;1;355.00;0
496;1;21832746;496;212;1090;1090;7.53;0.46;147.97;4.17;594;1;356.00;0
500;1;21832753;500;206;1090;1090;7.52;0.46;148.35;4.17;590;1;357.00;0
503;1;21832760;503;202;1090;1090;7.58;0.47;148.48;4.17;587;1;358.00;0
504;1;21832766;504;200;1090;1090;7.61;0.47;148.32;4.17;586;1;359.00;0
507;1;21832774;507;201;1151;1215;8.07;0.51;148.67;3.95;644;1;360.00;64
510;1;21832792;510;206;1163;1216;8.00;0.50;149.43;3.92;653;1;361.00;53
511;1;21832799;511;208;1175;1216;8.07;0.50;149.26;3.90;664;1;362.00;41
514;1;21832807;514;209;1179;1216;8.14;0.51;149.79;3.90;665;1;363.00;37
516;1;21832815;516;211;1185;1216;8.12;0.51;149.60;3.90;669;1;364.00;31
521;1;21832822;521;212;1190;1216;7.96;0.49;149.90;3.91;669;1;365.00;26
526;1;21832830;526;219;1197;1216;7.83;0.49;150.47;3.92;671;1;366.00;19
530;1;21832838;530;222;1200;1216;7.69;0.48;151.11;3.92;670;1;367.00;16
531;1;21832846;531;230;1205;1217;7.59;0.47;150.97;3.94;674;1;368.00;12
533;1;21832853;533;230;1209;1218;7.51;0.46;151.23;3.96;676;1;369.00;9
536;1;21832861;536;233;1211;1218;7.37;0.46;151.20;3.96;675;1;370.00;7
538;1;21832869;538;246;1217;1222;7.31;0.45;150.83;3.96;679;1;371.00;5
539;1;21832877;539;254;1218;1222;7.16;0.44;150.83;3.96;679;1;372.00;4
541;1;21832885;541;265;1218;1222;7.04;0.43;151.13;3.96;677;1;373.00;4
543;1;21832898;543;277;1218;1222;6.96;0.43;151.15;3.96;675;1;374.00;4
543;1;21832913;543;281;1224;1228;6.87;0.42;151.15;3.96;681;1;375.00;4
545;1;21832921;545;284;1225;1228;6.78;0.42;150.92;3.96;680;1;376.00;3
546;1;21832929;546;290;1225;1228;6.72;0.41;151.07;3.96;679;1;377.00;3
548;1;21832938;548;293;1229;1231;6.59;0.41;150.94;3.96;681;1;378.00;2
552;1;21832946;552;305;1229;1231;6.47;0.40;150.96;3.96;677;1;379.00;2
553;1;21832954;553;308;1229;1231;6.37;0.39;150.77;3.96;676;1;380.00;2
555;1;21832962;555;303;1231;1232;6.29;0.39;150.83;3.97;676;1;381.00;1
555;1;21832970;555;298;1232;1233;6.34;0.39;150.83;3.97;677;1;382.00;1
558;1;21832978;558;288;1233;1233;6.43;0.40;151.11;3.99;675;1;383.00;0
561;1;21832986;561;287;1245;1246;6.56;0.40;150.68;3.95;684;1;384.00;1
563;1;21832995;563;286;1246;1246;6.68;0.41;150.55;3.94;683;1;385.00;0
563;1;21833003;563;279;1246;1246;6.79;0.42;150.55;3.94;683;1;386.00;0
565;1;21833011;565;275;1247;1247;6.85;0.42;150.48;3.94;682;1;387.00;0
567;1;21833025;567;272;1247;1247;6.98;0.43;150.35;3.94;680;1;388.00;0
569;1;21833033;569;276;1251;1251;7.12;0.43;150.36;3.93;682;1;389.00;0
570;1;21833044;570;275;1251;1251;7.18;0.44;150.27;3.93;681;1;390.00;0
571;1;21833058;571;275;1255;1255;7.27;0.44;150.44;3.92;684;1;391.00;0
573;1;21833067;573;273;1255;1255;7.30;0.44;150.47;3.92;682;1;392.00;0
573;1;21833075;573;271;1255;1255;7.34;0.45;150.47;3.92;682;1;393.00;0
575;1;21833083;575;269;1255;1255;7.36;0.45;150.19;3.92;680;1;394.00;0
576;1;21833092;576;272;1255;1255;7.38;0.45;150.39;3.92;679;1;395.00;0
577;1;21833100;577;274;1266;1267;7.53;0.46;150.76;3.89;689;1;396.00;1
579;1;21833109;579;258;1266;1267;7.57;0.46;150.79;3.89;687;1;397.00;1
579;1;21833119;579;252;1267;1267;7.64;0.46;150.79;3.89;688;1;398.00;0
579;1;21833128;579;244;1267;1267;7.77;0.47;150.79;3.89;688;1;399.00;0
579;1;21833138;579;241;1267;1267;7.86;0.48;150.79;3.89;688;1;400.00;0
581;1;21833154;581;242;1267;1267;7.95;0.48;150.97;3.89;686;1;401.00;0
581;1;21833165;581;235;1268;1268;7.99;0.49;150.97;3.88;687;1;402.00;0
586;1;21833174;586;235;1268;1268;8.01;0.49;151.10;3.88;682;1;403.00;0
589;1;21833183;589;235;1274;1274;8.00;0.49;151.27;3.87;685;1;404.00;0
592;1;21833194;592;239;1276;1276;8.01;0.49;151.61;3.87;684;1;405.00;0
596;1;21833203;596;224;1276;1276;8.00;0.49;152.26;3.87;680;1;406.00;0
597;1;21833214;597;215;1276;1276;8.02;0.49;152.08;3.87;679;1;407.00;0
598;1;21833222;598;211;1280;1280;8.03;0.49;152.28;3.85;682;1;408.00;0
598;1;21833237;598;209;1280;1280;8.09;0.50;152.28;3.85;682;1;409.00;0
601;1;21833246;601;209;1280;1280;8.09;0.50;152.92;3.85;679;1;410.00;0
601;1;21833256;601;209;1281;1281;8.20;0.50;152.92;3.85;680;1;411.00;0
603;1;21833265;603;206;1285;1285;8.27;0.51;153.13;3.84;682;1;412.00;0
605;1;21833275;605;203;1285;1285;8.38;0.52;153.91;3.84;680;1;413.00;0
607;1;21833284;607;201;1287;1288;8.51;0.52;153.99;3.84;680;1;414.00;1
608;1;21833293;608;197;1287;1288;8.58;0.53;154.03;3.84;679;1;415.00;1
612;1;21833302;612;196;1288;1288;8.64;0.53;154.77;3.83;676;1;416.00;0
613;1;21833311;613;190;1288;1288;8.71;0.53;154.93;3.83;675;1;417.00;0
616;1;21833320;616;186;1292;1292;8.74;0.54;155.25;3.83;676;1;418.00;0
617;1;21833330;617;184;1292;1292;8.82;0.54;155.44;3.83;675;1;419.00;0
621;1;21833340;621;180;1292;1292;8.87;0.54;156.26;3.83;671;1;420.00;0
624;1;21833350;624;175;1292;1292;8.92;0.54;156.77;3.83;668;1;421.00;0
628;1;21833359;628;172;1293;1293;8.93;0.54;157.62;3.82;665;1;422.00;0
630;1;21833368;630;164;1294;1294;8.94;0.54;158.19;3.82;664;1;423.00;0
631;1;21833377;631;159;1294;1294;8.99;0.55;158.39;3.82;663;1;424.00;0
634;1;21833386;634;164;1295;1295;9.02;0.55;159.16;3.82;661;1;425.00;0
637;1;21833395;637;162;1295;1295;9.06;0.55;159.36;3.82;658;1;426.00;0
641;1;21833404;641;158;1295;1295;9.08;0.55;159.76;3.82;654;1;427.00;0
644;1;21833413;644;160;1295;1295;9.19;0.56;160.03;3.82;651;1;428.00;0
646;1;21833421;646;162;1295;1295;9.29;0.57;160.72;3.82;649;1;429.00;0
649;1;21833430;649;159;1295;1295;9.35;0.57;160.88;3.82;646;1;430.00;0
649;1;21833438;649;160;1295;1295;9.40;0.57;160.88;3.82;646;1;431.00;0
652;1;21833446;652;186;1375;1422;9.24;0.57;160.74;3.60;723;1;432.00;47
654;1;21833465;654;180;1376;1423;9.25;0.57;161.11;3.60;722;1;433.00;47
655;1;21833475;655;169;1382;1423;9.42;0.58;161.51;3.59;727;1;434.00;41
657;1;21833484;657;167;1383;1423;9.51;0.59;162.06;3.59;726;1;435.00;40
660;1;21833493;660;161;1386;1423;9.63;0.60;162.08;3.59;726;1;436.00;37
660;1;21833502;660;161;1388;1423;9.62;0.59;162.08;3.59;728;1;437.00;35
662;1;21833517;662;161;1389;1423;9.67;0.60;162.56;3.59;727;1;438.00;34
664;1;21833527;664;165;1392;1423;9.74;0.60;163.12;3.60;728;1;439.00;31
665;1;21833535;665;168;1395;1424;9.83;0.60;163.18;3.61;730;1;440.00;29
668;1;21833545;668;168;1400;1425;9.88;0.61;164.21;3.63;732;1;441.00;25
672;1;21833554;672;167;1403;1425;9.95;0.61;164.31;3.64;731;1;442.00;22
676;1;21833564;676;166;1406;1426;9.98;0.61;165.00;3.66;730;1;443.00;20
680;1;21833573;680;170;1409;1426;9.98;0.61;165.50;3.68;729;1;444.00;17
682;1;21833583;682;171;1410;1426;10.07;0.62;166.12;3.68;728;1;445.00;16
684;1;21833592;684;165;1414;1426;10.10;0.62;166.72;3.71;730;1;446.00;12
688;1;21833601;688;165;1415;1430;10.13;0.62;167.44;3.71;727;1;447.00;15
690;1;21833611;690;166;1418;1430;10.13;0.62;168.15;3.72;728;1;448.00;12
696;1;21833621;696;163;1418;1430;10.23;0.63;168.74;3.72;722;1;449.00;12
701;1;21833633;701;165;1423;1436;10.22;0.63;169.62;3.73;722;1;450.00;13
705;1;21833643;705;166;1423;1436;10.16;0.62;170.17;3.73;718;1;451.00;13
711;1;21833653;711;168;1425;1436;10.16;0.62;170.00;3.74;714;1;452.00;11
716;1;21833663;716;167;1429;1440;10.10;0.61;170.61;3.73;713;1;453.00;11
717;1;21833672;717;163;1430;1441;10.10;0.61;170.70;3.73;713;1;454.00;11
720;1;21833682;720;162;1433;1441;10.08;0.61;170.95;3.74;713;1;455.00;8
723;1;21833693;723;156;1436;1445;10.11;0.62;171.11;3.74;713;1;456.00;9
725;1;21833703;725;153;1436;1445;10.03;0.61;171.56;3.74;711;1;457.00;9
728;1;21833713;728;144;1439;1445;9.96;0.61;172.34;3.77;711;1;458.00;6
731;1;21833722;731;139;1440;1446;10.02;0.61;172.67;3.76;709;1;459.00;6
732;1;21833732;732;138;1440;1446;10.03;0.61;172.76;3.76;708;1;460.00;6
739;1;21833742;739;137;1444;1452;10.07;0.61;173.33;3.76;705;1;461.00;8
742;1;21833752;742;134;1444;1452;10.09;0.61;173.70;3.76;702;1;462.00;8
744;1;21833762;744;134;1444;1453;10.06;0.61;174.22;3.76;700;1;463.00;9
746;1;21833772;746;136;1444;1453;10.01;0.61;174.40;3.76;698;1;464.00;9
748;1;21833782;748;133;1444;1453;10.04;0.61;174.55;3.76;696;1;465.00;9
750;1;21833791;750;126;1444;1453;10.15;0.61;174.55;3.76;694;1;466.00;9
752;1;21833800;752;123;1444;1453;10.25;0.62;174.49;3.76;692;1;467.00;9
756;1;21833815;756;121;1453;1465;10.42;0.63;175.06;3.73;697;1;468.00;12
760;1;21833827;760;118;1454;1465;10.46;0.64;175.04;3.73;694;1;469.00;11
762;1;21833841;762;118;1455;1465;10.57;0.64;175.14;3.73;693;1;470.00;10
763;1;21833854;763;119;1455;1465;10.63;0.65;175.24;3.73;692;1;471.00;10
767;1;21833866;767;121;1455;1465;10.63;0.65;174.81;3.73;688;1;472.00;10
768;1;21833879;768;122;1455;1465;10.68;0.65;174.76;3.73;687;1;473.00;10
773;1;21833890;773;120;1458;1469;10.67;0.65;174.72;3.72;685;1;474.00;11
774;1;21833902;774;120;1459;1469;10.73;0.65;174.78;3.75;685;1;475.00;10
776;1;21833914;776;118;1462;1473;10.79;0.66;174.91;3.74;686;1;476.00;11
781;1;21833926;781;120;1463;1474;10.81;0.66;174.97;3.74;682;1;477.00;11
784;1;21833945;784;122;1464;1474;10.77;0.65;174.71;3.77;680;1;478.00;10
784;1;21833954;784;123;1465;1474;10.69;0.65;174.71;3.80;681;1;479.00;9
786;1;21833965;786;127;1490;1500;10.63;0.65;174.98;3.81;704;1;480.00;10
789;1;21833977;789;128;1493;1500;10.57;0.64;175.00;3.82;704;1;481.00;7
789;1;21833987;789;124;1494;1500;10.61;0.65;175.00;3.82;705;1;482.00;6
792;1;21833996;792;126;1497;1501;10.55;0.64;174.93;3.84;705;1;483.00;4
795;1;21834006;795;124;1497;1502;10.53;0.64;175.02;3.84;702;1;484.00;5
795;1;21834016;795;134;1498;1502;10.57;0.64;175.02;3.85;703;1;485.00;4
795;1;21834025;795;140;1500;1505;10.70;0.65;175.02;3.84;705;1;486.00;5
797;1;21834034;797;143;1500;1505;10.78;0.66;175.08;3.84;703;1;487.00;5
800;1;21834044;800;149;1502;1505;10.79;0.66;175.04;3.85;702;1;488.00;3
804;1;21834053;804;153;1503;1505;10.82;0.66;175.49;3.85;699;1;489.00;2
805;1;21834063;805;158;1510;1511;10.84;0.66;175.58;3.85;705;1;490.00;1
805;1;21834072;805;157;1511;1511;10.76;0.66;175.58;3.85;706;1;491.00;0
808;1;21834081;808;158;1511;1511;10.70;0.65;175.50;3.85;703;1;492.00;0
810;1;21834091;810;165;1511;1511;10.62;0.65;175.34;3.85;701;1;493.00;0
810;1;21834100;810;175;1515;1515;10.57;0.65;175.34;3.84;705;1;494.00;0
813;1;21834110;813;179;1517;1517;10.44;0.64;175.65;3.84;704;1;495.00;0
815;1;21834119;815;186;1517;1517;10.35;0.63;175.67;3.84;702;1;496.00;0
817;1;21834128;817;188;1518;1518;10.18;0.62;175.79;3.83;701;1;497.00;0
820;1;21834137;820;193;1518;1518;10.02;0.61;175.71;3.83;698;1;498.00;0
822;1;21834146;822;192;1518;1518;9.94;0.61;175.61;3.83;696;1;499.00;0
825;1;21834155;825;196;1518;1518;9.81;0.60;175.39;3.83;693;1;500.00;0
826;1;21834168;826;197;1518;1518;9.69;0.59;175.20;3.83;692;1;501.00;0
830;1;21834177;830;200;1518;1518;9.59;0.59;175.18;3.83;688;1;502.00;0
830;1;21834185;830;209;1518;1518;9.58;0.59;175.18;3.83;688;1;503.00;0
833;1;21834193;833;220;1558;1588;9.64;0.59;175.09;3.74;725;1;504.00;30
835;1;21834207;835;215;1561;1589;9.62;0.59;174.95;3.73;726;1;505.00;28
837;1;21834216;837;213;1567;1589;9.58;0.59;174.71;3.72;730;1;506.00;22
839;1;21834225;839;216;1570;1589;9.58;0.59;174.64;3.72;731;1;507.00;19
842;1;21834234;842;217;1573;1589;9.52;0.58;174.40;3.72;731;1;508.00;16
843;1;21834242;843;219;1574;1589;9.57;0.59;174.71;3.72;731;1;509.00;15
843;1;21834253;843;221;1576;1589;9.59;0.59;174.71;3.73;733;1;510.00;13
846;1;21834262;846;227;1580;1589;9.55;0.59;174.99;3.74;734;1;511.00;9
846;1;21834270;846;225;1582;1590;9.62;0.59;174.99;3.74;736;1;512.00;8
850;1;21834279;850;225;1584;1591;9.55;0.59;174.77;3.74;734;1;513.00;7
853;1;21834287;853;231;1585;1591;9.50;0.58;174.67;3.75;732;1;514.00;6
855;1;21834296;855;236;1590;1595;9.37;0.57;175.40;3.74;735;1;515.00;5
859;1;21834305;859;239;1591;1595;9.20;0.56;175.13;3.75;732;1;516.00;4
862;1;21834314;862;248;1592;1595;8.99;0.55;174.82;3.75;730;1;517.00;3
867;1;21834322;867;255;1593;1595;8.79;0.54;174.80;3.76;726;1;518.00;2
870;1;21834330;870;259;1599;1601;8.61;0.52;174.90;3.76;729;1;519.00;2
873;1;21834339;873;264;1600;1601;8.47;0.52;175.30;3.76;727;1;520.00;1
875;1;21834348;875;272;1601;1601;8.37;0.51;175.52;3.76;726;1;521.00;0
877;1;21834356;877;275;1604;1604;8.22;0.50;175.72;3.75;727;1;522.00;0
881;1;21834364;881;276;1604;1604;8.10;0.49;175.97;3.75;723;1;523.00;0
881;1;21834372;881;279;1604;1604;7.97;0.49;175.97;3.75;723;1;524.00;0
886;1;21834380;886;271;1605;1605;7.82;0.48;176.29;3.75;719;1;525.00;0
891;1;21834388;891;266;1606;1606;7.74;0.47;176.79;3.75;715;1;526.00;0
892;1;21834397;892;263;1606;1606;7.71;0.47;177.14;3.75;714;1;527.00;0
895;1;21834404;895;264;1619;1619;7.67;0.47;177.31;3.72;724;1;528.00;0
899;1;21834413;899;263;1619;1619;7.58;0.46;178.03;3.72;720;1;529.00;0
899;1;21834421;899;267;1619;1619;7.57;0.46;178.03;3.72;720;1;530.00;0
903;1;21834430;903;270;1620;1620;7.47;0.46;179.01;3.72;717;1;531.00;0
906;1;21834438;906;269;1620;1620;7.43;0.45;179.35;3.72;714;1;532.00;0
909;1;21834447;909;268;1624;1624;7.48;0.46;179.39;3.71;715;1;533.00;0
911;1;21834455;911;270;1624;1624;7.45;0.46;179.83;3.71;713;1;534.00;0
912;1;21834463;912;271;1628;1628;7.40;0.45;179.96;3.71;716;1;535.00;0
912;1;21834472;912;272;1628;1628;7.33;0.45;179.96;3.71;716;1;536.00;0
918;1;21834480;918;277;1628;1628;7.22;0.44;180.51;3.71;710;1;537.00;0
920;1;21834488;920;268;1628;1628;7.18;0.44;180.88;3.71;708;1;538.00;0
924;1;21834497;924;264;1628;1628;7.12;0.43;180.91;3.71;704;1;539.00;0
926;1;21834507;926;266;1657;1662;7.27;0.45;181.24;3.64;731;1;540.00;5
928;1;21834518;928;261;1660;1662;7.26;0.45;181.82;3.64;732;1;541.00;2
932;1;21834526;932;256;1661;1662;7.23;0.44;181.69;3.64;729;1;542.00;1
933;1;21834535;933;252;1661;1662;7.28;0.45;181.94;3.64;728;1;543.00;1
937;2;21834543;937;252;1662;1662;7.33;0.45;182.38;3.64;725;2;544.00;0
937;2;21834562;937;246;1662;1662;7.43;0.46;182.38;3.64;725;2;545.00;0
940;2;21834571;940;251;1663;1663;7.48;0.46;182.69;3.63;723;2;546.00;0
941;2;21834586;941;252;1663;1663;7.47;0.46;182.54;3.63;722;2;547.00;0
945;2;21834601;945;256;1669;1669;7.44;0.45;183.08;3.62;724;2;548.00;0
946;2;21834611;946;252;1670;1670;7.39;0.45;183.32;3.62;724;2;549.00;0
950;2;21834620;950;253;1670;1670;7.33;0.45;183.38;3.62;720;2;550.00;0
954;2;21834629;954;253;1670;1670;7.28;0.44;183.73;3.62;716;2;551.00;0
955;2;21834638;955;257;1674;1674;7.29;0.44;183.74;3.61;719;2;552.00;0
957;2;21834647;957;259;1674;1674;7.34;0.45;183.75;3.61;717;2;553.00;0
960;2;21834656;960;258;1674;1674;7.37;0.45;183.99;3.61;714;2;554.00;0
963;2;21834666;963;256;1675;1675;7.40;0.45;184.24;3.61;712;2;555.00;0
966;2;21834675;966;251;1679;1679;7.43;0.45;184.15;3.61;713;2;556.00;0
969;2;21834684;969;252;1679;1679;7.48;0.45;184.04;3.61;710;2;557.00;0
970;2;21834693;970;250;1681;1682;7.51;0.46;184.04;3.60;711;2;558.00;1
973;2;21834702;973;248;1681;1682;7.43;0.45;183.92;3.60;708;2;559.00;1
976;2;21834712;976;245;1682;1682;7.33;0.44;183.74;3.60;706;2;560.00;0
976;2;21834721;976;247;1682;1682;7.38;0.45;183.74;3.60;706;2;561.00;0
978;2;21834730;978;253;1686;1686;7.40;0.45;184.06;3.59;708;2;562.00;0
980;2;21834739;980;253;1686;1686;7.41;0.45;184.12;3.59;706;2;563.00;0
981;2;21834748;981;250;1686;1686;7.49;0.46;183.96;3.59;705;2;564.00;0
984;2;21834757;984;248;1686;1686;7.48;0.45;184.23;3.59;702;2;565.00;0
987;2;21834766;987;243;1687;1687;7.50;0.45;184.41;3.59;700;2;566.00;0
987;2;21834774;987;248;1688;1688;7.48;0.45;184.41;3.59;701;2;567.00;0
988;2;21834785;988;250;1688;1688;7.46;0.45;184.50;3.59;700;2;568.00;0
990;2;21834794;990;258;1689;1689;7.48;0.45;184.63;3.59;699;2;569.00;0
993;2;21834804;993;257;1689;1689;7.44;0.45;184.71;3.59;696;2;570.00;0
996;2;21834814;996;261;1689;1689;7.40;0.45;185.02;3.59;693;2;571.00;0
996;2;21834823;996;252;1689;1689;7.46;0.45;185.02;3.59;693;2;572.00;0
1000;2;21834832;1000;245;1689;1689;7.54;0.46;185.52;3.59;689;2;573.00;0
1003;2;21834842;1003;241;1689;1689;7.63;0.46;185.68;3.59;686;2;574.00;0
1004;2;21834851;1004;236;1689;1689;7.73;0.47;185.79;3.59;685;2;575.00;0
1007;2;21834860;1007;254;1769;1816;8.05;0.50;185.93;3.43;762;2;576.00;47
1007;2;21834880;1007;245;1773;1817;8.14;0.50;185.93;3.42;766;2;577.00;44
1009;2;21834890;1009;241;1780;1817;8.28;0.51;186.27;3.42;771;2;578.00;37
1012;2;21834900;1012;236;1781;1817;8.32;0.51;186.99;3.42;769;2;579.00;36
1013;2;21834910;1013;236;1785;1817;8.36;0.51;186.98;3.42;772;2;580.00;32
1018;2;21834927;1018;222;1785;1817;8.31;0.51;187.62;3.42;767;2;581.00;32
1020;2;21834937;1020;212;1787;1817;8.29;0.51;187.99;3.42;767;2;582.00;30
1024;2;21834947;1024;209;1789;1817;8.23;0.51;189.02;3.43;765;2;583.00;28
1025;2;21834957;1025;200;1790;1818;8.23;0.50;189.06;3.43;765;2;584.00;28
1026;2;21834968;1026;209;1796;1820;8.22;0.50;189.31;3.44;770;2;585.00;24
1027;2;21834978;1027;213;1797;1820;8.20;0.50;189.28;3.45;770;2;586.00;23
1030;2;21834989;1030;215;1801;1821;8.21;0.51;190.08;3.46;771;2;587.00;20
1034;2;21834999;1034;220;1803;1821;8.35;0.51;190.39;3.47;769;2;588.00;18
1034;2;21835011;1034;224;1806;1821;8.47;0.52;190.39;3.48;772;2;589.00;15
1037;2;21835021;1037;237;1807;1821;8.52;0.52;190.69;3.49;770;2;590.00;14
1038;2;21835038;1038;242;1813;1825;8.53;0.52;190.73;3.51;775;2;591.00;12
1039;2;21835049;1039;235;1815;1825;8.60;0.53;191.00;3.52;776;2;592.00;10
1042;2;21835059;1042;240;1818;1825;8.59;0.53;191.34;3.54;776;2;593.00;7
1044;2;21835070;1044;234;1820;1828;8.67;0.53;191.56;3.55;776;2;594.00;8
1045;2;21835080;1045;232;1822;1828;8.71;0.53;191.60;3.56;777;2;595.00;6
1046;2;21835090;1046;229;1824;1828;8.72;0.53;191.78;3.56;778;2;596.00;4
1052;2;21835101;1052;225;1829;1832;8.66;0.53;192.30;3.56;777;2;597.00;3
1057;2;21835112;1057;221;1830;1833;8.69;0.53;192.71;3.56;773;2;598.00;3
1058;2;21835122;1058;221;1832;1833;8.74;0.53;192.70;3.58;774;2;599.00;1
1061;2;21835135;1061;226;1843;1859;8.71;0.53;193.24;3.56;782;2;600.00;16
1064;2;21835152;1064;222;1845;1859;8.80;0.54;193.30;3.56;781;2;601.00;14
1065;2;21835163;1065;219;1845;1859;8.88;0.54;193.37;3.56;780;2;602.00;14
1067;2;21835174;1067;225;1847;1860;8.95;0.55;193.49;3.55;780;2;603.00;13
1071;2;21835184;1071;227;1848;1860;8.98;0.55;193.58;3.55;777;2;604.00;12
1074;2;21835194;1074;218;1853;1866;8.99;0.55;193.99;3.55;779;2;605.00;13
1074;2;21835205;1074;222;1855;1866;9.01;0.55;193.99;3.55;781;2;606.00;11
1077;2;21835216;1077;218;1856;1867;9.02;0.55;194.15;3.55;779;2;607.00;11
1077;2;21835226;1077;218;1856;1867;8.99;0.55;194.15;3.55;779;2;608.00;11
1080;2;21835236;1080;221;1858;1867;8.99;0.55;194.29;3.55;778;2;609.00;9
1085;2;21835247;1085;216;1858;1867;8.96;0.55;194.63;3.55;773;2;610.00;9
1089;2;21835257;1089;215;1858;1867;8.97;0.55;195.26;3.55;769;2;611.00;9
1090;2;21835268;1090;221;1868;1879;8.99;0.55;195.26;3.54;778;2;612.00;11
1092;2;21835279;1092;219;1868;1879;8.97;0.55;195.70;3.54;776;2;613.00;11
1097;2;21835297;1097;220;1868;1879;8.95;0.54;195.94;3.54;771;2;614.00;11
1101;2;21835307;1101;219;1870;1879;8.94;0.54;196.49;3.55;769;2;615.00;9
1101;2;21835319;1101;218;1870;1879;8.97;0.54;196.49;3.55;769;2;616.00;9
1102;2;21835329;1102;216;1870;1879;9.06;0.55;196.51;3.55;768;2;617.00;9
1104;2;21835338;1104;211;1874;1883;9.11;0.55;196.74;3.55;770;2;618.00;9
1106;2;21835349;1106;204;1874;1883;9.28;0.56;196.95;3.55;768;2;619.00;9
1109;2;21835360;1109;201;1878;1887;9.40;0.57;196.99;3.54;769;2;620.00;9
1111;2;21835370;1111;198;1879;1888;9.46;0.58;197.20;3.54;768;2;621.00;9
1111;2;21835381;1111;191;1879;1888;9.56;0.58;197.20;3.54;768;2;622.00;9
1117;2;21835390;1117;189;1879;1888;9.61;0.58;197.60;3.54;762;2;623.00;9
1119;2;21835401;1119;192;1890;1901;9.62;0.59;197.61;3.53;771;2;624.00;11
1125;2;21835412;1125;185;1890;1901;9.65;0.59;198.20;3.53;765;2;625.00;11
1126;2;21835429;1126;186;1890;1901;9.62;0.58;198.51;3.53;764;2;626.00;11
1127;2;21835438;1127;181;1891;1902;9.60;0.58;198.74;3.53;764;2;627.00;11
1131;2;21835448;1131;184;1891;1903;9.48;0.58;199.44;3.53;760;2;628.00;12
1138;2;21835458;1138;187;1891;1903;9.42;0.57;199.90;3.53;753;2;629.00;12
1141;2;21835470;1141;184;1898;1909;9.39;0.57;200.36;3.55;757;2;630.00;11
1148;2;21835481;1148;177;1900;1909;9.32;0.56;201.28;3.56;752;2;631.00;9
1150;2;21835491;1150;170;1902;1909;9.30;0.56;201.77;3.56;752;2;632.00;7
1153;2;21835501;1153;171;1902;1909;9.28;0.56;201.76;3.56;749;2;633.00;7
1155;2;21835510;1155;168;1907;1915;9.30;0.56;202.18;3.55;752;2;634.00;8
1157;2;21835520;1157;164;1907;1915;9.29;0.56;202.42;3.55;750;2;635.00;8
1158;2;21835531;1158;153;1907;1915;9.23;0.56;202.64;3.55;749;2;636.00;8
1160;2;21835540;1160;155;1907;1915;9.26;0.56;202.90;3.55;747;2;637.00;8
1162;2;21835550;1162;155;1910;1919;9.21;0.56;202.84;3.55;748;2;638.00;9
1165;2;21835560;1165;156;1911;1920;9.30;0.56;202.95;3.55;746;2;639.00;9
1169;2;21835570;1169;159;1911;1920;9.28;0.56;202.88;3.55;742;2;640.00;9
1170;2;21835580;1170;163;1912;1921;9.35;0.57;202.76;3.55;742;2;641.00;9
1173;2;21835589;1173;159;1912;1921;9.30;0.56;202.89;3.55;739;2;642.00;9
1175;2;21835599;1175;165;1912;1921;9.27;0.56;203.12;3.55;737;2;643.00;9
1176;2;21835607;1176;168;1912;1921;9.28;0.56;203.16;3.55;736;2;644.00;9
1179;2;21835617;1179;175;1912;1921;9.25;0.56;203.69;3.55;733;2;645.00;9
1182;2;21835627;1182;176;1913;1921;9.23;0.56;204.01;3.57;731;2;646.00;8
1184;2;21835637;1184;173;1913;1921;9.16;0.56;204.06;3.57;729;2;647.00;8
1186;2;21835652;1186;183;1948;1991;9.16;0.56;204.24;3.50;762;2;648.00;43
1189;2;21835668;1189;183;1951;1992;9.08;0.55;204.27;3.50;762;2;649.00;41
1191;2;21835678;1191;178;1955;1992;9.10;0.55;204.39;3.50;764;2;650.00;37
1193;2;21835688;1193;177;1956;1992;9.11;0.56;204.66;3.50;763;2;651.00;36
1196;2;21835698;1196;180;1963;1992;9.05;0.55;204.72;3.52;767;2;652.00;29
1199;2;21835708;1199;182;1964;1992;9.05;0.55;204.69;3.52;765;2;653.00;28
1199;2;21835718;1199;184;1967;1992;9.11;0.55;204.69;3.53;768;2;654.00;25
1200;2;21835728;1200;189;1970;1992;9.12;0.56;204.63;3.56;770;2;655.00;22
1202;2;21835738;1202;192;1972;1993;9.15;0.56;204.35;3.56;770;2;656.00;21
1202;2;21835749;1202;198;1975;1994;9.18;0.56;204.35;3.57;773;2;657.00;19
1205;2;21835759;1205;195;1979;1994;9.14;0.56;204.18;3.61;774;2;658.00;15
1206;2;21835769;1206;199;1986;1998;9.09;0.56;204.08;3.63;780;2;659.00;12
1207;2;21835782;1207;207;1990;1998;9.11;0.56;204.01;3.65;783;2;660.00;8
1209;2;21835793;1209;211;1991;1998;9.00;0.55;203.94;3.66;782;2;661.00;7
1210;2;21835803;1210;219;1993;1998;8.89;0.55;203.88;3.67;783;2;662.00;5
1213;2;21835818;1213;228;1998;2004;8.85;0.54;203.66;3.66;785;2;663.00;6
1218;2;21835833;1218;235;2002;2004;8.78;0.54;203.45;3.70;784;2;664.00;2
1220;2;21835848;1220;246;2002;2004;8.72;0.53;203.28;3.70;782;2;665.00;2
1224;2;21835862;1224;252;2006;2007;8.69;0.53;203.20;3.71;782;2;666.00;1
1224;2;21835877;1224;262;2006;2007;8.63;0.53;203.20;3.71;782;2;667.00;1
1226;2;21835889;1226;265;2007;2007;8.53;0.52;203.31;3.71;781;2;668.00;0
1226;2;21835901;1226;269;2008;2008;8.42;0.51;203.31;3.70;782;2;669.00;0
1227;2;21835914;1227;271;2009;2009;8.36;0.51;203.40;3.70;782;2;670.00;0
1230;2;21835925;1230;276;2009;2009;8.24;0.50;203.23;3.70;779;2;671.00;0
1232;2;21835936;1232;282;2022;2022;8.14;0.50;203.23;3.68;790;2;672.00;0
1233;2;21835953;1233;286;2022;2022;8.06;0.49;203.11;3.68;789;2;673.00;0
1236;2;21835964;1236;288;2022;2022;7.92;0.48;202.95;3.68;786;2;674.00;0
1239;2;21835973;1239;286;2024;2024;7.74;0.47;202.83;3.68;785;2;675.00;0
1241;2;21835984;1241;287;2024;2024;7.63;0.47;202.82;3.68;783;2;676.00;0
1244;2;21835994;1244;286;2028;2028;7.59;0.46;202.65;3.67;784;2;677.00;0
1244;2;21836004;1244;290;2028;2028;7.51;0.46;202.65;3.67;784;2;678.00;0
1245;2;21836013;1245;294;2032;2032;7.40;0.45;202.79;3.66;787;2;679.00;0
1247;2;21836023;1247;297;2032;2032;7.29;0.45;202.52;3.66;785;2;680.00;0
1251;2;21836033;1251;291;2032;2032;7.24;0.44;202.45;3.66;781;2;681.00;0
1253;2;21836043;1253;295;2032;2032;7.17;0.44;202.45;3.66;779;2;682.00;0
1255;2;21836052;1255;299;2032;2032;7.15;0.44;202.40;3.66;777;2;683.00;0
1257;2;21836061;1257;296;2043;2044;7.18;0.44;202.33;3.65;786;2;684.00;1
1260;2;21836071;1260;296;2043;2044;7.18;0.44;202.27;3.65;783;2;685.00;1
1263;2;21836080;1263;299;2044;2044;7.16;0.44;202.42;3.64;781;2;686.00;0
1264;2;21836088;1264;301;2044;2044;7.15;0.44;202.65;3.64;780;2;687.00;0
1267;2;21836098;1267;307;2044;2044;7.12;0.43;202.43;3.64;777;2;688.00;0
1267;2;21836106;1267;311;2044;2044;7.13;0.43;202.43;3.64;777;2;689.00;0
1270;2;21836116;1270;319;2045;2045;7.01;0.43;202.82;3.64;775;2;690.00;0
1274;2;21836125;1274;325;2045;2045;6.88;0.42;203.03;3.64;771;2;691.00;0
1277;2;21836135;1277;328;2051;2051;6.82;0.41;203.14;3.64;774;2;692.00;0
1280;2;21836143;1280;330;2052;2052;6.65;0.40;203.38;3.63;772;2;693.00;0
1281;2;21836152;1281;334;2052;2052;6.55;0.40;203.54;3.63;771;2;694.00;0
1286;2;21836161;1286;324;2052;2052;6.41;0.39;203.68;3.63;766;2;695.00;0
1289;2;21836169;1289;321;2056;2056;6.33;0.39;203.79;3.63;767;2;696.00;0
1293;2;21836179;1293;314;2056;2056;6.25;0.38;203.77;3.63;763;2;697.00;0
1295;2;21836187;1295;308;2056;2056;6.21;0.38;203.91;3.63;761;2;698.00;0
1296;2;21836195;1296;303;2057;2057;6.14;0.38;204.10;3.63;761;2;699.00;0
1302;2;21836204;1302;294;2061;2061;6.11;0.37;204.29;3.62;759;2;700.00;0
1304;2;21836218;1304;285;2061;2061;6.19;0.38;204.19;3.62;757;2;701.00;0
1307;2;21836227;1307;278;2063;2064;6.28;0.38;204.20;3.62;756;2;702.00;1
1308;2;21836242;1308;274;2063;2064;6.35;0.39;204.20;3.62;755;2;703.00;1
1311;2;21836250;1311;267;2064;2064;6.41;0.39;204.13;3.62;753;2;704.00;0
1314;2;21836265;1314;263;2064;2064;6.45;0.40;204.53;3.62;750;2;705.00;0
1315;2;21836274;1315;261;2068;2068;6.64;0.41;204.69;3.61;753;2;706.00;0
1316;2;21836284;1316;255;2068;2068;6.69;0.41;204.86;3.61;752;2;707.00;0
1320;2;21836294;1320;255;2068;2068;6.73;0.41;205.37;3.61;748;2;708.00;0
1323;2;21836303;1323;249;2068;2068;6.81;0.42;205.53;3.61;745;2;709.00;0
1324;2;21836312;1324;243;2069;2069;6.92;0.43;205.72;3.61;745;2;710.00;0
1327;2;21836320;1327;242;2070;2070;7.02;0.43;206.02;3.61;743;2;711.00;0
1330;2;21836331;1330;235;2070;2070;7.09;0.43;205.98;3.61;740;2;712.00;0
1334;2;21836339;1334;236;2071;2071;7.12;0.44;206.04;3.61;737;2;713.00;0
1336;2;21836349;1336;235;2071;2071;7.26;0.45;206.39;3.61;735;2;714.00;0
1337;2;21836359;1337;235;2071;2071;7.43;0.46;206.37;3.61;734;2;715.00;0
1342;2;21836368;1342;230;2071;2071;7.51;0.46;206.39;3.61;729;2;716.00;0
1346;2;21836378;1346;226;2071;2071;7.63;0.47;206.33;3.61;725;2;717.00;0
1349;2;21836395;1349;226;2071;2071;7.75;0.47;206.72;3.61;722;2;718.00;0
1354;2;21836404;1354;226;2071;2071;7.76;0.48;207.33;3.61;717;2;719.00;0
1358;2;21836415;1358;224;2169;2301;8.31;0.52;207.39;3.44;811;2;720.00;132
1361;2;21836444;1361;223;2180;2302;8.37;0.53;207.32;3.43;819;2;721.00;122
1364;2;21836454;1364;220;2196;2302;8.40;0.53;207.39;3.42;832;2;722.00;106
1370;2;21836464;1370;220;2211;2302;8.37;0.52;207.73;3.42;841;2;723.00;91
1373;2;21836473;1373;222;2220;2302;8.35;0.52;207.70;3.42;847;2;724.00;82
1376;2;21836484;1376;223;2227;2302;8.29;0.52;208.17;3.43;851;2;725.00;75
1381;2;21836494;1381;225;2240;2302;8.08;0.50;208.45;3.44;859;2;726.00;62
1384;2;21836504;1384;225;2246;2302;7.97;0.50;208.76;3.45;862;2;727.00;56
1390;2;21836514;1390;231;2252;2303;7.86;0.49;209.03;3.46;862;2;728.00;51
1392;2;21836525;1392;238;2255;2304;7.81;0.48;209.28;3.47;863;2;729.00;49
1394;2;21836536;1394;239;2263;2304;7.70;0.48;209.51;3.49;869;2;730.00;41
1397;2;21836547;1397;242;2268;2305;7.59;0.47;209.78;3.51;871;2;731.00;37
1401;2;21836558;1401;240;2272;2305;7.47;0.46;210.21;3.52;871;2;732.00;33
1404;2;21836570;1404;246;2275;2305;7.38;0.46;210.41;3.53;871;2;733.00;30
1405;2;21836581;1405;253;2278;2305;7.35;0.46;210.53;3.55;873;2;734.00;27
1412;2;21836592;1412;256;2283;2309;7.30;0.45;210.67;3.56;871;2;735.00;26
1414;2;21836604;1414;262;2284;2309;7.36;0.46;210.95;3.56;870;2;736.00;25
1420;2;21836617;1420;265;2286;2309;7.38;0.46;210.78;3.57;866;2;737.00;23
1426;2;21836629;1426;271;2289;2312;7.40;0.46;211.44;3.58;863;2;738.00;23
1431;2;21836641;1431;277;2290;2312;7.35;0.45;211.70;3.59;859;2;739.00;22
1434;2;21836653;1434;280;2292;2312;7.35;0.45;211.75;3.60;858;2;740.00;20
1435;2;21836666;1435;283;2297;2316;7.43;0.46;211.96;3.60;862;2;741.00;19
1439;2;21836679;1439;280;2298;2317;7.42;0.46;212.20;3.60;859;2;742.00;19
1444;2;21836691;1444;279;2300;2317;7.37;0.45;212.48;3.62;856;2;743.00;17
1447;2;21836703;1447;282;2302;2321;7.35;0.45;212.72;3.62;855;2;744.00;19
1450;2;21836715;1450;281;2305;2321;7.34;0.45;213.12;3.63;855;2;745.00;16
1454;2;21836726;1454;292;2306;2321;7.26;0.45;213.24;3.63;852;2;746.00;15
1456;2;21836744;1456;285;2308;2322;7.27;0.45;213.29;3.65;852;2;747.00;14
1459;2;21836756;1459;285;2308;2322;7.31;0.45;213.55;3.65;849;2;748.00;14
1460;2;21836769;1460;283;2313;2328;7.34;0.45;213.70;3.64;853;2;749.00;15
1463;2;21836785;1463;282;2316;2328;7.35;0.45;213.91;3.67;853;2;750.00;12
1466;2;21836797;1466;276;2318;2329;7.45;0.46;213.78;3.68;852;2;751.00;11
1467;2;21836809;1467;275;2320;2329;7.53;0.46;213.80;3.69;853;2;752.00;9
1469;2;21836820;1469;271;2320;2329;7.57;0.46;213.86;3.69;851;2;753.00;9
1469;2;21836832;1469;275;2320;2329;7.63;0.47;213.86;3.69;851;2;754.00;9
1474;2;21836843;1474;278;2320;2329;7.63;0.47;213.79;3.69;846;2;755.00;9
1477;2;21836863;1477;271;2333;2341;7.68;0.47;213.77;3.70;856;2;756.00;8
1480;2;21836876;1480;267;2334;2341;7.72;0.47;214.01;3.70;854;2;757.00;7
1482;2;21836887;1482;255;2335;2341;7.78;0.47;214.06;3.71;853;2;758.00;6
1483;2;21836907;1483;249;2336;2341;7.82;0.48;214.17;3.71;853;2;759.00;5
1484;2;21836920;1484;253;2336;2341;7.87;0.48;214.20;3.71;852;2;760.00;5
1486;2;21836932;1486;247;2336;2341;7.92;0.48;214.34;3.71;850;2;761.00;5
1488;2;21836945;1488;248;2340;2345;7.92;0.48;214.41;3.70;852;2;762.00;5
1490;2;21836957;1490;247;2340;2345;7.95;0.49;214.44;3.70;850;2;763.00;5
1492;2;21836976;1492;249;2344;2349;7.99;0.49;214.63;3.70;852;2;764.00;5
1493;2;21836988;1493;243;2346;2351;8.00;0.49;214.64;3.69;853;2;765.00;5
1495;2;21837001;1495;248;2346;2351;8.00;0.49;214.61;3.69;851;2;766.00;5
1496;2;21837013;1496;247;2346;2351;8.06;0.49;214.65;3.69;850;2;767.00;5
1498;2;21837025;1498;248;2357;2364;8.15;0.50;214.58;3.68;859;2;768.00;7
1503;2;21837037;1503;245;2357;2364;8.12;0.50;215.02;3.68;854;2;769.00;7
1505;2;21837049;1505;245;2357;2364;8.16;0.50;215.03;3.68;852;2;770.00;7
1507;2;21837062;1507;241;2358;2365;8.21;0.50;215.30;3.68;851;2;771.00;7
1510;2;21837073;1510;239;2358;2366;8.19;0.50;215.40;3.68;848;2;772.00;8
1513;2;21837085;1513;238;2358;2366;8.22;0.50;215.45;3.68;845;2;773.00;8
1515;2;21837097;1515;240;2360;2369;8.24;0.50;215.64;3.67;845;2;774.00;9
1515;2;21837108;1515;234;2360;2369;8.27;0.50;215.64;3.67;845;2;775.00;9
1518;2;21837121;1518;235;2361;2369;8.25;0.50;215.80;3.67;843;2;776.00;8
1521;2;21837133;1521;235;2361;2369;8.24;0.50;216.02;3.67;840;2;777.00;8
1523;2;21837145;1523;244;2366;2375;8.24;0.50;215.98;3.67;843;2;778.00;9
1527;2;21837156;1527;245;2366;2375;8.23;0.50;216.13;3.67;839;2;779.00;9
1531;2;21837172;1531;249;2366;2375;8.11;0.49;216.21;3.67;835;2;780.00;9
1532;2;21837184;1532;252;2366;2375;8.08;0.49;216.11;3.67;834;2;781.00;9
1532;2;21837196;1532;247;2369;2379;8.00;0.49;216.11;3.66;837;2;782.00;10
1535;2;21837206;1535;248;2370;2380;7.97;0.48;216.23;3.66;835;2;783.00;10
1536;2;21837219;1536;251;2370;2380;7.97;0.48;216.36;3.66;834;2;784.00;10
1536;2;21837230;1536;253;2371;2381;7.99;0.49;216.36;3.66;835;2;785.00;10
1538;2;21837240;1538;254;2371;2381;7.96;0.48;216.33;3.66;833;2;786.00;10
1538;2;21837254;1538;256;2371;2381;7.96;0.48;216.33;3.66;833;2;787.00;10
1541;2;21837267;1541;258;2371;2381;7.96;0.48;216.54;3.66;830;2;788.00;10
1543;2;21837278;1543;260;2371;2381;7.96;0.48;216.73;3.66;828;2;789.00;10
1543;2;21837289;1543;258;2371;2381;7.98;0.49;216.73;3.66;828;2;790.00;10
1545;2;21837300;1545;262;2371;2381;7.94;0.48;216.74;3.66;826;2;791.00;10
1547;2;21837312;1547;270;2400;2451;7.82;0.48;216.73;3.62;853;2;792.00;51
1549;2;21837329;1549;261;2400;2452;7.75;0.47;216.85;3.62;851;2;793.00;52
1550;2;21837343;1550;261;2404;2452;7.78;0.47;216.85;3.61;854;2;794.00;48
1553;2;21837354;1553;259;2405;2452;7.74;0.47;216.81;3.61;852;2;795.00;47
1554;2;21837366;1554;250;2407;2452;7.77;0.47;216.95;3.61;853;2;796.00;45
1558;2;21837377;1558;249;2408;2452;7.84;0.48;217.13;3.61;850;2;797.00;44
1562;2;21837388;1562;248;2410;2452;7.88;0.48;217.33;3.62;848;2;798.00;42
1562;2;21837400;1562;249;2412;2452;7.90;0.48;217.33;3.62;850;2;799.00;40
1565;2;21837412;1565;242;2412;2453;7.92;0.48;217.82;3.62;847;2;800.00;41
1571;2;21837428;1571;244;2415;2454;7.92;0.48;217.90;3.62;844;2;801.00;39
1573;2;21837439;1573;250;2416;2454;7.88;0.48;218.12;3.63;843;2;802.00;38
1575;2;21837450;1575;259;2421;2458;7.81;0.48;218.18;3.63;846;2;803.00;37
1576;2;21837461;1576;266;2425;2458;7.83;0.48;218.22;3.64;849;2;804.00;33
1580;2;21837471;1580;262;2429;2458;7.80;0.48;218.54;3.67;849;2;805.00;29
1582;2;21837482;1582;261;2431;2458;7.71;0.47;218.62;3.68;849;2;806.00;27
1585;2;21837493;1585;254;2436;2464;7.71;0.47;218.75;3.69;851;2;807.00;28
1586;2;21837503;1586;251;2437;2464;7.74;0.47;218.95;3.69;851;2;808.00;27
1589;2;21837514;1589;247;2437;2464;7.72;0.47;219.01;3.69;848;2;809.00;27
1590;2;21837527;1590;238;2444;2470;7.78;0.47;219.04;3.70;854;2;810.00;26
1592;2;21837539;1592;239;2444;2470;7.77;0.47;219.25;3.70;852;2;811.00;26
1593;2;21837550;1593;239;2447;2470;7.84;0.48;219.32;3.70;854;2;812.00;23
1595;2;21837561;1595;238;2447;2471;7.82;0.48;219.37;3.70;852;2;813.00;24
1598;2;21837572;1598;240;2448;2472;7.87;0.48;219.72;3.70;850;2;814.00;24
1602;2;21837583;1602;242;2448;2472;7.87;0.48;219.88;3.70;846;2;815.00;24
1602;2;21837600;1602;237;2457;2485;7.87;0.48;219.88;3.68;855;2;816.00;28
1603;2;21837612;1603;233;2457;2485;7.82;0.48;219.82;3.68;854;2;817.00;28
1605;2;21837622;1605;233;2457;2485;7.82;0.48;219.70;3.68;852;2;818.00;28
1606;2;21837636;1606;239;2458;2486;7.85;0.48;219.63;3.68;852;2;819.00;28
1610;2;21837647;1610;239;2458;2486;7.85;0.48;219.79;3.68;848;2;820.00;28
1611;2;21837659;1611;239;2461;2490;7.89;0.48;219.72;3.68;850;2;821.00;29
1611;2;21837669;1611;241;2462;2490;7.85;0.48;219.72;3.72;851;2;822.00;28
1612;2;21837682;1612;247;2465;2494;7.81;0.47;219.73;3.72;853;2;823.00;29
1615;2;21837692;1615;245;2465;2494;7.74;0.47;219.68;3.72;850;2;824.00;29
1616;2;21837703;1616;246;2466;2494;7.65;0.47;219.96;3.76;850;2;825.00;28
1619;2;21837713;1619;249;2467;2494;7.52;0.46;219.80;3.77;848;2;826.00;27
1620;2;21837730;1620;263;2468;2494;7.39;0.45;219.72;3.81;848;2;827.00;26
1621;2;21837741;1621;264;2479;2506;7.38;0.45;219.64;3.81;858;2;828.00;27
1624;2;21837752;1624;269;2481;2506;7.35;0.45;219.59;3.82;857;2;829.00;25
1625;2;21837763;1625;263;2485;2506;7.37;0.45;219.50;3.91;860;2;830.00;21
1627;2;21837773;1627;276;2486;2506;7.41;0.45;219.41;3.92;859;2;831.00;20
1627;2;21837785;1627;286;2488;2506;7.48;0.46;219.41;3.98;861;2;832.00;18
1629;2;21837795;1629;287;2491;2506;7.46;0.46;219.25;4.02;862;2;833.00;15
1630;2;21837805;1630;292;2493;2507;7.47;0.46;219.26;4.05;863;2;834.00;14
1631;2;21837821;1631;293;2494;2507;7.45;0.46;219.19;4.06;863;2;835.00;13
1635;2;21837835;1635;297;2501;2513;7.44;0.45;219.12;4.09;866;2;836.00;12
1635;2;21837850;1635;307;2502;2514;7.43;0.46;219.12;4.09;867;2;837.00;12
1637;2;21837865;1637;317;2503;2514;7.36;0.45;218.91;4.09;866;2;838.00;11
1639;2;21837879;1639;319;2505;2514;7.31;0.45;218.72;4.12;866;2;839.00;9
1644;2;21837893;1644;321;2509;2519;7.26;0.44;218.43;4.13;865;2;840.00;10
1646;2;21837907;1646;321;2510;2519;7.25;0.44;218.36;4.14;864;2;841.00;9
1650;2;21837919;1650;322;2513;2519;7.25;0.44;218.24;4.17;863;2;842.00;6
1651;2;21837931;1651;328;2514;2520;7.29;0.45;218.13;4.17;863;2;843.00;6
1654;2;21837942;1654;333;2519;2524;7.24;0.44;218.20;4.18;865;2;844.00;5
1656;2;21837953;1656;333;2520;2524;7.18;0.44;218.08;4.18;864;2;845.00;4
1659;2;21837963;1659;333;2523;2527;7.14;0.44;217.97;4.19;864;2;846.00;4
1659;2;21837973;1659;337;2526;2527;7.08;0.43;217.97;4.19;867;2;847.00;1
1662;2;21837984;1662;340;2526;2527;7.03;0.43;217.87;4.19;864;2;848.00;1
1663;2;21837994;1663;334;2527;2527;7.02;0.43;217.99;4.19;864;2;849.00;0
1664;2;21838004;1664;338;2531;2531;7.07;0.44;217.93;4.18;867;2;850.00;0
1665;2;21838015;1665;332;2531;2531;7.07;0.44;217.93;4.18;866;2;851.00;0
1667;2;21838026;1667;316;2531;2531;7.06;0.43;217.95;4.18;864;2;852.00;0
1670;2;21838036;1670;302;2531;2531;7.04;0.43;217.95;4.18;861;2;853.00;0
1671;2;21838048;1671;296;2532;2532;7.03;0.43;217.93;4.18;861;2;854.00;0
1674;2;21838058;1674;289;2534;2534;7.04;0.43;217.86;4.18;860;2;855.00;0
1674;2;21838069;1674;284;2534;2534;7.06;0.43;217.86;4.18;860;2;856.00;0
1675;2;21838079;1675;277;2535;2535;7.09;0.43;217.81;4.18;860;2;857.00;0
1677;2;21838089;1677;278;2535;2535;7.13;0.44;217.71;4.18;858;2;858.00;0
1680;2;21838100;1680;283;2535;2535;7.18;0.44;217.76;4.18;855;2;859.00;0
1681;2;21838111;1681;284;2535;2535;7.25;0.44;217.88;4.18;854;2;860.00;0
1682;2;21838122;1682;282;2535;2535;7.34;0.45;217.83;4.18;853;2;861.00;0
1685;2;21838133;1685;285;2535;2535;7.37;0.45;217.94;4.18;850;2;862.00;0
1686;2;21838146;1686;284;2535;2535;7.47;0.46;217.89;4.18;849;2;863.00;0
1692;2;21838155;1692;303;2609;2662;7.70;0.48;218.05;4.06;917;2;864.00;53
1693;2;21838180;1693;294;2614;2663;7.73;0.48;218.12;4.06;921;2;865.00;49
1695;2;21838191;1695;287;2623;2663;7.72;0.48;218.14;4.05;928;2;866.00;40
1698;2;21838207;1698;289;2628;2663;7.69;0.48;217.97;4.05;930;2;867.00;35
1701;2;21838218;1701;290;2632;2663;7.71;0.48;217.90;4.05;931;2;868.00;31
1702;2;21838229;1702;286;2634;2663;7.63;0.47;217.89;4.05;932;2;869.00;29
1704;2;21838241;1704;283;2637;2663;7.55;0.47;217.81;4.05;933;2;870.00;26
1706;2;21838252;1706;284;2639;2663;7.41;0.46;217.99;4.05;933;2;871.00;24
1706;2;21838264;1706;289;2641;2664;7.29;0.45;217.99;4.05;935;2;872.00;23
1711;2;21838275;1711;296;2646;2665;7.14;0.44;217.97;4.06;935;2;873.00;19
1715;2;21838286;1715;298;2648;2665;7.03;0.44;218.49;4.07;933;2;874.00;17
1717;2;21838298;1717;282;2651;2666;6.95;0.43;218.41;4.07;934;2;875.00;15
1723;2;21838310;1723;287;2653;2666;6.82;0.42;218.67;4.08;930;2;876.00;13
1726;2;21838321;1726;281;2654;2666;6.75;0.42;218.60;4.08;928;2;877.00;12
1732;2;21838333;1732;288;2655;2666;6.66;0.41;219.20;4.09;923;2;878.00;11
1738;2;21838344;1738;292;2660;2670;6.69;0.41;219.44;4.09;922;2;879.00;10
1741;2;21838355;1741;286;2663;2670;6.68;0.41;219.65;4.10;922;2;880.00;7
1744;2;21838366;1744;281;2665;2670;6.68;0.41;220.13;4.11;921;2;881.00;5
1745;2;21838377;1745;275;2667;2673;6.71;0.41;220.30;4.11;922;2;882.00;6
1748;2;21838387;1748;272;2668;2673;6.68;0.41;220.50;4.11;920;2;883.00;5
1753;2;21838399;1753;272;2668;2673;6.72;0.41;220.80;4.11;915;2;884.00;5
1758;2;21838410;1758;271;2674;2677;6.69;0.41;221.23;4.12;916;2;885.00;3
1760;2;21838421;1760;265;2677;2678;6.70;0.41;221.39;4.12;917;2;886.00;1
1764;2;21838432;1764;262;2677;2678;6.72;0.41;221.56;4.12;913;2;887.00;1
1767;2;21838443;1767;265;2682;2682;6.82;0.42;221.70;4.12;915;2;888.00;0
1767;2;21838454;1767;266;2682;2682;6.91;0.42;221.70;4.12;915;2;889.00;0
1771;2;21838465;1771;265;2682;2682;6.98;0.43;221.99;4.12;911;2;890.00;0
1774;2;21838483;1774;267;2683;2683;7.02;0.43;222.36;4.12;909;2;891.00;0
1777;2;21838502;1777;265;2683;2683;7.12;0.44;222.59;4.12;906;2;892.00;0
1783;2;21838514;1783;267;2689;2689;7.17;0.44;222.51;4.11;906;2;893.00;0
1788;2;21838532;1788;261;2689;2689;7.14;0.44;223.19;4.11;901;2;894.00;0
1791;2;21838543;1791;254;2690;2690;7.17;0.44;223.15;4.11;899;2;895.00;0
1795;2;21838554;1795;256;2690;2690;7.17;0.44;223.46;4.11;895;2;896.00;0
1801;2;21838565;1801;256;2690;2690;7.18;0.44;223.88;4.11;889;2;897.00;0
1804;2;21838580;1804;259;2690;2690;7.23;0.44;223.97;4.11;886;2;898.00;0
1807;2;21838600;1807;260;2690;2690;7.20;0.44;224.40;4.11;883;2;899.00;0
1807;2;21838626;1807;264;2721;2736;7.22;0.44;224.40;4.06;914;2;900.00;15
1810;2;21838650;1810;263;2723;2736;7.18;0.44;224.67;4.06;913;2;901.00;13
1813;2;21838666;1813;259;2726;2736;7.22;0.44;224.70;4.06;913;2;902.00;10
1815;2;21838681;1815;264;2726;2736;7.26;0.45;224.76;4.06;911;2;903.00;10
1823;2;21838697;1823;265;2728;2736;7.28;0.45;225.34;4.06;905;2;904.00;8
1829;2;21838712;1829;264;2728;2736;7.34;0.45;225.46;4.06;899;2;905.00;8
1830;2;21838730;1830;267;2733;2740;7.42;0.46;225.52;4.05;903;2;906.00;7
1836;2;21838747;1836;270;2734;2740;7.45;0.46;225.54;4.06;898;2;907.00;6
1838;2;21838761;1838;273;2737;2744;7.50;0.46;225.50;4.05;899;2;908.00;7
1840;2;21838774;1840;281;2738;2745;7.50;0.46;225.69;4.05;898;2;909.00;7
1843;2;21838788;1843;284;2738;2745;7.54;0.46;226.12;4.05;895;2;910.00;7
1847;2;21838801;1847;280;2738;2745;7.53;0.46;226.68;4.05;891;2;911.00;7
1852;2;21838820;1852;284;2751;2758;7.60;0.46;226.86;4.04;899;2;912.00;7
1856;2;21838833;1856;286;2752;2758;7.58;0.46;227.15;4.04;896;2;913.00;6
1860;2;21838845;1860;287;2752;2758;7.55;0.46;227.42;4.04;892;2;914.00;6
1864;2;21838856;1864;288;2753;2759;7.47;0.46;227.64;4.04;889;2;915.00;6
1867;2;21838869;1867;293;2753;2760;7.44;0.45;227.47;4.04;886;2;916.00;7
1868;2;21838881;1868;297;2753;2760;7.40;0.45;227.67;4.04;885;2;917.00;7
1876;2;21838892;1876;306;2757;2763;7.31;0.45;228.14;4.04;881;2;918.00;6
1877;2;21838904;1877;310;2758;2763;7.28;0.44;228.29;4.05;881;2;919.00;5
1879;2;21838914;1879;319;2759;2763;7.21;0.44;228.51;4.04;880;2;920.00;4
1883;2;21838926;1883;321;2759;2763;7.09;0.43;228.87;4.04;876;2;921.00;4
1886;2;21838938;1886;308;2764;2769;6.98;0.43;229.05;4.04;878;2;922.00;5
1889;2;21838950;1889;306;2764;2769;6.89;0.42;229.09;4.04;875;2;923.00;5
1890;2;21838961;1890;301;2765;2769;6.86;0.42;229.27;4.05;875;2;924.00;4
1891;2;21838972;1891;296;2767;2769;6.89;0.42;229.26;4.06;876;2;925.00;2
1893;2;21838990;1893;293;2771;2773;6.92;0.42;229.41;4.05;878;2;926.00;2
1896;2;21839002;1896;292;2774;2774;6.95;0.42;229.40;4.06;878;2;927.00;0
1898;2;21839015;1898;288;2774;2774;6.97;0.42;229.55;4.06;876;2;928.00;0
1903;2;21839026;1903;287;2775;2775;6.99;0.43;230.00;4.06;872;2;929.00;0
1906;2;21839039;1906;289;2775;2775;7.02;0.43;230.19;4.06;869;2;930.00;0
1908;2;21839051;1908;288;2775;2775;7.06;0.43;230.36;4.06;867;2;931.00;0
1912;2;21839062;1912;279;2775;2775;7.07;0.43;230.27;4.06;863;2;932.00;0
1917;2;21839073;1917;273;2775;2775;7.11;0.43;230.30;4.06;858;2;933.00;0
1920;2;21839085;1920;271;2775;2775;7.25;0.44;230.56;4.06;855;2;934.00;0
1922;2;21839096;1922;271;2775;2775;7.33;0.45;230.61;4.06;853;2;935.00;0
1924;2;21839107;1924;289;2817;2845;7.46;0.46;230.56;4.00;893;2;936.00;28
1928;2;21839124;1928;278;2818;2846;7.48;0.46;230.85;4.00;890;2;937.00;28
1932;2;21839137;1932;281;2823;2846;7.64;0.47;231.10;3.99;891;2;938.00;23
1936;2;21839149;1936;289;2823;2846;7.67;0.47;231.44;3.99;887;2;939.00;23
1941;2;21839161;1941;287;2827;2846;7.74;0.47;231.46;3.99;886;2;940.00;19
1941;2;21839172;1941;288;2830;2846;7.72;0.47;231.46;3.99;889;2;941.00;16
1944;2;21839183;1944;286;2832;2846;7.68;0.47;231.65;3.99;888;2;942.00;14
1947;2;21839195;1947;289;2835;2846;7.64;0.47;231.61;4.00;888;2;943.00;11
1950;2;21839206;1950;286;2838;2847;7.66;0.47;231.86;4.00;888;2;944.00;9
1951;2;21839218;1951;281;2840;2849;7.63;0.47;231.90;4.00;889;2;945.00;9
1953;2;21839230;1953;285;2841;2849;7.67;0.47;231.87;4.00;888;2;946.00;8
1954;2;21839241;1954;282;2844;2853;7.67;0.47;231.95;4.00;890;2;947.00;9
1957;2;21839253;1957;281;2845;2853;7.68;0.47;232.07;4.00;888;2;948.00;8
1958;2;21839264;1958;279;2845;2853;7.66;0.47;232.07;4.00;887;2;949.00;8
1962;2;21839275;1962;283;2845;2853;7.66;0.47;232.18;4.00;883;2;950.00;8
1966;2;21839286;1966;277;2850;2859;7.64;0.46;232.35;4.00;884;2;951.00;9
1971;2;21839298;1971;274;2850;2859;7.65;0.46;232.54;4.00;879;2;952.00;9
1972;2;21839309;1972;271;2850;2859;7.64;0.46;232.53;4.00;878;2;953.00;9
1975;2;21839320;1975;264;2852;2862;7.67;0.47;232.77;3.99;877;2;954.00;10
1976;2;21839332;1976;260;2852;2862;7.70;0.47;232.77;3.99;876;2;955.00;10
1979;2;21839343;1979;256;2853;2862;7.75;0.47;232.81;3.99;874;2;956.00;9
1980;2;21839354;1980;259;2853;2863;7.81;0.47;232.88;3.99;873;2;957.00;10
1981;2;21839365;1981;262;2854;2864;7.87;0.48;232.92;3.99;873;2;958.00;10
1983;2;21839376;1983;265;2855;2864;7.88;0.48;233.07;4.00;872;2;959.00;9
1984;2;21839388;1984;277;2876;2890;7.87;0.48;233.14;3.98;892;2;960.00;14
1986;2;21839401;1986;278;2876;2890;7.87;0.48;233.21;3.98;890;2;961.00;14
1989;2;21839411;1989;279;2878;2890;7.87;0.48;233.21;3.98;889;2;962.00;12
1993;2;21839422;1993;279;2881;2891;7.85;0.48;233.52;4.00;888;2;963.00;10
1993;2;21839433;1993;292;2882;2891;7.84;0.48;233.52;4.00;889;2;964.00;9
1993;2;21839444;1993;289;2886;2895;7.94;0.48;233.52;3.99;893;2;965.00;9
1996;2;21839455;1996;286;2888;2895;7.95;0.48;233.54;4.00;892;2;966.00;7
1997;2;21839466;1997;279;2890;2899;7.94;0.48;233.54;4.00;893;2;967.00;9
1997;2;21839477;1997;279;2891;2899;7.94;0.48;233.54;4.00;894;2;968.00;8
2001;2;21839487;2001;278;2892;2899;7.93;0.48;233.74;4.00;891;2;969.00;7
2002;2;21839498;2002;277;2892;2899;7.89;0.48;233.70;4.00;890;2;970.00;7
2003;2;21839509;2003;274;2892;2899;7.87;0.48;233.80;4.00;889;2;971.00;7
2007;2;21839520;2007;273;2901;2911;7.84;0.47;233.89;3.99;894;2;972.00;10
2009;2;21839532;2009;275;2901;2911;7.81;0.47;233.98;3.99;892;2;973.00;10
2013;2;21839543;2013;279;2903;2911;7.80;0.47;234.26;3.99;890;2;974.00;8
2017;2;21839553;2017;279;2903;2911;7.76;0.47;234.35;3.99;886;2;975.00;8
2017;2;21839564;2017;275;2903;2911;7.77;0.47;234.35;3.99;886;2;976.00;8
2019;2;21839573;2019;278;2903;2911;7.73;0.47;234.29;3.99;884;2;977.00;8
2019;2;21839584;2019;282;2903;2912;7.66;0.47;234.29;3.99;884;2;978.00;9
2019;2;21839594;2019;278;2903;2912;7.66;0.47;234.29;3.99;884;2;979.00;9
2021;2;21839604;2021;278;2910;2918;7.63;0.47;234.48;4.01;889;2;980.00;8
2023;2;21839615;2023;279;2911;2919;7.50;0.46;234.61;4.00;888;2;981.00;8
2027;2;21839625;2027;277;2911;2919;7.41;0.45;234.59;4.00;884;2;982.00;8
2031;2;21839636;2031;273;2911;2919;7.32;0.45;234.54;4.00;880;2;983.00;8
2033;2;21839646;2033;277;2913;2923;7.27;0.44;234.63;4.00;880;2;984.00;10
2036;2;21839656;2036;272;2913;2923;7.30;0.44;234.59;4.00;877;2;985.00;10
2037;2;21839667;2037;275;2913;2923;7.30;0.44;234.56;4.00;876;2;986.00;10
2038;2;21839678;2038;270;2914;2924;7.34;0.45;234.58;4.00;876;2;987.00;10
2041;2;21839688;2041;269;2917;2928;7.39;0.45;234.45;4.00;876;2;988.00;11
2046;2;21839699;2046;271;2917;2928;7.41;0.45;234.54;4.00;871;2;989.00;11
2051;2;21839711;2051;271;2921;2934;7.43;0.45;234.24;3.99;870;2;990.00;13
2053;2;21839722;2053;272;2922;2934;7.48;0.45;234.44;3.99;869;2;991.00;12
2055;2;21839732;2055;268;2923;2934;7.45;0.45;234.30;3.99;868;2;992.00;11
2056;2;21839742;2056;273;2924;2934;7.42;0.45;234.31;3.99;868;2;993.00;10
2059;2;21839752;2059;272;2928;2938;7.44;0.45;234.08;3.99;869;2;994.00;10
2061;2;21839762;2061;277;2928;2938;7.41;0.45;233.88;3.99;867;2;995.00;10
2065;2;21839772;2065;273;2928;2938;7.34;0.45;233.59;3.99;863;2;996.00;10
2066;2;21839782;2066;277;2928;2938;7.31;0.45;233.60;3.99;862;2;997.00;10
2067;2;21839791;2067;278;2928;2939;7.24;0.44;233.62;3.99;861;2;998.00;11
2068;2;21839802;2068;279;2929;2940;7.14;0.44;233.62;3.99;861;2;999.00;11
2071;2;21839814;2071;285;2929;2940;7.01;0.43;233.58;3.99;858;2;1000.00;11
2074;2;21839833;2074;292;2930;2941;6.92;0.42;233.56;3.98;856;2;1001.00;11
2075;2;21839848;2075;299;2930;2941;6.85;0.42;233.56;3.98;855;2;1002.00;11
2075;2;21839861;2075;295;2930;2941;6.83;0.42;233.56;3.98;855;2;1003.00;11
2077;2;21839873;2077;300;2930;2941;6.78;0.42;233.56;3.98;853;2;1004.00;11
2079;3;21839886;2079;308;2931;2941;6.73;0.41;233.54;4.00;852;3;1005.00;10
2080;3;21839916;2080;309;2932;2941;6.69;0.41;233.53;4.02;852;3;1006.00;9
2081;3;21839932;2081;313;2932;2941;6.69;0.41;233.44;4.02;851;3;1007.00;9
2082;3;21839943;2082;337;3003;3068;6.95;0.43;233.40;3.95;921;3;1008.00;65
2086;3;21839962;2086;322;3006;3069;6.92;0.43;233.26;3.95;920;3;1009.00;63
2087;3;21839973;2087;310;3017;3069;6.99;0.44;233.29;3.96;930;3;1010.00;52
2089;3;21839984;2089;306;3021;3069;7.03;0.44;233.35;3.95;932;3;1011.00;48
2089;3;21839994;2089;302;3029;3069;7.07;0.44;233.35;3.97;940;3;1012.00;40
2090;3;21840007;2090;300;3031;3069;7.10;0.44;233.31;3.97;941;3;1013.00;38
2094;3;21840019;2094;300;3035;3069;7.21;0.45;233.68;3.98;941;3;1014.00;34
2096;3;21840030;2096;301;3037;3069;7.21;0.45;233.62;3.99;941;3;1015.00;32
2098;3;21840053;2098;302;3042;3070;7.31;0.45;233.67;4.01;944;3;1016.00;28
2100;3;21840065;2100;305;3047;3071;7.39;0.46;233.67;4.02;947;3;1017.00;24
2101;3;21840076;2101;305;3050;3071;7.45;0.46;233.64;4.03;949;3;1018.00;21
2103;3;21840087;2103;306;3055;3072;7.41;0.46;233.68;4.05;952;3;1019.00;17
2104;3;21840100;2104;307;3058;3072;7.33;0.45;233.57;4.05;954;3;1020.00;14
2106;3;21840111;2106;308;3060;3072;7.23;0.44;233.66;4.06;954;3;1021.00;12
2108;3;21840121;2108;315;3065;3072;7.09;0.44;233.61;4.07;957;3;1022.00;7
2109;3;21840132;2109;317;3069;3076;6.99;0.43;233.51;4.07;960;3;1023.00;7
2110;3;21840143;2110;317;3071;3076;6.91;0.43;233.46;4.08;961;3;1024.00;5
2112;3;21840154;2112;316;3073;3076;6.87;0.42;233.39;4.08;961;3;1025.00;3
2114;3;21840165;2114;320;3074;3079;6.84;0.42;233.35;4.08;960;3;1026.00;5
2116;3;21840176;2116;316;3075;3079;6.78;0.42;233.45;4.08;959;3;1027.00;4
2118;3;21840187;2118;315;3076;3079;6.75;0.41;233.46;4.09;958;3;1028.00;3
2120;3;21840199;2120;312;3080;3083;6.67;0.41;233.35;4.08;960;3;1029.00;3
2123;3;21840210;2123;311;3083;3084;6.66;0.41;233.24;4.09;960;3;1030.00;1
2124;3;21840221;2124;306;3083;3084;6.69;0.41;233.19;4.09;959;3;1031.00;1
2128;3;21840231;2128;304;3087;3088;6.69;0.41;233.41;4.08;959;3;1032.00;1
2129;3;21840243;2129;296;3088;3088;6.68;0.41;233.36;4.08;959;3;1033.00;0
2134;3;21840253;2134;299;3088;3088;6.63;0.41;233.27;4.08;954;3;1034.00;0
2137;3;21840264;2137;298;3090;3090;6.57;0.40;233.41;4.08;953;3;1035.00;0
2141;3;21840275;2141;301;3090;3090;6.47;0.40;233.69;4.08;949;3;1036.00;0
2143;3;21840285;2143;298;3096;3096;6.55;0.40;233.60;4.08;953;3;1037.00;0
2147;3;21840296;2147;303;3096;3096;6.54;0.40;233.68;4.08;949;3;1038.00;0
2149;3;21840306;2149;300;3097;3097;6.54;0.40;233.78;4.08;948;3;1039.00;0
2151;3;21840317;2151;309;3097;3097;6.50;0.40;233.83;4.08;946;3;1040.00;0
2154;4;21840327;2154;306;3097;3097;6.43;0.39;233.81;4.08;943;4;1041.00;0
2157;4;21840352;2157;312;3097;3097;6.38;0.39;233.88;4.08;940;4;1042.00;0
2160;4;21840367;2160;317;3097;3097;6.36;0.39;234.05;4.08;937;4;1043.00;0
2165;4;21840377;2165;321;3109;3109;6.34;0.39;234.14;4.06;944;4;1044.00;0
2167;4;21840388;2167;320;3109;3109;6.27;0.38;234.15;4.06;942;4;1045.00;0
2169;4;21840398;2169;316;3109;3109;6.26;0.38;234.27;4.06;940;4;1046.00;0
2171;4;21840408;2171;322;3109;3109;6.22;0.38;234.26;4.06;938;4;1047.00;0
2174;4;21840418;2174;328;3109;3109;6.19;0.38;234.38;4.06;935;4;1048.00;0
2176;4;21840427;2176;329;3109;3109;6.19;0.38;234.31;4.06;933;4;1049.00;0
2180;4;21840438;2180;313;3115;3115;6.16;0.38;234.56;4.05;935;4;1050.00;0
2187;4;21840450;2187;300;3115;3115;6.17;0.38;234.85;4.05;928;4;1051.00;0
2192;4;21840461;2192;298;3119;3119;6.27;0.38;235.13;4.05;927;4;1052.00;0
2196;4;21840471;2196;300;3120;3120;6.34;0.39;235.50;4.05;924;4;1053.00;0
2196;4;21840482;2196;291;3120;3120;6.39;0.39;235.50;4.05;924;4;1054.00;0
2202;4;21840492;2202;289;3120;3120;6.43;0.40;236.18;4.05;918;4;1055.00;0
2205;4;21840503;2205;279;3132;3133;6.49;0.40;236.53;4.03;927;4;1056.00;1
2207;4;21840514;2207;274;3133;3133;6.57;0.40;236.45;4.03;926;4;1057.00;0
2212;4;21840525;2212;262;3133;3133;6.62;0.41;236.86;4.03;921;4;1058.00;0
2217;4;21840536;2217;260;3134;3134;6.68;0.41;237.03;4.03;917;4;1059.00;0
2219;4;21840547;2219;260;3135;3135;6.77;0.41;236.95;4.03;916;4;1060.00;0
2225;4;21840557;2225;255;3135;3135;6.79;0.41;237.20;4.03;910;4;1061.00;0
2230;4;21840569;2230;253;3137;3138;6.85;0.42;237.55;4.03;907;4;1062.00;1
2233;4;21840580;2233;249;3138;3138;6.87;0.42;237.66;4.03;905;4;1063.00;0
2239;4;21840591;2239;254;3138;3138;6.84;0.41;238.05;4.03;899;4;1064.00;0
2244;4;21840601;2244;258;3138;3138;6.86;0.41;238.32;4.03;894;4;1065.00;0
2249;4;21840612;2249;260;3144;3144;6.89;0.42;238.45;4.02;895;4;1066.00;0
2253;4;21840623;2253;260;3144;3144;6.90;0.42;238.83;4.02;891;4;1067.00;0
2258;4;21840634;2258;260;3144;3144;6.93;0.42;239.17;4.02;886;4;1068.00;0
2261;4;21840645;2261;264;3144;3144;6.94;0.42;239.20;4.02;883;4;1069.00;0
2267;4;21840656;2267;261;3148;3148;6.96;0.42;239.43;4.02;881;4;1070.00;0
2272;4;21840667;2272;263;3149;3149;6.97;0.42;239.81;4.01;877;4;1071.00;0
2274;4;21840679;2274;270;3149;3149;7.01;0.43;240.08;4.01;875;4;1072.00;0
2279;4;21840689;2279;269;3150;3150;7.06;0.43;240.53;4.01;871;4;1073.00;0
2281;4;21840700;2281;272;3150;3150;7.07;0.43;240.75;4.01;869;4;1074.00;0
2282;4;21840711;2282;273;3150;3150;7.15;0.44;240.69;4.01;868;4;1075.00;0
2288;4;21840721;2288;270;3150;3150;7.24;0.44;240.98;4.01;862;4;1076.00;0
2292;4;21840732;2292;274;3150;3150;7.26;0.44;241.29;4.01;858;4;1077.00;0
2294;4;21840743;2294;272;3150;3150;7.33;0.45;241.35;4.01;856;4;1078.00;0
2298;4;21840760;2298;266;3150;3150;7.37;0.45;241.61;4.01;852;4;1079.00;0
2301;4;21840772;2301;288;3224;3275;7.54;0.47;241.73;3.92;923;4;1080.00;51
2306;4;21840794;2306;276;3230;3276;7.53;0.47;242.02;3.92;924;4;1081.00;46
2312;4;21840808;2312;271;3238;3276;7.58;0.47;242.14;3.91;926;4;1082.00;38
2313;4;21840822;2313;266;3239;3276;7.58;0.47;242.32;3.91;926;4;1083.00;37
2320;4;21840833;2320;263;3244;3276;7.55;0.47;242.38;3.91;924;4;1084.00;32
2324;4;21840845;2324;259;3245;3276;7.58;0.47;242.58;3.91;921;4;1085.00;31
2327;4;21840857;2327;260;3250;3276;7.66;0.47;242.55;3.92;923;4;1086.00;26
2331;4;21840869;2331;264;3253;3276;7.66;0.47;242.88;3.92;922;4;1087.00;23
2335;4;21840881;2335;269;3257;3277;7.60;0.47;243.23;3.92;922;4;1088.00;20
2338;4;21840893;2338;284;3263;3278;7.52;0.46;243.50;3.93;925;4;1089.00;15
2340;4;21840904;2340;284;3267;3278;7.36;0.45;243.67;3.94;927;4;1090.00;11
2344;4;21840916;2344;291;3272;3282;7.26;0.45;244.03;3.94;928;4;1091.00;10
2345;4;21840928;2345;290;3273;3282;7.14;0.44;244.20;3.94;928;4;1092.00;9
2348;4;21840939;2348;294;3274;3282;7.02;0.43;244.29;3.94;926;4;1093.00;8
2351;4;21840951;2351;305;3274;3282;6.93;0.43;244.49;3.94;923;4;1094.00;8
2356;4;21840962;2356;310;3279;3288;6.85;0.42;244.61;3.94;923;4;1095.00;9
2359;4;21840975;2359;315;3280;3288;6.82;0.42;244.88;3.94;921;4;1096.00;8
2363;4;21840986;2363;312;3281;3288;6.84;0.42;244.97;3.94;918;4;1097.00;7
2366;4;21840998;2366;307;3284;3291;6.85;0.42;245.13;3.94;918;4;1098.00;7
2369;4;21841011;2369;303;3284;3291;6.85;0.42;245.44;3.94;915;4;1099.00;7
2371;4;21841023;2371;305;3284;3291;6.87;0.42;245.54;3.94;913;4;1100.00;7
2372;4;21841038;2372;310;3285;3292;6.92;0.42;245.65;3.94;913;4;1101.00;7
2377;4;21841050;2377;315;3286;3293;6.86;0.42;245.67;3.94;909;4;1102.00;7
2378;4;21841062;2378;311;3287;3293;6.85;0.42;245.58;3.94;909;4;1103.00;6
2382;4;21841073;2382;315;3297;3306;6.89;0.42;245.95;3.93;915;4;1104.00;9
2384;4;21841085;2384;311;3297;3306;6.84;0.42;246.03;3.93;913;4;1105.00;9
2385;4;21841096;2385;302;3298;3306;6.81;0.42;246.04;3.93;913;4;1106.00;8
2387;4;21841113;2387;301;3299;3307;6.80;0.42;246.15;3.93;912;4;1107.00;8
2390;4;21841126;2390;298;3299;3307;6.84;0.42;246.21;3.93;909;4;1108.00;8
2392;4;21841137;2392;297;3303;3311;6.93;0.42;246.12;3.92;911;4;1109.00;8
2395;4;21841151;2395;289;3303;3311;6.99;0.43;246.32;3.92;908;4;1110.00;8
2399;4;21841163;2399;287;3305;3315;6.98;0.42;246.63;3.92;906;4;1111.00;10
2402;4;21841176;2402;286;3305;3315;7.06;0.43;246.76;3.92;903;4;1112.00;10
2403;4;21841187;2403;280;3305;3315;7.11;0.43;246.86;3.92;902;4;1113.00;10
2405;4;21841199;2405;283;3305;3315;7.15;0.43;246.87;3.92;900;4;1114.00;10
2406;4;21841210;2406;285;3306;3315;7.11;0.43;247.03;3.93;900;4;1115.00;9
2409;4;21841222;2409;290;3316;3327;7.20;0.44;247.35;3.92;907;4;1116.00;11
2410;4;21841234;2410;290;3317;3327;7.28;0.44;247.41;3.93;907;4;1117.00;10
2412;4;21841246;2412;286;3319;3327;7.38;0.45;247.56;3.94;907;4;1118.00;8
2414;4;21841258;2414;284;3319;3327;7.44;0.45;247.68;3.94;905;4;1119.00;8
2415;4;21841270;2415;285;3320;3327;7.47;0.46;247.92;3.95;905;4;1120.00;7
2421;4;21841281;2421;283;3320;3327;7.47;0.45;247.91;3.95;899;4;1121.00;7
2423;4;21841293;2423;277;3321;3328;7.53;0.46;248.10;3.96;898;4;1122.00;7
2426;4;21841304;2426;278;3322;3328;7.59;0.46;248.18;3.97;896;4;1123.00;6
2430;4;21841317;2430;276;3328;3334;7.63;0.46;248.55;3.97;898;4;1124.00;6
2433;4;21841329;2433;276;3330;3336;7.56;0.46;248.38;3.97;897;4;1125.00;6
2435;4;21841341;2435;273;3330;3336;7.54;0.46;248.68;3.97;895;4;1126.00;6
2436;4;21841354;2436;278;3330;3336;7.52;0.46;248.63;3.97;894;4;1127.00;6
2439;4;21841366;2439;270;3333;3340;7.50;0.46;248.74;3.96;894;4;1128.00;7
2441;4;21841378;2441;272;3333;3340;7.48;0.46;248.75;3.96;892;4;1129.00;7
2442;4;21841389;2442;275;3333;3340;7.50;0.46;248.82;3.96;891;4;1130.00;7
2444;4;21841400;2444;269;3334;3341;7.55;0.46;248.78;3.96;890;4;1131.00;7
2446;4;21841412;2446;276;3337;3345;7.51;0.46;248.79;3.96;891;4;1132.00;8
2449;4;21841423;2449;274;3337;3345;7.45;0.46;248.76;3.96;888;4;1133.00;8
2452;4;21841434;2452;283;3339;3348;7.45;0.46;248.80;3.96;887;4;1134.00;9
2454;4;21841446;2454;281;3339;3348;7.46;0.46;248.87;3.96;885;4;1135.00;9
2457;4;21841456;2457;285;3340;3348;7.46;0.46;248.88;3.96;883;4;1136.00;8
2457;4;21841467;2457;287;3340;3348;7.42;0.45;248.88;3.96;883;4;1137.00;8
2458;4;21841478;2458;294;3344;3352;7.42;0.45;248.86;3.95;886;4;1138.00;8
2462;4;21841488;2462;295;3344;3352;7.33;0.45;248.80;3.95;882;4;1139.00;8
2466;4;21841500;2466;289;3344;3352;7.27;0.44;248.62;3.95;878;4;1140.00;8
2470;4;21841511;2470;286;3344;3352;7.30;0.44;248.50;3.95;874;4;1141.00;8
2475;4;21841522;2475;288;3344;3353;7.28;0.44;248.58;3.95;869;4;1142.00;9
2477;4;21841533;2477;280;3345;3354;7.32;0.44;248.54;3.95;868;4;1143.00;9
2480;4;21841543;2480;281;3345;3354;7.32;0.44;248.44;3.95;865;4;1144.00;9
2482;4;21841555;2482;277;3346;3355;7.37;0.45;248.49;3.95;864;4;1145.00;9
2486;4;21841566;2486;275;3346;3355;7.37;0.45;248.44;3.95;860;4;1146.00;9
2486;4;21841576;2486;273;3346;3355;7.41;0.45;248.44;3.95;860;4;1147.00;9
2488;4;21841586;2488;273;3346;3355;7.43;0.45;248.44;3.95;858;4;1148.00;9
2489;4;21841597;2489;274;3346;3355;7.48;0.45;248.37;3.95;857;4;1149.00;9
2493;4;21841607;2493;268;3346;3355;7.44;0.45;248.46;3.95;853;4;1150.00;9
2494;4;21841618;2494;269;3346;3355;7.41;0.45;248.37;3.95;852;4;1151.00;9
2497;4;21841628;2497;285;3414;3482;7.41;0.46;248.11;3.87;917;4;1152.00;68
2498;4;21841649;2498;282;3414;3483;7.38;0.45;248.12;3.87;916;4;1153.00;69
2500;4;21841660;2500;274;3421;3483;7.38;0.45;248.24;3.87;921;4;1154.00;62
2502;4;21841670;2502;274;3423;3483;7.30;0.45;248.20;3.90;921;4;1155.00;60
2503;4;21841682;2503;271;3429;3483;7.29;0.45;248.20;3.90;926;4;1156.00;54
2506;4;21841693;2506;272;3434;3483;7.24;0.45;248.03;3.90;928;4;1157.00;49
2507;4;21841703;2507;278;3440;3483;7.22;0.44;248.11;3.90;933;4;1158.00;43
2511;4;21841720;2511;276;3443;3483;7.22;0.44;248.20;3.90;932;4;1159.00;40
2512;4;21841731;2512;277;3446;3484;7.20;0.44;248.24;3.91;934;4;1160.00;38
2512;4;21841742;2512;274;3450;3485;7.13;0.44;248.24;3.91;938;4;1161.00;35
2513;4;21841752;2513;271;3452;3485;7.13;0.44;248.26;3.92;939;4;1162.00;33
2515;4;21841763;2515;271;3453;3486;7.09;0.43;248.17;3.92;938;4;1163.00;33
2517;4;21841775;2517;275;3455;3486;7.05;0.43;248.17;3.92;938;4;1164.00;31
2518;4;21841786;2518;274;3457;3486;7.01;0.43;248.13;3.93;939;4;1165.00;29
2519;4;21841797;2519;256;3459;3486;7.07;0.43;248.14;3.94;940;4;1166.00;27
2520;4;21841807;2520;247;3463;3490;7.05;0.43;248.15;3.95;943;4;1167.00;27
2522;4;21841834;2522;237;3464;3490;7.07;0.43;248.11;3.95;942;4;1168.00;26
2524;4;21841848;2524;235;3465;3490;7.10;0.43;248.04;3.95;941;4;1169.00;25
2526;4;21841865;2526;234;3469;3496;7.14;0.44;247.97;3.95;943;4;1170.00;27
2526;4;21841880;2526;232;3471;3496;7.20;0.44;247.97;3.95;945;4;1171.00;25
2526;4;21841894;2526;233;3472;3496;7.24;0.44;247.97;3.95;946;4;1172.00;24
2526;4;21841917;2526;240;3477;3500;7.29;0.44;247.97;3.96;951;4;1173.00;23
2529;4;21841931;2529;238;3479;3501;7.34;0.45;247.87;3.96;950;4;1174.00;22
2530;4;21841959;2530;245;3481;3501;7.35;0.45;247.95;3.97;951;4;1175.00;20
2534;4;21841972;2534;253;3485;3505;7.37;0.45;247.77;3.97;951;4;1176.00;20
2535;4;21841986;2535;249;3485;3505;7.36;0.45;247.71;3.97;950;4;1177.00;20
2535;4;21841998;2535;245;3486;3505;7.38;0.45;247.71;3.98;951;4;1178.00;19
2537;4;21842010;2537;253;3488;3506;7.31;0.44;247.64;3.98;951;4;1179.00;18
2541;4;21842022;2541;256;3489;3506;7.26;0.44;247.47;4.00;948;4;1180.00;17
2544;4;21842033;2544;266;3495;3512;7.30;0.44;247.35;4.01;951;4;1181.00;17
2544;4;21842057;2544;266;3495;3512;7.33;0.45;247.35;4.01;951;4;1182.00;17
2546;4;21842068;2546;271;3497;3513;7.32;0.44;247.28;4.03;951;4;1183.00;16
2548;4;21842079;2548;277;3499;3513;7.32;0.44;247.17;4.06;951;4;1184.00;14
2550;4;21842090;2550;285;3499;3513;7.38;0.45;247.27;4.06;949;4;1185.00;14
2551;4;21842102;2551;284;3500;3513;7.36;0.45;247.29;4.07;949;4;1186.00;13
2551;4;21842113;2551;279;3501;3513;7.39;0.45;247.29;4.08;950;4;1187.00;12
2554;4;21842124;2554;275;3512;3525;7.48;0.45;247.22;4.08;958;4;1188.00;13
2556;4;21842136;2556;281;3513;3525;7.39;0.45;247.08;4.09;957;4;1189.00;12
2558;4;21842148;2558;282;3514;3525;7.37;0.45;247.02;4.09;956;4;1190.00;11
2560;4;21842158;2560;281;3516;3525;7.33;0.45;247.09;4.10;956;4;1191.00;9
2563;4;21842170;2563;285;3517;3525;7.28;0.44;247.05;4.11;954;4;1192.00;8
2565;4;21842181;2565;284;3517;3525;7.30;0.45;247.20;4.11;952;4;1193.00;8
2568;4;21842192;2568;284;3520;3529;7.22;0.44;247.21;4.11;952;4;1194.00;9
2569;4;21842203;2569;282;3523;3529;7.21;0.44;247.21;4.14;954;4;1195.00;6
2569;4;21842215;2569;280;3527;3533;7.26;0.44;247.21;4.14;958;4;1196.00;6
2570;4;21842226;2570;282;3529;3534;7.28;0.45;247.17;4.15;959;4;1197.00;5
2572;4;21842237;2572;283;3529;3534;7.27;0.45;247.20;4.15;957;4;1198.00;5
2575;4;21842248;2575;276;3532;3534;7.20;0.44;247.22;4.16;957;4;1199.00;2
2578;4;21842262;2578;286;3556;3575;7.22;0.45;247.15;4.13;978;4;1200.00;19
2580;4;21842284;2580;280;3557;3575;7.25;0.45;247.25;4.13;977;4;1201.00;18
2582;4;21842296;2582;280;3560;3575;7.35;0.45;247.40;4.13;978;4;1202.00;15
2583;4;21842307;2583;278;3563;3576;7.42;0.46;247.43;4.13;980;4;1203.00;13
2588;4;21842319;2588;276;3566;3577;7.34;0.45;247.67;4.14;978;4;1204.00;11
2592;4;21842331;2592;274;3566;3577;7.40;0.45;247.68;4.14;974;4;1205.00;11
2593;4;21842343;2593;273;3569;3580;7.49;0.46;247.66;4.13;976;4;1206.00;11
2594;4;21842354;2594;271;3570;3580;7.52;0.46;247.75;4.13;976;4;1207.00;10
2596;4;21842366;2596;272;3572;3580;7.60;0.47;247.76;4.13;976;4;1208.00;8
2599;4;21842377;2599;276;3574;3580;7.64;0.47;247.76;4.14;975;4;1209.00;6
2601;4;21842389;2601;273;3582;3586;7.69;0.47;247.88;4.13;981;4;1210.00;4
2605;4;21842401;2605;270;3582;3586;7.67;0.47;247.92;4.13;977;4;1211.00;4
2610;4;21842413;2610;268;3582;3586;7.67;0.47;248.00;4.13;972;4;1212.00;4
2612;4;21842424;2612;274;3583;3586;7.62;0.47;248.08;4.14;971;4;1213.00;3
2614;4;21842435;2614;278;3587;3590;7.52;0.46;248.10;4.13;973;4;1214.00;3
2621;4;21842447;2621;276;3589;3592;7.44;0.46;248.14;4.13;968;4;1215.00;3
2626;4;21842458;2626;282;3589;3592;7.38;0.45;248.20;4.13;963;4;1216.00;3
2631;4;21842470;2631;287;3590;3593;7.31;0.45;248.59;4.13;959;4;1217.00;3
2635;4;21842482;2635;289;3590;3593;7.26;0.44;248.64;4.13;955;4;1218.00;3
2641;4;21842493;2641;290;3591;3593;7.19;0.44;248.72;4.13;950;4;1219.00;2
2645;4;21842503;2645;296;3591;3593;7.10;0.43;248.88;4.13;946;4;1220.00;2
2650;4;21842515;2650;311;3591;3593;7.02;0.43;248.90;4.13;941;4;1221.00;2
2654;4;21842531;2654;309;3591;3593;6.93;0.42;248.98;4.13;937;4;1222.00;2
2659;4;21842542;2659;312;3591;3593;6.91;0.42;249.20;4.13;932;4;1223.00;2
2661;4;21842553;2661;327;3634;3663;6.92;0.43;249.33;4.09;973;4;1224.00;29
2665;4;21842569;2665;309;3638;3664;6.86;0.42;249.48;4.09;973;4;1225.00;26
2669;4;21842580;2669;304;3644;3664;6.83;0.42;249.57;4.09;975;4;1226.00;20
2673;4;21842591;2673;302;3647;3664;6.83;0.42;249.78;4.08;974;4;1227.00;17
2677;4;21842601;2677;298;3650;3666;6.76;0.41;249.69;4.08;973;4;1228.00;16
2683;4;21842620;2683;296;3652;3666;6.67;0.41;250.04;4.08;969;4;1229.00;14
2685;4;21842633;2685;303;3657;3666;6.66;0.41;250.18;4.09;972;4;1230.00;9
2687;4;21842644;2687;296;3662;3666;6.63;0.41;250.42;4.10;975;4;1231.00;4
2691;5;21842654;2691;294;3665;3667;6.61;0.40;250.74;4.10;974;5;1232.00;2
2696;5;21842687;2696;294;3665;3668;6.57;0.40;250.93;4.10;969;5;1233.00;3
2700;5;21842699;2700;288;3667;3668;6.52;0.40;251.07;4.10;967;5;1234.00;1
2702;5;21842711;2702;296;3671;3672;6.44;0.39;251.19;4.10;969;5;1235.00;1
2705;5;21842723;2705;295;3672;3672;6.36;0.39;251.52;4.10;967;5;1236.00;0
2707;5;21842734;2707;289;3672;3672;6.33;0.39;251.69;4.10;965;5;1237.00;0
2710;5;21842745;2710;294;3672;3672;6.30;0.38;251.77;4.10;962;5;1238.00;0
2711;5;21842756;2711;285;3678;3678;6.28;0.38;251.87;4.09;967;5;1239.00;0
2713;5;21842768;2713;293;3678;3678;6.23;0.38;251.92;4.09;965;5;1240.00;0
2718;5;21842779;2718;295;3678;3678;6.19;0.38;252.21;4.09;960;5;1241.00;0
2721;5;21842790;2721;293;3681;3681;6.25;0.38;252.23;4.09;960;5;1242.00;0
2725;5;21842802;2725;297;3681;3681;6.23;0.38;252.43;4.09;956;5;1243.00;0
2732;5;21842814;2732;301;3681;3681;6.24;0.38;252.64;4.09;949;5;1244.00;0
2735;5;21842825;2735;302;3682;3682;6.26;0.38;252.63;4.09;947;5;1245.00;0
2736;5;21842837;2736;309;3683;3683;6.29;0.39;252.70;4.09;947;5;1246.00;0
2739;5;21842848;2739;309;3683;3683;6.31;0.39;252.89;4.09;944;5;1247.00;0
2744;5;21842859;2744;304;3695;3696;6.36;0.39;252.98;4.07;951;5;1248.00;1
2747;5;21842872;2747;305;3696;3696;6.48;0.40;252.89;4.07;949;5;1249.00;0
2750;5;21842884;2750;306;3696;3696;6.60;0.40;253.10;4.07;946;5;1250.00;0
2753;5;21842895;2753;307;3697;3697;6.70;0.41;253.31;4.07;944;5;1251.00;0
2757;5;21842906;2757;309;3697;3697;6.82;0.42;253.24;4.07;940;5;1252.00;0
2763;5;21842942;2763;310;3701;3701;6.89;0.42;253.57;4.07;938;5;1253.00;0
2767;5;21842957;2767;315;3701;3701;6.86;0.42;253.77;4.07;934;5;1254.00;0
2769;5;21842971;2769;321;3704;3705;6.91;0.42;253.78;4.07;935;5;1255.00;1
2771;5;21842987;2771;322;3704;3705;6.96;0.43;253.92;4.07;933;5;1256.00;1
2775;5;21843001;2775;325;3704;3705;6.94;0.42;253.91;4.07;929;5;1257.00;1
2783;5;21843015;2783;327;3704;3705;6.87;0.42;254.38;4.07;921;5;1258.00;1
2789;5;21843027;2789;326;3704;3705;6.80;0.41;254.34;4.07;915;5;1259.00;1
2791;5;21843040;2791;330;3734;3739;6.87;0.42;254.45;4.03;943;5;1260.00;5
2796;5;21843054;2796;332;3734;3739;6.84;0.42;254.78;4.03;938;5;1261.00;5
2799;5;21843066;2799;335;3737;3739;6.84;0.42;254.96;4.03;938;5;1262.00;2
2802;5;21843078;2802;337;3737;3739;6.76;0.41;255.08;4.03;935;5;1263.00;2
2804;5;21843095;2804;346;3738;3739;6.67;0.41;255.05;4.03;934;5;1264.00;1
2807;5;21843106;2807;344;3738;3739;6.55;0.40;255.36;4.03;931;5;1265.00;1
2813;5;21843118;2813;350;3738;3740;6.36;0.39;255.64;4.03;925;5;1266.00;2
2815;5;21843129;2815;355;3738;3740;6.21;0.38;255.60;4.03;923;5;1267.00;2
2819;5;21843140;2819;355;3743;3746;6.11;0.37;255.74;4.03;924;5;1268.00;3
2820;5;21843152;2820;368;3744;3747;6.09;0.37;255.79;4.03;924;5;1269.00;3
2824;5;21843163;2824;371;3744;3747;6.06;0.37;255.88;4.03;920;5;1270.00;3
2825;5;21843173;2825;379;3744;3747;6.09;0.37;256.00;4.03;919;5;1271.00;3
2828;5;21843184;2828;371;3746;3751;6.14;0.38;255.99;4.02;918;5;1272.00;5
2830;5;21843196;2830;362;3747;3751;6.22;0.38;256.25;4.02;917;5;1273.00;4
2832;5;21843207;2832;359;3748;3751;6.29;0.39;256.37;4.03;916;5;1274.00;3
2834;5;21843218;2834;358;3749;3752;6.38;0.39;256.43;4.03;915;5;1275.00;3
2837;5;21843229;2837;355;3752;3756;6.37;0.39;256.48;4.02;915;5;1276.00;4
2842;5;21843240;2842;355;3752;3756;6.35;0.39;256.39;4.02;910;5;1277.00;4
2846;5;21843252;2846;354;3754;3759;6.34;0.39;256.56;4.02;908;5;1278.00;5
2850;5;21843264;2850;351;3754;3759;6.29;0.38;256.67;4.02;904;5;1279.00;5
2853;5;21843274;2853;353;3755;3759;6.32;0.38;256.88;4.02;902;5;1280.00;4
2855;5;21843286;2855;339;3755;3759;6.42;0.39;256.94;4.02;900;5;1281.00;4
2857;5;21843298;2857;329;3759;3763;6.55;0.40;256.87;4.02;902;5;1282.00;4
2860;5;21843310;2860;326;3759;3763;6.65;0.40;256.89;4.02;899;5;1283.00;4
2860;5;21843321;2860;322;3759;3763;6.79;0.41;256.89;4.02;899;5;1284.00;4
2862;5;21843332;2862;321;3759;3763;6.85;0.42;256.97;4.02;897;5;1285.00;4
2864;5;21843344;2864;316;3759;3764;6.87;0.42;257.20;4.02;895;5;1286.00;5
2865;5;21843355;2865;316;3760;3765;6.94;0.42;257.29;4.02;895;5;1287.00;5
2867;5;21843367;2867;321;3760;3765;6.98;0.43;257.38;4.02;893;5;1288.00;5
2868;5;21843378;2868;318;3761;3766;7.04;0.43;257.48;4.02;893;5;1289.00;5
2871;5;21843391;2871;319;3761;3766;7.08;0.43;257.47;4.02;890;5;1290.00;5
2873;5;21843403;2873;323;3761;3766;7.09;0.43;257.41;4.02;888;5;1291.00;5
2875;5;21843414;2875;316;3761;3766;7.13;0.43;257.41;4.02;886;5;1292.00;5
2879;5;21843426;2879;314;3761;3766;7.08;0.43;257.35;4.02;882;5;1293.00;5
2879;5;21843437;2879;309;3761;3766;7.07;0.43;257.35;4.02;882;5;1294.00;5
2881;5;21843448;2881;302;3761;3766;7.05;0.43;257.25;4.02;880;5;1295.00;5
2884;5;21843459;2884;325;3828;3893;7.28;0.45;257.38;3.95;944;5;1296.00;65
2886;5;21843486;2886;318;3830;3894;7.25;0.45;257.47;3.95;944;5;1297.00;64
2889;5;21843498;2889;313;3839;3894;7.26;0.45;257.55;3.94;950;5;1298.00;55
2890;5;21843510;2890;310;3840;3894;7.24;0.45;257.56;3.94;950;5;1299.00;54
2892;5;21843522;2892;310;3846;3894;7.25;0.45;257.57;3.94;954;5;1300.00;48
2894;5;21843537;2894;320;3847;3894;7.20;0.45;257.56;3.94;953;5;1301.00;47
2896;5;21843549;2896;326;3852;3894;7.15;0.44;257.62;3.94;956;5;1302.00;42
2898;5;21843560;2898;327;3856;3894;7.11;0.44;257.58;3.95;958;5;1303.00;38
2900;5;21843571;2900;326;3859;3895;7.06;0.44;257.46;3.95;959;5;1304.00;36
2903;5;21843584;2903;339;3864;3897;6.98;0.43;257.56;3.95;961;5;1305.00;33
2904;5;21843596;2904;346;3867;3897;6.94;0.43;257.69;3.96;963;5;1306.00;30
2905;5;21843607;2905;347;3869;3898;6.88;0.42;257.72;3.96;964;5;1307.00;29
2908;5;21843619;2908;351;3872;3898;6.80;0.42;257.60;3.97;964;5;1308.00;26
2910;5;21843638;2910;349;3875;3898;6.76;0.42;257.65;3.98;965;5;1309.00;23
2912;5;21843649;2912;357;3876;3898;6.71;0.41;257.59;3.98;964;5;1310.00;22
2916;5;21843661;2916;360;3880;3902;6.67;0.41;257.43;3.98;964;5;1311.00;22
2917;5;21843672;2917;360;3880;3902;6.64;0.41;257.38;3.98;963;5;1312.00;22
2919;5;21843685;2919;361;3880;3902;6.62;0.40;257.38;3.98;961;5;1313.00;22
2919;5;21843696;2919;366;3884;3905;6.64;0.41;257.38;3.99;965;5;1314.00;21
2921;5;21843707;2921;360;3884;3905;6.65;0.41;257.53;3.99;963;5;1315.00;21
2923;5;21843719;2923;354;3884;3905;6.69;0.41;257.59;3.99;961;5;1316.00;21
2924;5;21843730;2924;353;3889;3909;6.71;0.41;257.68;3.99;965;5;1317.00;20
2926;5;21843742;2926;349;3890;3910;6.79;0.41;257.69;3.99;964;5;1318.00;20
2929;5;21843754;2929;342;3891;3910;6.85;0.42;257.59;4.00;962;5;1319.00;19
2931;5;21843768;2931;330;3896;3915;6.93;0.42;257.55;3.99;965;5;1320.00;19
2933;5;21843779;2933;323;3897;3915;6.94;0.42;257.49;3.99;964;5;1321.00;18
2937;5;21843790;2937;325;3897;3915;6.94;0.42;257.69;3.99;960;5;1322.00;18
2937;5;21843802;2937;310;3898;3916;7.01;0.43;257.69;3.99;961;5;1323.00;18
2940;5;21843814;2940;302;3898;3916;7.04;0.43;257.78;3.99;958;5;1324.00;18
2943;5;21843834;2943;296;3902;3922;7.06;0.43;258.00;3.99;959;5;1325.00;20
2946;5;21843850;2946;288;3902;3922;7.09;0.43;258.11;3.99;956;5;1326.00;20
2947;5;21843866;2947;284;3902;3923;7.10;0.43;258.18;3.99;955;5;1327.00;21
2949;5;21843881;2949;280;3902;3923;7.11;0.43;258.10;3.99;953;5;1328.00;21
2951;5;21843897;2951;279;3903;3923;7.07;0.43;258.09;4.00;952;5;1329.00;20
2954;5;21843920;2954;269;3904;3923;7.01;0.42;258.16;4.02;950;5;1330.00;19
2959;5;21843932;2959;271;3904;3923;6.95;0.42;258.01;4.02;945;5;1331.00;19
2960;5;21843945;2960;267;3914;3935;7.01;0.42;257.98;4.01;954;5;1332.00;21
2964;5;21843958;2964;269;3915;3935;7.03;0.43;257.96;4.01;951;5;1333.00;20
2964;5;21843977;2964;262;3915;3935;7.08;0.43;257.96;4.01;951;5;1334.00;20
2964;5;21843988;2964;258;3915;3935;7.16;0.43;257.96;4.01;951;5;1335.00;20
2965;5;21844000;2965;253;3915;3935;7.23;0.44;258.00;4.01;950;5;1336.00;20
2965;5;21844012;2965;256;3915;3935;7.35;0.45;258.00;4.01;950;5;1337.00;20
2966;5;21844023;2966;255;3918;3939;7.38;0.45;257.95;4.00;952;5;1338.00;21
2968;5;21844035;2968;241;3918;3939;7.49;0.45;257.93;4.00;950;5;1339.00;21
2969;5;21844047;2969;238;3921;3943;7.56;0.46;257.89;4.00;952;5;1340.00;22
2972;5;21844066;2972;232;3921;3944;7.59;0.46;257.93;4.00;949;5;1341.00;23
2974;5;21844078;2974;219;3922;3944;7.69;0.47;257.82;4.00;948;5;1342.00;22
2975;5;21844090;2975;215;3922;3944;7.75;0.47;257.97;4.00;947;5;1343.00;22
2979;5;21844101;2979;210;3932;3957;7.77;0.47;258.08;3.99;953;5;1344.00;25
2983;5;21844114;2983;209;3933;3957;7.79;0.47;258.02;3.99;950;5;1345.00;24
2986;5;21844126;2986;212;3934;3957;7.88;0.48;258.25;4.01;948;5;1346.00;23
2988;5;21844137;2988;206;3935;3958;7.95;0.48;258.24;4.01;947;5;1347.00;23
2990;5;21844149;2990;193;3938;3959;7.98;0.48;258.52;4.04;948;5;1348.00;21
2993;5;21844161;2993;199;3938;3959;8.04;0.49;258.40;4.04;945;5;1349.00;21
2996;5;21844173;2996;195;3946;3968;8.12;0.49;258.65;4.04;950;5;1350.00;22
2999;5;21844186;2999;196;3947;3968;8.13;0.49;258.89;4.04;948;5;1351.00;21
2999;5;21844198;2999;196;3950;3968;8.16;0.49;258.89;4.05;951;5;1352.00;18
3002;5;21844209;3002;203;3950;3968;8.18;0.50;259.03;4.05;948;5;1353.00;18
3004;5;21844221;3004;212;3955;3974;8.25;0.50;259.14;4.05;951;5;1354.00;19
3008;5;21844233;3008;214;3957;3974;8.21;0.50;259.38;4.08;949;5;1355.00;17
3011;5;21844245;3011;221;3957;3974;8.21;0.50;259.52;4.08;946;5;1356.00;17
3012;5;21844256;3012;226;3958;3974;8.17;0.50;259.55;4.09;946;5;1357.00;16
3016;5;21844268;3016;236;3962;3978;8.04;0.49;259.45;4.09;946;5;1358.00;16
3020;5;21844280;3020;234;3963;3979;8.01;0.49;259.77;4.09;943;5;1359.00;16
3021;5;21844305;3021;243;3964;3979;7.99;0.49;259.85;4.11;943;5;1360.00;15
3024;5;21844319;3024;242;3965;3980;7.94;0.48;259.77;4.10;941;5;1361.00;15
3025;5;21844332;3025;250;3965;3980;7.95;0.48;259.84;4.10;940;5;1362.00;15
3026;5;21844343;3026;251;3966;3980;7.93;0.48;259.77;4.12;940;5;1363.00;14
3029;5;21844355;3029;259;3968;3980;7.93;0.48;259.89;4.15;939;5;1364.00;12
3031;5;21844366;3031;264;3969;3980;7.91;0.48;259.97;4.17;938;5;1365.00;11
3031;5;21844378;3031;261;3969;3980;7.87;0.48;259.97;4.17;938;5;1366.00;11
3033;5;21844388;3033;259;3971;3980;7.85;0.48;260.11;4.20;938;5;1367.00;9
3036;5;21844400;3036;268;4013;4050;7.91;0.49;260.29;4.16;977;5;1368.00;37
3039;5;21844417;3039;263;4015;4051;7.87;0.48;260.25;4.15;976;5;1369.00;36
3040;5;21844428;3040;260;4021;4051;7.83;0.48;260.39;4.16;981;5;1370.00;30
3042;5;21844439;3042;256;4025;4051;7.73;0.48;260.41;4.16;983;5;1371.00;26
3047;5;21844451;3047;251;4028;4051;7.67;0.47;260.57;4.16;981;5;1372.00;23
3050;5;21844462;3050;257;4031;4051;7.62;0.47;260.48;4.18;981;5;1373.00;20
3051;5;21844473;3051;257;4035;4051;7.59;0.47;260.48;4.19;984;5;1374.00;16
3055;5;21844485;3055;259;4041;4051;7.52;0.46;260.52;4.21;986;5;1375.00;10
3058;5;21844496;3058;256;4043;4052;7.53;0.46;260.61;4.22;985;5;1376.00;9
3062;5;21844508;3062;253;4048;4053;7.53;0.46;260.59;4.22;986;5;1377.00;5
3066;5;21844520;3066;257;4050;4053;7.56;0.46;260.73;4.24;984;5;1378.00;3
3067;5;21844531;3067;254;4053;4057;7.58;0.46;260.76;4.23;986;5;1379.00;4
3071;5;21844545;3071;249;4053;4057;7.54;0.46;260.92;4.23;982;5;1380.00;4
3077;5;21844557;3077;248;4055;4057;7.51;0.46;260.75;4.24;978;5;1381.00;2
3080;5;21844569;3080;255;4055;4057;7.51;0.46;260.75;4.24;975;5;1382.00;2
3086;5;21844581;3086;256;4062;4063;7.53;0.46;260.69;4.24;976;5;1383.00;1
3089;5;21844593;3089;256;4062;4063;7.56;0.46;260.81;4.24;973;5;1384.00;1
3091;5;21844604;3091;253;4063;4063;7.55;0.46;260.79;4.24;972;5;1385.00;0
3096;5;21844616;3096;258;4066;4066;7.60;0.46;260.88;4.23;970;5;1386.00;0
3098;5;21844629;3098;258;4066;4066;7.64;0.47;260.82;4.23;968;5;1387.00;0
3102;5;21844640;3102;262;4066;4066;7.60;0.46;260.91;4.23;964;5;1388.00;0
3108;5;21844651;3108;265;4067;4067;7.45;0.46;261.12;4.23;959;5;1389.00;0
3111;5;21844663;3111;269;4068;4068;7.41;0.45;261.15;4.23;957;5;1390.00;0
3116;5;21844673;3116;275;4068;4068;7.27;0.44;261.24;4.23;952;5;1391.00;0
3120;5;21844685;3120;278;4081;4081;7.20;0.44;261.18;4.22;961;5;1392.00;0
3126;5;21844697;3126;296;4081;4081;7.16;0.43;261.28;4.22;955;5;1393.00;0
3129;5;21844708;3129;293;4081;4081;7.13;0.43;261.31;4.22;952;5;1394.00;0
3132;5;21844720;3132;300;4083;4083;7.13;0.43;261.27;4.22;951;5;1395.00;0
3137;5;21844732;3137;303;4083;4083;7.12;0.43;261.30;4.22;946;5;1396.00;0
3139;5;21844742;3139;305;4087;4087;7.16;0.43;261.36;4.21;948;5;1397.00;0
3141;5;21844753;3141;307;4087;4087;7.07;0.43;261.35;4.21;946;5;1398.00;0
3145;5;21844764;3145;314;4091;4091;6.95;0.42;261.51;4.21;946;5;1399.00;0
3150;6;21844775;3150;297;4091;4091;6.85;0.42;261.66;4.21;941;6;1400.00;0
3156;6;21844812;3156;287;4091;4091;6.77;0.41;261.87;4.21;935;6;1401.00;0
3161;6;21844823;3161;287;4091;4091;6.70;0.41;261.93;4.21;930;6;1402.00;0
3163;6;21844833;3163;289;4091;4091;6.63;0.40;262.05;4.21;928;6;1403.00;0
3165;6;21844844;3165;284;4102;4103;6.65;0.40;262.25;4.20;937;6;1404.00;1
3168;6;21844855;3168;291;4103;4103;6.56;0.40;262.42;4.20;935;6;1405.00;0
3171;6;21844866;3171;295;4103;4103;6.49;0.40;262.64;4.20;932;6;1406.00;0
3174;6;21844876;3174;296;4103;4103;6.42;0.39;262.75;4.20;929;6;1407.00;0
3177;6;21844887;3177;292;4103;4103;6.44;0.39;262.85;4.20;926;6;1408.00;0
3181;6;21844898;3181;289;4103;4103;6.45;0.39;262.95;4.20;922;6;1409.00;0
3184;6;21844912;3184;281;4104;4104;6.48;0.40;263.11;4.20;920;6;1410.00;0
3188;6;21844923;3188;281;4104;4104;6.51;0.40;263.45;4.20;916;6;1411.00;0
3191;6;21844935;3191;276;4110;4110;6.60;0.41;263.60;4.19;919;6;1412.00;0
3195;6;21844946;3195;276;4111;4111;6.61;0.41;263.90;4.19;916;6;1413.00;0
3199;6;21844958;3199;278;4111;4111;6.63;0.41;263.99;4.19;912;6;1414.00;0
3203;6;21844976;3203;282;4111;4111;6.61;0.41;264.10;4.19;908;6;1415.00;0
3207;6;21844988;3207;288;4115;4115;6.70;0.41;264.22;4.19;908;6;1416.00;0
3209;6;21844999;3209;289;4115;4115;6.71;0.41;264.29;4.19;906;6;1417.00;0
3215;6;21845010;3215;289;4115;4115;6.66;0.41;264.31;4.19;900;6;1418.00;0
3221;6;21845022;3221;300;4116;4116;6.59;0.40;264.36;4.19;895;6;1419.00;0
3226;6;21845033;3226;308;4120;4120;6.56;0.40;264.77;4.18;894;6;1420.00;0
3229;6;21845044;3229;313;4120;4120;6.55;0.40;264.70;4.18;891;6;1421.00;0
3236;6;21845055;3236;313;4122;4123;6.57;0.40;264.81;4.18;886;6;1422.00;1
3237;6;21845067;3237;316;4122;4123;6.63;0.40;264.87;4.18;885;6;1423.00;1
3241;6;21845077;3241;310;4123;4123;6.63;0.40;264.87;4.18;882;6;1424.00;0
3247;6;21845087;3247;311;4123;4123;6.58;0.40;264.90;4.18;876;6;1425.00;0
3250;6;21845098;3250;307;4127;4127;6.60;0.40;265.10;4.18;877;6;1426.00;0
3256;6;21845109;3256;309;4127;4127;6.52;0.40;265.34;4.18;871;6;1427.00;0
3260;6;21845120;3260;314;4127;4127;6.49;0.39;265.24;4.18;867;6;1428.00;0
3265;6;21845130;3265;316;4127;4127;6.47;0.39;265.57;4.18;862;6;1429.00;0
3268;6;21845141;3268;318;4128;4128;6.50;0.40;265.66;4.18;860;6;1430.00;0
3272;6;21845151;3272;316;4129;4129;6.48;0.39;265.86;4.18;857;6;1431.00;0
3275;6;21845162;3275;319;4129;4129;6.47;0.39;265.97;4.18;854;6;1432.00;0
3277;6;21845172;3277;323;4130;4130;6.48;0.39;266.06;4.17;853;6;1433.00;0
3280;6;21845183;3280;331;4130;4130;6.44;0.39;266.11;4.17;850;6;1434.00;0
3285;6;21845193;3285;328;4130;4130;6.34;0.39;266.29;4.17;845;6;1435.00;0
3287;6;21845203;3287;333;4130;4130;6.30;0.39;266.42;4.17;843;6;1436.00;0
3289;6;21845213;3289;338;4130;4130;6.27;0.38;266.54;4.17;841;6;1437.00;0
3291;6;21845223;3291;338;4130;4130;6.20;0.38;266.63;4.17;839;6;1438.00;0
3295;6;21845233;3295;344;4130;4130;6.13;0.37;266.53;4.17;835;6;1439.00;0
3300;6;21845244;3300;382;4237;4360;6.59;0.42;266.56;4.07;937;6;1440.00;123
3304;6;21845273;3304;379;4246;4361;6.58;0.41;266.75;4.06;942;6;1441.00;115
3309;6;21845284;3309;371;4259;4361;6.59;0.42;267.04;4.06;950;6;1442.00;102
3311;6;21845295;3311;377;4265;4361;6.52;0.41;266.96;4.06;954;6;1443.00;96
3312;6;21845306;3312;376;4278;4361;6.51;0.41;266.95;4.06;966;6;1444.00;83
3314;6;21845316;3314;374;4286;4361;6.49;0.41;267.13;4.06;972;6;1445.00;75
3315;6;21845327;3315;378;4292;4361;6.49;0.41;267.09;4.06;977;6;1446.00;69
3318;6;21845338;3318;371;4299;4361;6.47;0.40;267.14;4.06;981;6;1447.00;62
3319;6;21845350;3319;371;4306;4362;6.45;0.40;267.23;4.07;987;6;1448.00;56
3321;6;21845362;3321;362;4312;4363;6.46;0.40;267.29;4.08;991;6;1449.00;51
3323;6;21845374;3323;362;4319;4363;6.44;0.40;267.22;4.09;996;6;1450.00;44
3326;6;21845385;3326;354;4324;4364;6.43;0.40;267.17;4.10;998;6;1451.00;40
3328;6;21845398;3328;369;4325;4364;6.42;0.40;267.12;4.10;997;6;1452.00;39
3329;6;21845410;3329;371;4327;4364;6.39;0.40;267.15;4.10;998;6;1453.00;37
3329;6;21845422;3329;374;4328;4364;6.38;0.40;267.15;4.10;999;6;1454.00;36
3332;6;21845434;3332;391;4333;4368;6.29;0.39;267.04;4.11;1001;6;1455.00;35
3334;6;21845460;3334;379;4336;4368;6.33;0.39;266.94;4.12;1002;6;1456.00;32
3335;6;21845473;3335;375;4338;4368;6.33;0.39;266.86;4.12;1003;6;1457.00;30
3336;6;21845493;3336;372;4340;4371;6.37;0.39;266.81;4.12;1004;6;1458.00;31
3337;6;21845505;3337;375;4341;4371;6.39;0.39;266.73;4.12;1004;6;1459.00;30
3338;6;21845519;3338;375;4342;4371;6.41;0.40;266.79;4.13;1004;6;1460.00;29
3342;6;21845531;3342;368;4345;4375;6.44;0.40;266.74;4.12;1003;6;1461.00;30
3347;6;21845544;3347;373;4347;4376;6.46;0.40;266.54;4.13;1000;6;1462.00;29
3348;6;21845556;3348;376;4349;4376;6.56;0.40;266.47;4.14;1001;6;1463.00;27
3349;6;21845569;3349;378;4353;4380;6.63;0.41;266.42;4.14;1004;6;1464.00;27
3351;6;21845582;3351;382;4354;4380;6.78;0.42;266.46;4.14;1003;6;1465.00;26
3351;6;21845595;3351;385;4354;4380;6.89;0.42;266.46;4.14;1003;6;1466.00;26
3352;6;21845607;3352;384;4355;4381;6.94;0.43;266.50;4.15;1003;6;1467.00;26
3354;6;21845619;3354;383;4356;4381;6.97;0.43;266.65;4.15;1002;6;1468.00;25
3358;6;21845632;3358;382;4361;4387;6.97;0.43;266.64;4.16;1003;6;1469.00;26
3362;6;21845647;3362;379;4361;4387;7.00;0.43;266.54;4.16;999;6;1470.00;26
3363;6;21845660;3363;387;4362;4388;7.02;0.43;266.47;4.16;999;6;1471.00;26
3368;6;21845672;3368;383;4364;4388;6.96;0.42;266.43;4.17;996;6;1472.00;24
3369;6;21845685;3369;379;4364;4388;6.94;0.42;266.44;4.17;995;6;1473.00;24
3371;6;21845697;3371;381;4366;4388;6.92;0.42;266.50;4.17;995;6;1474.00;22
3374;6;21845709;3374;386;4366;4388;6.82;0.42;266.48;4.17;992;6;1475.00;22
3374;6;21845721;3374;387;4374;4400;6.79;0.41;266.48;4.16;1000;6;1476.00;26
3374;6;21845733;3374;387;4377;4400;6.75;0.41;266.48;4.16;1003;6;1477.00;23
3378;6;21845745;3378;389;4378;4400;6.71;0.41;266.32;4.16;1000;6;1478.00;22
3378;6;21845756;3378;384;4378;4400;6.72;0.41;266.32;4.16;1000;6;1479.00;22
3379;6;21845768;3379;372;4378;4400;6.77;0.41;266.36;4.16;999;6;1480.00;22
3381;6;21845780;3381;369;4378;4400;6.82;0.41;266.30;4.16;997;6;1481.00;22
3384;6;21845793;3384;365;4381;4404;6.85;0.42;266.31;4.16;997;6;1482.00;23
3384;6;21845805;3384;360;4381;4404;6.90;0.42;266.31;4.16;997;6;1483.00;23
3386;6;21845817;3386;354;4385;4408;6.95;0.42;266.31;4.16;999;6;1484.00;23
3388;6;21845846;3388;350;4387;4410;6.99;0.42;266.21;4.16;999;6;1485.00;23
3390;6;21845861;3390;344;4387;4410;7.07;0.43;266.20;4.16;997;6;1486.00;23
3394;6;21845877;3394;351;4387;4410;7.08;0.43;266.25;4.16;993;6;1487.00;23
3395;6;21845892;3395;339;4395;4423;7.17;0.43;266.26;4.15;1000;6;1488.00;28
3397;6;21845908;3397;335;4396;4423;7.21;0.44;266.30;4.15;999;6;1489.00;27
3397;7;21845921;3397;328;4396;4423;7.27;0.44;266.30;4.15;999;7;1490.00;27
3397;7;21845947;3397;318;4397;4424;7.34;0.44;266.30;4.15;1000;7;1491.00;27
3397;7;21845961;3397;310;4397;4425;7.41;0.45;266.30;4.15;1000;7;1492.00;28
3398;7;21845980;3398;300;4397;4425;7.42;0.45;266.35;4.15;999;7;1493.00;28
3401;7;21845992;3401;293;4399;4428;7.49;0.45;266.46;4.15;998;7;1494.00;29
3401;7;21846011;3401;280;4399;4428;7.49;0.45;266.46;4.15;998;7;1495.00;29
3402;7;21846022;3402;277;4400;4428;7.49;0.45;266.51;4.14;998;7;1496.00;28
3406;7;21846035;3406;278;4400;4428;7.46;0.45;266.56;4.14;994;7;1497.00;28
3408;7;21846047;3408;266;4405;4434;7.49;0.45;266.50;4.14;997;7;1498.00;29
3410;7;21846059;3410;266;4405;4434;7.52;0.45;266.57;4.14;995;7;1499.00;29
3411;7;21846074;3411;269;4409;4453;7.41;0.45;266.64;4.14;998;7;1500.00;44
3415;7;21846094;3415;263;4409;4453;7.34;0.44;266.57;4.14;994;7;1501.00;44
3417;7;21846106;3417;263;4412;4457;7.28;0.44;266.60;4.14;995;7;1502.00;45
3417;7;21846118;3417;268;4413;4458;7.23;0.44;266.60;4.13;996;7;1503.00;45
3418;7;21846130;3418;256;4413;4458;7.16;0.43;266.56;4.13;995;7;1504.00;45
3421;7;21846143;3421;254;4417;4459;7.14;0.43;266.64;4.16;996;7;1505.00;42
3424;7;21846155;3424;246;4418;4459;7.08;0.43;266.72;4.16;994;7;1506.00;41
3428;7;21846167;3428;241;4418;4459;7.08;0.43;266.74;4.16;990;7;1507.00;41
3430;7;21846179;3430;229;4418;4459;7.07;0.43;266.88;4.16;988;7;1508.00;41
3432;7;21846191;3432;231;4418;4459;7.11;0.43;267.01;4.16;986;7;1509.00;41
3433;7;21846203;3433;229;4418;4459;7.19;0.44;266.97;4.16;985;7;1510.00;41
3436;7;21846215;3436;225;4419;4459;7.23;0.44;267.12;4.16;983;7;1511.00;40
3438;7;21846228;3438;237;4452;4529;7.33;0.45;267.12;4.13;1014;7;1512.00;77
3439;7;21846246;3439;222;4452;4530;7.42;0.45;267.07;4.13;1013;7;1513.00;78
3441;7;21846258;3441;223;4458;4530;7.56;0.46;267.02;4.13;1017;7;1514.00;72
3442;7;21846270;3442;212;4460;4530;7.68;0.47;267.11;4.13;1018;7;1515.00;70
3446;7;21846282;3446;206;4463;4530;7.76;0.47;267.31;4.13;1017;7;1516.00;67
3447;7;21846295;3447;209;4468;4530;7.83;0.48;267.30;4.14;1021;7;1517.00;62
3450;7;21846307;3450;205;4471;4530;7.89;0.48;267.35;4.14;1021;7;1518.00;59
3453;7;21846319;3453;199;4473;4530;7.87;0.48;267.57;4.14;1020;7;1519.00;57
3457;7;21846338;3457;200;4476;4531;7.88;0.48;267.49;4.14;1019;7;1520.00;55
3460;7;21846356;3460;200;4478;4532;7.88;0.48;267.70;4.15;1018;7;1521.00;54
3463;7;21846369;3463;203;4482;4532;7.89;0.48;267.62;4.17;1019;7;1522.00;50
3465;7;21846382;3465;209;4488;4536;7.89;0.48;267.86;4.17;1023;7;1523.00;48
3468;7;21846395;3468;206;4489;4536;7.86;0.48;267.96;4.17;1021;7;1524.00;47
3471;7;21846408;3471;206;4490;4536;7.79;0.47;268.07;4.19;1019;7;1525.00;46
3472;7;21846427;3472;217;4490;4536;7.75;0.47;268.18;4.19;1018;7;1526.00;46
3473;7;21846439;3473;219;4495;4542;7.70;0.47;268.19;4.21;1022;7;1527.00;47
3474;7;21846452;3474;226;4497;4542;7.66;0.47;268.22;4.22;1023;7;1528.00;45
3475;7;21846464;3475;224;4499;4542;7.66;0.46;268.19;4.25;1024;7;1529.00;43
3476;7;21846479;3476;227;4506;4548;7.67;0.46;268.32;4.26;1030;7;1530.00;42
3477;7;21846492;3477;233;4507;4548;7.63;0.46;268.46;4.28;1030;7;1531.00;41
3479;7;21846505;3479;230;4509;4548;7.55;0.46;268.47;4.30;1030;7;1532.00;39
3479;7;21846517;3479;230;4510;4549;7.54;0.46;268.47;4.31;1031;7;1533.00;39
3484;7;21846530;3484;240;4513;4550;7.51;0.46;268.61;4.33;1029;7;1534.00;37
3489;7;21846542;3489;247;4514;4550;7.45;0.45;268.76;4.35;1025;7;1535.00;36
3493;7;21846555;3493;253;4525;4563;7.42;0.45;268.83;4.38;1032;7;1536.00;38
3494;7;21846569;3494;251;4528;4563;7.45;0.45;268.96;4.44;1034;7;1537.00;35
3495;7;21846582;3495;261;4532;4563;7.48;0.45;268.93;4.50;1037;7;1538.00;31
3496;7;21846594;3496;260;4536;4564;7.47;0.45;268.98;4.54;1040;7;1539.00;28
3500;7;21846607;3500;262;4539;4564;7.50;0.46;269.11;4.56;1039;7;1540.00;25
3504;7;21846620;3504;264;4544;4568;7.48;0.45;269.07;4.56;1040;7;1541.00;24
3505;7;21846633;3505;272;4547;4568;7.46;0.45;269.10;4.59;1042;7;1542.00;21
3512;7;21846646;3512;275;4552;4572;7.43;0.45;269.11;4.60;1040;7;1543.00;20
3514;7;21846659;3514;274;4554;4572;7.46;0.45;269.13;4.62;1040;7;1544.00;18
3517;7;21846671;3517;274;4555;4572;7.40;0.45;269.08;4.63;1038;7;1545.00;17
3519;7;21846684;3519;274;4556;4572;7.33;0.45;269.16;4.64;1037;7;1546.00;16
3523;7;21846697;3523;278;4557;4572;7.24;0.44;269.36;4.65;1034;7;1547.00;15
3526;7;21846710;3526;276;4568;4584;7.27;0.44;269.30;4.65;1042;7;1548.00;16
3530;7;21846723;3530;275;4571;4584;7.23;0.44;269.35;4.66;1041;7;1549.00;13
3531;7;21846736;3531;270;4574;4584;7.16;0.44;269.46;4.68;1043;7;1550.00;10
3535;7;21846748;3535;263;4574;4584;7.09;0.43;269.53;4.68;1039;7;1551.00;10
3539;7;21846761;3539;264;4576;4584;7.06;0.43;269.73;4.70;1037;7;1552.00;8
3543;7;21846777;3543;266;4577;4584;7.06;0.43;269.75;4.70;1034;7;1553.00;7
3545;7;21846790;3545;262;4579;4585;7.05;0.43;269.73;4.71;1034;7;1554.00;6
3549;7;21846802;3549;261;4581;4587;7.04;0.43;269.99;4.71;1032;7;1555.00;6
3552;7;21846823;3552;259;4587;4593;7.16;0.44;270.11;4.70;1035;7;1556.00;6
3554;7;21846836;3554;262;4589;4594;7.21;0.44;270.30;4.71;1035;7;1557.00;5
3557;7;21846849;3557;262;4589;4594;7.20;0.44;270.53;4.71;1032;7;1558.00;5
3558;7;21846861;3558;271;4589;4594;7.25;0.44;270.51;4.71;1031;7;1559.00;5
3563;7;21846875;3563;273;4594;4599;7.25;0.44;270.61;4.71;1031;7;1560.00;5
3565;7;21846888;3565;274;4595;4599;7.23;0.44;270.72;4.71;1030;7;1561.00;4
3569;7;21846900;3569;280;4595;4599;7.24;0.44;270.88;4.71;1026;7;1562.00;4
3570;7;21846913;3570;285;4597;4600;7.21;0.44;270.86;4.71;1027;7;1563.00;3
3575;7;21846925;3575;287;4602;4604;7.15;0.44;271.09;4.71;1027;7;1564.00;2
3581;7;21846938;3581;286;4603;4604;7.09;0.43;271.20;4.71;1022;7;1565.00;1
3583;7;21846951;3583;292;4605;4607;7.16;0.44;271.30;4.71;1022;7;1566.00;2
3586;7;21846965;3586;301;4606;4607;7.10;0.43;271.36;4.71;1020;7;1567.00;1
3591;7;21846983;3591;307;4607;4607;7.08;0.43;271.53;4.71;1016;7;1568.00;0
3594;7;21846996;3594;309;4607;4607;7.03;0.43;271.53;4.71;1013;7;1569.00;0
3599;7;21847008;3599;311;4611;4611;7.01;0.43;271.70;4.71;1012;7;1570.00;0
3603;7;21847021;3603;303;4611;4611;6.98;0.43;271.63;4.71;1008;7;1571.00;0
3608;7;21847032;3608;309;4611;4611;6.83;0.42;271.67;4.71;1003;7;1572.00;0
3611;7;21847043;3611;314;4611;4611;6.66;0.41;271.76;4.71;1000;7;1573.00;0
3614;7;21847054;3614;318;4611;4612;6.51;0.40;271.74;4.71;997;7;1574.00;1
3616;7;21847066;3616;306;4613;4614;6.40;0.39;271.84;4.71;997;7;1575.00;1
3621;7;21847077;3621;296;4614;4614;6.23;0.38;271.96;4.71;993;7;1576.00;0
3624;7;21847088;3624;292;4615;4615;6.19;0.38;271.84;4.71;991;7;1577.00;0
3629;7;21847099;3629;296;4615;4615;6.10;0.38;271.88;4.71;986;7;1578.00;0
3634;7;21847110;3634;286;4615;4615;6.04;0.37;271.95;4.71;981;7;1579.00;0
3636;7;21847121;3636;296;4615;4615;6.05;0.37;271.96;4.71;979;7;1580.00;0
3641;7;21847131;3641;297;4615;4615;6.04;0.37;272.35;4.71;974;7;1581.00;0
3644;7;21847142;3644;293;4615;4615;6.04;0.37;272.43;4.71;971;7;1582.00;0
3648;7;21847153;3648;289;4615;4615;6.08;0.37;272.61;4.71;967;7;1583.00;0
3651;7;21847163;3651;301;4688;4742;6.41;0.40;272.76;4.63;1037;7;1584.00;54
3656;7;21847184;3656;291;4691;4743;6.37;0.40;272.87;4.63;1035;7;1585.00;52
3659;7;21847196;3659;289;4701;4743;6.43;0.40;273.04;4.62;1042;7;1586.00;42
3663;7;21847207;3663;290;4703;4743;6.43;0.40;273.10;4.62;1040;7;1587.00;40
3671;7;21847218;3671;291;4709;4743;6.44;0.40;273.30;4.62;1038;7;1588.00;34
3672;7;21847230;3672;300;4713;4743;6.44;0.40;273.27;4.62;1041;7;1589.00;30
3677;7;21847244;3677;303;4714;4743;6.39;0.40;273.39;4.62;1037;7;1590.00;29
3682;7;21847255;3682;316;4716;4743;6.33;0.39;273.44;4.62;1034;7;1591.00;27
3687;7;21847267;3687;318;4720;4744;6.25;0.39;273.42;4.63;1033;7;1592.00;24
3690;7;21847279;3690;316;4723;4745;6.15;0.38;273.54;4.63;1033;7;1593.00;22
3693;7;21847290;3693;329;4727;4745;6.12;0.38;273.70;4.64;1034;7;1594.00;18
3696;7;21847302;3696;340;4730;4746;6.10;0.38;273.69;4.64;1034;7;1595.00;16
3700;7;21847314;3700;348;4734;4746;6.07;0.38;273.90;4.65;1034;7;1596.00;12
3704;7;21847325;3704;351;4737;4746;6.10;0.38;273.81;4.65;1033;7;1597.00;9
3709;7;21847337;3709;353;4738;4746;6.03;0.38;273.96;4.65;1029;7;1598.00;8
3713;7;21847349;3713;357;4743;4750;5.96;0.37;274.19;4.65;1030;7;1599.00;7
3718;7;21847363;3718;363;4744;4750;5.89;0.37;274.22;4.65;1026;7;1600.00;6
3722;7;21847378;3722;359;4744;4750;5.84;0.36;274.23;4.65;1022;7;1601.00;6
3728;7;21847389;3728;370;4747;4753;5.78;0.36;274.30;4.65;1019;7;1602.00;6
3734;7;21847402;3734;378;4747;4753;5.73;0.35;274.24;4.65;1013;7;1603.00;6
3742;7;21847414;3742;380;4747;4753;5.62;0.35;274.37;4.65;1005;7;1604.00;6
3746;7;21847431;3746;387;4751;4757;5.61;0.35;274.32;4.65;1005;7;1605.00;6
3751;7;21847443;3751;394;4752;4758;5.55;0.34;274.42;4.65;1001;7;1606.00;6
3754;7;21847459;3754;394;4752;4758;5.56;0.34;274.41;4.65;998;7;1607.00;6
3759;7;21847470;3759;400;4755;4762;5.57;0.34;274.48;4.66;996;7;1608.00;7
3764;7;21847482;3764;403;4758;4762;5.54;0.34;274.40;4.66;994;7;1609.00;4
3765;7;21847493;3765;416;4759;4762;5.52;0.34;274.43;4.66;994;7;1610.00;3
3769;7;21847504;3769;418;4759;4763;5.44;0.34;274.44;4.66;990;7;1611.00;4
3772;7;21847515;3772;425;4760;4763;5.41;0.33;274.49;4.66;988;7;1612.00;3
3777;7;21847526;3777;427;4765;4769;5.36;0.33;274.58;4.66;988;7;1613.00;4
3780;7;21847538;3780;435;4765;4769;5.31;0.33;274.57;4.66;985;7;1614.00;4
3784;7;21847549;3784;435;4765;4770;5.21;0.32;274.50;4.66;981;7;1615.00;5
3788;7;21847559;3788;443;4765;4770;5.09;0.31;274.34;4.66;977;7;1616.00;5
3788;7;21847575;3788;446;4765;4770;5.05;0.31;274.34;4.66;977;7;1617.00;5
3793;7;21847585;3793;450;4765;4770;4.96;0.30;274.23;4.66;972;7;1618.00;5
3795;7;21847596;3795;449;4765;4770;4.89;0.30;274.14;4.66;970;7;1619.00;5
3797;7;21847607;3797;449;4791;4806;5.05;0.31;274.09;4.63;994;7;1620.00;15
3803;7;21847620;3803;444;4795;4806;4.98;0.31;273.98;4.63;992;7;1621.00;11
3806;7;21847631;3806;438;4796;4806;4.98;0.31;273.93;4.63;990;7;1622.00;10
3807;7;21847642;3807;430;4797;4806;5.03;0.31;273.96;4.63;990;7;1623.00;9
3810;7;21847653;3810;433;4798;4806;5.01;0.31;273.88;4.63;988;7;1624.00;8
3811;7;21847664;3811;429;4798;4806;5.02;0.31;273.97;4.63;987;7;1625.00;8
3812;7;21847675;3812;437;4801;4810;5.04;0.31;273.90;4.63;989;7;1626.00;9
3813;7;21847686;3813;436;4801;4810;5.06;0.31;273.88;4.63;988;7;1627.00;9
3817;7;21847697;3817;441;4805;4814;5.07;0.31;273.78;4.62;988;7;1628.00;9
3819;7;21847710;3819;447;4806;4815;5.11;0.31;273.74;4.62;987;7;1629.00;9
3820;7;21847720;3820;451;4806;4815;5.16;0.32;273.79;4.62;986;7;1630.00;9
3820;7;21847732;3820;440;4806;4815;5.20;0.32;273.79;4.62;986;7;1631.00;9
3821;7;21847743;3821;428;4817;4828;5.34;0.33;273.76;4.61;996;7;1632.00;11
3821;7;21847761;3821;415;4817;4828;5.47;0.33;273.76;4.61;996;7;1633.00;11
3822;7;21847772;3822;407;4817;4828;5.56;0.34;273.80;4.61;995;7;1634.00;11
3824;7;21847784;3824;400;4818;4829;5.67;0.35;273.83;4.61;994;7;1635.00;11
3827;7;21847796;3827;399;4818;4830;5.77;0.35;273.85;4.61;991;7;1636.00;12
3828;7;21847809;3828;386;4818;4830;5.83;0.35;273.80;4.61;990;7;1637.00;12
3828;7;21847820;3828;382;4820;4833;5.95;0.36;273.80;4.61;992;7;1638.00;13
3830;7;21847838;3830;378;4820;4833;6.06;0.37;273.78;4.61;990;7;1639.00;13
3831;7;21847854;3831;377;4821;4833;6.18;0.38;273.81;4.61;990;7;1640.00;12
3831;7;21847871;3831;368;4821;4833;6.22;0.38;273.81;4.61;990;7;1641.00;12
3833;7;21847887;3833;364;4826;4839;6.29;0.38;273.84;4.60;993;7;1642.00;13
3833;7;21847904;3833;365;4826;4839;6.34;0.39;273.84;4.60;993;7;1643.00;13
3833;7;21847928;3833;367;4826;4839;6.33;0.39;273.84;4.60;993;7;1644.00;13
3836;7;21847942;3836;359;4826;4839;6.38;0.39;273.90;4.60;990;7;1645.00;13
3836;7;21847955;3836;352;4829;4843;6.50;0.39;273.90;4.60;993;7;1646.00;14
3839;7;21847974;3839;354;4830;4844;6.54;0.40;273.84;4.60;991;7;1647.00;14
3839;7;21847994;3839;353;4830;4844;6.65;0.40;273.84;4.60;991;7;1648.00;14
3839;7;21848006;3839;350;4831;4845;6.79;0.41;273.84;4.60;992;7;1649.00;14
3842;7;21848021;3842;345;4831;4845;6.86;0.42;273.93;4.60;989;7;1650.00;14
3845;7;21848034;3845;345;4831;4845;6.88;0.42;273.94;4.60;986;7;1651.00;14
3846;7;21848053;3846;349;4831;4845;6.84;0.42;273.94;4.60;985;7;1652.00;14
3847;7;21848066;3847;343;4831;4845;6.88;0.42;273.92;4.60;984;7;1653.00;14
3848;7;21848077;3848;343;4831;4845;6.92;0.42;273.97;4.60;983;7;1654.00;14
3850;7;21848089;3850;339;4831;4845;6.88;0.42;274.01;4.60;981;7;1655.00;14
3852;8;21848102;3852;345;4867;4915;6.93;0.42;273.97;4.57;1015;8;1656.00;48
3856;8;21848138;3856;331;4867;4916;6.94;0.42;274.08;4.57;1011;8;1657.00;49
3856;8;21848151;3856;329;4874;4916;7.07;0.43;274.08;4.56;1018;8;1658.00;42
3857;8;21848169;3857;334;4878;4916;7.14;0.43;274.12;4.56;1021;8;1659.00;38
3860;8;21848182;3860;333;4881;4916;7.21;0.44;274.28;4.56;1021;8;1660.00;35
3862;8;21848195;3862;337;4885;4916;7.22;0.44;274.43;4.56;1023;8;1661.00;31
3864;8;21848207;3864;340;4889;4916;7.24;0.44;274.53;4.56;1025;8;1662.00;27
3868;8;21848219;3868;345;4890;4916;7.30;0.44;274.61;4.56;1022;8;1663.00;26
3870;8;21848231;3870;350;4893;4917;7.35;0.45;274.72;4.57;1023;8;1664.00;24
3873;8;21848244;3873;341;4895;4919;7.34;0.45;274.69;4.57;1022;8;1665.00;24
3876;8;21848259;3876;338;4898;4919;7.42;0.45;274.94;4.57;1022;8;1666.00;21
3878;8;21848272;3878;333;4902;4923;7.48;0.45;274.99;4.57;1024;8;1667.00;21
3879;8;21848284;3879;332;4903;4923;7.59;0.46;275.00;4.57;1024;8;1668.00;20
3880;8;21848297;3880;329;4903;4923;7.68;0.47;275.06;4.57;1023;8;1669.00;20
3883;8;21848322;3883;324;4903;4923;7.67;0.47;275.25;4.57;1020;8;1670.00;20
3886;8;21848335;3886;314;4907;4929;7.71;0.47;275.40;4.56;1021;8;1671.00;22
3889;8;21848349;3889;318;4907;4929;7.73;0.47;275.45;4.56;1018;8;1672.00;22
3895;8;21848362;3895;316;4907;4929;7.70;0.47;275.53;4.56;1012;8;1673.00;22
3896;8;21848394;3896;316;4909;4932;7.82;0.48;275.58;4.56;1013;8;1674.00;23
3899;8;21848407;3899;316;4909;4932;7.81;0.47;275.53;4.56;1010;8;1675.00;23
3902;8;21848420;3902;313;4910;4932;7.77;0.47;275.73;4.56;1008;8;1676.00;22
3905;8;21848433;3905;312;4910;4933;7.66;0.47;275.79;4.56;1005;8;1677.00;23
3909;8;21848446;3909;313;4911;4934;7.55;0.46;275.96;4.56;1002;8;1678.00;23
3912;8;21848458;3912;312;4911;4934;7.46;0.45;276.09;4.56;999;8;1679.00;23
3918;8;21848472;3918;312;4931;4960;7.37;0.45;276.23;4.54;1013;8;1680.00;29
3920;8;21848488;3920;300;4932;4960;7.27;0.44;276.28;4.56;1012;8;1681.00;28
3924;8;21848503;3924;290;4933;4960;7.27;0.44;276.37;4.56;1009;8;1682.00;27
3928;8;21848516;3928;287;4935;4961;7.28;0.44;276.42;4.56;1007;8;1683.00;26
3932;8;21848529;3932;282;4935;4961;7.26;0.44;276.53;4.56;1003;8;1684.00;26
3933;8;21848540;3933;279;4938;4965;7.31;0.44;276.49;4.55;1005;8;1685.00;27
3934;8;21848553;3934;271;4938;4965;7.38;0.45;276.48;4.55;1004;8;1686.00;27
3938;8;21848565;3938;267;4941;4969;7.31;0.44;276.60;4.55;1003;8;1687.00;28
3938;8;21848578;3938;264;4941;4969;7.39;0.45;276.60;4.55;1003;8;1688.00;28
3940;8;21848590;3940;260;4941;4969;7.47;0.45;276.73;4.55;1001;8;1689.00;28
3944;8;21848602;3944;263;4941;4969;7.54;0.46;276.84;4.55;997;8;1690.00;28
3948;8;21848614;3948;261;4942;4969;7.55;0.46;276.94;4.56;994;8;1691.00;27
3953;8;21848626;3953;268;4952;4981;7.64;0.46;276.97;4.55;999;8;1692.00;29
3953;8;21848639;3953;260;4953;4981;7.71;0.47;276.97;4.55;1000;8;1693.00;28
3956;8;21848652;3956;258;4953;4981;7.73;0.47;277.05;4.55;997;8;1694.00;28
3961;8;21848664;3961;256;4954;4981;7.74;0.47;277.24;4.56;993;8;1695.00;27
3962;8;21848677;3962;258;4955;4981;7.75;0.47;277.23;4.57;993;8;1696.00;26
3964;8;21848695;3964;258;4955;4981;7.75;0.47;277.40;4.57;991;8;1697.00;26
3966;8;21848707;3966;259;4955;4982;7.79;0.47;277.34;4.57;989;8;1698.00;27
3969;8;21848720;3969;260;4956;4982;7.76;0.47;277.49;4.57;987;8;1699.00;26
3973;8;21848733;3973;259;4961;4988;7.77;0.47;277.52;4.57;988;8;1700.00;27
3974;8;21848750;3974;266;4962;4989;7.79;0.47;277.64;4.57;988;8;1701.00;27
3975;8;21848762;3975;268;4964;4989;7.76;0.47;277.65;4.59;989;8;1702.00;25
3978;8;21848775;3978;265;4965;4989;7.74;0.47;277.74;4.59;987;8;1703.00;24
3979;8;21848789;3979;272;4969;4993;7.74;0.47;277.86;4.61;990;8;1704.00;24
3981;8;21848801;3981;271;4970;4993;7.72;0.47;277.90;4.62;989;8;1705.00;23
3984;8;21848813;3984;274;4970;4993;7.75;0.47;278.17;4.62;986;8;1706.00;23
3985;8;21848826;3985;272;4972;4994;7.77;0.47;278.12;4.64;987;8;1707.00;22
3988;8;21848838;3988;268;4975;4998;7.76;0.47;278.30;4.64;987;8;1708.00;23
3990;8;21848851;3990;267;4976;4998;7.82;0.47;278.30;4.65;986;8;1709.00;22
3996;8;21848866;3996;263;4981;5004;7.85;0.48;278.38;4.67;985;8;1710.00;23
4001;8;21848879;4001;264;4983;5004;7.86;0.48;278.68;4.67;982;8;1711.00;21
4001;8;21848892;4001;261;4984;5004;7.88;0.48;278.68;4.67;983;8;1712.00;20
4002;8;21848904;4002;263;4986;5004;7.89;0.48;278.71;4.70;984;8;1713.00;18
4003;8;21848916;4003;262;4990;5008;8.01;0.49;278.81;4.70;987;8;1714.00;18
4005;8;21848929;4005;267;4992;5008;8.04;0.49;278.88;4.73;987;8;1715.00;16
4006;8;21848941;4006;269;4992;5008;8.00;0.49;278.90;4.73;986;8;1716.00;16
4009;8;21848953;4009;269;4994;5008;8.00;0.49;278.95;4.76;985;8;1717.00;14
4012;8;21848966;4012;273;4994;5009;8.00;0.49;278.95;4.76;982;8;1718.00;15
4012;8;21848978;4012;273;4997;5010;8.02;0.49;278.95;4.78;985;8;1719.00;13
4017;8;21848990;4017;276;4997;5010;7.91;0.48;279.11;4.78;980;8;1720.00;13
4022;8;21849004;4022;282;4999;5011;7.80;0.47;279.03;4.79;977;8;1721.00;12
4023;8;21849016;4023;286;5000;5011;7.73;0.47;279.06;4.80;977;8;1722.00;11
4025;8;21849028;4025;285;5001;5011;7.69;0.47;279.08;4.81;976;8;1723.00;10
4028;8;21849040;4028;281;5001;5011;7.64;0.47;279.11;4.81;973;8;1724.00;10
4031;8;21849051;4031;284;5004;5011;7.63;0.47;279.20;4.84;973;8;1725.00;7
4033;8;21849064;4033;278;5004;5011;7.56;0.46;279.11;4.84;971;8;1726.00;7
4038;8;21849076;4038;277;5004;5011;7.46;0.46;279.22;4.84;966;8;1727.00;7
4039;8;21849087;4039;297;5074;5138;7.58;0.47;279.27;4.78;1035;8;1728.00;64
4041;8;21849109;4041;290;5078;5139;7.61;0.47;279.27;4.78;1037;8;1729.00;61
4046;8;21849122;4046;282;5087;5139;7.68;0.47;279.27;4.78;1041;8;1730.00;52
4048;8;21849135;4048;273;5088;5139;7.73;0.48;279.33;4.78;1040;8;1731.00;51
4049;8;21849147;4049;269;5093;5139;7.87;0.49;279.38;4.78;1044;8;1732.00;46
4052;8;21849159;4052;267;5094;5139;7.82;0.48;279.41;4.79;1042;8;1733.00;45
4055;8;21849172;4055;264;5096;5139;7.77;0.48;279.58;4.79;1041;8;1734.00;43
4055;8;21849185;4055;267;5101;5139;7.76;0.48;279.58;4.81;1046;8;1735.00;38
4059;8;21849196;4059;275;5102;5140;7.74;0.48;279.77;4.81;1043;8;1736.00;38
4064;8;21849209;4064;270;5108;5141;7.72;0.47;279.78;4.82;1044;8;1737.00;33
4067;8;21849221;4067;270;5109;5141;7.73;0.47;279.87;4.82;1042;8;1738.00;32
4074;8;21849232;4074;271;5112;5142;7.64;0.47;279.85;4.82;1038;8;1739.00;30
4078;8;21849246;4078;274;5118;5142;7.51;0.46;279.93;4.83;1040;8;1740.00;24
4080;8;21849258;4080;277;5121;5142;7.30;0.45;279.99;4.83;1041;8;1741.00;21
4085;8;21849269;4085;284;5126;5142;7.13;0.44;280.05;4.84;1041;8;1742.00;16
4091;8;21849281;4091;293;5131;5146;6.99;0.43;280.28;4.85;1040;8;1743.00;15
4094;8;21849298;4094;306;5134;5146;6.83;0.42;280.13;4.85;1040;8;1744.00;12
4100;8;21849317;4100;311;5138;5146;6.63;0.41;280.30;4.86;1038;8;1745.00;8
4104;8;21849332;4104;323;5141;5149;6.48;0.40;280.17;4.86;1037;8;1746.00;8
4106;8;21849347;4106;340;5143;5149;6.35;0.39;280.25;4.87;1037;8;1747.00;6
4110;8;21849359;4110;354;5144;5149;6.22;0.38;280.31;4.87;1034;8;1748.00;5
4115;8;21849370;4115;357;5147;5153;6.04;0.37;280.30;4.87;1032;8;1749.00;6
4120;8;21849382;4120;346;5150;5154;5.91;0.36;280.36;4.87;1030;8;1750.00;4
4123;8;21849394;4123;342;5150;5154;5.86;0.36;280.33;4.87;1027;8;1751.00;4
4125;8;21849407;4125;340;5155;5158;5.82;0.36;280.29;4.87;1030;8;1752.00;3
4130;8;21849419;4130;347;5158;5158;5.75;0.35;280.38;4.87;1028;8;1753.00;0
4133;8;21849431;4133;346;5158;5158;5.76;0.35;280.40;4.87;1025;8;1754.00;0
4137;8;21849442;4137;354;5160;5160;5.76;0.35;280.36;4.87;1023;8;1755.00;0
4139;8;21849454;4139;358;5160;5160;5.77;0.35;280.38;4.87;1021;8;1756.00;0
4141;8;21849465;4141;357;5166;5166;5.81;0.36;280.44;4.86;1025;8;1757.00;0
4145;8;21849477;4145;352;5166;5166;5.79;0.36;280.57;4.86;1021;8;1758.00;0
4148;8;21849488;4148;352;5167;5167;5.79;0.36;280.72;4.86;1019;8;1759.00;0
4150;8;21849500;4150;347;5167;5167;5.78;0.35;280.80;4.86;1017;8;1760.00;0
4153;8;21849511;4153;351;5167;5167;5.76;0.35;280.84;4.86;1014;8;1761.00;0
4160;8;21849522;4160;349;5167;5167;5.65;0.34;280.83;4.86;1007;8;1762.00;0
4160;8;21849534;4160;354;5167;5167;5.62;0.34;280.83;4.86;1007;8;1763.00;0
4164;8;21849545;4164;363;5178;5179;5.62;0.34;280.86;4.85;1014;8;1764.00;1
4169;8;21849559;4169;363;5178;5179;5.50;0.34;280.87;4.85;1009;8;1765.00;1
4171;8;21849570;4171;367;5179;5179;5.42;0.33;280.78;4.85;1008;8;1766.00;0
4172;8;21849581;4172;367;5179;5179;5.40;0.33;280.82;4.85;1007;8;1767.00;0
4174;8;21849593;4174;369;5179;5179;5.37;0.33;280.84;4.85;1005;8;1768.00;0
4177;8;21849603;4177;384;5179;5179;5.32;0.33;280.83;4.85;1002;8;1769.00;0
4179;8;21849618;4179;389;5182;5183;5.38;0.33;280.84;4.85;1003;8;1770.00;1
4183;8;21849629;4183;395;5182;5183;5.37;0.33;280.76;4.85;999;8;1771.00;1
4186;8;21849639;4186;403;5186;5187;5.39;0.33;280.78;4.85;1000;8;1772.00;1
4188;8;21849651;4188;404;5187;5188;5.37;0.33;280.72;4.84;999;8;1773.00;1
4190;8;21849662;4190;415;5187;5188;5.32;0.33;280.78;4.84;997;8;1774.00;1
4193;8;21849672;4193;417;5187;5188;5.29;0.33;280.71;4.84;994;8;1775.00;1
4196;8;21849683;4196;426;5198;5201;5.32;0.33;280.68;4.83;1002;8;1776.00;3
4201;8;21849696;4201;427;5198;5201;5.25;0.32;280.53;4.83;997;8;1777.00;3
4205;8;21849707;4205;426;5198;5201;5.24;0.32;280.45;4.83;993;8;1778.00;3
4211;8;21849717;4211;428;5199;5202;5.22;0.32;280.36;4.83;988;8;1779.00;3
4215;8;21849728;4215;433;5199;5203;5.23;0.32;280.38;4.83;984;8;1780.00;4
4219;8;21849739;4219;442;5199;5203;5.24;0.32;280.32;4.83;980;8;1781.00;4
4223;8;21849757;4223;444;5201;5206;5.28;0.33;280.31;4.83;978;8;1782.00;5
4227;8;21849768;4227;441;5202;5206;5.26;0.32;280.28;4.83;975;8;1783.00;4
4231;8;21849779;4231;439;5202;5206;5.27;0.32;280.22;4.83;971;8;1784.00;4
4238;8;21849789;4238;444;5202;5206;5.22;0.32;280.18;4.83;964;8;1785.00;4
4239;8;21849800;4239;449;5207;5212;5.27;0.32;280.20;4.83;968;8;1786.00;5
4242;8;21849810;4242;448;5207;5212;5.30;0.33;280.24;4.83;965;8;1787.00;5
4246;8;21849821;4246;451;5207;5212;5.34;0.33;280.21;4.83;961;8;1788.00;5
4248;8;21849835;4248;454;5207;5212;5.38;0.33;280.13;4.83;959;8;1789.00;5
4252;8;21849848;4252;454;5210;5216;5.42;0.33;280.18;4.83;958;8;1790.00;6
4255;8;21849862;4255;458;5211;5217;5.39;0.33;280.18;4.82;956;8;1791.00;6
4257;8;21849877;4257;463;5211;5217;5.38;0.33;280.22;4.82;954;8;1792.00;6
4258;8;21849890;4258;461;5212;5218;5.40;0.33;280.17;4.82;954;8;1793.00;6
4260;8;21849902;4260;449;5212;5218;5.38;0.33;280.10;4.82;952;8;1794.00;6
4261;8;21849917;4261;447;5212;5218;5.37;0.33;280.04;4.82;951;8;1795.00;6
4264;8;21849929;4264;443;5212;5218;5.39;0.33;280.08;4.82;948;8;1796.00;6
4267;8;21849941;4267;429;5212;5218;5.37;0.33;280.31;4.82;945;8;1797.00;6
4269;8;21849953;4269;418;5212;5218;5.46;0.33;280.34;4.82;943;8;1798.00;6
4273;8;21849964;4273;415;5212;5218;5.51;0.33;280.35;4.82;939;8;1799.00;6
4275;8;21849979;4275;424;5284;5356;5.95;0.37;280.37;4.76;1009;8;1800.00;72
4277;8;21850021;4277;410;5289;5357;6.00;0.37;280.36;4.75;1012;8;1801.00;68
4278;8;21850034;4278;397;5299;5357;6.14;0.38;280.39;4.75;1021;8;1802.00;58
4278;8;21850046;4278;390;5303;5357;6.27;0.39;280.39;4.75;1025;8;1803.00;54
4278;8;21850058;4278;379;5307;5357;6.38;0.39;280.39;4.75;1029;8;1804.00;50
4279;8;21850069;4279;372;5308;5357;6.40;0.39;280.46;4.75;1029;8;1805.00;49
4281;8;21850082;4281;354;5315;5357;6.47;0.40;280.46;4.75;1034;8;1806.00;42
4284;8;21850094;4284;342;5319;5357;6.51;0.40;280.51;4.75;1035;8;1807.00;38
4284;8;21850106;4284;340;5326;5358;6.50;0.40;280.51;4.76;1042;8;1808.00;32
4285;8;21850118;4285;336;5327;5359;6.50;0.40;280.53;4.76;1042;8;1809.00;32
4288;8;21850131;4288;342;5332;5359;6.50;0.40;280.60;4.76;1044;8;1810.00;27
4288;8;21850144;4288;335;5337;5363;6.57;0.40;280.60;4.76;1049;8;1811.00;26
4289;8;21850157;4289;349;5340;5363;6.60;0.41;280.59;4.76;1051;8;1812.00;23
4290;8;21850170;4290;346;5340;5363;6.66;0.41;280.68;4.76;1050;8;1813.00;23
4291;8;21850183;4291;349;5341;5363;6.67;0.41;280.79;4.76;1050;8;1814.00;22
4292;8;21850196;4292;356;5346;5369;6.70;0.41;280.83;4.76;1054;8;1815.00;23
4296;8;21850209;4296;363;5347;5369;6.71;0.41;281.02;4.76;1051;8;1816.00;22
4300;8;21850222;4300;351;5347;5369;6.70;0.41;281.13;4.76;1047;8;1817.00;22
4304;8;21850235;4304;345;5350;5372;6.68;0.41;281.31;4.77;1046;8;1818.00;22
4307;8;21850249;4307;344;5350;5372;6.67;0.41;281.35;4.77;1043;8;1819.00;22
4309;8;21850262;4309;344;5350;5372;6.66;0.41;281.38;4.77;1041;8;1820.00;22
4312;8;21850275;4312;337;5350;5373;6.68;0.41;281.52;4.77;1038;8;1821.00;23
4317;8;21850287;4317;338;5351;5374;6.69;0.41;281.58;4.77;1034;8;1822.00;23
4320;8;21850301;4320;330;5353;5374;6.70;0.41;281.66;4.77;1033;8;1823.00;21
4322;8;21850320;4322;335;5362;5387;6.76;0.41;281.87;4.77;1040;8;1824.00;25
4324;8;21850333;4324;326;5363;5387;6.83;0.42;281.92;4.77;1039;8;1825.00;24
4325;8;21850346;4325;334;5363;5387;6.92;0.42;282.00;4.77;1038;8;1826.00;24
4327;8;21850358;4327;328;5365;5388;6.94;0.42;282.03;4.76;1038;8;1827.00;23
4327;8;21850377;4327;329;5365;5388;7.05;0.43;282.03;4.76;1038;8;1828.00;23
4331;8;21850389;4331;332;5368;5392;7.05;0.43;282.11;4.76;1037;8;1829.00;24
4332;8;21850404;4332;333;5369;5392;7.07;0.43;282.07;4.76;1037;8;1830.00;23
4334;8;21850417;4334;332;5374;5396;7.03;0.43;282.19;4.76;1040;8;1831.00;22
4336;8;21850436;4336;328;5374;5396;7.01;0.43;282.20;4.76;1038;8;1832.00;22
4339;8;21850449;4339;335;5374;5396;7.01;0.43;282.14;4.76;1035;8;1833.00;22
4341;8;21850461;4341;336;5374;5396;7.04;0.43;282.20;4.76;1033;8;1834.00;22
4343;8;21850473;4343;347;5374;5396;7.05;0.43;282.23;4.76;1031;8;1835.00;22
4344;8;21850486;4344;352;5384;5408;7.07;0.43;282.25;4.75;1040;8;1836.00;24
4348;8;21850500;4348;343;5384;5408;7.05;0.43;282.42;4.75;1036;8;1837.00;24
4350;8;21850513;4350;350;5385;5408;7.08;0.43;282.45;4.75;1035;8;1838.00;23
4354;8;21850525;4354;343;5385;5408;7.08;0.43;282.60;4.75;1031;8;1839.00;23
4356;8;21850538;4356;338;5385;5408;7.08;0.43;282.60;4.75;1029;8;1840.00;23
4360;8;21850550;4360;332;5385;5408;7.07;0.43;282.76;4.75;1025;8;1841.00;23
4362;8;21850564;4362;332;5385;5409;7.09;0.43;282.82;4.75;1023;8;1842.00;24
4363;8;21850576;4363;323;5385;5409;7.14;0.43;282.86;4.75;1022;8;1843.00;24
4366;8;21850589;4366;320;5390;5415;7.15;0.43;282.90;4.75;1024;8;1844.00;25
4368;8;21850602;4368;313;5392;5417;7.17;0.44;283.00;4.75;1024;8;1845.00;25
4371;8;21850614;4371;306;5392;5417;7.17;0.44;283.00;4.75;1021;8;1846.00;25
4375;8;21850628;4375;306;5392;5417;7.18;0.44;283.19;4.75;1017;8;1847.00;25
4379;8;21850640;4379;299;5394;5421;7.20;0.44;283.35;4.74;1015;8;1848.00;27
4384;8;21850653;4384;295;5395;5421;7.18;0.44;283.44;4.74;1011;8;1849.00;26
4385;8;21850666;4385;289;5395;5421;7.15;0.43;283.54;4.74;1010;8;1850.00;26
4389;8;21850679;4389;289;5396;5422;7.08;0.43;283.77;4.74;1007;8;1851.00;26
4393;8;21850691;4393;287;5399;5426;6.97;0.42;283.90;4.74;1006;8;1852.00;27
4397;8;21850703;4397;286;5399;5426;6.96;0.42;284.06;4.74;1002;8;1853.00;27
4397;8;21850716;4397;283;5401;5429;6.97;0.42;284.06;4.74;1004;8;1854.00;28
4400;8;21850728;4400;279;5404;5429;7.00;0.43;284.13;4.77;1004;8;1855.00;25
4401;8;21850742;4401;277;5404;5429;7.05;0.43;284.28;4.77;1003;8;1856.00;25
4403;8;21850753;4403;265;5404;5429;7.00;0.43;284.33;4.77;1001;8;1857.00;25
4408;8;21850766;4408;261;5408;5433;7.04;0.43;284.61;4.76;1000;8;1858.00;25
4412;8;21850778;4412;263;5408;5433;7.11;0.43;284.69;4.76;996;8;1859.00;25
4412;8;21850793;4412;259;5408;5433;7.20;0.44;284.69;4.76;996;8;1860.00;25
4414;8;21850805;4414;253;5408;5433;7.27;0.44;284.68;4.76;994;8;1861.00;25
4417;8;21850818;4417;250;5408;5434;7.36;0.45;284.69;4.76;991;8;1862.00;26
4419;8;21850830;4419;242;5409;5435;7.43;0.45;284.64;4.76;990;8;1863.00;26
4422;8;21850843;4422;233;5409;5435;7.47;0.45;284.67;4.76;987;8;1864.00;26
4424;8;21850855;4424;233;5410;5436;7.56;0.46;284.73;4.76;986;8;1865.00;26
4427;8;21850868;4427;234;5410;5436;7.59;0.46;284.72;4.76;983;8;1866.00;26
4430;8;21850880;4430;236;5410;5436;7.65;0.46;284.63;4.76;980;8;1867.00;26
4432;8;21850893;4432;237;5410;5436;7.69;0.47;284.61;4.76;978;8;1868.00;26
4435;8;21850904;4435;232;5410;5436;7.71;0.47;284.61;4.76;975;8;1869.00;26
4436;8;21850916;4436;231;5410;5436;7.71;0.47;284.66;4.76;974;8;1870.00;26
4440;8;21850929;4440;227;5411;5436;7.66;0.46;284.67;4.78;971;8;1871.00;25
4442;8;21850940;4442;251;5480;5563;7.66;0.47;284.84;4.72;1038;8;1872.00;83
4442;8;21850964;4442;238;5482;5564;7.69;0.47;284.84;4.71;1040;8;1873.00;82
4445;8;21850977;4445;229;5487;5564;7.73;0.48;284.85;4.71;1042;8;1874.00;77
4448;8;21850990;4448;227;5490;5564;7.72;0.48;284.91;4.71;1042;8;1875.00;74
4453;8;21851004;4453;223;5495;5564;7.78;0.48;285.07;4.71;1042;8;1876.00;69
4455;8;21851017;4455;226;5496;5564;7.81;0.48;285.19;4.71;1041;8;1877.00;68
4457;8;21851030;4457;230;5500;5564;7.84;0.48;285.17;4.71;1043;8;1878.00;64
4461;8;21851043;4461;229;5503;5564;7.88;0.48;285.36;4.71;1042;8;1879.00;61
4463;8;21851062;4463;232;5508;5565;7.92;0.48;285.43;4.75;1045;8;1880.00;57
4465;8;21851075;4465;234;5511;5566;7.92;0.49;285.53;4.75;1046;8;1881.00;55
4469;8;21851088;4469;234;5516;5568;7.92;0.48;285.78;4.75;1047;8;1882.00;52
4473;8;21851102;4473;241;5519;5569;7.84;0.48;285.81;4.77;1046;8;1883.00;50
4476;8;21851115;4476;241;5522;5569;7.76;0.47;285.75;4.79;1046;8;1884.00;47
4477;8;21851128;4477;248;5525;5569;7.68;0.47;285.87;4.81;1048;8;1885.00;44
4479;8;21851140;4479;246;5529;5569;7.59;0.46;285.94;4.81;1050;8;1886.00;40
4483;8;21851153;4483;256;5534;5573;7.62;0.47;285.96;4.83;1051;8;1887.00;39
4485;8;21851166;4485;262;5535;5573;7.66;0.47;285.95;4.84;1050;8;1888.00;38
4487;8;21851179;4487;266;5539;5573;7.68;0.47;285.88;4.85;1052;8;1889.00;34
4491;8;21851200;4491;275;5544;5579;7.61;0.47;285.98;4.85;1053;8;1890.00;35
4494;8;21851214;4494;277;5546;5579;7.57;0.46;285.93;4.87;1052;8;1891.00;33
4495;8;21851226;4495;285;5549;5579;7.53;0.46;285.94;4.90;1054;8;1892.00;30
4497;8;21851238;4497;286;5553;5583;7.43;0.46;285.94;4.91;1056;8;1893.00;30
4501;8;21851251;4501;288;5554;5584;7.45;0.46;285.86;4.91;1053;8;1894.00;30
4503;8;21851264;4503;285;5558;5584;7.36;0.45;285.89;4.95;1055;8;1895.00;26
4509;8;21851276;4509;294;5563;5588;7.34;0.45;285.86;4.96;1054;8;1896.00;25
4511;8;21851290;4511;300;5565;5588;7.31;0.45;285.89;4.98;1054;8;1897.00;23
4514;8;21851302;4514;300;5565;5588;7.25;0.44;285.85;4.98;1051;8;1898.00;23
4517;8;21851314;4517;300;5567;5589;7.22;0.44;285.92;4.98;1050;8;1899.00;22
4518;8;21851328;4518;303;5567;5589;7.24;0.44;286.07;4.98;1049;8;1900.00;22
4523;8;21851344;4523;308;5575;5595;7.20;0.44;286.10;5.02;1052;8;1901.00;20
4524;8;21851358;4524;306;5577;5595;7.12;0.44;286.15;5.03;1053;8;1902.00;18
4528;8;21851370;4528;310;5579;5596;7.01;0.43;286.24;5.06;1051;8;1903.00;17
4530;8;21851383;4530;316;5579;5596;7.01;0.43;286.32;5.06;1049;8;1904.00;17
4532;8;21851395;4532;320;5581;5596;6.94;0.43;286.42;5.07;1049;8;1905.00;15
4536;8;21851407;4536;328;5582;5596;6.86;0.42;286.58;5.08;1046;8;1906.00;14
4537;8;21851420;4537;323;5582;5596;6.84;0.42;286.58;5.08;1045;8;1907.00;14
4539;8;21851433;4539;326;5594;5608;6.86;0.42;286.65;5.08;1055;8;1908.00;14
4540;8;21851446;4540;333;5595;5608;6.85;0.42;286.73;5.08;1055;8;1909.00;13
4541;8;21851457;4541;332;5595;5608;6.87;0.42;286.70;5.08;1054;8;1910.00;13
4544;8;21851475;4544;335;5596;5608;6.83;0.42;286.67;5.09;1052;8;1911.00;12
4546;8;21851486;4546;344;5597;5608;6.81;0.42;286.64;5.09;1051;8;1912.00;11
4549;8;21851498;4549;339;5597;5608;6.75;0.42;286.68;5.09;1048;8;1913.00;11
4552;8;21851509;4552;340;5601;5612;6.71;0.41;286.74;5.10;1049;8;1914.00;11
4557;8;21851521;4557;340;5601;5612;6.64;0.41;286.85;5.10;1044;8;1915.00;11
4561;8;21851532;4561;344;5608;5616;6.55;0.40;287.07;5.12;1047;8;1916.00;8
4565;8;21851544;4565;356;5609;5617;6.46;0.40;286.94;5.12;1044;8;1917.00;8
4568;8;21851555;4568;359;5610;5617;6.41;0.40;286.97;5.12;1042;8;1918.00;7
4572;8;21851566;4572;362;5610;5617;6.37;0.39;286.99;5.12;1038;8;1919.00;7
4576;8;21851579;4576;372;5633;5646;6.27;0.39;287.04;5.10;1057;8;1920.00;13
4580;8;21851592;4580;375;5633;5646;6.15;0.38;286.96;5.10;1053;8;1921.00;13
4589;8;21851602;4589;372;5636;5646;6.11;0.38;286.95;5.10;1047;8;1922.00;10
4595;8;21851613;4595;377;5638;5647;5.96;0.37;287.11;5.10;1043;8;1923.00;9
4600;8;21851623;4600;377;5638;5648;5.85;0.36;287.12;5.10;1038;8;1924.00;10
4605;8;21851634;4605;365;5638;5648;5.78;0.36;287.11;5.10;1033;8;1925.00;10
4610;8;21851645;4610;362;5641;5651;5.72;0.35;287.25;5.10;1031;8;1926.00;10
4615;8;21851656;4615;352;5641;5651;5.69;0.35;287.31;5.10;1026;8;1927.00;10
4617;8;21851666;4617;352;5641;5651;5.70;0.35;287.42;5.10;1024;8;1928.00;10
4620;8;21851676;4620;362;5641;5651;5.69;0.35;287.40;5.10;1021;8;1929.00;10
4623;8;21851686;4623;362;5645;5657;5.73;0.35;287.40;5.09;1022;8;1930.00;12
4630;8;21851697;4630;373;5645;5657;5.71;0.35;287.36;5.09;1015;8;1931.00;12
4631;8;21851708;4631;368;5645;5657;5.70;0.35;287.31;5.09;1014;8;1932.00;12
4634;8;21851719;4634;370;5645;5657;5.64;0.35;287.37;5.09;1011;8;1933.00;12
4636;8;21851730;4636;369;5648;5661;5.65;0.35;287.34;5.09;1012;8;1934.00;13
4639;8;21851741;4639;371;5650;5663;5.56;0.34;287.41;5.09;1011;8;1935.00;13
4641;8;21851751;4641;374;5650;5663;5.50;0.34;287.47;5.09;1009;8;1936.00;13
4644;8;21851762;4644;377;5651;5664;5.44;0.33;287.41;5.09;1007;8;1937.00;13
4644;8;21851773;4644;379;5651;5664;5.45;0.34;287.41;5.09;1007;8;1938.00;13
4647;8;21851785;4647;379;5651;5664;5.37;0.33;287.55;5.09;1004;8;1939.00;13
4651;8;21851800;4651;383;5652;5664;5.27;0.32;287.46;5.09;1001;8;1940.00;12
4654;8;21851812;4654;383;5652;5664;5.22;0.32;287.40;5.09;998;8;1941.00;12
4661;8;21851823;4661;395;5652;5664;5.11;0.31;287.49;5.09;991;8;1942.00;12
4661;8;21851839;4661;398;5652;5664;5.08;0.31;287.49;5.09;991;8;1943.00;12
4667;8;21851853;4667;407;5691;5734;5.17;0.32;287.44;5.06;1024;8;1944.00;43
4673;8;21851877;4673;405;5691;5735;5.11;0.32;287.44;5.06;1018;8;1945.00;44
4677;8;21851893;4677;413;5697;5735;5.18;0.32;287.53;5.05;1020;8;1946.00;38
4681;8;21851908;4681;411;5698;5735;5.14;0.32;287.73;5.05;1017;8;1947.00;37
4685;8;21851924;4685;412;5703;5735;5.13;0.32;287.64;5.05;1018;8;1948.00;32
4690;8;21851939;4690;420;5706;5735;5.14;0.32;287.67;5.05;1016;8;1949.00;29
4693;8;21851955;4693;428;5709;5737;5.12;0.32;287.64;5.05;1016;8;1950.00;28
4697;8;21851968;4697;413;5710;5737;5.15;0.32;287.75;5.05;1013;8;1951.00;27
4700;8;21851981;4700;408;5712;5738;5.21;0.32;287.78;5.05;1012;8;1952.00;26
4704;8;21851994;4704;406;5715;5739;5.22;0.32;287.78;5.05;1011;8;1953.00;24
4709;8;21852006;4709;409;5718;5739;5.19;0.32;287.76;5.06;1009;8;1954.00;21
4710;8;21852020;4710;410;5723;5743;5.30;0.33;287.73;5.05;1013;8;1955.00;20
4717;8;21852035;4717;410;5723;5743;5.30;0.33;287.60;5.05;1006;8;1956.00;20
4719;8;21852050;4719;403;5725;5743;5.37;0.33;287.58;5.06;1006;8;1957.00;18
4725;8;21852073;4725;403;5725;5743;5.41;0.33;287.54;5.06;1000;8;1958.00;18
4729;8;21852089;4729;398;5730;5749;5.45;0.33;287.50;5.05;1001;8;1959.00;19
4730;8;21852110;4730;399;5730;5749;5.53;0.34;287.49;5.05;1000;8;1960.00;19
4733;8;21852124;4733;404;5730;5749;5.49;0.34;287.53;5.05;997;8;1961.00;19
4735;8;21852138;4735;400;5733;5752;5.48;0.34;287.50;5.05;998;8;1962.00;19
4738;8;21852152;4738;398;5733;5752;5.46;0.33;287.46;5.05;995;8;1963.00;19
4739;8;21852166;4739;398;5734;5752;5.50;0.34;287.49;5.05;995;8;1964.00;18
4743;8;21852180;4743;401;5734;5753;5.43;0.33;287.51;5.05;991;8;1965.00;19
4747;8;21852194;4747;398;5735;5754;5.39;0.33;287.39;5.05;988;8;1966.00;19
4749;8;21852207;4749;401;5735;5754;5.38;0.33;287.42;5.05;986;8;1967.00;19
4754;8;21852221;4754;405;5745;5767;5.49;0.33;287.34;5.04;991;8;1968.00;22
4755;8;21852236;4755;407;5746;5767;5.54;0.34;287.38;5.04;991;8;1969.00;21
4757;8;21852250;4757;401;5746;5767;5.56;0.34;287.48;5.04;989;8;1970.00;21
4758;8;21852264;4758;409;5747;5768;5.58;0.34;287.50;5.04;989;8;1971.00;21
4762;8;21852278;4762;400;5747;5768;5.59;0.34;287.53;5.04;985;8;1972.00;21
4763;8;21852293;4763;397;5751;5772;5.72;0.35;287.60;5.04;988;8;1973.00;21
4766;8;21852308;4766;393;5751;5772;5.79;0.35;287.71;5.04;985;8;1974.00;21
4771;8;21852322;4771;387;5754;5776;5.83;0.35;287.86;5.04;983;8;1975.00;22
4771;8;21852337;4771;382;5754;5776;5.94;0.36;287.86;5.04;983;8;1976.00;22
4773;8;21852350;4773;387;5754;5776;5.97;0.36;287.85;5.04;981;8;1977.00;22
4776;9;21852365;4776;387;5754;5776;5.97;0.36;287.91;5.04;978;9;1978.00;22
4779;9;21852398;4779;385;5754;5776;6.03;0.37;287.95;5.04;975;9;1979.00;22
4780;9;21852413;4780;389;5781;5810;6.27;0.38;288.04;5.01;1001;9;1980.00;29
4781;9;21852435;4781;371;5781;5810;6.36;0.39;288.08;5.01;1000;9;1981.00;29
4783;9;21852448;4783;366;5784;5810;6.45;0.39;288.13;5.01;1001;9;1982.00;26
4787;9;21852480;4787;362;5784;5810;6.51;0.40;288.29;5.01;997;9;1983.00;26
4789;9;21852497;4789;358;5785;5810;6.59;0.40;288.40;5.01;996;9;1984.00;25
4789;9;21852510;4789;351;5785;5810;6.66;0.40;288.40;5.01;996;9;1985.00;25
4791;9;21852524;4791;352;5785;5811;6.62;0.40;288.52;5.01;994;9;1986.00;26
4792;9;21852545;4792;352;5785;5811;6.64;0.40;288.55;5.01;993;9;1987.00;26
4796;9;21852558;4796;353;5790;5817;6.61;0.40;288.66;5.01;994;9;1988.00;27
4797;9;21852572;4797;358;5791;5818;6.58;0.40;288.75;5.01;994;9;1989.00;27
4798;9;21852585;4798;365;5791;5818;6.55;0.40;288.81;5.01;993;9;1990.00;27
4801;9;21852598;4801;372;5791;5818;6.54;0.40;289.06;5.01;990;9;1991.00;27
4802;9;21852611;4802;371;5794;5822;6.55;0.40;289.04;5.00;992;9;1992.00;28
4805;9;21852624;4805;368;5794;5822;6.53;0.39;289.24;5.00;989;9;1993.00;28
4807;9;21852645;4807;363;5794;5822;6.52;0.39;289.37;5.00;987;9;1994.00;28
4808;9;21852659;4808;361;5795;5823;6.54;0.39;289.37;5.00;987;9;1995.00;28
4811;9;21852671;4811;360;5798;5827;6.48;0.39;289.60;5.00;987;9;1996.00;29
4812;9;21852684;4812;354;5798;5827;6.51;0.39;289.59;5.00;986;9;1997.00;29
4815;9;21852697;4815;355;5800;5830;6.51;0.39;289.81;5.00;985;9;1998.00;30
4815;9;21852711;4815;353;5800;5830;6.54;0.39;289.81;5.00;985;9;1999.00;30
4816;9;21852724;4816;354;5801;5830;6.60;0.40;289.83;5.00;985;9;2000.00;29
4819;9;21852742;4819;353;5801;5830;6.64;0.40;289.90;5.00;982;9;2001.00;29
4819;9;21852755;4819;352;5805;5834;6.76;0.41;289.90;5.00;986;9;2002.00;29
4820;9;21852768;4820;354;5805;5834;6.86;0.42;289.95;5.00;985;9;2003.00;29
4823;9;21852780;4823;350;5805;5834;6.87;0.42;290.00;5.00;982;9;2004.00;29
4825;9;21852795;4825;349;5805;5834;6.91;0.42;290.03;5.00;980;9;2005.00;29
4825;9;21852807;4825;345;5805;5835;6.91;0.42;290.03;5.00;980;9;2006.00;30
4826;9;21852820;4826;344;5806;5836;6.93;0.42;290.02;4.99;980;9;2007.00;30
4828;9;21852832;4828;342;5806;5836;6.93;0.42;290.15;4.99;978;9;2008.00;30
4831;9;21852852;4831;349;5807;5837;6.94;0.42;290.21;4.99;976;9;2009.00;30
4835;9;21852866;4835;346;5807;5837;6.89;0.42;290.23;4.99;972;9;2010.00;30
4840;9;21852882;4840;346;5807;5837;6.84;0.42;290.28;4.99;967;9;2011.00;30
4841;9;21852896;4841;342;5807;5837;6.86;0.42;290.38;4.99;966;9;2012.00;30
4844;9;21852908;4844;342;5807;5837;6.85;0.42;290.38;4.99;963;9;2013.00;30
4846;9;21852921;4846;348;5807;5837;6.85;0.42;290.43;4.99;961;9;2014.00;30
4851;9;21852936;4851;341;5807;5837;6.82;0.41;290.50;4.99;956;9;2015.00;30
4856;9;21852949;4856;360;5882;5964;6.79;0.42;290.51;4.93;1026;9;2016.00;82
4856;9;21852974;4856;341;5882;5965;6.84;0.42;290.51;4.93;1026;9;2017.00;83
4858;9;21852989;4858;326;5887;5965;6.96;0.43;290.55;4.93;1029;9;2018.00;78
4861;9;21853003;4861;324;5890;5965;7.04;0.43;290.59;4.93;1029;9;2019.00;75
4861;9;21853016;4861;311;5894;5965;7.11;0.44;290.59;4.93;1033;9;2020.00;71
4862;9;21853029;4862;314;5895;5965;7.22;0.44;290.56;4.93;1033;9;2021.00;70
4867;9;21853042;4867;308;5897;5965;7.26;0.44;290.62;4.93;1030;9;2022.00;68
4868;9;21853055;4868;310;5898;5965;7.31;0.45;290.64;4.93;1030;9;2023.00;67
4873;9;21853074;4873;311;5901;5966;7.38;0.45;290.83;4.93;1028;9;2024.00;65
4874;9;21853088;4874;316;5904;5968;7.45;0.45;290.85;4.93;1030;9;2025.00;64
4875;9;21853101;4875;311;5906;5968;7.47;0.46;290.87;4.93;1031;9;2026.00;62
4879;9;21853115;4879;303;5910;5969;7.41;0.45;290.93;4.94;1031;9;2027.00;59
4881;9;21853128;4881;303;5913;5969;7.32;0.45;291.01;4.94;1032;9;2028.00;56
4884;10;21853148;4884;300;5917;5969;7.18;0.44;291.04;4.97;1033;10;2029.00;52
4888;10;21853176;4888;294;5918;5969;7.04;0.43;291.06;4.97;1030;10;2030.00;51
4890;10;21853189;4890;293;5923;5973;6.91;0.42;291.04;5.00;1033;10;2031.00;50
4893;10;21853202;4893;286;5926;5973;6.89;0.42;291.12;5.00;1033;10;2032.00;47
4896;10;21853216;4896;285;5928;5973;6.78;0.41;291.13;5.01;1032;10;2033.00;45
4898;10;21853230;4898;288;5931;5976;6.77;0.41;291.17;5.01;1033;10;2034.00;45
4901;10;21853243;4901;294;5931;5976;6.81;0.42;291.24;5.01;1030;10;2035.00;45
4902;10;21853256;4902;296;5933;5976;6.82;0.42;291.28;5.01;1031;10;2036.00;43
4905;10;21853270;4905;294;5936;5980;6.81;0.42;291.55;5.01;1031;10;2037.00;44
4908;10;21853283;4908;295;5938;5981;6.83;0.42;291.68;5.01;1030;10;2038.00;43
4911;10;21853296;4911;298;5939;5981;6.86;0.42;291.83;5.01;1028;10;2039.00;42
4912;10;21853311;4912;297;5943;5986;6.90;0.42;291.95;5.00;1031;10;2040.00;43
4915;10;21853325;4915;298;5943;5986;6.96;0.43;291.97;5.00;1028;10;2041.00;43
4920;10;21853337;4920;293;5943;5986;7.00;0.43;292.06;5.00;1023;10;2042.00;43
4921;10;21853351;4921;285;5944;5987;7.07;0.43;292.02;5.00;1023;10;2043.00;43
4927;10;21853365;4927;286;5944;5987;7.13;0.43;292.14;5.00;1017;10;2044.00;43
4931;10;21853379;4931;282;5948;5993;7.17;0.44;292.13;5.00;1017;10;2045.00;45
4932;10;21853393;4932;284;5948;5993;7.21;0.44;292.08;5.00;1016;10;2046.00;45
4934;10;21853405;4934;278;5948;5994;7.18;0.44;292.09;5.00;1014;10;2047.00;46
4938;10;21853419;4938;283;5948;5994;7.09;0.43;292.20;5.00;1010;10;2048.00;46
4940;10;21853432;4940;284;5949;5994;7.05;0.43;292.17;5.03;1009;10;2049.00;45
4942;10;21853445;4942;288;5950;5994;6.92;0.42;292.15;5.05;1008;10;2050.00;44
4943;10;21853457;4943;294;5952;5994;6.85;0.42;292.16;5.06;1009;10;2051.00;42
4947;10;21853470;4947;295;5962;6006;6.77;0.41;292.27;5.05;1015;10;2052.00;44
4951;10;21853484;4951;310;5962;6006;6.74;0.41;292.42;5.05;1011;10;2053.00;44
4952;10;21853497;4952;317;5966;6006;6.73;0.41;292.46;5.07;1014;10;2054.00;40
4956;10;21853509;4956;323;5967;6006;6.70;0.41;292.66;5.10;1011;10;2055.00;39
4957;10;21853522;4957;328;5967;6006;6.68;0.41;292.70;5.10;1010;10;2056.00;39
4958;10;21853535;4958;333;5969;6006;6.62;0.40;292.70;5.12;1011;10;2057.00;37
4961;10;21853547;4961;337;5973;6010;6.58;0.40;292.78;5.14;1012;10;2058.00;37
4970;10;21853561;4970;342;5974;6010;6.50;0.39;293.00;5.15;1004;10;2059.00;36
4970;10;21853573;4970;347;5979;6014;6.56;0.40;293.00;5.17;1009;10;2060.00;35
4973;10;21853586;4973;353;5981;6015;6.53;0.40;293.26;5.18;1008;10;2061.00;34
4976;10;21853598;4976;351;5982;6015;6.49;0.39;293.35;5.21;1006;10;2062.00;33
4979;10;21853611;4979;361;5983;6015;6.47;0.39;293.41;5.22;1004;10;2063.00;32
4980;10;21853624;4980;368;5995;6028;6.53;0.40;293.43;5.22;1015;10;2064.00;33
4983;10;21853638;4983;369;5995;6028;6.55;0.40;293.46;5.22;1012;10;2065.00;33
4985;10;21853651;4985;375;5997;6028;6.57;0.40;293.62;5.25;1012;10;2066.00;31
4991;10;21853666;4991;381;5999;6029;6.59;0.40;293.61;5.25;1008;10;2067.00;30
4993;10;21853679;4993;387;6000;6030;6.58;0.40;293.75;5.27;1007;10;2068.00;30
4994;10;21853693;4994;389;6000;6030;6.54;0.40;293.73;5.27;1006;10;2069.00;30
4995;10;21853708;4995;397;6006;6036;6.57;0.40;293.77;5.32;1011;10;2070.00;30
4997;10;21853723;4997;399;6006;6036;6.52;0.40;293.85;5.32;1009;10;2071.00;30
4999;10;21853735;4999;402;6010;6036;6.49;0.40;293.83;5.36;1011;10;2072.00;26
5002;10;21853748;5002;405;6010;6036;6.41;0.39;293.90;5.36;1008;10;2073.00;26
5005;10;21853769;5005;403;6018;6042;6.36;0.39;293.84;5.41;1013;10;2074.00;24
5008;10;21853783;5008;397;6018;6042;6.34;0.39;293.77;5.41;1010;10;2075.00;24
5008;10;21853796;5008;400;6019;6042;6.32;0.39;293.77;5.41;1011;10;2076.00;23
5012;10;21853809;5012;398;6020;6042;6.28;0.38;293.63;5.43;1008;10;2077.00;22
5012;10;21853820;5012;393;6023;6046;6.26;0.38;293.63;5.42;1011;10;2078.00;23
5013;10;21853835;5013;395;6024;6047;6.29;0.38;293.61;5.42;1011;10;2079.00;23
5015;10;21853852;5015;397;6025;6047;6.25;0.38;293.55;5.44;1010;10;2080.00;22
5016;10;21853872;5016;396;6026;6048;6.24;0.38;293.60;5.44;1010;10;2081.00;22
5019;10;21853890;5019;397;6026;6048;6.22;0.38;293.49;5.44;1007;10;2082.00;22
5021;10;21853905;5021;402;6026;6048;6.28;0.39;293.44;5.44;1005;10;2083.00;22
5025;10;21853921;5025;403;6031;6048;6.27;0.38;293.38;5.52;1006;10;2084.00;17
5027;10;21853936;5027;407;6031;6048;6.29;0.39;293.35;5.52;1004;10;2085.00;17
5030;10;21853949;5030;411;6032;6048;6.28;0.38;293.33;5.53;1002;10;2086.00;16
5032;10;21853962;5032;412;6032;6048;6.29;0.38;293.26;5.53;1000;10;2087.00;16
5034;10;21853973;5034;422;6078;6118;6.39;0.39;293.22;5.49;1044;10;2088.00;40
5037;10;21853993;5037;427;6081;6119;6.31;0.39;293.18;5.50;1044;10;2089.00;38
5040;10;21854006;5040;423;6087;6119;6.22;0.38;293.15;5.49;1047;10;2090.00;32
5043;10;21854018;5043;424;6091;6119;6.07;0.37;293.15;5.53;1048;10;2091.00;28
5044;10;21854029;5044;431;6093;6119;6.00;0.37;293.14;5.53;1049;10;2092.00;26
5046;10;21854040;5046;437;6093;6119;5.88;0.36;293.08;5.53;1047;10;2093.00;26
5049;10;21854052;5049;443;6096;6119;5.83;0.36;293.12;5.54;1047;10;2094.00;23
5055;10;21854065;5055;445;6098;6119;5.73;0.35;292.90;5.54;1043;10;2095.00;21
5060;10;21854076;5060;449;6099;6120;5.61;0.34;292.85;5.54;1039;10;2096.00;21
5063;10;21854095;5063;457;6104;6121;5.48;0.33;292.84;5.57;1041;10;2097.00;17
5065;10;21854107;5065;463;6106;6121;5.35;0.33;292.79;5.58;1041;10;2098.00;15
5067;10;21854118;5067;463;6111;6125;5.21;0.32;292.73;5.58;1044;10;2099.00;14
5070;10;21854133;5070;469;6116;6140;5.10;0.31;292.71;5.58;1046;10;2100.00;24
5075;10;21854153;5075;456;6118;6140;4.99;0.31;292.59;5.59;1043;10;2101.00;22
5077;10;21854166;5077;458;6118;6140;4.90;0.30;292.53;5.59;1041;10;2102.00;22
5081;10;21854177;5081;459;6122;6146;4.88;0.30;292.55;5.59;1041;10;2103.00;24
5084;10;21854190;5084;465;6122;6146;4.82;0.29;292.65;5.59;1038;10;2104.00;24
5087;10;21854202;5087;471;6122;6146;4.85;0.30;292.72;5.59;1035;10;2105.00;24
5087;10;21854214;5087;476;6126;6149;4.88;0.30;292.72;5.59;1039;10;2106.00;23
5090;10;21854226;5090;464;6126;6149;4.80;0.29;292.79;5.59;1036;10;2107.00;23
5092;10;21854237;5092;445;6126;6149;4.82;0.29;292.85;5.59;1034;10;2108.00;23
5092;10;21854249;5092;434;6127;6150;4.84;0.30;292.85;5.59;1035;10;2109.00;23
5094;10;21854260;5094;430;6128;6151;4.89;0.30;292.85;5.59;1034;10;2110.00;23
5098;10;21854271;5098;428;6129;6151;4.90;0.30;292.82;5.59;1031;10;2111.00;22
5100;10;21854283;5100;430;6140;6164;4.96;0.30;292.83;5.59;1040;10;2112.00;24
5104;10;21854306;5104;425;6141;6164;4.99;0.30;292.76;5.59;1037;10;2113.00;23
5106;10;21854318;5106;423;6141;6164;5.05;0.31;292.72;5.59;1035;10;2114.00;23
5110;10;21854330;5110;431;6144;6166;5.12;0.31;292.61;5.59;1034;10;2115.00;22
5114;10;21854342;5114;433;6144;6166;5.22;0.32;292.59;5.59;1030;10;2116.00;22
5117;10;21854355;5117;433;6148;6170;5.29;0.32;292.64;5.58;1031;10;2117.00;22
5119;10;21854367;5119;428;6149;6170;5.33;0.33;292.63;5.59;1030;10;2118.00;21
5122;10;21854380;5122;434;6152;6174;5.41;0.33;292.64;5.58;1030;10;2119.00;22
5125;10;21854392;5125;426;6152;6174;5.44;0.33;292.79;5.58;1027;10;2120.00;22
5129;10;21854405;5129;425;6152;6174;5.43;0.33;292.78;5.58;1023;10;2121.00;22
5132;10;21854418;5132;421;6152;6174;5.42;0.33;292.72;5.58;1020;10;2122.00;22
5133;10;21854431;5133;419;6153;6174;5.43;0.33;292.74;5.59;1020;10;2123.00;21
5135;10;21854443;5135;420;6162;6186;5.56;0.34;292.74;5.58;1027;10;2124.00;24
5139;10;21854457;5139;416;6163;6186;5.60;0.34;292.73;5.58;1024;10;2125.00;23
5141;10;21854469;5141;413;6164;6186;5.63;0.34;292.77;5.58;1023;10;2126.00;22
5144;10;21854482;5144;409;6166;6186;5.68;0.35;292.75;5.59;1022;10;2127.00;20
5147;10;21854495;5147;407;6166;6186;5.69;0.35;292.73;5.59;1019;10;2128.00;20
5149;10;21854508;5149;406;6168;6186;5.69;0.35;292.75;5.59;1019;10;2129.00;18
5152;10;21854522;5152;410;6168;6187;5.64;0.34;292.79;5.59;1016;10;2130.00;19
5157;10;21854536;5157;401;6169;6187;5.62;0.34;292.81;5.59;1012;10;2131.00;18
5157;10;21854549;5157;399;6174;6193;5.65;0.34;292.81;5.59;1017;10;2132.00;19
5159;10;21854568;5159;401;6175;6194;5.69;0.35;292.77;5.59;1016;10;2133.00;19
5163;10;21854580;5163;406;6175;6194;5.67;0.35;292.80;5.59;1012;10;2134.00;19
5166;10;21854593;5166;405;6175;6194;5.71;0.35;292.84;5.59;1009;10;2135.00;19
5168;10;21854606;5168;400;6178;6198;5.80;0.35;292.81;5.58;1010;10;2136.00;20
5170;10;21854619;5170;401;6178;6198;5.78;0.35;292.86;5.58;1008;10;2137.00;20
5173;10;21854634;5173;402;6178;6198;5.76;0.35;292.92;5.58;1005;10;2138.00;20
5175;10;21854650;5175;401;6179;6199;5.77;0.35;292.91;5.58;1004;10;2139.00;20
5176;10;21854669;5176;397;6182;6203;5.79;0.35;292.93;5.58;1006;10;2140.00;21
5178;10;21854682;5178;404;6182;6203;5.73;0.35;292.90;5.58;1004;10;2141.00;21
5180;10;21854694;5180;403;6184;6206;5.67;0.35;292.82;5.58;1004;10;2142.00;22
5181;10;21854706;5181;407;6184;6206;5.57;0.34;292.86;5.58;1003;10;2143.00;22
5185;10;21854719;5185;413;6185;6206;5.42;0.33;292.99;5.58;1000;10;2144.00;21
5189;10;21854731;5189;416;6185;6206;5.36;0.33;293.04;5.58;996;10;2145.00;21
5193;10;21854743;5193;430;6189;6210;5.35;0.33;293.08;5.58;996;10;2146.00;21
5196;10;21854756;5196;424;6189;6210;5.32;0.32;293.24;5.58;993;10;2147.00;21
5196;10;21854768;5196;411;6189;6210;5.36;0.33;293.24;5.58;993;10;2148.00;21
5200;10;21854781;5200;400;6189;6210;5.42;0.33;293.22;5.58;989;10;2149.00;21
5202;10;21854795;5202;397;6189;6211;5.48;0.33;293.26;5.58;987;10;2150.00;22
5204;10;21854807;5204;392;6190;6212;5.53;0.34;293.28;5.58;986;10;2151.00;22
5206;10;21854820;5206;388;6190;6212;5.61;0.34;293.34;5.58;984;10;2152.00;22
5209;10;21854833;5209;381;6191;6213;5.69;0.35;293.40;5.57;982;10;2153.00;22
5212;10;21854846;5212;377;6191;6213;5.78;0.35;293.55;5.57;979;10;2154.00;22
5214;10;21854861;5214;370;6191;6213;5.84;0.36;293.64;5.57;977;10;2155.00;22
5215;10;21854878;5215;361;6191;6213;5.90;0.36;293.66;5.57;976;10;2156.00;22
5218;10;21854890;5218;349;6191;6213;5.97;0.36;293.81;5.57;973;10;2157.00;22
5220;10;21854903;5220;343;6191;6213;6.03;0.37;293.91;5.57;971;10;2158.00;22
5224;10;21854917;5224;339;6191;6213;6.06;0.37;294.03;5.57;967;10;2159.00;22
5225;10;21854933;5225;393;6311;6443;6.18;0.39;294.01;5.47;1086;10;2160.00;132
5227;10;21854967;5227;385;6317;6444;6.24;0.39;294.03;5.46;1090;10;2161.00;127
5229;10;21854982;5229;365;6328;6444;6.28;0.39;294.17;5.46;1099;10;2162.00;116
5230;10;21854996;5230;366;6331;6444;6.38;0.40;294.14;5.46;1101;10;2163.00;113
5232;10;21855011;5232;358;6339;6444;6.46;0.40;294.20;5.46;1107;10;2164.00;105
5236;10;21855024;5236;354;6340;6444;6.52;0.41;294.29;5.46;1104;10;2165.00;104
5239;10;21855039;5239;355;6347;6444;6.61;0.41;294.40;5.46;1108;10;2166.00;97
5241;10;21855053;5241;355;6353;6444;6.63;0.41;294.54;5.46;1112;10;2167.00;91
5244;10;21855068;5244;352;6358;6445;6.66;0.41;294.64;5.46;1114;10;2168.00;87
5245;10;21855082;5245;358;6362;6446;6.67;0.41;294.62;5.46;1117;10;2169.00;84
5248;10;21855096;5248;369;6366;6446;6.61;0.41;294.77;5.46;1118;10;2170.00;80
5250;10;21855111;5250;369;6371;6447;6.61;0.41;295.00;5.47;1121;10;2171.00;76
5251;10;21855125;5251;377;6373;6447;6.55;0.40;295.01;5.47;1122;10;2172.00;74
5252;10;21855139;5252;377;6375;6447;6.54;0.40;295.11;5.47;1123;10;2173.00;72
5254;10;21855155;5254;390;6378;6447;6.50;0.40;295.15;5.48;1124;10;2174.00;69
5258;10;21855171;5258;388;6383;6451;6.41;0.39;295.25;5.48;1125;10;2175.00;68
5261;10;21855193;5261;399;6384;6451;6.33;0.39;295.24;5.48;1123;10;2176.00;67
5263;10;21855210;5263;404;6386;6451;6.26;0.38;295.31;5.49;1123;10;2177.00;65
5266;10;21855232;5266;398;6387;6454;6.22;0.38;295.34;5.49;1121;10;2178.00;67
5268;10;21855247;5268;410;6389;6454;6.16;0.38;295.36;5.49;1121;10;2179.00;65
5270;10;21855262;5270;405;6390;6454;6.10;0.37;295.43;5.49;1120;10;2180.00;64
5272;10;21855283;5272;405;6394;6458;6.10;0.37;295.50;5.49;1122;10;2181.00;64
5275;10;21855298;5275;400;6397;6459;6.11;0.37;295.48;5.50;1122;10;2182.00;62
5277;10;21855320;5277;398;6398;6459;6.15;0.38;295.49;5.50;1121;10;2183.00;61
5279;10;21855334;5279;406;6402;6463;6.17;0.38;295.49;5.51;1123;10;2184.00;61
5281;10;21855349;5281;410;6404;6463;6.20;0.38;295.47;5.51;1123;10;2185.00;59
5282;10;21855365;5282;408;6407;6463;6.26;0.38;295.50;5.51;1125;10;2186.00;56
5284;10;21855380;5284;409;6408;6464;6.29;0.38;295.50;5.51;1124;10;2187.00;56
5287;10;21855396;5287;415;6409;6464;6.29;0.38;295.59;5.52;1122;10;2188.00;55
5288;10;21855410;5288;417;6413;6470;6.30;0.38;295.57;5.51;1125;10;2189.00;57
5292;10;21855427;5292;407;6414;6470;6.35;0.39;295.60;5.52;1122;10;2190.00;56
5294;10;21855442;5294;407;6415;6471;6.36;0.39;295.65;5.52;1121;10;2191.00;56
5299;10;21855457;5299;401;6415;6471;6.37;0.39;295.84;5.52;1116;10;2192.00;56
5301;10;21855472;5301;396;6416;6471;6.42;0.39;295.90;5.52;1115;10;2193.00;55
5305;10;21855486;5305;386;6416;6471;6.44;0.39;296.03;5.52;1111;10;2194.00;55
5308;10;21855499;5308;386;6416;6471;6.45;0.39;295.99;5.52;1108;10;2195.00;55
5311;10;21855513;5311;375;6425;6483;6.51;0.40;296.08;5.52;1114;10;2196.00;58
5314;10;21855527;5314;373;6427;6483;6.56;0.40;296.08;5.53;1113;10;2197.00;56
5315;10;21855540;5315;371;6428;6483;6.59;0.40;296.11;5.53;1113;10;2198.00;55
5318;10;21855553;5318;373;6429;6483;6.57;0.40;296.23;5.53;1111;10;2199.00;54
5321;10;21855567;5321;375;6431;6483;6.58;0.40;296.45;5.53;1110;10;2200.00;52
5324;10;21855584;5324;371;6432;6483;6.55;0.40;296.52;5.53;1108;10;2201.00;51
5326;10;21855598;5326;373;6435;6487;6.47;0.39;296.63;5.53;1109;10;2202.00;52
5328;10;21855611;5328;364;6435;6487;6.36;0.39;296.79;5.53;1107;10;2203.00;52
5331;10;21855623;5331;358;6439;6491;6.28;0.38;297.02;5.52;1108;10;2204.00;52
5336;10;21855637;5336;352;6443;6493;6.17;0.38;297.08;5.56;1107;10;2205.00;50
5338;10;21855657;5338;355;6443;6493;6.13;0.37;297.16;5.56;1105;10;2206.00;50
5341;10;21855670;5341;347;6443;6493;6.10;0.37;297.21;5.56;1102;10;2207.00;50
5343;10;21855683;5343;348;6452;6506;6.18;0.38;297.25;5.56;1109;10;2208.00;54
5347;10;21855697;5347;336;6452;6506;6.21;0.38;297.36;5.56;1105;10;2209.00;54
5349;10;21855709;5349;337;6454;6508;6.19;0.38;297.38;5.55;1105;10;2210.00;54
5352;10;21855722;5352;335;6455;6509;6.22;0.38;297.60;5.55;1103;10;2211.00;54
5352;10;21855734;5352;337;6455;6510;6.26;0.38;297.60;5.55;1103;10;2212.00;55
5357;10;21855747;5357;335;6455;6510;6.29;0.38;297.76;5.55;1098;10;2213.00;55
5360;10;21855760;5360;335;6457;6513;6.29;0.38;297.89;5.55;1097;10;2214.00;56
5363;10;21855772;5363;332;6458;6513;6.31;0.39;297.90;5.55;1095;10;2215.00;55
5365;10;21855786;5365;335;6458;6513;6.31;0.39;298.03;5.55;1093;10;2216.00;55
5369;10;21855798;5369;333;6459;6513;6.29;0.38;298.16;5.57;1090;10;2217.00;54
5370;10;21855818;5370;333;6464;6519;6.33;0.39;298.12;5.57;1094;10;2218.00;55
5376;10;21855832;5376;340;6464;6519;6.30;0.38;298.10;5.57;1088;10;2219.00;55
5377;10;21855852;5377;343;6464;6519;6.30;0.38;298.15;5.57;1087;10;2220.00;55
5380;10;21855878;5380;344;6464;6519;6.27;0.38;298.12;5.57;1084;10;2221.00;55
5386;10;21855896;5386;345;6468;6523;6.24;0.38;298.22;5.58;1082;10;2222.00;55
5387;10;21855913;5387;349;6469;6524;6.23;0.38;298.23;5.58;1082;10;2223.00;55
5390;10;21855928;5390;353;6470;6524;6.18;0.38;298.35;5.59;1080;10;2224.00;54
5395;10;21855944;5395;358;6471;6525;6.11;0.37;298.27;5.58;1076;10;2225.00;54
5396;10;21855956;5396;357;6472;6525;6.07;0.37;298.25;5.59;1076;10;2226.00;53
5397;10;21855969;5397;363;6472;6525;6.07;0.37;298.32;5.59;1075;10;2227.00;53
5401;10;21855982;5401;364;6473;6525;6.10;0.37;298.33;5.60;1072;10;2228.00;52
5403;10;21855995;5403;368;6474;6525;6.10;0.37;298.35;5.61;1071;10;2229.00;51
5406;10;21856008;5406;366;6476;6525;6.11;0.37;298.32;5.65;1070;10;2230.00;49
5407;10;21856021;5407;370;6477;6525;6.13;0.37;298.39;5.66;1070;10;2231.00;48
5407;10;21856034;5407;381;6510;6595;6.29;0.39;298.39;5.64;1103;10;2232.00;85
5409;10;21856052;5409;382;6515;6596;6.24;0.38;298.34;5.67;1106;10;2233.00;81
5412;10;21856065;5412;387;6523;6596;6.29;0.38;298.40;5.67;1111;10;2234.00;73
5413;10;21856077;5413;395;6525;6596;6.26;0.38;298.47;5.67;1112;10;2235.00;71
5417;10;21856089;5417;395;6532;6596;6.19;0.38;298.35;5.72;1115;10;2236.00;64
5417;10;21856102;5417;402;6535;6596;6.19;0.38;298.35;5.72;1118;10;2237.00;61
5419;10;21856114;5419;401;6540;6596;6.13;0.38;298.42;5.73;1121;10;2238.00;56
5422;10;21856127;5422;400;6542;6596;6.03;0.37;298.35;5.73;1120;10;2239.00;54
5424;10;21856139;5424;402;6549;6597;5.99;0.37;298.34;5.80;1125;10;2240.00;48
5426;10;21856152;5426;407;6551;6598;5.94;0.37;298.27;5.80;1125;10;2241.00;47
5431;10;21856164;5431;407;6554;6598;5.91;0.36;298.09;5.81;1123;10;2242.00;44
5436;10;21856177;5436;412;6559;6602;5.81;0.36;297.95;5.80;1123;10;2243.00;43
5437;10;21856189;5437;419;6563;6602;5.72;0.35;298.01;5.86;1126;10;2244.00;39
5440;10;21856201;5440;428;6564;6602;5.57;0.34;298.18;5.86;1124;10;2245.00;38
5441;10;21856213;5441;436;6564;6602;5.48;0.34;298.15;5.86;1123;10;2246.00;38
5445;10;21856225;5445;445;6569;6608;5.42;0.33;298.01;5.86;1124;10;2247.00;39
5448;10;21856237;5448;452;6569;6608;5.34;0.33;297.92;5.86;1121;10;2248.00;39
5450;10;21856249;5450;449;6572;6608;5.31;0.33;297.83;5.91;1122;10;2249.00;36
5454;10;21856262;5454;454;6578;6614;5.27;0.32;297.74;5.93;1124;10;2250.00;36
5455;10;21856275;5455;451;6579;6614;5.24;0.32;297.75;5.95;1124;10;2251.00;35
5456;10;21856286;5456;449;6581;6614;5.19;0.32;297.72;5.97;1125;10;2252.00;33
5458;10;21856298;5458;450;6583;6615;5.16;0.32;297.78;6.00;1125;10;2253.00;32
5460;10;21856310;5460;453;6584;6616;5.17;0.32;297.73;6.00;1124;10;2254.00;32
5460;10;21856322;5460;460;6586;6616;5.15;0.32;297.73;6.03;1126;10;2255.00;30
5463;10;21856333;5463;475;6595;6629;5.16;0.32;297.58;6.02;1132;10;2256.00;34
5466;10;21856346;5466;472;6595;6629;5.20;0.32;297.57;6.02;1129;10;2257.00;34
5470;10;21856357;5470;473;6598;6629;5.19;0.32;297.45;6.04;1128;10;2258.00;31
5472;10;21856369;5472;472;6600;6630;5.19;0.32;297.41;6.05;1128;10;2259.00;30
5472;10;21856381;5472;477;6600;6630;5.19;0.32;297.41;6.05;1128;10;2260.00;30
5472;10;21856392;5472;480;6606;6634;5.15;0.32;297.41;6.07;1134;10;2261.00;28
5477;10;21856404;5477;491;6606;6634;5.04;0.31;297.49;6.07;1129;10;2262.00;28
5479;10;21856422;5479;493;6611;6638;5.01;0.31;297.44;6.09;1132;10;2263.00;27
5484;10;21856434;5484;502;6611;6638;4.92;0.30;297.40;6.09;1127;10;2264.00;27
5487;10;21856445;5487;494;6611;6638;4.82;0.29;297.32;6.09;1124;10;2265.00;27
5491;10;21856457;5491;490;6612;6638;4.73;0.29;297.27;6.11;1121;10;2266.00;26
5494;10;21856468;5494;491;6612;6638;4.67;0.28;297.19;6.11;1118;10;2267.00;26
5499;10;21856480;5499;485;6622;6650;4.61;0.28;297.13;6.10;1123;10;2268.00;28
5502;10;21856493;5502;477;6622;6650;4.58;0.28;297.12;6.10;1120;10;2269.00;28
5504;10;21856504;5504;480;6623;6650;4.64;0.28;297.08;6.10;1119;10;2270.00;27
5504;10;21856516;5504;479;6623;6650;4.64;0.28;297.08;6.10;1119;10;2271.00;27
5506;10;21856534;5506;477;6623;6650;4.62;0.28;297.08;6.10;1117;10;2272.00;27
5508;10;21856545;5508;478;6623;6650;4.60;0.28;297.05;6.10;1115;10;2273.00;27
5510;10;21856556;5510;482;6623;6651;4.55;0.28;297.04;6.10;1113;10;2274.00;28
5512;10;21856567;5512;468;6623;6651;4.56;0.28;297.03;6.10;1111;10;2275.00;28
5512;10;21856579;5512;456;6627;6657;4.63;0.28;297.03;6.09;1115;10;2276.00;30
5514;10;21856590;5514;450;6628;6658;4.63;0.28;296.99;6.09;1114;10;2277.00;30
5517;10;21856601;5517;445;6628;6658;4.70;0.29;296.95;6.09;1111;10;2278.00;30
5519;10;21856613;5519;452;6628;6658;4.75;0.29;296.97;6.09;1109;10;2279.00;30
5521;10;21856632;5521;442;6632;6663;4.82;0.29;297.03;6.09;1111;10;2280.00;31
5522;10;21856644;5522;420;6632;6663;4.92;0.30;297.05;6.09;1110;10;2281.00;31
5524;10;21856655;5524;409;6632;6663;4.98;0.30;297.04;6.09;1108;10;2282.00;31
5527;10;21856667;5527;400;6633;6664;5.01;0.31;297.01;6.09;1106;10;2283.00;31
5528;10;21856680;5528;388;6636;6668;5.03;0.31;297.03;6.09;1108;10;2284.00;32
5532;10;21856692;5532;380;6636;6668;5.08;0.31;297.00;6.09;1104;10;2285.00;32
5534;10;21856703;5534;381;6638;6671;5.16;0.31;297.06;6.08;1104;10;2286.00;33
5538;10;21856716;5538;375;6638;6671;5.22;0.32;297.18;6.08;1100;10;2287.00;33
5543;10;21856728;5543;371;6638;6671;5.25;0.32;297.23;6.08;1095;10;2288.00;33
5547;10;21856740;5547;364;6638;6671;5.31;0.32;297.31;6.08;1091;10;2289.00;33
5550;10;21856753;5550;366;6641;6675;5.40;0.33;297.23;6.08;1091;10;2290.00;34
5553;10;21856766;5553;360;6641;6675;5.47;0.33;297.25;6.08;1088;10;2291.00;34
5557;10;21856778;5557;357;6641;6675;5.46;0.33;297.32;6.08;1084;10;2292.00;34
5562;10;21856790;5562;350;6641;6675;5.49;0.33;297.39;6.08;1079;10;2293.00;34
5567;10;21856802;5567;348;6641;6676;5.45;0.33;297.46;6.08;1074;10;2294.00;35
5568;10;21856815;5568;352;6643;6678;5.49;0.34;297.41;6.08;1075;10;2295.00;35
5574;10;21856829;5574;355;6644;6678;5.45;0.33;297.48;6.08;1070;10;2296.00;34
5580;10;21856844;5580;358;6645;6679;5.46;0.33;297.58;6.08;1065;10;2297.00;34
5582;10;21856856;5582;359;6645;6679;5.51;0.34;297.68;6.08;1063;10;2298.00;34
5585;10;21856869;5585;356;6646;6679;5.54;0.34;297.71;6.08;1061;10;2299.00;33
5590;10;21856881;5590;361;6646;6679;5.53;0.34;297.89;6.08;1056;10;2300.00;33
5595;10;21856898;5595;359;6646;6679;5.50;0.33;297.87;6.08;1051;10;2301.00;33
5598;10;21856911;5598;368;6647;6679;5.55;0.34;297.86;6.08;1049;10;2302.00;32
5601;10;21856922;5601;368;6647;6679;5.54;0.34;298.01;6.08;1046;10;2303.00;32
5603;10;21856935;5603;388;6722;6806;5.82;0.36;297.96;6.02;1119;10;2304.00;84
5607;10;21856958;5607;382;6726;6807;5.84;0.36;298.06;6.01;1119;10;2305.00;81
5609;10;21856971;5609;379;6731;6807;5.89;0.36;298.22;6.01;1122;10;2306.00;76
5610;10;21856985;5610;378;6735;6807;5.95;0.37;298.24;6.01;1125;10;2307.00;72
5612;10;21856998;5612;375;6738;6807;6.06;0.37;298.38;6.01;1126;10;2308.00;69
5618;10;21857012;5618;372;6741;6807;6.06;0.37;298.49;6.01;1123;10;2309.00;66
5620;10;21857028;5620;373;6743;6807;6.06;0.37;298.59;6.01;1123;10;2310.00;64
5622;10;21857041;5622;370;6745;6807;6.06;0.37;298.64;6.01;1123;10;2311.00;62
5624;10;21857054;5624;377;6746;6808;6.07;0.37;298.66;6.01;1122;10;2312.00;62
5628;10;21857068;5628;375;6749;6809;6.02;0.37;298.66;6.01;1121;10;2313.00;60
5632;10;21857082;5632;378;6749;6809;5.98;0.37;298.80;6.01;1117;10;2314.00;60
5635;10;21857095;5635;380;6752;6810;5.92;0.36;298.81;6.01;1117;10;2315.00;58
5638;10;21857108;5638;388;6753;6810;5.89;0.36;298.91;6.01;1115;10;2316.00;57
5640;10;21857121;5640;393;6755;6810;5.89;0.36;299.04;6.01;1115;10;2317.00;55
5641;10;21857135;5641;392;6757;6810;5.91;0.36;299.02;6.02;1116;10;2318.00;53
5642;10;21857148;5642;401;6760;6814;5.96;0.36;299.13;6.02;1118;10;2319.00;54
5644;10;21857162;5644;404;6762;6814;5.96;0.36;299.22;6.02;1118;10;2320.00;52
5646;10;21857175;5646;412;6764;6814;5.97;0.36;299.28;6.02;1118;10;2321.00;50
5648;10;21857188;5648;397;6765;6817;5.99;0.36;299.38;6.02;1117;10;2322.00;52
5650;10;21857202;5650;395;6766;6817;5.98;0.36;299.48;6.03;1116;10;2323.00;51
5651;10;21857216;5651;393;6768;6817;6.03;0.37;299.48;6.03;1117;10;2324.00;49
5654;10;21857230;5654;387;6772;6821;6.09;0.37;299.47;6.03;1118;10;2325.00;49
5657;10;21857244;5657;385;6774;6822;6.12;0.37;299.62;6.03;1117;10;2326.00;48
5657;10;21857259;5657;387;6774;6822;6.17;0.38;299.62;6.03;1117;10;2327.00;48
5659;10;21857272;5659;386;6776;6826;6.17;0.38;299.67;6.03;1117;10;2328.00;50
5663;10;21857287;5663;388;6777;6826;6.15;0.38;299.71;6.03;1114;10;2329.00;49
5664;10;21857306;5664;392;6777;6826;6.18;0.38;299.71;6.03;1113;10;2330.00;49
5667;10;21857319;5667;388;6778;6827;6.19;0.38;299.71;6.03;1111;10;2331.00;49
5668;10;21857334;5668;388;6781;6827;6.22;0.38;299.74;6.03;1113;10;2332.00;46
5671;10;21857348;5671;388;6786;6833;6.20;0.38;299.91;6.03;1115;10;2333.00;47
5676;10;21857362;5676;388;6786;6833;6.14;0.37;300.07;6.03;1110;10;2334.00;47
5677;10;21857376;5677;381;6786;6834;6.13;0.37;300.10;6.03;1109;10;2335.00;48
5679;10;21857390;5679;379;6786;6834;6.15;0.37;300.13;6.03;1107;10;2336.00;48
5682;10;21857403;5682;373;6787;6834;6.13;0.37;300.29;6.03;1105;10;2337.00;47
5687;10;21857417;5687;388;6787;6834;6.10;0.37;300.23;6.03;1100;10;2338.00;47
5690;10;21857430;5690;391;6788;6834;6.14;0.37;300.34;6.03;1098;10;2339.00;46
5695;10;21857446;5695;401;6813;6870;6.12;0.37;300.52;6.01;1118;10;2340.00;57
5695;10;21857463;5695;397;6816;6870;6.13;0.37;300.52;6.01;1121;10;2341.00;54
5698;10;21857477;5698;392;6819;6870;6.15;0.38;300.58;6.01;1121;10;2342.00;51
5701;10;21857491;5701;388;6819;6870;6.16;0.38;300.69;6.01;1118;10;2343.00;51
5703;10;21857505;5703;393;6821;6870;6.18;0.38;300.78;6.01;1118;10;2344.00;49
5706;10;21857519;5706;393;6822;6870;6.17;0.38;300.84;6.01;1116;10;2345.00;48
5707;10;21857533;5707;394;6825;6874;6.15;0.37;300.85;6.00;1118;10;2346.00;49
5709;10;21857547;5709;399;6825;6874;6.14;0.37;300.88;6.00;1116;10;2347.00;49
5713;10;21857560;5713;395;6829;6878;6.15;0.37;300.96;6.00;1116;10;2348.00;49
5716;10;21857573;5716;396;6830;6879;6.15;0.37;301.14;6.00;1114;10;2349.00;49
5719;10;21857587;5719;398;6830;6879;6.16;0.37;301.13;6.00;1111;10;2350.00;49
5723;10;21857600;5723;397;6830;6879;6.17;0.37;301.15;6.00;1107;10;2351.00;49
5727;10;21857614;5727;404;6841;6892;6.27;0.38;301.21;5.99;1114;10;2352.00;51
5731;10;21857628;5731;408;6841;6892;6.33;0.38;301.37;5.99;1110;10;2353.00;51
5735;10;21857642;5735;410;6841;6892;6.34;0.39;301.45;5.99;1106;10;2354.00;51
5737;10;21857656;5737;411;6842;6893;6.40;0.39;301.46;5.99;1105;10;2355.00;51
5741;10;21857669;5741;415;6842;6894;6.35;0.39;301.65;5.99;1101;10;2356.00;52
5742;10;21857683;5742;411;6842;6894;6.30;0.38;301.64;5.99;1100;10;2357.00;52
5745;10;21857696;5745;417;6844;6897;6.24;0.38;301.59;5.99;1099;10;2358.00;53
5746;10;21857710;5746;425;6844;6897;6.18;0.38;301.64;5.99;1098;10;2359.00;53
5748;10;21857723;5748;430;6845;6897;6.10;0.37;301.65;5.99;1097;10;2360.00;52
5749;10;21857737;5749;428;6845;6897;5.93;0.36;301.70;5.99;1096;10;2361.00;52
5752;10;21857750;5752;426;6850;6903;5.83;0.35;301.74;5.98;1098;10;2362.00;53
5752;10;21857765;5752;432;6850;6903;5.69;0.35;301.74;5.98;1098;10;2363.00;53
5753;10;21857778;5753;435;6850;6903;5.62;0.34;301.77;5.98;1097;10;2364.00;53
5753;10;21857790;5753;435;6850;6903;5.60;0.34;301.77;5.98;1097;10;2365.00;53
5755;10;21857803;5755;432;6853;6907;5.52;0.34;301.74;5.98;1098;10;2366.00;54
5755;10;21857817;5755;431;6854;6908;5.49;0.33;301.74;5.98;1099;10;2367.00;54
5756;10;21857830;5756;425;6854;6908;5.48;0.33;301.70;5.98;1098;10;2368.00;54
5757;10;21857847;5757;427;6855;6909;5.53;0.34;301.68;5.98;1098;10;2369.00;54
5760;10;21857866;5760;427;6855;6909;5.49;0.33;301.78;5.98;1095;10;2370.00;54
5763;10;21857882;5763;427;6855;6909;5.52;0.34;301.86;5.98;1092;10;2371.00;54
5766;10;21857898;5766;428;6855;6909;5.48;0.33;301.89;5.98;1089;10;2372.00;54
5769;10;21857914;5769;430;6855;6909;5.49;0.33;302.00;5.98;1086;10;2373.00;54
5769;10;21857930;5769;430;6855;6909;5.49;0.33;302.00;5.98;1086;10;2374.00;54
5772;10;21857946;5772;431;6855;6909;5.44;0.33;302.04;5.98;1083;10;2375.00;54
5775;10;21857958;5775;444;6895;6979;5.46;0.33;302.11;5.95;1120;10;2376.00;84
5778;10;21857977;5778;433;6895;6980;5.45;0.33;302.21;5.95;1117;10;2377.00;85
5781;10;21857989;5781;429;6900;6980;5.47;0.33;302.36;5.94;1119;10;2378.00;80
5783;10;21858003;5783;418;6902;6980;5.47;0.33;302.35;5.94;1119;10;2379.00;78
5785;10;21858017;5785;425;6905;6980;5.47;0.33;302.38;5.97;1120;10;2380.00;75
5787;10;21858031;5787;419;6907;6980;5.48;0.33;302.40;5.97;1120;10;2381.00;73
5790;10;21858050;5790;411;6909;6980;5.49;0.33;302.43;5.97;1119;10;2382.00;71
5792;10;21858063;5792;410;6914;6980;5.50;0.33;302.43;5.97;1122;10;2383.00;66
5795;10;21858075;5795;411;6916;6981;5.48;0.33;302.48;5.97;1121;10;2384.00;65
5796;10;21858087;5796;404;6918;6983;5.49;0.33;302.48;5.97;1122;10;2385.00;65
5798;10;21858101;5798;402;6921;6983;5.45;0.33;302.55;5.97;1123;10;2386.00;62
5799;10;21858113;5799;404;6925;6987;5.42;0.33;302.58;5.97;1126;10;2387.00;62
5800;10;21858126;5800;412;6926;6987;5.40;0.33;302.55;5.97;1126;10;2388.00;61
5802;10;21858138;5802;404;6926;6987;5.35;0.33;302.48;5.97;1124;10;2389.00;61
5804;10;21858150;5804;410;6926;6987;5.32;0.32;302.48;5.97;1122;10;2390.00;61
5806;10;21858163;5806;409;6930;6993;5.32;0.32;302.49;5.97;1124;10;2391.00;63
5809;10;21858175;5809;406;6930;6993;5.33;0.33;302.45;5.97;1121;10;2392.00;63
5809;10;21858187;5809;409;6930;6993;5.34;0.33;302.45;5.97;1121;10;2393.00;63
5811;10;21858201;5811;409;6932;6996;5.36;0.33;302.41;5.97;1121;10;2394.00;64
5816;10;21858214;5816;410;6934;6996;5.31;0.32;302.36;6.00;1118;10;2395.00;62
5819;10;21858226;5819;417;6934;6996;5.27;0.32;302.30;6.00;1115;10;2396.00;62
5820;10;21858239;5820;423;6934;6997;5.24;0.32;302.28;6.00;1114;10;2397.00;63
5821;10;21858251;5821;432;6935;6998;5.17;0.31;302.31;6.00;1114;10;2398.00;63
5823;10;21858264;5823;427;6936;6998;5.12;0.31;302.23;6.03;1113;10;2399.00;62
5824;10;21858279;5824;437;6959;7057;5.10;0.31;302.21;6.01;1135;10;2400.00;98
5826;10;21858301;5826;433;6963;7057;5.07;0.31;302.27;6.05;1137;10;2401.00;94
5828;10;21858315;5828;434;6967;7057;5.07;0.31;302.31;6.05;1139;10;2402.00;90
5828;10;21858327;5828;434;6970;7058;5.10;0.31;302.31;6.05;1142;10;2403.00;88
5829;10;21858339;5829;442;6972;7058;5.08;0.31;302.26;6.05;1143;10;2404.00;86
5829;10;21858352;5829;446;6977;7062;5.09;0.31;302.26;6.08;1148;10;2405.00;85
5833;10;21858365;5833;456;6982;7062;5.08;0.31;302.16;6.11;1149;10;2406.00;80
5834;10;21858379;5834;459;6985;7066;5.11;0.31;302.11;6.11;1151;10;2407.00;81
5834;10;21858392;5834;460;6987;7066;5.13;0.31;302.11;6.17;1153;10;2408.00;79
5837;10;21858405;5837;465;6987;7066;5.09;0.31;302.02;6.17;1150;10;2409.00;79
5839;10;21858418;5839;477;6989;7066;5.03;0.31;301.96;6.23;1150;10;2410.00;77
5840;10;21858430;5840;481;6991;7066;4.97;0.30;301.94;6.24;1151;10;2411.00;75
5841;10;21858443;5841;490;7003;7078;4.93;0.30;301.97;6.27;1162;10;2412.00;75
5843;10;21858456;5843;498;7003;7078;4.88;0.30;301.88;6.27;1160;10;2413.00;75
5844;10;21858474;5844;498;7006;7078;4.86;0.30;301.87;6.32;1162;10;2414.00;72
5847;10;21858487;5847;502;7006;7078;4.79;0.29;301.85;6.32;1159;10;2415.00;72
5849;10;21858500;5849;507;7008;7078;4.76;0.29;301.86;6.36;1159;10;2416.00;70
5849;10;21858513;5849;510;7010;7078;4.73;0.29;301.86;6.37;1161;10;2417.00;68
5851;10;21858525;5851;502;7014;7079;4.65;0.28;301.88;6.43;1163;10;2418.00;65
5852;10;21858537;5852;506;7014;7079;4.59;0.28;301.87;6.43;1162;10;2419.00;65
5853;10;21858549;5853;508;7020;7085;4.58;0.28;301.86;6.48;1167;10;2420.00;65
5855;10;21858562;5855;499;7021;7086;4.54;0.28;301.79;6.48;1166;10;2421.00;65
5856;10;21858573;5856;498;7023;7086;4.55;0.28;301.77;6.54;1167;10;2422.00;63
5859;10;21858585;5859;494;7028;7086;4.53;0.28;301.68;6.55;1169;10;2423.00;58
5859;10;21858598;5859;474;7029;7090;4.60;0.28;301.68;6.55;1170;10;2424.00;61
5860;10;21858610;5860;465;7032;7090;4.60;0.28;301.64;6.60;1172;10;2425.00;58
5860;10;21858623;5860;461;7033;7090;4.62;0.28;301.64;6.60;1173;10;2426.00;57
5862;10;21858635;5862;448;7037;7091;4.65;0.29;301.60;6.65;1175;10;2427.00;54
5864;10;21858648;5864;440;7040;7095;4.75;0.29;301.53;6.65;1176;10;2428.00;55
5865;10;21858661;5865;440;7043;7095;4.83;0.30;301.50;6.65;1178;10;2429.00;52
5865;10;21858683;5865;435;7051;7101;4.91;0.30;301.50;6.69;1186;10;2430.00;50
5866;10;21858696;5866;436;7051;7101;4.96;0.30;301.47;6.69;1185;10;2431.00;50
5868;10;21858708;5868;431;7051;7101;4.98;0.30;301.44;6.69;1183;10;2432.00;50
5869;10;21858720;5869;435;7053;7101;5.02;0.31;301.41;6.74;1184;10;2433.00;48
5870;10;21858733;5870;433;7057;7105;5.09;0.31;301.40;6.74;1187;10;2434.00;48
5871;10;21858746;5871;445;7058;7105;5.09;0.31;301.39;6.74;1187;10;2435.00;47
5873;10;21858764;5873;445;7060;7105;5.08;0.31;301.38;6.78;1187;10;2436.00;45
5873;10;21858776;5873;445;7060;7105;5.11;0.31;301.38;6.78;1187;10;2437.00;45
5875;10;21858789;5875;453;7060;7106;5.15;0.31;301.37;6.78;1185;10;2438.00;46
5877;10;21858803;5877;458;7063;7107;5.20;0.32;301.40;6.82;1186;10;2439.00;44
5879;10;21858815;5879;460;7064;7107;5.21;0.32;301.36;6.83;1185;10;2440.00;43
5882;10;21858828;5882;465;7067;7108;5.22;0.32;301.31;6.86;1185;10;2441.00;41
5886;10;21858840;5886;466;7067;7108;5.16;0.31;301.32;6.86;1181;10;2442.00;41
5889;10;21858852;5889;474;7068;7108;5.17;0.31;301.27;6.88;1179;10;2443.00;40
5890;10;21858864;5890;466;7069;7108;5.16;0.31;301.25;6.90;1179;10;2444.00;39
5893;10;21858875;5893;477;7071;7108;5.07;0.31;301.20;6.92;1178;10;2445.00;37
5898;10;21858887;5898;474;7072;7108;5.02;0.31;301.27;6.94;1174;10;2446.00;36
5902;10;21858899;5902;471;7073;7108;4.92;0.30;301.24;6.96;1171;10;2447.00;35
5905;10;21858910;5905;505;7156;7235;5.00;0.31;301.40;6.87;1251;10;2448.00;79
5910;10;21858932;5910;491;7160;7236;4.97;0.31;301.53;6.89;1250;10;2449.00;76
5914;10;21858946;5914;475;7166;7236;5.01;0.31;301.69;6.89;1252;10;2450.00;70
5916;10;21858960;5916;470;7168;7236;4.98;0.31;301.74;6.89;1252;10;2451.00;68
5920;10;21858972;5920;456;7172;7236;4.99;0.31;301.93;6.89;1252;10;2452.00;64
5924;10;21858986;5924;450;7172;7236;4.95;0.31;301.93;6.89;1248;10;2453.00;64
5928;10;21858999;5928;447;7174;7236;4.92;0.31;302.01;6.89;1246;10;2454.00;62
5929;10;21859013;5929;444;7175;7236;4.95;0.31;302.00;6.89;1246;10;2455.00;61
5933;10;21859027;5933;450;7178;7237;4.92;0.30;302.17;6.90;1245;10;2456.00;59
5935;10;21859040;5935;452;7178;7238;4.96;0.31;302.16;6.90;1243;10;2457.00;60
5936;10;21859053;5936;449;7179;7238;5.02;0.31;302.18;6.90;1243;10;2458.00;59
5941;10;21859066;5941;448;7180;7239;5.02;0.31;302.45;6.90;1239;10;2459.00;59
5941;10;21859082;5941;445;7181;7239;5.10;0.32;302.45;6.90;1240;10;2460.00;58
5944;10;21859095;5944;449;7182;7239;5.18;0.32;302.48;6.90;1238;10;2461.00;57
5948;10;21859109;5948;440;7186;7239;5.17;0.32;302.69;6.91;1238;10;2462.00;53
5952;10;21859121;5952;435;7189;7243;5.18;0.32;302.84;6.91;1237;10;2463.00;54
5958;10;21859136;5958;430;7189;7243;5.22;0.32;302.95;6.91;1231;10;2464.00;54
5960;10;21859150;5960;429;7189;7243;5.26;0.32;302.94;6.91;1229;10;2465.00;54
5963;10;21859163;5963;429;7190;7246;5.28;0.33;303.09;6.91;1227;10;2466.00;56
5968;10;21859178;5968;425;7190;7246;5.28;0.33;303.20;6.91;1222;10;2467.00;56
5971;10;21859192;5971;421;7192;7246;5.31;0.33;303.27;6.93;1221;10;2468.00;54
5974;10;21859206;5974;418;7195;7250;5.36;0.33;303.41;6.93;1221;10;2469.00;55
5979;10;21859220;5979;415;7196;7251;5.44;0.34;303.59;6.93;1217;10;2470.00;55
5984;10;21859234;5984;414;7198;7251;5.46;0.34;303.76;6.93;1214;10;2471.00;53
5987;10;21859248;5987;414;7199;7255;5.52;0.34;303.74;6.93;1212;10;2472.00;56
5992;10;21859263;5992;409;7199;7255;5.54;0.34;303.80;6.93;1207;10;2473.00;56
6001;10;21859278;6001;410;7200;7255;5.52;0.34;303.99;6.93;1199;10;2474.00;55
6002;10;21859292;6002;411;7202;7257;5.52;0.34;304.07;6.94;1200;10;2475.00;55
6007;10;21859306;6007;412;7202;7257;5.55;0.34;304.15;6.94;1195;10;2476.00;55
6011;10;21859319;6011;407;7207;7263;5.60;0.34;304.24;6.94;1196;10;2477.00;56
6014;10;21859334;6014;408;7207;7263;5.64;0.35;304.22;6.94;1193;10;2478.00;56
6020;10;21859348;6020;401;7209;7264;5.66;0.35;304.35;6.94;1189;10;2479.00;55
6026;10;21859362;6026;404;7209;7264;5.67;0.35;304.54;6.94;1183;10;2480.00;55
6028;10;21859376;6028;398;7210;7264;5.73;0.35;304.48;6.94;1182;10;2481.00;54
6033;10;21859389;6033;394;7211;7264;5.76;0.35;304.61;6.94;1178;10;2482.00;53
6039;10;21859404;6039;396;7211;7264;5.76;0.35;304.61;6.94;1172;10;2483.00;53
6044;10;21859419;6044;393;7218;7276;5.79;0.35;304.67;6.94;1174;10;2484.00;58
6048;10;21859435;6048;396;7218;7276;5.86;0.36;304.72;6.94;1170;10;2485.00;58
6052;10;21859449;6052;398;7219;7276;5.91;0.36;304.77;6.94;1167;10;2486.00;57
6056;10;21859463;6056;398;7220;7276;5.96;0.36;304.84;6.94;1164;10;2487.00;56
6058;10;21859477;6058;404;7220;7276;5.99;0.37;304.92;6.94;1162;10;2488.00;56
6065;10;21859491;6065;407;7222;7276;5.94;0.36;305.14;6.94;1157;10;2489.00;54
6067;10;21859507;6067;406;7226;7280;5.94;0.36;305.16;6.95;1159;10;2490.00;54
6072;10;21859521;6072;410;7226;7280;5.89;0.36;305.21;6.95;1154;10;2491.00;54
6076;10;21859535;6076;414;7229;7284;5.85;0.36;305.28;6.94;1153;10;2492.00;55
6078;10;21859550;6078;416;7231;7285;5.85;0.36;305.42;6.95;1153;10;2493.00;54
6084;10;21859564;6084;421;7233;7285;5.80;0.35;305.50;6.95;1149;10;2494.00;52
6087;10;21859577;6087;422;7233;7285;5.78;0.35;305.63;6.95;1146;10;2495.00;52
6091;10;21859590;6091;431;7243;7298;5.83;0.36;305.75;6.95;1152;10;2496.00;55
6092;10;21859606;6092;422;7245;7298;5.83;0.36;305.78;6.95;1153;10;2497.00;53
6095;10;21859620;6095;424;7247;7298;5.80;0.35;305.79;6.96;1152;10;2498.00;51
6098;10;21859634;6098;417;7247;7299;5.79;0.35;305.80;6.96;1149;10;2499.00;52
6101;10;21859649;6101;416;7248;7300;5.78;0.35;305.76;6.96;1147;10;2500.00;52
6104;10;21859667;6104;419;7248;7300;5.75;0.35;305.88;6.96;1144;10;2501.00;52
6106;10;21859682;6106;420;7251;7303;5.76;0.35;305.98;6.96;1145;10;2502.00;52
6107;10;21859696;6107;428;7251;7303;5.74;0.35;305.97;6.96;1144;10;2503.00;52
6110;10;21859709;6110;428;7254;7303;5.75;0.35;306.02;6.96;1144;10;2504.00;49
6112;10;21859723;6112;436;7254;7303;5.74;0.35;306.03;6.96;1142;10;2505.00;49
6116;10;21859737;6116;431;7259;7309;5.70;0.35;306.02;6.95;1143;10;2506.00;50
6120;10;21859758;6120;423;7259;7309;5.68;0.35;306.07;6.95;1139;10;2507.00;50
6121;10;21859784;6121;426;7260;7309;5.68;0.35;306.04;6.95;1139;10;2508.00;49
6122;10;21859799;6122;419;7261;7309;5.67;0.35;306.10;6.95;1139;10;2509.00;48
6123;10;21859820;6123;423;7263;7313;5.72;0.35;306.08;6.95;1140;10;2510.00;50
6128;10;21859834;6128;419;7264;7314;5.73;0.35;306.13;6.95;1136;10;2511.00;50
6131;10;21859854;6131;419;7264;7314;5.70;0.35;306.22;6.95;1133;10;2512.00;50
6135;10;21859873;6135;423;7265;7315;5.66;0.35;306.33;6.95;1130;10;2513.00;50
6140;10;21859893;6140;430;7265;7315;5.64;0.34;306.48;6.95;1125;10;2514.00;50
6141;10;21859910;6141;434;7265;7315;5.63;0.34;306.44;6.95;1124;10;2515.00;50
6144;10;21859927;6144;442;7265;7315;5.65;0.35;306.47;6.95;1121;10;2516.00;50
6146;10;21859943;6146;444;7265;7315;5.63;0.34;306.54;6.95;1119;10;2517.00;50
6148;10;21859958;6148;445;7265;7315;5.63;0.34;306.66;6.95;1117;10;2518.00;50
6152;10;21859972;6152;449;7265;7315;5.63;0.34;306.84;6.95;1113;10;2519.00;50
6156;10;21859991;6156;480;7331;7440;5.65;0.35;306.95;6.89;1175;10;2520.00;109
6156;10;21860021;6156;462;7334;7441;5.70;0.35;306.95;6.89;1178;10;2521.00;107
6158;10;21860035;6158;447;7341;7441;5.80;0.36;307.01;6.88;1183;10;2522.00;100
6160;10;21860049;6160;446;7345;7441;5.82;0.36;307.09;6.88;1185;10;2523.00;96
6163;10;21860063;6163;443;7348;7441;5.83;0.36;307.13;6.88;1185;10;2524.00;93
6164;10;21860077;6164;432;7349;7441;5.82;0.36;307.24;6.88;1185;10;2525.00;92
6168;10;21860090;6168;434;7354;7441;5.84;0.36;307.32;6.88;1186;10;2526.00;87
6171;10;21860104;6171;438;7356;7441;5.79;0.36;307.36;6.88;1185;10;2527.00;85
6173;10;21860117;6173;450;7362;7442;5.73;0.35;307.38;6.88;1189;10;2528.00;80
6176;10;21860130;6176;455;7367;7443;5.69;0.35;307.48;6.88;1191;10;2529.00;76
6179;10;21860144;6179;459;7369;7443;5.61;0.35;307.57;6.88;1190;10;2530.00;74
6182;10;21860157;6182;463;7376;7447;5.52;0.34;307.71;6.88;1194;10;2531.00;71
6188;10;21860170;6188;471;7377;7447;5.45;0.33;307.81;6.88;1189;10;2532.00;70
6191;10;21860184;6191;473;7379;7447;5.43;0.33;307.98;6.88;1188;10;2533.00;68
6195;10;21860197;6195;476;7383;7447;5.38;0.33;308.11;6.89;1188;10;2534.00;64
6199;10;21860210;6199;478;7388;7453;5.33;0.33;308.26;6.88;1189;10;2535.00;65
6200;10;21860224;6200;494;7388;7453;5.36;0.33;308.38;6.88;1188;10;2536.00;65
6202;10;21860237;6202;488;7390;7455;5.32;0.33;308.44;6.88;1188;10;2537.00;65
6203;10;21860250;6203;493;7392;7458;5.32;0.33;308.48;6.88;1189;10;2538.00;66
6204;10;21860263;6204;495;7394;7458;5.31;0.32;308.43;6.88;1190;10;2539.00;64
6206;10;21860276;6206;495;7395;7458;5.23;0.32;308.44;6.88;1189;10;2540.00;63
6208;10;21860289;6208;489;7396;7459;5.17;0.32;308.45;6.88;1188;10;2541.00;63
6209;10;21860302;6209;490;7397;7460;5.16;0.31;308.51;6.88;1188;10;2542.00;63
6210;10;21860315;6210;489;7397;7460;5.14;0.31;308.54;6.88;1187;10;2543.00;63
6215;10;21860328;6215;492;7407;7473;5.09;0.31;308.58;6.87;1192;10;2544.00;66
6218;10;21860342;6218;480;7407;7473;5.14;0.31;308.63;6.87;1189;10;2545.00;66
6220;10;21860355;6220;479;7407;7473;5.20;0.32;308.63;6.87;1187;10;2546.00;66
6222;10;21860368;6222;476;7408;7474;5.25;0.32;308.65;6.87;1186;10;2547.00;66
6226;10;21860382;6226;474;7408;7474;5.29;0.32;308.60;6.87;1182;10;2548.00;66
6228;10;21860395;6228;472;7411;7478;5.33;0.33;308.68;6.87;1183;10;2549.00;67
6228;10;21860409;6228;477;7413;7481;5.35;0.33;308.68;6.87;1185;10;2550.00;68
6229;10;21860422;6229;477;7417;7485;5.31;0.32;308.68;6.87;1188;10;2551.00;68
6230;10;21860436;6230;478;7417;7485;5.24;0.32;308.66;6.87;1187;10;2552.00;68
6231;10;21860448;6231;483;7417;7485;5.21;0.32;308.63;6.87;1186;10;2553.00;68
6234;10;21860460;6234;485;7417;7485;5.12;0.31;308.74;6.87;1183;10;2554.00;68
6238;10;21860472;6238;484;7419;7485;5.02;0.31;308.75;6.93;1181;10;2555.00;66
6240;10;21860487;6240;486;7429;7497;4.98;0.31;308.73;6.92;1189;10;2556.00;68
6241;10;21860500;6241;482;7430;7497;4.95;0.30;308.75;6.92;1189;10;2557.00;67
6245;10;21860512;6245;481;7431;7497;4.88;0.30;308.65;6.92;1186;10;2558.00;66
6248;10;21860525;6248;471;7431;7497;4.82;0.30;308.66;6.92;1183;10;2559.00;66
6249;10;21860538;6249;475;7431;7497;4.81;0.29;308.63;6.92;1182;10;2560.00;66
6252;10;21860550;6252;472;7431;7497;4.82;0.29;308.72;6.92;1179;10;2561.00;66
6254;10;21860563;6254;469;7431;7498;4.80;0.29;308.74;6.92;1177;10;2562.00;67
6256;10;21860575;6256;468;7431;7498;4.80;0.29;308.73;6.92;1175;10;2563.00;67
6258;10;21860587;6258;466;7435;7504;4.85;0.30;308.72;6.92;1177;10;2564.00;69
6260;10;21860600;6260;461;7437;7506;4.85;0.30;308.70;6.91;1177;10;2565.00;69
6262;10;21860613;6262;458;7437;7506;4.87;0.30;308.62;6.91;1175;10;2566.00;69
6267;10;21860625;6267;466;7437;7506;4.84;0.29;308.52;6.91;1170;10;2567.00;69
6267;10;21860638;6267;466;7439;7510;4.84;0.29;308.52;6.91;1172;10;2568.00;71
6270;10;21860651;6270;472;7439;7510;4.80;0.29;308.45;6.91;1169;10;2569.00;71
6272;10;21860663;6272;465;7439;7510;4.80;0.29;308.46;6.91;1167;10;2570.00;71
6272;10;21860676;6272;468;7440;7511;4.81;0.29;308.46;6.91;1168;10;2571.00;71
6273;10;21860688;6273;470;7443;7515;4.83;0.29;308.42;6.91;1170;10;2572.00;72
6274;10;21860700;6274;480;7446;7515;4.86;0.30;308.38;6.92;1172;10;2573.00;69
6276;10;21860712;6276;475;7448;7518;4.88;0.30;308.32;6.92;1172;10;2574.00;70
6278;10;21860725;6278;476;7449;7518;4.89;0.30;308.23;6.92;1171;10;2575.00;69
6280;10;21860737;6280;483;7450;7518;4.90;0.30;308.22;6.92;1170;10;2576.00;68
6281;10;21860750;6281;488;7451;7518;4.87;0.30;308.21;6.93;1170;10;2577.00;67
6283;10;21860762;6283;489;7455;7522;4.89;0.30;308.27;6.92;1172;10;2578.00;67
6284;10;21860775;6284;479;7456;7522;4.91;0.30;308.29;6.92;1172;10;2579.00;66
6284;10;21860790;6284;472;7458;7522;4.89;0.30;308.29;6.99;1174;10;2580.00;64
6284;10;21860802;6284;472;7458;7522;4.91;0.30;308.29;6.99;1174;10;2581.00;64
6285;10;21860816;6285;469;7458;7523;4.89;0.30;308.27;6.99;1173;10;2582.00;65
6286;10;21860828;6286;462;7459;7524;4.89;0.30;308.31;6.99;1173;10;2583.00;65
6287;10;21860842;6287;460;7460;7524;4.88;0.30;308.27;7.02;1173;10;2584.00;64
6290;10;21860854;6290;450;7461;7525;4.91;0.30;308.19;7.02;1171;10;2585.00;64
6290;10;21860868;6290;445;7462;7525;4.95;0.30;308.19;7.05;1172;10;2586.00;63
6291;10;21860880;6291;440;7462;7525;4.97;0.30;308.29;7.05;1171;10;2587.00;63
6292;10;21860893;6292;447;7464;7525;5.00;0.31;308.25;7.11;1172;10;2588.00;61
6294;10;21860906;6294;435;7464;7525;5.06;0.31;308.23;7.11;1170;10;2589.00;61
6295;10;21860919;6295;427;7466;7525;5.11;0.31;308.20;7.17;1171;10;2590.00;59
6298;10;21860932;6298;426;7467;7525;5.13;0.31;308.09;7.20;1169;10;2591.00;58
6298;10;21860945;6298;439;7539;7652;5.46;0.34;308.09;7.17;1241;10;2592.00;113
6299;10;21860969;6299;436;7542;7653;5.46;0.34;308.10;7.16;1243;10;2593.00;111
6300;10;21860984;6300;435;7550;7653;5.52;0.34;308.12;7.22;1250;10;2594.00;103
6303;10;21860997;6303;427;7554;7653;5.52;0.34;308.09;7.21;1251;10;2595.00;99
6304;10;21861011;6304;436;7560;7653;5.60;0.35;308.08;7.21;1256;10;2596.00;93
6304;10;21861024;6304;431;7562;7653;5.57;0.35;308.08;7.27;1258;10;2597.00;91
6306;10;21861037;6306;433;7565;7653;5.52;0.34;308.02;7.27;1259;10;2598.00;88
6307;10;21861050;6307;434;7570;7653;5.59;0.35;307.99;7.32;1263;10;2599.00;83
6310;10;21861064;6310;435;7573;7654;5.62;0.35;307.95;7.32;1263;10;2600.00;81
6313;10;21861082;6313;434;7576;7655;5.61;0.35;307.91;7.32;1263;10;2601.00;79
6316;10;21861096;6316;433;7577;7655;5.61;0.35;307.83;7.32;1261;10;2602.00;78
6319;10;21861109;6319;435;7582;7656;5.60;0.35;307.80;7.40;1263;10;2603.00;74
6323;10;21861123;6323;437;7584;7656;5.56;0.34;307.89;7.40;1261;10;2604.00;72
6327;10;21861136;6327;437;7587;7656;5.51;0.34;308.09;7.43;1260;10;2605.00;69
6328;10;21861150;6328;434;7592;7656;5.50;0.34;308.10;7.43;1264;10;2606.00;64
6335;10;21861163;6335;431;7598;7660;5.50;0.34;308.17;7.48;1263;10;2607.00;62
6336;10;21861178;6336;424;7599;7660;5.53;0.34;308.28;7.48;1263;10;2608.00;61
6341;10;21861192;6341;434;7601;7660;5.54;0.34;308.50;7.51;1260;10;2609.00;59
6345;10;21861208;6345;436;7606;7666;5.53;0.34;308.60;7.53;1261;10;2610.00;60
6348;10;21861222;6348;435;7606;7666;5.52;0.34;308.78;7.53;1258;10;2611.00;60
6350;10;21861237;6350;433;7610;7666;5.49;0.34;308.75;7.58;1260;10;2612.00;56
6354;10;21861250;6354;432;7614;7670;5.48;0.33;308.92;7.57;1260;10;2613.00;56
6356;10;21861265;6356;439;7616;7671;5.46;0.33;308.95;7.60;1260;10;2614.00;55
6358;10;21861278;6358;439;7618;7671;5.40;0.33;309.07;7.60;1260;10;2615.00;53
6363;10;21861292;6363;449;7621;7675;5.30;0.32;309.27;7.60;1258;10;2616.00;54
6368;10;21861306;6368;452;7621;7675;5.21;0.32;309.29;7.60;1253;10;2617.00;54
6371;10;21861319;6371;469;7621;7675;5.16;0.32;309.40;7.60;1250;10;2618.00;54
6378;10;21861332;6378;466;7622;7676;5.09;0.31;309.46;7.60;1244;10;2619.00;54
6380;10;21861345;6380;466;7623;7676;5.07;0.31;309.41;7.60;1243;10;2620.00;53
6383;10;21861358;6383;473;7627;7682;5.04;0.31;309.42;7.59;1244;10;2621.00;55
6386;10;21861372;6386;467;7627;7682;4.95;0.30;309.49;7.59;1241;10;2622.00;55
6387;10;21861385;6387;469;7627;7683;4.91;0.30;309.47;7.59;1240;10;2623.00;56
6390;10;21861397;6390;468;7627;7683;4.84;0.30;309.53;7.59;1237;10;2624.00;56
6397;10;21861411;6397;449;7627;7683;4.77;0.29;309.66;7.59;1230;10;2625.00;56
6398;10;21861430;6398;446;7627;7683;4.79;0.29;309.63;7.59;1229;10;2626.00;56
6402;10;21861443;6402;434;7627;7683;4.78;0.29;309.70;7.59;1225;10;2627.00;56
6404;10;21861455;6404;428;7636;7695;4.85;0.30;309.81;7.59;1232;10;2628.00;59
6407;10;21861469;6407;414;7636;7695;4.92;0.30;309.81;7.59;1229;10;2629.00;59
6411;10;21861483;6411;409;7636;7695;4.96;0.30;309.95;7.59;1225;10;2630.00;59
6418;10;21861496;6418;409;7636;7695;5.03;0.31;310.15;7.59;1218;10;2631.00;59
6419;10;21861510;6419;392;7636;7695;5.11;0.31;310.20;7.59;1217;10;2632.00;59
6423;10;21861523;6423;385;7636;7695;5.19;0.32;310.34;7.59;1213;10;2633.00;59
6426;10;21861536;6426;375;7639;7699;5.28;0.32;310.37;7.58;1213;10;2634.00;60
6432;10;21861551;6432;366;7639;7699;5.35;0.33;310.45;7.58;1207;10;2635.00;60
6437;10;21861564;6437;357;7642;7703;5.44;0.33;310.57;7.58;1205;10;2636.00;61
6440;10;21861579;6440;343;7642;7704;5.51;0.34;310.61;7.58;1202;10;2637.00;62
6443;10;21861593;6443;338;7642;7704;5.61;0.34;310.63;7.58;1199;10;2638.00;62
6447;10;21861607;6447;335;7642;7704;5.72;0.35;310.64;7.58;1195;10;2639.00;62
6450;10;21861622;6450;333;7657;7733;5.79;0.35;310.74;7.57;1207;10;2640.00;76
6454;10;21861639;6454;327;7658;7733;5.82;0.36;310.94;7.57;1204;10;2641.00;75
6459;10;21861653;6459;329;7660;7733;5.88;0.36;311.02;7.56;1201;10;2642.00;73
6465;10;21861667;6465;328;7664;7734;5.96;0.37;311.08;7.57;1199;10;2643.00;70
6470;10;21861681;6470;330;7665;7735;6.00;0.37;311.12;7.56;1195;10;2644.00;70
6475;10;21861695;6475;342;7665;7735;6.03;0.37;311.32;7.56;1190;10;2645.00;70
6481;10;21861709;6481;338;7667;7738;6.02;0.37;311.46;7.57;1186;10;2646.00;71
6487;10;21861724;6487;333;7667;7738;6.01;0.37;311.57;7.57;1180;10;2647.00;71
6492;10;21861738;6492;333;7668;7738;6.01;0.37;311.81;7.57;1176;10;2648.00;70
6496;10;21861753;6496;330;7668;7738;6.06;0.37;311.82;7.57;1172;10;2649.00;70
6501;10;21861767;6501;339;7673;7744;6.05;0.37;311.93;7.57;1172;10;2650.00;71
6502;10;21861783;6502;336;7674;7744;6.03;0.37;311.95;7.57;1172;10;2651.00;70
6508;10;21861797;6508;336;7675;7744;5.98;0.36;312.13;7.57;1167;10;2652.00;69
6511;10;21861812;6511;339;7675;7744;5.93;0.36;312.20;7.57;1164;10;2653.00;69
6517;10;21861827;6517;349;7681;7748;5.91;0.36;312.31;7.57;1164;10;2654.00;67
6518;10;21861843;6518;352;7683;7750;5.89;0.36;312.33;7.57;1165;10;2655.00;67
6523;10;21861863;6523;352;7685;7750;5.83;0.35;312.41;7.57;1162;10;2656.00;65
6523;10;21861882;6523;354;7687;7751;5.82;0.35;312.41;7.57;1164;10;2657.00;64
6528;10;21861900;6528;361;7688;7751;5.81;0.35;312.39;7.57;1160;10;2658.00;63
6534;10;21861917;6534;360;7688;7751;5.76;0.35;312.46;7.57;1154;10;2659.00;63
6537;10;21861936;6537;360;7689;7751;5.77;0.35;312.49;7.57;1152;10;2660.00;62
6544;10;21861951;6544;361;7689;7751;5.70;0.35;312.64;7.57;1145;10;2661.00;62
6545;10;21861967;6545;370;7689;7751;5.65;0.34;312.61;7.57;1144;10;2662.00;62
6549;10;21861982;6549;385;7689;7751;5.68;0.35;312.75;7.57;1140;10;2663.00;62
6550;10;21861996;6550;393;7725;7821;5.71;0.35;312.77;7.54;1175;10;2664.00;96
6554;10;21862016;6554;388;7726;7822;5.75;0.35;312.86;7.54;1172;10;2665.00;96
6556;10;21862030;6556;389;7731;7822;5.79;0.35;312.98;7.53;1175;10;2666.00;91
6557;10;21862044;6557;396;7733;7822;5.82;0.36;312.95;7.53;1176;10;2667.00;89
6561;10;21862058;6561;402;7736;7822;5.77;0.35;312.97;7.53;1175;10;2668.00;86
6566;10;21862072;6566;401;7740;7822;5.75;0.35;313.04;7.53;1174;10;2669.00;82
6570;10;21862093;6570;412;7742;7822;5.71;0.35;313.06;7.53;1172;10;2670.00;80
6576;10;21862106;6576;419;7743;7822;5.66;0.34;313.19;7.53;1167;10;2671.00;79
6579;10;21862119;6579;409;7747;7823;5.65;0.34;313.25;7.53;1168;10;2672.00;76
6581;10;21862134;6581;399;7750;7824;5.68;0.34;313.30;7.53;1169;10;2673.00;74
6583;10;21862148;6583;397;7751;7824;5.68;0.34;313.34;7.53;1168;10;2674.00;73
6586;10;21862161;6586;394;7754;7828;5.61;0.34;313.46;7.53;1168;10;2675.00;74
6588;10;21862176;6588;404;7755;7828;5.60;0.34;313.52;7.53;1167;10;2676.00;73
6592;10;21862188;6592;410;7755;7828;5.55;0.34;313.51;7.53;1163;10;2677.00;73
6596;10;21862202;6596;418;7755;7828;5.54;0.34;313.58;7.53;1159;10;2678.00;73
6598;10;21862216;6598;425;7761;7834;5.55;0.34;313.60;7.53;1163;10;2679.00;73
6599;10;21862231;6599;427;7761;7834;5.53;0.34;313.56;7.53;1162;10;2680.00;73
6601;10;21862244;6601;421;7761;7834;5.54;0.34;313.65;7.53;1160;11;2681.00;73
6604;10;21862267;6604;417;7763;7837;5.57;0.34;313.63;7.52;1159;11;2682.00;74
6605;10;21862281;6605;420;7763;7837;5.58;0.34;313.67;7.52;1158;11;2683.00;74
6605;10;21862295;6605;415;7764;7837;5.62;0.34;313.67;7.52;1159;11;2684.00;73
6606;10;21862309;6606;419;7766;7838;5.60;0.34;313.70;7.53;1160;11;2685.00;72
6610;10;21862322;6610;421;7767;7839;5.59;0.34;313.87;7.53;1157;11;2686.00;72
6610;10;21862336;6610;431;7767;7839;5.55;0.34;313.87;7.53;1157;11;2687.00;72
6613;10;21862350;6613;435;7779;7852;5.59;0.34;314.02;7.52;1166;11;2688.00;73
6616;10;21862365;6616;443;7779;7852;5.53;0.34;314.05;7.52;1163;11;2689.00;73
6623;10;21862379;6623;436;7780;7852;5.43;0.33;314.35;7.52;1157;11;2690.00;72
6626;10;21862393;6626;441;7781;7853;5.38;0.33;314.51;7.52;1155;11;2691.00;72
6627;10;21862406;6627;445;7781;7853;5.34;0.33;314.53;7.52;1154;11;2692.00;72
6628;10;21862420;6628;442;7786;7857;5.36;0.33;314.63;7.52;1158;11;2693.00;71
6631;10;21862434;6631;445;7788;7857;5.33;0.33;314.65;7.53;1157;11;2694.00;69
6636;10;21862448;6636;447;7791;7861;5.26;0.32;314.76;7.52;1155;11;2695.00;70
6638;10;21862462;6638;444;7791;7861;5.22;0.32;314.75;7.52;1153;11;2696.00;70
6639;10;21862476;6639;441;7791;7861;5.19;0.32;314.86;7.52;1152;11;2697.00;70
6641;10;21862489;6641;441;7791;7861;5.16;0.32;314.89;7.52;1150;11;2698.00;70
6642;10;21862505;6642;438;7791;7861;5.17;0.32;314.92;7.52;1149;11;2699.00;70
6648;10;21862522;6648;448;7818;7910;5.17;0.32;314.94;7.50;1170;11;2700.00;92
6651;10;21862545;6651;449;7818;7910;5.17;0.32;314.98;7.50;1167;11;2701.00;92
6652;10;21862558;6652;457;7822;7910;5.22;0.32;314.99;7.49;1170;11;2702.00;88
6654;10;21862572;6654;455;7822;7910;5.22;0.32;315.02;7.49;1168;11;2703.00;88
6655;10;21862585;6655;458;7825;7910;5.22;0.32;314.99;7.49;1170;11;2704.00;85
6655;10;21862598;6655;459;7825;7910;5.23;0.32;314.99;7.49;1170;11;2705.00;85
6655;10;21862611;6655;459;7826;7911;5.20;0.32;314.99;7.49;1171;11;2706.00;85
6657;10;21862624;6657;452;7826;7911;5.21;0.32;314.98;7.49;1169;11;2707.00;85
6658;10;21862637;6658;453;7831;7917;5.25;0.32;315.04;7.49;1173;11;2708.00;86
6663;10;21862651;6663;456;7832;7918;5.24;0.32;315.14;7.49;1169;11;2709.00;86
6665;10;21862664;6665;459;7832;7918;5.23;0.32;315.09;7.49;1167;11;2710.00;86
6667;10;21862677;6667;460;7832;7918;5.23;0.32;315.15;7.49;1165;11;2711.00;86
6669;10;21862690;6669;472;7836;7922;5.21;0.32;315.19;7.49;1167;11;2712.00;86
6671;10;21862702;6671;483;7836;7922;5.16;0.32;315.22;7.49;1165;11;2713.00;86
6673;10;21862716;6673;491;7837;7922;5.14;0.31;315.22;7.49;1164;11;2714.00;85
6676;10;21862729;6676;492;7838;7923;5.18;0.32;315.21;7.49;1162;11;2715.00;85
6678;10;21862741;6678;494;7841;7927;5.20;0.32;315.13;7.48;1163;11;2716.00;86
6678;10;21862755;6678;490;7842;7927;5.23;0.32;315.13;7.49;1164;11;2717.00;85
6684;10;21862768;6684;481;7844;7930;5.24;0.32;315.06;7.48;1160;11;2718.00;86
6689;10;21862782;6689;487;7844;7930;5.22;0.32;315.08;7.48;1155;11;2719.00;86
6692;10;21862795;6692;483;7846;7930;5.22;0.32;315.14;7.48;1154;11;2720.00;84
6695;10;21862808;6695;484;7846;7930;5.24;0.32;315.08;7.48;1151;11;2721.00;84
6697;10;21862821;6697;477;7850;7934;5.27;0.32;315.11;7.48;1153;11;2722.00;84
6697;10;21862835;6697;478;7850;7934;5.25;0.32;315.11;7.48;1153;11;2723.00;84
6698;10;21862847;6698;479;7850;7934;5.27;0.32;315.13;7.48;1152;11;2724.00;84
6702;10;21862859;6702;481;7850;7934;5.25;0.32;315.09;7.48;1148;11;2725.00;84
6702;10;21862872;6702;486;7851;7935;5.22;0.32;315.09;7.49;1149;11;2726.00;84
6705;10;21862884;6705;487;7853;7936;5.13;0.31;315.05;7.49;1148;11;2727.00;83
6708;10;21862897;6708;486;7853;7936;5.05;0.31;315.09;7.49;1145;11;2728.00;83
6710;10;21862909;6710;483;7854;7937;4.99;0.30;315.13;7.49;1144;11;2729.00;83
6712;10;21862923;6712;476;7857;7937;4.95;0.30;315.17;7.53;1145;11;2730.00;80
6716;10;21862937;6716;470;7857;7937;4.89;0.30;315.08;7.53;1141;11;2731.00;80
6719;10;21862949;6719;474;7858;7937;4.85;0.29;315.07;7.53;1139;11;2732.00;79
6721;10;21862962;6721;472;7858;7937;4.86;0.29;315.01;7.53;1137;11;2733.00;79
6724;10;21862974;6724;470;7858;7937;4.86;0.29;314.94;7.53;1134;11;2734.00;79
6725;10;21862987;6725;474;7858;7937;4.91;0.30;315.03;7.53;1133;11;2735.00;79
6726;10;21863006;6726;474;7919;8064;5.17;0.32;314.99;7.47;1193;11;2736.00;145
6727;10;21863031;6727;451;7919;8065;5.23;0.32;315.01;7.47;1192;11;2737.00;146
6730;10;21863044;6730;437;7928;8065;5.37;0.33;315.06;7.47;1198;11;2738.00;137
6732;10;21863056;6732;420;7931;8065;5.40;0.33;315.04;7.47;1199;11;2739.00;134
6733;10;21863070;6733;408;7939;8065;5.49;0.34;315.06;7.46;1206;11;2740.00;126
6736;10;21863084;6736;399;7942;8065;5.59;0.34;315.02;7.46;1206;11;2741.00;123
6736;10;21863098;6736;388;7944;8065;5.70;0.35;315.02;7.46;1208;11;2742.00;121
6737;10;21863117;6737;383;7947;8065;5.75;0.35;314.98;7.46;1210;11;2743.00;118
6738;10;21863131;6738;381;7949;8066;5.81;0.35;314.95;7.46;1211;11;2744.00;117
6739;10;21863145;6739;378;7955;8068;5.84;0.36;314.91;7.46;1216;11;2745.00;113
6739;10;21863159;6739;375;7959;8068;5.90;0.36;314.91;7.47;1220;11;2746.00;109
6741;10;21863172;6741;375;7962;8069;5.91;0.36;314.93;7.47;1221;11;2747.00;107
6741;10;21863187;6741;381;7966;8069;5.89;0.36;314.93;7.47;1225;11;2748.00;103
6742;10;21863207;6742;375;7968;8069;5.84;0.36;314.92;7.47;1226;11;2749.00;101
6743;10;21863222;6743;384;7970;8069;5.82;0.36;314.88;7.47;1227;11;2750.00;99
6746;10;21863236;6746;390;7975;8073;5.78;0.35;314.80;7.51;1229;11;2751.00;98
6747;10;21863250;6747;388;7978;8073;5.81;0.35;314.79;7.52;1231;11;2752.00;95
6749;10;21863265;6749;388;7980;8073;5.77;0.35;314.73;7.52;1231;11;2753.00;93
6750;10;21863280;6750;390;7984;8076;5.81;0.36;314.75;7.52;1234;11;2754.00;92
6753;10;21863294;6753;398;7990;8076;5.81;0.35;314.72;7.62;1237;11;2755.00;86
6753;10;21863309;6753;402;7991;8076;5.90;0.36;314.72;7.62;1238;11;2756.00;85
6755;10;21863323;6755;410;7997;8080;5.85;0.36;314.70;7.69;1242;11;2757.00;83
6758;10;21863338;6758;410;7998;8081;5.82;0.35;314.78;7.69;1240;11;2758.00;83
6760;10;21863353;6760;411;7999;8081;5.83;0.36;314.84;7.69;1239;11;2759.00;82
6765;10;21863369;6765;413;8005;8086;5.80;0.35;314.99;7.75;1240;11;2760.00;81
6767;10;21863385;6767;414;8006;8086;5.79;0.35;314.95;7.75;1239;11;2761.00;80
6768;10;21863400;6768;423;8008;8086;5.76;0.35;314.92;7.82;1240;11;2762.00;78
6770;10;21863414;6770;431;8009;8087;5.75;0.35;314.86;7.82;1239;11;2763.00;78
6772;10;21863428;6772;430;8010;8087;5.75;0.35;314.85;7.86;1238;11;2764.00;77
6773;10;21863442;6773;435;8016;8093;5.74;0.35;314.95;7.89;1243;11;2765.00;77
6774;10;21863456;6774;431;8017;8093;5.75;0.35;314.99;7.93;1243;11;2766.00;76
6778;10;21863470;6778;435;8017;8094;5.70;0.35;315.06;7.93;1239;11;2767.00;77
6781;10;21863485;6781;433;8018;8094;5.68;0.35;315.16;7.96;1237;11;2768.00;76
6785;10;21863499;6785;434;8018;8094;5.63;0.34;315.24;7.96;1233;11;2769.00;76
6786;10;21863513;6786;441;8020;8094;5.58;0.34;315.28;8.04;1234;11;2770.00;74
6788;10;21863526;6788;443;8020;8094;5.53;0.34;315.36;8.04;1232;11;2771.00;74
6791;10;21863539;6791;451;8031;8106;5.50;0.34;315.42;8.06;1240;11;2772.00;75
6792;10;21863554;6792;448;8032;8106;5.49;0.33;315.41;8.09;1240;11;2773.00;74
6795;10;21863568;6795;441;8034;8106;5.47;0.33;315.39;8.13;1239;11;2774.00;72
6797;10;21863582;6797;442;8035;8106;5.52;0.34;315.44;8.16;1238;11;2775.00;71
6797;10;21863596;6797;436;8036;8106;5.54;0.34;315.44;8.19;1239;11;2776.00;70
6798;10;21863609;6798;425;8037;8106;5.56;0.34;315.49;8.23;1239;11;2777.00;69
6803;10;21863623;6803;423;8040;8110;5.53;0.34;315.49;8.22;1237;11;2778.00;70
6805;10;21863637;6805;420;8040;8110;5.53;0.34;315.64;8.22;1235;11;2779.00;70
6807;10;21863651;6807;417;8046;8114;5.56;0.34;315.65;8.28;1239;11;2780.00;68
6810;10;21863665;6810;416;8047;8115;5.63;0.34;315.61;8.28;1237;11;2781.00;68
6814;10;21863680;6814;416;8048;8115;5.64;0.34;315.58;8.31;1234;11;2782.00;67
6815;10;21863693;6815;423;8048;8115;5.69;0.35;315.69;8.31;1233;11;2783.00;67
6819;10;21863707;6819;429;8059;8128;5.72;0.35;315.78;8.30;1240;11;2784.00;69
6822;10;21863722;6822;425;8061;8128;5.76;0.35;315.82;8.37;1239;11;2785.00;67
6828;10;21863737;6828;422;8061;8128;5.80;0.35;315.74;8.37;1233;11;2786.00;67
6830;10;21863751;6830;423;8062;8129;5.83;0.36;315.76;8.36;1232;11;2787.00;67
6837;10;21863765;6837;426;8064;8130;5.85;0.36;315.80;8.43;1227;11;2788.00;66
6841;10;21863779;6841;430;8064;8130;5.88;0.36;315.80;8.43;1223;11;2789.00;66
6844;10;21863795;6844;429;8071;8136;5.83;0.36;315.77;8.48;1227;11;2790.00;65
6847;10;21863810;6847;443;8071;8136;5.82;0.35;315.81;8.48;1224;11;2791.00;65
6848;10;21863823;6848;439;8072;8136;5.78;0.35;315.79;8.48;1224;11;2792.00;64
6852;10;21863844;6852;452;8074;8136;5.74;0.35;315.94;8.54;1222;11;2793.00;62
6855;10;21863864;6855;456;8079;8142;5.74;0.35;315.96;8.53;1224;11;2794.00;63
6857;10;21863882;6857;459;8079;8142;5.74;0.35;316.00;8.53;1222;11;2795.00;63
6863;10;21863900;6863;457;8079;8142;5.69;0.35;316.11;8.53;1216;11;2796.00;63
6867;10;21863918;6867;457;8079;8142;5.61;0.34;316.26;8.53;1212;11;2797.00;63
6870;10;21863935;6870;459;8082;8146;5.55;0.34;316.35;8.53;1212;11;2798.00;64
6875;10;21863952;6875;463;8083;8147;5.47;0.33;316.37;8.53;1208;11;2799.00;64
6880;10;21863976;6880;446;8083;8147;5.43;0.33;316.60;8.53;1203;11;2800.00;64
6884;10;21863997;6884;437;8084;8148;5.45;0.33;316.72;8.53;1200;11;2801.00;64
6885;10;21864012;6885;434;8084;8148;5.47;0.33;316.75;8.53;1199;11;2802.00;64
6888;10;21864025;6888;426;8084;8148;5.52;0.34;316.76;8.53;1196;11;2803.00;64
6893;10;21864045;6893;417;8084;8148;5.54;0.34;316.82;8.53;1191;11;2804.00;64
6897;10;21864065;6897;415;8084;8148;5.53;0.34;316.92;8.53;1187;11;2805.00;64
6900;10;21864079;6900;406;8084;8148;5.54;0.34;316.88;8.53;1184;11;2806.00;64
6904;10;21864093;6904;402;8084;8148;5.54;0.34;317.07;8.53;1180;11;2807.00;64
6908;10;21864106;6908;396;8122;8218;5.70;0.35;317.12;8.49;1214;11;2808.00;96
6909;10;21864126;6909;395;8126;8219;5.77;0.35;317.17;8.49;1217;11;2809.00;93
6913;10;21864140;6913;394;8131;8219;5.81;0.36;317.20;8.48;1218;11;2810.00;88
6917;10;21864154;6917;385;8133;8219;5.86;0.36;317.32;8.48;1216;11;2811.00;86
6919;10;21864169;6919;379;8135;8219;5.90;0.36;317.37;8.48;1216;11;2812.00;84
6922;10;21864183;6922;385;8136;8219;5.92;0.36;317.47;8.48;1214;11;2813.00;83
6924;10;21864199;6924;388;8137;8219;5.90;0.36;317.48;8.48;1213;11;2814.00;82
6928;10;21864216;6928;391;8139;8219;5.85;0.36;317.58;8.48;1211;11;2815.00;80
6931;10;21864230;6931;397;8140;8220;5.81;0.36;317.70;8.48;1209;11;2816.00;80
6933;10;21864244;6933;394;8141;8221;5.79;0.35;317.70;8.48;1208;11;2817.00;80
6936;10;21864259;6936;394;8143;8221;5.79;0.35;317.65;8.48;1207;11;2818.00;78
6941;10;21864273;6941;393;8145;8225;5.78;0.35;317.65;8.48;1204;11;2819.00;80
6945;10;21864289;6945;394;8145;8225;5.77;0.35;317.72;8.48;1200;11;2820.00;80
6946;10;21864310;6946;393;8147;8225;5.80;0.35;317.73;8.48;1201;11;2821.00;78
6951;10;21864324;6951;385;8147;8225;5.76;0.35;317.77;8.48;1196;11;2822.00;78
6952;10;21864338;6952;391;8152;8231;5.78;0.35;317.79;8.47;1200;11;2823.00;79
6956;10;21864353;6956;387;8152;8231;5.79;0.35;317.91;8.47;1196;11;2824.00;79
6959;10;21864373;6959;393;8153;8231;5.77;0.35;317.97;8.47;1194;11;2825.00;78
6966;10;21864388;6966;390;8154;8234;5.76;0.35;318.10;8.47;1188;11;2826.00;80
6969;10;21864403;6969;394;8155;8234;5.74;0.35;318.30;8.48;1186;11;2827.00;79
6972;10;21864418;6972;397;8156;8234;5.75;0.35;318.29;8.48;1184;11;2828.00;78
6978;10;21864432;6978;395;8158;8235;5.70;0.35;318.41;8.48;1180;11;2829.00;77
6979;10;21864447;6979;400;8159;8236;5.65;0.35;318.50;8.48;1180;11;2830.00;77
6981;10;21864461;6981;400;8161;8236;5.64;0.35;318.59;8.48;1180;11;2831.00;75
6984;10;21864474;6984;405;8170;8249;5.68;0.35;318.51;8.47;1186;11;2832.00;79
6990;10;21864490;6990;410;8173;8249;5.68;0.35;318.50;8.47;1183;11;2833.00;76
6996;10;21864504;6996;430;8173;8249;5.65;0.35;318.58;8.47;1177;11;2834.00;76
6999;10;21864518;6999;427;8175;8251;5.67;0.35;318.54;8.46;1176;11;2835.00;76
7003;10;21864532;7003;434;8175;8251;5.69;0.35;318.69;8.46;1172;11;2836.00;76
7006;10;21864546;7006;437;8179;8255;5.74;0.35;318.84;8.46;1173;11;2837.00;76
7008;10;21864560;7008;443;8180;8255;5.74;0.35;318.82;8.46;1172;11;2838.00;75
7012;10;21864574;7012;445;8182;8259;5.70;0.35;318.93;8.46;1170;11;2839.00;77
7018;10;21864588;7018;448;8182;8259;5.58;0.34;319.05;8.46;1164;11;2840.00;77
7022;10;21864602;7022;448;8182;8259;5.46;0.33;319.11;8.46;1160;11;2841.00;77
7025;10;21864616;7025;463;8183;8259;5.38;0.33;319.38;8.46;1158;11;2842.00;76
7031;10;21864629;7031;469;8184;8259;5.30;0.32;319.54;8.47;1153;11;2843.00;75
7033;10;21864643;7033;469;8194;8271;5.30;0.32;319.52;8.46;1161;11;2844.00;77
7036;10;21864663;7036;475;8194;8271;5.20;0.32;319.54;8.46;1158;11;2845.00;77
7041;10;21864676;7041;483;8196;8271;5.12;0.31;319.52;8.45;1155;11;2846.00;75
7042;10;21864689;7042;482;8196;8271;5.14;0.31;319.53;8.45;1154;11;2847.00;75
7045;10;21864703;7045;475;8196;8271;5.16;0.32;319.66;8.45;1151;11;2848.00;75
7049;10;21864717;7049;476;8196;8271;5.19;0.32;319.68;8.45;1147;11;2849.00;75
7051;10;21864732;7051;483;8198;8274;5.24;0.32;319.70;8.45;1147;11;2850.00;76
7054;10;21864746;7054;477;8198;8274;5.26;0.32;319.73;8.45;1144;11;2851.00;76
7059;10;21864767;7059;474;8203;8280;5.29;0.32;319.85;8.45;1144;11;2852.00;77
7062;10;21864783;7062;472;8204;8281;5.27;0.32;319.95;8.45;1142;11;2853.00;77
7065;10;21864797;7065;473;8204;8281;5.23;0.32;319.91;8.45;1139;11;2854.00;77
7068;10;21864811;7068;479;8204;8281;5.23;0.32;320.04;8.45;1136;11;2855.00;77
7068;10;21864830;7068;470;8207;8285;5.29;0.32;320.04;8.44;1139;11;2856.00;78
7072;10;21864844;7072;465;8207;8285;5.26;0.32;320.08;8.44;1135;11;2857.00;78
7074;10;21864857;7074;462;8207;8285;5.31;0.32;320.07;8.44;1133;11;2858.00;78
7075;10;21864871;7075;459;8208;8286;5.39;0.33;320.06;8.44;1133;11;2859.00;78
7079;10;21864885;7079;454;8211;8290;5.44;0.33;320.13;8.44;1132;11;2860.00;79
7081;10;21864899;7081;466;8211;8290;5.48;0.33;320.17;8.44;1130;11;2861.00;79
7084;10;21864913;7084;469;8213;8293;5.58;0.34;320.23;8.44;1129;11;2862.00;80
7087;10;21864927;7087;473;8213;8293;5.64;0.34;320.33;8.44;1126;11;2863.00;80
7090;10;21864941;7090;477;8216;8295;5.68;0.35;320.38;8.44;1126;11;2864.00;79
7091;10;21864956;7091;478;8216;8295;5.76;0.35;320.43;8.44;1125;11;2865.00;79
7094;10;21864970;7094;482;8220;8299;5.80;0.35;320.51;8.43;1126;11;2866.00;79
7096;10;21864984;7096;478;8220;8299;5.80;0.35;320.54;8.43;1124;11;2867.00;79
7099;10;21864999;7099;477;8220;8299;5.80;0.35;320.58;8.43;1121;11;2868.00;79
7102;10;21865013;7102;473;8220;8299;5.78;0.35;320.57;8.43;1118;11;2869.00;79
7104;10;21865033;7104;472;8220;8300;5.77;0.35;320.58;8.43;1116;11;2870.00;80
7106;10;21865046;7106;472;8221;8301;5.77;0.35;320.54;8.43;1115;11;2871.00;80
7108;10;21865060;7108;469;8221;8301;5.77;0.35;320.64;8.43;1113;11;2872.00;80
7110;10;21865073;7110;468;8222;8302;5.74;0.35;320.61;8.43;1112;11;2873.00;80
7115;10;21865086;7115;471;8222;8302;5.64;0.34;320.72;8.43;1107;11;2874.00;80
7118;10;21865100;7118;470;8222;8302;5.56;0.34;320.67;8.43;1104;11;2875.00;80
7119;10;21865112;7119;478;8222;8302;5.53;0.34;320.68;8.43;1103;11;2876.00;80
7124;10;21865125;7124;476;8222;8302;5.50;0.33;320.71;8.43;1098;11;2877.00;80
7125;10;21865138;7125;474;8222;8302;5.52;0.34;320.68;8.43;1097;11;2878.00;80
7129;10;21865151;7129;475;8222;8302;5.44;0.33;320.61;8.43;1093;11;2879.00;80
7130;10;21865173;7130;529;8346;8532;5.59;0.35;320.58;8.31;1216;11;2880.00;186
7131;10;21865217;7131;526;8349;8533;5.60;0.35;320.60;8.30;1218;11;2881.00;184
7137;10;21865230;7137;513;8359;8533;5.60;0.35;320.57;8.30;1222;11;2882.00;174
7138;10;21865244;7138;499;8363;8533;5.58;0.35;320.56;8.29;1225;11;2883.00;170
7140;10;21865257;7140;498;8370;8533;5.54;0.35;320.55;8.29;1230;11;2884.00;163
7141;10;21865270;7141;504;8373;8533;5.47;0.34;320.64;8.29;1232;11;2885.00;160
7141;10;21865283;7141;505;8380;8533;5.43;0.34;320.64;8.29;1239;11;2886.00;153
7142;10;21865297;7142;509;8386;8533;5.37;0.33;320.60;8.29;1244;11;2887.00;147
7143;10;21865311;7143;517;8392;8534;5.29;0.33;320.58;8.28;1249;11;2888.00;142
7143;10;21865330;7143;517;8395;8535;5.19;0.32;320.58;8.29;1252;11;2889.00;140
7145;10;21865343;7145;510;8401;8535;5.16;0.32;320.60;8.29;1256;11;2890.00;134
7145;10;21865356;7145;513;8403;8536;5.10;0.32;320.60;8.29;1258;11;2891.00;133
7150;10;21865370;7150;509;8408;8536;5.00;0.31;320.61;8.29;1258;11;2892.00;128
7151;10;21865384;7151;500;8409;8536;4.95;0.31;320.57;8.29;1258;11;2893.00;127
7152;10;21865399;7152;481;8410;8536;4.95;0.31;320.60;8.29;1258;11;2894.00;126
7154;10;21865413;7154;473;8413;8540;4.94;0.30;320.60;8.29;1259;11;2895.00;127
7154;10;21865433;7154;469;8414;8540;4.99;0.31;320.60;8.29;1260;11;2896.00;126
7155;10;21865448;7155;474;8415;8540;5.05;0.31;320.61;8.29;1260;11;2897.00;125
7158;10;21865462;7158;477;8418;8543;5.10;0.31;320.59;8.29;1260;11;2898.00;125
7161;10;21865483;7161;473;8418;8543;5.14;0.31;320.61;8.29;1257;11;2899.00;125
7163;10;21865510;7163;465;8418;8543;5.16;0.32;320.61;8.29;1255;11;2900.00;125
7164;10;21865529;7164;463;8422;8547;5.25;0.32;320.59;8.29;1258;11;2901.00;125
7167;10;21865544;7167;457;8423;8548;5.31;0.33;320.60;8.29;1256;11;2902.00;125
7170;10;21865559;7170;456;8424;8548;5.37;0.33;320.62;8.29;1254;11;2903.00;124
7172;10;21865573;7172;451;8426;8552;5.43;0.33;320.55;8.29;1254;11;2904.00;126
7173;10;21865595;7173;447;8427;8552;5.50;0.34;320.54;8.33;1254;11;2905.00;125
7173;10;21865612;7173;451;8429;8552;5.55;0.34;320.54;8.37;1256;11;2906.00;123
7175;10;21865626;7175;455;8430;8553;5.60;0.34;320.53;8.37;1255;11;2907.00;123
7177;10;21865641;7177;440;8433;8553;5.59;0.34;320.53;8.38;1256;11;2908.00;120
7180;10;21865656;7180;434;8436;8559;5.64;0.34;320.57;8.38;1256;11;2909.00;123
7183;10;21865672;7183;436;8437;8559;5.64;0.34;320.51;8.38;1254;11;2910.00;122
7185;10;21865688;7185;430;8438;8560;5.66;0.35;320.49;8.38;1253;11;2911.00;122
7186;10;21865705;7186;423;8438;8560;5.69;0.35;320.48;8.38;1252;11;2912.00;122
7190;10;21865720;7190;417;8440;8560;5.77;0.35;320.51;8.39;1250;11;2913.00;120
7193;10;21865734;7193;413;8440;8560;5.80;0.35;320.55;8.39;1247;11;2914.00;120
7194;10;21865749;7194;398;8443;8560;5.81;0.35;320.62;8.40;1249;11;2915.00;117
7195;10;21865763;7195;398;8451;8572;5.89;0.36;320.59;8.39;1256;11;2916.00;121
7201;10;21865779;7201;386;8451;8572;5.92;0.36;320.49;8.39;1250;11;2917.00;121
7204;10;21865794;7204;384;8454;8572;5.98;0.36;320.48;8.39;1250;11;2918.00;118
7207;10;21865808;7207;391;8454;8572;6.02;0.37;320.59;8.39;1247;11;2919.00;118
7210;10;21865823;7210;387;8454;8572;6.06;0.37;320.69;8.39;1244;11;2920.00;118
7215;10;21865837;7215;380;8455;8572;6.05;0.37;320.86;8.39;1240;11;2921.00;117
7216;10;21865857;7216;381;8460;8576;6.05;0.37;320.89;8.40;1244;11;2922.00;116
7219;10;21865879;7219;384;8460;8576;6.00;0.37;320.98;8.40;1241;11;2923.00;116
7222;10;21865898;7222;380;8465;8580;6.01;0.37;321.02;8.40;1243;11;2924.00;115
7222;10;21865916;7222;384;8467;8582;5.98;0.36;321.02;8.40;1245;11;2925.00;115
7226;10;21865934;7226;385;8470;8582;5.94;0.36;320.98;8.41;1244;11;2926.00;112
7226;10;21865952;7226;383;8472;8582;5.96;0.36;320.98;8.41;1246;11;2927.00;110
7229;10;21865969;7229;394;8481;8595;6.00;0.36;320.91;8.40;1252;11;2928.00;114
7229;10;21865987;7229;396;8484;8595;6.06;0.37;320.91;8.41;1255;11;2929.00;111
7232;10;21866004;7232;392;8487;8595;6.11;0.37;320.98;8.50;1255;11;2930.00;108
7234;10;21866020;7234;397;8489;8596;6.14;0.37;321.05;8.50;1255;11;2931.00;107
7235;10;21866035;7235;395;8490;8597;6.18;0.38;321.12;8.54;1255;11;2932.00;107
7238;10;21866052;7238;397;8492;8597;6.22;0.38;321.12;8.59;1254;11;2933.00;105
7239;10;21866067;7239;402;8495;8600;6.22;0.38;321.11;8.58;1256;11;2934.00;105
7243;11;21866082;7243;404;8496;8600;6.19;0.38;321.13;8.59;1253;12;2935.00;104
7247;11;21866125;7247;410;8498;8600;6.16;0.37;321.25;8.63;1251;12;2936.00;102
7251;11;21866141;7251;416;8500;8600;6.16;0.37;321.24;8.68;1249;12;2937.00;100
7252;11;21866156;7252;416;8507;8606;6.18;0.38;321.20;8.72;1255;12;2938.00;99
7254;11;21866171;7254;415;8509;8606;6.15;0.37;321.14;8.77;1255;12;2939.00;97
7256;11;21866192;7256;428;8511;8606;6.14;0.37;321.12;8.81;1255;12;2940.00;95
7260;11;21866207;7260;428;8512;8606;6.13;0.37;321.10;8.85;1252;12;2941.00;94
7262;11;21866222;7262;433;8516;8610;6.13;0.37;321.12;8.89;1254;12;2942.00;94
7265;11;21866237;7265;442;8519;8611;6.15;0.37;321.07;8.89;1254;12;2943.00;92
7268;11;21866252;7268;434;8521;8611;6.13;0.37;321.06;8.97;1253;12;2944.00;90
7269;11;21866267;7269;440;8522;8612;6.13;0.37;321.07;8.97;1253;12;2945.00;90
7271;11;21866282;7271;437;8523;8612;6.10;0.37;321.11;8.97;1252;12;2946.00;89
7274;11;21866296;7274;444;8525;8612;6.08;0.37;321.10;9.05;1251;12;2947.00;87
7276;11;21866311;7276;449;8525;8612;6.02;0.37;321.13;9.05;1249;12;2948.00;87
7277;11;21866325;7277;440;8527;8612;5.95;0.36;321.17;9.12;1250;12;2949.00;85
7278;11;21866339;7278;438;8527;8612;5.92;0.36;321.16;9.12;1249;12;2950.00;85
7282;11;21866354;7282;423;8527;8612;5.88;0.36;321.25;9.12;1245;12;2951.00;85
7284;11;21866369;7284;434;8569;8682;5.90;0.36;321.23;9.15;1285;12;2952.00;113
7285;11;21866392;7285;423;8571;8683;5.90;0.36;321.22;9.15;1286;12;2953.00;112
7287;11;21866408;7287;419;8577;8683;5.94;0.36;321.24;9.22;1290;12;2954.00;106
7287;11;21866424;7287;422;8579;8683;5.96;0.36;321.24;9.25;1292;12;2955.00;104
7288;11;21866439;7288;422;8581;8683;6.01;0.37;321.26;9.29;1293;12;2956.00;102
7290;11;21866454;7290;422;8581;8683;6.02;0.37;321.30;9.29;1291;12;2957.00;102
7291;11;21866470;7291;425;8584;8683;6.10;0.37;321.27;9.29;1293;12;2958.00;99
7293;11;21866485;7293;426;8586;8683;6.07;0.37;321.24;9.35;1293;12;2959.00;97
7296;11;21866506;7296;424;8588;8684;6.08;0.37;321.21;9.35;1292;12;2960.00;96
7296;11;21866521;7296;423;8592;8685;6.10;0.37;321.21;9.42;1296;12;2961.00;93
7301;12;21866536;7301;430;8594;8685;6.06;0.37;321.23;9.42;1293;13;2962.00;91
7305;12;21866566;7305;435;8599;8689;6.02;0.37;321.21;9.42;1294;13;2963.00;90
7310;12;21866582;7310;442;8603;8689;6.00;0.36;321.33;9.48;1293;13;2964.00;86
7314;12;21866598;7314;447;8603;8689;5.96;0.36;321.31;9.48;1289;13;2965.00;86
7316;12;21866614;7316;446;8603;8689;5.90;0.36;321.31;9.48;1287;13;2966.00;86
7321;12;21866631;7321;455;8609;8695;5.87;0.36;321.29;9.54;1288;13;2967.00;86
7326;12;21866647;7326;468;8609;8695;5.84;0.35;321.31;9.54;1283;13;2968.00;86
7329;12;21866662;7329;467;8611;8695;5.79;0.35;321.38;9.61;1282;13;2969.00;84
7332;12;21866679;7332;471;8614;8701;5.78;0.35;321.50;9.60;1282;13;2970.00;87
7336;12;21866695;7336;468;8614;8701;5.68;0.35;321.56;9.60;1278;13;2971.00;87
7339;12;21866710;7339;471;8618;8701;5.60;0.34;321.57;9.67;1279;13;2972.00;83
7341;12;21866724;7341;472;8618;8702;5.55;0.34;321.58;9.67;1277;13;2973.00;84
7345;12;21866738;7345;474;8619;8703;5.49;0.33;321.65;9.67;1274;13;2974.00;84
7350;12;21866759;7350;464;8619;8703;5.45;0.33;321.79;9.67;1269;13;2975.00;84
7352;12;21866773;7352;464;8627;8716;5.46;0.33;321.80;9.66;1275;13;2976.00;89
7357;12;21866789;7357;462;8629;8716;5.42;0.33;321.93;9.66;1272;13;2977.00;87
7359;12;21866804;7359;461;8630;8716;5.44;0.33;321.97;9.66;1271;13;2978.00;86
7362;12;21866818;7362;456;8630;8717;5.42;0.33;322.08;9.66;1268;13;2979.00;87
7367;12;21866833;7367;460;8632;8717;5.43;0.33;322.20;9.66;1265;13;2980.00;85
7371;12;21866848;7371;458;8635;8721;5.55;0.34;322.25;9.66;1264;13;2981.00;86
7377;12;21866863;7377;454;8635;8721;5.56;0.34;322.42;9.66;1258;13;2982.00;86
7381;12;21866884;7381;449;8640;8725;5.61;0.34;322.61;9.66;1259;13;2983.00;85
7384;12;21866900;7384;437;8640;8725;5.64;0.34;322.77;9.66;1256;13;2984.00;85
7389;12;21866930;7389;432;8640;8725;5.64;0.34;322.97;9.66;1251;13;2985.00;85
7391;12;21866948;7391;430;8641;8725;5.65;0.34;323.06;9.66;1250;13;2986.00;84
7394;12;21866963;7394;430;8641;8725;5.64;0.34;323.15;9.66;1247;13;2987.00;84
7398;12;21866978;7398;432;8650;8737;5.59;0.34;323.31;9.65;1252;13;2988.00;87
7399;12;21866994;7399;435;8650;8737;5.53;0.34;323.34;9.65;1251;13;2989.00;87
7401;12;21867009;7401;443;8651;8737;5.48;0.33;323.42;9.65;1250;13;2990.00;86
7405;12;21867023;7405;447;8652;8737;5.37;0.33;323.47;9.65;1247;13;2991.00;85
7407;12;21867038;7407;449;8652;8737;5.34;0.33;323.52;9.65;1245;13;2992.00;85
7414;12;21867052;7414;446;8652;8737;5.27;0.32;323.63;9.65;1238;13;2993.00;85
7417;12;21867067;7417;436;8652;8738;5.25;0.32;323.72;9.65;1235;13;2994.00;86
7419;12;21867081;7419;426;8652;8738;5.25;0.32;323.80;9.65;1233;13;2995.00;86
7424;12;21867095;7424;427;8656;8744;5.29;0.32;324.11;9.65;1232;13;2996.00;88
7426;12;21867110;7426;427;8657;8745;5.32;0.33;324.26;9.65;1231;13;2997.00;88
7432;12;21867124;7432;436;8658;8745;5.33;0.33;324.31;9.65;1226;13;2998.00;87
7435;12;21867139;7435;436;8659;8745;5.35;0.33;324.37;9.65;1224;13;2999.00;86
7438;12;21867156;7438;445;8666;8765;5.38;0.33;324.32;9.65;1228;13;3000.00;99
7442;12;21867177;7442;444;8666;8765;5.38;0.33;324.34;9.65;1224;13;3001.00;99
7446;12;21867192;7446;443;8668;8765;5.35;0.33;324.38;9.65;1222;13;3002.00;97
7449;12;21867206;7449;449;8671;8766;5.36;0.33;324.51;9.65;1222;13;3003.00;95
7457;12;21867220;7457;455;8676;8770;5.32;0.33;324.62;9.64;1219;13;3004.00;94
7460;12;21867235;7460;461;8677;8770;5.31;0.32;324.72;9.64;1217;13;3005.00;93
7463;12;21867249;7463;470;8680;8773;5.30;0.32;324.78;9.64;1217;13;3006.00;93
7467;12;21867264;7467;469;8680;8773;5.21;0.32;324.84;9.64;1213;13;3007.00;93
7467;12;21867278;7467;473;8681;8773;5.19;0.32;324.84;9.64;1214;13;3008.00;92
7470;12;21867291;7470;478;8681;8773;5.18;0.32;324.86;9.64;1211;13;3009.00;92
7476;12;21867304;7476;485;8685;8777;5.10;0.31;324.92;9.64;1209;13;3010.00;92
7479;12;21867319;7479;490;8686;8777;5.04;0.31;324.94;9.64;1207;13;3011.00;91
7484;12;21867333;7484;488;8687;8777;4.97;0.30;325.09;9.64;1203;13;3012.00;90
7491;12;21867349;7491;495;8687;8777;4.87;0.30;325.11;9.64;1196;13;3013.00;90
7493;12;21867363;7493;500;8688;8778;4.83;0.30;325.08;9.64;1195;13;3014.00;90
7494;12;21867376;7494;506;8690;8780;4.83;0.30;325.06;9.64;1196;13;3015.00;90
7499;12;21867389;7499;504;8690;8780;4.76;0.29;325.19;9.64;1191;13;3016.00;90
7501;12;21867403;7501;506;8691;8781;4.72;0.29;325.28;9.63;1190;13;3017.00;90
7502;12;21867416;7502;513;8692;8781;4.64;0.28;325.37;9.64;1190;13;3018.00;89
7504;12;21867430;7504;512;8692;8781;4.55;0.28;325.30;9.64;1188;13;3019.00;89
7507;12;21867443;7507;521;8692;8781;4.49;0.28;325.25;9.64;1185;13;3020.00;89
7508;12;21867478;7508;531;8692;8781;4.47;0.27;325.32;9.64;1184;13;3021.00;89
7511;12;21867493;7511;527;8692;8781;4.44;0.27;325.26;9.64;1181;13;3022.00;89
7511;12;21867507;7511;526;8692;8781;4.43;0.27;325.26;9.64;1181;13;3023.00;89
7513;12;21867520;7513;536;8759;8908;4.83;0.30;325.27;9.56;1246;13;3024.00;149
7515;12;21867543;7515;525;8763;8909;4.86;0.30;325.24;9.56;1248;13;3025.00;146
7517;12;21867559;7517;523;8771;8909;4.96;0.31;325.21;9.55;1254;13;3026.00;138
7520;12;21867573;7520;523;8774;8909;4.99;0.31;325.21;9.55;1254;13;3027.00;135
7523;12;21867587;7523;515;8779;8909;5.02;0.31;325.17;9.55;1256;13;3028.00;130
7527;12;21867601;7527;509;8783;8909;5.04;0.31;325.21;9.55;1256;13;3029.00;126
7530;12;21867617;7530;508;8787;8909;5.07;0.31;325.11;9.56;1257;13;3030.00;122
7533;12;21867632;7533;485;8789;8909;5.08;0.31;325.13;9.55;1256;14;3031.00;120
7539;12;21867656;7539;476;8792;8910;5.08;0.31;325.30;9.55;1253;14;3032.00;118
7539;12;21867671;7539;465;8795;8911;5.11;0.31;325.30;9.55;1256;14;3033.00;116
7541;12;21867686;7541;461;8797;8911;5.13;0.32;325.27;9.55;1256;14;3034.00;114
7542;12;21867700;7542;457;8800;8912;5.13;0.32;325.28;9.55;1258;14;3035.00;112
7544;12;21867715;7544;461;8805;8912;5.11;0.31;325.28;9.56;1261;14;3036.00;107
7545;12;21867730;7545;451;8807;8912;5.14;0.32;325.30;9.56;1262;14;3037.00;105
7548;12;21867744;7548;458;8810;8912;5.16;0.32;325.28;9.56;1262;14;3038.00;102
7549;12;21867759;7549;470;8814;8916;5.18;0.32;325.29;9.56;1265;14;3039.00;102
7551;12;21867775;7551;471;8815;8916;5.21;0.32;325.38;9.56;1264;14;3040.00;101
7552;12;21867790;7552;476;8815;8916;5.21;0.32;325.35;9.56;1263;14;3041.00;101
7554;12;21867805;7554;484;8818;8919;5.24;0.32;325.35;9.56;1264;14;3042.00;101
7555;12;21867821;7555;487;8819;8919;5.28;0.32;325.32;9.56;1264;14;3043.00;100
7559;12;21867836;7559;493;8821;8919;5.23;0.32;325.39;9.56;1262;14;3044.00;98
7559;12;21867853;7559;496;8824;8923;5.26;0.32;325.39;9.56;1265;14;3045.00;99
7560;12;21867874;7560;488;8825;8924;5.28;0.32;325.41;9.56;1265;14;3046.00;99
7563;12;21867895;7563;495;8826;8924;5.24;0.32;325.33;9.56;1263;14;3047.00;98
7565;12;21867915;7565;498;8829;8928;5.21;0.32;325.31;9.55;1264;14;3048.00;99
7565;12;21867933;7565;503;8829;8928;5.16;0.31;325.31;9.55;1264;14;3049.00;99
7565;12;21867951;7565;489;8831;8928;5.13;0.31;325.31;9.55;1266;14;3050.00;97
7565;12;21867968;7565;475;8832;8929;5.10;0.31;325.31;9.55;1267;14;3051.00;97
7566;12;21867984;7566;467;8832;8929;5.10;0.31;325.27;9.55;1266;14;3052.00;97
7569;12;21867999;7569;464;8837;8935;5.13;0.31;325.27;9.55;1268;14;3053.00;98
7573;12;21868016;7573;466;8837;8935;5.11;0.31;325.26;9.55;1264;14;3054.00;98
7574;12;21868032;7574;470;8837;8936;5.11;0.31;325.26;9.55;1263;14;3055.00;99
7576;12;21868047;7576;467;8837;8936;5.13;0.31;325.25;9.55;1261;14;3056.00;99
7579;12;21868069;7579;465;8837;8936;5.11;0.31;325.22;9.55;1258;14;3057.00;99
7580;12;21868087;7580;470;8837;8936;5.10;0.31;325.24;9.55;1257;14;3058.00;99
7580;12;21868108;7580;472;8837;8936;5.09;0.31;325.24;9.55;1257;14;3059.00;99
7581;12;21868125;7581;478;8863;8972;5.17;0.32;325.24;9.52;1282;14;3060.00;109
7582;12;21868143;7582;476;8865;8972;5.20;0.32;325.23;9.52;1283;14;3061.00;107
7584;12;21868157;7584;473;8866;8972;5.20;0.32;325.23;9.52;1282;14;3062.00;106
7585;12;21868173;7585;474;8866;8972;5.21;0.32;325.24;9.52;1281;14;3063.00;106
7585;12;21868188;7585;470;8867;8972;5.26;0.32;325.24;9.52;1282;14;3064.00;105
7588;12;21868204;7588;470;8867;8972;5.25;0.32;325.25;9.52;1279;14;3065.00;105
7588;12;21868219;7588;462;8871;8976;5.30;0.32;325.25;9.51;1283;14;3066.00;105
7588;12;21868235;7588;455;8872;8976;5.37;0.33;325.25;9.52;1284;14;3067.00;104
7591;12;21868250;7591;449;8875;8980;5.45;0.33;325.27;9.51;1284;14;3068.00;105
7593;12;21868266;7593;437;8876;8981;5.53;0.34;325.30;9.51;1283;14;3069.00;105
7595;12;21868281;7595;429;8876;8981;5.56;0.34;325.30;9.51;1281;14;3070.00;105
7597;12;21868296;7597;424;8876;8981;5.59;0.34;325.35;9.51;1279;14;3071.00;105
7597;12;21868311;7597;420;8885;8994;5.68;0.35;325.35;9.50;1288;14;3072.00;109
7598;12;21868328;7598;411;8885;8994;5.74;0.35;325.34;9.50;1287;14;3073.00;109
7599;13;21868343;7599;411;8885;8994;5.79;0.35;325.32;9.50;1286;15;3074.00;109
7602;13;21868365;7602;408;8886;8995;5.83;0.35;325.35;9.50;1284;15;3075.00;109
7603;13;21868381;7603;409;8886;8996;5.89;0.36;325.34;9.50;1283;15;3076.00;110
7607;13;21868397;7607;404;8886;8996;5.90;0.36;325.34;9.50;1279;15;3077.00;110
7611;13;21868413;7611;404;8888;8999;5.91;0.36;325.34;9.50;1277;15;3078.00;111
7612;14;21868428;7612;399;8889;8999;5.90;0.36;325.34;9.50;1277;16;3079.00;110
7616;14;21868455;7616;397;8891;8999;5.86;0.36;325.37;9.58;1275;16;3080.00;108
7616;14;21868473;7616;389;8891;8999;5.91;0.36;325.37;9.58;1275;16;3081.00;108
7619;14;21868488;7619;388;8897;9005;5.95;0.36;325.41;9.58;1278;16;3082.00;108
7620;14;21868504;7620;388;8898;9005;5.98;0.36;325.42;9.58;1278;16;3083.00;107
7624;14;21868519;7624;392;8898;9005;5.98;0.36;325.46;9.58;1274;16;3084.00;107
7625;14;21868534;7625;391;8898;9005;5.99;0.36;325.49;9.58;1273;16;3085.00;107
7627;14;21868554;7627;396;8901;9009;6.01;0.37;325.48;9.58;1274;16;3086.00;108
7628;14;21868569;7628;399;8902;9010;6.03;0.37;325.47;9.57;1274;16;3087.00;108
7632;14;21868585;7632;401;8902;9010;6.04;0.37;325.38;9.57;1270;16;3088.00;108
7636;14;21868600;7636;396;8903;9011;6.08;0.37;325.51;9.57;1267;16;3089.00;108
7640;14;21868618;7640;400;8904;9011;6.07;0.37;325.48;9.58;1264;16;3090.00;107
7640;14;21868633;7640;397;8904;9011;6.10;0.37;325.48;9.58;1264;16;3091.00;107
7641;14;21868648;7641;396;8904;9011;6.14;0.37;325.45;9.58;1263;16;3092.00;107
7643;14;21868662;7643;399;8904;9011;6.13;0.37;325.53;9.58;1261;16;3093.00;107
7643;14;21868677;7643;401;8905;9011;6.13;0.37;325.53;9.58;1262;16;3094.00;106
7649;14;21868692;7649;404;8905;9011;6.07;0.37;325.42;9.58;1256;16;3095.00;106
7653;14;21868712;7653;409;8938;9081;6.14;0.37;325.58;9.55;1285;16;3096.00;143
7654;14;21868733;7654;402;8940;9082;6.15;0.37;325.64;9.55;1286;16;3097.00;142
7655;14;21868749;7655;403;8947;9082;6.20;0.38;325.74;9.55;1292;16;3098.00;135
7656;14;21868764;7656;402;8950;9082;6.23;0.38;325.79;9.54;1294;16;3099.00;132
7658;14;21868781;7658;402;8952;9082;6.21;0.38;325.88;9.54;1294;16;3100.00;130
7661;14;21868805;7661;413;8956;9082;6.17;0.38;325.84;9.54;1295;16;3101.00;126
7664;14;21868828;7664;413;8959;9082;6.16;0.38;325.93;9.54;1295;16;3102.00;123
7667;14;21868843;7667;413;8962;9082;6.13;0.37;326.06;9.54;1295;16;3103.00;120
7668;14;21868858;7668;417;8965;9083;6.16;0.37;326.14;9.54;1297;16;3104.00;118
7671;14;21868873;7671;412;8969;9085;6.10;0.37;326.29;9.58;1298;16;3105.00;116
7671;14;21868889;7671;414;8971;9085;6.14;0.37;326.29;9.58;1300;16;3106.00;114
7673;14;21868904;7673;414;8977;9089;6.13;0.37;326.26;9.58;1304;16;3107.00;112
7677;14;21868919;7677;420;8979;9089;6.09;0.37;326.25;9.58;1302;16;3108.00;110
7680;14;21868935;7680;425;8981;9089;6.02;0.37;326.29;9.66;1301;16;3109.00;108
7687;14;21868951;7687;431;8981;9089;5.99;0.36;326.55;9.66;1294;16;3110.00;108
7689;14;21868967;7689;437;8987;9095;6.02;0.37;326.75;9.70;1298;16;3111.00;108
7691;14;21868983;7691;442;8987;9095;5.96;0.36;326.87;9.70;1296;16;3112.00;108
7693;14;21868999;7693;449;8987;9095;5.96;0.36;327.00;9.70;1294;16;3113.00;108
7698;14;21869015;7698;449;8990;9098;5.97;0.36;327.25;9.74;1292;16;3114.00;108
7700;14;21869030;7700;463;8990;9098;5.95;0.36;327.42;9.74;1290;16;3115.00;108
7700;14;21869045;7700;466;8991;9098;5.96;0.36;327.42;9.74;1291;16;3116.00;107
7701;14;21869060;7701;460;8993;9099;5.92;0.36;327.45;9.82;1292;16;3117.00;106
7707;14;21869075;7707;464;8994;9100;5.86;0.36;327.44;9.82;1287;16;3118.00;106
7708;14;21869090;7708;462;8996;9100;5.82;0.36;327.55;9.91;1288;16;3119.00;104
7712;14;21869107;7712;472;9016;9126;5.82;0.36;327.56;9.93;1304;16;3120.00;110
7717;14;21869124;7717;473;9017;9126;5.78;0.35;327.47;9.97;1300;16;3121.00;109
7719;14;21869139;7719;476;9019;9126;5.74;0.35;327.53;9.97;1300;16;3122.00;107
7721;14;21869154;7721;480;9021;9127;5.78;0.35;327.51;9.96;1300;16;3123.00;106
7724;14;21869169;7724;479;9023;9127;5.74;0.35;327.59;10.05;1299;16;3124.00;104
7727;14;21869184;7727;477;9027;9131;5.73;0.35;327.66;10.04;1300;16;3125.00;104
7730;14;21869199;7730;472;9027;9131;5.70;0.35;327.67;10.04;1297;16;3126.00;104
7732;14;21869214;7732;472;9032;9135;5.62;0.34;327.69;10.12;1300;16;3127.00;103
7734;14;21869230;7734;471;9032;9135;5.60;0.34;327.65;10.12;1298;16;3128.00;103
7735;14;21869244;7735;467;9032;9135;5.60;0.34;327.67;10.12;1297;16;3129.00;103
7738;14;21869259;7738;462;9034;9135;5.58;0.34;327.78;10.20;1296;16;3130.00;101
7740;14;21869274;7740;466;9034;9135;5.56;0.34;327.79;10.20;1294;16;3131.00;101
7744;14;21869288;7744;459;9044;9147;5.62;0.34;327.88;10.19;1300;16;3132.00;103
7746;14;21869304;7746;467;9046;9147;5.65;0.35;328.03;10.27;1300;16;3133.00;101
7747;14;21869319;7747;469;9047;9147;5.63;0.34;328.01;10.27;1300;16;3134.00;100
7751;14;21869333;7751;467;9047;9147;5.62;0.34;328.05;10.27;1296;16;3135.00;100
7753;14;21869348;7753;469;9049;9147;5.64;0.34;328.04;10.34;1296;16;3136.00;98
7757;14;21869362;7757;471;9049;9147;5.65;0.35;328.18;10.34;1292;16;3137.00;98
7758;14;21869376;7758;465;9049;9148;5.61;0.34;328.24;10.34;1291;16;3138.00;99
7761;14;21869390;7761;469;9049;9148;5.63;0.34;328.27;10.34;1288;16;3139.00;99
7765;14;21869410;7765;472;9054;9154;5.65;0.35;328.35;10.34;1289;16;3140.00;100
7774;14;21869425;7774;477;9055;9155;5.58;0.34;328.54;10.34;1281;16;3141.00;100
7776;14;21869439;7776;477;9055;9155;5.50;0.34;328.52;10.34;1279;16;3142.00;100
7781;14;21869453;7781;482;9055;9155;5.42;0.33;328.52;10.34;1274;16;3143.00;100
7787;14;21869467;7787;486;9058;9159;5.36;0.33;328.66;10.33;1271;16;3144.00;101
7792;14;21869481;7792;486;9058;9159;5.28;0.32;328.61;10.33;1266;16;3145.00;101
7799;14;21869494;7799;485;9058;9159;5.17;0.32;328.69;10.33;1259;16;3146.00;101
7805;14;21869508;7805;490;9059;9160;5.07;0.31;328.79;10.33;1254;16;3147.00;101
7806;14;21869521;7806;497;9062;9164;4.99;0.30;328.83;10.33;1256;16;3148.00;102
7811;14;21869534;7811;493;9062;9164;4.90;0.30;328.75;10.33;1251;16;3149.00;102
7817;14;21869548;7817;484;9066;9170;4.85;0.30;328.77;10.32;1249;16;3150.00;104
7819;14;21869562;7819;482;9066;9170;4.81;0.29;328.71;10.32;1247;16;3151.00;104
7826;14;21869575;7826;478;9068;9170;4.79;0.29;328.72;10.32;1242;16;3152.00;102
7830;14;21869588;7830;477;9068;9170;4.80;0.29;328.69;10.32;1238;16;3153.00;102
7833;14;21869601;7833;470;9072;9174;4.86;0.30;328.76;10.32;1239;16;3154.00;102
7838;14;21869614;7838;467;9072;9174;4.88;0.30;328.92;10.32;1234;16;3155.00;102
7841;14;21869628;7841;471;9072;9174;4.88;0.30;328.96;10.32;1231;16;3156.00;102
7844;14;21869641;7844;459;9072;9174;4.91;0.30;329.03;10.32;1228;16;3157.00;102
7848;14;21869654;7848;455;9072;9175;4.91;0.30;329.23;10.32;1224;16;3158.00;103
7854;14;21869668;7854;445;9073;9176;4.88;0.30;329.48;10.32;1219;16;3159.00;103
7855;14;21869681;7855;438;9073;9176;4.88;0.30;329.49;10.32;1218;16;3160.00;103
7859;14;21869694;7859;443;9074;9177;4.91;0.30;329.51;10.32;1215;16;3161.00;103
7861;14;21869707;7861;440;9074;9177;4.92;0.30;329.58;10.32;1213;16;3162.00;103
7865;14;21869721;7865;441;9074;9177;4.95;0.30;329.80;10.32;1209;16;3163.00;103
7868;14;21869734;7868;441;9074;9177;4.95;0.30;329.89;10.32;1206;16;3164.00;103
7874;14;21869748;7874;447;9074;9177;4.99;0.31;329.89;10.32;1200;16;3165.00;103
7877;14;21869761;7877;450;9074;9177;5.02;0.31;329.95;10.32;1197;16;3166.00;103
7881;14;21869774;7881;450;9074;9177;5.01;0.31;330.06;10.32;1193;16;3167.00;103
7882;14;21869788;7882;455;9138;9304;5.46;0.34;330.09;10.24;1256;16;3168.00;166
7885;14;21869812;7885;463;9142;9305;5.44;0.34;330.07;10.24;1257;16;3169.00;163
7889;14;21869826;7889;467;9152;9305;5.45;0.34;330.11;10.23;1263;16;3170.00;153
7895;14;21869840;7895;474;9156;9305;5.41;0.34;330.06;10.23;1261;16;3171.00;149
7898;14;21869855;7898;485;9162;9305;5.36;0.33;330.09;10.22;1264;16;3172.00;143
7902;14;21869874;7902;487;9164;9305;5.29;0.33;330.18;10.22;1262;16;3173.00;141
7905;14;21869893;7905;495;9168;9305;5.24;0.32;330.19;10.23;1263;16;3174.00;137
7913;14;21869912;7913;493;9170;9305;5.13;0.32;330.22;10.23;1257;16;3175.00;135
7917;14;21869931;7917;508;9173;9306;5.08;0.31;330.18;10.23;1256;16;3176.00;133
7921;14;21869949;7921;509;9177;9307;5.00;0.31;330.13;10.23;1256;16;3177.00;130
7925;14;21869965;7925;511;9179;9307;4.93;0.31;330.26;10.23;1254;16;3178.00;128
7929;14;21869982;7929;512;9182;9308;4.85;0.30;330.20;10.23;1253;16;3179.00;126
7934;14;21869999;7934;515;9183;9308;4.79;0.30;330.30;10.23;1249;16;3180.00;125
7936;14;21870015;7936;509;9186;9308;4.79;0.30;330.33;10.23;1250;16;3181.00;122
7942;14;21870029;7942;515;9187;9308;4.76;0.30;330.36;10.23;1245;16;3182.00;121
7947;14;21870043;7947;522;9191;9312;4.70;0.29;330.37;10.23;1244;16;3183.00;121
7950;14;21870058;7950;518;9194;9312;4.70;0.29;330.34;10.23;1244;16;3184.00;118
7952;14;21870072;7952;514;9195;9312;4.70;0.29;330.31;10.23;1243;16;3185.00;117
7957;14;21870087;7957;526;9197;9315;4.64;0.29;330.25;10.23;1240;16;3186.00;118
7961;14;21870103;7961;526;9198;9315;4.61;0.29;330.25;10.23;1237;16;3187.00;117
7964;14;21870117;7964;530;9198;9315;4.57;0.28;330.22;10.23;1234;16;3188.00;117
7970;14;21870131;7970;530;9202;9319;4.54;0.28;330.16;10.23;1232;16;3189.00;117
7974;14;21870146;7974;532;9204;9320;4.49;0.28;330.12;10.23;1230;16;3190.00;116
7978;14;21870159;7978;540;9207;9322;4.38;0.27;330.06;10.24;1229;16;3191.00;115
7982;14;21870173;7982;537;9212;9326;4.35;0.27;330.10;10.23;1230;16;3192.00;114
7983;14;21870206;7983;540;9212;9326;4.32;0.27;330.16;10.23;1229;16;3193.00;114
7984;14;21870222;7984;544;9212;9326;4.31;0.27;330.12;10.23;1228;16;3194.00;114
7987;14;21870235;7987;549;9215;9328;4.26;0.26;330.11;10.24;1228;16;3195.00;113
7988;14;21870249;7988;559;9215;9328;4.19;0.26;330.11;10.24;1227;16;3196.00;113
7989;14;21870262;7989;547;9220;9334;4.21;0.26;330.10;10.23;1231;16;3197.00;114
7990;14;21870276;7990;542;9220;9334;4.22;0.26;330.10;10.23;1230;16;3198.00;114
7992;14;21870289;7992;538;9220;9335;4.24;0.26;330.11;10.23;1228;16;3199.00;115
7994;14;21870304;7994;534;9220;9335;4.28;0.26;330.08;10.23;1226;16;3200.00;115
7997;14;21870321;7997;536;9220;9335;4.28;0.26;330.10;10.23;1223;16;3201.00;115
8000;14;21870335;8000;539;9221;9335;4.29;0.26;329.99;10.24;1221;16;3202.00;114
8002;14;21870348;8002;532;9221;9335;4.29;0.26;329.96;10.24;1219;16;3203.00;114
8002;14;21870362;8002;537;9230;9347;4.40;0.27;329.96;10.23;1228;16;3204.00;117
8007;14;21870376;8007;540;9230;9347;4.41;0.27;329.97;10.23;1223;16;3205.00;117
8008;14;21870396;8008;526;9232;9347;4.46;0.27;330.05;10.23;1224;16;3206.00;115
8009;14;21870416;8009;504;9232;9347;4.53;0.28;330.08;10.23;1223;16;3207.00;115
8010;14;21870430;8010;490;9232;9347;4.62;0.28;330.08;10.23;1222;16;3208.00;115
8010;14;21870445;8010;473;9232;9347;4.76;0.29;330.08;10.23;1222;16;3209.00;115
8012;14;21870460;8012;466;9235;9351;4.84;0.29;330.07;10.22;1223;16;3210.00;116
8012;14;21870481;8012;454;9235;9351;4.99;0.30;330.07;10.22;1223;16;3211.00;116
8014;14;21870496;8014;450;9239;9355;5.14;0.31;330.13;10.22;1225;16;3212.00;116
8016;14;21870518;8016;446;9241;9356;5.26;0.32;330.11;10.22;1225;16;3213.00;115
8017;14;21870539;8017;436;9241;9356;5.45;0.33;330.11;10.22;1224;16;3214.00;115
8018;14;21870554;8018;426;9241;9356;5.57;0.34;330.11;10.22;1223;16;3215.00;115
8019;14;21870569;8019;422;9252;9369;5.71;0.35;330.11;10.21;1233;16;3216.00;117
8021;14;21870585;8021;416;9252;9369;5.78;0.35;330.18;10.21;1231;16;3217.00;117
8021;14;21870601;8021;419;9252;9369;5.84;0.36;330.18;10.21;1231;16;3218.00;117
8024;14;21870616;8024;415;9253;9370;5.92;0.36;330.24;10.21;1229;16;3219.00;117
8024;14;21870632;8024;418;9253;9371;5.99;0.36;330.24;10.21;1229;16;3220.00;118
8026;15;21870647;8026;415;9253;9371;6.03;0.37;330.23;10.21;1227;17;3221.00;118
8027;15;21870680;8027;418;9255;9374;6.12;0.37;330.23;10.21;1228;17;3222.00;119
8027;15;21870695;8027;411;9255;9374;6.11;0.37;330.23;10.21;1228;17;3223.00;119
8027;15;21870723;8027;407;9256;9374;6.14;0.37;330.23;10.21;1229;17;3224.00;118
8028;15;21870737;8028;401;9256;9374;6.11;0.37;330.22;10.21;1228;17;3225.00;118
8030;15;21870752;8030;394;9261;9380;6.14;0.37;330.35;10.20;1231;17;3226.00;119
8033;15;21870768;8033;397;9261;9380;6.12;0.37;330.33;10.20;1228;17;3227.00;119
8036;15;21870783;8036;395;9261;9380;6.09;0.37;330.32;10.20;1225;17;3228.00;119
8039;15;21870799;8039;384;9261;9380;6.13;0.37;330.30;10.20;1222;17;3229.00;119
8043;15;21870814;8043;389;9264;9384;6.14;0.37;330.41;10.20;1221;17;3230.00;120
8049;15;21870829;8049;384;9265;9385;6.12;0.37;330.63;10.20;1216;17;3231.00;120
8050;15;21870845;8050;387;9265;9385;6.15;0.37;330.60;10.20;1215;17;3232.00;120
8052;15;21870861;8052;392;9266;9386;6.20;0.37;330.64;10.20;1214;17;3233.00;120
8053;15;21870875;8053;384;9266;9386;6.23;0.38;330.62;10.20;1213;17;3234.00;120
8053;15;21870890;8053;395;9266;9386;6.25;0.38;330.62;10.20;1213;17;3235.00;120
8055;15;21870905;8055;397;9266;9386;6.27;0.38;330.70;10.20;1211;17;3236.00;120
8059;15;21870919;8059;389;9266;9386;6.24;0.38;330.74;10.20;1207;17;3237.00;120
8061;15;21870934;8061;397;9266;9386;6.22;0.38;330.86;10.20;1205;17;3238.00;120
8065;15;21870949;8065;399;9266;9386;6.23;0.38;330.94;10.20;1201;17;3239.00;120
8067;15;21870966;8067;416;9330;9511;6.30;0.39;331.03;10.13;1263;17;3240.00;181
8068;15;21870991;8068;400;9330;9512;6.37;0.39;331.02;10.13;1262;17;3241.00;182
8074;15;21871007;8074;383;9338;9512;6.38;0.39;331.27;10.12;1264;17;3242.00;174
8076;15;21871023;8076;374;9338;9512;6.36;0.39;331.24;10.12;1262;17;3243.00;174
8078;15;21871038;8078;362;9343;9512;6.41;0.39;331.30;10.12;1265;17;3244.00;169
8080;15;21871055;8080;362;9344;9512;6.47;0.39;331.35;10.12;1264;17;3245.00;168
8085;15;21871071;8085;360;9348;9512;6.55;0.40;331.44;10.12;1263;17;3246.00;164
8089;15;21871087;8089;361;9351;9512;6.57;0.40;331.46;10.12;1262;17;3247.00;161
8092;15;21871102;8092;371;9357;9513;6.61;0.40;331.53;10.12;1265;17;3248.00;156
8095;15;21871118;8095;368;9358;9514;6.62;0.40;331.56;10.12;1263;17;3249.00;156
8098;15;21871134;8098;372;9362;9514;6.60;0.40;331.81;10.12;1264;17;3250.00;152
8103;15;21871150;8103;366;9367;9518;6.56;0.40;331.87;10.12;1264;17;3251.00;151
8108;15;21871166;8108;374;9369;9518;6.51;0.40;332.04;10.12;1261;17;3252.00;149
8109;15;21871181;8109;368;9371;9518;6.47;0.39;332.14;10.12;1262;17;3253.00;147
8112;15;21871196;8112;371;9372;9518;6.40;0.39;332.25;10.12;1260;17;3254.00;146
8116;15;21871212;8116;368;9378;9524;6.32;0.38;332.26;10.21;1262;17;3255.00;146
8119;15;21871230;8119;375;9378;9524;6.30;0.38;332.36;10.21;1259;17;3256.00;146
8123;15;21871245;8123;377;9378;9524;6.32;0.38;332.45;10.21;1255;17;3257.00;146
8126;15;21871261;8126;375;9381;9527;6.27;0.38;332.59;10.21;1255;17;3258.00;146
8127;15;21871276;8127;375;9381;9527;6.28;0.38;332.60;10.21;1254;17;3259.00;146
8131;15;21871292;8131;388;9381;9527;6.17;0.38;332.75;10.21;1250;17;3260.00;146
8132;15;21871307;8132;383;9381;9528;6.13;0.37;332.72;10.21;1249;17;3261.00;147
8134;15;21871322;8134;378;9382;9529;6.09;0.37;332.73;10.21;1248;17;3262.00;147
8137;15;21871337;8137;383;9382;9529;6.04;0.37;332.66;10.21;1245;17;3263.00;147
8138;15;21871352;8138;385;9391;9542;6.07;0.37;332.66;10.20;1253;17;3264.00;151
8141;15;21871368;8141;386;9391;9542;6.10;0.37;332.75;10.20;1250;17;3265.00;151
8144;15;21871385;8144;376;9393;9542;6.15;0.37;332.75;10.20;1249;17;3266.00;149
8147;15;21871400;8147;377;9394;9543;6.21;0.38;332.75;10.20;1247;17;3267.00;149
8150;15;21871416;8150;372;9394;9543;6.23;0.38;332.71;10.20;1244;17;3268.00;149
8154;15;21871432;8154;367;9397;9547;6.27;0.38;332.79;10.20;1243;17;3269.00;150
8156;15;21871450;8156;365;9397;9547;6.33;0.39;332.73;10.20;1241;17;3270.00;150
8157;15;21871465;8157;360;9400;9551;6.34;0.39;332.73;10.19;1243;17;3271.00;151
8158;15;21871481;8158;360;9402;9551;6.34;0.39;332.76;10.19;1244;17;3272.00;149
8160;15;21871496;8160;358;9402;9551;6.36;0.39;332.76;10.19;1242;17;3273.00;149
8163;15;21871512;8163;349;9402;9551;6.34;0.39;332.79;10.19;1239;17;3274.00;149
8167;15;21871529;8167;345;9402;9551;6.36;0.39;332.86;10.19;1235;17;3275.00;149
8170;15;21871544;8170;349;9415;9563;6.43;0.39;332.99;10.19;1245;17;3276.00;148
8171;15;21871561;8171;349;9415;9563;6.44;0.39;333.06;10.19;1244;17;3277.00;148
8175;15;21871576;8175;354;9415;9563;6.42;0.39;333.08;10.19;1240;17;3278.00;148
8176;15;21871592;8176;362;9417;9563;6.39;0.39;333.10;10.24;1241;17;3279.00;146
8179;15;21871606;8179;368;9418;9563;6.33;0.39;333.19;10.24;1239;17;3280.00;145
8180;15;21871621;8180;368;9419;9563;6.27;0.38;333.24;10.24;1239;17;3281.00;144
8182;15;21871637;8182;375;9420;9564;6.19;0.38;333.24;10.29;1238;17;3282.00;144
8185;15;21871652;8185;382;9420;9564;6.19;0.38;333.28;10.29;1235;17;3283.00;144
8187;15;21871667;8187;385;9427;9570;6.23;0.38;333.29;10.39;1240;17;3284.00;143
8190;15;21871683;8190;389;9430;9572;6.20;0.38;333.40;10.43;1240;17;3285.00;142
8194;15;21871699;8194;394;9430;9572;6.18;0.38;333.56;10.43;1236;17;3286.00;142
8196;15;21871714;8196;390;9431;9572;6.17;0.38;333.61;10.48;1235;17;3287.00;141
8202;15;21871729;8202;403;9435;9576;6.15;0.38;333.67;10.53;1233;17;3288.00;141
8204;15;21871750;8204;402;9436;9576;6.10;0.37;333.71;10.58;1232;17;3289.00;140
8207;15;21871765;8207;405;9438;9576;6.08;0.37;333.65;10.67;1231;17;3290.00;138
8211;15;21871781;8211;412;9439;9577;6.02;0.37;333.79;10.67;1228;17;3291.00;138
8214;15;21871798;8214;409;9444;9581;6.01;0.37;333.82;10.76;1230;17;3292.00;137
8216;15;21871813;8216;415;9444;9581;6.00;0.37;333.95;10.76;1228;17;3293.00;137
8217;15;21871828;8217;413;9446;9584;6.02;0.37;334.00;10.76;1229;17;3294.00;138
8220;15;21871849;8220;418;9449;9584;5.98;0.37;333.98;10.85;1229;17;3295.00;135
8222;15;21871869;8222;416;9449;9584;5.96;0.37;334.08;10.85;1227;17;3296.00;135
8225;15;21871887;8225;418;9451;9584;5.91;0.36;334.17;10.94;1226;17;3297.00;133
8225;15;21871907;8225;421;9455;9588;5.96;0.37;334.17;10.94;1230;17;3298.00;133
8229;15;21871924;8229;409;9455;9588;5.91;0.36;334.33;10.94;1226;17;3299.00;133
8232;15;21871946;8232;411;9460;9607;5.88;0.36;334.35;10.93;1228;17;3300.00;147
8236;15;21871976;8236;402;9460;9607;5.81;0.36;334.34;10.93;1224;17;3301.00;147
8239;15;21871991;8239;403;9460;9608;5.75;0.35;334.39;10.93;1221;17;3302.00;148
8243;15;21872006;8243;403;9465;9609;5.70;0.35;334.41;11.11;1222;17;3303.00;144
8246;15;21872020;8246;399;9465;9609;5.65;0.35;334.51;11.11;1219;17;3304.00;144
8249;15;21872034;8249;397;9468;9610;5.64;0.35;334.48;11.20;1219;17;3305.00;142
8253;15;21872048;8253;404;9470;9610;5.61;0.34;334.54;11.20;1217;17;3306.00;140
8255;15;21872062;8255;410;9470;9610;5.60;0.34;334.65;11.20;1215;17;3307.00;140
8259;15;21872076;8259;407;9472;9610;5.62;0.34;334.68;11.28;1213;17;3308.00;138
8260;15;21872090;8260;405;9472;9610;5.67;0.35;334.74;11.28;1212;17;3309.00;138
8263;15;21872103;8263;409;9472;9610;5.70;0.35;334.72;11.28;1209;17;3310.00;138
8265;15;21872116;8265;413;9474;9610;5.70;0.35;334.88;11.37;1209;17;3311.00;136
8268;15;21872130;8268;430;9538;9737;5.92;0.37;334.85;11.30;1270;17;3312.00;199
8270;15;21872154;8270;428;9543;9738;5.96;0.37;334.95;11.29;1273;17;3313.00;195
8275;15;21872169;8275;428;9554;9738;5.94;0.37;335.04;11.37;1279;17;3314.00;184
8281;15;21872184;8281;433;9557;9738;5.91;0.36;335.10;11.37;1276;17;3315.00;181
8284;15;21872199;8284;439;9563;9738;5.87;0.36;335.16;11.45;1279;17;3316.00;175
8286;15;21872213;8286;445;9566;9738;5.79;0.36;335.25;11.45;1280;17;3317.00;172
8289;15;21872227;8289;450;9571;9738;5.69;0.35;335.34;11.45;1282;17;3318.00;167
8292;15;21872240;8292;453;9573;9738;5.70;0.35;335.33;11.45;1281;17;3319.00;165
8296;15;21872254;8296;460;9576;9739;5.70;0.35;335.44;11.45;1280;17;3320.00;163
8302;15;21872268;8302;466;9578;9740;5.66;0.35;335.51;11.45;1276;17;3321.00;162
8304;15;21872282;8304;468;9580;9740;5.63;0.35;335.52;11.45;1276;17;3322.00;160
8307;15;21872296;8307;477;9584;9741;5.56;0.34;335.53;11.45;1277;17;3323.00;157
8313;15;21872309;8313;488;9587;9741;5.49;0.34;335.64;11.45;1274;17;3324.00;154
8317;15;21872323;8317;479;9590;9741;5.45;0.34;335.60;11.45;1273;17;3325.00;151
8324;15;21872337;8324;473;9591;9741;5.37;0.33;335.67;11.45;1267;17;3326.00;150
8327;15;21872351;8327;475;9594;9745;5.30;0.33;335.70;11.45;1267;17;3327.00;151
8330;15;21872365;8330;480;9597;9745;5.24;0.32;335.68;11.45;1267;17;3328.00;148
8334;15;21872379;8334;487;9599;9745;5.15;0.32;335.67;11.45;1265;17;3329.00;146
8339;15;21872395;8339;492;9602;9751;5.06;0.31;335.65;11.45;1263;17;3330.00;149
8341;15;21872409;8341;495;9603;9751;4.97;0.30;335.72;11.45;1262;17;3331.00;148
8344;15;21872422;8344;496;9603;9751;4.85;0.30;335.80;11.45;1259;17;3332.00;148
8350;15;21872436;8350;487;9608;9755;4.77;0.29;335.97;11.45;1258;17;3333.00;147
8355;15;21872450;8355;484;9611;9756;4.68;0.29;336.03;11.45;1256;17;3334.00;145
8357;15;21872470;8357;490;9612;9756;4.64;0.28;336.08;11.45;1255;17;3335.00;144
8363;15;21872484;8363;487;9615;9760;4.59;0.28;336.04;11.45;1252;17;3336.00;145
8365;15;21872498;8365;488;9615;9760;4.55;0.28;336.09;11.45;1250;17;3337.00;145
8369;15;21872511;8369;487;9615;9760;4.49;0.28;336.11;11.45;1246;17;3338.00;145
8371;15;21872524;8371;488;9616;9761;4.49;0.28;336.15;11.45;1245;17;3339.00;145
8376;15;21872539;8376;492;9618;9761;4.47;0.27;336.01;11.46;1242;17;3340.00;143
8378;15;21872553;8378;494;9624;9767;4.53;0.28;336.07;11.46;1246;17;3341.00;143
8382;15;21872567;8382;492;9625;9767;4.54;0.28;336.16;11.46;1243;17;3342.00;142
8386;15;21872581;8386;488;9626;9768;4.54;0.28;336.19;11.46;1240;17;3343.00;142
8387;15;21872594;8387;492;9626;9768;4.56;0.28;336.21;11.46;1239;17;3344.00;142
8391;15;21872607;8391;502;9628;9768;4.54;0.28;336.28;11.46;1237;17;3345.00;140
8396;15;21872620;8396;505;9629;9768;4.48;0.27;336.29;11.47;1233;17;3346.00;139
8397;15;21872634;8397;503;9629;9768;4.48;0.27;336.31;11.47;1232;17;3347.00;139
8400;15;21872647;8400;506;9639;9780;4.50;0.28;336.29;11.46;1239;17;3348.00;141
8402;15;21872662;8402;511;9641;9780;4.42;0.27;336.27;11.45;1239;17;3349.00;139
8408;15;21872675;8408;514;9641;9780;4.33;0.27;336.33;11.45;1233;17;3350.00;139
8409;15;21872688;8409;515;9642;9780;4.29;0.26;336.29;11.45;1233;17;3351.00;138
8413;15;21872701;8413;520;9643;9780;4.20;0.26;336.27;11.45;1230;17;3352.00;137
8417;15;21872715;8417;511;9643;9780;4.17;0.26;336.31;11.45;1226;17;3353.00;137
8422;15;21872728;8422;520;9646;9784;4.15;0.26;336.27;11.45;1224;17;3354.00;138
8427;15;21872742;8427;517;9646;9784;4.06;0.25;336.28;11.45;1219;17;3355.00;138
8431;15;21872754;8431;522;9650;9788;4.07;0.25;336.29;11.45;1219;17;3356.00;138
8434;15;21872768;8434;526;9651;9789;4.02;0.25;336.22;11.44;1217;17;3357.00;138
8436;15;21872781;8436;534;9652;9789;3.98;0.25;336.24;11.46;1216;17;3358.00;137
8437;15;21872795;8437;533;9652;9789;3.97;0.24;336.26;11.46;1215;17;3359.00;137
8441;15;21872809;8441;546;9674;9818;4.08;0.25;336.25;11.43;1233;17;3360.00;144
8445;15;21872824;8445;540;9674;9818;4.03;0.25;336.30;11.43;1229;17;3361.00;144
8447;15;21872837;8447;545;9676;9818;4.09;0.25;336.30;11.43;1229;17;3362.00;142
8448;15;21872852;8448;555;9677;9819;4.12;0.25;336.33;11.43;1229;17;3363.00;142
8451;15;21872866;8451;547;9678;9820;4.12;0.25;336.28;11.43;1227;17;3364.00;142
8453;15;21872879;8453;541;9678;9820;4.11;0.25;336.29;11.43;1225;17;3365.00;142
8456;15;21872892;8456;540;9680;9823;4.12;0.25;336.25;11.42;1224;17;3366.00;143
8459;15;21872906;8459;540;9680;9823;4.07;0.25;336.28;11.42;1221;17;3367.00;143
8461;15;21872919;8461;544;9681;9823;4.07;0.25;336.26;11.42;1220;17;3368.00;142
8463;15;21872932;8463;541;9681;9823;4.05;0.25;336.21;11.42;1218;17;3369.00;142
8467;15;21872946;8467;545;9686;9829;4.05;0.25;336.27;11.42;1219;17;3370.00;143
8469;15;21872960;8469;538;9686;9829;4.06;0.25;336.27;11.42;1217;17;3371.00;143
8472;15;21872973;8472;518;9686;9829;4.12;0.25;336.27;11.42;1214;17;3372.00;143
8472;15;21872988;8472;506;9686;9829;4.21;0.26;336.27;11.42;1214;17;3373.00;143
8476;15;21873008;8476;497;9690;9833;4.31;0.26;336.34;11.43;1214;17;3374.00;143
8478;15;21873022;8478;483;9692;9835;4.44;0.27;336.31;11.42;1214;17;3375.00;143
8479;15;21873036;8479;480;9692;9835;4.53;0.28;336.31;11.42;1213;17;3376.00;143
8481;15;21873050;8481;477;9693;9836;4.60;0.28;336.25;11.42;1212;17;3377.00;143
8483;15;21873065;8483;476;9693;9836;4.68;0.29;336.19;11.42;1210;17;3378.00;143
8485;15;21873079;8485;472;9693;9836;4.71;0.29;336.20;11.42;1208;17;3379.00;143
8486;15;21873099;8486;468;9693;9836;4.76;0.29;336.21;11.42;1207;17;3380.00;143
8487;15;21873118;8487;461;9693;9836;4.81;0.29;336.24;11.42;1206;17;3381.00;143
8490;15;21873133;8490;443;9693;9836;4.87;0.30;336.25;11.42;1203;17;3382.00;143
8491;15;21873147;8491;441;9693;9836;4.93;0.30;336.24;11.42;1202;17;3383.00;143
8492;15;21873161;8492;442;9734;9906;5.09;0.31;336.27;11.37;1242;17;3384.00;172
8493;15;21873181;8493;426;9735;9907;5.18;0.32;336.38;11.37;1242;17;3385.00;172
8498;15;21873195;8498;413;9740;9907;5.29;0.32;336.46;11.37;1242;17;3386.00;167
8499;15;21873211;8499;407;9741;9907;5.37;0.33;336.44;11.38;1242;17;3387.00;166
8501;15;21873226;8501;398;9744;9907;5.47;0.33;336.47;11.38;1243;17;3388.00;163
8504;15;21873240;8504;393;9747;9907;5.58;0.34;336.52;11.38;1243;17;3389.00;160
8508;15;21873257;8508;394;9751;9907;5.63;0.34;336.61;11.39;1243;17;3390.00;156
8510;15;21873272;8510;396;9754;9907;5.67;0.34;336.58;11.39;1244;17;3391.00;153
8513;15;21873287;8513;399;9756;9908;5.73;0.35;336.63;11.39;1243;17;3392.00;152
8514;15;21873302;8514;396;9759;9909;5.78;0.35;336.67;11.39;1245;17;3393.00;150
8519;15;21873318;8519;395;9760;9909;5.81;0.35;336.83;11.39;1241;17;3394.00;149
8524;15;21873333;8524;397;9766;9913;5.76;0.35;336.90;11.40;1242;17;3395.00;147
8524;15;21873350;8524;401;9767;9913;5.79;0.35;336.90;11.40;1243;17;3396.00;146
8527;15;21873364;8527;404;9767;9913;5.78;0.35;337.00;11.40;1240;17;3397.00;146
8531;15;21873380;8531;404;9767;9913;5.76;0.35;337.06;11.40;1236;17;3398.00;146
8533;15;21873395;8533;413;9772;9919;5.80;0.35;337.06;11.39;1239;17;3399.00;147
8535;15;21873412;8535;413;9772;9919;5.86;0.35;337.13;11.39;1237;17;3400.00;147
8536;15;21873430;8536;409;9772;9919;5.88;0.36;337.19;11.39;1236;17;3401.00;147
8540;15;21873446;8540;415;9774;9922;5.94;0.36;337.28;11.39;1234;17;3402.00;148
8542;16;21873461;8542;410;9774;9922;5.96;0.36;337.32;11.39;1232;18;3403.00;148
8542;16;21873489;8542;418;9775;9922;5.96;0.36;337.32;11.39;1233;18;3404.00;147
8543;16;21873503;8543;424;9775;9923;5.92;0.36;337.35;11.39;1232;18;3405.00;148
8546;16;21873518;8546;426;9776;9924;5.87;0.36;337.43;11.39;1230;18;3406.00;148
8546;16;21873533;8546;432;9776;9924;5.85;0.35;337.43;11.39;1230;18;3407.00;148
8551;16;21873547;8551;437;9787;9937;5.79;0.35;337.51;11.39;1236;18;3408.00;150
8552;16;21873563;8552;436;9788;9937;5.76;0.35;337.54;11.39;1236;18;3409.00;149
8555;16;21873577;8555;433;9788;9937;5.71;0.35;337.56;11.39;1233;18;3410.00;149
8557;16;21873593;8557;432;9789;9938;5.68;0.34;337.56;11.39;1232;18;3411.00;149
8559;16;21873612;8559;425;9789;9938;5.65;0.34;337.58;11.39;1230;18;3412.00;149
8562;16;21873626;8562;427;9793;9942;5.65;0.34;337.66;11.39;1231;18;3413.00;149
8565;16;21873641;8565;429;9793;9942;5.62;0.34;337.72;11.39;1228;18;3414.00;149
8566;16;21873655;8566;431;9796;9946;5.62;0.34;337.73;11.38;1230;18;3415.00;150
8568;16;21873670;8568;421;9796;9946;5.67;0.34;337.81;11.38;1228;18;3416.00;150
8570;16;21873685;8570;412;9796;9946;5.67;0.34;337.77;11.38;1226;18;3417.00;150
8572;16;21873699;8572;408;9796;9946;5.67;0.34;337.87;11.38;1224;18;3418.00;150
8576;16;21873715;8576;402;9796;9946;5.65;0.34;337.89;11.38;1220;18;3419.00;150
8582;16;21873731;8582;404;9821;9980;5.69;0.35;338.15;11.35;1239;18;3420.00;159
8586;16;21873749;8586;391;9821;9980;5.73;0.35;338.26;11.35;1235;18;3421.00;159
8589;16;21873764;8589;390;9824;9980;5.83;0.35;338.33;11.35;1235;18;3422.00;156
8589;16;21873780;8589;382;9824;9980;5.94;0.36;338.33;11.35;1235;18;3423.00;156
8594;16;21873795;8594;377;9825;9980;6.00;0.36;338.33;11.35;1231;18;3424.00;155
8595;16;21873810;8595;376;9826;9980;6.05;0.37;338.32;11.37;1231;18;3425.00;154
8599;16;21873832;8599;370;9826;9981;6.08;0.37;338.39;11.37;1227;18;3426.00;155
8605;16;21873847;8605;362;9826;9981;6.07;0.37;338.55;11.37;1221;18;3427.00;155
8605;16;21873866;8605;368;9831;9987;6.13;0.37;338.55;11.36;1226;18;3428.00;156
8607;16;21873885;8607;358;9832;9988;6.14;0.37;338.59;11.36;1225;18;3429.00;156
8611;16;21873907;8611;351;9834;9988;6.02;0.37;338.68;11.47;1223;18;3430.00;154
8614;16;21873929;8614;343;9834;9988;5.94;0.36;338.89;11.47;1220;18;3431.00;154
8620;16;21873947;8620;342;9837;9992;5.87;0.36;339.01;11.47;1217;18;3432.00;155
8624;16;21873966;8624;337;9837;9992;5.87;0.36;339.03;11.47;1213;18;3433.00;155
8629;16;21873985;8629;336;9837;9992;5.83;0.35;339.08;11.47;1208;18;3434.00;155
8630;16;21874001;8630;330;9838;9993;5.84;0.35;339.07;11.46;1208;18;3435.00;155
8633;16;21874017;8633;338;9841;9997;5.84;0.35;339.23;11.46;1208;18;3436.00;156
8636;16;21874033;8636;338;9841;9997;5.89;0.36;339.29;11.46;1205;18;3437.00;156
8638;16;21874048;8638;346;9843;10000;5.93;0.36;339.33;11.46;1205;18;3438.00;157
8641;16;21874064;8641;346;9845;10000;5.97;0.36;339.29;11.48;1204;18;3439.00;155
8643;16;21874079;8643;348;9845;10000;5.95;0.36;339.33;11.48;1202;18;3440.00;155
8646;16;21874094;8646;349;9845;10000;5.96;0.36;339.37;11.48;1199;18;3441.00;155
8648;16;21874109;8648;348;9849;10004;5.98;0.36;339.42;11.47;1201;18;3442.00;155
8649;16;21874123;8649;352;9849;10004;5.97;0.36;339.50;11.47;1200;18;3443.00;155
8653;16;21874138;8653;346;9849;10004;5.90;0.36;339.52;11.47;1196;18;3444.00;155
8654;16;21874153;8654;350;9849;10004;5.88;0.36;339.55;11.47;1195;18;3445.00;155
8656;16;21874169;8656;352;9849;10005;5.88;0.36;339.55;11.47;1193;18;3446.00;156
8657;16;21874185;8657;351;9850;10006;5.90;0.36;339.58;11.47;1193;18;3447.00;156
8662;16;21874200;8662;343;9850;10006;5.81;0.35;339.78;11.47;1188;18;3448.00;156
8665;16;21874215;8665;351;9851;10007;5.82;0.35;339.71;11.47;1186;18;3449.00;156
8668;16;21874231;8668;354;9851;10007;5.80;0.35;339.77;11.47;1183;18;3450.00;156
8671;16;21874247;8671;351;9851;10007;5.82;0.35;339.74;11.47;1180;18;3451.00;156
8674;16;21874263;8674;350;9851;10007;5.82;0.35;339.74;11.47;1177;18;3452.00;156
8676;16;21874277;8676;346;9851;10007;5.84;0.36;339.74;11.47;1175;18;3453.00;156
8678;16;21874291;8678;355;9851;10007;5.80;0.35;339.75;11.47;1173;18;3454.00;156
8679;16;21874306;8679;356;9852;10007;5.79;0.35;339.75;11.53;1173;18;3455.00;155
8683;16;21874320;8683;383;9919;10134;5.97;0.37;339.80;11.50;1236;18;3456.00;215
8686;16;21874344;8686;376;9922;10135;6.01;0.37;339.77;11.50;1236;18;3457.00;213
8688;16;21874360;8688;380;9931;10135;6.07;0.37;339.90;11.60;1243;18;3458.00;204
8692;16;21874375;8692;382;9932;10135;6.08;0.37;339.93;11.60;1240;18;3459.00;203
8694;16;21874390;8694;383;9939;10135;6.07;0.37;339.89;11.70;1245;18;3460.00;196
8696;16;21874405;8696;382;9939;10135;6.03;0.37;339.95;11.70;1243;18;3461.00;196
8699;16;21874421;8699;384;9944;10135;6.01;0.37;340.00;11.75;1245;18;3462.00;191
8704;16;21874435;8704;395;9945;10135;5.97;0.37;340.05;11.75;1241;18;3463.00;190
8707;16;21874455;8707;400;9948;10136;5.99;0.37;340.15;11.80;1241;18;3464.00;188
8708;16;21874470;8708;400;9953;10138;6.04;0.37;340.17;11.85;1245;18;3465.00;185
8709;16;21874485;8709;411;9955;10138;6.10;0.37;340.25;11.85;1246;18;3466.00;183
8713;16;21874500;8713;420;9959;10139;6.05;0.37;340.27;11.96;1246;18;3467.00;180
8720;16;21874514;8720;414;9962;10139;6.02;0.37;340.19;11.96;1242;18;3468.00;177
8720;16;21874529;8720;424;9966;10139;6.02;0.37;340.19;12.06;1246;18;3469.00;173
8722;16;21874543;8722;423;9971;10139;5.98;0.37;340.26;12.11;1249;18;3470.00;168
8725;16;21874558;8725;436;9975;10143;5.91;0.36;340.30;12.11;1250;18;3471.00;168
8729;16;21874573;8729;441;9980;10143;5.80;0.36;340.24;12.16;1251;18;3472.00;163
8730;16;21874588;8730;443;9984;10143;5.72;0.35;340.31;12.21;1254;18;3473.00;159
8734;16;21874602;8734;447;9987;10146;5.62;0.34;340.51;12.21;1253;18;3474.00;159
8740;16;21874617;8740;447;9989;10146;5.51;0.34;340.58;12.25;1249;18;3475.00;157
8741;16;21874632;8741;447;9990;10146;5.46;0.33;340.67;12.26;1249;18;3476.00;156
8742;17;21874646;8742;452;9994;10150;5.42;0.33;340.67;12.25;1252;19;3477.00;156
8744;17;21874677;8744;454;9998;10151;5.39;0.33;340.81;12.35;1254;19;3478.00;153
8747;17;21874692;8747;457;9999;10151;5.41;0.33;340.90;12.35;1252;19;3479.00;152
8749;17;21874707;8749;466;10005;10156;5.44;0.33;340.95;12.45;1256;19;3480.00;151
8754;17;21874722;8754;460;10007;10156;5.41;0.33;341.04;12.44;1253;19;3481.00;149
8755;17;21874737;8755;458;10008;10156;5.38;0.33;341.01;12.44;1253;19;3482.00;148
8758;17;21874751;8758;463;10009;10157;5.31;0.32;341.00;12.44;1251;19;3483.00;148
8759;17;21874765;8759;471;10009;10157;5.26;0.32;341.01;12.44;1250;19;3484.00;148
8761;17;21874779;8761;473;10018;10163;5.25;0.32;341.01;12.63;1257;19;3485.00;145
8764;17;21874794;8764;477;10018;10163;5.19;0.32;341.05;12.63;1254;19;3486.00;145
8766;17;21874808;8766;473;10018;10164;5.14;0.31;341.06;12.63;1252;19;3487.00;146
8767;17;21874823;8767;473;10018;10164;5.08;0.31;341.03;12.63;1251;19;3488.00;146
8768;17;21874836;8768;487;10021;10164;5.08;0.31;341.05;12.77;1253;19;3489.00;143
8769;17;21874850;8769;484;10021;10164;5.05;0.31;341.02;12.77;1252;19;3490.00;143
8771;17;21874865;8771;492;10024;10164;5.00;0.31;341.04;12.90;1253;19;3491.00;140
8773;17;21874886;8773;495;10034;10176;5.02;0.31;341.04;12.89;1261;19;3492.00;142
8774;17;21874900;8774;505;10035;10176;4.95;0.30;341.05;12.93;1261;19;3493.00;141
8776;17;21874916;8776;512;10036;10176;4.96;0.30;341.02;12.93;1260;19;3494.00;140
8782;17;21874929;8782;521;10038;10176;4.90;0.30;340.93;13.02;1256;19;3495.00;138
8784;17;21874943;8784;525;10038;10176;4.88;0.30;340.92;13.02;1254;19;3496.00;138
8788;17;21874955;8788;536;10038;10176;4.81;0.30;340.91;13.02;1250;19;3497.00;138
8792;17;21874969;8792;540;10041;10180;4.76;0.29;340.90;13.01;1249;19;3498.00;139
8796;17;21874984;8796;542;10041;10180;4.70;0.29;340.86;13.01;1245;19;3499.00;139
8799;17;21874997;8799;535;10045;10184;4.67;0.29;340.86;13.01;1246;19;3500.00;139
8803;17;21875016;8803;529;10045;10185;4.64;0.28;340.80;13.01;1242;19;3501.00;140
8808;17;21875030;8808;523;10046;10185;4.56;0.28;340.92;13.01;1238;19;3502.00;139
8812;17;21875043;8812;526;10046;10185;4.50;0.28;340.84;13.01;1234;19;3503.00;139
8813;17;21875055;8813;525;10056;10198;4.53;0.28;340.93;13.00;1243;19;3504.00;142
8817;17;21875069;8817;522;10056;10198;4.49;0.27;340.90;13.00;1239;19;3505.00;142
8823;17;21875082;8823;520;10056;10198;4.42;0.27;340.79;13.00;1233;19;3506.00;142
8826;17;21875095;8826;509;10057;10199;4.38;0.27;340.70;12.99;1231;19;3507.00;142
8828;17;21875108;8828;505;10057;10200;4.36;0.27;340.67;12.99;1229;19;3508.00;143
8832;17;21875121;8832;504;10057;10200;4.35;0.27;340.58;12.99;1225;19;3509.00;143
8834;17;21875143;8834;497;10061;10206;4.37;0.27;340.59;12.99;1227;19;3510.00;145
8838;17;21875156;8838;499;10061;10206;4.31;0.26;340.54;12.99;1223;19;3511.00;145
8840;17;21875168;8840;499;10062;10206;4.30;0.26;340.54;12.99;1222;19;3512.00;144
8842;17;21875181;8842;498;10062;10206;4.30;0.26;340.62;12.99;1220;19;3513.00;144
8846;17;21875194;8846;504;10066;10212;4.31;0.26;340.60;12.98;1220;19;3514.00;146
8848;17;21875207;8848;511;10066;10212;4.30;0.26;340.56;12.98;1218;19;3515.00;146
8850;17;21875220;8850;514;10066;10212;4.33;0.27;340.56;12.98;1216;19;3516.00;146
8853;17;21875233;8853;517;10067;10212;4.31;0.26;340.61;12.98;1214;19;3517.00;145
8856;17;21875246;8856;514;10070;10216;4.27;0.26;340.57;12.98;1214;19;3518.00;146
8862;17;21875259;8862;519;10073;10219;4.20;0.26;340.55;12.98;1211;19;3519.00;146
8866;17;21875273;8866;513;10074;10219;4.17;0.25;340.49;13.00;1208;19;3520.00;145
8868;17;21875286;8868;508;10075;10220;4.16;0.25;340.48;13.00;1207;19;3521.00;145
8870;17;21875299;8870;504;10075;10220;4.15;0.25;340.46;13.00;1205;19;3522.00;145
8871;17;21875312;8871;491;10075;10220;4.20;0.26;340.47;13.00;1204;19;3523.00;145
8877;17;21875325;8877;487;10076;10220;4.20;0.26;340.44;13.00;1199;19;3524.00;144
8878;17;21875338;8878;487;10077;10220;4.23;0.26;340.41;13.00;1199;19;3525.00;143
8882;17;21875352;8882;484;10077;10220;4.23;0.26;340.44;13.00;1195;19;3526.00;143
8883;17;21875371;8883;478;10077;10220;4.25;0.26;340.46;13.00;1194;19;3527.00;143
8886;17;21875384;8886;488;10117;10290;4.44;0.27;340.45;12.95;1231;19;3528.00;173
8887;17;21875404;8887;484;10122;10291;4.51;0.28;340.47;12.94;1235;19;3529.00;169
8891;17;21875417;8891;477;10126;10291;4.54;0.28;340.42;12.94;1235;19;3530.00;165
8895;17;21875431;8895;477;10128;10291;4.61;0.28;340.42;12.94;1233;19;3531.00;163
8897;17;21875445;8897;459;10131;10291;4.72;0.29;340.48;12.93;1234;19;3532.00;160
8900;17;21875460;8900;470;10132;10291;4.78;0.29;340.48;12.93;1232;19;3533.00;159
8905;17;21875473;8905;459;10135;10291;4.85;0.30;340.44;12.93;1230;19;3534.00;156
8906;17;21875487;8906;448;10137;10291;4.90;0.30;340.44;12.93;1231;19;3535.00;154
8909;17;21875501;8909;446;10140;10292;4.93;0.30;340.53;12.96;1231;19;3536.00;152
8911;17;21875515;8911;452;10143;10293;4.96;0.30;340.54;12.96;1232;19;3537.00;150
8913;17;21875529;8913;456;10144;10293;4.95;0.30;340.54;12.96;1231;19;3538.00;149
8915;17;21875543;8915;461;10149;10297;4.97;0.30;340.56;12.95;1234;19;3539.00;148
8917;17;21875559;8917;472;10149;10297;4.95;0.30;340.56;12.95;1232;19;3540.00;148
8919;17;21875574;8919;480;10149;10297;4.94;0.30;340.61;12.95;1230;19;3541.00;148
8923;17;21875587;8923;476;10149;10297;4.91;0.30;340.66;12.95;1226;19;3542.00;148
8925;17;21875601;8925;482;10154;10303;4.90;0.30;340.70;12.94;1229;19;3543.00;149
8928;17;21875616;8928;486;10154;10303;4.85;0.30;340.75;12.94;1226;19;3544.00;149
8931;17;21875630;8931;491;10154;10303;4.84;0.30;340.73;12.94;1223;19;3545.00;149
8934;17;21875644;8934;499;10156;10306;4.86;0.30;340.72;12.94;1222;19;3546.00;150
8938;17;21875658;8938;493;10156;10306;4.86;0.30;340.84;12.94;1218;19;3547.00;150
8942;17;21875672;8942;487;10157;10306;4.84;0.30;340.83;12.94;1215;19;3548.00;149
8945;17;21875686;8945;486;10157;10307;4.86;0.30;340.88;12.94;1212;19;3549.00;150
8949;17;21875700;8949;487;10159;10308;4.86;0.30;340.93;12.97;1210;19;3550.00;149
8952;17;21875714;8952;488;10159;10308;4.86;0.30;341.07;12.97;1207;19;3551.00;149
8957;17;21875728;8957;489;10170;10321;4.95;0.30;341.24;12.96;1213;19;3552.00;151
8958;17;21875743;8958;488;10170;10321;4.96;0.30;341.25;12.96;1212;19;3553.00;151
8962;17;21875757;8962;488;10170;10321;4.98;0.30;341.40;12.96;1208;19;3554.00;151
8964;17;21875771;8964;492;10172;10323;4.98;0.30;341.40;12.95;1208;19;3555.00;151
8968;17;21875785;8968;477;10172;10323;4.99;0.30;341.53;12.95;1204;19;3556.00;151
8971;17;21875800;8971;461;10176;10327;5.05;0.31;341.50;12.95;1205;19;3557.00;151
8971;17;21875814;8971;452;10176;10327;5.06;0.31;341.50;12.95;1205;19;3558.00;151
8974;17;21875828;8974;443;10179;10331;5.08;0.31;341.63;12.94;1205;19;3559.00;152
8976;17;21875843;8976;441;10179;10331;5.10;0.31;341.70;12.94;1203;19;3560.00;152
8977;17;21875857;8977;439;10179;10331;5.13;0.31;341.68;12.94;1202;19;3561.00;152
8982;17;21875878;8982;431;10179;10331;5.09;0.31;341.73;12.94;1197;19;3562.00;152
8984;17;21875897;8984;438;10179;10331;5.12;0.31;341.77;12.94;1195;19;3563.00;152
8985;17;21875916;8985;445;10189;10343;5.23;0.32;341.80;12.93;1204;19;3564.00;154
8987;17;21875935;8987;448;10190;10343;5.25;0.32;341.86;12.96;1203;19;3565.00;153
8991;17;21875952;8991;452;10191;10343;5.28;0.32;341.92;12.96;1200;19;3566.00;152
8996;17;21875969;8996;451;10191;10343;5.25;0.32;341.97;12.96;1195;19;3567.00;152
8997;17;21875986;8997;441;10191;10343;5.28;0.32;342.06;12.96;1194;19;3568.00;152
8999;17;21876001;8999;441;10191;10343;5.29;0.32;342.07;12.96;1192;19;3569.00;152
9000;17;21876018;9000;443;10191;10344;5.29;0.32;342.10;12.96;1191;19;3570.00;153
9003;18;21876033;9003;431;10191;10344;5.30;0.32;342.15;12.96;1188;20;3571.00;153
9004;18;21876054;9004;438;10196;10350;5.35;0.33;342.17;12.96;1192;20;3572.00;154
9005;18;21876069;9005;437;10197;10351;5.35;0.33;342.22;12.95;1192;20;3573.00;154
9007;18;21876084;9007;436;10197;10351;5.36;0.33;342.24;12.95;1190;20;3574.00;154
9009;18;21876098;9009;432;10198;10351;5.35;0.33;342.19;12.98;1189;20;3575.00;153
9012;18;21876112;9012;434;10201;10355;5.39;0.33;342.30;12.97;1189;20;3576.00;154
9016;18;21876126;9016;435;10201;10355;5.38;0.33;342.32;12.97;1185;20;3577.00;154
9016;18;21876139;9016;435;10201;10355;5.43;0.33;342.32;12.97;1185;20;3578.00;154
9022;18;21876153;9022;432;10202;10356;5.44;0.33;342.57;12.97;1180;20;3579.00;154
9022;18;21876168;9022;428;10205;10360;5.46;0.33;342.57;12.97;1183;20;3580.00;155
9027;18;21876182;9027;423;10205;10360;5.47;0.33;342.74;12.97;1178;20;3581.00;155
9029;18;21876196;9029;425;10207;10363;5.48;0.33;342.79;12.97;1178;20;3582.00;156
9030;18;21876211;9030;425;10207;10363;5.47;0.33;342.82;12.97;1177;20;3583.00;156
9032;18;21876229;9032;420;10208;10363;5.44;0.33;342.84;12.97;1176;20;3584.00;155
9033;18;21876244;9033;426;10208;10363;5.43;0.33;342.84;12.97;1175;20;3585.00;155
9036;18;21876257;9036;423;10212;10367;5.45;0.33;342.85;12.96;1176;20;3586.00;155
9037;18;21876272;9037;417;10212;10367;5.45;0.33;342.89;12.96;1175;20;3587.00;155
9038;18;21876286;9038;416;10212;10367;5.46;0.33;342.87;12.96;1174;20;3588.00;155
9041;18;21876300;9041;418;10212;10367;5.51;0.34;342.91;12.96;1171;20;3589.00;155
9046;18;21876315;9046;412;10212;10368;5.53;0.34;342.97;12.96;1166;20;3590.00;156
9047;18;21876329;9047;400;10213;10369;5.62;0.34;343.01;12.96;1166;20;3591.00;156
9051;18;21876344;9051;397;10213;10369;5.69;0.35;343.07;12.96;1162;20;3592.00;156
9051;18;21876358;9051;390;10214;10370;5.82;0.35;343.07;12.96;1163;20;3593.00;156
9053;18;21876375;9053;388;10214;10370;5.90;0.36;343.06;12.96;1161;20;3594.00;156
9055;18;21876389;9055;385;10214;10370;5.98;0.36;343.05;12.96;1159;20;3595.00;156
9058;18;21876405;9058;389;10214;10370;6.03;0.37;343.05;12.96;1156;20;3596.00;156
9059;18;21876419;9059;387;10214;10370;6.08;0.37;343.14;12.96;1155;20;3597.00;156
9061;18;21876433;9061;385;10214;10370;6.10;0.37;343.15;12.96;1153;20;3598.00;156
9063;18;21876449;9063;386;10214;10370;6.15;0.37;343.19;12.96;1151;20;3599.00;156
9067;18;21876471;9067;448;10337;10623;6.00;0.37;343.28;12.81;1270;20;3600.00;286
9069;18;21876509;9069;426;10337;10624;6.01;0.37;343.31;12.81;1268;20;3601.00;287
9072;18;21876525;9072;404;10345;10624;6.11;0.38;343.37;12.80;1273;20;3602.00;279
9076;18;21876539;9076;391;10346;10624;6.13;0.38;343.51;12.80;1270;20;3603.00;278
9079;18;21876554;9079;380;10351;10624;6.17;0.38;343.63;12.79;1272;20;3604.00;273
9082;18;21876570;9082;368;10354;10624;6.24;0.39;343.69;12.79;1272;20;3605.00;270
9085;18;21876591;9085;359;10363;10624;6.29;0.39;343.72;12.87;1278;20;3606.00;261
9088;18;21876609;9088;347;10368;10624;6.27;0.39;343.86;12.86;1280;20;3607.00;256
9090;18;21876625;9090;348;10377;10625;6.30;0.39;343.90;12.86;1287;20;3608.00;248
9093;18;21876640;9093;348;10381;10626;6.32;0.39;343.99;12.86;1288;20;3609.00;245
9094;18;21876657;9094;352;10387;10626;6.34;0.39;344.02;12.86;1293;20;3610.00;239
9096;18;21876672;9096;351;10388;10627;6.33;0.39;344.13;12.86;1292;20;3611.00;239
9100;18;21876688;9100;349;10393;10627;6.29;0.39;344.35;12.86;1293;20;3612.00;234
9103;18;21876704;9103;351;10394;10627;6.30;0.39;344.42;12.86;1291;20;3613.00;233
9107;18;21876720;9107;352;10397;10627;6.30;0.39;344.52;12.86;1290;20;3614.00;230
9109;18;21876736;9109;357;10400;10631;6.22;0.38;344.58;12.86;1291;20;3615.00;231
9110;18;21876752;9110;370;10402;10631;6.15;0.38;344.59;12.86;1292;20;3616.00;229
9112;18;21876768;9112;369;10404;10631;6.11;0.38;344.55;12.86;1292;20;3617.00;227
9114;18;21876785;9114;369;10406;10634;6.08;0.37;344.56;12.85;1292;20;3618.00;228
9117;18;21876802;9117;374;10408;10634;6.04;0.37;344.49;12.86;1291;20;3619.00;226
9120;18;21876819;9120;380;10408;10634;6.03;0.37;344.61;12.86;1288;20;3620.00;226
9123;18;21876834;9123;390;10411;10638;6.03;0.37;344.67;12.88;1288;20;3621.00;227
9127;18;21876850;9127;396;10413;10639;6.00;0.37;344.64;12.88;1286;20;3622.00;226
9133;18;21876866;9133;400;10414;10639;5.97;0.37;344.74;12.88;1281;20;3623.00;225
9133;18;21876882;9133;410;10416;10643;5.96;0.37;344.74;12.88;1283;20;3624.00;227
9135;18;21876897;9135;415;10420;10643;5.93;0.36;344.83;12.88;1285;20;3625.00;223
9138;18;21876919;9138;420;10423;10643;5.86;0.36;344.87;12.94;1285;20;3626.00;220
9142;18;21876934;9142;432;10423;10644;5.76;0.35;344.94;12.94;1281;20;3627.00;221
9144;18;21876951;9144;441;10425;10644;5.69;0.35;344.90;12.94;1281;20;3628.00;219
9146;18;21876966;9146;441;10432;10650;5.64;0.35;344.93;12.99;1286;20;3629.00;218
9148;18;21876985;9148;453;10437;10650;5.58;0.34;344.95;13.05;1289;20;3630.00;213
9155;18;21877001;9155;452;10440;10651;5.49;0.33;345.04;13.11;1285;20;3631.00;211
9158;18;21877017;9158;457;10443;10651;5.41;0.33;345.08;13.16;1285;20;3632.00;208
9160;18;21877033;9160;462;10445;10651;5.34;0.33;345.19;13.22;1285;20;3633.00;206
9160;18;21877048;9160;469;10447;10651;5.33;0.33;345.19;13.27;1287;20;3634.00;204
9163;18;21877062;9163;474;10449;10651;5.28;0.32;345.20;13.28;1286;20;3635.00;202
9165;18;21877077;9165;483;10459;10663;5.28;0.32;345.25;13.27;1294;20;3636.00;204
9168;18;21877093;9168;489;10463;10663;5.23;0.32;345.36;13.38;1295;20;3637.00;200
9171;18;21877107;9171;491;10466;10663;5.22;0.32;345.48;13.44;1295;20;3638.00;197
9172;18;21877121;9172;502;10467;10663;5.19;0.32;345.49;13.49;1295;20;3639.00;196
9176;18;21877136;9176;503;10471;10663;5.12;0.31;345.44;13.55;1295;20;3640.00;192
9177;19;21877151;9177;517;10475;10663;5.09;0.31;345.40;13.56;1298;21;3641.00;188
9180;19;21877182;9180;525;10481;10667;5.01;0.31;345.44;13.56;1301;21;3642.00;186
9181;19;21877197;9181;537;10482;10667;4.97;0.30;345.49;13.56;1301;21;3643.00;185
9182;19;21877211;9182;532;10487;10671;5.02;0.31;345.54;13.61;1305;21;3644.00;184
9184;19;21877226;9184;543;10489;10673;4.98;0.31;345.57;13.61;1305;21;3645.00;184
9186;19;21877239;9186;549;10491;10673;4.89;0.30;345.52;13.67;1305;21;3646.00;182
9189;19;21877253;9189;548;10493;10673;4.84;0.30;345.47;13.67;1304;21;3647.00;180
9190;19;21877270;9190;554;10505;10686;4.83;0.30;345.43;13.76;1315;21;3648.00;181
9192;19;21877292;9192;561;10508;10686;4.82;0.30;345.42;13.87;1316;21;3649.00;178
9196;19;21877306;9196;560;10508;10686;4.82;0.30;345.38;13.87;1312;21;3650.00;178
9199;19;21877320;9199;562;10511;10687;4.79;0.29;345.33;13.97;1312;21;3651.00;176
9203;19;21877334;9203;562;10512;10688;4.74;0.29;345.29;14.02;1309;21;3652.00;176
9205;19;21877349;9205;560;10512;10688;4.72;0.29;345.30;14.02;1307;21;3653.00;176
9207;19;21877364;9207;568;10517;10691;4.72;0.29;345.24;14.07;1310;21;3654.00;174
9210;19;21877379;9210;568;10517;10691;4.72;0.29;345.19;14.07;1307;21;3655.00;174
9214;19;21877393;9214;572;10519;10691;4.68;0.29;345.09;14.17;1305;21;3656.00;172
9216;19;21877407;9216;576;10520;10691;4.66;0.29;345.09;14.22;1304;21;3657.00;171
9218;19;21877420;9218;577;10526;10697;4.70;0.29;345.05;14.26;1308;21;3658.00;171
9219;19;21877435;9219;584;10526;10697;4.69;0.29;345.04;14.26;1307;21;3659.00;171
9223;19;21877450;9223;587;10530;10697;4.65;0.29;345.00;14.36;1307;21;3660.00;167
9226;19;21877464;9226;595;10530;10697;4.64;0.28;345.07;14.36;1304;21;3661.00;167
9230;19;21877478;9230;598;10535;10701;4.57;0.28;344.98;14.36;1305;21;3662.00;166
9235;19;21877492;9235;601;10536;10702;4.53;0.28;344.89;14.35;1301;21;3663.00;166
9238;19;21877506;9238;604;10538;10702;4.49;0.28;344.86;14.45;1300;21;3664.00;164
9240;19;21877519;9240;603;10539;10703;4.43;0.27;344.82;14.45;1299;21;3665.00;164
9244;19;21877532;9244;604;10541;10703;4.32;0.26;344.76;14.54;1297;21;3666.00;162
9247;19;21877547;9247;612;10541;10703;4.28;0.26;344.71;14.54;1294;21;3667.00;162
9249;19;21877560;9249;615;10541;10703;4.23;0.26;344.77;14.54;1292;21;3668.00;162
9251;19;21877572;9251;622;10543;10703;4.17;0.25;344.78;14.63;1292;21;3669.00;160
9252;19;21877585;9252;624;10543;10703;4.12;0.25;344.76;14.63;1291;21;3670.00;160
9254;19;21877597;9254;627;10543;10703;4.04;0.25;344.77;14.63;1289;21;3671.00;160
9257;19;21877609;9257;636;10584;10773;4.14;0.25;344.79;14.67;1327;21;3672.00;189
9259;19;21877628;9259;639;10584;10774;4.05;0.25;344.75;14.67;1325;21;3673.00;190
9262;19;21877640;9262;636;10591;10774;4.03;0.25;344.75;14.66;1329;21;3674.00;183
9263;19;21877652;9263;637;10596;10774;4.01;0.25;344.72;14.66;1333;21;3675.00;178
9265;19;21877664;9265;635;10601;10774;3.98;0.25;344.73;14.65;1336;21;3676.00;173
9270;19;21877677;9270;636;10603;10774;3.94;0.24;344.68;14.65;1333;21;3677.00;171
9272;19;21877690;9272;619;10605;10774;3.94;0.24;344.75;14.65;1333;21;3678.00;169
9277;19;21877703;9277;621;10607;10774;3.93;0.24;344.65;14.65;1330;21;3679.00;167
9279;19;21877716;9279;613;10608;10775;3.98;0.24;344.64;14.65;1329;21;3680.00;167
9281;19;21877730;9281;618;10610;10776;4.05;0.25;344.72;14.64;1329;21;3681.00;166
9283;19;21877743;9283;602;10610;10776;4.10;0.25;344.70;14.64;1327;21;3682.00;166
9285;19;21877757;9285;596;10613;10780;4.16;0.25;344.70;14.64;1328;21;3683.00;167
9286;19;21877772;9286;586;10613;10780;4.27;0.26;344.71;14.64;1327;21;3684.00;167
9288;19;21877786;9288;582;10614;10780;4.33;0.27;344.74;14.64;1326;21;3685.00;166
9291;19;21877800;9291;572;10614;10780;4.36;0.27;344.73;14.64;1323;21;3686.00;166
9293;19;21877820;9293;567;10619;10786;4.46;0.27;344.73;14.63;1326;21;3687.00;167
9298;19;21877835;9298;554;10619;10786;4.48;0.27;344.72;14.63;1321;21;3688.00;167
9301;19;21877850;9301;550;10619;10786;4.53;0.28;344.76;14.63;1318;21;3689.00;167
9303;19;21877871;9303;551;10622;10792;4.60;0.28;344.75;14.63;1319;21;3690.00;170
9304;19;21877891;9304;546;10622;10792;4.62;0.28;344.74;14.63;1318;21;3691.00;170
9308;19;21877920;9308;551;10624;10792;4.62;0.28;344.71;14.63;1316;21;3692.00;168
9310;19;21877940;9310;547;10624;10793;4.66;0.28;344.73;14.63;1314;21;3693.00;169
9312;19;21877959;9312;548;10625;10794;4.67;0.29;344.71;14.63;1313;21;3694.00;169
9315;19;21877974;9315;547;10626;10794;4.69;0.29;344.70;14.63;1311;21;3695.00;168
9318;19;21877991;9318;545;10635;10807;4.80;0.29;344.68;14.61;1317;21;3696.00;172
9322;19;21878010;9322;546;10636;10807;4.83;0.29;344.65;14.61;1314;21;3697.00;171
9326;19;21878026;9326;543;10638;10807;4.83;0.29;344.64;14.61;1312;21;3698.00;169
9328;19;21878040;9328;544;10639;10808;4.84;0.29;344.64;14.61;1311;21;3699.00;169
9332;19;21878056;9332;544;10640;10808;4.78;0.29;344.75;14.61;1308;21;3700.00;168
9335;19;21878077;9335;552;10643;10812;4.78;0.29;344.73;14.61;1308;21;3701.00;169
9339;19;21878098;9339;551;10643;10812;4.75;0.29;344.68;14.61;1304;21;3702.00;169
9343;19;21878113;9343;548;10647;10816;4.74;0.29;344.72;14.60;1304;21;3703.00;169
9349;19;21878128;9349;536;10647;10816;4.75;0.29;344.75;14.60;1298;21;3704.00;169
9352;19;21878143;9352;536;10647;10816;4.79;0.29;344.75;14.60;1295;21;3705.00;169
9355;19;21878158;9355;531;10647;10816;4.78;0.29;344.73;14.60;1292;21;3706.00;169
9356;19;21878172;9356;526;10647;10816;4.82;0.29;344.74;14.60;1291;21;3707.00;169
9360;19;21878188;9360;527;10658;10828;4.91;0.30;344.79;14.59;1298;21;3708.00;170
9365;19;21878204;9365;524;10658;10828;4.90;0.30;344.87;14.59;1293;21;3709.00;170
9367;19;21878220;9367;528;10658;10828;4.88;0.30;344.91;14.59;1291;21;3710.00;170
9370;19;21878237;9370;522;10658;10828;4.90;0.30;344.91;14.59;1288;21;3711.00;170
9373;19;21878253;9373;526;10658;10828;4.91;0.30;345.07;14.59;1285;21;3712.00;170
9379;19;21878268;9379;520;10658;10828;4.90;0.30;344.97;14.59;1279;21;3713.00;170
9382;19;21878285;9382;522;10658;10829;4.96;0.30;345.01;14.59;1276;21;3714.00;171
9386;19;21878301;9386;523;10658;10829;4.98;0.31;345.08;14.59;1272;21;3715.00;171
9388;19;21878315;9388;522;10663;10835;4.99;0.31;345.09;14.58;1275;21;3716.00;172
9391;19;21878330;9391;523;10664;10836;4.96;0.30;345.12;14.58;1273;21;3717.00;172
9393;19;21878347;9393;524;10664;10836;4.86;0.30;345.19;14.58;1271;21;3718.00;172
9399;19;21878361;9399;535;10664;10836;4.73;0.29;345.37;14.58;1265;21;3719.00;172
9402;19;21878382;9402;538;10668;10841;4.70;0.29;345.34;14.57;1266;21;3720.00;173
9405;19;21878397;9405;535;10668;10841;4.62;0.28;345.37;14.57;1263;21;3721.00;173
9410;19;21878413;9410;532;10668;10841;4.56;0.28;345.35;14.57;1258;21;3722.00;173
9412;19;21878427;9412;533;10669;10842;4.55;0.28;345.48;14.57;1257;21;3723.00;173
9418;19;21878442;9418;532;10672;10846;4.55;0.28;345.45;14.57;1254;21;3724.00;174
9420;19;21878457;9420;518;10672;10846;4.62;0.28;345.46;14.57;1252;21;3725.00;174
9421;19;21878472;9421;511;10674;10849;4.68;0.28;345.49;14.57;1253;21;3726.00;175
9422;19;21878486;9422;504;10674;10849;4.72;0.29;345.50;14.57;1252;21;3727.00;175
9425;19;21878501;9425;500;10675;10849;4.74;0.29;345.59;14.56;1250;21;3728.00;174
9426;19;21878516;9426;508;10675;10849;4.76;0.29;345.67;14.56;1249;21;3729.00;174
9428;19;21878530;9428;506;10679;10853;4.80;0.29;345.70;14.56;1251;21;3730.00;174
9430;19;21878545;9430;494;10679;10853;4.83;0.29;345.68;14.56;1249;21;3731.00;174
9432;19;21878566;9432;480;10679;10853;4.87;0.30;345.67;14.56;1247;21;3732.00;174
9436;19;21878581;9436;476;10679;10853;4.88;0.30;345.76;14.56;1243;21;3733.00;174
9438;19;21878596;9438;471;10679;10854;4.92;0.30;345.83;14.56;1241;21;3734.00;175
9439;19;21878610;9439;466;10681;10856;5.01;0.31;345.80;14.56;1242;21;3735.00;175
9443;19;21878626;9443;468;10681;10856;5.00;0.31;345.94;14.56;1238;21;3736.00;175
9448;19;21878640;9448;470;10682;10857;5.05;0.31;345.97;14.55;1234;21;3737.00;175
9451;19;21878655;9451;469;10682;10857;5.07;0.31;345.99;14.55;1231;21;3738.00;175
9456;19;21878671;9456;470;10682;10857;5.11;0.31;346.16;14.55;1226;21;3739.00;175
9456;19;21878686;9456;475;10682;10857;5.16;0.31;346.16;14.55;1226;21;3740.00;175
9457;19;21878700;9457;478;10682;10857;5.19;0.32;346.24;14.55;1225;21;3741.00;175
9462;19;21878715;9462;475;10682;10857;5.18;0.32;346.39;14.55;1220;21;3742.00;175
9467;19;21878730;9467;477;10682;10857;5.20;0.32;346.43;14.55;1215;21;3743.00;175
9468;19;21878745;9468;506;10758;10984;5.29;0.33;346.44;14.45;1290;21;3744.00;226
9472;19;21878770;9472;494;10758;10985;5.30;0.33;346.58;14.45;1286;21;3745.00;227
9473;19;21878786;9473;483;10764;10985;5.42;0.34;346.58;14.45;1291;21;3746.00;221
9476;19;21878801;9476;478;10767;10985;5.49;0.34;346.69;14.48;1291;21;3747.00;218
9479;19;21878816;9479;462;10772;10985;5.52;0.34;346.80;14.47;1293;21;3748.00;213
9479;19;21878832;9479;470;10773;10985;5.59;0.35;346.80;14.47;1294;21;3749.00;212
9482;19;21878848;9482;463;10778;10990;5.63;0.35;346.85;14.47;1296;21;3750.00;212
9485;19;21878865;9485;469;10780;10990;5.65;0.35;346.91;14.47;1295;21;3751.00;210
9489;19;21878886;9489;462;10782;10991;5.63;0.35;346.98;14.46;1293;21;3752.00;209
9490;19;21878901;9490;464;10786;10992;5.60;0.35;347.04;14.46;1296;21;3753.00;206
9494;19;21878917;9494;468;10789;10992;5.57;0.34;347.03;14.46;1295;21;3754.00;203
9498;19;21878932;9498;464;10792;10993;5.49;0.34;347.19;14.46;1294;21;3755.00;201
9501;19;21878948;9501;470;10795;10993;5.44;0.33;347.23;14.46;1294;21;3756.00;198
9505;19;21878963;9505;467;10797;10993;5.38;0.33;347.28;14.46;1292;21;3757.00;196
9508;19;21878979;9508;476;10801;10993;5.31;0.33;347.33;14.46;1293;21;3758.00;192
9509;19;21878994;9509;468;10804;10997;5.29;0.32;347.32;14.45;1295;21;3759.00;193
9510;19;21879018;9510;468;10805;10997;5.26;0.32;347.37;14.45;1295;21;3760.00;192
9512;19;21879033;9512;464;10805;10997;5.23;0.32;347.33;14.45;1293;21;3761.00;192
9517;19;21879048;9517;473;10809;11000;5.26;0.32;347.33;14.45;1292;21;3762.00;191
9518;19;21879064;9518;466;10810;11000;5.29;0.32;347.31;14.45;1292;21;3763.00;190
9520;19;21879079;9520;466;10811;11000;5.35;0.33;347.27;14.45;1291;21;3764.00;189
9522;19;21879094;9522;452;10814;11004;5.37;0.33;347.33;14.48;1292;21;3765.00;190
9522;19;21879110;9522;449;10817;11005;5.43;0.33;347.33;14.48;1295;21;3766.00;188
9523;19;21879125;9523;441;10817;11005;5.47;0.33;347.32;14.48;1294;21;3767.00;188
9525;19;21879140;9525;441;10820;11009;5.49;0.33;347.38;14.48;1295;21;3768.00;189
9526;19;21879156;9526;434;10820;11009;5.49;0.33;347.38;14.48;1294;21;3769.00;189
9527;19;21879171;9527;427;10820;11009;5.53;0.34;347.38;14.48;1293;21;3770.00;189
9533;19;21879186;9533;423;10821;11010;5.54;0.34;347.42;14.48;1288;21;3771.00;189
9536;19;21879202;9536;418;10821;11010;5.54;0.34;347.53;14.48;1285;21;3772.00;189
9538;19;21879218;9538;412;10826;11016;5.60;0.34;347.54;14.47;1288;21;3773.00;190
9541;19;21879233;9541;408;10826;11016;5.58;0.34;347.58;14.47;1285;21;3774.00;190
9544;19;21879248;9544;415;10826;11017;5.53;0.34;347.63;14.47;1282;21;3775.00;191
9545;19;21879263;9545;414;10826;11017;5.50;0.34;347.73;14.47;1281;21;3776.00;191
9551;19;21879278;9551;412;10826;11017;5.40;0.33;347.78;14.47;1275;21;3777.00;191
9554;19;21879292;9554;411;10826;11017;5.32;0.32;347.86;14.47;1272;21;3778.00;191
9559;19;21879307;9559;408;10827;11017;5.24;0.32;348.01;14.47;1268;21;3779.00;190
9560;19;21879323;9560;416;10853;11053;5.27;0.32;348.00;14.55;1293;21;3780.00;200
9563;19;21879349;9563;407;10854;11053;5.23;0.32;347.96;14.55;1291;21;3781.00;199
9568;19;21879370;9568;407;10856;11053;5.17;0.32;348.01;14.55;1288;21;3782.00;197
9568;19;21879385;9568;404;10856;11053;5.23;0.32;348.01;14.55;1288;21;3783.00;197
9576;19;21879399;9576;403;10857;11053;5.21;0.32;348.14;14.55;1281;21;3784.00;196
9577;19;21879416;9577;398;10857;11053;5.20;0.32;348.12;14.55;1280;21;3785.00;196
9580;20;21879430;9580;399;10860;11057;5.18;0.32;348.21;14.54;1280;22;3786.00;197
9584;20;21879453;9584;399;10860;11057;5.17;0.31;348.40;14.54;1276;22;3787.00;197
9586;20;21879471;9586;394;10863;11061;5.19;0.32;348.48;14.54;1277;22;3788.00;198
9589;20;21879487;9589;397;10864;11062;5.16;0.31;348.54;14.54;1275;22;3789.00;198
9591;20;21879502;9591;392;10864;11062;5.17;0.32;348.57;14.54;1273;22;3790.00;198
9593;20;21879517;9593;403;10864;11062;5.19;0.32;348.64;14.54;1271;22;3791.00;198
9596;20;21879531;9596;413;10874;11075;5.24;0.32;348.64;14.52;1278;22;3792.00;201
9598;20;21879547;9598;409;10875;11075;5.27;0.32;348.63;14.52;1277;22;3793.00;200
9602;20;21879561;9602;399;10875;11075;5.26;0.32;348.80;14.52;1273;22;3794.00;200
9606;20;21879576;9606;402;10877;11076;5.27;0.32;348.95;14.52;1271;22;3795.00;199
9608;20;21879590;9608;408;10877;11077;5.23;0.32;348.91;14.52;1269;22;3796.00;200
9609;20;21879605;9609;415;10879;11077;5.24;0.32;348.96;14.52;1270;22;3797.00;198
9610;20;21879620;9610;417;10882;11080;5.26;0.32;348.98;14.52;1272;22;3798.00;198
9613;20;21879635;9613;415;10883;11080;5.23;0.32;348.98;14.52;1270;22;3799.00;197
9614;20;21879651;9614;425;10884;11080;5.20;0.32;348.99;14.52;1270;22;3800.00;196
9615;20;21879670;9615;426;10884;11080;5.18;0.32;349.00;14.52;1269;22;3801.00;196
9617;20;21879684;9617;431;10889;11086;5.23;0.32;349.09;14.52;1272;22;3802.00;197
9619;20;21879699;9619;440;10890;11086;5.23;0.32;349.20;14.52;1271;22;3803.00;196
9623;20;21879714;9623;444;10890;11086;5.21;0.32;349.19;14.52;1267;22;3804.00;196
9625;20;21879729;9625;448;10891;11086;5.14;0.31;349.23;14.57;1266;22;3805.00;195
9625;20;21879743;9625;461;10894;11090;5.06;0.31;349.23;14.57;1269;22;3806.00;196
9627;20;21879758;9627;469;10895;11091;5.00;0.30;349.19;14.57;1268;22;3807.00;196
9629;20;21879780;9629;474;10896;11091;4.91;0.30;349.15;14.62;1267;22;3808.00;195
9632;20;21879794;9632;478;10897;11092;4.80;0.29;349.18;14.62;1265;22;3809.00;195
9633;20;21879810;9633;494;10898;11092;4.71;0.29;349.19;14.68;1265;22;3810.00;194
9634;20;21879824;9634;494;10898;11092;4.66;0.28;349.18;14.68;1264;22;3811.00;194
9635;20;21879838;9635;502;10899;11092;4.64;0.28;349.15;14.73;1264;22;3812.00;193
9637;20;21879852;9637;512;10899;11092;4.62;0.28;349.13;14.73;1262;22;3813.00;193
9640;20;21879868;9640;518;10900;11092;4.60;0.28;349.20;14.79;1260;22;3814.00;192
9643;20;21879887;9643;516;10900;11092;4.57;0.28;349.13;14.79;1257;22;3815.00;192
9644;20;21879904;9644;534;10935;11162;4.75;0.29;349.21;14.74;1291;22;3816.00;227
9646;20;21879930;9646;528;10938;11163;4.68;0.29;349.26;14.79;1292;22;3817.00;225
9646;20;21879948;9646;533;10946;11163;4.68;0.29;349.26;14.78;1300;22;3818.00;217
9647;20;21879963;9647;533;10950;11163;4.62;0.28;349.27;14.89;1303;22;3819.00;213
9648;20;21879979;9648;532;10952;11163;4.60;0.28;349.26;14.89;1304;22;3820.00;211
9649;20;21879994;9649;541;10953;11163;4.60;0.28;349.23;14.89;1304;22;3821.00;210
9649;20;21880008;9649;548;10957;11163;4.58;0.28;349.23;14.99;1308;22;3822.00;206
9653;20;21880021;9653;559;10959;11163;4.52;0.28;349.24;14.99;1306;22;3823.00;204
9658;20;21880035;9658;553;10964;11164;4.53;0.28;349.13;15.09;1306;22;3824.00;200
9659;20;21880050;9659;557;10967;11166;4.53;0.28;349.11;15.09;1308;22;3825.00;199
9661;20;21880064;9661;552;10970;11166;4.48;0.27;349.06;15.14;1309;22;3826.00;196
9662;20;21880078;9662;553;10977;11170;4.48;0.27;349.04;15.19;1315;22;3827.00;193
9663;20;21880092;9663;551;10979;11170;4.47;0.27;349.05;15.19;1316;22;3828.00;191
9666;20;21880105;9666;558;10982;11170;4.41;0.27;349.00;15.29;1316;22;3829.00;188
9668;20;21880118;9668;552;10983;11170;4.38;0.27;349.01;15.29;1315;22;3830.00;187
9670;20;21880132;9670;564;10988;11176;4.40;0.27;348.97;15.29;1318;22;3831.00;188
9671;20;21880147;9671;563;10990;11176;4.36;0.27;348.94;15.39;1319;22;3832.00;186
9672;20;21880160;9672;571;10990;11176;4.35;0.27;348.93;15.39;1318;22;3833.00;186
9673;20;21880173;9673;571;10993;11179;4.35;0.27;348.90;15.39;1320;22;3834.00;186
9674;20;21880187;9674;562;10995;11179;4.37;0.27;348.89;15.49;1321;22;3835.00;184
9675;20;21880200;9675;556;10995;11179;4.34;0.27;348.87;15.49;1320;22;3836.00;184
9679;20;21880213;9679;553;10997;11180;4.28;0.26;348.87;15.59;1318;22;3837.00;183
9680;20;21880228;9680;554;10998;11181;4.30;0.26;348.86;15.59;1318;22;3838.00;183
9683;20;21880242;9683;553;10998;11181;4.29;0.26;348.79;15.59;1315;22;3839.00;183
9686;20;21880257;9686;562;11015;11207;4.30;0.26;348.74;15.67;1329;22;3840.00;192
9688;20;21880274;9688;575;11015;11207;4.27;0.26;348.74;15.67;1327;22;3841.00;192
9692;20;21880300;9692;571;11019;11207;4.25;0.26;348.81;15.67;1327;22;3842.00;188
9696;20;21880314;9696;567;11022;11208;4.25;0.26;348.74;15.66;1326;22;3843.00;186
9698;20;21880327;9698;566;11023;11208;4.23;0.26;348.71;15.66;1325;22;3844.00;185
9700;20;21880342;9700;581;11027;11212;4.20;0.26;348.68;15.66;1327;22;3845.00;185
9701;20;21880355;9701;576;11028;11214;4.19;0.25;348.69;15.66;1327;22;3846.00;186
9703;20;21880369;9703;579;11032;11218;4.15;0.25;348.69;15.65;1329;22;3847.00;186
9705;20;21880383;9705;568;11032;11218;4.09;0.25;348.69;15.65;1327;22;3848.00;186
9708;20;21880397;9708;574;11032;11218;4.04;0.25;348.68;15.65;1324;22;3849.00;186
9711;20;21880410;9711;560;11032;11218;3.99;0.24;348.62;15.65;1321;22;3850.00;186
9712;20;21880424;9712;548;11032;11218;3.96;0.24;348.64;15.65;1320;22;3851.00;186
9715;20;21880437;9715;553;11043;11230;4.02;0.25;348.59;15.64;1328;22;3852.00;187
9717;20;21880451;9717;548;11043;11230;4.03;0.25;348.59;15.64;1326;22;3853.00;187
9719;20;21880466;9719;541;11043;11230;4.11;0.25;348.61;15.64;1324;22;3854.00;187
9722;20;21880480;9722;536;11043;11230;4.14;0.25;348.67;15.64;1321;22;3855.00;187
9724;20;21880495;9724;527;11043;11230;4.15;0.25;348.66;15.64;1319;22;3856.00;187
9726;20;21880509;9726;518;11043;11230;4.18;0.25;348.65;15.64;1317;22;3857.00;187
9730;20;21880522;9730;508;11043;11231;4.21;0.26;348.85;15.64;1313;22;3858.00;188
9731;20;21880537;9731;500;11043;11231;4.29;0.26;348.82;15.64;1312;22;3859.00;188
9736;20;21880551;9736;490;11048;11237;4.34;0.26;348.87;15.63;1312;22;3860.00;189
9739;20;21880566;9739;486;11049;11238;4.40;0.27;348.84;15.63;1310;22;3861.00;189
9740;20;21880580;9740;482;11049;11238;4.47;0.27;348.85;15.63;1309;22;3862.00;189
9745;20;21880595;9745;472;11049;11238;4.49;0.27;348.82;15.63;1304;22;3863.00;189
9749;20;21880610;9749;473;11052;11242;4.54;0.28;348.84;15.62;1303;22;3864.00;190
9754;20;21880625;9754;465;11052;11242;4.58;0.28;348.86;15.62;1298;22;3865.00;190
9757;20;21880640;9757;462;11052;11242;4.59;0.28;348.96;15.62;1295;22;3866.00;190
9761;20;21880654;9761;459;11053;11243;4.63;0.28;349.06;15.62;1292;22;3867.00;190
9763;20;21880669;9763;458;11056;11247;4.68;0.28;349.04;15.62;1293;22;3868.00;191
9767;20;21880684;9767;466;11056;11247;4.69;0.28;349.17;15.62;1289;22;3869.00;191
9768;20;21880701;9768;456;11060;11253;4.74;0.29;349.16;15.61;1292;22;3870.00;193
9773;20;21880717;9773;460;11060;11253;4.76;0.29;349.32;15.61;1287;22;3871.00;193
9776;20;21880732;9776;458;11062;11253;4.80;0.29;349.38;15.61;1286;22;3872.00;191
9780;20;21880747;9780;459;11062;11253;4.81;0.29;349.49;15.61;1282;22;3873.00;191
9786;20;21880762;9786;453;11066;11257;4.84;0.29;349.70;15.61;1280;22;3874.00;191
9788;20;21880778;9788;461;11066;11257;4.87;0.30;349.72;15.61;1278;22;3875.00;191
9793;20;21880793;9793;452;11066;11257;4.84;0.29;349.77;15.61;1273;22;3876.00;191
9794;20;21880807;9794;460;11066;11257;4.81;0.29;349.77;15.61;1272;22;3877.00;191
9800;20;21880822;9800;458;11066;11258;4.79;0.29;349.76;15.61;1266;22;3878.00;192
9802;20;21880837;9802;459;11067;11259;4.80;0.29;349.75;15.60;1265;22;3879.00;192
9804;20;21880858;9804;460;11067;11259;4.82;0.29;349.73;15.60;1263;22;3880.00;192
9807;20;21880874;9807;458;11068;11260;4.85;0.29;349.70;15.60;1261;22;3881.00;192
9809;20;21880888;9809;451;11068;11260;4.87;0.30;349.67;15.60;1259;22;3882.00;192
9814;20;21880903;9814;442;11069;11260;4.88;0.30;349.73;15.64;1255;22;3883.00;191
9816;20;21880919;9816;440;11069;11260;4.90;0.30;349.79;15.64;1253;22;3884.00;191
9821;20;21880934;9821;443;11069;11260;4.90;0.30;349.84;15.64;1248;22;3885.00;191
9821;20;21880949;9821;434;11069;11260;5.00;0.30;349.84;15.64;1248;22;3886.00;191
9828;20;21880963;9828;442;11069;11260;4.99;0.30;349.99;15.64;1241;22;3887.00;191
9830;20;21880979;9830;456;11144;11387;5.26;0.32;350.05;15.54;1314;22;3888.00;243
9832;20;21881005;9832;446;11146;11388;5.32;0.33;350.03;15.54;1314;22;3889.00;242
9834;20;21881021;9834;440;11153;11388;5.37;0.33;350.03;15.53;1319;22;3890.00;235
9839;20;21881043;9839;438;11153;11388;5.29;0.33;350.01;15.53;1314;22;3891.00;235
9844;20;21881066;9844;439;11159;11388;5.22;0.32;350.00;15.52;1315;22;3892.00;229
9845;20;21881082;9845;434;11159;11388;5.20;0.32;350.04;15.52;1314;22;3893.00;229
9849;20;21881097;9849;443;11160;11388;5.12;0.31;350.11;15.52;1311;22;3894.00;228
9851;20;21881113;9851;450;11163;11388;5.02;0.31;350.18;15.52;1312;22;3895.00;225
9853;20;21881128;9853;454;11163;11389;4.95;0.30;350.27;15.52;1310;22;3896.00;226
9854;20;21881144;9854;441;11164;11390;4.93;0.30;350.30;15.52;1310;22;3897.00;226
9857;20;21881160;9857;444;11168;11390;4.94;0.30;350.30;15.56;1311;22;3898.00;222
9860;20;21881176;9860;443;11172;11391;4.86;0.30;350.33;15.56;1312;22;3899.00;219
9860;20;21881194;9860;443;11181;11406;4.86;0.30;350.33;15.55;1321;22;3900.00;225
9864;20;21881216;9864;440;11183;11406;4.85;0.30;350.36;15.55;1319;22;3901.00;223
9864;20;21881232;9864;453;11186;11406;4.91;0.30;350.36;15.58;1322;22;3902.00;220
9868;20;21881247;9868;464;11188;11410;4.89;0.30;350.52;15.58;1320;22;3903.00;222
9870;20;21881265;9870;465;11190;11410;4.93;0.30;350.57;15.58;1320;22;3904.00;220
9871;20;21881281;9871;474;11192;11410;4.97;0.30;350.58;15.58;1321;22;3905.00;218
9873;20;21881302;9873;465;11197;11413;5.02;0.31;350.56;15.58;1324;22;3906.00;216
9875;20;21881318;9875;459;11199;11413;5.08;0.31;350.54;15.58;1324;22;3907.00;214
9879;20;21881335;9879;455;11200;11413;5.08;0.31;350.54;15.58;1321;22;3908.00;213
9881;20;21881351;9881;452;11204;11417;5.07;0.31;350.65;15.61;1323;22;3909.00;213
9883;20;21881369;9883;447;11206;11418;5.09;0.31;350.73;15.61;1323;22;3910.00;212
9884;20;21881385;9884;447;11207;11418;5.09;0.31;350.77;15.61;1323;22;3911.00;211
9885;20;21881402;9885;450;11214;11422;5.09;0.31;350.80;15.61;1329;22;3912.00;208
9886;20;21881426;9886;456;11214;11422;5.10;0.31;350.81;15.61;1328;22;3913.00;208
9887;20;21881441;9887;458;11214;11422;5.15;0.31;350.90;15.61;1327;22;3914.00;208
9888;20;21881457;9888;469;11217;11424;5.18;0.32;350.89;15.60;1329;22;3915.00;207
9891;20;21881473;9891;468;11217;11424;5.19;0.32;350.95;15.60;1326;22;3916.00;207
9893;20;21881489;9893;458;11221;11430;5.21;0.32;350.97;15.60;1328;22;3917.00;209
9896;20;21881506;9896;458;11222;11430;5.22;0.32;351.04;15.60;1326;22;3918.00;208
9899;20;21881528;9899;464;11222;11431;5.22;0.32;351.12;15.60;1323;22;3919.00;209
9901;20;21881544;9901;454;11222;11431;5.23;0.32;351.16;15.60;1321;22;3920.00;209
9902;20;21881560;9902;460;11223;11431;5.23;0.32;351.17;15.60;1321;22;3921.00;208
9906;20;21881575;9906;460;11223;11431;5.22;0.32;351.18;15.60;1317;22;3922.00;208
9906;20;21881592;9906;466;11223;11431;5.24;0.32;351.18;15.60;1317;22;3923.00;208
9909;20;21881607;9909;469;11235;11443;5.27;0.32;351.30;15.59;1326;22;3924.00;208
9913;20;21881629;9913;468;11235;11443;5.24;0.32;351.38;15.59;1322;22;3925.00;208
9914;20;21881645;9914;475;11236;11443;5.25;0.32;351.44;15.59;1322;22;3926.00;207
9916;20;21881661;9916;475;11236;11443;5.25;0.32;351.53;15.59;1320;22;3927.00;207
9918;20;21881683;9918;469;11236;11443;5.30;0.32;351.67;15.59;1318;22;3928.00;207
9921;20;21881699;9921;471;11236;11443;5.31;0.32;351.65;15.59;1315;22;3929.00;207
9923;20;21881716;9923;461;11241;11447;5.25;0.32;351.75;15.58;1318;22;3930.00;206
9925;20;21881733;9925;466;11241;11447;5.22;0.32;351.80;15.58;1316;22;3931.00;206
9929;20;21881748;9929;478;11245;11451;5.14;0.31;351.70;15.58;1316;22;3932.00;206
9932;20;21881764;9932;478;11246;11452;5.01;0.30;351.83;15.58;1314;22;3933.00;206
9934;20;21881780;9934;477;11246;11452;4.93;0.30;351.86;15.58;1312;22;3934.00;206
9935;20;21881795;9935;478;11246;11452;4.87;0.30;351.85;15.58;1311;22;3935.00;206
9939;20;21881810;9939;482;11257;11465;4.87;0.30;351.93;15.56;1318;22;3936.00;208
9940;20;21881826;9940;485;11258;11465;4.86;0.29;351.93;15.60;1318;22;3937.00;207
9940;20;21881841;9940;494;11258;11465;4.86;0.30;351.93;15.60;1318;22;3938.00;207
9941;20;21881856;9941;500;11259;11466;4.86;0.30;351.92;15.59;1318;22;3939.00;207
9943;20;21881876;9943;494;11259;11467;4.82;0.29;352.00;15.59;1316;22;3940.00;208
9947;20;21881895;9947;497;11259;11467;4.80;0.29;351.97;15.59;1312;22;3941.00;208
9952;20;21881915;9952;492;11261;11470;4.79;0.29;352.12;15.59;1309;22;3942.00;209
9953;20;21881934;9953;489;11261;11470;4.83;0.29;352.12;15.59;1308;22;3943.00;209
9957;20;21881951;9957;491;11262;11470;4.83;0.29;352.18;15.59;1305;22;3944.00;208
9962;20;21881969;9962;491;11262;11470;4.81;0.29;352.20;15.59;1300;22;3945.00;208
9964;20;21881986;9964;490;11267;11476;4.85;0.30;352.23;15.58;1303;22;3946.00;209
9968;20;21882003;9968;490;11267;11476;4.87;0.30;352.25;15.58;1299;22;3947.00;209
9972;20;21882018;9972;483;11267;11476;4.88;0.30;352.29;15.58;1295;22;3948.00;209
9973;20;21882034;9973;482;11267;11476;4.93;0.30;352.30;15.58;1294;22;3949.00;209
9974;20;21882049;9974;477;11270;11480;4.93;0.30;352.37;15.58;1296;22;3950.00;210
9977;20;21882065;9977;480;11271;11481;4.96;0.30;352.39;15.58;1294;22;3951.00;210
9981;20;21882080;9981;480;11271;11481;4.94;0.30;352.39;15.58;1290;22;3952.00;210
9986;20;21882095;9986;474;11272;11482;4.97;0.30;352.45;15.58;1286;22;3953.00;210
9988;20;21882110;9988;469;11272;11482;4.94;0.30;352.50;15.58;1284;22;3954.00;210
9990;20;21882124;9990;463;11274;11482;4.89;0.30;352.52;15.70;1284;22;3955.00;208
9991;20;21882142;9991;459;11274;11482;4.88;0.30;352.52;15.70;1283;22;3956.00;208
9993;20;21882156;9993;454;11274;11482;4.88;0.30;352.49;15.70;1281;22;3957.00;208
9996;20;21882170;9996;458;11275;11482;4.84;0.30;352.54;15.73;1279;22;3958.00;207
10001;20;21882184;10001;456;11275;11482;4.78;0.29;352.54;15.73;1274;22;3959.00;207
10002;20;21882201;10002;470;11336;11607;4.98;0.31;352.55;15.70;1334;22;3960.00;271
10008;20;21882227;10008;463;11336;11608;4.94;0.31;352.48;15.70;1328;22;3961.00;272
10010;20;21882248;10010;463;11346;11608;5.02;0.31;352.51;15.69;1336;22;3962.00;262
10013;20;21882263;10013;464;11349;11608;5.04;0.31;352.49;15.69;1336;22;3963.00;259
10016;20;21882278;10016;462;11356;11608;5.06;0.31;352.45;15.68;1340;22;3964.00;252
10020;20;21882293;10020;476;11357;11608;5.02;0.31;352.45;15.68;1337;22;3965.00;251
10020;20;21882308;10020;480;11362;11608;5.03;0.31;352.45;15.68;1342;22;3966.00;246
10023;20;21882322;10023;487;11367;11608;4.97;0.31;352.39;15.67;1344;22;3967.00;241
10023;20;21882336;10023;493;11370;11609;4.95;0.31;352.39;15.67;1347;22;3968.00;239
10027;20;21882351;10027;494;11372;11610;4.88;0.30;352.32;15.67;1345;22;3969.00;238
10032;20;21882367;10032;499;11376;11610;4.83;0.30;352.30;15.67;1344;22;3970.00;234
10035;20;21882384;10035;504;11381;11614;4.80;0.29;352.29;15.66;1346;22;3971.00;233
10036;20;21882400;10036;510;11381;11614;4.73;0.29;352.26;15.66;1345;22;3972.00;233
10036;20;21882415;10036;516;11382;11614;4.73;0.29;352.26;15.66;1346;22;3973.00;232
10041;20;21882430;10041;514;11382;11614;4.71;0.29;352.26;15.66;1341;22;3974.00;232
10042;20;21882447;10042;524;11387;11620;4.74;0.29;352.25;15.66;1345;22;3975.00;233
10046;20;21882462;10046;527;11388;11620;4.71;0.29;352.20;15.72;1342;22;3976.00;232
10046;20;21882478;10046;537;11389;11620;4.68;0.29;352.20;15.77;1343;22;3977.00;231
10047;20;21882494;10047;532;11391;11623;4.63;0.28;352.20;15.77;1344;22;3978.00;232
10047;20;21882516;10047;538;11393;11623;4.57;0.28;352.20;15.77;1346;22;3979.00;230
10051;20;21882530;10051;543;11394;11623;4.51;0.28;352.23;15.83;1343;22;3980.00;229
10052;20;21882545;10052;549;11394;11624;4.45;0.27;352.21;15.83;1342;22;3981.00;230
10053;20;21882559;10053;557;11397;11625;4.42;0.27;352.21;15.83;1344;22;3982.00;228
10057;20;21882573;10057;560;11398;11625;4.35;0.27;352.17;15.83;1341;22;3983.00;227
10060;20;21882588;10060;564;11409;11638;4.36;0.27;352.21;15.88;1349;22;3984.00;229
10063;20;21882605;10063;565;11409;11638;4.31;0.26;352.17;15.88;1346;22;3985.00;229
10065;20;21882619;10065;572;11409;11638;4.22;0.26;352.20;15.88;1344;22;3986.00;229
10065;20;21882634;10065;580;11410;11639;4.19;0.26;352.20;15.87;1345;22;3987.00;229
10066;20;21882648;10066;583;11411;11639;4.15;0.25;352.21;15.93;1345;22;3988.00;228
10069;20;21882663;10069;583;11414;11643;4.08;0.25;352.22;15.93;1345;22;3989.00;229
10069;20;21882680;10069;590;11414;11643;4.04;0.25;352.22;15.93;1345;22;3990.00;229
10071;20;21882694;10071;594;11418;11647;3.97;0.24;352.24;15.92;1347;22;3991.00;229
10072;20;21882709;10072;589;11418;11647;3.94;0.24;352.30;15.92;1346;22;3992.00;229
10073;20;21882723;10073;586;11426;11647;3.95;0.24;352.27;16.39;1353;22;3993.00;221
10075;20;21882737;10075;578;11428;11647;3.99;0.25;352.25;16.45;1353;22;3994.00;219
10077;20;21882751;10077;589;11428;11647;4.00;0.25;352.19;16.45;1351;22;3995.00;219
10081;20;21882766;10081;586;11439;11659;4.02;0.25;352.12;16.43;1358;22;3996.00;220
10082;20;21882781;10082;580;11439;11659;4.03;0.25;352.13;16.43;1357;22;3997.00;220
10083;20;21882795;10083;584;11440;11659;3.96;0.24;352.14;16.49;1357;22;3998.00;219
10083;20;21882817;10083;584;11441;11659;3.94;0.24;352.14;16.55;1358;22;3999.00;218
10083;20;21882831;10083;575;11442;11659;3.95;0.24;352.14;16.61;1359;22;4000.00;217
10085;20;21882850;10085;576;11442;11659;3.95;0.24;352.13;16.61;1357;22;4001.00;217
10086;20;21882865;10086;579;11443;11660;3.95;0.24;352.11;16.66;1357;22;4002.00;217
10086;20;21882879;10086;570;11444;11660;3.96;0.24;352.11;16.72;1358;22;4003.00;216
10087;20;21882899;10087;579;11449;11666;4.02;0.25;352.09;16.71;1362;22;4004.00;217
10087;20;21882914;10087;579;11452;11668;4.06;0.25;352.09;16.76;1365;22;4005.00;216
10088;20;21882927;10088;585;11453;11668;4.09;0.25;352.09;16.82;1365;22;4006.00;215
10091;20;21882947;10091;591;11454;11668;4.11;0.25;352.12;16.88;1363;22;4007.00;214
10094;20;21882962;10094;594;11458;11672;4.17;0.26;352.07;16.93;1364;22;4008.00;214
10096;20;21882977;10096;593;11458;11672;4.25;0.26;352.09;16.93;1362;22;4009.00;214
10098;20;21882992;10098;599;11459;11672;4.29;0.26;352.11;16.98;1361;22;4010.00;213
10099;20;21883007;10099;594;11460;11673;4.34;0.27;352.11;16.98;1361;22;4011.00;213
10100;20;21883021;10100;603;11463;11677;4.36;0.27;352.09;16.98;1363;22;4012.00;214
10103;20;21883035;10103;602;11463;11677;4.38;0.27;352.09;16.98;1360;22;4013.00;214
10105;20;21883049;10105;610;11465;11680;4.45;0.27;352.08;16.97;1360;22;4014.00;215
10112;20;21883064;10112;611;11465;11680;4.41;0.27;352.04;16.97;1353;22;4015.00;215
10113;20;21883078;10113;603;11466;11680;4.41;0.27;352.05;16.97;1353;22;4016.00;214
10117;20;21883092;10117;612;11466;11680;4.40;0.27;352.02;16.97;1349;22;4017.00;214
10120;20;21883105;10120;614;11470;11684;4.41;0.27;352.12;16.97;1350;22;4018.00;214
10123;20;21883120;10123;606;11470;11684;4.41;0.27;352.08;16.97;1347;22;4019.00;214
10127;20;21883136;10127;608;11470;11684;4.36;0.27;352.29;16.97;1343;22;4020.00;214
10131;20;21883150;10131;599;11470;11684;4.33;0.26;352.37;16.97;1339;22;4021.00;214
10136;20;21883164;10136;590;11470;11685;4.28;0.26;352.35;16.97;1334;22;4022.00;215
10139;20;21883179;10139;585;11471;11686;4.23;0.26;352.50;16.97;1332;22;4023.00;215
10142;20;21883193;10142;583;11471;11686;4.20;0.26;352.63;16.97;1329;22;4024.00;215
10145;20;21883206;10145;569;11472;11687;4.21;0.26;352.70;16.96;1327;22;4025.00;215
10151;20;21883219;10151;567;11472;11687;4.18;0.25;352.78;16.96;1321;22;4026.00;215
10155;20;21883233;10155;554;11472;11687;4.19;0.26;352.86;16.96;1317;22;4027.00;215
10158;20;21883247;10158;553;11472;11687;4.17;0.25;352.85;16.96;1314;22;4028.00;215
10161;20;21883267;10161;536;11472;11687;4.18;0.26;352.93;16.96;1311;22;4029.00;215
10166;20;21883281;10166;533;11472;11687;4.17;0.25;353.00;16.96;1306;22;4030.00;215
10167;20;21883295;10167;527;11472;11687;4.21;0.26;352.97;16.96;1305;22;4031.00;215
10168;20;21883309;10168;535;11543;11814;4.54;0.28;352.99;16.86;1375;22;4032.00;271
10170;20;21883333;10170;518;11547;11815;4.58;0.28;353.00;16.86;1377;22;4033.00;268
10173;20;21883348;10173;508;11553;11815;4.63;0.29;353.05;16.85;1380;22;4034.00;262
10177;20;21883363;10177;496;11556;11815;4.64;0.29;353.12;16.84;1379;22;4035.00;259
10180;20;21883378;10180;486;11559;11815;4.63;0.29;353.28;16.84;1379;22;4036.00;256
10185;20;21883393;10185;481;11562;11815;4.61;0.29;353.31;16.84;1377;22;4037.00;253
10188;20;21883408;10188;465;11564;11815;4.63;0.29;353.40;16.84;1376;22;4038.00;251
10194;20;21883424;10194;473;11564;11815;4.63;0.28;353.54;16.84;1370;22;4039.00;251
10196;20;21883440;10196;470;11564;11816;4.66;0.29;353.53;16.84;1368;22;4040.00;252
10199;20;21883455;10199;467;11566;11817;4.67;0.29;353.71;16.83;1367;22;4041.00;251
10202;20;21883471;10202;466;11567;11817;4.70;0.29;353.72;16.83;1365;22;4042.00;250
10204;20;21883487;10204;470;11568;11818;4.76;0.29;353.80;16.83;1364;22;4043.00;250
10208;20;21883504;10208;468;11571;11818;4.76;0.29;353.90;16.87;1363;22;4044.00;247
10213;20;21883519;10213;463;11571;11818;4.74;0.29;354.04;16.87;1358;22;4045.00;247
10216;20;21883536;10216;468;11573;11818;4.74;0.29;354.16;16.87;1357;22;4046.00;245
10219;20;21883551;10219;467;11577;11822;4.80;0.29;354.23;16.87;1358;22;4047.00;245
10224;20;21883568;10224;466;11578;11822;4.80;0.29;354.24;16.87;1354;22;4048.00;244
10227;20;21883584;10227;463;11580;11822;4.80;0.29;354.43;16.87;1353;22;4049.00;242
10228;20;21883602;10228;472;11583;11828;4.84;0.30;354.43;16.86;1355;22;4050.00;245
10231;20;21883618;10231;467;11584;11828;4.82;0.29;354.58;16.86;1353;22;4051.00;244
10236;20;21883634;10236;467;11585;11828;4.84;0.30;354.66;16.86;1349;22;4052.00;243
10241;20;21883650;10241;477;11591;11832;4.86;0.30;354.72;16.86;1350;22;4053.00;241
10245;20;21883666;10245;466;11593;11833;4.81;0.29;354.88;16.86;1348;22;4054.00;240
10247;20;21883682;10247;472;11594;11833;4.78;0.29;354.95;16.86;1347;22;4055.00;239
10249;20;21883698;10249;472;11596;11837;4.79;0.29;354.97;16.86;1347;22;4056.00;241
10254;20;21883714;10254;469;11597;11837;4.78;0.29;355.07;16.86;1343;22;4057.00;240
10256;20;21883730;10256;461;11597;11837;4.82;0.29;355.09;16.86;1341;22;4058.00;240
10259;20;21883746;10259;462;11599;11838;4.83;0.30;355.22;16.86;1340;22;4059.00;239
10263;20;21883762;10263;461;11601;11838;4.81;0.29;355.24;16.86;1338;22;4060.00;237
10270;20;21883778;10270;448;11605;11844;4.79;0.29;355.31;16.86;1335;22;4061.00;239
10273;20;21883795;10273;452;11607;11844;4.80;0.29;355.43;16.86;1334;22;4062.00;237
10274;20;21883812;10274;454;11607;11845;4.84;0.29;355.41;16.86;1333;22;4063.00;238
10278;20;21883828;10278;448;11609;11845;4.87;0.30;355.47;16.85;1331;22;4064.00;236
10282;20;21883844;10282;441;11611;11845;4.87;0.30;355.56;16.86;1329;22;4065.00;234
10284;20;21883859;10284;441;11612;11845;4.84;0.29;355.57;16.85;1328;22;4066.00;233
10286;20;21883881;10286;440;11614;11845;4.82;0.29;355.61;16.85;1328;22;4067.00;231
10291;20;21883900;10291;439;11621;11857;4.78;0.29;355.57;16.89;1330;22;4068.00;236
10294;20;21883922;10294;442;11623;11857;4.76;0.29;355.62;16.88;1329;22;4069.00;234
10297;20;21883941;10297;438;11624;11857;4.69;0.29;355.72;16.92;1327;22;4070.00;233
10299;20;21883959;10299;451;11626;11857;4.70;0.29;355.81;16.92;1327;22;4071.00;231
10299;20;21883979;10299;441;11626;11857;4.70;0.29;355.81;16.92;1327;22;4072.00;231
10303;20;21883996;10303;437;11627;11857;4.68;0.29;355.84;16.92;1324;22;4073.00;230
10304;20;21884013;10304;437;11632;11861;4.71;0.29;355.85;16.91;1328;22;4074.00;229
10307;20;21884031;10307;434;11632;11861;4.72;0.29;355.88;16.91;1325;22;4075.00;229
10311;20;21884047;10311;434;11636;11865;4.76;0.29;355.94;16.91;1325;22;4076.00;229
10314;20;21884064;10314;437;11637;11866;4.79;0.29;356.12;16.91;1323;22;4077.00;229
10316;20;21884080;10316;446;11637;11866;4.80;0.29;356.11;16.91;1321;22;4078.00;229
10318;20;21884096;10318;453;11637;11866;4.85;0.30;356.13;16.91;1319;22;4079.00;229
10323;20;21884114;10323;465;11659;11895;4.84;0.29;356.31;16.88;1336;22;4080.00;236
10324;20;21884139;10324;456;11660;11895;4.82;0.29;356.29;16.87;1336;22;4081.00;235
10325;20;21884155;10325;450;11662;11895;4.81;0.29;356.29;16.87;1337;22;4082.00;233
10327;20;21884171;10327;457;11663;11896;4.82;0.29;356.29;16.87;1336;22;4083.00;233
10332;20;21884187;10332;453;11663;11897;4.79;0.29;356.26;16.87;1331;22;4084.00;234
10334;20;21884202;10334;458;11663;11897;4.78;0.29;356.30;16.87;1329;22;4085.00;234
10337;20;21884219;10337;464;11665;11900;4.74;0.29;356.29;16.87;1328;22;4086.00;235
10339;20;21884237;10339;471;11665;11900;4.73;0.29;356.35;16.87;1326;22;4087.00;235
10343;20;21884257;10343;477;11666;11900;4.69;0.28;356.44;16.87;1323;22;4088.00;234
10344;20;21884275;10344;482;11666;11900;4.69;0.28;356.51;16.87;1322;22;4089.00;234
10349;20;21884291;10349;488;11671;11906;4.68;0.28;356.61;16.86;1322;22;4090.00;235
10350;20;21884316;10350;493;11671;11906;4.66;0.28;356.61;16.86;1321;22;4091.00;235
10353;20;21884332;10353;498;11671;11906;4.63;0.28;356.68;16.86;1318;22;4092.00;235
10353;20;21884352;10353;487;11671;11906;4.61;0.28;356.68;16.86;1318;22;4093.00;235
10354;20;21884378;10354;487;11674;11910;4.57;0.28;356.77;16.86;1320;22;4094.00;236
10358;20;21884395;10358;486;11676;11912;4.52;0.27;356.80;16.85;1318;22;4095.00;236
10360;20;21884411;10360;491;11676;11912;4.50;0.27;356.79;16.85;1316;22;4096.00;236
10362;20;21884427;10362;495;11677;11913;4.50;0.27;356.88;16.85;1315;22;4097.00;236
10363;20;21884444;10363;501;11677;11913;4.51;0.27;356.85;16.85;1314;22;4098.00;236
10366;20;21884460;10366;494;11677;11913;4.49;0.27;356.92;16.85;1311;22;4099.00;236
10367;20;21884477;10367;498;11677;11913;4.50;0.27;356.96;16.85;1310;22;4100.00;236
10369;20;21884498;10369;493;11677;11913;4.54;0.28;357.02;16.85;1308;22;4101.00;236
10371;20;21884514;10371;494;11677;11913;4.53;0.28;357.10;16.85;1306;22;4102.00;236
10372;20;21884529;10372;488;11677;11913;4.57;0.28;357.14;16.85;1305;22;4103.00;236
10373;20;21884543;10373;504;11717;11983;4.64;0.28;357.18;16.79;1344;22;4104.00;266
10373;20;21884564;10373;501;11719;11984;4.65;0.28;357.18;16.79;1346;22;4105.00;265
10374;20;21884579;10374;501;11725;11984;4.69;0.29;357.22;16.83;1351;22;4106.00;259
10374;20;21884594;10374;499;11729;11984;4.74;0.29;357.22;16.82;1355;22;4107.00;255
10376;20;21884609;10376;501;11733;11984;4.74;0.29;357.27;16.82;1357;22;4108.00;251
10377;20;21884630;10377;510;11736;11984;4.73;0.29;357.25;16.81;1359;22;4109.00;248
10382;20;21884648;10382;511;11738;11984;4.71;0.29;357.40;16.81;1356;22;4110.00;246
10384;20;21884664;10384;527;11740;11984;4.74;0.29;357.41;16.81;1356;22;4111.00;244
10387;20;21884680;10387;529;11742;11985;4.75;0.29;357.40;16.81;1355;22;4112.00;243
10388;20;21884696;10388;531;11743;11986;4.76;0.29;357.42;16.81;1355;22;4113.00;243
10391;20;21884712;10391;535;11744;11986;4.75;0.29;357.40;16.81;1353;22;4114.00;242
10392;20;21884728;10392;538;11748;11990;4.73;0.29;357.44;16.80;1356;22;4115.00;242
10393;20;21884745;10393;530;11749;11990;4.71;0.29;357.42;16.80;1356;22;4116.00;241
10396;20;21884761;10396;525;11749;11990;4.67;0.29;357.41;16.80;1353;22;4117.00;241
10399;20;21884778;10399;526;11749;11990;4.64;0.28;357.38;16.80;1350;22;4118.00;241
10403;20;21884794;10403;525;11754;11996;4.68;0.29;357.37;16.79;1351;22;4119.00;242
10406;20;21884811;10406;527;11754;11996;4.69;0.29;357.33;16.79;1348;22;4120.00;242
10407;20;21884827;10407;525;11754;11996;4.71;0.29;357.33;16.79;1347;22;4121.00;242
10411;20;21884842;10411;531;11757;11999;4.73;0.29;357.34;16.83;1346;22;4122.00;242
10414;20;21884859;10414;526;11757;11999;4.75;0.29;357.38;16.83;1343;22;4123.00;242
10416;20;21884876;10416;526;11758;11999;4.75;0.29;357.37;16.83;1342;22;4124.00;241
10423;20;21884893;10423;535;11758;12000;4.65;0.29;357.34;16.83;1335;22;4125.00;242
10425;20;21884908;10425;528;11759;12001;4.64;0.28;357.30;16.83;1334;22;4126.00;242
10428;20;21884925;10428;526;11759;12001;4.56;0.28;357.42;16.83;1331;22;4127.00;242
10429;20;21884940;10429;533;11768;12014;4.54;0.28;357.45;16.82;1339;22;4128.00;246
10433;20;21884963;10433;536;11768;12014;4.50;0.28;357.49;16.82;1335;22;4129.00;246
10438;20;21884980;10438;538;11770;12014;4.45;0.27;357.44;16.88;1332;22;4130.00;244
10438;20;21885001;10438;541;11772;12015;4.46;0.27;357.44;16.94;1334;22;4131.00;243
10440;20;21885017;10440;538;11772;12015;4.44;0.27;357.41;16.94;1332;22;4132.00;243
10446;20;21885032;10446;528;11775;12019;4.41;0.27;357.33;16.94;1329;22;4133.00;244
10448;20;21885048;10448;535;11777;12019;4.37;0.27;357.30;16.94;1329;22;4134.00;242
10450;20;21885065;10450;535;11780;12023;4.38;0.27;357.36;16.93;1330;22;4135.00;243
10451;20;21885081;10451;536;11780;12023;4.36;0.27;357.35;16.93;1329;22;4136.00;243
10455;20;21885098;10455;544;11780;12023;4.30;0.26;357.35;16.93;1325;22;4137.00;243
10457;20;21885117;10457;546;11781;12023;4.27;0.26;357.35;16.98;1324;22;4138.00;242
10459;20;21885133;10459;547;11781;12023;4.23;0.26;357.39;16.98;1322;22;4139.00;242
10461;20;21885150;10461;550;11802;12057;4.30;0.26;357.34;16.95;1341;22;4140.00;255
10463;20;21885168;10463;547;11803;12057;4.30;0.26;357.32;16.95;1340;22;4141.00;254
10465;20;21885185;10465;548;11804;12057;4.29;0.26;357.27;16.95;1339;22;4142.00;253
10466;20;21885199;10466;557;11805;12057;4.30;0.26;357.31;16.94;1339;22;4143.00;252
10468;20;21885214;10468;559;11805;12057;4.31;0.26;357.30;16.94;1337;22;4144.00;252
10470;20;21885229;10470;571;11805;12057;4.32;0.26;357.37;16.94;1335;22;4145.00;252
10471;20;21885245;10471;567;11806;12058;4.29;0.26;357.35;17.01;1335;22;4146.00;252
10472;20;21885259;10472;566;11806;12058;4.30;0.26;357.36;17.01;1334;22;4147.00;252
10475;20;21885274;10475;562;11811;12064;4.28;0.26;357.30;17.00;1336;22;4148.00;253
10476;20;21885289;10476;551;11812;12065;4.26;0.26;357.29;17.00;1336;22;4149.00;253
10478;20;21885305;10478;544;11813;12065;4.21;0.26;357.25;17.06;1335;22;4150.00;252
10479;20;21885321;10479;545;11814;12065;4.24;0.26;357.31;17.06;1335;22;4151.00;251
10479;20;21885338;10479;541;11818;12069;4.31;0.26;357.31;17.06;1339;22;4152.00;251
10482;20;21885354;10482;534;11819;12069;4.29;0.26;357.31;17.06;1337;22;4153.00;250
10484;20;21885369;10484;540;11820;12069;4.29;0.26;357.27;17.06;1336;22;4154.00;249
10486;20;21885384;10486;546;11822;12070;4.33;0.26;357.29;17.12;1336;22;4155.00;248
10488;20;21885406;10488;544;11825;12074;4.35;0.27;357.24;17.12;1337;22;4156.00;249
10489;20;21885422;10489;547;11828;12074;4.41;0.27;357.20;17.24;1339;22;4157.00;246
10491;20;21885437;10491;551;11830;12077;4.48;0.27;357.19;17.24;1339;22;4158.00;247
10492;20;21885452;10492;552;11832;12077;4.49;0.27;357.19;17.30;1340;22;4159.00;245
10493;20;21885468;10493;552;11832;12077;4.47;0.27;357.18;17.30;1339;22;4160.00;245
10495;20;21885492;10495;555;11833;12077;4.46;0.27;357.23;17.36;1338;22;4161.00;244
10495;20;21885510;10495;562;11838;12081;4.50;0.27;357.23;17.42;1343;22;4162.00;243
10496;20;21885525;10496;568;11839;12081;4.48;0.27;357.22;17.48;1343;22;4163.00;242
10499;20;21885540;10499;568;11839;12081;4.50;0.27;357.23;17.48;1340;22;4164.00;242
10501;20;21885555;10501;574;11839;12081;4.53;0.28;357.22;17.48;1338;22;4165.00;242
10503;20;21885570;10503;572;11840;12082;4.52;0.28;357.18;17.55;1337;22;4166.00;242
10503;20;21885585;10503;576;11842;12083;4.52;0.28;357.18;17.61;1339;22;4167.00;241
10504;20;21885600;10504;567;11842;12083;4.51;0.28;357.17;17.61;1338;22;4168.00;241
10505;20;21885615;10505;562;11844;12084;4.50;0.28;357.19;17.67;1339;22;4169.00;240
10508;20;21885632;10508;561;11844;12084;4.48;0.27;357.17;17.67;1336;22;4170.00;240
10512;20;21885647;10512;557;11845;12084;4.47;0.27;357.11;17.73;1333;22;4171.00;239
10514;20;21885663;10514;562;11845;12084;4.47;0.27;357.10;17.73;1331;22;4172.00;239
10517;20;21885677;10517;564;11849;12086;4.39;0.27;357.31;17.85;1332;22;4173.00;237
10519;20;21885692;10519;549;11850;12086;4.38;0.27;357.27;17.91;1331;22;4174.00;236
10522;20;21885706;10522;547;11851;12086;4.36;0.27;357.37;17.97;1329;22;4175.00;235
10525;20;21885721;10525;563;11916;12213;4.59;0.28;357.43;17.88;1391;22;4176.00;297
10528;20;21885746;10528;550;11922;12214;4.60;0.28;357.64;17.99;1394;22;4177.00;292
10531;20;21885762;10531;537;11928;12214;4.64;0.29;357.78;17.98;1397;22;4178.00;286
10534;20;21885778;10534;544;11934;12214;4.64;0.29;357.85;17.98;1400;22;4179.00;280
10535;20;21885794;10535;538;11942;12214;4.69;0.29;357.88;18.09;1407;22;4180.00;272
10537;20;21885809;10537;539;11948;12214;4.72;0.29;357.84;18.08;1411;22;4181.00;266
10539;20;21885824;10539;540;11951;12214;4.73;0.29;357.84;18.20;1412;22;4182.00;263
10541;20;21885839;10541;544;11953;12214;4.77;0.29;357.90;18.20;1412;22;4183.00;261
10542;20;21885854;10542;542;11959;12215;4.85;0.30;357.98;18.31;1417;22;4184.00;256
10544;20;21885871;10544;551;11961;12217;4.87;0.30;358.00;18.31;1417;22;4185.00;256
10549;20;21885897;10549;559;11964;12217;4.80;0.29;358.11;18.31;1415;22;4186.00;253
10550;20;21885921;10550;559;11967;12218;4.74;0.29;358.12;18.43;1417;22;4187.00;251
10553;20;21885943;10553;564;11971;12218;4.72;0.29;358.18;18.42;1418;22;4188.00;247
10553;20;21885966;10553;570;11973;12218;4.69;0.29;358.18;18.42;1420;22;4189.00;245
10556;20;21885984;10556;575;11975;12218;4.60;0.28;358.37;18.54;1419;22;4190.00;243
10559;20;21886006;10559;579;11980;12222;4.55;0.28;358.44;18.53;1421;22;4191.00;242
10563;20;21886025;10563;584;11986;12222;4.46;0.27;358.39;18.65;1423;22;4192.00;236
10568;20;21886042;10568;588;11986;12222;4.35;0.27;358.53;18.65;1418;22;4193.00;236
10571;20;21886058;10571;587;11988;12225;4.26;0.26;358.54;18.65;1417;22;4194.00;237
10575;20;21886083;10575;599;11991;12225;4.21;0.26;358.55;18.76;1416;22;4195.00;234
10576;20;21886100;10576;604;11992;12225;4.19;0.26;358.63;18.76;1416;22;4196.00;233
10582;20;21886117;10582;603;11997;12229;4.13;0.25;358.62;18.87;1415;22;4197.00;232
10586;20;21886134;10586;605;11999;12230;4.10;0.25;358.65;18.87;1413;22;4198.00;231
10588;20;21886151;10588;611;12001;12230;4.10;0.25;358.69;18.86;1413;22;4199.00;229
10592;20;21886169;10592;604;12014;12264;4.12;0.25;358.71;18.96;1422;22;4200.00;250
10594;20;21886195;10594;592;12014;12264;4.17;0.25;358.78;18.96;1420;22;4201.00;250
10596;20;21886213;10596;596;12016;12264;4.21;0.26;358.88;18.96;1420;22;4202.00;248
10601;20;21886233;10601;589;12017;12265;4.26;0.26;359.09;18.96;1416;22;4203.00;248
10603;20;21886252;10603;587;12017;12265;4.34;0.26;359.09;18.96;1414;22;4204.00;248
10608;20;21886269;10608;589;12022;12271;4.39;0.27;359.25;18.95;1414;22;4205.00;249
10610;20;21886287;10610;587;12024;12271;4.45;0.27;359.29;18.95;1414;22;4206.00;247
10616;20;21886305;10616;578;12025;12272;4.52;0.27;359.35;18.95;1409;22;4207.00;247
10617;20;21886323;10617;571;12025;12272;4.63;0.28;359.36;18.95;1408;22;4208.00;247
10621;20;21886339;10621;576;12025;12272;4.65;0.28;359.48;18.95;1404;22;4209.00;247
10622;20;21886355;10622;564;12025;12272;4.70;0.29;359.52;18.95;1403;22;4210.00;247
10627;20;21886372;10627;562;12027;12272;4.68;0.28;359.61;18.94;1400;22;4211.00;245
10631;20;21886388;10631;549;12037;12284;4.71;0.29;359.67;18.93;1406;22;4212.00;247
10634;21;21886406;10634;546;12039;12284;4.73;0.29;359.73;18.93;1405;23;4213.00;245
10638;21;21886431;10638;538;12039;12284;4.73;0.29;359.76;18.93;1401;23;4214.00;245
10643;21;21886448;10643;535;12039;12284;4.70;0.28;359.84;18.93;1396;23;4215.00;245
10646;21;21886465;10646;544;12039;12284;4.73;0.29;359.96;18.93;1393;23;4216.00;245
10649;21;21886483;10649;541;12041;12284;4.75;0.29;360.01;18.93;1392;23;4217.00;243
10653;21;21886505;10653;545;12044;12288;4.74;0.29;360.20;18.92;1391;23;4218.00;244
10657;21;21886522;10657;541;12045;12288;4.72;0.29;360.33;18.92;1388;23;4219.00;243
10659;21;21886569;10659;539;12048;12292;4.75;0.29;360.37;18.92;1389;23;4220.00;244
10666;21;21886590;10666;545;12049;12293;4.71;0.28;360.45;18.92;1383;23;4221.00;244
10668;21;21886606;10668;550;12051;12293;4.73;0.29;360.48;18.92;1383;23;4222.00;242
10671;21;21886622;10671;556;12051;12293;4.69;0.28;360.52;18.92;1380;23;4223.00;242
10676;21;21886638;10676;558;12059;12306;4.66;0.28;360.50;18.90;1383;23;4224.00;247
10680;21;21886655;10680;558;12062;12306;4.64;0.28;360.51;18.90;1382;23;4225.00;244
10683;21;21886672;10683;566;12062;12306;4.60;0.28;360.57;18.90;1379;23;4226.00;244
10685;21;21886687;10685;566;12063;12307;4.60;0.28;360.53;18.90;1378;23;4227.00;244
10691;21;21886703;10691;576;12064;12308;4.57;0.28;360.59;18.90;1373;23;4228.00;244
10694;21;21886720;10694;572;12064;12308;4.55;0.28;360.63;18.90;1370;23;4229.00;244
10697;21;21886737;10697;576;12068;12314;4.58;0.28;360.65;18.89;1371;23;4230.00;246
10699;21;21886753;10699;574;12068;12314;4.58;0.28;360.69;18.89;1369;23;4231.00;246
10703;21;21886770;10703;577;12070;12314;4.55;0.28;360.78;18.89;1367;23;4232.00;244
10707;21;21886787;10707;576;12071;12314;4.49;0.27;360.90;18.89;1364;23;4233.00;243
10710;21;21886803;10710;570;12076;12320;4.46;0.27;360.92;18.89;1366;23;4234.00;244
10713;21;21886819;10713;581;12076;12320;4.45;0.27;360.98;18.89;1363;23;4235.00;244
10718;21;21886834;10718;583;12077;12320;4.37;0.26;360.96;18.94;1359;23;4236.00;243
10721;21;21886850;10721;589;12077;12320;4.33;0.26;360.94;18.94;1356;23;4237.00;243
10721;21;21886866;10721;590;12080;12324;4.36;0.26;360.94;18.93;1359;23;4238.00;244
10724;21;21886882;10724;597;12082;12325;4.38;0.27;360.94;18.93;1358;23;4239.00;243
10726;21;21886898;10726;594;12082;12325;4.39;0.27;360.91;18.93;1356;23;4240.00;243
10727;21;21886912;10727;597;12083;12326;4.37;0.27;360.95;18.93;1356;23;4241.00;243
10731;21;21886928;10731;595;12083;12326;4.30;0.26;360.98;18.93;1352;23;4242.00;243
10731;21;21886943;10731;600;12083;12326;4.26;0.26;360.98;18.93;1352;23;4243.00;243
10735;21;21886957;10735;611;12084;12326;4.15;0.25;361.11;18.93;1349;23;4244.00;242
10739;21;21886972;10739;617;12084;12326;4.03;0.24;361.10;18.93;1345;23;4245.00;242
10741;21;21886987;10741;625;12084;12326;3.91;0.24;361.16;18.93;1343;23;4246.00;242
10742;21;21887002;10742;620;12084;12326;3.84;0.23;361.17;18.93;1342;23;4247.00;242
10743;21;21887018;10743;629;12121;12396;3.89;0.24;361.19;18.88;1378;23;4248.00;275
10745;21;21887038;10745;620;12121;12397;3.90;0.24;361.22;18.88;1376;23;4249.00;276
10748;21;21887055;10748;615;12128;12397;4.00;0.24;361.28;18.87;1380;23;4250.00;269
10750;21;21887075;10750;610;12128;12397;4.05;0.25;361.36;18.87;1378;23;4251.00;269
10753;21;21887096;10753;615;12133;12397;4.11;0.25;361.38;18.87;1380;23;4252.00;264
10756;21;21887115;10756;623;12136;12397;4.21;0.26;361.48;18.86;1380;23;4253.00;261
10758;21;21887134;10758;623;12139;12397;4.28;0.26;361.51;18.86;1381;23;4254.00;258
10763;21;21887154;10763;631;12142;12397;4.29;0.26;361.51;18.86;1379;23;4255.00;255
10763;21;21887173;10763;627;12143;12398;4.30;0.26;361.51;18.86;1380;23;4256.00;255
10768;21;21887191;10768;625;12147;12399;4.28;0.26;361.57;18.85;1379;23;4257.00;252
10771;21;21887209;10771;629;12149;12399;4.23;0.26;361.56;18.85;1378;23;4258.00;250
10773;21;21887224;10773;637;12155;12403;4.14;0.25;361.63;18.85;1382;23;4259.00;248
10775;21;21887242;10775;633;12156;12403;4.09;0.25;361.66;18.85;1381;23;4260.00;247
10778;21;21887258;10778;631;12156;12403;4.09;0.25;361.81;18.85;1378;23;4261.00;247
10780;21;21887273;10780;628;12156;12403;4.09;0.25;361.90;18.85;1376;23;4262.00;247
10783;21;21887289;10783;640;12161;12409;4.09;0.25;361.99;18.84;1378;23;4263.00;248
10786;21;21887305;10786;639;12161;12409;4.10;0.25;362.15;18.84;1375;23;4264.00;248
10788;21;21887321;10788;636;12161;12409;4.10;0.25;362.22;18.84;1373;23;4265.00;248
10791;21;21887340;10791;640;12163;12412;4.12;0.25;362.34;18.83;1372;23;4266.00;249
10793;21;21887362;10793;632;12163;12412;4.13;0.25;362.41;18.83;1370;23;4267.00;249
10796;21;21887383;10796;631;12164;12412;4.13;0.25;362.51;18.83;1368;23;4268.00;248
10799;21;21887403;10799;621;12164;12413;4.14;0.25;362.65;18.83;1365;23;4269.00;249
10802;21;21887423;10802;621;12165;12414;4.14;0.25;362.69;18.83;1363;23;4270.00;249
10803;21;21887445;10803;619;12165;12414;4.17;0.25;362.67;18.83;1362;23;4271.00;249
10804;21;21887465;10804;613;12174;12427;4.22;0.26;362.69;18.82;1370;23;4272.00;253
10806;21;21887487;10806;608;12174;12427;4.22;0.26;362.71;18.82;1368;23;4273.00;253
10809;21;21887507;10809;603;12174;12427;4.22;0.26;362.72;18.82;1365;23;4274.00;253
10811;21;21887526;10811;597;12176;12429;4.26;0.26;362.66;18.81;1365;23;4275.00;253
10814;21;21887542;10814;600;12176;12429;4.25;0.26;362.68;18.81;1362;23;4276.00;253
10816;21;21887558;10816;597;12180;12433;4.30;0.26;362.74;18.81;1364;23;4277.00;253
10817;21;21887574;10817;594;12180;12433;4.30;0.26;362.79;18.81;1363;23;4278.00;253
10819;21;21887589;10819;599;12183;12437;4.27;0.26;362.81;18.80;1364;23;4279.00;254
10823;21;21887605;10823;602;12183;12437;4.25;0.26;362.82;18.80;1360;23;4280.00;254
10824;21;21887621;10824;598;12183;12437;4.26;0.26;362.79;18.80;1359;23;4281.00;254
10826;21;21887641;10826;601;12183;12437;4.30;0.26;362.83;18.80;1357;23;4282.00;254
10828;21;21887662;10828;600;12183;12437;4.34;0.26;362.80;18.80;1355;23;4283.00;254
10829;21;21887679;10829;594;12192;12449;4.43;0.27;362.80;18.79;1363;23;4284.00;257
10835;21;21887697;10835;598;12192;12449;4.39;0.27;362.79;18.79;1357;23;4285.00;257
10835;21;21887714;10835;589;12194;12449;4.40;0.27;362.79;18.79;1359;23;4286.00;255
10837;21;21887730;10837;597;12194;12449;4.39;0.27;362.79;18.79;1357;23;4287.00;255
10838;21;21887746;10838;593;12194;12449;4.37;0.27;362.79;18.79;1356;23;4288.00;255
10838;21;21887763;10838;594;12194;12449;4.40;0.27;362.79;18.79;1356;23;4289.00;255
10840;21;21887782;10840;585;12194;12450;4.35;0.26;362.73;18.79;1354;23;4290.00;256
10842;21;21887799;10842;590;12194;12450;4.34;0.26;362.74;18.79;1352;23;4291.00;256
10846;21;21887814;10846;584;12199;12456;4.34;0.26;362.70;18.78;1353;23;4292.00;257
10847;21;21887830;10847;580;12200;12457;4.34;0.26;362.67;18.78;1353;23;4293.00;257
10849;21;21887845;10849;581;12200;12457;4.32;0.26;362.64;18.78;1351;23;4294.00;257
10854;21;21887860;10854;580;12200;12457;4.27;0.26;362.58;18.78;1346;23;4295.00;257
10856;21;21887878;10856;573;12202;12461;4.28;0.26;362.57;18.78;1346;23;4296.00;259
10856;21;21887899;10856;582;12202;12461;4.30;0.26;362.57;18.78;1346;23;4297.00;259
10857;21;21887919;10857;576;12202;12461;4.32;0.26;362.55;18.78;1345;23;4298.00;259
10860;21;21887937;10860;566;12203;12462;4.34;0.26;362.52;18.77;1343;23;4299.00;259
10861;21;21887956;10861;567;12206;12466;4.35;0.26;362.54;18.77;1345;23;4300.00;260
10864;21;21887979;10864;560;12206;12466;4.34;0.26;362.58;18.77;1342;23;4301.00;260
10867;21;21887999;10867;565;12208;12469;4.33;0.26;362.62;18.77;1341;23;4302.00;261
10869;21;21888017;10869;561;12209;12469;4.34;0.26;362.63;18.77;1340;23;4303.00;260
10870;21;21888035;10870;551;12209;12469;4.32;0.26;362.62;18.77;1339;23;4304.00;260
10873;21;21888052;10873;548;12211;12469;4.31;0.26;362.68;18.89;1338;23;4305.00;258
10875;21;21888072;10875;534;12215;12473;4.34;0.26;362.66;18.89;1340;23;4306.00;258
10877;21;21888089;10877;522;12215;12473;4.39;0.27;362.66;18.89;1338;23;4307.00;258
10882;21;21888106;10882;503;12215;12473;4.42;0.27;362.61;18.89;1333;23;4308.00;258
10882;21;21888122;10882;487;12215;12473;4.46;0.27;362.61;18.89;1333;23;4309.00;258
10886;21;21888138;10886;480;12215;12474;4.53;0.27;362.64;18.89;1329;23;4310.00;259
10887;21;21888153;10887;489;12216;12475;4.59;0.28;362.65;18.88;1329;23;4311.00;259
10887;21;21888169;10887;477;12216;12475;4.68;0.28;362.65;18.88;1329;23;4312.00;259
10889;21;21888190;10889;471;12218;12476;4.72;0.29;362.69;18.89;1329;23;4313.00;258
10889;21;21888205;10889;471;12218;12476;4.79;0.29;362.69;18.89;1329;23;4314.00;258
10889;21;21888220;10889;477;12218;12476;4.84;0.29;362.69;18.89;1329;23;4315.00;258
10891;21;21888235;10891;468;12218;12476;4.86;0.30;362.68;18.89;1327;23;4316.00;258
10891;21;21888250;10891;467;12219;12476;4.92;0.30;362.68;18.89;1328;23;4317.00;257
10894;21;21888266;10894;464;12220;12476;4.92;0.30;362.77;18.90;1326;23;4318.00;256
10895;21;21888281;10895;453;12220;12476;4.95;0.30;362.74;18.90;1325;23;4319.00;256
10897;22;21888298;10897;490;12313;12706;5.19;0.32;362.71;18.76;1416;24;4320.00;393
10898;22;21888345;10898;480;12318;12707;5.16;0.32;362.69;18.75;1420;24;4321.00;389
10899;22;21888361;10899;474;12327;12707;5.25;0.33;362.69;18.74;1428;24;4322.00;380
10902;22;21888377;10902;475;12336;12707;5.24;0.33;362.72;18.73;1434;24;4323.00;371
10907;22;21888393;10907;467;12345;12707;5.29;0.33;362.63;18.72;1438;24;4324.00;362
10907;22;21888410;10907;462;12351;12707;5.34;0.33;362.63;18.72;1444;24;4325.00;356
10909;22;21888426;10909;453;12358;12707;5.41;0.34;362.60;18.71;1449;24;4326.00;349
10910;22;21888450;10910;458;12366;12707;5.49;0.34;362.66;18.70;1456;24;4327.00;341
10912;22;21888466;10912;458;12373;12708;5.54;0.34;362.73;18.70;1461;24;4328.00;335
10917;22;21888484;10917;457;12379;12709;5.51;0.34;362.73;18.75;1462;24;4329.00;330
10923;22;21888510;10923;461;12386;12709;5.45;0.34;362.79;18.75;1463;24;4330.00;323
10925;22;21888528;10925;476;12389;12710;5.42;0.34;362.74;18.75;1464;24;4331.00;321
10931;22;21888546;10931;475;12392;12710;5.34;0.33;362.86;18.81;1461;24;4332.00;318
10932;22;21888573;10932;491;12395;12710;5.31;0.33;362.89;18.81;1463;24;4333.00;315
10934;22;21888594;10934;498;12396;12710;5.29;0.33;362.90;18.81;1462;24;4334.00;314
10940;22;21888615;10940;504;12401;12714;5.25;0.32;363.02;18.87;1461;24;4335.00;313
10942;22;21888645;10942;505;12402;12714;5.23;0.32;363.06;18.87;1460;24;4336.00;312
10944;22;21888667;10944;519;12407;12714;5.12;0.31;363.12;18.99;1463;24;4337.00;307
10947;22;21888697;10947;529;12408;12717;5.06;0.31;363.16;18.99;1461;24;4338.00;309
10950;22;21888718;10950;532;12412;12717;5.02;0.31;363.20;19.12;1462;24;4339.00;305
10951;22;21888738;10951;535;12414;12717;5.00;0.31;363.30;19.18;1463;24;4340.00;303
10958;23;21888758;10958;539;12418;12721;4.91;0.30;363.46;19.24;1460;25;4341.00;303
10961;23;21888797;10961;540;12420;12722;4.90;0.30;363.60;19.23;1459;25;4342.00;302
10961;23;21888816;10961;549;12421;12722;4.90;0.30;363.60;19.23;1460;25;4343.00;301
10966;23;21888836;10966;548;12426;12726;4.84;0.29;363.69;19.35;1460;25;4344.00;300
10967;23;21888855;10967;565;12428;12726;4.79;0.29;363.77;19.42;1461;25;4345.00;298
10969;23;21888883;10969;564;12429;12726;4.73;0.29;363.79;19.48;1460;25;4346.00;297
10971;23;21888901;10971;568;12430;12727;4.65;0.28;363.77;19.48;1459;25;4347.00;297
10971;23;21888921;10971;580;12433;12727;4.62;0.28;363.77;19.48;1462;25;4348.00;294
10972;23;21888938;10972;582;12439;12733;4.65;0.28;363.85;19.59;1467;25;4349.00;294
10973;23;21888958;10973;587;12441;12733;4.66;0.28;363.89;19.65;1468;25;4350.00;292
10974;23;21888976;10974;587;12443;12734;4.67;0.28;363.88;19.71;1469;25;4351.00;291
10976;23;21888994;10976;589;12444;12734;4.72;0.29;363.84;19.71;1468;25;4352.00;290
10981;23;21889018;10981;587;12445;12734;4.71;0.29;363.91;19.71;1464;25;4353.00;289
10982;23;21889037;10982;583;12447;12734;4.75;0.29;363.90;19.83;1465;25;4354.00;287
10982;23;21889054;10982;593;12449;12734;4.75;0.29;363.90;19.83;1467;25;4355.00;285
10983;23;21889071;10983;595;12458;12746;4.81;0.29;363.88;19.82;1475;25;4356.00;288
10986;23;21889090;10986;603;12462;12746;4.77;0.29;363.94;19.94;1476;25;4357.00;284
10988;23;21889107;10988;595;12464;12746;4.79;0.29;363.94;19.94;1476;25;4358.00;282
10990;23;21889126;10990;611;12466;12746;4.77;0.29;363.99;20.06;1476;25;4359.00;280
10991;23;21889143;10991;616;12467;12746;4.79;0.29;364.00;20.06;1476;25;4360.00;279
10993;23;21889160;10993;623;12471;12746;4.82;0.29;364.02;20.12;1478;25;4361.00;275
10995;23;21889177;10995;631;12476;12750;4.82;0.29;363.99;20.18;1481;25;4362.00;274
10996;23;21889195;10996;630;12478;12750;4.84;0.30;364.00;20.18;1482;25;4363.00;272
11002;23;21889216;11002;633;12482;12754;4.80;0.29;364.07;20.18;1480;25;4364.00;272
11003;23;21889235;11003;643;12485;12756;4.73;0.29;364.06;20.17;1482;25;4365.00;271
11012;23;21889255;11012;643;12488;12756;4.60;0.28;364.09;20.29;1476;25;4366.00;268
11015;23;21889273;11015;645;12490;12756;4.55;0.28;364.16;20.29;1475;25;4367.00;266
11017;23;21889290;11017;662;12499;12769;4.53;0.28;364.14;20.28;1482;25;4368.00;270
11020;23;21889309;11020;667;12500;12769;4.46;0.27;364.25;20.28;1480;25;4369.00;269
11024;23;21889325;11024;662;12500;12769;4.41;0.27;364.27;20.28;1476;25;4370.00;269
11026;23;21889341;11026;666;12502;12770;4.35;0.27;364.35;20.28;1476;25;4371.00;268
11028;23;21889358;11028;666;12503;12771;4.28;0.26;364.35;20.28;1475;25;4372.00;268
11033;23;21889373;11033;662;12504;12771;4.20;0.26;364.46;20.29;1471;25;4373.00;267
11035;23;21889388;11035;662;12506;12774;4.17;0.26;364.50;20.28;1471;25;4374.00;268
11037;23;21889404;11037;645;12507;12774;4.16;0.26;364.49;20.28;1470;25;4375.00;267
11041;23;21889419;11041;643;12507;12774;4.15;0.26;364.60;20.28;1466;25;4376.00;267
11045;23;21889435;11045;644;12508;12774;4.15;0.25;364.65;20.28;1463;25;4377.00;266
11048;23;21889451;11048;638;12512;12780;4.15;0.25;364.70;20.28;1464;25;4378.00;268
11050;23;21889467;11050;632;12513;12780;4.15;0.26;364.69;20.28;1463;25;4379.00;267
11054;23;21889485;11054;629;12513;12780;4.18;0.26;364.78;20.28;1459;25;4380.00;267
11056;23;21889501;11056;630;12513;12780;4.20;0.26;364.88;20.28;1457;25;4381.00;267
11058;23;21889517;11058;615;12516;12784;4.19;0.26;364.97;20.27;1458;25;4382.00;268
11062;23;21889533;11062;599;12517;12785;4.19;0.26;364.95;20.27;1455;25;4383.00;268
11066;23;21889549;11066;588;12517;12785;4.16;0.26;365.04;20.27;1451;25;4384.00;268
11072;23;21889565;11072;589;12518;12786;4.14;0.25;365.08;20.27;1446;25;4385.00;268
11075;23;21889581;11075;585;12518;12786;4.14;0.25;365.10;20.27;1443;25;4386.00;268
11078;23;21889599;11078;580;12518;12786;4.16;0.26;365.17;20.27;1440;25;4387.00;268
11080;23;21889615;11080;588;12518;12786;4.21;0.26;365.17;20.27;1438;25;4388.00;268
11083;23;21889632;11083;592;12518;12786;4.23;0.26;365.24;20.27;1435;25;4389.00;268
11087;23;21889648;11087;592;12518;12786;4.27;0.26;365.29;20.27;1431;25;4390.00;268
11091;23;21889666;11091;588;12518;12786;4.28;0.26;365.29;20.27;1427;25;4391.00;268
11095;23;21889683;11095;604;12553;12856;4.37;0.27;365.41;20.21;1458;25;4392.00;303
11102;23;21889710;11102;595;12555;12857;4.38;0.27;365.48;20.21;1453;25;4393.00;302
11105;23;21889728;11105;590;12557;12857;4.36;0.27;365.51;20.21;1452;25;4394.00;300
11108;23;21889745;11108;598;12559;12857;4.36;0.27;365.48;20.20;1451;25;4395.00;298
11113;23;21889762;11113;593;12560;12857;4.32;0.26;365.52;20.20;1447;25;4396.00;297
11119;23;21889779;11119;599;12560;12857;4.24;0.26;365.53;20.20;1441;25;4397.00;297
11126;23;21889796;11126;606;12562;12857;4.17;0.25;365.60;20.20;1436;25;4398.00;295
11127;23;21889813;11127;604;12564;12857;4.16;0.25;365.62;20.20;1437;25;4399.00;293
11134;23;21889830;11134;610;12564;12858;4.06;0.25;365.76;20.20;1430;25;4400.00;294
11142;23;21889851;11142;610;12566;12859;3.97;0.24;365.77;20.20;1424;25;4401.00;293
11146;23;21889868;11146;617;12567;12859;3.91;0.24;365.78;20.20;1421;25;4402.00;292
11147;23;21889890;11147;617;12573;12863;3.93;0.24;365.78;20.19;1426;25;4403.00;290
11152;23;21889912;11152;624;12575;12863;3.90;0.24;365.84;20.19;1423;25;4404.00;288
11154;23;21889942;11154;617;12579;12863;3.90;0.24;365.80;20.19;1425;25;4405.00;284
11158;23;21889968;11158;612;12582;12863;3.91;0.24;365.77;20.19;1424;25;4406.00;281
11159;23;21889989;11159;620;12588;12869;3.93;0.24;365.78;20.18;1429;25;4407.00;281
11161;23;21890014;11161;616;12588;12869;3.94;0.24;365.74;20.18;1427;25;4408.00;281
11164;23;21890033;11164;621;12590;12869;3.95;0.24;365.75;20.18;1426;25;4409.00;279
11169;23;21890053;11169;620;12593;12875;3.97;0.24;365.74;20.17;1424;25;4410.00;282
11172;23;21890073;11172;619;12595;12875;3.94;0.24;365.75;20.17;1423;25;4411.00;280
11174;23;21890094;11174;617;12596;12875;3.95;0.24;365.78;20.17;1422;25;4412.00;279
11177;23;21890113;11177;625;12598;12876;3.90;0.24;365.78;20.17;1421;25;4413.00;278
11178;23;21890138;11178;626;12599;12877;3.90;0.24;365.75;20.17;1421;25;4414.00;278
11181;23;21890156;11181;629;12600;12877;3.85;0.23;365.74;20.17;1419;25;4415.00;277
11185;23;21890173;11185;629;12612;12890;3.90;0.24;365.74;20.15;1427;25;4416.00;278
11185;23;21890192;11185;633;12613;12890;3.89;0.24;365.74;20.15;1428;25;4417.00;277
11187;23;21890206;11187;634;12613;12890;3.85;0.23;365.85;20.15;1426;25;4418.00;277
11189;23;21890221;11189;634;12615;12891;3.84;0.23;365.85;20.15;1426;25;4419.00;276
11191;23;21890237;11191;646;12615;12891;3.78;0.23;365.82;20.15;1424;25;4420.00;276
11192;23;21890252;11192;658;12619;12895;3.78;0.23;365.83;20.14;1427;25;4421.00;276
11193;23;21890268;11193;652;12619;12895;3.78;0.23;365.91;20.14;1426;25;4422.00;276
11197;23;21890283;11197;641;12622;12899;3.77;0.23;366.03;20.14;1425;25;4423.00;277
11199;23;21890300;11199;641;12622;12899;3.74;0.23;366.04;20.14;1423;25;4424.00;277
11201;23;21890315;11201;640;12622;12899;3.72;0.23;366.04;20.14;1421;25;4425.00;277
11204;23;21890330;11204;644;12622;12899;3.70;0.23;366.12;20.14;1418;25;4426.00;277
11208;23;21890348;11208;642;12622;12899;3.71;0.23;366.11;20.14;1414;25;4427.00;277
11211;23;21890367;11211;644;12631;12911;3.76;0.23;366.17;20.12;1420;25;4428.00;280
11212;23;21890387;11212;647;12631;12911;3.74;0.23;366.18;20.12;1419;25;4429.00;280
11215;23;21890405;11215;658;12633;12911;3.73;0.23;366.21;20.12;1418;25;4430.00;278
11217;23;21890424;11217;638;12633;12911;3.72;0.23;366.19;20.12;1416;25;4431.00;278
11219;23;21890445;11219;619;12633;12911;3.73;0.23;366.19;20.12;1414;25;4432.00;278
11222;23;21890465;11222;619;12633;12911;3.79;0.23;366.22;20.12;1411;25;4433.00;278
11222;23;21890485;11222;614;12633;12912;3.87;0.24;366.22;20.12;1411;25;4434.00;279
11223;23;21890504;11223;609;12633;12912;3.91;0.24;366.19;20.12;1410;25;4435.00;279
11223;23;21890522;11223;601;12638;12918;4.01;0.25;366.19;20.11;1415;25;4436.00;280
11226;23;21890545;11226;602;12639;12919;4.06;0.25;366.22;20.11;1413;25;4437.00;280
11227;23;21890567;11227;600;12639;12919;4.14;0.25;366.22;20.11;1412;25;4438.00;280
11231;23;21890588;11231;596;12639;12919;4.15;0.25;366.18;20.11;1408;25;4439.00;280
11233;23;21890609;11233;598;12643;12924;4.22;0.26;366.20;20.10;1410;25;4440.00;281
11235;23;21890629;11235;600;12643;12924;4.26;0.26;366.26;20.10;1408;25;4441.00;281
11237;23;21890646;11237;598;12643;12924;4.30;0.26;366.26;20.10;1406;25;4442.00;281
11239;23;21890663;11239;598;12644;12925;4.32;0.26;366.24;20.10;1405;25;4443.00;281
11241;23;21890679;11241;592;12647;12929;4.35;0.26;366.23;20.10;1406;25;4444.00;282
11245;23;21890696;11245;595;12647;12929;4.36;0.26;366.22;20.10;1402;25;4445.00;282
11247;23;21890713;11247;588;12649;12932;4.36;0.26;366.23;20.09;1402;25;4446.00;283
11248;23;21890731;11248;590;12649;12932;4.34;0.26;366.21;20.09;1401;25;4447.00;283
11249;23;21890749;11249;588;12650;12932;4.33;0.26;366.20;20.09;1401;25;4448.00;282
11250;23;21890769;11250;582;12650;12932;4.31;0.26;366.17;20.09;1400;25;4449.00;282
11252;23;21890788;11252;580;12653;12936;4.29;0.26;366.16;20.09;1401;25;4450.00;283
11254;23;21890806;11254;585;12653;12936;4.26;0.26;366.11;20.09;1399;25;4451.00;283
11254;23;21890826;11254;584;12653;12936;4.25;0.26;366.11;20.09;1399;25;4452.00;283
11258;23;21890846;11258;588;12653;12936;4.21;0.26;366.18;20.09;1395;25;4453.00;283
11258;23;21890865;11258;594;12653;12937;4.16;0.25;366.18;20.09;1395;25;4454.00;284
11258;23;21890884;11258;601;12655;12939;4.14;0.25;366.18;20.09;1397;25;4455.00;284
11260;23;21890902;11260;604;12655;12939;4.10;0.25;366.15;20.09;1395;25;4456.00;284
11261;23;21890922;11261;605;12656;12940;4.13;0.25;366.13;20.08;1395;25;4457.00;284
11262;23;21890942;11262;615;12656;12940;4.09;0.25;366.10;20.08;1394;25;4458.00;284
11266;23;21890964;11266;616;12656;12940;4.05;0.25;366.03;20.08;1390;25;4459.00;284
11269;23;21890983;11269;614;12656;12940;4.02;0.24;366.03;20.08;1387;25;4460.00;284
11271;23;21891002;11271;619;12656;12940;4.04;0.24;366.16;20.08;1385;25;4461.00;284
11271;23;21891021;11271;625;12656;12940;4.03;0.24;366.16;20.08;1385;25;4462.00;284
11272;23;21891039;11272;621;12656;12940;4.05;0.25;366.13;20.08;1384;25;4463.00;284
11272;23;21891057;11272;638;12715;13067;4.33;0.27;366.13;19.99;1443;25;4464.00;352
11274;23;21891085;11274;615;12715;13068;4.40;0.27;366.21;19.99;1441;25;4465.00;353
11275;23;21891104;11275;599;12722;13068;4.55;0.28;366.18;19.98;1447;25;4466.00;346
11277;23;21891122;11277;581;12723;13068;4.59;0.28;366.21;19.98;1446;25;4467.00;345
11278;23;21891143;11278;575;12728;13068;4.67;0.29;366.21;19.97;1450;25;4468.00;340
11279;23;21891166;11279;566;12729;13068;4.72;0.29;366.20;19.97;1450;25;4469.00;339
11279;23;21891197;11279;558;12733;13068;4.77;0.29;366.20;19.97;1454;25;4470.00;335
11281;23;21891219;11281;551;12734;13068;4.78;0.29;366.19;19.97;1453;25;4471.00;334
11286;23;21891240;11286;566;12737;13069;4.78;0.29;366.17;19.96;1451;25;4472.00;332
11286;23;21891264;11286;549;12742;13070;4.83;0.29;366.17;19.96;1456;25;4473.00;328
11291;23;21891292;11291;553;12745;13070;4.86;0.30;366.19;19.96;1454;25;4474.00;325
11295;23;21891322;11295;549;12748;13071;4.86;0.30;366.16;19.96;1453;25;4475.00;323
11296;23;21891346;11296;543;12751;13071;4.87;0.30;366.17;19.95;1455;25;4476.00;320
11297;23;21891367;11297;540;12754;13071;4.86;0.30;366.16;19.95;1457;25;4477.00;317
11299;23;21891386;11299;538;12756;13071;4.84;0.30;366.14;19.95;1457;25;4478.00;315
11300;23;21891406;11300;540;12759;13075;4.82;0.29;366.14;19.95;1459;25;4479.00;316
11302;23;21891427;11302;529;12763;13075;4.82;0.29;366.18;20.08;1461;25;4480.00;312
11302;23;21891448;11302;518;12763;13075;4.80;0.29;366.18;20.08;1461;25;4481.00;312
11302;23;21891466;11302;509;12766;13078;4.79;0.29;366.18;20.08;1464;25;4482.00;312
11302;23;21891484;11302;511;12767;13078;4.81;0.29;366.18;20.08;1465;25;4483.00;311
11308;23;21891503;11308;502;12770;13078;4.83;0.29;366.18;20.14;1462;25;4484.00;308
11309;23;21891522;11309;509;12773;13082;4.85;0.30;366.18;20.14;1464;25;4485.00;309
11312;23;21891548;11312;499;12775;13083;4.86;0.30;366.20;20.14;1463;25;4486.00;308
11314;23;21891566;11314;495;12775;13083;4.88;0.30;366.32;20.14;1461;25;4487.00;308
11317;23;21891584;11317;500;12778;13087;4.88;0.30;366.27;20.13;1461;25;4488.00;309
11321;23;21891602;11321;501;12779;13087;4.91;0.30;366.22;20.13;1458;25;4489.00;308
11323;23;21891619;11323;493;12779;13087;4.93;0.30;366.20;20.13;1456;25;4490.00;308
11323;23;21891637;11323;496;12780;13088;4.97;0.30;366.20;20.13;1457;25;4491.00;308
11324;23;21891654;11324;501;12780;13088;4.98;0.30;366.17;20.13;1456;25;4492.00;308
11325;23;21891671;11325;509;12784;13094;5.05;0.31;366.15;20.12;1459;25;4493.00;310
11329;23;21891689;11329;498;12784;13094;5.04;0.31;366.07;20.12;1455;25;4494.00;310
11330;23;21891707;11330;498;12784;13095;5.04;0.31;366.08;20.12;1454;25;4495.00;311
11332;23;21891725;11332;499;12784;13095;5.02;0.30;366.06;20.12;1452;25;4496.00;311
11334;23;21891742;11334;496;12785;13095;4.98;0.30;366.05;20.13;1451;25;4497.00;310
11338;23;21891759;11338;499;12787;13095;4.96;0.30;366.13;20.13;1449;25;4498.00;308
11341;23;21891777;11341;493;12787;13095;4.93;0.30;366.16;20.13;1446;25;4499.00;308
11344;23;21891797;11344;502;12809;13145;4.99;0.30;366.24;20.17;1465;25;4500.00;336
11345;23;21891823;11345;499;12810;13147;4.97;0.30;366.28;20.17;1465;25;4501.00;337
11346;23;21891841;11346;507;12816;13147;5.01;0.30;366.36;20.16;1470;25;4502.00;331
11348;23;21891858;11348;519;12817;13147;4.99;0.30;366.40;20.16;1469;25;4503.00;330
11350;23;21891879;11350;522;12820;13147;4.95;0.30;366.36;20.17;1470;25;4504.00;327
11353;23;21891921;11353;522;12821;13147;4.93;0.30;366.41;20.17;1468;25;4505.00;326
11355;23;21891946;11355;536;12829;13151;4.91;0.30;366.57;20.30;1474;25;4506.00;322
11358;23;21891968;11358;545;12831;13151;4.90;0.30;366.67;20.30;1473;25;4507.00;320
11361;23;21891988;11361;545;12837;13155;4.92;0.30;366.66;20.37;1476;25;4508.00;318
11364;23;21892009;11364;549;12839;13156;4.90;0.30;366.82;20.43;1475;25;4509.00;317
11366;23;21892028;11366;555;12841;13156;4.88;0.30;366.94;20.43;1475;25;4510.00;315
11369;23;21892045;11369;543;12841;13156;4.82;0.29;366.98;20.43;1472;25;4511.00;315
11372;23;21892062;11372;558;12856;13169;4.75;0.29;367.13;20.55;1484;25;4512.00;313
11374;23;21892080;11374;549;12857;13169;4.73;0.29;367.13;20.55;1483;25;4513.00;312
11378;23;21892098;11378;559;12863;13169;4.68;0.28;367.25;20.75;1485;25;4514.00;306
11380;23;21892115;11380;564;12864;13170;4.64;0.28;367.33;20.74;1484;25;4515.00;306
11383;23;21892132;11383;580;12866;13171;4.63;0.28;367.41;20.81;1483;25;4516.00;305
11386;23;21892149;11386;579;12868;13171;4.62;0.28;367.49;20.87;1482;25;4517.00;303
11389;23;21892167;11389;588;12872;13174;4.64;0.28;367.48;20.93;1483;25;4518.00;302
11392;23;21892185;11392;599;12872;13174;4.64;0.28;367.52;20.93;1480;25;4519.00;302
11396;23;21892202;11396;602;12875;13174;4.59;0.28;367.68;21.06;1479;25;4520.00;299
11398;23;21892219;11398;614;12876;13174;4.57;0.28;367.70;21.12;1478;25;4521.00;298
11400;23;21892237;11400;609;12880;13180;4.58;0.28;367.73;21.11;1480;25;4522.00;300
11402;23;21892262;11402;618;12884;13180;4.53;0.28;367.78;21.30;1482;25;4523.00;296
11403;23;21892280;11403;618;12885;13180;4.50;0.27;367.81;21.30;1482;25;4524.00;295
11405;23;21892298;11405;619;12885;13180;4.46;0.27;367.85;21.30;1480;25;4525.00;295
11408;23;21892316;11408;617;12891;13184;4.40;0.27;367.86;21.47;1483;25;4526.00;293
11408;23;21892335;11408;608;12892;13185;4.40;0.27;367.86;21.47;1484;25;4527.00;293
11411;23;21892352;11411;603;12892;13185;4.36;0.27;367.86;21.47;1481;25;4528.00;293
11411;23;21892370;11411;605;12896;13186;4.38;0.27;367.86;21.59;1485;25;4529.00;290
11412;23;21892389;11412;597;12897;13186;4.40;0.27;367.84;21.59;1485;25;4530.00;289
11414;23;21892406;11414;595;12899;13186;4.40;0.27;367.83;21.71;1485;25;4531.00;287
11416;23;21892425;11416;598;12899;13186;4.40;0.27;367.82;21.71;1483;25;4532.00;287
11418;23;21892443;11418;587;12900;13186;4.42;0.27;367.79;21.77;1482;25;4533.00;286
11421;23;21892460;11421;583;12901;13186;4.41;0.27;367.92;21.83;1480;25;4534.00;285
11424;23;21892477;11424;593;12904;13186;4.38;0.27;368.03;21.89;1480;25;4535.00;282
11426;23;21892501;11426;598;12941;13256;4.52;0.28;368.00;21.83;1515;25;4536.00;315
11430;23;21892524;11430;596;12944;13257;4.49;0.28;368.01;21.88;1514;25;4537.00;313
11432;23;21892542;11432;594;12952;13257;4.50;0.28;368.00;21.93;1520;25;4538.00;305
11435;23;21892559;11435;599;12955;13257;4.51;0.28;368.12;21.98;1520;25;4539.00;302
11439;23;21892579;11439;612;12958;13257;4.47;0.27;368.08;21.98;1519;25;4540.00;299
11443;23;21892607;11443;617;12964;13257;4.43;0.27;368.11;22.09;1521;25;4541.00;293
11444;23;21892626;11444;632;12967;13257;4.40;0.27;368.10;22.14;1523;25;4542.00;290
11448;23;21892649;11448;630;12970;13257;4.39;0.27;368.10;22.13;1522;25;4543.00;287
11453;23;21892673;11453;642;12973;13258;4.35;0.27;368.08;22.19;1520;25;4544.00;285
11457;23;21892692;11457;635;12975;13260;4.35;0.27;368.04;22.19;1518;25;4545.00;285
11461;23;21892710;11461;644;12979;13260;4.28;0.26;368.16;22.28;1518;25;4546.00;281
11464;23;21892727;11464;651;12984;13264;4.18;0.26;368.18;22.34;1520;25;4547.00;280
11468;23;21892745;11468;649;12988;13264;4.07;0.25;368.28;22.33;1520;25;4548.00;276
11471;23;21892762;11471;653;12989;13264;3.95;0.24;368.35;22.40;1518;25;4549.00;275
11477;23;21892779;11477;652;12989;13264;3.85;0.24;368.46;22.40;1512;25;4550.00;275
11480;23;21892797;11480;649;12994;13270;3.85;0.24;368.52;22.39;1514;25;4551.00;276
11485;23;21892815;11485;660;12994;13270;3.82;0.23;368.68;22.39;1509;25;4552.00;276
11488;23;21892832;11488;663;12994;13270;3.83;0.23;368.67;22.39;1506;25;4553.00;276
11490;23;21892849;11490;659;12996;13273;3.86;0.24;368.77;22.38;1506;25;4554.00;277
11493;23;21892866;11493;654;12997;13273;3.87;0.24;368.87;22.38;1504;25;4555.00;276
11498;23;21892883;11498;665;12997;13273;3.86;0.24;368.95;22.38;1499;25;4556.00;276
11503;23;21892900;11503;649;12997;13274;3.86;0.24;368.94;22.38;1494;25;4557.00;277
11506;23;21892917;11506;654;12998;13275;3.83;0.23;369.00;22.38;1492;25;4558.00;277
11509;23;21892935;11509;643;12998;13275;3.80;0.23;368.99;22.38;1489;25;4559.00;277
11511;23;21892954;11511;644;13015;13301;3.88;0.24;369.09;22.35;1504;25;4560.00;286
11514;23;21892973;11514;645;13016;13301;3.81;0.23;369.19;22.35;1502;25;4561.00;285
11518;23;21892991;11518;648;13018;13301;3.81;0.23;369.33;22.35;1500;25;4562.00;283
11521;23;21893011;11521;651;13020;13302;3.79;0.23;369.45;22.42;1499;25;4563.00;282
11528;23;21893029;11528;652;13020;13302;3.72;0.23;369.55;22.42;1492;25;4564.00;282
11534;23;21893046;11534;655;13024;13306;3.66;0.22;369.58;22.41;1490;25;4565.00;282
11540;23;21893064;11540;658;13025;13306;3.60;0.22;369.60;22.41;1485;25;4566.00;281
11545;23;21893080;11545;661;13027;13310;3.56;0.22;369.69;22.41;1482;25;4567.00;283
11547;23;21893098;11547;660;13027;13310;3.53;0.22;369.75;22.41;1480;25;4568.00;283
11551;23;21893114;11551;671;13027;13310;3.46;0.21;369.81;22.41;1476;25;4569.00;283
11556;23;21893131;11556;684;13027;13310;3.44;0.21;369.88;22.41;1471;25;4570.00;283
11557;23;21893148;11557;686;13028;13310;3.42;0.21;369.89;22.41;1471;25;4571.00;282
11566;23;21893164;11566;691;13039;13322;3.41;0.21;369.99;22.39;1473;25;4572.00;283
11569;23;21893182;11569;705;13040;13322;3.35;0.21;370.04;22.39;1471;25;4573.00;282
11571;23;21893198;11571;711;13041;13322;3.33;0.20;370.15;22.39;1470;25;4574.00;281
11573;23;21893214;11573;721;13042;13322;3.30;0.20;370.32;22.39;1469;25;4575.00;280
11578;23;21893230;11578;725;13042;13322;3.24;0.20;370.35;22.39;1464;25;4576.00;280
11583;23;21893247;11583;734;13042;13322;3.22;0.20;370.44;22.39;1459;25;4577.00;280
11589;23;21893262;11589;742;13042;13323;3.16;0.19;370.47;22.39;1453;25;4578.00;281
11595;23;21893278;11595;740;13042;13323;3.12;0.19;370.57;22.39;1447;25;4579.00;281
11601;23;21893294;11601;745;13047;13329;3.06;0.19;370.67;22.38;1446;25;4580.00;282
11604;23;21893311;11604;749;13048;13330;3.04;0.19;370.63;22.38;1444;25;4581.00;282
11606;23;21893327;11606;753;13048;13330;2.94;0.18;370.65;22.38;1442;25;4582.00;282
11609;23;21893341;11609;765;13048;13330;2.90;0.18;370.65;22.38;1439;25;4583.00;282
11611;23;21893358;11611;775;13051;13334;2.88;0.18;370.68;22.37;1440;25;4584.00;283
11614;23;21893374;11614;769;13051;13334;2.85;0.17;370.76;22.37;1437;25;4585.00;283
11617;23;21893390;11617;775;13051;13334;2.82;0.17;370.72;22.37;1434;25;4586.00;283
11618;23;21893405;11618;769;13052;13335;2.81;0.17;370.70;22.37;1434;25;4587.00;283
11622;23;21893420;11622;777;13055;13339;2.78;0.17;370.73;22.37;1433;25;4588.00;284
11623;23;21893437;11623;781;13055;13339;2.73;0.17;370.71;22.37;1432;25;4589.00;284
11626;23;21893454;11626;789;13059;13345;2.72;0.17;370.80;22.36;1433;25;4590.00;286
11627;23;21893470;11627;792;13059;13345;2.73;0.17;370.78;22.36;1432;25;4591.00;286
11630;23;21893486;11630;779;13061;13345;2.70;0.17;370.84;22.36;1431;25;4592.00;284
11633;23;21893501;11633;786;13061;13345;2.67;0.16;370.78;22.36;1428;25;4593.00;284
11637;23;21893517;11637;788;13065;13349;2.66;0.16;370.80;22.35;1428;25;4594.00;284
11637;23;21893532;11637;798;13065;13349;2.66;0.16;370.80;22.35;1428;25;4595.00;284
11642;23;21893547;11642;798;13065;13349;2.60;0.16;370.86;22.35;1423;25;4596.00;284
11644;23;21893563;11644;794;13065;13349;2.60;0.16;370.85;22.35;1421;25;4597.00;284
11647;23;21893577;11647;788;13065;13350;2.60;0.16;370.81;22.35;1418;25;4598.00;285
11648;23;21893593;11648;788;13066;13351;2.63;0.16;370.78;22.35;1418;25;4599.00;285
11650;23;21893609;11650;782;13066;13351;2.67;0.16;370.76;22.35;1416;25;4600.00;285
11653;23;21893629;11653;785;13067;13352;2.70;0.17;370.75;22.35;1414;25;4601.00;285
11654;23;21893645;11654;787;13067;13352;2.76;0.17;370.73;22.35;1413;25;4602.00;285
11655;23;21893660;11655;786;13067;13352;2.81;0.17;370.72;22.35;1412;25;4603.00;285
11658;23;21893675;11658;782;13067;13352;2.79;0.17;370.69;22.35;1409;25;4604.00;285
11659;23;21893690;11659;779;13067;13352;2.80;0.17;370.72;22.35;1408;25;4605.00;285
11659;23;21893704;11659;774;13067;13352;2.82;0.17;370.72;22.35;1408;25;4606.00;285
11661;23;21893719;11661;764;13067;13352;2.86;0.18;370.73;22.35;1406;25;4607.00;285
11663;23;21893734;11663;771;13134;13479;3.26;0.20;370.76;22.23;1471;25;4608.00;345
11664;23;21893759;11664;757;13136;13480;3.31;0.21;370.73;22.23;1472;25;4609.00;344
11664;23;21893775;11664;747;13143;13480;3.47;0.22;370.73;22.22;1479;25;4610.00;337
11667;23;21893790;11667;745;13146;13480;3.52;0.22;370.72;22.21;1479;25;4611.00;334
11668;23;21893806;11668;732;13151;13480;3.62;0.23;370.79;22.21;1483;25;4612.00;329
11673;23;21893822;11673;740;13152;13480;3.62;0.22;370.76;22.21;1479;25;4613.00;328
11673;23;21893839;11673;740;13156;13480;3.70;0.23;370.76;22.20;1483;25;4614.00;324
11674;23;21893857;11674;745;13158;13480;3.74;0.23;370.79;22.20;1484;25;4615.00;322
11676;23;21893889;11676;752;13161;13481;3.77;0.23;370.77;22.20;1485;25;4616.00;320
11677;23;21893915;11677;750;13166;13482;3.78;0.23;370.80;22.19;1489;25;4617.00;316
11680;23;21893937;11680;759;13169;13482;3.74;0.23;370.79;22.19;1489;25;4618.00;313
11681;23;21893964;11681;761;13172;13483;3.71;0.23;370.83;22.18;1491;25;4619.00;311
11681;23;21893988;11681;752;13175;13483;3.72;0.23;370.83;22.26;1494;25;4620.00;308
11684;23;21894012;11684;750;13180;13483;3.75;0.23;370.84;22.26;1496;25;4621.00;303
11685;23;21894033;11685;740;13180;13483;3.83;0.24;370.91;22.26;1495;25;4622.00;303
11687;23;21894053;11687;737;13185;13487;3.88;0.24;370.92;22.25;1498;25;4623.00;302
11689;23;21894080;11689;728;13186;13487;3.96;0.24;370.96;22.25;1497;25;4624.00;301
11689;23;21894101;11689;721;13187;13487;4.03;0.25;370.96;22.25;1498;25;4625.00;300
11689;23;21894122;11689;720;13190;13490;4.09;0.25;370.96;22.24;1501;25;4626.00;300
11689;23;21894152;11689;716;13191;13490;4.15;0.26;370.96;22.24;1502;25;4627.00;299
11689;23;21894172;11689;711;13192;13490;4.21;0.26;370.96;22.24;1503;25;4628.00;298
11691;23;21894194;11691;705;13195;13494;4.24;0.26;371.06;22.24;1504;25;4629.00;299
11693;23;21894221;11693;705;13197;13495;4.27;0.26;371.07;22.24;1504;25;4630.00;298
11696;23;21894240;11696;697;13198;13495;4.28;0.26;371.01;22.24;1502;25;4631.00;297
11701;23;21894261;11701;691;13201;13499;4.30;0.26;370.98;22.23;1500;25;4632.00;298
11701;23;21894281;11701;688;13203;13499;4.35;0.27;370.98;22.31;1502;25;4633.00;296
11703;23;21894305;11703;687;13203;13499;4.36;0.27;370.96;22.31;1500;25;4634.00;296
11705;23;21894326;11705;687;13205;13501;4.36;0.27;370.97;22.30;1500;25;4635.00;296
11706;23;21894347;11706;691;13205;13501;4.36;0.26;371.00;22.30;1499;25;4636.00;296
11706;23;21894367;11706;690;13210;13507;4.43;0.27;371.00;22.29;1504;25;4637.00;297
11710;23;21894389;11710;692;13211;13507;4.38;0.27;371.04;22.37;1501;25;4638.00;296
11711;23;21894415;11711;693;13211;13508;4.40;0.27;371.07;22.37;1500;25;4639.00;297
11712;23;21894436;11712;691;13211;13508;4.39;0.27;371.08;22.37;1499;25;4640.00;297
11716;23;21894460;11716;692;13211;13508;4.38;0.27;371.11;22.37;1495;25;4641.00;297
11718;23;21894484;11718;695;13212;13508;4.37;0.26;371.17;22.45;1494;25;4642.00;296
11719;23;21894506;11719;698;13212;13508;4.36;0.26;371.14;22.45;1493;25;4643.00;296
11720;23;21894530;11720;690;13222;13520;4.41;0.27;371.26;22.43;1502;25;4644.00;298
11720;23;21894553;11720;688;13223;13520;4.42;0.27;371.26;22.43;1503;25;4645.00;297
11721;23;21894576;11721;682;13223;13520;4.45;0.27;371.26;22.43;1502;25;4646.00;297
11722;23;21894599;11722;678;13223;13520;4.50;0.27;371.25;22.43;1501;25;4647.00;297
11724;23;21894620;11724;680;13224;13520;4.51;0.27;371.22;22.51;1500;25;4648.00;296
11727;23;21894642;11727;675;13224;13520;4.55;0.28;371.31;22.51;1497;25;4649.00;296
11730;23;21894666;11730;681;13229;13526;4.55;0.28;371.31;22.50;1499;25;4650.00;297
11732;23;21894688;11732;673;13229;13526;4.56;0.28;371.34;22.50;1497;25;4651.00;297
11734;23;21894706;11734;669;13233;13530;4.61;0.28;371.35;22.49;1499;25;4652.00;297
11739;23;21894743;11739;672;13234;13531;4.59;0.28;371.44;22.49;1495;25;4653.00;297
11740;23;21894761;11740;677;13234;13531;4.59;0.28;371.42;22.49;1494;25;4654.00;297
11742;23;21894778;11742;673;13234;13531;4.55;0.28;371.41;22.49;1492;25;4655.00;297
11746;23;21894803;11746;670;13245;13544;4.54;0.28;371.48;22.47;1499;25;4656.00;299
11747;23;21894827;11747;663;13245;13544;4.56;0.28;371.48;22.47;1498;25;4657.00;299
11752;23;21894853;11752;665;13245;13544;4.54;0.28;371.57;22.47;1493;25;4658.00;299
11756;23;21894877;11756;652;13246;13545;4.57;0.28;371.67;22.47;1490;25;4659.00;299
11758;23;21894906;11758;651;13246;13546;4.63;0.28;371.68;22.47;1488;25;4660.00;300
11764;23;21894931;11764;651;13246;13546;4.63;0.28;371.63;22.47;1482;25;4661.00;300
11765;23;21894955;11765;653;13248;13549;4.68;0.28;371.69;22.47;1483;25;4662.00;301
11766;23;21894981;11766;653;13249;13549;4.71;0.29;371.69;22.47;1483;25;4663.00;300
11771;23;21895003;11771;648;13249;13549;4.72;0.29;371.87;22.47;1478;25;4664.00;300
11773;23;21895027;11773;649;13250;13549;4.78;0.29;371.83;22.54;1477;25;4665.00;299
11780;23;21895052;11780;653;13255;13555;4.79;0.29;371.80;22.53;1475;25;4666.00;300
11782;23;21895084;11782;649;13255;13555;4.77;0.29;371.83;22.53;1473;25;4667.00;300
11785;23;21895105;11785;651;13255;13555;4.71;0.29;371.88;22.53;1470;25;4668.00;300
11789;23;21895128;11789;647;13255;13555;4.67;0.28;371.84;22.53;1466;25;4669.00;300
11791;23;21895149;11791;647;13258;13559;4.62;0.28;371.90;22.52;1467;25;4670.00;301
11794;23;21895169;11794;658;13259;13560;4.59;0.28;372.01;22.52;1465;25;4671.00;301
11797;24;21895188;11797;656;13259;13560;4.58;0.28;372.08;22.52;1462;26;4672.00;301
11797;24;21895226;11797;661;13260;13561;4.60;0.28;372.08;22.52;1463;26;4673.00;301
11801;24;21895243;11801;661;13260;13561;4.57;0.28;372.18;22.52;1459;26;4674.00;301
11804;24;21895260;11804;661;13260;13561;4.55;0.28;372.22;22.52;1456;26;4675.00;301
11808;24;21895277;11808;665;13260;13561;4.50;0.27;372.28;22.52;1452;26;4676.00;301
11809;24;21895293;11809;664;13261;13561;4.44;0.27;372.28;22.59;1452;26;4677.00;300
11811;24;21895310;11811;673;13261;13561;4.42;0.27;372.29;22.59;1450;26;4678.00;300
11815;24;21895327;11815;672;13261;13561;4.34;0.26;372.39;22.59;1446;26;4679.00;300
11819;24;21895351;11819;696;13318;13686;4.48;0.28;372.36;22.49;1499;26;4680.00;368
11821;24;21895377;11821;680;13320;13687;4.48;0.28;372.39;22.56;1499;26;4681.00;367
11824;24;21895396;11824;674;13328;13687;4.54;0.28;372.47;22.55;1504;26;4682.00;359
11827;24;21895416;11827;674;13332;13687;4.53;0.28;372.56;22.54;1505;26;4683.00;355
11829;24;21895445;11829;677;13340;13687;4.53;0.28;372.60;22.60;1511;26;4684.00;347
11832;24;21895466;11832;686;13342;13687;4.49;0.28;372.64;22.60;1510;26;4685.00;345
11833;24;21895486;11833;688;13352;13687;4.47;0.28;372.67;22.65;1519;26;4686.00;335
11836;24;21895506;11836;689;13354;13687;4.45;0.27;372.64;22.65;1518;26;4687.00;333
11837;24;21895528;11837;690;13358;13688;4.48;0.28;372.65;22.65;1521;26;4688.00;330
11840;24;21895550;11840;695;13363;13689;4.49;0.28;372.60;22.71;1523;26;4689.00;326
11841;24;21895571;11841;693;13366;13689;4.48;0.28;372.57;22.71;1525;26;4690.00;323
11842;24;21895592;11842;699;13372;13693;4.44;0.27;372.56;22.77;1530;26;4691.00;321
11844;24;21895614;11844;706;13374;13693;4.39;0.27;372.67;22.77;1530;26;4692.00;319
11847;24;21895634;11847;697;13376;13693;4.36;0.27;372.67;22.84;1529;26;4693.00;317
11848;24;21895654;11848;700;13376;13693;4.33;0.26;372.70;22.84;1528;26;4694.00;317
11848;24;21895673;11848;710;13380;13699;4.32;0.26;372.70;22.83;1532;26;4695.00;319
11854;24;21895700;11854;718;13381;13699;4.27;0.26;372.76;22.90;1527;26;4696.00;318
11857;24;21895718;11857;720;13381;13699;4.22;0.26;372.82;22.90;1524;26;4697.00;318
11859;24;21895735;11859;727;13384;13702;4.19;0.26;372.92;22.97;1525;26;4698.00;318
11862;24;21895751;11862;711;13384;13702;4.15;0.25;373.04;22.97;1522;26;4699.00;318
11867;24;21895769;11867;708;13385;13702;4.11;0.25;373.15;23.03;1518;26;4700.00;317
11870;24;21895790;11870;706;13385;13703;4.10;0.25;373.18;23.03;1515;26;4701.00;318
11873;24;21895807;11873;703;13387;13704;4.13;0.25;373.27;23.03;1514;26;4702.00;317
11875;24;21895824;11875;708;13388;13704;4.14;0.25;373.36;23.10;1513;26;4703.00;316
11875;24;21895840;11875;699;13398;13717;4.20;0.26;373.36;23.08;1523;26;4704.00;319
11877;24;21895858;11877;703;13401;13717;4.22;0.26;373.39;23.21;1524;26;4705.00;316
11881;24;21895876;11881;701;13401;13717;4.21;0.26;373.51;23.21;1520;26;4706.00;316
11884;24;21895899;11884;701;13403;13718;4.22;0.26;373.48;23.21;1519;26;4707.00;315
11887;24;21895922;11887;711;13403;13718;4.20;0.26;373.54;23.21;1516;26;4708.00;315
11890;24;21895948;11890;701;13406;13722;4.22;0.26;373.60;23.21;1516;26;4709.00;316
11891;24;21895972;11891;707;13407;13722;4.22;0.26;373.60;23.20;1516;26;4710.00;315
11892;24;21895995;11892;711;13408;13726;4.24;0.26;373.60;23.20;1516;26;4711.00;318
11899;24;21896015;11899;710;13408;13726;4.23;0.26;373.89;23.20;1509;26;4712.00;318
11899;24;21896035;11899;708;13408;13726;4.26;0.26;373.89;23.20;1509;26;4713.00;318
11902;24;21896056;11902;710;13408;13726;4.25;0.26;374.00;23.20;1506;26;4714.00;318
11906;24;21896080;11906;715;13408;13726;4.19;0.26;374.15;23.20;1502;26;4715.00;318
11909;24;21896101;11909;725;13418;13738;4.17;0.25;374.21;23.19;1509;26;4716.00;320
11914;24;21896121;11914;727;13418;13738;4.09;0.25;374.37;23.19;1504;26;4717.00;320
11918;24;21896144;11918;739;13418;13738;4.03;0.25;374.41;23.19;1500;26;4718.00;320
11925;24;21896167;11925;737;13418;13738;3.94;0.24;374.47;23.19;1493;26;4719.00;320
11925;24;21896187;11925;734;13418;13738;3.91;0.24;374.47;23.19;1493;26;4720.00;320
11928;24;21896206;11928;740;13418;13738;3.84;0.23;374.48;23.19;1490;26;4721.00;320
11930;24;21896229;11930;740;13418;13739;3.79;0.23;374.53;23.19;1488;26;4722.00;321
11933;24;21896248;11933;742;13418;13739;3.72;0.23;374.53;23.19;1485;26;4723.00;321
11936;24;21896268;11936;746;13423;13745;3.68;0.22;374.54;23.18;1487;26;4724.00;322
11942;24;21896288;11942;737;13424;13747;3.59;0.22;374.57;23.18;1482;26;4725.00;323
11945;24;21896310;11945;735;13424;13747;3.52;0.22;374.63;23.18;1479;26;4726.00;323
11949;24;21896328;11949;734;13424;13747;3.44;0.21;374.68;23.18;1475;26;4727.00;323
11952;24;21896354;11952;729;13427;13751;3.42;0.21;374.74;23.17;1475;26;4728.00;324
11954;24;21896374;11954;729;13427;13751;3.44;0.21;374.70;23.17;1473;26;4729.00;324
11958;24;21896394;11958;721;13427;13751;3.43;0.21;374.72;23.17;1469;26;4730.00;324
11961;24;21896412;11961;722;13428;13752;3.43;0.21;374.77;23.17;1467;26;4731.00;324
11965;24;21896430;11965;718;13429;13756;3.40;0.21;374.80;23.17;1464;26;4732.00;327
11966;24;21896455;11966;719;13429;13756;3.39;0.21;374.79;23.17;1463;26;4733.00;327
11968;24;21896472;11968;709;13431;13759;3.40;0.21;374.77;23.16;1463;26;4734.00;328
11969;24;21896489;11969;702;13431;13759;3.39;0.21;374.80;23.16;1462;26;4735.00;328
11971;24;21896506;11971;706;13431;13759;3.35;0.21;374.78;23.16;1460;26;4736.00;328
11973;24;21896524;11973;700;13431;13759;3.32;0.20;374.75;23.16;1458;26;4737.00;328
11977;24;21896540;11977;703;13434;13763;3.32;0.20;374.82;23.16;1457;26;4738.00;329
11978;24;21896558;11978;716;13434;13763;3.32;0.20;374.89;23.16;1456;26;4739.00;329
11981;24;21896578;11981;716;13434;13763;3.30;0.20;374.89;23.16;1453;26;4740.00;329
11984;24;21896594;11984;717;13434;13763;3.29;0.20;374.85;23.16;1450;26;4741.00;329
11986;24;21896610;11986;727;13434;13764;3.29;0.20;374.94;23.16;1448;26;4742.00;330
11990;24;21896626;11990;723;13435;13765;3.25;0.20;375.02;23.16;1445;26;4743.00;330
11993;24;21896642;11993;728;13436;13765;3.21;0.20;375.05;23.16;1443;26;4744.00;329
11996;24;21896658;11996;722;13437;13766;3.22;0.20;375.17;23.15;1441;26;4745.00;329
12001;24;21896676;12001;732;13437;13766;3.19;0.20;375.24;23.15;1436;26;4746.00;329
12007;24;21896693;12007;740;13437;13766;3.19;0.20;375.34;23.15;1430;26;4747.00;329
12010;24;21896710;12010;742;13437;13766;3.18;0.20;375.37;23.15;1427;26;4748.00;329
12013;24;21896726;12013;742;13437;13766;3.16;0.19;375.38;23.15;1424;26;4749.00;329
12017;24;21896742;12017;739;13438;13766;3.12;0.19;375.34;23.15;1421;26;4750.00;328
12022;24;21896759;12022;736;13438;13766;3.10;0.19;375.42;23.15;1416;26;4751.00;328
12027;24;21896774;12027;759;13503;13893;3.36;0.21;375.47;23.04;1476;26;4752.00;390
12031;24;21896801;12031;751;13504;13894;3.32;0.21;375.42;23.04;1473;26;4753.00;390
12036;24;21896817;12036;748;13510;13894;3.31;0.21;375.35;23.03;1474;26;4754.00;384
12039;24;21896832;12039;739;13510;13894;3.29;0.20;375.40;23.03;1471;26;4755.00;384
12042;24;21896847;12042;740;13513;13894;3.33;0.21;375.34;23.03;1471;26;4756.00;381
12043;24;21896862;12043;738;13515;13894;3.35;0.21;375.33;23.02;1472;26;4757.00;379
12044;24;21896877;12044;736;13518;13894;3.38;0.21;375.30;23.02;1474;26;4758.00;376
12048;24;21896893;12048;741;13520;13894;3.39;0.21;375.27;23.02;1472;26;4759.00;374
12049;24;21896908;12049;744;13521;13895;3.40;0.21;375.28;23.02;1472;26;4760.00;374
12052;24;21896924;12052;756;13523;13896;3.41;0.21;375.33;23.02;1471;26;4761.00;373
12058;24;21896940;12058;760;13526;13896;3.38;0.21;375.45;23.01;1468;26;4762.00;370
12061;24;21896955;12061;761;13528;13897;3.35;0.21;375.43;23.01;1467;26;4763.00;369
12063;24;21896971;12063;773;13530;13897;3.34;0.21;375.43;23.01;1467;26;4764.00;367
12065;24;21896987;12065;763;13531;13897;3.32;0.21;375.46;23.01;1466;26;4765.00;366
12068;24;21897003;12068;770;13532;13897;3.28;0.20;375.44;23.01;1464;26;4766.00;365
12069;24;21897018;12069;773;13538;13901;3.29;0.20;375.42;23.09;1469;26;4767.00;363
12071;24;21897036;12071;776;13540;13901;3.29;0.20;375.39;23.08;1469;26;4768.00;361
12074;24;21897051;12074;777;13541;13901;3.29;0.20;375.47;23.08;1467;26;4769.00;360
12078;24;21897068;12078;778;13543;13907;3.28;0.20;375.51;23.08;1465;26;4770.00;364
12080;24;21897085;12080;784;13544;13907;3.29;0.20;375.50;23.08;1464;26;4771.00;363
12083;24;21897101;12083;779;13545;13907;3.29;0.20;375.46;23.08;1462;26;4772.00;362
12085;24;21897117;12085;782;13546;13911;3.28;0.20;375.46;23.08;1461;26;4773.00;365
12088;24;21897134;12088;773;13547;13912;3.29;0.20;375.45;23.07;1459;26;4774.00;365
12090;24;21897150;12090;786;13547;13912;3.28;0.20;375.52;23.07;1457;26;4775.00;365
12093;24;21897166;12093;793;13550;13916;3.29;0.20;375.54;23.07;1457;26;4776.00;366
12093;24;21897181;12093;783;13551;13916;3.32;0.20;375.54;23.07;1458;26;4777.00;365
12097;24;21897203;12097;768;13551;13916;3.34;0.20;375.59;23.07;1454;26;4778.00;365
12097;24;21897221;12097;762;13551;13917;3.41;0.21;375.59;23.07;1454;26;4779.00;366
12100;24;21897236;12100;753;13551;13917;3.46;0.21;375.59;23.07;1451;27;4780.00;366
12101;24;21897262;12101;737;13555;13923;3.54;0.22;375.60;23.06;1454;27;4781.00;368
12105;25;21897281;12105;719;13555;13923;3.64;0.22;375.55;23.06;1450;28;4782.00;368
12107;25;21897318;12107;694;13555;13924;3.72;0.23;375.52;23.06;1448;28;4783.00;369
12110;25;21897353;12110;689;13556;13924;3.77;0.23;375.48;23.14;1446;28;4784.00;368
12112;25;21897370;12112;671;13556;13924;3.87;0.24;375.46;23.14;1444;28;4785.00;368
12113;25;21897387;12113;665;13556;13924;3.98;0.24;375.47;23.14;1443;28;4786.00;368
12120;25;21897404;12120;656;13556;13924;4.05;0.25;375.56;23.14;1436;28;4787.00;368
12121;25;21897423;12121;654;13565;13936;4.19;0.26;375.60;23.13;1444;28;4788.00;371
12123;25;21897442;12123;651;13565;13936;4.30;0.26;375.64;23.13;1442;28;4789.00;371
12123;25;21897461;12123;653;13566;13936;4.39;0.27;375.64;23.13;1443;28;4790.00;370
12128;25;21897479;12128;653;13566;13936;4.42;0.27;375.62;23.13;1438;28;4791.00;370
12130;25;21897503;12130;641;13566;13936;4.51;0.28;375.64;23.13;1436;28;4792.00;370
12133;25;21897521;12133;638;13566;13936;4.53;0.28;375.69;23.13;1433;28;4793.00;370
12136;25;21897541;12136;634;13567;13940;4.56;0.28;375.69;23.13;1431;28;4794.00;373
12137;25;21897559;12137;631;13567;13940;4.60;0.28;375.73;23.13;1430;28;4795.00;373
12141;25;21897577;12141;631;13570;13944;4.58;0.28;375.84;23.12;1429;28;4796.00;374
12142;25;21897597;12142;625;13570;13945;4.58;0.28;375.89;23.12;1428;28;4797.00;375
12145;25;21897621;12145;626;13570;13945;4.59;0.28;375.91;23.12;1425;28;4798.00;375
12149;25;21897639;12149;626;13570;13945;4.57;0.28;375.94;23.12;1421;28;4799.00;375
12152;25;21897659;12152;628;13592;13986;4.64;0.28;376.11;23.08;1440;28;4800.00;394
12155;25;21897683;12155;619;13593;13986;4.64;0.28;376.22;23.16;1438;28;4801.00;393
12158;25;21897701;12158;611;13594;13986;4.65;0.28;376.25;23.16;1436;28;4802.00;392
12159;25;21897718;12159;617;13595;13987;4.71;0.29;376.24;23.16;1436;28;4803.00;392
12160;25;21897735;12160;605;13596;13988;4.72;0.29;376.28;23.15;1436;28;4804.00;392
12161;25;21897752;12161;599;13596;13988;4.74;0.29;376.27;23.15;1435;28;4805.00;392
12165;25;21897770;12165;597;13597;13991;4.76;0.29;376.47;23.15;1432;28;4806.00;394
12170;25;21897788;12170;593;13597;13991;4.76;0.29;376.50;23.15;1427;28;4807.00;394
12172;25;21897806;12172;590;13597;13991;4.75;0.29;376.56;23.15;1425;28;4808.00;394
12174;25;21897823;12174;598;13597;13991;4.78;0.29;376.66;23.15;1423;28;4809.00;394
12177;25;21897840;12177;596;13602;13997;4.74;0.29;376.78;23.14;1425;28;4810.00;395
12180;25;21897859;12180;600;13602;13997;4.75;0.29;376.88;23.14;1422;28;4811.00;395
12183;25;21897876;12183;596;13602;13997;4.76;0.29;376.94;23.14;1419;28;4812.00;395
12184;25;21897899;12184;588;13602;13997;4.76;0.29;376.95;23.14;1418;28;4813.00;395
12185;25;21897921;12185;587;13603;14001;4.79;0.29;376.99;23.14;1418;28;4814.00;398
12186;25;21897946;12186;578;13605;14003;4.81;0.29;377.02;23.22;1419;28;4815.00;398
12187;25;21897968;12187;576;13605;14003;4.82;0.29;377.10;23.22;1418;28;4816.00;398
12190;25;21897991;12190;569;13606;14004;4.83;0.29;377.13;23.22;1416;28;4817.00;398
12190;25;21898011;12190;569;13606;14004;4.87;0.30;377.13;23.22;1416;28;4818.00;398
12191;25;21898032;12191;560;13606;14004;4.94;0.30;377.16;23.22;1415;28;4819.00;398
12193;25;21898052;12193;554;13606;14004;4.98;0.30;377.17;23.22;1413;28;4820.00;398
12196;25;21898073;12196;546;13607;14004;4.99;0.30;377.26;23.22;1411;28;4821.00;397
12199;25;21898095;12199;545;13607;14004;5.04;0.31;377.25;23.22;1408;28;4822.00;397
12202;25;21898115;12202;537;13607;14004;5.05;0.31;377.34;23.22;1405;28;4823.00;397
12207;25;21898136;12207;547;13641;14074;5.00;0.30;377.45;23.16;1434;28;4824.00;433
12207;25;21898163;12207;532;13645;14075;5.03;0.31;377.45;23.16;1438;28;4825.00;430
12212;25;21898183;12212;525;13648;14075;5.02;0.31;377.44;23.15;1436;28;4826.00;427
12213;25;21898204;12213;513;13650;14075;5.07;0.31;377.45;23.15;1437;28;4827.00;425
12214;25;21898222;12214;514;13651;14077;5.10;0.31;377.47;23.15;1437;28;4828.00;426
12217;25;21898241;12217;512;13652;14077;5.10;0.31;377.49;23.15;1435;28;4829.00;425
12220;25;21898260;12220;513;13654;14077;5.12;0.31;377.56;23.22;1434;28;4830.00;423
12222;25;21898281;12222;507;13657;14077;5.16;0.31;377.58;23.29;1435;28;4831.00;420
12228;25;21898300;12228;509;13661;14078;5.14;0.31;377.54;23.29;1433;28;4832.00;417
12231;25;21898318;12231;508;13664;14079;5.12;0.31;377.63;23.29;1433;28;4833.00;415
12231;25;21898335;12231;507;13665;14079;5.16;0.31;377.63;23.29;1434;28;4834.00;414
12233;25;21898352;12233;511;13667;14083;5.11;0.31;377.63;23.28;1434;28;4835.00;416
12238;25;21898370;12238;515;13667;14083;5.06;0.31;377.69;23.28;1429;28;4836.00;416
12239;25;21898387;12239;507;13667;14083;5.02;0.31;377.73;23.28;1428;28;4837.00;416
12241;25;21898404;12241;499;13668;14083;4.94;0.30;377.82;23.28;1427;28;4838.00;415
12246;25;21898429;12246;501;13670;14089;4.90;0.30;377.84;23.28;1424;28;4839.00;419
12249;25;21898448;12249;506;13670;14089;4.86;0.30;377.90;23.28;1421;28;4840.00;419
12251;25;21898465;12251;510;13672;14089;4.81;0.29;377.87;23.29;1421;28;4841.00;417
12255;25;21898484;12255;505;13673;14092;4.81;0.29;377.91;23.28;1418;28;4842.00;419
12259;25;21898503;12259;514;13674;14092;4.81;0.29;377.95;23.28;1415;28;4843.00;418
12261;25;21898521;12261;514;13674;14092;4.81;0.29;378.03;23.28;1413;28;4844.00;418
12263;25;21898538;12263;517;13674;14093;4.83;0.29;378.16;23.28;1411;28;4845.00;419
12267;25;21898556;12267;516;13675;14094;4.83;0.29;378.25;23.28;1408;28;4846.00;419
12272;25;21898573;12272;526;13676;14094;4.79;0.29;378.36;23.28;1404;28;4847.00;418
12275;25;21898590;12275;529;13684;14107;4.79;0.29;378.34;23.27;1409;28;4848.00;423
12278;25;21898609;12278;526;13685;14107;4.81;0.29;378.40;23.27;1407;28;4849.00;422
12282;25;21898626;12282;532;13685;14107;4.81;0.29;378.37;23.27;1403;28;4850.00;422
12284;25;21898643;12284;533;13686;14108;4.86;0.30;378.44;23.27;1402;28;4851.00;422
12286;25;21898662;12286;540;13686;14108;4.90;0.30;378.45;23.27;1400;28;4852.00;422
12291;25;21898679;12291;539;13691;14112;4.92;0.30;378.65;23.26;1400;28;4853.00;421
12294;25;21898697;12294;541;13692;14112;4.99;0.30;378.81;23.26;1398;28;4854.00;420
12296;25;21898714;12296;542;13694;14116;5.04;0.31;378.82;23.34;1398;28;4855.00;422
12298;25;21898731;12298;548;13694;14116;5.07;0.31;378.84;23.34;1396;28;4856.00;422
12299;25;21898749;12299;551;13694;14116;5.10;0.31;378.89;23.34;1395;28;4857.00;422
12301;25;21898765;12301;551;13695;14116;5.10;0.31;378.87;23.41;1394;28;4858.00;421
12303;25;21898785;12303;559;13695;14116;5.09;0.31;378.93;23.41;1392;28;4859.00;421
12307;25;21898809;12307;566;13715;14150;5.17;0.32;379.04;23.38;1408;28;4860.00;435
12310;25;21898829;12310;567;13716;14150;5.17;0.32;379.07;23.38;1406;28;4861.00;434
12314;25;21898847;12314;567;13720;14150;5.11;0.31;379.09;23.48;1406;29;4862.00;430
12319;25;21898875;12319;569;13720;14150;5.08;0.31;379.16;23.48;1401;29;4863.00;430
12322;25;21898894;12322;574;13720;14150;5.04;0.31;379.20;23.48;1398;29;4864.00;430
12324;25;21898912;12324;575;13720;14150;4.97;0.30;379.23;23.48;1396;29;4865.00;430
12328;25;21898929;12328;584;13720;14151;4.90;0.30;379.16;23.48;1392;29;4866.00;431
12332;25;21898946;12332;588;13720;14151;4.84;0.30;379.25;23.48;1388;29;4867.00;431
12335;25;21898963;12335;589;13723;14157;4.85;0.30;379.35;23.47;1388;29;4868.00;434
12336;25;21898979;12336;597;13723;14158;4.81;0.29;379.33;23.47;1387;29;4869.00;435
12338;25;21898995;12338;596;13723;14158;4.78;0.29;379.45;23.47;1385;29;4870.00;435
12342;25;21899012;12342;597;13723;14158;4.77;0.29;379.51;23.47;1381;29;4871.00;435
12342;25;21899029;12342;606;13726;14162;4.78;0.29;379.51;23.47;1384;29;4872.00;436
12345;25;21899045;12345;606;13726;14162;4.72;0.29;379.63;23.47;1381;29;4873.00;436
12347;25;21899060;12347;615;13726;14162;4.68;0.29;379.68;23.47;1379;29;4874.00;436
12353;25;21899076;12353;613;13727;14163;4.61;0.28;379.77;23.47;1374;29;4875.00;436
12357;25;21899091;12357;611;13728;14167;4.55;0.28;379.85;23.47;1371;29;4876.00;439
12358;25;21899107;12358;611;13728;14167;4.55;0.28;379.90;23.47;1370;29;4877.00;439
12361;25;21899123;12361;608;13729;14170;4.57;0.28;379.96;23.46;1368;29;4878.00;441
12364;25;21899139;12364;607;13729;14170;4.55;0.28;380.02;23.46;1365;29;4879.00;441
12368;25;21899154;12368;603;13729;14170;4.56;0.28;380.08;23.46;1361;29;4880.00;441
12370;25;21899170;12370;602;13729;14170;4.60;0.28;380.11;23.46;1359;29;4881.00;441
12371;25;21899186;12371;595;13731;14174;4.62;0.28;380.09;23.46;1360;29;4882.00;443
12376;25;21899206;12376;595;13731;14174;4.65;0.28;380.14;23.46;1355;29;4883.00;443
12379;25;21899221;12379;588;13731;14174;4.68;0.28;380.13;23.46;1352;29;4884.00;443
12379;25;21899244;12379;589;13731;14174;4.70;0.29;380.13;23.46;1352;29;4885.00;443
12380;25;21899260;12380;588;13731;14175;4.67;0.28;380.22;23.46;1351;29;4886.00;444
12382;25;21899274;12382;585;13731;14176;4.63;0.28;380.25;23.46;1349;29;4887.00;445
12386;25;21899290;12386;582;13731;14176;4.61;0.28;380.29;23.46;1345;29;4888.00;445
12389;25;21899315;12389;580;13732;14177;4.58;0.28;380.38;23.46;1343;29;4889.00;445
12393;25;21899338;12393;583;13732;14177;4.53;0.28;380.42;23.46;1339;29;4890.00;445
12393;25;21899358;12393;579;13732;14177;4.49;0.27;380.42;23.46;1339;29;4891.00;445
12398;25;21899377;12398;578;13732;14177;4.42;0.27;380.56;23.46;1334;29;4892.00;445
12402;25;21899394;12402;579;13732;14177;4.36;0.27;380.70;23.46;1330;29;4893.00;445
12407;25;21899409;12407;575;13732;14177;4.32;0.26;380.80;23.46;1325;30;4894.00;445
12407;25;21899435;12407;572;13732;14177;4.35;0.26;380.80;23.46;1325;30;4895.00;445
12410;25;21899450;12410;589;13787;14304;4.58;0.28;380.87;23.37;1377;30;4896.00;517
12413;25;21899477;12413;588;13792;14305;4.53;0.28;380.85;23.36;1379;30;4897.00;513
12416;25;21899491;12416;589;13798;14305;4.49;0.28;380.89;23.35;1382;30;4898.00;507
12419;25;21899510;12419;582;13799;14305;4.37;0.27;380.92;23.35;1380;30;4899.00;506
12423;25;21899526;12423;580;13804;14305;4.28;0.27;381.02;23.34;1381;30;4900.00;501
12425;25;21899547;12425;578;13808;14305;4.22;0.26;381.09;23.34;1383;30;4901.00;497
12429;25;21899565;12429;571;13810;14305;4.14;0.26;381.16;23.34;1381;30;4902.00;495
12431;25;21899581;12431;564;13812;14305;4.12;0.25;381.21;23.34;1381;30;4903.00;493
12432;25;21899599;12432;568;13814;14306;4.15;0.26;381.28;23.35;1382;30;4904.00;492
12436;25;21899616;12436;573;13816;14308;4.10;0.25;381.27;23.34;1380;30;4905.00;492
12440;25;21899634;12440;578;13818;14308;4.07;0.25;381.26;23.34;1378;30;4906.00;490
12440;25;21899650;12440;574;13820;14309;4.09;0.25;381.26;23.35;1380;30;4907.00;489
12445;25;21899669;12445;575;13821;14309;4.08;0.25;381.21;23.35;1376;30;4908.00;488
12448;25;21899686;12448;564;13823;14309;4.06;0.25;381.17;23.35;1375;30;4909.00;486
12449;25;21899703;12449;563;13824;14309;4.08;0.25;381.18;23.35;1375;30;4910.00;485
12452;25;21899718;12452;564;13827;14313;4.06;0.25;381.18;23.35;1375;30;4911.00;486
12454;25;21899735;12454;565;13829;14313;4.07;0.25;381.14;23.34;1375;30;4912.00;484
12456;25;21899752;12456;575;13830;14313;4.05;0.25;381.10;23.34;1374;30;4913.00;483
12462;25;21899770;12462;567;13832;14316;3.97;0.24;381.06;23.35;1370;30;4914.00;484
12467;25;21899788;12467;576;13833;14316;3.93;0.24;381.06;23.35;1366;30;4915.00;483
12470;25;21899804;12470;577;13833;14316;3.93;0.24;381.11;23.35;1363;30;4916.00;483
12474;25;21899820;12474;583;13834;14320;3.90;0.24;381.12;23.35;1360;30;4917.00;486
12475;25;21899835;12475;587;13835;14321;3.91;0.24;381.09;23.35;1360;30;4918.00;486
12480;25;21899850;12480;589;13835;14321;3.85;0.24;381.09;23.35;1355;30;4919.00;486
12486;25;21899867;12486;590;13839;14326;3.80;0.23;381.05;23.34;1353;30;4920.00;487
12492;25;21899883;12492;584;13839;14326;3.79;0.23;381.04;23.34;1347;30;4921.00;487
12494;25;21899904;12494;588;13839;14326;3.80;0.23;381.04;23.34;1345;30;4922.00;487
12496;25;21899927;12496;584;13840;14327;3.79;0.23;381.03;23.35;1344;30;4923.00;487
12500;25;21899966;12500;591;13840;14327;3.77;0.23;381.04;23.35;1340;30;4924.00;487
12501;25;21900012;12501;585;13845;14333;3.75;0.23;381.05;23.35;1344;30;4925.00;488
12502;25;21900043;12502;587;13845;14333;3.75;0.23;381.05;23.35;1343;30;4926.00;488
12505;25;21900067;12505;592;13845;14334;3.73;0.23;381.07;23.35;1340;30;4927.00;489
12511;25;21900087;12511;609;13847;14334;3.66;0.22;380.99;23.38;1336;30;4928.00;487
12513;25;21900107;12513;612;13848;14334;3.63;0.22;380.97;23.39;1335;30;4929.00;486
12513;25;21900139;12513;620;13848;14334;3.65;0.22;380.97;23.39;1335;30;4930.00;486
12514;25;21900160;12514;620;13850;14334;3.63;0.22;380.98;23.41;1336;30;4931.00;484
12516;25;21900180;12516;632;13858;14346;3.69;0.23;381.01;23.40;1342;30;4932.00;488
12519;25;21900200;12519;635;13859;14346;3.65;0.22;381.06;23.41;1340;30;4933.00;487
12521;25;21900221;12521;629;13861;14346;3.64;0.22;381.04;23.43;1340;30;4934.00;485
12524;25;21900241;12524;627;13863;14346;3.66;0.23;380.99;23.45;1339;30;4935.00;483
12528;25;21900262;12528;619;13866;14346;3.65;0.23;381.04;23.49;1338;30;4936.00;480
12532;25;21900281;12532;618;13867;14346;3.69;0.23;381.07;23.50;1335;30;4937.00;479
12533;25;21900299;12533;617;13868;14350;3.69;0.23;381.07;23.50;1335;30;4938.00;482
12534;25;21900318;12534;610;13873;14350;3.71;0.23;381.08;23.55;1339;30;4939.00;477
12536;25;21900336;12536;611;13876;14354;3.72;0.23;381.11;23.55;1340;30;4940.00;478
12538;25;21900363;12538;609;13877;14355;3.79;0.23;381.10;23.56;1339;30;4941.00;478
12541;25;21900382;12541;609;13879;14355;3.82;0.23;381.13;23.58;1338;30;4942.00;476
12544;25;21900400;12544;602;13880;14355;3.86;0.24;381.11;23.59;1336;30;4943.00;475
12547;25;21900417;12547;602;13890;14368;3.98;0.24;381.10;23.57;1343;30;4944.00;478
12550;25;21900437;12550;599;13893;14368;4.05;0.25;381.14;23.60;1343;30;4945.00;475
12551;25;21900455;12551;603;13894;14368;4.07;0.25;381.17;23.61;1343;30;4946.00;474
12553;25;21900472;12553;595;13896;14369;4.13;0.25;381.19;23.62;1343;30;4947.00;473
12558;26;21900500;12558;583;13898;14370;4.14;0.25;381.17;23.63;1340;31;4948.00;472
12561;27;21900542;12561;577;13899;14370;4.23;0.26;381.16;23.64;1338;32;4949.00;471
12562;27;21900580;12562;574;13905;14379;4.31;0.26;381.17;23.72;1343;32;4950.00;474
12566;27;21900607;12566;571;13906;14379;4.32;0.27;381.20;23.73;1340;32;4951.00;473
12572;27;21900635;12572;575;13909;14379;4.29;0.26;381.24;23.75;1337;32;4952.00;470
12574;27;21900654;12574;577;13909;14379;4.27;0.26;381.26;23.75;1335;32;4953.00;470
12579;27;21900672;12579;577;13914;14385;4.27;0.26;381.20;23.75;1335;32;4954.00;471
12581;27;21900696;12581;576;13917;14385;4.28;0.26;381.22;23.77;1336;32;4955.00;468
12582;27;21900714;12582;567;13918;14385;4.32;0.26;381.22;23.77;1336;32;4956.00;467
12584;27;21900734;12584;558;13919;14385;4.32;0.26;381.25;23.78;1335;32;4957.00;466
12586;27;21900758;12586;548;13922;14389;4.36;0.27;381.22;23.80;1336;32;4958.00;467
12589;27;21900779;12589;545;13923;14390;4.38;0.27;381.27;23.80;1334;32;4959.00;467
12593;27;21900806;12593;539;13924;14390;4.37;0.27;381.36;23.81;1331;32;4960.00;466
12593;27;21900827;12593;543;13926;14391;4.40;0.27;381.36;23.82;1333;32;4961.00;465
12596;27;21900848;12596;535;13926;14391;4.42;0.27;381.41;23.82;1330;32;4962.00;465
12600;27;21900868;12600;539;13933;14391;4.40;0.27;381.50;23.88;1333;32;4963.00;458
12602;27;21900889;12602;535;13933;14391;4.44;0.27;381.53;23.88;1331;32;4964.00;458
12603;27;21900909;12603;541;13934;14391;4.49;0.27;381.51;23.89;1331;32;4965.00;457
12604;27;21900933;12604;546;13936;14391;4.53;0.28;381.53;23.97;1332;32;4966.00;455
12605;27;21900961;12605;544;13938;14391;4.54;0.28;381.61;23.99;1333;32;4967.00;453
12610;27;21900987;12610;552;13982;14461;4.56;0.28;381.62;24.16;1372;33;4968.00;479
12615;27;21901038;12615;547;13983;14462;4.56;0.28;381.72;24.17;1368;33;4969.00;479
12617;27;21901066;12617;531;13985;14462;4.65;0.28;381.81;24.16;1368;33;4970.00;477
12620;27;21901089;12620;519;13986;14462;4.72;0.29;381.86;24.17;1366;33;4971.00;476
12624;27;21901116;12624;514;13991;14462;4.80;0.29;381.96;24.18;1367;33;4972.00;471
12629;27;21901139;12629;513;13993;14462;4.86;0.30;382.06;24.18;1364;33;4973.00;469
12629;27;21901164;12629;513;13996;14462;4.96;0.30;382.06;24.18;1367;33;4974.00;466
12632;27;21901186;12632;522;13999;14462;4.99;0.30;382.15;24.26;1367;33;4975.00;463
12634;27;21901214;12634;527;14002;14463;5.00;0.30;382.25;24.26;1368;33;4976.00;461
12635;27;21901237;12635;528;14003;14464;5.02;0.31;382.27;24.27;1368;33;4977.00;461
12640;27;21901264;12640;535;14004;14464;4.98;0.30;382.32;24.27;1364;33;4978.00;460
12642;27;21901287;12642;543;14006;14468;4.99;0.30;382.48;24.28;1364;33;4979.00;462
12645;27;21901312;12645;557;14006;14468;4.99;0.30;382.46;24.28;1361;33;4980.00;462
12649;27;21901331;12649;571;14006;14468;4.99;0.30;382.59;24.28;1357;33;4981.00;462
12651;27;21901351;12651;564;14006;14468;4.98;0.30;382.68;24.28;1355;33;4982.00;462
12653;27;21901369;12653;569;14011;14474;4.97;0.30;382.73;24.28;1358;33;4983.00;463
12655;27;21901390;12655;570;14011;14474;4.94;0.30;382.80;24.28;1356;33;4984.00;463
12656;27;21901412;12656;586;14012;14474;4.93;0.30;382.89;24.28;1356;33;4985.00;462
12657;27;21901432;12657;584;14015;14477;4.91;0.30;382.94;24.29;1358;33;4986.00;462
12661;27;21901453;12661;585;14016;14477;4.89;0.30;383.03;24.30;1355;33;4987.00;461
12663;27;21901474;12663;587;14017;14477;4.86;0.29;383.08;24.30;1354;33;4988.00;460
12665;27;21901494;12665;582;14017;14478;4.84;0.29;383.11;24.30;1352;33;4989.00;461
12666;27;21901515;12666;582;14019;14479;4.87;0.29;383.08;24.30;1353;33;4990.00;460
12668;27;21901534;12668;574;14020;14479;4.87;0.29;383.14;24.38;1352;33;4991.00;459
12669;27;21901553;12669;576;14030;14492;4.89;0.30;383.14;24.36;1361;33;4992.00;462
12670;27;21901574;12670;561;14031;14492;4.95;0.30;383.22;24.37;1361;33;4993.00;461
12674;27;21901595;12674;551;14031;14492;4.95;0.30;383.25;24.37;1357;33;4994.00;461
12677;27;21901615;12677;538;14031;14494;5.00;0.30;383.27;24.37;1354;33;4995.00;463
12680;27;21901635;12680;528;14032;14494;5.02;0.30;383.40;24.38;1352;33;4996.00;462
12680;27;21901655;12680;521;14035;14498;5.13;0.31;383.40;24.37;1355;33;4997.00;463
12683;27;21901676;12683;511;14035;14498;5.19;0.31;383.51;24.37;1352;33;4998.00;463
12687;27;21901697;12687;505;14037;14502;5.22;0.31;383.59;24.37;1350;33;4999.00;465
12690;27;21901719;12690;505;14037;14502;5.23;0.32;383.60;24.37;1347;33;5000.00;465
12693;27;21901746;12693;497;14037;14502;5.27;0.32;383.67;24.37;1344;33;5001.00;465
12697;27;21901767;12697;501;14038;14502;5.24;0.32;383.65;24.38;1341;33;5002.00;464
12699;27;21901786;12699;491;14039;14502;5.24;0.32;383.64;24.39;1340;33;5003.00;463
12702;27;21901806;12702;487;14047;14514;5.26;0.32;383.67;24.37;1345;34;5004.00;467
12704;27;21901836;12704;481;14048;14514;5.25;0.32;383.69;24.38;1344;34;5005.00;466
12707;27;21901855;12707;477;14048;14514;5.29;0.32;383.79;24.38;1341;34;5006.00;466
12712;27;21901879;12712;470;14049;14514;5.29;0.32;383.86;24.38;1337;34;5007.00;465
12713;27;21901907;12713;460;14049;14514;5.30;0.32;383.84;24.38;1336;34;5008.00;465
12718;27;21901935;12718;462;14049;14514;5.30;0.32;383.95;24.38;1331;34;5009.00;465
12720;27;21901966;12720;467;14050;14515;5.30;0.32;384.11;24.39;1330;34;5010.00;465
12721;27;21902002;12721;466;14050;14515;5.31;0.32;384.11;24.39;1329;34;5011.00;465
12723;27;21902027;12723;464;14054;14521;5.36;0.33;384.24;24.38;1331;34;5012.00;467
12727;27;21902052;12727;463;14055;14522;5.34;0.32;384.35;24.39;1328;34;5013.00;467
12728;27;21902080;12728;462;14055;14522;5.38;0.33;384.40;24.39;1327;34;5014.00;467
12735;27;21902102;12735;456;14055;14522;5.38;0.33;384.50;24.39;1320;34;5015.00;467
12737;27;21902128;12737;454;14058;14526;5.44;0.33;384.53;24.39;1321;34;5016.00;468
12743;27;21902153;12743;453;14058;14526;5.43;0.33;384.59;24.39;1315;34;5017.00;468
12747;27;21902180;12747;462;14058;14526;5.40;0.33;384.67;24.39;1311;34;5018.00;468
12749;27;21902206;12749;460;14060;14527;5.42;0.33;384.64;24.39;1311;34;5019.00;467
12753;27;21902228;12753;456;14061;14531;5.44;0.33;384.68;24.39;1308;34;5020.00;470
12756;27;21902251;12756;457;14061;14531;5.51;0.33;384.75;24.39;1305;34;5021.00;470
12760;27;21902277;12760;452;14062;14534;5.53;0.34;384.78;24.39;1302;34;5022.00;472
12760;27;21902307;12760;463;14063;14534;5.51;0.33;384.78;24.39;1303;34;5023.00;471
12762;27;21902333;12762;457;14063;14534;5.51;0.34;384.84;24.39;1301;34;5024.00;471
12763;27;21902357;12763;465;14063;14534;5.54;0.34;384.85;24.39;1300;34;5025.00;471
12766;27;21902381;12766;467;14066;14538;5.56;0.34;384.86;24.39;1300;34;5026.00;472
12769;27;21902417;12769;465;14066;14538;5.56;0.34;384.91;24.39;1297;34;5027.00;472
12770;27;21902451;12770;470;14067;14538;5.57;0.34;384.94;24.40;1297;34;5028.00;471
12772;27;21902478;12772;470;14067;14538;5.57;0.34;385.00;24.40;1295;34;5029.00;471
12776;27;21902501;12776;482;14067;14539;5.53;0.34;385.08;24.40;1291;34;5030.00;472
12779;27;21902524;12779;492;14067;14540;5.47;0.34;385.06;24.40;1288;34;5031.00;473
12780;27;21902546;12780;507;14067;14540;5.46;0.34;385.09;24.40;1287;34;5032.00;473
12782;27;21902568;12782;514;14068;14541;5.48;0.34;385.12;24.40;1286;34;5033.00;473
12788;27;21902588;12788;515;14068;14541;5.43;0.33;385.19;24.40;1280;34;5034.00;473
12792;27;21902608;12792;517;14069;14541;5.39;0.33;385.24;24.48;1277;34;5035.00;472
12794;27;21902630;12794;520;14069;14541;5.35;0.33;385.27;24.48;1275;34;5036.00;472
12797;27;21902654;12797;524;14069;14541;5.29;0.32;385.32;24.48;1272;34;5037.00;472
12800;27;21902680;12800;530;14069;14541;5.26;0.32;385.41;24.48;1269;34;5038.00;472
12804;27;21902701;12804;529;14069;14541;5.27;0.32;385.42;24.48;1265;34;5039.00;472
12810;27;21902723;12810;551;14150;14771;5.59;0.35;385.48;24.34;1340;34;5040.00;621
12813;27;21902778;12813;549;14157;14772;5.61;0.35;385.49;24.33;1344;34;5041.00;615
12817;27;21902802;12817;545;14165;14772;5.63;0.35;385.59;24.32;1348;34;5042.00;607
12823;27;21902827;12823;539;14174;14772;5.63;0.35;385.68;24.30;1351;34;5043.00;598
12827;27;21902852;12827;538;14181;14772;5.59;0.35;385.82;24.29;1354;34;5044.00;591
12829;27;21902874;12829;532;14186;14772;5.58;0.35;385.79;24.37;1357;34;5045.00;586
12833;27;21902918;12833;538;14191;14772;5.60;0.35;385.92;24.36;1358;34;5046.00;581
12834;27;21902938;12834;542;14194;14772;5.59;0.35;385.94;24.36;1360;34;5047.00;578
12838;27;21902959;12838;542;14198;14773;5.62;0.35;385.97;24.36;1360;34;5048.00;575
12842;27;21902981;12842;546;14200;14774;5.66;0.35;386.05;24.35;1358;34;5049.00;574
12846;27;21903002;12846;539;14205;14774;5.64;0.35;386.22;24.43;1359;34;5050.00;569
12849;27;21903030;12849;540;14208;14775;5.62;0.35;386.18;24.43;1359;34;5051.00;567
12851;27;21903056;12851;542;14211;14775;5.61;0.35;386.30;24.43;1360;34;5052.00;564
12855;27;21903082;12855;547;14215;14775;5.53;0.34;386.25;24.51;1360;34;5053.00;560
12857;27;21903103;12857;555;14216;14775;5.41;0.33;386.38;24.51;1359;34;5054.00;559
12858;27;21903124;12858;553;14221;14779;5.33;0.33;386.35;24.50;1363;34;5055.00;558
12862;27;21903145;12862;562;14222;14779;5.27;0.32;386.33;24.50;1360;34;5056.00;557
12862;27;21903164;12862;565;14224;14779;5.22;0.32;386.33;24.50;1362;34;5057.00;555
12863;27;21903182;12863;570;14227;14782;5.17;0.32;386.35;24.50;1364;34;5058.00;555
12868;27;21903202;12868;567;14227;14782;5.12;0.31;386.39;24.50;1359;34;5059.00;555
12869;27;21903220;12869;570;14229;14782;5.11;0.31;386.37;24.50;1360;34;5060.00;553
12871;27;21903239;12871;573;14231;14786;5.06;0.31;386.32;24.49;1360;34;5061.00;555
12875;27;21903258;12875;570;14234;14787;5.00;0.31;386.34;24.49;1359;34;5062.00;553
12876;27;21903278;12876;568;14236;14787;4.98;0.31;386.35;24.49;1360;34;5063.00;551
12879;27;21903298;12879;574;14239;14791;4.91;0.30;386.36;24.49;1360;34;5064.00;552
12880;27;21903324;12880;582;14241;14791;4.83;0.30;386.36;24.49;1361;34;5065.00;550
12883;27;21903345;12883;584;14241;14791;4.75;0.29;386.35;24.49;1358;34;5066.00;550
12885;27;21903363;12885;588;14242;14792;4.70;0.29;386.39;24.49;1357;34;5067.00;550
12888;27;21903382;12888;599;14242;14792;4.62;0.28;386.36;24.49;1354;34;5068.00;550
12892;27;21903399;12892;601;14245;14798;4.62;0.28;386.27;24.48;1353;34;5069.00;553
12895;27;21903419;12895;611;14247;14798;4.55;0.28;386.25;24.51;1352;34;5070.00;551
12898;27;21903447;12898;612;14248;14799;4.48;0.28;386.26;24.51;1350;34;5071.00;551
12902;27;21903464;12902;624;14248;14799;4.39;0.27;386.23;24.51;1346;34;5072.00;551
12906;27;21903481;12906;630;14248;14799;4.26;0.26;386.15;24.51;1342;34;5073.00;551
12909;27;21903498;12909;637;14248;14799;4.16;0.26;386.10;24.51;1339;34;5074.00;551
12911;27;21903516;12911;620;14248;14799;4.05;0.25;386.06;24.51;1337;34;5075.00;551
12914;27;21903533;12914;620;14257;14811;4.01;0.25;386.03;24.50;1343;34;5076.00;554
12919;27;21903551;12919;625;14257;14811;3.92;0.24;386.04;24.50;1338;34;5077.00;554
12922;27;21903570;12922;625;14257;14811;3.84;0.24;385.99;24.50;1335;34;5078.00;554
12924;27;21903587;12924;633;14257;14811;3.78;0.23;386.02;24.50;1333;34;5079.00;554
12926;27;21903604;12926;634;14257;14811;3.73;0.23;386.00;24.50;1331;34;5080.00;554
12931;27;21903620;12931;641;14257;14811;3.67;0.23;385.97;24.50;1326;34;5081.00;554
12934;27;21903637;12934;642;14258;14815;3.63;0.22;385.95;24.50;1324;34;5082.00;557
12935;27;21903655;12935;638;14258;14815;3.63;0.22;385.93;24.50;1323;34;5083.00;557
12937;27;21903671;12937;634;14260;14819;3.66;0.23;385.94;24.49;1323;34;5084.00;559
12938;27;21903689;12938;634;14260;14821;3.66;0.23;385.95;24.49;1322;34;5085.00;561
12944;27;21903705;12944;637;14260;14821;3.59;0.22;385.88;24.49;1316;34;5086.00;561
12948;27;21903722;12948;627;14260;14821;3.57;0.22;385.80;24.49;1312;34;5087.00;561
12951;27;21903739;12951;631;14270;14834;3.64;0.22;385.77;24.48;1319;34;5088.00;564
12955;27;21903757;12955;621;14270;14834;3.64;0.22;385.77;24.48;1315;34;5089.00;564
12957;27;21903774;12957;629;14271;14834;3.66;0.22;385.75;24.48;1314;34;5090.00;563
12959;27;21903791;12959;614;14272;14835;3.69;0.23;385.76;24.48;1313;34;5091.00;563
12961;27;21903808;12961;602;14273;14836;3.72;0.23;385.77;24.49;1312;34;5092.00;563
12965;27;21903825;12965;597;14273;14836;3.76;0.23;385.77;24.49;1308;34;5093.00;563
12968;27;21903847;12968;581;14274;14839;3.84;0.23;385.76;24.49;1306;34;5094.00;565
12970;27;21903867;12970;569;14274;14839;3.90;0.24;385.73;24.49;1304;34;5095.00;565
12973;27;21903886;12973;566;14274;14839;3.95;0.24;385.71;24.49;1301;34;5096.00;565
12978;27;21903911;12978;571;14275;14839;3.99;0.24;385.78;24.49;1297;34;5097.00;564
12981;27;21903951;12981;571;14278;14845;4.02;0.24;385.72;24.48;1297;34;5098.00;567
12985;27;21903974;12985;566;14280;14845;4.05;0.25;385.72;24.50;1295;34;5099.00;565
12987;27;21904005;12987;564;14284;14864;4.08;0.25;385.71;24.50;1297;34;5100.00;580
12990;27;21904036;12990;558;14285;14864;4.12;0.25;385.78;24.51;1295;34;5101.00;579
12994;27;21904057;12994;552;14288;14868;4.14;0.25;385.75;24.52;1294;34;5102.00;580
12996;27;21904080;12996;551;14289;14869;4.21;0.26;385.76;24.53;1293;34;5103.00;580
13000;27;21904104;13000;545;14290;14869;4.28;0.26;385.77;24.54;1290;34;5104.00;579
13003;27;21904125;13003;551;14295;14870;4.32;0.26;385.74;24.57;1292;34;5105.00;575
13008;27;21904146;13008;544;14295;14870;4.33;0.26;385.81;24.57;1287;34;5106.00;575
13012;27;21904164;13012;539;14298;14870;4.37;0.27;385.77;24.61;1286;34;5107.00;572
13016;27;21904185;13016;539;14298;14870;4.40;0.27;385.84;24.61;1282;34;5108.00;572
13019;27;21904207;13019;538;14302;14870;4.39;0.27;385.80;24.67;1283;34;5109.00;568
13020;27;21904226;13020;539;14303;14870;4.41;0.27;385.79;24.68;1283;34;5110.00;567
13022;27;21904244;13022;539;14307;14870;4.45;0.27;385.83;24.74;1285;34;5111.00;563
13023;27;21904263;13023;546;14343;14940;4.58;0.28;385.81;24.69;1320;34;5112.00;597
13027;27;21904288;13027;536;14345;14941;4.63;0.28;385.81;24.72;1318;34;5113.00;596
13029;27;21904307;13029;531;14351;14941;4.74;0.29;385.87;24.74;1322;34;5114.00;590
13033;27;21904324;13033;523;14357;14941;4.81;0.29;385.77;24.76;1324;34;5115.00;584
13035;27;21904346;13035;520;14360;14941;4.88;0.30;385.84;24.77;1325;34;5116.00;581
13037;27;21904364;13037;510;14361;14941;4.88;0.30;385.85;24.76;1324;34;5117.00;580
13038;27;21904383;13038;514;14365;14941;4.86;0.30;385.86;24.79;1327;34;5118.00;576
13042;27;21904402;13042;515;14367;14941;4.82;0.29;385.90;24.80;1325;34;5119.00;574
13044;27;21904420;13044;526;14370;14942;4.81;0.29;385.96;24.81;1326;34;5120.00;572
13048;27;21904440;13048;529;14374;14943;4.69;0.29;386.08;24.84;1326;34;5121.00;569
13049;27;21904459;13049;522;14378;14943;4.65;0.28;386.08;24.94;1329;34;5122.00;565
13050;27;21904481;13050;514;14383;14947;4.63;0.28;386.08;24.96;1333;34;5123.00;564
13052;27;21904501;13052;506;14384;14947;4.61;0.28;386.09;24.96;1332;34;5124.00;563
13054;27;21904520;13054;504;14387;14947;4.60;0.28;386.09;25.00;1333;34;5125.00;560
13057;27;21904538;13057;502;14388;14947;4.60;0.28;386.18;25.01;1331;34;5126.00;559
13059;27;21904566;13059;507;14392;14953;4.66;0.28;386.25;25.01;1333;34;5127.00;561
13061;27;21904594;13061;508;14395;14953;4.67;0.28;386.22;25.03;1334;34;5128.00;558
13063;27;21904613;13063;508;14396;14953;4.69;0.29;386.30;25.04;1333;34;5129.00;557
13064;27;21904636;13064;509;14402;14959;4.75;0.29;386.37;25.08;1338;34;5130.00;557
13067;27;21904657;13067;499;14404;14959;4.79;0.29;386.35;25.10;1337;34;5131.00;555
13070;27;21904681;13070;493;14406;14959;4.80;0.29;386.41;25.12;1336;34;5132.00;553
13070;27;21904701;13070;490;14409;14960;4.90;0.30;386.41;25.15;1339;34;5133.00;551
13071;27;21904722;13071;488;14411;14961;4.95;0.30;386.42;25.15;1340;34;5134.00;550
13073;27;21904753;13073;486;14417;14961;4.98;0.30;386.52;25.19;1344;34;5135.00;544
13075;27;21904782;13075;482;14425;14974;5.03;0.31;386.51;25.18;1350;34;5136.00;549
13078;27;21904804;13078;484;14428;14974;5.02;0.30;386.51;25.26;1350;34;5137.00;546
13080;27;21904827;13080;496;14430;14974;5.03;0.31;386.53;25.28;1350;34;5138.00;544
13083;27;21904851;13083;496;14431;14975;5.05;0.31;386.65;25.29;1348;34;5139.00;544
13086;27;21904873;13086;504;14435;14975;5.08;0.31;386.67;25.30;1349;34;5140.00;540
13090;27;21904899;13090;520;14440;14979;5.05;0.31;386.80;25.31;1350;34;5141.00;539
13093;27;21904922;13093;513;14442;14979;4.99;0.30;386.82;25.32;1349;34;5142.00;537
13096;27;21904947;13096;513;14444;14983;4.94;0.30;386.82;25.33;1348;34;5143.00;539
13098;27;21904968;13098;514;14446;14983;4.90;0.30;386.83;25.34;1348;34;5144.00;537
13100;27;21904988;13100;512;14448;14983;4.86;0.30;386.90;25.36;1348;34;5145.00;535
13102;27;21905013;13102;515;14451;14983;4.85;0.29;386.89;25.37;1349;34;5146.00;532
13102;27;21905039;13102;518;14453;14983;4.83;0.29;386.89;25.38;1351;34;5147.00;530
13105;27;21905067;13105;511;14461;14995;4.86;0.30;386.90;25.39;1356;34;5148.00;534
13109;27;21905097;13109;514;14464;14995;4.89;0.30;386.98;25.39;1355;34;5149.00;531
13111;27;21905119;13111;516;14469;14995;4.92;0.30;387.02;25.41;1358;34;5150.00;526
13113;27;21905143;13113;511;14471;14995;4.97;0.30;387.07;25.42;1358;34;5151.00;524
13115;27;21905167;13115;520;14475;14995;4.98;0.30;387.05;25.44;1360;34;5152.00;520
13118;27;21905189;13118;510;14476;14995;4.98;0.30;387.08;25.45;1358;34;5153.00;519
13120;27;21905214;13120;506;14478;14996;4.99;0.30;387.11;25.45;1358;34;5154.00;518
13123;27;21905237;13123;510;14482;14998;5.00;0.30;387.15;25.47;1359;34;5155.00;516
13125;27;21905264;13125;508;14488;15004;4.99;0.30;387.18;25.48;1363;34;5156.00;516
13130;27;21905289;13130;517;14489;15005;4.95;0.30;387.29;25.48;1359;34;5157.00;516
13131;27;21905317;13131;514;14493;15005;4.96;0.30;387.33;25.51;1362;34;5158.00;512
13133;27;21905341;13133;516;14495;15005;4.97;0.30;387.42;25.59;1362;34;5159.00;510
13134;27;21905370;13134;521;14503;15010;5.01;0.31;387.40;25.60;1369;34;5160.00;507
13136;27;21905402;13136;523;14504;15010;5.02;0.31;387.38;25.61;1368;34;5161.00;506
13138;27;21905429;13138;524;14504;15010;5.02;0.31;387.40;25.61;1366;34;5162.00;506
13143;27;21905454;13143;530;14506;15011;4.99;0.30;387.44;25.62;1363;34;5163.00;505
13143;27;21905484;13143;532;14507;15015;4.99;0.30;387.44;25.61;1364;34;5164.00;508
13143;27;21905509;13143;532;14510;15015;5.01;0.31;387.44;25.63;1367;34;5165.00;505
13145;27;21905536;13145;522;14511;15018;5.04;0.31;387.43;25.62;1366;34;5166.00;507
13147;27;21905563;13147;520;14512;15018;5.06;0.31;387.44;25.62;1365;34;5167.00;506
13150;27;21905587;13150;512;14513;15018;5.08;0.31;387.47;25.63;1363;34;5168.00;505
13151;27;21905609;13151;502;14515;15018;5.13;0.31;387.50;25.64;1364;34;5169.00;503
13154;27;21905634;13154;502;14518;15022;5.15;0.31;387.52;25.64;1364;34;5170.00;504
13157;27;21905655;13157;499;14518;15022;5.15;0.31;387.54;25.64;1361;34;5171.00;504
13159;27;21905678;13159;498;14518;15022;5.17;0.31;387.55;25.64;1359;34;5172.00;504
13162;27;21905701;13162;495;14520;15022;5.19;0.31;387.63;25.65;1358;34;5173.00;502
13162;27;21905722;13162;487;14520;15023;5.19;0.31;387.63;25.65;1358;34;5174.00;503
13164;27;21905748;13164;488;14520;15025;5.19;0.31;387.63;25.65;1356;34;5175.00;505
13166;27;21905769;13166;485;14521;15025;5.16;0.31;387.63;25.66;1355;34;5176.00;504
13170;27;21905788;13170;481;14522;15026;5.14;0.31;387.60;25.66;1352;34;5177.00;504
13173;27;21905815;13173;477;14522;15026;5.12;0.31;387.66;25.66;1349;34;5178.00;504
13175;27;21905835;13175;479;14523;15026;5.08;0.31;387.74;25.67;1348;34;5179.00;503
13177;27;21905861;13177;468;14523;15026;5.04;0.31;387.73;25.67;1346;34;5180.00;503
13182;27;21905887;13182;464;14524;15026;4.98;0.30;387.80;25.67;1342;34;5181.00;502
13185;27;21905918;13185;464;14525;15026;4.98;0.30;387.88;25.68;1340;34;5182.00;501
13187;27;21905946;13187;458;14525;15026;4.98;0.30;387.96;25.68;1338;34;5183.00;501
13189;27;21905973;13189;478;14588;15153;5.04;0.31;388.08;25.57;1399;34;5184.00;565
13189;27;21906016;13189;457;14590;15154;5.06;0.31;388.08;25.67;1401;34;5185.00;564
13191;27;21906043;13191;455;14592;15154;5.07;0.31;388.19;25.67;1401;34;5186.00;562
13193;27;21906063;13193;454;14593;15154;5.09;0.31;388.29;25.67;1400;34;5187.00;561
13196;27;21906082;13196;460;14596;15154;5.13;0.32;388.31;25.67;1400;34;5188.00;558
13199;27;21906105;13199;462;14598;15154;5.14;0.32;388.38;25.67;1399;34;5189.00;556
13201;27;21906134;13201;467;14600;15154;5.18;0.32;388.48;25.66;1399;34;5190.00;554
13203;27;21906157;13203;477;14602;15154;5.18;0.32;388.57;25.66;1399;34;5191.00;552
13205;27;21906181;13205;476;14604;15155;5.24;0.32;388.64;25.66;1399;34;5192.00;551
13208;27;21906206;13208;481;14607;15156;5.22;0.32;388.70;25.66;1399;34;5193.00;549
13210;27;21906240;13210;473;14610;15156;5.16;0.32;388.73;25.65;1400;34;5194.00;546
13213;27;21906271;13213;476;14612;15157;5.14;0.32;388.80;25.65;1399;34;5195.00;545
13216;27;21906296;13216;480;14615;15157;5.09;0.31;388.76;25.65;1399;34;5196.00;542
13221;27;21906322;13221;484;14616;15157;5.01;0.31;388.84;25.65;1395;34;5197.00;541
13221;27;21906346;13221;498;14617;15157;4.98;0.31;388.84;25.65;1396;34;5198.00;540
13223;27;21906370;13223;507;14619;15161;4.97;0.31;388.87;25.64;1396;34;5199.00;542
13226;27;21906398;13226;507;14622;15161;4.93;0.30;388.96;25.64;1396;34;5200.00;539
13231;27;21906439;13231;515;14622;15161;4.90;0.30;388.92;25.64;1391;34;5201.00;539
13234;27;21906467;13234;516;14623;15164;4.89;0.30;389.00;25.64;1389;34;5202.00;541
13235;27;21906490;13235;524;14623;15164;4.87;0.30;388.98;25.64;1388;34;5203.00;541
13237;27;21906516;13237;527;14623;15164;4.83;0.30;388.97;25.64;1386;34;5204.00;541
13239;27;21906539;13239;523;14624;15168;4.82;0.30;389.06;25.64;1385;34;5205.00;544
13242;27;21906567;13242;521;14625;15169;4.76;0.29;389.07;25.63;1383;34;5206.00;544
13244;27;21906590;13244;530;14625;15169;4.73;0.29;389.11;25.63;1381;34;5207.00;544
13250;27;21906615;13250;543;14628;15173;4.67;0.29;389.15;25.63;1378;34;5208.00;545
13252;27;21906640;13252;555;14628;15173;4.62;0.28;389.11;25.63;1376;34;5209.00;545
13253;27;21906664;13253;553;14628;15173;4.59;0.28;389.08;25.63;1375;34;5210.00;545
13258;27;21906688;13258;558;14628;15174;4.58;0.28;389.11;25.63;1370;34;5211.00;546
13260;27;21906714;13260;560;14628;15174;4.56;0.28;389.12;25.63;1368;34;5212.00;546
13261;27;21906737;13261;573;14631;15180;4.57;0.28;389.16;25.62;1370;34;5213.00;549
13262;27;21906762;13262;580;14631;15180;4.59;0.28;389.22;25.62;1369;34;5214.00;549
13263;27;21906788;13263;585;14631;15180;4.56;0.28;389.23;25.62;1368;34;5215.00;549
13264;27;21906813;13264;591;14631;15181;4.52;0.28;389.21;25.62;1367;34;5216.00;550
13270;27;21906835;13270;598;14631;15181;4.45;0.27;389.22;25.62;1361;34;5217.00;550
13271;27;21906856;13271;605;14631;15181;4.44;0.27;389.25;25.62;1360;34;5218.00;550
13274;27;21906875;13274;611;14631;15181;4.37;0.27;389.21;25.62;1357;34;5219.00;550
13276;27;21906898;13276;617;14649;15217;4.45;0.27;389.21;25.59;1373;34;5220.00;568
13278;27;21906918;13278;627;14650;15217;4.42;0.27;389.23;25.59;1372;34;5221.00;567
13281;27;21906937;13281;630;14651;15217;4.39;0.27;389.19;25.59;1370;34;5222.00;566
13282;27;21906961;13282;627;14651;15217;4.32;0.27;389.24;25.59;1369;34;5223.00;566
13284;27;21906981;13284;625;14651;15217;4.33;0.27;389.20;25.59;1367;34;5224.00;566
13286;27;21907016;13286;632;14651;15217;4.31;0.26;389.20;25.59;1365;34;5225.00;566
13289;27;21907040;13289;624;14652;15221;4.30;0.26;389.14;25.59;1363;34;5226.00;569
13292;27;21907064;13292;621;14652;15221;4.27;0.26;389.09;25.59;1360;34;5227.00;569
13292;27;21907087;13292;623;14654;15225;4.28;0.26;389.09;25.58;1362;34;5228.00;571
13294;27;21907110;13294;620;14654;15226;4.25;0.26;389.04;25.58;1360;34;5229.00;572
13297;27;21907133;13297;618;14654;15226;4.15;0.25;389.08;25.58;1357;34;5230.00;572
13297;27;21907162;13297;613;14654;15226;4.12;0.25;389.08;25.58;1357;34;5231.00;572
13301;27;21907182;13301;616;14664;15239;4.11;0.25;389.07;25.57;1363;34;5232.00;575
13304;27;21907205;13304;617;14664;15239;4.09;0.25;389.00;25.57;1360;34;5233.00;575
13305;27;21907229;13305;618;14664;15239;4.12;0.25;388.99;25.57;1359;34;5234.00;575
13305;27;21907250;13305;622;14665;15240;4.17;0.25;388.99;25.56;1360;34;5235.00;575
13308;27;21907269;13308;625;14665;15241;4.17;0.26;388.95;25.56;1357;34;5236.00;576
13309;27;21907288;13309;630;14665;15241;4.16;0.25;388.94;25.56;1356;34;5237.00;576
13311;27;21907318;13311;633;14666;15244;4.16;0.25;388.94;25.56;1355;34;5238.00;578
13314;27;21907345;13314;636;14666;15244;4.13;0.25;388.91;25.56;1352;34;5239.00;578
13316;27;21907367;13316;641;14666;15244;4.08;0.25;388.90;25.56;1350;34;5240.00;578
13317;27;21907387;13317;642;14667;15244;4.02;0.25;388.89;25.56;1350;34;5241.00;577
13324;27;21907407;13324;652;14670;15250;3.93;0.24;388.80;25.56;1346;34;5242.00;580
13326;27;21907429;13326;665;14670;15250;3.84;0.23;388.79;25.56;1344;34;5243.00;580
13327;27;21907446;13327;666;14671;15250;3.81;0.23;388.78;25.57;1344;34;5244.00;579
13332;27;21907465;13332;667;14672;15250;3.70;0.23;388.70;25.58;1340;34;5245.00;578
13335;27;21907483;13335;673;14673;15254;3.64;0.22;388.75;25.58;1338;34;5246.00;581
13337;27;21907500;13337;671;14673;15255;3.56;0.22;388.77;25.58;1336;34;5247.00;582
13340;27;21907515;13340;656;14673;15255;3.50;0.21;388.74;25.58;1333;34;5248.00;582
13342;27;21907531;13342;651;14674;15256;3.50;0.21;388.75;25.58;1332;34;5249.00;582
13347;27;21907549;13347;626;14675;15256;3.47;0.21;388.65;25.59;1328;34;5250.00;581
13350;27;21907569;13350;614;14675;15256;3.47;0.21;388.65;25.59;1325;34;5251.00;581
13350;27;21907587;13350;596;14675;15256;3.52;0.21;388.65;25.59;1325;34;5252.00;581
13352;27;21907604;13352;582;14675;15256;3.54;0.22;388.65;25.59;1323;34;5253.00;581
13356;27;21907623;13356;570;14676;15256;3.59;0.22;388.65;25.60;1320;34;5254.00;580
13357;27;21907645;13357;566;14676;15256;3.64;0.22;388.65;25.60;1319;34;5255.00;580
13358;27;21907671;13358;557;14706;15326;3.91;0.24;388.67;25.55;1348;34;5256.00;620
13360;27;21907698;13360;550;14709;15327;3.95;0.24;388.66;25.54;1349;34;5257.00;618
13362;27;21907718;13362;539;14715;15327;4.01;0.24;388.67;25.53;1353;34;5258.00;612
13362;27;21907736;13362;535;14719;15327;4.10;0.25;388.67;25.53;1357;34;5259.00;608
13364;27;21907754;13364;522;14720;15327;4.14;0.25;388.69;25.53;1356;34;5260.00;607
13367;27;21907772;13367;511;14722;15327;4.17;0.25;388.68;25.53;1355;34;5261.00;605
13368;27;21907799;13368;511;14724;15327;4.24;0.26;388.70;25.52;1356;34;5262.00;603
13370;27;21907817;13370;507;14726;15327;4.29;0.26;388.71;25.52;1356;34;5263.00;601
13372;27;21907837;13372;503;14728;15328;4.34;0.26;388.71;25.52;1356;34;5264.00;600
13374;27;21907867;13374;497;14729;15330;4.40;0.27;388.70;25.52;1355;34;5265.00;601
13376;27;21907886;13376;499;14730;15330;4.42;0.27;388.68;25.53;1354;34;5266.00;600
13379;27;21907911;13379;497;14731;15334;4.40;0.27;388.65;25.53;1352;34;5267.00;603
13382;27;21907937;13382;498;14732;15334;4.42;0.27;388.69;25.53;1350;34;5268.00;602
13386;27;21907964;13386;502;14732;15334;4.41;0.27;388.66;25.53;1346;34;5269.00;602
13393;27;21907990;13393;511;14733;15334;4.39;0.27;388.63;25.54;1340;34;5270.00;601
13395;27;21908016;13395;503;14737;15340;4.44;0.27;388.62;25.55;1342;34;5271.00;603
13397;27;21908035;13397;505;14737;15340;4.48;0.27;388.60;25.55;1340;34;5272.00;603
13400;27;21908063;13400;508;14739;15340;4.47;0.27;388.56;25.57;1339;34;5273.00;601
13402;27;21908085;13402;504;14740;15343;4.48;0.27;388.65;25.57;1338;34;5274.00;603
13405;27;21908106;13405;501;14740;15343;4.48;0.27;388.63;25.57;1335;34;5275.00;603
13411;27;21908128;13411;506;14742;15343;4.44;0.27;388.67;25.58;1331;34;5276.00;601
13413;27;21908152;13413;508;14743;15344;4.48;0.27;388.65;25.59;1330;34;5277.00;601
13418;27;21908171;13418;510;14747;15345;4.46;0.27;388.69;25.63;1329;34;5278.00;598
13420;27;21908191;13420;502;14749;15345;4.50;0.27;388.64;25.65;1329;34;5279.00;596
13424;27;21908213;13424;504;14769;15371;4.59;0.28;388.66;25.62;1345;34;5280.00;602
13430;27;21908235;13430;494;14770;15371;4.61;0.28;388.69;25.64;1340;34;5281.00;601
13432;27;21908256;13432;494;14772;15371;4.64;0.28;388.72;25.64;1340;34;5282.00;599
13436;27;21908279;13436;489;14774;15372;4.70;0.29;388.76;25.66;1338;34;5283.00;598
13440;27;21908310;13440;498;14776;15372;4.73;0.29;388.80;25.68;1336;34;5284.00;596
13442;27;21908331;13442;492;14780;15376;4.75;0.29;388.81;25.70;1338;34;5285.00;596
13447;27;21908353;13447;486;14784;15376;4.73;0.29;388.82;25.74;1337;34;5286.00;592
13452;27;21908375;13452;485;14785;15379;4.71;0.29;388.86;25.74;1333;34;5287.00;594
13455;27;21908398;13455;488;14787;15380;4.74;0.29;388.86;25.76;1332;34;5288.00;593
13458;27;21908420;13458;495;14790;15380;4.78;0.29;388.86;25.78;1332;34;5289.00;590
13460;27;21908443;13460;500;14792;15380;4.74;0.29;388.88;25.79;1332;34;5290.00;588
13464;27;21908468;13464;497;14794;15380;4.70;0.29;388.97;25.81;1330;34;5291.00;586
13464;27;21908491;13464;495;14804;15392;4.76;0.29;388.97;25.82;1340;34;5292.00;588
13465;27;21908518;13465;494;14806;15392;4.75;0.29;389.03;25.92;1341;34;5293.00;586
13469;27;21908552;13469;495;14809;15392;4.70;0.29;389.07;25.93;1340;34;5294.00;583
13472;27;21908579;13472;499;14811;15392;4.63;0.28;389.00;25.95;1339;34;5295.00;581
13475;27;21908601;13475;502;14814;15392;4.59;0.28;389.15;25.97;1339;34;5296.00;578
13478;27;21908624;13478;500;14816;15392;4.57;0.28;389.16;25.98;1338;34;5297.00;576
13483;27;21908650;13483;496;14818;15393;4.53;0.28;389.22;26.00;1335;34;5298.00;575
13484;27;21908672;13484;497;14820;15393;4.50;0.27;389.30;26.00;1336;34;5299.00;573
13485;27;21908696;13485;496;14824;15399;4.53;0.28;389.33;26.01;1339;34;5300.00;575
13490;27;21908723;13490;504;14826;15400;4.55;0.28;389.43;26.01;1336;34;5301.00;574
13492;27;21908746;13492;499;14829;15400;4.55;0.28;389.48;26.03;1337;34;5302.00;571
13493;27;21908768;13493;503;14830;15400;4.56;0.28;389.52;26.04;1337;34;5303.00;570
13497;27;21908788;13497;501;14834;15404;4.53;0.28;389.66;26.04;1337;34;5304.00;570
13498;27;21908809;13498;506;14836;15404;4.53;0.28;389.66;26.05;1338;34;5305.00;568
13502;27;21908832;13502;490;14838;15404;4.50;0.27;389.81;26.07;1336;34;5306.00;566
13504;27;21908854;13504;487;14841;15405;4.54;0.28;389.91;26.16;1337;34;5307.00;564
13505;27;21908887;13505;490;14843;15409;4.56;0.28;389.99;26.17;1338;34;5308.00;566
13507;27;21908912;13507;486;14849;15409;4.58;0.28;390.08;26.47;1342;35;5309.00;560
13509;27;21908956;13509;486;14853;15415;4.56;0.28;390.15;26.49;1344;35;5310.00;562
13513;27;21908980;13513;489;14855;15415;4.57;0.28;390.26;26.50;1342;35;5311.00;560
13518;27;21909005;13518;506;14857;15415;4.58;0.28;390.30;26.51;1339;35;5312.00;558
13520;27;21909030;13520;513;14860;15415;4.58;0.28;390.40;26.53;1340;35;5313.00;555
13522;27;21909057;13522;518;14863;15419;4.57;0.28;390.49;26.62;1341;35;5314.00;556
13528;27;21909080;13528;526;14867;15419;4.54;0.28;390.66;26.63;1339;35;5315.00;552
13529;27;21909101;13529;526;14869;15419;4.52;0.27;390.74;26.64;1340;35;5316.00;550
13533;27;21909121;13533;526;14869;15419;4.48;0.27;390.80;26.64;1336;35;5317.00;550
13538;27;21909145;13538;524;14871;15420;4.46;0.27;390.87;26.66;1333;35;5318.00;549
13539;27;21909175;13539;525;14876;15421;4.45;0.27;390.96;26.67;1337;35;5319.00;545
13541;27;21909198;13541;521;14877;15421;4.45;0.27;390.99;26.68;1336;35;5320.00;544
13543;27;21909219;13543;509;14880;15422;4.49;0.27;391.08;26.68;1337;35;5321.00;542
13545;27;21909239;13545;506;14882;15422;4.49;0.27;391.27;26.70;1337;35;5322.00;540
13547;27;21909261;13547;494;14885;15422;4.54;0.28;391.31;26.71;1338;35;5323.00;537
13547;27;21909280;13547;492;14888;15422;4.61;0.28;391.31;26.80;1341;35;5324.00;534
13549;27;21909300;13549;499;14891;15422;4.64;0.28;391.35;26.82;1342;35;5325.00;531
13552;27;21909318;13552;496;14891;15422;4.67;0.28;391.54;26.82;1339;35;5326.00;531
13553;27;21909337;13553;492;14892;15422;4.73;0.29;391.62;26.83;1339;35;5327.00;530
13556;27;21909356;13556;518;14962;15549;4.87;0.30;391.76;26.73;1406;35;5328.00;587
13556;27;21909390;13556;500;14962;15550;4.92;0.30;391.76;26.73;1406;35;5329.00;588
13559;27;21909412;13559;489;14965;15550;4.98;0.31;391.79;26.73;1406;35;5330.00;585
13559;27;21909434;13559;494;14967;15550;5.03;0.31;391.79;26.74;1408;35;5331.00;583
13561;27;21909463;13561;485;14970;15550;5.08;0.31;391.92;26.74;1409;35;5332.00;580
13562;27;21909484;13562;490;14970;15550;5.12;0.32;391.91;26.74;1408;35;5333.00;580
13566;27;21909516;13566;490;14976;15550;5.15;0.32;391.89;26.83;1410;35;5334.00;574
13569;27;21909536;13569;499;14978;15550;5.19;0.32;391.95;26.83;1409;35;5335.00;572
13569;27;21909556;13569;495;14981;15551;5.23;0.32;391.95;26.83;1412;35;5336.00;570
13572;27;21909578;13572;496;14985;15552;5.22;0.32;391.98;26.84;1413;35;5337.00;567
13576;27;21909599;13576;499;14989;15552;5.19;0.32;392.11;26.84;1413;35;5338.00;563
13579;27;21909619;13579;506;14992;15553;5.16;0.32;392.17;26.83;1413;35;5339.00;561
13581;27;21909641;13581;499;14997;15553;5.13;0.31;392.19;26.85;1416;35;5340.00;556
13583;27;21909663;13583;496;14999;15553;5.10;0.31;392.20;26.85;1416;35;5341.00;554
13587;27;21909686;13587;503;15001;15553;5.09;0.31;392.19;26.86;1414;35;5342.00;552
13587;27;21909709;13587;503;15006;15557;5.07;0.31;392.19;26.86;1419;35;5343.00;551
13591;27;21909732;13591;502;15007;15557;5.05;0.31;392.25;26.86;1416;35;5344.00;550
13592;27;21909752;13592;505;15008;15557;5.04;0.31;392.24;26.86;1416;35;5345.00;549
13594;27;21909777;13594;509;15010;15560;5.03;0.31;392.22;26.87;1416;35;5346.00;550
13595;27;21909799;13595;492;15012;15560;5.04;0.31;392.23;26.97;1417;35;5347.00;548
13596;27;21909819;13596;492;15013;15560;5.03;0.31;392.30;26.97;1417;35;5348.00;547
13596;27;21909840;13596;494;15014;15564;5.00;0.31;392.30;26.98;1418;35;5349.00;550
13601;27;21909861;13601;495;15016;15565;4.93;0.30;392.51;26.98;1415;35;5350.00;549
13603;27;21909882;13603;491;15016;15565;4.91;0.30;392.53;26.98;1413;35;5351.00;549
13608;27;21909908;13608;504;15019;15569;4.87;0.30;392.58;26.98;1411;35;5352.00;550
13610;27;21909935;13610;503;15021;15569;4.83;0.29;392.61;26.98;1411;35;5353.00;548
13611;27;21909968;13611;505;15022;15569;4.81;0.29;392.61;26.99;1411;35;5354.00;547
13615;27;21909995;13615;501;15023;15571;4.77;0.29;392.78;27.08;1408;36;5355.00;548
13619;27;21910032;13619;504;15024;15571;4.76;0.29;392.76;27.08;1405;36;5356.00;547
13623;27;21910055;13623;496;15028;15577;4.76;0.29;392.83;27.07;1405;36;5357.00;549
13629;27;21910079;13629;496;15030;15577;4.74;0.29;392.97;27.08;1401;36;5358.00;547
13632;27;21910099;13632;502;15030;15577;4.74;0.29;392.96;27.08;1398;36;5359.00;547
13635;27;21910120;13635;501;15030;15578;4.74;0.29;393.04;27.08;1395;36;5360.00;548
13636;27;21910141;13636;506;15031;15578;4.74;0.29;393.12;27.08;1395;36;5361.00;547
13637;27;21910165;13637;503;15031;15578;4.73;0.29;393.11;27.08;1394;36;5362.00;547
13637;27;21910186;13637;514;15034;15578;4.72;0.29;393.11;27.09;1397;36;5363.00;544
13640;27;21910205;13640;515;15043;15590;4.74;0.29;393.18;27.08;1403;36;5364.00;547
13642;27;21910229;13642;513;15043;15590;4.74;0.29;393.16;27.08;1401;36;5365.00;547
13644;27;21910250;13644;508;15044;15590;4.73;0.29;393.16;27.08;1400;36;5366.00;546
13647;27;21910270;13647;513;15045;15590;4.67;0.29;393.12;27.09;1398;36;5367.00;545
13650;27;21910290;13650;507;15046;15590;4.66;0.28;393.08;27.09;1396;36;5368.00;544
13651;27;21910310;13651;509;15046;15590;4.68;0.29;393.09;27.09;1395;36;5369.00;544
13655;27;21910337;13655;512;15047;15594;4.65;0.28;393.04;27.09;1392;36;5370.00;547
13655;27;21910364;13655;510;15048;15594;4.62;0.28;393.04;27.10;1393;36;5371.00;546
13658;27;21910383;13658;518;15050;15598;4.58;0.28;393.00;27.10;1392;36;5372.00;548
13661;27;21910404;13661;522;15050;15599;4.52;0.28;393.00;27.10;1389;36;5373.00;549
13661;27;21910424;13661;522;15051;15599;4.49;0.27;393.00;27.10;1390;36;5374.00;548
13662;27;21910449;13662;527;15051;15599;4.50;0.28;393.05;27.10;1389;36;5375.00;548
13664;27;21910469;13664;526;15062;15612;4.51;0.28;393.01;27.08;1398;36;5376.00;550
13664;27;21910491;13664;530;15063;15612;4.49;0.28;393.01;27.09;1399;36;5377.00;549
13669;27;21910513;13669;538;15063;15612;4.42;0.27;393.01;27.09;1394;36;5378.00;549
13671;27;21910531;13671;554;15064;15613;4.37;0.27;392.98;27.09;1393;36;5379.00;549
13673;27;21910550;13673;550;15064;15614;4.32;0.26;392.98;27.09;1391;36;5380.00;550
13676;27;21910569;13676;562;15064;15614;4.27;0.26;392.98;27.09;1388;36;5381.00;550
13678;27;21910588;13678;568;15065;15617;4.25;0.26;393.03;27.08;1387;36;5382.00;552
13682;27;21910607;13682;579;15065;15617;4.17;0.26;392.98;27.08;1383;36;5383.00;552
13683;27;21910634;13683;583;15065;15617;4.15;0.25;392.98;27.08;1382;36;5384.00;552
13687;27;21910652;13687;595;15065;15617;4.06;0.25;393.00;27.08;1378;36;5385.00;552
13688;27;21910670;13688;598;15070;15623;4.06;0.25;392.97;27.18;1382;36;5386.00;553
13688;27;21910691;13688;599;15070;15623;4.02;0.25;392.97;27.18;1382;36;5387.00;553
13690;27;21910711;13690;605;15070;15623;3.99;0.24;393.00;27.18;1380;36;5388.00;553
13694;27;21910730;13694;610;15070;15623;3.94;0.24;393.02;27.18;1376;36;5389.00;553
13697;27;21910750;13697;614;15072;15627;3.92;0.24;393.05;27.27;1375;36;5390.00;555
13701;27;21910777;13701;615;15072;15628;3.87;0.24;393.01;27.27;1371;36;5391.00;556
13703;27;21910797;13703;619;15072;15628;3.88;0.24;392.99;27.27;1369;36;5392.00;556
13705;27;21910815;13705;628;15073;15629;3.87;0.24;392.95;27.27;1368;36;5393.00;556
13705;27;21910833;13705;630;15073;15629;3.85;0.24;392.95;27.27;1368;36;5394.00;556
13709;27;21910851;13709;639;15074;15629;3.80;0.23;392.91;27.37;1365;36;5395.00;555
13710;27;21910868;13710;642;15074;15629;3.79;0.23;392.88;27.37;1364;36;5396.00;555
13710;27;21910886;13710;637;15074;15629;3.75;0.23;392.88;27.37;1364;36;5397.00;555
13710;27;21910902;13710;647;15074;15629;3.72;0.23;392.88;27.37;1364;36;5398.00;555
13710;27;21910919;13710;641;15074;15629;3.73;0.23;392.88;27.37;1364;36;5399.00;555
