step_arrived;step_collisions;step_duration;step_ended;step_halting;step_inserted;step_loaded;step_meanSpeed;step_meanSpeedRelative;step_meanTravelTime;step_meanWaitingTime;step_running;step_teleports;step_time;step_waiting
0;0;22294020;0;1;86;245;16.52;1.17;-1.00;0.00;86;0;0.00;159
0;0;22294047;0;0;99;245;15.61;1.08;-1.00;0.13;99;0;1.00;146
0;0;22294048;0;1;118;245;14.83;1.01;-1.00;0.43;118;0;2.00;127
0;0;22294050;0;2;130;245;13.96;0.95;-1.00;0.67;130;0;3.00;115
0;0;22294051;0;3;144;245;12.91;0.87;-1.00;0.99;144;0;4.00;101
0;0;22294052;0;4;153;245;11.88;0.80;-1.00;1.23;153;0;5.00;92
0;0;22294053;0;7;165;245;10.92;0.73;-1.00;1.58;165;0;6.00;80
0;0;22294055;0;10;171;245;10.34;0.69;-1.00;1.77;171;0;7.00;74
0;0;22294056;0;17;181;246;9.85;0.65;-1.00;2.11;181;0;8.00;65
0;0;22294058;0;19;185;247;9.46;0.63;-1.00;2.26;185;0;9.00;62
0;0;22294062;0;23;194;247;9.05;0.60;-1.00;2.62;194;0;10.00;53
0;0;22294064;0;27;200;248;8.68;0.57;-1.00;2.82;200;0;11.00;48
1;0;22294066;1;27;206;248;8.63;0.57;12.00;3.09;205;0;12.00;42
1;0;22294068;1;33;211;248;8.68;0.56;12.00;3.32;210;0;13.00;37
1;0;22294070;1;36;214;248;8.68;0.56;12.00;3.47;213;0;14.00;34
1;0;22294072;1;39;222;252;8.52;0.55;12.00;3.76;221;0;15.00;30
1;0;22294076;1;44;223;252;8.59;0.55;12.00;3.82;222;0;16.00;29
1;0;22294079;1;47;227;252;8.65;0.55;12.00;4.02;226;0;17.00;25
2;0;22294081;2;51;230;255;8.59;0.55;15.00;4.20;228;0;18.00;25
2;0;22294084;2;59;233;255;8.62;0.54;15.00;4.25;231;0;19.00;22
3;0;22294093;3;64;234;255;8.65;0.54;16.67;4.32;231;0;20.00;21
3;0;22294097;3;69;241;259;8.82;0.55;16.67;4.47;238;0;21.00;18
3;0;22294100;3;73;242;260;8.89;0.56;16.67;4.46;239;0;22.00;18
3;0;22294103;3;78;244;260;8.86;0.56;16.67;4.61;241;0;23.00;16
3;0;22294105;3;79;248;264;8.79;0.55;16.67;4.63;245;0;24.00;16
5;0;22294108;5;82;251;264;8.78;0.55;20.00;4.78;246;0;25.00;13
6;0;22294112;6;85;252;264;8.80;0.55;20.83;4.81;246;0;26.00;12
6;0;22294116;6;91;252;265;8.80;0.55;20.83;4.81;246;0;27.00;13
6;0;22294119;6;96;253;265;8.68;0.54;20.83;4.90;247;0;28.00;12
6;0;22294122;6;98;259;271;8.56;0.53;20.83;4.85;253;0;29.00;12
6;0;22294128;6;98;260;271;8.41;0.52;20.83;4.95;254;0;30.00;11
6;0;22294131;6;98;261;272;8.43;0.52;20.83;4.93;255;0;31.00;11
8;0;22294134;8;101;262;272;8.34;0.52;23.25;4.93;254;0;32.00;10
8;0;22294137;8;106;262;272;8.36;0.52;23.25;4.93;254;0;33.00;10
9;0;22294140;9;109;263;272;8.33;0.52;24.44;5.04;254;0;34.00;9
9;0;22294144;9;110;264;272;8.30;0.51;24.44;5.15;255;0;35.00;8
10;0;22294147;10;114;276;284;8.54;0.53;25.00;5.06;266;0;36.00;8
10;0;22294151;10;116;276;284;8.55;0.53;25.00;5.06;266;0;37.00;8
10;0;22294153;10;119;277;284;8.51;0.53;25.00;5.14;267;0;38.00;7
13;0;22294156;13;120;278;284;8.38;0.52;27.54;5.20;265;0;39.00;6
14;0;22294160;14;122;279;284;8.32;0.51;28.07;5.23;265;0;40.00;5
14;0;22294164;14;124;280;284;8.27;0.51;28.07;5.23;266;0;41.00;4
15;0;22294167;15;127;284;288;8.26;0.51;28.53;5.17;269;0;42.00;4
16;0;22294170;16;130;284;288;8.04;0.50;29.06;5.17;268;0;43.00;4
18;0;22294173;18;132;288;292;7.87;0.48;29.56;5.11;270;0;44.00;4
18;0;22294177;18;135;290;294;7.72;0.48;29.56;5.08;272;0;45.00;4
18;0;22294180;18;138;290;294;7.50;0.47;29.56;5.08;272;0;46.00;4
18;0;22294182;18;138;290;294;7.49;0.47;29.56;5.08;272;0;47.00;4
18;0;22294185;18;140;301;307;7.72;0.48;29.56;4.89;283;0;48.00;6
19;0;22294189;19;143;301;307;7.58;0.47;30.53;4.89;282;0;49.00;6
19;0;22294192;19;147;301;307;7.57;0.47;30.53;4.89;282;0;50.00;6
19;0;22294196;19;149;302;308;7.57;0.47;30.53;4.88;283;0;51.00;6
19;0;22294199;19;150;303;309;7.46;0.46;30.53;4.86;284;0;52.00;6
19;0;22294202;19;153;303;309;7.42;0.46;30.53;4.86;284;0;53.00;6
19;0;22294204;19;155;305;312;7.43;0.46;30.53;4.83;286;0;54.00;7
21;0;22294207;21;158;305;312;7.28;0.45;32.76;4.83;284;0;55.00;7
24;0;22294211;24;147;306;312;7.27;0.45;33.21;4.82;282;0;56.00;6
27;0;22294214;27;141;306;312;7.14;0.44;34.93;4.82;279;0;57.00;6
28;0;22294218;28;142;312;318;7.09;0.44;35.75;4.75;284;0;58.00;6
28;0;22294221;28;143;312;318;7.08;0.43;35.75;4.75;284;0;59.00;6
28;0;22294225;28;145;312;318;7.11;0.44;35.75;4.75;284;0;60.00;6
28;0;22294230;28;149;312;318;7.12;0.44;35.75;4.75;284;0;61.00;6
28;0;22294233;28;153;316;322;7.15;0.44;35.75;4.70;288;0;62.00;6
29;0;22294236;29;154;317;323;7.38;0.45;36.69;4.69;288;0;63.00;6
30;0;22294239;30;156;317;323;7.46;0.46;37.47;4.69;287;0;64.00;6
30;0;22294242;30;156;318;324;7.59;0.46;37.47;4.68;288;0;65.00;6
30;0;22294247;30;157;318;324;7.66;0.47;37.47;4.68;288;0;66.00;6
32;0;22294251;32;146;318;324;7.73;0.47;37.75;4.68;286;0;67.00;6
33;0;22294254;33;142;318;324;7.82;0.48;38.52;4.68;285;0;68.00;6
33;0;22294257;33;138;318;324;8.00;0.49;38.52;4.68;285;0;69.00;6
33;0;22294261;33;133;318;324;8.14;0.50;38.52;4.68;285;0;70.00;6
33;0;22294265;33;129;318;324;8.22;0.50;38.52;4.68;285;0;71.00;6
33;0;22294268;33;133;351;394;8.43;0.52;38.52;4.24;318;0;72.00;43
33;0;22294278;33;127;352;395;8.59;0.53;38.52;4.23;319;0;73.00;43
33;0;22294282;33;122;359;395;8.93;0.55;38.52;4.18;326;0;74.00;36
34;1;22294286;34;121;362;395;9.04;0.55;39.59;4.17;328;1;75.00;33
35;1;22294301;35;117;364;395;9.21;0.56;40.63;4.17;329;1;76.00;31
35;1;22294305;35;116;366;395;9.37;0.57;40.63;4.18;331;1;77.00;29
35;1;22294315;35;120;368;395;9.51;0.58;40.63;4.19;333;1;78.00;27
36;1;22294319;36;123;370;395;9.68;0.59;41.22;4.20;334;1;79.00;25
36;1;22294322;36;123;372;396;9.66;0.59;41.22;4.22;336;1;80.00;24
39;1;22294333;39;122;374;397;9.66;0.59;44.28;4.25;335;1;81.00;23
39;1;22294337;39;123;376;397;9.66;0.59;44.28;4.28;337;1;82.00;21
39;1;22294341;39;126;382;401;9.57;0.58;44.28;4.26;343;1;83.00;19
40;1;22294346;40;129;383;401;9.55;0.58;45.25;4.28;343;1;84.00;18
40;1;22294350;40;130;384;401;9.49;0.57;45.25;4.30;344;1;85.00;17
40;1;22294353;40;130;385;401;9.39;0.57;45.25;4.31;345;1;86.00;16
40;1;22294356;40;132;390;407;9.26;0.56;45.25;4.26;350;1;87.00;17
43;1;22294361;43;135;390;407;9.04;0.55;48.00;4.26;347;1;88.00;17
45;1;22294366;45;137;390;407;8.86;0.54;49.71;4.26;345;1;89.00;17
46;1;22294371;46;135;394;413;8.77;0.53;50.59;4.22;348;1;90.00;19
48;1;22294377;48;134;394;413;8.69;0.53;52.27;4.22;346;1;91.00;19
48;1;22294381;48;136;396;413;8.62;0.52;52.27;4.21;348;1;92.00;17
49;1;22294384;49;133;397;414;8.52;0.52;53.10;4.20;348;1;93.00;17
49;1;22294388;49;134;398;415;8.45;0.51;53.10;4.19;349;1;94.00;17
52;1;22294391;52;134;398;415;8.31;0.51;54.13;4.19;346;1;95.00;17
53;1;22294397;53;138;408;428;8.24;0.50;54.92;4.09;355;1;96.00;20
54;1;22294402;54;136;409;428;8.30;0.51;55.70;4.08;355;1;97.00;19
55;1;22294405;55;134;409;428;8.40;0.51;56.35;4.08;354;1;98.00;19
56;1;22294408;56;135;410;429;8.51;0.52;57.11;4.07;354;1;99.00;19
57;1;22294414;57;134;410;429;8.64;0.53;57.86;4.07;353;1;100.00;19
59;1;22294422;59;135;413;433;8.69;0.53;59.32;4.05;354;1;101.00;20
59;1;22294428;59;135;413;433;8.74;0.54;59.32;4.05;354;1;102.00;20
59;1;22294432;59;137;417;437;8.65;0.53;59.32;4.02;358;1;103.00;20
60;1;22294436;60;133;417;437;8.71;0.53;59.92;4.02;357;1;104.00;20
62;1;22294440;62;130;417;437;8.77;0.54;60.97;4.02;355;1;105.00;20
65;1;22294445;65;124;417;437;8.90;0.54;62.98;4.02;352;1;106.00;20
66;1;22294449;66;117;417;437;9.00;0.55;63.64;4.02;351;1;107.00;20
66;1;22294453;66;111;428;449;9.13;0.56;63.64;3.92;362;1;108.00;21
66;1;22294457;66;103;430;449;9.25;0.57;63.64;4.07;364;1;109.00;19
66;1;22294464;66;96;431;449;9.45;0.58;63.64;4.07;365;1;110.00;18
67;1;22294469;67;95;431;449;9.64;0.59;64.30;4.07;364;1;111.00;18
67;1;22294474;67;93;431;449;9.84;0.60;64.30;4.07;364;1;112.00;18
68;1;22294480;68;91;431;449;10.04;0.61;65.01;4.07;363;1;113.00;18
69;1;22294485;69;87;432;450;10.22;0.62;65.70;4.06;363;1;114.00;18
70;1;22294490;70;82;432;450;10.34;0.63;66.40;4.06;362;1;115.00;18
71;1;22294496;71;76;437;456;10.47;0.64;67.07;4.03;366;1;116.00;19
71;1;22294502;71;72;438;457;10.51;0.64;67.07;4.02;367;1;117.00;19
71;1;22294507;71;67;438;457;10.55;0.64;67.07;4.02;367;1;118.00;19
71;1;22294512;71;65;438;457;10.58;0.65;67.07;4.02;367;1;119.00;19
73;1;22294519;73;66;442;462;10.76;0.66;68.40;3.98;369;1;120.00;20
75;1;22294531;75;68;442;462;10.92;0.66;69.31;3.98;367;1;121.00;20
75;1;22294537;75;72;443;462;10.90;0.66;69.31;4.25;368;1;122.00;19
76;1;22294544;76;72;446;463;10.89;0.66;70.01;4.45;370;1;123.00;17
77;1;22294550;77;74;450;467;10.78;0.66;70.44;4.42;373;1;124.00;17
80;1;22294555;80;73;451;467;10.87;0.66;72.46;4.69;371;1;125.00;16
81;1;22294563;81;75;455;470;11.02;0.67;73.07;4.88;374;1;126.00;15
82;1;22294569;82;76;455;470;11.13;0.68;73.73;4.88;373;1;127.00;15
83;1;22294575;83;79;459;470;11.19;0.68;74.39;5.37;376;1;128.00;11
84;1;22294582;84;82;459;470;11.26;0.69;75.04;5.37;375;1;129.00;11
85;1;22294588;85;84;464;474;11.38;0.69;75.64;5.47;379;1;130.00;10
87;1;22294595;87;86;464;474;11.53;0.70;76.89;5.47;377;1;131.00;10
88;1;22294602;88;89;467;474;11.58;0.71;77.10;5.94;379;1;132.00;7
88;1;22294609;88;90;468;474;11.55;0.71;77.10;5.93;380;1;133.00;6
90;1;22294617;90;88;470;475;11.56;0.71;78.22;6.09;380;1;134.00;5
91;1;22294623;91;89;472;477;11.56;0.71;78.81;6.07;381;1;135.00;5
93;1;22294631;93;91;473;477;11.47;0.70;80.02;6.19;380;1;136.00;4
94;1;22294637;94;93;474;478;11.41;0.70;79.86;6.18;380;1;137.00;4
95;1;22294644;95;96;476;478;11.35;0.69;80.34;6.38;381;1;138.00;2
98;1;22294650;98;99;476;478;11.25;0.69;80.23;6.38;378;1;139.00;2
99;1;22294656;99;100;477;478;11.33;0.69;80.78;6.46;378;1;140.00;1
101;1;22294663;101;102;477;478;11.39;0.70;81.82;6.46;376;1;141.00;1
102;1;22294668;102;102;478;478;11.53;0.71;82.16;6.49;376;1;142.00;0
102;1;22294674;102;103;478;478;11.52;0.71;82.16;6.49;376;1;143.00;0
104;1;22294681;104;121;549;605;11.26;0.70;82.81;5.66;445;1;144.00;56
104;1;22294699;104;115;555;606;11.25;0.70;82.81;5.61;451;1;145.00;51
106;1;22294705;106;114;565;606;11.28;0.71;83.66;5.54;459;1;146.00;41
106;1;22294713;106;113;568;606;11.12;0.70;83.66;5.53;462;1;147.00;38
109;1;22294719;109;115;572;606;11.03;0.69;85.39;5.52;463;1;148.00;34
110;1;22294727;110;113;573;606;10.95;0.69;85.84;5.52;463;1;149.00;33
111;1;22294735;111;112;577;611;10.75;0.68;86.34;5.50;466;1;150.00;34
114;1;22294745;114;110;580;611;10.72;0.67;86.82;5.51;466;1;151.00;31
117;1;22294752;117;110;581;612;10.59;0.66;87.80;5.51;464;1;152.00;31
121;1;22294760;121;109;585;613;10.56;0.66;87.26;5.54;464;1;153.00;28
122;1;22294769;122;110;589;613;10.66;0.66;87.66;5.57;467;1;154.00;24
122;1;22294775;122;112;592;614;10.64;0.66;87.66;5.58;470;1;155.00;22
123;1;22294787;123;116;599;614;10.47;0.65;87.83;5.63;476;1;156.00;15
126;1;22294796;126;118;601;614;10.45;0.65;88.89;5.66;475;1;157.00;13
128;1;22294803;128;124;603;614;10.51;0.65;89.96;5.68;475;1;158.00;11
129;1;22294811;129;131;608;618;10.53;0.65;90.43;5.68;479;1;159.00;10
131;1;22294819;131;134;610;618;10.51;0.65;90.85;5.69;479;1;160.00;8
132;1;22294827;132;138;610;618;10.45;0.65;90.30;5.69;478;1;161.00;8
136;1;22294834;136;145;612;621;10.39;0.64;92.36;5.67;476;1;162.00;9
137;1;22294848;137;150;613;621;10.33;0.64;92.88;5.69;476;1;163.00;8
140;1;22294855;140;154;613;621;10.20;0.63;93.84;5.69;473;1;164.00;8
141;1;22294862;141;157;618;625;10.03;0.62;94.33;5.72;477;1;165.00;7
146;1;22294869;146;155;619;626;9.89;0.61;95.94;5.71;473;1;166.00;7
146;1;22294876;146;157;619;626;9.85;0.61;95.94;5.71;473;1;167.00;7
146;1;22294883;146;157;623;630;9.84;0.61;95.94;5.68;477;1;168.00;7
147;1;22294890;147;157;625;630;9.80;0.60;95.46;5.74;478;1;169.00;5
148;1;22294898;148;154;627;630;9.74;0.60;95.47;5.76;479;1;170.00;3
151;1;22294905;151;150;629;631;9.61;0.59;95.97;5.79;478;1;171.00;2
152;1;22294913;152;148;630;631;9.41;0.58;96.41;5.79;478;1;172.00;1
152;1;22294918;152;152;636;637;9.35;0.58;96.41;5.74;484;1;173.00;1
155;1;22294925;155;156;636;637;9.14;0.56;97.35;5.74;481;1;174.00;1
155;1;22294933;155;145;637;638;8.99;0.56;97.35;5.74;482;1;175.00;1
156;1;22294942;156;134;637;638;8.93;0.55;97.76;5.74;481;1;176.00;1
157;1;22294949;157;129;637;638;8.89;0.55;98.11;5.74;480;1;177.00;1
158;1;22294955;158;124;637;638;8.88;0.55;98.32;5.74;479;1;178.00;1
161;1;22294963;161;130;638;638;8.85;0.55;99.65;5.77;477;1;179.00;0
163;1;22294972;163;131;669;672;8.97;0.56;100.50;5.51;506;1;180.00;3
163;1;22294982;163;139;670;672;9.04;0.56;100.50;5.50;507;1;181.00;2
163;1;22294987;163;131;671;672;9.17;0.57;100.50;5.49;508;1;182.00;1
163;1;22294994;163;132;671;672;9.31;0.58;100.50;5.49;508;1;183.00;1
165;1;22295001;165;132;672;672;9.41;0.58;100.59;5.49;507;1;184.00;0
166;1;22295007;166;126;672;672;9.48;0.59;101.07;5.49;506;1;185.00;0
170;1;22295014;170;119;676;676;9.52;0.59;101.06;5.46;506;1;186.00;0
172;1;22295021;172;118;676;676;9.57;0.59;101.45;5.46;504;1;187.00;0
172;1;22295028;172;120;680;680;9.67;0.60;101.45;5.44;508;1;188.00;0
174;1;22295035;174;125;681;681;9.74;0.60;101.68;5.43;507;1;189.00;0
176;1;22295042;176;130;681;681;9.73;0.60;102.41;5.43;505;1;190.00;0
176;1;22295050;176;133;681;681;9.74;0.60;102.41;5.43;505;1;191.00;0
181;1;22295056;181;140;694;694;9.64;0.59;103.04;5.33;513;1;192.00;0
181;1;22295066;181;146;694;694;9.59;0.59;103.04;5.33;513;1;193.00;0
184;1;22295072;184;151;694;694;9.52;0.58;102.47;5.33;510;1;194.00;0
187;1;22295080;187;155;695;695;9.49;0.58;101.91;5.32;508;1;195.00;0
189;1;22295087;189;157;696;696;9.43;0.58;102.90;5.32;507;1;196.00;0
193;1;22295095;193;162;696;696;9.34;0.57;101.95;5.32;503;1;197.00;0
194;1;22295103;194;168;698;699;9.27;0.57;102.45;5.30;504;1;198.00;1
196;1;22295110;196;171;698;699;9.12;0.56;102.25;5.30;502;1;199.00;1
197;1;22295118;197;172;699;699;9.03;0.55;102.50;5.30;502;1;200.00;0
198;1;22295129;198;172;699;699;8.91;0.55;102.63;5.30;501;1;201.00;0
201;1;22295136;201;177;705;705;8.78;0.54;102.63;5.26;504;1;202.00;0
203;1;22295145;203;184;705;705;8.60;0.53;102.78;5.26;502;1;203.00;0
203;1;22295151;203;190;705;705;8.44;0.52;102.78;5.26;502;1;204.00;0
206;1;22295158;206;196;705;705;8.31;0.51;102.82;5.26;499;1;205.00;0
209;1;22295167;209;205;709;709;8.23;0.51;103.11;5.24;500;1;206.00;0
212;1;22295174;212;211;710;710;8.12;0.50;104.05;5.23;498;1;207.00;0
215;1;22295182;215;218;710;710;7.96;0.49;104.63;5.23;495;1;208.00;0
218;1;22295189;218;218;711;711;7.86;0.48;104.71;5.22;493;1;209.00;0
220;1;22295199;220;217;711;711;7.70;0.47;104.14;5.22;491;1;210.00;0
220;1;22295205;220;222;711;711;7.64;0.47;104.14;5.22;491;1;211.00;0
221;1;22295211;221;230;711;711;7.54;0.46;104.38;5.22;490;1;212.00;0
223;1;22295218;223;234;711;711;7.41;0.46;103.87;5.22;488;1;213.00;0
224;1;22295225;224;237;711;711;7.36;0.45;104.04;5.22;487;1;214.00;0
225;1;22295232;225;239;711;711;7.29;0.45;103.89;5.22;486;1;215.00;0
226;1;22295237;226;253;753;781;7.46;0.46;104.23;4.93;527;1;216.00;28
226;1;22295249;226;250;755;782;7.39;0.46;104.23;4.92;529;1;217.00;27
229;1;22295256;229;248;763;782;7.43;0.46;104.50;4.89;534;1;218.00;19
232;1;22295265;232;250;764;782;7.46;0.46;105.25;4.89;532;1;219.00;18
233;1;22295272;233;254;767;782;7.50;0.46;105.12;4.88;534;1;220.00;15
236;1;22295279;236;257;768;782;7.54;0.46;105.78;4.88;532;1;221.00;14
237;1;22295291;237;249;770;782;7.53;0.46;106.24;4.89;533;1;222.00;12
238;1;22295300;238;245;772;782;7.53;0.46;106.72;4.89;534;1;223.00;10
239;1;22295307;239;229;772;783;7.55;0.46;107.18;4.89;533;1;224.00;11
239;1;22295315;239;221;776;785;7.58;0.47;107.18;4.90;537;1;225.00;9
240;1;22295323;240;223;777;785;7.59;0.47;107.67;4.91;537;1;226.00;8
241;1;22295332;241;224;785;789;7.68;0.47;107.91;4.91;544;1;227.00;4
242;1;22295339;242;224;787;789;7.79;0.48;108.09;4.93;545;1;228.00;2
243;1;22295348;243;224;789;789;7.95;0.49;107.99;4.94;546;1;229.00;0
246;1;22295355;246;228;789;789;8.07;0.49;109.46;4.94;543;1;230.00;0
247;1;22295364;247;210;795;795;8.26;0.50;109.11;4.91;548;1;231.00;0
248;1;22295372;248;202;795;795;8.50;0.52;109.27;4.91;547;1;232.00;0
249;2;22295380;249;189;795;795;8.66;0.53;109.58;4.91;546;2;233.00;0
253;2;22295401;253;179;797;798;8.78;0.54;110.72;4.90;544;2;234.00;1
253;2;22295409;253;176;797;798;8.89;0.54;110.72;4.90;544;2;235.00;1
254;2;22295424;254;168;798;798;8.98;0.55;111.18;4.89;544;2;236.00;0
256;2;22295434;256;163;799;799;8.98;0.55;111.31;4.89;543;2;237.00;0
256;2;22295442;256;158;800;800;9.03;0.55;111.31;4.88;544;2;238.00;0
258;2;22295451;258;157;800;800;9.11;0.56;111.06;4.88;542;2;239.00;0
259;2;22295460;259;161;824;826;9.22;0.57;111.00;4.74;565;2;240.00;2
260;2;22295470;260;155;825;826;9.28;0.57;110.67;4.74;565;2;241.00;1
263;2;22295481;263;148;826;826;9.44;0.58;111.49;4.73;563;2;242.00;0
265;2;22295489;265;139;827;827;9.62;0.59;111.99;4.73;562;2;243.00;0
266;2;22295504;266;137;827;827;9.70;0.59;112.44;4.73;561;2;244.00;0
269;2;22295513;269;130;831;831;9.75;0.60;112.84;4.71;562;2;245.00;0
271;2;22295522;271;130;831;831;9.77;0.60;113.25;4.71;560;2;246.00;0
273;2;22295530;273;127;835;835;9.73;0.59;113.80;4.69;562;2;247.00;0
275;2;22295538;275;129;835;835;9.79;0.60;114.36;4.69;560;2;248.00;0
276;2;22295546;276;125;835;835;9.92;0.60;114.32;4.69;559;2;249.00;0
279;2;22295553;279;126;835;835;10.01;0.61;114.66;4.69;556;2;250.00;0
281;2;22295563;281;127;835;835;10.08;0.62;114.86;4.69;554;2;251.00;0
283;2;22295570;283;128;846;847;10.10;0.62;115.28;4.63;563;2;252.00;1
284;2;22295581;284;126;846;847;10.12;0.62;115.76;4.63;562;2;253.00;1
289;2;22295588;289;128;847;847;10.16;0.62;116.31;4.63;558;2;254.00;0
289;2;22295598;289;128;847;847;10.23;0.62;116.31;4.63;558;2;255.00;0
292;2;22295605;292;128;847;847;10.26;0.63;116.70;4.63;555;2;256.00;0
293;2;22295613;293;128;847;847;10.27;0.63;117.15;4.63;554;2;257.00;0
295;2;22295620;295;126;848;848;10.24;0.62;117.64;4.62;553;2;258.00;0
296;2;22295635;296;133;848;848;10.21;0.62;118.09;4.62;552;2;259.00;0
297;2;22295641;297;135;854;854;10.19;0.62;118.29;4.60;557;2;260.00;0
300;2;22295650;300;138;855;855;10.10;0.61;118.55;4.59;555;2;261.00;0
301;2;22295657;301;146;855;855;10.03;0.61;119.00;4.59;554;2;262.00;0
301;2;22295665;301;151;855;855;10.03;0.61;119.00;4.59;554;2;263.00;0
301;2;22295672;301;153;859;859;9.89;0.60;119.00;4.57;558;2;264.00;0
301;2;22295686;301;153;859;859;9.87;0.60;119.00;4.57;558;2;265.00;0
303;2;22295695;303;151;859;859;9.81;0.60;119.09;4.57;556;2;266.00;0
305;2;22295702;305;147;860;860;9.87;0.60;119.62;4.57;555;2;267.00;0
305;2;22295708;305;145;864;864;9.89;0.60;119.62;4.55;559;2;268.00;0
308;2;22295718;308;139;864;864;9.87;0.60;120.06;4.55;556;2;269.00;0
309;2;22295727;309;140;868;870;9.93;0.60;120.45;4.53;559;2;270.00;2
312;2;22295735;312;132;868;870;9.98;0.61;121.15;4.53;556;2;271.00;2
314;2;22295741;314;129;870;870;10.04;0.61;121.46;4.52;556;2;272.00;0
316;2;22295749;316;129;870;870;10.08;0.61;121.94;4.52;554;2;273.00;0
318;2;22295756;318;127;874;874;10.18;0.62;122.41;4.51;556;2;274.00;0
319;2;22295765;319;127;874;874;10.28;0.62;122.64;4.51;555;2;275.00;0
322;2;22295772;322;123;874;874;10.32;0.63;122.95;4.51;552;2;276.00;0
323;2;22295780;323;124;874;874;10.29;0.62;123.21;4.51;551;2;277.00;0
326;2;22295786;326;125;875;875;10.25;0.62;123.76;4.50;549;2;278.00;0
329;3;22295794;329;119;876;876;10.29;0.62;124.10;4.50;547;3;279.00;0
333;3;22295815;333;115;876;876;10.32;0.62;124.41;4.50;543;3;280.00;0
335;3;22295822;335;110;877;877;10.35;0.63;124.48;4.49;542;3;281.00;0
336;3;22295830;336;105;877;877;10.34;0.63;124.52;4.49;541;3;282.00;0
340;3;22295837;340;98;877;877;10.31;0.62;124.69;4.49;537;3;283.00;0
340;3;22295845;340;95;877;877;10.33;0.63;124.69;4.49;537;3;284.00;0
340;3;22295851;340;91;877;877;10.34;0.63;124.69;4.49;537;3;285.00;0
341;3;22295858;341;89;877;877;10.49;0.64;124.68;4.49;536;3;286.00;0
342;3;22295866;342;87;877;877;10.64;0.65;124.74;4.49;535;3;287.00;0
344;3;22295874;344;102;944;1004;10.46;0.65;124.64;4.18;600;3;288.00;60
345;3;22295896;345;89;947;1005;10.57;0.65;124.70;4.17;602;3;289.00;58
346;3;22295904;346;85;953;1005;10.65;0.66;124.55;4.15;607;3;290.00;52
346;3;22295913;346;81;955;1005;10.71;0.66;124.55;4.15;609;3;291.00;50
349;3;22295920;349;80;962;1005;10.82;0.67;125.31;4.15;613;3;292.00;43
354;3;22295930;354;74;963;1005;10.84;0.67;125.06;4.15;609;3;293.00;42
355;3;22295939;355;76;965;1005;10.92;0.67;125.51;4.16;610;3;294.00;40
357;3;22295956;357;79;968;1005;11.03;0.68;126.04;4.16;611;3;295.00;37
359;3;22295967;359;80;970;1006;11.10;0.68;126.16;4.17;611;3;296.00;36
360;3;22295975;360;80;973;1007;11.20;0.69;126.63;4.19;613;3;297.00;34
362;3;22295985;362;82;978;1007;11.23;0.69;126.12;4.22;616;3;298.00;29
364;3;22295995;364;79;981;1008;11.22;0.69;126.46;4.24;617;3;299.00;27
367;3;22296007;367;79;986;1014;11.13;0.68;126.28;4.25;619;3;300.00;28
368;3;22296024;368;77;990;1014;11.06;0.68;126.70;4.29;622;3;301.00;24
369;3;22296035;369;82;993;1014;10.99;0.67;126.77;4.32;624;3;302.00;21
371;3;22296044;371;87;996;1018;10.97;0.67;127.47;4.34;625;3;303.00;22
372;3;22296054;372;93;998;1018;10.96;0.67;127.93;4.36;626;3;304.00;20
373;3;22296066;373;101;1002;1018;10.92;0.67;127.92;4.40;629;3;305.00;16
373;3;22296075;373;112;1008;1021;10.89;0.67;127.92;4.43;635;3;306.00;13
376;3;22296086;376;114;1009;1021;10.96;0.67;128.09;4.43;633;3;307.00;12
378;3;22296098;378;118;1012;1021;11.08;0.68;128.76;4.46;634;3;308.00;9
379;3;22296108;379;123;1014;1025;11.09;0.68;129.02;4.45;635;3;309.00;11
380;3;22296119;380;130;1016;1026;11.17;0.69;128.74;4.46;636;3;310.00;10
381;3;22296131;381;134;1018;1026;11.23;0.69;128.75;4.49;637;3;311.00;8
385;3;22296141;385;139;1024;1030;11.16;0.68;130.09;4.50;639;3;312.00;6
386;3;22296152;386;141;1026;1030;11.14;0.68;130.25;4.50;640;3;313.00;4
390;3;22296163;390;143;1027;1030;11.14;0.68;130.32;4.50;637;3;314.00;3
391;3;22296172;391;144;1030;1032;11.16;0.68;130.26;4.50;639;3;315.00;2
392;3;22296182;392;151;1030;1032;11.19;0.68;130.37;4.50;638;3;316.00;2
395;3;22296192;395;150;1036;1038;11.13;0.68;131.48;4.48;641;3;317.00;2
395;3;22296209;395;153;1036;1038;11.14;0.68;131.48;4.48;641;3;318.00;2
398;3;22296220;398;158;1037;1039;11.01;0.67;132.08;4.48;639;3;319.00;2
399;3;22296231;399;160;1037;1039;10.78;0.66;132.26;4.48;638;3;320.00;2
402;3;22296240;402;164;1037;1039;10.56;0.65;132.63;4.48;635;3;321.00;2
402;3;22296251;402;168;1037;1039;10.35;0.64;132.63;4.48;635;3;322.00;2
405;3;22296259;405;176;1037;1039;10.15;0.62;132.90;4.48;632;3;323.00;2
408;3;22296269;408;179;1048;1051;9.96;0.61;133.71;4.43;640;3;324.00;3
408;3;22296280;408;173;1048;1051;9.80;0.60;133.71;4.43;640;3;325.00;3
413;3;22296288;413;175;1049;1051;9.69;0.60;134.91;4.43;636;3;326.00;2
414;3;22296299;414;176;1049;1051;9.62;0.59;134.94;4.43;635;3;327.00;2
417;3;22296307;417;177;1049;1051;9.67;0.59;135.38;4.43;632;3;328.00;2
420;3;22296317;420;180;1049;1051;9.70;0.60;136.30;4.43;629;3;329.00;2
421;3;22296329;421;184;1052;1055;9.67;0.59;136.34;4.42;631;3;330.00;3
422;3;22296339;422;186;1054;1055;9.70;0.60;136.37;4.47;632;3;331.00;1
425;3;22296350;425;188;1058;1059;9.81;0.60;136.60;4.46;633;3;332.00;1
426;3;22296358;426;196;1059;1060;9.89;0.61;136.61;4.46;633;3;333.00;1
432;3;22296368;432;196;1060;1060;9.90;0.61;137.41;4.46;628;3;334.00;0
435;3;22296377;435;199;1060;1060;9.92;0.61;137.97;4.46;625;3;335.00;0
439;3;22296386;439;206;1073;1073;9.80;0.60;138.49;4.40;634;3;336.00;0
442;3;22296398;442;203;1073;1073;9.75;0.60;139.06;4.40;631;3;337.00;0
445;3;22296406;445;208;1073;1073;9.67;0.59;139.81;4.40;628;3;338.00;0
448;3;22296416;448;210;1074;1074;9.61;0.59;140.77;4.40;626;3;339.00;0
451;3;22296424;451;214;1075;1075;9.52;0.58;141.42;4.40;624;3;340.00;0
453;3;22296434;453;217;1075;1075;9.41;0.58;141.98;4.40;622;3;341.00;0
456;3;22296442;456;219;1078;1078;9.29;0.57;142.48;4.38;622;3;342.00;0
459;3;22296453;459;221;1078;1078;9.22;0.57;143.47;4.38;619;3;343.00;0
462;3;22296461;462;222;1078;1078;9.18;0.56;144.75;4.38;616;3;344.00;0
467;3;22296470;467;228;1078;1078;9.03;0.55;145.18;4.38;611;3;345.00;0
472;3;22296478;472;230;1084;1084;8.91;0.55;146.37;4.37;612;3;346.00;0
472;3;22296487;472;233;1084;1084;8.68;0.53;146.37;4.37;612;3;347.00;0
475;3;22296496;475;234;1084;1084;8.41;0.52;146.99;4.37;609;3;348.00;0
478;3;22296503;478;238;1084;1084;8.10;0.50;147.86;4.37;606;3;349.00;0
480;3;22296511;480;225;1088;1088;7.91;0.49;148.15;4.35;608;3;350.00;0
482;3;22296519;482;223;1089;1089;7.73;0.48;148.95;4.35;607;3;351.00;0
485;3;22296527;485;218;1089;1089;7.57;0.47;149.28;4.35;604;3;352.00;0
490;3;22296535;490;215;1090;1090;7.51;0.46;150.08;4.35;600;3;353.00;0
491;3;22296542;491;216;1090;1090;7.52;0.47;150.03;4.35;599;3;354.00;0
492;3;22296551;492;218;1090;1090;7.57;0.47;149.86;4.35;598;3;355.00;0
499;3;22296558;499;224;1090;1090;7.52;0.47;150.17;4.35;591;3;356.00;0
501;3;22296567;501;214;1090;1090;7.53;0.47;150.32;4.35;589;3;357.00;0
503;3;22296574;503;216;1090;1090;7.60;0.47;150.54;4.35;587;3;358.00;0
506;3;22296583;506;215;1090;1090;7.60;0.47;151.08;4.35;584;3;359.00;0
509;3;22296591;509;232;1158;1215;7.83;0.49;151.40;4.09;649;3;360.00;57
512;3;22296612;512;224;1164;1216;7.74;0.49;151.26;4.07;652;3;361.00;52
516;3;22296619;516;227;1177;1216;7.77;0.49;151.56;4.05;661;3;362.00;39
518;3;22296628;518;222;1179;1216;7.74;0.49;151.26;4.05;661;3;363.00;37
522;3;22296636;522;222;1184;1216;7.70;0.48;151.51;4.05;662;3;364.00;32
527;3;22296645;527;233;1189;1216;7.55;0.47;151.54;4.05;662;3;365.00;27
530;3;22296653;530;238;1193;1216;7.52;0.47;151.39;4.06;663;3;366.00;23
532;3;22296662;532;246;1197;1216;7.44;0.46;151.21;4.07;665;3;367.00;19
534;3;22296673;534;248;1203;1217;7.37;0.46;151.21;4.09;669;3;368.00;14
536;3;22296684;536;259;1205;1218;7.32;0.45;151.34;4.10;669;3;369.00;13
536;3;22296692;536;262;1209;1218;7.23;0.45;151.34;4.11;673;3;370.00;9
537;3;22296701;537;271;1215;1222;7.12;0.44;151.28;4.11;678;3;371.00;7
539;3;22296711;539;276;1217;1222;6.95;0.43;151.23;4.12;678;3;372.00;5
541;3;22296729;541;285;1218;1222;6.86;0.43;150.78;4.13;677;3;373.00;4
543;3;22296737;543;288;1220;1222;6.76;0.42;150.83;4.14;677;3;374.00;2
545;3;22296746;545;292;1226;1228;6.61;0.41;150.95;4.13;681;3;375.00;2
547;3;22296755;547;301;1226;1228;6.56;0.41;150.89;4.13;679;3;376.00;2
550;3;22296767;550;311;1227;1228;6.51;0.40;151.14;4.14;677;3;377.00;1
550;3;22296783;550;312;1229;1231;6.44;0.40;151.14;4.13;679;3;378.00;2
552;3;22296793;552;310;1230;1231;6.40;0.39;150.92;4.14;678;3;379.00;1
553;3;22296803;553;313;1230;1231;6.31;0.39;150.98;4.14;677;3;380.00;1
556;3;22296812;556;300;1232;1232;6.19;0.38;150.47;4.14;676;3;381.00;0
557;3;22296821;557;288;1233;1233;6.22;0.38;150.29;4.14;676;3;382.00;0
560;3;22296831;560;285;1233;1233;6.23;0.38;150.23;4.14;673;3;383.00;0
563;3;22296840;563;286;1245;1246;6.29;0.39;149.67;4.10;682;3;384.00;1
564;3;22296851;564;282;1245;1246;6.35;0.39;149.66;4.10;681;3;385.00;1
566;3;22296861;566;277;1245;1246;6.42;0.39;149.66;4.10;679;3;386.00;1
570;3;22296870;570;274;1246;1247;6.55;0.40;149.80;4.09;676;3;387.00;1
570;3;22296887;570;277;1247;1247;6.75;0.41;149.80;4.09;677;3;388.00;0
571;3;22296898;571;275;1250;1251;6.94;0.42;150.03;4.09;679;3;389.00;1
572;3;22296916;572;273;1250;1251;7.09;0.43;150.16;4.09;678;3;390.00;1
573;4;22296925;573;272;1254;1255;7.29;0.44;150.13;4.08;681;4;391.00;1
574;4;22296948;574;270;1255;1255;7.35;0.45;149.92;4.08;681;4;392.00;0
576;4;22296957;576;267;1255;1255;7.39;0.45;149.81;4.08;679;4;393.00;0
578;4;22296975;578;269;1255;1255;7.48;0.46;149.97;4.08;677;4;394.00;0
580;4;22296986;580;265;1255;1255;7.48;0.46;150.30;4.08;675;4;395.00;0
581;4;22296997;581;274;1265;1267;7.55;0.46;150.23;4.04;684;4;396.00;2
582;4;22297006;582;265;1266;1267;7.58;0.46;150.36;4.04;684;4;397.00;1
582;4;22297017;582;259;1267;1267;7.62;0.46;150.36;4.04;685;4;398.00;0
584;4;22297028;584;252;1267;1267;7.63;0.46;150.78;4.04;683;4;399.00;0
584;4;22297038;584;251;1267;1267;7.71;0.47;150.78;4.04;683;4;400.00;0
587;4;22297054;587;250;1267;1267;7.77;0.47;151.12;4.04;680;4;401.00;0
588;4;22297067;588;252;1268;1268;7.84;0.48;151.05;4.04;680;4;402.00;0
589;4;22297080;589;247;1268;1268;7.91;0.48;151.38;4.04;679;4;403.00;0
591;4;22297090;591;245;1274;1274;8.01;0.49;151.76;4.02;683;4;404.00;0
595;4;22297105;595;244;1276;1276;8.05;0.49;151.63;4.02;681;4;405.00;0
597;4;22297124;597;230;1276;1276;8.08;0.49;151.64;4.02;679;4;406.00;0
599;4;22297139;599;221;1276;1276;8.12;0.49;151.91;4.02;677;4;407.00;0
600;4;22297161;600;216;1280;1280;8.22;0.50;151.70;4.00;680;4;408.00;0
602;4;22297173;602;208;1280;1280;8.25;0.50;151.86;4.00;678;4;409.00;0
603;4;22297188;603;203;1280;1280;8.36;0.51;152.17;4.00;677;4;410.00;0
605;4;22297202;605;205;1281;1281;8.51;0.52;152.65;4.00;676;4;411.00;0
607;4;22297216;607;206;1284;1285;8.64;0.52;152.83;3.99;677;4;412.00;1
607;4;22297231;607;201;1284;1285;8.77;0.53;152.83;3.99;677;4;413.00;1
608;4;22297247;608;198;1286;1288;8.95;0.54;153.02;3.99;678;4;414.00;2
611;4;22297259;611;201;1287;1288;8.98;0.55;153.42;3.99;676;4;415.00;1
612;4;22297272;612;198;1288;1288;9.07;0.55;153.83;3.99;676;4;416.00;0
615;4;22297287;615;198;1288;1288;9.08;0.55;154.47;3.99;673;4;417.00;0
616;4;22297300;616;194;1292;1292;9.14;0.56;154.88;3.98;676;4;418.00;0
618;4;22297310;618;185;1292;1292;9.11;0.55;155.26;3.98;674;4;419.00;0
620;4;22297330;620;179;1292;1292;9.10;0.56;155.38;3.98;672;4;420.00;0
622;4;22297340;622;177;1292;1292;9.07;0.55;156.03;3.98;670;4;421.00;0
623;4;22297350;623;174;1293;1293;9.13;0.56;156.16;3.98;670;4;422.00;0
625;4;22297361;625;175;1294;1294;9.23;0.56;156.47;3.97;669;4;423.00;0
625;4;22297370;625;172;1294;1294;9.35;0.57;156.47;3.97;669;4;424.00;0
626;5;22297380;626;170;1295;1295;9.40;0.57;156.78;3.97;669;5;425.00;0
629;5;22297401;629;171;1295;1295;9.37;0.57;157.65;3.97;666;5;426.00;0
631;5;22297411;631;168;1295;1295;9.37;0.57;157.85;3.97;664;5;427.00;0
636;5;22297421;636;171;1295;1295;9.36;0.57;158.58;3.97;659;5;428.00;0
640;5;22297431;640;173;1295;1295;9.35;0.57;159.01;3.97;655;5;429.00;0
641;5;22297440;641;173;1295;1295;9.39;0.57;159.16;3.97;654;5;430.00;0
642;5;22297450;642;172;1295;1295;9.49;0.58;159.46;3.97;653;5;431.00;0
644;5;22297461;644;205;1376;1422;9.29;0.58;159.47;3.74;732;5;432.00;46
648;5;22297486;648;194;1376;1423;9.34;0.58;160.24;3.74;728;5;433.00;47
651;5;22297500;651;184;1381;1423;9.51;0.59;160.71;3.73;730;5;434.00;42
654;5;22297512;654;176;1381;1423;9.52;0.59;161.26;3.73;727;5;435.00;42
657;5;22297523;657;176;1387;1423;9.67;0.60;162.16;3.73;730;5;436.00;36
660;5;22297538;660;174;1388;1423;9.70;0.60;162.31;3.73;728;5;437.00;35
663;5;22297552;663;186;1390;1423;9.73;0.60;162.53;3.74;727;5;438.00;33
665;5;22297567;665;190;1393;1423;9.79;0.60;163.12;3.74;728;5;439.00;30
667;5;22297580;667;188;1396;1424;9.79;0.60;163.18;3.75;729;5;440.00;28
669;5;22297602;669;186;1399;1425;9.82;0.60;163.55;3.76;730;5;441.00;26
673;5;22297621;673;180;1404;1425;9.91;0.61;164.27;3.79;731;5;442.00;21
675;5;22297636;675;182;1406;1426;9.97;0.61;164.75;3.80;731;5;443.00;20
677;5;22297649;677;177;1409;1426;9.99;0.61;164.77;3.81;732;5;444.00;17
679;5;22297661;679;178;1411;1426;9.98;0.61;164.90;3.82;732;5;445.00;15
680;5;22297673;680;181;1413;1426;9.94;0.61;165.10;3.84;733;5;446.00;13
683;5;22297688;683;177;1415;1430;9.96;0.61;165.48;3.83;732;5;447.00;15
684;5;22297702;684;175;1417;1430;9.95;0.61;165.47;3.85;733;5;448.00;13
689;5;22297714;689;178;1417;1430;9.92;0.61;165.99;3.85;728;5;449.00;13
693;5;22297728;693;175;1422;1436;9.88;0.60;166.57;3.86;729;5;450.00;14
697;5;22297739;697;177;1422;1436;9.93;0.61;167.22;3.86;725;5;451.00;14
699;5;22297750;699;175;1424;1436;9.90;0.60;167.62;3.87;725;5;452.00;12
703;5;22297760;703;177;1428;1440;9.78;0.60;168.29;3.86;725;5;453.00;12
706;5;22297771;706;172;1430;1441;9.75;0.59;168.63;3.86;724;5;454.00;11
711;5;22297782;711;170;1432;1441;9.74;0.59;169.62;3.89;721;5;455.00;9
715;5;22297792;715;169;1435;1445;9.77;0.59;170.03;3.88;720;5;456.00;10
716;5;22297803;716;162;1435;1445;9.81;0.60;170.39;3.88;719;5;457.00;10
719;5;22297813;719;154;1438;1445;9.78;0.60;170.92;3.91;719;5;458.00;7
721;5;22297823;721;151;1440;1446;9.86;0.60;171.41;3.92;719;5;459.00;6
722;5;22297834;722;149;1440;1446;9.81;0.60;171.73;3.92;718;5;460.00;6
726;5;22297844;726;141;1444;1452;9.82;0.60;172.10;3.91;718;5;461.00;8
728;5;22297855;728;141;1444;1452;9.84;0.60;172.08;3.91;716;5;462.00;8
731;5;22297866;731;142;1444;1453;9.82;0.60;172.79;3.91;713;5;463.00;9
734;5;22297877;734;137;1444;1453;9.88;0.60;172.65;3.91;710;5;464.00;9
737;5;22297887;737;136;1444;1453;9.91;0.60;172.64;3.91;707;5;465.00;9
739;5;22297898;739;136;1444;1453;9.89;0.60;172.74;3.91;705;5;466.00;9
742;5;22297907;742;132;1444;1453;9.82;0.60;172.87;3.91;702;5;467.00;9
747;5;22297923;747;136;1453;1465;9.89;0.60;173.07;3.89;706;5;468.00;12
749;5;22297935;749;131;1453;1465;9.93;0.60;173.31;3.89;704;5;469.00;12
753;5;22297946;753;127;1455;1465;10.01;0.61;173.56;3.88;702;5;470.00;10
754;5;22297955;754;128;1455;1465;10.08;0.61;173.83;3.88;701;5;471.00;10
758;5;22297966;758;128;1455;1465;10.14;0.62;173.67;3.88;697;5;472.00;10
761;5;22297976;761;131;1455;1465;10.23;0.62;173.96;3.88;694;5;473.00;10
763;5;22297986;763;130;1458;1469;10.30;0.63;173.90;3.88;695;5;474.00;11
766;5;22297998;766;127;1459;1469;10.37;0.63;174.31;3.90;693;5;475.00;10
768;6;22298007;768;125;1463;1473;10.36;0.63;174.37;3.93;695;6;476.00;10
770;6;22298037;770;130;1464;1474;10.36;0.63;174.85;3.92;694;6;477.00;10
773;6;22298049;773;132;1465;1474;10.33;0.63;174.77;3.95;692;6;478.00;9
776;6;22298058;776;134;1465;1474;10.28;0.63;175.14;3.95;689;6;479.00;9
779;6;22298071;779;139;1491;1500;10.12;0.62;175.33;3.95;712;6;480.00;9
781;6;22298085;781;135;1491;1500;10.16;0.62;175.53;3.95;710;6;481.00;9
784;6;22298096;784;136;1493;1500;10.20;0.62;175.88;3.95;709;6;482.00;7
787;6;22298106;787;138;1496;1501;10.21;0.62;175.83;3.97;709;6;483.00;5
787;6;22298117;787;138;1496;1502;10.30;0.63;175.83;3.97;709;6;484.00;6
787;6;22298127;787;137;1497;1502;10.30;0.63;175.83;3.98;710;6;485.00;5
789;6;22298137;789;143;1500;1505;10.29;0.63;175.78;3.98;711;6;486.00;5
793;6;22298147;793;149;1501;1505;10.29;0.62;175.61;3.99;708;6;487.00;4
795;6;22298157;795;153;1502;1505;10.29;0.62;176.05;3.99;707;6;488.00;3
796;6;22298168;796;159;1502;1505;10.31;0.63;176.12;3.99;706;6;489.00;3
797;6;22298177;797;162;1508;1511;10.34;0.63;176.06;3.98;711;6;490.00;3
800;6;22298187;800;166;1510;1511;10.25;0.62;176.10;3.99;710;6;491.00;1
803;6;22298200;803;172;1511;1511;10.23;0.62;176.26;3.99;708;6;492.00;0
806;6;22298213;806;177;1511;1511;10.24;0.62;176.50;3.99;705;6;493.00;0
806;6;22298223;806;181;1515;1515;10.18;0.62;176.50;3.98;709;6;494.00;0
808;6;22298234;808;189;1517;1517;10.07;0.61;176.53;3.97;709;6;495.00;0
808;6;22298246;808;194;1517;1517;9.92;0.61;176.53;3.97;709;6;496.00;0
809;6;22298255;809;203;1518;1518;9.78;0.60;176.57;3.97;709;6;497.00;0
809;6;22298266;809;206;1518;1518;9.70;0.59;176.57;3.97;709;6;498.00;0
810;6;22298275;810;208;1518;1518;9.58;0.59;176.52;3.97;708;6;499.00;0
811;6;22298287;811;213;1518;1518;9.48;0.58;176.65;3.97;707;6;500.00;0
814;6;22298303;814;214;1518;1518;9.45;0.58;176.54;3.97;704;6;501.00;0
817;6;22298314;817;217;1518;1518;9.32;0.57;176.43;3.97;701;6;502.00;0
819;6;22298324;819;219;1518;1518;9.25;0.57;176.68;3.97;699;6;503.00;0
820;6;22298335;820;224;1557;1588;9.34;0.58;176.57;3.87;737;6;504.00;31
820;6;22298352;820;226;1560;1589;9.26;0.57;176.57;3.87;740;6;505.00;29
821;6;22298362;821;227;1568;1589;9.25;0.57;176.45;3.86;747;6;506.00;21
825;6;22298372;825;228;1571;1589;9.22;0.57;176.06;3.86;746;6;507.00;18
827;6;22298383;827;230;1574;1589;9.18;0.56;176.38;3.86;747;6;508.00;15
832;6;22298392;832;233;1576;1589;9.10;0.56;176.09;3.86;744;6;509.00;13
834;6;22298405;834;237;1578;1589;9.04;0.55;176.20;3.86;744;6;510.00;11
837;6;22298416;837;239;1580;1589;8.97;0.55;175.96;3.87;743;6;511.00;9
839;6;22298426;839;241;1581;1590;8.90;0.55;175.82;3.87;742;6;512.00;9
845;6;22298438;845;249;1584;1591;8.85;0.54;175.88;3.87;739;6;513.00;7
848;6;22298450;848;254;1587;1591;8.87;0.54;175.79;3.88;739;6;514.00;4
852;6;22298461;852;255;1593;1595;8.85;0.54;175.35;3.89;741;6;515.00;2
855;6;22298471;855;259;1595;1595;8.80;0.54;175.56;3.89;740;6;516.00;0
860;6;22298482;860;263;1595;1595;8.70;0.53;175.61;3.89;735;6;517.00;0
864;6;22298493;864;264;1595;1595;8.60;0.53;176.41;3.89;731;6;518.00;0
865;6;22298503;865;264;1601;1601;8.56;0.52;176.71;3.88;736;6;519.00;0
867;6;22298514;867;270;1601;1601;8.44;0.52;177.00;3.88;734;6;520.00;0
871;6;22298524;871;270;1601;1601;8.29;0.51;177.32;3.88;730;6;521.00;0
872;6;22298534;872;274;1604;1604;8.11;0.50;177.59;3.87;732;6;522.00;0
874;6;22298544;874;279;1604;1604;7.89;0.48;177.72;3.87;730;6;523.00;0
878;6;22298552;878;285;1604;1604;7.67;0.47;177.63;3.87;726;6;524.00;0
880;6;22298561;880;275;1605;1605;7.53;0.46;178.14;3.87;725;6;525.00;0
882;6;22298569;882;272;1606;1606;7.39;0.45;178.39;3.87;724;6;526.00;0
885;6;22298579;885;267;1606;1606;7.28;0.45;178.78;3.87;721;6;527.00;0
888;6;22298587;888;271;1618;1619;7.21;0.44;178.96;3.84;730;6;528.00;1
891;6;22298599;891;274;1618;1619;7.12;0.44;179.14;3.84;727;6;529.00;1
896;6;22298607;896;274;1619;1619;7.01;0.43;179.51;3.84;723;6;530.00;0
897;6;22298617;897;277;1620;1620;6.97;0.43;179.88;3.84;723;6;531.00;0
898;6;22298624;898;279;1620;1620;7.00;0.43;180.15;3.84;722;6;532.00;0
902;6;22298634;902;282;1624;1624;6.99;0.43;180.34;3.83;722;6;533.00;0
903;6;22298643;903;284;1624;1624;6.93;0.42;180.57;3.83;721;6;534.00;0
905;6;22298651;905;284;1628;1628;6.91;0.42;180.26;3.82;723;6;535.00;0
907;6;22298660;907;288;1628;1628;6.88;0.42;180.48;3.82;721;6;536.00;0
908;6;22298669;908;285;1628;1628;6.75;0.41;180.40;3.82;720;6;537.00;0
909;6;22298677;909;275;1628;1628;6.70;0.41;180.42;3.82;719;6;538.00;0
912;6;22298685;912;267;1628;1628;6.74;0.41;181.04;3.82;716;6;539.00;0
915;6;22298697;915;264;1658;1662;6.97;0.43;181.23;3.75;743;6;540.00;4
919;6;22298711;919;264;1658;1662;6.97;0.43;181.25;3.75;739;6;541.00;4
923;6;22298721;923;261;1661;1662;7.10;0.44;181.81;3.75;738;6;542.00;1
926;6;22298732;926;254;1661;1662;7.18;0.44;182.25;3.75;735;6;543.00;1
931;6;22298742;931;254;1662;1662;7.27;0.44;182.13;3.75;731;6;544.00;0
933;6;22298761;933;250;1662;1662;7.33;0.45;182.53;3.75;729;6;545.00;0
936;6;22298771;936;251;1663;1663;7.37;0.45;183.00;3.75;727;6;546.00;0
936;6;22298781;936;253;1663;1663;7.46;0.46;183.00;3.75;727;6;547.00;0
938;6;22298791;938;253;1669;1669;7.43;0.45;183.19;3.74;731;6;548.00;0
940;6;22298803;940;259;1670;1670;7.43;0.46;183.36;3.74;730;6;549.00;0
944;6;22298822;944;255;1670;1670;7.38;0.45;183.47;3.74;726;6;550.00;0
946;6;22298833;946;258;1670;1670;7.31;0.45;183.23;3.74;724;6;551.00;0
949;6;22298844;949;259;1674;1674;7.31;0.45;183.53;3.73;725;6;552.00;0
951;6;22298854;951;260;1674;1674;7.31;0.45;183.78;3.73;723;6;553.00;0
954;6;22298865;954;259;1674;1674;7.35;0.45;183.91;3.73;720;6;554.00;0
956;6;22298875;956;257;1675;1675;7.38;0.45;184.15;3.73;719;6;555.00;0
958;6;22298885;958;259;1679;1679;7.43;0.45;184.55;3.72;721;6;556.00;0
959;6;22298897;959;255;1679;1679;7.49;0.46;184.56;3.72;720;6;557.00;0
964;6;22298907;964;257;1681;1682;7.50;0.46;184.97;3.72;717;6;558.00;1
967;6;22298919;967;258;1681;1682;7.50;0.46;184.87;3.72;714;6;559.00;1
969;6;22298930;969;255;1682;1682;7.53;0.46;184.99;3.71;713;6;560.00;0
970;6;22298940;970;257;1682;1682;7.55;0.46;185.21;3.71;712;6;561.00;0
974;6;22298950;974;255;1686;1686;7.53;0.46;185.27;3.71;712;6;562.00;0
976;6;22298961;976;254;1686;1686;7.56;0.46;185.42;3.71;710;6;563.00;0
980;6;22298971;980;253;1686;1686;7.56;0.46;185.41;3.71;706;6;564.00;0
983;6;22298982;983;248;1686;1686;7.56;0.46;185.20;3.71;703;6;565.00;0
984;6;22298991;984;244;1687;1687;7.60;0.46;185.40;3.71;703;6;566.00;0
987;6;22299002;987;239;1688;1688;7.61;0.47;185.52;3.70;701;6;567.00;0
989;6;22299013;989;249;1688;1688;7.54;0.46;185.80;3.70;699;6;568.00;0
990;6;22299030;990;249;1689;1689;7.58;0.46;185.78;3.70;699;6;569.00;0
991;6;22299040;991;249;1689;1689;7.57;0.46;185.92;3.70;698;6;570.00;0
995;6;22299051;995;250;1689;1689;7.50;0.46;186.13;3.70;694;6;571.00;0
995;6;22299061;995;238;1689;1689;7.49;0.46;186.13;3.70;694;6;572.00;0
999;6;22299071;999;234;1689;1689;7.48;0.46;186.22;3.70;690;6;573.00;0
1000;6;22299081;1000;226;1689;1689;7.44;0.45;186.32;3.70;689;6;574.00;0
1003;6;22299090;1003;220;1689;1689;7.54;0.46;186.48;3.70;686;6;575.00;0
1004;6;22299101;1004;244;1767;1816;7.92;0.49;186.51;3.54;763;6;576.00;49
1006;6;22299122;1006;235;1771;1817;8.05;0.50;186.84;3.54;765;6;577.00;46
1010;6;22299133;1010;225;1780;1817;8.29;0.51;186.89;3.53;770;6;578.00;37
1013;6;22299144;1013;225;1781;1817;8.35;0.52;187.17;3.53;768;6;579.00;36
1017;6;22299153;1017;220;1786;1817;8.49;0.52;187.36;3.53;769;6;580.00;31
1019;6;22299171;1019;206;1789;1817;8.55;0.53;187.49;3.53;770;6;581.00;28
1024;6;22299182;1024;199;1791;1817;8.62;0.53;187.97;3.53;767;6;582.00;26
1027;6;22299194;1027;195;1794;1817;8.62;0.53;188.29;3.54;767;6;583.00;23
1029;6;22299205;1029;200;1797;1818;8.60;0.53;188.69;3.55;768;6;584.00;21
1033;6;22299224;1033;201;1800;1820;8.51;0.52;189.13;3.55;767;6;585.00;20
1033;6;22299236;1033;208;1803;1820;8.49;0.52;189.13;3.56;770;6;586.00;17
1040;6;22299248;1040;208;1807;1821;8.37;0.51;189.57;3.57;767;6;587.00;14
1042;6;22299259;1042;215;1809;1821;8.30;0.51;189.80;3.58;767;6;588.00;12
1043;6;22299271;1043;221;1810;1821;8.29;0.51;189.98;3.59;767;6;589.00;11
1045;6;22299283;1045;229;1812;1821;8.24;0.51;190.29;3.59;767;6;590.00;9
1045;6;22299302;1045;235;1816;1825;8.29;0.51;190.29;3.60;771;6;591.00;9
1047;6;22299314;1047;238;1816;1825;8.36;0.51;190.52;3.60;769;6;592.00;9
1047;6;22299325;1047;234;1819;1825;8.45;0.52;190.52;3.61;772;6;593.00;6
1050;6;22299339;1050;231;1820;1828;8.47;0.52;190.89;3.61;770;6;594.00;8
1051;6;22299350;1051;228;1822;1828;8.51;0.52;190.93;3.63;771;6;595.00;6
1054;6;22299363;1054;217;1822;1828;8.55;0.52;191.03;3.63;768;6;596.00;6
1055;6;22299374;1055;213;1828;1832;8.61;0.53;191.20;3.64;773;6;597.00;4
1058;6;22299386;1058;212;1829;1833;8.60;0.52;191.44;3.64;771;6;598.00;4
1060;6;22299399;1060;214;1831;1833;8.65;0.53;191.83;3.65;771;6;599.00;2
1063;6;22299414;1063;220;1842;1859;8.59;0.52;192.13;3.63;779;6;600.00;17
1064;6;22299434;1064;217;1844;1859;8.67;0.53;192.23;3.63;780;6;601.00;15
1069;6;22299446;1069;217;1845;1859;8.71;0.53;192.69;3.63;776;6;602.00;14
1071;6;22299457;1071;217;1847;1860;8.81;0.53;192.90;3.63;776;6;603.00;13
1074;6;22299469;1074;219;1848;1860;8.80;0.53;193.02;3.63;774;6;604.00;12
1076;6;22299480;1076;221;1853;1866;8.85;0.54;193.17;3.63;777;6;605.00;13
1076;6;22299491;1076;222;1855;1866;8.83;0.53;193.17;3.63;779;6;606.00;11
1078;6;22299502;1078;215;1856;1867;8.87;0.54;193.31;3.63;778;6;607.00;11
1079;6;22299514;1079;214;1857;1867;8.92;0.54;193.29;3.63;778;6;608.00;10
1082;6;22299524;1082;212;1857;1867;8.97;0.55;193.53;3.63;775;6;609.00;10
1083;6;22299536;1083;214;1857;1867;8.97;0.55;193.82;3.63;774;6;610.00;10
1086;6;22299547;1086;217;1858;1867;8.99;0.55;194.11;3.63;772;6;611.00;9
1087;6;22299557;1087;221;1868;1879;9.01;0.55;194.33;3.62;781;6;612.00;11
1089;6;22299610;1089;224;1868;1879;8.98;0.54;194.47;3.62;779;6;613.00;11
1090;6;22299632;1090;228;1869;1879;9.01;0.55;194.73;3.62;779;6;614.00;10
1091;6;22299645;1091;223;1869;1879;9.02;0.55;195.06;3.62;778;6;615.00;10
1092;6;22299655;1092;222;1869;1879;9.07;0.55;195.15;3.62;777;6;616.00;10
1093;6;22299667;1093;219;1869;1879;9.06;0.55;195.04;3.62;776;6;617.00;10
1096;6;22299677;1096;218;1873;1883;9.09;0.55;195.55;3.62;777;6;618.00;10
1100;6;22299688;1100;218;1873;1883;9.13;0.55;195.91;3.62;773;6;619.00;10
1102;6;22299701;1102;215;1877;1887;9.21;0.56;196.28;3.62;775;6;620.00;10
1104;6;22299713;1104;212;1878;1888;9.23;0.56;196.53;3.62;774;6;621.00;10
1106;6;22299723;1106;211;1878;1888;9.20;0.56;196.93;3.62;772;6;622.00;10
1108;6;22299734;1108;206;1878;1888;9.26;0.56;197.22;3.62;770;6;623.00;10
1110;6;22299745;1110;209;1889;1901;9.20;0.56;197.44;3.61;779;6;624.00;12
1114;6;22299756;1114;202;1889;1901;9.17;0.56;197.72;3.61;775;6;625.00;12
1116;6;22299768;1116;200;1889;1901;9.15;0.55;197.89;3.61;773;6;626.00;12
1117;6;22299779;1117;192;1890;1902;9.11;0.55;198.13;3.61;773;6;627.00;12
1120;6;22299789;1120;192;1890;1903;9.00;0.55;198.47;3.61;770;6;628.00;13
1121;6;22299801;1121;189;1892;1903;9.00;0.55;198.59;3.63;771;6;629.00;11
1123;6;22299812;1123;185;1899;1909;9.03;0.55;199.01;3.64;776;6;630.00;10
1124;6;22299824;1124;185;1900;1909;9.06;0.55;199.13;3.64;776;6;631.00;9
1128;6;22299835;1128;177;1901;1909;9.10;0.55;199.23;3.64;773;6;632.00;8
1133;6;22299846;1133;176;1901;1909;9.15;0.56;199.99;3.64;768;6;633.00;8
1137;6;22299856;1137;170;1906;1915;9.24;0.56;200.76;3.63;769;6;634.00;9
1141;7;22299868;1141;168;1906;1915;9.26;0.56;201.09;3.63;765;7;635.00;9
1145;7;22299894;1145;163;1906;1915;9.29;0.56;201.34;3.63;761;7;636.00;9
1148;7;22299906;1148;155;1906;1915;9.29;0.56;201.58;3.63;758;7;637.00;9
1150;7;22299917;1150;152;1909;1919;9.25;0.56;201.76;3.63;759;7;638.00;10
1152;7;22299930;1152;151;1910;1920;9.31;0.56;201.83;3.62;758;7;639.00;10
1155;7;22299941;1155;155;1910;1920;9.27;0.56;201.95;3.62;755;7;640.00;10
1157;7;22299952;1157;157;1911;1921;9.28;0.56;202.19;3.62;754;7;641.00;10
1160;7;22299964;1160;156;1911;1921;9.29;0.56;202.48;3.62;751;7;642.00;10
1163;7;22299973;1163;156;1911;1921;9.31;0.56;202.86;3.62;748;7;643.00;10
1164;7;22299985;1164;155;1911;1921;9.28;0.56;203.03;3.62;747;7;644.00;10
1166;7;22299997;1166;156;1911;1921;9.26;0.56;203.26;3.62;745;7;645.00;10
1168;7;22300010;1168;164;1911;1921;9.20;0.56;203.61;3.62;743;7;646.00;10
1169;7;22300020;1169;163;1912;1921;9.20;0.56;203.77;3.65;743;7;647.00;9
1173;7;22300030;1173;175;1948;1991;9.22;0.56;203.85;3.58;775;7;648.00;43
1174;7;22300047;1174;166;1948;1992;9.15;0.56;204.13;3.58;774;7;649.00;44
1176;7;22300056;1176;170;1957;1992;9.13;0.56;204.23;3.57;781;7;650.00;35
1177;7;22300068;1177;174;1959;1992;9.14;0.56;204.15;3.57;782;7;651.00;33
1181;7;22300078;1181;177;1964;1992;9.13;0.56;204.47;3.57;783;7;652.00;28
1183;7;22300088;1183;178;1967;1992;9.03;0.55;204.69;3.60;784;7;653.00;25
1185;7;22300099;1185;188;1970;1992;8.98;0.55;205.00;3.62;785;7;654.00;22
1188;7;22300108;1188;192;1972;1992;8.96;0.55;205.04;3.62;784;7;655.00;20
1191;7;22300120;1191;195;1976;1993;8.92;0.54;205.13;3.64;785;7;656.00;17
1194;7;22300132;1194;191;1979;1994;8.91;0.54;204.88;3.66;785;7;657.00;15
1196;7;22300141;1196;195;1982;1994;8.83;0.54;204.72;3.68;786;7;658.00;12
1198;7;22300152;1198;199;1989;1998;8.78;0.53;204.59;3.71;791;7;659.00;9
1200;7;22300165;1200;204;1990;1998;8.73;0.53;204.62;3.72;790;7;660.00;8
1202;7;22300175;1202;213;1990;1998;8.72;0.53;204.44;3.72;788;7;661.00;8
1204;7;22300186;1204;220;1990;1998;8.72;0.53;204.35;3.72;786;7;662.00;8
1206;7;22300197;1206;228;1996;2004;8.72;0.53;204.32;3.72;790;7;663.00;8
1208;7;22300208;1208;242;2000;2004;8.67;0.53;204.13;3.77;792;7;664.00;4
1211;7;22300220;1211;245;2001;2004;8.62;0.53;204.08;3.78;790;7;665.00;3
1213;7;22300230;1213;254;2005;2007;8.53;0.52;203.96;3.78;792;7;666.00;2
1215;7;22300240;1215;260;2006;2007;8.46;0.52;203.88;3.79;791;7;667.00;1
1216;7;22300250;1216;265;2007;2007;8.44;0.52;203.82;3.79;791;7;668.00;0
1217;7;22300260;1217;270;2008;2008;8.37;0.51;203.73;3.78;791;7;669.00;0
1219;7;22300270;1219;276;2009;2009;8.26;0.51;203.53;3.78;790;7;670.00;0
1220;7;22300281;1220;281;2009;2009;8.19;0.50;203.45;3.78;789;7;671.00;0
1222;7;22300290;1222;280;2021;2022;8.03;0.49;203.38;3.76;799;7;672.00;1
1223;7;22300302;1223;284;2022;2022;7.85;0.48;203.24;3.76;799;7;673.00;0
1224;7;22300312;1224;287;2022;2022;7.73;0.47;203.22;3.76;798;7;674.00;0
1228;7;22300322;1228;284;2024;2024;7.65;0.47;203.21;3.75;796;7;675.00;0
1230;7;22300332;1230;287;2024;2024;7.50;0.46;203.11;3.75;794;7;676.00;0
1231;7;22300341;1231;283;2028;2028;7.48;0.46;203.13;3.75;797;7;677.00;0
1232;7;22300352;1232;285;2028;2028;7.38;0.45;203.05;3.75;796;7;678.00;0
1235;7;22300362;1235;287;2032;2032;7.24;0.44;202.96;3.74;797;7;679.00;0
1237;7;22300371;1237;290;2032;2032;7.20;0.44;202.81;3.74;795;7;680.00;0
1238;7;22300381;1238;288;2032;2032;7.20;0.44;202.73;3.74;794;7;681.00;0
1240;7;22300390;1240;290;2032;2032;7.23;0.44;202.77;3.74;792;7;682.00;0
1244;7;22300400;1244;288;2032;2032;7.22;0.44;202.73;3.74;788;7;683.00;0
1245;7;22300410;1245;294;2042;2044;7.34;0.45;202.68;3.73;797;7;684.00;2
1247;7;22300421;1247;297;2043;2044;7.38;0.45;202.80;3.72;796;7;685.00;1
1249;7;22300432;1249;299;2044;2044;7.39;0.45;202.81;3.72;795;7;686.00;0
1251;7;22300441;1251;301;2044;2044;7.34;0.45;202.86;3.72;793;7;687.00;0
1254;7;22300451;1254;310;2044;2044;7.30;0.45;202.91;3.72;790;7;688.00;0
1259;7;22300460;1259;313;2044;2044;7.15;0.44;202.96;3.72;785;7;689.00;0
1261;7;22300471;1261;322;2045;2045;7.02;0.43;202.96;3.72;784;7;690.00;0
1265;7;22300480;1265;323;2045;2045;6.81;0.42;203.19;3.72;780;7;691.00;0
1268;7;22300488;1268;325;2051;2051;6.67;0.41;203.55;3.71;783;7;692.00;0
1269;7;22300499;1269;333;2052;2052;6.57;0.40;203.59;3.71;783;7;693.00;0
1273;7;22300507;1273;337;2052;2052;6.40;0.39;203.82;3.71;779;7;694.00;0
1275;7;22300517;1275;329;2052;2052;6.26;0.38;203.76;3.71;777;7;695.00;0
1281;7;22300528;1281;317;2056;2056;6.23;0.38;203.69;3.71;775;7;696.00;0
1285;7;22300538;1285;310;2056;2056;6.22;0.38;204.01;3.71;771;7;697.00;0
1290;7;22300548;1290;310;2056;2056;6.19;0.38;204.00;3.71;766;7;698.00;0
1292;7;22300557;1292;306;2057;2057;6.17;0.38;204.09;3.70;765;7;699.00;0
1293;7;22300568;1293;286;2061;2061;6.26;0.38;204.08;3.70;768;7;700.00;0
1296;7;22300583;1296;280;2061;2061;6.31;0.39;204.43;3.70;765;7;701.00;0
1298;7;22300601;1298;275;2063;2064;6.49;0.40;204.54;3.70;765;7;702.00;1
1301;7;22300610;1301;269;2064;2064;6.54;0.40;204.92;3.69;763;7;703.00;0
1303;7;22300620;1303;268;2064;2064;6.69;0.41;205.17;3.69;761;7;704.00;0
1305;7;22300632;1305;260;2064;2064;6.82;0.42;205.26;3.69;759;7;705.00;0
1306;7;22300642;1306;259;2068;2068;7.01;0.43;205.46;3.69;762;7;706.00;0
1309;7;22300656;1309;255;2068;2068;7.11;0.43;205.85;3.69;759;7;707.00;0
1309;7;22300668;1309;246;2068;2068;7.36;0.45;205.85;3.69;759;7;708.00;0
1312;7;22300680;1312;235;2068;2068;7.44;0.46;205.91;3.69;756;7;709.00;0
1314;7;22300701;1314;232;2069;2069;7.52;0.46;205.91;3.69;755;7;710.00;0
1316;7;22300713;1316;236;2070;2070;7.57;0.46;205.94;3.69;754;7;711.00;0
1319;7;22300724;1319;231;2070;2070;7.59;0.47;206.11;3.69;751;7;712.00;0
1321;7;22300748;1321;230;2071;2071;7.61;0.47;206.24;3.68;750;7;713.00;0
1326;7;22300763;1326;231;2071;2071;7.64;0.47;206.54;3.68;745;7;714.00;0
1329;7;22300774;1329;229;2071;2071;7.66;0.47;206.74;3.68;742;7;715.00;0
1333;7;22300788;1333;231;2071;2071;7.70;0.47;207.20;3.68;738;7;716.00;0
1334;7;22300802;1334;232;2071;2071;7.78;0.48;207.36;3.68;737;7;717.00;0
1340;7;22300814;1340;223;2071;2071;7.76;0.47;207.67;3.68;731;7;718.00;0
1344;7;22300825;1344;229;2071;2071;7.71;0.47;207.81;3.68;727;7;719.00;0
1347;7;22300840;1347;238;2172;2301;8.14;0.51;208.18;3.51;825;7;720.00;129
1351;7;22300875;1351;236;2182;2302;8.05;0.51;208.59;3.50;831;7;721.00;120
1355;7;22300890;1355;228;2199;2302;8.09;0.51;208.43;3.49;844;7;722.00;103
1358;7;22300904;1358;225;2207;2302;8.11;0.51;208.68;3.49;849;7;723.00;95
1363;7;22300918;1363;227;2218;2302;8.11;0.51;209.01;3.49;855;7;724.00;84
1369;7;22300936;1369;222;2229;2302;7.99;0.50;209.21;3.50;860;7;725.00;73
1372;7;22300951;1372;216;2236;2302;7.92;0.50;208.99;3.51;864;7;726.00;66
1375;7;22300972;1375;219;2245;2302;7.83;0.49;209.35;3.52;870;7;727.00;57
1380;7;22300986;1380;224;2253;2303;7.69;0.48;210.02;3.54;873;7;728.00;50
1385;7;22301001;1385;236;2257;2304;7.53;0.47;210.20;3.55;872;7;729.00;47
1390;7;22301014;1390;234;2265;2304;7.37;0.46;210.63;3.57;875;7;730.00;39
1393;7;22301025;1393;244;2268;2305;7.29;0.46;210.93;3.57;875;7;731.00;37
1396;7;22301038;1396;244;2271;2305;7.16;0.45;210.99;3.59;875;7;732.00;34
1399;7;22301050;1399;251;2274;2305;7.06;0.44;211.21;3.60;875;7;733.00;31
1403;7;22301061;1403;258;2277;2305;6.97;0.43;211.25;3.61;874;7;734.00;28
1404;7;22301073;1404;267;2281;2309;6.93;0.43;211.37;3.62;877;7;735.00;28
1407;7;22301086;1407;269;2284;2309;6.91;0.43;211.48;3.63;877;7;736.00;25
1409;7;22301099;1409;279;2287;2309;6.91;0.43;211.58;3.64;878;7;737.00;22
1412;7;22301111;1412;278;2288;2312;6.92;0.43;211.67;3.65;876;7;738.00;24
1418;7;22301124;1418;283;2290;2312;6.93;0.43;211.67;3.66;872;7;739.00;22
1421;7;22301137;1421;291;2292;2312;6.94;0.43;211.58;3.67;871;7;740.00;20
1423;7;22301150;1423;298;2296;2316;6.92;0.43;211.54;3.67;873;7;741.00;20
1424;7;22301163;1424;298;2298;2317;6.91;0.43;211.79;3.67;874;7;742.00;19
1427;7;22301174;1427;305;2300;2317;6.90;0.42;211.82;3.69;873;7;743.00;17
1429;7;22301186;1429;307;2305;2321;6.83;0.42;211.98;3.70;876;7;744.00;16
1434;7;22301199;1434;306;2305;2321;6.83;0.42;212.07;3.70;871;7;745.00;16
1437;7;22301211;1437;310;2307;2321;6.80;0.42;212.51;3.71;870;7;746.00;14
1440;7;22301223;1440;298;2308;2322;6.83;0.42;212.56;3.72;868;7;747.00;14
1442;7;22301236;1442;293;2308;2322;6.90;0.42;212.50;3.72;866;7;748.00;14
1443;7;22301248;1443;290;2314;2328;6.96;0.42;212.47;3.71;871;7;749.00;14
1445;7;22301262;1445;287;2315;2328;7.10;0.43;212.72;3.72;870;7;750.00;13
1447;7;22301275;1447;285;2316;2329;7.20;0.44;212.78;3.72;869;7;751.00;13
1447;7;22301287;1447;277;2318;2329;7.28;0.44;212.78;3.75;871;7;752.00;11
1451;7;22301299;1451;277;2318;2329;7.30;0.44;212.76;3.75;867;7;753.00;11
1454;7;22301311;1454;277;2318;2329;7.34;0.45;212.90;3.75;864;7;754.00;11
1456;7;22301324;1456;274;2320;2329;7.35;0.45;212.86;3.76;864;7;755.00;9
1459;7;22301346;1459;265;2331;2341;7.38;0.45;213.16;3.77;872;7;756.00;10
1463;7;22301358;1463;257;2332;2341;7.43;0.45;213.51;3.77;869;7;757.00;9
1464;7;22301371;1464;255;2334;2341;7.48;0.46;213.53;3.78;870;7;758.00;7
1468;7;22301386;1468;255;2336;2341;7.53;0.46;213.85;3.78;868;7;759.00;5
1469;7;22301402;1469;249;2336;2341;7.61;0.46;213.99;3.78;867;7;760.00;5
1471;7;22301417;1471;247;2336;2341;7.69;0.47;214.11;3.78;865;7;761.00;5
1474;7;22301436;1474;251;2340;2345;7.71;0.47;214.40;3.77;866;7;762.00;5
1478;7;22301452;1478;252;2340;2345;7.79;0.48;214.68;3.77;862;7;763.00;5
1482;7;22301468;1482;255;2344;2349;7.86;0.48;214.92;3.77;862;7;764.00;5
1484;7;22301484;1484;258;2346;2351;7.94;0.48;215.03;3.77;862;7;765.00;5
1486;7;22301502;1486;265;2346;2351;8.03;0.49;215.27;3.77;860;7;766.00;5
1488;7;22301518;1488;262;2346;2351;8.03;0.49;215.19;3.77;858;7;767.00;5
1490;7;22301534;1490;257;2357;2364;8.12;0.49;215.30;3.75;867;7;768.00;7
1491;7;22301551;1491;249;2357;2364;8.15;0.50;215.40;3.75;866;7;769.00;7
1493;7;22301566;1493;248;2357;2364;8.20;0.50;215.42;3.75;864;7;770.00;7
1493;7;22301583;1493;246;2358;2365;8.31;0.51;215.42;3.75;865;7;771.00;7
1495;7;22301599;1495;238;2359;2366;8.32;0.51;215.60;3.75;864;7;772.00;7
1498;7;22301614;1498;237;2359;2366;8.35;0.51;215.70;3.75;861;7;773.00;7
1500;7;22301630;1500;232;2361;2369;8.42;0.51;215.81;3.74;861;7;774.00;8
1503;7;22301645;1503;226;2361;2369;8.37;0.51;215.90;3.74;858;7;775.00;8
1506;7;22301659;1506;224;2362;2369;8.35;0.51;216.16;3.74;856;7;776.00;7
1508;7;22301682;1508;230;2362;2369;8.28;0.51;216.12;3.74;854;7;777.00;7
1509;7;22301694;1509;229;2367;2375;8.31;0.51;216.30;3.74;858;7;778.00;8
1510;7;22301706;1510;229;2367;2375;8.32;0.51;216.32;3.74;857;7;779.00;8
1510;7;22301721;1510;234;2367;2375;8.36;0.51;216.32;3.74;857;7;780.00;8
1513;7;22301733;1513;235;2367;2375;8.28;0.51;216.43;3.74;854;7;781.00;8
1514;7;22301751;1514;240;2370;2379;8.26;0.50;216.33;3.73;856;7;782.00;9
1516;7;22301764;1516;244;2371;2380;8.33;0.51;216.22;3.73;855;7;783.00;9
1518;8;22301777;1518;252;2371;2380;8.35;0.51;216.28;3.73;853;8;784.00;9
1518;8;22301809;1518;249;2372;2381;8.42;0.51;216.28;3.73;854;8;785.00;9
1521;8;22301822;1521;252;2372;2381;8.42;0.51;216.40;3.73;851;8;786.00;9
1522;8;22301835;1522;249;2372;2381;8.40;0.51;216.53;3.73;850;8;787.00;9
1526;8;22301846;1526;258;2372;2381;8.41;0.51;216.96;3.73;846;8;788.00;9
1531;8;22301857;1531;261;2372;2381;8.36;0.51;217.19;3.73;841;8;789.00;9
1534;8;22301869;1534;256;2372;2381;8.33;0.51;217.42;3.73;838;8;790.00;9
1535;8;22301881;1535;253;2372;2381;8.27;0.50;217.41;3.73;837;8;791.00;9
1538;8;22301891;1538;255;2401;2451;8.09;0.49;217.52;3.69;863;8;792.00;50
1540;8;22301908;1540;251;2401;2452;8.03;0.49;217.53;3.69;861;8;793.00;51
1544;8;22301920;1544;248;2406;2452;8.01;0.49;217.77;3.68;862;8;794.00;46
1546;8;22301932;1546;244;2408;2452;8.00;0.49;217.98;3.68;862;8;795.00;44
1550;8;22301944;1550;249;2410;2452;8.03;0.49;218.16;3.68;860;8;796.00;42
1551;8;22301954;1551;246;2412;2452;8.07;0.49;218.18;3.68;861;8;797.00;40
1554;8;22301973;1554;250;2415;2452;8.15;0.49;218.35;3.69;861;8;798.00;37
1555;8;22301985;1555;247;2418;2452;8.19;0.50;218.26;3.69;863;8;799.00;34
1559;8;22301998;1559;238;2420;2453;8.19;0.50;218.42;3.69;861;8;800.00;33
1563;8;22302013;1563;238;2423;2454;8.09;0.49;218.94;3.70;860;8;801.00;31
1568;8;22302024;1568;243;2426;2454;8.00;0.49;219.18;3.71;858;8;802.00;28
1568;8;22302036;1568;246;2429;2458;7.92;0.48;219.18;3.71;861;8;803.00;29
1571;9;22302048;1571;242;2431;2458;7.84;0.48;219.48;3.71;860;9;804.00;27
1575;9;22302067;1575;244;2433;2458;7.75;0.47;219.85;3.72;858;9;805.00;25
1577;9;22302079;1577;244;2433;2458;7.74;0.47;220.05;3.72;856;9;806.00;25
1582;9;22302095;1582;245;2437;2464;7.71;0.47;220.45;3.72;855;9;807.00;27
1586;9;22302107;1586;243;2438;2464;7.67;0.47;220.62;3.72;852;9;808.00;26
1586;9;22302119;1586;245;2439;2464;7.67;0.47;220.62;3.73;853;9;809.00;25
1589;9;22302132;1589;243;2446;2470;7.65;0.47;220.83;3.73;857;9;810.00;24
1592;9;22302145;1592;240;2447;2470;7.67;0.47;220.97;3.73;855;9;811.00;23
1593;9;22302156;1593;244;2448;2470;7.66;0.47;221.03;3.73;855;9;812.00;22
1593;9;22302169;1593;242;2448;2471;7.67;0.47;221.03;3.73;855;9;813.00;23
1594;9;22302179;1594;244;2449;2472;7.64;0.47;220.99;3.73;855;9;814.00;23
1598;9;22302190;1598;237;2449;2472;7.52;0.46;221.02;3.73;851;9;815.00;23
1601;9;22302202;1601;241;2457;2485;7.51;0.46;220.99;3.72;856;9;816.00;28
1602;9;22302215;1602;236;2458;2485;7.48;0.45;220.95;3.72;856;9;817.00;27
1604;9;22302226;1604;241;2458;2485;7.48;0.46;220.98;3.72;854;9;818.00;27
1604;9;22302238;1604;239;2459;2486;7.53;0.46;220.98;3.72;855;9;819.00;27
1605;9;22302249;1605;240;2459;2486;7.57;0.46;220.96;3.72;854;9;820.00;27
1606;9;22302261;1606;245;2462;2490;7.59;0.46;220.89;3.71;856;9;821.00;28
1609;9;22302272;1609;248;2463;2490;7.54;0.46;221.02;3.75;854;9;822.00;27
1610;9;22302283;1610;249;2466;2494;7.57;0.46;220.97;3.75;856;9;823.00;28
1611;9;22302295;1611;254;2467;2494;7.50;0.46;220.90;3.79;856;9;824.00;27
1614;9;22302306;1614;264;2468;2494;7.44;0.45;220.88;3.80;854;9;825.00;26
1617;9;22302319;1617;263;2469;2494;7.37;0.45;220.72;3.81;852;9;826.00;25
1619;9;22302332;1619;270;2470;2494;7.33;0.45;220.65;3.86;851;9;827.00;24
1619;9;22302342;1619;276;2481;2506;7.37;0.45;220.65;3.85;862;9;828.00;25
1620;9;22302354;1620;284;2482;2506;7.40;0.45;220.66;3.85;862;9;829.00;24
1622;9;22302366;1622;287;2485;2506;7.34;0.45;220.64;3.92;863;9;830.00;21
1622;9;22302377;1622;301;2487;2506;7.34;0.45;220.64;3.96;865;9;831.00;19
1626;9;22302387;1626;304;2489;2506;7.29;0.45;220.45;4.02;863;9;832.00;17
1631;9;22302399;1631;313;2491;2506;7.24;0.44;220.09;4.04;860;9;833.00;15
1634;9;22302410;1634;320;2494;2507;7.20;0.44;220.18;4.09;860;9;834.00;13
1635;9;22302422;1635;325;2495;2507;7.17;0.44;220.07;4.09;860;9;835.00;12
1635;9;22302433;1635;329;2502;2513;7.20;0.44;220.07;4.11;867;9;836.00;11
1637;9;22302444;1637;328;2503;2514;7.16;0.44;219.94;4.11;866;9;837.00;11
1641;9;22302455;1641;336;2507;2514;7.13;0.44;219.88;4.16;866;9;838.00;7
1644;9;22302467;1644;341;2507;2514;7.11;0.43;219.60;4.16;863;9;839.00;7
1645;9;22302479;1645;343;2512;2519;7.15;0.44;219.62;4.18;867;9;840.00;7
1649;9;22302490;1649;349;2513;2519;7.14;0.44;219.34;4.18;864;9;841.00;6
1652;9;22302502;1652;349;2515;2519;7.11;0.43;219.25;4.19;863;9;842.00;4
1653;9;22302513;1653;356;2517;2520;7.08;0.43;219.14;4.20;864;9;843.00;3
1655;9;22302524;1655;357;2522;2524;7.02;0.43;219.13;4.20;867;9;844.00;2
1656;9;22302535;1656;361;2523;2524;6.92;0.42;219.12;4.20;867;9;845.00;1
1656;9;22302546;1656;361;2526;2527;6.88;0.42;219.12;4.20;870;9;846.00;1
1658;9;22302556;1658;362;2526;2527;6.80;0.42;219.03;4.20;868;9;847.00;1
1660;9;22302568;1660;365;2527;2527;6.80;0.42;219.00;4.20;867;9;848.00;0
1661;9;22302580;1661;360;2527;2527;6.74;0.41;218.94;4.20;866;9;849.00;0
1663;9;22302590;1663;358;2531;2531;6.77;0.42;218.89;4.19;868;9;850.00;0
1664;9;22302602;1664;354;2531;2531;6.79;0.42;218.84;4.19;867;9;851.00;0
1667;9;22302613;1667;339;2531;2531;6.80;0.42;218.77;4.19;864;9;852.00;0
1669;9;22302624;1669;328;2531;2531;6.80;0.42;218.66;4.19;862;9;853.00;0
1671;9;22302635;1671;313;2532;2532;6.79;0.42;218.58;4.19;861;9;854.00;0
1672;9;22302646;1672;306;2534;2534;6.83;0.42;218.53;4.19;862;9;855.00;0
1673;9;22302657;1673;295;2534;2534;6.89;0.42;218.58;4.19;861;9;856.00;0
1676;9;22302669;1676;294;2535;2535;6.91;0.42;218.64;4.19;859;9;857.00;0
1677;9;22302682;1677;290;2535;2535;7.01;0.43;218.64;4.19;858;9;858.00;0
1678;9;22302703;1678;288;2535;2535;7.06;0.43;218.75;4.19;857;9;859.00;0
1679;9;22302716;1679;284;2535;2535;7.07;0.43;218.73;4.19;856;9;860.00;0
1679;9;22302730;1679;285;2535;2535;7.14;0.44;218.73;4.19;856;9;861.00;0
1684;9;22302742;1684;282;2535;2535;7.18;0.44;219.03;4.19;851;9;862.00;0
1686;9;22302756;1686;280;2535;2535;7.24;0.44;218.98;4.19;849;9;863.00;0
1690;9;22302769;1690;296;2608;2662;7.46;0.46;219.10;4.07;918;9;864.00;54
1694;9;22302797;1694;291;2613;2663;7.41;0.46;219.15;4.06;919;9;865.00;50
1696;9;22302821;1696;284;2624;2663;7.46;0.46;219.15;4.05;928;9;866.00;39
1697;9;22302835;1697;289;2629;2663;7.45;0.46;219.16;4.05;932;9;867.00;34
1701;9;22302849;1701;294;2634;2663;7.33;0.45;218.95;4.05;933;9;868.00;29
1701;9;22302862;1701;288;2636;2663;7.24;0.45;218.95;4.05;935;9;869.00;27
1704;9;22302876;1704;290;2638;2663;7.14;0.44;218.96;4.05;934;9;870.00;25
1708;9;22302898;1708;292;2640;2663;7.03;0.43;218.83;4.06;932;9;871.00;23
1712;9;22302915;1712;289;2642;2664;6.92;0.43;218.86;4.06;930;9;872.00;22
1714;9;22302933;1714;294;2645;2665;6.83;0.42;219.19;4.07;931;9;873.00;20
1719;9;22302949;1719;295;2647;2665;6.73;0.41;219.46;4.07;928;9;874.00;18
1724;9;22302963;1724;290;2649;2666;6.66;0.41;219.83;4.07;925;9;875.00;17
1730;9;22302978;1730;291;2654;2666;6.54;0.40;220.21;4.09;924;9;876.00;12
1730;9;22302991;1730;281;2655;2666;6.55;0.40;220.21;4.09;925;9;877.00;11
1735;9;22303006;1735;284;2657;2666;6.47;0.40;220.32;4.10;922;9;878.00;9
1739;9;22303020;1739;286;2661;2670;6.55;0.40;220.54;4.10;922;9;879.00;9
1741;9;22303033;1741;292;2662;2670;6.61;0.41;220.74;4.10;921;9;880.00;8
1746;9;22303045;1746;292;2664;2670;6.67;0.41;221.15;4.11;918;9;881.00;6
1748;9;22303056;1748;287;2665;2673;6.79;0.42;221.31;4.11;917;9;882.00;8
1752;9;22303069;1752;286;2667;2673;6.86;0.42;221.45;4.11;915;9;883.00;6
1755;9;22303081;1755;281;2668;2673;6.91;0.42;221.90;4.11;913;9;884.00;5
1757;9;22303092;1757;278;2674;2677;7.00;0.43;222.05;4.12;917;9;885.00;3
1761;9;22303105;1761;276;2675;2678;7.00;0.43;222.51;4.12;914;9;886.00;3
1764;9;22303118;1764;274;2677;2678;7.07;0.43;222.70;4.13;913;9;887.00;1
1768;9;22303130;1768;271;2681;2682;7.12;0.44;223.28;4.12;913;9;888.00;1
1771;9;22303149;1771;265;2682;2682;7.19;0.44;223.55;4.13;911;9;889.00;0
1774;9;22303161;1774;264;2682;2682;7.28;0.45;223.56;4.13;908;9;890.00;0
1782;9;22303172;1782;267;2683;2683;7.30;0.44;223.87;4.12;901;9;891.00;0
1786;9;22303190;1786;262;2683;2683;7.37;0.45;224.17;4.12;897;9;892.00;0
1790;9;22303203;1790;267;2689;2689;7.35;0.45;224.47;4.12;899;9;893.00;0
1794;9;22303217;1794;273;2689;2689;7.32;0.45;224.59;4.12;895;9;894.00;0
1797;9;22303229;1797;268;2690;2690;7.29;0.44;224.65;4.12;893;9;895.00;0
1800;9;22303241;1800;272;2690;2690;7.27;0.44;224.91;4.12;890;9;896.00;0
1805;9;22303253;1805;275;2690;2690;7.24;0.44;225.56;4.12;885;9;897.00;0
1808;9;22303266;1808;276;2690;2690;7.26;0.44;225.77;4.12;882;9;898.00;0
1811;9;22303278;1811;278;2690;2690;7.28;0.44;225.96;4.12;879;9;899.00;0
1815;9;22303291;1815;277;2719;2736;7.35;0.45;226.08;4.07;904;9;900.00;17
1820;9;22303315;1820;277;2721;2736;7.29;0.45;226.46;4.07;901;9;901.00;15
1823;9;22303330;1823;271;2725;2736;7.26;0.44;226.67;4.07;902;9;902.00;11
1824;9;22303342;1824;269;2725;2736;7.27;0.45;226.81;4.07;901;9;903.00;11
1829;9;22303355;1829;272;2727;2736;7.26;0.45;227.19;4.07;898;9;904.00;9
1834;9;22303368;1834;272;2727;2736;7.21;0.44;227.28;4.07;893;9;905.00;9
1839;9;22303381;1839;268;2732;2740;7.27;0.44;227.22;4.06;893;9;906.00;8
1841;9;22303394;1841;261;2733;2740;7.23;0.44;227.49;4.06;892;9;907.00;7
1844;9;22303406;1844;263;2735;2744;7.16;0.44;227.79;4.06;891;9;908.00;9
1845;9;22303425;1845;270;2736;2745;7.17;0.44;227.79;4.06;891;9;909.00;9
1851;9;22303438;1851;284;2736;2745;7.06;0.43;228.04;4.06;885;9;910.00;9
1853;9;22303451;1853;285;2736;2745;7.10;0.44;228.22;4.06;883;9;911.00;9
1854;9;22303464;1854;296;2747;2758;7.19;0.44;228.30;4.05;893;9;912.00;11
1857;9;22303477;1857;292;2749;2758;7.21;0.44;228.48;4.05;892;9;913.00;9
1858;9;22303489;1858;291;2749;2758;7.25;0.45;228.65;4.05;891;9;914.00;9
1862;9;22303502;1862;292;2750;2759;7.19;0.44;228.61;4.06;888;9;915.00;9
1864;9;22303515;1864;290;2751;2760;7.10;0.44;228.91;4.06;887;9;916.00;9
1866;9;22303528;1866;286;2751;2760;7.07;0.43;229.11;4.06;885;9;917.00;9
1872;9;22303539;1872;283;2754;2763;7.00;0.43;228.98;4.06;882;9;918.00;9
1876;9;22303552;1876;292;2756;2763;6.91;0.42;229.25;4.07;880;9;919.00;7
1879;9;22303565;1879;295;2757;2763;6.86;0.42;229.53;4.07;878;9;920.00;6
1882;9;22303577;1882;299;2757;2763;6.82;0.42;229.66;4.07;875;9;921.00;6
1886;9;22303588;1886;293;2762;2769;6.77;0.41;229.61;4.06;876;9;922.00;7
1888;9;22303602;1888;287;2765;2769;6.76;0.41;229.63;4.07;877;9;923.00;4
1890;9;22303615;1890;285;2767;2769;6.73;0.41;229.77;4.08;877;9;924.00;2
1892;9;22303628;1892;289;2767;2769;6.73;0.41;229.96;4.08;875;9;925.00;2
1893;9;22303640;1893;284;2773;2773;6.71;0.41;230.00;4.08;880;9;926.00;0
1893;9;22303654;1893;286;2774;2774;6.75;0.41;230.00;4.08;881;9;927.00;0
1895;9;22303667;1895;287;2774;2774;6.75;0.41;230.17;4.08;879;9;928.00;0
1897;9;22303680;1897;295;2775;2775;6.73;0.41;230.09;4.08;878;9;929.00;0
1900;9;22303694;1900;301;2775;2775;6.73;0.41;230.31;4.08;875;9;930.00;0
1904;9;22303707;1904;284;2775;2775;6.75;0.41;230.17;4.08;871;9;931.00;0
1905;9;22303720;1905;273;2775;2775;6.80;0.42;230.27;4.08;870;9;932.00;0
1909;9;22303733;1909;262;2775;2775;6.82;0.42;230.39;4.08;866;9;933.00;0
1913;9;22303746;1913;259;2775;2775;6.89;0.42;230.65;4.08;862;9;934.00;0
1915;9;22303758;1915;257;2775;2775;7.00;0.43;230.84;4.08;860;9;935.00;0
1919;9;22303771;1919;269;2821;2845;7.07;0.43;231.05;4.01;902;9;936.00;24
1922;9;22303790;1922;260;2822;2846;7.20;0.44;231.21;4.01;900;9;937.00;24
1923;9;22303805;1923;264;2828;2846;7.40;0.45;231.24;4.01;905;9;938.00;18
1924;9;22303819;1924;267;2830;2846;7.50;0.46;231.40;4.00;906;9;939.00;16
1924;9;22303835;1924;262;2834;2846;7.62;0.46;231.40;4.00;910;9;940.00;12
1926;9;22303848;1926;267;2836;2846;7.65;0.46;231.38;4.01;910;9;941.00;10
1927;9;22303861;1927;267;2838;2846;7.73;0.47;231.42;4.01;911;9;942.00;8
1927;9;22303874;1927;270;2840;2846;7.79;0.47;231.42;4.01;913;9;943.00;6
1930;9;22303887;1930;268;2842;2847;7.77;0.47;231.46;4.01;912;9;944.00;5
1934;9;22303901;1934;269;2845;2849;7.79;0.47;231.73;4.01;911;9;945.00;4
1936;9;22303917;1936;268;2847;2849;7.88;0.48;231.68;4.02;911;9;946.00;2
1938;9;22303931;1938;269;2850;2853;7.93;0.48;232.10;4.01;912;9;947.00;3
1941;9;22303946;1941;271;2850;2853;7.94;0.48;232.15;4.01;909;9;948.00;3
1942;9;22303958;1942;265;2850;2853;7.99;0.48;232.20;4.01;908;9;949.00;3
1945;9;22303973;1945;265;2850;2853;8.01;0.49;232.23;4.01;905;9;950.00;3
1948;9;22303989;1948;262;2855;2859;8.10;0.49;232.35;4.01;907;9;951.00;4
1949;9;22304004;1949;260;2855;2859;8.14;0.49;232.41;4.01;906;9;952.00;4
1950;9;22304018;1950;264;2855;2859;8.18;0.50;232.45;4.01;905;9;953.00;4
1953;9;22304032;1953;267;2857;2862;8.23;0.50;232.58;4.00;904;9;954.00;5
1954;9;22304046;1954;265;2859;2862;8.22;0.50;232.58;4.01;905;9;955.00;3
1957;9;22304061;1957;268;2859;2862;8.22;0.50;232.84;4.01;902;9;956.00;3
1958;9;22304073;1958;268;2860;2863;8.23;0.50;232.85;4.01;902;9;957.00;3
1962;10;22304087;1962;268;2861;2864;8.18;0.50;233.11;4.01;899;10;958.00;3
1964;10;22304127;1964;268;2861;2864;8.19;0.50;233.52;4.01;897;10;959.00;3
1967;10;22304141;1967;275;2882;2890;8.19;0.50;233.55;3.98;915;10;960.00;8
1969;10;22304155;1969;274;2883;2890;8.12;0.49;233.74;3.98;914;10;961.00;7
1970;10;22304168;1970;276;2884;2890;8.12;0.50;233.90;3.98;914;10;962.00;6
1972;10;22304181;1972;283;2885;2891;8.13;0.50;233.99;3.98;913;10;963.00;6
1974;10;22304193;1974;284;2885;2891;8.16;0.50;234.27;3.98;911;10;964.00;6
1980;10;22304205;1980;280;2889;2895;8.15;0.50;234.33;3.97;909;10;965.00;6
1983;10;22304220;1983;277;2889;2895;8.16;0.50;234.38;3.97;906;10;966.00;6
1984;10;22304239;1984;275;2892;2899;8.13;0.50;234.42;3.97;908;10;967.00;7
1986;10;22304252;1986;268;2892;2899;8.15;0.50;234.65;3.97;906;10;968.00;7
1988;10;22304265;1988;265;2892;2899;8.18;0.50;234.62;3.97;904;10;969.00;7
1991;10;22304278;1991;266;2892;2899;8.14;0.50;234.75;3.97;901;10;970.00;7
1993;10;22304289;1993;268;2892;2899;8.12;0.49;234.75;3.97;899;10;971.00;7
1995;10;22304302;1995;271;2902;2911;8.16;0.50;234.68;3.96;907;10;972.00;9
2000;10;22304315;2000;270;2902;2911;8.17;0.50;234.95;3.96;902;10;973.00;9
2007;10;22304328;2007;270;2903;2911;8.09;0.49;235.03;3.96;896;10;974.00;8
2014;10;22304340;2014;273;2903;2911;8.04;0.49;235.38;3.96;889;10;975.00;8
2016;10;22304352;2016;274;2903;2911;8.03;0.49;235.54;3.96;887;10;976.00;8
2018;10;22304364;2018;275;2903;2911;7.97;0.48;235.50;3.96;885;10;977.00;8
2021;10;22304374;2021;278;2903;2912;7.87;0.48;235.75;3.96;882;10;978.00;9
2024;10;22304386;2024;281;2903;2912;7.76;0.47;235.60;3.96;879;10;979.00;9
2027;10;22304398;2027;276;2910;2918;7.67;0.47;235.71;3.97;883;10;980.00;8
2029;10;22304410;2029;283;2911;2919;7.52;0.46;235.62;3.97;882;10;981.00;8
2031;10;22304421;2031;279;2911;2919;7.38;0.45;235.59;3.97;880;10;982.00;8
2035;10;22304433;2035;283;2911;2919;7.23;0.44;235.58;3.97;876;10;983.00;8
2035;10;22304444;2035;283;2913;2923;7.21;0.44;235.58;3.96;878;10;984.00;10
2037;10;22304455;2037;279;2913;2923;7.19;0.44;235.52;3.96;876;10;985.00;10
2038;10;22304467;2038;276;2913;2923;7.10;0.43;235.54;3.96;875;10;986.00;10
2040;10;22304478;2040;276;2914;2924;7.11;0.43;235.45;3.96;874;10;987.00;10
2041;10;22304488;2041;274;2917;2928;7.11;0.43;235.38;3.96;876;10;988.00;11
2044;10;22304502;2044;277;2917;2928;7.06;0.43;235.19;3.96;873;10;989.00;11
2045;10;22304515;2045;278;2921;2934;7.15;0.43;235.28;3.96;876;10;990.00;13
2048;10;22304527;2048;274;2922;2934;7.18;0.44;235.01;3.95;874;10;991.00;12
2053;10;22304538;2053;277;2923;2934;7.20;0.44;234.78;3.95;870;10;992.00;11
2056;10;22304550;2056;282;2924;2934;7.22;0.44;234.68;3.96;868;10;993.00;10
2059;10;22304561;2059;282;2928;2938;7.26;0.44;234.64;3.96;869;10;994.00;10
2059;10;22304573;2059;287;2928;2938;7.25;0.44;234.64;3.96;869;10;995.00;10
2059;10;22304584;2059;290;2928;2938;7.21;0.44;234.64;3.96;869;10;996.00;10
2059;10;22304597;2059;283;2929;2938;7.18;0.44;234.64;3.96;870;10;997.00;9
2061;10;22304607;2061;281;2929;2939;7.14;0.43;234.87;3.96;868;10;998.00;10
2062;10;22304619;2062;287;2930;2940;7.13;0.43;234.80;3.96;868;10;999.00;10
2062;10;22304632;2062;288;2930;2940;7.12;0.43;234.80;3.96;868;10;1000.00;10
2065;10;22304648;2065;292;2931;2941;7.13;0.43;235.00;3.96;866;10;1001.00;10
2066;10;22304660;2066;296;2931;2941;7.09;0.43;235.03;3.96;865;10;1002.00;10
2068;10;22304671;2068;300;2931;2941;7.02;0.43;235.05;3.96;863;10;1003.00;10
2068;10;22304683;2068;311;2931;2941;7.03;0.43;235.05;3.96;863;10;1004.00;10
2070;10;22304692;2070;319;2933;2941;6.95;0.42;235.06;3.99;863;10;1005.00;8
2071;10;22304706;2071;326;2933;2941;6.92;0.42;235.07;3.99;862;10;1006.00;8
2071;10;22304718;2071;335;2934;2941;6.91;0.42;235.07;4.01;863;10;1007.00;7
2072;10;22304729;2072;356;3003;3068;7.10;0.44;235.03;3.92;931;10;1008.00;65
2075;10;22304751;2075;341;3005;3069;7.09;0.44;235.02;3.92;930;10;1009.00;64
2078;10;22304765;2078;334;3013;3069;7.14;0.44;235.09;3.93;935;10;1010.00;56
2078;10;22304777;2078;325;3020;3069;7.20;0.45;235.09;3.93;942;10;1011.00;49
2078;10;22304788;2078;321;3028;3069;7.21;0.45;235.09;3.93;950;10;1012.00;41
2080;10;22304802;2080;314;3032;3069;7.18;0.44;235.20;3.94;952;10;1013.00;37
2082;10;22304815;2082;316;3035;3069;7.13;0.44;235.10;3.94;953;10;1014.00;34
2083;11;22304827;2083;314;3037;3069;7.16;0.44;235.09;3.95;954;11;1015.00;32
2086;11;22304861;2086;316;3040;3070;7.11;0.44;235.02;3.96;954;11;1016.00;30
2086;11;22304876;2086;313;3047;3071;7.16;0.44;235.02;3.99;961;11;1017.00;24
2088;11;22304890;2088;320;3050;3071;7.12;0.44;234.98;4.00;962;11;1018.00;21
2090;11;22304905;2090;314;3053;3072;7.13;0.44;234.89;4.00;963;11;1019.00;19
2092;11;22304920;2092;314;3055;3072;7.09;0.44;234.86;4.01;963;11;1020.00;17
2093;11;22304933;2093;312;3060;3072;7.08;0.44;234.87;4.02;967;11;1021.00;12
2094;11;22304946;2094;313;3063;3072;7.06;0.44;234.86;4.03;969;11;1022.00;9
2097;11;22304958;2097;315;3068;3076;7.05;0.43;234.82;4.04;971;11;1023.00;8
2099;11;22304980;2099;310;3069;3076;7.00;0.43;234.87;4.04;970;11;1024.00;7
2101;11;22304992;2101;310;3071;3076;6.91;0.42;234.92;4.04;970;11;1025.00;5
2101;11;22305006;2101;310;3073;3079;6.86;0.42;234.92;4.04;972;11;1026.00;6
2104;11;22305019;2104;316;3075;3079;6.78;0.42;234.84;4.05;971;11;1027.00;4
2105;11;22305032;2105;317;3075;3079;6.66;0.41;234.83;4.05;970;11;1028.00;4
2106;11;22305046;2106;318;3081;3083;6.57;0.40;234.80;4.06;975;11;1029.00;2
2107;11;22305058;2107;316;3082;3084;6.50;0.40;234.83;4.06;975;11;1030.00;2
2109;11;22305071;2109;320;3082;3084;6.44;0.40;234.73;4.06;973;11;1031.00;2
2111;11;22305083;2111;322;3088;3088;6.38;0.39;234.67;4.05;977;11;1032.00;0
2113;11;22305098;2113;320;3088;3088;6.32;0.39;234.79;4.05;975;11;1033.00;0
2119;11;22305111;2119;313;3088;3088;6.34;0.39;234.68;4.05;969;11;1034.00;0
2119;11;22305123;2119;319;3090;3090;6.39;0.39;234.68;4.05;971;11;1035.00;0
2123;11;22305142;2123;321;3090;3090;6.40;0.39;234.68;4.05;967;11;1036.00;0
2125;11;22305154;2125;323;3096;3096;6.45;0.39;234.59;4.04;971;11;1037.00;0
2127;11;22305167;2127;317;3096;3096;6.50;0.40;234.58;4.04;969;11;1038.00;0
2128;11;22305179;2128;321;3097;3097;6.48;0.40;234.57;4.04;969;11;1039.00;0
2133;11;22305190;2133;321;3097;3097;6.42;0.39;234.61;4.04;964;11;1040.00;0
2135;11;22305203;2135;327;3097;3097;6.40;0.39;234.72;4.04;962;11;1041.00;0
2138;11;22305215;2138;332;3097;3097;6.36;0.39;234.78;4.04;959;11;1042.00;0
2141;11;22305225;2141;336;3097;3097;6.28;0.38;234.82;4.04;956;11;1043.00;0
2144;11;22305237;2144;335;3109;3109;6.19;0.38;234.89;4.03;965;11;1044.00;0
2147;11;22305250;2147;335;3109;3109;6.14;0.38;234.95;4.03;962;11;1045.00;0
2154;11;22305262;2154;336;3109;3109;6.05;0.37;235.02;4.03;955;11;1046.00;0
2156;11;22305274;2156;335;3109;3109;5.98;0.37;235.25;4.03;953;11;1047.00;0
2160;12;22305286;2160;343;3109;3109;5.88;0.36;235.43;4.03;949;12;1048.00;0
2164;12;22305318;2164;339;3109;3109;5.86;0.36;235.33;4.03;945;12;1049.00;0
2168;12;22305332;2168;328;3115;3115;5.83;0.36;235.48;4.02;947;12;1050.00;0
2169;12;22305345;2169;320;3115;3115;5.87;0.36;235.59;4.02;946;12;1051.00;0
2173;12;22305355;2173;312;3119;3119;5.97;0.37;235.98;4.02;946;12;1052.00;0
2176;12;22305368;2176;314;3120;3120;6.05;0.37;236.12;4.02;944;12;1053.00;0
2177;12;22305384;2177;313;3120;3120;6.20;0.38;236.24;4.02;943;12;1054.00;0
2182;12;22305396;2182;312;3120;3120;6.27;0.38;236.71;4.02;938;12;1055.00;0
2187;12;22305409;2187;303;3133;3133;6.30;0.39;236.98;4.00;946;12;1056.00;0
2188;12;22305423;2188;299;3133;3133;6.45;0.39;237.06;4.00;945;12;1057.00;0
2194;12;22305436;2194;283;3133;3133;6.51;0.40;237.33;4.00;939;12;1058.00;0
2198;12;22305448;2198;276;3134;3134;6.62;0.40;237.64;4.00;936;12;1059.00;0
2199;12;22305461;2199;272;3135;3135;6.73;0.41;237.69;4.00;936;12;1060.00;0
2203;12;22305473;2203;266;3135;3135;6.82;0.42;238.22;4.00;932;12;1061.00;0
2210;12;22305486;2210;267;3137;3138;6.85;0.42;238.58;3.99;927;12;1062.00;1
2212;12;22305500;2212;263;3137;3138;6.93;0.42;238.55;3.99;925;12;1063.00;1
2217;12;22305512;2217;265;3138;3138;6.97;0.43;238.81;3.99;921;12;1064.00;0
2225;12;22305524;2225;264;3138;3138;6.97;0.43;239.08;3.99;913;12;1065.00;0
2226;12;22305537;2226;270;3144;3144;7.03;0.43;239.04;3.99;918;12;1066.00;0
2230;12;22305549;2230;265;3144;3144;6.99;0.43;239.56;3.99;914;12;1067.00;0
2236;12;22305562;2236;261;3144;3144;6.89;0.42;239.64;3.99;908;12;1068.00;0
2240;12;22305574;2240;263;3144;3144;6.81;0.42;239.75;3.99;904;12;1069.00;0
2245;12;22305587;2245;266;3147;3148;6.79;0.41;239.92;3.99;902;12;1070.00;1
2252;12;22305601;2252;267;3148;3149;6.85;0.42;240.59;3.98;896;12;1071.00;1
2255;12;22305615;2255;268;3149;3149;6.83;0.42;240.71;3.98;894;12;1072.00;0
2260;12;22305631;2260;269;3150;3150;6.86;0.42;241.05;3.98;890;12;1073.00;0
2261;12;22305648;2261;274;3150;3150;6.92;0.42;241.04;3.98;889;12;1074.00;0
2268;12;22305662;2268;275;3150;3150;6.88;0.42;241.70;3.98;882;12;1075.00;0
2271;12;22305675;2271;283;3150;3150;6.94;0.42;241.78;3.98;879;12;1076.00;0
2276;12;22305688;2276;280;3150;3150;6.97;0.42;242.05;3.98;874;12;1077.00;0
2278;12;22305701;2278;275;3150;3150;7.00;0.43;242.16;3.98;872;12;1078.00;0
2280;12;22305715;2280;273;3150;3150;7.07;0.43;242.12;3.98;870;12;1079.00;0
2285;12;22305729;2285;299;3226;3275;7.19;0.45;242.38;3.89;941;12;1080.00;49
2285;12;22305753;2285;288;3232;3276;7.33;0.45;242.38;3.88;947;12;1081.00;44
2292;12;22305768;2292;280;3239;3276;7.37;0.46;242.56;3.88;947;12;1082.00;37
2298;12;22305782;2298;284;3243;3276;7.44;0.46;242.69;3.88;945;12;1083.00;33
2300;12;22305796;2300;279;3248;3276;7.43;0.46;242.94;3.88;948;12;1084.00;28
2305;12;22305810;2305;281;3250;3276;7.39;0.46;243.22;3.88;945;12;1085.00;26
2309;12;22305823;2309;280;3254;3276;7.36;0.45;243.34;3.88;945;12;1086.00;22
2313;12;22305838;2313;281;3258;3276;7.36;0.45;243.65;3.89;945;12;1087.00;18
2316;12;22305852;2316;283;3261;3277;7.32;0.45;243.95;3.89;945;12;1088.00;16
2319;12;22305866;2319;289;3264;3278;7.25;0.44;243.89;3.89;945;12;1089.00;14
2321;12;22305880;2321;288;3269;3278;7.21;0.44;244.03;3.90;948;12;1090.00;9
2327;12;22305894;2327;297;3275;3282;7.06;0.43;244.53;3.90;948;12;1091.00;7
2332;12;22305908;2332;299;3276;3282;6.91;0.42;244.59;3.90;944;12;1092.00;6
2336;12;22305922;2336;306;3276;3282;6.76;0.41;244.79;3.90;940;12;1093.00;6
2338;12;22305936;2338;316;3276;3282;6.69;0.41;244.85;3.90;938;12;1094.00;6
2341;12;22305950;2341;319;3282;3288;6.56;0.40;245.21;3.90;941;12;1095.00;6
2345;12;22305965;2345;334;3282;3288;6.52;0.40;245.44;3.90;937;12;1096.00;6
2346;12;22305981;2346;335;3283;3288;6.54;0.40;245.56;3.91;937;12;1097.00;5
2351;12;22305996;2351;326;3285;3291;6.54;0.40;245.54;3.91;934;12;1098.00;6
2355;12;22306010;2355;325;3285;3291;6.53;0.40;245.92;3.91;930;12;1099.00;6
2356;12;22306025;2356;322;3285;3291;6.60;0.40;246.00;3.91;929;12;1100.00;6
2359;12;22306043;2359;323;3286;3292;6.70;0.41;246.28;3.90;927;12;1101.00;6
2361;12;22306057;2361;318;3287;3293;6.80;0.42;246.43;3.90;926;12;1102.00;6
2365;12;22306072;2365;324;3287;3293;6.95;0.43;246.82;3.90;922;12;1103.00;6
2373;12;22306085;2373;325;3298;3306;7.05;0.43;246.97;3.89;925;12;1104.00;8
2376;12;22306100;2376;328;3298;3306;7.11;0.43;247.09;3.89;922;12;1105.00;8
2382;12;22306120;2382;314;3299;3306;7.15;0.44;247.33;3.89;917;12;1106.00;7
2388;12;22306134;2388;310;3300;3307;7.20;0.44;247.73;3.89;912;12;1107.00;7
2389;12;22306149;2389;307;3301;3307;7.27;0.44;247.78;3.89;912;12;1108.00;6
2391;12;22306161;2391;300;3304;3311;7.34;0.45;248.07;3.89;913;12;1109.00;7
2394;12;22306177;2394;281;3304;3311;7.36;0.45;248.13;3.89;910;12;1110.00;7
2395;12;22306190;2395;284;3306;3315;7.41;0.45;248.19;3.89;911;12;1111.00;9
2399;12;22306204;2399;288;3307;3315;7.44;0.45;248.26;3.89;908;12;1112.00;8
2401;12;22306217;2401;287;3307;3315;7.48;0.46;248.48;3.89;906;12;1113.00;8
2405;12;22306230;2405;292;3307;3315;7.56;0.46;248.62;3.89;902;12;1114.00;8
2409;12;22306243;2409;294;3307;3315;7.65;0.47;249.18;3.89;898;12;1115.00;8
2412;12;22306256;2412;302;3319;3327;7.77;0.47;249.34;3.89;907;12;1116.00;8
2414;12;22306271;2414;295;3320;3327;7.80;0.48;249.72;3.90;906;12;1117.00;7
2417;12;22306284;2417;291;3321;3327;7.87;0.48;249.79;3.91;904;12;1118.00;6
2419;12;22306298;2419;293;3322;3327;7.85;0.48;249.97;3.91;903;12;1119.00;5
2421;12;22306317;2421;287;3323;3327;7.86;0.48;249.96;3.92;902;12;1120.00;4
2424;12;22306330;2424;282;3323;3327;7.82;0.48;250.11;3.92;899;12;1121.00;4
2426;12;22306342;2426;284;3323;3328;7.86;0.48;250.08;3.92;897;12;1122.00;5
2430;12;22306355;2430;279;3323;3328;7.88;0.48;250.36;3.92;893;12;1123.00;5
2431;12;22306368;2431;277;3328;3334;7.93;0.48;250.30;3.91;897;12;1124.00;6
2433;12;22306382;2433;277;3330;3336;7.88;0.48;250.30;3.91;897;12;1125.00;6
2434;12;22306394;2434;275;3330;3336;7.90;0.48;250.36;3.91;896;12;1126.00;6
2439;12;22306406;2439;279;3330;3336;7.83;0.48;250.30;3.91;891;12;1127.00;6
2442;12;22306419;2442;279;3333;3340;7.73;0.47;250.57;3.91;891;12;1128.00;7
2444;12;22306440;2444;282;3333;3340;7.68;0.47;250.68;3.91;889;12;1129.00;7
2444;12;22306452;2444;281;3333;3340;7.54;0.46;250.68;3.91;889;12;1130.00;7
2445;12;22306464;2445;287;3334;3341;7.49;0.46;250.77;3.90;889;12;1131.00;7
2448;12;22306475;2448;290;3337;3345;7.43;0.45;250.78;3.90;889;12;1132.00;8
2450;12;22306487;2450;291;3337;3345;7.34;0.45;250.82;3.90;887;12;1133.00;8
2452;12;22306501;2452;293;3339;3348;7.29;0.45;250.71;3.90;887;12;1134.00;9
2454;12;22306514;2454;296;3339;3348;7.25;0.44;250.73;3.90;885;12;1135.00;9
2457;12;22306525;2457;300;3340;3348;7.26;0.44;250.60;3.90;883;12;1136.00;8
2459;12;22306537;2459;302;3340;3348;7.26;0.44;250.64;3.90;881;12;1137.00;8
2461;12;22306549;2461;308;3344;3352;7.25;0.44;250.50;3.90;883;12;1138.00;8
2464;12;22306560;2464;311;3344;3352;7.21;0.44;250.45;3.90;880;12;1139.00;8
2464;12;22306575;2464;311;3344;3352;7.20;0.44;250.45;3.90;880;12;1140.00;8
2469;12;22306587;2469;305;3344;3352;7.18;0.44;250.47;3.90;875;12;1141.00;8
2471;12;22306600;2471;300;3344;3353;7.20;0.44;250.43;3.90;873;12;1142.00;9
2473;12;22306612;2473;298;3345;3354;7.26;0.44;250.42;3.89;872;12;1143.00;9
2473;12;22306623;2473;299;3345;3354;7.27;0.44;250.42;3.89;872;12;1144.00;9
2476;12;22306635;2476;293;3346;3355;7.27;0.44;250.39;3.89;870;12;1145.00;9
2479;12;22306647;2479;297;3346;3355;7.27;0.44;250.28;3.89;867;12;1146.00;9
2483;12;22306657;2483;298;3346;3355;7.27;0.44;250.25;3.89;863;12;1147.00;9
2485;12;22306670;2485;294;3346;3355;7.23;0.44;250.10;3.89;861;12;1148.00;9
2485;12;22306682;2485;292;3346;3355;7.29;0.44;250.10;3.89;861;12;1149.00;9
2487;12;22306692;2487;293;3346;3355;7.36;0.45;250.12;3.89;859;12;1150.00;9
2491;12;22306704;2491;290;3346;3355;7.28;0.44;250.26;3.89;855;12;1151.00;9
2492;12;22306716;2492;313;3413;3482;7.28;0.45;250.27;3.82;921;12;1152.00;69
2493;12;22306737;2493;303;3413;3483;7.27;0.45;250.26;3.82;920;12;1153.00;70
2495;12;22306748;2495;294;3421;3483;7.34;0.45;250.29;3.81;926;12;1154.00;62
2497;12;22306761;2497;292;3425;3483;7.34;0.45;250.37;3.84;928;12;1155.00;58
2501;12;22306772;2501;290;3430;3483;7.33;0.45;250.28;3.84;929;12;1156.00;53
2505;12;22306785;2505;286;3432;3483;7.29;0.45;250.25;3.84;927;12;1157.00;51
2507;12;22306797;2507;275;3438;3483;7.26;0.45;250.19;3.85;931;12;1158.00;45
2511;12;22306808;2511;279;3441;3483;7.23;0.44;249.91;3.85;930;12;1159.00;42
2512;12;22306820;2512;279;3443;3484;7.27;0.45;249.95;3.85;931;12;1160.00;41
2515;12;22306833;2515;273;3448;3485;7.29;0.45;250.06;3.86;933;12;1161.00;37
2518;12;22306845;2518;276;3450;3485;7.21;0.44;250.00;3.86;932;12;1162.00;35
2519;12;22306856;2519;277;3452;3486;7.23;0.44;249.96;3.87;933;12;1163.00;34
2520;12;22306869;2520;276;3454;3486;7.19;0.44;249.91;3.87;934;12;1164.00;32
2520;12;22306880;2520;275;3457;3486;7.10;0.43;249.91;3.88;937;12;1165.00;29
2521;12;22306890;2521;263;3458;3486;7.04;0.43;249.89;3.88;937;12;1166.00;28
2523;12;22306902;2523;256;3462;3490;7.07;0.43;249.91;3.88;939;12;1167.00;28
2523;12;22306915;2523;257;3463;3490;7.06;0.43;249.91;3.88;940;12;1168.00;27
2526;12;22306928;2526;244;3464;3490;7.08;0.43;249.81;3.89;938;12;1169.00;26
2528;12;22306941;2528;240;3468;3496;7.15;0.44;249.71;3.89;940;12;1170.00;28
2529;12;22306954;2529;243;3469;3496;7.20;0.44;249.72;3.89;940;12;1171.00;27
2530;12;22306973;2530;246;3473;3496;7.25;0.44;249.73;3.90;943;12;1172.00;23
2532;12;22306986;2532;249;3476;3500;7.30;0.44;249.83;3.90;944;12;1173.00;24
2533;12;22306999;2533;245;3478;3501;7.33;0.45;249.74;3.90;945;12;1174.00;23
2533;12;22307011;2533;244;3479;3501;7.40;0.45;249.74;3.90;946;12;1175.00;22
2538;12;22307023;2538;250;3482;3505;7.40;0.45;249.65;3.90;944;12;1176.00;23
2539;12;22307042;2539;245;3482;3505;7.34;0.45;249.75;3.90;943;12;1177.00;23
2541;12;22307054;2541;251;3483;3505;7.38;0.45;249.58;3.90;942;12;1178.00;22
2542;12;22307066;2542;252;3485;3506;7.36;0.45;249.55;3.91;943;12;1179.00;21
2543;12;22307079;2543;266;3486;3506;7.32;0.45;249.47;3.92;943;12;1180.00;20
2545;12;22307090;2545;266;3493;3512;7.35;0.45;249.41;3.96;948;12;1181.00;19
2547;12;22307103;2547;271;3494;3512;7.31;0.44;249.43;3.96;947;12;1182.00;18
2547;12;22307115;2547;269;3496;3513;7.33;0.45;249.43;3.98;949;12;1183.00;17
2547;12;22307128;2547;275;3496;3513;7.41;0.45;249.43;3.98;949;12;1184.00;17
2549;12;22307140;2549;274;3497;3513;7.38;0.45;249.42;3.99;948;12;1185.00;16
2549;12;22307152;2549;275;3499;3513;7.41;0.45;249.42;4.02;950;12;1186.00;14
2551;12;22307166;2551;281;3499;3513;7.42;0.45;249.33;4.02;948;12;1187.00;14
2554;12;22307178;2554;284;3511;3525;7.42;0.45;249.20;4.03;957;12;1188.00;14
2555;12;22307191;2555;276;3511;3525;7.39;0.45;249.21;4.03;956;12;1189.00;14
2560;12;22307205;2560;279;3512;3525;7.30;0.44;248.96;4.03;952;12;1190.00;13
2562;12;22307218;2562;277;3514;3525;7.33;0.45;249.00;4.05;952;12;1191.00;11
2566;12;22307231;2566;283;3514;3525;7.26;0.44;249.00;4.05;948;12;1192.00;11
2568;12;22307251;2568;289;3515;3525;7.24;0.44;249.14;4.06;947;12;1193.00;10
2571;12;22307264;2571;287;3520;3529;7.22;0.44;249.08;4.08;949;12;1194.00;9
2573;12;22307277;2573;287;3522;3529;7.23;0.44;249.34;4.10;949;12;1195.00;7
2575;12;22307288;2575;288;3526;3533;7.25;0.44;249.29;4.10;951;12;1196.00;7
2577;12;22307302;2577;286;3529;3534;7.21;0.44;249.33;4.11;952;12;1197.00;5
2577;12;22307314;2577;291;3529;3534;7.18;0.44;249.33;4.11;952;12;1198.00;5
2579;12;22307327;2579;286;3529;3534;7.07;0.43;249.35;4.11;950;12;1199.00;5
2582;12;22307343;2582;289;3555;3575;6.95;0.43;249.32;4.10;973;12;1200.00;20
2582;12;22307365;2582;275;3556;3575;6.99;0.43;249.32;4.10;974;12;1201.00;19
2584;12;22307378;2584;274;3559;3575;7.00;0.43;249.33;4.10;975;12;1202.00;16
2586;12;22307389;2586;274;3562;3576;7.03;0.43;249.47;4.10;976;12;1203.00;14
2589;12;22307402;2589;276;3565;3577;6.98;0.43;249.55;4.10;976;12;1204.00;12
2593;12;22307415;2593;274;3566;3577;6.98;0.43;249.62;4.10;973;12;1205.00;11
2593;12;22307428;2593;274;3572;3580;7.04;0.43;249.62;4.10;979;12;1206.00;8
2595;12;22307440;2595;270;3572;3580;7.07;0.43;249.55;4.10;977;12;1207.00;8
2598;12;22307452;2598;270;3572;3580;7.07;0.43;249.65;4.10;974;12;1208.00;8
2603;12;22307465;2603;272;3573;3580;7.14;0.44;249.78;4.10;970;12;1209.00;7
2606;12;22307477;2606;271;3579;3586;7.24;0.44;249.95;4.10;973;12;1210.00;7
2606;12;22307489;2606;270;3581;3586;7.26;0.44;249.95;4.10;975;12;1211.00;5
2612;12;22307501;2612;269;3581;3586;7.27;0.44;250.14;4.10;969;12;1212.00;5
2612;12;22307514;2612;270;3582;3586;7.29;0.45;250.14;4.10;970;12;1213.00;4
2616;12;22307525;2616;270;3586;3590;7.26;0.44;250.25;4.10;970;12;1214.00;4
2619;12;22307538;2619;265;3589;3592;7.24;0.44;250.33;4.10;970;12;1215.00;3
2625;12;22307551;2625;268;3589;3592;7.18;0.44;250.24;4.10;964;12;1216.00;3
2629;12;22307564;2629;269;3590;3593;7.10;0.43;250.23;4.10;961;12;1217.00;3
2633;12;22307575;2633;275;3590;3593;7.10;0.44;250.34;4.10;957;12;1218.00;3
2637;12;22307587;2637;273;3590;3593;7.17;0.44;250.26;4.10;953;12;1219.00;3
2644;12;22307601;2644;274;3591;3593;7.11;0.44;250.47;4.10;947;12;1220.00;2
2647;12;22307613;2647;282;3591;3593;7.05;0.43;250.56;4.10;944;12;1221.00;2
2650;12;22307624;2650;286;3591;3593;6.97;0.43;250.62;4.10;941;12;1222.00;2
2654;12;22307636;2654;293;3591;3593;6.88;0.42;251.06;4.10;937;12;1223.00;2
2658;12;22307649;2658;301;3632;3663;6.87;0.42;251.14;4.06;974;12;1224.00;31
2663;12;22307668;2663;288;3636;3664;6.83;0.42;251.25;4.05;973;12;1225.00;28
2667;12;22307681;2667;277;3644;3664;6.86;0.42;251.47;4.06;977;12;1226.00;20
2670;12;22307700;2670;268;3644;3664;6.85;0.42;251.64;4.06;974;12;1227.00;20
2673;12;22307713;2673;268;3648;3666;6.88;0.42;251.84;4.05;975;12;1228.00;18
2682;12;22307725;2682;267;3649;3666;6.89;0.42;252.22;4.05;967;12;1229.00;17
2686;12;22307739;2686;261;3651;3666;6.87;0.42;252.58;4.06;965;12;1230.00;15
2688;12;22307770;2688;268;3653;3666;6.88;0.42;252.73;4.06;965;12;1231.00;13
2695;12;22307782;2695;266;3655;3667;6.79;0.41;253.09;4.07;960;12;1232.00;12
2697;12;22307794;2697;263;3658;3668;6.81;0.42;253.11;4.07;961;12;1233.00;10
2703;13;22307806;2703;269;3658;3668;6.73;0.41;253.49;4.07;955;13;1234.00;10
2705;13;22307834;2705;278;3666;3672;6.72;0.41;253.63;4.07;961;13;1235.00;6
2709;13;22307848;2709;280;3668;3672;6.71;0.41;253.84;4.08;959;13;1236.00;4
2712;13;22307861;2712;280;3671;3672;6.69;0.41;254.09;4.08;959;13;1237.00;1
2714;13;22307873;2714;279;3672;3672;6.70;0.41;254.30;4.08;958;13;1238.00;0
2719;13;22307885;2719;282;3678;3678;6.68;0.41;254.61;4.08;959;13;1239.00;0
2721;13;22307899;2721;277;3678;3678;6.71;0.41;254.66;4.08;957;13;1240.00;0
2725;13;22307911;2725;281;3678;3678;6.71;0.41;255.08;4.08;953;13;1241.00;0
2727;13;22307924;2727;281;3680;3681;6.79;0.41;255.18;4.08;953;13;1242.00;1
2730;13;22307939;2730;282;3681;3681;6.78;0.41;255.19;4.08;951;13;1243.00;0
2736;13;22307951;2736;284;3681;3681;6.77;0.41;255.18;4.08;945;13;1244.00;0
2742;13;22307964;2742;284;3682;3682;6.72;0.41;255.33;4.07;940;13;1245.00;0
2744;13;22307977;2744;282;3683;3683;6.70;0.41;255.56;4.07;939;13;1246.00;0
2749;13;22307988;2749;289;3683;3683;6.67;0.41;255.80;4.07;934;13;1247.00;0
2753;13;22308001;2753;299;3696;3696;6.72;0.41;255.64;4.06;943;13;1248.00;0
2760;13;22308014;2760;299;3696;3696;6.70;0.41;256.13;4.06;936;13;1249.00;0
2764;13;22308027;2764;297;3696;3696;6.65;0.40;256.20;4.06;932;13;1250.00;0
2769;13;22308038;2769;301;3697;3697;6.61;0.40;256.56;4.06;928;13;1251.00;0
2779;13;22308051;2779;306;3697;3697;6.50;0.39;256.81;4.06;918;13;1252.00;0
2780;13;22308064;2780;313;3701;3701;6.53;0.40;256.93;4.05;921;13;1253.00;0
2781;13;22308077;2781;314;3701;3701;6.53;0.40;256.88;4.05;920;13;1254.00;0
2787;13;22308088;2787;310;3705;3705;6.48;0.39;257.13;4.05;918;13;1255.00;0
2789;13;22308102;2789;308;3705;3705;6.47;0.39;257.31;4.05;916;13;1256.00;0
2791;13;22308114;2791;309;3705;3705;6.47;0.39;257.50;4.05;914;13;1257.00;0
2793;13;22308127;2793;313;3705;3705;6.46;0.39;257.67;4.05;912;13;1258.00;0
2794;13;22308138;2794;312;3705;3705;6.50;0.40;257.63;4.05;911;13;1259.00;0
2797;13;22308152;2797;314;3735;3739;6.63;0.41;257.69;4.02;938;13;1260.00;4
2799;13;22308167;2799;317;3736;3739;6.66;0.41;257.77;4.02;937;13;1261.00;3
2803;13;22308180;2803;315;3738;3739;6.66;0.41;257.90;4.02;935;13;1262.00;1
2803;13;22308198;2803;322;3738;3739;6.63;0.41;257.90;4.02;935;13;1263.00;1
2806;13;22308209;2806;323;3739;3739;6.59;0.41;258.04;4.02;933;13;1264.00;0
2810;13;22308222;2810;328;3739;3739;6.57;0.40;258.02;4.02;929;13;1265.00;0
2812;13;22308235;2812;335;3739;3740;6.50;0.40;258.06;4.02;927;13;1266.00;1
2815;13;22308247;2815;336;3739;3740;6.37;0.39;258.22;4.02;924;13;1267.00;1
2816;13;22308257;2816;347;3744;3746;6.27;0.39;258.20;4.01;928;13;1268.00;2
2819;13;22308270;2819;351;3745;3747;6.17;0.38;258.33;4.01;926;13;1269.00;2
2821;13;22308282;2821;361;3745;3747;6.07;0.37;258.43;4.01;924;13;1270.00;2
2825;13;22308294;2825;367;3745;3747;6.03;0.37;258.48;4.01;920;13;1271.00;2
2829;13;22308306;2829;359;3748;3751;6.01;0.37;258.56;4.01;919;13;1272.00;3
2833;13;22308319;2833;358;3748;3751;5.98;0.37;258.64;4.01;915;13;1273.00;3
2834;13;22308332;2834;356;3748;3751;6.01;0.37;258.59;4.01;914;13;1274.00;3
2837;13;22308345;2837;352;3749;3752;6.04;0.37;258.66;4.01;912;13;1275.00;3
2841;13;22308356;2841;353;3752;3756;6.06;0.37;258.84;4.01;911;13;1276.00;4
2845;13;22308375;2845;353;3752;3756;6.04;0.37;258.73;4.01;907;13;1277.00;4
2845;13;22308387;2845;353;3754;3759;6.12;0.38;258.73;4.00;909;13;1278.00;5
2846;13;22308401;2846;352;3754;3759;6.21;0.38;258.88;4.00;908;13;1279.00;5
2848;13;22308412;2848;354;3755;3759;6.30;0.39;259.04;4.00;907;13;1280.00;4
2849;13;22308424;2849;343;3755;3759;6.40;0.39;258.99;4.00;906;13;1281.00;4
2851;13;22308437;2851;337;3759;3763;6.48;0.40;259.06;4.00;908;13;1282.00;4
2854;13;22308450;2854;330;3759;3763;6.58;0.40;259.30;4.00;905;13;1283.00;4
2857;13;22308463;2857;328;3759;3763;6.68;0.41;259.42;4.00;902;13;1284.00;4
2859;13;22308474;2859;322;3759;3763;6.77;0.41;259.48;4.00;900;13;1285.00;4
2860;13;22308486;2860;317;3759;3764;6.85;0.42;259.46;4.00;899;13;1286.00;5
2864;13;22308500;2864;318;3760;3765;6.93;0.42;259.69;4.00;896;13;1287.00;5
2865;13;22308514;2865;320;3760;3765;7.04;0.43;259.75;4.00;895;13;1288.00;5
2868;13;22308524;2868;320;3761;3766;7.15;0.44;259.80;4.00;893;13;1289.00;5
2872;13;22308539;2872;320;3761;3766;7.20;0.44;260.00;4.00;889;13;1290.00;5
2875;13;22308552;2875;321;3761;3766;7.29;0.44;259.99;4.00;886;13;1291.00;5
2878;13;22308565;2878;315;3761;3766;7.35;0.45;260.16;4.00;883;13;1292.00;5
2879;13;22308578;2879;310;3761;3766;7.38;0.45;260.26;4.00;882;13;1293.00;5
2882;13;22308589;2882;310;3761;3766;7.37;0.45;260.20;4.00;879;13;1294.00;5
2887;13;22308602;2887;304;3761;3766;7.33;0.44;260.35;4.00;874;13;1295.00;5
2888;13;22308615;2888;319;3828;3893;7.62;0.47;260.36;3.93;940;13;1296.00;65
2892;13;22308639;2892;311;3830;3894;7.61;0.47;260.47;3.93;938;13;1297.00;64
2894;13;22308652;2894;301;3839;3894;7.71;0.48;260.45;3.92;945;13;1298.00;55
2898;13;22308664;2898;303;3840;3894;7.64;0.47;260.56;3.92;942;13;1299.00;54
2902;13;22308679;2902;305;3845;3894;7.61;0.47;260.86;3.92;943;13;1300.00;49
2904;13;22308696;2904;306;3848;3894;7.52;0.46;260.85;3.92;944;13;1301.00;46
2907;13;22308708;2907;315;3851;3894;7.49;0.46;260.86;3.92;944;13;1302.00;43
2911;13;22308722;2911;324;3853;3894;7.39;0.45;260.88;3.93;942;13;1303.00;41
2912;13;22308735;2912;318;3856;3895;7.32;0.45;260.87;3.93;944;13;1304.00;39
2914;13;22308755;2914;319;3862;3897;7.19;0.44;260.88;3.94;948;13;1305.00;35
2915;13;22308767;2915;326;3865;3897;7.12;0.44;260.90;3.94;950;13;1306.00;32
2918;13;22308780;2918;324;3868;3898;7.06;0.43;260.93;3.95;950;13;1307.00;30
2920;13;22308791;2920;329;3871;3898;7.07;0.43;260.90;3.95;951;13;1308.00;27
2921;13;22308803;2921;335;3873;3898;7.09;0.43;260.84;3.96;952;13;1309.00;25
2922;13;22308816;2922;343;3875;3898;7.10;0.43;260.77;3.96;953;13;1310.00;23
2925;13;22308829;2925;344;3879;3902;7.10;0.43;260.83;3.97;954;13;1311.00;23
2928;13;22308841;2928;344;3881;3902;7.06;0.43;260.75;3.97;953;13;1312.00;21
2929;13;22308853;2929;349;3881;3902;7.06;0.43;260.79;3.97;952;13;1313.00;21
2932;13;22308866;2932;355;3884;3905;6.96;0.42;260.75;3.98;952;13;1314.00;21
2933;13;22308879;2933;349;3884;3905;6.89;0.42;260.73;3.98;951;13;1315.00;21
2934;13;22308890;2934;345;3885;3905;6.84;0.42;260.75;3.98;951;13;1316.00;20
2935;13;22308903;2935;343;3888;3909;6.84;0.42;260.81;3.97;953;13;1317.00;21
2939;13;22308915;2939;342;3891;3910;6.83;0.42;260.78;3.98;952;13;1318.00;19
2939;13;22308928;2939;338;3891;3910;6.89;0.42;260.78;3.98;952;13;1319.00;19
2943;13;22308943;2943;338;3897;3915;6.90;0.42;260.79;3.98;954;13;1320.00;18
2946;13;22308955;2946;331;3897;3915;6.91;0.42;260.71;3.98;951;13;1321.00;18
2946;13;22308968;2946;332;3897;3915;6.97;0.43;260.71;3.98;951;13;1322.00;18
2948;13;22308980;2948;323;3898;3916;6.98;0.43;260.86;3.98;950;13;1323.00;18
2949;13;22308991;2949;310;3898;3916;7.02;0.43;260.88;3.98;949;13;1324.00;18
2953;13;22309005;2953;299;3902;3922;7.06;0.43;261.02;3.97;949;13;1325.00;20
2953;13;22309019;2953;293;3902;3922;7.10;0.43;261.02;3.97;949;13;1326.00;20
2958;13;22309031;2958;287;3902;3923;7.09;0.43;261.09;3.97;944;13;1327.00;21
2960;13;22309043;2960;280;3902;3923;7.09;0.43;261.17;3.97;942;13;1328.00;21
2963;13;22309055;2963;277;3903;3923;7.01;0.42;261.08;3.99;940;13;1329.00;20
2965;13;22309068;2965;267;3904;3923;6.98;0.42;261.17;4.00;939;13;1330.00;19
2969;14;22309081;2969;264;3904;3923;6.96;0.42;261.10;4.00;935;14;1331.00;19
2971;14;22309106;2971;258;3914;3935;7.01;0.42;261.14;3.99;943;14;1332.00;21
2972;14;22309135;2972;253;3915;3935;7.00;0.42;261.16;3.99;943;14;1333.00;20
2976;14;22309155;2976;250;3915;3935;7.00;0.42;261.16;3.99;939;14;1334.00;20
2976;14;22309174;2976;245;3915;3935;7.07;0.43;261.16;3.99;939;14;1335.00;20
2976;14;22309186;2976;240;3915;3935;7.18;0.44;261.16;3.99;939;14;1336.00;20
2979;14;22309199;2979;233;3915;3935;7.28;0.44;261.17;3.99;936;14;1337.00;20
2979;14;22309211;2979;240;3918;3939;7.37;0.45;261.17;3.99;939;14;1338.00;21
2980;14;22309230;2980;230;3918;3939;7.39;0.45;261.12;3.99;938;14;1339.00;21
2981;14;22309241;2981;225;3921;3943;7.50;0.45;261.07;3.99;940;14;1340.00;22
2982;14;22309254;2982;223;3922;3944;7.58;0.46;261.08;3.99;940;14;1341.00;22
2983;14;22309267;2983;218;3922;3944;7.63;0.46;261.02;3.99;939;14;1342.00;22
2984;14;22309279;2984;219;3922;3944;7.70;0.47;261.01;3.99;938;14;1343.00;22
2988;14;22309289;2988;213;3932;3957;7.71;0.47;260.97;3.98;944;14;1344.00;25
2992;14;22309304;2992;211;3933;3957;7.69;0.47;261.27;3.98;941;14;1345.00;24
2994;14;22309317;2994;209;3933;3957;7.66;0.46;261.19;3.98;939;14;1346.00;24
2997;14;22309329;2997;206;3934;3958;7.66;0.46;261.22;3.97;937;14;1347.00;24
3000;14;22309341;3000;204;3937;3959;7.65;0.46;261.26;4.01;937;14;1348.00;22
3002;14;22309355;3002;198;3937;3959;7.65;0.46;261.23;4.01;935;14;1349.00;22
3004;14;22309369;3004;201;3944;3968;7.64;0.46;261.36;4.01;940;14;1350.00;24
3004;14;22309382;3004;196;3947;3968;7.67;0.46;261.36;4.03;943;14;1351.00;21
3006;14;22309394;3006;198;3949;3968;7.74;0.47;261.41;4.03;943;14;1352.00;19
3008;14;22309406;3008;201;3949;3968;7.78;0.47;261.42;4.03;941;14;1353.00;19
3008;14;22309418;3008;203;3956;3974;7.82;0.47;261.42;4.06;948;14;1354.00;18
3011;14;22309436;3011;209;3956;3974;7.81;0.47;261.37;4.06;945;14;1355.00;18
3011;14;22309448;3011;209;3956;3974;7.82;0.47;261.37;4.06;945;14;1356.00;18
3014;14;22309460;3014;217;3957;3974;7.83;0.47;261.42;4.07;943;14;1357.00;17
3016;14;22309473;3016;213;3961;3978;7.82;0.47;261.47;4.09;945;14;1358.00;17
3016;14;22309485;3016;215;3962;3979;7.85;0.48;261.47;4.08;946;14;1359.00;17
3017;14;22309499;3017;213;3964;3979;7.81;0.47;261.42;4.11;947;14;1360.00;15
3019;14;22309511;3019;218;3965;3980;7.81;0.47;261.44;4.11;946;14;1361.00;15
3019;14;22309524;3019;220;3966;3980;7.80;0.47;261.44;4.11;947;14;1362.00;14
3020;14;22309537;3020;223;3967;3980;7.78;0.47;261.47;4.12;947;14;1363.00;13
3021;14;22309550;3021;226;3967;3980;7.81;0.48;261.44;4.12;946;14;1364.00;13
3025;14;22309562;3025;228;3967;3980;7.80;0.48;261.74;4.12;942;14;1365.00;13
3027;14;22309574;3027;232;3967;3980;7.85;0.48;261.80;4.12;940;14;1366.00;13
3030;14;22309587;3030;231;3970;3980;7.81;0.48;261.88;4.17;940;14;1367.00;10
3036;14;22309600;3036;237;4012;4050;7.93;0.48;261.77;4.15;976;14;1368.00;38
3036;14;22309620;3036;229;4015;4051;7.94;0.48;261.77;4.16;979;14;1369.00;36
3038;14;22309634;3038;228;4021;4051;8.05;0.49;261.84;4.15;983;14;1370.00;30
3039;14;22309646;3039;228;4026;4051;8.01;0.49;261.87;4.16;987;14;1371.00;25
3041;14;22309666;3041;228;4028;4051;7.98;0.49;261.94;4.16;987;14;1372.00;23
3044;14;22309678;3044;229;4033;4051;7.91;0.48;261.95;4.19;989;14;1373.00;18
3045;14;22309690;3045;224;4036;4051;7.84;0.48;261.91;4.19;991;14;1374.00;15
3047;14;22309704;3047;222;4040;4051;7.83;0.48;261.96;4.20;993;14;1375.00;11
3052;14;22309718;3052;222;4042;4052;7.75;0.47;261.97;4.20;990;14;1376.00;10
3054;15;22309731;3054;223;4047;4053;7.76;0.47;261.95;4.22;993;15;1377.00;6
3056;15;22309769;3056;226;4048;4053;7.71;0.47;261.94;4.22;992;15;1378.00;5
3059;15;22309782;3059;227;4052;4057;7.64;0.47;262.00;4.22;993;15;1379.00;5
3060;15;22309799;3060;230;4053;4057;7.64;0.47;262.06;4.23;993;15;1380.00;4
3061;15;22309814;3061;233;4054;4057;7.62;0.47;262.08;4.22;993;15;1381.00;3
3065;15;22309829;3065;234;4057;4057;7.59;0.46;262.17;4.23;992;15;1382.00;0
3067;15;22309842;3067;235;4062;4063;7.63;0.47;262.13;4.23;995;15;1383.00;1
3071;15;22309856;3071;236;4063;4063;7.62;0.46;262.16;4.23;992;15;1384.00;0
3075;15;22309870;3075;239;4063;4063;7.60;0.46;262.19;4.23;988;15;1385.00;0
3076;15;22309884;3076;246;4065;4066;7.65;0.47;262.18;4.22;989;15;1386.00;1
3080;15;22309898;3080;244;4065;4066;7.65;0.47;262.14;4.22;985;15;1387.00;1
3084;15;22309911;3084;248;4066;4066;7.63;0.46;262.11;4.22;982;15;1388.00;0
3088;15;22309925;3088;251;4067;4067;7.64;0.47;262.25;4.22;979;15;1389.00;0
3092;15;22309938;3092;255;4068;4068;7.63;0.46;262.46;4.22;976;15;1390.00;0
3095;15;22309954;3095;262;4068;4068;7.53;0.46;262.61;4.22;973;15;1391.00;0
3099;15;22309968;3099;269;4081;4081;7.43;0.45;262.52;4.21;982;15;1392.00;0
3102;15;22309982;3102;276;4081;4081;7.34;0.45;262.52;4.21;979;15;1393.00;0
3108;15;22309994;3108;279;4081;4081;7.25;0.44;262.61;4.21;973;15;1394.00;0
3111;15;22310006;3111;282;4083;4083;7.20;0.44;262.62;4.21;972;15;1395.00;0
3115;15;22310019;3115;287;4083;4083;7.12;0.43;262.75;4.21;968;15;1396.00;0
3117;15;22310031;3117;285;4087;4087;7.10;0.43;262.90;4.20;970;15;1397.00;0
3120;15;22310044;3120;290;4087;4087;6.99;0.43;262.96;4.20;967;15;1398.00;0
3127;16;22310055;3127;294;4091;4091;6.88;0.42;262.80;4.20;964;16;1399.00;0
3132;16;22310082;3132;286;4091;4091;6.83;0.42;262.91;4.20;959;16;1400.00;0
3140;16;22310101;3140;274;4091;4091;6.83;0.42;263.53;4.20;951;16;1401.00;0
3141;16;22310119;3141;271;4091;4091;6.86;0.42;263.57;4.20;950;16;1402.00;0
3147;16;22310132;3147;276;4091;4091;6.86;0.42;263.90;4.20;944;16;1403.00;0
3151;16;22310145;3151;271;4102;4103;6.95;0.42;264.12;4.19;951;16;1404.00;1
3156;16;22310159;3156;271;4103;4103;6.96;0.42;264.29;4.19;947;16;1405.00;0
3160;16;22310172;3160;275;4103;4103;6.97;0.42;264.43;4.19;943;16;1406.00;0
3167;16;22310185;3167;270;4103;4103;6.97;0.42;264.88;4.19;936;16;1407.00;0
3170;16;22310200;3170;272;4103;4103;7.04;0.43;264.93;4.19;933;16;1408.00;0
3174;16;22310214;3174;265;4103;4103;7.06;0.43;265.16;4.19;929;16;1409.00;0
3176;16;22310228;3176;263;4104;4104;7.10;0.43;265.40;4.19;928;16;1410.00;0
3181;16;22310240;3181;259;4104;4104;7.11;0.43;265.44;4.19;923;16;1411.00;0
3185;16;22310257;3185;258;4110;4110;7.16;0.44;265.71;4.18;925;16;1412.00;0
3188;16;22310275;3188;266;4111;4111;7.17;0.44;265.99;4.18;923;16;1413.00;0
3190;16;22310290;3190;268;4111;4111;7.18;0.44;266.04;4.18;921;16;1414.00;0
3194;16;22310306;3194;273;4111;4111;7.08;0.43;266.30;4.18;917;16;1415.00;0
3197;16;22310324;3197;271;4115;4115;7.05;0.43;266.31;4.18;918;16;1416.00;0
3200;16;22310340;3200;277;4115;4115;7.02;0.43;266.54;4.18;915;16;1417.00;0
3207;16;22310355;3207;285;4115;4115;6.95;0.42;266.49;4.18;908;16;1418.00;0
3211;16;22310372;3211;289;4116;4116;6.88;0.42;266.87;4.18;905;16;1419.00;0
3214;16;22310388;3214;293;4120;4120;6.84;0.42;266.96;4.17;906;16;1420.00;0
3219;16;22310404;3219;291;4120;4120;6.76;0.41;267.17;4.17;901;16;1421.00;0
3224;16;22310418;3224;289;4122;4123;6.71;0.41;267.33;4.17;898;16;1422.00;1
3229;16;22310435;3229;295;4122;4123;6.66;0.41;267.17;4.17;893;16;1423.00;1
3233;16;22310453;3233;293;4123;4123;6.64;0.41;267.44;4.17;890;16;1424.00;0
3240;16;22310469;3240;296;4123;4123;6.62;0.41;267.48;4.17;883;16;1425.00;0
3244;16;22310483;3244;292;4127;4127;6.65;0.41;267.53;4.17;883;16;1426.00;0
3248;16;22310499;3248;301;4127;4127;6.58;0.40;267.63;4.17;879;16;1427.00;0
3252;16;22310513;3252;298;4127;4127;6.55;0.40;267.70;4.17;875;16;1428.00;0
3256;16;22310524;3256;299;4127;4127;6.56;0.40;267.62;4.17;871;16;1429.00;0
3261;16;22310536;3261;300;4128;4128;6.49;0.40;267.73;4.17;867;16;1430.00;0
3263;16;22310548;3263;308;4129;4129;6.49;0.40;267.83;4.17;866;16;1431.00;0
3266;16;22310561;3266;311;4129;4129;6.50;0.40;267.91;4.17;863;16;1432.00;0
3274;16;22310573;3274;318;4130;4130;6.49;0.40;268.25;4.16;856;16;1433.00;0
3277;16;22310588;3277;321;4130;4130;6.51;0.40;268.20;4.16;853;16;1434.00;0
3281;16;22310601;3281;320;4130;4130;6.50;0.40;268.35;4.16;849;16;1435.00;0
3285;16;22310613;3285;322;4130;4130;6.44;0.39;268.55;4.16;845;16;1436.00;0
3292;16;22310624;3292;324;4130;4130;6.36;0.39;268.62;4.16;838;16;1437.00;0
3298;16;22310636;3298;328;4130;4130;6.27;0.38;269.02;4.16;832;16;1438.00;0
3301;16;22310648;3301;329;4130;4130;6.21;0.38;268.99;4.16;829;16;1439.00;0
3304;16;22310661;3304;365;4239;4360;6.69;0.42;269.13;4.06;935;16;1440.00;121
3305;16;22310691;3305;365;4248;4361;6.64;0.42;269.18;4.05;943;16;1441.00;113
3312;16;22310704;3312;364;4261;4361;6.60;0.42;269.44;4.05;949;16;1442.00;100
3315;16;22310717;3315;362;4271;4361;6.53;0.41;269.41;4.04;956;16;1443.00;90
3318;16;22310731;3318;361;4283;4361;6.44;0.41;269.47;4.04;965;16;1444.00;78
3320;16;22310750;3320;365;4290;4361;6.35;0.40;269.41;4.04;970;16;1445.00;71
3322;16;22310764;3322;369;4299;4361;6.34;0.40;269.49;4.05;977;16;1446.00;62
3323;16;22310775;3323;366;4306;4361;6.32;0.40;269.54;4.05;983;16;1447.00;55
3324;16;22310790;3324;366;4315;4362;6.33;0.40;269.49;4.06;991;16;1448.00;47
3325;16;22310807;3325;366;4318;4363;6.39;0.40;269.50;4.07;993;16;1449.00;45
3328;16;22310822;3328;365;4324;4363;6.38;0.40;269.66;4.07;996;16;1450.00;39
3330;16;22310838;3330;366;4326;4364;6.36;0.40;269.66;4.08;996;16;1451.00;38
3332;16;22310860;3332;370;4330;4364;6.37;0.40;269.62;4.08;998;16;1452.00;34
3337;16;22310881;3337;368;4332;4364;6.36;0.40;269.52;4.09;995;16;1453.00;32
3337;16;22310900;3337;377;4333;4364;6.38;0.40;269.52;4.09;996;16;1454.00;31
3338;16;22310917;3338;385;4336;4368;6.40;0.40;269.48;4.09;998;16;1455.00;32
3342;16;22310948;3342;381;4338;4368;6.50;0.40;269.44;4.09;996;17;1456.00;30
3345;16;22310982;3345;379;4338;4368;6.55;0.41;269.32;4.09;993;17;1457.00;30
3346;16;22311003;3346;376;4340;4371;6.66;0.41;269.35;4.09;994;17;1458.00;31
3349;16;22311019;3349;372;4340;4371;6.74;0.42;269.39;4.09;991;17;1459.00;31
3352;16;22311034;3352;377;4341;4371;6.74;0.42;269.22;4.10;989;17;1460.00;30
3354;16;22311054;3354;377;4344;4375;6.78;0.42;269.09;4.10;990;17;1461.00;31
3357;16;22311070;3357;379;4347;4376;6.82;0.42;268.91;4.10;990;17;1462.00;29
3358;16;22311084;3358;377;4348;4376;6.87;0.42;268.84;4.11;990;17;1463.00;28
3361;16;22311099;3361;382;4351;4380;6.87;0.42;268.70;4.10;990;17;1464.00;29
3363;16;22311114;3363;377;4353;4380;6.87;0.42;268.72;4.11;990;17;1465.00;27
3368;16;22311130;3368;380;4354;4380;6.85;0.42;268.61;4.12;986;17;1466.00;26
3370;16;22311146;3370;376;4354;4381;6.86;0.42;268.70;4.12;984;17;1467.00;27
3374;16;22311161;3374;382;4355;4381;6.79;0.42;268.60;4.12;981;17;1468.00;26
3376;16;22311174;3376;394;4359;4387;6.77;0.41;268.60;4.12;983;17;1469.00;28
3379;16;22311200;3379;393;4359;4387;6.73;0.41;268.62;4.12;980;17;1470.00;28
3379;16;22311214;3379;385;4359;4388;6.71;0.41;268.62;4.12;980;17;1471.00;29
3381;16;22311227;3381;383;4360;4388;6.72;0.41;268.60;4.13;979;17;1472.00;28
3382;16;22311241;3382;381;4360;4388;6.74;0.41;268.61;4.13;978;17;1473.00;28
3384;16;22311255;3384;385;4361;4388;6.73;0.41;268.62;4.13;977;17;1474.00;27
3384;16;22311269;3384;389;4362;4388;6.78;0.41;268.62;4.14;978;17;1475.00;26
3384;16;22311282;3384;401;4371;4400;6.84;0.42;268.62;4.13;987;17;1476.00;29
3388;16;22311297;3388;404;4372;4400;6.81;0.42;268.63;4.13;984;17;1477.00;28
3388;16;22311311;3388;402;4373;4400;6.79;0.41;268.63;4.14;985;17;1478.00;27
3389;16;22311322;3389;405;4373;4400;6.73;0.41;268.64;4.14;984;17;1479.00;27
3393;16;22311336;3393;395;4375;4400;6.68;0.41;268.64;4.15;982;17;1480.00;25
3393;16;22311350;3393;397;4377;4400;6.71;0.41;268.64;4.16;984;17;1481.00;23
3394;16;22311363;3394;390;4380;4404;6.70;0.41;268.58;4.15;986;17;1482.00;24
3396;16;22311377;3396;390;4382;4404;6.72;0.41;268.49;4.16;986;17;1483.00;22
3399;16;22311397;3399;385;4385;4408;6.75;0.41;268.51;4.15;986;17;1484.00;23
3400;16;22311412;3400;380;4387;4410;6.74;0.41;268.49;4.15;987;17;1485.00;23
3403;16;22311426;3403;376;4388;4410;6.74;0.41;268.52;4.15;985;17;1486.00;22
3404;16;22311448;3404;372;4388;4410;6.78;0.41;268.51;4.15;984;17;1487.00;22
3404;16;22311462;3404;367;4397;4423;6.90;0.42;268.51;4.14;993;17;1488.00;26
3404;16;22311476;3404;370;4397;4423;6.98;0.42;268.51;4.14;993;17;1489.00;26
3406;16;22311488;3406;359;4397;4423;7.02;0.43;268.46;4.14;991;17;1490.00;26
3407;16;22311502;3407;353;4398;4424;7.12;0.43;268.52;4.14;991;17;1491.00;26
3409;16;22311517;3409;349;4398;4425;7.22;0.44;268.48;4.14;989;17;1492.00;27
3411;16;22311531;3411;343;4398;4425;7.27;0.44;268.43;4.14;987;17;1493.00;27
3411;16;22311546;3411;337;4400;4428;7.34;0.44;268.43;4.14;989;17;1494.00;28
3412;16;22311567;3412;327;4401;4428;7.37;0.45;268.42;4.14;989;17;1495.00;27
3415;16;22311585;3415;319;4401;4428;7.40;0.45;268.42;4.14;986;17;1496.00;27
3418;16;22311599;3418;308;4401;4428;7.43;0.45;268.57;4.14;983;17;1497.00;27
3419;16;22311621;3419;308;4406;4434;7.52;0.45;268.60;4.14;987;17;1498.00;28
3422;16;22311636;3422;303;4406;4434;7.50;0.45;268.62;4.14;984;17;1499.00;28
3423;16;22311651;3423;304;4410;4453;7.47;0.45;268.66;4.13;987;17;1500.00;43
3425;16;22311672;3425;297;4410;4453;7.48;0.45;268.79;4.13;985;17;1501.00;43
3427;16;22311686;3427;295;4413;4457;7.42;0.45;268.89;4.13;986;17;1502.00;44
3430;16;22311701;3430;295;4414;4458;7.35;0.45;268.86;4.13;984;17;1503.00;44
3433;16;22311715;3433;289;4414;4458;7.30;0.44;268.95;4.13;981;17;1504.00;44
3436;16;22311728;3436;285;4417;4459;7.29;0.44;269.16;4.16;981;17;1505.00;42
3440;16;22311741;3440;284;4419;4459;7.15;0.43;269.13;4.16;979;17;1506.00;40
3444;16;22311754;3444;273;4419;4459;7.15;0.43;269.29;4.16;975;17;1507.00;40
3447;16;22311769;3447;269;4419;4459;7.16;0.43;269.29;4.16;972;17;1508.00;40
3450;16;22311783;3450;267;4419;4459;7.12;0.43;269.29;4.16;969;17;1509.00;40
3454;16;22311797;3454;268;4419;4459;7.13;0.43;269.55;4.16;965;17;1510.00;40
3455;16;22311811;3455;270;4419;4459;7.17;0.43;269.57;4.16;964;17;1511.00;40
3455;16;22311825;3455;273;4455;4529;7.22;0.44;269.57;4.13;1000;17;1512.00;74
3456;16;22311852;3456;258;4456;4530;7.24;0.44;269.55;4.13;1000;17;1513.00;74
3458;16;22311869;3458;263;4461;4530;7.31;0.44;269.51;4.13;1003;17;1514.00;69
3460;16;22311886;3460;252;4463;4530;7.45;0.45;269.49;4.12;1003;17;1515.00;67
3460;16;22311903;3460;256;4465;4530;7.58;0.46;269.49;4.12;1005;17;1516.00;65
3461;16;22311920;3461;259;4468;4530;7.68;0.47;269.52;4.13;1007;17;1517.00;62
3462;16;22311938;3462;257;4472;4530;7.76;0.47;269.58;4.13;1010;17;1518.00;58
3463;16;22311957;3463;255;4474;4530;7.89;0.48;269.55;4.13;1011;17;1519.00;56
3465;16;22311973;3465;254;4476;4531;7.96;0.48;269.50;4.14;1011;17;1520.00;55
3469;16;22311990;3469;250;4478;4532;8.00;0.49;269.42;4.14;1009;17;1521.00;54
3470;16;22312008;3470;250;4482;4532;8.04;0.49;269.40;4.16;1012;17;1522.00;50
3474;16;22312024;3474;251;4488;4536;8.07;0.49;269.32;4.16;1014;17;1523.00;48
3477;16;22312040;3477;255;4491;4536;8.05;0.49;269.38;4.18;1014;17;1524.00;45
3479;16;22312054;3479;260;4491;4536;8.05;0.49;269.42;4.18;1012;17;1525.00;45
3480;16;22312074;3480;257;4492;4536;8.06;0.49;269.45;4.20;1012;17;1526.00;44
3483;16;22312088;3483;258;4495;4542;8.11;0.49;269.48;4.20;1012;17;1527.00;47
3486;16;22312103;3486;264;4499;4542;8.09;0.49;269.64;4.23;1013;17;1528.00;43
3487;16;22312122;3487;263;4499;4542;8.08;0.49;269.65;4.23;1012;17;1529.00;43
3489;16;22312138;3489;264;4505;4548;8.04;0.49;269.76;4.27;1016;17;1530.00;43
3490;16;22312153;3490;263;4508;4548;8.03;0.49;269.89;4.27;1018;17;1531.00;40
3493;16;22312167;3493;265;4509;4548;8.02;0.49;270.01;4.29;1016;17;1532.00;39
3497;16;22312181;3497;263;4512;4549;7.98;0.48;270.08;4.33;1015;17;1533.00;37
3499;16;22312195;3499;269;4516;4550;7.97;0.48;270.26;4.36;1017;17;1534.00;34
3502;16;22312208;3502;268;4517;4550;7.97;0.48;270.40;4.38;1015;17;1535.00;33
3508;16;22312222;3508;276;4527;4563;7.88;0.48;270.40;4.41;1019;17;1536.00;36
3511;16;22312238;3511;278;4530;4563;7.89;0.48;270.68;4.45;1019;17;1537.00;33
3514;16;22312251;3514;284;4532;4563;7.83;0.47;270.67;4.46;1018;17;1538.00;31
3515;16;22312266;3515;290;4535;4564;7.78;0.47;270.84;4.50;1020;17;1539.00;29
3516;16;22312279;3516;297;4539;4564;7.79;0.47;270.96;4.53;1023;17;1540.00;25
3520;16;22312294;3520;299;4543;4568;7.78;0.47;270.97;4.53;1023;17;1541.00;25
3521;16;22312317;3521;308;4547;4568;7.73;0.47;270.90;4.55;1026;17;1542.00;21
3523;16;22312331;3523;309;4551;4572;7.65;0.47;271.13;4.56;1028;17;1543.00;21
3525;16;22312347;3525;306;4551;4572;7.66;0.47;271.16;4.56;1026;17;1544.00;21
3528;16;22312361;3528;305;4552;4572;7.64;0.47;271.11;4.57;1024;17;1545.00;20
3530;16;22312375;3530;309;4552;4572;7.57;0.46;271.14;4.57;1022;17;1546.00;20
3533;16;22312389;3533;316;4556;4572;7.50;0.46;271.18;4.62;1023;17;1547.00;16
3536;16;22312404;3536;322;4564;4584;7.46;0.46;271.15;4.61;1028;17;1548.00;20
3538;16;22312418;3538;319;4565;4584;7.35;0.45;271.07;4.61;1027;17;1549.00;19
3541;16;22312433;3541;314;4567;4584;7.33;0.45;271.14;4.61;1026;17;1550.00;17
3545;16;22312447;3545;313;4570;4584;7.31;0.45;271.16;4.63;1025;17;1551.00;14
3547;16;22312461;3547;308;4572;4584;7.31;0.45;271.29;4.65;1025;17;1552.00;12
3549;16;22312474;3549;300;4575;4584;7.30;0.45;271.36;4.67;1026;17;1553.00;9
3551;16;22312488;3551;299;4576;4585;7.33;0.45;271.43;4.68;1025;17;1554.00;9
3552;16;22312504;3552;296;4579;4587;7.38;0.45;271.39;4.68;1027;17;1555.00;8
3554;17;22312521;3554;297;4587;4593;7.48;0.46;271.46;4.69;1033;18;1556.00;6
3555;17;22312553;3555;303;4588;4594;7.58;0.46;271.49;4.68;1033;18;1557.00;6
3559;17;22312570;3559;303;4589;4594;7.59;0.47;271.54;4.69;1030;18;1558.00;5
3563;17;22312587;3563;299;4590;4594;7.54;0.46;271.63;4.69;1027;18;1559.00;4
3567;17;22312611;3567;297;4594;4599;7.61;0.47;271.78;4.69;1027;18;1560.00;5
3571;17;22312630;3571;299;4596;4599;7.62;0.47;271.84;4.70;1025;18;1561.00;3
3576;17;22312655;3576;307;4597;4599;7.63;0.47;271.90;4.70;1021;18;1562.00;2
3580;17;22312679;3580;308;4598;4600;7.63;0.47;272.02;4.70;1018;18;1563.00;2
3587;17;22312698;3587;312;4601;4604;7.56;0.46;272.14;4.70;1014;18;1564.00;3
3592;17;22312715;3592;322;4602;4604;7.45;0.46;272.30;4.70;1010;18;1565.00;2
3596;17;22312732;3596;328;4605;4607;7.41;0.45;272.26;4.69;1009;18;1566.00;2
3604;17;22312748;3604;335;4606;4607;7.33;0.45;272.29;4.69;1002;18;1567.00;1
3610;17;22312763;3610;344;4607;4607;7.28;0.44;272.43;4.69;997;18;1568.00;0
3613;17;22312777;3613;346;4607;4607;7.25;0.44;272.35;4.69;994;18;1569.00;0
3618;18;22312788;3618;350;4611;4611;7.16;0.44;272.59;4.69;993;19;1570.00;0
3624;18;22312818;3624;353;4611;4611;7.02;0.43;272.53;4.69;987;19;1571.00;0
3628;18;22312831;3628;358;4611;4611;6.88;0.42;272.44;4.69;983;19;1572.00;0
3631;18;22312843;3631;364;4611;4611;6.68;0.41;272.51;4.69;980;19;1573.00;0
3635;18;22312859;3635;365;4612;4612;6.46;0.39;272.71;4.69;977;19;1574.00;0
3639;18;22312872;3639;361;4614;4614;6.25;0.38;272.72;4.69;975;19;1575.00;0
3643;18;22312885;3643;351;4614;4614;6.09;0.37;272.90;4.69;971;19;1576.00;0
3648;18;22312897;3648;347;4615;4615;5.90;0.36;273.11;4.69;967;19;1577.00;0
3650;18;22312915;3650;351;4615;4615;5.81;0.35;273.21;4.69;965;19;1578.00;0
3654;18;22312927;3654;343;4615;4615;5.74;0.35;273.18;4.69;961;19;1579.00;0
3658;18;22312938;3658;345;4615;4615;5.72;0.35;273.43;4.69;957;19;1580.00;0
3660;18;22312950;3660;342;4615;4615;5.76;0.35;273.46;4.69;955;19;1581.00;0
3665;18;22312962;3665;336;4615;4615;5.81;0.36;273.59;4.69;950;19;1582.00;0
3668;18;22312973;3668;331;4615;4615;5.86;0.36;273.75;4.69;947;19;1583.00;0
3669;18;22312985;3669;344;4687;4742;6.21;0.39;273.79;4.62;1018;19;1584.00;55
3673;18;22313008;3673;339;4691;4743;6.22;0.39;274.03;4.61;1018;19;1585.00;52
3673;18;22313021;3673;332;4701;4743;6.31;0.39;274.03;4.61;1028;19;1586.00;42
3679;18;22313034;3679;331;4705;4743;6.29;0.39;274.25;4.61;1026;19;1587.00;38
3681;18;22313047;3681;334;4712;4743;6.38;0.40;274.35;4.61;1031;19;1588.00;31
3687;18;22313058;3687;346;4716;4743;6.38;0.40;274.60;4.61;1029;19;1589.00;27
3690;18;22313073;3690;352;4718;4743;6.40;0.40;274.69;4.61;1028;19;1590.00;25
3696;18;22313086;3696;355;4721;4743;6.34;0.39;274.62;4.61;1025;19;1591.00;22
3700;18;22313100;3700;366;4724;4744;6.29;0.39;274.81;4.61;1024;19;1592.00;20
3704;18;22313113;3704;369;4726;4745;6.19;0.38;274.87;4.61;1022;19;1593.00;19
3707;18;22313126;3707;374;4730;4745;6.17;0.38;274.95;4.62;1023;19;1594.00;15
3712;18;22313138;3712;378;4733;4746;6.07;0.38;275.03;4.62;1021;19;1595.00;13
3716;18;22313153;3716;379;4736;4746;6.01;0.37;275.01;4.62;1020;19;1596.00;10
3719;18;22313166;3719;386;4736;4746;5.98;0.37;275.07;4.62;1017;19;1597.00;10
3724;18;22313183;3724;395;4741;4746;5.85;0.36;275.23;4.63;1017;19;1598.00;5
3728;18;22313200;3728;396;4743;4750;5.77;0.36;275.40;4.63;1015;19;1599.00;7
3730;18;22313218;3730;386;4744;4750;5.76;0.36;275.39;4.63;1014;19;1600.00;6
3736;18;22313238;3736;396;4745;4750;5.71;0.35;275.55;4.63;1009;19;1601.00;5
3741;18;22313254;3741;397;4746;4753;5.70;0.35;275.63;4.63;1005;19;1602.00;7
3747;18;22313270;3747;401;4747;4753;5.63;0.35;275.64;4.64;1000;19;1603.00;6
3752;18;22313286;3752;403;4748;4753;5.63;0.35;275.75;4.64;996;19;1604.00;5
3755;18;22313309;3755;406;4751;4757;5.67;0.35;275.87;4.64;996;19;1605.00;6
3762;18;22313325;3762;417;4753;4758;5.63;0.35;275.93;4.64;991;19;1606.00;5
3767;18;22313353;3767;418;4754;4758;5.60;0.34;275.88;4.64;987;19;1607.00;4
3771;18;22313369;3771;421;4758;4762;5.63;0.34;276.02;4.64;987;19;1608.00;4
3775;18;22313385;3775;424;4758;4762;5.62;0.34;275.96;4.64;983;19;1609.00;4
3780;18;22313401;3780;427;4758;4762;5.56;0.34;275.92;4.64;978;19;1610.00;4
3781;18;22313415;3781;429;4759;4763;5.54;0.34;275.86;4.64;978;19;1611.00;4
3781;18;22313428;3781;436;4760;4763;5.52;0.34;275.86;4.64;979;19;1612.00;3
3784;18;22313439;3784;442;4764;4769;5.53;0.34;275.96;4.63;980;19;1613.00;5
3787;18;22313451;3787;450;4764;4769;5.48;0.34;275.83;4.63;977;19;1614.00;5
3788;18;22313464;3788;451;4765;4770;5.49;0.34;275.81;4.63;977;19;1615.00;5
3790;18;22313476;3790;456;4765;4770;5.44;0.33;275.79;4.63;975;19;1616.00;5
3792;18;22313488;3792;461;4765;4770;5.42;0.33;275.70;4.63;973;19;1617.00;5
3792;18;22313501;3792;463;4765;4770;5.37;0.33;275.70;4.63;973;19;1618.00;5
3795;18;22313513;3795;468;4765;4770;5.29;0.33;275.68;4.63;970;19;1619.00;5
3799;18;22313525;3799;472;4793;4806;5.39;0.33;275.47;4.61;994;19;1620.00;13
3803;18;22313541;3803;468;4794;4806;5.35;0.33;275.47;4.60;991;19;1621.00;12
3806;18;22313553;3806;457;4796;4806;5.33;0.33;275.40;4.60;990;19;1622.00;10
3808;18;22313565;3808;456;4796;4806;5.32;0.33;275.40;4.60;988;19;1623.00;10
3811;18;22313576;3811;448;4797;4806;5.33;0.33;275.30;4.60;986;19;1624.00;9
3813;18;22313587;3813;448;4797;4806;5.35;0.33;275.35;4.60;984;19;1625.00;9
3814;18;22313601;3814;452;4801;4810;5.44;0.34;275.28;4.60;987;19;1626.00;9
3816;18;22313616;3816;455;4801;4810;5.48;0.34;275.31;4.60;985;19;1627.00;9
3818;18;22313632;3818;453;4805;4814;5.58;0.34;275.32;4.60;987;19;1628.00;9
3819;18;22313648;3819;454;4806;4815;5.61;0.34;275.35;4.60;987;19;1629.00;9
3820;18;22313663;3820;454;4806;4815;5.66;0.35;275.33;4.60;986;19;1630.00;9
3821;18;22313687;3821;440;4806;4815;5.66;0.35;275.27;4.60;985;19;1631.00;9
3821;18;22313704;3821;434;4817;4828;5.77;0.35;275.27;4.59;996;19;1632.00;11
3824;18;22313719;3824;427;4817;4828;5.79;0.35;275.28;4.59;993;19;1633.00;11
3824;18;22313736;3824;425;4817;4828;5.84;0.36;275.28;4.59;993;19;1634.00;11
3824;18;22313752;3824;418;4818;4829;5.91;0.36;275.28;4.59;994;19;1635.00;11
3825;18;22313769;3825;414;4818;4830;5.96;0.36;275.26;4.59;993;19;1636.00;12
3828;18;22313786;3828;397;4818;4830;6.02;0.37;275.36;4.59;990;19;1637.00;12
3828;18;22313803;3828;384;4820;4833;6.14;0.37;275.36;4.58;992;19;1638.00;13
3831;18;22313818;3831;374;4820;4833;6.20;0.38;275.55;4.58;989;19;1639.00;13
3831;18;22313833;3831;375;4821;4833;6.36;0.39;275.55;4.58;990;19;1640.00;12
3832;18;22313847;3832;365;4821;4833;6.49;0.40;275.55;4.58;989;19;1641.00;12
3834;19;22313860;3834;365;4826;4839;6.66;0.40;275.63;4.58;992;20;1642.00;13
3836;19;22313888;3836;356;4826;4839;6.72;0.41;275.59;4.58;990;20;1643.00;13
3839;19;22313909;3839;351;4826;4839;6.77;0.41;275.64;4.58;987;20;1644.00;13
3842;19;22313930;3842;349;4826;4839;6.83;0.41;275.64;4.58;984;20;1645.00;13
3843;19;22313944;3843;349;4829;4843;6.84;0.41;275.62;4.58;986;20;1646.00;14
3844;19;22313958;3844;345;4830;4844;6.90;0.42;275.64;4.58;986;20;1647.00;14
3846;19;22313972;3846;340;4830;4844;6.93;0.42;275.56;4.58;984;20;1648.00;14
3848;19;22313989;3848;336;4831;4845;6.95;0.42;275.55;4.58;983;20;1649.00;14
3849;19;22314017;3849;335;4831;4845;6.96;0.42;275.55;4.58;982;20;1650.00;14
3849;19;22314058;3849;335;4831;4845;6.98;0.42;275.55;4.58;982;20;1651.00;14
3850;19;22314074;3850;337;4831;4845;7.00;0.42;275.50;4.58;981;20;1652.00;14
3853;19;22314091;3853;329;4831;4845;7.05;0.43;275.52;4.58;978;20;1653.00;14
3854;19;22314108;3854;328;4831;4845;7.09;0.43;275.56;4.58;977;20;1654.00;14
3855;19;22314123;3855;321;4831;4845;7.16;0.43;275.55;4.58;976;20;1655.00;14
3857;19;22314141;3857;333;4869;4915;7.17;0.43;275.54;4.54;1012;20;1656.00;46
3859;19;22314165;3859;319;4869;4916;7.25;0.44;275.62;4.54;1010;20;1657.00;47
3859;19;22314190;3859;313;4876;4916;7.40;0.45;275.62;4.54;1017;20;1658.00;40
3863;19;22314206;3863;316;4878;4916;7.43;0.45;275.91;4.54;1015;20;1659.00;38
3865;19;22314221;3865;315;4881;4916;7.49;0.46;275.91;4.54;1016;20;1660.00;35
3866;19;22314235;3866;317;4883;4916;7.53;0.46;276.01;4.54;1017;20;1661.00;33
3869;19;22314249;3869;318;4885;4916;7.56;0.46;276.16;4.54;1016;20;1662.00;31
3870;19;22314263;3870;319;4888;4916;7.62;0.46;276.24;4.54;1018;20;1663.00;28
3873;19;22314276;3873;324;4890;4917;7.65;0.46;276.31;4.54;1017;20;1664.00;27
3875;19;22314298;3875;324;4894;4919;7.64;0.46;276.33;4.54;1019;20;1665.00;25
3880;19;22314313;3880;325;4896;4919;7.65;0.46;276.49;4.54;1016;20;1666.00;23
3880;19;22314328;3880;321;4900;4923;7.70;0.47;276.49;4.54;1020;20;1667.00;23
3882;19;22314341;3882;314;4901;4923;7.74;0.47;276.56;4.54;1019;20;1668.00;22
3885;19;22314355;3885;313;4902;4923;7.81;0.47;276.80;4.54;1017;20;1669.00;21
3891;19;22314370;3891;308;4903;4923;7.83;0.47;276.82;4.54;1012;20;1670.00;20
3894;19;22314384;3894;312;4907;4929;7.95;0.48;276.97;4.54;1013;20;1671.00;22
3895;19;22314405;3895;310;4907;4929;7.98;0.48;277.01;4.54;1012;20;1672.00;22
3898;19;22314419;3898;311;4907;4929;8.01;0.49;277.18;4.54;1009;20;1673.00;22
3902;19;22314434;3902;311;4909;4932;8.09;0.49;277.34;4.54;1007;20;1674.00;23
3906;19;22314449;3906;300;4909;4932;8.04;0.49;277.47;4.54;1003;20;1675.00;23
3909;19;22314463;3909;301;4910;4932;7.97;0.48;277.59;4.54;1001;20;1676.00;22
3912;19;22314477;3912;303;4910;4933;7.91;0.48;277.79;4.54;998;20;1677.00;23
3913;19;22314490;3913;306;4911;4934;7.82;0.47;277.85;4.54;998;20;1678.00;23
3921;19;22314504;3921;297;4911;4934;7.66;0.47;278.24;4.54;990;20;1679.00;23
3924;19;22314521;3924;300;4931;4960;7.55;0.46;278.38;4.54;1007;20;1680.00;29
3930;19;22314542;3930;286;4932;4960;7.50;0.46;278.40;4.54;1002;20;1681.00;28
3931;19;22314559;3931;280;4933;4960;7.52;0.46;278.40;4.54;1002;20;1682.00;27
3937;19;22314578;3937;275;4935;4961;7.47;0.45;278.47;4.54;998;20;1683.00;26
3939;19;22314596;3939;276;4935;4961;7.48;0.45;278.48;4.54;996;20;1684.00;26
3941;19;22314613;3941;277;4938;4965;7.56;0.46;278.57;4.53;997;20;1685.00;27
3942;19;22314631;3942;271;4938;4965;7.59;0.46;278.57;4.53;996;20;1686.00;27
3943;19;22314648;3943;272;4941;4969;7.64;0.46;278.55;4.53;998;20;1687.00;28
3946;19;22314664;3946;270;4941;4969;7.70;0.47;278.67;4.53;995;20;1688.00;28
3951;19;22314681;3951;267;4941;4969;7.76;0.47;278.80;4.53;990;20;1689.00;28
3952;19;22314699;3952;262;4941;4969;7.86;0.48;278.81;4.53;989;20;1690.00;28
3954;19;22314715;3954;260;4941;4969;7.90;0.48;278.76;4.53;987;20;1691.00;28
3960;19;22314737;3960;258;4951;4981;7.97;0.48;278.76;4.52;991;20;1692.00;30
3961;19;22314752;3961;259;4952;4981;8.03;0.49;278.71;4.52;991;20;1693.00;29
3964;19;22314767;3964;257;4952;4981;8.08;0.49;278.68;4.52;988;20;1694.00;29
3965;19;22314780;3965;257;4953;4981;8.12;0.49;278.64;4.54;988;20;1695.00;28
3967;19;22314794;3967;262;4953;4981;8.06;0.49;278.59;4.54;986;20;1696.00;28
3970;19;22314807;3970;257;4954;4981;8.03;0.49;278.66;4.56;984;20;1697.00;27
3971;19;22314821;3971;258;4955;4982;8.02;0.49;278.69;4.56;984;20;1698.00;27
3972;19;22314836;3972;258;4955;4982;8.00;0.48;278.72;4.56;983;20;1699.00;27
3972;19;22314850;3972;246;4960;4988;8.02;0.49;278.72;4.56;988;20;1700.00;28
3973;19;22314868;3973;243;4963;4989;7.96;0.48;278.73;4.59;990;20;1701.00;26
3974;19;22314882;3974;246;4964;4989;7.97;0.48;278.86;4.59;990;20;1702.00;25
3975;19;22314897;3975;252;4966;4989;7.92;0.48;278.79;4.59;991;20;1703.00;23
3977;19;22314912;3977;256;4968;4993;7.92;0.48;278.89;4.59;991;20;1704.00;25
3981;19;22314930;3981;261;4971;4993;7.83;0.48;278.83;4.62;990;20;1705.00;22
3984;19;22314947;3984;265;4971;4993;7.84;0.48;278.86;4.62;987;20;1706.00;22
3989;19;22314964;3989;267;4974;4994;7.84;0.48;278.86;4.65;985;20;1707.00;20
3990;19;22314982;3990;270;4977;4998;7.83;0.48;278.87;4.65;987;20;1708.00;21
3992;19;22315001;3992;273;4978;4998;7.89;0.48;278.84;4.67;986;20;1709.00;20
3994;19;22315019;3994;275;4983;5004;7.96;0.49;278.92;4.67;989;20;1710.00;21
3998;19;22315038;3998;275;4985;5004;8.00;0.49;279.04;4.69;987;20;1711.00;19
3999;19;22315055;3999;272;4987;5004;8.00;0.49;279.00;4.69;988;20;1712.00;17
4001;19;22315071;4001;275;4988;5004;7.97;0.49;279.05;4.71;987;20;1713.00;16
4009;19;22315098;4009;283;4994;5008;7.91;0.48;279.22;4.72;985;20;1714.00;14
4013;19;22315116;4013;284;4994;5008;7.87;0.48;279.24;4.72;981;20;1715.00;14
4016;19;22315131;4016;285;4995;5008;7.88;0.48;279.45;4.74;979;20;1716.00;13
4020;19;22315146;4020;281;4995;5008;7.82;0.48;279.53;4.74;975;20;1717.00;13
4025;19;22315158;4025;287;4996;5009;7.79;0.47;279.62;4.75;971;20;1718.00;13
4026;19;22315172;4026;291;4997;5010;7.79;0.47;279.58;4.75;971;20;1719.00;13
4028;19;22315191;4028;291;4998;5010;7.74;0.47;279.82;4.76;970;20;1720.00;12
4030;19;22315211;4030;299;4999;5011;7.72;0.47;279.85;4.76;969;20;1721.00;12
4031;19;22315225;4031;296;5000;5011;7.68;0.47;279.94;4.78;969;20;1722.00;11
4033;19;22315237;4033;296;5001;5011;7.59;0.46;280.04;4.79;968;20;1723.00;10
4036;19;22315250;4036;299;5002;5011;7.56;0.46;280.10;4.80;966;20;1724.00;9
4038;19;22315263;4038;302;5002;5011;7.64;0.47;280.23;4.80;964;20;1725.00;9
4042;19;22315276;4042;298;5005;5011;7.64;0.47;280.39;4.82;963;20;1726.00;6
4046;19;22315288;4046;295;5005;5011;7.65;0.47;280.45;4.82;959;20;1727.00;6
4049;19;22315302;4049;312;5075;5138;7.77;0.48;280.43;4.77;1026;20;1728.00;63
4053;19;22315325;4053;299;5078;5139;7.82;0.48;280.60;4.76;1025;20;1729.00;61
4056;19;22315338;4056;297;5087;5139;7.88;0.49;280.62;4.77;1031;20;1730.00;52
4059;19;22315353;4059;290;5090;5139;7.84;0.48;280.54;4.77;1031;20;1731.00;49
4062;19;22315368;4062;290;5095;5139;7.85;0.48;280.58;4.77;1033;20;1732.00;44
4066;19;22315384;4066;286;5097;5139;7.74;0.48;280.60;4.78;1031;20;1733.00;42
4069;19;22315401;4069;287;5101;5139;7.72;0.47;280.72;4.78;1032;20;1734.00;38
4071;19;22315416;4071;293;5104;5139;7.64;0.47;280.86;4.78;1033;20;1735.00;35
4075;19;22315433;4075;291;5107;5140;7.58;0.46;280.98;4.79;1032;20;1736.00;33
4077;19;22315451;4077;292;5111;5141;7.50;0.46;281.02;4.79;1034;20;1737.00;30
4080;19;22315468;4080;298;5114;5141;7.46;0.46;281.00;4.79;1034;20;1738.00;27
4081;19;22315484;4081;298;5117;5142;7.44;0.46;280.98;4.80;1036;20;1739.00;25
4086;19;22315503;4086;305;5123;5142;7.24;0.44;280.94;4.80;1037;20;1740.00;19
4090;19;22315518;4090;307;5125;5142;7.10;0.44;280.84;4.81;1035;20;1741.00;17
4091;19;22315534;4091;320;5128;5142;6.98;0.43;280.85;4.81;1037;20;1742.00;14
4095;19;22315549;4095;327;5134;5146;6.86;0.42;280.79;4.82;1039;20;1743.00;12
4100;19;22315565;4100;337;5137;5146;6.76;0.42;280.78;4.82;1037;20;1744.00;9
4103;19;22315581;4103;346;5138;5146;6.71;0.41;280.88;4.82;1035;20;1745.00;8
4106;19;22315597;4106;350;5139;5149;6.68;0.41;281.08;4.82;1033;20;1746.00;10
4109;19;22315612;4109;368;5140;5149;6.62;0.41;280.97;4.82;1031;20;1747.00;9
4114;19;22315624;4114;376;5142;5149;6.50;0.40;281.15;4.83;1028;20;1748.00;7
4119;19;22315637;4119;383;5145;5153;6.31;0.39;281.10;4.83;1026;20;1749.00;8
4124;19;22315649;4124;371;5148;5154;6.18;0.38;281.09;4.83;1024;20;1750.00;6
4129;19;22315668;4129;369;5151;5154;6.05;0.37;281.19;4.84;1022;20;1751.00;3
4131;19;22315681;4131;369;5156;5158;5.98;0.37;281.17;4.84;1025;20;1752.00;2
4134;19;22315692;4134;366;5156;5158;5.91;0.36;281.10;4.84;1022;20;1753.00;2
4137;19;22315705;4137;367;5156;5158;5.86;0.36;281.21;4.84;1019;20;1754.00;2
4139;19;22315718;4139;365;5158;5160;5.78;0.35;281.17;4.84;1019;20;1755.00;2
4143;19;22315731;4143;369;5158;5160;5.71;0.35;281.27;4.84;1015;20;1756.00;2
4145;19;22315743;4145;365;5165;5166;5.72;0.35;281.38;4.83;1020;20;1757.00;1
4149;19;22315755;4149;361;5165;5166;5.71;0.35;281.44;4.83;1016;20;1758.00;1
4152;19;22315768;4152;363;5166;5167;5.71;0.35;281.52;4.83;1014;20;1759.00;1
4156;19;22315780;4156;365;5167;5167;5.73;0.35;281.62;4.83;1011;20;1760.00;0
4161;19;22315790;4161;366;5167;5167;5.66;0.35;281.78;4.83;1006;20;1761.00;0
4163;19;22315803;4163;362;5167;5167;5.61;0.34;281.85;4.83;1004;20;1762.00;0
4168;19;22315816;4168;363;5167;5167;5.53;0.34;281.91;4.83;999;20;1763.00;0
4172;19;22315828;4172;375;5178;5179;5.55;0.34;281.92;4.82;1006;20;1764.00;1
4176;19;22315840;4176;379;5179;5179;5.53;0.34;281.94;4.82;1003;20;1765.00;0
4179;19;22315852;4179;380;5179;5179;5.51;0.34;282.04;4.82;1000;20;1766.00;0
4180;19;22315864;4180;398;5179;5179;5.51;0.34;282.06;4.82;999;20;1767.00;0
4182;19;22315875;4182;395;5179;5179;5.55;0.34;282.09;4.82;997;20;1768.00;0
4186;19;22315887;4186;397;5179;5179;5.53;0.34;282.17;4.82;993;20;1769.00;0
4189;19;22315902;4189;405;5183;5183;5.54;0.34;282.21;4.82;994;20;1770.00;0
4195;19;22315914;4195;407;5183;5183;5.46;0.34;282.18;4.82;988;20;1771.00;0
4197;19;22315926;4197;407;5187;5187;5.48;0.34;282.17;4.81;990;20;1772.00;0
4201;19;22315939;4201;410;5188;5188;5.48;0.34;282.11;4.81;987;20;1773.00;0
4204;19;22315951;4204;412;5188;5188;5.44;0.34;282.11;4.81;984;20;1774.00;0
4205;19;22315964;4205;420;5188;5188;5.47;0.34;282.06;4.81;983;20;1775.00;0
4207;19;22315975;4207;421;5199;5201;5.54;0.34;282.01;4.80;992;20;1776.00;2
4212;19;22315988;4212;419;5199;5201;5.48;0.34;281.87;4.80;987;20;1777.00;2
4214;19;22316001;4214;414;5199;5201;5.50;0.34;281.88;4.80;985;20;1778.00;2
4219;19;22316013;4219;420;5200;5202;5.47;0.34;281.86;4.80;981;20;1779.00;2
4224;19;22316025;4224;426;5200;5203;5.40;0.33;281.69;4.80;976;20;1780.00;3
4229;19;22316037;4229;432;5200;5203;5.36;0.33;281.70;4.80;971;20;1781.00;3
4233;19;22316049;4233;437;5202;5206;5.42;0.33;281.60;4.80;969;20;1782.00;4
4239;19;22316062;4239;436;5202;5206;5.37;0.33;281.54;4.80;963;20;1783.00;4
4241;19;22316073;4241;440;5203;5206;5.32;0.33;281.50;4.80;962;20;1784.00;3
4244;19;22316086;4244;444;5203;5206;5.31;0.33;281.54;4.80;959;20;1785.00;3
4248;19;22316101;4248;452;5208;5212;5.33;0.33;281.52;4.80;960;20;1786.00;4
4253;19;22316115;4253;458;5208;5212;5.26;0.32;281.49;4.80;955;20;1787.00;4
4256;19;22316129;4256;454;5208;5212;5.21;0.32;281.60;4.80;952;20;1788.00;4
4257;19;22316143;4257;454;5208;5212;5.24;0.32;281.63;4.80;951;20;1789.00;4
4258;19;22316156;4258;462;5211;5216;5.31;0.33;281.64;4.79;953;20;1790.00;5
4262;19;22316170;4262;467;5212;5217;5.28;0.32;281.53;4.79;950;20;1791.00;5
4264;19;22316185;4264;478;5212;5217;5.26;0.32;281.55;4.79;948;20;1792.00;5
4272;19;22316200;4272;475;5213;5218;5.19;0.32;281.78;4.79;941;20;1793.00;5
4276;19;22316213;4276;466;5213;5218;5.17;0.31;281.77;4.79;937;20;1794.00;5
4277;19;22316225;4277;450;5213;5218;5.14;0.31;281.78;4.79;936;20;1795.00;5
4278;19;22316240;4278;447;5213;5218;5.17;0.31;281.78;4.79;935;20;1796.00;5
4280;19;22316255;4280;432;5213;5218;5.20;0.31;281.76;4.79;933;20;1797.00;5
4281;19;22316270;4281;417;5213;5218;5.28;0.32;281.82;4.79;932;20;1798.00;5
4282;19;22316285;4282;403;5213;5218;5.39;0.33;281.81;4.79;931;20;1799.00;5
4282;19;22316303;4282;422;5293;5356;5.81;0.36;281.81;4.72;1011;20;1800.00;63
4284;19;22316349;4284;411;5296;5357;5.88;0.36;281.84;4.72;1012;20;1801.00;61
4284;19;22316367;4284;403;5305;5357;5.99;0.37;281.84;4.71;1021;20;1802.00;52
4285;19;22316382;4285;397;5308;5357;6.07;0.37;281.86;4.71;1023;20;1803.00;49
4286;19;22316404;4286;388;5313;5357;6.16;0.38;281.85;4.71;1027;20;1804.00;44
4286;19;22316419;4286;393;5313;5357;6.23;0.38;281.85;4.71;1027;20;1805.00;44
4286;19;22316433;4286;373;5319;5357;6.28;0.38;281.85;4.71;1033;20;1806.00;38
4288;19;22316448;4288;364;5323;5357;6.28;0.38;281.91;4.72;1035;20;1807.00;34
4288;19;22316463;4288;356;5329;5358;6.34;0.39;281.91;4.72;1041;20;1808.00;29
4291;19;22316476;4291;349;5332;5359;6.34;0.39;282.00;4.72;1041;20;1809.00;27
4291;19;22316491;4291;349;5335;5359;6.36;0.39;282.00;4.72;1044;20;1810.00;24
4292;19;22316507;4292;348;5339;5363;6.42;0.39;282.02;4.72;1047;20;1811.00;24
4292;19;22316521;4292;356;5340;5363;6.51;0.40;282.02;4.72;1048;20;1812.00;23
4293;19;22316535;4293;349;5341;5363;6.59;0.40;282.00;4.72;1048;20;1813.00;22
4294;19;22316550;4294;361;5342;5363;6.61;0.40;282.05;4.73;1048;20;1814.00;21
4296;19;22316564;4296;362;5347;5369;6.67;0.41;282.08;4.72;1051;20;1815.00;22
4299;19;22316587;4299;364;5347;5369;6.71;0.41;282.36;4.72;1048;20;1816.00;22
4300;19;22316603;4300;371;5347;5369;6.71;0.41;282.40;4.72;1047;20;1817.00;22
4302;19;22316619;4302;360;5349;5372;6.72;0.41;282.49;4.72;1047;20;1818.00;23
4304;19;22316634;4304;351;5350;5372;6.77;0.41;282.57;4.72;1046;20;1819.00;22
4307;19;22316648;4307;346;5350;5372;6.82;0.41;282.58;4.72;1043;20;1820.00;22
4307;19;22316663;4307;330;5350;5373;6.85;0.42;282.58;4.72;1043;20;1821.00;23
4309;19;22316678;4309;329;5351;5374;6.96;0.42;282.56;4.72;1042;20;1822.00;23
4314;19;22316692;4314;325;5352;5374;6.99;0.43;282.71;4.73;1038;20;1823.00;22
4316;19;22316710;4316;322;5360;5387;7.07;0.43;282.74;4.72;1044;20;1824.00;27
4318;19;22316726;4318;319;5362;5387;7.17;0.44;282.75;4.72;1044;20;1825.00;25
4322;19;22316745;4322;319;5362;5387;7.27;0.44;282.85;4.72;1040;20;1826.00;25
4323;19;22316771;4323;322;5364;5388;7.31;0.45;282.85;4.73;1041;20;1827.00;24
4327;19;22316790;4327;322;5365;5388;7.36;0.45;282.98;4.73;1038;20;1828.00;23
4329;19;22316810;4329;321;5368;5392;7.40;0.45;283.00;4.72;1039;20;1829.00;24
4332;19;22316832;4332;322;5368;5392;7.43;0.45;283.05;4.72;1036;20;1830.00;24
4337;19;22316852;4337;327;5374;5396;7.40;0.45;283.21;4.72;1037;20;1831.00;22
4338;19;22316871;4338;328;5374;5396;7.45;0.46;283.29;4.72;1036;20;1832.00;22
4341;19;22316890;4341;327;5374;5396;7.45;0.46;283.42;4.72;1033;20;1833.00;22
4342;19;22316910;4342;327;5375;5396;7.49;0.46;283.48;4.73;1033;20;1834.00;21
4348;19;22316928;4348;331;5375;5396;7.45;0.46;283.53;4.73;1027;20;1835.00;21
4351;19;22316949;4351;339;5384;5408;7.41;0.45;283.63;4.72;1033;20;1836.00;24
4354;19;22316968;4354;346;5384;5408;7.39;0.45;283.65;4.72;1030;20;1837.00;24
4356;19;22316986;4356;343;5386;5408;7.45;0.45;283.63;4.72;1030;20;1838.00;22
4358;19;22317010;4358;345;5386;5408;7.38;0.45;283.74;4.72;1028;20;1839.00;22
4361;19;22317026;4361;339;5386;5408;7.35;0.45;283.72;4.72;1025;20;1840.00;22
4364;19;22317041;4364;331;5386;5408;7.34;0.45;283.92;4.72;1022;20;1841.00;22
4367;19;22317055;4367;325;5386;5409;7.26;0.44;283.98;4.72;1019;20;1842.00;23
4370;19;22317070;4370;324;5386;5409;7.26;0.44;284.14;4.72;1016;20;1843.00;23
4371;19;22317083;4371;317;5391;5415;7.21;0.44;284.23;4.71;1020;20;1844.00;24
4374;19;22317104;4374;318;5393;5417;7.20;0.44;284.28;4.71;1019;20;1845.00;24
4378;19;22317119;4378;310;5393;5417;7.16;0.44;284.30;4.71;1015;20;1846.00;24
4384;19;22317133;4384;310;5393;5417;7.08;0.43;284.36;4.71;1009;20;1847.00;24
4386;19;22317147;4386;306;5396;5421;7.16;0.44;284.44;4.71;1010;20;1848.00;25
4391;19;22317160;4391;305;5396;5421;7.20;0.44;284.53;4.71;1005;20;1849.00;25
4394;19;22317174;4394;303;5396;5421;7.19;0.44;284.73;4.71;1002;20;1850.00;25
4398;19;22317187;4398;301;5397;5422;7.20;0.44;284.82;4.71;999;20;1851.00;25
4400;19;22317202;4400;299;5400;5426;7.18;0.44;284.86;4.71;1000;20;1852.00;26
4402;19;22317216;4402;292;5400;5426;7.18;0.44;284.85;4.71;998;20;1853.00;26
4408;19;22317229;4408;284;5402;5429;7.19;0.44;285.01;4.71;994;20;1854.00;27
4408;19;22317243;4408;275;5403;5429;7.28;0.44;285.01;4.71;995;20;1855.00;26
4411;19;22317256;4411;270;5403;5429;7.28;0.44;285.11;4.71;992;20;1856.00;26
4416;19;22317270;4416;262;5405;5429;7.27;0.44;285.18;4.73;989;20;1857.00;24
4421;19;22317283;4421;256;5409;5433;7.32;0.45;285.35;4.73;988;20;1858.00;24
4423;19;22317298;4423;247;5409;5433;7.39;0.45;285.40;4.73;986;20;1859.00;24
4427;19;22317314;4427;241;5409;5433;7.39;0.45;285.50;4.73;982;20;1860.00;24
4431;19;22317329;4431;248;5409;5433;7.38;0.45;285.66;4.73;978;20;1861.00;24
4432;19;22317343;4432;241;5409;5434;7.39;0.45;285.72;4.73;977;20;1862.00;25
4435;19;22317356;4435;240;5410;5435;7.43;0.45;285.66;4.73;975;20;1863.00;25
4439;19;22317370;4439;234;5410;5435;7.37;0.45;285.70;4.73;971;20;1864.00;25
4443;19;22317384;4443;235;5411;5436;7.38;0.45;285.76;4.73;968;20;1865.00;25
4446;19;22317398;4446;239;5411;5436;7.39;0.45;285.96;4.73;965;20;1866.00;25
4448;19;22317410;4448;239;5411;5436;7.36;0.45;286.08;4.73;963;20;1867.00;25
4450;19;22317431;4450;240;5411;5436;7.37;0.45;286.17;4.73;961;20;1868.00;25
4453;20;22317444;4453;238;5411;5436;7.40;0.45;286.20;4.73;958;21;1869.00;25
4455;20;22317473;4455;241;5411;5436;7.49;0.46;286.20;4.73;956;21;1870.00;25
4458;20;22317487;4458;232;5411;5436;7.54;0.46;286.43;4.73;953;21;1871.00;25
4460;20;22317501;4460;250;5479;5563;7.62;0.47;286.41;4.68;1019;21;1872.00;84
4463;20;22317526;4463;235;5481;5564;7.71;0.47;286.48;4.68;1018;21;1873.00;83
4466;20;22317540;4466;229;5487;5564;7.78;0.48;286.46;4.68;1021;21;1874.00;77
4468;20;22317554;4468;224;5490;5564;7.75;0.48;286.50;4.68;1022;21;1875.00;74
4469;20;22317569;4469;225;5494;5564;7.80;0.48;286.49;4.68;1025;21;1876.00;70
4471;20;22317582;4471;232;5499;5564;7.82;0.48;286.61;4.68;1028;21;1877.00;65
4475;20;22317597;4475;227;5503;5564;7.82;0.48;286.56;4.68;1028;21;1878.00;61
4479;20;22317610;4479;225;5503;5564;7.86;0.48;286.75;4.68;1024;21;1879.00;61
4481;20;22317625;4481;231;5508;5565;7.92;0.49;286.81;4.70;1027;21;1880.00;57
4483;20;22317639;4483;228;5512;5566;7.94;0.49;286.77;4.72;1029;21;1881.00;54
4486;20;22317653;4486;226;5518;5568;7.91;0.48;286.82;4.74;1032;21;1882.00;50
4488;20;22317668;4488;230;5524;5569;7.88;0.48;286.91;4.76;1036;21;1883.00;45
4490;20;22317681;4490;233;5528;5569;7.82;0.48;286.88;4.76;1038;21;1884.00;41
4492;20;22317695;4492;233;5532;5569;7.74;0.47;286.89;4.78;1040;21;1885.00;37
4493;20;22317708;4493;240;5534;5569;7.74;0.47;286.84;4.78;1041;21;1886.00;35
4495;20;22317728;4495;251;5540;5573;7.71;0.47;286.95;4.80;1045;21;1887.00;33
4497;20;22317741;4497;251;5540;5573;7.69;0.47;287.06;4.80;1043;21;1888.00;33
4505;20;22317755;4505;260;5543;5573;7.58;0.46;286.94;4.83;1038;21;1889.00;30
4506;20;22317778;4506;270;5547;5579;7.55;0.46;286.93;4.83;1041;21;1890.00;32
4511;20;22317792;4511;280;5549;5579;7.45;0.46;286.90;4.83;1038;21;1891.00;30
4513;20;22317806;4513;286;5550;5579;7.35;0.45;286.94;4.85;1037;21;1892.00;29
4515;20;22317821;4515;289;5553;5583;7.31;0.45;286.92;4.85;1038;21;1893.00;30
4516;20;22317835;4516;287;5554;5584;7.25;0.44;286.96;4.85;1038;21;1894.00;30
4520;20;22317848;4520;289;5556;5584;7.19;0.44;286.94;4.86;1036;21;1895.00;28
4523;20;22317862;4523;292;5560;5588;7.19;0.44;287.10;4.86;1037;21;1896.00;28
4526;20;22317875;4526;297;5561;5588;7.15;0.44;287.09;4.86;1035;21;1897.00;27
4530;20;22317889;4530;303;5561;5588;7.11;0.43;287.18;4.86;1031;21;1898.00;27
4533;20;22317904;4533;300;5567;5589;7.03;0.43;287.36;4.93;1034;21;1899.00;22
4535;20;22317919;4535;303;5567;5589;7.00;0.43;287.44;4.93;1032;21;1900.00;22
4536;20;22317937;4536;304;5575;5595;7.02;0.43;287.47;4.97;1039;21;1901.00;20
4539;20;22317951;4539;304;5576;5595;6.99;0.43;287.55;4.97;1037;21;1902.00;19
4544;20;22317966;4544;308;5576;5596;6.95;0.43;287.69;4.97;1032;21;1903.00;20
4544;20;22317979;4544;314;5580;5596;6.90;0.42;287.69;5.01;1036;21;1904.00;16
4544;20;22317991;4544;310;5580;5596;6.90;0.42;287.69;5.01;1036;21;1905.00;16
4548;20;22318005;4548;318;5580;5596;6.86;0.42;287.68;5.01;1032;21;1906.00;16
4551;20;22318018;4551;321;5581;5596;6.85;0.42;287.70;5.02;1030;21;1907.00;15
4556;20;22318031;4556;328;5593;5608;6.81;0.42;287.69;5.02;1037;21;1908.00;15
4557;20;22318045;4557;334;5594;5608;6.78;0.42;287.66;5.03;1037;21;1909.00;14
4560;20;22318056;4560;336;5594;5608;6.77;0.41;287.75;5.03;1034;21;1910.00;14
4565;20;22318069;4565;348;5596;5608;6.75;0.41;287.78;5.04;1031;21;1911.00;12
4571;20;22318082;4571;357;5596;5608;6.73;0.41;287.76;5.04;1025;21;1912.00;12
4573;20;22318095;4573;360;5597;5608;6.73;0.41;287.92;5.05;1024;21;1913.00;11
4575;20;22318107;4575;366;5601;5612;6.64;0.40;287.95;5.05;1026;21;1914.00;11
4581;20;22318120;4581;371;5601;5612;6.53;0.40;288.04;5.05;1020;21;1915.00;11
4583;20;22318132;4583;372;5607;5616;6.45;0.39;288.15;5.06;1024;21;1916.00;9
4586;20;22318143;4586;383;5608;5617;6.32;0.39;288.30;5.06;1022;21;1917.00;9
4587;20;22318154;4587;385;5609;5617;6.26;0.38;288.43;5.07;1022;21;1918.00;8
4593;20;22318165;4593;385;5609;5617;6.17;0.38;288.53;5.07;1016;21;1919.00;8
4599;20;22318179;4599;390;5632;5646;6.05;0.37;288.46;5.05;1033;21;1920.00;14
4602;20;22318192;4602;388;5633;5646;5.94;0.37;288.44;5.05;1031;21;1921.00;13
4608;20;22318205;4608;390;5636;5646;5.88;0.36;288.36;5.04;1028;21;1922.00;10
4613;20;22318218;4613;401;5637;5647;5.76;0.35;288.30;5.04;1024;21;1923.00;10
4614;20;22318231;4614;396;5637;5648;5.69;0.35;288.32;5.04;1023;21;1924.00;11
4620;20;22318245;4620;383;5637;5648;5.61;0.35;288.15;5.04;1017;21;1925.00;11
4624;20;22318258;4624;387;5640;5651;5.56;0.34;288.09;5.04;1016;21;1926.00;11
4627;20;22318273;4627;378;5640;5651;5.55;0.34;288.06;5.04;1013;21;1927.00;11
4632;20;22318288;4632;377;5640;5651;5.47;0.34;287.99;5.04;1008;21;1928.00;11
4634;20;22318303;4634;375;5640;5651;5.44;0.33;288.01;5.04;1006;21;1929.00;11
4638;20;22318316;4638;375;5644;5657;5.47;0.34;287.85;5.04;1006;21;1930.00;13
4643;20;22318332;4643;383;5644;5657;5.42;0.33;287.86;5.04;1001;21;1931.00;13
4645;20;22318346;4645;381;5644;5657;5.37;0.33;287.89;5.04;999;21;1932.00;13
4648;20;22318358;4648;381;5645;5657;5.29;0.32;287.92;5.04;997;21;1933.00;12
4653;20;22318373;4653;378;5648;5661;5.27;0.32;287.77;5.04;995;21;1934.00;13
4658;20;22318388;4658;371;5650;5663;5.23;0.32;287.85;5.03;992;21;1935.00;13
4662;20;22318403;4662;367;5650;5663;5.21;0.32;287.78;5.03;988;21;1936.00;13
4664;20;22318416;4664;379;5651;5664;5.25;0.32;287.82;5.03;987;21;1937.00;13
4665;20;22318431;4665;377;5651;5664;5.28;0.32;287.83;5.03;986;21;1938.00;13
4670;20;22318446;4670;379;5651;5664;5.22;0.32;287.66;5.03;981;21;1939.00;13
4673;20;22318458;4673;382;5651;5664;5.20;0.32;287.64;5.03;978;21;1940.00;13
4675;20;22318472;4675;393;5651;5664;5.21;0.32;287.70;5.03;976;21;1941.00;13
4675;20;22318487;4675;388;5651;5664;5.21;0.32;287.70;5.03;976;21;1942.00;13
4677;20;22318501;4677;386;5651;5664;5.22;0.32;287.82;5.03;974;21;1943.00;13
4681;20;22318516;4681;399;5691;5734;5.25;0.32;287.90;5.00;1010;21;1944.00;43
4683;20;22318538;4683;407;5693;5735;5.22;0.32;287.87;5.00;1010;21;1945.00;42
4684;20;22318554;4684;409;5698;5735;5.24;0.32;287.84;4.99;1014;21;1946.00;37
4689;20;22318569;4689;404;5702;5735;5.27;0.32;288.03;4.99;1013;21;1947.00;33
4693;20;22318585;4693;418;5705;5735;5.28;0.32;287.90;4.99;1012;21;1948.00;30
4696;20;22318600;4696;420;5707;5735;5.27;0.32;288.01;4.99;1011;21;1949.00;28
4701;20;22318617;4701;419;5712;5737;5.24;0.32;288.14;4.99;1011;21;1950.00;25
4704;20;22318634;4704;408;5714;5737;5.27;0.32;288.16;4.99;1010;21;1951.00;23
4707;20;22318649;4707;398;5715;5738;5.26;0.32;288.24;4.99;1008;21;1952.00;23
4708;20;22318664;4708;393;5719;5739;5.29;0.32;288.27;4.99;1011;21;1953.00;20
4710;20;22318679;4710;387;5720;5739;5.29;0.32;288.32;4.99;1010;21;1954.00;19
4712;20;22318694;4712;382;5724;5743;5.36;0.33;288.28;4.99;1012;21;1955.00;19
4718;20;22318708;4718;381;5725;5743;5.37;0.33;288.26;4.99;1007;21;1956.00;18
4722;20;22318721;4722;381;5725;5743;5.38;0.33;288.15;4.99;1003;21;1957.00;18
4729;20;22318734;4729;384;5725;5743;5.39;0.33;288.13;4.99;996;21;1958.00;18
4733;20;22318747;4733;384;5730;5749;5.46;0.33;288.06;4.99;997;21;1959.00;19
4735;20;22318759;4735;381;5730;5749;5.51;0.34;288.10;4.99;995;21;1960.00;19
4739;20;22318772;4739;383;5730;5749;5.53;0.34;288.14;4.99;991;21;1961.00;19
4742;20;22318785;4742;387;5732;5752;5.62;0.34;288.20;4.99;990;21;1962.00;20
4744;20;22318798;4744;383;5732;5752;5.68;0.35;288.21;4.99;988;21;1963.00;20
4746;20;22318811;4746;388;5733;5752;5.77;0.35;288.25;4.99;987;21;1964.00;19
4748;20;22318823;4748;389;5733;5753;5.75;0.35;288.23;4.99;985;21;1965.00;20
4749;20;22318841;4749;391;5734;5754;5.83;0.36;288.26;4.99;985;21;1966.00;20
4751;20;22318854;4751;396;5734;5754;5.82;0.36;288.15;4.99;983;21;1967.00;20
4753;20;22318867;4753;400;5745;5767;5.93;0.36;288.19;4.98;992;21;1968.00;22
4756;20;22318881;4756;405;5745;5767;5.96;0.36;288.09;4.98;989;21;1969.00;22
4757;20;22318894;4757;407;5745;5767;5.97;0.36;288.09;4.98;988;21;1970.00;22
4758;20;22318905;4758;408;5746;5768;6.02;0.37;288.05;4.98;988;21;1971.00;22
4760;20;22318918;4760;395;5746;5768;6.03;0.37;288.06;4.98;986;21;1972.00;22
4762;20;22318932;4762;384;5750;5772;6.07;0.37;288.16;4.97;988;21;1973.00;22
4763;20;22318946;4763;381;5750;5772;6.12;0.37;288.14;4.97;987;21;1974.00;22
4766;20;22318957;4766;378;5753;5776;6.14;0.37;288.26;4.97;987;21;1975.00;23
4769;20;22318972;4769;377;5753;5776;6.19;0.38;288.26;4.97;984;21;1976.00;23
4769;20;22318986;4769;380;5753;5776;6.20;0.38;288.26;4.97;984;21;1977.00;23
4775;20;22319000;4775;371;5753;5776;6.21;0.38;288.43;4.97;978;21;1978.00;23
4776;20;22319013;4776;370;5753;5776;6.23;0.38;288.41;4.97;977;21;1979.00;23
4781;20;22319028;4781;372;5781;5810;6.39;0.39;288.41;4.95;1000;21;1980.00;29
4783;20;22319050;4783;352;5781;5810;6.45;0.39;288.48;4.95;998;21;1981.00;29
4784;20;22319063;4784;348;5783;5810;6.60;0.40;288.44;4.95;999;21;1982.00;27
4788;20;22319077;4788;341;5783;5810;6.68;0.41;288.66;4.95;995;21;1983.00;27
4789;20;22319089;4789;334;5784;5810;6.81;0.42;288.66;4.95;995;21;1984.00;26
4791;20;22319103;4791;328;5784;5810;6.80;0.42;288.74;4.95;993;21;1985.00;26
4793;20;22319124;4793;325;5784;5811;6.82;0.42;288.73;4.95;991;21;1986.00;27
4795;20;22319138;4795;333;5784;5811;6.78;0.41;288.86;4.95;989;21;1987.00;27
4801;20;22319152;4801;335;5789;5817;6.71;0.41;288.99;4.94;988;21;1988.00;28
4804;20;22319172;4804;347;5790;5818;6.68;0.41;289.07;4.94;986;21;1989.00;28
4808;20;22319187;4808;350;5790;5818;6.64;0.40;289.23;4.94;982;21;1990.00;28
4810;20;22319201;4810;357;5790;5818;6.63;0.40;289.35;4.94;980;21;1991.00;28
4813;20;22319215;4813;352;5793;5822;6.64;0.40;289.44;4.94;980;21;1992.00;29
4814;20;22319229;4814;351;5793;5822;6.62;0.40;289.54;4.94;979;21;1993.00;29
4818;20;22319241;4818;353;5793;5822;6.61;0.40;289.57;4.94;975;21;1994.00;29
4820;20;22319255;4820;346;5794;5823;6.59;0.40;289.58;4.94;974;21;1995.00;29
4822;20;22319269;4822;343;5797;5827;6.55;0.40;289.60;4.94;975;21;1996.00;30
4825;20;22319282;4825;342;5797;5827;6.45;0.39;289.72;4.94;972;21;1997.00;30
4827;20;22319295;4827;342;5799;5830;6.38;0.39;289.82;4.93;972;21;1998.00;31
4829;20;22319307;4829;340;5799;5830;6.36;0.39;290.04;4.93;970;21;1999.00;31
4831;20;22319321;4831;338;5800;5830;6.35;0.39;290.11;4.93;969;21;2000.00;30
4832;20;22319338;4832;342;5800;5830;6.36;0.39;290.10;4.93;968;21;2001.00;30
4833;20;22319351;4833;341;5804;5834;6.41;0.39;290.15;4.93;971;21;2002.00;30
4834;20;22319364;4834;336;5804;5834;6.48;0.39;290.13;4.93;970;21;2003.00;30
4836;20;22319377;4836;330;5804;5834;6.54;0.40;290.14;4.93;968;21;2004.00;30
4838;21;22319396;4838;337;5804;5834;6.53;0.40;290.19;4.93;966;22;2005.00;30
4843;21;22319422;4843;345;5804;5835;6.54;0.40;290.31;4.93;961;22;2006.00;31
4844;21;22319436;4844;339;5805;5836;6.57;0.40;290.28;4.93;961;22;2007.00;31
4845;21;22319448;4845;345;5805;5836;6.55;0.40;290.28;4.93;960;22;2008.00;31
4848;21;22319461;4848;339;5806;5837;6.55;0.40;290.22;4.93;958;22;2009.00;31
4849;21;22319475;4849;345;5806;5837;6.55;0.40;290.22;4.93;957;22;2010.00;31
4852;21;22319487;4852;352;5806;5837;6.55;0.40;290.34;4.93;954;22;2011.00;31
4854;21;22319508;4854;349;5806;5837;6.57;0.40;290.31;4.93;952;22;2012.00;31
4857;21;22319522;4857;350;5806;5837;6.57;0.40;290.36;4.93;949;22;2013.00;31
4859;21;22319535;4859;355;5806;5837;6.54;0.40;290.44;4.93;947;22;2014.00;31
4863;21;22319547;4863;351;5806;5837;6.49;0.39;290.60;4.93;943;22;2015.00;31
4865;21;22319559;4865;380;5879;5964;6.42;0.40;290.68;4.87;1014;22;2016.00;85
4866;21;22319582;4866;354;5879;5965;6.50;0.40;290.66;4.87;1013;22;2017.00;86
4867;22;22319596;4867;347;5884;5965;6.56;0.40;290.69;4.87;1017;23;2018.00;81
4868;22;22319624;4868;342;5887;5965;6.71;0.41;290.75;4.87;1019;23;2019.00;78
4870;22;22319637;4870;338;5892;5965;6.78;0.42;290.79;4.87;1022;23;2020.00;73
4875;22;22319651;4875;338;5894;5965;6.83;0.42;291.02;4.87;1019;23;2021.00;71
4876;22;22319665;4876;335;5897;5965;6.91;0.42;291.02;4.87;1021;23;2022.00;68
4878;22;22319677;4878;335;5899;5965;7.00;0.43;291.13;4.87;1021;23;2023.00;66
4879;22;22319696;4879;332;5901;5966;7.09;0.43;291.17;4.87;1022;23;2024.00;65
4880;22;22319712;4880;335;5907;5968;7.08;0.43;291.20;4.87;1027;23;2025.00;61
4882;22;22319725;4882;322;5909;5968;7.11;0.43;291.25;4.87;1027;23;2026.00;59
4885;22;22319738;4885;323;5911;5969;7.05;0.43;291.35;4.87;1026;23;2027.00;58
4886;22;22319757;4886;321;5913;5969;7.00;0.43;291.38;4.88;1027;23;2028.00;56
4888;22;22319771;4888;310;5918;5969;6.92;0.42;291.39;4.91;1030;23;2029.00;51
4891;22;22319786;4891;310;5921;5969;6.83;0.42;291.48;4.93;1030;23;2030.00;48
4894;22;22319801;4894;300;5924;5973;6.72;0.41;291.55;4.93;1030;23;2031.00;49
4896;22;22319816;4896;299;5924;5973;6.70;0.41;291.54;4.93;1028;23;2032.00;49
4898;22;22319829;4898;297;5927;5973;6.70;0.41;291.61;4.94;1029;23;2033.00;46
4898;22;22319843;4898;295;5929;5976;6.78;0.41;291.61;4.94;1031;23;2034.00;47
4900;22;22319856;4900;290;5929;5976;6.79;0.42;291.74;4.94;1029;23;2035.00;47
4901;22;22319871;4901;299;5930;5976;6.89;0.42;291.75;4.94;1029;23;2036.00;46
4902;22;22319885;4902;297;5934;5980;6.99;0.43;291.72;4.94;1032;23;2037.00;46
4906;22;22319900;4906;292;5936;5981;7.09;0.43;291.98;4.94;1030;23;2038.00;45
4908;22;22319914;4908;290;5936;5981;7.16;0.44;291.98;4.94;1028;23;2039.00;45
4913;22;22319930;4913;292;5940;5986;7.28;0.44;292.15;4.94;1027;23;2040.00;46
4914;22;22319950;4914;286;5941;5986;7.37;0.45;292.19;4.94;1027;23;2041.00;45
4919;22;22319965;4919;287;5942;5986;7.36;0.45;292.26;4.94;1023;23;2042.00;44
4924;22;22319981;4924;284;5943;5987;7.38;0.45;292.37;4.94;1019;23;2043.00;44
4928;22;22319996;4928;281;5943;5987;7.38;0.45;292.50;4.94;1015;23;2044.00;44
4931;22;22320022;4931;280;5947;5993;7.44;0.45;292.55;4.94;1016;23;2045.00;46
4935;22;22320036;4935;276;5948;5993;7.42;0.45;292.57;4.96;1013;23;2046.00;45
4938;22;22320051;4938;275;5948;5994;7.40;0.45;292.61;4.96;1010;23;2047.00;46
4938;22;22320065;4938;278;5948;5994;7.33;0.44;292.61;4.96;1010;23;2048.00;46
4941;22;22320079;4941;279;5949;5994;7.22;0.44;292.56;4.99;1008;23;2049.00;45
4945;22;22320092;4945;277;5949;5994;7.12;0.43;292.66;4.99;1004;23;2050.00;45
4945;22;22320116;4945;280;5951;5994;7.09;0.43;292.66;5.01;1006;23;2051.00;43
4949;22;22320130;4949;275;5961;6006;7.08;0.43;292.72;5.00;1012;23;2052.00;45
4950;22;22320147;4950;281;5962;6006;7.08;0.43;292.69;5.01;1012;23;2053.00;44
4956;22;22320160;4956;287;5965;6006;7.03;0.43;292.70;5.04;1009;23;2054.00;41
4958;22;22320174;4958;293;5967;6006;6.98;0.42;292.70;5.06;1009;23;2055.00;39
4959;22;22320189;4959;298;5968;6006;6.96;0.42;292.80;5.06;1009;23;2056.00;38
4961;22;22320203;4961;304;5969;6006;7.00;0.43;292.70;5.09;1008;23;2057.00;37
4964;22;22320218;4964;306;5972;6010;6.95;0.42;292.63;5.10;1008;23;2058.00;38
4966;22;22320233;4966;317;5972;6010;6.91;0.42;292.68;5.10;1006;23;2059.00;38
4967;22;22320248;4967;321;5979;6014;7.00;0.42;292.66;5.13;1012;23;2060.00;35
4970;22;22320264;4970;327;5980;6015;6.97;0.42;292.85;5.13;1010;23;2061.00;35
4970;22;22320277;4970;328;5981;6015;6.93;0.42;292.85;5.15;1011;23;2062.00;34
4972;22;22320289;4972;335;5982;6015;6.89;0.42;292.89;5.17;1010;23;2063.00;33
4977;22;22320303;4977;342;5995;6028;6.85;0.42;292.87;5.21;1018;23;2064.00;33
4979;22;22320320;4979;346;5995;6028;6.85;0.42;292.91;5.21;1016;23;2065.00;33
4982;22;22320339;4982;345;5997;6028;6.77;0.41;293.11;5.24;1015;23;2066.00;31
4983;22;22320352;4983;349;5998;6029;6.75;0.41;293.10;5.24;1015;23;2067.00;31
4987;22;22320372;4987;356;6000;6030;6.69;0.41;293.14;5.27;1013;23;2068.00;30
4988;22;22320391;4988;352;6000;6030;6.67;0.41;293.15;5.27;1012;23;2069.00;30
4991;22;22320406;4991;355;6006;6036;6.67;0.41;293.22;5.31;1015;23;2070.00;30
4992;22;22320421;4992;360;6006;6036;6.66;0.41;293.30;5.31;1014;23;2071.00;30
4995;22;22320433;4995;368;6010;6036;6.64;0.41;293.45;5.35;1015;23;2072.00;26
4998;22;22320446;4998;377;6010;6036;6.60;0.40;293.50;5.35;1012;23;2073.00;26
4999;22;22320457;4999;378;6016;6042;6.67;0.41;293.54;5.35;1017;23;2074.00;26
5003;22;22320471;5003;375;6017;6042;6.66;0.41;293.75;5.37;1014;23;2075.00;25
5004;22;22320485;5004;378;6018;6042;6.61;0.41;293.71;5.37;1014;23;2076.00;24
5008;22;22320499;5008;380;6018;6042;6.47;0.40;293.81;5.37;1010;23;2077.00;24
5010;22;22320512;5010;380;6023;6046;6.40;0.39;293.85;5.39;1013;23;2078.00;23
5011;22;22320525;5011;385;6024;6047;6.38;0.39;293.81;5.39;1013;23;2079.00;23
5017;22;22320538;5017;389;6024;6047;6.28;0.39;293.83;5.39;1007;23;2080.00;23
5017;22;22320552;5017;389;6026;6048;6.21;0.38;293.83;5.41;1009;23;2081.00;22
5019;22;22320565;5019;388;6026;6048;6.15;0.38;293.82;5.41;1007;23;2082.00;22
5024;22;22320577;5024;387;6029;6048;6.07;0.37;293.74;5.45;1005;23;2083.00;19
5025;22;22320589;5025;390;6029;6048;6.08;0.37;293.78;5.45;1004;23;2084.00;19
5027;22;22320602;5027;396;6029;6048;6.04;0.37;293.71;5.45;1002;23;2085.00;19
5029;22;22320615;5029;396;6030;6048;6.04;0.37;293.71;5.47;1001;23;2086.00;18
5031;22;22320628;5031;392;6030;6048;6.01;0.37;293.73;5.47;999;23;2087.00;18
5034;22;22320640;5034;401;6072;6118;6.15;0.38;293.70;5.47;1038;23;2088.00;46
5036;22;22320659;5036;400;6074;6119;6.09;0.38;293.64;5.47;1038;23;2089.00;45
5038;22;22320672;5038;401;6080;6119;6.08;0.38;293.63;5.47;1042;23;2090.00;39
5045;22;22320684;5045;405;6084;6119;5.91;0.36;293.45;5.48;1039;23;2091.00;35
5048;22;22320697;5048;406;6086;6119;5.78;0.35;293.43;5.48;1038;23;2092.00;33
5053;22;22320708;5053;414;6089;6119;5.69;0.35;293.37;5.49;1036;23;2093.00;30
5056;22;22320720;5056;411;6091;6119;5.60;0.34;293.31;5.49;1035;23;2094.00;28
5061;22;22320733;5061;413;6093;6119;5.51;0.34;293.22;5.49;1032;23;2095.00;26
5066;22;22320745;5066;423;6098;6120;5.38;0.33;293.11;5.53;1032;23;2096.00;22
5070;22;22320756;5070;423;6099;6121;5.30;0.32;293.06;5.53;1029;23;2097.00;22
5073;22;22320769;5073;433;6100;6121;5.17;0.32;293.12;5.53;1027;23;2098.00;21
5077;22;22320781;5077;448;6105;6125;5.04;0.31;293.05;5.54;1028;23;2099.00;20
5082;22;22320795;5082;442;6110;6140;4.93;0.30;293.09;5.53;1028;23;2100.00;30
5086;22;22320814;5086;442;6111;6140;4.84;0.30;292.95;5.54;1025;23;2101.00;29
5087;22;22320825;5087;438;6112;6140;4.83;0.30;292.95;5.54;1025;23;2102.00;28
5088;22;22320837;5088;438;6116;6146;4.83;0.30;292.98;5.54;1028;23;2103.00;30
5090;22;22320849;5090;445;6117;6146;4.82;0.30;293.03;5.54;1027;23;2104.00;29
5091;22;22320858;5091;441;6118;6146;4.83;0.30;293.07;5.54;1027;23;2105.00;28
5094;22;22320870;5094;441;6122;6149;4.81;0.29;293.04;5.54;1028;23;2106.00;27
5097;22;22320881;5097;445;6122;6149;4.79;0.29;293.09;5.54;1025;23;2107.00;27
5100;22;22320892;5100;426;6123;6149;4.83;0.30;293.10;5.54;1023;23;2108.00;26
5102;22;22320904;5102;416;6124;6150;4.86;0.30;293.07;5.54;1022;23;2109.00;26
5103;22;22320916;5103;405;6126;6151;4.93;0.30;293.10;5.54;1023;23;2110.00;25
5105;22;22320927;5105;396;6127;6151;4.99;0.31;293.08;5.54;1022;23;2111.00;24
5108;22;22320939;5108;388;6137;6164;5.06;0.31;293.10;5.53;1029;23;2112.00;27
5112;22;22320952;5112;382;6137;6164;5.11;0.31;293.06;5.53;1025;23;2113.00;27
5116;23;22320966;5116;383;6138;6164;5.20;0.32;292.97;5.53;1022;24;2114.00;26
5121;23;22320990;5121;377;6140;6166;5.28;0.32;293.01;5.53;1019;24;2115.00;26
5125;23;22321004;5125;385;6141;6166;5.37;0.33;293.14;5.53;1016;24;2116.00;25
5127;23;22321023;5127;382;6144;6170;5.51;0.34;293.10;5.53;1017;24;2117.00;26
5129;23;22321037;5129;386;6145;6170;5.57;0.34;293.15;5.53;1016;24;2118.00;25
5131;23;22321055;5131;390;6148;6174;5.63;0.34;293.13;5.53;1017;24;2119.00;26
5134;23;22321068;5134;392;6148;6174;5.68;0.35;293.10;5.53;1014;24;2120.00;26
5138;23;22321080;5138;395;6148;6174;5.76;0.35;293.23;5.53;1010;24;2121.00;26
5141;23;22321094;5141;394;6149;6174;5.78;0.35;293.27;5.53;1008;24;2122.00;25
5144;23;22321107;5144;394;6149;6174;5.77;0.35;293.21;5.53;1005;24;2123.00;25
5146;23;22321121;5146;403;6159;6186;5.87;0.36;293.14;5.53;1013;24;2124.00;27
5148;23;22321143;5148;400;6161;6186;5.91;0.36;293.16;5.53;1013;24;2125.00;25
5151;23;22321156;5151;404;6162;6186;5.95;0.36;293.14;5.53;1011;24;2126.00;24
5152;23;22321171;5152;404;6162;6186;6.01;0.37;293.16;5.53;1010;24;2127.00;24
5154;23;22321184;5154;408;6162;6186;6.06;0.37;293.17;5.53;1008;24;2128.00;24
5156;23;22321198;5156;404;6162;6186;6.12;0.37;293.21;5.53;1006;24;2129.00;24
5160;23;22321212;5160;401;6164;6187;6.09;0.37;293.18;5.53;1004;24;2130.00;23
5162;23;22321225;5162;404;6164;6187;6.09;0.37;293.19;5.53;1002;24;2131.00;23
5168;23;22321238;5168;403;6170;6193;6.07;0.37;293.14;5.53;1002;24;2132.00;23
5173;23;22321252;5173;404;6170;6194;6.07;0.37;293.14;5.53;997;24;2133.00;24
5177;23;22321267;5177;411;6171;6194;6.01;0.37;293.06;5.53;994;24;2134.00;23
5183;23;22321279;5183;406;6171;6194;5.92;0.36;293.08;5.53;988;24;2135.00;23
5187;23;22321291;5187;406;6174;6198;5.89;0.36;293.22;5.53;987;24;2136.00;24
5192;23;22321305;5192;408;6174;6198;5.88;0.36;293.47;5.53;982;24;2137.00;24
5197;23;22321318;5197;403;6174;6198;5.86;0.36;293.43;5.53;977;24;2138.00;24
5201;23;22321331;5201;406;6175;6199;5.92;0.36;293.37;5.53;974;24;2139.00;24
5206;23;22321344;5206;404;6178;6203;5.97;0.36;293.49;5.52;972;24;2140.00;25
5207;23;22321356;5207;399;6178;6203;5.99;0.36;293.50;5.52;971;24;2141.00;25
5212;23;22321369;5212;406;6180;6206;5.99;0.36;293.62;5.52;968;24;2142.00;26
5213;23;22321382;5213;414;6180;6206;6.01;0.37;293.70;5.52;967;24;2143.00;26
5215;23;22321394;5215;413;6181;6206;6.04;0.37;293.80;5.52;966;24;2144.00;25
5218;23;22321407;5218;418;6181;6206;5.94;0.36;293.94;5.52;963;24;2145.00;25
5221;23;22321421;5221;419;6185;6210;5.94;0.36;294.00;5.52;964;24;2146.00;25
5224;23;22321435;5224;407;6185;6210;5.95;0.36;294.00;5.52;961;24;2147.00;25
5225;23;22321447;5225;404;6185;6210;5.98;0.36;294.05;5.52;960;24;2148.00;25
5227;23;22321460;5227;396;6185;6210;5.98;0.36;294.05;5.52;958;24;2149.00;25
5229;23;22321472;5229;392;6185;6211;6.02;0.37;294.13;5.52;956;24;2150.00;26
5232;23;22321484;5232;383;6186;6212;6.12;0.37;294.23;5.52;954;24;2151.00;26
5233;23;22321497;5233;384;6186;6212;6.20;0.38;294.25;5.52;953;24;2152.00;26
5236;23;22321509;5236;378;6187;6213;6.26;0.38;294.34;5.52;951;24;2153.00;26
5237;23;22321523;5237;383;6187;6213;6.33;0.38;294.32;5.52;950;24;2154.00;26
5241;23;22321536;5241;383;6187;6213;6.38;0.39;294.41;5.52;946;24;2155.00;26
5246;23;22321548;5246;372;6187;6213;6.36;0.39;294.52;5.52;941;24;2156.00;26
5248;23;22321560;5248;368;6187;6213;6.43;0.39;294.54;5.52;939;24;2157.00;26
5249;23;22321573;5249;357;6187;6213;6.48;0.39;294.59;5.52;938;24;2158.00;26
5250;23;22321586;5250;352;6187;6213;6.49;0.39;294.72;5.52;937;24;2159.00;26
5252;23;22321601;5252;402;6310;6443;6.57;0.41;294.79;5.41;1058;24;2160.00;133
5255;23;22321635;5255;394;6314;6444;6.59;0.41;294.94;5.41;1059;24;2161.00;130
5256;23;22321649;5256;371;6324;6444;6.66;0.42;295.01;5.40;1068;24;2162.00;120
5256;23;22321662;5256;373;6330;6444;6.67;0.42;295.01;5.40;1074;24;2163.00;114
5260;23;22321675;5260;369;6338;6444;6.66;0.41;295.04;5.40;1078;24;2164.00;106
5262;23;22321688;5262;373;6342;6444;6.54;0.41;295.09;5.40;1080;24;2165.00;102
5262;23;22321703;5262;372;6351;6444;6.43;0.40;295.09;5.40;1089;24;2166.00;93
5265;23;22321723;5265;369;6355;6444;6.39;0.40;295.26;5.40;1090;24;2167.00;89
5266;23;22321737;5266;369;6359;6445;6.41;0.40;295.29;5.40;1093;24;2168.00;86
5276;23;22321751;5276;366;6366;6446;6.39;0.40;295.48;5.41;1090;24;2169.00;80
5278;23;22321766;5278;374;6371;6446;6.37;0.40;295.49;5.41;1093;24;2170.00;75
5281;23;22321781;5281;376;6373;6447;6.34;0.39;295.48;5.41;1092;24;2171.00;74
5284;23;22321795;5284;377;6376;6447;6.34;0.39;295.56;5.41;1092;24;2172.00;71
5285;23;22321808;5285;383;6379;6447;6.28;0.39;295.65;5.42;1094;24;2173.00;68
5288;23;22321822;5288;391;6383;6447;6.18;0.38;295.68;5.42;1095;24;2174.00;64
5291;23;22321836;5291;392;6386;6451;6.05;0.37;295.74;5.42;1095;24;2175.00;65
5291;23;22321850;5291;389;6386;6451;6.06;0.38;295.74;5.42;1095;24;2176.00;65
5293;23;22321864;5293;394;6388;6451;6.00;0.37;295.87;5.42;1095;24;2177.00;63
5295;23;22321877;5295;404;6389;6454;5.98;0.37;295.81;5.42;1094;24;2178.00;65
5297;23;22321892;5297;410;6390;6454;6.02;0.37;295.84;5.43;1093;24;2179.00;64
5299;23;22321906;5299;405;6390;6454;6.01;0.37;295.82;5.43;1091;24;2180.00;64
5302;23;22321921;5302;404;6394;6458;6.00;0.37;295.91;5.43;1092;24;2181.00;64
5305;23;22321936;5305;403;6395;6459;6.00;0.37;295.91;5.42;1090;24;2182.00;64
5309;23;22321950;5309;399;6396;6459;5.96;0.37;295.85;5.43;1087;24;2183.00;63
5309;23;22321972;5309;401;6400;6463;5.99;0.37;295.85;5.43;1091;24;2184.00;63
5312;23;22321992;5312;402;6401;6463;5.99;0.37;295.94;5.43;1089;24;2185.00;62
5314;23;22322006;5314;394;6401;6463;6.01;0.37;295.98;5.43;1087;24;2186.00;62
5314;23;22322021;5314;393;6401;6464;6.04;0.37;295.98;5.43;1087;24;2187.00;63
5316;23;22322035;5316;398;6401;6464;6.05;0.37;296.04;5.43;1085;24;2188.00;63
5317;23;22322049;5317;402;6405;6470;6.07;0.37;296.07;5.43;1088;24;2189.00;65
5319;23;22322071;5319;401;6407;6470;6.12;0.37;296.07;5.43;1088;24;2190.00;63
5319;23;22322085;5319;387;6407;6471;6.20;0.38;296.07;5.43;1088;24;2191.00;64
5320;23;22322100;5320;383;6407;6471;6.32;0.39;296.15;5.43;1087;24;2192.00;64
5320;23;22322114;5320;379;6409;6471;6.38;0.39;296.15;5.44;1089;24;2193.00;62
5321;23;22322129;5321;375;6409;6471;6.41;0.39;296.16;5.44;1088;24;2194.00;62
5325;23;22322143;5325;370;6410;6471;6.42;0.39;296.32;5.44;1085;24;2195.00;61
5329;23;22322158;5329;372;6420;6483;6.48;0.39;296.33;5.44;1091;24;2196.00;63
5332;23;22322173;5332;371;6421;6483;6.51;0.40;296.42;5.44;1089;24;2197.00;62
5336;23;22322201;5336;370;6423;6483;6.51;0.40;296.51;5.45;1087;24;2198.00;60
5339;23;22322220;5339;369;6424;6483;6.57;0.40;296.61;5.46;1085;24;2199.00;59
5340;23;22322238;5340;366;6425;6483;6.60;0.40;296.71;5.46;1085;24;2200.00;58
5344;23;22322259;5344;362;6427;6483;6.59;0.40;296.89;5.46;1083;24;2201.00;56
5344;23;22322277;5344;362;6430;6487;6.54;0.40;296.89;5.46;1086;24;2202.00;57
5346;23;22322296;5346;360;6431;6487;6.46;0.39;296.89;5.46;1085;24;2203.00;56
5349;23;22322312;5349;353;6434;6491;6.37;0.39;296.92;5.46;1085;24;2204.00;57
5351;23;22322330;5351;359;6437;6493;6.27;0.38;296.90;5.45;1086;24;2205.00;56
5357;23;22322350;5357;346;6439;6493;6.15;0.37;297.00;5.50;1082;24;2206.00;54
5362;23;22322366;5362;347;6439;6493;6.07;0.37;297.18;5.50;1077;24;2207.00;54
5363;23;22322383;5363;343;6448;6506;6.05;0.37;297.22;5.50;1085;24;2208.00;58
5370;23;22322402;5370;340;6448;6506;5.99;0.36;297.30;5.50;1078;24;2209.00;58
5372;23;22322424;5372;341;6450;6508;6.01;0.37;297.39;5.49;1078;24;2210.00;58
5373;23;22322442;5373;328;6451;6509;6.07;0.37;297.45;5.49;1078;24;2211.00;58
5375;23;22322458;5375;319;6451;6510;6.10;0.37;297.54;5.49;1076;24;2212.00;59
5377;23;22322474;5377;315;6451;6510;6.18;0.38;297.58;5.49;1074;24;2213.00;59
5379;23;22322491;5379;311;6453;6513;6.22;0.38;297.68;5.49;1074;24;2214.00;60
5380;23;22322508;5380;313;6454;6513;6.31;0.38;297.69;5.49;1074;24;2215.00;59
5384;23;22322524;5384;314;6454;6513;6.34;0.39;297.73;5.49;1070;24;2216.00;59
5387;23;22322541;5387;319;6454;6513;6.40;0.39;297.86;5.49;1067;24;2217.00;59
5389;23;22322557;5389;314;6459;6519;6.44;0.39;297.93;5.49;1070;24;2218.00;60
5393;24;22322574;5393;312;6459;6519;6.41;0.39;298.04;5.49;1066;25;2219.00;60
5396;24;22322611;5396;320;6459;6519;6.38;0.39;298.14;5.49;1063;25;2220.00;60
5398;24;22322630;5398;317;6459;6519;6.33;0.38;298.19;5.49;1061;25;2221.00;60
5399;24;22322644;5399;317;6463;6523;6.28;0.38;298.25;5.49;1064;25;2222.00;60
5401;24;22322656;5401;322;6464;6524;6.26;0.38;298.25;5.49;1063;25;2223.00;60
5404;24;22322670;5404;317;6464;6524;6.21;0.38;298.23;5.49;1060;25;2224.00;60
5405;24;22322683;5405;325;6466;6525;6.15;0.38;298.27;5.50;1061;25;2225.00;59
5407;24;22322697;5407;317;6466;6525;6.09;0.37;298.28;5.50;1059;25;2226.00;59
5410;24;22322709;5410;328;6467;6525;6.04;0.37;298.34;5.51;1057;25;2227.00;58
5411;24;22322723;5411;335;6467;6525;6.02;0.37;298.30;5.51;1056;25;2228.00;58
5413;24;22322736;5413;344;6468;6525;6.02;0.37;298.25;5.52;1055;25;2229.00;57
5414;24;22322749;5414;344;6470;6525;6.03;0.37;298.22;5.56;1056;25;2230.00;55
5416;24;22322762;5416;342;6471;6525;6.03;0.37;298.21;5.57;1055;25;2231.00;54
5420;24;22322774;5420;351;6505;6595;6.23;0.38;298.11;5.57;1085;25;2232.00;90
5421;24;22322795;5421;342;6509;6596;6.24;0.38;298.07;5.60;1088;25;2233.00;87
5425;24;22322807;5425;343;6517;6596;6.31;0.39;298.09;5.62;1092;25;2234.00;79
5428;24;22322821;5428;346;6524;6596;6.29;0.39;297.99;5.68;1096;25;2235.00;72
5432;24;22322835;5432;353;6529;6596;6.26;0.38;298.03;5.72;1097;25;2236.00;67
5432;24;22322848;5432;353;6530;6596;6.21;0.38;298.03;5.73;1098;25;2237.00;66
5434;24;22322861;5434;358;6537;6596;6.12;0.37;297.96;5.76;1103;25;2238.00;59
5436;24;22322874;5436;365;6537;6596;6.03;0.37;297.91;5.76;1101;25;2239.00;59
5439;24;22322887;5439;371;6541;6597;5.93;0.36;297.85;5.77;1102;25;2240.00;56
5442;24;22322902;5442;374;6546;6598;5.84;0.36;297.78;5.79;1104;25;2241.00;52
5445;24;22322921;5445;387;6549;6598;5.76;0.35;297.66;5.80;1104;25;2242.00;49
5446;24;22322935;5446;390;6556;6602;5.69;0.35;297.62;5.80;1110;25;2243.00;46
5449;24;22322948;5449;390;6558;6602;5.57;0.34;297.51;5.82;1109;25;2244.00;44
5452;24;22322962;5452;396;6559;6602;5.49;0.34;297.43;5.82;1107;25;2245.00;43
5453;24;22322976;5453;401;6560;6602;5.46;0.34;297.38;5.84;1107;25;2246.00;42
5455;24;22322995;5455;410;6565;6608;5.46;0.34;297.33;5.84;1110;25;2247.00;43
5457;24;22323010;5457;421;6565;6608;5.41;0.33;297.37;5.84;1108;25;2248.00;43
5458;24;22323022;5458;426;6565;6608;5.39;0.33;297.32;5.84;1107;25;2249.00;43
5458;24;22323037;5458;431;6574;6614;5.38;0.33;297.32;5.94;1116;25;2250.00;40
5460;24;22323051;5460;428;6575;6614;5.30;0.33;297.28;5.94;1115;25;2251.00;39
5460;24;22323064;5460;426;6576;6614;5.29;0.33;297.28;5.94;1116;25;2252.00;38
5460;24;22323077;5460;432;6576;6615;5.24;0.32;297.28;5.94;1116;25;2253.00;39
5464;24;22323089;5464;426;6577;6616;5.22;0.32;297.25;5.93;1113;25;2254.00;39
5467;24;22323102;5467;436;6577;6616;5.25;0.32;297.21;5.93;1110;25;2255.00;39
5467;24;22323116;5467;442;6592;6629;5.30;0.33;297.21;6.02;1125;25;2256.00;37
5468;24;22323133;5468;447;6592;6629;5.34;0.33;297.19;6.02;1124;25;2257.00;37
5471;24;22323150;5471;444;6595;6629;5.38;0.33;297.04;6.05;1124;25;2258.00;34
5472;24;22323166;5472;440;6596;6630;5.43;0.33;296.99;6.05;1124;25;2259.00;34
5473;24;22323182;5473;443;6596;6630;5.43;0.33;297.08;6.05;1123;25;2260.00;34
5476;24;22323200;5476;442;6602;6634;5.42;0.33;297.07;6.08;1126;25;2261.00;32
5481;24;22323218;5481;446;6602;6634;5.34;0.33;296.95;6.08;1121;25;2262.00;32
5481;24;22323241;5481;453;6606;6638;5.32;0.32;296.95;6.10;1125;25;2263.00;32
5484;24;22323258;5484;463;6607;6638;5.18;0.32;296.97;6.11;1123;25;2264.00;31
5487;24;22323274;5487;456;6607;6638;5.07;0.31;296.89;6.11;1120;25;2265.00;31
5489;24;22323290;5489;454;6609;6638;5.01;0.31;296.98;6.14;1120;25;2266.00;29
5495;24;22323306;5495;448;6609;6638;4.90;0.30;296.95;6.14;1114;25;2267.00;29
5496;24;22323322;5496;449;6620;6650;4.91;0.30;296.92;6.15;1124;25;2268.00;30
5500;24;22323340;5500;449;6621;6650;4.88;0.30;296.90;6.15;1121;25;2269.00;29
5504;24;22323356;5504;451;6621;6650;4.89;0.30;296.87;6.15;1117;25;2270.00;29
5505;24;22323372;5505;446;6622;6650;4.87;0.30;296.90;6.17;1117;25;2271.00;28
5508;24;22323395;5508;449;6622;6650;4.80;0.29;296.86;6.17;1114;25;2272.00;28
5511;24;22323409;5511;456;6622;6650;4.79;0.29;296.85;6.17;1111;25;2273.00;28
5513;24;22323424;5513;459;6623;6651;4.75;0.29;296.84;6.19;1110;25;2274.00;28
5515;24;22323440;5515;451;6623;6651;4.77;0.29;296.84;6.19;1108;25;2275.00;28
5517;24;22323456;5517;450;6627;6657;4.86;0.30;296.92;6.18;1110;25;2276.00;30
5519;24;22323471;5519;443;6628;6658;4.89;0.30;296.90;6.18;1109;25;2277.00;30
5521;24;22323483;5521;442;6628;6658;4.90;0.30;296.96;6.18;1107;25;2278.00;30
5523;24;22323496;5523;440;6628;6658;4.93;0.30;296.95;6.18;1105;25;2279.00;30
5524;24;22323510;5524;435;6632;6663;5.03;0.31;296.97;6.18;1108;25;2280.00;31
5528;24;22323530;5528;434;6632;6663;5.07;0.31;296.99;6.18;1104;25;2281.00;31
5531;24;22323543;5531;426;6632;6663;5.10;0.31;296.93;6.18;1101;25;2282.00;31
5532;24;22323555;5532;413;6633;6664;5.17;0.32;296.97;6.18;1101;25;2283.00;31
5535;24;22323568;5535;402;6636;6668;5.23;0.32;296.99;6.18;1101;25;2284.00;32
5536;24;22323581;5536;392;6636;6668;5.27;0.32;297.02;6.18;1100;25;2285.00;32
5540;24;22323602;5540;385;6637;6671;5.27;0.32;297.15;6.18;1097;25;2286.00;34
5544;24;22323615;5544;374;6637;6671;5.28;0.32;297.15;6.18;1093;25;2287.00;34
5547;24;22323629;5547;375;6637;6671;5.29;0.32;297.13;6.18;1090;25;2288.00;34
5552;24;22323640;5552;374;6637;6671;5.27;0.32;297.21;6.18;1085;25;2289.00;34
5554;24;22323655;5554;366;6642;6675;5.31;0.32;297.18;6.17;1088;25;2290.00;33
5561;24;22323669;5561;368;6642;6675;5.27;0.32;297.47;6.17;1081;25;2291.00;33
5563;24;22323683;5563;362;6642;6675;5.22;0.32;297.48;6.17;1079;25;2292.00;33
5568;24;22323696;5568;363;6642;6675;5.23;0.32;297.45;6.17;1074;25;2293.00;33
5571;24;22323708;5571;362;6642;6676;5.29;0.32;297.61;6.17;1071;25;2294.00;34
5576;24;22323721;5576;358;6643;6678;5.33;0.33;297.83;6.17;1067;25;2295.00;35
5583;24;22323735;5583;361;6644;6678;5.36;0.33;297.99;6.18;1061;25;2296.00;34
5583;24;22323748;5583;360;6646;6679;5.51;0.34;297.99;6.17;1063;25;2297.00;33
5587;24;22323761;5587;361;6647;6679;5.60;0.34;297.96;6.18;1060;25;2298.00;32
5591;24;22323774;5591;363;6647;6679;5.67;0.35;297.94;6.18;1056;25;2299.00;32
5596;24;22323789;5596;358;6647;6679;5.68;0.34;297.92;6.18;1051;25;2300.00;32
5597;24;22323808;5597;356;6647;6679;5.73;0.35;297.94;6.18;1050;25;2301.00;32
5600;24;22323822;5600;355;6648;6679;5.76;0.35;297.96;6.18;1048;25;2302.00;31
5603;24;22323836;5603;354;6648;6679;5.76;0.35;297.94;6.18;1045;25;2303.00;31
5607;24;22323849;5607;374;6726;6806;5.89;0.36;298.05;6.11;1119;25;2304.00;80
5610;24;22323872;5610;363;6728;6807;5.89;0.36;298.07;6.10;1118;25;2305.00;79
5614;24;22323887;5614;355;6734;6807;5.92;0.37;298.13;6.10;1120;25;2306.00;73
5616;24;22323902;5616;348;6736;6807;5.97;0.37;298.22;6.10;1120;25;2307.00;71
5620;24;22323917;5620;346;6741;6807;6.05;0.37;298.28;6.10;1121;25;2308.00;66
5621;24;22323931;5621;347;6743;6807;6.13;0.38;298.30;6.10;1122;25;2309.00;64
5625;24;22323947;5625;342;6747;6807;6.15;0.38;298.31;6.10;1122;25;2310.00;60
5626;24;22323963;5626;344;6748;6807;6.21;0.38;298.30;6.10;1122;25;2311.00;59
5629;24;22323977;5629;341;6751;6808;6.18;0.38;298.32;6.10;1122;25;2312.00;57
5633;24;22324000;5633;344;6753;6809;6.19;0.38;298.39;6.10;1120;25;2313.00;56
5633;24;22324015;5633;345;6754;6809;6.22;0.38;298.39;6.10;1121;25;2314.00;55
5635;24;22324030;5635;354;6757;6810;6.21;0.38;298.44;6.10;1122;25;2315.00;53
5640;24;22324045;5640;357;6758;6810;6.11;0.37;298.58;6.10;1118;25;2316.00;52
5643;24;22324058;5643;356;6759;6810;6.09;0.37;298.73;6.10;1116;25;2317.00;51
5644;24;22324073;5644;365;6760;6810;6.09;0.37;298.76;6.11;1116;25;2318.00;50
5646;24;22324087;5646;366;6766;6814;6.05;0.37;298.80;6.11;1120;25;2319.00;48
5650;24;22324103;5650;370;6766;6814;6.02;0.37;298.95;6.11;1116;25;2320.00;48
5654;24;22324117;5654;378;6766;6814;5.97;0.36;298.91;6.11;1112;25;2321.00;48
5656;24;22324132;5656;368;6769;6817;5.91;0.36;298.94;6.11;1113;25;2322.00;48
5659;24;22324147;5659;376;6771;6817;5.91;0.36;298.96;6.11;1112;25;2323.00;46
5661;24;22324162;5661;374;6771;6817;5.97;0.36;299.05;6.11;1110;25;2324.00;46
5662;24;22324177;5662;375;6776;6821;6.03;0.37;299.03;6.11;1114;25;2325.00;45
5665;24;22324191;5665;377;6777;6822;6.09;0.37;299.12;6.11;1112;25;2326.00;45
5666;24;22324207;5666;377;6779;6822;6.18;0.38;299.15;6.12;1113;25;2327.00;43
5666;24;22324223;5666;372;6782;6826;6.28;0.38;299.15;6.11;1116;25;2328.00;44
5667;24;22324246;5667;372;6782;6826;6.35;0.39;299.17;6.11;1115;25;2329.00;44
5668;24;22324260;5668;376;6783;6826;6.40;0.39;299.15;6.11;1115;25;2330.00;43
5671;24;22324281;5671;370;6784;6827;6.44;0.39;299.26;6.11;1113;25;2331.00;43
5674;24;22324303;5674;371;6785;6827;6.47;0.39;299.32;6.11;1111;25;2332.00;42
5679;24;22324319;5679;371;6789;6833;6.42;0.39;299.43;6.11;1110;25;2333.00;44
5681;24;22324339;5681;372;6790;6833;6.40;0.39;299.49;6.11;1109;25;2334.00;43
5684;24;22324354;5684;381;6790;6834;6.39;0.39;299.51;6.11;1106;25;2335.00;44
5689;24;22324370;5689;384;6790;6834;6.35;0.39;299.63;6.11;1101;25;2336.00;44
5692;24;22324385;5692;390;6790;6834;6.28;0.38;299.69;6.11;1098;25;2337.00;44
5693;24;22324401;5693;394;6790;6834;6.24;0.38;299.71;6.11;1097;25;2338.00;44
5697;24;22324416;5697;397;6790;6834;6.17;0.38;299.83;6.11;1093;25;2339.00;44
5698;24;22324432;5698;396;6816;6870;6.19;0.38;299.90;6.09;1118;25;2340.00;54
5699;24;22324450;5699;396;6818;6870;6.15;0.38;299.94;6.08;1119;25;2341.00;52
5700;24;22324466;5700;393;6821;6870;6.20;0.38;300.06;6.08;1121;25;2342.00;49
5703;24;22324481;5703;391;6821;6870;6.17;0.38;300.12;6.08;1118;25;2343.00;49
5706;24;22324496;5706;389;6822;6870;6.18;0.38;300.17;6.08;1116;25;2344.00;48
5707;24;22324512;5707;387;6822;6870;6.23;0.38;300.19;6.08;1115;25;2345.00;48
5711;24;22324526;5711;389;6826;6874;6.20;0.38;300.23;6.08;1115;25;2346.00;48
5716;24;22324541;5716;391;6826;6874;6.21;0.38;300.17;6.08;1110;25;2347.00;48
5718;24;22324556;5718;392;6830;6878;6.22;0.38;300.15;6.08;1112;25;2348.00;48
5721;24;22324571;5721;390;6831;6879;6.20;0.38;300.31;6.08;1110;25;2349.00;48
5722;24;22324585;5722;387;6831;6879;6.22;0.38;300.36;6.08;1109;25;2350.00;48
5725;24;22324608;5725;382;6831;6879;6.21;0.38;300.47;6.08;1106;25;2351.00;48
5727;24;22324625;5727;387;6842;6892;6.22;0.38;300.50;6.07;1115;25;2352.00;50
5729;24;22324640;5729;390;6842;6892;6.20;0.38;300.55;6.07;1113;25;2353.00;50
5731;24;22324654;5731;386;6842;6892;6.20;0.38;300.75;6.07;1111;25;2354.00;50
5735;24;22324669;5735;384;6843;6893;6.21;0.38;300.83;6.07;1108;25;2355.00;50
5737;24;22324684;5737;383;6843;6894;6.21;0.38;300.90;6.07;1106;25;2356.00;51
5740;24;22324700;5740;387;6843;6894;6.16;0.37;300.94;6.07;1103;25;2357.00;51
5741;24;22324714;5741;394;6845;6897;6.12;0.37;300.91;6.06;1104;25;2358.00;52
5743;24;22324729;5743;399;6845;6897;6.03;0.37;300.91;6.06;1102;25;2359.00;52
5744;24;22324742;5744;404;6846;6897;6.00;0.37;300.93;6.06;1102;25;2360.00;51
5745;24;22324755;5745;409;6846;6897;5.95;0.36;300.93;6.06;1101;25;2361.00;51
5748;24;22324770;5748;413;6851;6903;5.86;0.36;301.03;6.06;1103;25;2362.00;52
5751;24;22324785;5751;414;6851;6903;5.76;0.35;301.15;6.06;1100;25;2363.00;52
5752;24;22324799;5752;410;6851;6903;5.71;0.35;301.16;6.06;1099;25;2364.00;52
5753;24;22324813;5753;407;6851;6903;5.66;0.35;301.17;6.06;1098;25;2365.00;52
5754;24;22324828;5754;406;6854;6907;5.60;0.34;301.18;6.06;1100;25;2366.00;53
5754;24;22324841;5754;407;6855;6908;5.58;0.34;301.18;6.06;1101;25;2367.00;53
5755;24;22324855;5755;405;6855;6908;5.53;0.34;301.21;6.06;1100;25;2368.00;53
5757;24;22324869;5757;401;6856;6909;5.60;0.34;301.20;6.06;1099;25;2369.00;53
5761;24;22324884;5761;396;6856;6909;5.62;0.34;301.22;6.06;1095;25;2370.00;53
5761;24;22324898;5761;400;6856;6909;5.65;0.34;301.22;6.06;1095;25;2371.00;53
5765;24;22324910;5765;393;6856;6909;5.65;0.34;301.21;6.06;1091;25;2372.00;53
5767;24;22324924;5767;387;6856;6909;5.66;0.35;301.28;6.06;1089;25;2373.00;53
5770;24;22324938;5770;388;6856;6909;5.71;0.35;301.46;6.06;1086;25;2374.00;53
5774;24;22324952;5774;386;6856;6909;5.72;0.35;301.60;6.06;1082;25;2375.00;53
5777;24;22324966;5777;391;6891;6979;5.80;0.35;301.76;6.02;1114;25;2376.00;88
5781;24;22324989;5781;384;6891;6980;5.78;0.35;301.86;6.02;1110;25;2377.00;89
5783;24;22325006;5783;383;6897;6980;5.79;0.35;302.04;6.02;1114;25;2378.00;83
5785;24;22325021;5785;382;6898;6980;5.74;0.35;302.07;6.02;1113;25;2379.00;82
5786;24;22325039;5786;377;6900;6980;5.75;0.35;302.09;6.02;1114;25;2380.00;80
5792;24;22325055;5792;374;6903;6980;5.70;0.35;302.31;6.05;1111;25;2381.00;77
5794;24;22325074;5794;370;6905;6980;5.70;0.35;302.33;6.05;1111;25;2382.00;75
5798;24;22325094;5798;377;6909;6980;5.67;0.34;302.35;6.05;1111;25;2383.00;71
5802;24;22325113;5802;374;6909;6981;5.62;0.34;302.55;6.05;1107;25;2384.00;72
5803;24;22325132;5803;375;6913;6983;5.62;0.34;302.55;6.05;1110;25;2385.00;70
5806;24;22325150;5806;375;6914;6983;5.60;0.34;302.53;6.05;1108;25;2386.00;69
5809;24;22325166;5809;381;6920;6987;5.59;0.34;302.56;6.05;1111;25;2387.00;67
5811;24;22325183;5811;376;6923;6987;5.61;0.34;302.58;6.05;1112;25;2388.00;64
5813;24;22325200;5813;378;6925;6987;5.61;0.34;302.52;6.06;1112;25;2389.00;62
5816;24;22325216;5816;376;6927;6987;5.59;0.34;302.45;6.06;1111;25;2390.00;60
5816;24;22325235;5816;379;6931;6993;5.62;0.34;302.45;6.05;1115;25;2391.00;62
5821;24;22325261;5821;374;6931;6993;5.50;0.33;302.30;6.05;1110;25;2392.00;62
5822;24;22325277;5822;370;6931;6993;5.49;0.33;302.27;6.05;1109;25;2393.00;62
5827;24;22325291;5827;365;6933;6996;5.52;0.33;302.24;6.05;1106;25;2394.00;63
5828;24;22325311;5828;362;6934;6996;5.52;0.33;302.21;6.05;1106;25;2395.00;62
5829;24;22325327;5829;359;6934;6996;5.48;0.33;302.17;6.05;1105;25;2396.00;62
5830;24;22325341;5830;360;6934;6997;5.42;0.33;302.12;6.05;1104;25;2397.00;63
5835;24;22325355;5835;367;6935;6998;5.40;0.33;302.02;6.05;1100;25;2398.00;63
5835;24;22325369;5835;371;6935;6998;5.34;0.32;302.02;6.05;1100;25;2399.00;63
5835;24;22325385;5835;381;6961;7057;5.37;0.33;302.02;6.03;1126;25;2400.00;96
5837;24;22325411;5837;380;6966;7057;5.36;0.33;301.93;6.07;1129;25;2401.00;91
5838;24;22325425;5838;387;6968;7057;5.36;0.33;301.92;6.06;1130;25;2402.00;89
5839;24;22325439;5839;393;6972;7058;5.40;0.33;301.88;6.10;1133;25;2403.00;86
5840;24;22325454;5840;406;6975;7058;5.42;0.33;301.87;6.13;1135;25;2404.00;83
5843;24;22325468;5843;409;6977;7062;5.41;0.33;301.79;6.13;1134;25;2405.00;85
5844;24;22325495;5844;413;6981;7062;5.41;0.33;301.75;6.13;1137;25;2406.00;81
5845;24;22325511;5845;416;6985;7066;5.46;0.33;301.72;6.16;1140;25;2407.00;81
5850;24;22325525;5850;422;6985;7066;5.45;0.33;301.75;6.16;1135;25;2408.00;81
5852;24;22325539;5852;431;6986;7066;5.45;0.33;301.69;6.19;1134;25;2409.00;80
5853;24;22325553;5853;441;6987;7066;5.43;0.33;301.66;6.20;1134;25;2410.00;79
5854;24;22325568;5854;445;6988;7066;5.41;0.33;301.62;6.23;1134;25;2411.00;78
5855;24;22325582;5855;450;7000;7078;5.38;0.33;301.60;6.29;1145;25;2412.00;78
5856;24;22325597;5856;448;7001;7078;5.36;0.33;301.56;6.32;1145;25;2413.00;77
5858;24;22325618;5858;447;7004;7078;5.33;0.32;301.52;6.34;1146;25;2414.00;74
5858;24;22325632;5858;457;7004;7078;5.30;0.32;301.52;6.34;1146;25;2415.00;74
5858;24;22325645;5858;462;7007;7078;5.24;0.32;301.52;6.40;1149;25;2416.00;71
5860;24;22325657;5860;462;7008;7078;5.16;0.31;301.49;6.41;1148;25;2417.00;70
5860;24;22325671;5860;466;7011;7079;5.09;0.31;301.49;6.44;1151;25;2418.00;68
5863;24;22325684;5863;466;7011;7079;4.96;0.30;301.51;6.44;1148;25;2419.00;68
5863;24;22325697;5863;465;7016;7085;4.97;0.30;301.51;6.46;1153;25;2420.00;69
5864;24;22325710;5864;468;7019;7086;4.89;0.30;301.46;6.51;1155;25;2421.00;67
5869;24;22325723;5869;471;7021;7086;4.81;0.29;301.40;6.54;1152;25;2422.00;65
5869;24;22325737;5869;458;7023;7086;4.75;0.29;301.40;6.57;1154;25;2423.00;63
5872;24;22325750;5872;456;7028;7090;4.70;0.29;301.28;6.58;1156;25;2424.00;62
5874;24;22325763;5874;444;7030;7090;4.70;0.29;301.24;6.62;1156;25;2425.00;60
5874;24;22325777;5874;435;7032;7090;4.69;0.29;301.24;6.63;1158;25;2426.00;58
5875;24;22325788;5875;428;7035;7091;4.70;0.29;301.24;6.67;1160;25;2427.00;56
5876;24;22325802;5876;426;7041;7095;4.74;0.29;301.22;6.68;1165;25;2428.00;54
5877;24;22325826;5877;420;7043;7095;4.75;0.29;301.19;6.72;1166;25;2429.00;52
5877;24;22325840;5877;418;7048;7101;4.83;0.29;301.19;6.72;1171;25;2430.00;53
5878;24;22325853;5878;413;7048;7101;4.88;0.30;301.20;6.72;1170;25;2431.00;53
5879;24;22325867;5879;416;7051;7101;4.89;0.30;301.17;6.76;1172;25;2432.00;50
5880;24;22325880;5880;418;7053;7101;4.89;0.30;301.12;6.79;1173;25;2433.00;48
5880;24;22325893;5880;421;7059;7105;4.97;0.30;301.12;6.83;1179;25;2434.00;46
5880;25;22325905;5880;425;7060;7105;5.00;0.31;301.12;6.84;1180;26;2435.00;45
5882;25;22325943;5882;422;7060;7105;5.01;0.31;301.09;6.84;1178;26;2436.00;45
5885;25;22325963;5885;423;7062;7105;4.99;0.30;301.08;6.88;1177;26;2437.00;43
5887;25;22325983;5887;428;7062;7106;4.99;0.30;301.06;6.88;1175;26;2438.00;44
5888;25;22325996;5888;429;7066;7107;4.99;0.30;301.08;6.92;1178;26;2439.00;41
5892;25;22326009;5892;428;7066;7107;4.94;0.30;301.06;6.92;1174;26;2440.00;41
5895;25;22326022;5895;426;7068;7108;4.92;0.30;300.98;6.94;1173;26;2441.00;40
5897;25;22326036;5897;427;7069;7108;4.86;0.29;300.93;6.96;1172;26;2442.00;39
5902;25;22326048;5902;426;7069;7108;4.77;0.29;300.94;6.96;1167;26;2443.00;39
5904;25;22326060;5904;436;7071;7108;4.73;0.29;300.91;6.99;1167;26;2444.00;37
5906;25;22326073;5906;444;7072;7108;4.71;0.29;300.88;7.00;1166;26;2445.00;36
5908;25;22326086;5908;437;7072;7108;4.69;0.29;300.83;7.00;1164;26;2446.00;36
5911;25;22326099;5911;440;7072;7108;4.70;0.29;300.76;7.00;1161;26;2447.00;36
5915;25;22326110;5915;460;7141;7235;4.98;0.31;300.98;6.93;1226;26;2448.00;94
5918;25;22326135;5918;445;7145;7236;4.99;0.31;300.91;6.93;1227;26;2449.00;91
5920;25;22326148;5920;426;7153;7236;5.09;0.32;300.98;6.92;1233;26;2450.00;83
5921;25;22326162;5921;424;7156;7236;5.14;0.32;300.94;6.93;1235;26;2451.00;80
5925;25;22326175;5925;415;7161;7236;5.16;0.32;301.05;6.93;1236;26;2452.00;75
5928;25;22326188;5928;411;7162;7236;5.11;0.32;301.06;6.93;1234;26;2453.00;74
5932;25;22326202;5932;408;7166;7236;5.05;0.31;301.25;6.93;1234;26;2454.00;70
5936;25;22326217;5936;406;7169;7236;4.98;0.31;301.47;6.93;1233;26;2455.00;67
5940;25;22326232;5940;403;7173;7237;5.00;0.31;301.54;6.93;1233;26;2456.00;64
5943;25;22326252;5943;404;7175;7238;4.99;0.31;301.63;6.93;1232;26;2457.00;63
5946;25;22326268;5946;406;7177;7238;5.01;0.31;301.69;6.93;1231;26;2458.00;61
5946;25;22326282;5946;404;7178;7239;5.10;0.31;301.69;6.93;1232;26;2459.00;61
5950;25;22326298;5950;405;7180;7239;5.09;0.31;301.82;6.94;1230;26;2460.00;59
5954;25;22326313;5954;397;7182;7239;5.13;0.32;301.92;6.94;1228;26;2461.00;57
5956;25;22326329;5956;399;7183;7239;5.18;0.32;302.02;6.95;1227;26;2462.00;56
5960;25;22326343;5960;395;7187;7243;5.24;0.32;302.18;6.95;1227;26;2463.00;56
5965;25;22326357;5965;385;7187;7243;5.29;0.33;302.24;6.95;1222;26;2464.00;56
5967;25;22326373;5967;389;7189;7243;5.32;0.33;302.37;6.95;1222;26;2465.00;54
5970;25;22326388;5970;389;7189;7246;5.42;0.33;302.49;6.95;1219;26;2466.00;57
5974;25;22326404;5974;390;7190;7246;5.44;0.33;302.59;6.95;1216;26;2467.00;56
5976;25;22326430;5976;394;7193;7246;5.43;0.33;302.71;6.97;1217;26;2468.00;53
5977;25;22326449;5977;392;7197;7250;5.50;0.34;302.70;6.97;1220;26;2469.00;53
5982;25;22326466;5982;396;7199;7251;5.52;0.34;302.83;6.97;1217;26;2470.00;52
5986;25;22326485;5986;396;7201;7251;5.59;0.34;302.81;6.97;1215;26;2471.00;50
5991;25;22326505;5991;397;7204;7255;5.60;0.34;302.91;6.97;1213;26;2472.00;51
5994;25;22326524;5994;409;7205;7255;5.60;0.34;302.94;6.97;1211;26;2473.00;50
5999;25;22326545;5999;406;7206;7255;5.61;0.34;302.99;6.97;1207;26;2474.00;49
6002;25;22326564;6002;409;7209;7257;5.64;0.34;302.97;6.98;1207;26;2475.00;48
6007;25;22326584;6007;412;7210;7257;5.64;0.34;303.03;6.98;1203;26;2476.00;47
6010;25;22326604;6010;417;7214;7263;5.68;0.35;303.08;6.98;1204;26;2477.00;49
6013;25;22326622;6013;415;7215;7263;5.71;0.35;303.12;6.98;1202;26;2478.00;48
6018;25;22326642;6018;413;7216;7264;5.71;0.35;303.14;6.98;1198;26;2479.00;48
6022;25;22326662;6022;415;7217;7264;5.73;0.35;303.19;6.98;1195;26;2480.00;47
6025;25;22326682;6025;417;7218;7264;5.72;0.35;303.30;6.98;1193;26;2481.00;46
6028;25;22326703;6028;416;7218;7264;5.73;0.35;303.46;6.98;1190;26;2482.00;46
6031;25;22326721;6031;416;7218;7264;5.75;0.35;303.50;6.98;1187;26;2483.00;46
6036;25;22326740;6036;418;7225;7276;5.76;0.35;303.56;6.97;1189;26;2484.00;51
6040;25;22326761;6040;421;7225;7276;5.72;0.35;303.70;6.97;1185;26;2485.00;51
6044;25;22326782;6044;422;7226;7276;5.69;0.35;303.68;6.97;1182;26;2486.00;50
6047;25;22326806;6047;424;7227;7276;5.69;0.35;303.81;6.97;1180;26;2487.00;49
6053;25;22326822;6053;424;7228;7276;5.67;0.34;303.76;6.97;1175;26;2488.00;48
6055;25;22326853;6055;424;7228;7276;5.65;0.34;303.76;6.97;1173;26;2489.00;48
6057;25;22326876;6057;431;7231;7280;5.65;0.34;303.84;6.97;1174;26;2490.00;49
6064;25;22326891;6064;439;7232;7280;5.58;0.34;303.87;6.97;1168;26;2491.00;48
6066;25;22326906;6066;440;7236;7284;5.61;0.34;303.86;6.97;1170;26;2492.00;48
6070;25;22326922;6070;445;7239;7285;5.59;0.34;304.05;6.97;1169;26;2493.00;46
6073;25;22326937;6073;450;7239;7285;5.57;0.34;304.29;6.97;1166;26;2494.00;46
6079;25;22326952;6079;457;7239;7285;5.48;0.33;304.60;6.97;1160;26;2495.00;46
6081;25;22326968;6081;467;7249;7298;5.45;0.33;304.73;6.96;1168;26;2496.00;49
6086;25;22326984;6086;466;7250;7298;5.42;0.33;304.95;6.96;1164;26;2497.00;48
6089;25;22327000;6089;463;7250;7298;5.43;0.33;304.86;6.96;1161;26;2498.00;48
6091;25;22327021;6091;464;7251;7299;5.43;0.33;304.98;6.96;1160;26;2499.00;48
6095;25;22327037;6095;457;7251;7300;5.44;0.33;305.05;6.96;1156;26;2500.00;49
6098;25;22327063;6098;453;7251;7300;5.46;0.33;305.14;6.96;1153;26;2501.00;49
6106;25;22327078;6106;450;7253;7303;5.41;0.33;305.25;6.95;1147;26;2502.00;50
6110;25;22327094;6110;451;7253;7303;5.41;0.33;305.31;6.95;1143;26;2503.00;50
6110;25;22327108;6110;459;7254;7303;5.47;0.33;305.31;6.95;1144;26;2504.00;49
6114;25;22327124;6114;464;7254;7303;5.45;0.33;305.34;6.95;1140;26;2505.00;49
6117;25;22327141;6117;459;7259;7309;5.49;0.33;305.47;6.95;1142;26;2506.00;50
6119;25;22327159;6119;462;7259;7309;5.48;0.33;305.47;6.95;1140;26;2507.00;50
6122;25;22327180;6122;459;7259;7309;5.48;0.33;305.66;6.95;1137;26;2508.00;50
6126;25;22327199;6126;457;7259;7309;5.50;0.34;305.79;6.95;1133;26;2509.00;50
6128;25;22327217;6128;456;7262;7313;5.52;0.34;305.79;6.95;1134;26;2510.00;51
6130;25;22327236;6130;456;7263;7314;5.56;0.34;305.75;6.95;1133;26;2511.00;51
6134;25;22327255;6134;457;7263;7314;5.54;0.34;305.77;6.95;1129;26;2512.00;51
6137;25;22327274;6137;461;7264;7315;5.58;0.34;305.84;6.94;1127;26;2513.00;51
6144;25;22327291;6144;468;7264;7315;5.52;0.34;305.93;6.94;1120;26;2514.00;51
6146;25;22327314;6146;465;7264;7315;5.53;0.34;306.03;6.94;1118;26;2515.00;51
6146;25;22327332;6146;477;7264;7315;5.54;0.34;306.03;6.94;1118;26;2516.00;51
6149;25;22327351;6149;475;7264;7315;5.45;0.33;306.10;6.94;1115;26;2517.00;51
6154;25;22327369;6154;473;7264;7315;5.43;0.33;306.35;6.94;1110;26;2518.00;51
6157;25;22327387;6157;478;7264;7315;5.40;0.33;306.39;6.94;1107;26;2519.00;51
6161;25;22327407;6161;501;7333;7440;5.47;0.34;306.52;6.88;1172;26;2520.00;107
6167;25;22327437;6167;487;7334;7441;5.47;0.34;306.69;6.88;1167;26;2521.00;107
6168;25;22327455;6168;473;7341;7441;5.59;0.34;306.68;6.87;1173;26;2522.00;100
6170;25;22327473;6170;468;7344;7441;5.62;0.35;306.81;6.87;1174;26;2523.00;97
6174;25;22327490;6174;466;7348;7441;5.69;0.35;307.01;6.87;1174;26;2524.00;93
6175;25;22327508;6175;467;7350;7441;5.74;0.35;307.02;6.87;1175;26;2525.00;91
6178;25;22327536;6178;463;7355;7441;5.73;0.35;307.11;6.87;1177;26;2526.00;86
6178;25;22327553;6178;471;7358;7441;5.75;0.35;307.11;6.87;1180;26;2527.00;83
6180;25;22327569;6180;475;7362;7442;5.75;0.35;307.24;6.87;1182;26;2528.00;80
6183;25;22327584;6183;481;7370;7443;5.72;0.35;307.37;6.87;1187;26;2529.00;73
6185;25;22327598;6185;491;7373;7443;5.69;0.35;307.39;6.87;1188;26;2530.00;70
6188;25;22327613;6188;492;7378;7447;5.58;0.34;307.43;6.87;1190;26;2531.00;69
6190;25;22327629;6190;494;7381;7447;5.46;0.33;307.45;6.87;1191;26;2532.00;66
6192;25;22327650;6192;505;7381;7447;5.35;0.33;307.50;6.87;1189;26;2533.00;66
6194;25;22327665;6194;506;7383;7447;5.28;0.32;307.47;6.87;1189;26;2534.00;64
6195;25;22327679;6195;514;7387;7453;5.25;0.32;307.50;6.87;1192;26;2535.00;66
6200;25;22327695;6200;519;7388;7453;5.22;0.32;307.58;6.87;1188;26;2536.00;65
6204;25;22327716;6204;523;7389;7455;5.20;0.32;307.65;6.87;1185;26;2537.00;66
6205;25;22327731;6205;524;7391;7458;5.20;0.32;307.60;6.87;1186;26;2538.00;67
6207;25;22327744;6207;525;7393;7458;5.14;0.31;307.63;6.87;1186;26;2539.00;65
6208;25;22327757;6208;526;7393;7458;5.09;0.31;307.64;6.87;1185;26;2540.00;65
6210;25;22327772;6210;524;7393;7459;5.06;0.31;307.67;6.87;1183;26;2541.00;66
6213;25;22327786;6213;523;7394;7460;5.01;0.31;307.68;6.87;1181;26;2542.00;66
6215;25;22327801;6215;518;7394;7460;4.98;0.30;307.68;6.87;1179;26;2543.00;66
6215;25;22327816;6215;518;7402;7473;4.99;0.31;307.68;6.86;1187;26;2544.00;71
6216;25;22327831;6216;517;7403;7473;5.00;0.31;307.69;6.86;1187;26;2545.00;70
6218;25;22327844;6218;518;7404;7473;5.01;0.31;307.68;6.86;1186;26;2546.00;69
6218;25;22327857;6218;521;7405;7474;5.03;0.31;307.68;6.86;1187;26;2547.00;69
6219;25;22327871;6219;522;7405;7474;5.10;0.31;307.79;6.86;1186;26;2548.00;69
6223;25;22327885;6223;521;7407;7478;5.14;0.32;307.80;6.86;1184;26;2549.00;71
6226;25;22327902;6226;517;7409;7481;5.12;0.31;307.81;6.86;1183;26;2550.00;72
6227;25;22327918;6227;518;7412;7485;5.10;0.31;307.77;6.86;1185;26;2551.00;73
6229;25;22327936;6229;519;7412;7485;5.06;0.31;307.82;6.86;1183;26;2552.00;73
6231;25;22327953;6231;515;7414;7485;4.99;0.31;307.81;6.86;1183;26;2553.00;71
6233;25;22327971;6233;505;7414;7485;4.90;0.30;307.83;6.86;1181;26;2554.00;71
6235;25;22327987;6235;510;7416;7485;4.83;0.30;307.88;6.92;1181;26;2555.00;69
6237;25;22328007;6237;506;7427;7497;4.83;0.30;307.95;6.91;1190;26;2556.00;70
6240;25;22328024;6240;500;7427;7497;4.83;0.30;307.90;6.91;1187;26;2557.00;70
6243;25;22328044;6243;497;7429;7497;4.83;0.30;307.94;6.91;1186;26;2558.00;68
6247;25;22328062;6247;499;7429;7497;4.80;0.29;307.93;6.91;1182;26;2559.00;68
6247;25;22328088;6247;495;7429;7497;4.84;0.30;307.93;6.91;1182;26;2560.00;68
6250;25;22328107;6250;495;7429;7497;4.90;0.30;307.98;6.91;1179;26;2561.00;68
6253;25;22328124;6253;493;7429;7498;4.89;0.30;307.88;6.91;1176;26;2562.00;69
6257;25;22328141;6257;491;7430;7498;4.86;0.30;307.80;6.94;1173;26;2563.00;68
6257;25;22328158;6257;493;7434;7504;4.91;0.30;307.80;6.94;1177;26;2564.00;70
6261;25;22328174;6261;483;7436;7506;4.87;0.30;307.70;6.93;1175;26;2565.00;70
6263;25;22328192;6263;494;7436;7506;4.85;0.30;307.62;6.93;1173;26;2566.00;70
6267;25;22328210;6267;491;7436;7506;4.80;0.29;307.64;6.93;1169;26;2567.00;70
6269;25;22328224;6269;501;7438;7510;4.83;0.29;307.62;6.93;1169;26;2568.00;72
6271;25;22328238;6271;496;7438;7510;4.79;0.29;307.58;6.93;1167;26;2569.00;72
6271;25;22328252;6271;503;7438;7510;4.81;0.29;307.58;6.93;1167;26;2570.00;72
6272;25;22328266;6272;507;7439;7511;4.84;0.30;307.63;6.93;1167;26;2571.00;72
6273;25;22328280;6273;505;7443;7515;4.90;0.30;307.74;6.93;1170;26;2572.00;72
6278;25;22328293;6278;512;7445;7515;4.89;0.30;307.67;6.94;1167;26;2573.00;70
6280;25;22328308;6280;510;7447;7518;4.93;0.30;307.59;6.94;1167;26;2574.00;71
6281;25;22328322;6281;517;7448;7518;4.95;0.30;307.55;6.94;1167;26;2575.00;70
6283;25;22328336;6283;520;7449;7518;4.91;0.30;307.55;6.94;1166;26;2576.00;69
6285;26;22328349;6285;523;7449;7518;4.80;0.29;307.49;6.94;1164;27;2577.00;69
6285;26;22328374;6285;527;7454;7522;4.78;0.29;307.49;6.94;1169;27;2578.00;68
6286;26;22328388;6286;518;7455;7522;4.75;0.29;307.47;6.94;1169;27;2579.00;67
6287;26;22328404;6287;511;7457;7522;4.78;0.29;307.55;7.01;1170;27;2580.00;65
6287;26;22328418;6287;508;7457;7522;4.77;0.29;307.55;7.01;1170;27;2581.00;65
6288;26;22328431;6288;508;7457;7523;4.81;0.29;307.54;7.01;1169;27;2582.00;66
6288;26;22328445;6288;498;7460;7524;4.83;0.30;307.54;7.07;1172;27;2583.00;64
6289;26;22328459;6289;491;7460;7524;4.83;0.30;307.52;7.07;1171;27;2584.00;64
6290;27;22328473;6290;490;7463;7525;4.89;0.30;307.54;7.13;1173;28;2585.00;62
6291;27;22328506;6291;497;7463;7525;4.90;0.30;307.57;7.13;1172;28;2586.00;62
6294;28;22328521;6294;498;7464;7525;4.92;0.30;307.53;7.16;1170;29;2587.00;61
6295;28;22328548;6295;489;7465;7525;4.95;0.30;307.52;7.19;1170;29;2588.00;60
6296;28;22328569;6296;493;7466;7525;5.01;0.31;307.54;7.22;1170;29;2589.00;59
6299;28;22328584;6299;488;7467;7525;5.05;0.31;307.46;7.25;1168;29;2590.00;58
6302;28;22328598;6302;483;7467;7525;5.12;0.31;307.44;7.25;1165;29;2591.00;58
6304;29;22328611;6304;503;7535;7652;5.44;0.34;307.41;7.21;1231;30;2592.00;117
6305;29;22328650;6305;494;7539;7653;5.48;0.34;307.40;7.24;1234;30;2593.00;114
6306;29;22328665;6306;491;7549;7653;5.57;0.35;307.52;7.23;1243;30;2594.00;104
6308;29;22328680;6308;488;7555;7653;5.61;0.35;307.54;7.26;1247;30;2595.00;98
6309;29;22328695;6309;483;7562;7653;5.66;0.35;307.52;7.28;1253;30;2596.00;91
6310;29;22328709;6310;478;7564;7653;5.65;0.35;307.50;7.28;1254;30;2597.00;89
6311;29;22328724;6311;478;7568;7653;5.63;0.35;307.48;7.33;1257;30;2598.00;85
6312;29;22328745;6312;476;7570;7653;5.66;0.35;307.44;7.33;1258;30;2599.00;83
6316;29;22328760;6316;478;7572;7654;5.65;0.35;307.41;7.33;1256;30;2600.00;82
6319;29;22328780;6319;471;7576;7655;5.64;0.35;307.42;7.38;1257;30;2601.00;79
6322;29;22328803;6322;469;7578;7655;5.58;0.34;307.42;7.38;1256;30;2602.00;77
6325;29;22328819;6325;466;7580;7656;5.55;0.34;307.48;7.38;1255;30;2603.00;76
6326;29;22328835;6326;462;7585;7656;5.51;0.34;307.45;7.41;1259;30;2604.00;71
6327;29;22328851;6327;462;7588;7656;5.47;0.34;307.40;7.44;1261;30;2605.00;68
6329;29;22328867;6329;465;7590;7656;5.44;0.34;307.43;7.44;1261;30;2606.00;66
6332;29;22328881;6332;476;7596;7660;5.43;0.33;307.34;7.45;1264;30;2607.00;64
6333;29;22328898;6333;472;7598;7660;5.45;0.34;307.31;7.48;1265;30;2608.00;62
6335;29;22328914;6335;474;7599;7660;5.47;0.34;307.34;7.48;1264;30;2609.00;61
6336;29;22328930;6336;479;7602;7666;5.51;0.34;307.31;7.47;1266;30;2610.00;64
6338;29;22328946;6338;480;7603;7666;5.53;0.34;307.41;7.48;1265;30;2611.00;63
6340;29;22328968;6340;480;7604;7666;5.56;0.34;307.43;7.48;1264;30;2612.00;62
6340;29;22328983;6340;482;7609;7670;5.56;0.34;307.43;7.48;1269;30;2613.00;61
6345;29;22328998;6345;486;7611;7671;5.53;0.34;307.45;7.48;1266;30;2614.00;60
6351;29;22329014;6351;484;7611;7671;5.46;0.33;307.57;7.48;1260;30;2615.00;60
6352;29;22329030;6352;491;7614;7675;5.45;0.33;307.58;7.47;1262;30;2616.00;61
6356;29;22329044;6356;501;7614;7675;5.41;0.33;307.67;7.47;1258;30;2617.00;61
6361;29;22329058;6361;505;7614;7675;5.37;0.33;307.76;7.47;1253;30;2618.00;61
6363;29;22329073;6363;506;7614;7676;5.33;0.33;307.73;7.47;1251;30;2619.00;62
6369;29;22329088;6369;506;7614;7676;5.22;0.32;307.78;7.47;1245;30;2620.00;62
6374;29;22329103;6374;504;7618;7682;5.14;0.31;307.76;7.47;1244;30;2621.00;64
6375;29;22329119;6375;505;7618;7682;5.15;0.32;307.80;7.47;1243;30;2622.00;64
6381;29;22329133;6381;503;7618;7683;5.08;0.31;307.81;7.47;1237;30;2623.00;65
6384;29;22329147;6384;501;7618;7683;5.04;0.31;307.88;7.47;1234;30;2624.00;65
6388;29;22329161;6388;486;7618;7683;5.00;0.31;307.87;7.47;1230;30;2625.00;65
6391;29;22329175;6391;473;7618;7683;4.97;0.30;307.96;7.47;1227;30;2626.00;65
6393;29;22329197;6393;463;7618;7683;4.98;0.30;307.93;7.47;1225;30;2627.00;65
6395;29;22329210;6395;467;7627;7695;5.05;0.31;307.94;7.46;1232;30;2628.00;68
6401;29;22329225;6401;454;7627;7695;5.06;0.31;307.90;7.46;1226;30;2629.00;68
6403;29;22329240;6403;446;7627;7695;5.13;0.31;307.95;7.46;1224;30;2630.00;68
6406;29;22329254;6406;435;7627;7695;5.18;0.31;308.01;7.46;1221;30;2631.00;68
6409;29;22329269;6409;427;7627;7695;5.27;0.32;308.04;7.46;1218;30;2632.00;68
6412;29;22329283;6412;420;7627;7695;5.39;0.33;308.12;7.46;1215;30;2633.00;68
6414;29;22329299;6414;401;7630;7699;5.49;0.33;308.27;7.46;1216;30;2634.00;69
6416;29;22329314;6416;395;7630;7699;5.54;0.34;308.32;7.46;1214;30;2635.00;69
6420;29;22329329;6420;383;7633;7703;5.59;0.34;308.59;7.46;1213;30;2636.00;70
6426;29;22329345;6426;384;7633;7704;5.57;0.34;308.75;7.46;1207;30;2637.00;71
6427;29;22329360;6427;374;7633;7704;5.60;0.34;308.78;7.46;1206;30;2638.00;71
6431;29;22329375;6431;374;7633;7704;5.60;0.34;308.95;7.46;1202;30;2639.00;71
6437;29;22329393;6437;378;7657;7733;5.55;0.34;309.14;7.44;1220;30;2640.00;76
6441;29;22329411;6441;373;7658;7733;5.59;0.34;309.15;7.44;1217;30;2641.00;75
6444;29;22329427;6444;375;7660;7733;5.63;0.34;309.37;7.44;1216;30;2642.00;73
6449;29;22329442;6449;379;7661;7734;5.63;0.34;309.33;7.44;1212;30;2643.00;73
6453;29;22329457;6453;385;7662;7735;5.65;0.34;309.42;7.44;1209;30;2644.00;73
6457;29;22329473;6457;386;7662;7735;5.62;0.34;309.57;7.44;1205;30;2645.00;73
6464;29;22329488;6464;392;7664;7738;5.62;0.34;309.78;7.44;1200;30;2646.00;74
6467;29;22329504;6467;397;7664;7738;5.65;0.34;309.80;7.44;1197;30;2647.00;74
6469;29;22329520;6469;396;7666;7738;5.62;0.34;309.91;7.45;1197;30;2648.00;72
6471;29;22329535;6471;414;7666;7738;5.61;0.34;309.93;7.45;1195;30;2649.00;72
6473;29;22329550;6473;420;7672;7744;5.56;0.34;309.96;7.45;1199;30;2650.00;72
6477;29;22329566;6477;413;7672;7744;5.54;0.34;310.08;7.45;1195;30;2651.00;72
6481;29;22329582;6481;416;7672;7744;5.48;0.33;310.10;7.45;1191;30;2652.00;72
6485;29;22329597;6485;416;7673;7744;5.43;0.33;310.16;7.45;1188;30;2653.00;71
6488;29;22329612;6488;418;7677;7748;5.46;0.33;310.14;7.45;1189;30;2654.00;71
6496;29;22329628;6496;415;7678;7750;5.43;0.33;310.05;7.45;1182;30;2655.00;72
6499;29;22329643;6499;423;7678;7750;5.42;0.33;310.09;7.45;1179;30;2656.00;72
6501;29;22329657;6501;425;7680;7751;5.45;0.33;310.23;7.45;1179;30;2657.00;71
6503;29;22329673;6503;422;7682;7751;5.50;0.33;310.26;7.45;1179;30;2658.00;69
6508;29;22329688;6508;425;7682;7751;5.48;0.33;310.24;7.45;1174;30;2659.00;69
6510;29;22329704;6510;428;7682;7751;5.49;0.33;310.28;7.45;1172;30;2660.00;69
6513;29;22329719;6513;435;7683;7751;5.53;0.34;310.41;7.45;1170;30;2661.00;68
6516;29;22329735;6516;435;7683;7751;5.56;0.34;310.51;7.45;1167;30;2662.00;68
6521;29;22329749;6521;436;7684;7751;5.54;0.34;310.58;7.45;1163;30;2663.00;67
6524;29;22329765;6524;455;7723;7821;5.54;0.34;310.65;7.42;1199;30;2664.00;98
6528;29;22329787;6528;450;7724;7822;5.52;0.34;310.77;7.42;1196;30;2665.00;98
6533;29;22329803;6533;455;7729;7822;5.47;0.33;310.91;7.41;1196;30;2666.00;93
6535;29;22329819;6535;453;7730;7822;5.51;0.34;310.98;7.41;1195;30;2667.00;92
6538;29;22329834;6538;458;7733;7822;5.51;0.34;311.03;7.41;1195;30;2668.00;89
6539;29;22329849;6539;453;7734;7822;5.61;0.34;311.12;7.41;1195;30;2669.00;88
6541;29;22329866;6541;459;7736;7822;5.59;0.34;311.09;7.41;1195;30;2670.00;86
6545;29;22329881;6545;463;7738;7822;5.59;0.34;311.22;7.41;1193;30;2671.00;84
6552;29;22329897;6552;461;7739;7823;5.55;0.34;311.27;7.41;1187;30;2672.00;84
6555;29;22329911;6555;460;7741;7824;5.49;0.33;311.39;7.41;1186;30;2673.00;83
6559;29;22329927;6559;467;7744;7824;5.43;0.33;311.57;7.41;1185;30;2674.00;80
6562;29;22329942;6562;485;7749;7828;5.38;0.33;311.58;7.41;1187;30;2675.00;79
6566;29;22329958;6566;487;7751;7828;5.32;0.32;311.83;7.41;1185;30;2676.00;77
6568;29;22329973;6568;499;7752;7828;5.31;0.32;312.01;7.41;1184;30;2677.00;76
6570;29;22329988;6570;501;7752;7828;5.28;0.32;312.02;7.41;1182;30;2678.00;76
6571;29;22330005;6571;513;7758;7834;5.32;0.33;312.10;7.41;1187;30;2679.00;76
6574;29;22330021;6574;520;7758;7834;5.30;0.32;312.32;7.41;1184;30;2680.00;76
6576;29;22330037;6576;511;7758;7834;5.28;0.32;312.34;7.41;1182;30;2681.00;76
6577;29;22330053;6577;503;7761;7837;5.35;0.33;312.31;7.41;1184;30;2682.00;76
6578;29;22330069;6578;502;7761;7837;5.37;0.33;312.41;7.41;1183;30;2683.00;76
6580;29;22330087;6580;490;7761;7837;5.41;0.33;312.43;7.41;1181;30;2684.00;76
6582;29;22330104;6582;494;7761;7838;5.45;0.33;312.51;7.41;1179;30;2685.00;77
6585;29;22330125;6585;496;7762;7839;5.49;0.34;312.56;7.41;1177;30;2686.00;77
6588;29;22330141;6588;496;7762;7839;5.47;0.33;312.79;7.41;1174;30;2687.00;77
6592;29;22330156;6592;504;7775;7852;5.43;0.33;312.93;7.40;1183;30;2688.00;77
6596;29;22330173;6596;499;7775;7852;5.41;0.33;313.08;7.40;1179;30;2689.00;77
6602;29;22330188;6602;507;7777;7852;5.39;0.33;313.12;7.40;1175;30;2690.00;75
6603;29;22330203;6603;518;7778;7853;5.40;0.33;313.17;7.40;1175;30;2691.00;75
6608;29;22330218;6608;517;7778;7853;5.35;0.33;313.39;7.40;1170;30;2692.00;75
6613;29;22330233;6613;514;7782;7857;5.35;0.33;313.62;7.40;1169;30;2693.00;75
6614;29;22330249;6614;505;7782;7857;5.34;0.32;313.64;7.40;1168;30;2694.00;75
6620;29;22330265;6620;512;7785;7861;5.27;0.32;313.74;7.40;1165;30;2695.00;76
6625;29;22330283;6625;518;7785;7861;5.27;0.32;313.86;7.40;1160;30;2696.00;76
6626;29;22330299;6626;517;7785;7861;5.28;0.32;313.84;7.40;1159;30;2697.00;76
6628;29;22330314;6628;510;7785;7861;5.19;0.32;313.82;7.40;1157;30;2698.00;76
6629;29;22330329;6629;513;7785;7861;5.15;0.31;313.93;7.40;1156;30;2699.00;76
6631;29;22330347;6631;517;7813;7910;5.16;0.32;314.00;7.37;1182;30;2700.00;97
6632;29;22330372;6632;507;7813;7910;5.14;0.32;314.10;7.37;1181;30;2701.00;97
6635;29;22330387;6635;514;7816;7910;5.17;0.32;314.08;7.37;1181;30;2702.00;94
6639;29;22330402;6639;519;7816;7910;5.11;0.31;314.17;7.37;1177;30;2703.00;94
6640;29;22330417;6640;524;7819;7910;5.12;0.31;314.15;7.37;1179;30;2704.00;91
6642;29;22330438;6642;525;7819;7910;5.14;0.32;314.14;7.37;1177;30;2705.00;91
6644;29;22330455;6644;528;7820;7911;5.12;0.31;314.17;7.37;1176;30;2706.00;91
6646;29;22330472;6646;530;7820;7911;5.11;0.31;314.21;7.37;1174;30;2707.00;91
6647;29;22330491;6647;535;7825;7917;5.11;0.31;314.22;7.36;1178;30;2708.00;92
6652;29;22330513;6652;534;7826;7918;5.09;0.31;314.30;7.36;1174;30;2709.00;92
6653;29;22330534;6653;539;7826;7918;5.08;0.31;314.31;7.36;1173;30;2710.00;92
6653;29;22330553;6653;536;7827;7918;5.07;0.31;314.31;7.36;1174;30;2711.00;91
6658;29;22330573;6658;534;7830;7922;5.05;0.31;314.28;7.36;1172;30;2712.00;92
6660;29;22330594;6660;542;7831;7922;5.05;0.31;314.28;7.36;1171;30;2713.00;91
6663;29;22330611;6663;546;7831;7922;5.02;0.31;314.37;7.36;1168;30;2714.00;91
6666;29;22330635;6666;542;7832;7923;5.04;0.31;314.35;7.36;1166;30;2715.00;91
6667;29;22330655;6667;533;7835;7927;5.09;0.31;314.36;7.36;1168;30;2716.00;92
6672;29;22330677;6672;530;7836;7927;5.05;0.31;314.42;7.36;1164;30;2717.00;91
6676;29;22330697;6676;537;7838;7930;5.05;0.31;314.40;7.36;1162;30;2718.00;92
6677;29;22330718;6677;534;7839;7930;5.03;0.31;314.37;7.36;1162;30;2719.00;91
6679;29;22330736;6679;532;7840;7930;4.98;0.30;314.41;7.36;1161;30;2720.00;90
6681;29;22330753;6681;533;7840;7930;4.99;0.30;314.42;7.36;1159;30;2721.00;90
6685;29;22330768;6685;530;7843;7934;4.98;0.30;314.47;7.36;1158;30;2722.00;91
6687;29;22330783;6687;527;7844;7934;5.00;0.30;314.56;7.36;1157;30;2723.00;90
6688;29;22330798;6688;532;7844;7934;5.06;0.31;314.52;7.36;1156;30;2724.00;90
6690;29;22330811;6690;531;7845;7934;5.07;0.31;314.51;7.36;1155;30;2725.00;89
6694;29;22330825;6694;524;7845;7935;5.02;0.30;314.53;7.36;1151;30;2726.00;90
6694;29;22330840;6694;523;7846;7936;5.04;0.31;314.53;7.36;1152;30;2727.00;90
6699;29;22330854;6699;520;7846;7936;4.96;0.30;314.56;7.36;1147;30;2728.00;90
6703;29;22330868;6703;518;7848;7937;4.90;0.30;314.59;7.36;1145;30;2729.00;89
6705;29;22330883;6705;522;7849;7937;4.88;0.30;314.58;7.40;1144;30;2730.00;88
6709;29;22330899;6709;516;7850;7937;4.82;0.29;314.57;7.41;1141;30;2731.00;87
6711;29;22330912;6711;516;7852;7937;4.81;0.29;314.53;7.41;1141;30;2732.00;85
6714;29;22330944;6714;511;7852;7937;4.78;0.29;314.43;7.41;1138;30;2733.00;85
6716;29;22330959;6716;507;7852;7937;4.79;0.29;314.38;7.41;1136;30;2734.00;85
6719;29;22330973;6719;502;7852;7937;4.82;0.29;314.33;7.41;1133;30;2735.00;85
6720;29;22330988;6720;506;7914;8064;5.02;0.31;314.29;7.35;1194;30;2736.00;150
6722;29;22331016;6722;479;7917;8065;5.12;0.32;314.33;7.35;1195;30;2737.00;148
6723;29;22331031;6723;471;7924;8065;5.26;0.33;314.34;7.35;1201;30;2738.00;141
6724;29;22331045;6724;462;7929;8065;5.39;0.33;314.31;7.35;1205;30;2739.00;136
6725;29;22331061;6725;456;7934;8065;5.59;0.34;314.34;7.34;1209;30;2740.00;131
6726;29;22331077;6726;451;7936;8065;5.69;0.35;314.36;7.34;1210;30;2741.00;129
6728;29;22331092;6728;450;7939;8065;5.82;0.36;314.32;7.34;1211;30;2742.00;126
6729;29;22331117;6729;438;7944;8065;5.91;0.36;314.29;7.34;1215;30;2743.00;121
6732;29;22331133;6732;436;7945;8066;5.93;0.36;314.24;7.34;1213;30;2744.00;121
6735;29;22331150;6735;434;7948;8068;5.94;0.36;314.21;7.34;1213;30;2745.00;120
6736;29;22331166;6736;438;7950;8068;5.92;0.36;314.17;7.34;1214;30;2746.00;118
6736;29;22331182;6736;430;7956;8069;5.91;0.36;314.17;7.35;1220;30;2747.00;113
6736;29;22331199;6736;429;7958;8069;5.91;0.36;314.17;7.35;1222;30;2748.00;111
6738;29;22331217;6738;428;7963;8069;5.88;0.36;314.17;7.35;1225;30;2749.00;106
6741;29;22331233;6741;438;7965;8069;5.85;0.36;314.15;7.36;1224;30;2750.00;104
6742;29;22331251;6742;448;7968;8073;5.85;0.36;314.19;7.39;1226;30;2751.00;105
6743;29;22331268;6743;447;7971;8073;5.82;0.36;314.14;7.42;1228;30;2752.00;102
6745;29;22331291;6745;447;7976;8073;5.81;0.36;314.12;7.43;1231;30;2753.00;97
6745;29;22331307;6745;452;7977;8076;5.83;0.36;314.12;7.42;1232;30;2754.00;99
6746;29;22331324;6746;456;7983;8076;5.80;0.35;314.14;7.50;1237;30;2755.00;93
6748;29;22331340;6748;466;7985;8076;5.80;0.35;314.12;7.50;1237;30;2756.00;91
6749;29;22331357;6749;467;7988;8080;5.76;0.35;314.10;7.50;1239;30;2757.00;92
6753;29;22331373;6753;471;7991;8081;5.72;0.35;314.16;7.57;1238;30;2758.00;90
6754;29;22331390;6754;477;7991;8081;5.70;0.35;314.14;7.57;1237;30;2759.00;90
6759;29;22331408;6759;484;7997;8086;5.69;0.35;314.21;7.61;1238;30;2760.00;89
6759;29;22331427;6759;485;7999;8086;5.67;0.35;314.21;7.65;1240;30;2761.00;87
6762;29;22331442;6762;492;8001;8086;5.67;0.35;314.19;7.70;1239;30;2762.00;85
6765;29;22331457;6765;492;8003;8087;5.65;0.34;314.32;7.74;1238;30;2763.00;84
6768;29;22331474;6768;498;8004;8087;5.60;0.34;314.31;7.78;1236;30;2764.00;83
6772;29;22331490;6772;499;8009;8093;5.61;0.34;314.46;7.77;1237;30;2765.00;84
6776;29;22331507;6776;499;8009;8093;5.57;0.34;314.73;7.77;1233;30;2766.00;84
6776;29;22331524;6776;498;8010;8094;5.58;0.34;314.73;7.81;1234;30;2767.00;84
6778;29;22331540;6778;502;8011;8094;5.58;0.34;314.69;7.85;1233;30;2768.00;83
6781;29;22331556;6781;507;8011;8094;5.55;0.34;314.76;7.85;1230;30;2769.00;83
6783;29;22331571;6783;510;8012;8094;5.52;0.33;314.85;7.89;1229;30;2770.00;82
6785;29;22331588;6785;514;8012;8094;5.52;0.33;314.90;7.89;1227;30;2771.00;82
6785;29;22331605;6785;506;8024;8106;5.58;0.34;314.90;7.96;1239;30;2772.00;82
6785;29;22331621;6785;508;8024;8106;5.54;0.34;314.90;7.96;1239;31;2773.00;82
6787;29;22331649;6787;503;8025;8106;5.52;0.33;314.91;7.96;1238;31;2774.00;81
6788;29;22331668;6788;497;8026;8106;5.55;0.34;314.91;8.00;1238;31;2775.00;80
6788;29;22331688;6788;489;8026;8106;5.59;0.34;314.91;8.00;1238;31;2776.00;80
6792;29;22331706;6792;489;8027;8106;5.58;0.34;314.97;8.04;1235;31;2777.00;79
6793;29;22331723;6793;481;8030;8110;5.62;0.34;315.08;8.04;1237;31;2778.00;80
6796;29;22331739;6796;476;8032;8110;5.62;0.34;315.17;8.11;1236;31;2779.00;78
6798;29;22331755;6798;473;8037;8114;5.64;0.34;315.22;8.15;1239;31;2780.00;77
6804;29;22331771;6804;480;8039;8115;5.57;0.34;315.30;8.18;1235;31;2781.00;76
6805;29;22331787;6805;475;8039;8115;5.56;0.34;315.34;8.18;1234;31;2782.00;76
6808;29;22331802;6808;478;8041;8115;5.56;0.34;315.37;8.26;1233;31;2783.00;74
6813;29;22331818;6813;476;8051;8128;5.56;0.34;315.43;8.25;1238;31;2784.00;77
6815;29;22331834;6815;469;8051;8128;5.57;0.34;315.49;8.25;1236;31;2785.00;77
6818;29;22331849;6818;473;8054;8128;5.57;0.34;315.50;8.31;1236;31;2786.00;74
6821;29;22331865;6821;475;8055;8129;5.64;0.34;315.57;8.31;1234;31;2787.00;74
6828;29;22331880;6828;473;8055;8130;5.65;0.34;315.50;8.31;1227;31;2788.00;75
6830;29;22331896;6830;480;8057;8130;5.68;0.35;315.51;8.38;1227;31;2789.00;73
6834;29;22331920;6834;474;8062;8136;5.68;0.35;315.55;8.38;1228;31;2790.00;74
6838;30;22331944;6838;475;8064;8136;5.64;0.34;315.50;8.44;1226;32;2791.00;72
6844;30;22331968;6844;476;8065;8136;5.58;0.34;315.72;8.44;1221;32;2792.00;71
6850;30;22331984;6850;480;8065;8136;5.55;0.34;315.77;8.44;1215;32;2793.00;71
6851;30;22331999;6851;472;8072;8142;5.58;0.34;315.80;8.50;1221;32;2794.00;70
6854;30;22332015;6854;475;8072;8142;5.60;0.34;315.83;8.50;1218;32;2795.00;70
6858;30;22332035;6858;475;8072;8142;5.53;0.34;315.90;8.50;1214;32;2796.00;70
6862;30;22332048;6862;475;8072;8142;5.48;0.34;315.92;8.50;1210;32;2797.00;70
6867;30;22332062;6867;475;8075;8146;5.38;0.33;315.92;8.50;1208;32;2798.00;71
6871;30;22332077;6871;476;8076;8147;5.26;0.32;315.99;8.50;1205;32;2799.00;71
6876;30;22332090;6876;462;8076;8147;5.21;0.32;316.03;8.50;1200;32;2800.00;71
6879;30;22332108;6879;458;8077;8148;5.20;0.32;316.15;8.50;1198;32;2801.00;71
6885;30;22332122;6885;455;8077;8148;5.17;0.32;316.37;8.50;1192;32;2802.00;71
6888;30;22332137;6888;450;8077;8148;5.18;0.32;316.54;8.50;1189;32;2803.00;71
6893;30;22332157;6893;443;8077;8148;5.19;0.32;316.71;8.50;1184;32;2804.00;71
6898;30;22332172;6898;439;8077;8148;5.15;0.32;316.83;8.50;1179;32;2805.00;71
6902;30;22332186;6902;428;8077;8148;5.14;0.31;316.96;8.50;1175;32;2806.00;71
6904;30;22332201;6904;422;8077;8148;5.15;0.32;317.08;8.50;1173;32;2807.00;71
6907;30;22332216;6907;425;8116;8218;5.30;0.33;317.17;8.46;1209;32;2808.00;102
6910;30;22332248;6910;410;8120;8219;5.35;0.33;317.15;8.45;1210;32;2809.00;99
6913;30;22332274;6913;404;8126;8219;5.40;0.33;317.10;8.45;1213;32;2810.00;93
6918;30;22332294;6918;404;8126;8219;5.44;0.33;317.16;8.45;1208;32;2811.00;93
6920;30;22332311;6920;409;8128;8219;5.51;0.34;317.13;8.45;1208;32;2812.00;91
6922;30;22332326;6922;412;8133;8219;5.56;0.34;317.18;8.45;1211;32;2813.00;86
6923;30;22332343;6923;410;8135;8219;5.60;0.34;317.22;8.44;1212;32;2814.00;84
6929;30;22332358;6929;414;8137;8219;5.54;0.34;317.33;8.44;1208;32;2815.00;82
6931;30;22332378;6931;413;8138;8220;5.50;0.34;317.39;8.44;1207;32;2816.00;82
6934;30;22332395;6934;422;8138;8221;5.48;0.34;317.42;8.44;1204;32;2817.00;83
6939;30;22332414;6939;422;8138;8221;5.48;0.33;317.41;8.44;1199;32;2818.00;83
6942;30;22332433;6942;427;8141;8225;5.49;0.34;317.41;8.44;1199;32;2819.00;84
6947;30;22332456;6947;426;8142;8225;5.50;0.34;317.42;8.44;1195;32;2820.00;83
6950;30;22332476;6950;427;8143;8225;5.55;0.34;317.46;8.44;1193;32;2821.00;82
6958;30;22332496;6958;421;8144;8225;5.55;0.34;317.53;8.44;1186;32;2822.00;81
6961;30;22332511;6961;418;8148;8231;5.58;0.34;317.70;8.44;1187;32;2823.00;83
6966;30;22332528;6966;411;8148;8231;5.58;0.34;317.81;8.44;1182;32;2824.00;83
6970;30;22332544;6970;418;8150;8231;5.58;0.34;317.79;8.44;1180;32;2825.00;81
6975;30;22332558;6975;422;8151;8234;5.57;0.34;317.84;8.44;1176;32;2826.00;83
6980;30;22332575;6980;416;8153;8234;5.58;0.34;317.95;8.44;1173;32;2827.00;81
6987;30;22332595;6987;421;8153;8234;5.54;0.34;318.04;8.44;1166;32;2828.00;81
6989;30;22332610;6989;423;8154;8235;5.58;0.34;318.05;8.44;1165;32;2829.00;81
6994;30;22332627;6994;425;8155;8236;5.61;0.34;318.06;8.44;1161;32;2830.00;81
6997;30;22332643;6997;430;8155;8236;5.57;0.34;318.01;8.44;1158;32;2831.00;81
7000;30;22332657;7000;430;8165;8249;5.54;0.34;317.98;8.43;1165;32;2832.00;84
7004;30;22332678;7004;433;8166;8249;5.46;0.33;318.04;8.43;1162;32;2833.00;83
7010;30;22332702;7010;436;8166;8249;5.33;0.32;318.11;8.43;1156;32;2834.00;83
7014;30;22332719;7014;444;8168;8251;5.34;0.32;318.23;8.42;1154;32;2835.00;83
7014;30;22332738;7014;448;8168;8251;5.37;0.33;318.23;8.42;1154;32;2836.00;83
7017;30;22332755;7017;453;8172;8255;5.39;0.33;318.31;8.42;1155;32;2837.00;83
7020;30;22332773;7020;454;8173;8255;5.38;0.33;318.32;8.42;1153;32;2838.00;82
7022;30;22332788;7022;463;8175;8259;5.42;0.33;318.35;8.42;1153;32;2839.00;84
7025;30;22332805;7025;464;8175;8259;5.35;0.33;318.50;8.42;1150;32;2840.00;84
7026;30;22332821;7026;471;8176;8259;5.31;0.32;318.51;8.42;1150;32;2841.00;83
7027;30;22332836;7027;477;8176;8259;5.21;0.32;318.55;8.42;1149;32;2842.00;83
7032;30;22332853;7032;481;8178;8259;5.12;0.31;318.63;8.43;1146;32;2843.00;81
7034;30;22332870;7034;486;8188;8271;5.16;0.31;318.59;8.41;1154;32;2844.00;83
7035;30;22332886;7035;492;8188;8271;5.11;0.31;318.67;8.41;1153;32;2845.00;83
7039;30;22332902;7039;494;8189;8271;5.05;0.31;318.89;8.41;1150;32;2846.00;82
7042;30;22332920;7042;488;8189;8271;4.98;0.31;318.92;8.41;1147;32;2847.00;82
7044;30;22332938;7044;483;8189;8271;4.98;0.31;319.07;8.41;1145;32;2848.00;82
7051;30;22332954;7051;471;8189;8271;4.88;0.30;319.22;8.41;1138;32;2849.00;82
7054;30;22332971;7054;467;8191;8274;4.88;0.30;319.22;8.41;1137;32;2850.00;83
7057;30;22332987;7057;466;8191;8274;4.92;0.30;319.35;8.41;1134;32;2851.00;83
7063;30;22333002;7063;465;8196;8280;4.95;0.30;319.44;8.41;1133;32;2852.00;84
7067;30;22333031;7067;464;8197;8281;4.97;0.30;319.40;8.41;1130;32;2853.00;84
7070;30;22333047;7070;472;8197;8281;4.97;0.30;319.52;8.41;1127;32;2854.00;84
7073;30;22333061;7073;475;8197;8281;4.93;0.30;319.59;8.41;1124;32;2855.00;84
7075;30;22333084;7075;468;8200;8285;4.97;0.30;319.68;8.40;1125;32;2856.00;85
7076;30;22333101;7076;464;8200;8285;5.01;0.30;319.65;8.40;1124;32;2857.00;85
7079;30;22333115;7079;458;8200;8285;5.01;0.30;319.65;8.40;1121;32;2858.00;85
7080;30;22333132;7080;453;8201;8286;5.06;0.31;319.62;8.40;1121;32;2859.00;85
7081;30;22333152;7081;452;8204;8290;5.10;0.31;319.58;8.40;1123;32;2860.00;86
7084;30;22333172;7084;450;8204;8290;5.16;0.31;319.53;8.40;1120;32;2861.00;86
7087;30;22333190;7087;446;8206;8293;5.20;0.32;319.43;8.40;1119;32;2862.00;87
7087;30;22333214;7087;447;8206;8293;5.24;0.32;319.43;8.40;1119;32;2863.00;87
7087;30;22333230;7087;453;8209;8295;5.36;0.33;319.43;8.40;1122;32;2864.00;86
7091;30;22333249;7091;453;8209;8295;5.38;0.33;319.36;8.40;1118;32;2865.00;86
7093;30;22333265;7093;462;8213;8299;5.42;0.33;319.33;8.39;1120;32;2866.00;86
7095;30;22333281;7095;454;8213;8299;5.43;0.33;319.35;8.39;1118;32;2867.00;86
7098;30;22333295;7098;453;8213;8299;5.45;0.33;319.40;8.39;1115;32;2868.00;86
7101;30;22333310;7101;451;8213;8299;5.46;0.33;319.40;8.39;1112;32;2869.00;86
7101;30;22333327;7101;443;8213;8300;5.55;0.34;319.40;8.39;1112;32;2870.00;87
7104;30;22333345;7104;440;8214;8301;5.65;0.34;319.39;8.39;1110;32;2871.00;87
7104;30;22333361;7104;437;8214;8301;5.68;0.35;319.39;8.39;1110;32;2872.00;87
7106;30;22333388;7106;433;8215;8302;5.75;0.35;319.33;8.39;1109;32;2873.00;87
7112;30;22333405;7112;432;8215;8302;5.76;0.35;319.31;8.39;1103;32;2874.00;87
7113;30;22333424;7113;429;8215;8302;5.75;0.35;319.35;8.39;1102;32;2875.00;87
7113;30;22333455;7113;426;8215;8302;5.73;0.35;319.35;8.39;1102;32;2876.00;87
7114;30;22333473;7114;428;8215;8302;5.70;0.35;319.32;8.39;1101;32;2877.00;87
7116;30;22333489;7116;431;8215;8302;5.67;0.35;319.31;8.39;1099;32;2878.00;87
7116;30;22333504;7116;429;8215;8302;5.67;0.35;319.31;8.39;1099;32;2879.00;87
7120;30;22333520;7120;488;8342;8532;5.66;0.36;319.23;8.26;1222;32;2880.00;190
7121;30;22333554;7121;477;8343;8533;5.62;0.35;319.19;8.26;1222;32;2881.00;190
7122;30;22333570;7122;462;8349;8533;5.66;0.36;319.16;8.26;1227;32;2882.00;184
7124;30;22333598;7124;459;8352;8533;5.60;0.35;319.17;8.26;1228;32;2883.00;181
7125;30;22333616;7125;452;8359;8533;5.65;0.36;319.18;8.25;1234;32;2884.00;174
7127;30;22333632;7127;451;8362;8533;5.60;0.35;319.16;8.25;1235;32;2885.00;171
7128;30;22333648;7128;450;8370;8533;5.57;0.35;319.17;8.25;1242;32;2886.00;163
7131;30;22333663;7131;448;8375;8533;5.51;0.34;319.16;8.25;1244;32;2887.00;158
7135;30;22333680;7135;460;8381;8534;5.51;0.34;319.28;8.25;1246;32;2888.00;153
7137;30;22333699;7137;462;8384;8535;5.48;0.34;319.25;8.25;1247;32;2889.00;151
7140;30;22333715;7140;462;8391;8535;5.41;0.34;319.21;8.25;1251;32;2890.00;144
7141;30;22333731;7141;468;8394;8536;5.39;0.34;319.20;8.25;1253;32;2891.00;142
7143;30;22333747;7143;464;8396;8536;5.36;0.33;319.18;8.25;1253;32;2892.00;140
7145;30;22333765;7145;460;8401;8536;5.33;0.33;319.18;8.25;1256;32;2893.00;135
7145;30;22333791;7145;449;8402;8536;5.31;0.33;319.18;8.25;1257;32;2894.00;134
7146;30;22333808;7146;442;8405;8540;5.26;0.32;319.27;8.26;1259;32;2895.00;135
7148;30;22333825;7148;446;8405;8540;5.26;0.32;319.26;8.26;1257;32;2896.00;135
7152;30;22333840;7152;443;8406;8540;5.31;0.33;319.23;8.26;1254;32;2897.00;134
7153;30;22333858;7153;437;8409;8543;5.34;0.33;319.21;8.26;1256;32;2898.00;134
7157;30;22333888;7157;436;8410;8543;5.32;0.32;319.22;8.26;1253;32;2899.00;133
7160;30;22333913;7160;439;8410;8543;5.34;0.32;319.22;8.26;1250;32;2900.00;133
7160;30;22333935;7160;434;8414;8547;5.39;0.33;319.22;8.26;1254;32;2901.00;133
7162;30;22333951;7162;441;8415;8548;5.41;0.33;319.15;8.25;1253;32;2902.00;133
7164;30;22333967;7164;438;8415;8548;5.40;0.33;319.15;8.25;1251;32;2903.00;133
7166;30;22333986;7166;433;8417;8552;5.41;0.33;319.14;8.25;1251;32;2904.00;135
7168;30;22334008;7168;437;8419;8552;5.39;0.33;319.22;8.34;1251;32;2905.00;133
7170;30;22334033;7170;437;8421;8552;5.36;0.33;319.20;8.34;1251;32;2906.00;131
7172;30;22334061;7172;427;8421;8553;5.33;0.32;319.18;8.34;1249;32;2907.00;132
7172;30;22334085;7172;425;8424;8553;5.32;0.32;319.18;8.35;1252;32;2908.00;129
7174;30;22334102;7174;422;8427;8559;5.35;0.33;319.19;8.35;1253;32;2909.00;132
7176;30;22334121;7176;408;8427;8559;5.35;0.32;319.25;8.35;1251;32;2910.00;132
7177;30;22334137;7177;405;8429;8560;5.42;0.33;319.27;8.35;1252;32;2911.00;131
7178;30;22334153;7178;394;8429;8560;5.47;0.33;319.27;8.35;1251;32;2912.00;131
7178;30;22334170;7178;391;8432;8560;5.54;0.34;319.27;8.36;1254;32;2913.00;128
7179;30;22334185;7179;390;8432;8560;5.60;0.34;319.23;8.36;1253;32;2914.00;128
7181;30;22334202;7181;384;8434;8560;5.66;0.34;319.17;8.37;1253;32;2915.00;126
7182;30;22334218;7182;380;8442;8572;5.77;0.35;319.14;8.36;1260;32;2916.00;130
7185;30;22334235;7185;372;8442;8572;5.80;0.35;319.10;8.36;1257;32;2917.00;130
7187;30;22334252;7187;370;8446;8572;5.83;0.35;319.08;8.36;1259;32;2918.00;126
7192;30;22334271;7192;372;8447;8572;5.84;0.36;319.12;8.37;1255;32;2919.00;125
7193;30;22334301;7193;375;8447;8572;5.88;0.36;319.21;8.37;1254;32;2920.00;125
7195;30;22334321;7195;373;8449;8572;5.91;0.36;319.27;8.37;1254;32;2921.00;123
7197;30;22334338;7197;368;8453;8576;5.87;0.36;319.36;8.37;1256;32;2922.00;123
7199;30;22334354;7199;373;8454;8576;5.92;0.36;319.35;8.37;1255;32;2923.00;122
7201;30;22334370;7201;380;8457;8580;5.99;0.36;319.30;8.37;1256;32;2924.00;123
7202;30;22334387;7202;371;8460;8582;6.01;0.37;319.33;8.37;1258;32;2925.00;122
7205;30;22334403;7205;364;8462;8582;5.99;0.36;319.38;8.38;1257;32;2926.00;120
7207;30;22334422;7207;368;8463;8582;5.96;0.36;319.47;8.38;1256;32;2927.00;119
7210;30;22334446;7210;367;8473;8595;5.94;0.36;319.58;8.37;1263;32;2928.00;122
7212;30;22334470;7212;370;8475;8595;5.95;0.36;319.69;8.38;1263;32;2929.00;120
7214;30;22334491;7214;373;8478;8595;5.96;0.36;319.75;8.47;1264;32;2930.00;117
7214;30;22334522;7214;383;8480;8596;5.97;0.36;319.75;8.47;1266;32;2931.00;116
7218;30;22334540;7218;384;8481;8597;6.00;0.36;319.74;8.52;1263;32;2932.00;116
7219;30;22334556;7219;384;8483;8597;6.05;0.37;319.76;8.57;1264;32;2933.00;114
7219;30;22334573;7219;396;8487;8600;6.08;0.37;319.76;8.57;1268;32;2934.00;113
7220;30;22334589;7220;396;8487;8600;6.11;0.37;319.78;8.57;1267;32;2935.00;113
7222;30;22334611;7222;397;8488;8600;6.09;0.37;319.80;8.61;1266;32;2936.00;112
7225;30;22334634;7225;394;8489;8600;6.04;0.37;319.77;8.62;1264;32;2937.00;111
7226;30;22334652;7226;399;8496;8606;6.06;0.37;319.75;8.70;1270;32;2938.00;110
7229;30;22334679;7229;407;8498;8606;6.05;0.37;319.68;8.75;1269;32;2939.00;108
7232;30;22334701;7232;411;8499;8606;6.04;0.37;319.70;8.80;1267;32;2940.00;107
7233;30;22334722;7233;414;8500;8606;6.05;0.37;319.81;8.80;1267;32;2941.00;106
7237;30;22334742;7237;417;8503;8610;6.02;0.37;319.78;8.80;1266;32;2942.00;107
7240;30;22334760;7240;417;8507;8611;5.95;0.36;319.73;8.89;1267;32;2943.00;104
7242;30;22334780;7242;410;8507;8611;5.93;0.36;319.72;8.89;1265;32;2944.00;104
7245;30;22334809;7245;418;8511;8612;5.92;0.36;319.71;8.98;1266;32;2945.00;101
7246;30;22334828;7246;418;8512;8612;5.91;0.36;319.68;8.98;1266;32;2946.00;100
7247;30;22334845;7247;419;8512;8612;5.94;0.36;319.78;8.98;1265;32;2947.00;100
7250;30;22334862;7250;423;8513;8612;5.98;0.36;319.82;8.98;1263;32;2948.00;99
7253;30;22334878;7253;425;8513;8612;5.95;0.36;319.90;8.98;1260;32;2949.00;99
7257;30;22334893;7257;422;8517;8612;5.94;0.36;320.05;9.15;1260;32;2950.00;95
7257;30;22334910;7257;422;8518;8612;5.96;0.36;320.05;9.15;1261;32;2951.00;94
7259;30;22334931;7259;434;8562;8682;5.99;0.36;320.12;9.18;1303;32;2952.00;120
7261;30;22334962;7261;419;8564;8683;5.97;0.36;320.18;9.18;1303;32;2953.00;119
7264;30;22334983;7264;419;8569;8683;6.01;0.37;320.13;9.18;1305;32;2954.00;114
7265;30;22335000;7265;414;8572;8683;6.04;0.37;320.20;9.26;1307;32;2955.00;111
7267;30;22335017;7267;410;8573;8683;6.08;0.37;320.20;9.26;1306;32;2956.00;110
7269;30;22335034;7269;406;8575;8683;6.11;0.37;320.42;9.33;1306;32;2957.00;108
7270;30;22335050;7270;405;8578;8683;6.25;0.38;320.40;9.33;1308;32;2958.00;105
7276;30;22335067;7276;409;8578;8683;6.29;0.38;320.54;9.33;1302;32;2959.00;105
7278;30;22335088;7278;408;8582;8684;6.33;0.39;320.61;9.41;1304;32;2960.00;102
7284;30;22335118;7284;414;8584;8685;6.36;0.39;320.56;9.41;1300;32;2961.00;101
7286;30;22335137;7286;417;8586;8685;6.34;0.39;320.62;9.41;1300;32;2962.00;99
7291;30;22335153;7291;420;8593;8689;6.24;0.38;320.74;9.48;1302;32;2963.00;96
7293;30;22335171;7293;422;8594;8689;6.21;0.38;320.71;9.48;1301;32;2964.00;95
7296;30;22335187;7296;428;8595;8689;6.17;0.37;320.70;9.51;1299;32;2965.00;94
7300;30;22335208;7300;436;8596;8689;6.10;0.37;320.73;9.55;1296;32;2966.00;93
7302;30;22335230;7302;438;8601;8695;6.07;0.37;320.75;9.58;1299;32;2967.00;94
7308;31;22335256;7308;436;8601;8695;5.93;0.36;320.85;9.58;1293;33;2968.00;94
7315;31;22335291;7315;442;8602;8695;5.81;0.35;320.81;9.62;1287;33;2969.00;93
7316;31;22335310;7316;449;8605;8701;5.80;0.35;320.79;9.61;1289;33;2970.00;96
7321;31;22335328;7321;454;8605;8701;5.72;0.35;320.95;9.61;1284;33;2971.00;96
7325;31;22335345;7325;457;8606;8701;5.60;0.34;321.05;9.61;1281;33;2972.00;95
7328;31;22335361;7328;470;8606;8702;5.48;0.33;321.17;9.61;1278;33;2973.00;96
7331;31;22335378;7331;476;8607;8703;5.38;0.33;321.28;9.61;1276;33;2974.00;96
7337;31;22335399;7337;460;8607;8703;5.27;0.32;321.35;9.61;1270;33;2975.00;96
7340;31;22335420;7340;455;8616;8716;5.26;0.32;321.44;9.60;1276;33;2976.00;100
7343;31;22335440;7343;454;8617;8716;5.26;0.32;321.46;9.60;1274;33;2977.00;99
7347;31;22335457;7347;453;8617;8716;5.26;0.32;321.51;9.60;1270;33;2978.00;99
7349;31;22335474;7349;447;8617;8717;5.36;0.33;321.54;9.60;1268;33;2979.00;100
7350;31;22335489;7350;440;8618;8717;5.45;0.33;321.63;9.60;1268;33;2980.00;99
7356;31;22335506;7356;425;8621;8721;5.53;0.34;321.69;9.60;1265;33;2981.00;100
7360;31;22335524;7360;408;8621;8721;5.64;0.35;321.72;9.60;1261;33;2982.00;100
7362;31;22335544;7362;391;8624;8725;5.69;0.35;321.76;9.60;1262;33;2983.00;101
7364;31;22335563;7364;383;8624;8725;5.71;0.35;321.80;9.60;1260;33;2984.00;101
7368;31;22335581;7368;370;8624;8725;5.70;0.35;321.93;9.60;1256;33;2985.00;101
7374;31;22335611;7374;367;8624;8725;5.71;0.35;322.13;9.60;1250;33;2986.00;101
7377;31;22335632;7377;361;8624;8725;5.72;0.35;322.23;9.60;1247;33;2987.00;101
7381;31;22335654;7381;359;8634;8737;5.79;0.35;322.33;9.59;1253;33;2988.00;103
7383;31;22335678;7383;363;8634;8737;5.77;0.35;322.38;9.59;1251;33;2989.00;103
7388;31;22335702;7388;360;8634;8737;5.70;0.35;322.56;9.59;1246;33;2990.00;103
7392;31;22335725;7392;371;8634;8737;5.69;0.35;322.64;9.59;1242;33;2991.00;103
7396;31;22335742;7396;380;8634;8737;5.68;0.35;322.75;9.59;1238;33;2992.00;103
7402;31;22335757;7402;382;8634;8737;5.65;0.35;322.83;9.59;1232;33;2993.00;103
7408;31;22335773;7408;384;8635;8738;5.61;0.34;322.99;9.59;1227;33;2994.00;103
7414;31;22335790;7414;380;8635;8738;5.59;0.34;323.15;9.59;1221;33;2995.00;103
7417;31;22335806;7417;377;8640;8744;5.64;0.35;323.16;9.59;1223;33;2996.00;104
7421;31;22335823;7421;379;8641;8745;5.64;0.34;323.31;9.60;1220;33;2997.00;104
7425;31;22335842;7425;386;8642;8745;5.60;0.34;323.31;9.60;1217;33;2998.00;103
7428;31;22335864;7428;389;8643;8745;5.57;0.34;323.34;9.60;1215;33;2999.00;102
7433;31;22335886;7433;400;8651;8765;5.50;0.34;323.44;9.60;1218;33;3000.00;114
7440;31;22335914;7440;405;8652;8765;5.43;0.33;323.46;9.60;1212;33;3001.00;113
7444;31;22335936;7444;413;8653;8765;5.39;0.33;323.55;9.60;1209;33;3002.00;112
7448;31;22335954;7448;423;8655;8766;5.36;0.33;323.61;9.60;1207;33;3003.00;111
7453;31;22335971;7453;416;8661;8770;5.36;0.33;323.59;9.61;1208;33;3004.00;109
7458;31;22335986;7458;425;8662;8770;5.31;0.32;323.68;9.61;1204;33;3005.00;108
7460;31;22336003;7460;431;8666;8773;5.19;0.32;323.80;9.61;1206;33;3006.00;107
7465;31;22336019;7465;433;8667;8773;5.13;0.31;323.75;9.61;1202;33;3007.00;106
7471;31;22336035;7471;437;8667;8773;5.04;0.31;323.94;9.61;1196;33;3008.00;106
7475;31;22336052;7475;443;8669;8773;5.02;0.31;323.95;9.61;1194;33;3009.00;104
7483;31;22336068;7483;450;8671;8777;4.95;0.30;324.15;9.61;1188;33;3010.00;106
7484;31;22336084;7484;456;8672;8777;4.90;0.30;324.16;9.61;1188;33;3011.00;105
7486;31;22336099;7486;461;8674;8777;4.83;0.29;324.19;9.61;1188;33;3012.00;103
7491;31;22336113;7491;454;8675;8777;4.79;0.29;324.44;9.61;1184;33;3013.00;102
7493;31;22336129;7493;459;8676;8778;4.78;0.29;324.42;9.61;1183;33;3014.00;102
7495;31;22336147;7495;458;8678;8780;4.76;0.29;324.42;9.60;1183;33;3015.00;102
7499;31;22336162;7499;463;8678;8780;4.68;0.29;324.38;9.60;1179;33;3016.00;102
7500;31;22336181;7500;467;8679;8781;4.65;0.28;324.36;9.60;1179;33;3017.00;102
7503;31;22336199;7503;481;8680;8781;4.58;0.28;324.37;9.60;1177;33;3018.00;101
7505;31;22336217;7505;486;8680;8781;4.50;0.28;324.41;9.60;1175;33;3019.00;101
7507;31;22336232;7507;486;8680;8781;4.44;0.27;324.48;9.60;1173;33;3020.00;101
7510;31;22336247;7510;499;8680;8781;4.39;0.27;324.46;9.60;1170;33;3021.00;101
7513;31;22336262;7513;497;8680;8781;4.39;0.27;324.48;9.60;1167;33;3022.00;101
7515;31;22336276;7515;501;8680;8781;4.40;0.27;324.48;9.60;1165;33;3023.00;101
7517;31;22336289;7517;503;8745;8908;4.76;0.30;324.41;9.54;1228;33;3024.00;163
7518;31;22336319;7518;498;8748;8909;4.79;0.30;324.43;9.53;1230;33;3025.00;161
7521;31;22336338;7521;500;8756;8909;4.87;0.30;324.50;9.53;1235;33;3026.00;153
7521;31;22336367;7521;495;8757;8909;4.87;0.30;324.50;9.52;1236;33;3027.00;152
7523;31;22336387;7523;500;8762;8909;4.90;0.30;324.47;9.52;1239;33;3028.00;147
7526;31;22336402;7526;502;8765;8909;4.87;0.30;324.43;9.52;1239;33;3029.00;144
7527;31;22336420;7527;511;8767;8909;4.86;0.30;324.40;9.52;1240;34;3030.00;142
7530;31;22336446;7530;497;8769;8909;4.84;0.30;324.36;9.52;1239;34;3031.00;140
7531;31;22336462;7531;487;8770;8910;4.77;0.29;324.33;9.52;1239;34;3032.00;140
7531;31;22336477;7531;481;8772;8911;4.76;0.29;324.33;9.52;1241;34;3033.00;139
7533;31;22336491;7533;477;8775;8911;4.75;0.29;324.29;9.52;1242;34;3034.00;136
7535;31;22336507;7535;472;8778;8912;4.77;0.29;324.26;9.52;1243;34;3035.00;134
7536;31;22336524;7536;475;8781;8912;4.84;0.30;324.28;9.53;1245;34;3036.00;131
7536;31;22336540;7536;470;8783;8912;4.88;0.30;324.28;9.53;1247;34;3037.00;129
7537;31;22336556;7537;481;8786;8912;4.94;0.30;324.28;9.53;1249;34;3038.00;126
7540;31;22336573;7540;485;8792;8916;4.98;0.31;324.31;9.53;1252;34;3039.00;124
7541;31;22336598;7541;485;8796;8916;5.04;0.31;324.32;9.53;1255;34;3040.00;120
7543;31;22336617;7543;487;8798;8916;5.12;0.31;324.44;9.53;1255;34;3041.00;118
7545;31;22336633;7545;492;8801;8919;5.21;0.32;324.52;9.53;1256;34;3042.00;118
7546;31;22336650;7546;495;8803;8919;5.27;0.32;324.49;9.54;1257;34;3043.00;116
7548;31;22336666;7548;499;8804;8919;5.33;0.33;324.58;9.54;1256;34;3044.00;115
7550;31;22336682;7550;500;8810;8923;5.38;0.33;324.61;9.53;1260;34;3045.00;113
7553;31;22336701;7553;497;8810;8924;5.36;0.33;324.57;9.53;1257;34;3046.00;114
7553;31;22336720;7553;496;8812;8924;5.41;0.33;324.57;9.53;1259;34;3047.00;112
7554;31;22336740;7554;498;8814;8928;5.44;0.33;324.56;9.53;1260;34;3048.00;114
7555;31;22336757;7555;504;8817;8928;5.43;0.33;324.56;9.55;1262;34;3049.00;111
7556;31;22336777;7556;485;8818;8928;5.46;0.33;324.53;9.55;1262;34;3050.00;110
7556;31;22336792;7556;475;8819;8929;5.52;0.34;324.53;9.55;1263;34;3051.00;110
7559;31;22336809;7559;471;8819;8929;5.51;0.34;324.53;9.55;1260;34;3052.00;110
7559;31;22336825;7559;466;8824;8935;5.51;0.33;324.53;9.54;1265;34;3053.00;111
7563;31;22336841;7563;464;8824;8935;5.48;0.33;324.42;9.54;1261;34;3054.00;111
7565;31;22336860;7565;460;8824;8936;5.46;0.33;324.39;9.54;1259;34;3055.00;112
7565;31;22336882;7565;455;8824;8936;5.44;0.33;324.39;9.54;1259;34;3056.00;112
7565;31;22336904;7565;459;8824;8936;5.40;0.33;324.39;9.54;1259;34;3057.00;112
7567;31;22336922;7567;456;8824;8936;5.39;0.33;324.39;9.54;1257;34;3058.00;112
7569;31;22336939;7569;453;8824;8936;5.40;0.33;324.36;9.54;1255;34;3059.00;112
7570;31;22336956;7570;467;8849;8972;5.46;0.33;324.37;9.52;1279;34;3060.00;123
7573;32;22336978;7573;465;8850;8972;5.44;0.33;324.35;9.51;1277;35;3061.00;122
7574;32;22337008;7574;463;8853;8972;5.48;0.33;324.33;9.51;1279;35;3062.00;119
7575;33;22337025;7575;461;8853;8972;5.50;0.33;324.31;9.51;1278;36;3063.00;119
7577;33;22337056;7577;464;8854;8972;5.55;0.34;324.41;9.51;1277;36;3064.00;118
7580;33;22337073;7580;465;8856;8972;5.58;0.34;324.56;9.52;1276;36;3065.00;116
7581;33;22337101;7581;462;8859;8976;5.62;0.34;324.54;9.52;1278;36;3066.00;117
7581;33;22337119;7581;457;8859;8976;5.62;0.34;324.54;9.52;1278;36;3067.00;117
7582;33;22337155;7582;452;8862;8980;5.64;0.34;324.62;9.52;1280;36;3068.00;118
7584;33;22337180;7584;447;8863;8981;5.67;0.34;324.71;9.52;1279;36;3069.00;118
7586;33;22337201;7586;444;8863;8981;5.66;0.34;324.67;9.52;1277;36;3070.00;118
7587;33;22337219;7587;438;8863;8981;5.69;0.34;324.66;9.52;1276;36;3071.00;118
7589;33;22337235;7589;435;8872;8994;5.71;0.34;324.70;9.51;1283;36;3072.00;122
7593;33;22337257;7593;433;8872;8994;5.71;0.35;324.83;9.51;1279;36;3073.00;122
7596;33;22337280;7596;430;8872;8994;5.76;0.35;324.82;9.51;1276;36;3074.00;122
7600;33;22337302;7600;433;8873;8995;5.76;0.35;324.98;9.50;1273;36;3075.00;122
7603;33;22337322;7603;433;8873;8996;5.79;0.35;324.97;9.50;1270;36;3076.00;123
7606;33;22337340;7606;439;8873;8996;5.80;0.35;324.95;9.50;1267;36;3077.00;123
7611;33;22337356;7611;431;8875;8999;5.80;0.35;324.98;9.50;1264;36;3078.00;124
7614;33;22337373;7614;422;8876;8999;5.81;0.35;324.97;9.50;1262;36;3079.00;123
7617;33;22337389;7617;421;8878;8999;5.84;0.35;325.02;9.59;1261;36;3080.00;121
7621;33;22337410;7621;422;8879;8999;5.84;0.35;324.97;9.60;1258;36;3081.00;120
7624;33;22337427;7624;415;8885;9005;5.90;0.36;324.97;9.60;1261;36;3082.00;120
7627;33;22337459;7627;413;8887;9005;5.86;0.36;325.01;9.60;1260;36;3083.00;118
7630;33;22337480;7630;402;8887;9005;5.84;0.36;325.00;9.60;1257;36;3084.00;118
7633;33;22337497;7633;402;8887;9005;5.83;0.35;324.94;9.60;1254;36;3085.00;118
7634;33;22337512;7634;400;8890;9009;5.85;0.35;324.93;9.60;1256;36;3086.00;119
7635;33;22337529;7635;393;8891;9010;5.88;0.36;324.98;9.60;1256;36;3087.00;119
7637;33;22337545;7637;396;8892;9010;5.91;0.36;325.16;9.60;1255;36;3088.00;118
7639;33;22337561;7639;397;8893;9011;5.94;0.36;325.23;9.60;1254;36;3089.00;118
7644;33;22337582;7644;401;8894;9011;5.90;0.36;325.20;9.61;1250;36;3090.00;117
7648;33;22337608;7648;397;8894;9011;5.92;0.36;325.21;9.61;1246;36;3091.00;117
7650;33;22337634;7650;394;8895;9011;5.99;0.36;325.23;9.61;1245;36;3092.00;116
7653;33;22337653;7653;393;8895;9011;5.99;0.36;325.21;9.61;1242;36;3093.00;116
7656;33;22337670;7656;389;8895;9011;6.03;0.37;325.32;9.61;1239;36;3094.00;116
7656;33;22337686;7656;389;8895;9011;6.06;0.37;325.32;9.61;1239;36;3095.00;116
7658;33;22337703;7658;399;8931;9081;6.18;0.38;325.31;9.57;1273;36;3096.00;150
7660;33;22337726;7660;392;8933;9082;6.18;0.38;325.41;9.57;1273;36;3097.00;149
7663;33;22337746;7663;388;8939;9082;6.22;0.38;325.47;9.56;1276;36;3098.00;143
7667;33;22337767;7667;381;8939;9082;6.21;0.38;325.47;9.56;1272;36;3099.00;143
7670;33;22337788;7670;380;8943;9082;6.21;0.38;325.57;9.56;1273;36;3100.00;139
7675;33;22337817;7675;377;8945;9082;6.19;0.38;325.67;9.56;1270;36;3101.00;137
7677;34;22337835;7677;384;8947;9082;6.24;0.38;325.65;9.56;1270;37;3102.00;135
7679;34;22337866;7679;387;8951;9082;6.26;0.38;325.77;9.56;1272;37;3103.00;131
7683;34;22337890;7683;383;8952;9083;6.26;0.38;325.78;9.56;1269;37;3104.00;131
7686;34;22337909;7686;387;8956;9085;6.24;0.38;325.77;9.60;1270;37;3105.00;129
7689;34;22337931;7689;387;8959;9085;6.23;0.38;325.93;9.60;1270;37;3106.00;126
7691;34;22337955;7691;389;8965;9089;6.21;0.38;325.98;9.65;1274;37;3107.00;124
7692;34;22337973;7692;396;8967;9089;6.20;0.38;325.94;9.65;1275;37;3108.00;122
7696;34;22338002;7696;403;8969;9089;6.18;0.38;326.08;9.70;1273;37;3109.00;120
7698;34;22338023;7698;401;8970;9089;6.15;0.37;326.08;9.70;1272;37;3110.00;119
7702;34;22338040;7702;407;8975;9095;6.14;0.37;326.19;9.69;1273;37;3111.00;120
7706;34;22338056;7706;409;8975;9095;6.06;0.37;326.14;9.69;1269;37;3112.00;120
7711;34;22338073;7711;408;8977;9095;6.03;0.37;326.20;9.79;1266;37;3113.00;118
7714;34;22338098;7714;416;8980;9098;6.07;0.37;326.14;9.83;1266;37;3114.00;118
7717;34;22338118;7717;414;8980;9098;6.04;0.37;326.30;9.83;1263;37;3115.00;118
7717;34;22338135;7717;416;8981;9098;6.06;0.37;326.30;9.83;1264;37;3116.00;117
7719;34;22338151;7719;414;8982;9099;6.08;0.37;326.39;9.88;1263;37;3117.00;117
7722;34;22338168;7722;419;8983;9100;6.08;0.37;326.51;9.88;1261;37;3118.00;117
7724;34;22338186;7724;422;8984;9100;6.08;0.37;326.59;9.92;1260;37;3119.00;116
7727;34;22338207;7727;431;9005;9126;6.06;0.37;326.71;9.99;1278;37;3120.00;121
7729;34;22338228;7729;426;9007;9126;6.06;0.37;326.80;10.03;1278;37;3121.00;119
7732;34;22338245;7732;426;9010;9126;6.04;0.37;326.92;10.08;1278;37;3122.00;116
7736;34;22338262;7736;431;9012;9127;6.02;0.37;327.11;10.12;1276;37;3123.00;115
7740;34;22338279;7740;424;9013;9127;5.99;0.36;327.13;10.17;1273;37;3124.00;114
7744;34;22338299;7744;423;9017;9131;6.02;0.37;327.20;10.16;1273;37;3125.00;114
7749;34;22338316;7749;419;9019;9131;6.01;0.36;327.23;10.25;1270;37;3126.00;112
7752;34;22338332;7752;426;9022;9135;6.00;0.36;327.48;10.25;1270;37;3127.00;113
7756;34;22338349;7756;428;9022;9135;5.99;0.36;327.52;10.25;1266;37;3128.00;113
7757;34;22338365;7757;424;9024;9135;5.97;0.36;327.60;10.33;1267;37;3129.00;111
7759;34;22338381;7759;425;9024;9135;5.96;0.36;327.70;10.33;1265;37;3130.00;111
7762;34;22338397;7762;425;9026;9135;5.94;0.36;327.81;10.42;1264;37;3131.00;109
7764;34;22338413;7764;430;9036;9147;5.96;0.36;327.96;10.41;1272;37;3132.00;111
7765;34;22338431;7765;430;9036;9147;5.95;0.36;328.01;10.41;1271;37;3133.00;111
7768;34;22338446;7768;431;9039;9147;5.92;0.36;328.06;10.49;1271;37;3134.00;108
7770;34;22338462;7770;446;9039;9147;5.93;0.36;328.11;10.49;1269;37;3135.00;108
7774;34;22338477;7774;448;9041;9147;5.89;0.36;328.07;10.58;1267;37;3136.00;106
7778;34;22338492;7778;449;9041;9147;5.87;0.36;328.13;10.58;1263;37;3137.00;106
7784;34;22338510;7784;457;9042;9148;5.84;0.36;328.24;10.62;1258;37;3138.00;106
7787;34;22338539;7787;464;9043;9148;5.80;0.35;328.38;10.66;1256;37;3139.00;105
7791;34;22338565;7791;463;9048;9154;5.81;0.35;328.42;10.66;1257;37;3140.00;106
7793;34;22338596;7793;464;9051;9155;5.80;0.35;328.44;10.74;1258;37;3141.00;104
7796;34;22338622;7796;473;9051;9155;5.69;0.35;328.44;10.74;1255;37;3142.00;104
7800;34;22338647;7800;482;9053;9155;5.59;0.34;328.58;10.82;1253;37;3143.00;102
7804;34;22338663;7804;477;9056;9159;5.55;0.34;328.59;10.81;1252;37;3144.00;103
7810;34;22338679;7810;484;9056;9159;5.46;0.33;328.71;10.81;1246;37;3145.00;103
7813;34;22338696;7813;489;9058;9159;5.38;0.33;328.82;10.89;1245;37;3146.00;101
7816;34;22338710;7816;500;9059;9160;5.29;0.32;328.81;10.89;1243;37;3147.00;101
7822;34;22338724;7822;503;9062;9164;5.15;0.31;328.80;10.89;1240;37;3148.00;102
7824;34;22338739;7824;507;9062;9164;5.08;0.31;328.81;10.89;1238;37;3149.00;102
7830;34;22338754;7830;494;9066;9170;5.02;0.31;328.75;10.88;1236;37;3150.00;104
7836;34;22338770;7836;486;9066;9170;4.96;0.30;328.84;10.88;1230;37;3151.00;104
7839;34;22338784;7839;477;9068;9170;4.97;0.30;328.84;10.88;1229;37;3152.00;102
7843;34;22338807;7843;470;9068;9170;4.95;0.30;328.80;10.88;1225;37;3153.00;102
7847;34;22338821;7847;467;9072;9174;4.95;0.30;328.91;10.88;1225;37;3154.00;102
7848;34;22338837;7848;461;9072;9174;4.98;0.30;328.92;10.88;1224;37;3155.00;102
7852;34;22338852;7852;460;9072;9174;4.97;0.30;328.94;10.88;1220;37;3156.00;102
7855;34;22338868;7855;458;9072;9174;5.01;0.31;328.96;10.88;1217;37;3157.00;102
7857;34;22338882;7857;462;9072;9175;5.08;0.31;329.06;10.88;1215;37;3158.00;103
7861;34;22338896;7861;451;9073;9176;5.11;0.31;329.17;10.88;1212;37;3159.00;103
7864;34;22338911;7864;446;9073;9176;5.11;0.31;329.25;10.88;1209;37;3160.00;103
7867;34;22338926;7867;442;9074;9177;5.11;0.31;329.43;10.87;1207;37;3161.00;103
7870;34;22338947;7870;437;9074;9177;5.10;0.31;329.51;10.87;1204;37;3162.00;103
7874;34;22338962;7874;422;9074;9177;5.11;0.31;329.66;10.87;1200;37;3163.00;103
7877;34;22338977;7877;434;9074;9177;5.14;0.32;329.74;10.87;1197;37;3164.00;103
7882;34;22338990;7882;432;9074;9177;5.14;0.32;329.96;10.87;1192;37;3165.00;103
7889;34;22339006;7889;424;9074;9177;5.12;0.31;330.03;10.87;1185;37;3166.00;103
7892;34;22339023;7892;421;9074;9177;5.14;0.32;329.96;10.87;1182;37;3167.00;103
7894;34;22339039;7894;429;9137;9304;5.66;0.35;329.95;10.80;1243;37;3168.00;167
7899;34;22339066;7899;435;9143;9305;5.62;0.35;329.95;10.79;1244;37;3169.00;162
7902;34;22339087;7902;443;9151;9305;5.65;0.35;329.99;10.79;1249;37;3170.00;154
7906;34;22339105;7906;443;9155;9305;5.59;0.35;329.97;10.78;1249;37;3171.00;150
7908;34;22339122;7908;453;9159;9305;5.56;0.35;329.92;10.78;1251;37;3172.00;146
7915;34;22339139;7915;461;9163;9305;5.43;0.34;329.97;10.78;1248;37;3173.00;142
7918;34;22339156;7918;463;9164;9305;5.34;0.33;330.01;10.78;1246;37;3174.00;141
7922;34;22339177;7922;471;9169;9305;5.27;0.33;329.96;10.77;1247;37;3175.00;136
7929;34;22339198;7929;480;9170;9306;5.14;0.32;329.90;10.77;1241;37;3176.00;136
7933;34;22339217;7933;485;9173;9307;5.09;0.32;329.91;10.77;1240;37;3177.00;134
7939;34;22339238;7939;483;9175;9307;5.02;0.31;329.84;10.77;1236;37;3178.00;132
7945;34;22339261;7945;491;9178;9308;4.92;0.30;329.90;10.77;1233;37;3179.00;130
7950;34;22339285;7950;495;9180;9308;4.88;0.30;329.91;10.77;1230;37;3180.00;128
7955;34;22339313;7955;499;9183;9308;4.87;0.30;329.89;10.77;1228;37;3181.00;125
7960;34;22339338;7960;507;9185;9308;4.81;0.30;329.97;10.77;1225;37;3182.00;123
7961;34;22339356;7961;508;9191;9312;4.81;0.30;329.94;10.77;1230;37;3183.00;121
7964;34;22339375;7964;511;9192;9312;4.73;0.29;329.93;10.77;1228;37;3184.00;120
7967;34;22339395;7967;511;9192;9312;4.63;0.29;329.92;10.77;1225;37;3185.00;120
7968;34;22339411;7968;518;9195;9315;4.56;0.28;329.92;10.77;1227;37;3186.00;120
7974;34;22339428;7974;521;9195;9315;4.45;0.27;329.83;10.77;1221;37;3187.00;120
7977;34;22339442;7977;515;9196;9315;4.35;0.27;329.78;10.77;1219;37;3188.00;119
7981;34;22339458;7981;519;9200;9319;4.30;0.26;329.68;10.77;1219;37;3189.00;119
7985;34;22339480;7985;518;9202;9320;4.25;0.26;329.69;10.77;1217;37;3190.00;118
7987;34;22339493;7987;515;9204;9322;4.27;0.26;329.67;10.77;1217;37;3191.00;118
7990;34;22339507;7990;516;9208;9326;4.33;0.27;329.63;10.77;1218;37;3192.00;118
7993;34;22339522;7993;522;9211;9326;4.39;0.27;329.60;10.78;1218;37;3193.00;115
7994;34;22339538;7994;523;9211;9326;4.42;0.27;329.60;10.78;1217;37;3194.00;115
7994;34;22339555;7994;523;9213;9328;4.44;0.27;329.60;10.78;1219;37;3195.00;115
7997;34;22339572;7997;530;9213;9328;4.39;0.27;329.60;10.78;1216;37;3196.00;115
7997;34;22339590;7997;522;9218;9334;4.39;0.27;329.60;10.77;1221;37;3197.00;116
7999;34;22339608;7999;512;9218;9334;4.31;0.27;329.56;10.77;1219;37;3198.00;116
8000;34;22339629;8000;512;9218;9335;4.33;0.27;329.52;10.77;1218;37;3199.00;117
8002;34;22339659;8002;517;9218;9335;4.34;0.27;329.50;10.77;1216;37;3200.00;117
8003;34;22339683;8003;513;9218;9335;4.37;0.27;329.50;10.77;1215;37;3201.00;117
8005;34;22339699;8005;518;9218;9335;4.43;0.27;329.52;10.77;1213;37;3202.00;117
8005;34;22339726;8005;510;9218;9335;4.48;0.28;329.52;10.77;1213;37;3203.00;117
8010;34;22339740;8010;519;9227;9347;4.60;0.28;329.62;10.76;1217;37;3204.00;120
8011;34;22339758;8011;518;9228;9347;4.67;0.29;329.62;10.76;1217;37;3205.00;119
8012;34;22339777;8012;506;9229;9347;4.72;0.29;329.60;10.76;1217;37;3206.00;118
8014;34;22339803;8014;488;9229;9347;4.76;0.29;329.53;10.76;1215;37;3207.00;118
8020;34;22339832;8020;475;9229;9347;4.77;0.29;329.49;10.76;1209;37;3208.00;118
8023;34;22339853;8023;462;9230;9347;4.77;0.29;329.47;10.77;1207;37;3209.00;117
8023;34;22339873;8023;451;9233;9351;4.85;0.30;329.47;10.77;1210;37;3210.00;118
8025;34;22339889;8025;442;9233;9351;4.88;0.30;329.56;10.77;1208;37;3211.00;118
8026;34;22339906;8026;437;9237;9355;5.00;0.30;329.54;10.76;1211;37;3212.00;118
8027;34;22339922;8027;431;9238;9356;5.06;0.31;329.52;10.76;1211;37;3213.00;118
8028;34;22339941;8028;428;9238;9356;5.09;0.31;329.51;10.76;1210;37;3214.00;118
8030;34;22339962;8030;430;9238;9356;5.11;0.31;329.50;10.76;1208;37;3215.00;118
8031;34;22339981;8031;428;9249;9369;5.25;0.32;329.50;10.75;1218;37;3216.00;120
8031;34;22340007;8031;426;9249;9369;5.27;0.32;329.50;10.75;1218;37;3217.00;120
8035;34;22340025;8035;416;9249;9369;5.28;0.32;329.43;10.75;1214;37;3218.00;120
8037;34;22340041;8037;424;9251;9370;5.36;0.33;329.40;10.76;1214;37;3219.00;119
8040;34;22340056;8040;431;9251;9371;5.41;0.33;329.44;10.76;1211;37;3220.00;120
8041;34;22340073;8041;428;9251;9371;5.46;0.33;329.45;10.76;1210;37;3221.00;120
8042;34;22340098;8042;423;9253;9374;5.49;0.33;329.45;10.75;1211;37;3222.00;121
8043;34;22340122;8043;423;9253;9374;5.50;0.33;329.45;10.75;1210;37;3223.00;121
8043;34;22340150;8043;424;9254;9374;5.50;0.33;329.45;10.75;1211;37;3224.00;120
8045;34;22340168;8045;419;9254;9374;5.52;0.34;329.51;10.75;1209;37;3225.00;120
8045;34;22340184;8045;418;9259;9380;5.59;0.34;329.51;10.75;1214;37;3226.00;121
8045;34;22340201;8045;417;9259;9380;5.63;0.34;329.51;10.75;1214;37;3227.00;121
8046;34;22340217;8046;417;9259;9380;5.70;0.35;329.51;10.75;1213;37;3228.00;121
8047;34;22340234;8047;419;9259;9380;5.77;0.35;329.47;10.75;1212;37;3229.00;121
8050;34;22340262;8050;411;9262;9384;5.80;0.35;329.52;10.74;1212;37;3230.00;122
8054;34;22340286;8054;413;9263;9385;5.85;0.36;329.70;10.74;1209;37;3231.00;122
8056;34;22340305;8056;411;9264;9385;5.87;0.36;329.68;10.75;1208;37;3232.00;121
8059;34;22340324;8059;404;9265;9386;5.94;0.36;329.69;10.75;1206;37;3233.00;121
8062;34;22340344;8062;403;9265;9386;5.96;0.36;329.66;10.75;1203;37;3234.00;121
8065;34;22340363;8065;404;9265;9386;5.99;0.36;329.64;10.75;1200;37;3235.00;121
8067;34;22340380;8067;403;9265;9386;6.00;0.37;329.66;10.75;1198;37;3236.00;121
8073;34;22340397;8073;398;9265;9386;5.98;0.36;329.71;10.75;1192;37;3237.00;121
8076;34;22340413;8076;394;9265;9386;6.01;0.36;329.82;10.75;1189;37;3238.00;121
8078;34;22340430;8078;395;9265;9386;6.03;0.37;329.94;10.75;1187;37;3239.00;121
8082;34;22340449;8082;412;9329;9511;6.10;0.37;330.01;10.68;1247;37;3240.00;182
8083;35;22340503;8083;398;9330;9512;6.12;0.37;330.00;10.69;1247;38;3241.00;182
8084;35;22340535;8084;382;9337;9512;6.19;0.38;330.05;10.68;1253;38;3242.00;175
8086;35;22340551;8086;372;9339;9512;6.31;0.39;330.14;10.68;1253;38;3243.00;173
8087;35;22340568;8087;371;9345;9512;6.40;0.39;330.14;10.67;1258;38;3244.00;167
8087;35;22340588;8087;363;9347;9512;6.52;0.40;330.14;10.67;1260;38;3245.00;165
8090;35;22340610;8090;360;9353;9512;6.56;0.40;330.15;10.67;1263;38;3246.00;159
8092;35;22340631;8092;364;9356;9512;6.59;0.40;330.20;10.67;1264;38;3247.00;156
8095;35;22340649;8095;366;9360;9513;6.62;0.40;330.18;10.67;1265;38;3248.00;153
8101;35;22340666;8101;358;9364;9514;6.59;0.40;330.21;10.67;1263;38;3249.00;150
8102;35;22340684;8102;354;9368;9514;6.56;0.40;330.22;10.66;1266;38;3250.00;146
8106;35;22340702;8106;357;9371;9518;6.56;0.40;330.28;10.66;1265;38;3251.00;147
8108;35;22340720;8108;352;9371;9518;6.55;0.40;330.28;10.66;1263;38;3252.00;147
8111;35;22340740;8111;362;9371;9518;6.49;0.40;330.27;10.66;1260;38;3253.00;147
8113;35;22340768;8113;357;9371;9518;6.41;0.39;330.34;10.66;1258;38;3254.00;147
8115;35;22340786;8115;356;9377;9524;6.41;0.39;330.41;10.75;1262;38;3255.00;147
8117;35;22340808;8117;358;9377;9524;6.39;0.39;330.46;10.75;1260;38;3256.00;147
8120;35;22340828;8120;357;9377;9524;6.36;0.39;330.55;10.75;1257;38;3257.00;147
8122;35;22340849;8122;360;9381;9527;6.32;0.38;330.56;10.75;1259;38;3258.00;146
8126;35;22340871;8126;364;9381;9527;6.29;0.38;330.62;10.75;1255;38;3259.00;146
8129;35;22340892;8129;371;9382;9527;6.31;0.38;330.72;10.75;1253;38;3260.00;145
8130;35;22340910;8130;366;9382;9528;6.34;0.38;330.83;10.75;1252;38;3261.00;146
8132;35;22340935;8132;362;9383;9529;6.38;0.39;330.89;10.75;1251;38;3262.00;146
8134;35;22340960;8134;371;9383;9529;6.37;0.39;330.90;10.75;1249;38;3263.00;146
8140;35;22340981;8140;354;9393;9542;6.37;0.39;331.19;10.74;1253;38;3264.00;149
8143;35;22341002;8143;354;9393;9542;6.37;0.39;331.24;10.74;1250;38;3265.00;149
8144;35;22341026;8144;354;9394;9542;6.36;0.39;331.28;10.74;1250;38;3266.00;148
8148;35;22341050;8148;346;9395;9543;6.36;0.39;331.38;10.74;1247;38;3267.00;148
8151;35;22341068;8151;349;9395;9543;6.34;0.39;331.50;10.74;1244;38;3268.00;148
8156;35;22341084;8156;346;9398;9547;6.34;0.39;331.47;10.74;1242;38;3269.00;149
8158;35;22341103;8158;349;9398;9547;6.33;0.39;331.58;10.74;1240;38;3270.00;149
8159;35;22341120;8159;347;9401;9551;6.31;0.38;331.60;10.73;1242;38;3271.00;150
8161;35;22341137;8161;344;9402;9551;6.28;0.38;331.79;10.73;1241;38;3272.00;149
8164;35;22341157;8164;343;9402;9551;6.27;0.38;331.75;10.73;1238;38;3273.00;149
8167;35;22341179;8167;351;9402;9551;6.24;0.38;331.80;10.73;1235;38;3274.00;149
8168;35;22341201;8168;351;9402;9551;6.26;0.38;331.89;10.73;1234;38;3275.00;149
8170;35;22341224;8170;356;9411;9563;6.32;0.39;331.89;10.72;1241;38;3276.00;152
8174;35;22341253;8174;361;9414;9563;6.30;0.39;332.05;10.73;1240;38;3277.00;149
8177;35;22341274;8177;358;9415;9563;6.28;0.38;332.08;10.73;1238;38;3278.00;148
8180;35;22341299;8180;369;9415;9563;6.23;0.38;332.11;10.73;1235;38;3279.00;148
8183;35;22341321;8183;370;9417;9563;6.19;0.38;332.23;10.78;1234;38;3280.00;146
8184;35;22341354;8184;379;9418;9563;6.20;0.38;332.23;10.78;1234;38;3281.00;145
8188;35;22341381;8188;383;9418;9564;6.20;0.38;332.30;10.78;1230;38;3282.00;146
8190;35;22341404;8190;385;9419;9564;6.19;0.38;332.26;10.83;1229;38;3283.00;145
8193;35;22341432;8193;386;9424;9570;6.24;0.38;332.32;10.83;1231;38;3284.00;146
8196;35;22341461;8196;388;9427;9572;6.19;0.38;332.41;10.87;1231;38;3285.00;145
8199;35;22341483;8199;393;9427;9572;6.20;0.38;332.46;10.87;1228;38;3286.00;145
8203;35;22341505;8203;400;9428;9572;6.20;0.38;332.54;10.92;1225;38;3287.00;144
8208;35;22341522;8208;403;9431;9576;6.22;0.38;332.61;10.92;1223;38;3288.00;145
8211;35;22341540;8211;408;9431;9576;6.16;0.38;332.55;10.92;1220;38;3289.00;145
8218;35;22341557;8218;411;9432;9576;6.03;0.37;332.58;10.97;1214;38;3290.00;144
8220;35;22341573;8220;418;9433;9577;6.02;0.37;332.61;10.97;1213;38;3291.00;144
8224;35;22341589;8224;417;9436;9581;5.97;0.36;332.65;10.96;1212;38;3292.00;145
8227;35;22341606;8227;422;9437;9581;5.94;0.36;332.76;11.01;1210;38;3293.00;144
8229;35;22341625;8229;426;9439;9584;5.93;0.36;332.81;11.01;1210;38;3294.00;145
8230;35;22341651;8230;428;9442;9584;5.91;0.36;332.85;11.11;1212;38;3295.00;142
8233;35;22341671;8233;425;9442;9584;5.87;0.36;333.08;11.11;1209;38;3296.00;142
8235;35;22341687;8235;428;9442;9584;5.85;0.36;333.13;11.11;1207;38;3297.00;142
8237;35;22341703;8237;432;9449;9588;5.81;0.36;333.22;11.25;1212;38;3298.00;139
8239;35;22341719;8239;427;9449;9588;5.76;0.35;333.18;11.25;1210;38;3299.00;139
8244;35;22341737;8244;425;9457;9607;5.69;0.35;333.27;11.39;1213;38;3300.00;150
8246;35;22341760;8246;419;9458;9607;5.67;0.35;333.31;11.43;1212;38;3301.00;149
8249;35;22341775;8249;418;9459;9608;5.63;0.34;333.45;11.48;1210;38;3302.00;149
8251;35;22341791;8251;412;9460;9609;5.59;0.34;333.51;11.48;1209;38;3303.00;149
8252;35;22341810;8252;411;9460;9609;5.57;0.34;333.55;11.48;1208;38;3304.00;149
8255;35;22341829;8255;411;9464;9610;5.52;0.34;333.67;11.57;1209;38;3305.00;146
8257;35;22341845;8257;410;9465;9610;5.54;0.34;333.69;11.56;1208;38;3306.00;145
8259;35;22341860;8259;414;9465;9610;5.55;0.34;333.64;11.56;1206;38;3307.00;145
8261;35;22341875;8261;413;9467;9610;5.58;0.34;333.78;11.65;1206;38;3308.00;143
8262;35;22341889;8262;421;9467;9610;5.59;0.34;333.89;11.65;1205;38;3309.00;143
8264;35;22341904;8264;415;9469;9610;5.61;0.34;333.97;11.74;1205;38;3310.00;141
8267;35;22341919;8267;417;9470;9610;5.62;0.34;333.91;11.74;1203;38;3311.00;140
8273;35;22341934;8273;431;9533;9737;5.80;0.36;334.26;11.76;1260;38;3312.00;204
8276;35;22341961;8276;442;9537;9738;5.84;0.36;334.26;11.75;1261;38;3313.00;201
8280;35;22341984;8280;442;9545;9738;5.82;0.36;334.22;11.74;1265;38;3314.00;193
8283;35;22342004;8283;445;9549;9738;5.76;0.36;334.26;11.83;1266;38;3315.00;189
8287;35;22342032;8287;455;9554;9738;5.72;0.35;334.32;11.83;1267;38;3316.00;184
8290;35;22342048;8290;462;9558;9738;5.65;0.35;334.41;11.87;1268;38;3317.00;180
8293;35;22342062;8293;475;9565;9738;5.57;0.34;334.48;11.91;1272;38;3318.00;173
8296;35;22342077;8296;476;9569;9738;5.54;0.34;334.45;11.91;1273;38;3319.00;169
8299;35;22342091;8299;476;9573;9739;5.50;0.34;334.52;11.91;1274;38;3320.00;166
8303;35;22342109;8303;473;9576;9740;5.41;0.33;334.68;11.91;1273;38;3321.00;164
8305;35;22342128;8305;477;9578;9740;5.35;0.33;334.61;11.91;1273;38;3322.00;162
8308;35;22342147;8308;489;9582;9741;5.28;0.33;334.65;11.91;1274;38;3323.00;159
8313;35;22342161;8313;494;9585;9741;5.16;0.32;334.76;11.91;1272;38;3324.00;156
8317;35;22342177;8317;489;9585;9741;5.07;0.31;334.82;11.91;1268;38;3325.00;156
8322;35;22342190;8322;495;9588;9741;5.02;0.31;335.02;11.91;1266;38;3326.00;153
8331;35;22342206;8331;494;9590;9745;4.92;0.30;335.00;11.91;1259;38;3327.00;155
8334;35;22342222;8334;496;9592;9745;4.90;0.30;335.11;11.91;1258;38;3328.00;153
8340;35;22342238;8340;494;9594;9745;4.83;0.30;335.22;11.91;1254;38;3329.00;151
8343;35;22342259;8343;497;9597;9751;4.84;0.30;335.22;11.91;1254;38;3330.00;154
8344;35;22342280;8344;495;9597;9751;4.85;0.30;335.19;11.91;1253;38;3331.00;154
8349;35;22342298;8349;485;9599;9751;4.76;0.29;335.26;11.91;1250;38;3332.00;152
8352;35;22342313;8352;492;9604;9755;4.73;0.29;335.32;11.91;1252;38;3333.00;151
8357;35;22342329;8357;480;9607;9756;4.68;0.29;335.27;11.91;1250;38;3334.00;149
8363;35;22342344;8363;474;9608;9756;4.62;0.28;335.26;11.91;1245;38;3335.00;148
8367;35;22342357;8367;474;9610;9760;4.63;0.28;335.31;11.91;1243;38;3336.00;150
8369;35;22342373;8369;466;9612;9760;4.65;0.29;335.31;11.91;1243;38;3337.00;148
8371;35;22342392;8371;469;9612;9760;4.69;0.29;335.32;11.91;1241;38;3338.00;148
8375;35;22342413;8375;468;9612;9761;4.72;0.29;335.27;11.91;1237;38;3339.00;149
8379;35;22342434;8379;468;9613;9761;4.69;0.29;335.24;11.91;1234;38;3340.00;148
8384;35;22342451;8384;472;9619;9767;4.69;0.29;335.22;11.91;1235;38;3341.00;148
8389;35;22342468;8389;472;9620;9767;4.68;0.29;335.35;11.91;1231;38;3342.00;147
8391;35;22342485;8391;470;9621;9768;4.67;0.29;335.34;11.91;1230;38;3343.00;147
8394;35;22342499;8394;478;9622;9768;4.64;0.28;335.38;11.91;1228;38;3344.00;146
8399;35;22342515;8399;489;9622;9768;4.59;0.28;335.30;11.91;1223;38;3345.00;146
8404;35;22342534;8404;496;9623;9768;4.52;0.28;335.31;11.91;1219;38;3346.00;145
8409;35;22342561;8409;506;9623;9768;4.46;0.27;335.35;11.91;1214;38;3347.00;145
8411;35;22342583;8411;505;9634;9780;4.48;0.27;335.29;11.90;1223;38;3348.00;146
8416;35;22342603;8416;504;9634;9780;4.40;0.27;335.35;11.90;1218;38;3349.00;146
8419;35;22342621;8419;498;9636;9780;4.37;0.27;335.35;11.90;1217;38;3350.00;144
8421;35;22342637;8421;504;9636;9780;4.36;0.27;335.33;11.90;1215;38;3351.00;144
8426;35;22342651;8426;507;9637;9780;4.32;0.26;335.26;11.90;1211;38;3352.00;143
8430;35;22342669;8430;514;9638;9780;4.28;0.26;335.21;11.90;1208;38;3353.00;142
8432;35;22342688;8432;516;9641;9784;4.27;0.26;335.20;11.90;1209;38;3354.00;143
8432;35;22342704;8432;515;9641;9784;4.21;0.26;335.20;11.90;1209;38;3355.00;143
8435;35;22342721;8435;518;9645;9788;4.18;0.26;335.21;11.90;1210;38;3356.00;143
8437;35;22342739;8437;528;9646;9789;4.15;0.26;335.14;11.90;1209;38;3357.00;143
8442;35;22342755;8442;524;9647;9789;4.12;0.25;335.13;11.89;1205;38;3358.00;142
8445;35;22342772;8445;525;9647;9789;4.09;0.25;335.18;11.89;1202;38;3359.00;142
8447;35;22342791;8447;533;9669;9818;4.15;0.25;335.17;11.87;1222;38;3360.00;149
8451;35;22342814;8451;534;9669;9818;4.09;0.25;335.24;11.87;1218;38;3361.00;149
8456;35;22342833;8456;535;9671;9818;4.01;0.25;335.22;11.87;1215;38;3362.00;147
8457;35;22342852;8457;549;9673;9819;3.99;0.24;335.22;11.86;1216;38;3363.00;146
8460;35;22342872;8460;543;9674;9820;3.98;0.24;335.21;11.88;1214;38;3364.00;146
8463;35;22342899;8463;534;9674;9820;4.01;0.25;335.21;11.88;1211;38;3365.00;146
8466;35;22342922;8466;529;9677;9823;4.11;0.25;335.15;11.88;1211;38;3366.00;146
8470;35;22342939;8470;526;9677;9823;4.13;0.25;335.16;11.88;1207;38;3367.00;146
8471;35;22342958;8471;525;9677;9823;4.20;0.26;335.16;11.88;1206;38;3368.00;146
8472;35;22342979;8472;518;9677;9823;4.28;0.26;335.12;11.88;1205;38;3369.00;146
8475;35;22343001;8475;521;9682;9829;4.34;0.26;335.20;11.87;1207;38;3370.00;147
8477;35;22343042;8477;521;9682;9829;4.35;0.27;335.21;11.87;1205;38;3371.00;147
8480;35;22343062;8480;506;9682;9829;4.39;0.27;335.22;11.87;1202;38;3372.00;147
8481;35;22343084;8481;497;9682;9829;4.46;0.27;335.24;11.87;1201;38;3373.00;147
8483;35;22343110;8483;495;9685;9833;4.54;0.28;335.24;11.87;1202;38;3374.00;148
8486;35;22343131;8486;495;9687;9835;4.59;0.28;335.24;11.87;1201;38;3375.00;148
8488;35;22343149;8488;478;9687;9835;4.68;0.28;335.21;11.87;1199;38;3376.00;148
8488;35;22343171;8488;472;9688;9836;4.81;0.29;335.21;11.87;1200;38;3377.00;148
8490;35;22343200;8490;473;9688;9836;4.88;0.30;335.15;11.87;1198;38;3378.00;148
8494;35;22343221;8494;467;9688;9836;4.92;0.30;335.19;11.87;1194;38;3379.00;148
8495;35;22343237;8495;468;9688;9836;4.98;0.30;335.15;11.87;1193;38;3380.00;148
8496;35;22343264;8496;452;9689;9836;5.06;0.31;335.17;11.88;1193;38;3381.00;147
8497;35;22343282;8497;444;9689;9836;5.09;0.31;335.22;11.88;1192;38;3382.00;147
8499;35;22343298;8499;426;9689;9836;5.13;0.31;335.31;11.88;1190;38;3383.00;147
8499;35;22343314;8499;432;9730;9906;5.29;0.32;335.31;11.83;1231;38;3384.00;176
8500;35;22343338;8500;416;9731;9907;5.39;0.33;335.42;11.83;1231;38;3385.00;176
8502;35;22343358;8502;410;9736;9907;5.50;0.34;335.46;11.82;1234;38;3386.00;171
8505;35;22343386;8505;410;9736;9907;5.52;0.34;335.62;11.82;1231;38;3387.00;171
8507;35;22343402;8507;407;9739;9907;5.59;0.34;335.65;11.82;1232;38;3388.00;168
8512;35;22343420;8512;400;9742;9907;5.65;0.34;335.61;11.82;1230;38;3389.00;165
8513;35;22343439;8513;406;9745;9907;5.74;0.35;335.65;11.82;1232;38;3390.00;162
8516;35;22343455;8516;405;9748;9907;5.76;0.35;335.76;11.82;1232;38;3391.00;159
8518;35;22343474;8518;404;9749;9908;5.75;0.35;335.83;11.82;1231;38;3392.00;159
8523;35;22343496;8523;411;9751;9909;5.74;0.35;335.92;11.81;1228;38;3393.00;158
8527;35;22343513;8527;412;9754;9909;5.73;0.35;336.21;11.81;1227;38;3394.00;155
8530;35;22343530;8530;410;9760;9913;5.68;0.35;336.23;11.81;1230;38;3395.00;153
8535;35;22343547;8535;414;9761;9913;5.69;0.35;336.41;11.82;1226;38;3396.00;152
8537;35;22343564;8537;417;9761;9913;5.75;0.35;336.43;11.82;1224;38;3397.00;152
8539;35;22343580;8539;418;9761;9913;5.81;0.35;336.51;11.82;1222;38;3398.00;152
8541;35;22343596;8541;417;9766;9919;5.87;0.36;336.67;11.82;1225;38;3399.00;153
8543;35;22343614;8543;418;9766;9919;5.93;0.36;336.76;11.82;1223;38;3400.00;153
8545;35;22343638;8545;426;9766;9919;5.96;0.36;336.87;11.82;1221;38;3401.00;153
8547;35;22343657;8547;425;9769;9922;6.02;0.37;336.92;11.83;1222;38;3402.00;153
8551;35;22343677;8551;419;9769;9922;5.98;0.36;336.87;11.83;1218;38;3403.00;153
8553;35;22343691;8553;415;9770;9922;6.02;0.37;336.94;11.83;1217;38;3404.00;152
8556;35;22343708;8556;412;9770;9923;6.01;0.36;336.97;11.83;1214;38;3405.00;153
8560;35;22343729;8560;413;9772;9924;6.01;0.36;337.04;11.84;1212;38;3406.00;152
8564;35;22343747;8564;419;9772;9924;5.98;0.36;337.12;11.84;1208;38;3407.00;152
8566;35;22343768;8566;426;9782;9937;6.05;0.37;337.15;11.83;1216;38;3408.00;155
8567;35;22343791;8567;424;9783;9937;6.09;0.37;337.22;11.83;1216;38;3409.00;154
8568;35;22343815;8568;426;9783;9937;6.05;0.37;337.27;11.83;1215;38;3410.00;154
8570;35;22343839;8570;433;9784;9938;6.02;0.37;337.38;11.83;1214;38;3411.00;154
8572;35;22343857;8572;431;9784;9938;5.94;0.36;337.57;11.83;1212;38;3412.00;154
8576;35;22343874;8576;435;9788;9942;5.89;0.36;337.62;11.83;1212;38;3413.00;154
8579;35;22343890;8579;434;9788;9942;5.83;0.35;337.64;11.83;1209;38;3414.00;154
8582;35;22343906;8582;425;9791;9946;5.77;0.35;337.76;11.82;1209;38;3415.00;155
8584;35;22343923;8584;422;9791;9946;5.77;0.35;337.85;11.82;1207;38;3416.00;155
8585;35;22343940;8585;421;9791;9946;5.80;0.35;337.89;11.82;1206;38;3417.00;155
8586;35;22343960;8586;416;9791;9946;5.82;0.35;337.95;11.82;1205;38;3418.00;155
8588;35;22343982;8588;399;9791;9946;5.85;0.35;338.04;11.82;1203;38;3419.00;155
8590;35;22344004;8590;395;9817;9980;5.92;0.36;338.06;11.79;1227;38;3420.00;163
8594;35;22344033;8594;392;9817;9980;5.95;0.36;338.14;11.79;1223;38;3421.00;163
8597;35;22344051;8597;389;9819;9980;6.01;0.37;338.12;11.79;1222;38;3422.00;161
8598;35;22344069;8598;387;9819;9980;6.08;0.37;338.12;11.79;1221;38;3423.00;161
8601;35;22344085;8601;388;9820;9980;6.13;0.37;338.13;11.79;1219;38;3424.00;160
8604;35;22344103;8604;380;9820;9980;6.13;0.37;338.18;11.79;1216;38;3425.00;160
8607;35;22344123;8607;386;9820;9981;6.12;0.37;338.22;11.79;1213;38;3426.00;161
8609;35;22344148;8609;382;9821;9981;6.08;0.37;338.33;11.81;1212;38;3427.00;160
8612;35;22344167;8612;382;9826;9987;6.04;0.37;338.40;11.80;1214;38;3428.00;161
8614;35;22344184;8614;379;9827;9988;6.04;0.37;338.47;11.80;1213;38;3429.00;161
8618;35;22344207;8618;374;9829;9988;6.00;0.36;338.55;11.91;1211;38;3430.00;159
8621;35;22344228;8621;373;9829;9988;5.92;0.36;338.57;11.91;1208;38;3431.00;159
8625;35;22344244;8625;376;9832;9992;5.89;0.36;338.65;11.90;1207;38;3432.00;160
8630;35;22344263;8630;382;9832;9992;5.89;0.36;338.74;11.90;1202;38;3433.00;160
8634;35;22344284;8634;386;9832;9992;5.86;0.36;338.82;11.90;1198;38;3434.00;160
8635;35;22344305;8635;382;9833;9993;5.85;0.36;338.81;11.90;1198;38;3435.00;160
8638;35;22344335;8638;380;9836;9997;5.82;0.35;338.78;11.90;1198;38;3436.00;161
8641;35;22344356;8641;387;9836;9997;5.81;0.35;338.82;11.90;1195;38;3437.00;161
8643;35;22344374;8643;386;9838;10000;5.86;0.35;338.89;11.90;1195;38;3438.00;162
8646;35;22344391;8646;386;9839;10000;5.94;0.36;338.95;11.90;1193;38;3439.00;161
8647;35;22344407;8647;386;9839;10000;6.00;0.36;338.92;11.90;1192;38;3440.00;161
8648;36;22344424;8648;386;9839;10000;6.04;0.37;339.00;11.90;1191;39;3441.00;161
8651;36;22344463;8651;391;9844;10004;6.07;0.37;338.96;11.91;1193;39;3442.00;160
8652;36;22344483;8652;398;9844;10004;6.10;0.37;339.04;11.91;1192;39;3443.00;160
8654;36;22344500;8654;400;9844;10004;6.17;0.37;339.03;11.91;1190;39;3444.00;160
8657;36;22344516;8657;401;9844;10004;6.22;0.38;339.00;11.91;1187;39;3445.00;160
8660;36;22344532;8660;409;9844;10005;6.22;0.38;339.04;11.91;1184;39;3446.00;161
8664;36;22344549;8664;407;9845;10006;6.20;0.38;339.19;11.91;1181;39;3447.00;161
8666;36;22344575;8666;400;9845;10006;6.15;0.37;339.19;11.91;1179;39;3448.00;161
8667;36;22344601;8667;401;9846;10007;6.14;0.37;339.22;11.91;1179;39;3449.00;161
8672;36;22344619;8672;408;9846;10007;6.02;0.37;339.34;11.91;1174;39;3450.00;161
8673;36;22344636;8673;409;9846;10007;5.97;0.36;339.33;11.91;1173;39;3451.00;161
8676;36;22344655;8676;407;9846;10007;5.93;0.36;339.36;11.91;1170;39;3452.00;161
8678;36;22344672;8678;422;9846;10007;5.90;0.36;339.46;11.91;1168;39;3453.00;161
8681;36;22344687;8681;423;9846;10007;5.91;0.36;339.62;11.91;1165;39;3454.00;161
8683;36;22344703;8683;425;9847;10007;5.88;0.36;339.66;11.97;1164;39;3455.00;160
8685;36;22344719;8685;446;9913;10134;6.02;0.37;339.77;11.89;1228;39;3456.00;221
8690;36;22344751;8690;439;9918;10135;5.99;0.37;339.79;11.94;1228;39;3457.00;217
8692;36;22344770;8692;439;9925;10135;6.06;0.37;339.83;11.93;1233;39;3458.00;210
8695;36;22344788;8695;447;9926;10135;6.07;0.37;339.88;11.93;1231;39;3459.00;209
8699;36;22344805;8699;447;9931;10135;6.07;0.37;339.90;11.98;1232;39;3460.00;204
8701;36;22344822;8701;457;9931;10135;6.06;0.37;339.87;11.98;1230;39;3461.00;204
8704;36;22344840;8704;463;9935;10135;6.10;0.37;340.03;11.98;1231;39;3462.00;200
8706;36;22344860;8706;471;9937;10135;6.09;0.37;340.11;12.03;1231;39;3463.00;198
8711;36;22344882;8711;474;9940;10136;6.14;0.38;340.15;12.03;1229;39;3464.00;196
8711;36;22344910;8711;471;9947;10138;6.23;0.38;340.15;12.14;1236;39;3465.00;191
8716;36;22344933;8716;469;9952;10138;6.24;0.38;340.17;12.24;1236;39;3466.00;186
8719;36;22344955;8719;474;9955;10139;6.22;0.38;340.17;12.24;1236;39;3467.00;184
8723;36;22344974;8723;471;9960;10139;6.19;0.38;340.09;12.35;1237;39;3468.00;179
8724;36;22344996;8724;469;9964;10139;6.10;0.37;340.12;12.35;1240;39;3469.00;175
8727;36;22345016;8727;472;9969;10139;6.04;0.37;340.12;12.45;1242;39;3470.00;170
8728;36;22345034;8728;477;9974;10143;6.00;0.37;340.13;12.45;1246;39;3471.00;169
8732;36;22345055;8732;481;9977;10143;5.92;0.36;340.23;12.45;1245;39;3472.00;166
8734;36;22345074;8734;488;9981;10143;5.86;0.36;340.21;12.55;1247;39;3473.00;162
8738;36;22345099;8738;492;9983;10146;5.77;0.35;340.28;12.55;1245;39;3474.00;163
8739;36;22345119;8739;492;9984;10146;5.71;0.35;340.35;12.55;1245;39;3475.00;162
8742;36;22345136;8742;501;9986;10146;5.61;0.34;340.34;12.65;1244;39;3476.00;160
8745;36;22345155;8745;500;9989;10150;5.55;0.34;340.46;12.65;1244;39;3477.00;161
8749;36;22345182;8749;504;9991;10151;5.56;0.34;340.48;12.65;1242;39;3478.00;160
8753;36;22345213;8753;507;9994;10151;5.51;0.34;340.65;12.75;1241;39;3479.00;157
8754;36;22345235;8754;507;9999;10156;5.51;0.34;340.69;12.75;1245;39;3480.00;157
8757;36;22345254;8757;509;10002;10156;5.45;0.33;340.67;12.85;1245;39;3481.00;154
8761;36;22345274;8761;512;10002;10156;5.43;0.33;340.72;12.85;1241;39;3482.00;154
8763;36;22345294;8763;512;10003;10157;5.41;0.33;340.75;12.84;1240;39;3483.00;154
8764;36;22345313;8764;519;10003;10157;5.40;0.33;340.78;12.84;1239;39;3484.00;154
8765;36;22345331;8765;517;10010;10163;5.40;0.33;340.76;12.94;1245;39;3485.00;153
8767;36;22345349;8767;526;10010;10163;5.36;0.33;340.81;12.94;1243;39;3486.00;153
8768;36;22345366;8768;526;10012;10164;5.29;0.32;340.82;13.03;1244;39;3487.00;152
8772;36;22345391;8772;529;10012;10164;5.22;0.32;340.76;13.03;1240;39;3488.00;152
8774;36;22345418;8774;533;10012;10164;5.16;0.31;340.78;13.03;1238;39;3489.00;152
8775;36;22345440;8775;535;10012;10164;5.12;0.31;340.78;13.03;1237;39;3490.00;152
8778;36;22345459;8778;546;10012;10164;5.07;0.31;340.83;13.03;1234;39;3491.00;152
8781;36;22345478;8781;548;10023;10176;5.06;0.31;340.84;13.02;1242;39;3492.00;153
8784;36;22345497;8784;554;10023;10176;5.00;0.30;340.97;13.02;1239;39;3493.00;153
8786;36;22345517;8786;561;10023;10176;4.98;0.30;340.94;13.02;1237;39;3494.00;153
8789;36;22345537;8789;557;10023;10176;4.94;0.30;340.89;13.02;1234;39;3495.00;153
8792;36;22345556;8792;560;10023;10176;4.84;0.30;340.88;13.02;1231;39;3496.00;153
8794;36;22345577;8794;570;10023;10176;4.73;0.29;340.84;13.02;1229;39;3497.00;153
8799;36;22345604;8799;574;10026;10180;4.62;0.28;340.73;13.02;1227;39;3498.00;154
8804;36;22345621;8804;569;10026;10180;4.51;0.28;340.69;13.02;1222;39;3499.00;154
8809;36;22345641;8809;564;10030;10184;4.51;0.28;340.63;13.01;1221;39;3500.00;154
8815;36;22345666;8815;555;10031;10185;4.47;0.27;340.53;13.01;1216;39;3501.00;154
8819;36;22345684;8819;554;10031;10185;4.47;0.27;340.49;13.01;1212;39;3502.00;154
8820;36;22345705;8820;554;10031;10185;4.48;0.27;340.48;13.01;1211;39;3503.00;154
8825;36;22345722;8825;559;10041;10198;4.51;0.28;340.40;13.00;1216;39;3504.00;157
8826;36;22345739;8826;562;10041;10198;4.56;0.28;340.39;13.00;1215;39;3505.00;157
8829;36;22345753;8829;567;10041;10198;4.52;0.28;340.37;13.00;1212;39;3506.00;157
8832;36;22345767;8832;558;10042;10199;4.49;0.28;340.37;12.99;1210;39;3507.00;157
8834;36;22345781;8834;548;10042;10200;4.46;0.27;340.38;12.99;1208;39;3508.00;158
8835;36;22345795;8835;552;10042;10200;4.47;0.28;340.39;12.99;1207;39;3509.00;158
8837;36;22345812;8837;548;10045;10206;4.49;0.28;340.36;12.99;1208;39;3510.00;161
8838;36;22345828;8838;549;10045;10206;4.50;0.28;340.37;12.99;1207;39;3511.00;161
8841;36;22345848;8841;547;10046;10206;4.50;0.28;340.37;12.99;1205;39;3512.00;160
8846;36;22345873;8846;545;10047;10206;4.48;0.28;340.28;12.99;1201;39;3513.00;159
8850;36;22345896;8850;542;10051;10212;4.51;0.28;340.31;12.98;1201;39;3514.00;161
8856;36;22345922;8856;547;10051;10212;4.51;0.28;340.23;12.98;1195;39;3515.00;161
8858;36;22345946;8858;546;10051;10212;4.52;0.28;340.22;12.98;1193;39;3516.00;161
8861;36;22345977;8861;552;10051;10212;4.46;0.27;340.23;12.98;1190;39;3517.00;161
8866;36;22346003;8866;549;10054;10216;4.42;0.27;340.19;12.98;1188;39;3518.00;162
8868;36;22346030;8868;559;10056;10219;4.34;0.27;340.19;12.98;1188;39;3519.00;163
8870;36;22346054;8870;561;10056;10219;4.30;0.26;340.15;12.98;1186;39;3520.00;163
8876;36;22346081;8876;545;10058;10220;4.27;0.26;340.11;12.98;1182;39;3521.00;162
8878;36;22346103;8878;539;10058;10220;4.22;0.26;340.12;12.98;1180;39;3522.00;162
8881;36;22346135;8881;525;10058;10220;4.18;0.26;340.16;12.98;1177;39;3523.00;162
8886;36;22346164;8886;522;10059;10220;4.17;0.25;340.15;12.98;1173;39;3524.00;161
8889;36;22346197;8889;515;10059;10220;4.19;0.26;340.16;12.98;1170;39;3525.00;161
8890;37;22346221;8890;511;10060;10220;4.23;0.26;340.14;13.00;1170;40;3526.00;160
8893;37;22346264;8893;509;10062;10220;4.24;0.26;340.14;13.00;1169;40;3527.00;158
8896;37;22346286;8896;511;10098;10290;4.42;0.27;340.15;12.96;1202;40;3528.00;192
8900;37;22346321;8900;513;10099;10291;4.50;0.27;340.10;12.96;1199;40;3529.00;192
8902;37;22346351;8902;518;10105;10291;4.59;0.28;340.11;12.95;1203;40;3530.00;186
8904;37;22346376;8904;509;10108;10291;4.67;0.29;340.08;12.95;1204;40;3531.00;183
8906;37;22346396;8906;503;10110;10291;4.78;0.29;340.14;12.95;1204;40;3532.00;181
8911;37;22346414;8911;507;10112;10291;4.81;0.29;340.16;12.94;1201;40;3533.00;179
8915;37;22346436;8915;499;10114;10291;4.86;0.30;340.12;12.94;1199;40;3534.00;177
8918;37;22346465;8918;500;10118;10291;4.91;0.30;340.13;12.94;1200;40;3535.00;173
8919;37;22346493;8919;504;10120;10292;4.92;0.30;340.14;12.94;1201;40;3536.00;172
8925;37;22346524;8925;502;10122;10293;4.90;0.30;340.09;12.94;1197;40;3537.00;171
8926;37;22346554;8926;509;10124;10293;4.91;0.30;340.06;12.94;1198;40;3538.00;169
8928;37;22346581;8928;507;10128;10297;4.94;0.30;340.08;12.93;1200;40;3539.00;169
8929;37;22346609;8929;511;10129;10297;4.93;0.30;340.07;12.93;1200;40;3540.00;168
8934;37;22346633;8934;513;10129;10297;4.88;0.30;340.18;12.93;1195;40;3541.00;168
8935;37;22346664;8935;518;10129;10297;4.87;0.30;340.18;12.93;1194;40;3542.00;168
8937;37;22346692;8937;520;10136;10303;4.85;0.29;340.21;12.93;1199;40;3543.00;167
8940;37;22346716;8940;521;10137;10303;4.77;0.29;340.26;12.93;1197;40;3544.00;166
8942;37;22346743;8942;519;10138;10303;4.74;0.29;340.23;12.93;1196;40;3545.00;165
8944;37;22346770;8944;520;10140;10306;4.73;0.29;340.29;12.93;1196;40;3546.00;166
8945;37;22346795;8945;506;10140;10306;4.70;0.29;340.30;12.93;1195;40;3547.00;166
8945;37;22346816;8945;502;10141;10306;4.72;0.29;340.30;12.92;1196;40;3548.00;165
8948;37;22346835;8948;496;10141;10307;4.72;0.29;340.26;12.92;1193;40;3549.00;166
8951;37;22346856;8951;490;10143;10308;4.73;0.29;340.38;12.95;1192;40;3550.00;165
8953;37;22346878;8953;489;10143;10308;4.72;0.29;340.50;12.95;1190;40;3551.00;165
8954;37;22346902;8954;491;10153;10321;4.85;0.29;340.49;12.94;1199;40;3552.00;168
8958;37;22346921;8958;488;10154;10321;4.86;0.29;340.54;12.94;1196;40;3553.00;167
8959;37;22346949;8959;484;10154;10321;4.91;0.30;340.63;12.94;1195;40;3554.00;167
8960;37;22346972;8960;481;10156;10323;4.99;0.30;340.64;12.94;1196;40;3555.00;167
8960;37;22347005;8960;468;10156;10323;5.07;0.31;340.64;12.94;1196;40;3556.00;167
8962;37;22347030;8962;466;10160;10327;5.13;0.31;340.72;12.93;1198;40;3557.00;167
8964;37;22347055;8964;453;10160;10327;5.20;0.32;340.81;12.93;1196;40;3558.00;167
8966;37;22347075;8966;445;10163;10331;5.21;0.32;340.90;12.93;1197;40;3559.00;168
8967;37;22347095;8967;442;10163;10331;5.24;0.32;340.93;12.93;1196;40;3560.00;168
8969;37;22347113;8969;435;10163;10331;5.25;0.32;341.04;12.93;1194;40;3561.00;168
8972;37;22347135;8972;435;10163;10331;5.26;0.32;341.03;12.93;1191;40;3562.00;168
8973;37;22347153;8973;436;10163;10331;5.26;0.32;341.03;12.93;1190;40;3563.00;168
8975;37;22347169;8975;441;10172;10343;5.29;0.32;341.14;12.92;1197;40;3564.00;171
8977;37;22347188;8977;449;10172;10343;5.24;0.32;341.28;12.92;1195;40;3565.00;171
8978;37;22347205;8978;453;10175;10343;5.31;0.32;341.25;12.94;1197;40;3566.00;168
8980;37;22347221;8980;452;10175;10343;5.29;0.32;341.27;12.94;1195;40;3567.00;168
8980;37;22347238;8980;451;10175;10343;5.25;0.32;341.27;12.94;1195;40;3568.00;168
8982;37;22347255;8982;452;10175;10343;5.22;0.32;341.37;12.94;1193;40;3569.00;168
8985;37;22347274;8985;447;10175;10344;5.23;0.32;341.39;12.94;1190;40;3570.00;169
8989;37;22347307;8989;453;10175;10344;5.22;0.32;341.43;12.94;1186;40;3571.00;169
8992;37;22347323;8992;448;10180;10350;5.25;0.32;341.53;12.94;1188;40;3572.00;170
8997;37;22347341;8997;456;10182;10351;5.24;0.32;341.56;12.97;1185;40;3573.00;169
8999;37;22347361;8999;450;10182;10351;5.25;0.32;341.67;12.97;1183;40;3574.00;169
9000;37;22347378;9000;446;10182;10351;5.28;0.32;341.76;12.97;1182;40;3575.00;169
9000;37;22347393;9000;445;10185;10355;5.33;0.32;341.76;12.97;1185;40;3576.00;170
9002;37;22347410;9002;437;10185;10355;5.29;0.32;341.90;12.97;1183;40;3577.00;170
9005;37;22347426;9005;446;10185;10355;5.29;0.32;341.95;12.97;1180;40;3578.00;170
9006;37;22347441;9006;452;10186;10356;5.32;0.32;341.99;12.96;1180;40;3579.00;170
9009;37;22347458;9009;457;10189;10360;5.31;0.32;341.96;12.96;1180;40;3580.00;171
9011;37;22347479;9011;452;10189;10360;5.40;0.33;341.93;12.96;1178;40;3581.00;171
9016;37;22347497;9016;447;10191;10363;5.49;0.33;342.03;12.96;1175;40;3582.00;172
9019;37;22347514;9019;445;10191;10363;5.53;0.34;342.01;12.96;1172;40;3583.00;172
9020;37;22347530;9020;453;10192;10363;5.57;0.34;342.07;12.96;1172;40;3584.00;171
9024;37;22347546;9024;444;10192;10363;5.61;0.34;342.02;12.96;1168;40;3585.00;171
9025;37;22347564;9025;447;10196;10367;5.66;0.34;342.01;12.95;1171;40;3586.00;171
9029;37;22347581;9029;437;10196;10367;5.63;0.34;342.01;12.95;1167;40;3587.00;171
9030;37;22347598;9030;442;10196;10367;5.66;0.34;342.07;12.95;1166;40;3588.00;171
9032;37;22347613;9032;440;10196;10367;5.61;0.34;342.10;12.95;1164;40;3589.00;171
9034;37;22347630;9034;441;10196;10368;5.58;0.34;342.08;12.95;1162;40;3590.00;172
9037;37;22347647;9037;436;10198;10369;5.61;0.34;342.13;12.98;1161;40;3591.00;171
9039;37;22347663;9039;428;10198;10369;5.62;0.34;342.18;12.98;1159;40;3592.00;171
9041;37;22347685;9041;418;10199;10370;5.65;0.34;342.13;12.98;1158;40;3593.00;171
9042;37;22347717;9042;411;10199;10370;5.69;0.34;342.17;12.98;1157;40;3594.00;171
9043;37;22347740;9043;400;10199;10370;5.71;0.35;342.23;12.98;1156;40;3595.00;171
9045;37;22347762;9045;393;10199;10370;5.75;0.35;342.31;12.98;1154;40;3596.00;171
9049;37;22347779;9049;394;10199;10370;5.76;0.35;342.37;12.98;1150;40;3597.00;171
9052;37;22347795;9052;389;10199;10370;5.78;0.35;342.40;12.98;1147;40;3598.00;171
9054;37;22347812;9054;393;10200;10370;5.78;0.35;342.40;13.02;1146;40;3599.00;170
9055;37;22347831;9055;447;10325;10623;5.74;0.36;342.41;12.86;1270;40;3600.00;298
9056;37;22347877;9056;434;10325;10624;5.74;0.36;342.41;12.86;1269;40;3601.00;299
9059;37;22347895;9059;418;10333;10624;5.81;0.36;342.49;12.85;1274;40;3602.00;291
9061;37;22347913;9061;401;10336;10624;5.87;0.37;342.53;12.85;1275;40;3603.00;288
9065;37;22347930;9065;395;10341;10624;5.91;0.37;342.63;12.84;1276;40;3604.00;283
9067;37;22347948;9067;389;10346;10624;5.96;0.37;342.68;12.96;1279;40;3605.00;278
9072;37;22347977;9072;377;10352;10624;6.00;0.37;342.80;12.95;1280;40;3606.00;272
9074;37;22347994;9074;371;10356;10624;6.02;0.37;342.79;12.95;1282;40;3607.00;268
9078;37;22348014;9078;365;10365;10625;6.03;0.37;342.82;12.95;1287;40;3608.00;260
9078;37;22348032;9078;363;10368;10626;6.11;0.38;342.82;12.94;1290;40;3609.00;258
9079;37;22348057;9079;365;10374;10626;6.14;0.38;342.81;12.94;1295;40;3610.00;252
9082;37;22348075;9082;366;10376;10627;6.10;0.38;342.78;12.98;1294;40;3611.00;251
9086;37;22348095;9086;363;10379;10627;6.09;0.38;342.82;12.98;1293;40;3612.00;248
9089;37;22348123;9089;359;10383;10627;6.05;0.37;342.84;12.98;1294;40;3613.00;244
9090;37;22348141;9090;359;10385;10627;6.04;0.37;342.94;12.98;1295;40;3614.00;242
9095;37;22348160;9095;364;10390;10631;5.98;0.37;343.05;12.98;1295;40;3615.00;241
9099;37;22348179;9099;369;10392;10631;5.92;0.36;343.12;12.98;1293;40;3616.00;239
9102;37;22348199;9102;384;10393;10631;5.86;0.36;343.07;12.98;1291;40;3617.00;238
9105;37;22348218;9105;377;10395;10634;5.83;0.36;343.26;12.98;1290;40;3618.00;239
9110;37;22348237;9110;374;10395;10634;5.78;0.36;343.25;12.98;1285;40;3619.00;239
9112;37;22348267;9112;372;10395;10634;5.81;0.36;343.24;12.98;1283;40;3620.00;239
9116;37;22348292;9116;372;10398;10638;5.78;0.36;343.36;12.97;1282;40;3621.00;240
9119;37;22348312;9119;375;10400;10639;5.83;0.36;343.40;12.97;1281;40;3622.00;239
9121;37;22348332;9121;379;10400;10639;5.87;0.36;343.43;12.97;1279;40;3623.00;239
9124;37;22348351;9124;379;10404;10643;5.87;0.36;343.43;12.97;1280;40;3624.00;239
9127;37;22348370;9127;384;10405;10643;5.82;0.36;343.40;12.97;1278;40;3625.00;238
9129;37;22348389;9129;393;10409;10643;5.78;0.36;343.44;12.98;1280;40;3626.00;234
9130;37;22348406;9130;397;10410;10644;5.71;0.35;343.52;12.98;1280;40;3627.00;234
9132;37;22348425;9132;401;10416;10644;5.68;0.35;343.54;12.99;1284;40;3628.00;228
9139;37;22348445;9139;405;10419;10650;5.67;0.35;343.65;12.98;1280;40;3629.00;231
9141;37;22348477;9141;416;10422;10650;5.67;0.35;343.65;12.99;1281;40;3630.00;228
9143;37;22348508;9143;417;10425;10651;5.62;0.34;343.63;12.99;1282;40;3631.00;226
9144;37;22348535;9144;428;10427;10651;5.58;0.34;343.65;13.05;1283;40;3632.00;224
9145;37;22348558;9145;433;10428;10651;5.51;0.34;343.64;13.05;1283;40;3633.00;223
9147;37;22348584;9147;426;10434;10651;5.45;0.33;343.72;13.29;1287;40;3634.00;217
9148;37;22348604;9148;447;10436;10651;5.40;0.33;343.76;13.29;1288;40;3635.00;215
9150;37;22348623;9150;454;10444;10663;5.41;0.33;343.82;13.28;1294;40;3636.00;219
9153;37;22348653;9153;462;10447;10663;5.32;0.33;343.85;13.34;1294;40;3637.00;216
9155;37;22348671;9155;477;10454;10663;5.25;0.32;343.92;13.46;1299;40;3638.00;209
9156;37;22348689;9156;483;10454;10663;5.17;0.32;343.95;13.46;1298;40;3639.00;209
9160;37;22348707;9160;492;10457;10663;5.12;0.31;344.03;13.47;1297;40;3640.00;206
9164;37;22348728;9164;500;10462;10663;5.07;0.31;344.00;13.59;1298;40;3641.00;201
9169;37;22348751;9169;506;10467;10667;5.01;0.31;344.00;13.59;1298;40;3642.00;200
9171;37;22348768;9171;521;10469;10667;4.96;0.30;344.06;13.65;1298;40;3643.00;198
9175;37;22348786;9175;531;10472;10671;4.93;0.30;344.02;13.64;1297;40;3644.00;199
9176;37;22348802;9176;539;10477;10673;4.87;0.30;344.10;13.64;1301;40;3645.00;196
9178;37;22348818;9178;553;10478;10673;4.81;0.29;344.13;13.70;1300;40;3646.00;195
9180;37;22348834;9180;552;10480;10673;4.79;0.29;344.10;13.76;1300;40;3647.00;193
9181;37;22348850;9181;553;10490;10686;4.79;0.29;344.07;13.80;1309;40;3648.00;196
9185;37;22348867;9185;557;10490;10686;4.77;0.29;344.09;13.80;1305;40;3649.00;196
9186;37;22348884;9186;556;10494;10686;4.75;0.29;344.06;13.97;1308;40;3650.00;192
9187;37;22348903;9187;556;10495;10687;4.74;0.29;344.04;13.97;1308;40;3651.00;192
9188;37;22348919;9188;556;10495;10688;4.74;0.29;344.05;13.97;1307;40;3652.00;193
9192;37;22348936;9192;553;10496;10688;4.71;0.29;343.98;14.03;1304;40;3653.00;192
9193;37;22348953;9193;561;10499;10691;4.74;0.29;343.99;14.02;1306;40;3654.00;192
9196;37;22348971;9196;556;10501;10691;4.73;0.29;343.91;14.13;1305;40;3655.00;190
9197;37;22348986;9197;560;10503;10691;4.74;0.29;343.94;14.14;1306;40;3656.00;188
9197;37;22349003;9197;559;10503;10691;4.76;0.29;343.94;14.14;1306;40;3657.00;188
9200;37;22349018;9200;559;10512;10697;4.73;0.29;343.85;14.24;1312;40;3658.00;185
9201;37;22349034;9201;562;10512;10697;4.73;0.29;343.82;14.24;1311;40;3659.00;185
9202;37;22349051;9202;567;10513;10697;4.71;0.29;343.86;14.29;1311;40;3660.00;184
9206;37;22349067;9206;575;10514;10697;4.66;0.29;343.78;14.35;1308;40;3661.00;183
9206;37;22349082;9206;577;10517;10701;4.67;0.29;343.78;14.34;1311;40;3662.00;184
9209;37;22349099;9209;581;10518;10702;4.63;0.28;343.80;14.34;1309;40;3663.00;184
9213;37;22349114;9213;585;10519;10702;4.60;0.28;343.77;14.40;1306;40;3664.00;183
9217;37;22349128;9217;584;10520;10703;4.54;0.28;343.74;14.40;1303;40;3665.00;183
9221;37;22349142;9221;593;10520;10703;4.47;0.27;343.68;14.40;1299;40;3666.00;183
9228;37;22349156;9228;601;10520;10703;4.34;0.27;343.52;14.40;1292;40;3667.00;183
9231;37;22349171;9231;600;10520;10703;4.24;0.26;343.52;14.40;1289;40;3668.00;183
9234;37;22349184;9234;601;10520;10703;4.19;0.26;343.44;14.40;1286;40;3669.00;183
9237;37;22349199;9237;608;10520;10703;4.16;0.25;343.44;14.40;1283;40;3670.00;183
9239;37;22349213;9239;606;10520;10703;4.10;0.25;343.43;14.40;1281;40;3671.00;183
9243;37;22349225;9243;623;10562;10773;4.23;0.26;343.52;14.34;1319;40;3672.00;211
9247;37;22349246;9247;620;10564;10774;4.15;0.26;343.47;14.34;1317;40;3673.00;210
9250;37;22349262;9250;619;10570;10774;4.11;0.25;343.41;14.33;1320;40;3674.00;204
9252;37;22349274;9252;606;10573;10774;4.07;0.25;343.37;14.33;1321;40;3675.00;201
9253;37;22349288;9253;603;10575;10774;4.02;0.25;343.39;14.32;1322;40;3676.00;199
9254;37;22349303;9254;600;10576;10774;3.99;0.25;343.38;14.32;1322;40;3677.00;198
9256;37;22349317;9256;579;10577;10774;4.00;0.25;343.34;14.32;1321;40;3678.00;197
9259;37;22349332;9259;561;10579;10774;4.02;0.25;343.35;14.32;1320;40;3679.00;195
9262;37;22349346;9262;553;10581;10775;4.05;0.25;343.34;14.32;1319;40;3680.00;194
9266;37;22349361;9266;548;10582;10776;4.09;0.25;343.31;14.32;1316;40;3681.00;194
9268;37;22349375;9268;548;10583;10776;4.18;0.25;343.32;14.32;1315;40;3682.00;193
9272;37;22349390;9272;534;10587;10780;4.26;0.26;343.37;14.31;1315;40;3683.00;193
9273;37;22349406;9273;524;10587;10780;4.34;0.26;343.37;14.31;1314;40;3684.00;193
9275;37;22349421;9275;521;10587;10780;4.44;0.27;343.35;14.31;1312;40;3685.00;193
9276;37;22349437;9276;512;10587;10780;4.52;0.28;343.36;14.31;1311;40;3686.00;193
9279;37;22349453;9279;496;10591;10786;4.60;0.28;343.31;14.31;1312;40;3687.00;195
9280;37;22349469;9280;493;10592;10786;4.65;0.28;343.32;14.31;1312;40;3688.00;194
9282;37;22349485;9282;487;10592;10786;4.70;0.29;343.30;14.31;1310;40;3689.00;194
9283;37;22349503;9283;478;10595;10792;4.80;0.29;343.30;14.30;1312;40;3690.00;197
9286;37;22349520;9286;476;10595;10792;4.82;0.30;343.26;14.30;1309;40;3691.00;197
9288;37;22349543;9288;478;10596;10792;4.83;0.30;343.24;14.30;1308;40;3692.00;196
9291;37;22349559;9291;480;10596;10793;4.83;0.29;343.28;14.30;1305;40;3693.00;197
9294;37;22349575;9294;484;10598;10794;4.85;0.30;343.27;14.30;1304;40;3694.00;196
9294;37;22349594;9294;496;10598;10794;4.85;0.30;343.27;14.30;1304;40;3695.00;196
9297;37;22349611;9297;506;10607;10807;4.92;0.30;343.26;14.29;1310;40;3696.00;200
9301;37;22349629;9301;507;10609;10807;4.93;0.30;343.22;14.29;1308;40;3697.00;198
9304;37;22349646;9304;506;10610;10807;4.88;0.30;343.13;14.29;1306;40;3698.00;197
9308;37;22349662;9308;509;10610;10808;4.87;0.30;343.18;14.29;1302;40;3699.00;198
9313;37;22349680;9313;511;10612;10808;4.81;0.29;343.21;14.29;1299;40;3700.00;196
9316;37;22349700;9316;517;10615;10812;4.78;0.29;343.25;14.29;1299;40;3701.00;197
9321;37;22349717;9321;518;10616;10812;4.70;0.29;343.29;14.29;1295;40;3702.00;196
9323;37;22349733;9323;524;10619;10816;4.71;0.29;343.28;14.28;1296;40;3703.00;197
9328;37;22349749;9328;525;10621;10816;4.66;0.28;343.17;14.28;1293;40;3704.00;195
9333;37;22349766;9333;521;10621;10816;4.63;0.28;343.15;14.28;1288;40;3705.00;195
9337;37;22349781;9337;527;10623;10816;4.67;0.29;343.24;14.32;1286;40;3706.00;193
9338;37;22349798;9338;521;10623;10816;4.72;0.29;343.22;14.32;1285;40;3707.00;193
9342;37;22349814;9342;526;10634;10828;4.79;0.29;343.19;14.30;1292;40;3708.00;194
9343;37;22349831;9343;523;10634;10828;4.81;0.29;343.19;14.30;1291;40;3709.00;194
9348;37;22349847;9348;520;10634;10828;4.84;0.30;343.27;14.30;1286;40;3710.00;194
9353;37;22349863;9353;517;10634;10828;4.82;0.29;343.36;14.30;1281;40;3711.00;194
9356;37;22349879;9356;525;10634;10828;4.84;0.30;343.39;14.30;1278;40;3712.00;194
9360;37;22349895;9360;520;10634;10828;4.80;0.29;343.48;14.30;1274;40;3713.00;194
9364;37;22349912;9364;515;10634;10829;4.80;0.29;343.53;14.30;1270;40;3714.00;195
9368;37;22349928;9368;511;10634;10829;4.78;0.29;343.54;14.30;1266;40;3715.00;195
9370;37;22349946;9370;513;10639;10835;4.78;0.29;343.68;14.29;1269;40;3716.00;196
9372;37;22349964;9372;509;10640;10836;4.75;0.29;343.75;14.29;1268;40;3717.00;196
9375;37;22349981;9375;506;10640;10836;4.69;0.29;343.70;14.29;1265;40;3718.00;196
9375;37;22349997;9375;512;10640;10836;4.64;0.28;343.70;14.29;1265;40;3719.00;196
9379;37;22350016;9379;515;10644;10841;4.64;0.28;343.66;14.29;1265;40;3720.00;197
9386;37;22350032;9386;517;10644;10841;4.58;0.28;343.91;14.29;1258;40;3721.00;197
9391;37;22350048;9391;507;10645;10841;4.56;0.28;343.99;14.33;1254;40;3722.00;196
9391;37;22350065;9391;504;10646;10842;4.60;0.28;343.99;14.32;1255;40;3723.00;196
9394;37;22350081;9394;496;10649;10846;4.62;0.28;344.08;14.32;1255;40;3724.00;197
9397;37;22350098;9397;500;10649;10846;4.65;0.28;344.20;14.32;1252;40;3725.00;197
9397;37;22350115;9397;497;10651;10849;4.77;0.29;344.20;14.32;1254;40;3726.00;198
9401;37;22350131;9401;497;10651;10849;4.79;0.29;344.28;14.32;1250;40;3727.00;198
9404;37;22350147;9404;504;10652;10849;4.81;0.29;344.26;14.32;1248;40;3728.00;197
9406;37;22350163;9406;513;10652;10849;4.81;0.29;344.27;14.32;1246;40;3729.00;197
9408;37;22350179;9408;517;10656;10853;4.84;0.30;344.34;14.31;1248;40;3730.00;197
9410;37;22350196;9410;507;10656;10853;4.85;0.30;344.42;14.31;1246;40;3731.00;197
9411;37;22350213;9411;506;10656;10853;4.90;0.30;344.40;14.31;1245;40;3732.00;197
9415;37;22350229;9415;499;10657;10853;4.90;0.30;344.49;14.35;1242;40;3733.00;196
9416;37;22350246;9416;495;10657;10854;4.90;0.30;344.57;14.35;1241;40;3734.00;197
9419;37;22350263;9419;494;10659;10856;4.92;0.30;344.58;14.34;1240;40;3735.00;197
9422;37;22350280;9422;482;10659;10856;4.91;0.30;344.69;14.34;1237;40;3736.00;197
9424;37;22350297;9424;484;10660;10857;4.93;0.30;344.69;14.34;1236;40;3737.00;197
9425;37;22350314;9425;483;10661;10857;4.93;0.30;344.77;14.38;1236;40;3738.00;196
9427;37;22350330;9427;480;10661;10857;4.97;0.30;344.91;14.38;1234;40;3739.00;196
9428;37;22350346;9428;488;10661;10857;5.02;0.31;344.94;14.38;1233;40;3740.00;196
9430;37;22350369;9430;486;10661;10857;4.98;0.30;344.99;14.38;1231;40;3741.00;196
9433;37;22350385;9433;491;10661;10857;4.95;0.30;345.24;14.38;1228;40;3742.00;196
9437;37;22350403;9437;491;10661;10857;4.90;0.30;345.34;14.38;1224;40;3743.00;196
9439;37;22350419;9439;523;10738;10984;5.00;0.31;345.33;14.27;1299;40;3744.00;246
9444;37;22350446;9444;507;10738;10985;4.97;0.31;345.45;14.27;1294;40;3745.00;247
9447;37;22350463;9447;485;10742;10985;5.03;0.31;345.57;14.27;1295;40;3746.00;243
9448;37;22350479;9448;483;10742;10985;5.01;0.31;345.63;14.27;1294;40;3747.00;243
9452;37;22350496;9452;479;10746;10985;5.02;0.31;345.65;14.26;1294;40;3748.00;239
9455;37;22350512;9455;474;10747;10985;5.08;0.31;345.76;14.26;1292;40;3749.00;238
9456;37;22350532;9456;470;10752;10990;5.08;0.31;345.81;14.26;1296;40;3750.00;238
9458;37;22350549;9458;464;10754;10990;5.12;0.31;345.82;14.26;1296;40;3751.00;236
9459;37;22350565;9459;473;10755;10991;5.13;0.31;345.84;14.26;1296;40;3752.00;236
9462;37;22350582;9462;467;10757;10992;5.15;0.32;345.90;14.26;1295;40;3753.00;235
9463;37;22350599;9463;478;10760;10992;5.15;0.32;345.97;14.29;1297;40;3754.00;232
9463;37;22350616;9463;484;10761;10993;5.21;0.32;345.97;14.29;1298;40;3755.00;232
9465;37;22350632;9465;488;10765;10993;5.25;0.32;346.00;14.29;1300;40;3756.00;228
9467;37;22350650;9467;489;10766;10993;5.26;0.32;345.99;14.29;1299;40;3757.00;227
9468;37;22350667;9468;484;10768;10993;5.23;0.32;345.99;14.29;1300;40;3758.00;225
9470;37;22350683;9470;484;10773;10997;5.24;0.32;346.03;14.28;1303;40;3759.00;224
9472;37;22350702;9472;483;10775;10997;5.21;0.32;346.01;14.28;1303;40;3760.00;222
9474;37;22350724;9474;481;10776;10997;5.17;0.32;346.01;14.28;1302;40;3761.00;221
9476;37;22350741;9476;482;10780;11000;5.17;0.32;346.05;14.28;1304;40;3762.00;220
9478;37;22350757;9478;480;10782;11000;5.17;0.32;346.03;14.28;1304;40;3763.00;218
9479;37;22350774;9479;476;10784;11000;5.16;0.31;346.08;14.28;1305;40;3764.00;216
9481;37;22350791;9481;479;10787;11004;5.17;0.32;346.15;14.28;1306;40;3765.00;217
9483;37;22350808;9483;468;10789;11005;5.22;0.32;346.19;14.28;1306;40;3766.00;216
9485;37;22350826;9485;459;10790;11005;5.25;0.32;346.15;14.28;1305;40;3767.00;215
9487;37;22350844;9487;459;10794;11009;5.29;0.32;346.16;14.28;1307;40;3768.00;215
9489;37;22350862;9489;461;10796;11009;5.32;0.32;346.12;14.31;1307;40;3769.00;213
9489;37;22350879;9489;450;10797;11009;5.41;0.33;346.12;14.31;1308;40;3770.00;212
9491;37;22350896;9491;435;10798;11010;5.47;0.33;346.10;14.31;1307;40;3771.00;212
9493;37;22350914;9493;440;10799;11010;5.52;0.34;346.17;14.31;1306;40;3772.00;211
9497;37;22350931;9497;440;10804;11016;5.53;0.34;346.23;14.30;1307;40;3773.00;212
9498;37;22350950;9498;448;10804;11016;5.49;0.33;346.22;14.30;1306;40;3774.00;212
9500;37;22350969;9500;441;10805;11017;5.48;0.33;346.28;14.30;1305;40;3775.00;212
9503;37;22350989;9503;436;10805;11017;5.39;0.33;346.36;14.30;1302;40;3776.00;212
9505;37;22351009;9505;439;10805;11017;5.32;0.32;346.37;14.30;1300;40;3777.00;212
9509;37;22351027;9509;438;10805;11017;5.23;0.32;346.41;14.30;1296;40;3778.00;212
9510;37;22351044;9510;423;10807;11017;5.16;0.31;346.40;14.37;1297;40;3779.00;210
9515;37;22351067;9515;418;10829;11053;5.13;0.31;346.44;14.34;1314;40;3780.00;224
9520;37;22351097;9520;420;10832;11053;5.11;0.31;346.51;14.40;1312;40;3781.00;221
9522;37;22351115;9522;407;10835;11053;5.09;0.31;346.61;14.39;1313;40;3782.00;218
9530;37;22351131;9530;408;10836;11053;5.01;0.31;346.74;14.39;1306;40;3783.00;217
9530;37;22351148;9530;405;10837;11053;5.11;0.31;346.74;14.39;1307;40;3784.00;216
9531;37;22351166;9531;405;10837;11053;5.11;0.31;346.82;14.39;1306;40;3785.00;216
9533;37;22351186;9533;407;10840;11057;5.12;0.31;346.96;14.39;1307;40;3786.00;217
9536;37;22351204;9536;412;10841;11057;5.12;0.31;347.04;14.39;1305;40;3787.00;216
9540;37;22351224;9540;404;10845;11061;5.16;0.32;347.00;14.39;1305;40;3788.00;216
9542;37;22351243;9542;401;10848;11062;5.18;0.32;347.18;14.45;1306;40;3789.00;214
9545;37;22351262;9545;393;10848;11062;5.21;0.32;347.29;14.45;1303;40;3790.00;214
9553;37;22351279;9553;401;10849;11062;5.18;0.32;347.39;14.48;1296;40;3791.00;213
9559;37;22351297;9559;395;10859;11075;5.17;0.32;347.36;14.46;1300;40;3792.00;216
9561;37;22351315;9561;396;10860;11075;5.19;0.32;347.47;14.46;1299;40;3793.00;215
9565;37;22351331;9565;403;10860;11075;5.18;0.32;347.48;14.46;1295;40;3794.00;215
9568;37;22351347;9568;393;10861;11076;5.16;0.32;347.50;14.46;1293;40;3795.00;215
9570;37;22351364;9570;392;10861;11077;5.13;0.31;347.47;14.46;1291;40;3796.00;216
9571;37;22351380;9571;391;10863;11077;5.12;0.31;347.44;14.46;1292;40;3797.00;214
9574;37;22351396;9574;405;10865;11080;5.11;0.31;347.53;14.46;1291;40;3798.00;215
9577;37;22351413;9577;414;10865;11080;5.09;0.31;347.55;14.46;1288;40;3799.00;215
9579;37;22351429;9579;419;10866;11080;5.06;0.31;347.53;14.46;1287;40;3800.00;214
9581;37;22351449;9581;419;10866;11080;5.06;0.31;347.59;14.46;1285;40;3801.00;214
9583;37;22351467;9583;424;10872;11086;5.08;0.31;347.58;14.51;1289;40;3802.00;214
9588;37;22351483;9588;429;10872;11086;5.04;0.31;347.68;14.51;1284;40;3803.00;214
9591;37;22351500;9591;439;10873;11086;5.00;0.30;347.64;14.57;1282;40;3804.00;213
9591;37;22351517;9591;447;10874;11086;4.97;0.30;347.64;14.63;1283;40;3805.00;212
9595;37;22351540;9595;451;10877;11090;4.91;0.30;347.73;14.63;1282;40;3806.00;213
9598;37;22351557;9598;449;10879;11091;4.90;0.30;347.81;14.68;1281;40;3807.00;212
9602;37;22351573;9602;457;10880;11091;4.85;0.29;347.77;14.75;1278;40;3808.00;211
9602;37;22351589;9602;458;10881;11092;4.85;0.29;347.77;14.75;1279;40;3809.00;211
9604;37;22351607;9604;470;10882;11092;4.80;0.29;347.75;14.80;1278;40;3810.00;210
9608;37;22351623;9608;475;10883;11092;4.74;0.29;347.78;14.87;1275;40;3811.00;209
9608;37;22351640;9608;484;10883;11092;4.73;0.29;347.78;14.87;1275;40;3812.00;209
9609;37;22351655;9609;488;10884;11092;4.71;0.29;347.79;14.93;1275;40;3813.00;208
9613;37;22351670;9613;494;10884;11092;4.67;0.28;347.77;14.93;1271;40;3814.00;208
9617;37;22351685;9617;502;10885;11092;4.66;0.28;347.86;14.99;1268;40;3815.00;207
9619;37;22351702;9619;513;10920;11162;4.89;0.30;347.85;14.94;1301;40;3816.00;242
9619;37;22351723;9619;508;10924;11163;4.91;0.30;347.85;15.07;1305;40;3817.00;239
9621;37;22351739;9621;508;10934;11163;4.93;0.30;347.87;15.12;1313;40;3818.00;229
9623;37;22351754;9623;511;10935;11163;4.87;0.30;347.81;15.11;1312;40;3819.00;228
9623;37;22351769;9623;515;10940;11163;4.90;0.30;347.81;15.23;1317;40;3820.00;223
9624;37;22351785;9624;517;10943;11163;4.89;0.30;347.78;15.23;1319;40;3821.00;220
9628;37;22351801;9628;517;10946;11163;4.85;0.30;347.85;15.23;1318;40;3822.00;217
9629;37;22351817;9629;522;10949;11163;4.78;0.29;347.87;15.23;1320;40;3823.00;214
9631;37;22351834;9631;518;10954;11164;4.70;0.29;347.81;15.34;1323;40;3824.00;210
9631;37;22351849;9631;517;10958;11166;4.60;0.28;347.81;15.34;1327;40;3825.00;208
9634;37;22351865;9634;519;10961;11166;4.53;0.28;347.82;15.46;1327;40;3826.00;205
9638;37;22351881;9638;522;10965;11170;4.44;0.27;347.76;15.45;1327;40;3827.00;205
9639;37;22351898;9639;524;10966;11170;4.40;0.27;347.78;15.45;1327;40;3828.00;204
9641;37;22351913;9641;524;10968;11170;4.34;0.26;347.74;15.57;1327;40;3829.00;202
9644;37;22351929;9644;524;10968;11170;4.24;0.26;347.73;15.57;1324;40;3830.00;202
9645;37;22351944;9645;525;10973;11176;4.26;0.26;347.70;15.56;1328;40;3831.00;203
9647;37;22351960;9647;529;10973;11176;4.22;0.26;347.68;15.56;1326;40;3832.00;203
9647;37;22351975;9647;529;10975;11176;4.20;0.25;347.68;15.68;1328;40;3833.00;201
9648;37;22351989;9648;538;10979;11179;4.18;0.25;347.66;15.73;1331;40;3834.00;200
9649;37;22352007;9649;533;10980;11179;4.22;0.26;347.66;15.79;1331;40;3835.00;199
9651;37;22352023;9651;525;10980;11179;4.25;0.26;347.62;15.79;1329;40;3836.00;199
9653;37;22352043;9653;520;10980;11180;4.28;0.26;347.62;15.79;1327;40;3837.00;200
9656;37;22352058;9656;521;10983;11181;4.29;0.26;347.66;15.90;1327;40;3838.00;198
9659;37;22352074;9659;520;10983;11181;4.33;0.26;347.60;15.90;1324;40;3839.00;198
9661;37;22352092;9661;530;11003;11207;4.36;0.27;347.58;15.99;1342;40;3840.00;204
9663;37;22352110;9663;530;11004;11207;4.32;0.26;347.54;15.99;1341;40;3841.00;203
9665;37;22352124;9665;534;11007;11207;4.32;0.26;347.52;15.99;1342;40;3842.00;200
9669;37;22352139;9669;533;11010;11208;4.31;0.26;347.51;16.10;1341;40;3843.00;198
9671;37;22352154;9671;539;11010;11208;4.32;0.26;347.48;16.10;1339;40;3844.00;198
9673;37;22352170;9673;545;11016;11212;4.33;0.26;347.51;16.20;1343;40;3845.00;196
9675;37;22352194;9675;543;11018;11214;4.29;0.26;347.48;16.20;1343;40;3846.00;196
9678;37;22352210;9678;543;11021;11218;4.29;0.26;347.47;16.19;1343;40;3847.00;197
9681;37;22352225;9681;541;11023;11218;4.24;0.26;347.43;16.30;1342;40;3848.00;195
9684;38;22352241;9684;550;11023;11218;4.16;0.25;347.40;16.30;1339;41;3849.00;195
9689;38;22352281;9689;538;11025;11218;4.08;0.25;347.41;16.41;1336;41;3850.00;193
9692;38;22352297;9692;526;11025;11218;4.05;0.25;347.37;16.41;1333;41;3851.00;193
9694;38;22352319;9694;518;11036;11230;4.08;0.25;347.37;16.39;1342;41;3852.00;194
9696;38;22352336;9696;511;11038;11230;4.07;0.25;347.38;16.50;1342;41;3853.00;192
9697;38;22352351;9697;504;11038;11230;4.10;0.25;347.37;16.50;1341;41;3854.00;192
9698;38;22352368;9698;497;11038;11230;4.15;0.25;347.38;16.50;1340;41;3855.00;192
9699;38;22352384;9699;491;11038;11230;4.19;0.26;347.43;16.50;1339;41;3856.00;192
9704;38;22352401;9704;483;11038;11230;4.21;0.26;347.55;16.50;1334;41;3857.00;192
9707;38;22352417;9707;483;11038;11231;4.24;0.26;347.52;16.50;1331;41;3858.00;193
9708;38;22352432;9708;472;11038;11231;4.27;0.26;347.50;16.50;1330;41;3859.00;193
9713;38;22352448;9713;467;11043;11237;4.33;0.26;347.53;16.49;1330;41;3860.00;194
9718;38;22352465;9718;468;11044;11238;4.37;0.27;347.41;16.49;1326;41;3861.00;194
9721;38;22352481;9721;465;11044;11238;4.42;0.27;347.53;16.49;1323;41;3862.00;194
9724;38;22352497;9724;464;11044;11238;4.47;0.27;347.59;16.49;1320;41;3863.00;194
9727;38;22352513;9727;461;11047;11242;4.59;0.28;347.71;16.49;1320;41;3864.00;195
9734;38;22352529;9734;462;11047;11242;4.56;0.28;347.75;16.49;1313;41;3865.00;195
9737;38;22352545;9737;451;11047;11242;4.58;0.28;347.70;16.49;1310;41;3866.00;195
9738;38;22352562;9738;456;11048;11243;4.63;0.28;347.68;16.49;1310;41;3867.00;195
9743;38;22352577;9743;451;11051;11247;4.63;0.28;347.64;16.48;1308;41;3868.00;196
9749;38;22352595;9749;452;11051;11247;4.65;0.28;347.77;16.48;1302;41;3869.00;196
9751;38;22352614;9751;447;11056;11253;4.68;0.28;347.85;16.47;1305;41;3870.00;197
9755;38;22352631;9755;444;11056;11253;4.71;0.29;347.84;16.47;1301;41;3871.00;197
9758;38;22352647;9758;454;11057;11253;4.76;0.29;347.95;16.47;1299;41;3872.00;196
9761;38;22352664;9761;447;11057;11253;4.76;0.29;347.99;16.47;1296;41;3873.00;196
9763;38;22352680;9763;448;11061;11257;4.77;0.29;347.99;16.47;1298;41;3874.00;196
9768;38;22352697;9768;438;11061;11257;4.72;0.29;348.10;16.47;1293;41;3875.00;196
9773;38;22352714;9773;436;11061;11257;4.68;0.28;348.11;16.47;1288;41;3876.00;196
9775;38;22352737;9775;431;11061;11257;4.63;0.28;348.10;16.47;1286;41;3877.00;196
9778;38;22352752;9778;427;11061;11258;4.57;0.28;348.24;16.47;1283;41;3878.00;197
9781;38;22352769;9781;436;11062;11259;4.52;0.27;348.31;16.47;1281;41;3879.00;197
9782;38;22352786;9782;433;11063;11259;4.48;0.27;348.34;16.50;1281;41;3880.00;196
9783;38;22352803;9783;429;11064;11260;4.49;0.27;348.44;16.50;1281;41;3881.00;196
9787;38;22352819;9787;427;11064;11260;4.49;0.27;348.51;16.50;1277;41;3882.00;196
9788;38;22352835;9788;431;11064;11260;4.58;0.28;348.49;16.50;1276;41;3883.00;196
9791;38;22352853;9791;430;11064;11260;4.68;0.28;348.53;16.50;1273;41;3884.00;196
9795;38;22352869;9795;437;11064;11260;4.71;0.29;348.64;16.50;1269;41;3885.00;196
9799;38;22352885;9799;431;11064;11260;4.74;0.29;348.72;16.50;1265;41;3886.00;196
9804;38;22352902;9804;432;11064;11260;4.78;0.29;348.71;16.50;1260;41;3887.00;196
9807;38;22352919;9807;448;11137;11387;5.15;0.32;348.75;16.39;1330;41;3888.00;250
9809;38;22352948;9809;438;11141;11388;5.18;0.32;348.73;16.39;1332;41;3889.00;247
9811;38;22352966;9811;438;11147;11388;5.19;0.32;348.73;16.38;1336;41;3890.00;241
9812;38;22352983;9812;443;11150;11388;5.24;0.32;348.79;16.38;1338;41;3891.00;238
9813;38;22353000;9813;446;11155;11388;5.21;0.32;348.84;16.37;1342;41;3892.00;233
9817;38;22353017;9817;444;11157;11388;5.14;0.32;348.94;16.37;1340;41;3893.00;231
9818;38;22353034;9818;449;11158;11388;5.03;0.31;348.95;16.37;1340;41;3894.00;230
9819;38;22353058;9819;456;11160;11388;4.97;0.31;348.99;16.37;1341;41;3895.00;228
9820;38;22353075;9820;474;11163;11389;4.89;0.30;349.01;16.36;1343;41;3896.00;226
9823;38;22353091;9823;462;11166;11390;4.82;0.30;349.18;16.36;1343;41;3897.00;224
9823;38;22353108;9823;438;11170;11390;4.81;0.30;349.18;16.36;1347;41;3898.00;220
9826;38;22353125;9826;433;11172;11391;4.83;0.30;349.21;16.36;1346;41;3899.00;219
9828;38;22353146;9828;440;11179;11406;4.85;0.30;349.27;16.35;1351;41;3900.00;227
9830;38;22353169;9830;440;11182;11406;4.94;0.30;349.26;16.39;1352;41;3901.00;224
9832;38;22353204;9832;446;11182;11406;4.99;0.31;349.33;16.39;1350;41;3902.00;224
9837;38;22353226;9837;441;11185;11410;4.96;0.30;349.42;16.38;1348;41;3903.00;225
9839;38;22353247;9839;444;11186;11410;5.01;0.31;349.47;16.38;1347;41;3904.00;224
9840;38;22353268;9840;448;11189;11410;5.04;0.31;349.58;16.38;1349;41;3905.00;221
9847;38;22353291;9847;438;11193;11413;5.02;0.31;349.76;16.38;1346;41;3906.00;220
9847;38;22353311;9847;429;11194;11413;5.03;0.31;349.76;16.38;1347;41;3907.00;219
9851;38;22353328;9851;425;11196;11413;5.06;0.31;349.85;16.38;1345;41;3908.00;217
9853;38;22353346;9853;423;11199;11417;5.06;0.31;349.85;16.38;1346;41;3909.00;218
9856;38;22353364;9856;418;11201;11418;5.06;0.31;349.89;16.37;1345;41;3910.00;217
9859;38;22353388;9859;424;11202;11418;5.05;0.31;349.88;16.37;1343;41;3911.00;216
9864;38;22353407;9864;430;11206;11422;5.05;0.31;350.00;16.37;1342;41;3912.00;216
9866;38;22353424;9866;437;11207;11422;5.09;0.31;350.13;16.37;1341;41;3913.00;215
9867;38;22353442;9867;443;11207;11422;5.12;0.31;350.22;16.37;1340;41;3914.00;215
9872;38;22353460;9872;452;11209;11424;5.16;0.31;350.39;16.37;1337;41;3915.00;215
9874;38;22353478;9874;456;11210;11424;5.16;0.31;350.49;16.40;1336;41;3916.00;214
9876;38;22353494;9876;467;11215;11430;5.15;0.31;350.51;16.39;1339;41;3917.00;215
9879;38;22353514;9879;468;11216;11430;5.15;0.31;350.59;16.39;1337;41;3918.00;214
9880;38;22353531;9880;466;11216;11431;5.15;0.31;350.62;16.39;1336;41;3919.00;215
9880;38;22353549;9880;472;11216;11431;5.15;0.31;350.62;16.39;1336;41;3920.00;215
9883;38;22353567;9883;465;11216;11431;5.15;0.31;350.63;16.39;1333;41;3921.00;215
9885;38;22353584;9885;463;11216;11431;5.11;0.31;350.66;16.39;1331;41;3922.00;215
9886;38;22353601;9886;464;11219;11431;5.06;0.31;350.68;16.42;1333;41;3923.00;212
9889;38;22353618;9889;462;11227;11443;5.07;0.31;350.66;16.41;1338;41;3924.00;216
9892;38;22353639;9892;462;11229;11443;5.03;0.31;350.67;16.41;1337;41;3925.00;214
9896;38;22353657;9896;466;11231;11443;5.02;0.30;350.72;16.41;1335;41;3926.00;212
9897;38;22353675;9897;461;11231;11443;4.98;0.30;350.82;16.41;1334;41;3927.00;212
9898;38;22353692;9898;466;11231;11443;5.00;0.30;350.82;16.41;1333;41;3928.00;212
9900;38;22353712;9900;469;11233;11443;5.04;0.31;350.97;16.41;1333;41;3929.00;210
9903;38;22353732;9903;468;11236;11447;4.98;0.30;350.98;16.40;1333;41;3930.00;211
9906;38;22353750;9906;474;11236;11447;4.91;0.30;350.94;16.40;1330;41;3931.00;211
9907;38;22353768;9907;488;11240;11451;4.91;0.30;351.00;16.40;1333;41;3932.00;211
9907;38;22353784;9907;489;11241;11452;4.91;0.30;351.00;16.40;1334;41;3933.00;211
9909;38;22353801;9909;492;11241;11452;4.90;0.30;350.95;16.40;1332;41;3934.00;211
9910;38;22353817;9910;496;11241;11452;4.88;0.30;351.00;16.40;1331;41;3935.00;211
9912;38;22353833;9912;496;11251;11465;4.91;0.30;351.06;16.38;1339;41;3936.00;214
9915;38;22353852;9915;493;11252;11465;4.90;0.30;351.18;16.38;1337;41;3937.00;213
9916;38;22353868;9916;496;11252;11465;4.87;0.29;351.19;16.38;1336;41;3938.00;213
9917;38;22353884;9917;503;11253;11466;4.92;0.30;351.22;16.38;1336;41;3939.00;213
9919;38;22353901;9919;496;11253;11467;4.95;0.30;351.25;16.38;1334;41;3940.00;214
9921;38;22353917;9921;499;11253;11467;4.96;0.30;351.32;16.38;1332;41;3941.00;214
9923;38;22353934;9923;500;11256;11470;4.98;0.30;351.36;16.41;1333;41;3942.00;214
9925;38;22353951;9925;505;11256;11470;4.96;0.30;351.37;16.41;1331;41;3943.00;214
9928;38;22353971;9928;507;11257;11470;4.98;0.30;351.49;16.40;1329;41;3944.00;213
9930;38;22353989;9930;497;11257;11470;4.97;0.30;351.55;16.40;1327;41;3945.00;213
9933;38;22354007;9933;496;11262;11476;5.00;0.31;351.66;16.40;1329;41;3946.00;214
9939;38;22354027;9939;498;11262;11476;4.97;0.30;351.61;16.40;1323;41;3947.00;214
9940;38;22354046;9940;496;11262;11476;4.96;0.30;351.62;16.40;1322;41;3948.00;214
9941;38;22354065;9941;491;11262;11476;4.96;0.30;351.62;16.40;1321;41;3949.00;214
9941;38;22354087;9941;498;11265;11480;4.95;0.30;351.62;16.39;1324;41;3950.00;215
9944;38;22354108;9944;498;11266;11481;4.94;0.30;351.63;16.39;1322;41;3951.00;215
9946;38;22354129;9946;497;11266;11481;4.91;0.30;351.64;16.39;1320;41;3952.00;215
9949;38;22354148;9949;492;11267;11482;4.86;0.30;351.73;16.39;1318;41;3953.00;215
9953;38;22354166;9953;489;11267;11482;4.82;0.29;351.71;16.39;1314;41;3954.00;215
9956;38;22354183;9956;489;11269;11482;4.75;0.29;351.74;16.51;1313;41;3955.00;213
9957;38;22354202;9957;496;11269;11482;4.69;0.29;351.80;16.51;1312;41;3956.00;213
9963;38;22354219;9963;488;11270;11482;4.59;0.28;351.78;16.54;1307;41;3957.00;212
9965;38;22354234;9965;496;11270;11482;4.55;0.28;351.76;16.54;1305;41;3958.00;212
9968;38;22354251;9968;491;11270;11482;4.53;0.28;351.78;16.54;1302;41;3959.00;212
9972;38;22354269;9972;503;11328;11607;4.74;0.29;351.75;16.46;1356;41;3960.00;279
9974;38;22354297;9974;496;11330;11608;4.72;0.29;351.73;16.46;1356;41;3961.00;278
9976;38;22354314;9976;499;11338;11608;4.73;0.29;351.74;16.45;1362;41;3962.00;270
9979;38;22354330;9979;504;11341;11608;4.76;0.29;351.75;16.44;1362;41;3963.00;267
9982;38;22354347;9982;504;11347;11608;4.76;0.29;351.68;16.44;1365;41;3964.00;261
9984;38;22354363;9984;504;11347;11608;4.69;0.29;351.67;16.44;1363;41;3965.00;261
9985;38;22354379;9985;508;11352;11608;4.70;0.29;351.70;16.43;1367;41;3966.00;256
9987;38;22354395;9987;517;11357;11608;4.66;0.29;351.68;16.43;1370;41;3967.00;251
9990;38;22354411;9990;521;11363;11609;4.58;0.28;351.60;16.42;1373;41;3968.00;246
9993;38;22354431;9993;525;11366;11610;4.54;0.28;351.56;16.42;1373;41;3969.00;244
9994;38;22354447;9994;530;11370;11610;4.53;0.28;351.54;16.42;1376;41;3970.00;240
9997;38;22354464;9997;541;11374;11614;4.47;0.27;351.50;16.41;1377;41;3971.00;240
9999;38;22354480;9999;546;11376;11614;4.44;0.27;351.55;16.44;1377;41;3972.00;238
10001;38;22354499;10001;555;11377;11614;4.39;0.27;351.48;16.44;1376;41;3973.00;237
10001;38;22354515;10001;563;11377;11614;4.35;0.27;351.48;16.44;1376;41;3974.00;237
10001;38;22354531;10001;560;11381;11620;4.33;0.27;351.48;16.44;1380;41;3975.00;239
10002;38;22354548;10002;574;11383;11620;4.27;0.26;351.46;16.44;1381;41;3976.00;237
10002;38;22354565;10002;581;11383;11620;4.25;0.26;351.46;16.44;1381;41;3977.00;237
10003;38;22354581;10003;584;11386;11623;4.21;0.26;351.48;16.44;1383;41;3978.00;237
10004;38;22354598;10004;593;11386;11623;4.16;0.25;351.55;16.44;1382;41;3979.00;237
10005;38;22354617;10005;604;11386;11623;4.13;0.25;351.54;16.44;1381;41;3980.00;237
10007;38;22354633;10007;596;11387;11624;4.10;0.25;351.56;16.44;1380;41;3981.00;237
10010;38;22354650;10010;609;11389;11625;4.05;0.25;351.55;16.50;1379;41;3982.00;236
10013;38;22354666;10013;618;11390;11625;4.04;0.25;351.49;16.56;1377;41;3983.00;235
10014;38;22354683;10014;621;11401;11638;4.05;0.25;351.49;16.61;1387;41;3984.00;237
10017;38;22354700;10017;621;11404;11638;4.01;0.25;351.50;16.67;1387;41;3985.00;234
10018;38;22354716;10018;631;11404;11638;4.00;0.24;351.47;16.67;1386;41;3986.00;234
10019;38;22354732;10019;633;11406;11639;3.97;0.24;351.47;16.73;1387;41;3987.00;233
10021;38;22354748;10021;643;11407;11639;3.93;0.24;351.48;16.73;1386;41;3988.00;232
10023;38;22354764;10023;646;11411;11643;3.89;0.24;351.47;16.79;1388;41;3989.00;232
10024;38;22354781;10024;654;11411;11643;3.85;0.24;351.44;16.79;1387;41;3990.00;232
10025;38;22354798;10025;654;11416;11647;3.80;0.23;351.40;16.84;1391;41;3991.00;231
10026;38;22354814;10026;649;11416;11647;3.78;0.23;351.40;16.84;1390;41;3992.00;231
10027;38;22354831;10027;648;11416;11647;3.81;0.23;351.41;16.84;1389;41;3993.00;231
10029;38;22354847;10029;640;11418;11647;3.84;0.24;351.44;16.97;1389;41;3994.00;229
10032;38;22354862;10032;632;11418;11647;3.86;0.24;351.47;16.97;1386;41;3995.00;229
10033;38;22354878;10033;628;11428;11659;3.95;0.24;351.46;16.95;1395;41;3996.00;231
10034;38;22354895;10034;630;11432;11659;3.96;0.24;351.43;17.19;1398;41;3997.00;227
10035;38;22354911;10035;627;11433;11659;4.00;0.25;351.43;17.19;1398;41;3998.00;226
10036;38;22354927;10036;620;11433;11659;4.02;0.25;351.43;17.19;1397;41;3999.00;226
10037;38;22354944;10037;608;11433;11659;4.06;0.25;351.45;17.19;1396;41;4000.00;226
10039;38;22354964;10039;610;11433;11659;4.07;0.25;351.44;17.19;1394;41;4001.00;226
10041;38;22354980;10041;614;11436;11660;4.04;0.25;351.40;17.37;1395;41;4002.00;224
10043;39;22354996;10043;621;11436;11660;4.05;0.25;351.49;17.37;1393;42;4003.00;224
10044;39;22355027;10044;616;11442;11666;4.15;0.25;351.49;17.42;1398;42;4004.00;224
10045;39;22355044;10045;607;11444;11668;4.16;0.25;351.48;17.42;1399;42;4005.00;224
10046;39;22355059;10046;606;11444;11668;4.21;0.26;351.45;17.42;1398;42;4006.00;224
10049;39;22355078;10049;606;11446;11668;4.20;0.26;351.42;17.54;1397;42;4007.00;222
10050;39;22355096;10050;601;11449;11672;4.23;0.26;351.42;17.53;1399;42;4008.00;223
10051;39;22355112;10051;602;11452;11672;4.25;0.26;351.39;17.71;1401;42;4009.00;220
10054;39;22355128;10054;607;11452;11672;4.27;0.26;351.36;17.71;1398;42;4010.00;220
10057;39;22355144;10057;606;11453;11673;4.33;0.26;351.34;17.71;1396;42;4011.00;220
10059;39;22355159;10059;603;11456;11677;4.34;0.26;351.37;17.70;1397;42;4012.00;221
10062;39;22355176;10062;597;11457;11677;4.37;0.27;351.42;17.76;1395;42;4013.00;220
10066;39;22355191;10066;596;11460;11680;4.40;0.27;351.49;17.82;1394;42;4014.00;220
10068;39;22355208;10068;597;11460;11680;4.40;0.27;351.58;17.82;1392;42;4015.00;220
10071;39;22355223;10071;602;11461;11680;4.37;0.27;351.58;17.82;1390;42;4016.00;219
10073;39;22355239;10073;602;11461;11680;4.34;0.27;351.67;17.82;1388;42;4017.00;219
10076;39;22355254;10076;611;11465;11684;4.33;0.26;351.64;17.81;1389;42;4018.00;219
10081;39;22355270;10081;614;11465;11684;4.25;0.26;351.79;17.81;1384;42;4019.00;219
10085;39;22355287;10085;609;11465;11684;4.20;0.26;351.91;17.81;1380;42;4020.00;219
10088;39;22355304;10088;599;11465;11684;4.15;0.25;352.08;17.81;1377;42;4021.00;219
10095;39;22355318;10095;602;11465;11685;4.09;0.25;352.17;17.81;1370;42;4022.00;220
10097;39;22355333;10097;603;11466;11686;4.10;0.25;352.19;17.81;1369;42;4023.00;220
10100;39;22355348;10100;604;11466;11686;4.08;0.25;352.24;17.81;1366;42;4024.00;220
10105;39;22355363;10105;588;11467;11687;4.05;0.25;352.30;17.81;1362;42;4025.00;220
10107;39;22355377;10107;581;11467;11687;4.05;0.25;352.27;17.81;1360;42;4026.00;220
10110;39;22355391;10110;581;11467;11687;4.07;0.25;352.42;17.81;1357;42;4027.00;220
10114;39;22355407;10114;574;11467;11687;4.08;0.25;352.47;17.81;1353;42;4028.00;220
10118;39;22355421;10118;568;11467;11687;4.12;0.25;352.61;17.81;1349;42;4029.00;220
10121;39;22355438;10121;568;11467;11687;4.14;0.25;352.74;17.81;1346;42;4030.00;220
10123;39;22355454;10123;561;11467;11687;4.15;0.25;352.73;17.81;1344;42;4031.00;220
10124;39;22355469;10124;564;11528;11814;4.50;0.28;352.74;17.72;1404;42;4032.00;286
10127;39;22355496;10127;552;11534;11815;4.55;0.28;352.75;17.71;1407;42;4033.00;281
10132;39;22355512;10132;541;11541;11815;4.56;0.28;352.81;17.70;1409;42;4034.00;274
10137;39;22355527;10137;533;11544;11815;4.60;0.28;352.81;17.69;1407;42;4035.00;271
10140;39;22355543;10140;532;11549;11815;4.61;0.29;352.84;17.69;1409;42;4036.00;266
10143;39;22355560;10143;529;11551;11815;4.60;0.28;352.91;17.69;1408;42;4037.00;264
10145;39;22355576;10145;529;11553;11815;4.61;0.28;352.89;17.68;1408;42;4038.00;262
10152;39;22355594;10152;522;11555;11815;4.57;0.28;353.01;17.68;1403;42;4039.00;260
10154;39;22355612;10154;515;11557;11816;4.57;0.28;353.04;17.68;1403;42;4040.00;259
10157;39;22355629;10157;524;11558;11817;4.59;0.28;353.05;17.68;1401;42;4041.00;259
10162;39;22355645;10162;519;11559;11817;4.60;0.28;353.08;17.68;1397;42;4042.00;258
10166;39;22355663;10166;527;11561;11818;4.62;0.28;353.10;17.68;1395;42;4043.00;257
10170;39;22355680;10170;529;11562;11818;4.63;0.28;353.25;17.68;1392;42;4044.00;256
10176;39;22355697;10176;520;11563;11818;4.64;0.29;353.36;17.68;1387;42;4045.00;255
10178;39;22355715;10178;520;11565;11818;4.65;0.29;353.36;17.68;1387;42;4046.00;253
10180;39;22355732;10180;519;11568;11822;4.67;0.29;353.38;17.67;1388;42;4047.00;254
10186;39;22355749;10186;522;11569;11822;4.66;0.29;353.43;17.67;1383;42;4048.00;253
10189;39;22355767;10189;515;11570;11822;4.66;0.29;353.45;17.67;1381;42;4049.00;252
10193;39;22355787;10193;507;11575;11828;4.74;0.29;353.52;17.67;1382;42;4050.00;253
10198;39;22355806;10198;505;11576;11828;4.74;0.29;353.69;17.67;1378;42;4051.00;252
10204;39;22355822;10204;503;11578;11828;4.75;0.29;353.71;17.67;1374;42;4052.00;250
10206;39;22355840;10206;503;11582;11832;4.79;0.29;353.72;17.66;1376;42;4053.00;250
10210;39;22355858;10210;500;11583;11833;4.81;0.29;353.75;17.66;1373;42;4054.00;250
10215;39;22355877;10215;495;11584;11833;4.81;0.29;353.78;17.66;1369;42;4055.00;249
10218;39;22355895;10218;491;11587;11837;4.85;0.30;353.84;17.66;1369;42;4056.00;250
10224;39;22355913;10224;493;11588;11837;4.85;0.30;353.94;17.66;1364;42;4057.00;249
10231;39;22355930;10231;494;11589;11837;4.82;0.29;354.14;17.66;1358;42;4058.00;248
10233;39;22355948;10233;494;11590;11838;4.81;0.29;354.11;17.66;1357;42;4059.00;248
10236;39;22355965;10236;505;11593;11838;4.80;0.29;354.09;17.70;1357;42;4060.00;245
10241;39;22355982;10241;497;11599;11844;4.72;0.29;354.16;17.69;1358;42;4061.00;245
10243;39;22356006;10243;503;11602;11844;4.67;0.28;354.14;17.69;1359;42;4062.00;242
10246;39;22356023;10246;497;11603;11845;4.62;0.28;354.18;17.69;1357;42;4063.00;242
10249;39;22356041;10249;502;11604;11845;4.60;0.28;354.21;17.69;1355;42;4064.00;241
10252;39;22356057;10252;497;11605;11845;4.55;0.28;354.29;17.69;1353;42;4065.00;240
10252;39;22356074;10252;486;11607;11845;4.56;0.28;354.29;17.69;1355;42;4066.00;238
10255;39;22356090;10255;481;11607;11845;4.48;0.27;354.40;17.69;1352;42;4067.00;238
10256;39;22356108;10256;480;11616;11857;4.52;0.28;354.51;17.68;1360;42;4068.00;241
10259;39;22356125;10259;484;11616;11857;4.49;0.27;354.57;17.68;1357;42;4069.00;241
10262;39;22356141;10262;489;11619;11857;4.46;0.27;354.72;17.72;1357;42;4070.00;238
10265;39;22356158;10265;491;11619;11857;4.45;0.27;354.70;17.72;1354;42;4071.00;238
10266;39;22356182;10266;483;11620;11857;4.51;0.28;354.69;17.72;1354;42;4072.00;237
10268;39;22356200;10268;474;11620;11857;4.47;0.27;354.72;17.72;1352;42;4073.00;237
10271;39;22356217;10271;459;11624;11861;4.47;0.27;354.72;17.72;1353;42;4074.00;237
10273;39;22356234;10273;461;11624;11861;4.46;0.27;354.75;17.72;1351;42;4075.00;237
10277;39;22356251;10277;461;11629;11865;4.51;0.27;354.87;17.72;1352;42;4076.00;236
10279;39;22356270;10279;465;11630;11866;4.52;0.28;354.89;17.71;1351;42;4077.00;236
10281;39;22356286;10281;471;11631;11866;4.51;0.28;354.94;17.71;1350;42;4078.00;235
10283;39;22356303;10283;473;11631;11866;4.53;0.28;354.90;17.71;1348;42;4079.00;235
10285;39;22356321;10285;488;11653;11895;4.54;0.28;354.96;17.68;1368;42;4080.00;242
10288;39;22356340;10288;482;11653;11895;4.59;0.28;355.14;17.68;1365;42;4081.00;242
10289;39;22356357;10289;468;11655;11895;4.66;0.28;355.17;17.68;1366;42;4082.00;240
10292;39;22356374;10292;484;11657;11896;4.67;0.28;355.22;17.67;1365;42;4083.00;239
10294;39;22356391;10294;484;11657;11897;4.67;0.28;355.24;17.67;1363;42;4084.00;240
10295;39;22356410;10295;494;11657;11897;4.70;0.29;355.22;17.67;1362;42;4085.00;240
10298;39;22356428;10298;492;11659;11900;4.69;0.28;355.29;17.67;1361;42;4086.00;241
10299;39;22356451;10299;495;11659;11900;4.64;0.28;355.38;17.67;1360;42;4087.00;241
10300;39;22356469;10300;502;11660;11900;4.65;0.28;355.36;17.67;1360;42;4088.00;240
10306;39;22356486;10306;510;11661;11900;4.60;0.28;355.50;17.71;1355;42;4089.00;239
10309;40;22356504;10309;511;11666;11906;4.58;0.28;355.62;17.70;1357;43;4090.00;240
10312;40;22356534;10312;517;11666;11906;4.49;0.27;355.62;17.70;1354;43;4091.00;240
10315;40;22356551;10315;515;11666;11906;4.44;0.27;355.66;17.70;1351;43;4092.00;240
10317;40;22356568;10317;524;11666;11906;4.33;0.26;355.63;17.70;1349;43;4093.00;240
10319;40;22356585;10319;529;11668;11910;4.31;0.26;355.67;17.70;1349;43;4094.00;242
10320;40;22356602;10320;535;11670;11912;4.32;0.26;355.66;17.70;1350;43;4095.00;242
10323;40;22356618;10323;529;11670;11912;4.32;0.26;355.78;17.70;1347;43;4096.00;242
10323;40;22356636;10323;535;11672;11913;4.36;0.27;355.78;17.70;1349;43;4097.00;241
10324;40;22356652;10324;544;11673;11913;4.39;0.27;355.82;17.74;1349;43;4098.00;240
10325;40;22356670;10325;538;11673;11913;4.45;0.27;355.91;17.74;1348;43;4099.00;240
10329;40;22356687;10329;529;11673;11913;4.46;0.27;355.95;17.74;1344;43;4100.00;240
10330;40;22356708;10330;527;11674;11913;4.47;0.27;355.93;17.78;1344;43;4101.00;239
10332;40;22356724;10332;538;11674;11913;4.49;0.27;356.07;17.78;1342;43;4102.00;239
10337;40;22356740;10337;539;11674;11913;4.48;0.27;356.17;17.78;1337;43;4103.00;239
10340;40;22356756;10340;548;11713;11983;4.56;0.28;356.14;17.72;1373;43;4104.00;270
10343;40;22356780;10343;552;11715;11984;4.59;0.28;356.24;17.72;1372;43;4105.00;269
10345;40;22356797;10345;546;11721;11984;4.65;0.28;356.39;17.71;1376;43;4106.00;263
10347;40;22356814;10347;548;11721;11984;4.67;0.28;356.42;17.71;1374;43;4107.00;263
10349;40;22356830;10349;549;11723;11984;4.66;0.28;356.48;17.71;1374;43;4108.00;261
10349;40;22356847;10349;548;11724;11984;4.66;0.28;356.48;17.70;1375;43;4109.00;260
10350;40;22356865;10350;556;11728;11984;4.65;0.28;356.56;17.70;1378;43;4110.00;256
10352;40;22356881;10352;559;11729;11984;4.62;0.28;356.62;17.70;1377;43;4111.00;255
10356;40;22356898;10356;562;11732;11985;4.57;0.28;356.77;17.70;1376;43;4112.00;253
10358;40;22356914;10358;564;11736;11986;4.56;0.28;356.81;17.69;1378;43;4113.00;250
10361;40;22356930;10361;569;11739;11986;4.51;0.28;356.89;17.69;1378;43;4114.00;247
10364;40;22356947;10364;564;11744;11990;4.53;0.28;356.89;17.69;1380;43;4115.00;246
10367;40;22356967;10367;574;11745;11990;4.53;0.28;356.87;17.68;1378;43;4116.00;245
10368;40;22356983;10368;577;11745;11990;4.59;0.28;356.85;17.68;1377;43;4117.00;245
10372;40;22357000;10372;576;11745;11990;4.60;0.28;356.89;17.68;1373;43;4118.00;245
10373;40;22357017;10373;570;11751;11996;4.65;0.28;356.95;17.72;1378;43;4119.00;245
10375;40;22357035;10375;569;11751;11996;4.65;0.28;357.02;17.72;1376;43;4120.00;245
10379;40;22357051;10379;572;11751;11996;4.67;0.29;357.08;17.72;1372;43;4121.00;245
10381;40;22357068;10381;566;11753;11999;4.71;0.29;357.05;17.72;1372;43;4122.00;246
10385;40;22357085;10385;568;11754;11999;4.74;0.29;357.06;17.72;1369;43;4123.00;245
10390;40;22357102;10390;561;11754;11999;4.73;0.29;357.00;17.72;1364;43;4124.00;245
10393;40;22357125;10393;558;11754;12000;4.68;0.29;356.96;17.72;1361;43;4125.00;246
10394;40;22357142;10394;559;11755;12001;4.65;0.28;357.03;17.71;1361;43;4126.00;246
10396;40;22357157;10396;555;11755;12001;4.59;0.28;357.00;17.71;1359;43;4127.00;246
10401;40;22357176;10401;547;11766;12014;4.53;0.28;356.91;17.74;1365;43;4128.00;248
10405;40;22357194;10405;555;11767;12014;4.40;0.27;356.86;17.81;1362;43;4129.00;247
10406;40;22357215;10406;556;11768;12014;4.36;0.27;356.88;17.87;1362;43;4130.00;246
10409;40;22357236;10409;549;11769;12015;4.33;0.26;356.95;17.87;1360;43;4131.00;246
10412;40;22357259;10412;548;11769;12015;4.31;0.26;356.97;17.87;1357;43;4132.00;246
10414;40;22357284;10414;552;11774;12019;4.34;0.27;356.99;17.87;1360;43;4133.00;245
10417;40;22357301;10417;556;11774;12019;4.32;0.26;357.00;17.87;1357;43;4134.00;245
10419;40;22357318;10419;558;11777;12023;4.34;0.27;357.05;17.86;1358;43;4135.00;246
10424;40;22357334;10424;562;11777;12023;4.33;0.26;357.05;17.86;1353;43;4136.00;246
10425;40;22357351;10425;556;11777;12023;4.33;0.26;357.06;17.86;1352;43;4137.00;246
10429;40;22357367;10429;559;11777;12023;4.27;0.26;357.01;17.86;1348;43;4138.00;246
10430;40;22357384;10430;563;11777;12023;4.27;0.26;356.98;17.86;1347;43;4139.00;246
10434;40;22357402;10434;565;11798;12057;4.34;0.27;357.00;17.88;1364;43;4140.00;259
10436;40;22357420;10436;562;11798;12057;4.34;0.27;357.01;17.88;1362;43;4141.00;259
10441;40;22357437;10441;563;11801;12057;4.36;0.27;356.96;17.87;1360;43;4142.00;256
10442;40;22357453;10442;558;11801;12057;4.42;0.27;356.95;17.87;1359;43;4143.00;256
10442;40;22357469;10442;565;11802;12057;4.45;0.27;356.95;17.87;1360;43;4144.00;255
10444;40;22357485;10444;562;11802;12057;4.47;0.27;356.95;17.87;1358;43;4145.00;255
10446;40;22357502;10446;561;11803;12058;4.46;0.27;357.01;17.92;1357;43;4146.00;255
10446;40;22357524;10446;563;11804;12058;4.43;0.27;357.01;17.91;1358;43;4147.00;254
10447;40;22357540;10447;565;11808;12064;4.40;0.27;357.01;17.91;1361;43;4148.00;256
10450;40;22357556;10450;552;11809;12065;4.37;0.27;356.94;17.91;1359;43;4149.00;256
10453;40;22357573;10453;545;11809;12065;4.36;0.27;357.00;17.91;1356;43;4150.00;256
10454;40;22357590;10454;532;11812;12065;4.29;0.26;356.97;17.97;1358;43;4151.00;253
10455;40;22357607;10455;524;11816;12069;4.30;0.26;356.98;18.04;1361;43;4152.00;253
10455;40;22357624;10455;530;11816;12069;4.30;0.26;356.98;18.04;1361;43;4153.00;253
10457;40;22357641;10457;524;11819;12069;4.29;0.26;356.94;18.17;1362;43;4154.00;250
10457;40;22357656;10457;531;11820;12070;4.31;0.26;356.94;18.17;1363;43;4155.00;250
10458;40;22357681;10458;533;11825;12074;4.34;0.27;356.91;18.16;1367;43;4156.00;249
10463;40;22357698;10463;541;11826;12074;4.36;0.27;356.90;18.23;1363;43;4157.00;248
10463;40;22357716;10463;545;11828;12077;4.37;0.27;356.90;18.22;1365;43;4158.00;249
10464;40;22357732;10464;545;11829;12077;4.38;0.27;356.90;18.22;1365;43;4159.00;248
10465;40;22357748;10465;550;11830;12077;4.38;0.27;356.91;18.29;1365;43;4160.00;247
10466;40;22357765;10466;546;11830;12077;4.37;0.27;356.89;18.29;1364;43;4161.00;247
10466;40;22357788;10466;544;11835;12081;4.45;0.27;356.89;18.35;1369;43;4162.00;246
10467;40;22357805;10467;553;11835;12081;4.50;0.28;356.88;18.35;1368;43;4163.00;246
10469;40;22357829;10469;548;11836;12081;4.51;0.28;356.92;18.41;1367;43;4164.00;245
10472;40;22357846;10472;550;11837;12081;4.47;0.27;356.93;18.48;1365;43;4165.00;244
10474;40;22357864;10474;566;11838;12082;4.45;0.27;356.93;18.54;1364;43;4166.00;244
10475;40;22357880;10475;562;11839;12083;4.48;0.27;356.96;18.54;1364;43;4167.00;244
10476;40;22357897;10476;567;11840;12083;4.47;0.27;356.94;18.61;1364;43;4168.00;243
10477;40;22357913;10477;576;11842;12084;4.46;0.27;356.92;18.67;1365;43;4169.00;242
10479;40;22357930;10479;572;11842;12084;4.47;0.27;356.87;18.67;1363;43;4170.00;242
10484;40;22357946;10484;576;11843;12084;4.44;0.27;356.84;18.74;1359;43;4171.00;241
10485;40;22357963;10485;580;11843;12084;4.40;0.27;356.94;18.74;1358;43;4172.00;241
10488;40;22357979;10488;573;11846;12086;4.40;0.27;357.11;18.80;1358;43;4173.00;240
10489;40;22357995;10489;572;11846;12086;4.42;0.27;357.12;18.80;1357;43;4174.00;240
10491;40;22358012;10491;570;11846;12086;4.42;0.27;357.10;18.80;1355;43;4175.00;240
10493;40;22358028;10493;581;11912;12213;4.71;0.29;357.07;18.76;1419;43;4176.00;301
10495;40;22358055;10495;567;11917;12214;4.75;0.29;357.10;18.75;1422;43;4177.00;297
10496;40;22358072;10496;554;11926;12214;4.78;0.30;357.19;18.74;1430;43;4178.00;288
10498;40;22358090;10498;544;11930;12214;4.77;0.30;357.24;18.80;1432;43;4179.00;284
10500;40;22358107;10500;537;11935;12214;4.78;0.30;357.20;18.79;1435;43;4180.00;279
10500;40;22358124;10500;537;11939;12214;4.79;0.30;357.20;18.92;1439;43;4181.00;275
10503;40;22358141;10503;530;11943;12214;4.78;0.29;357.19;18.91;1440;43;4182.00;271
10503;40;22358157;10503;527;11945;12214;4.83;0.30;357.19;18.91;1442;43;4183.00;269
10504;40;22358175;10504;533;11949;12215;4.88;0.30;357.28;19.03;1445;43;4184.00;266
10506;41;22358192;10506;536;11951;12217;4.96;0.31;357.34;19.03;1445;44;4185.00;266
10509;41;22358231;10509;533;11955;12217;4.99;0.31;357.36;19.15;1446;44;4186.00;262
10512;41;22358250;10512;542;11958;12218;4.99;0.31;357.46;19.21;1446;44;4187.00;260
10516;41;22358268;10516;549;11962;12218;4.97;0.31;357.60;19.27;1446;44;4188.00;256
10521;41;22358284;10521;547;11964;12218;4.95;0.30;357.64;19.27;1443;44;4189.00;254
10523;41;22358305;10523;550;11966;12218;4.91;0.30;357.67;19.27;1443;44;4190.00;252
10526;41;22358321;10526;558;11972;12222;4.92;0.30;357.65;19.39;1446;44;4191.00;250
10535;41;22358339;10535;562;11975;12222;4.81;0.29;357.77;19.39;1440;44;4192.00;247
10540;41;22358356;10540;569;11977;12222;4.70;0.29;357.83;19.39;1437;44;4193.00;245
10543;41;22358374;10543;574;11982;12225;4.63;0.28;357.82;19.51;1439;44;4194.00;243
10546;41;22358390;10546;579;11984;12225;4.56;0.28;357.78;19.51;1438;44;4195.00;241
10548;41;22358407;10548;585;11987;12225;4.50;0.27;357.89;19.63;1439;44;4196.00;238
10552;41;22358424;10552;587;11990;12229;4.43;0.27;357.96;19.62;1438;44;4197.00;239
10554;41;22358451;10554;590;11992;12230;4.39;0.27;357.95;19.62;1438;44;4198.00;238
10558;41;22358485;10558;596;11993;12230;4.34;0.26;358.03;19.62;1435;44;4199.00;237
10562;41;22358506;10562;590;12004;12264;4.32;0.26;358.14;19.60;1442;44;4200.00;260
10565;41;22358531;10565;585;12007;12264;4.32;0.26;358.20;19.60;1442;44;4201.00;257
10569;41;22358549;10569;590;12007;12264;4.31;0.26;358.30;19.60;1438;44;4202.00;257
10573;41;22358566;10573;586;12007;12265;4.34;0.27;358.42;19.60;1434;44;4203.00;258
10577;41;22358590;10577;590;12007;12265;4.35;0.27;358.51;19.60;1430;44;4204.00;258
10578;41;22358608;10578;588;12011;12271;4.41;0.27;358.53;19.59;1433;44;4205.00;260
10582;41;22358625;10582;578;12015;12271;4.39;0.27;358.59;19.59;1433;44;4206.00;256
10587;41;22358642;10587;566;12015;12272;4.42;0.27;358.69;19.59;1428;44;4207.00;257
10587;41;22358666;10587;559;12015;12272;4.46;0.27;358.69;19.59;1428;44;4208.00;257
10593;41;22358682;10593;552;12015;12272;4.45;0.27;358.75;19.59;1422;44;4209.00;257
10596;41;22358700;10596;552;12015;12272;4.44;0.27;358.80;19.59;1419;44;4210.00;257
10598;41;22358717;10598;548;12017;12272;4.48;0.27;358.79;19.58;1419;44;4211.00;255
10602;41;22358734;10602;538;12027;12284;4.50;0.27;358.89;19.57;1425;44;4212.00;257
10605;41;22358752;10605;533;12028;12284;4.51;0.28;359.01;19.57;1423;44;4213.00;256
10607;41;22358771;10607;525;12028;12284;4.58;0.28;359.00;19.57;1421;44;4214.00;256
10611;41;22358788;10611;530;12029;12284;4.61;0.28;359.00;19.62;1418;44;4215.00;255
10614;41;22358807;10614;526;12030;12284;4.62;0.28;359.10;19.62;1416;44;4216.00;254
10620;41;22358824;10620;517;12031;12284;4.62;0.28;359.20;19.62;1411;44;4217.00;253
10623;41;22358843;10623;524;12035;12288;4.66;0.28;359.27;19.61;1412;44;4218.00;253
10626;41;22358861;10626;518;12036;12288;4.68;0.29;359.30;19.61;1410;44;4219.00;252
10629;41;22358879;10629;519;12038;12292;4.69;0.29;359.38;19.61;1409;44;4220.00;254
10634;41;22358898;10634;513;12038;12293;4.67;0.28;359.47;19.61;1404;44;4221.00;255
10639;41;22358915;10639;512;12040;12293;4.61;0.28;359.52;19.61;1401;44;4222.00;253
10645;41;22358933;10645;505;12042;12293;4.59;0.28;359.60;19.61;1397;44;4223.00;251
10648;41;22358950;10648;498;12048;12306;4.59;0.28;359.68;19.60;1400;44;4224.00;258
10654;41;22358968;10654;493;12048;12306;4.58;0.28;359.68;19.60;1394;44;4225.00;258
10654;41;22358985;10654;485;12050;12306;4.60;0.28;359.68;19.60;1396;44;4226.00;256
10659;41;22359002;10659;490;12051;12307;4.56;0.28;359.73;19.60;1392;44;4227.00;256
10666;41;22359020;10666;488;12053;12308;4.52;0.27;359.74;19.60;1387;44;4228.00;255
10668;41;22359038;10668;487;12053;12308;4.53;0.27;359.79;19.60;1385;44;4229.00;255
10673;41;22359056;10673;487;12058;12314;4.51;0.27;359.83;19.59;1385;44;4230.00;256
10676;41;22359077;10676;492;12059;12314;4.51;0.27;359.87;19.59;1383;44;4231.00;255
10680;41;22359106;10680;503;12060;12314;4.50;0.27;359.89;19.59;1380;44;4232.00;254
10685;41;22359127;10685;509;12061;12314;4.48;0.27;359.98;19.58;1376;44;4233.00;253
10690;41;22359144;10690;518;12067;12320;4.41;0.27;360.13;19.58;1377;44;4234.00;253
10693;41;22359161;10693;517;12067;12320;4.38;0.27;360.12;19.58;1374;44;4235.00;253
10697;41;22359178;10697;519;12068;12320;4.35;0.27;360.18;19.58;1371;44;4236.00;252
10701;41;22359195;10701;524;12068;12320;4.36;0.26;360.27;19.58;1367;44;4237.00;252
10701;41;22359214;10701;524;12071;12324;4.39;0.27;360.27;19.57;1370;44;4238.00;253
10704;41;22359231;10704;531;12072;12325;4.35;0.26;360.42;19.57;1368;44;4239.00;253
10707;41;22359249;10707;532;12074;12325;4.28;0.26;360.43;19.62;1367;44;4240.00;251
10711;41;22359268;10711;529;12075;12326;4.22;0.26;360.49;19.62;1364;44;4241.00;251
10712;41;22359285;10712;534;12075;12326;4.17;0.25;360.49;19.62;1363;44;4242.00;251
10715;41;22359304;10715;532;12075;12326;4.14;0.25;360.61;19.62;1360;44;4243.00;251
10717;41;22359321;10717;536;12075;12326;4.10;0.25;360.67;19.62;1358;44;4244.00;251
10718;41;22359347;10718;542;12075;12326;4.05;0.25;360.66;19.62;1357;44;4245.00;251
10721;41;22359363;10721;540;12076;12326;4.05;0.25;360.72;19.62;1355;44;4246.00;250
10723;41;22359382;10723;533;12076;12326;4.05;0.25;360.78;19.62;1353;44;4247.00;250
10728;41;22359399;10728;531;12111;12396;4.05;0.25;360.87;19.57;1383;44;4248.00;285
10732;41;22359422;10732;525;12113;12397;4.05;0.25;360.86;19.57;1381;44;4249.00;284
10737;41;22359440;10737;514;12118;12397;4.12;0.25;360.85;19.56;1381;44;4250.00;279
10741;41;22359460;10741;513;12120;12397;4.16;0.25;361.01;19.56;1379;44;4251.00;277
10741;41;22359476;10741;505;12125;12397;4.24;0.26;361.01;19.56;1384;44;4252.00;272
10744;41;22359491;10744;500;12128;12397;4.28;0.26;361.10;19.55;1384;44;4253.00;269
10748;41;22359509;10748;498;12132;12397;4.25;0.26;361.18;19.55;1384;44;4254.00;265
10750;41;22359526;10750;507;12138;12397;4.26;0.26;361.16;19.60;1388;44;4255.00;259
10753;41;22359543;10753;506;12140;12398;4.27;0.26;361.35;19.59;1387;44;4256.00;258
10757;41;22359562;10757;497;12144;12399;4.27;0.26;361.45;19.59;1387;44;4257.00;255
10760;41;22359583;10760;501;12145;12399;4.26;0.26;361.51;19.59;1385;44;4258.00;254
10762;41;22359602;10762;507;12149;12403;4.27;0.26;361.51;19.58;1387;44;4259.00;254
10765;41;22359621;10765;507;12149;12403;4.30;0.26;361.66;19.58;1384;44;4260.00;254
10765;41;22359640;10765;520;12149;12403;4.38;0.27;361.66;19.58;1384;44;4261.00;254
10767;41;22359657;10767;529;12149;12403;4.38;0.27;361.75;19.58;1382;44;4262.00;254
10769;41;22359674;10769;531;12154;12409;4.40;0.27;361.84;19.58;1385;44;4263.00;255
10772;41;22359692;10772;535;12154;12409;4.39;0.27;361.96;19.58;1382;44;4264.00;255
10772;41;22359712;10772;539;12154;12409;4.41;0.27;361.96;19.58;1382;44;4265.00;255
10775;41;22359729;10775;542;12156;12412;4.40;0.27;362.10;19.57;1381;44;4266.00;256
10775;41;22359747;10775;543;12157;12412;4.42;0.27;362.10;19.57;1382;44;4267.00;255
10780;41;22359764;10780;541;12157;12412;4.40;0.27;362.16;19.57;1377;44;4268.00;255
10782;41;22359781;10782;544;12157;12413;4.41;0.27;362.29;19.57;1375;44;4269.00;256
10785;41;22359798;10785;543;12158;12414;4.37;0.27;362.33;19.57;1373;44;4270.00;256
10786;41;22359816;10786;549;12158;12414;4.36;0.26;362.35;19.57;1372;44;4271.00;256
10791;41;22359833;10791;547;12167;12427;4.38;0.27;362.48;19.56;1376;44;4272.00;260
10794;41;22359852;10794;531;12167;12427;4.39;0.27;362.55;19.56;1373;44;4273.00;260
10795;41;22359869;10795;539;12167;12427;4.40;0.27;362.64;19.56;1372;44;4274.00;260
10797;41;22359885;10797;538;12169;12429;4.40;0.27;362.76;19.55;1372;44;4275.00;260
10799;41;22359903;10799;535;12169;12429;4.40;0.27;362.82;19.55;1370;44;4276.00;260
10799;41;22359919;10799;539;12173;12433;4.43;0.27;362.82;19.55;1374;44;4277.00;260
10802;41;22359937;10802;538;12173;12433;4.45;0.27;362.79;19.55;1371;44;4278.00;260
10803;41;22359953;10803;545;12176;12437;4.47;0.27;362.76;19.54;1373;44;4279.00;261
10805;41;22359971;10805;535;12176;12437;4.48;0.27;362.82;19.54;1371;44;4280.00;261
10807;41;22359987;10807;535;12176;12437;4.50;0.27;362.79;19.54;1369;44;4281.00;261
10812;41;22360005;10812;537;12176;12437;4.48;0.27;362.85;19.54;1364;44;4282.00;261
10813;41;22360022;10813;538;12176;12437;4.45;0.27;362.83;19.54;1363;44;4283.00;261
10815;41;22360039;10815;538;12186;12449;4.50;0.27;362.87;19.53;1371;44;4284.00;263
10817;41;22360056;10817;539;12186;12449;4.48;0.27;362.92;19.53;1369;44;4285.00;263
10820;41;22360073;10820;550;12187;12449;4.43;0.27;362.92;19.52;1367;44;4286.00;262
10824;41;22360089;10824;553;12187;12449;4.40;0.27;362.88;19.52;1363;44;4287.00;262
10826;41;22360107;10826;561;12187;12449;4.35;0.27;362.84;19.52;1361;44;4288.00;262
10829;41;22360123;10829;564;12187;12449;4.31;0.26;362.85;19.52;1358;44;4289.00;262
10834;41;22360141;10834;558;12188;12450;4.27;0.26;362.81;19.57;1354;44;4290.00;262
10837;41;22360157;10837;559;12188;12450;4.28;0.26;362.79;19.57;1351;44;4291.00;262
10839;41;22360181;10839;547;12193;12456;4.34;0.26;362.79;19.57;1354;44;4292.00;263
10841;41;22360197;10841;545;12194;12457;4.32;0.26;362.75;19.56;1353;44;4293.00;263
10842;41;22360214;10842;541;12194;12457;4.33;0.26;362.76;19.56;1352;44;4294.00;263
10844;41;22360230;10844;527;12194;12457;4.33;0.26;362.75;19.56;1350;44;4295.00;263
10847;41;22360247;10847;535;12196;12461;4.37;0.27;362.79;19.56;1349;44;4296.00;265
10849;41;22360264;10849;538;12196;12461;4.35;0.26;362.77;19.56;1347;44;4297.00;265
10851;41;22360279;10851;527;12196;12461;4.38;0.27;362.76;19.56;1345;44;4298.00;265
10853;41;22360296;10853;533;12197;12462;4.38;0.27;362.75;19.56;1344;44;4299.00;265
10855;41;22360312;10855;531;12200;12466;4.35;0.26;362.76;19.55;1345;44;4300.00;266
10857;41;22360338;10857;535;12200;12466;4.36;0.27;362.73;19.55;1343;44;4301.00;266
10860;41;22360354;10860;537;12202;12469;4.37;0.27;362.74;19.55;1342;44;4302.00;267
10864;41;22360370;10864;539;12202;12469;4.34;0.26;362.70;19.55;1338;44;4303.00;267
10864;41;22360386;10864;533;12203;12469;4.36;0.27;362.70;19.55;1339;44;4304.00;266
10869;41;22360402;10869;528;12205;12469;4.30;0.26;362.72;19.69;1336;44;4305.00;264
10871;41;22360421;10871;505;12210;12473;4.32;0.26;362.71;19.72;1339;44;4306.00;263
10874;41;22360438;10874;493;12210;12473;4.38;0.27;362.67;19.72;1336;44;4307.00;263
10877;41;22360454;10877;479;12210;12473;4.42;0.27;362.64;19.72;1333;44;4308.00;263
10877;41;22360470;10877;469;12210;12473;4.51;0.27;362.64;19.72;1333;44;4309.00;263
10878;41;22360486;10878;462;12210;12474;4.58;0.28;362.65;19.72;1332;44;4310.00;264
10879;41;22360504;10879;449;12211;12475;4.67;0.28;362.67;19.72;1332;44;4311.00;264
10880;41;22360520;10880;442;12211;12475;4.71;0.29;362.68;19.72;1331;44;4312.00;264
10883;41;22360536;10883;438;12213;12476;4.78;0.29;362.67;19.73;1330;44;4313.00;263
10883;41;22360553;10883;431;12213;12476;4.83;0.29;362.67;19.73;1330;44;4314.00;263
10885;41;22360569;10885;434;12213;12476;4.88;0.30;362.68;19.73;1328;44;4315.00;263
10886;41;22360586;10886;437;12214;12476;4.94;0.30;362.66;19.73;1328;44;4316.00;262
10888;41;22360603;10888;438;12215;12476;5.01;0.31;362.64;19.73;1327;44;4317.00;261
10891;41;22360627;10891;436;12215;12476;5.03;0.31;362.63;19.73;1324;44;4318.00;261
10892;41;22360643;10892;442;12215;12476;5.03;0.31;362.69;19.73;1323;44;4319.00;261
10894;41;22360665;10894;470;12309;12706;5.29;0.33;362.71;19.59;1415;44;4320.00;397
10895;41;22360706;10895;463;12313;12707;5.29;0.33;362.69;19.58;1418;44;4321.00;394
10899;41;22360723;10899;450;12325;12707;5.29;0.33;362.65;19.61;1426;44;4322.00;382
10900;41;22360740;10900;457;12332;12707;5.26;0.33;362.62;19.61;1432;44;4323.00;375
10904;41;22360765;10904;453;12343;12707;5.26;0.33;362.66;19.59;1439;44;4324.00;364
10905;41;22360782;10905;444;12351;12707;5.26;0.33;362.63;19.58;1446;44;4325.00;356
10907;41;22360800;10907;451;12356;12707;5.26;0.33;362.62;19.58;1449;44;4326.00;351
10908;41;22360817;10908;449;12363;12707;5.27;0.33;362.60;19.57;1455;44;4327.00;344
10912;42;22360835;10912;453;12367;12708;5.26;0.33;362.70;19.57;1455;45;4328.00;341
10914;42;22360872;10914;461;12373;12709;5.24;0.32;362.68;19.56;1459;45;4329.00;336
10917;42;22360891;10917;468;12381;12709;5.19;0.32;362.81;19.56;1464;45;4330.00;328
10919;42;22360910;10919;477;12387;12710;5.16;0.32;362.82;19.69;1468;45;4331.00;323
10922;42;22360927;10922;489;12391;12710;5.12;0.32;362.80;19.69;1469;45;4332.00;319
10924;42;22360946;10924;490;12395;12710;5.10;0.31;362.89;19.83;1471;45;4333.00;315
10930;42;22360964;10930;516;12397;12710;5.03;0.31;362.86;19.83;1467;46;4334.00;313
10934;42;22360988;10934;514;12403;12714;4.99;0.31;362.93;19.82;1469;46;4335.00;311
10936;42;22361008;10936;516;12405;12714;5.00;0.31;362.98;19.95;1469;46;4336.00;309
10941;42;22361027;10941;524;12407;12714;4.96;0.30;363.08;19.95;1466;46;4337.00;307
10942;42;22361045;10942;530;12410;12717;4.98;0.30;363.09;20.09;1468;46;4338.00;307
10942;42;22361069;10942;541;12411;12717;4.97;0.30;363.09;20.09;1469;46;4339.00;306
10946;42;22361087;10946;550;12413;12717;4.95;0.30;363.18;20.22;1467;46;4340.00;304
10949;42;22361107;10949;551;12417;12721;4.90;0.30;363.38;20.21;1468;46;4341.00;304
10952;42;22361128;10952;556;12420;12722;4.91;0.30;363.39;20.28;1468;46;4342.00;302
10954;42;22361147;10954;560;12423;12722;4.89;0.30;363.45;20.35;1469;46;4343.00;299
10955;42;22361165;10955;566;12427;12726;4.92;0.30;363.53;20.41;1472;46;4344.00;299
10959;42;22361187;10959;569;12428;12726;4.89;0.30;363.58;20.47;1469;46;4345.00;298
10960;42;22361205;10960;569;12428;12726;4.89;0.30;363.57;20.47;1468;46;4346.00;298
10962;42;22361224;10962;569;12431;12727;4.89;0.30;363.61;20.60;1469;46;4347.00;296
10962;42;22361241;10962;570;12432;12727;4.86;0.30;363.61;20.60;1470;46;4348.00;295
10964;42;22361261;10964;569;12437;12733;4.83;0.29;363.62;20.60;1473;46;4349.00;296
10967;42;22361281;10967;568;12439;12733;4.77;0.29;363.66;20.66;1472;46;4350.00;294
10970;42;22361300;10970;562;12441;12734;4.74;0.29;363.74;20.66;1471;46;4351.00;293
10971;42;22361318;10971;572;12442;12734;4.74;0.29;363.76;20.73;1471;46;4352.00;292
10974;42;22361336;10974;567;12443;12734;4.72;0.29;363.90;20.73;1469;46;4353.00;291
10976;42;22361353;10976;577;12443;12734;4.70;0.29;363.96;20.73;1467;46;4354.00;291
10978;42;22361371;10978;587;12446;12734;4.71;0.29;364.00;20.73;1468;46;4355.00;288
10980;42;22361388;10980;588;12455;12746;4.72;0.29;364.04;20.72;1475;46;4356.00;291
10982;42;22361406;10982;595;12455;12746;4.72;0.29;364.11;20.72;1473;46;4357.00;291
10984;42;22361424;10984;595;12458;12746;4.76;0.29;364.17;20.72;1474;46;4358.00;288
10988;42;22361441;10988;602;12458;12746;4.76;0.29;364.26;20.72;1470;46;4359.00;288
10989;42;22361459;10989;603;12461;12746;4.83;0.29;364.27;20.72;1472;46;4360.00;285
10995;42;22361478;10995;604;12462;12746;4.83;0.29;364.30;20.72;1467;46;4361.00;284
10999;42;22361496;10999;609;12467;12750;4.80;0.29;364.33;20.72;1468;46;4362.00;283
11002;42;22361515;11002;613;12468;12750;4.79;0.29;364.34;20.72;1466;46;4363.00;282
11006;42;22361533;11006;613;12473;12754;4.76;0.29;364.43;20.71;1467;46;4364.00;281
11008;42;22361550;11008;618;12476;12756;4.75;0.29;364.51;20.71;1468;46;4365.00;280
11012;42;22361568;11012;628;12477;12756;4.69;0.29;364.49;20.71;1465;46;4366.00;279
11014;42;22361585;11014;636;12477;12756;4.65;0.28;364.56;20.71;1463;46;4367.00;279
11017;42;22361603;11017;654;12486;12769;4.64;0.28;364.51;20.70;1469;46;4368.00;283
11020;42;22361621;11020;652;12487;12769;4.62;0.28;364.59;20.70;1467;46;4369.00;282
11024;42;22361638;11024;651;12487;12769;4.56;0.28;364.64;20.70;1463;46;4370.00;282
11028;42;22361655;11028;659;12488;12770;4.47;0.27;364.66;20.70;1460;46;4371.00;282
11028;42;22361672;11028;658;12489;12771;4.46;0.27;364.66;20.70;1461;46;4372.00;282
11034;42;22361689;11034;662;12489;12771;4.40;0.27;364.76;20.70;1455;46;4373.00;282
11034;42;22361706;11034;668;12493;12774;4.39;0.27;364.76;20.70;1459;46;4374.00;281
11038;42;22361723;11038;663;12493;12774;4.37;0.27;364.83;20.70;1455;46;4375.00;281
11043;42;22361740;11043;657;12493;12774;4.36;0.27;364.91;20.70;1450;46;4376.00;281
11045;42;22361757;11045;665;12494;12774;4.34;0.27;364.96;20.70;1449;46;4377.00;280
11048;42;22361775;11048;652;12499;12780;4.36;0.27;364.94;20.70;1451;46;4378.00;281
11051;42;22361792;11051;650;12499;12780;4.38;0.27;365.07;20.70;1448;46;4379.00;281
11053;42;22361815;11053;652;12500;12780;4.41;0.27;365.06;20.69;1447;46;4380.00;280
11057;42;22361831;11057;647;12500;12780;4.43;0.27;365.10;20.69;1443;46;4381.00;280
11061;42;22361849;11061;633;12504;12784;4.39;0.27;365.14;20.69;1443;46;4382.00;280
11064;42;22361870;11064;631;12505;12785;4.37;0.27;365.16;20.69;1441;46;4383.00;280
11069;42;22361898;11069;632;12505;12785;4.34;0.27;365.19;20.69;1436;46;4384.00;280
11076;42;22361916;11076;620;12506;12786;4.28;0.26;365.32;20.69;1430;46;4385.00;280
11081;42;22361935;11081;624;12506;12786;4.28;0.26;365.39;20.69;1425;46;4386.00;280
11086;42;22361954;11086;622;12506;12786;4.25;0.26;365.37;20.69;1420;46;4387.00;280
11091;42;22361973;11091;615;12506;12786;4.21;0.26;365.32;20.69;1415;46;4388.00;280
11097;42;22361992;11097;618;12506;12786;4.17;0.26;365.36;20.69;1409;46;4389.00;280
11102;42;22362012;11102;622;12506;12786;4.13;0.25;365.36;20.69;1404;46;4390.00;280
11106;42;22362030;11106;627;12507;12786;4.08;0.25;365.38;20.69;1401;46;4391.00;279
11110;42;22362049;11110;631;12538;12856;4.23;0.26;365.43;20.63;1428;46;4392.00;318
11113;42;22362073;11113;632;12540;12857;4.28;0.26;365.44;20.63;1427;46;4393.00;317
11116;42;22362098;11116;629;12545;12857;4.31;0.26;365.46;20.62;1429;46;4394.00;312
11118;42;22362116;11118;636;12545;12857;4.30;0.26;365.45;20.62;1427;46;4395.00;312
11121;42;22362136;11121;643;12548;12857;4.29;0.26;365.44;20.62;1427;46;4396.00;309
11124;42;22362156;11124;647;12549;12857;4.26;0.26;365.45;20.62;1425;46;4397.00;308
11126;42;22362175;11126;647;12553;12857;4.26;0.26;365.43;20.61;1427;46;4398.00;304
11131;42;22362196;11131;658;12556;12857;4.24;0.26;365.49;20.61;1425;46;4399.00;301
11136;42;22362217;11136;657;12559;12858;4.24;0.26;365.46;20.61;1423;46;4400.00;299
11140;42;22362242;11140;658;12562;12859;4.21;0.26;365.44;20.60;1422;46;4401.00;297
11142;42;22362262;11142;662;12563;12859;4.20;0.26;365.45;20.60;1421;46;4402.00;296
11147;42;22362297;11147;659;12567;12863;4.17;0.26;365.50;20.60;1420;46;4403.00;296
11149;42;22362318;11149;664;12567;12863;4.15;0.25;365.52;20.60;1418;46;4404.00;296
11155;42;22362339;11155;663;12569;12863;4.10;0.25;365.46;20.60;1414;46;4405.00;294
11158;42;22362360;11158;660;12571;12863;4.11;0.25;365.48;20.60;1413;46;4406.00;292
11162;42;22362382;11162;661;12574;12869;4.11;0.25;365.50;20.59;1412;46;4407.00;295
11163;42;22362403;11163;655;12574;12869;4.11;0.25;365.58;20.59;1411;46;4408.00;295
11168;42;22362421;11168;655;12575;12869;4.10;0.25;365.70;20.59;1407;46;4409.00;294
11171;42;22362441;11171;648;12581;12875;4.13;0.25;365.76;20.58;1410;46;4410.00;294
11173;42;22362461;11173;655;12581;12875;4.13;0.25;365.83;20.58;1408;46;4411.00;294
11177;42;22362488;11177;652;12582;12875;4.08;0.25;365.83;20.58;1405;46;4412.00;293
11179;42;22362507;11179;660;12582;12876;4.06;0.25;365.78;20.58;1403;46;4413.00;294
11183;42;22362524;11183;663;12584;12877;4.05;0.25;365.86;20.58;1401;46;4414.00;293
11185;42;22362544;11185;670;12584;12877;4.02;0.24;365.95;20.58;1399;46;4415.00;293
11188;42;22362562;11188;679;12592;12890;4.03;0.25;365.97;20.57;1404;46;4416.00;298
11191;42;22362583;11191;697;12595;12890;4.02;0.24;366.05;20.56;1404;46;4417.00;295
11193;42;22362602;11193;691;12595;12890;4.03;0.24;366.11;20.56;1402;46;4418.00;295
11197;42;22362621;11197;697;12597;12891;4.02;0.24;366.07;20.56;1400;46;4419.00;294
11198;42;22362640;11198;703;12597;12891;3.99;0.24;366.11;20.56;1399;46;4420.00;294
11204;42;22362659;11204;710;12601;12895;3.94;0.24;366.06;20.56;1397;46;4421.00;294
11206;42;22362680;11206;702;12601;12895;3.90;0.24;366.16;20.56;1395;46;4422.00;294
11207;42;22362699;11207;692;12604;12899;3.94;0.24;366.15;20.55;1397;46;4423.00;295
11213;42;22362718;11213;691;12604;12899;3.88;0.24;366.15;20.55;1391;46;4424.00;295
11214;42;22362737;11214;686;12604;12899;3.86;0.23;366.21;20.55;1390;46;4425.00;295
11216;42;22362755;11216;677;12604;12899;3.85;0.23;366.20;20.55;1388;46;4426.00;295
11218;42;22362773;11218;674;12604;12899;3.81;0.23;366.32;20.55;1386;46;4427.00;295
11220;42;22362791;11220;681;12614;12911;3.87;0.23;366.29;20.54;1394;46;4428.00;297
11223;42;22362812;11223;685;12614;12911;3.87;0.23;366.33;20.54;1391;46;4429.00;297
11225;42;22362831;11225;689;12615;12911;3.90;0.24;366.35;20.53;1390;46;4430.00;296
11226;42;22362857;11226;682;12615;12911;3.90;0.24;366.32;20.53;1389;46;4431.00;296
11228;42;22362876;11228;671;12615;12911;3.92;0.24;366.32;20.53;1387;46;4432.00;296
11229;42;22362895;11229;664;12615;12911;3.94;0.24;366.29;20.53;1386;46;4433.00;296
11232;42;22362914;11232;648;12615;12912;3.93;0.24;366.34;20.53;1383;46;4434.00;297
11235;42;22362931;11235;642;12615;12912;3.91;0.24;366.46;20.53;1380;46;4435.00;297
11235;42;22362949;11235;641;12619;12918;3.97;0.24;366.46;20.53;1384;46;4436.00;299
11237;42;22362974;11237;644;12620;12919;3.98;0.24;366.45;20.53;1383;46;4437.00;299
11239;42;22362992;11239;649;12620;12919;3.99;0.24;366.51;20.53;1381;46;4438.00;299
11239;42;22363013;11239;647;12620;12919;4.02;0.24;366.51;20.53;1381;46;4439.00;299
11243;42;22363035;11243;649;12623;12924;4.00;0.24;366.53;20.52;1380;46;4440.00;301
11244;42;22363054;11244;651;12623;12924;4.05;0.25;366.52;20.52;1379;46;4441.00;301
11247;42;22363072;11247;654;12623;12924;4.03;0.25;366.50;20.52;1376;46;4442.00;301
11248;42;22363091;11248;660;12624;12925;4.07;0.25;366.47;20.52;1376;46;4443.00;301
11248;42;22363112;11248;665;12627;12929;4.07;0.25;366.47;20.52;1379;46;4444.00;302
11250;42;22363130;11250;660;12627;12929;4.08;0.25;366.45;20.52;1377;46;4445.00;302
11252;42;22363148;11252;659;12629;12932;4.10;0.25;366.53;20.51;1377;46;4446.00;303
11253;42;22363165;11253;655;12629;12932;4.10;0.25;366.50;20.51;1376;46;4447.00;303
11254;42;22363182;11254;666;12630;12932;4.15;0.25;366.48;20.51;1376;46;4448.00;302
11257;42;22363201;11257;664;12630;12932;4.14;0.25;366.47;20.51;1373;46;4449.00;302
11259;42;22363220;11259;670;12634;12936;4.16;0.25;366.42;20.56;1375;46;4450.00;302
11262;42;22363239;11262;669;12634;12936;4.12;0.25;366.37;20.56;1372;46;4451.00;302
11264;42;22363256;11264;675;12634;12936;4.09;0.25;366.32;20.56;1370;46;4452.00;302
11265;42;22363273;11265;679;12634;12936;4.03;0.25;366.30;20.56;1369;46;4453.00;302
11267;42;22363290;11267;673;12634;12937;4.00;0.24;366.30;20.56;1367;46;4454.00;303
11268;42;22363308;11268;678;12636;12939;3.99;0.24;366.29;20.55;1368;46;4455.00;303
11270;42;22363324;11270;678;12636;12939;3.96;0.24;366.25;20.55;1366;46;4456.00;303
11271;42;22363350;11271;683;12637;12940;3.94;0.24;366.23;20.55;1366;46;4457.00;303
11273;42;22363367;11273;684;12637;12940;3.93;0.24;366.36;20.55;1364;46;4458.00;303
11274;42;22363384;11274;682;12637;12940;3.91;0.24;366.35;20.55;1363;46;4459.00;303
11274;42;22363401;11274;677;12637;12940;3.90;0.24;366.35;20.55;1363;46;4460.00;303
11276;42;22363417;11276;670;12637;12940;3.87;0.23;366.39;20.55;1361;46;4461.00;303
11278;42;22363433;11278;670;12637;12940;3.84;0.23;366.38;20.55;1359;46;4462.00;303
11278;42;22363450;11278;652;12637;12940;3.84;0.23;366.38;20.55;1359;46;4463.00;303
11278;42;22363467;11278;663;12698;13067;4.05;0.25;366.38;20.45;1420;46;4464.00;369
11279;42;22363495;11279;643;12699;13068;4.12;0.25;366.36;20.51;1420;46;4465.00;369
11281;42;22363513;11281;629;12706;13068;4.24;0.26;366.40;20.50;1425;46;4466.00;362
11282;42;22363531;11282;617;12707;13068;4.31;0.26;366.37;20.50;1425;46;4467.00;361
11283;42;22363549;11283;602;12713;13068;4.38;0.27;366.36;20.49;1430;46;4468.00;355
11284;42;22363568;11284;589;12713;13068;4.44;0.27;366.36;20.49;1429;46;4469.00;355
11287;42;22363595;11287;586;12717;13068;4.56;0.28;366.45;20.48;1430;46;4470.00;351
11288;42;22363615;11288;579;12720;13068;4.65;0.28;366.44;20.48;1432;46;4471.00;348
11288;42;22363633;11288;590;12723;13069;4.74;0.29;366.44;20.48;1435;46;4472.00;346
11289;42;22363665;11289;578;12728;13070;4.84;0.30;366.45;20.47;1439;46;4473.00;342
11291;42;22363690;11291;580;12731;13070;4.87;0.30;366.46;20.47;1440;46;4474.00;339
11293;42;22363717;11293;566;12735;13071;4.88;0.30;366.45;20.47;1442;46;4475.00;336
11294;42;22363736;11294;572;12736;13071;4.90;0.30;366.45;20.47;1442;46;4476.00;335
11295;42;22363754;11295;565;12738;13071;4.87;0.30;366.43;20.46;1443;46;4477.00;333
11297;42;22363772;11297;562;12738;13071;4.82;0.30;366.42;20.46;1441;46;4478.00;333
11298;42;22363790;11298;562;12743;13075;4.79;0.29;366.40;20.51;1445;46;4479.00;332
11300;42;22363810;11300;560;12746;13075;4.76;0.29;366.46;20.65;1446;46;4480.00;329
11303;42;22363833;11303;551;12747;13075;4.73;0.29;366.43;20.65;1444;46;4481.00;328
11305;42;22363852;11305;544;12749;13078;4.73;0.29;366.42;20.65;1444;46;4482.00;329
11306;42;22363872;11306;549;12750;13078;4.70;0.29;366.40;20.65;1444;46;4483.00;328
11310;42;22363891;11310;531;12750;13078;4.72;0.29;366.49;20.65;1440;46;4484.00;328
11313;42;22363912;11313;535;12755;13082;4.70;0.29;366.52;20.65;1442;46;4485.00;327
11316;42;22363931;11316;529;12759;13083;4.69;0.29;366.68;20.65;1443;46;4486.00;324
11320;42;22363950;11320;521;12759;13083;4.68;0.28;366.62;20.65;1439;46;4487.00;324
11321;42;22363969;11321;518;12761;13087;4.71;0.29;366.61;20.64;1440;46;4488.00;326
11323;42;22363989;11323;511;12761;13087;4.74;0.29;366.61;20.64;1438;46;4489.00;326
11327;42;22364008;11327;511;12761;13087;4.78;0.29;366.59;20.64;1434;46;4490.00;326
11330;42;22364028;11330;509;12762;13088;4.82;0.29;366.60;20.64;1432;46;4491.00;326
11334;42;22364048;11334;499;12762;13088;4.80;0.29;366.60;20.64;1428;46;4492.00;326
11336;42;22364066;11336;506;12766;13094;4.83;0.29;366.57;20.64;1430;46;4493.00;328
11338;42;22364086;11338;500;12766;13094;4.84;0.29;366.58;20.64;1428;46;4494.00;328
11342;42;22364106;11342;497;12766;13095;4.83;0.29;366.68;20.64;1424;46;4495.00;329
11344;42;22364124;11344;498;12767;13095;4.84;0.29;366.73;20.71;1423;46;4496.00;328
11346;42;22364145;11346;498;12768;13095;4.83;0.29;366.78;20.71;1422;46;4497.00;327
11348;42;22364164;11348;499;12770;13095;4.83;0.29;366.76;20.72;1422;46;4498.00;325
11349;42;22364182;11349;512;12771;13095;4.82;0.29;366.81;20.73;1422;46;4499.00;324
11350;42;22364204;11350;521;12794;13145;4.92;0.30;366.78;20.70;1444;46;4500.00;351
11353;42;22364234;11353;521;12796;13147;4.91;0.30;366.78;20.70;1443;46;4501.00;351
11354;43;22364254;11354;527;12799;13147;4.96;0.30;366.88;20.70;1445;47;4502.00;348
11356;43;22364287;11356;531;12800;13147;5.00;0.30;366.89;20.70;1444;47;4503.00;347
11357;43;22364307;11357;532;12802;13147;5.05;0.31;366.89;20.70;1445;47;4504.00;345
11359;43;22364325;11359;537;12804;13147;5.07;0.31;366.94;20.78;1445;47;4505.00;343
11362;43;22364347;11362;539;12809;13151;5.07;0.31;367.07;20.77;1447;47;4506.00;342
11363;43;22364372;11363;539;12813;13151;5.09;0.31;367.05;20.85;1450;47;4507.00;338
11365;43;22364392;11365;554;12817;13155;5.08;0.31;367.17;20.85;1452;47;4508.00;338
11367;43;22364412;11367;550;12819;13156;5.06;0.31;367.20;20.85;1452;47;4509.00;337
11368;43;22364431;11368;551;12822;13156;5.03;0.31;367.28;20.92;1454;47;4510.00;334
11368;43;22364450;11368;556;12824;13156;4.94;0.30;367.28;20.92;1456;47;4511.00;332
11371;43;22364469;11371;561;12836;13169;4.91;0.30;367.40;20.99;1465;47;4512.00;333
11372;43;22364489;11372;572;12837;13169;4.88;0.30;367.37;20.99;1465;47;4513.00;332
11373;43;22364509;11373;574;12838;13169;4.83;0.29;367.41;21.06;1465;47;4514.00;331
11377;43;22364529;11377;570;12840;13170;4.80;0.29;367.44;21.06;1463;47;4515.00;330
11379;43;22364548;11379;583;12844;13171;4.81;0.29;367.43;21.13;1465;47;4516.00;327
11383;43;22364567;11383;585;12846;13171;4.81;0.29;367.46;21.13;1463;47;4517.00;325
11385;43;22364587;11385;595;12850;13174;4.86;0.30;367.58;21.13;1465;47;4518.00;324
11387;43;22364606;11387;599;12851;13174;4.87;0.30;367.61;21.13;1464;47;4519.00;323
11388;43;22364625;11388;599;12855;13174;4.85;0.30;367.71;21.20;1467;47;4520.00;319
11390;43;22364645;11390;603;12856;13174;4.83;0.29;367.81;21.20;1466;47;4521.00;318
11394;44;22364663;11394;602;12861;13180;4.77;0.29;367.79;21.34;1467;48;4522.00;319
11396;44;22364699;11396;608;12864;13180;4.69;0.29;367.82;21.33;1468;48;4523.00;316
11398;44;22364719;11398;609;12865;13180;4.66;0.28;367.82;21.40;1467;48;4524.00;315
11400;44;22364738;11400;613;12867;13180;4.64;0.28;367.84;21.47;1467;48;4525.00;313
11402;44;22364756;11402;611;12871;13184;4.62;0.28;367.94;21.54;1469;48;4526.00;313
11404;44;22364777;11404;600;12873;13185;4.62;0.28;367.94;21.54;1469;48;4527.00;312
11407;44;22364798;11407;604;12875;13185;4.61;0.28;367.99;21.68;1468;48;4528.00;310
11410;44;22364818;11410;607;12878;13186;4.57;0.28;368.03;21.82;1468;48;4529.00;308
11411;44;22364838;11411;612;12880;13186;4.59;0.28;368.03;21.89;1469;48;4530.00;306
11413;44;22364858;11413;613;12880;13186;4.60;0.28;368.17;21.89;1467;48;4531.00;306
11415;44;22364879;11415;616;12881;13186;4.56;0.28;368.23;21.96;1466;48;4532.00;305
11418;44;22364898;11418;620;12882;13186;4.59;0.28;368.29;21.96;1464;48;4533.00;304
11421;44;22364918;11421;617;12884;13186;4.60;0.28;368.37;22.10;1463;48;4534.00;302
11424;44;22364938;11424;616;12884;13186;4.60;0.28;368.51;22.10;1460;48;4535.00;302
11425;44;22364958;11425;623;12921;13256;4.69;0.29;368.50;22.05;1496;48;4536.00;335
11427;44;22364984;11427;625;12923;13257;4.71;0.29;368.62;22.11;1496;48;4537.00;334
11428;44;22365004;11428;629;12930;13257;4.72;0.29;368.68;22.10;1502;48;4538.00;327
11431;44;22365029;11431;634;12932;13257;4.68;0.29;368.64;22.10;1501;48;4539.00;325
11436;44;22365049;11436;638;12934;13257;4.61;0.28;368.65;22.10;1498;48;4540.00;323
11441;44;22365071;11441;655;12941;13257;4.52;0.28;368.72;22.31;1500;48;4541.00;316
11445;44;22365089;11445;661;12944;13257;4.45;0.27;368.90;22.31;1499;48;4542.00;313
11450;44;22365108;11450;676;12946;13257;4.38;0.27;368.93;22.30;1496;48;4543.00;311
11454;44;22365126;11454;682;12949;13258;4.33;0.27;369.02;22.30;1495;48;4544.00;309
11457;44;22365146;11457;680;12952;13260;4.30;0.26;369.20;22.30;1495;48;4545.00;308
11461;44;22365164;11461;686;12954;13260;4.23;0.26;369.24;22.30;1493;48;4546.00;306
11463;44;22365183;11463;682;12957;13264;4.16;0.26;369.22;22.29;1494;48;4547.00;307
11466;44;22365201;11466;693;12958;13264;4.11;0.25;369.22;22.29;1492;48;4548.00;306
11470;44;22365220;11470;699;12959;13264;4.07;0.25;369.33;22.29;1489;48;4549.00;305
11475;44;22365238;11475;694;12961;13264;4.04;0.25;369.32;22.29;1486;48;4550.00;303
11480;44;22365257;11480;689;12965;13270;4.00;0.25;369.57;22.28;1485;48;4551.00;305
11483;44;22365277;11483;686;12965;13270;4.00;0.25;369.59;22.28;1482;48;4552.00;305
11485;44;22365296;11485;689;12965;13270;3.99;0.25;369.55;22.28;1480;48;4553.00;305
11491;44;22365313;11491;680;12967;13273;3.97;0.24;369.63;22.28;1476;48;4554.00;306
11492;44;22365332;11492;677;12967;13273;3.98;0.24;369.61;22.28;1475;48;4555.00;306
11495;44;22365350;11495;678;12967;13273;3.95;0.24;369.67;22.28;1472;48;4556.00;306
11499;44;22365368;11499;670;12967;13274;3.91;0.24;369.79;22.28;1468;48;4557.00;307
11504;44;22365386;11504;658;12968;13275;3.91;0.24;369.74;22.28;1464;48;4558.00;307
11507;44;22365406;11507;659;12968;13275;3.87;0.24;369.74;22.28;1461;48;4559.00;307
11512;44;22365426;11512;671;12982;13301;3.90;0.24;369.91;22.25;1470;48;4560.00;319
11514;44;22365447;11514;665;12983;13301;3.89;0.24;369.94;22.25;1469;48;4561.00;318
11517;44;22365466;11517;657;12986;13301;3.90;0.24;369.96;22.25;1469;48;4562.00;315
11518;44;22365483;11518;658;12987;13302;3.92;0.24;369.94;22.25;1469;48;4563.00;315
11524;44;22365502;11524;665;12987;13302;3.84;0.24;370.12;22.25;1463;48;4564.00;315
11526;44;22365521;11526;668;12990;13306;3.80;0.23;370.20;22.24;1464;48;4565.00;316
11527;44;22365539;11527;674;12990;13306;3.77;0.23;370.20;22.24;1463;48;4566.00;316
11533;44;22365557;11533;669;12993;13310;3.72;0.23;370.31;22.29;1460;48;4567.00;317
11536;44;22365578;11536;675;12994;13310;3.73;0.23;370.32;22.29;1458;48;4568.00;316
11538;44;22365597;11538;682;12994;13310;3.75;0.23;370.30;22.29;1456;48;4569.00;316
11544;44;22365617;11544;680;12994;13310;3.70;0.23;370.39;22.29;1450;48;4570.00;316
11548;44;22365640;11548;677;12996;13310;3.69;0.23;370.39;22.29;1448;48;4571.00;314
11551;44;22365660;11551;675;13005;13322;3.72;0.23;370.53;22.28;1454;48;4572.00;317
11554;44;22365681;11554;679;13007;13322;3.67;0.22;370.56;22.28;1453;48;4573.00;315
11558;44;22365702;11558;674;13008;13322;3.65;0.22;370.53;22.28;1450;48;4574.00;314
11564;44;22365722;11564;672;13009;13322;3.58;0.22;370.60;22.28;1445;48;4575.00;313
11569;44;22365745;11569;682;13011;13322;3.54;0.22;370.67;22.28;1442;48;4576.00;311
11570;44;22365767;11570;683;13011;13322;3.53;0.22;370.65;22.28;1441;48;4577.00;311
11574;44;22365788;11574;682;13012;13323;3.49;0.21;370.65;22.27;1438;48;4578.00;311
11578;44;22365807;11578;690;13013;13323;3.46;0.21;370.67;22.27;1435;48;4579.00;310
11581;44;22365826;11581;690;13017;13329;3.46;0.21;370.71;22.27;1436;48;4580.00;312
11585;44;22365849;11585;687;13019;13330;3.43;0.21;370.79;22.27;1434;48;4581.00;311
11590;44;22365867;11590;689;13019;13330;3.37;0.21;370.91;22.27;1429;48;4582.00;311
11591;44;22365887;11591;685;13021;13330;3.32;0.20;370.92;22.26;1430;48;4583.00;309
11595;44;22365906;11595;698;13024;13334;3.27;0.20;370.93;22.26;1429;48;4584.00;310
11598;44;22365925;11598;704;13026;13334;3.23;0.20;371.03;22.31;1428;48;4585.00;308
11601;44;22365944;11601;711;13026;13334;3.17;0.19;371.08;22.31;1425;48;4586.00;308
11605;44;22365962;11605;713;13027;13335;3.14;0.19;371.09;22.31;1422;48;4587.00;308
11609;44;22365980;11609;725;13030;13339;3.14;0.19;371.15;22.31;1421;48;4588.00;309
11611;44;22365998;11611;731;13030;13339;3.13;0.19;371.17;22.31;1419;48;4589.00;309
11614;44;22366017;11614;729;13035;13345;3.13;0.19;371.14;22.30;1421;48;4590.00;310
11615;44;22366036;11615;743;13035;13345;3.11;0.19;371.16;22.30;1420;48;4591.00;310
11619;44;22366054;11619;741;13036;13345;3.06;0.19;371.19;22.30;1417;48;4592.00;309
11620;44;22366072;11620;739;13036;13345;3.04;0.18;371.23;22.30;1416;48;4593.00;309
11620;44;22366089;11620;744;13040;13349;3.08;0.19;371.23;22.29;1420;48;4594.00;309
11623;44;22366111;11623;746;13040;13349;3.07;0.19;371.28;22.29;1417;48;4595.00;309
11623;44;22366129;11623;751;13041;13349;3.07;0.19;371.28;22.34;1418;48;4596.00;308
11624;44;22366147;11624;745;13041;13349;3.08;0.19;371.25;22.34;1417;48;4597.00;308
11627;44;22366165;11627;739;13041;13350;3.10;0.19;371.28;22.34;1414;48;4598.00;309
11630;44;22366182;11630;732;13042;13351;3.12;0.19;371.29;22.34;1412;48;4599.00;309
11633;44;22366202;11633;733;13042;13351;3.15;0.19;371.30;22.34;1409;48;4600.00;309
11636;44;22366224;11636;726;13043;13352;3.20;0.19;371.26;22.34;1407;48;4601.00;309
11636;44;22366243;11636;732;13043;13352;3.25;0.20;371.26;22.34;1407;48;4602.00;309
11640;44;22366262;11640;731;13043;13352;3.24;0.20;371.25;22.34;1403;48;4603.00;309
11642;44;22366280;11642;731;13043;13352;3.27;0.20;371.28;22.34;1401;48;4604.00;309
11645;44;22366297;11645;735;13043;13352;3.27;0.20;371.23;22.34;1398;48;4605.00;309
11646;44;22366329;11646;731;13043;13352;3.30;0.20;371.28;22.34;1397;48;4606.00;309
11649;44;22366347;11649;720;13043;13352;3.34;0.20;371.21;22.34;1394;49;4607.00;309
11649;44;22366381;11649;731;13115;13479;3.66;0.23;371.21;22.22;1466;49;4608.00;364
11653;44;22366411;11653;715;13115;13480;3.69;0.23;371.13;22.22;1462;49;4609.00;365
11654;44;22366431;11654;701;13120;13480;3.79;0.23;371.10;22.21;1466;49;4610.00;360
11657;44;22366450;11657;704;13120;13480;3.86;0.24;371.11;22.21;1463;49;4611.00;360
11659;44;22366470;11659;700;13127;13480;3.96;0.24;371.11;22.20;1468;49;4612.00;353
11661;44;22366489;11661;705;13128;13480;3.99;0.24;371.16;22.20;1467;49;4613.00;352
11663;44;22366509;11663;701;13132;13480;4.03;0.25;371.12;22.19;1469;49;4614.00;348
11664;44;22366531;11664;705;13133;13480;4.06;0.25;371.14;22.19;1469;49;4615.00;347
11665;44;22366551;11665;709;13137;13481;4.08;0.25;371.15;22.24;1472;49;4616.00;344
11667;44;22366571;11667;709;13142;13482;4.06;0.25;371.14;22.24;1475;49;4617.00;340
11669;44;22366591;11669;711;13145;13482;4.06;0.25;371.19;22.23;1476;49;4618.00;337
11670;44;22366614;11670;717;13148;13483;4.03;0.25;371.16;22.23;1478;49;4619.00;335
11671;44;22366644;11671;708;13151;13483;4.03;0.25;371.17;22.23;1480;49;4620.00;332
11671;44;22366665;11671;701;13152;13483;4.02;0.25;371.17;22.23;1481;49;4621.00;331
11671;44;22366685;11671;696;13156;13483;4.08;0.25;371.17;22.23;1485;49;4622.00;327
11671;44;22366705;11671;696;13160;13487;4.14;0.25;371.17;22.22;1489;49;4623.00;327
11672;44;22366725;11672;686;13162;13487;4.17;0.26;371.14;22.22;1490;49;4624.00;325
11674;44;22366747;11674;688;13165;13487;4.20;0.26;371.14;22.22;1491;49;4625.00;322
11674;45;22366767;11674;678;13166;13490;4.26;0.26;371.14;22.22;1492;50;4626.00;324
11674;45;22366813;11674;688;13167;13490;4.25;0.26;371.14;22.22;1493;50;4627.00;323
11675;45;22366834;11675;673;13168;13490;4.31;0.26;371.19;22.22;1493;50;4628.00;322
11676;45;22366862;11676;678;13172;13494;4.36;0.27;371.17;22.21;1496;50;4629.00;322
11677;45;22366884;11677;673;13174;13495;4.40;0.27;371.21;22.21;1497;50;4630.00;321
11678;45;22366905;11678;677;13175;13495;4.45;0.27;371.23;22.21;1497;50;4631.00;320
11680;45;22366925;11680;675;13177;13499;4.47;0.27;371.17;22.20;1497;50;4632.00;322
11680;45;22366953;11680;664;13178;13499;4.51;0.28;371.17;22.20;1498;50;4633.00;321
11684;45;22366976;11684;659;13178;13499;4.49;0.27;371.17;22.20;1494;50;4634.00;321
11687;45;22366997;11687;659;13180;13501;4.55;0.28;371.13;22.20;1493;50;4635.00;321
11689;45;22367019;11689;658;13180;13501;4.54;0.28;371.09;22.20;1491;50;4636.00;321
11690;45;22367040;11690;642;13185;13507;4.56;0.28;371.08;22.19;1495;50;4637.00;322
11691;45;22367071;11691;655;13185;13507;4.56;0.28;371.10;22.19;1494;50;4638.00;322
11692;45;22367092;11692;654;13185;13508;4.56;0.28;371.09;22.19;1493;50;4639.00;323
11693;45;22367114;11693;648;13185;13508;4.56;0.28;371.08;22.19;1492;50;4640.00;323
11697;45;22367134;11697;649;13185;13508;4.51;0.27;371.23;22.19;1488;50;4641.00;323
11699;45;22367155;11699;639;13185;13508;4.45;0.27;371.25;22.19;1486;50;4642.00;323
11701;45;22367175;11701;635;13185;13508;4.38;0.27;371.26;22.19;1484;50;4643.00;323
11702;45;22367196;11702;637;13195;13520;4.37;0.27;371.27;22.17;1493;50;4644.00;325
11706;45;22367218;11706;618;13196;13520;4.39;0.27;371.28;22.17;1490;50;4645.00;324
11710;45;22367239;11710;612;13196;13520;4.41;0.27;371.31;22.17;1486;50;4646.00;324
11713;45;22367262;11713;607;13196;13520;4.45;0.27;371.33;22.17;1483;50;4647.00;324
11716;45;22367284;11716;600;13196;13520;4.53;0.28;371.31;22.17;1480;50;4648.00;324
11720;45;22367305;11720;600;13196;13520;4.57;0.28;371.32;22.17;1476;50;4649.00;324
11726;45;22367328;11726;592;13201;13526;4.56;0.28;371.39;22.16;1475;50;4650.00;325
11727;45;22367350;11727;589;13201;13526;4.59;0.28;371.38;22.16;1474;50;4651.00;325
11731;45;22367378;11731;587;13205;13530;4.62;0.28;371.33;22.16;1474;50;4652.00;325
11733;45;22367400;11733;593;13206;13531;4.61;0.28;371.33;22.15;1473;50;4653.00;325
11735;45;22367420;11735;583;13207;13531;4.60;0.28;371.36;22.23;1472;50;4654.00;324
11738;45;22367446;11738;574;13207;13531;4.62;0.28;371.37;22.23;1469;50;4655.00;324
11742;45;22367468;11742;570;13219;13544;4.62;0.28;371.38;22.29;1477;50;4656.00;325
11743;45;22367493;11743;560;13219;13544;4.69;0.29;371.39;22.29;1476;50;4657.00;325
11746;45;22367519;11746;559;13219;13544;4.70;0.29;371.36;22.29;1473;50;4658.00;325
11750;45;22367543;11750;564;13220;13545;4.72;0.29;371.47;22.29;1470;50;4659.00;325
11753;45;22367568;11753;562;13220;13546;4.73;0.29;371.49;22.29;1467;50;4660.00;326
11755;45;22367590;11755;563;13220;13546;4.71;0.29;371.47;22.29;1465;50;4661.00;326
11757;45;22367613;11757;554;13222;13549;4.71;0.29;371.49;22.28;1465;50;4662.00;327
11759;45;22367636;11759;563;13223;13549;4.73;0.29;371.53;22.28;1464;50;4663.00;326
11764;45;22367656;11764;553;13223;13549;4.72;0.29;371.65;22.28;1459;50;4664.00;326
11767;45;22367679;11767;553;13224;13549;4.69;0.29;371.63;22.36;1457;50;4665.00;325
11768;45;22367700;11768;562;13229;13555;4.69;0.29;371.64;22.35;1461;50;4666.00;326
11771;45;22367728;11771;572;13229;13555;4.63;0.28;371.76;22.35;1458;50;4667.00;326
11775;45;22367751;11775;566;13229;13555;4.54;0.28;371.78;22.35;1454;50;4668.00;326
11779;45;22367771;11779;579;13229;13555;4.48;0.27;371.76;22.35;1450;50;4669.00;326
11784;45;22367795;11784;585;13232;13559;4.42;0.27;371.69;22.35;1448;50;4670.00;327
11786;45;22367817;11786;586;13233;13560;4.39;0.27;371.76;22.34;1447;50;4671.00;327
11788;45;22367838;11788;596;13233;13560;4.38;0.27;371.87;22.34;1445;50;4672.00;327
11790;45;22367864;11790;595;13234;13561;4.41;0.27;371.95;22.34;1444;50;4673.00;327
11791;45;22367886;11791;595;13234;13561;4.44;0.27;372.01;22.34;1443;50;4674.00;327
11793;45;22367906;11793;605;13234;13561;4.42;0.27;372.08;22.34;1441;50;4675.00;327
11798;45;22367929;11798;610;13235;13561;4.40;0.27;372.32;22.42;1437;50;4676.00;326
11799;45;22367950;11799;615;13235;13561;4.40;0.27;372.33;22.42;1436;50;4677.00;326
11801;45;22367973;11801;613;13235;13561;4.39;0.27;372.36;22.42;1434;50;4678.00;326
11805;45;22367996;11805;611;13235;13561;4.38;0.27;372.44;22.42;1430;50;4679.00;326
11806;45;22368020;11806;631;13294;13686;4.64;0.29;372.50;22.40;1488;50;4680.00;392
11809;45;22368055;11809;636;13299;13687;4.63;0.29;372.60;22.39;1490;50;4681.00;388
11812;45;22368082;11812;628;13312;13687;4.67;0.29;372.65;22.60;1500;50;4682.00;375
11813;45;22368106;11813;629;13316;13687;4.70;0.29;372.64;22.60;1503;50;4683.00;371
11815;45;22368135;11815;624;13322;13687;4.71;0.29;372.78;22.67;1507;50;4684.00;365
11817;45;22368160;11817;626;13326;13687;4.68;0.29;372.76;22.74;1509;50;4685.00;361
11820;45;22368188;11820;626;13331;13687;4.67;0.29;372.83;22.73;1511;50;4686.00;356
11822;45;22368216;11822;626;13335;13687;4.68;0.29;372.92;22.73;1513;50;4687.00;352
11826;45;22368241;11826;635;13342;13688;4.65;0.29;372.91;22.87;1516;50;4688.00;346
11828;45;22368268;11828;638;13345;13689;4.63;0.28;372.90;22.87;1517;50;4689.00;344
11832;45;22368294;11832;634;13347;13689;4.58;0.28;372.99;22.87;1515;50;4690.00;342
11835;45;22368321;11835;633;13352;13693;4.50;0.28;373.06;22.86;1517;50;4691.00;341
11837;45;22368347;11837;636;13353;13693;4.46;0.27;373.03;22.86;1516;50;4692.00;340
11840;45;22368367;11840;636;13353;13693;4.40;0.27;373.22;22.86;1513;50;4693.00;340
11843;45;22368388;11843;637;13353;13693;4.35;0.27;373.34;22.86;1510;50;4694.00;340
11846;45;22368413;11846;641;13358;13699;4.31;0.26;373.48;22.85;1512;50;4695.00;341
11850;45;22368437;11850;649;13358;13699;4.21;0.26;373.46;22.85;1508;50;4696.00;341
11852;45;22368459;11852;648;13358;13699;4.16;0.25;373.60;22.85;1506;50;4697.00;341
11854;45;22368479;11854;655;13360;13702;4.13;0.25;373.78;22.85;1506;50;4698.00;342
11855;45;22368501;11855;658;13360;13702;4.11;0.25;373.75;22.85;1505;50;4699.00;342
11859;45;22368520;11859;650;13360;13702;4.08;0.25;373.84;22.85;1501;50;4700.00;342
11860;45;22368547;11860;653;13360;13703;4.10;0.25;373.88;22.85;1500;50;4701.00;343
11860;45;22368568;11860;644;13361;13704;4.12;0.25;373.88;22.84;1501;50;4702.00;343
11864;45;22368596;11864;643;13361;13704;4.11;0.25;373.96;22.84;1497;50;4703.00;343
11866;45;22368620;11866;637;13372;13717;4.19;0.26;374.00;22.83;1506;50;4704.00;345
11871;45;22368655;11871;640;13372;13717;4.22;0.26;373.94;22.83;1501;50;4705.00;345
11872;45;22368682;11872;637;13372;13717;4.26;0.26;373.98;22.83;1500;50;4706.00;345
11876;45;22368703;11876;635;13374;13718;4.26;0.26;374.01;22.82;1498;50;4707.00;344
11877;45;22368723;11877;633;13374;13718;4.28;0.26;374.09;22.82;1497;50;4708.00;344
11878;45;22368744;11878;634;13377;13722;4.32;0.26;374.09;22.82;1499;50;4709.00;345
11880;45;22368769;11880;634;13378;13722;4.33;0.26;374.15;22.82;1498;50;4710.00;344
11883;45;22368791;11883;636;13381;13726;4.32;0.26;374.18;22.81;1498;50;4711.00;345
11888;45;22368815;11888;633;13381;13726;4.29;0.26;374.29;22.81;1493;50;4712.00;345
11890;45;22368838;11890;629;13381;13726;4.27;0.26;374.34;22.81;1491;50;4713.00;345
11892;45;22368859;11892;641;13381;13726;4.27;0.26;374.39;22.81;1489;50;4714.00;345
11896;45;22368928;11896;648;13381;13726;4.20;0.26;374.53;22.81;1485;50;4715.00;345
11900;45;22368953;11900;651;13391;13738;4.18;0.26;374.60;22.80;1491;50;4716.00;347
11904;45;22368977;11904;659;13391;13738;4.12;0.25;374.63;22.80;1487;50;4717.00;347
11907;45;22368998;11907;667;13392;13738;4.08;0.25;374.71;22.79;1485;50;4718.00;346
11912;45;22369018;11912;669;13392;13738;4.05;0.25;374.89;22.79;1480;50;4719.00;346
11915;45;22369037;11915;675;13392;13738;4.01;0.25;374.91;22.79;1477;50;4720.00;346
11919;45;22369056;11919;675;13392;13738;3.97;0.24;375.03;22.79;1473;50;4721.00;346
11921;45;22369076;11921;670;13392;13739;3.96;0.24;375.00;22.79;1471;50;4722.00;347
11924;45;22369098;11924;674;13392;13739;3.91;0.24;375.07;22.79;1468;50;4723.00;347
11932;45;22369117;11932;672;13397;13745;3.88;0.24;375.11;22.79;1465;50;4724.00;348
11934;45;22369135;11934;670;13399;13747;3.88;0.24;375.09;22.78;1465;50;4725.00;348
11941;45;22369161;11941;659;13399;13747;3.82;0.23;375.13;22.78;1458;50;4726.00;348
11947;45;22369178;11947;653;13399;13747;3.77;0.23;375.18;22.78;1452;50;4727.00;348
11952;45;22369195;11952;639;13402;13751;3.77;0.23;375.37;22.78;1450;50;4728.00;349
11956;45;22369212;11956;634;13402;13751;3.72;0.23;375.45;22.78;1446;50;4729.00;349
11960;45;22369229;11960;632;13402;13751;3.68;0.23;375.50;22.78;1442;50;4730.00;349
11963;45;22369246;11963;632;13403;13752;3.69;0.22;375.56;22.78;1440;50;4731.00;349
11968;45;22369263;11968;624;13406;13756;3.64;0.22;375.70;22.77;1438;50;4732.00;350
11971;45;22369280;11971;627;13406;13756;3.62;0.22;375.68;22.77;1435;50;4733.00;350
11975;45;22369296;11975;629;13409;13759;3.57;0.22;375.78;22.77;1434;50;4734.00;350
11979;45;22369314;11979;618;13409;13759;3.54;0.22;375.90;22.77;1430;50;4735.00;350
11985;45;22369331;11985;623;13409;13759;3.48;0.21;375.93;22.77;1424;50;4736.00;350
11990;45;22369348;11990;616;13409;13759;3.42;0.21;375.91;22.77;1419;50;4737.00;350
11993;45;22369364;11993;624;13413;13763;3.42;0.21;375.95;22.76;1420;50;4738.00;350
11997;45;22369382;11997;623;13413;13763;3.36;0.20;375.91;22.76;1416;50;4739.00;350
11998;45;22369400;11998;631;13413;13763;3.31;0.20;375.89;22.76;1415;50;4740.00;350
11998;45;22369417;11998;632;13413;13763;3.30;0.20;375.89;22.76;1415;50;4741.00;350
11999;45;22369432;11999;638;13413;13764;3.27;0.20;375.92;22.76;1414;50;4742.00;351
12003;45;22369448;12003;644;13414;13765;3.20;0.19;375.96;22.76;1411;50;4743.00;351
12006;45;22369465;12006;650;13414;13765;3.16;0.19;375.89;22.76;1408;50;4744.00;351
12008;45;22369481;12008;649;13415;13766;3.14;0.19;375.91;22.76;1407;50;4745.00;351
12011;45;22369497;12011;645;13415;13766;3.14;0.19;375.93;22.76;1404;50;4746.00;351
12013;45;22369514;12013;644;13415;13766;3.14;0.19;375.97;22.76;1402;50;4747.00;351
12017;45;22369530;12017;649;13415;13766;3.11;0.19;375.99;22.76;1398;50;4748.00;351
12019;45;22369546;12019;652;13415;13766;3.10;0.19;375.99;22.76;1396;50;4749.00;351
12020;45;22369562;12020;657;13415;13766;3.10;0.19;375.99;22.76;1395;50;4750.00;351
12025;45;22369578;12025;653;13415;13766;3.09;0.19;376.01;22.76;1390;50;4751.00;351
12027;45;22369594;12027;672;13484;13893;3.42;0.21;376.00;22.64;1457;50;4752.00;409
12032;45;22369621;12032;660;13488;13894;3.40;0.21;375.95;22.69;1456;50;4753.00;406
12034;45;22369639;12034;650;13495;13894;3.49;0.22;375.93;22.68;1461;50;4754.00;399
12037;45;22369655;12037;655;13498;13894;3.52;0.22;375.93;22.68;1461;50;4755.00;396
12040;45;22369672;12040;653;13504;13894;3.51;0.22;375.96;22.67;1464;50;4756.00;390
12041;45;22369689;12041;653;13508;13894;3.54;0.22;375.97;22.66;1467;50;4757.00;386
12046;45;22369706;12046;651;13512;13894;3.54;0.22;376.03;22.66;1466;50;4758.00;382
12049;45;22369723;12049;645;13513;13894;3.52;0.22;376.02;22.66;1464;50;4759.00;381
12053;45;22369741;12053;656;13515;13895;3.49;0.22;376.06;22.65;1462;50;4760.00;380
12057;45;22369758;12057;651;13517;13896;3.47;0.22;375.99;22.65;1460;50;4761.00;379
12063;45;22369775;12063;657;13520;13896;3.41;0.21;375.93;22.65;1457;50;4762.00;376
12065;45;22369791;12065;664;13521;13897;3.41;0.21;375.93;22.65;1456;50;4763.00;376
12071;45;22369808;12071;667;13523;13897;3.36;0.21;375.96;22.65;1452;50;4764.00;374
12073;45;22369825;12073;668;13525;13897;3.37;0.21;375.94;22.65;1452;50;4765.00;372
12076;45;22369843;12076;676;13525;13897;3.37;0.21;375.91;22.65;1449;50;4766.00;372
12078;45;22369862;12078;676;13527;13901;3.36;0.21;375.88;22.64;1449;50;4767.00;374
12081;45;22369878;12081;679;13529;13901;3.33;0.21;375.88;22.70;1448;50;4768.00;372
12082;45;22369895;12082;684;13530;13901;3.32;0.21;375.86;22.70;1448;50;4769.00;371
12085;45;22369914;12085;687;13534;13907;3.32;0.21;375.86;22.69;1449;50;4770.00;373
12087;45;22369932;12087;692;13534;13907;3.33;0.21;375.90;22.69;1447;50;4771.00;373
12089;45;22369952;12089;681;13535;13907;3.34;0.21;375.89;22.69;1446;50;4772.00;372
12092;45;22369972;12092;677;13539;13911;3.34;0.21;376.02;22.69;1447;50;4773.00;372
12096;45;22369995;12096;680;13540;13912;3.35;0.21;375.99;22.68;1444;50;4774.00;372
12098;45;22370016;12098;681;13540;13912;3.35;0.21;375.98;22.68;1442;50;4775.00;372
12102;45;22370035;12102;679;13542;13916;3.36;0.21;375.95;22.68;1440;50;4776.00;374
12104;45;22370055;12104;670;13544;13916;3.37;0.21;375.91;22.74;1440;50;4777.00;372
12106;45;22370076;12106;663;13545;13916;3.34;0.21;375.94;22.74;1439;50;4778.00;371
12107;45;22370099;12107;664;13546;13917;3.36;0.21;375.91;22.74;1439;50;4779.00;371
12109;45;22370120;12109;664;13547;13917;3.37;0.21;375.85;22.74;1438;50;4780.00;370
12110;45;22370140;12110;655;13552;13923;3.43;0.21;375.82;22.73;1442;50;4781.00;371
12111;45;22370161;12111;629;13552;13923;3.51;0.22;375.80;22.73;1441;50;4782.00;371
12112;45;22370182;12112;617;13552;13924;3.59;0.22;375.79;22.73;1440;50;4783.00;372
12115;46;22370220;12115;609;13553;13924;3.67;0.22;375.79;22.73;1438;51;4784.00;371
12115;46;22370256;12115;601;13553;13924;3.74;0.23;375.79;22.73;1438;51;4785.00;371
12117;46;22370277;12117;603;13553;13924;3.82;0.23;375.83;22.73;1436;51;4786.00;371
12120;46;22370300;12120;584;13553;13924;3.89;0.24;375.91;22.73;1433;51;4787.00;371
12122;46;22370320;12122;596;13562;13936;3.96;0.24;375.91;22.72;1440;51;4788.00;374
12122;46;22370342;12122;593;13562;13936;4.01;0.24;375.91;22.72;1440;51;4789.00;374
12123;46;22370364;12123;596;13562;13936;4.05;0.25;375.89;22.72;1439;51;4790.00;374
12123;46;22370383;12123;591;13562;13936;4.09;0.25;375.89;22.72;1439;51;4791.00;374
12123;46;22370402;12123;579;13562;13936;4.13;0.25;375.89;22.72;1439;51;4792.00;374
12124;46;22370422;12124;574;13562;13936;4.15;0.25;375.91;22.72;1438;51;4793.00;374
12124;46;22370444;12124;565;13566;13940;4.22;0.26;375.91;22.72;1442;51;4794.00;374
12125;46;22370466;12125;551;13566;13940;4.26;0.26;375.93;22.72;1441;51;4795.00;374
12129;46;22370486;12129;541;13570;13944;4.28;0.26;375.92;22.77;1441;51;4796.00;374
12129;46;22370517;12129;547;13570;13945;4.29;0.26;375.92;22.77;1441;51;4797.00;375
12132;46;22370537;12132;547;13570;13945;4.28;0.26;375.97;22.77;1438;51;4798.00;375
12134;46;22370557;12134;541;13570;13945;4.33;0.26;375.98;22.77;1436;51;4799.00;375
12135;46;22370589;12135;553;13594;13986;4.42;0.27;376.02;22.73;1459;51;4800.00;392
12136;46;22370622;12136;553;13594;13986;4.45;0.27;376.01;22.73;1458;51;4801.00;392
12136;46;22370646;12136;542;13596;13986;4.54;0.28;376.01;22.73;1460;51;4802.00;390
12136;46;22370666;12136;542;13597;13987;4.61;0.28;376.01;22.73;1461;51;4803.00;390
12141;46;22370687;12141;551;13599;13988;4.60;0.28;376.14;22.79;1458;51;4804.00;389
12145;46;22370710;12145;556;13600;13988;4.58;0.28;376.22;22.79;1455;51;4805.00;388
12147;46;22370735;12147;551;13602;13991;4.59;0.28;376.23;22.79;1455;51;4806.00;389
12151;46;22370755;12151;542;13602;13991;4.61;0.28;376.30;22.79;1451;51;4807.00;389
12151;46;22370776;12151;545;13603;13991;4.65;0.28;376.30;22.79;1452;51;4808.00;388
12157;46;22370797;12157;543;13604;13991;4.63;0.28;376.44;22.85;1447;51;4809.00;387
12159;46;22370817;12159;542;13610;13997;4.67;0.28;376.49;22.84;1451;51;4810.00;387
12160;46;22370838;12160;543;13610;13997;4.69;0.28;376.48;22.84;1450;51;4811.00;387
12162;46;22370859;12162;543;13611;13997;4.70;0.29;376.56;22.84;1449;51;4812.00;386
12163;46;22370883;12163;547;13611;13997;4.74;0.29;376.54;22.84;1448;51;4813.00;386
12164;46;22370903;12164;553;13614;14001;4.78;0.29;376.63;22.84;1450;51;4814.00;387
12168;46;22370926;12168;550;13616;14003;4.76;0.29;376.65;22.84;1448;51;4815.00;387
12170;46;22370949;12170;537;13617;14003;4.79;0.29;376.68;22.90;1447;51;4816.00;386
12173;46;22370972;12173;536;13618;14004;4.84;0.29;376.68;22.90;1445;51;4817.00;386
12180;46;22370991;12180;533;13618;14004;4.82;0.29;376.81;22.90;1438;51;4818.00;386
12183;46;22371017;12183;532;13620;14004;4.84;0.29;376.89;22.90;1437;51;4819.00;384
12185;46;22371039;12185;530;13621;14004;4.86;0.29;376.92;22.90;1436;51;4820.00;383
12188;46;22371060;12188;522;13621;14004;4.84;0.29;377.00;22.90;1433;51;4821.00;383
12194;46;22371082;12194;516;13621;14004;4.77;0.29;377.15;22.90;1427;51;4822.00;383
12197;46;22371105;12197;508;13621;14004;4.78;0.29;377.24;22.90;1424;51;4823.00;383
12199;46;22371127;12199;519;13657;14074;4.77;0.29;377.22;22.84;1458;51;4824.00;417
12204;46;22371154;12204;503;13659;14075;4.75;0.29;377.42;22.83;1455;51;4825.00;416
12207;46;22371175;12207;507;13663;14075;4.79;0.29;377.46;22.83;1456;51;4826.00;412
12211;46;22371197;12211;504;13663;14075;4.81;0.29;377.46;22.83;1452;51;4827.00;412
12212;46;22371218;12212;509;13666;14077;4.85;0.29;377.52;22.82;1454;51;4828.00;411
12213;46;22371238;12213;507;13666;14077;4.86;0.30;377.52;22.82;1453;51;4829.00;411
12217;46;22371284;12217;507;13669;14077;4.91;0.30;377.58;22.82;1452;51;4830.00;408
12221;46;22371305;12221;509;13669;14077;4.89;0.30;377.62;22.82;1448;51;4831.00;408
12223;46;22371327;12223;511;13674;14078;4.87;0.30;377.62;22.82;1451;51;4832.00;404
12227;46;22371348;12227;512;13678;14079;4.88;0.30;377.63;22.82;1451;51;4833.00;401
12232;46;22371369;12232;518;13680;14079;4.88;0.30;377.66;22.81;1448;51;4834.00;399
12233;46;22371388;12233;523;13684;14083;4.85;0.30;377.67;22.81;1451;51;4835.00;399
12234;46;22371421;12234;527;13684;14083;4.83;0.29;377.65;22.81;1450;51;4836.00;399
12239;46;22371456;12239;519;13685;14083;4.80;0.29;377.82;22.81;1446;51;4837.00;398
12241;46;22371486;12241;525;13685;14083;4.75;0.29;377.81;22.81;1444;51;4838.00;398
12242;46;22371516;12242;527;13688;14089;4.81;0.29;377.79;22.80;1446;51;4839.00;401
12246;46;22371540;12246;525;13688;14089;4.78;0.29;377.80;22.80;1442;51;4840.00;401
12248;46;22371567;12248;535;13689;14089;4.77;0.29;377.84;22.80;1441;51;4841.00;400
12252;46;22371597;12252;530;13690;14092;4.78;0.29;377.87;22.80;1438;51;4842.00;402
12255;46;22371632;12255;540;13690;14092;4.76;0.29;377.89;22.80;1435;51;4843.00;402
12259;46;22371659;12259;543;13690;14092;4.76;0.29;377.92;22.80;1431;51;4844.00;402
12262;46;22371688;12262;542;13690;14093;4.72;0.29;377.95;22.80;1428;51;4845.00;403
12265;46;22371708;12265;542;13691;14094;4.74;0.29;378.06;22.80;1426;51;4846.00;403
12267;46;22371731;12267;544;13692;14094;4.73;0.29;378.09;22.80;1425;51;4847.00;402
12272;46;22371751;12272;546;13699;14107;4.72;0.29;378.18;22.79;1427;51;4848.00;408
12277;46;22371772;12277;543;13700;14107;4.74;0.29;378.38;22.79;1423;51;4849.00;407
12279;46;22371797;12279;547;13700;14107;4.75;0.29;378.32;22.79;1421;51;4850.00;407
12280;46;22371820;12280;550;13700;14108;4.79;0.29;378.32;22.79;1420;51;4851.00;408
12284;46;22371845;12284;547;13700;14108;4.80;0.29;378.52;22.79;1416;51;4852.00;408
12285;46;22371872;12285;544;13705;14112;4.81;0.29;378.51;22.78;1420;51;4853.00;407
12288;46;22371897;12288;533;13705;14112;4.81;0.29;378.62;22.78;1417;51;4854.00;407
12290;46;22371920;12290;534;13707;14116;4.82;0.29;378.68;22.78;1417;51;4855.00;409
12294;46;22371948;12294;539;13707;14116;4.84;0.29;378.76;22.78;1413;51;4856.00;409
12296;46;22371973;12296;536;13707;14116;4.88;0.30;378.94;22.78;1411;51;4857.00;409
12299;46;22372002;12299;535;13707;14116;4.90;0.30;379.12;22.78;1408;51;4858.00;409
12302;46;22372025;12302;537;13707;14116;4.93;0.30;379.15;22.78;1405;51;4859.00;409
12306;46;22372047;12306;541;13725;14150;5.00;0.31;379.33;22.75;1419;51;4860.00;425
12308;46;22372073;12308;543;13727;14150;5.00;0.30;379.40;22.75;1419;51;4861.00;423
12309;46;22372096;12309;549;13728;14150;4.96;0.30;379.40;22.74;1419;51;4862.00;422
12314;46;22372119;12314;554;13728;14150;4.89;0.30;379.50;22.74;1414;51;4863.00;422
12316;46;22372136;12316;558;13729;14150;4.88;0.30;379.54;22.74;1413;51;4864.00;421
12318;46;22372153;12318;564;13729;14150;4.86;0.30;379.68;22.74;1411;51;4865.00;421
12318;46;22372173;12318;564;13729;14151;4.84;0.30;379.68;22.74;1411;51;4866.00;422
12321;46;22372190;12321;564;13729;14151;4.85;0.30;379.82;22.74;1408;51;4867.00;422
12323;46;22372207;12323;562;13733;14157;4.86;0.30;379.87;22.74;1410;51;4868.00;424
12324;46;22372240;12324;563;13733;14158;4.89;0.30;379.86;22.74;1409;51;4869.00;425
12325;46;22372263;12325;558;13733;14158;4.89;0.30;379.93;22.74;1408;51;4870.00;425
12328;46;22372284;12328;564;13733;14158;4.86;0.30;379.98;22.74;1405;51;4871.00;425
12333;46;22372305;12333;566;13736;14162;4.85;0.30;380.00;22.73;1403;51;4872.00;426
12335;46;22372326;12335;563;13736;14162;4.81;0.29;380.05;22.73;1401;51;4873.00;426
12335;46;22372347;12335;570;13736;14162;4.79;0.29;380.05;22.73;1401;51;4874.00;426
12339;46;22372365;12339;573;13737;14163;4.72;0.29;380.06;22.73;1398;51;4875.00;426
12342;46;22372381;12342;561;13738;14167;4.68;0.29;380.07;22.73;1396;51;4876.00;429
12344;46;22372403;12344;556;13738;14167;4.60;0.28;380.22;22.73;1394;51;4877.00;429
12346;46;22372425;12346;552;13739;14170;4.58;0.28;380.19;22.73;1393;51;4878.00;431
12353;46;22372443;12353;554;13739;14170;4.52;0.27;380.33;22.73;1386;51;4879.00;431
12356;46;22372460;12356;560;13739;14170;4.52;0.27;380.31;22.73;1383;51;4880.00;431
12357;46;22372475;12357;559;13739;14170;4.51;0.27;380.33;22.73;1382;51;4881.00;431
12360;46;22372490;12360;558;13742;14174;4.52;0.27;380.42;22.72;1382;51;4882.00;432
12363;46;22372505;12363;558;13742;14174;4.49;0.27;380.54;22.72;1379;51;4883.00;432
12365;46;22372520;12365;561;13742;14174;4.47;0.27;380.56;22.72;1377;51;4884.00;432
12368;46;22372537;12368;560;13742;14174;4.46;0.27;380.66;22.72;1374;51;4885.00;432
12371;46;22372554;12371;560;13742;14175;4.43;0.27;380.63;22.72;1371;51;4886.00;433
12373;46;22372572;12373;564;13742;14176;4.42;0.27;380.64;22.72;1369;51;4887.00;434
12376;46;22372589;12376;574;13742;14176;4.42;0.27;380.68;22.72;1366;51;4888.00;434
12379;46;22372604;12379;570;13743;14177;4.40;0.27;380.72;22.72;1364;51;4889.00;434
12384;46;22372620;12384;574;13743;14177;4.33;0.26;380.79;22.72;1359;51;4890.00;434
12387;46;22372635;12387;575;13743;14177;4.25;0.26;380.84;22.72;1356;51;4891.00;434
12389;46;22372649;12389;583;13743;14177;4.19;0.25;380.81;22.72;1354;51;4892.00;434
12393;46;22372664;12393;592;13743;14177;4.08;0.25;380.85;22.72;1350;51;4893.00;434
12394;46;22372681;12394;594;13744;14177;4.03;0.25;380.86;22.72;1350;51;4894.00;433
12397;46;22372695;12397;586;13745;14177;3.94;0.24;380.88;22.72;1348;51;4895.00;432
12403;46;22372711;12403;604;13800;14304;4.14;0.26;380.95;22.63;1397;51;4896.00;504
12407;46;22372740;12407;603;13803;14305;4.04;0.25;380.93;22.63;1396;51;4897.00;502
12409;46;22372757;12409;604;13811;14305;4.03;0.25;380.95;22.62;1402;51;4898.00;494
12413;46;22372774;12413;611;13814;14305;3.90;0.24;380.98;22.61;1401;51;4899.00;491
12416;46;22372790;12416;601;13820;14305;3.87;0.24;381.01;22.60;1404;51;4900.00;485
12418;46;22372810;12418;596;13823;14305;3.80;0.24;380.98;22.60;1405;51;4901.00;482
12423;46;22372825;12423;599;13825;14305;3.76;0.23;381.05;22.60;1402;51;4902.00;480
12427;46;22372844;12427;602;13826;14305;3.76;0.23;381.03;22.60;1399;51;4903.00;479
12430;46;22372871;12430;612;13828;14306;3.75;0.23;381.10;22.59;1398;51;4904.00;478
12434;46;22372897;12434;615;13830;14308;3.80;0.24;381.13;22.59;1396;51;4905.00;478
12439;46;22372917;12439;613;13830;14308;3.78;0.23;381.23;22.59;1391;51;4906.00;478
12442;46;22372939;12442;616;13832;14309;3.78;0.23;381.25;22.59;1390;51;4907.00;477
12445;46;22372957;12445;618;13833;14309;3.79;0.24;381.32;22.59;1388;51;4908.00;476
12448;46;22372972;12448;614;13834;14309;3.78;0.24;381.35;22.59;1386;51;4909.00;475
12452;46;22372988;12452;610;13834;14309;3.71;0.23;381.37;22.59;1382;51;4910.00;475
12456;46;22373004;12456;610;13837;14313;3.67;0.23;381.31;22.59;1381;51;4911.00;476
12459;46;22373020;12459;613;13838;14313;3.62;0.23;381.26;22.58;1379;51;4912.00;475
12462;46;22373034;12462;613;13839;14313;3.55;0.22;381.26;22.58;1377;51;4913.00;474
12469;46;22373054;12469;609;13840;14316;3.53;0.22;381.18;22.58;1371;51;4914.00;476
12474;46;22373072;12474;609;13840;14316;3.55;0.22;381.13;22.58;1366;51;4915.00;476
12479;46;22373087;12479;612;13840;14316;3.56;0.22;381.07;22.58;1361;51;4916.00;476
12482;46;22373103;12482;610;13841;14320;3.61;0.22;381.07;22.58;1359;51;4917.00;479
12485;46;22373117;12485;605;13842;14321;3.63;0.22;381.06;22.58;1357;51;4918.00;479
12488;46;22373132;12488;602;13842;14321;3.62;0.22;381.03;22.58;1354;51;4919.00;479
12492;46;22373148;12492;601;13846;14326;3.61;0.22;381.09;22.57;1354;51;4920.00;480
12495;46;22373165;12495;606;13846;14326;3.62;0.22;381.12;22.57;1351;51;4921.00;480
12497;46;22373205;12497;607;13846;14326;3.61;0.22;381.15;22.57;1349;51;4922.00;480
12499;46;22373220;12499;608;13846;14327;3.64;0.22;381.13;22.57;1347;51;4923.00;481
12504;46;22373235;12504;610;13846;14327;3.58;0.22;381.15;22.57;1342;51;4924.00;481
12508;46;22373251;12508;606;13851;14333;3.59;0.22;381.24;22.57;1343;51;4925.00;482
12510;46;22373268;12510;604;13853;14333;3.58;0.22;381.21;22.58;1343;51;4926.00;480
12517;46;22373282;12517;604;13853;14334;3.52;0.21;381.14;22.58;1336;51;4927.00;481
12520;46;22373297;12520;598;13853;14334;3.51;0.21;381.11;22.58;1333;51;4928.00;481
12522;46;22373311;12522;611;13854;14334;3.50;0.21;381.11;22.58;1332;51;4929.00;480
12523;46;22373325;12523;611;13855;14334;3.50;0.21;381.11;22.59;1332;51;4930.00;479
12525;46;22373339;12525;619;13856;14334;3.44;0.21;381.08;22.60;1331;51;4931.00;478
12528;46;22373353;12528;624;13863;14346;3.45;0.21;381.13;22.59;1335;51;4932.00;483
12530;46;22373368;12530;620;13864;14346;3.46;0.21;381.17;22.59;1334;51;4933.00;482
12532;46;22373383;12532;607;13866;14346;3.48;0.21;381.25;22.60;1334;51;4934.00;480
12534;46;22373403;12534;604;13866;14346;3.51;0.21;381.31;22.60;1332;51;4935.00;480
12540;46;22373422;12540;609;13868;14346;3.49;0.21;381.29;22.61;1328;51;4936.00;478
12542;46;22373438;12542;607;13868;14346;3.53;0.21;381.34;22.61;1326;51;4937.00;478
12543;46;22373453;12543;601;13870;14350;3.60;0.22;381.34;22.61;1327;51;4938.00;480
12547;46;22373470;12547;600;13871;14350;3.62;0.22;381.36;22.62;1324;51;4939.00;479
12549;46;22373490;12549;595;13874;14354;3.65;0.22;381.39;22.61;1325;51;4940.00;480
12550;46;22373507;12550;592;13876;14355;3.68;0.22;381.38;22.62;1326;51;4941.00;479
12551;46;22373522;12551;593;13877;14355;3.70;0.22;381.35;22.63;1326;51;4942.00;478
12555;46;22373536;12555;596;13878;14355;3.67;0.22;381.34;22.63;1323;51;4943.00;477
12556;46;22373564;12556;596;13889;14368;3.77;0.23;381.34;22.62;1333;51;4944.00;479
12558;46;22373580;12558;599;13889;14368;3.77;0.23;381.33;22.62;1331;51;4945.00;479
12560;46;22373595;12560;587;13891;14368;3.77;0.23;381.36;22.64;1331;51;4946.00;477
12563;46;22373609;12563;576;13894;14369;3.81;0.23;381.39;22.71;1331;51;4947.00;475
12564;46;22373625;12564;564;13894;14370;3.85;0.23;381.37;22.71;1330;51;4948.00;476
12564;46;22373640;12564;558;13895;14370;3.88;0.23;381.37;22.71;1331;51;4949.00;475
12564;46;22373664;12564;562;13899;14379;3.94;0.24;381.37;22.70;1335;51;4950.00;480
12564;46;22373683;12564;560;13901;14379;3.95;0.24;381.37;22.71;1337;51;4951.00;478
12566;46;22373698;12566;553;13904;14379;3.98;0.24;381.34;22.72;1338;51;4952.00;475
12567;46;22373713;12567;550;13906;14379;3.99;0.24;381.35;22.73;1339;51;4953.00;473
12567;46;22373731;12567;548;13911;14385;4.02;0.24;381.35;22.73;1344;51;4954.00;474
12569;46;22373751;12569;545;13912;14385;4.02;0.24;381.40;22.73;1343;51;4955.00;473
12569;46;22373770;12569;530;13914;14385;4.11;0.25;381.40;22.74;1345;52;4956.00;471
12573;46;22373800;12573;518;13916;14385;4.18;0.25;381.47;22.74;1343;52;4957.00;469
12573;46;22373822;12573;506;13917;14389;4.26;0.26;381.47;22.74;1344;52;4958.00;472
12575;46;22373840;12575;497;13917;14390;4.35;0.26;381.44;22.74;1342;52;4959.00;473
12576;46;22373857;12576;489;13919;14390;4.46;0.27;381.49;22.75;1343;52;4960.00;471
12577;46;22373873;12577;486;13920;14391;4.52;0.27;381.55;22.75;1343;52;4961.00;471
12579;46;22373890;12579;488;13920;14391;4.55;0.28;381.66;22.75;1341;52;4962.00;471
12580;46;22373906;12580;494;13921;14391;4.59;0.28;381.63;22.76;1341;52;4963.00;470
12581;46;22373925;12581;491;13922;14391;4.59;0.28;381.70;22.83;1341;52;4964.00;469
12582;46;22373940;12582;492;13922;14391;4.57;0.28;381.72;22.83;1340;52;4965.00;469
12583;46;22373956;12583;496;13923;14391;4.58;0.28;381.80;22.84;1340;52;4966.00;468
12584;46;22373973;12584;496;13924;14391;4.60;0.28;381.87;22.84;1340;52;4967.00;467
12589;46;22373993;12589;518;13965;14461;4.61;0.28;381.91;22.96;1376;53;4968.00;496
12589;46;22374029;12589;492;13966;14462;4.68;0.29;381.91;22.97;1377;54;4969.00;496
12594;46;22374068;12594;493;13968;14462;4.75;0.29;382.03;22.97;1374;54;4970.00;494
12597;46;22374088;12597;479;13968;14462;4.81;0.29;382.09;22.97;1371;54;4971.00;494
12597;46;22374112;12597;472;13971;14462;4.90;0.30;382.09;23.05;1374;54;4972.00;491
12601;46;22374135;12601;470;13972;14462;4.94;0.30;382.16;23.05;1371;54;4973.00;490
12601;46;22374153;12601;474;13975;14462;5.01;0.31;382.16;23.05;1374;54;4974.00;487
12606;46;22374173;12606;473;13976;14462;5.00;0.31;382.24;23.05;1370;54;4975.00;486
12606;46;22374191;12606;483;13979;14463;5.08;0.31;382.24;23.06;1373;54;4976.00;484
12608;46;22374208;12608;484;13981;14464;5.15;0.31;382.31;23.06;1373;54;4977.00;483
12612;46;22374227;12612;496;13983;14464;5.17;0.31;382.39;23.05;1371;54;4978.00;481
12614;46;22374246;12614;505;13986;14468;5.19;0.32;382.44;23.05;1372;54;4979.00;482
12616;46;22374268;12616;506;13988;14468;5.25;0.32;382.51;23.06;1372;54;4980.00;480
12617;46;22374285;12617;509;13988;14468;5.27;0.32;382.52;23.06;1371;54;4981.00;480
12619;46;22374303;12619;511;13989;14468;5.29;0.32;382.53;23.07;1370;54;4982.00;479
12622;46;22374319;12622;515;13993;14474;5.30;0.32;382.56;23.06;1371;54;4983.00;481
12624;46;22374337;12624;511;13993;14474;5.32;0.32;382.57;23.06;1369;54;4984.00;481
12626;46;22374355;12626;520;13994;14474;5.34;0.32;382.58;23.07;1368;54;4985.00;480
12631;46;22374372;12631;524;13995;14477;5.34;0.32;382.65;23.07;1364;54;4986.00;482
12633;46;22374389;12633;523;13996;14477;5.34;0.32;382.68;23.07;1363;54;4987.00;481
12635;46;22374406;12635;527;13996;14477;5.33;0.32;382.65;23.07;1361;54;4988.00;481
12640;46;22374426;12640;523;13996;14478;5.34;0.32;382.74;23.07;1356;54;4989.00;482
12641;46;22374444;12641;519;13998;14479;5.39;0.33;382.71;23.08;1357;54;4990.00;481
12643;46;22374462;12643;508;13999;14479;5.42;0.33;382.70;23.09;1356;54;4991.00;480
12647;46;22374479;12647;508;14010;14492;5.43;0.33;382.75;23.08;1363;54;4992.00;482
12649;46;22374498;12649;499;14010;14492;5.43;0.33;382.81;23.08;1361;54;4993.00;482
12652;46;22374517;12652;495;14010;14492;5.42;0.33;382.88;23.08;1358;54;4994.00;482
12655;46;22374533;12655;494;14011;14494;5.42;0.33;382.91;23.09;1356;54;4995.00;483
12659;46;22374551;12659;488;14011;14494;5.42;0.33;382.86;23.09;1352;54;4996.00;483
12662;46;22374570;12662;476;14014;14498;5.46;0.33;382.85;23.08;1352;54;4997.00;484
12665;46;22374588;12665;478;14016;14498;5.47;0.33;382.87;23.09;1351;54;4998.00;482
12669;46;22374605;12669;470;14017;14502;5.47;0.33;383.00;23.09;1348;54;4999.00;485
12671;46;22374623;12671;465;14017;14502;5.42;0.33;383.09;23.09;1346;54;5000.00;485
12675;46;22374647;12675;460;14017;14502;5.38;0.33;383.12;23.09;1342;54;5001.00;485
12677;46;22374665;12677;458;14019;14502;5.38;0.33;383.13;23.11;1342;54;5002.00;483
12682;46;22374687;12682;455;14019;14502;5.39;0.33;383.35;23.11;1337;54;5003.00;483
12686;46;22374705;12686;450;14026;14514;5.39;0.33;383.40;23.09;1340;54;5004.00;488
12689;46;22374724;12689;445;14027;14514;5.34;0.33;383.54;23.17;1338;54;5005.00;487
12693;46;22374743;12693;445;14028;14514;5.32;0.32;383.68;23.17;1335;54;5006.00;486
12701;46;22374764;12701;437;14028;14514;5.29;0.32;383.81;23.17;1327;54;5007.00;486
12703;46;22374783;12703;430;14028;14514;5.27;0.32;383.79;23.17;1325;54;5008.00;486
12706;46;22374802;12706;431;14028;14514;5.26;0.32;383.76;23.17;1322;54;5009.00;486
12710;46;22374824;12710;428;14029;14515;5.25;0.32;383.83;23.17;1319;54;5010.00;486
12710;46;22374846;12710;426;14029;14515;5.27;0.32;383.83;23.17;1319;54;5011.00;486
12712;46;22374865;12712;435;14033;14521;5.26;0.32;383.86;23.17;1321;54;5012.00;488
12715;46;22374895;12715;430;14033;14522;5.25;0.32;383.95;23.17;1318;54;5013.00;489
12718;46;22374926;12718;430;14033;14522;5.26;0.32;384.04;23.17;1315;54;5014.00;489
12723;46;22374951;12723;429;14033;14522;5.28;0.32;384.10;23.17;1310;54;5015.00;489
12730;46;22374976;12730;423;14036;14526;5.28;0.32;384.10;23.16;1306;54;5016.00;490
12732;46;22375002;12732;427;14036;14526;5.33;0.32;384.09;23.16;1304;54;5017.00;490
12734;46;22375028;12734;428;14036;14526;5.32;0.32;384.09;23.16;1302;54;5018.00;490
12736;46;22375056;12736;426;14037;14527;5.31;0.32;384.07;23.16;1301;54;5019.00;490
12740;46;22375078;12740;431;14038;14531;5.30;0.32;384.05;23.16;1298;54;5020.00;493
12744;46;22375106;12744;438;14039;14531;5.33;0.32;384.07;23.25;1295;55;5021.00;492
12748;46;22375140;12748;434;14040;14534;5.32;0.32;384.04;23.25;1292;55;5022.00;494
12751;46;22375166;12751;442;14040;14534;5.31;0.32;384.04;23.25;1289;55;5023.00;494
12753;46;22375192;12753;440;14040;14534;5.33;0.32;384.08;23.25;1287;55;5024.00;494
12757;46;22375219;12757;439;14040;14534;5.31;0.32;384.21;23.25;1283;55;5025.00;494
12761;46;22375253;12761;448;14043;14538;5.32;0.32;384.21;23.25;1282;55;5026.00;495
12763;46;22375279;12763;447;14043;14538;5.35;0.32;384.28;23.25;1280;55;5027.00;495
12767;46;22375299;12767;453;14043;14538;5.32;0.32;384.37;23.25;1276;55;5028.00;495
12769;46;22375324;12769;455;14043;14538;5.26;0.32;384.44;23.25;1274;55;5029.00;495
12770;46;22375347;12770;455;14043;14539;5.22;0.32;384.45;23.25;1273;55;5030.00;496
12773;46;22375366;12773;458;14043;14540;5.15;0.31;384.46;23.25;1270;55;5031.00;497
12775;46;22375387;12775;460;14043;14540;5.10;0.31;384.54;23.25;1268;55;5032.00;497
12777;46;22375406;12777;461;14044;14541;5.09;0.31;384.62;23.24;1267;55;5033.00;497
12779;46;22375427;12779;459;14044;14541;5.05;0.31;384.73;23.24;1265;55;5034.00;497
12779;46;22375444;12779;461;14044;14541;5.02;0.31;384.73;23.24;1265;55;5035.00;497
12780;46;22375461;12780;470;14044;14541;5.04;0.31;384.76;23.24;1264;55;5036.00;497
12782;46;22375478;12782;477;14044;14541;5.05;0.31;384.83;23.24;1262;55;5037.00;497
12784;46;22375496;12784;484;14044;14541;5.05;0.31;384.85;23.24;1260;55;5038.00;497
12786;46;22375514;12786;489;14044;14541;5.06;0.31;384.90;23.24;1258;55;5039.00;497
12788;46;22375534;12788;502;14126;14771;5.43;0.34;384.91;23.11;1338;55;5040.00;645
12792;46;22375571;12792;499;14131;14772;5.40;0.34;385.07;23.10;1339;55;5041.00;641
12792;46;22375592;12792;499;14140;14772;5.48;0.34;385.07;23.09;1348;55;5042.00;632
12797;46;22375612;12797;496;14148;14772;5.50;0.35;385.11;23.08;1351;55;5043.00;624
12799;46;22375630;12799;492;14153;14772;5.49;0.34;385.13;23.07;1354;55;5044.00;619
12803;46;22375649;12803;498;14159;14772;5.48;0.34;385.22;23.06;1356;55;5045.00;613
12805;46;22375673;12805;498;14168;14772;5.50;0.34;385.24;23.15;1363;55;5046.00;604
12808;46;22375698;12808;496;14173;14772;5.53;0.34;385.30;23.14;1365;55;5047.00;599
12812;46;22375730;12812;503;14180;14773;5.53;0.34;385.42;23.13;1368;55;5048.00;593
12813;46;22375755;12813;503;14182;14774;5.55;0.35;385.49;23.13;1369;55;5049.00;592
12817;46;22375779;12817;499;14185;14774;5.55;0.34;385.49;23.13;1368;55;5050.00;589
12819;46;22375803;12819;497;14188;14775;5.52;0.34;385.49;23.13;1369;55;5051.00;587
12821;46;22375826;12821;495;14191;14775;5.47;0.34;385.52;23.13;1370;55;5052.00;584
12824;46;22375848;12824;495;14193;14775;5.39;0.33;385.46;23.12;1369;55;5053.00;582
12829;46;22375873;12829;499;14195;14775;5.28;0.33;385.57;23.12;1366;55;5054.00;580
12835;46;22375895;12835;501;14199;14779;5.18;0.32;385.63;23.12;1364;55;5055.00;580
12839;46;22375917;12839;508;14200;14779;5.14;0.32;385.65;23.12;1361;55;5056.00;579
12841;46;22375945;12841;506;14201;14779;5.07;0.31;385.71;23.12;1360;55;5057.00;578
12843;46;22375969;12843;510;14203;14782;5.07;0.31;385.83;23.11;1360;55;5058.00;579
12845;46;22375996;12845;521;14204;14782;5.04;0.31;385.89;23.11;1359;55;5059.00;578
12846;46;22376016;12846;523;14206;14782;5.07;0.31;385.91;23.11;1360;55;5060.00;576
12850;46;22376036;12850;536;14208;14786;5.07;0.31;385.91;23.11;1358;55;5061.00;578
12852;46;22376056;12852;535;14209;14787;5.04;0.31;385.96;23.11;1357;55;5062.00;578
12855;46;22376074;12855;545;14212;14787;5.04;0.31;385.99;23.11;1357;55;5063.00;575
12858;46;22376098;12858;552;14213;14791;5.05;0.31;386.01;23.11;1355;55;5064.00;578
12863;46;22376123;12863;557;14215;14791;5.01;0.31;385.97;23.11;1352;55;5065.00;576
12865;46;22376140;12865;553;14215;14791;4.99;0.31;385.94;23.11;1350;55;5066.00;576
12868;46;22376156;12868;560;14216;14792;4.90;0.30;385.89;23.11;1348;55;5067.00;576
12868;46;22376181;12868;565;14217;14792;4.82;0.30;385.89;23.11;1349;55;5068.00;575
12872;46;22376200;12872;569;14223;14798;4.80;0.29;385.86;23.11;1351;55;5069.00;575
12877;46;22376221;12877;574;14224;14798;4.70;0.29;385.89;23.11;1347;55;5070.00;574
12883;46;22376240;12883;580;14224;14799;4.57;0.28;385.80;23.11;1341;55;5071.00;575
12886;46;22376259;12886;588;14224;14799;4.49;0.28;385.74;23.11;1338;55;5072.00;575
12892;46;22376280;12892;591;14224;14799;4.32;0.26;385.75;23.11;1332;55;5073.00;575
12895;46;22376296;12895;593;14224;14799;4.21;0.26;385.72;23.11;1329;55;5074.00;575
12900;46;22376317;12900;583;14224;14799;4.08;0.25;385.72;23.11;1324;55;5075.00;575
12902;46;22376335;12902;583;14232;14811;4.06;0.25;385.70;23.10;1330;55;5076.00;579
12904;46;22376362;12904;581;14232;14811;4.01;0.25;385.67;23.10;1328;55;5077.00;579
12906;46;22376380;12906;572;14232;14811;4.02;0.25;385.69;23.10;1326;55;5078.00;579
12908;46;22376395;12908;572;14232;14811;4.04;0.25;385.70;23.10;1324;55;5079.00;579
12912;46;22376411;12912;565;14232;14811;4.04;0.25;385.65;23.10;1320;55;5080.00;579
12916;46;22376429;12916;559;14232;14811;4.04;0.25;385.61;23.10;1316;55;5081.00;579
12918;46;22376448;12918;547;14233;14815;4.09;0.25;385.64;23.10;1315;55;5082.00;582
12924;46;22376469;12924;543;14233;14815;4.05;0.25;385.66;23.10;1309;55;5083.00;582
12925;46;22376490;12925;544;14236;14819;4.10;0.25;385.64;23.09;1311;55;5084.00;583
12927;46;22376507;12927;539;14236;14821;4.09;0.25;385.65;23.09;1309;55;5085.00;585
12929;46;22376524;12929;543;14236;14821;4.06;0.25;385.67;23.09;1307;55;5086.00;585
12931;46;22376539;12931;538;14236;14821;4.07;0.25;385.64;23.09;1305;55;5087.00;585
12935;46;22376553;12935;539;14246;14834;4.06;0.25;385.62;23.08;1311;55;5088.00;588
12939;46;22376569;12939;541;14246;14834;4.03;0.25;385.55;23.08;1307;55;5089.00;588
12942;46;22376586;12942;545;14246;14834;4.03;0.25;385.51;23.08;1304;55;5090.00;588
12944;46;22376600;12944;529;14247;14835;4.04;0.25;385.52;23.08;1303;55;5091.00;588
12947;46;22376616;12947;519;14247;14836;4.05;0.25;385.47;23.08;1300;55;5092.00;589
12949;46;22376633;12949;513;14247;14836;4.14;0.25;385.45;23.08;1298;55;5093.00;589
12951;46;22376647;12951;496;14249;14839;4.23;0.26;385.43;23.15;1298;55;5094.00;590
12956;46;22376665;12956;497;14249;14839;4.28;0.26;385.46;23.15;1293;55;5095.00;590
12957;46;22376685;12957;491;14249;14839;4.33;0.26;385.47;23.15;1292;55;5096.00;590
12959;46;22376702;12959;481;14250;14839;4.35;0.26;385.44;23.16;1291;55;5097.00;589
12961;46;22376733;12961;479;14254;14845;4.36;0.27;385.42;23.16;1293;55;5098.00;591
12964;46;22376754;12964;462;14254;14845;4.35;0.27;385.41;23.16;1290;55;5099.00;591
12966;46;22376781;12966;477;14259;14864;4.36;0.27;385.41;23.16;1293;55;5100.00;605
12967;46;22376805;12967;470;14259;14864;4.42;0.27;385.39;23.16;1292;55;5101.00;605
12973;46;22376820;12973;478;14260;14868;4.39;0.27;385.43;23.16;1287;55;5102.00;608
12976;46;22376837;12976;481;14261;14869;4.44;0.27;385.47;23.17;1285;55;5103.00;608
12976;46;22376855;12976;476;14262;14869;4.46;0.27;385.47;23.18;1286;55;5104.00;607
12979;46;22376871;12979;477;14267;14870;4.48;0.27;385.43;23.21;1288;55;5105.00;603
12983;46;22376889;12983;480;14270;14870;4.48;0.27;385.41;23.21;1287;55;5106.00;600
12985;46;22376905;12985;478;14273;14870;4.47;0.27;385.45;23.25;1288;55;5107.00;597
12987;46;22376923;12987;475;14273;14870;4.47;0.27;385.42;23.25;1286;55;5108.00;597
12988;46;22376940;12988;480;14276;14870;4.51;0.28;385.42;23.28;1288;55;5109.00;594
12990;46;22376957;12990;477;14276;14870;4.48;0.28;385.45;23.28;1286;55;5110.00;594
12996;46;22376972;12996;484;14279;14870;4.43;0.27;385.42;23.29;1283;55;5111.00;591
12999;46;22376988;12999;483;14314;14940;4.59;0.28;385.43;23.27;1315;55;5112.00;626
13002;46;22377009;13002;477;14316;14941;4.63;0.28;385.42;23.27;1314;55;5113.00;625
13005;46;22377024;13005;471;14323;14941;4.70;0.29;385.43;23.28;1318;55;5114.00;618
13009;46;22377041;13009;473;14328;14941;4.69;0.29;385.50;23.31;1319;55;5115.00;613
13012;46;22377057;13012;472;14332;14941;4.74;0.29;385.50;23.34;1320;55;5116.00;609
13016;46;22377073;13016;487;14336;14941;4.73;0.29;385.59;23.34;1320;55;5117.00;605
13021;46;22377092;13021;473;14343;14941;4.67;0.29;385.63;23.38;1322;55;5118.00;598
13021;46;22377112;13021;479;14345;14941;4.66;0.29;385.63;23.40;1324;55;5119.00;596
13027;46;22377131;13027;490;14350;14942;4.60;0.28;385.70;23.41;1323;55;5120.00;592
13027;46;22377149;13027;501;14354;14943;4.56;0.28;385.70;23.44;1327;55;5121.00;589
13032;46;22377167;13032;499;14358;14943;4.49;0.27;385.86;23.46;1326;55;5122.00;585
13033;46;22377190;13033;508;14361;14947;4.44;0.27;385.88;23.45;1328;55;5123.00;586
13035;46;22377208;13035;516;14364;14947;4.41;0.27;385.95;23.56;1329;55;5124.00;583
13039;46;22377229;13039;513;14367;14947;4.38;0.27;386.09;23.57;1328;55;5125.00;580
13043;46;22377250;13043;511;14367;14947;4.31;0.26;386.13;23.57;1324;55;5126.00;580
13043;46;22377283;13043;508;14373;14953;4.33;0.26;386.13;23.60;1330;55;5127.00;580
13047;46;22377303;13047;507;14377;14953;4.27;0.26;386.23;23.63;1330;55;5128.00;576
13047;46;22377323;13047;510;14380;14953;4.27;0.26;386.23;23.64;1333;55;5129.00;573
13049;46;22377353;13049;510;14382;14959;4.25;0.26;386.20;23.65;1333;55;5130.00;577
13051;46;22377372;13051;496;14385;14959;4.29;0.26;386.25;23.66;1334;55;5131.00;574
13052;46;22377389;13052;486;14388;14959;4.36;0.26;386.29;23.68;1336;55;5132.00;571
13056;46;22377407;13056;472;14392;14960;4.37;0.27;386.33;23.69;1336;55;5133.00;568
13057;46;22377426;13057;468;14394;14961;4.42;0.27;386.36;23.70;1337;55;5134.00;567
13059;46;22377445;13059;463;14397;14961;4.46;0.27;386.36;23.72;1338;55;5135.00;564
13060;46;22377462;13060;461;14410;14974;4.55;0.28;386.39;23.73;1350;55;5136.00;564
13062;46;22377481;13062;457;14411;14974;4.58;0.28;386.48;23.74;1349;55;5137.00;563
13065;46;22377498;13065;457;14414;14974;4.61;0.28;386.46;23.75;1349;55;5138.00;560
13069;46;22377515;13069;460;14415;14975;4.62;0.28;386.56;23.75;1346;55;5139.00;560
13071;46;22377532;13071;460;14418;14975;4.63;0.28;386.58;23.84;1347;55;5140.00;557
13073;46;22377548;13073;478;14425;14979;4.60;0.28;386.61;23.86;1352;55;5141.00;554
13077;46;22377565;13077;468;14429;14979;4.55;0.28;386.62;23.86;1352;55;5142.00;550
13079;46;22377582;13079;477;14432;14983;4.55;0.28;386.64;23.88;1353;55;5143.00;551
13081;46;22377599;13081;483;14435;14983;4.53;0.28;386.63;23.88;1354;55;5144.00;548
13083;46;22377615;13083;484;14436;14983;4.51;0.27;386.71;23.89;1353;55;5145.00;547
13088;46;22377632;13088;494;14438;14983;4.53;0.28;386.79;23.90;1350;55;5146.00;545
13092;46;22377650;13092;503;14440;14983;4.52;0.27;386.90;23.91;1348;55;5147.00;543
13097;46;22377669;13097;507;14448;14995;4.57;0.28;386.90;23.90;1351;55;5148.00;547
13099;46;22377693;13099;512;14449;14995;4.63;0.28;386.89;23.91;1350;55;5149.00;546
13102;46;22377711;13102;516;14451;14995;4.71;0.29;386.98;23.92;1349;55;5150.00;544
13103;46;22377732;13103;519;14454;14995;4.83;0.29;386.97;23.94;1351;55;5151.00;541
13108;46;22377750;13108;522;14454;14995;4.88;0.30;386.97;23.94;1346;55;5152.00;541
13110;46;22377769;13110;518;14455;14995;4.94;0.30;387.01;23.95;1345;55;5153.00;540
13110;46;22377788;13110;514;14455;14996;5.03;0.31;387.01;23.95;1345;55;5154.00;541
13112;46;22377807;13112;518;14458;14998;5.02;0.31;387.01;23.95;1346;55;5155.00;540
13112;46;22377828;13112;517;14463;15004;5.03;0.31;387.01;23.95;1351;55;5156.00;541
13115;46;22377858;13115;527;14463;15005;4.99;0.30;387.05;23.95;1348;55;5157.00;542
13118;46;22377876;13118;533;14463;15005;4.97;0.30;386.99;23.95;1345;55;5158.00;542
13120;46;22377897;13120;536;14463;15005;4.94;0.30;386.99;23.95;1343;55;5159.00;542
13120;46;22377919;13120;534;14468;15010;4.95;0.30;386.99;23.96;1348;55;5160.00;542
13121;46;22377941;13121;535;14469;15010;4.94;0.30;387.01;24.03;1348;55;5161.00;541
13123;46;22377960;13123;536;14469;15010;4.92;0.30;387.03;24.03;1346;55;5162.00;541
13126;46;22377976;13126;546;14471;15011;4.95;0.30;387.07;24.04;1345;55;5163.00;540
13129;46;22377994;13129;546;14474;15015;4.97;0.30;387.20;24.04;1345;55;5164.00;541
13132;46;22378011;13132;531;14475;15015;4.96;0.30;387.20;24.05;1343;55;5165.00;540
13133;46;22378028;13133;524;14476;15018;4.98;0.30;387.23;24.04;1343;55;5166.00;542
13133;46;22378046;13133;512;14477;15018;4.98;0.30;387.23;24.05;1344;55;5167.00;541
13136;46;22378062;13136;508;14477;15018;4.97;0.30;387.29;24.05;1341;55;5168.00;541
13138;46;22378079;13138;499;14478;15018;4.96;0.30;387.30;24.06;1340;55;5169.00;540
13141;46;22378096;13141;492;14481;15022;5.00;0.30;387.44;24.06;1340;55;5170.00;541
13142;46;22378112;13142;484;14481;15022;5.08;0.31;387.43;24.06;1339;55;5171.00;541
13143;46;22378129;13143;485;14483;15022;5.11;0.31;387.41;24.07;1340;55;5172.00;539
13144;46;22378145;13144;479;14483;15022;5.17;0.31;387.43;24.07;1339;55;5173.00;539
13147;46;22378164;13147;475;14483;15023;5.21;0.32;387.41;24.07;1336;55;5174.00;540
13150;46;22378185;13150;472;14485;15025;5.24;0.32;387.53;24.08;1335;55;5175.00;540
13152;46;22378209;13152;468;14487;15025;5.21;0.32;387.60;24.16;1335;55;5176.00;538
13152;46;22378228;13152;474;14488;15026;5.23;0.32;387.60;24.16;1336;55;5177.00;538
13156;46;22378247;13156;466;14488;15026;5.18;0.32;387.65;24.16;1332;55;5178.00;538
13162;46;22378266;13162;467;14488;15026;5.11;0.31;387.62;24.16;1326;55;5179.00;538
13165;46;22378286;13165;478;14488;15026;5.06;0.31;387.65;24.16;1323;55;5180.00;538
13170;46;22378304;13170;472;14489;15026;5.01;0.31;387.62;24.23;1319;55;5181.00;537
13174;46;22378322;13174;462;14489;15026;5.00;0.30;387.71;24.23;1315;55;5182.00;537
13177;46;22378339;13177;456;14489;15026;4.99;0.30;387.70;24.23;1312;55;5183.00;537
13181;46;22378355;13181;476;14551;15153;5.07;0.31;387.86;24.13;1370;55;5184.00;602
13183;46;22378380;13183;459;14552;15154;5.08;0.31;387.94;24.13;1369;55;5185.00;602
13185;46;22378397;13185;453;14556;15154;5.12;0.32;387.99;24.12;1371;55;5186.00;598
13190;46;22378414;13190;452;14556;15154;5.09;0.32;388.03;24.12;1366;55;5187.00;598
13192;46;22378436;13192;448;14560;15154;5.14;0.32;388.08;24.12;1368;55;5188.00;594
13195;46;22378453;13195;444;14560;15154;5.17;0.32;388.08;24.12;1365;55;5189.00;594
13197;46;22378471;13197;437;14563;15154;5.22;0.32;388.10;24.11;1366;55;5190.00;591
13202;46;22378487;13202;441;14565;15154;5.26;0.32;388.15;24.11;1363;55;5191.00;589
13204;46;22378502;13204;437;14567;15155;5.37;0.33;388.25;24.11;1363;55;5192.00;588
13206;46;22378519;13206;446;14570;15156;5.45;0.34;388.23;24.11;1364;55;5193.00;586
13208;46;22378535;13208;444;14575;15156;5.56;0.34;388.21;24.11;1367;55;5194.00;581
13211;46;22378551;13211;446;14578;15157;5.61;0.35;388.32;24.11;1367;55;5195.00;579
13215;46;22378567;13215;457;14580;15157;5.61;0.34;388.32;24.11;1365;55;5196.00;577
13219;46;22378584;13219;463;14581;15157;5.58;0.34;388.34;24.11;1362;55;5197.00;576
13223;46;22378600;13223;467;14582;15157;5.52;0.34;388.36;24.21;1359;55;5198.00;575
13227;46;22378622;13227;476;14586;15161;5.43;0.33;388.36;24.20;1359;55;5199.00;575
13229;46;22378643;13229;484;14586;15161;5.35;0.33;388.38;24.20;1357;55;5200.00;575
13232;46;22378664;13232;495;14587;15161;5.24;0.32;388.37;24.21;1355;55;5201.00;574
13235;46;22378683;13235;503;14588;15164;5.17;0.32;388.42;24.21;1353;55;5202.00;576
13238;46;22378700;13238;513;14588;15164;5.05;0.31;388.41;24.21;1350;55;5203.00;576
13241;46;22378717;13241;522;14588;15164;4.99;0.31;388.43;24.21;1347;55;5204.00;576
13243;46;22378732;13243;530;14589;15168;4.93;0.30;388.45;24.21;1346;55;5205.00;579
13246;46;22378749;13246;538;14590;15169;4.84;0.30;388.45;24.21;1344;55;5206.00;579
13249;46;22378765;13249;549;14590;15169;4.78;0.29;388.48;24.21;1341;55;5207.00;579
13250;46;22378781;13250;553;14593;15173;4.83;0.30;388.48;24.20;1343;55;5208.00;580
13252;46;22378796;13252;561;14593;15173;4.80;0.29;388.53;24.20;1341;55;5209.00;580
13254;46;22378811;13254;567;14593;15173;4.78;0.29;388.52;24.20;1339;55;5210.00;580
13256;46;22378827;13256;568;14593;15174;4.78;0.29;388.53;24.20;1337;55;5211.00;581
13258;46;22378843;13258;569;14593;15174;4.73;0.29;388.55;24.20;1335;55;5212.00;581
13259;46;22378858;13259;577;14597;15180;4.80;0.29;388.56;24.20;1338;55;5213.00;583
13264;46;22378874;13264;581;14597;15180;4.79;0.29;388.58;24.20;1333;55;5214.00;583
13266;46;22378890;13266;579;14597;15180;4.78;0.29;388.63;24.20;1331;55;5215.00;583
13267;46;22378907;13267;582;14597;15181;4.79;0.29;388.70;24.20;1330;55;5216.00;584
13268;46;22378931;13268;578;14597;15181;4.77;0.29;388.73;24.20;1329;55;5217.00;584
13272;46;22378947;13272;583;14597;15181;4.72;0.29;388.82;24.20;1325;55;5218.00;584
13274;46;22378962;13274;582;14597;15181;4.70;0.29;388.82;24.20;1323;55;5219.00;584
13277;46;22378979;13277;594;14618;15217;4.77;0.29;388.88;24.16;1341;55;5220.00;599
13278;46;22378997;13278;595;14618;15217;4.69;0.29;388.86;24.16;1340;55;5221.00;599
13279;46;22379011;13279;605;14619;15217;4.62;0.28;388.83;24.16;1340;55;5222.00;598
13282;46;22379026;13282;601;14619;15217;4.52;0.28;388.85;24.16;1337;55;5223.00;598
13283;46;22379041;13283;604;14619;15217;4.45;0.27;388.83;24.16;1336;55;5224.00;598
13285;46;22379056;13285;602;14619;15217;4.42;0.27;388.84;24.16;1334;55;5225.00;598
13289;46;22379077;13289;605;14620;15221;4.35;0.27;388.82;24.16;1331;55;5226.00;601
13291;46;22379092;13291;600;14620;15221;4.34;0.27;388.84;24.16;1329;55;5227.00;601
13293;46;22379106;13293;596;14622;15225;4.32;0.27;388.91;24.15;1329;55;5228.00;603
13294;46;22379120;13294;595;14622;15226;4.32;0.27;388.89;24.15;1328;55;5229.00;604
13299;46;22379136;13299;595;14622;15226;4.29;0.26;388.85;24.15;1323;55;5230.00;604
13301;46;22379154;13301;596;14622;15226;4.26;0.26;388.81;24.15;1321;55;5231.00;604
13306;46;22379167;13306;591;14632;15239;4.24;0.26;388.70;24.14;1326;55;5232.00;607
13306;46;22379186;13306;595;14632;15239;4.27;0.26;388.70;24.14;1326;55;5233.00;607
13310;46;22379200;13310;587;14632;15239;4.25;0.26;388.63;24.14;1322;55;5234.00;607
13311;46;22379215;13311;589;14633;15240;4.26;0.26;388.60;24.14;1322;55;5235.00;607
13312;46;22379228;13312;596;14633;15241;4.26;0.26;388.59;24.14;1321;55;5236.00;608
13315;46;22379243;13315;594;14633;15241;4.24;0.26;388.58;24.14;1318;55;5237.00;608
13319;46;22379265;13319;600;14634;15244;4.22;0.26;388.53;24.14;1315;55;5238.00;610
13324;46;22379281;13324;606;14635;15244;4.13;0.25;388.47;24.13;1311;55;5239.00;609
13327;46;22379300;13327;601;14635;15244;4.07;0.25;388.51;24.13;1308;55;5240.00;609
13329;46;22379314;13329;609;14635;15244;3.99;0.24;388.54;24.13;1306;55;5241.00;609
13332;46;22379327;13332;615;14638;15250;3.93;0.24;388.50;24.13;1306;55;5242.00;612
13334;46;22379340;13334;622;14638;15250;3.86;0.24;388.48;24.13;1304;55;5243.00;612
13336;46;22379353;13336;629;14638;15250;3.81;0.23;388.52;24.13;1302;55;5244.00;612
13339;46;22379367;13339;635;14640;15250;3.72;0.23;388.49;24.14;1301;55;5245.00;610
13340;46;22379381;13340;639;14641;15254;3.61;0.22;388.50;24.13;1301;55;5246.00;613
13341;46;22379394;13341;641;14641;15255;3.52;0.22;388.48;24.13;1300;55;5247.00;614
13345;46;22379406;13345;632;14641;15255;3.41;0.21;388.51;24.13;1296;55;5248.00;614
13348;46;22379418;13348;628;14642;15256;3.32;0.20;388.51;24.13;1294;55;5249.00;614
13350;46;22379436;13350;607;14642;15256;3.32;0.20;388.52;24.13;1292;55;5250.00;614
13353;46;22379450;13353;599;14642;15256;3.31;0.20;388.51;24.13;1289;55;5251.00;614
13356;46;22379463;13356;596;14642;15256;3.33;0.20;388.47;24.13;1286;55;5252.00;614
13358;46;22379476;13358;584;14642;15256;3.40;0.21;388.45;24.13;1284;55;5253.00;614
13359;46;22379489;13359;579;14642;15256;3.43;0.21;388.44;24.13;1283;55;5254.00;614
13364;46;22379514;13364;569;14642;15256;3.46;0.21;388.55;24.13;1278;55;5255.00;614
13366;46;22379528;13366;571;14670;15326;3.72;0.23;388.52;24.09;1304;55;5256.00;656
13370;46;22379546;13370;563;14673;15327;3.79;0.23;388.55;24.08;1303;55;5257.00;654
13374;46;22379560;13374;548;14677;15327;3.88;0.24;388.60;24.08;1303;55;5258.00;650
13377;46;22379574;13377;544;14682;15327;3.96;0.24;388.59;24.07;1305;55;5259.00;645
13378;46;22379588;13378;532;14684;15327;4.08;0.25;388.62;24.07;1306;55;5260.00;643
13380;47;22379602;13380;520;14686;15327;4.16;0.25;388.63;24.06;1306;56;5261.00;641
13384;47;22379623;13384;508;14687;15327;4.17;0.25;388.72;24.06;1303;56;5262.00;640
13384;47;22379638;13384;507;14689;15327;4.25;0.26;388.72;24.06;1305;56;5263.00;638
13385;47;22379651;13385;501;14690;15328;4.29;0.26;388.73;24.06;1305;56;5264.00;638
13388;47;22379666;13388;500;14691;15330;4.33;0.26;388.70;24.06;1303;56;5265.00;639
13390;47;22379683;13390;504;14693;15330;4.39;0.27;388.68;24.06;1303;56;5266.00;637
13394;47;22379699;13394;500;14697;15334;4.43;0.27;388.63;24.05;1303;56;5267.00;637
13397;47;22379723;13397;504;14697;15334;4.51;0.27;388.65;24.05;1300;56;5268.00;637
13400;47;22379740;13400;507;14698;15334;4.54;0.28;388.72;24.07;1298;56;5269.00;636
13405;47;22379756;13405;500;14698;15334;4.55;0.28;388.83;24.07;1293;56;5270.00;636
13409;47;22379770;13409;502;14702;15340;4.54;0.28;388.88;24.08;1293;56;5271.00;638
13412;47;22379787;13412;507;14702;15340;4.53;0.28;388.89;24.08;1290;56;5272.00;638
13418;47;22379802;13418;505;14703;15340;4.53;0.27;388.78;24.09;1285;56;5273.00;637
13423;47;22379818;13423;497;14704;15343;4.56;0.28;388.77;24.09;1281;57;5274.00;639
13429;47;22379839;13429;488;14706;15343;4.56;0.28;388.87;24.12;1277;57;5275.00;637
13430;47;22379856;13430;489;14706;15343;4.59;0.28;388.90;24.12;1276;57;5276.00;637
13433;47;22379871;13433;486;14706;15344;4.61;0.28;388.90;24.12;1273;57;5277.00;638
13436;47;22379888;13436;475;14708;15345;4.65;0.28;389.00;24.13;1272;57;5278.00;637
13436;47;22379903;13436;476;14710;15345;4.69;0.28;389.00;24.15;1274;57;5279.00;635
13440;47;22379922;13440;485;14731;15371;4.74;0.29;389.01;24.13;1291;57;5280.00;640
13443;47;22379945;13443;480;14733;15371;4.75;0.29;389.09;24.16;1290;57;5281.00;638
13445;47;22379963;13445;480;14736;15371;4.79;0.29;389.09;24.17;1291;57;5282.00;635
13449;47;22379987;13449;476;14739;15372;4.78;0.29;389.23;24.21;1290;57;5283.00;633
13452;47;22380012;13452;479;14740;15372;4.79;0.29;389.30;24.21;1288;57;5284.00;632
13456;47;22380031;13456;471;14743;15376;4.79;0.29;389.30;24.21;1287;57;5285.00;633
13460;47;22380050;13460;467;14745;15376;4.83;0.29;389.33;24.22;1285;57;5286.00;631
13462;47;22380071;13462;465;14749;15379;4.83;0.29;389.39;24.25;1287;57;5287.00;630
13465;47;22380089;13465;465;14749;15380;4.82;0.29;389.50;24.25;1284;57;5288.00;631
13468;47;22380106;13468;462;14752;15380;4.84;0.29;389.48;24.29;1284;57;5289.00;628
13472;47;22380125;13472;455;14752;15380;4.83;0.29;389.56;24.29;1280;57;5290.00;628
13478;47;22380141;13478;459;14753;15380;4.80;0.29;389.63;24.29;1275;57;5291.00;627
13482;47;22380157;13482;467;14764;15392;4.77;0.29;389.70;24.31;1282;57;5292.00;628
13484;47;22380175;13484;465;14767;15392;4.80;0.29;389.73;24.31;1283;57;5293.00;625
13486;47;22380193;13486;466;14768;15392;4.84;0.30;389.70;24.33;1282;57;5294.00;624
13491;47;22380209;13491;478;14769;15392;4.81;0.29;389.67;24.33;1278;57;5295.00;623
13494;47;22380227;13494;477;14771;15392;4.82;0.29;389.72;24.35;1277;57;5296.00;621
13495;47;22380247;13495;470;14773;15392;4.84;0.30;389.75;24.35;1278;57;5297.00;619
13498;47;22380265;13498;469;14777;15393;4.87;0.30;389.92;24.38;1279;57;5298.00;616
13503;47;22380283;13503;462;14777;15393;4.86;0.30;390.12;24.38;1274;57;5299.00;616
13505;47;22380302;13505;472;14783;15399;4.84;0.29;390.13;24.40;1278;57;5300.00;616
13507;47;22380323;13507;479;14787;15400;4.82;0.29;390.28;24.51;1280;57;5301.00;613
13510;47;22380341;13510;476;14789;15400;4.81;0.29;390.40;24.51;1279;57;5302.00;611
13511;47;22380356;13511;477;14789;15400;4.83;0.29;390.48;24.51;1278;57;5303.00;611
13512;47;22380372;13512;488;14792;15404;4.87;0.30;390.50;24.50;1280;57;5304.00;612
13516;47;22380393;13516;495;14797;15404;4.93;0.30;390.47;24.54;1281;57;5305.00;607
13521;47;22380408;13521;483;14798;15404;4.96;0.30;390.55;24.56;1277;57;5306.00;606
13522;47;22380424;13522;480;14801;15405;5.03;0.31;390.63;24.57;1279;57;5307.00;604
13524;47;22380445;13524;475;14805;15409;5.03;0.31;390.82;24.58;1281;57;5308.00;604
13526;47;22380462;13526;467;14807;15409;5.09;0.31;390.83;24.60;1281;57;5309.00;602
13528;47;22380480;13528;465;14810;15415;5.12;0.31;390.92;24.60;1282;57;5310.00;605
13530;47;22380498;13530;470;14814;15415;5.11;0.31;390.94;24.63;1284;57;5311.00;601
13533;47;22380515;13533;479;14814;15415;5.08;0.31;390.98;24.63;1281;57;5312.00;601
13534;47;22380532;13534;476;14814;15415;5.06;0.31;391.01;24.63;1280;57;5313.00;601
13535;47;22380548;13535;488;14819;15419;5.00;0.31;391.09;24.65;1284;57;5314.00;600
13537;47;22380565;13537;490;14819;15419;5.01;0.31;391.12;24.65;1282;57;5315.00;600
13540;47;22380586;13540;505;14820;15419;4.96;0.30;391.25;24.66;1280;57;5316.00;599
13542;47;22380609;13542;503;14821;15419;4.95;0.30;391.28;24.68;1279;57;5317.00;598
13544;47;22380625;13544;506;14822;15420;4.90;0.30;391.26;24.69;1278;57;5318.00;598
13547;47;22380642;13547;501;14823;15421;4.86;0.30;391.35;24.70;1276;57;5319.00;598
13549;47;22380657;13549;503;14824;15421;4.83;0.30;391.36;24.71;1275;57;5320.00;597
13554;47;22380674;13554;508;14825;15422;4.81;0.29;391.41;24.71;1271;57;5321.00;597
13555;47;22380693;13555;511;14827;15422;4.82;0.29;391.40;24.74;1272;57;5322.00;595
13558;47;22380708;13558;512;14827;15422;4.80;0.29;391.45;24.74;1269;57;5323.00;595
13559;47;22380723;13559;509;14829;15422;4.87;0.30;391.48;24.76;1270;57;5324.00;593
13560;47;22380739;13560;506;14829;15422;4.94;0.30;391.49;24.76;1269;57;5325.00;593
13561;47;22380754;13561;503;14830;15422;5.00;0.31;391.48;24.77;1269;57;5326.00;592
13563;47;22380769;13563;495;14830;15422;5.11;0.31;391.50;24.77;1267;57;5327.00;592
13565;47;22380784;13565;518;14902;15549;5.24;0.33;391.52;24.68;1337;57;5328.00;647
13566;47;22380809;13566;506;14902;15550;5.27;0.33;391.59;24.68;1336;57;5329.00;648
13567;47;22380825;13567;487;14906;15550;5.41;0.34;391.58;24.67;1339;57;5330.00;644
13570;47;22380841;13570;484;14911;15550;5.45;0.34;391.63;24.69;1341;57;5331.00;639
13571;47;22380861;13571;483;14913;15550;5.46;0.34;391.63;24.69;1342;57;5332.00;637
13572;47;22380877;13572;486;14915;15550;5.52;0.34;391.64;24.69;1343;57;5333.00;635
13575;47;22380894;13575;493;14918;15550;5.51;0.34;391.78;24.70;1343;57;5334.00;632
13575;47;22380911;13575;501;14919;15550;5.48;0.34;391.78;24.69;1344;57;5335.00;631
13577;47;22380932;13577;498;14922;15551;5.46;0.34;391.77;24.72;1345;57;5336.00;629
13579;47;22380955;13579;501;14925;15552;5.43;0.33;391.80;24.72;1346;57;5337.00;627
13580;47;22380976;13580;509;14925;15552;5.39;0.33;391.83;24.72;1345;57;5338.00;627
13581;47;22380996;13581;508;14927;15553;5.38;0.33;391.83;24.72;1346;57;5339.00;626
13583;47;22381014;13583;509;14929;15553;5.37;0.33;391.83;24.73;1346;57;5340.00;624
13585;47;22381030;13585;500;14930;15553;5.37;0.33;391.86;24.73;1345;57;5341.00;623
13590;47;22381047;13590;496;14932;15553;5.33;0.33;391.84;24.73;1342;57;5342.00;621
13593;47;22381070;13593;496;14935;15557;5.33;0.33;391.88;24.74;1342;57;5343.00;622
13599;47;22381088;13599;493;14936;15557;5.27;0.32;392.04;24.73;1337;57;5344.00;621
13604;47;22381104;13604;488;14936;15557;5.25;0.32;392.12;24.73;1332;57;5345.00;621
13611;47;22381121;13611;493;14938;15560;5.22;0.32;392.15;24.74;1327;57;5346.00;622
13613;47;22381138;13613;494;14939;15560;5.22;0.32;392.25;24.75;1326;57;5347.00;621
13615;47;22381154;13615;481;14939;15560;5.23;0.32;392.28;24.75;1324;57;5348.00;621
13617;47;22381170;13617;482;14943;15564;5.30;0.32;392.46;24.77;1326;57;5349.00;621
13619;47;22381190;13619;475;14944;15565;5.34;0.33;392.46;24.77;1325;57;5350.00;621
13621;47;22381206;13621;473;14946;15565;5.38;0.33;392.49;24.79;1325;57;5351.00;619
13624;47;22381222;13624;478;14949;15569;5.38;0.33;392.51;24.78;1325;57;5352.00;620
13626;47;22381239;13626;484;14949;15569;5.32;0.33;392.49;24.78;1323;57;5353.00;620
13630;47;22381257;13630;484;14953;15569;5.28;0.32;392.56;24.80;1323;57;5354.00;616
13637;47;22381276;13637;478;14955;15571;5.23;0.32;392.71;24.91;1318;57;5355.00;616
13641;47;22381302;13641;480;14957;15571;5.20;0.32;392.72;25.02;1316;57;5356.00;614
13643;47;22381319;13643;478;14962;15577;5.21;0.32;392.71;25.09;1319;57;5357.00;615
13648;47;22381336;13648;478;14964;15577;5.15;0.31;392.79;25.10;1316;57;5358.00;613
13652;47;22381353;13652;486;14966;15577;5.12;0.31;392.80;25.11;1314;57;5359.00;611
13654;47;22381369;13654;483;14966;15578;5.10;0.31;392.90;25.11;1312;57;5360.00;612
13656;47;22381385;13656;493;14966;15578;5.02;0.31;392.92;25.11;1310;57;5361.00;612
13659;47;22381401;13659;498;14966;15578;4.95;0.30;393.00;25.11;1307;57;5362.00;612
13661;47;22381419;13661;499;14966;15578;4.88;0.30;393.09;25.11;1305;57;5363.00;612
13661;47;22381437;13661;511;14975;15590;4.86;0.30;393.09;25.10;1314;57;5364.00;615
13663;47;22381453;13663;505;14976;15590;4.85;0.29;393.06;25.11;1313;57;5365.00;614
13666;47;22381469;13666;501;14976;15590;4.84;0.29;393.15;25.11;1310;57;5366.00;614
13670;47;22381484;13670;506;14976;15590;4.79;0.29;393.09;25.11;1306;57;5367.00;614
13672;47;22381501;13672;499;14976;15590;4.78;0.29;393.10;25.11;1304;57;5368.00;614
13673;47;22381517;13673;506;14976;15590;4.77;0.29;393.08;25.11;1303;57;5369.00;614
13674;47;22381534;13674;507;14980;15594;4.77;0.29;393.10;25.11;1306;57;5370.00;614
13675;47;22381552;13675;504;14980;15594;4.77;0.29;393.10;25.11;1305;57;5371.00;614
13678;47;22381570;13678;509;14983;15598;4.72;0.29;393.07;25.12;1305;57;5372.00;615
13680;47;22381586;13680;508;14983;15599;4.69;0.29;393.09;25.12;1303;57;5373.00;616
13682;47;22381601;13682;513;14984;15599;4.67;0.28;393.09;25.20;1302;57;5374.00;615
13684;47;22381617;13684;524;14984;15599;4.62;0.28;393.08;25.20;1300;57;5375.00;615
13688;47;22381636;13688;531;14996;15612;4.59;0.28;393.13;25.19;1308;57;5376.00;616
13690;47;22381653;13690;535;14996;15612;4.54;0.28;393.09;25.19;1306;57;5377.00;616
13694;47;22381669;13694;550;14996;15612;4.50;0.27;393.07;25.19;1302;57;5378.00;616
13698;47;22381684;13698;561;14997;15613;4.49;0.27;393.00;25.19;1299;57;5379.00;616
13698;47;22381701;13698;570;14998;15614;4.49;0.27;393.00;25.30;1300;57;5380.00;616
13700;47;22381717;13700;579;14998;15614;4.51;0.28;392.97;25.30;1298;57;5381.00;616
13701;47;22381732;13701;577;14999;15617;4.53;0.28;392.94;25.30;1298;57;5382.00;618
13701;47;22381748;13701;586;14999;15617;4.50;0.28;392.94;25.30;1298;57;5383.00;618
13702;47;22381762;13702;589;14999;15617;4.49;0.28;392.93;25.30;1297;57;5384.00;618
13706;47;22381776;13706;587;14999;15617;4.48;0.27;392.89;25.30;1293;57;5385.00;618
13707;47;22381792;13707;590;15003;15623;4.50;0.28;392.92;25.30;1296;57;5386.00;620
13707;47;22381806;13707;598;15003;15623;4.46;0.27;392.92;25.30;1296;57;5387.00;620
13710;47;22381821;13710;602;15003;15623;4.40;0.27;392.95;25.30;1293;57;5388.00;620
13715;47;22381836;13715;601;15003;15623;4.34;0.27;392.92;25.30;1288;57;5389.00;620
13718;47;22381851;13718;610;15006;15627;4.30;0.26;392.88;25.29;1288;57;5390.00;621
13719;47;22381870;13719;612;15006;15628;4.28;0.26;392.86;25.29;1287;57;5391.00;622
13722;47;22381884;13722;613;15006;15628;4.27;0.26;392.86;25.29;1284;57;5392.00;622
13726;47;22381898;13726;613;15007;15629;4.24;0.26;392.80;25.29;1281;57;5393.00;622
13729;47;22381913;13729;613;15007;15629;4.23;0.26;392.81;25.29;1278;57;5394.00;622
13733;47;22381927;13733;609;15007;15629;4.18;0.26;392.88;25.29;1274;57;5395.00;622
13733;47;22381940;13733;610;15007;15629;4.17;0.26;392.88;25.29;1274;57;5396.00;622
13734;47;22381954;13734;613;15007;15629;4.16;0.26;392.87;25.29;1273;57;5397.00;622
13738;47;22381967;13738;614;15007;15629;4.13;0.25;392.90;25.29;1269;57;5398.00;622
13739;47;22381980;13739;617;15007;15629;4.11;0.25;392.89;25.29;1268;57;5399.00;622
