step_arrived;step_collisions;step_duration;step_ended;step_halting;step_inserted;step_loaded;step_meanSpeed;step_meanSpeedRelative;step_meanTravelTime;step_meanWaitingTime;step_running;step_teleports;step_time;step_waiting
0;0;624850282;0;1;89;245;16.08;1.13;-1.00;0.00;89;0;0.00;156
0;0;624850308;0;1;101;245;15.37;1.06;-1.00;0.12;101;0;1.00;144
0;0;624850309;0;3;122;245;14.23;0.97;-1.00;0.44;122;0;2.00;123
0;0;624850310;0;1;133;245;13.54;0.92;-1.00;0.65;133;0;3.00;112
0;0;624850312;0;3;147;245;12.47;0.84;-1.00;0.97;147;0;4.00;98
0;0;624850313;0;6;153;245;11.81;0.79;-1.00;1.13;153;0;5.00;92
0;0;624850315;0;6;163;245;11.14;0.75;-1.00;1.43;163;0;6.00;82
0;0;624850316;0;14;172;245;10.45;0.70;-1.00;1.72;172;0;7.00;73
0;0;624850318;0;16;180;246;10.00;0.66;-1.00;2.00;180;0;8.00;66
0;0;624850320;0;20;190;247;9.56;0.63;-1.00;2.37;190;0;9.00;57
0;0;624850322;0;23;196;247;9.23;0.61;-1.00;2.60;196;0;10.00;51
0;0;624850324;0;30;200;248;9.00;0.59;-1.00;2.72;200;0;11.00;48
0;0;624850326;0;32;204;248;8.95;0.59;-1.00;2.90;204;0;12.00;44
0;0;624850328;0;35;209;248;8.96;0.59;-1.00;3.14;209;0;13.00;39
1;0;624850330;1;38;213;248;8.94;0.58;14.00;3.35;212;0;14.00;35
2;0;624850333;2;41;217;252;8.83;0.57;14.50;3.43;215;0;15.00;35
2;0;624850336;2;44;220;252;8.73;0.56;14.50;3.60;218;0;16.00;32
2;0;624850338;2;49;223;252;8.63;0.55;14.50;3.78;221;0;17.00;29
2;0;624850341;2;55;226;255;8.74;0.56;14.50;3.97;224;0;18.00;29
3;0;624850344;3;61;228;255;8.85;0.56;16.00;4.11;225;0;19.00;27
4;0;624850346;4;65;231;255;8.76;0.55;17.00;4.31;227;0;20.00;24
5;0;624850349;5;69;238;259;8.74;0.55;17.80;4.44;233;0;21.00;21
5;0;624850352;5;73;241;260;8.70;0.55;17.80;4.60;236;0;22.00;19
6;0;624850355;6;79;244;260;8.62;0.54;18.50;4.75;238;0;23.00;16
7;0;624850357;7;82;248;264;8.43;0.53;19.29;4.88;241;0;24.00;16
7;0;624850361;7;87;250;264;8.42;0.52;19.29;4.94;243;0;25.00;14
7;0;624850363;7;88;253;264;8.36;0.52;19.29;4.95;246;0;26.00;11
7;0;624850366;7;91;253;265;8.23;0.51;19.29;4.95;246;0;27.00;12
7;0;624850369;7;93;253;265;8.16;0.50;19.29;4.95;246;0;28.00;12
7;0;624850372;7;96;258;271;8.06;0.50;19.29;4.87;251;0;29.00;13
8;0;624850377;8;96;259;271;8.03;0.50;20.38;4.97;251;0;30.00;12
8;0;624850380;8;101;260;272;7.97;0.49;20.38;4.95;252;0;31.00;12
8;0;624850383;8;102;260;272;8.11;0.50;20.38;4.95;252;0;32.00;12
8;0;624850386;8;107;261;272;8.19;0.51;20.38;5.06;253;0;33.00;11
10;0;624850389;10;110;262;272;8.08;0.50;23.10;5.10;252;0;34.00;10
11;0;624850392;11;111;263;272;8.12;0.50;23.64;5.22;252;0;35.00;9
11;0;624850394;11;115;273;284;8.53;0.53;23.64;5.03;262;0;36.00;11
11;0;624850398;11;119;275;284;8.53;0.53;23.64;5.26;264;0;37.00;9
12;0;624850401;12;120;275;284;8.48;0.53;24.50;5.26;263;0;38.00;9
13;0;624850404;13;123;276;284;8.40;0.52;25.23;5.35;263;0;39.00;8
14;0;624850407;14;124;277;284;8.38;0.52;26.07;5.41;263;0;40.00;7
15;0;624850410;15;127;277;284;8.30;0.51;26.93;5.41;262;0;41.00;7
15;0;624850413;15;128;282;288;8.25;0.51;26.93;5.38;267;0;42.00;6
15;0;624850417;15;131;283;288;8.06;0.50;26.93;5.41;268;0;43.00;5
16;0;624850419;16;134;288;292;7.93;0.49;27.44;5.39;272;0;44.00;4
16;0;624850423;16;137;291;294;7.70;0.48;27.44;5.34;275;0;45.00;3
16;0;624850426;16;140;291;294;7.50;0.47;27.44;5.34;275;0;46.00;3
16;0;624850428;16;138;291;294;7.39;0.46;27.44;5.34;275;0;47.00;3
18;0;624850432;18;141;301;307;7.51;0.47;28.17;5.16;283;0;48.00;6
18;0;624850436;18;144;302;307;7.45;0.47;28.17;5.15;284;0;49.00;5
18;0;624850439;18;149;302;307;7.44;0.47;28.17;5.15;284;0;50.00;5
20;0;624850442;20;148;303;308;7.46;0.47;30.45;5.13;283;0;51.00;5
21;0;624850444;21;151;304;309;7.42;0.46;31.43;5.12;283;0;52.00;5
21;0;624850447;21;153;304;309;7.44;0.47;31.43;5.12;283;0;53.00;5
21;0;624850450;21;154;306;312;7.52;0.47;31.43;5.08;285;0;54.00;6
23;0;624850453;23;156;306;312;7.34;0.46;31.91;5.08;283;0;55.00;6
24;0;624850457;24;145;307;312;7.25;0.45;31.96;5.07;283;0;56.00;5
24;0;624850460;24;139;307;312;7.11;0.44;31.96;5.07;283;0;57.00;5
25;0;624850464;25;140;313;318;7.11;0.44;32.12;5.00;288;0;58.00;5
26;0;624850468;26;141;313;318;7.12;0.44;33.00;5.00;287;0;59.00;5
27;0;624850474;27;144;313;318;7.21;0.44;33.85;5.00;286;0;60.00;5
27;0;624850477;27;145;313;318;7.29;0.45;33.85;5.00;286;0;61.00;5
28;0;624850481;28;148;317;322;7.33;0.45;34.86;4.95;289;0;62.00;5
29;0;624850484;29;150;318;323;7.52;0.46;35.76;4.93;289;0;63.00;5
31;0;624850488;31;151;318;323;7.52;0.46;37.32;4.93;287;0;64.00;5
31;0;624850491;31;151;319;324;7.54;0.46;37.32;4.92;288;0;65.00;5
34;0;624850494;34;153;319;324;7.42;0.45;38.44;4.92;285;0;66.00;5
34;0;624850498;34;146;319;324;7.46;0.46;38.44;4.92;285;0;67.00;5
34;0;624850501;34;141;319;324;7.59;0.46;38.44;4.92;285;0;68.00;5
34;0;624850505;34;139;319;324;7.75;0.47;38.44;4.92;285;0;69.00;5
34;0;624850511;34;136;319;324;7.91;0.48;38.44;4.92;285;0;70.00;5
34;0;624850515;34;130;319;324;8.05;0.49;38.44;4.92;285;0;71.00;5
34;0;624850519;34;133;351;394;8.27;0.51;38.44;4.47;317;0;72.00;43
35;0;624850528;35;125;352;395;8.48;0.52;39.43;4.46;317;0;73.00;43
36;0;624850533;36;118;359;395;8.78;0.54;40.36;4.41;323;0;74.00;36
36;0;624850537;36;118;363;395;9.09;0.56;40.36;4.40;327;0;75.00;32
36;0;624850540;36;116;365;395;9.26;0.57;40.36;4.39;329;0;76.00;30
36;0;624850550;36;114;367;395;9.45;0.58;40.36;4.40;331;0;77.00;28
37;0;624850561;37;115;370;395;9.51;0.58;41.38;4.41;333;0;78.00;25
38;0;624850564;38;118;372;395;9.61;0.59;41.89;4.42;334;0;79.00;23
38;0;624850568;38;117;374;396;9.73;0.59;41.89;4.44;336;0;80.00;22
39;1;624850572;39;118;377;397;9.77;0.59;42.90;4.48;338;1;81.00;20
41;1;624850592;41;119;380;397;9.77;0.59;44.80;4.52;339;1;82.00;17
42;1;624850596;42;122;386;401;9.66;0.59;45.21;4.48;344;1;83.00;15
43;1;624850600;43;122;386;401;9.66;0.58;46.00;4.48;343;1;84.00;15
43;1;624850604;43;125;386;401;9.61;0.58;46.00;4.48;343;1;85.00;15
43;1;624850608;43;122;386;401;9.54;0.58;46.00;4.48;343;1;86.00;15
43;1;624850612;43;122;391;407;9.48;0.57;46.00;4.43;348;1;87.00;16
44;1;624850617;44;123;391;407;9.34;0.57;46.95;4.43;347;1;88.00;16
44;1;624850621;44;127;391;407;9.28;0.56;46.95;4.43;347;1;89.00;16
45;1;624850626;45;126;395;413;9.27;0.56;47.91;4.39;350;1;90.00;18
46;1;624850631;46;129;395;413;9.25;0.56;48.85;4.39;349;1;91.00;18
51;1;624850635;51;129;397;413;9.08;0.55;52.96;4.38;346;1;92.00;16
53;1;624850640;53;134;398;414;8.88;0.54;54.47;4.37;345;1;93.00;16
54;1;624850644;54;132;399;415;8.89;0.54;55.20;4.36;345;1;94.00;16
55;1;624850648;55;133;399;415;8.79;0.54;55.93;4.36;344;1;95.00;16
56;1;624850652;56;132;409;428;8.76;0.54;56.57;4.25;353;1;96.00;19
61;1;624850657;61;131;409;428;8.67;0.53;58.36;4.25;348;1;97.00;19
61;1;624850661;61;131;410;428;8.78;0.54;58.36;4.25;349;1;98.00;18
63;1;624850664;63;129;411;429;8.83;0.54;59.48;4.24;348;1;99.00;18
63;1;624850670;63;126;411;429;8.94;0.55;59.48;4.24;348;1;100.00;18
64;1;624850684;64;124;414;433;9.14;0.56;60.11;4.21;350;1;101.00;19
64;1;624850689;64;119;414;433;9.29;0.57;60.11;4.21;350;1;102.00;19
65;1;624850693;65;115;418;437;9.37;0.58;60.71;4.18;353;1;103.00;19
66;1;624850700;66;106;420;437;9.50;0.59;61.23;4.32;354;1;104.00;17
67;1;624850709;67;100;420;437;9.66;0.59;61.79;4.32;353;1;105.00;17
68;1;624850716;68;96;420;437;9.79;0.60;62.40;4.32;352;1;106.00;17
70;1;624850721;70;91;420;437;9.97;0.61;63.64;4.32;350;1;107.00;17
70;1;624850728;70;87;430;449;10.13;0.62;63.64;4.22;360;1;108.00;19
70;1;624850736;70;80;431;449;10.23;0.63;63.64;4.21;361;1;109.00;18
72;1;624850743;72;76;432;449;10.26;0.63;64.93;4.20;360;1;110.00;17
72;1;624850750;72;75;432;449;10.37;0.63;64.93;4.20;360;1;111.00;17
72;1;624850758;72;74;432;449;10.50;0.64;64.93;4.20;360;1;112.00;17
72;1;624850764;72;68;432;449;10.73;0.66;64.93;4.20;360;1;113.00;17
72;1;624850771;72;68;433;450;10.85;0.66;64.93;4.20;361;1;114.00;17
73;1;624850779;73;69;433;450;11.00;0.67;65.60;4.20;360;1;115.00;17
74;1;624850786;74;67;439;456;11.14;0.68;66.28;4.41;365;1;116.00;17
75;1;624850795;75;69;439;457;11.21;0.68;66.92;4.41;364;1;117.00;18
76;1;624850802;76;69;442;457;11.23;0.68;67.54;4.60;366;1;118.00;15
77;1;624850811;77;75;443;457;11.21;0.68;68.18;4.85;366;1;119.00;14
79;1;624850820;79;77;449;462;11.30;0.69;69.42;5.00;370;1;120.00;13
80;1;624850827;80;78;449;462;11.33;0.69;70.06;5.00;369;1;121.00;13
81;1;624850833;81;78;450;462;11.32;0.69;70.26;5.26;369;1;122.00;12
82;1;624850839;82;78;453;463;11.32;0.69;70.88;5.45;371;1;123.00;10
83;1;624850845;83;83;457;467;11.27;0.68;71.52;5.42;374;1;124.00;10
85;1;624850851;85;84;458;467;11.32;0.69;72.74;5.57;373;1;125.00;9
85;1;624850857;85;86;462;470;11.36;0.69;72.74;5.67;377;1;126.00;8
86;1;624850863;86;89;463;470;11.52;0.70;73.22;5.66;377;1;127.00;7
86;1;624850869;86;92;464;470;11.59;0.71;73.22;5.82;378;1;128.00;6
87;1;624850875;87;91;465;470;11.67;0.71;73.45;5.83;378;1;129.00;5
88;1;624850881;88;91;469;474;11.80;0.72;73.97;5.79;381;1;130.00;5
89;1;624850887;89;93;470;474;11.83;0.72;74.58;5.91;381;1;131.00;4
90;1;624850895;90;92;470;474;11.85;0.72;75.22;5.91;380;1;132.00;4
92;1;624850900;92;93;470;474;11.80;0.72;75.68;5.91;378;1;133.00;4
92;1;624850907;92;93;472;475;11.71;0.72;75.68;6.01;380;1;134.00;3
92;1;624850913;92;94;474;477;11.69;0.72;75.68;5.99;382;1;135.00;3
93;1;624850919;93;98;474;477;11.70;0.72;76.33;5.99;381;1;136.00;3
95;1;624850924;95;95;476;478;11.70;0.72;77.35;6.05;381;1;137.00;2
98;1;624850933;98;97;476;478;11.65;0.71;78.03;6.05;378;1;138.00;2
100;1;624850939;100;99;477;478;11.56;0.71;78.45;6.13;377;1;139.00;1
102;1;624850945;102;99;477;478;11.45;0.70;79.66;6.13;375;1;140.00;1
102;1;624850950;102;99;478;478;11.47;0.71;79.66;6.16;376;1;141.00;0
104;1;624850956;104;99;478;478;11.53;0.71;80.26;6.16;374;1;142.00;0
107;1;624850963;107;101;478;478;11.56;0.71;81.31;6.16;371;1;143.00;0
109;1;624850970;109;124;553;605;11.15;0.70;82.34;5.33;444;1;144.00;52
110;1;624850987;110;118;558;606;11.17;0.70;82.91;5.29;448;1;145.00;48
111;1;624850994;111;116;568;606;11.21;0.70;83.09;5.23;457;1;146.00;38
113;1;624851014;113;112;569;606;11.11;0.70;84.13;5.23;456;1;147.00;37
113;1;624851023;113;112;574;606;11.10;0.70;84.13;5.22;461;1;148.00;32
115;1;624851031;115;109;576;606;11.01;0.69;84.17;5.22;461;1;149.00;30
117;1;624851041;117;108;579;611;10.94;0.68;84.50;5.20;462;1;150.00;32
120;1;624851054;120;108;581;611;10.94;0.68;86.10;5.21;461;1;151.00;30
120;1;624851063;120;106;583;612;11.10;0.69;86.10;5.22;463;1;152.00;29
123;1;624851071;123;104;585;613;11.13;0.69;87.23;5.23;462;1;153.00;28
125;1;624851078;125;107;589;613;11.23;0.69;88.19;5.26;464;1;154.00;24
125;1;624851085;125;109;592;614;11.16;0.69;88.19;5.28;467;1;155.00;22
129;1;624851092;129;111;596;614;11.09;0.69;88.03;5.30;467;1;156.00;18
131;1;624851098;131;113;599;614;11.13;0.69;89.03;5.34;468;1;157.00;15
134;1;624851105;134;116;601;614;11.09;0.68;89.46;5.37;467;1;158.00;13
135;1;624851112;135;124;604;618;11.03;0.68;89.87;5.37;469;1;159.00;14
135;1;624851119;135;130;607;618;10.87;0.67;89.87;5.40;472;1;160.00;11
135;1;624851125;135;130;609;618;10.76;0.66;89.87;5.44;474;1;161.00;9
136;1;624851131;136;135;611;621;10.55;0.65;90.40;5.47;475;1;162.00;10
139;1;624851138;139;136;612;621;10.39;0.64;91.40;5.47;473;1;163.00;9
140;1;624851144;140;136;615;621;10.25;0.63;91.91;5.51;475;1;164.00;6
143;1;624851150;143;139;619;625;10.11;0.62;93.34;5.51;476;1;165.00;6
148;1;624851156;148;138;621;626;9.92;0.61;94.97;5.52;473;1;166.00;5
149;1;624851163;149;141;623;626;9.83;0.61;94.49;5.54;474;1;167.00;3
150;1;624851168;150;145;627;630;9.78;0.61;94.95;5.51;477;1;168.00;3
152;1;624851174;152;147;627;630;9.61;0.60;95.66;5.51;475;1;169.00;3
152;1;624851180;152;138;627;630;9.55;0.59;95.66;5.51;475;1;170.00;3
153;1;624851186;153;137;629;631;9.54;0.59;96.13;5.50;476;1;171.00;2
154;1;624851192;154;129;629;631;9.50;0.59;96.45;5.50;475;1;172.00;2
156;1;624851204;156;131;635;637;9.53;0.59;96.02;5.46;479;1;173.00;2
157;1;624851210;157;133;635;637;9.53;0.59;95.85;5.46;478;1;174.00;2
159;1;624851216;159;128;636;638;9.44;0.58;96.64;5.45;477;1;175.00;2
160;1;624851223;160;128;636;638;9.48;0.59;96.38;5.45;476;1;176.00;2
162;1;624851229;162;128;636;638;9.45;0.58;96.80;5.45;474;1;177.00;2
164;1;624851235;164;124;638;638;9.45;0.58;96.97;5.50;474;1;178.00;0
164;1;624851241;164;123;638;638;9.45;0.58;96.97;5.50;474;1;179.00;0
166;1;624851248;166;122;668;672;9.60;0.59;97.36;5.26;502;1;180.00;4
167;1;624851256;167;119;668;672;9.60;0.59;97.85;5.26;501;1;181.00;4
167;1;624851262;167;117;671;672;9.69;0.60;97.85;5.24;504;1;182.00;1
168;1;624851268;168;122;671;672;9.68;0.60;98.02;5.24;503;1;183.00;1
170;1;624851275;170;126;672;672;9.65;0.60;98.67;5.24;502;1;184.00;0
173;1;624851282;173;128;672;672;9.56;0.59;99.41;5.24;499;1;185.00;0
174;1;624851298;174;134;676;676;9.50;0.59;99.47;5.21;502;1;186.00;0
175;1;624851306;175;140;676;676;9.44;0.58;99.42;5.21;501;1;187.00;0
176;1;624851313;176;148;680;680;9.39;0.58;99.64;5.19;504;1;188.00;0
179;1;624851320;179;152;681;681;9.35;0.58;99.99;5.18;502;1;189.00;0
183;1;624851326;183;154;681;681;9.28;0.57;99.86;5.18;498;1;190.00;0
185;1;624851333;185;160;681;681;9.24;0.57;99.78;5.18;496;1;191.00;0
185;1;624851345;185;166;694;694;9.22;0.57;99.78;5.09;509;1;192.00;0
190;1;624851352;190;170;694;694;9.03;0.55;99.93;5.09;504;1;193.00;0
193;1;624851358;193;178;694;694;8.92;0.55;100.10;5.09;501;1;194.00;0
195;1;624851364;195;179;695;695;8.76;0.54;99.61;5.08;500;1;195.00;0
197;1;624851370;197;186;696;696;8.59;0.53;99.48;5.07;499;1;196.00;0
199;1;624851377;199;189;696;696;8.49;0.52;100.46;5.07;497;1;197.00;0
201;1;624851383;201;197;698;699;8.40;0.51;100.33;5.06;497;1;198.00;1
201;1;624851389;201;203;698;699;8.33;0.51;100.33;5.06;497;1;199.00;1
202;1;624851395;202;207;699;699;8.24;0.51;100.41;5.05;497;1;200.00;0
202;1;624851405;202;208;699;699;8.16;0.50;100.41;5.05;497;1;201.00;0
202;1;624851411;202;211;705;705;8.14;0.50;100.41;5.02;503;1;202.00;0
203;1;624851417;203;218;705;705;8.05;0.50;100.04;5.02;502;1;203.00;0
206;1;624851423;206;221;705;705;7.96;0.49;99.98;5.02;499;1;204.00;0
208;1;624851429;208;224;705;705;7.90;0.49;99.43;5.02;497;1;205.00;0
212;1;624851435;212;227;709;709;7.87;0.49;100.18;5.00;497;1;206.00;0
214;1;624851441;214;235;710;710;7.89;0.49;100.48;4.99;496;1;207.00;0
216;1;624851448;216;238;710;710;7.81;0.48;100.70;4.99;494;1;208.00;0
217;1;624851453;217;241;711;711;7.71;0.48;100.35;4.98;494;1;209.00;0
218;1;624851461;218;243;711;711;7.58;0.47;100.80;4.98;493;1;210.00;0
223;1;624851468;223;245;711;711;7.37;0.45;101.25;4.98;488;1;211.00;0
223;1;624851474;223;254;711;711;7.24;0.44;101.25;4.98;488;1;212.00;0
226;1;624851480;226;257;711;711;7.12;0.44;101.85;4.98;485;1;213.00;0
226;1;624851485;226;258;711;711;7.01;0.43;101.85;4.98;485;1;214.00;0
226;1;624851491;226;263;711;711;6.89;0.42;101.85;4.98;485;1;215.00;0
228;1;624851497;228;280;753;781;7.00;0.43;101.95;4.71;525;1;216.00;28
230;1;624851508;230;265;755;782;6.96;0.43;102.53;4.70;525;1;217.00;27
231;1;624851514;231;255;761;782;7.04;0.44;103.01;4.68;530;1;218.00;21
231;1;624851521;231;240;762;782;7.11;0.44;103.01;4.67;531;1;219.00;20
235;1;624851527;235;228;766;782;7.18;0.44;104.23;4.67;531;1;220.00;16
235;1;624851534;235;220;766;782;7.27;0.45;104.23;4.67;531;1;221.00;16
235;1;624851540;235;219;769;782;7.44;0.46;104.23;4.67;534;1;222.00;13
236;1;624851547;236;221;772;782;7.61;0.47;104.72;4.68;536;1;223.00;10
237;1;624851554;237;222;774;783;7.68;0.47;104.79;4.69;537;1;224.00;9
238;1;624851561;238;222;777;785;7.67;0.47;105.26;4.70;539;1;225.00;8
241;1;624851575;241;207;780;785;7.81;0.48;105.64;4.72;539;1;226.00;5
242;1;624851582;242;202;786;789;7.96;0.49;106.13;4.70;544;1;227.00;3
246;1;624851590;246;188;787;789;8.13;0.50;107.01;4.71;541;1;228.00;2
246;1;624851598;246;183;788;789;8.40;0.51;107.01;4.72;542;1;229.00;1
246;1;624851605;246;181;789;789;8.71;0.53;107.01;4.73;543;1;230.00;0
248;1;624851612;248;174;795;795;8.96;0.55;107.24;4.70;547;1;231.00;0
248;1;624851626;248;168;795;795;9.22;0.56;107.24;4.70;547;1;232.00;0
249;1;624851635;249;162;795;795;9.44;0.58;107.74;4.70;546;1;233.00;0
250;1;624851644;250;160;797;798;9.69;0.59;107.67;4.69;547;1;234.00;1
252;1;624851653;252;153;797;798;9.87;0.60;107.94;4.69;545;1;235.00;1
252;1;624851663;252;150;798;798;10.06;0.62;107.94;4.68;546;1;236.00;0
255;1;624851671;255;145;799;799;10.18;0.62;108.67;4.68;544;1;237.00;0
256;1;624851680;256;143;800;800;10.27;0.63;109.00;4.67;544;1;238.00;0
257;1;624851689;257;135;800;800;10.33;0.63;109.49;4.67;543;1;239.00;0
260;1;624851700;260;136;824;826;10.37;0.64;110.00;4.54;564;1;240.00;2
262;1;624851711;262;125;825;826;10.51;0.64;110.27;4.53;563;1;241.00;1
264;1;624851718;264;122;826;826;10.63;0.65;111.03;4.53;562;1;242.00;0
267;1;624851726;267;120;827;827;10.84;0.66;111.67;4.52;560;1;243.00;0
269;1;624851734;269;114;827;827;10.93;0.67;112.36;4.52;558;1;244.00;0
273;1;624851741;273;111;831;831;11.02;0.67;112.38;4.51;558;1;245.00;0
276;1;624851751;276;110;831;831;11.04;0.67;113.42;4.51;555;1;246.00;0
277;1;624851761;277;105;835;835;11.08;0.67;113.86;4.49;558;1;247.00;0
283;1;624851774;283;106;835;835;11.09;0.67;115.08;4.49;552;1;248.00;0
285;2;624851786;285;108;835;835;11.21;0.68;115.22;4.49;550;2;249.00;0
285;2;624851832;285;104;835;835;11.39;0.69;115.22;4.49;550;2;250.00;0
287;2;624851841;287;97;835;835;11.50;0.70;115.41;4.49;548;2;251.00;0
288;2;624851848;288;100;845;847;11.65;0.71;115.46;4.44;557;2;252.00;2
293;2;624851857;293;98;845;847;11.79;0.72;116.29;4.44;552;2;253.00;2
294;2;624851866;294;99;847;847;11.94;0.73;116.39;4.43;553;2;254.00;0
295;2;624851880;295;101;847;847;12.06;0.73;116.82;4.43;552;2;255.00;0
296;2;624851895;296;101;847;847;12.15;0.74;116.80;4.43;551;2;256.00;0
297;2;624851909;297;103;847;847;12.22;0.74;116.79;4.43;550;2;257.00;0
299;2;624851926;299;106;848;848;12.26;0.75;117.01;4.43;549;2;258.00;0
301;2;624851935;301;108;848;848;12.28;0.75;116.88;4.43;547;2;259.00;0
305;2;624851942;305;109;854;854;12.29;0.75;117.50;4.40;549;2;260.00;0
309;2;624851957;309;108;855;855;12.36;0.75;118.74;4.40;546;2;261.00;0
311;2;624851965;311;111;855;855;12.31;0.74;118.59;4.40;544;2;262.00;0
314;2;624851973;314;107;855;855;12.33;0.74;118.67;4.40;541;2;263.00;0
316;2;624851980;316;107;859;859;12.23;0.74;119.04;4.38;543;2;264.00;0
318;2;624851988;318;109;859;859;12.23;0.74;119.09;4.38;541;2;265.00;0
319;2;624851995;319;114;859;859;12.22;0.74;118.99;4.38;540;2;266.00;0
320;2;624852001;320;116;860;860;12.26;0.74;119.44;4.37;540;2;267.00;0
321;2;624852008;321;116;864;864;12.13;0.73;119.91;4.36;543;2;268.00;0
323;2;624852016;323;113;864;864;12.07;0.73;120.65;4.36;541;2;269.00;0
325;2;624852024;325;112;868;870;12.10;0.73;121.05;4.34;543;2;270.00;2
327;2;624852031;327;111;868;870;12.10;0.73;121.18;4.34;541;2;271.00;2
328;2;624852038;328;106;870;870;12.25;0.74;121.61;4.33;542;2;272.00;0
330;2;624852044;330;102;870;870;12.34;0.75;121.83;4.33;540;2;273.00;0
331;2;624852051;331;97;874;874;12.45;0.76;121.85;4.32;543;2;274.00;0
333;2;624852059;333;92;874;874;12.59;0.76;122.14;4.32;541;2;275.00;0
337;2;624852065;337;87;874;874;12.59;0.76;122.25;4.32;537;2;276.00;0
340;2;624852073;340;82;874;874;12.58;0.76;122.54;4.32;534;2;277.00;0
342;2;624852079;342;79;875;875;12.49;0.76;122.66;4.31;533;2;278.00;0
346;2;624852087;346;78;876;876;12.45;0.76;122.76;4.31;530;2;279.00;0
347;2;624852094;347;75;876;876;12.37;0.75;122.59;4.31;529;2;280.00;0
348;2;624852101;348;75;877;877;12.38;0.75;122.95;4.31;529;2;281.00;0
349;2;624852108;349;73;877;877;12.36;0.75;122.78;4.31;528;2;282.00;0
351;2;624852114;351;74;877;877;12.36;0.75;123.07;4.31;526;2;283.00;0
355;2;624852121;355;73;877;877;12.43;0.76;123.56;4.31;522;2;284.00;0
356;2;624852128;356;74;877;877;12.56;0.76;123.54;4.31;521;2;285.00;0
358;2;624852135;358;75;877;877;12.69;0.77;123.90;4.31;519;2;286.00;0
360;2;624852142;360;74;877;877;12.71;0.77;124.39;4.31;517;2;287.00;0
360;2;624852149;360;95;948;1004;12.25;0.76;124.39;3.99;588;2;288.00;56
363;2;624852166;363;87;952;1005;12.27;0.76;124.98;3.97;589;2;289.00;53
365;2;624852174;365;82;957;1005;12.32;0.76;125.27;3.96;592;2;290.00;48
365;2;624852182;365;84;961;1005;12.18;0.75;125.27;3.96;596;2;291.00;44
366;2;624852189;366;91;966;1005;12.16;0.75;125.53;3.96;600;2;292.00;39
366;2;624852196;366;86;969;1005;12.16;0.75;125.53;3.96;603;2;293.00;36
368;3;624852204;368;86;972;1005;12.20;0.75;125.77;3.97;604;3;294.00;33
370;3;624852220;370;87;975;1005;12.11;0.75;126.16;3.98;605;3;295.00;30
371;3;624852229;371;90;978;1006;12.11;0.74;126.59;3.99;607;3;296.00;28
375;3;624852239;375;94;983;1007;12.06;0.74;127.62;4.02;608;3;297.00;24
375;3;624852252;375;98;985;1007;11.96;0.73;127.62;4.03;610;3;298.00;22
378;3;624852266;378;100;987;1008;11.79;0.72;127.45;4.04;609;3;299.00;21
380;3;624852279;380;109;993;1014;11.50;0.71;127.33;4.07;613;3;300.00;21
382;3;624852296;382;110;996;1014;11.29;0.69;127.99;4.09;614;3;301.00;18
384;3;624852306;384;115;996;1014;11.16;0.69;128.17;4.09;612;3;302.00;18
385;3;624852316;385;121;1001;1018;11.05;0.68;128.35;4.10;616;3;303.00;17
389;3;624852325;389;126;1002;1018;10.88;0.67;128.76;4.11;613;3;304.00;16
390;3;624852334;390;135;1003;1018;10.79;0.66;129.03;4.11;613;3;305.00;15
391;3;624852344;391;139;1009;1021;10.63;0.65;129.11;4.15;618;3;306.00;12
392;3;624852354;392;144;1009;1021;10.62;0.65;129.01;4.15;617;3;307.00;12
394;3;624852366;394;154;1010;1021;10.59;0.65;129.30;4.15;616;3;308.00;11
395;3;624852375;395;161;1014;1025;10.44;0.64;129.38;4.16;619;3;309.00;11
397;3;624852384;397;165;1015;1026;10.39;0.64;129.94;4.16;618;3;310.00;11
398;3;624852393;398;172;1017;1026;10.34;0.64;129.67;4.18;619;3;311.00;9
401;3;624852401;401;172;1023;1030;10.29;0.63;129.87;4.19;622;3;312.00;7
405;3;624852409;405;174;1024;1030;10.19;0.63;131.01;4.20;619;3;313.00;6
406;3;624852416;406;179;1026;1030;10.11;0.62;131.11;4.22;620;3;314.00;4
408;3;624852424;408;184;1029;1032;9.97;0.61;131.50;4.23;621;3;315.00;3
411;3;624852432;411;189;1030;1032;9.76;0.60;132.06;4.25;619;3;316.00;2
412;3;624852444;412;194;1035;1038;9.62;0.59;132.48;4.24;623;3;317.00;3
413;3;624852457;413;198;1036;1038;9.42;0.58;132.68;4.23;623;3;318.00;2
417;3;624852464;417;200;1037;1039;9.17;0.56;133.54;4.23;620;3;319.00;2
421;3;624852471;421;200;1037;1039;9.02;0.55;133.39;4.23;616;3;320.00;2
421;3;624852479;421;204;1038;1039;8.96;0.55;133.39;4.26;617;3;321.00;1
423;3;624852485;423;205;1038;1039;8.95;0.55;133.30;4.26;615;3;322.00;1
426;3;624852493;426;206;1039;1039;8.83;0.54;134.50;4.27;613;3;323.00;0
429;3;624852500;429;205;1050;1051;8.84;0.54;135.17;4.22;621;3;324.00;1
433;3;624852508;433;202;1050;1051;8.78;0.54;135.46;4.22;617;3;325.00;1
433;3;624852516;433;205;1051;1051;8.82;0.54;135.46;4.22;618;3;326.00;0
433;3;624852523;433;208;1051;1051;8.86;0.54;135.46;4.22;618;3;327.00;0
435;3;624852530;435;208;1051;1051;8.89;0.55;136.04;4.22;616;3;328.00;0
437;3;624852537;437;210;1051;1051;8.94;0.55;136.03;4.22;614;3;329.00;0
437;3;624852546;437;214;1055;1055;8.93;0.55;136.03;4.21;618;3;330.00;0
438;3;624852552;438;218;1055;1055;8.98;0.55;136.08;4.21;617;3;331.00;0
440;3;624852560;440;226;1059;1059;9.13;0.56;136.22;4.20;619;3;332.00;0
445;3;624852567;445;229;1060;1060;9.04;0.56;137.49;4.19;615;3;333.00;0
451;3;624852574;451;228;1060;1060;8.85;0.54;138.13;4.19;609;3;334.00;0
457;3;624852581;457;230;1060;1060;8.69;0.53;138.51;4.19;603;3;335.00;0
461;3;624852588;461;229;1073;1073;8.47;0.52;139.17;4.14;612;3;336.00;0
464;3;624852597;464;227;1073;1073;8.30;0.51;139.77;4.14;609;3;337.00;0
465;3;624852603;465;233;1073;1073;8.20;0.50;139.58;4.14;608;3;338.00;0
471;3;624852609;471;241;1074;1074;8.07;0.50;141.03;4.14;603;3;339.00;0
475;3;624852616;475;237;1075;1075;7.91;0.49;142.02;4.14;600;3;340.00;0
479;3;624852622;479;235;1075;1075;7.88;0.49;142.23;4.14;596;3;341.00;0
481;3;624852629;481;232;1077;1078;7.84;0.48;142.84;4.13;596;3;342.00;1
483;3;624852635;483;231;1077;1078;7.80;0.48;143.35;4.13;594;3;343.00;1
485;3;624852641;485;228;1078;1078;7.83;0.48;143.51;4.13;593;3;344.00;0
488;3;624852648;488;227;1078;1078;7.78;0.48;144.29;4.13;590;3;345.00;0
491;3;624852654;491;228;1084;1084;7.79;0.48;144.52;4.11;593;3;346.00;0
493;3;624852661;493;224;1084;1084;7.75;0.48;144.89;4.11;591;3;347.00;0
498;3;624852667;498;226;1084;1084;7.77;0.48;145.26;4.11;586;3;348.00;0
500;3;624852674;500;221;1084;1084;7.74;0.48;145.56;4.11;584;3;349.00;0
505;3;624852680;505;221;1088;1088;7.65;0.47;145.86;4.10;583;3;350.00;0
507;3;624852689;507;224;1089;1089;7.60;0.47;146.19;4.10;582;3;351.00;0
510;3;624852696;510;228;1089;1089;7.50;0.46;145.98;4.10;579;3;352.00;0
512;3;624852705;512;227;1090;1090;7.35;0.45;145.60;4.09;578;3;353.00;0
517;3;624852715;517;232;1090;1090;7.15;0.44;145.79;4.09;573;3;354.00;0
521;3;624852728;521;232;1090;1090;6.98;0.43;145.62;4.09;569;3;355.00;0
525;3;624852737;525;238;1090;1090;6.86;0.42;145.75;4.09;565;3;356.00;0
528;3;624852747;528;242;1090;1090;6.73;0.41;145.64;4.09;562;3;357.00;0
529;3;624852757;529;248;1090;1090;6.63;0.41;145.50;4.09;561;3;358.00;0
531;3;624852766;531;249;1090;1090;6.60;0.40;145.76;4.09;559;3;359.00;0
531;3;624852779;531;259;1151;1215;7.06;0.44;145.76;3.88;620;3;360.00;64
532;3;624852807;532;260;1159;1216;7.06;0.44;145.69;3.86;627;3;361.00;57
534;3;624852818;534;264;1174;1216;7.18;0.45;145.42;3.83;640;3;362.00;42
536;3;624852828;536;262;1177;1216;7.11;0.44;145.36;3.83;641;3;363.00;39
537;3;624852837;537;269;1184;1216;7.09;0.44;145.36;3.83;647;3;364.00;32
539;3;624852846;539;271;1185;1216;7.06;0.44;145.51;3.83;646;3;365.00;31
540;3;624852857;540;274;1190;1216;7.04;0.44;145.66;3.84;650;3;366.00;26
542;3;624852874;542;281;1192;1216;6.95;0.43;145.81;3.85;650;3;367.00;24
543;3;624852883;543;290;1196;1217;6.84;0.42;145.86;3.86;653;3;368.00;21
544;3;624852892;544;291;1203;1218;6.77;0.42;145.97;3.89;659;3;369.00;15
547;3;624852902;547;298;1204;1218;6.61;0.41;146.08;3.90;657;3;370.00;14
548;3;624852910;548;292;1211;1222;6.55;0.41;145.97;3.90;663;3;371.00;11
550;3;624852919;550;290;1214;1222;6.52;0.40;145.80;3.92;664;3;372.00;8
550;3;624852927;550;288;1216;1222;6.60;0.41;145.80;3.93;666;3;373.00;6
552;3;624852936;552;281;1218;1222;6.62;0.41;145.69;3.95;666;3;374.00;4
554;3;624852945;554;280;1224;1228;6.64;0.41;145.64;3.94;670;3;375.00;4
554;3;624852955;554;277;1226;1228;6.73;0.41;145.64;3.95;672;3;376.00;2
555;3;624852965;555;276;1226;1228;6.79;0.42;145.91;3.95;671;3;377.00;2
557;3;624852988;557;276;1229;1231;6.87;0.42;146.23;3.95;672;3;378.00;2
557;3;624852997;557;271;1229;1231;6.98;0.43;146.23;3.95;672;3;379.00;2
559;3;624853006;559;272;1230;1231;7.06;0.43;146.21;3.97;671;3;380.00;1
559;3;624853016;559;274;1231;1232;7.15;0.44;146.21;3.96;672;3;381.00;1
559;3;624853033;559;273;1232;1233;7.27;0.44;146.21;3.96;673;3;382.00;1
561;3;624853043;561;270;1233;1233;7.33;0.45;146.23;3.96;672;3;383.00;0
562;3;624853054;562;264;1245;1246;7.51;0.46;146.25;3.92;683;3;384.00;1
564;3;624853066;564;262;1245;1246;7.50;0.46;146.14;3.92;681;3;385.00;1
566;3;624853077;566;260;1245;1246;7.64;0.46;146.09;3.92;679;3;386.00;1
566;3;624853088;566;246;1246;1247;7.75;0.47;146.09;3.92;680;3;387.00;1
567;3;624853099;567;242;1246;1247;7.88;0.48;146.12;3.92;679;3;388.00;1
570;3;624853110;570;231;1250;1251;7.94;0.48;146.16;3.91;680;3;389.00;1
574;3;624853124;574;227;1250;1251;8.04;0.49;146.29;3.91;676;3;390.00;1
575;3;624853135;575;226;1255;1255;8.11;0.49;146.34;3.90;680;3;391.00;0
577;3;624853147;577;224;1255;1255;8.19;0.50;146.51;3.90;678;3;392.00;0
580;3;624853159;580;223;1255;1255;8.30;0.50;147.03;3.90;675;3;393.00;0
582;3;624853170;582;222;1255;1255;8.50;0.52;147.62;3.90;673;3;394.00;0
583;3;624853183;583;223;1255;1255;8.59;0.52;147.55;3.90;672;3;395.00;0
584;3;624853193;584;206;1266;1267;8.74;0.53;147.73;3.87;682;3;396.00;1
585;3;624853206;585;194;1266;1267;8.92;0.54;147.66;3.87;681;3;397.00;1
586;3;624853218;586;178;1267;1267;9.19;0.56;147.48;3.87;681;3;398.00;0
587;3;624853235;587;168;1267;1267;9.41;0.57;147.42;3.87;680;3;399.00;0
588;3;624853256;588;162;1267;1267;9.60;0.58;147.72;3.87;679;3;400.00;0
588;3;624853282;588;156;1267;1267;9.77;0.60;147.72;3.87;679;3;401.00;0
590;3;624853296;590;154;1268;1268;9.97;0.61;148.25;3.87;678;3;402.00;0
592;3;624853309;592;143;1268;1268;10.13;0.62;148.59;3.87;676;3;403.00;0
596;3;624853320;596;138;1274;1274;10.27;0.63;149.53;3.85;678;3;404.00;0
598;3;624853341;598;137;1276;1276;10.48;0.64;149.95;3.85;678;3;405.00;0
601;3;624853354;601;132;1276;1276;10.72;0.66;150.72;3.85;675;3;406.00;0
604;3;624853366;604;124;1276;1276;10.93;0.67;151.22;3.85;672;3;407.00;0
607;3;624853378;607;123;1280;1280;11.09;0.68;152.19;3.83;673;3;408.00;0
611;3;624853398;611;116;1280;1280;11.23;0.69;152.83;3.83;669;3;409.00;0
613;3;624853409;613;115;1280;1280;11.36;0.69;153.24;3.83;667;3;410.00;0
615;3;624853420;615;112;1281;1281;11.50;0.70;153.24;3.83;666;3;411.00;0
618;3;624853430;618;116;1285;1285;11.54;0.70;153.53;3.82;667;3;412.00;0
620;3;624853441;620;114;1285;1285;11.61;0.71;153.55;3.82;665;3;413.00;0
622;3;624853451;622;111;1287;1288;11.63;0.71;153.97;3.82;665;3;414.00;1
624;3;624853464;624;107;1287;1288;11.65;0.71;154.44;3.82;663;3;415.00;1
626;3;624853477;626;104;1288;1288;11.73;0.72;154.88;3.82;662;3;416.00;0
633;3;624853488;633;103;1288;1288;11.66;0.71;155.89;3.82;655;3;417.00;0
635;3;624853506;635;97;1292;1292;11.69;0.71;155.92;3.81;657;3;418.00;0
636;3;624853517;636;98;1292;1292;11.71;0.72;155.88;3.81;656;3;419.00;0
641;3;624853530;641;99;1292;1292;11.69;0.71;156.85;3.81;651;3;420.00;0
643;3;624853541;643;101;1292;1292;11.71;0.72;157.13;3.81;649;3;421.00;0
645;3;624853550;645;93;1293;1293;11.74;0.72;157.09;3.81;648;3;422.00;0
650;3;624853560;650;94;1294;1294;11.77;0.72;157.88;3.80;644;3;423.00;0
652;3;624853572;652;93;1294;1294;11.89;0.73;158.19;3.80;642;3;424.00;0
655;3;624853583;655;92;1295;1295;11.97;0.73;158.10;3.80;640;3;425.00;0
657;3;624853595;657;94;1295;1295;12.13;0.74;158.63;3.80;638;3;426.00;0
658;3;624853605;658;95;1295;1295;12.25;0.75;158.80;3.80;637;3;427.00;0
662;3;624853615;662;94;1295;1295;12.43;0.76;159.40;3.80;633;3;428.00;0
663;3;624853625;663;96;1295;1295;12.54;0.76;159.37;3.80;632;3;429.00;0
666;3;624853636;666;99;1295;1295;12.57;0.77;160.28;3.80;629;3;430.00;0
672;3;624853649;672;99;1295;1295;12.61;0.77;160.89;3.80;623;3;431.00;0
675;3;624853661;675;131;1375;1422;11.79;0.73;161.64;3.58;700;3;432.00;47
678;3;624853681;678;116;1375;1423;11.85;0.73;162.02;3.58;697;3;433.00;48
681;3;624853694;681;104;1379;1423;12.01;0.74;162.56;3.58;698;3;434.00;44
687;3;624853710;687;100;1379;1423;12.17;0.75;162.96;3.58;692;3;435.00;44
691;3;624853722;691;99;1383;1423;12.36;0.76;163.54;3.58;692;3;436.00;40
692;3;624853738;692;103;1383;1423;12.47;0.77;163.42;3.58;691;3;437.00;40
696;3;624853759;696;105;1385;1423;12.57;0.77;163.88;3.58;689;3;438.00;38
704;3;624853770;704;107;1387;1423;12.68;0.78;164.94;3.59;683;3;439.00;36
707;3;624853783;707;110;1388;1424;12.76;0.78;165.27;3.59;681;3;440.00;36
711;3;624853793;711;109;1393;1425;12.75;0.78;165.74;3.61;682;3;441.00;32
714;3;624853806;714;105;1394;1425;12.64;0.77;166.19;3.61;680;3;442.00;31
717;3;624853818;717;105;1398;1426;12.56;0.77;166.38;3.63;681;3;443.00;28
722;3;624853829;722;105;1403;1426;12.48;0.76;166.83;3.66;681;3;444.00;23
724;3;624853842;724;102;1408;1426;12.31;0.75;167.15;3.70;684;3;445.00;18
732;3;624853854;732;101;1410;1426;12.20;0.75;167.87;3.71;678;3;446.00;16
734;3;624853865;734;97;1415;1430;12.10;0.74;167.91;3.73;681;3;447.00;15
735;3;624853877;735;96;1416;1430;12.06;0.74;167.80;3.74;681;3;448.00;14
738;3;624853891;738;100;1419;1430;12.08;0.74;167.77;3.76;681;3;449.00;11
741;3;624853904;741;106;1423;1436;12.11;0.74;167.58;3.76;682;3;450.00;13
744;3;624853920;744;108;1425;1436;12.22;0.74;167.71;3.76;681;3;451.00;11
748;3;624853934;748;110;1426;1436;12.26;0.75;167.97;3.76;678;3;452.00;10
752;3;624853949;752;114;1430;1440;12.23;0.75;168.22;3.77;678;3;453.00;10
753;3;624853963;753;111;1432;1441;12.36;0.75;168.08;3.78;679;3;454.00;9
760;3;624853975;760;110;1433;1441;12.38;0.76;167.93;3.79;673;3;455.00;8
761;3;624853987;761;112;1436;1445;12.39;0.76;167.93;3.80;675;3;456.00;9
764;3;624853998;764;114;1437;1445;12.34;0.75;167.93;3.79;673;3;457.00;8
766;3;624854009;766;119;1438;1445;12.32;0.75;168.07;3.80;672;3;458.00;7
769;3;624854019;769;121;1439;1446;12.25;0.75;168.06;3.79;670;3;459.00;7
771;3;624854029;771;126;1440;1446;12.14;0.74;168.16;3.81;669;3;460.00;6
774;3;624854039;774;129;1445;1452;12.10;0.74;168.16;3.82;671;3;461.00;7
776;3;624854052;776;131;1445;1452;11.97;0.73;167.99;3.82;669;3;462.00;7
778;3;624854066;778;135;1445;1453;11.88;0.72;167.72;3.82;667;3;463.00;8
782;3;624854077;782;136;1447;1453;11.82;0.72;167.81;3.85;665;3;464.00;6
783;3;624854091;783;137;1447;1453;11.82;0.72;167.98;3.85;664;3;465.00;6
787;3;624854115;787;135;1448;1453;11.67;0.71;167.92;3.85;661;3;466.00;5
788;3;624854127;788;135;1448;1453;11.53;0.70;167.95;3.85;660;3;467.00;5
789;3;624854138;789;139;1458;1465;11.46;0.70;167.96;3.83;669;3;468.00;7
791;3;624854151;791;140;1458;1465;11.34;0.69;167.75;3.83;667;3;469.00;7
794;3;624854161;794;154;1460;1465;11.23;0.68;167.66;3.83;666;3;470.00;5
795;3;624854170;795;160;1461;1465;11.15;0.68;167.59;3.85;666;3;471.00;4
799;3;624854179;799;166;1461;1465;11.09;0.67;167.76;3.85;662;3;472.00;4
799;3;624854188;799;170;1462;1465;11.01;0.67;167.76;3.86;663;3;473.00;3
801;3;624854197;801;176;1465;1469;10.90;0.67;167.86;3.85;664;3;474.00;4
802;3;624854206;802;180;1467;1469;10.87;0.66;167.88;3.87;665;3;475.00;2
804;3;624854214;804;184;1471;1473;10.91;0.67;167.74;3.86;667;3;476.00;2
808;3;624854224;808;192;1472;1474;10.85;0.66;167.74;3.86;664;3;477.00;2
808;3;624854233;808;192;1474;1474;10.78;0.66;167.74;3.86;666;3;478.00;0
812;3;624854242;812;193;1474;1474;10.61;0.65;167.91;3.86;662;3;479.00;0
813;3;624854253;813;194;1495;1500;10.48;0.64;167.71;3.81;682;3;480.00;5
814;3;624854264;814;199;1497;1500;10.35;0.64;167.66;3.80;683;3;481.00;3
814;3;624854274;814;206;1500;1500;10.25;0.63;167.66;3.80;686;3;482.00;0
815;3;624854282;815;214;1501;1501;10.07;0.62;167.69;3.80;686;3;483.00;0
817;3;624854291;817;216;1502;1502;9.90;0.61;167.67;3.80;685;3;484.00;0
817;3;624854300;817;218;1502;1502;9.78;0.60;167.67;3.80;685;3;485.00;0
820;3;624854308;820;222;1504;1505;9.62;0.59;168.01;3.79;684;3;486.00;1
821;3;624854317;821;231;1504;1505;9.47;0.58;167.96;3.79;683;3;487.00;1
822;3;624854326;822;243;1505;1505;9.33;0.57;167.99;3.79;683;3;488.00;0
824;3;624854333;824;244;1505;1505;9.20;0.57;168.00;3.79;681;3;489.00;0
826;3;624854342;826;241;1511;1511;9.17;0.56;167.82;3.78;685;3;490.00;0
832;3;624854350;832;238;1511;1511;9.00;0.55;167.79;3.78;679;3;491.00;0
833;3;624854359;833;239;1511;1511;8.85;0.54;167.75;3.78;678;3;492.00;0
835;3;624854367;835;234;1511;1511;8.76;0.54;168.03;3.78;676;3;493.00;0
839;3;624854374;839;240;1515;1515;8.62;0.53;167.83;3.77;676;3;494.00;0
844;3;624854383;844;237;1517;1517;8.57;0.53;167.46;3.77;673;3;495.00;0
847;3;624854391;847;240;1517;1517;8.53;0.52;167.52;3.77;670;3;496.00;0
849;3;624854399;849;244;1518;1518;8.51;0.52;167.36;3.77;669;3;497.00;0
849;3;624854407;849;246;1518;1518;8.47;0.52;167.36;3.77;669;3;498.00;0
851;3;624854414;851;250;1518;1518;8.42;0.52;167.26;3.77;667;3;499.00;0
854;3;624854423;854;252;1518;1518;8.37;0.51;167.06;3.77;664;3;500.00;0
857;3;624854435;857;255;1518;1518;8.31;0.51;166.90;3.77;661;3;501.00;0
858;3;624854443;858;258;1518;1518;8.27;0.51;166.77;3.77;660;3;502.00;0
864;3;624854450;864;262;1518;1518;8.12;0.50;166.83;3.77;654;3;503.00;0
866;3;624854457;866;268;1560;1588;8.18;0.50;166.75;3.66;694;3;504.00;28
873;3;624854471;873;261;1563;1589;8.01;0.49;166.71;3.66;690;3;505.00;26
876;3;624854480;876;258;1571;1589;7.93;0.49;167.32;3.65;695;3;506.00;18
879;3;624854490;879;259;1572;1589;7.74;0.47;167.35;3.65;693;3;507.00;17
882;3;624854498;882;264;1574;1589;7.65;0.47;168.23;3.65;692;3;508.00;15
884;3;624854506;884;271;1577;1589;7.54;0.46;168.48;3.65;693;3;509.00;12
886;3;624854518;886;269;1580;1589;7.48;0.46;169.16;3.66;694;3;510.00;9
889;3;624854527;889;272;1582;1589;7.41;0.45;169.20;3.66;693;3;511.00;7
891;3;624854535;891;264;1583;1590;7.37;0.45;169.94;3.67;692;3;512.00;7
894;3;624854542;894;262;1585;1591;7.34;0.45;170.49;3.67;691;3;513.00;6
894;3;624854549;894;270;1587;1591;7.28;0.45;170.49;3.68;693;3;514.00;4
899;3;624854557;899;271;1593;1595;7.23;0.44;170.92;3.68;694;3;515.00;2
900;3;624854566;900;280;1594;1595;7.19;0.44;171.18;3.68;694;3;516.00;1
903;3;624854574;903;279;1595;1595;7.16;0.44;171.54;3.68;692;3;517.00;0
906;3;624854582;906;277;1595;1595;7.15;0.44;171.94;3.68;689;3;518.00;0
909;3;624854590;909;274;1600;1601;7.15;0.44;172.52;3.67;691;3;519.00;1
910;3;624854599;910;278;1600;1601;7.21;0.44;172.75;3.67;690;3;520.00;1
912;3;624854607;912;277;1601;1601;7.21;0.44;173.30;3.67;689;3;521.00;0
913;3;624854615;913;272;1603;1604;7.23;0.44;173.29;3.67;690;3;522.00;1
916;3;624854623;916;257;1604;1604;7.20;0.44;173.76;3.67;688;3;523.00;0
918;3;624854633;918;251;1604;1604;7.23;0.44;173.89;3.67;686;3;524.00;0
921;3;624854641;921;247;1605;1605;7.26;0.44;174.13;3.67;684;3;525.00;0
924;3;624854650;924;245;1606;1606;7.30;0.44;174.51;3.67;682;3;526.00;0
928;3;624854659;928;241;1606;1606;7.30;0.44;174.44;3.67;678;3;527.00;0
932;3;624854667;932;235;1619;1619;7.46;0.45;174.33;3.64;687;3;528.00;0
935;3;624854678;935;234;1619;1619;7.50;0.46;174.08;3.64;684;3;529.00;0
939;3;624854694;939;232;1619;1619;7.54;0.46;173.96;3.64;680;3;530.00;0
942;3;624854705;942;234;1620;1620;7.67;0.47;174.17;3.63;678;3;531.00;0
942;4;624854720;942;233;1620;1620;7.79;0.47;174.17;3.63;678;4;532.00;0
944;4;624854764;944;228;1624;1624;7.84;0.48;174.66;3.63;680;4;533.00;0
947;4;624854778;947;227;1624;1624;7.85;0.48;175.01;3.63;677;4;534.00;0
949;4;624854790;949;221;1628;1628;7.93;0.48;174.97;3.62;679;4;535.00;0
954;4;624854805;954;222;1628;1628;7.93;0.48;175.23;3.62;674;4;536.00;0
956;4;624854829;956;218;1628;1628;8.03;0.49;175.54;3.62;672;4;537.00;0
960;4;624854840;960;218;1628;1628;8.09;0.49;175.77;3.62;668;4;538.00;0
962;4;624854850;962;215;1628;1628;8.16;0.50;176.09;3.62;666;4;539.00;0
963;4;624854862;963;220;1659;1662;8.32;0.51;176.32;3.55;696;4;540.00;3
968;4;624854875;968;210;1659;1662;8.39;0.51;176.30;3.55;691;4;541.00;3
971;4;624854884;971;208;1661;1662;8.50;0.52;176.56;3.55;690;4;542.00;1
973;4;624854896;973;208;1661;1662;8.60;0.53;176.63;3.55;688;4;543.00;1
976;4;624854905;976;207;1662;1662;8.66;0.53;176.92;3.55;686;4;544.00;0
978;4;624854915;978;207;1662;1662;8.74;0.54;177.07;3.55;684;4;545.00;0
981;4;624854924;981;206;1663;1663;8.76;0.54;177.25;3.55;682;4;546.00;0
989;4;624854941;989;204;1663;1663;8.70;0.53;176.63;3.55;674;4;547.00;0
990;4;624854951;990;203;1669;1669;8.72;0.53;176.49;3.54;679;4;548.00;0
995;4;624854961;995;200;1670;1670;8.68;0.53;177.09;3.54;675;4;549.00;0
1000;4;624854971;1000;204;1670;1670;8.65;0.53;177.58;3.54;670;4;550.00;0
1002;4;624854981;1002;205;1670;1670;8.65;0.53;177.80;3.54;668;4;551.00;0
1006;4;624854990;1006;203;1674;1674;8.67;0.53;178.18;3.53;668;4;552.00;0
1009;4;624855000;1009;203;1674;1674;8.67;0.53;178.37;3.53;665;4;553.00;0
1012;4;624855008;1012;206;1674;1674;8.61;0.53;178.85;3.53;662;4;554.00;0
1015;4;624855017;1015;213;1675;1675;8.56;0.52;179.00;3.53;660;4;555.00;0
1017;4;624855027;1017;213;1679;1679;8.58;0.52;179.15;3.52;662;4;556.00;0
1022;4;624855036;1022;205;1679;1679;8.58;0.53;179.46;3.52;657;4;557.00;0
1025;4;624855046;1025;193;1681;1682;8.61;0.53;179.79;3.52;656;4;558.00;1
1029;4;624855056;1029;188;1681;1682;8.63;0.53;179.95;3.52;652;4;559.00;1
1032;4;624855065;1032;182;1682;1682;8.73;0.53;180.24;3.52;650;4;560.00;0
1037;4;624855074;1037;178;1682;1682;8.83;0.54;180.43;3.52;645;4;561.00;0
1041;4;624855085;1041;174;1686;1686;9.04;0.55;180.83;3.51;645;4;562.00;0
1044;4;624855095;1044;168;1686;1686;9.18;0.56;181.35;3.51;642;4;563.00;0
1048;4;624855105;1048;164;1686;1686;9.26;0.56;181.75;3.51;638;4;564.00;0
1050;4;624855116;1050;164;1686;1686;9.41;0.57;181.72;3.51;636;4;565.00;0
1052;4;624855125;1052;150;1687;1687;9.55;0.58;181.94;3.51;635;4;566.00;0
1054;4;624855136;1054;140;1688;1688;9.67;0.59;182.47;3.51;634;4;567.00;0
1055;4;624855146;1055;136;1688;1688;9.82;0.59;182.62;3.51;633;4;568.00;0
1056;4;624855163;1056;129;1689;1689;9.93;0.60;182.88;3.51;633;4;569.00;0
1058;4;624855175;1058;127;1689;1689;10.01;0.61;183.10;3.51;631;4;570.00;0
1058;4;624855185;1058;120;1689;1689;10.11;0.61;183.10;3.51;631;4;571.00;0
1060;4;624855195;1060;118;1689;1689;10.25;0.62;183.46;3.51;629;4;572.00;0
1062;4;624855204;1062;113;1689;1689;10.35;0.63;183.48;3.51;627;4;573.00;0
1062;4;624855214;1062;112;1689;1689;10.49;0.64;183.48;3.51;627;4;574.00;0
1063;4;624855225;1063;111;1689;1689;10.62;0.65;183.77;3.51;626;4;575.00;0
1065;4;624855234;1065;138;1772;1816;10.50;0.65;184.11;3.34;707;4;576.00;44
1068;4;624855255;1068;126;1775;1817;10.61;0.65;184.03;3.34;707;4;577.00;42
1070;4;624855266;1070;119;1782;1817;10.77;0.66;184.44;3.33;712;4;578.00;35
1071;4;624855277;1071;112;1785;1817;10.92;0.67;184.51;3.33;714;4;579.00;32
1074;4;624855287;1074;104;1789;1817;11.00;0.68;184.66;3.34;715;4;580.00;28
1074;4;624855298;1074;101;1790;1817;11.02;0.68;184.66;3.34;716;4;581.00;27
1076;4;624855308;1076;101;1792;1817;11.06;0.68;184.84;3.34;716;4;582.00;25
1082;4;624855319;1082;105;1794;1817;11.09;0.68;185.40;3.34;712;4;583.00;23
1083;4;624855329;1083;100;1797;1818;11.11;0.68;185.43;3.35;714;4;584.00;21
1085;4;624855340;1085;105;1802;1820;11.19;0.68;185.74;3.36;717;4;585.00;18
1090;4;624855350;1090;106;1804;1820;11.28;0.69;185.96;3.37;714;4;586.00;16
1091;4;624855361;1091;108;1807;1821;11.31;0.69;185.93;3.38;716;4;587.00;14
1094;4;624855372;1094;113;1810;1821;11.38;0.70;186.13;3.39;716;4;588.00;11
1097;4;624855383;1097;122;1812;1821;11.46;0.70;186.60;3.40;715;4;589.00;9
1099;4;624855394;1099;124;1813;1821;11.59;0.71;186.77;3.41;714;4;590.00;8
1104;4;624855404;1104;124;1817;1825;11.64;0.71;187.08;3.41;713;4;591.00;8
1107;4;624855415;1107;129;1818;1825;11.77;0.72;187.31;3.40;711;4;592.00;7
1107;4;624855425;1107;127;1821;1825;11.78;0.72;187.31;3.43;714;4;593.00;4
1109;4;624855436;1109;130;1823;1828;11.87;0.72;187.56;3.43;714;4;594.00;5
1113;4;624855449;1113;133;1824;1828;11.95;0.73;187.86;3.44;711;4;595.00;4
1115;4;624855461;1115;130;1825;1828;12.01;0.73;187.97;3.45;710;4;596.00;3
1118;4;624855478;1118;132;1830;1832;12.07;0.73;188.32;3.45;712;4;597.00;2
1121;4;624855489;1121;128;1831;1833;12.21;0.74;188.79;3.45;710;4;598.00;2
1122;4;624855499;1122;129;1833;1833;12.33;0.75;188.67;3.45;711;4;599.00;0
1124;4;624855512;1124;135;1845;1859;12.24;0.74;189.16;3.43;721;4;600.00;14
1130;4;624855534;1130;130;1845;1859;12.29;0.75;189.94;3.43;715;4;601.00;14
1132;4;624855547;1132;131;1846;1859;12.31;0.75;190.08;3.43;714;4;602.00;13
1137;4;624855558;1137;132;1847;1860;12.28;0.75;190.29;3.43;710;4;603.00;13
1139;4;624855568;1139;134;1848;1860;12.33;0.75;190.48;3.43;709;4;604.00;12
1140;4;624855579;1140;136;1853;1866;12.34;0.75;190.40;3.42;713;4;605.00;13
1146;4;624855590;1146;136;1854;1866;12.38;0.75;190.88;3.42;708;4;606.00;12
1151;4;624855602;1151;134;1855;1867;12.41;0.76;191.21;3.42;704;4;607.00;12
1154;4;624855612;1154;136;1856;1867;12.44;0.76;191.40;3.42;702;4;608.00;11
1158;4;624855622;1158;132;1857;1867;12.47;0.76;191.79;3.42;699;4;609.00;10
1163;4;624855632;1163;129;1858;1867;12.47;0.76;192.18;3.43;695;4;610.00;9
1166;4;624855643;1166;127;1858;1867;12.49;0.76;192.15;3.43;692;4;611.00;9
1172;4;624855652;1172;122;1867;1879;12.49;0.76;192.69;3.41;695;4;612.00;12
1177;4;624855664;1177;117;1869;1879;12.43;0.76;193.05;3.42;692;4;613.00;10
1179;4;624855674;1179;113;1869;1879;12.49;0.76;193.04;3.42;690;4;614.00;10
1185;4;624855683;1185;110;1871;1879;12.42;0.76;193.55;3.42;686;4;615.00;8
1187;4;624855693;1187;106;1872;1879;12.44;0.76;193.65;3.43;685;4;616.00;7
1195;4;624855703;1195;111;1872;1879;12.50;0.76;193.89;3.43;677;4;617.00;7
1198;4;624855715;1198;108;1875;1883;12.58;0.76;193.90;3.42;677;4;618.00;8
1204;4;624855726;1204;105;1875;1883;12.66;0.77;194.08;3.42;671;4;619.00;8
1207;4;624855736;1207;103;1879;1887;12.71;0.77;194.24;3.43;672;4;620.00;8
1212;4;624855746;1212;101;1881;1888;12.68;0.77;194.43;3.44;669;4;621.00;7
1215;4;624855755;1215;98;1882;1888;12.70;0.77;194.38;3.43;667;4;622.00;6
1217;4;624855765;1217;97;1882;1888;12.74;0.77;194.40;3.43;665;4;623.00;6
1220;4;624855775;1220;97;1890;1901;12.65;0.77;194.53;3.42;670;4;624.00;11
1223;4;624855786;1223;103;1890;1901;12.67;0.77;194.57;3.42;667;4;625.00;11
1227;4;624855795;1227;104;1890;1901;12.53;0.76;194.80;3.42;663;4;626.00;11
1230;4;624855805;1230;112;1894;1902;12.47;0.75;195.31;3.45;664;4;627.00;8
1231;4;624855815;1231;111;1894;1903;12.46;0.75;195.37;3.45;663;4;628.00;9
1233;4;624855824;1233;113;1895;1903;12.32;0.75;195.43;3.45;662;4;629.00;8
1233;5;624855842;1233;115;1899;1909;12.36;0.75;195.43;3.44;666;5;630.00;10
1239;5;624855859;1239;117;1900;1909;12.26;0.74;195.55;3.44;661;5;631.00;9
1242;5;624855869;1242;121;1901;1909;12.30;0.75;195.41;3.44;659;5;632.00;8
1245;5;624855878;1245;126;1902;1909;12.28;0.74;195.27;3.46;657;5;633.00;7
1246;5;624855888;1246;126;1907;1915;12.24;0.74;195.33;3.45;661;5;634.00;8
1249;5;624855898;1249;124;1907;1915;12.12;0.73;195.05;3.45;658;5;635.00;8
1249;5;624855908;1249;127;1907;1915;12.03;0.73;195.05;3.45;658;5;636.00;8
1250;5;624855917;1250;133;1907;1915;11.99;0.73;195.00;3.45;657;5;637.00;8
1251;5;624855926;1251;140;1910;1919;11.89;0.72;195.07;3.45;659;5;638.00;9
1255;5;624855935;1255;151;1913;1920;11.76;0.71;195.14;3.47;658;5;639.00;7
1256;5;624855945;1256;156;1915;1920;11.55;0.70;195.07;3.48;659;5;640.00;5
1256;5;624855953;1256;164;1917;1921;11.43;0.70;195.07;3.49;661;5;641.00;4
1258;5;624855963;1258;167;1917;1921;11.23;0.68;194.86;3.49;659;5;642.00;4
1258;5;624855977;1258;170;1917;1921;11.11;0.68;194.86;3.49;659;5;643.00;4
1262;5;624855985;1262;177;1918;1921;10.97;0.67;194.79;3.50;656;5;644.00;3
1263;5;624855993;1263;183;1918;1921;10.84;0.66;194.69;3.50;655;5;645.00;3
1264;5;624856002;1264;187;1920;1921;10.71;0.65;194.70;3.51;656;5;646.00;1
1265;5;624856012;1265;192;1920;1921;10.61;0.65;194.71;3.51;655;5;647.00;1
1266;5;624856021;1266;203;1957;1991;10.54;0.64;194.83;3.45;691;5;648.00;34
1267;5;624856035;1267;200;1960;1992;10.38;0.64;194.84;3.45;693;5;649.00;32
1269;5;624856044;1269;208;1969;1992;10.36;0.63;194.75;3.44;700;5;650.00;23
1269;5;624856052;1269;211;1974;1992;10.28;0.63;194.75;3.44;705;5;651.00;18
1272;5;624856062;1272;211;1977;1992;10.08;0.62;194.52;3.44;705;5;652.00;15
1273;5;624856070;1273;211;1981;1992;9.99;0.61;194.42;3.45;708;5;653.00;11
1276;5;624856078;1276;216;1984;1992;9.88;0.61;194.41;3.45;708;5;654.00;8
1278;5;624856086;1278;220;1986;1992;9.75;0.60;194.33;3.45;708;5;655.00;6
1281;5;624856095;1281;222;1987;1993;9.61;0.59;194.10;3.45;706;5;656.00;6
1282;5;624856103;1282;228;1990;1994;9.48;0.58;194.03;3.46;708;5;657.00;4
1284;5;624856112;1284;235;1992;1994;9.34;0.57;193.91;3.47;708;5;658.00;2
1284;5;624856119;1284;231;1996;1998;9.21;0.56;193.91;3.46;712;5;659.00;2
1286;5;624856129;1286;236;1997;1998;9.07;0.55;193.71;3.47;711;5;660.00;1
1287;5;624856137;1287;234;1998;1998;8.92;0.55;193.79;3.47;711;5;661.00;0
1288;5;624856145;1288;240;1998;1998;8.77;0.54;193.66;3.47;710;5;662.00;0
1289;5;624856153;1289;242;2004;2004;8.68;0.53;193.71;3.46;715;5;663.00;0
1289;5;624856161;1289;248;2004;2004;8.59;0.53;193.71;3.46;715;5;664.00;0
1294;5;624856169;1294;249;2004;2004;8.50;0.52;193.55;3.46;710;5;665.00;0
1294;5;624856179;1294;256;2006;2007;8.44;0.52;193.55;3.46;712;5;666.00;1
1295;5;624856187;1295;257;2006;2007;8.33;0.51;193.47;3.46;711;5;667.00;1
1299;5;624856195;1299;264;2007;2007;8.26;0.50;193.39;3.45;708;5;668.00;0
1301;5;624856203;1301;268;2008;2008;8.05;0.49;193.30;3.45;707;5;669.00;0
1304;5;624856210;1304;265;2009;2009;7.92;0.48;193.20;3.45;705;5;670.00;0
1305;5;624856218;1305;275;2009;2009;7.80;0.47;193.19;3.45;704;5;671.00;0
1308;5;624856225;1308;281;2022;2022;7.66;0.47;193.10;3.43;714;5;672.00;0
1313;5;624856234;1313;284;2022;2022;7.50;0.46;193.06;3.43;709;5;673.00;0
1314;5;624856242;1314;284;2022;2022;7.41;0.45;192.93;3.43;708;5;674.00;0
1320;5;624856249;1320;277;2024;2024;7.29;0.45;192.74;3.43;704;5;675.00;0
1322;5;624856258;1322;265;2024;2024;7.28;0.44;193.03;3.43;702;5;676.00;0
1327;5;624856266;1327;256;2028;2028;7.23;0.44;193.37;3.42;701;5;677.00;0
1329;5;624856274;1329;258;2028;2028;7.17;0.44;193.52;3.42;699;5;678.00;0
1331;5;624856282;1331;259;2032;2032;7.09;0.43;193.78;3.42;701;5;679.00;0
1335;5;624856290;1335;249;2032;2032;7.07;0.43;194.29;3.42;697;5;680.00;0
1337;5;624856297;1337;242;2032;2032;7.12;0.44;194.06;3.42;695;5;681.00;0
1341;5;624856305;1341;229;2032;2032;7.13;0.44;194.45;3.42;691;5;682.00;0
1344;5;624856313;1344;231;2032;2032;7.17;0.44;194.77;3.42;688;5;683.00;0
1346;5;624856320;1346;226;2043;2044;7.32;0.45;195.08;3.40;697;5;684.00;1
1351;5;624856329;1351;228;2043;2044;7.36;0.45;195.21;3.40;692;5;685.00;1
1353;5;624856336;1353;219;2044;2044;7.50;0.46;195.43;3.40;691;5;686.00;0
1354;5;624856349;1354;210;2044;2044;7.65;0.47;195.64;3.40;690;5;687.00;0
1356;5;624856357;1356;203;2044;2044;7.80;0.48;195.88;3.40;688;5;688.00;0
1358;5;624856371;1358;199;2044;2044;7.89;0.48;196.13;3.40;686;5;689.00;0
1359;5;624856380;1359;196;2045;2045;8.02;0.49;196.09;3.40;686;5;690.00;0
1361;5;624856388;1361;198;2045;2045;8.07;0.49;196.19;3.40;684;5;691.00;0
1363;5;624856397;1363;191;2051;2051;8.26;0.51;196.11;3.39;688;5;692.00;0
1366;5;624856406;1366;193;2052;2052;8.39;0.51;196.28;3.39;686;5;693.00;0
1370;5;624856418;1370;194;2052;2052;8.50;0.52;196.49;3.39;682;5;694.00;0
1373;5;624856427;1373;194;2052;2052;8.62;0.53;196.34;3.39;679;5;695.00;0
1375;5;624856436;1375;194;2056;2056;8.77;0.54;196.69;3.38;681;5;696.00;0
1378;5;624856445;1378;190;2056;2056;8.86;0.54;196.89;3.38;678;5;697.00;0
1380;5;624856529;1380;182;2056;2056;8.87;0.54;196.78;3.38;676;5;698.00;0
1386;5;624856539;1386;183;2057;2057;8.80;0.54;196.77;3.38;671;5;699.00;0
1388;5;624856551;1388;187;2061;2061;8.75;0.53;196.80;3.38;673;5;700.00;0
1393;5;624856565;1393;189;2061;2061;8.70;0.53;196.84;3.38;668;5;701.00;0
1397;5;624856574;1397;190;2063;2064;8.61;0.53;196.96;3.37;666;5;702.00;1
1401;5;624856583;1401;186;2063;2064;8.57;0.52;197.00;3.37;662;5;703.00;1
1405;5;624856592;1405;179;2064;2064;8.57;0.52;197.01;3.37;659;5;704.00;0
1409;5;624856601;1409;182;2064;2064;8.61;0.53;197.13;3.37;655;5;705.00;0
1412;5;624856609;1412;183;2068;2068;8.62;0.53;197.43;3.37;656;5;706.00;0
1416;5;624856618;1416;185;2068;2068;8.62;0.53;197.51;3.37;652;5;707.00;0
1423;5;624856626;1423;181;2068;2068;8.58;0.52;197.38;3.37;645;5;708.00;0
1428;5;624856634;1428;179;2068;2068;8.55;0.52;197.50;3.37;640;5;709.00;0
1432;5;624856643;1432;177;2069;2069;8.53;0.52;197.65;3.37;637;5;710.00;0
1432;5;624856652;1432;174;2070;2070;8.63;0.53;197.65;3.36;638;5;711.00;0
1437;5;624856660;1437;176;2070;2070;8.59;0.52;197.85;3.36;633;5;712.00;0
1441;5;624856669;1441;176;2071;2071;8.61;0.53;198.17;3.36;630;5;713.00;0
1444;5;624856678;1444;180;2071;2071;8.60;0.53;198.28;3.36;627;5;714.00;0
1450;5;624856686;1450;175;2071;2071;8.57;0.52;198.32;3.36;621;5;715.00;0
1451;5;624856694;1451;176;2071;2071;8.64;0.53;198.42;3.36;620;5;716.00;0
1456;5;624856703;1456;180;2071;2071;8.55;0.52;198.69;3.36;615;5;717.00;0
1458;5;624856717;1458;181;2071;2071;8.51;0.52;198.67;3.36;613;5;718.00;0
1461;5;624856731;1461;172;2071;2071;8.48;0.51;198.68;3.36;610;5;719.00;0
1466;5;624856748;1466;207;2195;2301;8.61;0.54;198.81;3.17;729;5;720.00;106
1468;5;624856800;1468;197;2205;2302;8.58;0.54;198.93;3.16;737;5;721.00;97
1469;5;624856821;1469;181;2220;2302;8.62;0.54;198.98;3.16;751;5;722.00;82
1471;5;624856836;1471;176;2230;2302;8.59;0.54;198.97;3.16;759;5;723.00;72
1475;5;624856848;1475;173;2237;2302;8.62;0.54;199.10;3.16;762;5;724.00;65
1475;5;624856860;1475;170;2242;2302;8.63;0.54;199.10;3.16;767;5;725.00;60
1479;5;624856870;1479;171;2249;2302;8.59;0.54;199.27;3.17;770;5;726.00;53
1480;5;624856882;1480;161;2253;2302;8.63;0.54;199.24;3.18;773;5;727.00;49
1482;5;624856894;1482;157;2261;2303;8.68;0.54;199.33;3.20;779;5;728.00;42
1484;5;624856907;1484;157;2265;2304;8.70;0.54;199.41;3.21;781;5;729.00;39
1485;5;624856921;1485;154;2270;2304;8.75;0.54;199.57;3.22;785;5;730.00;34
1488;5;624856933;1488;160;2274;2305;8.76;0.54;199.53;3.23;786;5;731.00;31
1491;5;624856945;1491;169;2276;2305;8.72;0.54;199.60;3.24;785;5;732.00;29
1493;5;624856957;1493;174;2279;2305;8.75;0.54;199.87;3.25;786;5;733.00;26
1497;5;624856971;1497;181;2280;2305;8.78;0.54;199.95;3.26;783;5;734.00;25
1501;5;624856990;1501;185;2283;2309;8.75;0.54;200.30;3.26;782;5;735.00;26
1505;5;624857002;1505;181;2285;2309;8.80;0.54;200.36;3.27;780;5;736.00;24
1506;5;624857014;1506;181;2286;2309;8.95;0.55;200.42;3.27;780;5;737.00;23
1507;5;624857026;1507;181;2288;2312;9.00;0.55;200.65;3.27;781;5;738.00;24
1511;5;624857037;1511;177;2288;2312;9.06;0.56;200.68;3.27;777;5;739.00;24
1513;5;624857049;1513;174;2288;2312;9.14;0.56;200.44;3.27;775;5;740.00;24
1516;5;624857061;1516;171;2293;2316;9.23;0.57;200.65;3.28;777;5;741.00;23
1519;5;624857073;1519;169;2294;2317;9.37;0.57;200.86;3.27;775;5;742.00;23
1521;5;624857091;1521;165;2296;2317;9.52;0.58;200.87;3.29;775;5;743.00;21
1524;5;624857108;1524;171;2299;2321;9.59;0.59;201.09;3.28;775;5;744.00;22
1529;5;624857120;1529;166;2300;2321;9.73;0.60;201.36;3.28;771;5;745.00;21
1529;5;624857138;1529;170;2302;2321;9.89;0.61;201.36;3.30;773;5;746.00;19
1530;5;624857149;1530;167;2302;2322;10.03;0.62;201.55;3.30;772;5;747.00;20
1533;5;624857161;1533;166;2303;2322;10.23;0.63;201.60;3.31;770;5;748.00;19
1535;5;624857173;1535;163;2309;2328;10.40;0.64;201.54;3.32;774;5;749.00;19
1540;5;624857187;1540;161;2310;2328;10.53;0.64;201.82;3.33;770;5;750.00;18
1542;5;624857198;1542;156;2312;2329;10.71;0.66;201.98;3.34;770;5;751.00;17
1544;5;624857210;1544;157;2313;2329;10.80;0.66;202.04;3.35;769;5;752.00;16
1549;5;624857222;1549;153;2314;2329;10.89;0.67;202.22;3.36;765;5;753.00;15
1553;5;624857233;1553;153;2314;2329;10.99;0.67;202.46;3.36;761;5;754.00;15
1554;5;624857244;1554;153;2315;2329;11.07;0.68;202.51;3.37;761;5;755.00;14
1558;5;624857256;1558;159;2326;2341;11.09;0.68;202.58;3.36;768;5;756.00;15
1560;5;624857269;1560;153;2327;2341;11.22;0.69;202.49;3.36;767;5;757.00;14
1563;5;624857281;1563;150;2330;2341;11.33;0.69;202.81;3.38;767;5;758.00;11
1568;5;624857292;1568;149;2331;2341;11.45;0.70;202.84;3.38;763;5;759.00;10
1570;5;624857303;1570;149;2331;2341;11.57;0.71;203.09;3.38;761;5;760.00;10
1571;5;624857315;1571;153;2331;2341;11.63;0.71;203.17;3.38;760;5;761.00;10
1575;5;624857326;1575;153;2335;2345;11.58;0.71;203.06;3.37;760;5;762.00;10
1581;5;624857338;1581;152;2335;2345;11.67;0.71;203.58;3.37;754;5;763.00;10
1584;5;624857349;1584;151;2339;2349;11.79;0.72;203.66;3.37;755;5;764.00;10
1588;5;624857360;1588;155;2341;2351;11.82;0.72;203.87;3.37;753;5;765.00;10
1590;5;624857371;1590;157;2341;2351;11.82;0.72;204.11;3.37;751;5;766.00;10
1595;5;624857382;1595;157;2341;2351;11.82;0.72;204.42;3.37;746;5;767.00;10
1598;5;624857392;1598;160;2351;2364;11.85;0.72;204.75;3.35;753;5;768.00;13
1602;5;624857410;1602;160;2351;2364;11.90;0.73;205.18;3.35;749;5;769.00;13
1606;5;624857421;1606;161;2351;2364;11.94;0.73;205.38;3.35;745;5;770.00;13
1614;5;624857432;1614;160;2352;2365;11.88;0.72;206.05;3.35;738;5;771.00;13
1616;5;624857443;1616;162;2352;2366;11.87;0.72;206.20;3.35;736;5;772.00;14
1621;5;624857453;1621;162;2352;2366;11.82;0.72;206.12;3.35;731;5;773.00;14
1625;5;624857464;1625;163;2354;2369;11.87;0.72;206.18;3.35;729;5;774.00;15
1627;5;624857475;1627;162;2355;2369;11.82;0.72;206.27;3.37;728;5;775.00;14
1633;5;624857486;1633;157;2356;2369;11.81;0.72;206.06;3.37;723;5;776.00;13
1636;5;624857497;1636;160;2356;2369;11.78;0.72;206.33;3.37;720;5;777.00;13
1639;5;624857506;1639;165;2361;2375;11.75;0.71;206.67;3.37;722;5;778.00;14
1642;5;624857518;1642;165;2361;2375;11.74;0.71;206.74;3.37;719;5;779.00;14
1646;5;624857530;1646;165;2361;2375;11.71;0.71;207.11;3.37;715;5;780.00;14
1651;5;624857541;1651;164;2361;2375;11.64;0.71;207.35;3.37;710;5;781.00;14
1654;5;624857551;1654;157;2364;2379;11.59;0.71;207.39;3.36;710;5;782.00;15
1657;5;624857561;1657;159;2365;2380;11.49;0.70;207.43;3.36;708;5;783.00;15
1661;5;624857572;1661;152;2365;2380;11.44;0.70;207.56;3.36;704;5;784.00;15
1667;5;624857583;1667;149;2368;2381;11.30;0.69;207.85;3.37;701;5;785.00;13
1669;5;624857594;1669;144;2368;2381;11.19;0.68;207.75;3.37;699;5;786.00;13
1671;5;624857605;1671;146;2368;2381;11.12;0.68;207.93;3.37;697;5;787.00;13
1675;5;624857615;1675;145;2368;2381;11.12;0.68;208.24;3.37;693;5;788.00;13
1678;5;624857625;1678;149;2368;2381;11.13;0.68;208.07;3.37;690;5;789.00;13
1681;5;624857635;1681;151;2368;2381;11.13;0.68;208.04;3.37;687;5;790.00;13
1685;5;624857646;1685;151;2368;2381;11.16;0.68;208.01;3.37;683;5;791.00;13
1687;5;624857657;1687;151;2402;2451;11.10;0.68;208.04;3.32;715;5;792.00;49
1690;5;624857673;1690;148;2402;2452;11.02;0.67;207.86;3.32;712;5;793.00;50
1692;5;624857683;1692;144;2409;2452;11.06;0.67;207.88;3.32;717;5;794.00;43
1693;5;624857694;1693;151;2412;2452;10.95;0.67;207.82;3.32;719;5;795.00;40
1696;5;624857704;1696;154;2415;2452;10.85;0.66;207.68;3.32;719;5;796.00;37
1699;5;624857716;1699;158;2418;2452;10.83;0.66;207.72;3.35;719;5;797.00;34
1700;5;624857726;1700;159;2422;2452;10.82;0.66;207.63;3.36;722;5;798.00;30
1701;5;624857736;1701;156;2426;2452;10.82;0.66;207.56;3.39;725;5;799.00;26
1702;5;624857747;1702;160;2430;2453;10.84;0.66;207.56;3.40;728;5;800.00;23
1704;5;624857761;1704;165;2432;2454;10.84;0.66;207.46;3.40;728;5;801.00;22
1706;5;624857771;1706;170;2434;2454;10.71;0.65;207.31;3.44;728;5;802.00;20
1708;5;624857785;1708;172;2440;2458;10.67;0.65;207.32;3.44;732;5;803.00;18
1711;5;624857795;1711;176;2441;2458;10.54;0.64;207.29;3.44;730;5;804.00;17
1712;5;624857804;1712;179;2442;2458;10.38;0.63;207.26;3.47;730;5;805.00;16
1715;5;624857813;1715;180;2442;2458;10.21;0.62;207.14;3.47;727;5;806.00;16
1717;5;624857822;1717;189;2447;2464;10.10;0.61;207.06;3.47;730;5;807.00;17
1719;5;624857831;1719;197;2448;2464;9.99;0.61;207.00;3.50;729;5;808.00;16
1721;5;624857840;1721;206;2448;2464;9.91;0.60;206.93;3.50;727;5;809.00;16
1723;5;624857851;1723;219;2453;2470;9.80;0.60;206.79;3.51;730;5;810.00;17
1725;5;624857860;1725;218;2456;2470;9.66;0.59;206.65;3.56;731;5;811.00;14
1727;5;624857869;1727;226;2457;2470;9.50;0.58;206.57;3.56;730;5;812.00;13
1731;5;624857878;1731;233;2461;2471;9.25;0.56;206.84;3.64;730;5;813.00;10
1731;5;624857887;1731;236;2463;2472;9.13;0.56;206.84;3.68;732;5;814.00;9
1732;5;624857896;1732;241;2465;2472;8.99;0.55;206.77;3.70;733;5;815.00;7
1734;5;624857904;1734;249;2476;2485;8.86;0.54;206.67;3.71;742;5;816.00;9
1736;5;624857913;1736;256;2476;2485;8.80;0.54;206.50;3.71;740;5;817.00;9
1740;5;624857921;1740;262;2477;2485;8.65;0.53;206.27;3.72;737;5;818.00;8
1741;5;624857929;1741;270;2479;2486;8.55;0.52;206.36;3.73;738;5;819.00;7
1743;5;624857937;1743;274;2481;2486;8.46;0.52;206.29;3.74;738;5;820.00;5
1747;5;624857945;1747;281;2486;2490;8.43;0.52;206.05;3.74;739;5;821.00;4
1749;5;624857954;1749;289;2488;2490;8.40;0.51;205.93;3.74;739;5;822.00;2
1751;5;624857963;1751;297;2492;2494;8.38;0.51;205.91;3.74;741;5;823.00;2
1752;5;624857971;1752;301;2493;2494;8.41;0.52;205.89;3.74;741;5;824.00;1
1754;5;624857979;1754;304;2494;2494;8.36;0.51;205.86;3.74;740;5;825.00;0
1756;5;624857988;1756;311;2494;2494;8.22;0.50;205.70;3.74;738;5;826.00;0
1759;5;624857996;1759;304;2494;2494;8.06;0.49;205.62;3.74;735;5;827.00;0
1760;5;624858004;1760;302;2505;2506;8.07;0.49;205.58;3.72;745;5;828.00;1
1761;5;624858013;1761;296;2506;2506;8.03;0.49;205.64;3.72;745;5;829.00;0
1761;5;624858022;1761;288;2506;2506;8.02;0.49;205.64;3.72;745;5;830.00;0
1765;5;624858031;1765;288;2506;2506;8.00;0.49;205.69;3.72;741;5;831.00;0
1765;5;624858039;1765;287;2506;2506;8.06;0.50;205.69;3.72;741;5;832.00;0
1766;5;624858048;1766;284;2506;2506;8.08;0.50;205.65;3.72;740;5;833.00;0
1768;5;624858063;1768;281;2507;2507;8.11;0.50;205.52;3.72;739;5;834.00;0
1768;5;624858072;1768;276;2507;2507;8.19;0.50;205.52;3.72;739;5;835.00;0
1770;5;624858080;1770;274;2513;2513;8.29;0.51;205.54;3.72;743;5;836.00;0
1771;5;624858090;1771;270;2514;2514;8.39;0.51;205.53;3.71;743;5;837.00;0
1773;5;624858098;1773;272;2514;2514;8.44;0.52;205.40;3.71;741;5;838.00;0
1773;5;624858107;1773;266;2514;2514;8.45;0.52;205.40;3.71;741;5;839.00;0
1774;6;624858117;1774;264;2519;2519;8.51;0.52;205.35;3.71;745;6;840.00;0
1776;6;624858132;1776;262;2519;2519;8.54;0.52;205.25;3.71;743;6;841.00;0
1779;6;624858141;1779;267;2519;2519;8.50;0.52;205.34;3.71;740;6;842.00;0
1783;6;624858149;1783;261;2520;2520;8.43;0.52;205.32;3.71;737;6;843.00;0
1786;6;624858158;1786;258;2524;2524;8.37;0.51;205.38;3.70;738;6;844.00;0
1788;6;624858166;1788;256;2524;2524;8.31;0.51;205.47;3.70;736;6;845.00;0
1792;6;624858175;1792;252;2526;2527;8.24;0.50;205.51;3.70;734;6;846.00;1
1793;6;624858188;1793;251;2527;2527;8.18;0.50;205.63;3.70;734;6;847.00;0
1796;6;624858197;1796;253;2527;2527;8.11;0.50;205.60;3.70;731;6;848.00;0
1801;6;624858204;1801;255;2527;2527;8.03;0.49;205.98;3.70;726;6;849.00;0
1806;6;624858213;1806;246;2531;2531;8.03;0.49;206.06;3.69;725;6;850.00;0
1810;6;624858222;1810;239;2531;2531;7.99;0.49;206.39;3.69;721;6;851.00;0
1813;6;624858230;1813;234;2531;2531;7.94;0.49;206.39;3.69;718;6;852.00;0
1819;6;624858238;1819;234;2531;2531;7.94;0.49;206.67;3.69;712;6;853.00;0
1822;6;624858246;1822;228;2532;2532;7.90;0.48;206.89;3.69;710;6;854.00;0
1826;6;624858255;1826;222;2534;2534;7.99;0.49;206.68;3.69;708;6;855.00;0
1832;6;624858263;1832;222;2534;2534;7.98;0.49;206.80;3.69;702;6;856.00;0
1837;6;624858272;1837;213;2535;2535;8.04;0.49;207.05;3.69;698;6;857.00;0
1839;6;624858280;1839;205;2535;2535;8.17;0.50;207.19;3.69;696;6;858.00;0
1842;6;624858289;1842;203;2535;2535;8.28;0.51;207.33;3.69;693;6;859.00;0
1847;6;624858297;1847;195;2535;2535;8.33;0.51;207.50;3.69;688;6;860.00;0
1849;6;624858305;1849;191;2535;2535;8.44;0.52;207.60;3.69;686;6;861.00;0
1852;6;624858313;1852;195;2535;2535;8.56;0.52;207.69;3.69;683;6;862.00;0
1854;6;624858321;1854;193;2535;2535;8.61;0.53;207.84;3.69;681;6;863.00;0
1856;6;624858330;1856;199;2615;2662;8.91;0.55;207.84;3.58;759;6;864.00;47
1859;6;624858348;1859;197;2619;2663;8.89;0.55;207.97;3.57;760;6;865.00;44
1865;6;624858357;1865;204;2626;2663;8.87;0.55;208.02;3.57;761;6;866.00;37
1866;6;624858367;1866;203;2627;2663;8.81;0.55;207.98;3.57;761;6;867.00;36
1870;6;624858376;1870;200;2633;2663;8.69;0.54;208.17;3.57;763;6;868.00;30
1873;6;624858385;1873;197;2634;2663;8.52;0.53;208.15;3.57;761;6;869.00;29
1876;6;624858396;1876;197;2637;2663;8.42;0.52;208.60;3.57;761;6;870.00;26
1884;6;624858405;1884;195;2638;2663;8.31;0.51;208.51;3.57;754;6;871.00;25
1888;6;624858415;1888;201;2640;2664;8.29;0.51;208.60;3.58;752;6;872.00;24
1893;6;624858425;1893;205;2644;2665;8.27;0.51;208.71;3.59;751;6;873.00;21
1896;6;624858435;1896;211;2645;2665;8.29;0.51;208.75;3.59;749;6;874.00;20
1899;6;624858445;1899;213;2649;2666;8.32;0.51;208.87;3.60;750;6;875.00;17
1903;6;624858454;1903;219;2650;2666;8.34;0.51;208.86;3.60;747;6;876.00;16
1907;6;624858463;1907;219;2652;2666;8.45;0.52;209.11;3.61;745;6;877.00;14
1911;6;624858472;1911;222;2654;2666;8.51;0.52;209.58;3.61;743;6;878.00;12
1915;6;624858482;1915;230;2660;2670;8.50;0.52;209.75;3.63;745;6;879.00;10
1919;6;624858492;1919;231;2663;2670;8.47;0.52;209.83;3.64;744;6;880.00;7
1920;6;624858502;1920;232;2664;2670;8.48;0.52;209.80;3.64;744;6;881.00;6
1925;6;624858511;1925;232;2667;2673;8.46;0.52;209.88;3.65;742;6;882.00;6
1932;6;624858521;1932;235;2668;2673;8.47;0.52;209.79;3.65;736;6;883.00;5
1933;6;624858530;1933;236;2670;2673;8.52;0.52;209.84;3.66;737;6;884.00;3
1937;6;624858540;1937;233;2675;2677;8.59;0.52;209.89;3.66;738;6;885.00;2
1941;6;624858549;1941;231;2677;2678;8.60;0.52;210.02;3.66;736;6;886.00;1
1946;6;624858559;1946;233;2677;2678;8.60;0.52;209.87;3.66;731;6;887.00;1
1950;6;624858569;1950;233;2682;2682;8.60;0.52;209.89;3.66;732;6;888.00;0
1953;6;624858579;1953;231;2682;2682;8.62;0.52;209.84;3.66;729;6;889.00;0
1957;6;624858588;1957;232;2682;2682;8.59;0.52;210.03;3.66;725;6;890.00;0
1962;6;624858597;1962;235;2683;2683;8.59;0.52;210.09;3.65;721;6;891.00;0
1964;6;624858607;1964;232;2683;2683;8.65;0.53;210.15;3.65;719;6;892.00;0
1967;6;624858616;1967;236;2689;2689;8.70;0.53;210.44;3.65;722;6;893.00;0
1971;6;624858626;1971;230;2689;2689;8.69;0.53;210.57;3.65;718;6;894.00;0
1973;6;624858636;1973;231;2690;2690;8.73;0.53;210.68;3.65;717;6;895.00;0
1975;6;624858645;1975;230;2690;2690;8.76;0.54;210.67;3.65;715;6;896.00;0
1977;6;624858655;1977;214;2690;2690;8.80;0.54;210.81;3.65;713;6;897.00;0
1981;6;624858665;1981;207;2690;2690;8.91;0.54;210.93;3.65;709;6;898.00;0
1983;6;624858674;1983;199;2690;2690;9.08;0.55;210.99;3.65;707;6;899.00;0
1985;6;624858686;1985;196;2721;2736;9.17;0.56;211.06;3.61;736;6;900.00;15
1989;6;624858704;1989;186;2721;2736;9.28;0.57;211.46;3.61;732;6;901.00;15
1991;6;624858720;1991;187;2725;2736;9.38;0.58;211.61;3.60;734;6;902.00;11
1991;6;624858739;1991;181;2725;2736;9.49;0.58;211.61;3.60;734;6;903.00;11
1992;6;624858754;1992;181;2727;2736;9.56;0.59;211.76;3.60;735;6;904.00;9
1994;6;624858771;1994;183;2727;2736;9.64;0.59;211.89;3.60;733;6;905.00;9
1996;6;624858787;1996;173;2732;2740;9.66;0.59;211.75;3.60;736;6;906.00;8
1999;6;624858802;1999;165;2733;2740;9.66;0.59;211.85;3.60;734;6;907.00;7
2005;6;624858819;2005;160;2737;2744;9.69;0.59;211.99;3.60;732;6;908.00;7
2007;6;624858834;2007;151;2738;2745;9.76;0.60;211.97;3.60;731;6;909.00;7
2012;6;624858847;2012;147;2738;2745;9.81;0.60;212.08;3.60;726;6;910.00;7
2016;6;624858858;2016;149;2738;2745;9.82;0.60;212.33;3.60;722;6;911.00;7
2017;6;624858870;2017;150;2751;2758;9.94;0.61;212.36;3.59;734;6;912.00;7
2018;6;624858882;2018;143;2751;2758;10.04;0.61;212.48;3.59;733;6;913.00;7
2020;6;624858894;2020;134;2752;2758;10.17;0.62;212.63;3.59;732;6;914.00;6
2021;6;624858906;2021;128;2753;2759;10.28;0.63;212.62;3.59;732;6;915.00;6
2023;6;624858919;2023;129;2754;2760;10.31;0.63;212.74;3.59;731;6;916.00;6
2028;6;624858932;2028;122;2755;2760;10.21;0.62;212.84;3.59;727;6;917.00;5
2030;6;624858947;2030;123;2757;2763;10.26;0.62;212.89;3.59;727;6;918.00;6
2034;6;624858961;2034;122;2757;2763;10.32;0.63;213.00;3.59;723;6;919.00;6
2038;6;624858973;2038;133;2759;2763;10.28;0.63;213.11;3.60;721;6;920.00;4
2040;6;624858985;2040;126;2759;2763;10.35;0.63;213.24;3.60;719;6;921.00;4
2041;6;624858998;2041;134;2764;2769;10.43;0.63;213.19;3.59;723;6;922.00;5
2044;6;624859010;2044;127;2765;2769;10.50;0.64;213.30;3.60;721;6;923.00;4
2045;6;624859021;2045;130;2765;2769;10.53;0.64;213.37;3.60;720;6;924.00;4
2048;6;624859031;2048;132;2765;2769;10.68;0.65;213.49;3.60;717;6;925.00;4
2051;6;624859041;2051;133;2772;2773;10.60;0.64;213.45;3.61;721;6;926.00;1
2053;6;624859052;2053;131;2774;2774;10.76;0.65;213.43;3.61;721;6;927.00;0
2057;6;624859062;2057;130;2774;2774;10.79;0.66;213.64;3.61;717;6;928.00;0
2061;6;624859073;2061;138;2775;2775;10.84;0.66;213.81;3.61;714;6;929.00;0
2064;6;624859085;2064;139;2775;2775;10.90;0.66;213.87;3.61;711;6;930.00;0
2068;6;624859095;2068;138;2775;2775;10.95;0.66;214.08;3.61;707;6;931.00;0
2069;6;624859105;2069;143;2775;2775;10.93;0.66;214.20;3.61;706;6;932.00;0
2072;6;624859122;2072;142;2775;2775;10.83;0.66;214.31;3.61;703;6;933.00;0
2073;6;624859133;2073;146;2775;2775;10.87;0.66;214.24;3.61;702;6;934.00;0
2076;6;624859143;2076;147;2775;2775;10.91;0.66;214.33;3.61;699;6;935.00;0
2080;6;624859154;2080;162;2815;2845;10.70;0.65;214.34;3.56;735;6;936.00;30
2080;6;624859171;2080;153;2815;2846;10.82;0.66;214.34;3.56;735;6;937.00;31
2085;6;624859182;2085;155;2821;2846;10.87;0.66;214.36;3.56;736;6;938.00;25
2086;6;624859193;2086;155;2822;2846;10.90;0.67;214.51;3.56;736;6;939.00;24
2091;6;624859204;2091;160;2825;2846;10.91;0.67;214.40;3.56;734;6;940.00;21
2094;6;624859226;2094;160;2828;2846;10.96;0.67;214.45;3.56;734;6;941.00;18
2096;6;624859236;2096;163;2831;2846;11.00;0.67;214.41;3.56;735;6;942.00;15
2099;6;624859249;2099;168;2834;2846;11.04;0.67;214.39;3.56;735;6;943.00;12
2103;6;624859259;2103;173;2837;2847;11.00;0.67;214.35;3.57;734;6;944.00;10
2105;6;624859270;2105;172;2840;2849;10.94;0.67;214.40;3.57;735;6;945.00;9
2112;6;624859281;2112;174;2841;2849;10.87;0.66;214.34;3.57;729;6;946.00;8
2116;6;624859292;2116;174;2845;2853;10.81;0.66;214.40;3.57;729;6;947.00;8
2120;6;624859303;2120;180;2846;2853;10.81;0.66;214.24;3.57;726;6;948.00;7
2124;6;624859314;2124;175;2846;2853;10.73;0.65;214.19;3.57;722;6;949.00;7
2126;6;624859328;2126;178;2846;2853;10.69;0.65;214.15;3.57;720;6;950.00;7
2127;6;624859339;2127;184;2850;2859;10.70;0.65;214.09;3.57;723;6;951.00;9
2129;6;624859349;2129;186;2850;2859;10.65;0.65;214.08;3.57;721;6;952.00;9
2134;6;624859358;2134;182;2850;2859;10.59;0.64;214.18;3.57;716;6;953.00;9
2137;6;624859368;2137;183;2852;2862;10.63;0.65;214.13;3.57;715;6;954.00;10
2138;6;624859378;2138;186;2856;2862;10.50;0.64;214.08;3.58;718;6;955.00;6
2141;6;624859388;2141;190;2857;2862;10.50;0.64;213.98;3.58;716;6;956.00;5
2148;6;624859397;2148;192;2857;2863;10.43;0.63;213.91;3.58;709;6;957.00;6
2150;6;624859406;2150;191;2858;2864;10.45;0.63;213.79;3.58;708;6;958.00;6
2152;6;624859416;2152;192;2858;2864;10.47;0.63;213.68;3.58;706;6;959.00;6
2153;6;624859426;2153;201;2876;2890;10.44;0.63;213.59;3.56;723;6;960.00;14
2157;6;624859437;2157;197;2876;2890;10.43;0.63;213.44;3.56;719;6;961.00;14
2159;6;624859446;2159;200;2879;2890;10.49;0.64;213.30;3.57;720;6;962.00;11
2162;6;624859455;2162;200;2881;2891;10.52;0.64;213.23;3.56;719;6;963.00;10
2166;6;624859465;2166;204;2881;2891;10.49;0.64;212.99;3.56;715;6;964.00;10
2167;6;624859475;2167;203;2884;2895;10.53;0.64;212.91;3.56;717;6;965.00;11
2169;6;624859484;2169;205;2885;2895;10.50;0.64;212.74;3.56;716;6;966.00;10
2169;6;624859493;2169;211;2888;2899;10.46;0.63;212.74;3.56;719;6;967.00;11
2170;6;624859502;2170;212;2888;2899;10.44;0.63;212.73;3.56;718;6;968.00;11
2170;6;624859511;2170;215;2889;2899;10.36;0.63;212.73;3.56;719;6;969.00;10
2171;6;624859520;2171;217;2889;2899;10.24;0.62;212.71;3.56;718;6;970.00;10
2174;6;624859529;2174;219;2891;2899;10.06;0.61;212.56;3.58;717;6;971.00;8
2175;6;624859538;2175;220;2902;2911;9.97;0.61;212.48;3.57;727;6;972.00;9
2176;6;624859549;2176;224;2903;2911;9.92;0.60;212.46;3.57;727;6;973.00;8
2176;6;624859558;2176;228;2904;2911;9.88;0.60;212.46;3.58;728;6;974.00;7
2178;6;624859567;2178;228;2905;2911;9.80;0.60;212.46;3.58;727;6;975.00;6
2180;6;624859576;2180;236;2905;2911;9.69;0.59;212.42;3.58;725;6;976.00;6
2181;6;624859586;2181;243;2905;2911;9.64;0.59;212.44;3.58;724;6;977.00;6
2184;6;624859595;2184;248;2905;2912;9.55;0.58;212.48;3.58;721;6;978.00;7
2184;6;624859604;2184;240;2905;2912;9.47;0.58;212.48;3.58;721;6;979.00;7
2186;7;624859613;2186;233;2911;2918;9.48;0.58;212.52;3.59;725;7;980.00;7
2188;7;624859649;2188;226;2913;2919;9.44;0.58;212.56;3.59;725;7;981.00;6
2190;7;624859659;2190;225;2913;2919;9.35;0.57;212.64;3.59;723;7;982.00;6
2192;7;624859668;2192;228;2914;2919;9.26;0.57;212.51;3.59;722;7;983.00;5
2195;7;624859678;2195;228;2918;2923;9.24;0.56;212.57;3.60;723;7;984.00;5
2197;7;624859687;2197;236;2918;2923;9.06;0.55;212.50;3.60;721;7;985.00;5
2197;7;624859715;2197;241;2919;2923;9.01;0.55;212.50;3.61;722;7;986.00;4
2198;7;624859725;2198;243;2921;2924;8.98;0.55;212.47;3.61;723;7;987.00;3
2200;7;624859734;2200;241;2925;2928;8.90;0.54;212.30;3.61;725;7;988.00;3
2203;7;624859743;2203;241;2927;2928;8.79;0.54;212.33;3.61;724;7;989.00;1
2204;7;624859754;2204;239;2931;2934;8.74;0.53;212.32;3.61;727;7;990.00;3
2204;7;624859763;2204;236;2933;2934;8.77;0.53;212.32;3.61;729;7;991.00;1
2205;7;624859772;2205;230;2934;2934;8.76;0.54;212.27;3.61;729;7;992.00;0
2206;7;624859787;2206;229;2934;2934;8.77;0.54;212.28;3.61;728;7;993.00;0
2206;7;624859795;2206;226;2938;2938;8.84;0.54;212.28;3.61;732;7;994.00;0
2207;7;624859805;2207;227;2938;2938;8.83;0.54;212.26;3.61;731;7;995.00;0
2210;7;624859813;2210;228;2938;2938;8.76;0.54;212.23;3.61;728;7;996.00;0
2210;7;624859821;2210;229;2938;2938;8.65;0.53;212.23;3.61;728;7;997.00;0
2210;7;624859830;2210;236;2939;2939;8.50;0.52;212.23;3.60;729;7;998.00;0
2214;7;624859838;2214;239;2940;2940;8.33;0.51;212.31;3.60;726;7;999.00;0
2216;7;624859848;2216;237;2940;2940;8.29;0.51;212.27;3.60;724;7;1000.00;0
2218;7;624859861;2218;236;2941;2941;8.23;0.51;212.23;3.60;723;7;1001.00;0
2221;7;624859869;2221;233;2941;2941;8.13;0.50;212.18;3.60;720;7;1002.00;0
2223;7;624859878;2223;236;2941;2941;8.10;0.50;212.32;3.60;718;7;1003.00;0
2224;7;624859885;2224;233;2941;2941;8.08;0.50;212.35;3.60;717;7;1004.00;0
2226;7;624859894;2226;232;2941;2941;8.08;0.50;212.51;3.60;715;7;1005.00;0
2231;7;624859902;2231;233;2941;2941;8.02;0.49;212.75;3.60;710;7;1006.00;0
2234;7;624859911;2234;231;2941;2941;7.91;0.48;212.80;3.60;707;7;1007.00;0
2237;7;624859918;2237;250;3010;3068;8.04;0.50;212.83;3.52;773;7;1008.00;58
2240;7;624859936;2240;244;3013;3069;8.01;0.50;213.14;3.52;773;7;1009.00;56
2246;7;624859945;2246;236;3024;3069;8.08;0.50;213.27;3.51;778;7;1010.00;45
2248;7;624859953;2248;233;3030;3069;8.11;0.50;213.39;3.51;782;7;1011.00;39
2251;7;624859962;2251;233;3038;3069;8.15;0.50;213.30;3.51;787;7;1012.00;31
2255;7;624859970;2255;230;3042;3069;8.09;0.50;213.42;3.51;787;7;1013.00;27
2258;7;624859981;2258;231;3046;3069;8.06;0.50;213.46;3.52;788;7;1014.00;23
2259;7;624859995;2259;233;3048;3069;8.05;0.50;213.55;3.52;789;7;1015.00;21
2265;7;624860004;2265;233;3050;3070;7.96;0.49;213.65;3.52;785;7;1016.00;20
2267;7;624860013;2267;237;3051;3071;7.94;0.49;213.58;3.53;784;7;1017.00;20
2269;7;624860022;2269;233;3054;3071;7.88;0.49;213.70;3.53;785;7;1018.00;17
2274;7;624860031;2274;240;3058;3072;7.68;0.47;213.88;3.54;784;7;1019.00;14
2278;7;624860042;2278;235;3061;3072;7.58;0.47;214.08;3.55;783;7;1020.00;11
2281;7;624860050;2281;234;3063;3072;7.54;0.47;214.15;3.55;782;7;1021.00;9
2283;7;624860059;2283;231;3065;3072;7.48;0.46;214.23;3.56;782;7;1022.00;7
2287;7;624860069;2287;233;3070;3076;7.46;0.46;214.40;3.56;783;7;1023.00;6
2290;7;624860079;2290;229;3070;3076;7.48;0.46;214.43;3.56;780;7;1024.00;6
2292;7;624860087;2292;230;3071;3076;7.50;0.46;214.67;3.57;779;7;1025.00;5
2296;7;624860097;2296;232;3072;3079;7.52;0.46;214.75;3.57;776;7;1026.00;7
2300;7;624860106;2300;223;3073;3079;7.61;0.47;214.81;3.57;773;7;1027.00;6
2305;7;624860116;2305;222;3074;3079;7.65;0.47;215.20;3.58;769;7;1028.00;5
2305;7;624860125;2305;214;3079;3083;7.80;0.48;215.20;3.58;774;7;1029.00;4
2309;7;624860135;2309;218;3080;3084;7.90;0.48;215.24;3.58;771;7;1030.00;4
2313;7;624860145;2313;215;3081;3084;7.94;0.48;215.20;3.58;768;7;1031.00;3
2315;7;624860155;2315;214;3085;3088;8.03;0.49;215.39;3.58;770;7;1032.00;3
2317;7;624860164;2317;205;3087;3088;8.13;0.50;215.57;3.58;770;7;1033.00;1
2320;7;624860174;2320;202;3087;3088;8.21;0.50;215.59;3.58;767;7;1034.00;1
2322;7;624860184;2322;208;3089;3090;8.30;0.51;215.65;3.58;767;7;1035.00;1
2327;7;624860194;2327;201;3089;3090;8.27;0.51;215.92;3.58;762;7;1036.00;1
2333;7;624860204;2333;197;3096;3096;8.29;0.50;215.91;3.57;763;7;1037.00;0
2336;7;624860221;2336;201;3096;3096;8.33;0.51;216.07;3.57;760;7;1038.00;0
2340;7;624860230;2340;201;3097;3097;8.39;0.51;216.34;3.57;757;7;1039.00;0
2343;7;624860240;2343;204;3097;3097;8.43;0.51;216.52;3.57;754;7;1040.00;0
2345;7;624860249;2345;200;3097;3097;8.45;0.52;216.50;3.57;752;7;1041.00;0
2350;7;624860261;2350;199;3097;3097;8.46;0.52;216.59;3.57;747;7;1042.00;0
2356;7;624860271;2356;198;3097;3097;8.47;0.52;216.72;3.57;741;7;1043.00;0
2359;7;624860284;2359;191;3108;3109;8.55;0.52;216.98;3.56;749;7;1044.00;1
2362;7;624860298;2362;188;3108;3109;8.47;0.52;217.05;3.56;746;7;1045.00;1
2366;7;624860309;2366;190;3109;3109;8.49;0.52;217.34;3.56;743;7;1046.00;0
2375;7;624860320;2375;192;3109;3109;8.46;0.52;217.47;3.56;734;7;1047.00;0
2379;7;624860332;2379;196;3109;3109;8.46;0.52;217.52;3.56;730;7;1048.00;0
2385;7;624860342;2385;195;3109;3109;8.42;0.51;217.71;3.56;724;7;1049.00;0
2385;7;624860354;2385;199;3115;3115;8.47;0.52;217.71;3.55;730;7;1050.00;0
2390;7;624860364;2390;197;3115;3115;8.50;0.52;217.83;3.55;725;7;1051.00;0
2393;7;624860373;2393;200;3119;3119;8.60;0.52;218.05;3.55;726;7;1052.00;0
2396;7;624860383;2396;200;3120;3120;8.73;0.53;218.12;3.55;724;7;1053.00;0
2400;7;624860393;2400;198;3120;3120;8.70;0.53;218.25;3.55;720;7;1054.00;0
2403;7;624860403;2403;195;3120;3120;8.79;0.54;218.31;3.55;717;7;1055.00;0
2405;7;624860413;2405;191;3133;3133;8.91;0.54;218.28;3.54;728;7;1056.00;0
2408;7;624860423;2408;188;3133;3133;8.90;0.54;218.32;3.54;725;7;1057.00;0
2411;7;624860433;2411;188;3133;3133;8.87;0.54;218.46;3.54;722;7;1058.00;0
2414;7;624860442;2414;187;3134;3134;8.89;0.54;218.51;3.53;720;7;1059.00;0
2421;7;624860452;2421;191;3135;3135;8.81;0.54;218.56;3.53;714;7;1060.00;0
2426;7;624860461;2426;193;3135;3135;8.79;0.54;218.60;3.53;709;7;1061.00;0
2429;7;624860471;2429;192;3137;3138;8.75;0.53;218.70;3.53;708;7;1062.00;1
2429;7;624860481;2429;196;3137;3138;8.80;0.54;218.70;3.53;708;7;1063.00;1
2429;7;624860490;2429;205;3138;3138;8.85;0.54;218.70;3.53;709;7;1064.00;0
2434;7;624860500;2434;209;3138;3138;8.83;0.54;218.94;3.53;704;7;1065.00;0
2436;7;624860509;2436;211;3144;3144;8.84;0.54;219.13;3.53;708;7;1066.00;0
2440;7;624860519;2440;201;3144;3144;8.87;0.54;219.14;3.53;704;7;1067.00;0
2444;7;624860530;2444;194;3144;3144;8.92;0.55;219.38;3.53;700;7;1068.00;0
2448;7;624860540;2448;192;3144;3144;8.93;0.55;219.44;3.53;696;7;1069.00;0
2451;7;624860549;2451;187;3148;3148;9.01;0.55;219.69;3.52;697;7;1070.00;0
2456;7;624860559;2456;186;3149;3149;9.11;0.56;219.72;3.52;693;7;1071.00;0
2459;7;624860569;2459;185;3149;3149;9.14;0.56;219.68;3.52;690;7;1072.00;0
2464;8;624860578;2464;184;3150;3150;9.08;0.55;219.84;3.52;686;8;1073.00;0
2468;8;624860604;2468;185;3150;3150;9.09;0.55;219.95;3.52;682;8;1074.00;0
2471;8;624860614;2471;184;3150;3150;9.09;0.55;219.93;3.52;679;8;1075.00;0
2473;8;624860623;2473;175;3150;3150;9.22;0.56;220.02;3.52;677;8;1076.00;0
2474;8;624860633;2474;170;3150;3150;9.35;0.57;220.00;3.52;676;8;1077.00;0
2478;8;624860643;2478;160;3150;3150;9.51;0.58;219.97;3.52;672;8;1078.00;0
2480;8;624860653;2480;159;3150;3150;9.64;0.59;219.99;3.52;670;8;1079.00;0
2485;8;624860665;2485;190;3236;3275;9.53;0.58;220.23;3.43;751;8;1080.00;39
2488;8;624860691;2488;180;3239;3276;9.56;0.59;220.24;3.43;751;8;1081.00;37
2490;8;624860703;2490;169;3245;3276;9.66;0.59;220.29;3.42;755;8;1082.00;31
2493;8;624860717;2493;169;3246;3276;9.68;0.59;220.51;3.42;753;8;1083.00;30
2496;8;624860732;2496;165;3251;3276;9.69;0.59;220.59;3.42;755;8;1084.00;25
2499;8;624860750;2499;164;3251;3276;9.68;0.59;220.74;3.42;752;8;1085.00;25
2502;8;624860767;2502;165;3257;3276;9.72;0.59;220.78;3.43;755;8;1086.00;19
2505;8;624860782;2505;169;3259;3276;9.73;0.59;220.88;3.43;754;8;1087.00;17
2508;8;624860798;2508;172;3264;3277;9.62;0.59;220.95;3.44;756;8;1088.00;13
2512;8;624860824;2512;179;3267;3278;9.52;0.58;220.90;3.44;755;8;1089.00;11
2515;8;624860839;2515;176;3271;3278;9.40;0.57;220.86;3.45;756;8;1090.00;7
2518;8;624860851;2518;177;3277;3282;9.32;0.57;221.08;3.45;759;8;1091.00;5
2519;8;624860869;2519;180;3278;3282;9.24;0.56;221.14;3.45;759;8;1092.00;4
2520;8;624860880;2520;191;3278;3282;9.19;0.56;221.21;3.45;758;8;1093.00;4
2524;8;624860890;2524;196;3279;3282;9.10;0.56;221.39;3.45;755;8;1094.00;3
2525;8;624860901;2525;199;3285;3288;9.07;0.55;221.45;3.45;760;8;1095.00;3
2527;8;624860913;2527;197;3285;3288;9.11;0.56;221.57;3.45;758;8;1096.00;3
2529;8;624860923;2529;196;3285;3288;9.16;0.56;221.56;3.45;756;8;1097.00;3
2531;8;624860936;2531;198;3287;3291;9.22;0.56;221.65;3.45;756;8;1098.00;4
2533;8;624860948;2533;195;3287;3291;9.26;0.57;221.55;3.45;754;8;1099.00;4
2535;8;624860960;2535;198;3288;3291;9.27;0.57;221.58;3.45;753;8;1100.00;3
2535;8;624860975;2535;198;3289;3292;9.28;0.57;221.58;3.45;754;8;1101.00;3
2536;8;624860991;2536;198;3290;3293;9.35;0.57;221.51;3.44;754;8;1102.00;3
2538;8;624861001;2538;206;3290;3293;9.41;0.58;221.56;3.44;752;8;1103.00;3
2541;8;624861011;2541;205;3300;3306;9.43;0.58;221.51;3.43;759;8;1104.00;6
2545;8;624861023;2545;208;3302;3306;9.52;0.58;221.52;3.44;757;8;1105.00;4
2547;8;624861033;2547;204;3302;3306;9.58;0.59;221.48;3.44;755;8;1106.00;4
2550;8;624861044;2550;208;3303;3307;9.61;0.59;221.51;3.44;753;8;1107.00;4
2552;8;624861054;2552;210;3303;3307;9.67;0.59;221.39;3.44;751;8;1108.00;4
2556;8;624861065;2556;210;3308;3311;9.67;0.59;221.28;3.44;752;8;1109.00;3
2559;8;624861078;2559;213;3308;3311;9.69;0.59;221.23;3.44;749;8;1110.00;3
2561;8;624861096;2561;217;3311;3315;9.74;0.59;221.19;3.44;750;8;1111.00;4
2566;8;624861107;2566;223;3311;3315;9.75;0.60;221.00;3.44;745;8;1112.00;4
2568;8;624861118;2568;225;3311;3315;9.80;0.60;220.93;3.44;743;8;1113.00;4
2573;8;624861128;2573;228;3311;3315;9.79;0.60;220.65;3.44;738;8;1114.00;4
2573;8;624861139;2573;231;3312;3315;9.80;0.60;220.65;3.45;739;8;1115.00;3
2577;8;624861149;2577;235;3321;3327;9.80;0.60;220.76;3.44;744;8;1116.00;6
2579;8;624861161;2579;237;3321;3327;9.75;0.60;220.69;3.44;742;8;1117.00;6
2580;8;624861171;2580;239;3323;3327;9.75;0.60;220.70;3.44;743;8;1118.00;4
2584;8;624861181;2584;242;3323;3327;9.67;0.59;220.63;3.44;739;8;1119.00;4
2589;8;624861190;2589;242;3323;3327;9.67;0.59;220.53;3.44;734;8;1120.00;4
2589;8;624861199;2589;245;3323;3327;9.63;0.59;220.53;3.44;734;8;1121.00;4
2591;8;624861207;2591;237;3323;3328;9.56;0.58;220.50;3.44;732;8;1122.00;5
2593;8;624861217;2593;241;3323;3328;9.60;0.58;220.47;3.44;730;8;1123.00;5
2595;8;624861226;2595;240;3328;3334;9.58;0.58;220.42;3.44;733;8;1124.00;6
2598;8;624861236;2598;238;3331;3336;9.49;0.58;220.39;3.45;733;8;1125.00;5
2598;8;624861246;2598;240;3332;3336;9.40;0.57;220.39;3.45;734;8;1126.00;4
2599;8;624861255;2599;242;3332;3336;9.47;0.58;220.36;3.45;733;8;1127.00;4
2600;8;624861265;2600;244;3335;3340;9.43;0.57;220.32;3.44;735;8;1128.00;5
2604;8;624861274;2604;244;3335;3340;9.39;0.57;220.19;3.44;731;8;1129.00;5
2604;8;624861283;2604;243;3335;3340;9.40;0.57;220.19;3.44;731;8;1130.00;5
2606;8;624861292;2606;226;3336;3341;9.46;0.57;220.13;3.44;730;8;1131.00;5
2608;8;624861303;2608;218;3339;3345;9.45;0.57;220.10;3.44;731;8;1132.00;6
2610;8;624861313;2610;209;3339;3345;9.55;0.58;220.04;3.44;729;8;1133.00;6
2610;8;624861322;2610;206;3341;3348;9.67;0.59;220.04;3.44;731;8;1134.00;7
2612;8;624861332;2612;205;3342;3348;9.74;0.59;219.89;3.44;730;8;1135.00;6
2612;9;624861342;2612;204;3342;3348;9.80;0.60;219.89;3.44;730;9;1136.00;6
2614;9;624861377;2614;200;3342;3348;9.87;0.60;219.83;3.44;728;9;1137.00;6
2616;9;624861388;2616;198;3346;3352;9.93;0.60;219.86;3.43;730;9;1138.00;6
2616;10;624861398;2616;194;3346;3352;9.94;0.60;219.86;3.43;730;10;1139.00;6
2618;10;624861423;2618;199;3346;3352;9.96;0.60;219.83;3.43;728;10;1140.00;6
2619;10;624861433;2619;197;3346;3352;9.89;0.60;219.84;3.43;727;10;1141.00;6
2620;10;624861443;2620;192;3346;3353;9.94;0.60;219.84;3.43;726;10;1142.00;7
2621;10;624861452;2621;192;3347;3354;9.94;0.61;219.80;3.43;726;10;1143.00;7
2624;10;624861469;2624;189;3347;3354;9.97;0.61;219.76;3.43;723;10;1144.00;7
2625;10;624861484;2625;186;3348;3355;10.05;0.61;219.78;3.43;723;10;1145.00;7
2626;10;624861494;2626;184;3348;3355;10.08;0.61;219.79;3.43;722;10;1146.00;7
2628;10;624861503;2628;185;3348;3355;10.07;0.61;219.73;3.43;720;10;1147.00;7
2632;10;624861513;2632;187;3348;3355;10.05;0.61;219.72;3.43;716;10;1148.00;7
2634;10;624861523;2634;193;3348;3355;10.07;0.61;219.77;3.43;714;10;1149.00;7
2635;10;624861533;2635;195;3350;3355;10.10;0.62;219.77;3.45;715;10;1150.00;5
2636;10;624861542;2636;191;3350;3355;10.07;0.62;219.88;3.45;714;10;1151.00;5
2636;10;624861550;2636;208;3415;3482;10.13;0.63;219.88;3.39;779;10;1152.00;67
2638;10;624861570;2638;206;3418;3483;10.05;0.62;219.87;3.40;780;10;1153.00;65
2640;10;624861580;2640;203;3428;3483;10.07;0.62;219.94;3.40;788;10;1154.00;55
2641;10;624861590;2641;202;3435;3483;10.03;0.62;220.04;3.40;794;10;1155.00;48
2647;10;624861601;2647;202;3444;3483;9.95;0.62;219.97;3.41;797;10;1156.00;39
2650;10;624861611;2650;204;3447;3483;9.84;0.61;220.04;3.41;797;10;1157.00;36
2653;10;624861621;2653;209;3450;3483;9.70;0.60;220.13;3.42;797;10;1158.00;33
2655;10;624861631;2655;210;3455;3483;9.62;0.59;220.27;3.42;800;10;1159.00;28
2657;10;624861641;2657;216;3458;3484;9.56;0.59;220.32;3.43;801;10;1160.00;26
2659;10;624861650;2659;226;3462;3485;9.49;0.59;220.53;3.44;803;10;1161.00;23
2661;10;624861661;2661;225;3466;3485;9.38;0.58;220.53;3.44;805;10;1162.00;19
2663;10;624861670;2663;234;3469;3486;9.31;0.57;220.72;3.45;806;10;1163.00;17
2666;10;624861680;2666;241;3473;3486;9.22;0.57;220.68;3.46;807;10;1164.00;13
2671;10;624861690;2671;243;3476;3486;9.14;0.56;220.77;3.47;805;10;1165.00;10
2674;10;624861700;2674;250;3478;3486;9.03;0.56;220.82;3.47;804;10;1166.00;8
2678;10;624861710;2678;260;3485;3490;8.96;0.55;220.88;3.48;807;10;1167.00;5
2682;10;624861721;2682;265;3485;3490;8.89;0.55;220.86;3.48;803;10;1168.00;5
2684;10;624861731;2684;267;3485;3490;8.82;0.54;220.87;3.48;801;10;1169.00;5
2687;10;624861743;2687;270;3489;3496;8.70;0.53;221.01;3.48;802;10;1170.00;7
2688;10;624861753;2688;276;3490;3496;8.66;0.53;220.99;3.48;802;10;1171.00;6
2690;10;624861764;2690;274;3492;3496;8.62;0.53;221.19;3.48;802;10;1172.00;4
2693;10;624861773;2693;273;3497;3500;8.50;0.52;221.44;3.48;804;10;1173.00;3
2696;10;624861783;2696;266;3498;3501;8.50;0.52;221.53;3.48;802;10;1174.00;3
2699;10;624861792;2699;266;3499;3501;8.48;0.52;221.73;3.49;800;10;1175.00;2
2706;10;624861801;2706;268;3503;3505;8.40;0.51;221.86;3.49;797;10;1176.00;2
2709;10;624861811;2709;269;3504;3505;8.39;0.51;221.88;3.49;795;10;1177.00;1
2710;10;624861821;2710;266;3505;3505;8.41;0.51;221.86;3.49;795;10;1178.00;0
2712;10;624861830;2712;271;3506;3506;8.41;0.51;221.95;3.49;794;10;1179.00;0
2713;10;624861839;2713;275;3506;3506;8.42;0.51;221.92;3.49;793;10;1180.00;0
2716;10;624861849;2716;280;3511;3512;8.47;0.52;221.96;3.48;795;10;1181.00;1
2717;10;624861858;2717;281;3512;3512;8.43;0.51;221.94;3.48;795;10;1182.00;0
2721;10;624861866;2721;279;3513;3513;8.37;0.51;222.09;3.48;792;10;1183.00;0
2725;10;624861876;2725;275;3513;3513;8.34;0.51;222.08;3.48;788;10;1184.00;0
2727;10;624861885;2727;271;3513;3513;8.28;0.51;222.02;3.48;786;10;1185.00;0
2732;10;624861895;2732;273;3513;3513;8.17;0.50;222.03;3.48;781;10;1186.00;0
2735;10;624861904;2735;266;3513;3513;8.10;0.49;222.09;3.48;778;10;1187.00;0
2739;10;624861913;2739;267;3525;3525;8.01;0.49;222.17;3.47;786;10;1188.00;0
2744;10;624861922;2744;267;3525;3525;7.85;0.48;222.25;3.47;781;10;1189.00;0
2747;10;624861931;2747;252;3525;3525;7.73;0.47;222.43;3.47;778;10;1190.00;0
2752;10;624861940;2752;244;3525;3525;7.64;0.47;222.59;3.47;773;10;1191.00;0
2754;10;624861949;2754;242;3525;3525;7.57;0.47;222.72;3.47;771;10;1192.00;0
2761;10;624861957;2761;237;3525;3525;7.55;0.46;222.95;3.47;764;10;1193.00;0
2764;10;624861966;2764;237;3529;3529;7.55;0.46;223.18;3.47;765;10;1194.00;0
2769;10;624861976;2769;236;3529;3529;7.56;0.47;223.20;3.47;760;10;1195.00;0
2771;10;624861985;2771;230;3533;3533;7.67;0.47;223.32;3.47;762;10;1196.00;0
2778;10;624861995;2778;225;3534;3534;7.71;0.47;223.42;3.46;756;10;1197.00;0
2782;10;624862004;2782;223;3534;3534;7.74;0.48;223.63;3.46;752;10;1198.00;0
2785;10;624862013;2785;221;3534;3534;7.76;0.48;223.86;3.46;749;10;1199.00;0
2793;10;624862025;2793;220;3560;3575;7.74;0.47;223.91;3.44;767;10;1200.00;15
2796;10;624862043;2796;208;3561;3575;7.85;0.48;224.17;3.44;765;10;1201.00;14
2799;10;624862052;2799;209;3564;3575;7.92;0.49;224.15;3.44;765;10;1202.00;11
2802;10;624862062;2802;205;3565;3576;7.99;0.49;224.13;3.44;763;10;1203.00;11
2805;10;624862071;2805;207;3568;3577;8.11;0.50;224.24;3.44;763;10;1204.00;9
2807;10;624862081;2807;207;3569;3577;8.28;0.51;224.26;3.44;762;10;1205.00;8
2811;10;624862090;2811;212;3572;3580;8.41;0.51;224.52;3.44;761;10;1206.00;8
2815;10;624862100;2815;204;3572;3580;8.49;0.52;224.61;3.44;757;10;1207.00;8
2819;10;624862109;2819;209;3575;3580;8.52;0.52;224.60;3.44;756;10;1208.00;5
2825;10;624862118;2825;207;3575;3580;8.50;0.52;224.59;3.44;750;10;1209.00;5
2827;10;624862128;2827;210;3582;3586;8.50;0.52;224.83;3.44;755;10;1210.00;4
2832;10;624862140;2832;212;3582;3586;8.48;0.52;225.11;3.44;750;10;1211.00;4
2834;10;624862152;2834;207;3582;3586;8.49;0.52;225.12;3.44;748;10;1212.00;4
2839;10;624862164;2839;214;3582;3586;8.46;0.52;225.46;3.44;743;10;1213.00;4
2844;10;624862173;2844;211;3586;3590;8.47;0.52;225.61;3.43;742;10;1214.00;4
2847;10;624862183;2847;214;3588;3592;8.51;0.52;225.66;3.43;741;10;1215.00;4
2850;10;624862192;2850;214;3589;3592;8.40;0.51;225.78;3.43;739;10;1216.00;3
2855;10;624862201;2855;213;3590;3593;8.32;0.51;225.89;3.43;735;10;1217.00;3
2859;10;624862211;2859;217;3590;3593;8.31;0.51;225.92;3.43;731;10;1218.00;3
2864;10;624862220;2864;218;3590;3593;8.19;0.50;226.02;3.43;726;10;1219.00;3
2870;10;624862229;2870;222;3590;3593;8.13;0.50;225.95;3.43;720;10;1220.00;3
2872;10;624862238;2872;220;3590;3593;8.07;0.49;226.12;3.43;718;10;1221.00;3
2878;10;624862246;2878;224;3591;3593;7.88;0.48;225.94;3.44;713;10;1222.00;2
2883;10;624862256;2883;224;3591;3593;7.73;0.47;225.88;3.44;708;10;1223.00;2
2886;10;624862265;2886;238;3634;3663;7.60;0.47;225.89;3.40;748;10;1224.00;29
2891;10;624862279;2891;242;3635;3664;7.52;0.46;225.85;3.40;744;10;1225.00;29
2896;10;624862288;2896;235;3641;3664;7.58;0.46;225.86;3.39;745;10;1226.00;23
2900;10;624862297;2900;240;3644;3664;7.62;0.47;225.97;3.40;744;10;1227.00;20
2902;10;624862306;2902;243;3647;3666;7.67;0.47;226.03;3.40;745;10;1228.00;19
2904;10;624862316;2904;239;3649;3666;7.79;0.48;226.05;3.40;745;10;1229.00;17
2905;10;624862326;2905;244;3652;3666;7.79;0.48;226.08;3.40;747;10;1230.00;14
2908;10;624862335;2908;248;3655;3666;7.81;0.48;226.40;3.41;747;10;1231.00;11
2908;10;624862344;2908;247;3657;3667;7.77;0.47;226.40;3.41;749;10;1232.00;10
2914;10;624862353;2914;255;3660;3668;7.67;0.47;226.56;3.42;746;10;1233.00;8
2914;10;624862363;2914;269;3662;3668;7.64;0.47;226.56;3.42;748;10;1234.00;6
2917;10;624862372;2917;271;3667;3672;7.53;0.46;226.62;3.42;750;10;1235.00;5
2919;10;624862381;2919;280;3669;3672;7.51;0.46;226.58;3.43;750;10;1236.00;3
2923;10;624862390;2923;275;3669;3672;7.56;0.46;226.58;3.43;746;10;1237.00;3
2924;10;624862399;2924;266;3670;3672;7.62;0.47;226.59;3.43;746;10;1238.00;2
2925;10;624862408;2925;267;3678;3678;7.72;0.47;226.59;3.43;753;10;1239.00;0
2928;10;624862418;2928;265;3678;3678;7.82;0.48;226.57;3.43;750;10;1240.00;0
2931;10;624862428;2931;265;3678;3678;7.88;0.48;226.67;3.43;747;10;1241.00;0
2934;10;624862438;2934;264;3680;3681;7.97;0.49;226.67;3.43;746;10;1242.00;1
2935;10;624862454;2935;264;3680;3681;7.99;0.49;226.65;3.43;745;10;1243.00;1
2936;10;624862464;2936;266;3681;3681;7.93;0.48;226.63;3.43;745;10;1244.00;0
2942;10;624862478;2942;270;3682;3682;7.82;0.48;226.59;3.43;740;10;1245.00;0
2944;10;624862488;2944;257;3683;3683;7.82;0.48;226.59;3.42;739;10;1246.00;0
2946;10;624862498;2946;253;3683;3683;7.81;0.48;226.70;3.42;737;10;1247.00;0
2951;10;624862508;2951;251;3695;3696;7.96;0.48;226.70;3.41;744;10;1248.00;1
2952;10;624862519;2952;243;3696;3696;8.09;0.49;226.68;3.41;744;10;1249.00;0
2957;10;624862528;2957;244;3696;3696;8.16;0.50;226.63;3.41;739;10;1250.00;0
2959;10;624862538;2959;243;3697;3697;8.33;0.51;226.50;3.41;738;10;1251.00;0
2961;10;624862549;2961;244;3697;3697;8.45;0.51;226.72;3.41;736;10;1252.00;0
2963;10;624862559;2963;239;3701;3701;8.59;0.52;226.74;3.41;738;10;1253.00;0
2964;10;624862570;2964;232;3701;3701;8.67;0.53;226.73;3.41;737;10;1254.00;0
2969;10;624862580;2969;230;3705;3705;8.63;0.52;226.76;3.41;736;10;1255.00;0
2970;10;624862590;2970;228;3705;3705;8.68;0.53;226.81;3.41;735;10;1256.00;0
2972;10;624862600;2972;231;3705;3705;8.64;0.52;226.78;3.41;733;10;1257.00;0
2974;10;624862609;2974;228;3705;3705;8.57;0.52;226.69;3.41;731;10;1258.00;0
2975;10;624862619;2975;229;3705;3705;8.52;0.52;226.69;3.41;730;10;1259.00;0
2979;10;624862630;2979;235;3734;3739;8.45;0.52;226.65;3.38;755;10;1260.00;5
2982;10;624862642;2982;232;3734;3739;8.44;0.52;226.60;3.38;752;10;1261.00;5
2984;10;624862651;2984;234;3737;3739;8.47;0.52;226.52;3.38;753;10;1262.00;2
2985;10;624862660;2985;237;3737;3739;8.43;0.52;226.46;3.38;752;10;1263.00;2
2985;10;624862669;2985;238;3738;3739;8.49;0.52;226.46;3.38;753;10;1264.00;1
2985;10;624862678;2985;241;3738;3739;8.56;0.52;226.46;3.38;753;10;1265.00;1
2985;10;624862693;2985;244;3738;3740;8.54;0.52;226.46;3.38;753;10;1266.00;2
2986;10;624862702;2986;243;3738;3740;8.58;0.52;226.45;3.38;752;10;1267.00;2
2990;10;624862710;2990;242;3743;3746;8.59;0.52;226.39;3.38;753;10;1268.00;3
2993;10;624862726;2993;243;3744;3747;8.59;0.52;226.28;3.38;751;10;1269.00;3
2996;10;624862742;2996;243;3744;3747;8.61;0.52;226.25;3.38;748;10;1270.00;3
2997;10;624862755;2997;247;3744;3747;8.57;0.52;226.20;3.38;747;10;1271.00;3
2999;10;624862776;2999;247;3747;3751;8.54;0.52;226.15;3.37;748;10;1272.00;4
3001;10;624862792;3001;248;3747;3751;8.58;0.52;226.28;3.37;746;10;1273.00;4
3005;10;624862805;3005;252;3747;3751;8.57;0.52;226.23;3.37;742;10;1274.00;4
3005;10;624862821;3005;250;3748;3752;8.64;0.52;226.23;3.37;743;10;1275.00;4
3008;10;624862834;3008;249;3751;3756;8.65;0.52;226.16;3.37;743;10;1276.00;5
3008;10;624862845;3008;254;3751;3756;8.69;0.53;226.16;3.37;743;10;1277.00;5
3008;10;624862855;3008;249;3753;3759;8.77;0.53;226.16;3.37;745;10;1278.00;6
3008;10;624862865;3008;249;3753;3759;8.79;0.53;226.16;3.37;745;10;1279.00;6
3010;10;624862874;3010;247;3754;3759;8.76;0.53;226.17;3.37;744;10;1280.00;5
3010;10;624862883;3010;243;3754;3759;8.84;0.54;226.17;3.37;744;10;1281.00;5
3010;10;624862893;3010;243;3758;3763;8.95;0.54;226.17;3.37;748;10;1282.00;5
3010;10;624862904;3010;232;3758;3763;9.08;0.55;226.17;3.37;748;10;1283.00;5
3011;10;624862915;3011;226;3758;3763;9.21;0.56;226.15;3.37;747;10;1284.00;5
3013;10;624862925;3013;219;3758;3763;9.31;0.57;226.13;3.37;745;10;1285.00;5
3015;10;624862935;3015;219;3758;3764;9.45;0.57;226.18;3.37;743;10;1286.00;6
3017;10;624862945;3017;215;3759;3765;9.56;0.58;226.16;3.36;742;10;1287.00;6
3020;10;624862955;3020;213;3759;3765;9.60;0.58;226.15;3.36;739;10;1288.00;6
3021;10;624862965;3021;203;3760;3766;9.62;0.58;226.16;3.36;739;10;1289.00;6
3023;10;624862984;3023;199;3760;3766;9.66;0.58;226.14;3.36;737;10;1290.00;6
3026;10;624862994;3026;194;3760;3766;9.70;0.59;226.10;3.36;734;10;1291.00;6
3026;10;624863004;3026;192;3760;3766;9.73;0.59;226.10;3.36;734;10;1292.00;6
3026;10;624863020;3026;182;3760;3766;9.80;0.59;226.10;3.36;734;10;1293.00;6
3029;10;624863030;3029;178;3761;3766;9.86;0.60;226.08;3.37;732;10;1294.00;5
3031;10;624863043;3031;171;3762;3766;9.88;0.60;226.11;3.38;731;10;1295.00;4
3035;10;624863052;3035;187;3824;3893;9.82;0.60;226.04;3.33;789;10;1296.00;69
3038;10;624863074;3038;181;3824;3894;9.85;0.60;225.97;3.33;786;10;1297.00;70
3042;10;624863085;3042;174;3831;3894;9.89;0.60;225.84;3.32;789;10;1298.00;63
3044;10;624863097;3044;172;3835;3894;9.93;0.61;225.79;3.32;791;10;1299.00;59
3044;10;624863108;3044;165;3841;3894;10.07;0.62;225.79;3.32;797;10;1300.00;53
3045;10;624863123;3045;160;3844;3894;10.08;0.62;225.79;3.32;799;10;1301.00;50
3045;10;624863134;3045;151;3847;3894;10.13;0.62;225.79;3.33;802;10;1302.00;47
3048;10;624863144;3048;157;3851;3894;10.15;0.62;225.77;3.33;803;10;1303.00;43
3049;10;624863155;3049;156;3852;3895;10.26;0.63;225.73;3.33;803;10;1304.00;43
3051;10;624863165;3051;160;3858;3897;10.24;0.62;225.71;3.34;807;10;1305.00;39
3054;10;624863176;3054;159;3860;3897;10.30;0.63;225.67;3.34;806;10;1306.00;37
3056;10;624863186;3056;161;3863;3898;10.32;0.63;225.60;3.35;807;10;1307.00;35
3056;10;624863196;3056;162;3864;3898;10.33;0.63;225.60;3.35;808;10;1308.00;34
3059;10;624863207;3059;165;3869;3898;10.19;0.62;225.57;3.36;810;10;1309.00;29
3059;10;624863225;3059;162;3874;3898;10.12;0.62;225.57;3.37;815;10;1310.00;24
3060;10;624863241;3060;168;3877;3902;10.04;0.61;225.53;3.38;817;10;1311.00;25
3064;10;624863253;3064;173;3879;3902;9.98;0.61;225.51;3.39;815;10;1312.00;23
3065;10;624863264;3065;174;3883;3902;9.95;0.61;225.55;3.40;818;10;1313.00;19
3070;10;624863277;3070;179;3885;3905;9.93;0.61;225.67;3.41;815;10;1314.00;20
3074;10;624863289;3074;186;3887;3905;9.89;0.60;225.83;3.41;813;10;1315.00;18
3076;10;624863300;3076;190;3890;3905;9.83;0.60;225.83;3.42;814;10;1316.00;15
3081;10;624863311;3081;190;3894;3909;9.70;0.59;226.04;3.42;813;10;1317.00;15
3084;10;624863328;3084;198;3897;3910;9.62;0.59;226.08;3.43;813;10;1318.00;13
3087;10;624863339;3087;201;3897;3910;9.55;0.58;226.18;3.43;810;10;1319.00;13
3089;10;624863351;3089;204;3904;3915;9.50;0.58;226.33;3.44;815;10;1320.00;11
3091;10;624863362;3091;215;3904;3915;9.47;0.58;226.41;3.44;813;10;1321.00;11
3093;10;624863372;3093;220;3904;3915;9.46;0.58;226.39;3.44;811;10;1322.00;11
3097;10;624863383;3097;225;3907;3916;9.37;0.57;226.53;3.46;810;10;1323.00;9
3099;10;624863394;3099;235;3907;3916;9.29;0.57;226.64;3.46;808;10;1324.00;9
3103;10;624863404;3103;234;3914;3922;9.20;0.56;226.93;3.46;811;10;1325.00;8
3108;10;624863416;3108;239;3914;3922;9.07;0.55;227.08;3.46;806;10;1326.00;8
3112;10;624863426;3112;245;3914;3923;8.93;0.54;227.16;3.46;802;10;1327.00;9
3113;10;624863437;3113;250;3915;3923;8.82;0.54;227.15;3.47;802;10;1328.00;8
3117;10;624863447;3117;257;3915;3923;8.68;0.53;227.27;3.47;798;10;1329.00;8
3119;10;624863457;3119;256;3915;3923;8.59;0.52;227.45;3.47;796;10;1330.00;8
3122;10;624863467;3122;257;3920;3923;8.48;0.52;227.65;3.51;798;10;1331.00;3
3127;10;624863477;3127;264;3929;3935;8.46;0.51;227.77;3.50;802;10;1332.00;6
3130;10;624863488;3130;265;3930;3935;8.41;0.51;227.92;3.50;800;10;1333.00;5
3131;10;624863498;3131;265;3932;3935;8.38;0.51;227.95;3.50;801;10;1334.00;3
3133;10;624863508;3133;265;3932;3935;8.30;0.51;227.92;3.50;799;10;1335.00;3
3135;10;624863518;3135;264;3933;3935;8.16;0.50;228.00;3.50;798;10;1336.00;2
3137;10;624863528;3137;275;3933;3935;8.10;0.50;227.99;3.50;796;10;1337.00;2
3138;10;624863537;3138;284;3936;3939;8.02;0.49;228.07;3.50;798;10;1338.00;3
3141;10;624863547;3141;277;3939;3939;7.93;0.49;228.08;3.50;798;10;1339.00;0
3141;10;624863556;3141;275;3943;3943;7.97;0.49;228.08;3.50;802;10;1340.00;0
3142;10;624863567;3142;274;3944;3944;7.97;0.49;228.09;3.50;802;10;1341.00;0
3143;10;624863576;3143;274;3944;3944;7.96;0.49;228.17;3.50;801;10;1342.00;0
3147;10;624863586;3147;271;3944;3944;7.88;0.48;228.22;3.50;797;10;1343.00;0
3149;10;624863596;3149;272;3957;3957;7.83;0.48;228.26;3.49;808;10;1344.00;0
3152;10;624863606;3152;268;3957;3957;7.78;0.48;228.47;3.49;805;10;1345.00;0
3154;10;624863615;3154;273;3957;3957;7.82;0.48;228.54;3.49;803;10;1346.00;0
3156;10;624863625;3156;275;3958;3958;7.82;0.48;228.60;3.49;802;10;1347.00;0
3159;10;624863634;3159;276;3959;3959;7.85;0.48;228.79;3.49;800;10;1348.00;0
3160;10;624863645;3160;275;3959;3959;7.87;0.48;228.78;3.49;799;10;1349.00;0
3164;10;624863657;3164;277;3966;3968;7.89;0.48;228.86;3.48;802;10;1350.00;2
3167;10;624863668;3167;279;3966;3968;7.87;0.48;229.03;3.48;799;10;1351.00;2
3169;10;624863678;3169;276;3967;3968;7.84;0.48;229.01;3.48;798;10;1352.00;1
3172;10;624863688;3172;275;3967;3968;7.72;0.47;229.01;3.48;795;10;1353.00;1
3175;10;624863697;3175;279;3973;3974;7.71;0.47;229.02;3.48;798;10;1354.00;1
3178;10;624863708;3178;282;3974;3974;7.65;0.47;229.04;3.48;796;10;1355.00;0
3181;10;624863729;3181;279;3974;3974;7.55;0.46;229.04;3.48;793;10;1356.00;0
3183;10;624863739;3183;280;3974;3974;7.47;0.46;229.07;3.48;791;10;1357.00;0
3191;10;624863747;3191;281;3978;3978;7.33;0.45;229.21;3.48;787;10;1358.00;0
3196;10;624863758;3196;284;3979;3979;7.27;0.45;229.34;3.48;783;10;1359.00;0
3200;10;624863768;3200;280;3979;3979;7.24;0.44;229.40;3.48;779;10;1360.00;0
3205;10;624863777;3205;274;3980;3980;7.27;0.44;229.49;3.47;775;10;1361.00;0
3208;10;624863786;3208;268;3980;3980;7.36;0.45;229.48;3.47;772;10;1362.00;0
3211;10;624863795;3211;263;3980;3980;7.39;0.45;229.61;3.47;769;10;1363.00;0
3217;10;624863803;3217;257;3980;3980;7.42;0.45;230.07;3.47;763;10;1364.00;0
3221;10;624863812;3221;247;3980;3980;7.41;0.45;230.09;3.47;759;10;1365.00;0
3227;10;624863821;3227;246;3980;3980;7.39;0.45;230.26;3.47;753;10;1366.00;0
3232;10;624863830;3232;241;3980;3980;7.42;0.45;230.51;3.47;748;10;1367.00;0
3236;10;624863839;3236;235;4016;4050;7.57;0.46;230.50;3.44;780;10;1368.00;34
3241;10;624863853;3241;224;4021;4051;7.68;0.47;230.60;3.44;780;10;1369.00;30
3245;10;624863862;3245;217;4026;4051;7.76;0.48;230.88;3.44;781;10;1370.00;25
3248;10;624863871;3248;217;4027;4051;7.86;0.48;230.84;3.44;779;10;1371.00;24
3253;10;624863880;3253;214;4028;4051;7.87;0.48;231.13;3.44;775;10;1372.00;23
3258;10;624863889;3258;214;4031;4051;7.83;0.48;231.28;3.44;773;10;1373.00;20
3262;10;624863899;3262;226;4032;4051;7.77;0.47;231.32;3.44;770;10;1374.00;19
3268;10;624863908;3268;229;4036;4051;7.73;0.47;231.40;3.44;768;10;1375.00;15
3270;10;624863917;3270;232;4036;4052;7.65;0.47;231.50;3.44;766;10;1376.00;16
3276;10;624863925;3276;232;4038;4053;7.62;0.46;231.59;3.45;762;10;1377.00;15
3279;10;624863935;3279;235;4041;4053;7.66;0.47;231.69;3.45;762;10;1378.00;12
3286;10;624863944;3286;235;4047;4057;7.70;0.47;231.85;3.46;761;10;1379.00;10
3289;10;624863955;3289;241;4048;4057;7.76;0.47;231.92;3.46;759;10;1380.00;9
3293;10;624863965;3293;240;4050;4057;7.77;0.48;231.85;3.46;757;10;1381.00;7
3295;10;624863975;3295;242;4052;4057;7.82;0.48;232.02;3.47;757;10;1382.00;5
3301;10;624863985;3301;245;4058;4063;7.84;0.48;232.16;3.46;757;10;1383.00;5
3306;10;624863995;3306;246;4059;4063;7.84;0.48;232.16;3.46;753;10;1384.00;4
3312;10;624864005;3312;249;4060;4063;7.78;0.48;232.44;3.47;748;10;1385.00;3
3315;10;624864014;3315;245;4063;4066;7.79;0.48;232.55;3.47;748;10;1386.00;3
3318;10;624864024;3318;244;4064;4066;7.73;0.47;232.62;3.47;746;10;1387.00;2
3321;10;624864033;3321;252;4065;4066;7.73;0.47;232.76;3.47;744;10;1388.00;1
3328;10;624864043;3328;253;4066;4067;7.59;0.46;232.74;3.47;738;10;1389.00;1
3332;10;624864052;3332;255;4068;4068;7.55;0.46;232.80;3.47;736;10;1390.00;0
3337;10;624864062;3337;262;4068;4068;7.55;0.46;232.87;3.47;731;10;1391.00;0
3340;10;624864071;3340;265;4081;4081;7.62;0.47;232.86;3.46;741;10;1392.00;0
3341;10;624864082;3341;276;4081;4081;7.62;0.47;232.82;3.46;740;10;1393.00;0
3342;10;624864091;3342;284;4081;4081;7.61;0.47;232.85;3.46;739;10;1394.00;0
3346;10;624864100;3346;287;4083;4083;7.60;0.46;232.86;3.46;737;10;1395.00;0
3349;10;624864109;3349;292;4083;4083;7.55;0.46;232.83;3.46;734;10;1396.00;0
3352;10;624864118;3352;293;4087;4087;7.47;0.45;232.81;3.46;735;10;1397.00;0
3356;10;624864128;3356;296;4087;4087;7.39;0.45;232.84;3.46;731;10;1398.00;0
3356;10;624864136;3356;301;4091;4091;7.38;0.45;232.84;3.46;735;10;1399.00;0
3361;10;624864147;3361;302;4091;4091;7.25;0.44;232.74;3.46;730;10;1400.00;0
3364;10;624864160;3364;305;4091;4091;7.11;0.43;232.77;3.46;727;10;1401.00;0
3365;10;624864169;3365;316;4091;4091;7.01;0.43;232.73;3.46;726;10;1402.00;0
3368;10;624864177;3368;319;4091;4091;6.88;0.42;232.62;3.46;723;10;1403.00;0
3371;10;624864185;3371;323;4102;4103;6.89;0.42;232.56;3.45;731;10;1404.00;1
3373;10;624864195;3373;326;4102;4103;6.77;0.41;232.51;3.45;729;10;1405.00;1
3373;10;624864203;3373;333;4103;4103;6.70;0.41;232.51;3.45;730;10;1406.00;0
3375;10;624864212;3375;327;4103;4103;6.61;0.40;232.43;3.45;728;10;1407.00;0
3375;10;624864220;3375;325;4103;4103;6.61;0.40;232.43;3.45;728;10;1408.00;0
3377;10;624864228;3377;324;4103;4103;6.52;0.40;232.41;3.45;726;10;1409.00;0
3381;10;624864238;3381;320;4104;4104;6.47;0.39;232.38;3.44;723;10;1410.00;0
3384;10;624864246;3384;316;4104;4104;6.41;0.39;232.29;3.44;720;10;1411.00;0
3388;10;624864255;3388;314;4110;4110;6.46;0.39;232.17;3.44;722;10;1412.00;0
3388;10;624864264;3388;311;4111;4111;6.50;0.39;232.17;3.44;723;10;1413.00;0
3388;10;624864272;3388;311;4111;4111;6.52;0.40;232.17;3.44;723;10;1414.00;0
3389;10;624864281;3389;314;4111;4111;6.54;0.40;232.11;3.44;722;10;1415.00;0
3389;10;624864289;3389;303;4115;4115;6.66;0.41;232.11;3.44;726;10;1416.00;0
3390;10;624864298;3390;292;4115;4115;6.75;0.41;232.18;3.44;725;10;1417.00;0
3394;10;624864307;3394;290;4115;4115;6.81;0.41;232.16;3.44;721;10;1418.00;0
3394;10;624864316;3394;286;4116;4116;6.94;0.42;232.16;3.44;722;10;1419.00;0
3395;10;624864330;3395;286;4120;4120;7.09;0.43;232.13;3.43;725;10;1420.00;0
3397;10;624864339;3397;284;4120;4120;7.15;0.43;232.08;3.43;723;10;1421.00;0
3401;10;624864348;3401;284;4122;4123;7.26;0.44;232.01;3.43;721;10;1422.00;1
3402;10;624864356;3402;288;4122;4123;7.37;0.45;231.98;3.43;720;10;1423.00;1
3405;10;624864365;3405;284;4123;4123;7.46;0.45;231.85;3.43;718;10;1424.00;0
3406;10;624864374;3406;283;4123;4123;7.59;0.46;231.82;3.43;717;10;1425.00;0
3407;10;624864383;3407;279;4127;4127;7.72;0.47;231.76;3.43;720;10;1426.00;0
3408;10;624864392;3408;276;4127;4127;7.82;0.48;231.72;3.43;719;10;1427.00;0
3409;10;624864400;3409;276;4127;4127;7.89;0.48;231.73;3.43;718;10;1428.00;0
3413;10;624864409;3413;272;4127;4127;7.93;0.48;231.70;3.43;714;10;1429.00;0
3414;10;624864418;3414;270;4128;4128;7.96;0.48;231.67;3.43;714;10;1430.00;0
3416;10;624864427;3416;268;4129;4129;8.04;0.49;231.72;3.43;713;10;1431.00;0
3418;10;624864436;3418;268;4129;4129;8.07;0.49;231.65;3.43;711;10;1432.00;0
3418;10;624864445;3418;268;4130;4130;8.08;0.49;231.65;3.43;712;10;1433.00;0
3418;10;624864453;3418;268;4130;4130;8.05;0.49;231.65;3.43;712;10;1434.00;0
3419;10;624864461;3419;249;4130;4130;8.02;0.49;231.64;3.43;711;10;1435.00;0
3419;10;624864471;3419;234;4130;4130;8.08;0.49;231.64;3.43;711;10;1436.00;0
3421;10;624864479;3421;228;4130;4130;8.22;0.50;231.61;3.43;709;10;1437.00;0
3422;10;624864488;3422;222;4130;4130;8.35;0.51;231.62;3.43;708;10;1438.00;0
3422;10;624864496;3422;213;4130;4130;8.53;0.52;231.62;3.43;708;10;1439.00;0
3422;11;624864507;3422;259;4250;4360;8.51;0.53;231.62;3.33;828;11;1440.00;110
3426;11;624864546;3426;238;4257;4361;8.57;0.53;231.63;3.33;831;11;1441.00;104
3427;11;624864556;3427;222;4266;4361;8.79;0.55;231.57;3.33;839;11;1442.00;95
3427;11;624864566;3427;206;4272;4361;8.92;0.56;231.57;3.32;845;11;1443.00;89
3429;12;624864575;3429;195;4280;4361;9.07;0.56;231.58;3.33;851;12;1444.00;81
3429;12;624864597;3429;195;4284;4361;9.17;0.57;231.58;3.33;855;12;1445.00;77
3431;12;624864606;3431;193;4290;4361;9.26;0.57;231.54;3.33;859;12;1446.00;71
3432;12;624864627;3432;197;4295;4361;9.29;0.57;231.56;3.34;863;12;1447.00;66
3433;12;624864644;3433;191;4301;4362;9.36;0.58;231.57;3.34;868;12;1448.00;61
3436;12;624864666;3436;194;4304;4363;9.38;0.58;231.52;3.35;868;12;1449.00;59
3439;12;624864681;3439;194;4309;4363;9.45;0.58;231.51;3.35;870;12;1450.00;54
3439;12;624864694;3439;198;4311;4364;9.45;0.58;231.51;3.36;872;12;1451.00;53
3441;12;624864704;3441;205;4313;4364;9.46;0.58;231.47;3.36;872;12;1452.00;51
3442;12;624864715;3442;206;4314;4364;9.46;0.58;231.46;3.36;872;12;1453.00;50
3443;12;624864734;3443;214;4315;4364;9.44;0.58;231.43;3.37;872;12;1454.00;49
3446;12;624864750;3446;218;4316;4368;9.43;0.58;231.43;3.37;870;12;1455.00;52
3446;12;624864775;3446;225;4317;4368;9.46;0.58;231.43;3.37;871;12;1456.00;51
3447;12;624864791;3447;227;4319;4368;9.49;0.58;231.51;3.37;872;12;1457.00;49
3452;12;624864807;3452;231;4322;4371;9.39;0.57;231.47;3.38;870;12;1458.00;49
3454;12;624864828;3454;225;4323;4371;9.43;0.57;231.47;3.38;869;12;1459.00;48
3456;12;624864843;3456;224;4324;4371;9.41;0.57;231.59;3.38;868;12;1460.00;47
3456;12;624864862;3456;226;4327;4375;9.29;0.57;231.59;3.38;871;12;1461.00;48
3457;12;624864875;3457;219;4328;4376;9.35;0.57;231.55;3.38;871;12;1462.00;48
3459;12;624864886;3459;225;4334;4376;9.33;0.57;231.61;3.40;875;12;1463.00;42
3462;13;624864906;3462;217;4336;4380;9.37;0.57;231.63;3.40;874;13;1464.00;44
3463;13;624864932;3463;215;4339;4380;9.43;0.57;231.63;3.42;876;13;1465.00;41
3466;13;624864944;3466;213;4340;4380;9.48;0.58;231.67;3.42;874;13;1466.00;40
3471;13;624864956;3471;206;4342;4381;9.54;0.58;231.72;3.43;871;13;1467.00;39
3473;13;624864968;3473;204;4342;4381;9.66;0.59;231.70;3.43;869;13;1468.00;39
3477;13;624864980;3477;194;4347;4387;9.75;0.59;231.69;3.43;870;13;1469.00;40
3479;13;624864996;3479;194;4348;4387;9.85;0.60;231.80;3.44;869;13;1470.00;39
3483;13;624865015;3483;196;4348;4388;9.90;0.60;231.98;3.44;865;13;1471.00;40
3488;13;624865026;3488;190;4350;4388;9.89;0.60;232.05;3.45;862;13;1472.00;38
3490;13;624865038;3490;189;4351;4388;9.93;0.60;231.97;3.46;861;13;1473.00;37
3494;13;624865057;3494;194;4351;4388;9.98;0.60;232.02;3.46;857;13;1474.00;37
3496;13;624865068;3496;199;4352;4388;9.95;0.60;232.04;3.47;856;13;1475.00;36
3499;13;624865080;3499;198;4361;4400;9.92;0.60;232.10;3.47;862;13;1476.00;39
3501;13;624865093;3501;197;4362;4400;9.91;0.60;232.09;3.48;861;13;1477.00;38
3502;13;624865105;3502;201;4365;4400;9.87;0.60;232.06;3.48;863;13;1478.00;35
3505;13;624865116;3505;200;4367;4400;9.83;0.60;232.23;3.49;862;13;1479.00;33
3507;13;624865133;3507;207;4368;4400;9.81;0.60;232.29;3.50;861;13;1480.00;32
3507;13;624865144;3507;206;4372;4400;9.75;0.59;232.29;3.52;865;13;1481.00;28
3510;13;624865156;3510;215;4375;4404;9.69;0.59;232.31;3.52;865;13;1482.00;29
3513;13;624865167;3513;214;4376;4404;9.66;0.59;232.39;3.53;863;13;1483.00;28
3515;13;624865179;3515;214;4382;4408;9.61;0.58;232.51;3.55;867;13;1484.00;26
3518;13;624865191;3518;224;4384;4410;9.50;0.58;232.60;3.54;866;13;1485.00;26
3519;13;624865201;3519;223;4385;4410;9.45;0.58;232.63;3.55;866;13;1486.00;25
3522;13;624865213;3522;226;4386;4410;9.41;0.57;232.72;3.55;864;13;1487.00;24
3524;13;624865223;3524;230;4395;4423;9.38;0.57;232.83;3.55;871;13;1488.00;28
3526;14;624865235;3526;229;4395;4423;9.30;0.57;232.93;3.55;869;14;1489.00;28
3528;14;624865268;3528;236;4397;4423;9.24;0.57;233.04;3.57;869;14;1490.00;26
3532;14;624865278;3532;241;4399;4424;9.20;0.56;233.15;3.58;867;14;1491.00;25
3537;14;624865288;3537;246;4400;4425;9.13;0.56;233.26;3.59;863;14;1492.00;25
3539;14;624865299;3539;255;4402;4425;9.00;0.55;233.35;3.61;863;14;1493.00;23
3542;14;624865309;3542;262;4405;4428;8.91;0.55;233.40;3.62;863;14;1494.00;23
3546;14;624865320;3546;267;4406;4428;8.80;0.54;233.43;3.63;860;14;1495.00;22
3548;14;624865331;3548;273;4409;4428;8.81;0.54;233.40;3.65;861;14;1496.00;19
3552;14;624865342;3552;276;4411;4428;8.79;0.54;233.49;3.67;859;14;1497.00;17
3556;14;624865352;3556;278;4418;4434;8.79;0.54;233.62;3.68;862;14;1498.00;16
3559;14;624865364;3559;283;4421;4434;8.74;0.53;233.70;3.70;862;14;1499.00;13
3564;14;624865377;3564;292;4427;4453;8.59;0.53;234.07;3.71;863;14;1500.00;26
3568;14;624865396;3568;294;4428;4453;8.51;0.52;234.20;3.72;860;14;1501.00;25
3569;14;624865407;3569;294;4431;4457;8.51;0.52;234.19;3.72;862;14;1502.00;26
3572;14;624865418;3572;291;4434;4458;8.45;0.52;234.36;3.73;862;14;1503.00;24
3573;14;624865429;3573;294;4435;4458;8.37;0.51;234.41;3.73;862;14;1504.00;23
3575;14;624865439;3575;301;4438;4459;8.29;0.51;234.48;3.73;863;14;1505.00;21
3581;14;624865449;3581;310;4441;4459;8.12;0.50;234.53;3.74;860;14;1506.00;18
3583;14;624865460;3583;314;4441;4459;8.08;0.49;234.54;3.74;858;14;1507.00;18
3588;14;624865472;3588;319;4441;4459;8.00;0.49;234.65;3.74;853;14;1508.00;18
3589;14;624865482;3589;313;4443;4459;7.97;0.49;234.73;3.74;854;14;1509.00;16
3590;14;624865492;3590;311;4444;4459;7.94;0.49;234.75;3.74;854;14;1510.00;15
3595;14;624865502;3595;311;4444;4459;7.87;0.48;234.85;3.74;849;14;1511.00;15
3598;14;624865512;3598;312;4478;4529;7.81;0.48;234.87;3.72;880;14;1512.00;51
3602;14;624865529;3602;301;4483;4530;7.79;0.48;234.99;3.72;881;14;1513.00;47
3603;14;624865540;3603;301;4489;4530;7.81;0.48;235.04;3.72;886;14;1514.00;41
3606;14;624865550;3606;302;4497;4530;7.84;0.48;235.02;3.71;891;14;1515.00;33
3607;14;624865560;3607;303;4501;4530;7.90;0.48;235.00;3.71;894;14;1516.00;29
3611;14;624865570;3611;298;4502;4530;7.91;0.48;235.06;3.72;891;14;1517.00;28
3612;14;624865580;3612;299;4506;4530;7.91;0.48;235.11;3.72;894;14;1518.00;24
3616;14;624865591;3616;299;4508;4530;7.86;0.48;235.18;3.72;892;14;1519.00;22
3622;14;624865603;3622;303;4510;4531;7.83;0.48;235.17;3.73;888;14;1520.00;21
3625;14;624865614;3625;299;4511;4532;7.81;0.48;235.05;3.73;886;14;1521.00;21
3627;14;624865624;3627;311;4513;4532;7.78;0.47;235.19;3.73;886;14;1522.00;19
3630;14;624865634;3630;311;4517;4536;7.76;0.47;235.23;3.73;887;14;1523.00;19
3634;14;624865645;3634;311;4519;4536;7.70;0.47;235.36;3.74;885;14;1524.00;17
3638;14;624865656;3638;309;4519;4536;7.58;0.46;235.41;3.74;881;14;1525.00;17
3642;14;624865666;3642;314;4519;4536;7.44;0.45;235.52;3.74;877;14;1526.00;17
3643;14;624865677;3643;312;4523;4542;7.32;0.45;235.60;3.73;880;14;1527.00;19
3645;14;624865688;3645;322;4523;4542;7.14;0.44;235.75;3.73;878;14;1528.00;19
3649;14;624865698;3649;324;4524;4542;7.00;0.43;235.90;3.74;875;14;1529.00;18
3652;14;624865710;3652;314;4528;4548;6.94;0.43;236.03;3.75;876;14;1530.00;20
3655;14;624865724;3655;304;4528;4548;6.86;0.42;236.08;3.75;873;14;1531.00;20
3659;14;624865735;3659;302;4529;4548;6.78;0.42;236.11;3.75;870;14;1532.00;19
3663;14;624865750;3663;307;4533;4549;6.73;0.41;236.22;3.76;870;14;1533.00;16
3667;14;624865761;3667;307;4534;4550;6.75;0.42;236.45;3.76;867;14;1534.00;16
3671;14;624865773;3671;311;4536;4550;6.70;0.41;236.33;3.77;865;14;1535.00;14
3673;14;624865784;3673;318;4548;4563;6.73;0.41;236.41;3.76;875;14;1536.00;15
3677;14;624865796;3677;307;4550;4563;6.71;0.41;236.32;3.76;873;14;1537.00;13
3680;14;624865807;3680;299;4552;4563;6.79;0.42;236.50;3.77;872;14;1538.00;11
3683;14;624865818;3683;296;4553;4564;6.84;0.42;236.64;3.77;870;14;1539.00;11
3687;14;624865829;3687;294;4553;4564;6.89;0.42;236.78;3.77;866;14;1540.00;11
3691;14;624865841;3691;290;4558;4568;6.99;0.43;236.74;3.78;867;14;1541.00;10
3695;14;624865853;3695;281;4559;4568;7.01;0.43;236.93;3.78;864;14;1542.00;9
3698;14;624865864;3698;288;4564;4572;7.05;0.43;236.98;3.78;866;14;1543.00;8
3703;14;624865875;3703;286;4564;4572;7.05;0.43;236.91;3.78;861;14;1544.00;8
3705;14;624865886;3705;291;4566;4572;7.11;0.43;236.83;3.78;861;14;1545.00;6
3710;14;624865897;3710;292;4566;4572;7.11;0.43;236.95;3.78;856;14;1546.00;6
3716;14;624865907;3716;293;4567;4572;7.09;0.43;237.19;3.78;851;14;1547.00;5
3720;14;624865918;3720;290;4578;4584;7.14;0.44;237.16;3.77;858;14;1548.00;6
3723;14;624865930;3723;289;4579;4584;7.08;0.43;237.24;3.77;856;14;1549.00;5
3725;14;624865940;3725;299;4579;4584;7.05;0.43;237.32;3.77;854;14;1550.00;5
3726;14;624865951;3726;297;4579;4584;7.05;0.43;237.29;3.77;853;14;1551.00;5
3730;14;624865963;3730;297;4579;4584;7.04;0.43;237.29;3.77;849;14;1552.00;5
3734;14;624865975;3734;298;4579;4584;7.04;0.43;237.22;3.77;845;14;1553.00;5
3737;14;624865985;3737;305;4580;4585;6.98;0.43;237.25;3.77;843;14;1554.00;5
3740;14;624865996;3740;309;4582;4587;6.93;0.42;237.21;3.77;842;14;1555.00;5
3742;14;624866007;3742;309;4588;4593;6.83;0.42;237.21;3.77;846;14;1556.00;5
3750;14;624866018;3750;305;4589;4594;6.79;0.41;237.25;3.77;839;14;1557.00;5
3753;14;624866029;3753;314;4589;4594;6.76;0.41;237.34;3.77;836;14;1558.00;5
3757;14;624866039;3757;318;4589;4594;6.64;0.40;237.25;3.77;832;14;1559.00;5
3761;14;624866051;3761;315;4594;4599;6.58;0.40;237.31;3.76;833;14;1560.00;5
3764;14;624866061;3764;322;4594;4599;6.55;0.40;237.40;3.76;830;14;1561.00;5
3769;14;624866071;3769;321;4594;4599;6.47;0.39;237.25;3.76;825;14;1562.00;5
3773;14;624866082;3773;325;4595;4600;6.42;0.39;237.26;3.76;822;14;1563.00;5
3776;14;624866091;3776;328;4599;4604;6.34;0.39;237.41;3.76;823;14;1564.00;5
3779;14;624866101;3779;333;4599;4604;6.22;0.38;237.32;3.76;820;14;1565.00;5
3782;14;624866111;3782;341;4601;4607;6.15;0.37;237.40;3.76;819;14;1566.00;6
3788;14;624866121;3788;341;4601;4607;6.01;0.37;237.24;3.76;813;14;1567.00;6
3789;14;624866131;3789;341;4602;4607;6.00;0.37;237.18;3.76;813;14;1568.00;5
3796;14;624866140;3796;347;4603;4607;5.88;0.36;237.07;3.79;807;14;1569.00;4
3801;14;624866149;3801;350;4607;4611;5.86;0.36;237.02;3.78;806;14;1570.00;4
3803;14;624866159;3803;353;4607;4611;5.84;0.36;236.99;3.78;804;14;1571.00;4
3807;14;624866168;3807;359;4607;4611;5.74;0.35;236.94;3.78;800;14;1572.00;4
3809;14;624866177;3809;360;4607;4611;5.66;0.35;236.92;3.78;798;14;1573.00;4
3811;14;624866187;3811;365;4608;4612;5.59;0.34;236.99;3.78;797;14;1574.00;4
3815;14;624866197;3815;368;4610;4614;5.58;0.34;236.95;3.78;795;14;1575.00;4
3816;14;624866206;3816;375;4610;4614;5.56;0.34;236.92;3.78;794;14;1576.00;4
3817;14;624866216;3817;362;4611;4615;5.57;0.34;236.91;3.78;794;14;1577.00;4
3818;14;624866225;3818;354;4611;4615;5.61;0.34;236.90;3.78;793;14;1578.00;4
3818;14;624866234;3818;357;4611;4615;5.61;0.34;236.90;3.78;793;14;1579.00;4
3820;14;624866243;3820;352;4611;4615;5.64;0.34;236.90;3.78;791;14;1580.00;4
3822;14;624866253;3822;351;4611;4615;5.69;0.35;236.89;3.78;789;14;1581.00;4
3822;14;624866263;3822;357;4611;4615;5.75;0.35;236.89;3.78;789;14;1582.00;4
3823;14;624866272;3823;358;4611;4615;5.79;0.35;236.87;3.78;788;14;1583.00;4
3823;14;624866281;3823;381;4682;4742;6.26;0.39;236.87;3.72;859;14;1584.00;60
3823;14;624866302;3823;378;4685;4743;6.32;0.39;236.87;3.72;862;14;1585.00;58
3825;14;624866313;3825;357;4694;4743;6.42;0.40;236.90;3.72;869;14;1586.00;49
3828;14;624866323;3828;327;4696;4743;6.49;0.40;236.85;3.72;868;14;1587.00;47
3829;14;624866338;3829;311;4701;4743;6.57;0.41;236.80;3.72;872;14;1588.00;42
3829;14;624866348;3829;296;4702;4743;6.61;0.41;236.80;3.72;873;14;1589.00;41
3832;14;624866365;3832;278;4704;4743;6.65;0.41;236.82;3.72;872;14;1590.00;39
3832;14;624866375;3832;271;4706;4743;6.80;0.42;236.82;3.72;874;14;1591.00;37
3833;14;624866386;3833;274;4707;4744;6.88;0.42;236.85;3.72;874;14;1592.00;37
3834;14;624866397;3834;274;4712;4745;7.03;0.43;236.83;3.73;878;14;1593.00;33
3835;14;624866419;3835;270;4713;4745;7.16;0.44;236.80;3.73;878;14;1594.00;32
3835;14;624866429;3835;274;4716;4746;7.29;0.45;236.80;3.73;881;14;1595.00;30
3837;14;624866440;3837;266;4718;4746;7.43;0.46;236.82;3.74;881;14;1596.00;28
3838;14;624866451;3838;265;4720;4746;7.56;0.46;236.83;3.74;882;14;1597.00;26
3840;15;624866461;3840;258;4722;4746;7.69;0.47;236.78;3.75;882;15;1598.00;24
3842;15;624866484;3842;254;4729;4750;7.84;0.48;236.75;3.78;887;15;1599.00;21
3845;15;624866496;3845;254;4731;4750;7.94;0.48;236.77;3.79;886;15;1600.00;19
3845;15;624866511;3845;248;4733;4750;8.10;0.49;236.77;3.79;888;15;1601.00;17
3845;15;624866523;3845;244;4737;4753;8.23;0.50;236.77;3.80;892;15;1602.00;16
3846;15;624866535;3846;240;4739;4753;8.40;0.51;236.81;3.81;893;15;1603.00;14
3847;15;624866547;3847;232;4741;4753;8.51;0.52;236.80;3.81;894;15;1604.00;12
3848;15;624866560;3848;228;4745;4757;8.63;0.53;236.76;3.81;897;15;1605.00;12
3850;15;624866572;3850;221;4746;4758;8.81;0.54;236.72;3.81;896;15;1606.00;12
3852;15;624866583;3852;218;4746;4758;8.94;0.54;236.70;3.81;894;15;1607.00;12
3854;15;624866597;3854;214;4749;4762;9.03;0.55;236.81;3.81;895;15;1608.00;13
3856;15;624866611;3856;216;4751;4762;9.09;0.55;236.83;3.81;895;15;1609.00;11
3859;15;624866622;3859;211;4751;4762;9.24;0.56;236.90;3.81;892;15;1610.00;11
3861;15;624866634;3861;211;4752;4763;9.29;0.56;236.85;3.82;891;15;1611.00;11
3861;15;624866646;3861;212;4752;4763;9.31;0.57;236.85;3.82;891;15;1612.00;11
3865;15;624866660;3865;210;4758;4769;9.37;0.57;236.93;3.81;893;15;1613.00;11
3871;15;624866675;3871;205;4758;4769;9.41;0.57;236.88;3.81;887;15;1614.00;11
3873;15;624866688;3873;208;4758;4770;9.43;0.57;236.95;3.81;885;15;1615.00;12
3875;15;624866701;3875;205;4758;4770;9.42;0.57;236.94;3.81;883;15;1616.00;12
3877;15;624866724;3877;204;4759;4770;9.48;0.57;236.99;3.85;882;15;1617.00;11
3877;15;624866741;3877;200;4759;4770;9.53;0.58;236.99;3.85;882;15;1618.00;11
3882;15;624866758;3882;200;4759;4770;9.56;0.58;236.96;3.85;877;15;1619.00;11
3883;15;624866779;3883;200;4785;4806;9.58;0.58;237.03;3.83;902;15;1620.00;21
3885;15;624866812;3885;198;4785;4806;9.59;0.58;237.04;3.83;900;15;1621.00;21
3886;15;624866829;3886;199;4788;4806;9.60;0.58;237.05;3.83;902;15;1622.00;18
3889;15;624866847;3889;197;4788;4806;9.67;0.59;237.05;3.83;899;15;1623.00;18
3890;15;624866862;3890;196;4789;4806;9.77;0.59;237.03;3.83;899;15;1624.00;17
3892;15;624866877;3892;194;4790;4806;9.80;0.60;237.13;3.83;898;15;1625.00;16
3892;15;624866891;3892;197;4793;4810;9.87;0.60;237.13;3.82;901;15;1626.00;17
3895;15;624866913;3895;199;4793;4810;9.94;0.60;237.21;3.82;898;15;1627.00;17
3897;15;624866925;3897;196;4797;4814;9.93;0.60;237.18;3.82;900;15;1628.00;17
3901;15;624866939;3901;197;4798;4815;9.88;0.60;237.21;3.82;897;15;1629.00;17
3906;15;624866951;3906;192;4798;4815;9.83;0.60;237.27;3.82;892;15;1630.00;17
3908;15;624866963;3908;190;4799;4815;9.85;0.60;237.30;3.86;891;15;1631.00;16
3917;15;624866976;3917;189;4810;4828;9.79;0.60;237.36;3.85;893;15;1632.00;18
3919;15;624866990;3919;182;4810;4828;9.81;0.60;237.35;3.85;891;15;1633.00;18
3923;15;624867002;3923;179;4810;4828;9.82;0.60;237.34;3.85;887;15;1634.00;18
3929;15;624867014;3929;179;4813;4829;9.78;0.60;237.40;3.89;884;15;1635.00;16
3930;15;624867027;3930;180;4813;4830;9.81;0.60;237.40;3.89;883;15;1636.00;17
3933;15;624867039;3933;174;4813;4830;9.82;0.60;237.44;3.89;880;15;1637.00;17
3936;15;624867050;3936;171;4815;4833;9.88;0.60;237.61;3.88;879;15;1638.00;18
3939;15;624867064;3939;174;4817;4833;9.89;0.60;237.51;3.89;878;15;1639.00;16
3942;15;624867076;3942;171;4817;4833;9.93;0.61;237.45;3.89;875;15;1640.00;16
3945;15;624867088;3945;164;4817;4833;9.99;0.61;237.52;3.89;872;15;1641.00;16
3948;15;624867100;3948;161;4823;4839;10.06;0.61;237.44;3.90;875;15;1642.00;16
3954;15;624867114;3954;160;4823;4839;10.06;0.61;237.50;3.90;869;15;1643.00;16
3957;15;624867128;3957;160;4823;4839;10.07;0.61;237.50;3.90;866;15;1644.00;16
3958;15;624867143;3958;164;4824;4839;10.05;0.61;237.48;3.91;866;15;1645.00;15
3962;15;624867156;3962;169;4827;4843;10.01;0.61;237.48;3.90;865;15;1646.00;16
3965;15;624867177;3965;165;4828;4844;10.03;0.61;237.65;3.90;863;15;1647.00;16
3965;15;624867191;3965;166;4828;4844;10.05;0.61;237.65;3.90;863;15;1648.00;16
3968;15;624867204;3968;165;4831;4845;10.05;0.61;237.72;3.92;863;15;1649.00;14
3971;15;624867218;3971;170;4831;4845;10.04;0.61;237.75;3.92;860;15;1650.00;14
3973;15;624867230;3973;169;4831;4845;10.02;0.61;237.83;3.92;858;15;1651.00;14
3974;15;624867243;3974;170;4831;4845;10.03;0.61;237.93;3.92;857;15;1652.00;14
3976;15;624867254;3976;171;4831;4845;10.07;0.61;238.06;3.92;855;15;1653.00;14
3977;15;624867266;3977;174;4831;4845;10.08;0.61;238.02;3.92;854;15;1654.00;14
3979;15;624867277;3979;177;4831;4845;10.04;0.61;238.13;3.92;852;15;1655.00;14
3983;15;624867289;3983;183;4869;4915;10.01;0.61;238.19;3.90;886;15;1656.00;46
3986;15;624867306;3986;184;4871;4916;10.00;0.61;238.33;3.90;885;15;1657.00;45
3989;15;624867318;3989;188;4876;4916;10.02;0.61;238.42;3.90;887;15;1658.00;40
3993;15;624867330;3993;193;4882;4916;9.93;0.60;238.58;3.92;889;15;1659.00;34
3997;15;624867350;3997;198;4885;4916;9.92;0.60;238.70;3.92;888;15;1660.00;31
3999;15;624867363;3999;202;4888;4916;9.91;0.60;238.77;3.92;889;15;1661.00;28
4003;15;624867375;4003;200;4893;4916;9.82;0.60;238.86;3.94;890;15;1662.00;23
4005;15;624867386;4005;202;4895;4916;9.82;0.60;239.01;3.94;890;15;1663.00;21
4009;15;624867398;4009;201;4897;4917;9.82;0.60;239.04;3.95;888;15;1664.00;20
4012;15;624867410;4012;201;4902;4919;9.73;0.59;239.12;3.96;890;15;1665.00;17
4014;15;624867422;4014;203;4906;4919;9.71;0.59;239.28;3.97;892;15;1666.00;13
4018;15;624867434;4018;202;4910;4923;9.66;0.59;239.38;3.98;892;15;1667.00;13
4021;15;624867446;4021;205;4911;4923;9.60;0.59;239.50;3.98;890;15;1668.00;12
4022;15;624867458;4022;207;4912;4923;9.57;0.59;239.44;3.98;890;15;1669.00;11
4025;15;624867470;4025;216;4913;4923;9.50;0.58;239.42;3.99;888;15;1670.00;10
4026;15;624867482;4026;219;4919;4929;9.50;0.58;239.44;3.98;893;15;1671.00;10
4033;15;624867495;4033;226;4920;4929;9.44;0.58;239.46;3.99;887;15;1672.00;9
4038;15;624867507;4038;233;4922;4929;9.39;0.57;239.50;4.00;884;15;1673.00;7
4041;15;624867518;4041;238;4925;4932;9.33;0.57;239.58;4.01;884;15;1674.00;7
4043;15;624867530;4043;246;4927;4932;9.25;0.56;239.71;4.01;884;15;1675.00;5
4045;15;624867542;4045;248;4928;4932;9.14;0.56;239.70;4.01;883;15;1676.00;4
4048;15;624867552;4048;259;4928;4933;9.01;0.55;239.79;4.01;880;15;1677.00;5
4051;15;624867566;4051;256;4932;4934;8.83;0.54;239.89;4.02;881;15;1678.00;2
4053;15;624867577;4053;259;4932;4934;8.69;0.53;239.98;4.02;879;15;1679.00;2
4057;15;624867590;4057;260;4948;4960;8.51;0.52;240.02;4.00;891;15;1680.00;12
4061;15;624867603;4061;258;4949;4960;8.38;0.51;239.93;4.00;888;15;1681.00;11
4063;15;624867614;4063;262;4953;4960;8.27;0.50;239.96;4.01;890;15;1682.00;7
4066;15;624867625;4066;257;4956;4961;8.19;0.50;240.04;4.01;890;15;1683.00;5
4068;15;624867635;4068;261;4956;4961;8.04;0.49;240.18;4.01;888;15;1684.00;5
4069;15;624867646;4069;263;4961;4965;8.00;0.49;240.25;4.01;892;15;1685.00;4
4072;15;624867656;4072;272;4961;4965;7.92;0.48;240.30;4.01;889;15;1686.00;4
4073;15;624867667;4073;285;4964;4969;7.84;0.48;240.27;4.01;891;15;1687.00;5
4075;15;624867677;4075;286;4964;4969;7.78;0.48;240.35;4.01;889;15;1688.00;5
4078;15;624867687;4078;292;4964;4969;7.70;0.47;240.43;4.01;886;15;1689.00;5
4079;15;624867697;4079;296;4964;4969;7.61;0.47;240.39;4.01;885;15;1690.00;5
4079;15;624867706;4079;298;4965;4969;7.52;0.46;240.39;4.01;886;15;1691.00;4
4082;15;624867715;4082;307;4976;4981;7.48;0.46;240.40;4.00;894;15;1692.00;5
4086;15;624867727;4086;307;4977;4981;7.37;0.45;240.47;4.00;891;15;1693.00;4
4090;15;624867736;4090;303;4979;4981;7.24;0.44;240.48;4.00;889;15;1694.00;2
4095;15;624867745;4095;315;4979;4981;7.06;0.43;240.52;4.00;884;15;1695.00;2
4101;15;624867754;4101;315;4979;4981;6.91;0.42;240.51;4.00;878;15;1696.00;2
4105;15;624867763;4105;319;4979;4981;6.76;0.41;240.60;4.00;874;15;1697.00;2
4111;15;624867772;4111;317;4980;4982;6.54;0.40;240.68;4.00;869;15;1698.00;2
4116;15;624867781;4116;326;4980;4982;6.29;0.38;240.70;4.00;864;15;1699.00;2
4120;15;624867790;4120;316;4986;4988;6.17;0.38;240.87;4.00;866;15;1700.00;2
4122;15;624867803;4122;315;4987;4989;6.01;0.37;240.89;3.99;865;15;1701.00;2
4125;15;624867811;4125;313;4987;4989;5.88;0.36;241.03;3.99;862;15;1702.00;2
4127;15;624867820;4127;309;4987;4989;5.76;0.35;241.10;3.99;860;15;1703.00;2
4127;15;624867828;4127;310;4991;4993;5.76;0.35;241.10;3.99;864;15;1704.00;2
4132;15;624867836;4132;313;4991;4993;5.69;0.35;241.14;3.99;859;15;1705.00;2
4137;15;624867845;4137;321;4991;4993;5.72;0.35;241.20;3.99;854;15;1706.00;2
4138;15;624867853;4138;316;4992;4994;5.79;0.36;241.28;3.99;854;15;1707.00;2
4141;15;624867862;4141;307;4996;4998;5.95;0.37;241.36;3.99;855;15;1708.00;2
4146;15;624867871;4146;310;4996;4998;6.03;0.37;241.40;3.99;850;15;1709.00;2
4148;15;624867881;4148;313;5000;5004;6.17;0.38;241.41;3.99;852;15;1710.00;4
4151;15;624867890;4151;316;5000;5004;6.21;0.38;241.37;3.99;849;15;1711.00;4
4156;15;624867900;4156;313;5002;5004;6.25;0.38;241.48;3.98;846;15;1712.00;2
4158;15;624867909;4158;311;5002;5004;6.29;0.39;241.46;3.98;844;15;1713.00;2
4161;15;624867918;4161;313;5006;5008;6.37;0.39;241.51;3.98;845;15;1714.00;2
4164;15;624867927;4164;320;5006;5008;6.33;0.39;241.46;3.98;842;15;1715.00;2
4167;15;624867936;4167;321;5006;5008;6.29;0.39;241.42;3.98;839;15;1716.00;2
4170;15;624867945;4170;328;5006;5008;6.20;0.38;241.46;3.98;836;15;1717.00;2
4172;15;624867954;4172;332;5007;5009;6.16;0.38;241.40;3.98;835;15;1718.00;2
4178;15;624867963;4178;341;5008;5010;6.07;0.38;241.26;3.98;830;15;1719.00;2
4184;15;624867973;4184;339;5008;5010;5.99;0.37;241.44;3.98;824;15;1720.00;2
4186;15;624867982;4186;340;5009;5011;5.93;0.37;241.46;3.98;823;15;1721.00;2
4193;15;624867990;4193;344;5009;5011;5.78;0.36;241.27;3.98;816;15;1722.00;2
4198;15;624868000;4198;348;5009;5011;5.74;0.35;241.20;3.98;811;15;1723.00;2
4202;15;624868009;4202;343;5009;5011;5.75;0.35;241.25;3.98;807;15;1724.00;2
4206;15;624868018;4206;341;5009;5011;5.71;0.35;241.21;3.98;803;15;1725.00;2
4210;15;624868027;4210;342;5009;5011;5.70;0.35;241.25;3.98;799;15;1726.00;2
4213;15;624868035;4213;341;5009;5011;5.67;0.35;241.24;3.98;796;15;1727.00;2
4218;15;624868044;4218;361;5088;5138;6.03;0.38;241.16;3.93;870;15;1728.00;50
4220;15;624868062;4220;359;5091;5139;6.02;0.37;241.17;3.93;871;15;1729.00;48
4225;15;624868072;4225;356;5098;5139;6.06;0.38;241.20;3.92;873;15;1730.00;41
4228;15;624868081;4228;356;5100;5139;6.07;0.38;241.26;3.92;872;15;1731.00;39
4231;15;624868091;4231;348;5106;5139;6.11;0.38;241.28;3.92;875;15;1732.00;33
4234;15;624868100;4234;349;5108;5139;6.12;0.38;241.32;3.92;874;15;1733.00;31
4237;15;624868114;4237;355;5111;5139;6.09;0.38;241.25;3.93;874;15;1734.00;28
4241;15;624868123;4241;349;5114;5139;6.09;0.38;241.45;3.94;873;15;1735.00;25
4244;15;624868133;4244;350;5117;5140;6.09;0.38;241.46;3.94;873;15;1736.00;23
4246;15;624868142;4246;354;5122;5141;6.04;0.37;241.46;3.94;876;15;1737.00;19
4248;15;624868152;4248;350;5126;5141;5.96;0.37;241.52;3.95;878;15;1738.00;15
4250;15;624868162;4250;345;5129;5142;5.97;0.37;241.55;3.95;879;15;1739.00;13
4253;15;624868173;4253;343;5131;5142;6.00;0.37;241.53;3.95;878;15;1740.00;11
4254;15;624868182;4254;339;5132;5142;6.07;0.37;241.56;3.96;878;15;1741.00;10
4256;15;624868192;4256;338;5136;5142;6.14;0.38;241.61;3.96;880;15;1742.00;6
4258;15;624868202;4258;342;5140;5146;6.20;0.38;241.61;3.96;882;15;1743.00;6
4260;15;624868212;4260;335;5142;5146;6.24;0.39;241.63;3.96;882;15;1744.00;4
4264;15;624868222;4264;334;5143;5146;6.28;0.39;241.61;3.97;879;15;1745.00;3
4265;15;624868238;4265;330;5145;5149;6.33;0.39;241.62;3.97;880;15;1746.00;4
4270;15;624868248;4270;323;5146;5149;6.38;0.39;241.77;3.97;876;15;1747.00;3
4272;15;624868258;4272;314;5146;5149;6.44;0.40;241.82;3.97;874;15;1748.00;3
4276;15;624868269;4276;303;5152;5153;6.51;0.40;241.82;3.97;876;15;1749.00;1
4277;15;624868280;4277;294;5153;5154;6.61;0.41;241.87;3.97;876;15;1750.00;1
4278;15;624868290;4278;286;5153;5154;6.77;0.42;241.88;3.97;875;15;1751.00;1
4280;15;624868301;4280;281;5157;5158;6.88;0.42;241.82;3.97;877;15;1752.00;1
4282;15;624868311;4282;278;5157;5158;6.96;0.43;241.85;3.97;875;15;1753.00;1
4285;15;624868328;4285;274;5158;5158;7.07;0.43;241.84;3.97;873;15;1754.00;0
4288;15;624868339;4288;276;5160;5160;7.18;0.44;241.78;3.97;872;15;1755.00;0
4290;15;624868351;4290;262;5160;5160;7.21;0.44;241.78;3.97;870;15;1756.00;0
4295;15;624868362;4295;246;5166;5166;7.36;0.45;241.75;3.96;871;15;1757.00;0
4296;15;624868375;4296;238;5166;5166;7.48;0.46;241.89;3.96;870;15;1758.00;0
4298;15;624868387;4298;223;5167;5167;7.59;0.46;241.91;3.96;869;15;1759.00;0
4303;15;624868400;4303;224;5167;5167;7.76;0.47;241.97;3.96;864;15;1760.00;0
4305;15;624868411;4305;215;5167;5167;7.90;0.48;241.93;3.96;862;15;1761.00;0
4308;15;624868428;4308;212;5167;5167;8.02;0.49;242.03;3.96;859;15;1762.00;0
4310;15;624868439;4310;207;5167;5167;8.17;0.50;241.97;3.96;857;15;1763.00;0
4310;15;624868450;4310;205;5178;5179;8.41;0.51;241.97;3.95;868;15;1764.00;1
4312;15;624868462;4312;201;5178;5179;8.55;0.52;241.92;3.95;866;15;1765.00;1
4314;15;624868473;4314;199;5179;5179;8.68;0.53;241.93;3.95;865;15;1766.00;0
4315;15;624868484;4315;193;5179;5179;8.79;0.53;241.98;3.95;864;15;1767.00;0
4321;15;624868495;4321;189;5179;5179;8.83;0.54;242.03;3.95;858;15;1768.00;0
4324;15;624868506;4324;187;5179;5179;8.95;0.54;242.12;3.95;855;15;1769.00;0
4326;15;624868519;4326;189;5182;5183;8.97;0.54;242.11;3.95;856;15;1770.00;1
4331;15;624868532;4331;189;5182;5183;8.96;0.54;242.12;3.95;851;15;1771.00;1
4334;15;624868543;4334;187;5186;5187;8.99;0.54;242.34;3.95;852;15;1772.00;1
4335;15;624868555;4335;181;5187;5188;9.08;0.55;242.30;3.95;852;15;1773.00;1
4336;15;624868567;4336;183;5187;5188;9.15;0.55;242.28;3.95;851;15;1774.00;1
4338;15;624868579;4338;184;5187;5188;9.18;0.56;242.39;3.95;849;15;1775.00;1
4339;15;624868590;4339;180;5198;5201;9.33;0.57;242.44;3.94;859;15;1776.00;3
4342;15;624868603;4342;181;5198;5201;9.32;0.56;242.46;3.94;856;15;1777.00;3
4344;15;624868615;4344;179;5198;5201;9.37;0.57;242.58;3.94;854;15;1778.00;3
4346;15;624868626;4346;177;5199;5202;9.47;0.57;242.61;3.94;853;15;1779.00;3
4348;15;624868637;4348;176;5199;5203;9.55;0.58;242.75;3.94;851;15;1780.00;4
4350;15;624868648;4350;177;5199;5203;9.64;0.58;242.86;3.94;849;15;1781.00;4
4354;15;624868660;4354;181;5201;5206;9.77;0.59;243.01;3.94;847;15;1782.00;5
4359;15;624868672;4359;174;5201;5206;9.78;0.59;243.19;3.94;842;15;1783.00;5
4360;15;624868683;4360;180;5202;5206;9.84;0.60;243.17;3.94;842;15;1784.00;4
4363;15;624868694;4363;180;5202;5206;9.84;0.60;243.11;3.94;839;15;1785.00;4
4367;15;624868704;4367;177;5207;5212;9.86;0.60;243.19;3.94;840;15;1786.00;5
4371;15;624868717;4371;181;5207;5212;9.87;0.60;243.18;3.94;836;15;1787.00;5
4374;15;624868733;4374;182;5207;5212;9.86;0.60;243.34;3.94;833;15;1788.00;5
4376;15;624868751;4376;183;5207;5212;9.87;0.60;243.31;3.94;831;15;1789.00;5
4378;15;624868769;4378;179;5210;5216;9.80;0.59;243.34;3.93;832;15;1790.00;6
4381;15;624868788;4381;174;5211;5217;9.83;0.60;243.39;3.93;830;15;1791.00;6
4384;15;624868807;4384;176;5211;5217;9.90;0.60;243.38;3.93;827;15;1792.00;6
4386;15;624868823;4386;178;5212;5218;9.94;0.60;243.39;3.93;826;15;1793.00;6
4389;15;624868841;4389;181;5212;5218;10.00;0.61;243.51;3.93;823;15;1794.00;6
4394;15;624868856;4394;180;5212;5218;10.01;0.61;243.56;3.93;818;15;1795.00;6
4397;15;624868869;4397;180;5212;5218;10.10;0.61;243.57;3.93;815;15;1796.00;6
4398;15;624868881;4398;176;5212;5218;10.10;0.61;243.58;3.93;814;15;1797.00;6
4403;15;624868895;4403;179;5212;5218;10.09;0.61;243.62;3.93;809;15;1798.00;6
4405;15;624868908;4405;178;5212;5218;10.16;0.62;243.65;3.93;807;15;1799.00;6
4410;15;624868923;4410;202;5280;5356;9.83;0.60;243.77;3.88;870;15;1800.00;76
4413;15;624868955;4413;195;5280;5357;9.82;0.60;243.82;3.88;867;15;1801.00;77
4419;15;624868969;4419;180;5291;5357;9.82;0.60;244.02;3.88;872;15;1802.00;66
4420;15;624868981;4420;174;5291;5357;9.88;0.61;244.04;3.88;871;15;1803.00;66
4423;15;624868992;4423;176;5297;5357;9.95;0.61;244.13;3.88;874;15;1804.00;60
4430;15;624869004;4430;177;5302;5357;10.00;0.61;244.25;3.89;872;15;1805.00;55
4432;15;624869018;4432;178;5309;5357;10.03;0.62;244.33;3.89;877;15;1806.00;48
4434;15;624869030;4434;184;5314;5357;10.01;0.61;244.30;3.90;880;15;1807.00;43
4440;15;624869042;4440;182;5317;5358;10.04;0.62;244.39;3.90;877;15;1808.00;41
4443;15;624869055;4443;181;5324;5359;9.99;0.61;244.45;3.90;881;15;1809.00;35
4446;15;624869066;4446;178;5326;5359;10.01;0.61;244.51;3.91;880;15;1810.00;33
4450;15;624869078;4450;176;5330;5363;10.02;0.61;244.55;3.90;880;15;1811.00;33
4454;15;624869091;4454;177;5331;5363;9.95;0.61;244.50;3.90;877;15;1812.00;32
4457;15;624869103;4457;173;5331;5363;9.89;0.61;244.61;3.90;874;15;1813.00;32
4460;15;624869116;4460;177;5331;5363;9.83;0.60;244.57;3.90;871;15;1814.00;32
4463;15;624869128;4463;179;5336;5369;9.80;0.60;244.52;3.90;873;15;1815.00;33
4466;15;624869141;4466;183;5336;5369;9.74;0.60;244.46;3.90;870;15;1816.00;33
4471;15;624869160;4471;190;5336;5369;9.75;0.60;244.51;3.90;865;15;1817.00;33
4474;15;624869173;4474;191;5338;5372;9.76;0.60;244.56;3.90;864;15;1818.00;34
4480;15;624869184;4480;194;5338;5372;9.70;0.59;244.66;3.90;858;15;1819.00;34
4483;15;624869196;4483;200;5340;5372;9.68;0.59;244.74;3.91;857;15;1820.00;32
4487;15;624869208;4487;201;5343;5373;9.55;0.58;244.92;3.92;856;15;1821.00;30
4488;15;624869219;4488;205;5344;5374;9.48;0.58;244.98;3.91;856;15;1822.00;30
4493;15;624869231;4493;204;5344;5374;9.37;0.57;245.12;3.91;851;15;1823.00;30
4496;15;624869242;4496;208;5352;5387;9.26;0.57;245.18;3.91;856;15;1824.00;35
4498;15;624869256;4498;204;5357;5387;9.20;0.56;245.26;3.92;859;15;1825.00;30
4501;15;624869269;4501;208;5359;5387;9.16;0.56;245.32;3.93;858;15;1826.00;28
4507;15;624869281;4507;209;5360;5388;9.13;0.56;245.47;3.92;853;15;1827.00;28
4508;15;624869293;4508;213;5361;5388;9.12;0.56;245.45;3.92;853;15;1828.00;27
4510;15;624869305;4510;214;5364;5392;9.12;0.56;245.55;3.92;854;15;1829.00;28
4513;15;624869319;4513;211;5366;5392;9.10;0.56;245.77;3.94;853;15;1830.00;26
4514;15;624869330;4514;216;5370;5396;8.96;0.55;245.82;3.94;856;15;1831.00;26
4518;15;624869341;4518;218;5371;5396;8.88;0.54;245.77;3.95;853;15;1832.00;25
4522;15;624869352;4522;229;5372;5396;8.81;0.54;245.97;3.95;850;15;1833.00;24
4526;15;624869363;4526;231;5373;5396;8.69;0.53;246.06;3.96;847;15;1834.00;23
4527;15;624869374;4527;232;5373;5396;8.57;0.52;246.06;3.96;846;15;1835.00;23
4531;15;624869385;4531;242;5384;5408;8.56;0.52;246.00;3.96;853;15;1836.00;24
4534;15;624869397;4534;237;5385;5408;8.47;0.52;246.04;3.97;851;15;1837.00;23
4536;15;624869407;4536;246;5387;5408;8.42;0.52;246.17;3.97;851;15;1838.00;21
4537;15;624869417;4537;260;5387;5408;8.35;0.51;246.17;3.97;850;15;1839.00;21
4539;15;624869427;4539;268;5389;5408;8.29;0.51;246.24;3.98;850;15;1840.00;19
4540;15;624869438;4540;270;5389;5408;8.20;0.50;246.21;3.98;849;15;1841.00;19
4542;15;624869448;4542;277;5391;5409;8.14;0.50;246.25;4.00;849;15;1842.00;18
4546;15;624869458;4546;287;5392;5409;8.05;0.49;246.17;4.00;846;15;1843.00;17
4549;15;624869471;4549;288;5397;5415;8.06;0.49;246.32;4.00;848;15;1844.00;18
4551;15;624869482;4551;295;5401;5417;8.00;0.49;246.36;4.01;850;15;1845.00;16
4557;15;624869493;4557;302;5402;5417;7.86;0.48;246.39;4.02;845;15;1846.00;15
4557;15;624869502;4557;301;5404;5417;7.78;0.48;246.39;4.02;847;15;1847.00;13
4562;15;624869512;4562;306;5407;5421;7.69;0.47;246.50;4.02;845;15;1848.00;14
4566;15;624869523;4566;300;5408;5421;7.63;0.47;246.64;4.02;842;15;1849.00;13
4568;15;624869533;4568;299;5408;5421;7.58;0.47;246.65;4.02;840;15;1850.00;13
4571;15;624869543;4571;299;5410;5422;7.51;0.46;246.64;4.02;839;15;1851.00;12
4573;15;624869553;4573;299;5413;5426;7.44;0.46;246.60;4.02;840;15;1852.00;13
4574;15;624869562;4574;300;5415;5426;7.40;0.45;246.59;4.03;841;15;1853.00;11
4576;15;624869572;4576;301;5417;5429;7.43;0.46;246.61;4.02;841;15;1854.00;12
4576;15;624869582;4576;302;5417;5429;7.39;0.45;246.61;4.02;841;15;1855.00;12
4579;15;624869592;4579;309;5419;5429;7.37;0.45;246.61;4.03;840;15;1856.00;10
4579;15;624869601;4579;308;5419;5429;7.36;0.45;246.61;4.03;840;15;1857.00;10
4580;15;624869610;4580;313;5424;5433;7.42;0.46;246.67;4.02;844;15;1858.00;9
4583;15;624869619;4583;318;5424;5433;7.37;0.45;246.60;4.02;841;15;1859.00;9
4586;15;624869630;4586;320;5424;5433;7.29;0.45;246.77;4.02;838;15;1860.00;9
4589;15;624869640;4589;322;5424;5433;7.16;0.44;246.75;4.02;835;15;1861.00;9
4594;15;624869649;4594;330;5425;5434;6.99;0.43;246.68;4.02;831;15;1862.00;9
4598;15;624869658;4598;338;5426;5435;6.83;0.42;246.59;4.02;828;15;1863.00;9
4602;15;624869666;4602;334;5426;5435;6.67;0.41;246.52;4.02;824;15;1864.00;9
4605;15;624869675;4605;341;5427;5436;6.55;0.40;246.55;4.02;822;15;1865.00;9
4610;15;624869683;4610;341;5427;5436;6.35;0.39;246.54;4.02;817;15;1866.00;9
4611;15;624869692;4611;346;5427;5436;6.19;0.38;246.49;4.02;816;15;1867.00;9
4613;15;624869700;4613;358;5427;5436;6.03;0.37;246.51;4.02;814;15;1868.00;9
4615;15;624869708;4615;362;5427;5436;5.90;0.36;246.43;4.02;812;15;1869.00;9
4617;15;624869716;4617;356;5427;5436;5.84;0.36;246.49;4.02;810;15;1870.00;9
4622;15;624869725;4622;352;5427;5436;5.72;0.36;246.41;4.02;805;15;1871.00;9
4624;15;624869733;4624;371;5498;5563;6.08;0.38;246.41;3.97;874;15;1872.00;65
4628;15;624869751;4628;362;5502;5564;6.02;0.38;246.38;3.97;874;15;1873.00;62
4629;15;624869760;4629;351;5512;5564;6.14;0.39;246.42;3.96;883;15;1874.00;52
4636;15;624869769;4636;347;5516;5564;6.08;0.38;246.36;3.96;880;15;1875.00;48
4639;15;624869778;4639;347;5523;5564;6.11;0.38;246.25;3.96;884;15;1876.00;41
4640;15;624869787;4640;339;5525;5564;6.13;0.39;246.28;3.96;885;15;1877.00;39
4642;15;624869795;4642;340;5528;5564;6.19;0.39;246.29;3.97;886;15;1878.00;36
4647;15;624869804;4647;336;5532;5564;6.23;0.39;246.35;3.97;885;15;1879.00;32
4648;15;624869813;4648;336;5535;5565;6.30;0.39;246.31;3.97;887;15;1880.00;30
4652;15;624869821;4652;338;5539;5566;6.28;0.39;246.34;3.97;887;15;1881.00;27
4658;15;624869830;4658;340;5543;5568;6.27;0.39;246.29;3.97;885;15;1882.00;25
4659;15;624869840;4659;339;5547;5569;6.24;0.39;246.31;3.98;888;15;1883.00;22
4664;15;624869849;4664;350;5547;5569;6.21;0.38;246.37;3.98;883;15;1884.00;22
4667;15;624869858;4667;350;5551;5569;6.19;0.38;246.36;3.98;884;15;1885.00;18
4670;15;624869867;4670;359;5551;5569;6.15;0.38;246.34;3.98;881;15;1886.00;18
4672;15;624869876;4672;361;5557;5573;6.15;0.38;246.40;3.98;885;15;1887.00;16
4676;15;624869885;4676;362;5557;5573;6.08;0.38;246.39;3.98;881;15;1888.00;16
4679;15;624869894;4679;364;5558;5573;6.05;0.37;246.36;3.99;879;15;1889.00;15
4682;15;624869904;4682;370;5563;5579;6.02;0.37;246.40;3.99;881;15;1890.00;16
4684;15;624869914;4684;366;5564;5579;6.05;0.37;246.38;3.99;880;15;1891.00;15
4687;15;624869924;4687;357;5565;5579;6.10;0.37;246.38;3.99;878;15;1892.00;14
4689;15;624869933;4689;358;5570;5583;6.20;0.38;246.45;3.99;881;15;1893.00;13
4693;15;624869943;4693;355;5572;5584;6.24;0.38;246.40;3.99;879;15;1894.00;12
4696;15;624869953;4696;356;5572;5584;6.26;0.38;246.40;3.99;876;15;1895.00;12
4698;15;624869963;4698;352;5577;5588;6.34;0.39;246.37;3.99;879;15;1896.00;11
4701;15;624869974;4701;349;5577;5588;6.37;0.39;246.31;3.99;876;15;1897.00;11
4705;15;624869984;4705;342;5577;5588;6.43;0.39;246.33;3.99;872;15;1898.00;11
4707;15;624869995;4707;341;5578;5589;6.52;0.40;246.45;3.99;871;15;1899.00;11
4710;15;624870007;4710;337;5578;5589;6.50;0.40;246.53;3.99;868;15;1900.00;11
4711;15;624870034;4711;339;5584;5595;6.58;0.40;246.56;3.98;873;15;1901.00;11
4714;15;624870046;4714;336;5584;5595;6.53;0.40;246.59;3.98;870;15;1902.00;11
4720;15;624870056;4720;337;5585;5596;6.45;0.39;246.55;3.98;865;15;1903.00;11
4722;15;624870067;4722;338;5585;5596;6.47;0.39;246.49;3.98;863;15;1904.00;11
4725;15;624870083;4725;339;5585;5596;6.45;0.39;246.49;3.98;860;15;1905.00;11
4727;15;624870099;4727;337;5585;5596;6.43;0.39;246.53;3.98;858;15;1906.00;11
4732;15;624870109;4732;340;5585;5596;6.39;0.39;246.47;3.98;853;15;1907.00;11
4736;15;624870119;4736;337;5596;5608;6.40;0.39;246.54;3.98;860;15;1908.00;12
4742;15;624870130;4742;338;5596;5608;6.33;0.38;246.49;3.98;854;15;1909.00;12
4743;15;624870140;4743;340;5598;5608;6.32;0.38;246.48;3.99;855;15;1910.00;10
4745;15;624870150;4745;340;5598;5608;6.35;0.39;246.45;3.99;853;15;1911.00;10
4750;15;624870160;4750;340;5598;5608;6.33;0.39;246.46;3.99;848;15;1912.00;10
4751;15;624870171;4751;326;5598;5608;6.43;0.39;246.49;3.99;847;15;1913.00;10
4752;15;624870182;4752;323;5602;5612;6.57;0.40;246.47;3.99;850;15;1914.00;10
4753;15;624870193;4753;316;5602;5612;6.65;0.40;246.49;3.99;849;15;1915.00;10
4755;15;624870204;4755;315;5606;5616;6.74;0.41;246.58;3.99;851;15;1916.00;10
4756;15;624870216;4756;295;5607;5617;6.86;0.42;246.61;3.99;851;15;1917.00;10
4757;15;624870226;4757;281;5607;5617;7.01;0.43;246.59;3.99;850;15;1918.00;10
4759;15;624870237;4759;274;5607;5617;7.14;0.43;246.69;3.99;848;15;1919.00;10
4760;15;624870250;4760;278;5632;5646;7.33;0.45;246.70;3.97;872;15;1920.00;14
4761;15;624870262;4761;268;5632;5646;7.46;0.45;246.77;3.97;871;15;1921.00;14
4763;15;624870274;4763;267;5633;5646;7.55;0.46;246.86;3.97;870;15;1922.00;13
4764;15;624870284;4764;260;5634;5647;7.65;0.46;246.84;3.97;870;15;1923.00;13
4766;15;624870295;4766;260;5634;5648;7.79;0.47;246.92;3.97;868;15;1924.00;14
4768;15;624870305;4768;259;5634;5648;7.85;0.48;246.97;3.97;866;15;1925.00;14
4771;15;624870317;4771;248;5636;5651;7.93;0.48;247.00;3.97;865;15;1926.00;15
4773;15;624870328;4773;238;5636;5651;7.96;0.48;247.02;3.97;863;15;1927.00;15
4774;15;624870345;4774;232;5637;5651;8.08;0.49;247.02;3.97;863;15;1928.00;14
4777;15;624870357;4777;234;5637;5651;8.16;0.50;247.10;3.97;860;15;1929.00;14
4780;15;624870368;4780;225;5642;5657;8.21;0.50;247.22;3.97;862;15;1930.00;15
4781;15;624870380;4781;221;5642;5657;8.25;0.50;247.26;3.97;861;15;1931.00;15
4785;15;624870392;4785;226;5642;5657;8.28;0.50;247.27;3.97;857;15;1932.00;15
4787;15;624870403;4787;225;5642;5657;8.31;0.50;247.37;3.97;855;15;1933.00;15
4791;15;624870415;4791;220;5645;5661;8.32;0.50;247.39;3.97;854;15;1934.00;16
4794;15;624870427;4794;216;5647;5663;8.41;0.51;247.52;3.96;853;15;1935.00;16
4797;15;624870439;4797;210;5647;5663;8.50;0.51;247.67;3.96;850;15;1936.00;16
4798;15;624870451;4798;204;5648;5664;8.61;0.52;247.63;3.96;850;15;1937.00;16
4800;15;624870462;4800;203;5648;5664;8.71;0.53;247.75;3.96;848;15;1938.00;16
4801;15;624870474;4801;197;5648;5664;8.85;0.54;247.83;3.96;847;15;1939.00;16
4803;15;624870486;4803;199;5648;5664;8.95;0.54;247.78;3.96;845;15;1940.00;16
4809;15;624870498;4809;197;5648;5664;9.04;0.55;247.95;3.96;839;15;1941.00;16
4814;15;624870509;4814;195;5648;5664;9.11;0.55;247.99;3.96;834;15;1942.00;16
4816;15;624870521;4816;191;5648;5664;9.15;0.55;248.05;3.96;832;15;1943.00;16
4818;15;624870532;4818;213;5691;5734;9.07;0.55;248.12;3.93;873;15;1944.00;43
4822;15;624870549;4822;199;5691;5735;9.15;0.55;248.28;3.93;869;15;1945.00;44
4824;15;624870561;4824;194;5695;5735;9.33;0.56;248.28;3.93;871;15;1946.00;40
4826;15;624870574;4826;190;5696;5735;9.41;0.57;248.31;3.93;870;15;1947.00;39
4828;16;624870586;4828;188;5697;5735;9.50;0.58;248.43;3.93;869;16;1948.00;38
4829;16;624870610;4829;188;5701;5735;9.61;0.58;248.51;3.96;872;16;1949.00;34
4832;16;624870625;4832;192;5704;5737;9.66;0.59;248.70;3.96;872;16;1950.00;33
4834;16;624870638;4834;197;5707;5737;9.72;0.59;248.87;3.96;873;16;1951.00;30
4837;16;624870650;4837;204;5709;5738;9.76;0.59;248.93;3.96;872;16;1952.00;29
4841;16;624870662;4841;200;5712;5739;9.81;0.60;249.05;3.96;871;16;1953.00;27
4844;16;624870674;4844;202;5715;5739;9.83;0.60;249.12;3.97;871;16;1954.00;24
4846;16;624870686;4846;205;5721;5743;9.86;0.60;249.09;3.97;875;16;1955.00;22
4851;16;624870697;4851;204;5722;5743;9.89;0.60;249.21;3.97;871;16;1956.00;21
4851;16;624870709;4851;200;5722;5743;9.90;0.60;249.21;3.97;871;16;1957.00;21
4855;16;624870721;4855;195;5722;5743;9.97;0.61;249.46;3.97;867;16;1958.00;21
4857;16;624870738;4857;189;5727;5749;10.03;0.61;249.48;3.96;870;16;1959.00;22
4861;16;624870759;4861;187;5727;5749;10.08;0.61;249.56;3.96;866;16;1960.00;22
4866;16;624870777;4866;189;5727;5749;10.07;0.61;249.67;3.96;861;16;1961.00;22
4868;16;624870795;4868;190;5729;5752;10.17;0.62;249.75;3.96;861;16;1962.00;23
4871;16;624870812;4871;190;5729;5752;10.23;0.62;249.85;3.96;858;16;1963.00;23
4875;16;624870830;4875;188;5730;5752;10.30;0.63;249.86;3.96;855;16;1964.00;22
4878;16;624870846;4878;187;5730;5753;10.30;0.62;249.94;3.96;852;16;1965.00;23
4881;16;624870860;4881;183;5731;5754;10.29;0.62;249.91;3.96;850;16;1966.00;23
4885;16;624870874;4885;184;5731;5754;10.29;0.62;249.98;3.96;846;16;1967.00;23
4886;16;624870887;4886;182;5742;5767;10.27;0.62;249.96;3.98;856;16;1968.00;25
4889;16;624870901;4889;182;5742;5767;10.30;0.62;250.01;3.98;853;16;1969.00;25
4893;16;624870914;4893;187;5742;5767;10.29;0.62;250.05;3.98;849;16;1970.00;25
4897;16;624870927;4897;181;5743;5768;10.23;0.62;250.05;3.98;846;16;1971.00;25
4899;16;624870941;4899;176;5743;5768;10.19;0.62;250.00;3.98;844;16;1972.00;25
4904;16;624870953;4904;171;5748;5772;10.22;0.62;250.02;3.98;844;16;1973.00;24
4907;16;624870966;4907;173;5749;5772;10.18;0.62;250.01;3.99;842;16;1974.00;23
4911;16;624870979;4911;176;5752;5776;10.08;0.61;250.02;3.99;841;16;1975.00;24
4915;16;624870992;4915;174;5753;5776;10.11;0.61;249.99;4.00;838;16;1976.00;23
4920;16;624871005;4920;170;5753;5776;10.16;0.62;250.04;4.00;833;16;1977.00;23
4922;16;624871018;4922;170;5753;5776;10.22;0.62;250.00;4.00;831;16;1978.00;23
4926;16;624871031;4926;170;5753;5776;10.22;0.62;249.98;4.00;827;16;1979.00;23
4930;16;624871044;4930;173;5773;5810;10.27;0.62;250.02;3.98;843;16;1980.00;37
4931;16;624871058;4931;166;5774;5810;10.27;0.63;250.01;3.98;843;16;1981.00;36
4934;16;624871070;4934;170;5776;5810;10.21;0.62;249.99;3.98;842;16;1982.00;34
4935;16;624871081;4935;170;5777;5810;10.17;0.62;249.98;3.98;842;16;1983.00;33
4940;16;624871093;4940;173;5777;5810;10.04;0.61;249.99;3.98;837;16;1984.00;33
4941;17;624871105;4941;171;5777;5810;9.95;0.61;250.00;3.98;836;17;1985.00;33
4945;17;624871137;4945;178;5777;5811;9.93;0.60;249.95;3.98;832;17;1986.00;34
4949;17;624871150;4949;181;5780;5811;9.90;0.60;250.05;4.02;831;17;1987.00;31
4954;17;624871162;4954;184;5784;5817;9.89;0.60;250.24;4.02;830;17;1988.00;33
4956;17;624871174;4956;186;5785;5818;9.84;0.60;250.17;4.02;829;17;1989.00;33
4962;17;624871185;4962;181;5785;5818;9.76;0.59;250.18;4.02;823;17;1990.00;33
4964;17;624871197;4964;184;5787;5818;9.71;0.59;250.20;4.02;823;17;1991.00;31
4967;17;624871208;4967;181;5790;5822;9.68;0.59;250.30;4.02;823;17;1992.00;32
4971;17;624871221;4971;179;5790;5822;9.62;0.59;250.26;4.02;819;17;1993.00;32
4973;17;624871235;4973;186;5791;5822;9.59;0.58;250.25;4.02;818;17;1994.00;31
4978;17;624871247;4978;190;5793;5823;9.45;0.57;250.33;4.02;815;17;1995.00;30
4980;17;624871261;4980;195;5798;5827;9.38;0.57;250.43;4.03;818;17;1996.00;29
4983;17;624871274;4983;192;5798;5827;9.35;0.57;250.45;4.03;815;17;1997.00;29
4986;17;624871285;4986;202;5800;5830;9.32;0.57;250.52;4.03;814;17;1998.00;30
4989;17;624871299;4989;208;5802;5830;9.26;0.56;250.60;4.04;813;17;1999.00;28
4992;17;624871312;4992;219;5802;5830;9.17;0.56;250.70;4.04;810;17;2000.00;28
4992;17;624871327;4992;227;5803;5830;9.04;0.55;250.70;4.05;811;17;2001.00;27
4994;17;624871339;4994;237;5808;5834;8.97;0.55;250.71;4.05;814;17;2002.00;26
4995;17;624871350;4995;246;5808;5834;8.90;0.54;250.75;4.05;813;17;2003.00;26
4999;17;624871361;4999;249;5810;5834;8.77;0.53;250.83;4.06;811;17;2004.00;24
5000;17;624871373;5000;255;5810;5834;8.70;0.53;250.88;4.06;810;17;2005.00;24
5003;17;624871383;5003;260;5812;5835;8.60;0.52;250.91;4.07;809;17;2006.00;23
5006;17;624871394;5006;264;5813;5836;8.53;0.52;250.90;4.07;807;17;2007.00;23
5008;17;624871404;5008;268;5814;5836;8.45;0.52;251.04;4.08;806;17;2008.00;22
5012;17;624871414;5012;270;5815;5837;8.33;0.51;251.08;4.08;803;17;2009.00;22
5014;17;624871426;5014;276;5816;5837;8.32;0.51;251.03;4.09;802;17;2010.00;21
5016;17;624871436;5016;281;5817;5837;8.29;0.51;251.06;4.10;801;17;2011.00;20
5018;17;624871447;5018;287;5819;5837;8.25;0.50;251.11;4.11;801;17;2012.00;18
5021;17;624871457;5021;292;5819;5837;8.19;0.50;251.12;4.11;798;17;2013.00;18
5023;17;624871469;5023;295;5821;5837;8.04;0.49;251.11;4.12;798;17;2014.00;16
5024;17;624871478;5024;303;5821;5837;7.91;0.48;251.10;4.12;797;17;2015.00;16
5027;17;624871488;5027;327;5887;5964;8.04;0.50;251.21;4.08;860;17;2016.00;77
5030;17;624871508;5030;321;5891;5965;7.91;0.49;251.22;4.08;861;17;2017.00;74
5032;17;624871518;5032;318;5899;5965;7.88;0.49;251.25;4.08;867;17;2018.00;66
5034;17;624871528;5034;318;5904;5965;7.78;0.48;251.23;4.08;870;17;2019.00;61
5035;17;624871538;5035;313;5912;5965;7.78;0.48;251.19;4.08;877;17;2020.00;53
5039;17;624871548;5039;314;5914;5965;7.65;0.47;251.26;4.08;875;17;2021.00;51
5040;17;624871558;5040;313;5918;5965;7.57;0.47;251.24;4.09;878;17;2022.00;47
5042;17;624871568;5042;315;5921;5965;7.56;0.47;251.16;4.09;879;17;2023.00;44
5044;17;624871577;5044;318;5927;5966;7.55;0.47;251.09;4.09;883;17;2024.00;39
5046;17;624871587;5046;324;5932;5968;7.53;0.47;251.03;4.10;886;17;2025.00;36
5050;17;624871598;5050;322;5935;5968;7.53;0.47;250.91;4.10;885;17;2026.00;33
5053;17;624871608;5053;323;5938;5969;7.44;0.46;250.82;4.10;885;17;2027.00;31
5055;17;624871618;5055;335;5943;5969;7.35;0.45;250.78;4.11;888;17;2028.00;26
5057;17;624871627;5057;334;5948;5969;7.26;0.45;250.74;4.12;891;17;2029.00;21
5059;17;624871637;5059;339;5948;5969;7.13;0.44;250.72;4.12;889;17;2030.00;21
5063;17;624871647;5063;350;5953;5973;7.04;0.43;250.59;4.12;890;17;2031.00;20
5065;17;624871658;5065;360;5954;5973;6.90;0.42;250.56;4.12;889;17;2032.00;19
5066;17;624871668;5066;372;5954;5973;6.74;0.41;250.60;4.12;888;17;2033.00;19
5067;17;624871677;5067;373;5957;5976;6.62;0.41;250.60;4.12;890;17;2034.00;19
5069;17;624871687;5069;383;5957;5976;6.49;0.40;250.64;4.12;888;17;2035.00;19
5071;17;624871696;5071;384;5957;5976;6.33;0.39;250.67;4.12;886;17;2036.00;19
5075;17;624871706;5075;387;5963;5980;6.19;0.38;250.63;4.12;888;17;2037.00;17
5077;17;624871716;5077;395;5964;5981;6.10;0.38;250.71;4.12;887;17;2038.00;17
5078;17;624871726;5078;400;5964;5981;5.99;0.37;250.66;4.12;886;17;2039.00;17
5082;17;624871737;5082;391;5970;5986;5.94;0.37;250.60;4.12;888;17;2040.00;16
5083;17;624871748;5083;387;5972;5986;5.89;0.37;250.56;4.12;889;17;2041.00;14
5084;17;624871756;5084;384;5972;5986;5.84;0.36;250.57;4.12;888;17;2042.00;14
5086;17;624871765;5086;370;5973;5987;5.84;0.36;250.65;4.12;887;17;2043.00;14
5089;17;624871776;5089;366;5973;5987;5.88;0.36;250.65;4.12;884;17;2044.00;14
5092;17;624871790;5092;360;5979;5993;6.01;0.37;250.64;4.12;887;17;2045.00;14
5094;17;624871800;5094;355;5979;5993;6.12;0.38;250.67;4.12;885;17;2046.00;14
5099;17;624871810;5099;346;5980;5994;6.17;0.38;250.68;4.12;881;17;2047.00;14
5103;17;624871819;5103;339;5980;5994;6.27;0.38;250.65;4.12;877;17;2048.00;14
5105;17;624871834;5105;331;5980;5994;6.33;0.39;250.64;4.12;875;17;2049.00;14
5109;17;624871855;5109;322;5980;5994;6.34;0.39;250.57;4.12;871;17;2050.00;14
5113;17;624871865;5113;313;5980;5994;6.33;0.39;250.57;4.12;867;17;2051.00;14
5114;17;624871875;5114;315;5991;6006;6.47;0.39;250.61;4.11;877;17;2052.00;15
5117;17;624871886;5117;310;5991;6006;6.46;0.39;250.59;4.11;874;17;2053.00;15
5121;17;624871896;5121;309;5992;6006;6.49;0.39;250.57;4.11;871;17;2054.00;14
5123;17;624871905;5123;307;5992;6006;6.56;0.40;250.58;4.11;869;17;2055.00;14
5124;17;624871915;5124;301;5992;6006;6.59;0.40;250.61;4.11;868;17;2056.00;14
5127;17;624871925;5127;294;5992;6006;6.63;0.40;250.65;4.11;865;17;2057.00;14
5128;17;624871934;5128;294;5996;6010;6.76;0.41;250.66;4.11;868;17;2058.00;14
5130;17;624871945;5130;297;5996;6010;6.83;0.42;250.65;4.11;866;17;2059.00;14
5133;17;624871955;5133;294;6000;6014;6.94;0.42;250.67;4.11;867;17;2060.00;14
5135;17;624871965;5135;292;6001;6015;7.04;0.43;250.60;4.10;866;17;2061.00;14
5138;17;624871976;5138;293;6001;6015;7.03;0.43;250.64;4.10;863;17;2062.00;14
5142;17;624871987;5142;288;6001;6015;7.00;0.43;250.75;4.10;859;17;2063.00;14
5146;17;624871997;5146;283;6014;6028;7.15;0.44;250.84;4.10;868;17;2064.00;14
5150;17;624872008;5150;281;6014;6028;7.11;0.43;250.84;4.10;864;17;2065.00;14
5158;17;624872018;5158;281;6014;6028;7.04;0.43;251.05;4.10;856;17;2066.00;14
5162;17;624872028;5162;272;6015;6029;7.09;0.43;251.05;4.10;853;17;2067.00;14
5165;17;624872038;5165;274;6016;6030;7.04;0.43;251.20;4.09;851;17;2068.00;14
5169;17;624872048;5169;275;6016;6030;7.00;0.43;251.27;4.09;847;17;2069.00;14
5176;17;624872060;5176;269;6020;6036;7.01;0.43;251.25;4.09;844;17;2070.00;16
5179;17;624872070;5179;265;6020;6036;6.98;0.42;251.35;4.09;841;17;2071.00;16
5182;17;624872080;5182;273;6022;6036;6.98;0.43;251.40;4.09;840;17;2072.00;14
5188;17;624872089;5188;274;6022;6036;6.90;0.42;251.50;4.09;834;17;2073.00;14
5193;17;624872100;5193;278;6028;6042;6.89;0.42;251.43;4.09;835;17;2074.00;14
5200;17;624872110;5200;275;6028;6042;6.81;0.41;251.48;4.09;828;17;2075.00;14
5200;17;624872120;5200;280;6029;6042;6.82;0.41;251.48;4.13;829;17;2076.00;13
5205;17;624872130;5205;283;6029;6042;6.77;0.41;251.55;4.13;824;17;2077.00;13
5207;17;624872146;5207;287;6033;6046;6.84;0.42;251.54;4.13;826;17;2078.00;13
5210;17;624872156;5210;289;6034;6047;6.87;0.42;251.56;4.13;824;17;2079.00;13
5214;17;624872166;5214;289;6034;6047;6.87;0.42;251.66;4.13;820;17;2080.00;13
5215;17;624872175;5215;292;6035;6048;6.95;0.42;251.64;4.13;820;17;2081.00;13
5218;17;624872185;5218;289;6035;6048;6.96;0.42;251.75;4.13;817;17;2082.00;13
5222;18;624872195;5222;291;6035;6048;6.90;0.42;251.78;4.13;813;18;2083.00;13
5223;18;624872211;5223;290;6035;6048;6.85;0.42;251.83;4.13;812;18;2084.00;13
5226;18;624872220;5226;291;6035;6048;6.75;0.41;251.90;4.13;809;18;2085.00;13
5229;18;624872230;5229;289;6035;6048;6.72;0.41;251.94;4.13;806;18;2086.00;13
5232;18;624872239;5232;273;6035;6048;6.75;0.41;252.01;4.13;803;18;2087.00;13
5234;18;624872250;5234;282;6079;6118;6.84;0.42;252.06;4.10;845;18;2088.00;39
5236;18;624872265;5236;264;6081;6119;6.87;0.42;252.17;4.10;845;18;2089.00;38
5238;18;624872275;5238;253;6085;6119;6.98;0.43;252.21;4.10;847;18;2090.00;34
5241;18;624872286;5241;247;6086;6119;7.04;0.43;252.26;4.15;845;18;2091.00;33
5245;18;624872296;5245;247;6089;6119;7.16;0.44;252.33;4.15;844;18;2092.00;30
5246;18;624872307;5246;242;6090;6119;7.34;0.45;252.40;4.15;844;18;2093.00;29
5249;18;624872318;5249;240;6093;6119;7.46;0.45;252.46;4.15;844;18;2094.00;26
5254;18;624872328;5254;237;6094;6119;7.56;0.46;252.61;4.15;840;18;2095.00;25
5255;18;624872339;5255;226;6097;6120;7.69;0.47;252.62;4.15;842;18;2096.00;23
5258;18;624872349;5258;217;6100;6121;7.81;0.48;252.64;4.15;842;18;2097.00;21
5259;18;624872360;5259;212;6104;6121;7.94;0.48;252.64;4.15;845;18;2098.00;17
5264;18;624872371;5264;210;6110;6125;7.96;0.48;252.64;4.15;846;18;2099.00;15
5267;18;624872386;5267;212;6116;6140;8.00;0.49;252.65;4.15;849;18;2100.00;24
5270;18;624872409;5270;210;6116;6140;8.07;0.49;252.64;4.15;846;18;2101.00;24
5271;18;624872421;5271;208;6117;6140;8.19;0.50;252.71;4.20;846;18;2102.00;23
5276;18;624872432;5276;213;6121;6146;8.20;0.50;252.77;4.20;845;18;2103.00;25
5279;18;624872445;5279;213;6121;6146;8.28;0.50;252.80;4.20;842;18;2104.00;25
5281;18;624872456;5281;215;6121;6146;8.35;0.51;252.85;4.20;840;18;2105.00;25
5284;18;624872468;5284;215;6125;6149;8.45;0.51;253.02;4.20;841;18;2106.00;24
5287;18;624872480;5287;215;6125;6149;8.56;0.52;253.02;4.20;838;18;2107.00;24
5290;18;624872491;5290;210;6127;6149;8.62;0.52;253.12;4.25;837;18;2108.00;22
5292;18;624872503;5292;209;6127;6150;8.78;0.53;253.23;4.25;835;18;2109.00;23
5293;18;624872514;5293;206;6128;6151;8.90;0.54;253.22;4.25;835;18;2110.00;23
5295;18;624872531;5295;199;6128;6151;9.00;0.55;253.26;4.25;833;18;2111.00;23
5296;18;624872543;5296;199;6140;6164;9.11;0.55;253.23;4.24;844;18;2112.00;24
5300;18;624872554;5300;191;6141;6164;9.19;0.56;253.28;4.28;841;18;2113.00;23
5305;18;624872572;5305;187;6141;6164;9.23;0.56;253.27;4.28;836;18;2114.00;23
5308;18;624872583;5308;181;6143;6166;9.24;0.56;253.22;4.28;835;18;2115.00;23
5314;18;624872595;5314;185;6143;6166;9.28;0.56;253.33;4.28;829;18;2116.00;23
5318;18;624872606;5318;184;6146;6170;9.41;0.57;253.42;4.28;828;18;2117.00;24
5322;18;624872617;5322;188;6148;6170;9.49;0.57;253.54;4.28;826;18;2118.00;22
5324;18;624872629;5324;183;6151;6174;9.55;0.58;253.58;4.28;827;18;2119.00;23
5327;18;624872647;5327;182;6151;6174;9.67;0.58;253.71;4.28;824;18;2120.00;23
5331;18;624872659;5331;178;6151;6174;9.71;0.59;253.81;4.28;820;18;2121.00;23
5334;18;624872670;5334;172;6151;6174;9.82;0.59;253.92;4.28;817;18;2122.00;23
5335;18;624872681;5335;169;6151;6174;9.83;0.60;253.97;4.28;816;18;2123.00;23
5336;18;624872692;5336;168;6162;6186;9.88;0.60;253.98;4.28;826;18;2124.00;24
5338;18;624872704;5338;163;6162;6186;9.94;0.60;253.95;4.28;824;18;2125.00;24
5340;18;624872721;5340;162;6163;6186;10.05;0.61;253.97;4.28;823;18;2126.00;23
5340;18;624872739;5340;160;6165;6186;10.14;0.62;253.97;4.28;825;18;2127.00;21
5340;18;624872757;5340;165;6166;6186;10.28;0.63;253.97;4.33;826;18;2128.00;20
5342;18;624872773;5342;162;6166;6186;10.44;0.64;253.99;4.33;824;18;2129.00;20
5344;18;624872796;5344;167;6168;6187;10.53;0.64;253.99;4.33;824;18;2130.00;19
5346;18;624872813;5346;166;6169;6187;10.62;0.65;254.01;4.33;823;18;2131.00;18
5350;18;624872830;5350;169;6174;6193;10.57;0.64;254.04;4.33;824;18;2132.00;19
5354;18;624872846;5354;168;6175;6194;10.55;0.64;254.00;4.33;821;18;2133.00;19
5356;18;624872861;5356;166;6175;6194;10.43;0.63;254.02;4.33;819;18;2134.00;19
5361;18;624872874;5361;167;6175;6194;10.37;0.63;254.05;4.33;814;18;2135.00;19
5362;18;624872886;5362;171;6178;6198;10.33;0.63;254.06;4.33;816;18;2136.00;20
5366;18;624872899;5366;171;6178;6198;10.31;0.63;254.14;4.33;812;18;2137.00;20
5366;18;624872911;5366;173;6178;6198;10.30;0.63;254.14;4.33;812;18;2138.00;20
5369;18;624872924;5369;175;6179;6199;10.22;0.62;254.18;4.33;810;18;2139.00;20
5375;18;624872936;5375;172;6182;6203;10.08;0.61;254.27;4.32;807;18;2140.00;21
5380;18;624872949;5380;171;6183;6203;10.00;0.61;254.24;4.36;803;18;2141.00;20
5384;18;624872960;5384;172;6185;6206;9.97;0.61;254.34;4.36;801;18;2142.00;21
5387;18;624872973;5387;176;6186;6206;9.88;0.60;254.42;4.36;799;18;2143.00;20
5389;18;624872984;5389;176;6186;6206;9.79;0.60;254.43;4.36;797;18;2144.00;20
5389;18;624872995;5389;178;6188;6206;9.76;0.60;254.43;4.37;799;18;2145.00;18
5392;18;624873006;5392;184;6192;6210;9.74;0.60;254.41;4.37;800;18;2146.00;18
5398;18;624873018;5398;179;6192;6210;9.69;0.59;254.65;4.37;794;18;2147.00;18
5403;18;624873029;5403;177;6192;6210;9.63;0.59;254.61;4.37;789;18;2148.00;18
5407;18;624873040;5407;183;6192;6210;9.64;0.59;254.57;4.37;785;18;2149.00;18
5412;18;624873051;5412;187;6192;6211;9.58;0.58;254.62;4.37;780;18;2150.00;19
5413;18;624873062;5413;190;6193;6212;9.55;0.58;254.64;4.37;780;18;2151.00;19
5417;18;624873073;5417;193;6193;6212;9.42;0.57;254.69;4.37;776;18;2152.00;19
5423;18;624873084;5423;199;6194;6213;9.36;0.57;254.77;4.37;771;18;2153.00;19
5424;18;624873095;5424;207;6194;6213;9.34;0.57;254.78;4.37;770;18;2154.00;19
5426;18;624873105;5426;209;6194;6213;9.24;0.56;254.77;4.37;768;18;2155.00;19
5428;18;624873115;5428;212;6194;6213;9.20;0.56;254.71;4.37;766;18;2156.00;19
5431;18;624873125;5431;215;6194;6213;9.12;0.55;254.64;4.37;763;18;2157.00;19
5432;18;624873136;5432;217;6194;6213;9.07;0.55;254.64;4.37;762;18;2158.00;19
5433;18;624873146;5433;223;6194;6213;9.05;0.55;254.62;4.37;761;18;2159.00;19
5436;18;624873157;5436;262;6292;6443;9.07;0.57;254.59;4.30;856;18;2160.00;151
5437;18;624873185;5437;262;6296;6444;9.06;0.57;254.59;4.30;859;18;2161.00;148
5441;18;624873198;5441;258;6308;6444;9.01;0.56;254.53;4.29;867;18;2162.00;136
5443;18;624873209;5443;253;6313;6444;8.94;0.56;254.46;4.29;870;18;2163.00;131
5445;18;624873221;5445;255;6324;6444;8.89;0.55;254.42;4.29;879;18;2164.00;120
5447;18;624873232;5447;258;6330;6444;8.79;0.55;254.41;4.29;883;18;2165.00;114
5447;18;624873244;5447;255;6339;6444;8.74;0.54;254.41;4.29;892;18;2166.00;105
5449;18;624873260;5449;268;6346;6444;8.68;0.54;254.36;4.30;897;18;2167.00;98
5453;18;624873271;5453;274;6353;6445;8.65;0.54;254.32;4.30;900;18;2168.00;92
5454;18;624873283;5454;278;6362;6446;8.58;0.53;254.31;4.31;908;18;2169.00;84
5457;18;624873300;5457;284;6366;6446;8.48;0.53;254.32;4.32;909;18;2170.00;80
5459;18;624873311;5459;289;6370;6447;8.36;0.52;254.25;4.32;911;18;2171.00;77
5460;18;624873322;5460;297;6373;6447;8.17;0.51;254.23;4.34;913;18;2172.00;74
5462;18;624873332;5462;301;6377;6447;8.03;0.50;254.17;4.35;915;18;2173.00;70
5466;18;624873342;5466;313;6379;6447;7.84;0.48;254.08;4.35;913;18;2174.00;68
5467;18;624873353;5467;320;6384;6451;7.70;0.47;254.05;4.36;917;18;2175.00;67
5470;18;624873364;5470;322;6386;6451;7.58;0.47;254.02;4.36;916;18;2176.00;65
5470;18;624873375;5470;335;6391;6451;7.44;0.46;254.02;4.39;921;18;2177.00;60
5472;18;624873385;5472;340;6393;6454;7.31;0.45;253.95;4.39;921;18;2178.00;61
5473;18;624873398;5473;344;6397;6454;7.13;0.44;254.00;4.40;924;18;2179.00;57
5474;18;624873409;5474;359;6400;6454;7.00;0.43;253.99;4.41;926;18;2180.00;54
5475;18;624873420;5475;361;6407;6458;6.92;0.43;253.97;4.42;932;18;2181.00;51
5476;18;624873432;5476;368;6410;6459;6.84;0.42;253.96;4.43;934;18;2182.00;49
5476;18;624873443;5476;377;6413;6459;6.79;0.42;253.96;4.44;937;18;2183.00;46
5478;18;624873454;5478;381;6416;6463;6.72;0.41;253.88;4.44;938;18;2184.00;47
5480;18;624873467;5480;385;6419;6463;6.67;0.41;253.84;4.45;939;18;2185.00;44
5482;18;624873478;5482;393;6419;6463;6.56;0.40;253.85;4.45;937;18;2186.00;44
5483;18;624873489;5483;401;6420;6464;6.47;0.40;253.81;4.46;937;18;2187.00;44
5486;18;624873500;5486;409;6420;6464;6.37;0.39;253.75;4.46;934;18;2188.00;44
5487;18;624873512;5487;411;6427;6470;6.34;0.39;253.73;4.46;940;18;2189.00;43
5487;18;624873526;5487;413;6428;6470;6.30;0.39;253.73;4.46;941;18;2190.00;42
5489;18;624873537;5489;420;6429;6471;6.24;0.38;253.67;4.47;940;18;2191.00;42
5493;18;624873548;5493;421;6429;6471;6.15;0.38;253.59;4.47;936;18;2192.00;42
5495;18;624873565;5495;426;6432;6471;6.03;0.37;253.56;4.48;937;18;2193.00;39
5496;18;624873576;5496;429;6432;6471;5.95;0.37;253.62;4.48;936;18;2194.00;39
5498;18;624873595;5498;424;6434;6471;5.91;0.36;253.57;4.49;936;18;2195.00;37
5498;18;624873607;5498;421;6445;6483;5.99;0.37;253.57;4.49;947;18;2196.00;38
5500;18;624873619;5500;411;6445;6483;5.99;0.37;253.51;4.49;945;18;2197.00;38
5500;18;624873630;5500;411;6447;6483;6.06;0.37;253.51;4.50;947;18;2198.00;36
5501;18;624873641;5501;410;6449;6483;6.13;0.38;253.48;4.51;948;18;2199.00;34
5502;18;624873654;5502;410;6452;6483;6.21;0.38;253.46;4.52;950;18;2200.00;31
5503;18;624873670;5503;408;6454;6483;6.27;0.39;253.42;4.52;951;18;2201.00;29
5506;18;624873691;5506;406;6459;6487;6.28;0.39;253.40;4.52;953;18;2202.00;28
5508;18;624873701;5508;406;6460;6487;6.31;0.39;253.39;4.52;952;18;2203.00;27
5514;18;624873719;5514;404;6465;6491;6.35;0.39;253.34;4.52;951;18;2204.00;26
5516;18;624873732;5516;403;6467;6493;6.35;0.39;253.31;4.52;951;18;2205.00;26
5517;18;624873744;5517;402;6468;6493;6.28;0.39;253.31;4.52;951;18;2206.00;25
5520;18;624873754;5520;389;6468;6493;6.17;0.38;253.26;4.52;948;18;2207.00;25
5525;18;624873765;5525;394;6480;6506;6.09;0.38;253.29;4.51;955;18;2208.00;26
5527;18;624873783;5527;396;6480;6506;6.06;0.37;253.23;4.51;953;18;2209.00;26
5532;19;624873793;5532;389;6483;6508;6.02;0.37;253.17;4.51;951;19;2210.00;25
5532;19;624873816;5532;384;6484;6509;6.07;0.37;253.17;4.51;952;19;2211.00;25
5534;19;624873826;5534;379;6485;6510;6.08;0.37;253.22;4.51;951;19;2212.00;25
5537;19;624873837;5537;367;6485;6510;6.10;0.38;253.28;4.51;948;19;2213.00;25
5539;19;624873847;5539;368;6487;6513;6.18;0.38;253.24;4.51;948;19;2214.00;26
5543;19;624873857;5543;367;6487;6513;6.23;0.38;253.34;4.51;944;19;2215.00;26
5547;19;624873867;5547;356;6487;6513;6.27;0.39;253.45;4.51;940;19;2216.00;26
5551;19;624873878;5551;348;6488;6513;6.35;0.39;253.44;4.51;937;19;2217.00;25
5554;19;624873888;5554;343;6493;6519;6.46;0.40;253.46;4.51;939;19;2218.00;26
5561;19;624873899;5561;336;6493;6519;6.49;0.40;253.50;4.51;932;19;2219.00;26
5565;19;624873916;5565;330;6494;6519;6.55;0.40;253.51;4.51;929;19;2220.00;25
5569;19;624873926;5569;320;6495;6519;6.61;0.40;253.52;4.51;926;19;2221.00;24
5571;19;624873938;5571;307;6499;6523;6.66;0.41;253.58;4.51;928;19;2222.00;24
5575;19;624873949;5575;307;6500;6524;6.73;0.41;253.61;4.51;925;19;2223.00;24
5579;19;624873959;5579;304;6500;6524;6.78;0.42;253.66;4.51;921;19;2224.00;24
5582;19;624873970;5582;308;6501;6525;6.87;0.42;253.64;4.51;919;19;2225.00;24
5586;19;624873982;5586;310;6501;6525;6.90;0.42;253.70;4.51;915;19;2226.00;24
5591;19;624873993;5591;306;6501;6525;6.86;0.42;253.84;4.51;910;19;2227.00;24
5593;19;624874005;5593;305;6501;6525;6.88;0.42;253.88;4.51;908;19;2228.00;24
5597;19;624874016;5597;304;6501;6525;6.85;0.42;253.83;4.51;904;19;2229.00;24
5603;19;624874026;5603;302;6502;6525;6.79;0.42;253.91;4.55;899;19;2230.00;23
5607;19;624874038;5607;306;6502;6525;6.75;0.41;253.89;4.55;895;19;2231.00;23
5611;19;624874048;5611;315;6539;6595;6.85;0.42;254.01;4.53;928;19;2232.00;56
5614;19;624874063;5614;310;6541;6596;6.83;0.42;254.06;4.53;927;19;2233.00;55
5621;19;624874074;5621;308;6548;6596;6.90;0.42;254.03;4.52;927;19;2234.00;48
5627;19;624874085;5627;305;6553;6596;6.89;0.42;254.12;4.52;926;19;2235.00;43
5631;19;624874096;5631;304;6556;6596;6.88;0.42;254.33;4.52;925;19;2236.00;40
5636;19;624874107;5636;312;6559;6596;6.88;0.42;254.42;4.52;923;19;2237.00;37
5641;19;624874117;5641;320;6562;6596;6.93;0.42;254.44;4.52;921;19;2238.00;34
5644;19;624874128;5644;320;6565;6596;6.97;0.42;254.55;4.52;921;19;2239.00;31
5647;19;624874139;5647;322;6567;6597;7.07;0.43;254.57;4.53;920;19;2240.00;30
5651;19;624874150;5651;321;6569;6598;7.10;0.43;254.59;4.53;918;19;2241.00;29
5656;19;624874161;5656;313;6571;6598;7.11;0.43;254.73;4.53;915;19;2242.00;27
5660;19;624874173;5660;316;6576;6602;7.20;0.44;254.72;4.53;916;19;2243.00;26
5663;19;624874184;5663;316;6577;6602;7.24;0.44;254.72;4.53;914;19;2244.00;25
5664;19;624874195;5664;318;6578;6602;7.30;0.44;254.73;4.57;914;19;2245.00;24
5668;19;624874205;5668;315;6578;6602;7.29;0.44;254.82;4.57;910;19;2246.00;24
5670;19;624874216;5670;313;6583;6608;7.36;0.45;254.85;4.57;913;19;2247.00;25
5673;19;624874227;5673;316;6583;6608;7.34;0.45;254.90;4.57;910;19;2248.00;25
5678;19;624874238;5678;310;6583;6608;7.32;0.45;254.94;4.57;905;19;2249.00;25
5682;19;624874251;5682;316;6587;6614;7.38;0.45;254.99;4.57;905;19;2250.00;27
5686;19;624874262;5686;317;6587;6614;7.35;0.45;255.13;4.57;901;19;2251.00;27
5689;19;624874273;5689;314;6589;6614;7.35;0.45;255.19;4.57;900;19;2252.00;25
5691;19;624874284;5691;305;6589;6615;7.23;0.44;255.21;4.57;898;19;2253.00;26
5694;19;624874295;5694;308;6590;6616;7.16;0.43;255.27;4.57;896;19;2254.00;26
5696;19;624874305;5696;311;6590;6616;7.06;0.43;255.27;4.57;894;19;2255.00;26
5698;19;624874321;5698;314;6601;6629;7.14;0.43;255.30;4.56;903;19;2256.00;28
5704;19;624874332;5704;305;6601;6629;7.08;0.43;255.41;4.56;897;19;2257.00;28
5706;19;624874344;5706;298;6601;6629;7.11;0.43;255.56;4.56;895;19;2258.00;28
5709;19;624874354;5709;290;6602;6630;7.13;0.43;255.59;4.56;893;19;2259.00;28
5711;19;624874365;5711;289;6602;6630;7.12;0.43;255.71;4.56;891;19;2260.00;28
5714;19;624874376;5714;284;6606;6634;7.15;0.43;255.81;4.56;892;19;2261.00;28
5717;19;624874388;5717;283;6606;6634;7.17;0.44;255.74;4.56;889;19;2262.00;28
5722;19;624874399;5722;280;6609;6638;7.20;0.44;255.84;4.55;887;19;2263.00;29
5723;19;624874415;5723;282;6609;6638;7.27;0.44;255.85;4.55;886;19;2264.00;29
5729;19;624874427;5729;281;6609;6638;7.24;0.44;255.96;4.55;880;19;2265.00;29
5733;19;624874443;5733;255;6609;6638;7.29;0.44;256.15;4.55;876;19;2266.00;29
5737;19;624874455;5737;246;6609;6638;7.34;0.44;256.23;4.55;872;19;2267.00;29
5739;19;624874466;5739;234;6619;6650;7.52;0.46;256.35;4.55;880;19;2268.00;31
5740;19;624874478;5740;224;6619;6650;7.63;0.46;256.43;4.55;879;19;2269.00;31
5744;19;624874490;5744;217;6621;6650;7.79;0.47;256.60;4.62;877;19;2270.00;29
5745;19;624874502;5745;208;6621;6650;7.96;0.48;256.65;4.62;876;19;2271.00;29
5749;19;624874514;5749;208;6621;6650;8.09;0.49;256.80;4.62;872;19;2272.00;29
5751;19;624874526;5751;206;6621;6650;8.20;0.50;256.87;4.62;870;19;2273.00;29
5755;19;624874538;5755;201;6621;6651;8.28;0.50;256.94;4.62;866;19;2274.00;30
5759;19;624874549;5759;197;6621;6651;8.31;0.50;256.99;4.62;862;19;2275.00;30
5761;19;624874561;5761;191;6626;6657;8.48;0.51;256.97;4.61;865;19;2276.00;31
5762;19;624874574;5762;188;6627;6658;8.67;0.53;257.05;4.61;865;19;2277.00;31
5764;19;624874586;5764;184;6627;6658;8.79;0.53;257.17;4.61;863;19;2278.00;31
5769;19;624874598;5769;185;6627;6658;8.82;0.53;257.28;4.61;858;19;2279.00;31
5770;19;624874611;5770;181;6631;6663;8.94;0.54;257.26;4.61;861;19;2280.00;32
5773;19;624874628;5773;183;6631;6663;9.01;0.55;257.41;4.61;858;19;2281.00;32
5774;19;624874640;5774;177;6631;6663;9.05;0.55;257.42;4.61;857;19;2282.00;32
5777;19;624874652;5777;174;6632;6664;9.07;0.55;257.54;4.61;855;19;2283.00;32
5777;19;624874664;5777;176;6635;6668;9.10;0.55;257.54;4.61;858;19;2284.00;33
5778;19;624874675;5778;172;6635;6668;9.17;0.56;257.60;4.61;857;19;2285.00;33
5782;19;624874687;5782;174;6638;6671;9.24;0.56;257.64;4.65;856;19;2286.00;33
5784;19;624874699;5784;173;6638;6671;9.28;0.57;257.59;4.65;854;19;2287.00;33
5787;19;624874709;5787;177;6639;6671;9.42;0.57;257.63;4.65;852;19;2288.00;32
5789;19;624874721;5789;174;6639;6671;9.50;0.58;257.60;4.65;850;19;2289.00;32
5792;19;624874737;5792;177;6643;6675;9.57;0.58;257.65;4.65;851;19;2290.00;32
5795;19;624874755;5795;179;6643;6675;9.56;0.58;257.66;4.65;848;19;2291.00;32
5799;19;624874772;5799;177;6643;6675;9.64;0.59;257.59;4.65;844;19;2292.00;32
5802;19;624874792;5802;173;6643;6675;9.65;0.59;257.71;4.65;841;19;2293.00;32
5804;19;624874809;5804;170;6643;6676;9.70;0.59;257.73;4.65;839;19;2294.00;33
5809;19;624874826;5809;170;6645;6678;9.68;0.59;257.79;4.65;836;19;2295.00;33
5812;19;624874843;5812;169;6645;6678;9.71;0.59;257.79;4.65;833;19;2296.00;33
5814;19;624874857;5814;173;6646;6679;9.70;0.59;257.78;4.65;832;19;2297.00;33
5814;19;624874869;5814;170;6646;6679;9.73;0.59;257.78;4.65;832;19;2298.00;33
5817;19;624874882;5817;168;6646;6679;9.78;0.59;257.82;4.65;829;19;2299.00;33
5821;19;624874897;5821;172;6646;6679;9.79;0.60;257.86;4.65;825;19;2300.00;33
5824;19;624874913;5824;169;6647;6679;9.84;0.60;257.79;4.70;823;19;2301.00;32
5828;19;624874926;5828;171;6647;6679;9.88;0.60;257.84;4.70;819;19;2302.00;32
5831;19;624874938;5831;167;6647;6679;9.89;0.60;257.79;4.70;816;19;2303.00;32
5835;19;624874951;5835;194;6719;6806;9.67;0.59;257.90;4.65;884;19;2304.00;87
5838;19;624874974;5838;184;6719;6807;9.63;0.59;257.96;4.65;881;19;2305.00;88
5841;19;624874986;5841;175;6725;6807;9.72;0.60;258.01;4.64;884;19;2306.00;82
5842;19;624874999;5842;175;6725;6807;9.69;0.59;258.02;4.64;883;19;2307.00;82
5846;19;624875012;5846;183;6731;6807;9.73;0.60;258.07;4.64;885;19;2308.00;76
5850;19;624875024;5850;181;6733;6807;9.66;0.59;258.15;4.64;883;19;2309.00;74
5858;19;624875038;5858;182;6737;6807;9.63;0.59;258.21;4.64;879;19;2310.00;70
5861;19;624875050;5861;184;6738;6807;9.60;0.59;258.23;4.64;877;19;2311.00;69
5863;19;624875062;5863;184;6742;6808;9.54;0.58;258.28;4.69;879;19;2312.00;66
5867;19;624875074;5867;191;6745;6809;9.54;0.58;258.24;4.69;878;19;2313.00;64
5869;19;624875086;5869;186;6750;6809;9.52;0.58;258.30;4.69;881;19;2314.00;59
5873;19;624875099;5873;193;6754;6810;9.50;0.58;258.24;4.71;881;19;2315.00;56
5875;19;624875111;5875;195;6759;6810;9.45;0.58;258.20;4.72;884;19;2316.00;51
5880;19;624875130;5880;197;6761;6810;9.39;0.58;258.15;4.72;881;19;2317.00;49
5883;19;624875143;5883;203;6765;6810;9.31;0.57;258.12;4.77;882;19;2318.00;45
5885;19;624875155;5885;207;6770;6814;9.23;0.57;258.12;4.77;885;19;2319.00;44
5886;19;624875169;5886;212;6772;6814;9.22;0.57;258.16;4.77;886;19;2320.00;42
5889;19;624875180;5889;213;6772;6814;9.18;0.56;258.18;4.77;883;19;2321.00;42
5892;19;624875192;5892;214;6774;6817;9.17;0.56;258.13;4.77;882;19;2322.00;43
5896;19;624875205;5896;220;6775;6817;9.16;0.56;258.11;4.77;879;19;2323.00;42
5902;19;624875216;5902;227;6776;6817;9.10;0.56;258.08;4.78;874;19;2324.00;41
5905;19;624875228;5905;227;6780;6821;9.06;0.55;258.05;4.77;875;19;2325.00;41
5909;19;624875240;5909;230;6781;6822;9.05;0.55;258.14;4.77;872;19;2326.00;41
5912;19;624875258;5912;238;6782;6822;8.93;0.55;258.14;4.77;870;19;2327.00;40
5912;19;624875277;5912;240;6784;6826;8.84;0.54;258.14;4.77;872;19;2328.00;42
5916;19;624875288;5916;244;6784;6826;8.75;0.53;258.05;4.77;868;19;2329.00;42
5919;19;624875300;5919;252;6785;6826;8.69;0.53;258.06;4.77;866;19;2330.00;41
5923;19;624875312;5923;257;6786;6827;8.66;0.53;258.00;4.77;863;19;2331.00;41
5923;19;624875323;5923;268;6786;6827;8.51;0.52;258.00;4.77;863;19;2332.00;41
5927;19;624875336;5927;273;6791;6833;8.46;0.52;258.06;4.77;864;19;2333.00;42
5930;19;624875356;5930;276;6791;6833;8.36;0.51;258.03;4.77;861;19;2334.00;42
5932;19;624875367;5932;281;6791;6834;8.28;0.51;258.00;4.77;859;19;2335.00;43
5936;19;624875379;5936;290;6791;6834;8.18;0.50;257.98;4.77;855;19;2336.00;43
5937;19;624875390;5937;300;6792;6834;8.04;0.49;258.00;4.78;855;19;2337.00;42
5941;19;624875403;5941;311;6792;6834;7.90;0.48;257.89;4.78;851;19;2338.00;42
5943;19;624875413;5943;316;6792;6834;7.77;0.47;257.94;4.78;849;19;2339.00;42
5944;19;624875426;5944;325;6819;6870;7.83;0.48;257.95;4.77;875;19;2340.00;51
5944;19;624875440;5944;335;6820;6870;7.78;0.48;257.95;4.78;876;19;2341.00;50
5946;19;624875450;5946;348;6824;6870;7.74;0.47;257.95;4.79;878;19;2342.00;46
5948;19;624875461;5948;356;6825;6870;7.63;0.47;257.92;4.80;877;19;2343.00;45
5949;19;624875472;5949;359;6826;6870;7.49;0.46;257.91;4.80;877;19;2344.00;44
5950;19;624875483;5950;363;6828;6870;7.34;0.45;257.87;4.82;878;19;2345.00;42
5952;19;624875494;5952;370;6832;6874;7.25;0.44;257.84;4.81;880;19;2346.00;42
5953;19;624875504;5953;356;6833;6874;7.24;0.44;257.82;4.83;880;19;2347.00;41
5953;19;624875515;5953;352;6839;6878;7.26;0.44;257.82;4.84;886;19;2348.00;39
5955;19;624875525;5955;354;6840;6879;7.24;0.44;257.77;4.84;885;19;2349.00;39
5957;19;624875536;5957;349;6841;6879;7.19;0.44;257.73;4.84;884;19;2350.00;38
5957;19;624875546;5957;350;6842;6879;7.11;0.44;257.73;4.85;885;19;2351.00;37
5961;19;624875557;5961;351;6853;6892;7.11;0.43;257.66;4.85;892;19;2352.00;39
5963;19;624875569;5963;347;6854;6892;7.02;0.43;257.63;4.85;891;19;2353.00;38
5965;19;624875592;5965;347;6855;6892;7.03;0.43;257.56;4.85;890;19;2354.00;37
5966;19;624875603;5966;345;6857;6893;7.01;0.43;257.54;4.86;891;19;2355.00;36
5968;19;624875614;5968;349;6858;6894;6.93;0.42;257.53;4.86;890;19;2356.00;36
5968;19;624875625;5968;358;6858;6894;6.86;0.42;257.53;4.86;890;19;2357.00;36
5968;19;624875635;5968;358;6860;6897;6.85;0.42;257.53;4.86;892;19;2358.00;37
5971;19;624875645;5971;355;6863;6897;6.81;0.42;257.58;4.88;892;19;2359.00;34
5975;19;624875656;5975;345;6864;6897;6.73;0.41;257.51;4.88;889;19;2360.00;33
5977;19;624875666;5977;345;6864;6897;6.63;0.40;257.53;4.88;887;19;2361.00;33
5978;19;624875682;5978;344;6871;6903;6.61;0.40;257.52;4.89;893;19;2362.00;32
5981;19;624875693;5981;339;6871;6903;6.56;0.40;257.50;4.89;890;19;2363.00;32
5982;19;624875703;5982;333;6872;6903;6.43;0.39;257.49;4.90;890;19;2364.00;31
5984;19;624875712;5984;335;6872;6903;6.37;0.39;257.49;4.90;888;19;2365.00;31
5985;19;624875722;5985;342;6878;6907;6.36;0.39;257.48;4.91;893;19;2366.00;29
5986;19;624875733;5986;336;6879;6908;6.35;0.39;257.45;4.91;893;19;2367.00;29
5989;19;624875743;5989;337;6880;6908;6.29;0.38;257.52;4.91;891;19;2368.00;28
5989;19;624875752;5989;329;6881;6909;6.34;0.39;257.52;4.91;892;19;2369.00;28
5992;19;624875764;5992;326;6881;6909;6.33;0.39;257.50;4.91;889;19;2370.00;28
5992;19;624875774;5992;332;6884;6909;6.34;0.39;257.50;4.92;892;19;2371.00;25
5995;19;624875784;5995;329;6884;6909;6.30;0.39;257.45;4.92;889;19;2372.00;25
5998;19;624875793;5998;332;6885;6909;6.25;0.38;257.41;4.92;887;19;2373.00;24
6000;19;624875802;6000;328;6885;6909;6.23;0.38;257.43;4.92;885;19;2374.00;24
6004;19;624875810;6004;329;6885;6909;6.22;0.38;257.55;4.92;881;19;2375.00;24
6007;19;624875820;6007;335;6935;6979;6.35;0.39;257.57;4.89;928;19;2376.00;44
6009;19;624875837;6009;325;6937;6980;6.35;0.39;257.57;4.89;928;19;2377.00;43
6014;19;624875847;6014;320;6942;6980;6.25;0.38;257.74;4.89;928;19;2378.00;38
6017;19;624875857;6017;319;6945;6980;6.22;0.38;257.73;4.89;928;19;2379.00;35
6020;19;624875867;6020;312;6946;6980;6.21;0.38;257.85;4.89;926;19;2380.00;34
6023;19;624875877;6023;311;6949;6980;6.23;0.38;257.99;4.89;926;19;2381.00;31
6026;19;624875887;6026;315;6950;6980;6.29;0.39;258.05;4.89;924;19;2382.00;30
6029;19;624875897;6029;306;6951;6980;6.34;0.39;258.11;4.89;922;19;2383.00;29
6036;19;624875907;6036;304;6954;6981;6.32;0.39;258.32;4.89;918;19;2384.00;27
6037;19;624875917;6037;307;6956;6983;6.41;0.39;258.30;4.89;919;19;2385.00;27
6041;19;624875927;6041;311;6957;6983;6.44;0.39;258.33;4.89;916;19;2386.00;26
6045;19;624875937;6045;313;6962;6987;6.43;0.39;258.33;4.89;917;19;2387.00;25
6049;19;624875947;6049;312;6963;6987;6.46;0.40;258.44;4.89;914;19;2388.00;24
6053;19;624875957;6053;309;6964;6987;6.48;0.40;258.50;4.89;911;19;2389.00;23
6056;19;624875967;6056;314;6964;6987;6.55;0.40;258.54;4.89;908;19;2390.00;23
6061;19;624875977;6061;315;6970;6993;6.53;0.40;258.63;4.89;909;19;2391.00;23
6065;19;624875988;6065;309;6970;6993;6.54;0.40;258.64;4.89;905;19;2392.00;23
6069;19;624875998;6069;300;6970;6993;6.59;0.40;258.73;4.89;901;19;2393.00;23
6074;19;624876009;6074;299;6973;6996;6.64;0.41;258.70;4.89;899;19;2394.00;23
6078;19;624876020;6078;298;6973;6996;6.73;0.41;258.83;4.89;895;19;2395.00;23
6084;19;624876030;6084;296;6973;6996;6.79;0.41;258.85;4.89;889;19;2396.00;23
6088;19;624876041;6088;295;6974;6997;6.84;0.42;258.92;4.88;886;19;2397.00;23
6091;19;624876051;6091;291;6975;6998;7.02;0.43;258.95;4.88;884;19;2398.00;23
6093;19;624876062;6093;293;6975;6998;7.12;0.44;258.97;4.88;882;19;2399.00;23
6098;19;624876074;6098;300;7000;7057;7.24;0.44;258.96;4.87;902;19;2400.00;57
6101;19;624876095;6101;288;7003;7057;7.34;0.45;259.03;4.86;902;19;2401.00;54
6106;19;624876106;6106;286;7005;7057;7.43;0.45;259.00;4.86;899;19;2402.00;52
6111;19;624876117;6111;291;7007;7058;7.48;0.46;259.02;4.86;896;19;2403.00;51
6115;19;624876127;6115;295;7008;7058;7.52;0.46;259.11;4.86;893;19;2404.00;50
6121;19;624876138;6121;290;7012;7062;7.50;0.46;259.28;4.86;891;19;2405.00;50
6125;19;624876149;6125;292;7014;7062;7.48;0.46;259.26;4.86;889;19;2406.00;48
6129;19;624876160;6129;291;7019;7066;7.47;0.46;259.32;4.86;890;19;2407.00;47
6133;19;624876172;6133;289;7020;7066;7.49;0.46;259.40;4.86;887;19;2408.00;46
6136;19;624876183;6136;291;7020;7066;7.48;0.46;259.38;4.86;884;19;2409.00;46
6141;19;624876193;6141;289;7020;7066;7.45;0.45;259.48;4.86;879;19;2410.00;46
6143;19;624876203;6143;286;7021;7066;7.47;0.46;259.56;4.86;878;19;2411.00;45
6146;19;624876214;6146;287;7030;7078;7.52;0.46;259.60;4.86;884;19;2412.00;48
6151;19;624876225;6151;288;7031;7078;7.49;0.46;259.67;4.86;880;19;2413.00;47
6153;19;624876236;6153;286;7033;7078;7.52;0.46;259.68;4.86;880;19;2414.00;45
6158;19;624876246;6158;284;7033;7078;7.56;0.46;259.68;4.86;875;19;2415.00;45
6163;19;624876257;6163;290;7034;7078;7.58;0.46;259.69;4.86;871;19;2416.00;44
6166;19;624876267;6166;287;7034;7078;7.58;0.46;259.76;4.86;868;19;2417.00;44
6170;19;624876278;6170;285;7035;7079;7.59;0.46;259.84;4.86;865;19;2418.00;44
6177;19;624876289;6177;291;7038;7079;7.53;0.46;259.90;4.87;861;19;2419.00;41
6183;19;624876300;6183;286;7042;7085;7.54;0.46;259.77;4.86;859;19;2420.00;43
6189;19;624876311;6189;287;7043;7086;7.57;0.46;259.86;4.86;854;19;2421.00;43
6193;19;624876323;6193;292;7043;7086;7.54;0.46;259.93;4.86;850;19;2422.00;43
6196;19;624876333;6196;291;7043;7086;7.54;0.46;259.97;4.86;847;19;2423.00;43
6200;19;624876343;6200;298;7046;7090;7.49;0.46;260.05;4.86;846;19;2424.00;44
6203;19;624876354;6203;295;7047;7090;7.49;0.46;260.07;4.87;844;19;2425.00;43
6207;19;624876365;6207;294;7047;7090;7.44;0.45;260.11;4.87;840;19;2426.00;43
6210;19;624876379;6210;287;7050;7091;7.45;0.45;260.19;4.87;840;19;2427.00;41
6214;19;624876391;6214;285;7053;7095;7.52;0.46;260.18;4.87;839;19;2428.00;42
6217;19;624876401;6217;277;7053;7095;7.56;0.46;260.26;4.87;836;19;2429.00;42
6218;19;624876414;6218;277;7058;7101;7.63;0.47;260.30;4.87;840;19;2430.00;43
6220;19;624876425;6220;278;7059;7101;7.64;0.47;260.39;4.87;839;19;2431.00;42
6222;19;624876436;6222;272;7060;7101;7.66;0.47;260.38;4.87;838;19;2432.00;41
6224;19;624876447;6224;275;7060;7101;7.67;0.47;260.35;4.87;836;19;2433.00;41
6230;19;624876457;6230;273;7064;7105;7.62;0.46;260.54;4.87;834;19;2434.00;41
6230;19;624876469;6230;272;7064;7105;7.68;0.47;260.54;4.87;834;19;2435.00;41
6234;19;624876480;6234;259;7065;7105;7.63;0.46;260.59;4.87;831;19;2436.00;40
6238;19;624876491;6238;251;7065;7105;7.60;0.46;260.67;4.87;827;19;2437.00;40
6239;19;624876502;6239;245;7065;7106;7.57;0.46;260.70;4.87;826;19;2438.00;41
6241;19;624876513;6241;240;7067;7107;7.58;0.46;260.71;4.92;826;19;2439.00;40
6245;19;624876525;6245;232;7067;7107;7.52;0.46;260.90;4.92;822;19;2440.00;40
6250;19;624876536;6250;226;7068;7108;7.57;0.46;260.92;4.92;818;19;2441.00;40
6251;19;624876554;6251;229;7069;7108;7.60;0.46;260.94;4.92;818;19;2442.00;39
6252;19;624876565;6252;226;7069;7108;7.64;0.47;260.92;4.92;817;19;2443.00;39
6254;19;624876576;6254;221;7069;7108;7.61;0.46;260.89;4.92;815;19;2444.00;39
6257;19;624876586;6257;221;7069;7108;7.63;0.46;260.94;4.92;812;19;2445.00;39
6259;19;624876598;6259;219;7069;7108;7.65;0.47;260.97;4.92;810;19;2446.00;39
6262;19;624876609;6262;216;7069;7108;7.74;0.47;261.09;4.92;807;19;2447.00;39
6265;19;624876619;6265;231;7132;7235;8.08;0.50;261.03;4.89;867;19;2448.00;103
6266;19;624876639;6266;222;7135;7236;8.19;0.51;261.03;4.89;869;19;2449.00;101
6268;19;624876651;6268;215;7143;7236;8.31;0.51;261.07;4.88;875;19;2450.00;93
6271;19;624876662;6271;215;7147;7236;8.39;0.52;261.14;4.88;876;19;2451.00;89
6274;19;624876673;6274;218;7151;7236;8.50;0.52;261.21;4.88;877;19;2452.00;85
6275;19;624876684;6275;213;7154;7236;8.60;0.53;261.21;4.88;879;19;2453.00;82
6277;19;624876695;6277;219;7161;7236;8.68;0.54;261.29;4.89;884;19;2454.00;75
6280;19;624876707;6280;215;7162;7236;8.70;0.54;261.34;4.89;882;19;2455.00;74
6281;19;624876718;6281;211;7164;7237;8.70;0.53;261.36;4.89;883;19;2456.00;73
6283;19;624876729;6283;209;7166;7238;8.73;0.54;261.36;4.89;883;19;2457.00;72
6285;19;624876745;6285;207;7168;7238;8.74;0.54;261.38;4.90;883;19;2458.00;70
6286;19;624876763;6286;212;7172;7239;8.81;0.54;261.38;4.90;886;19;2459.00;67
6289;19;624876783;6289;211;7175;7239;8.73;0.54;261.40;4.91;886;19;2460.00;64
6291;19;624876801;6291;210;7176;7239;8.78;0.54;261.39;4.91;885;19;2461.00;63
6299;19;624876818;6299;218;7181;7239;8.75;0.54;261.47;4.92;882;19;2462.00;58
6301;19;624876835;6301;225;7185;7243;8.76;0.53;261.48;4.92;884;19;2463.00;58
6307;19;624876852;6307;218;7186;7243;8.70;0.53;261.42;4.92;879;19;2464.00;57
6309;19;624876872;6309;220;7187;7243;8.67;0.53;261.46;4.92;878;19;2465.00;56
6312;19;624876884;6312;225;7190;7246;8.61;0.52;261.46;4.93;878;19;2466.00;56
6315;19;624876897;6315;223;7192;7246;8.56;0.52;261.44;4.94;877;19;2467.00;54
6317;19;624876910;6317;231;7193;7246;8.60;0.52;261.43;4.94;876;19;2468.00;53
6318;19;624876921;6318;227;7199;7250;8.61;0.52;261.42;4.98;881;19;2469.00;51
6320;19;624876941;6320;226;7201;7251;8.70;0.53;261.37;4.98;881;19;2470.00;50
6321;19;624876953;6321;228;7202;7251;8.78;0.54;261.37;4.98;881;19;2471.00;49
6322;19;624876965;6322;229;7204;7255;8.86;0.54;261.37;4.98;882;19;2472.00;51
6323;19;624876977;6323;229;7204;7255;8.90;0.54;261.46;4.98;881;19;2473.00;51
6327;19;624876989;6327;229;7205;7255;8.95;0.55;261.38;4.98;878;19;2474.00;50
6329;19;624877001;6329;227;7207;7257;9.02;0.55;261.40;4.98;878;19;2475.00;50
6333;19;624877013;6333;231;7207;7257;9.06;0.55;261.35;4.98;874;19;2476.00;50
6335;19;624877025;6335;233;7212;7263;9.15;0.56;261.33;4.98;877;19;2477.00;51
6339;19;624877038;6339;238;7212;7263;9.15;0.56;261.44;4.98;873;19;2478.00;51
6341;19;624877051;6341;234;7212;7264;9.14;0.56;261.36;4.98;871;19;2479.00;52
6344;19;624877062;6344;234;7213;7264;9.02;0.55;261.32;5.02;869;19;2480.00;51
6346;19;624877072;6346;235;7213;7264;8.94;0.54;261.33;5.02;867;19;2481.00;51
6349;19;624877083;6349;231;7213;7264;8.81;0.54;261.26;5.02;864;19;2482.00;51
6351;19;624877094;6351;229;7214;7264;8.70;0.53;261.23;5.07;863;19;2483.00;50
6357;19;624877105;6357;231;7224;7276;8.65;0.53;261.08;5.06;867;19;2484.00;52
6357;19;624877117;6357;226;7227;7276;8.61;0.52;261.08;5.08;870;19;2485.00;49
6360;19;624877129;6360;231;7227;7276;8.60;0.52;261.01;5.08;867;19;2486.00;49
6362;19;624877140;6362;237;7228;7276;8.60;0.52;261.00;5.12;866;19;2487.00;48
6362;19;624877150;6362;240;7228;7276;8.58;0.52;261.00;5.12;866;19;2488.00;48
6363;19;624877161;6363;245;7228;7276;8.59;0.52;260.98;5.12;865;19;2489.00;48
6365;19;624877173;6365;251;7231;7280;8.58;0.52;260.97;5.12;866;19;2490.00;49
6367;19;624877184;6367;256;7231;7280;8.52;0.52;260.95;5.12;864;19;2491.00;49
6368;19;624877201;6368;266;7235;7284;8.49;0.52;260.91;5.12;867;19;2492.00;49
6368;19;624877212;6368;267;7236;7285;8.47;0.52;260.91;5.16;868;19;2493.00;49
6370;19;624877224;6370;276;7237;7285;8.41;0.51;260.91;5.16;867;19;2494.00;48
6372;19;624877235;6372;281;7238;7285;8.38;0.51;260.86;5.17;866;19;2495.00;47
6375;19;624877245;6375;286;7248;7298;8.38;0.51;260.83;5.21;873;19;2496.00;50
6378;19;624877257;6378;284;7248;7298;8.33;0.51;260.79;5.21;870;19;2497.00;50
6382;19;624877268;6382;292;7248;7298;8.27;0.50;260.76;5.21;866;19;2498.00;50
6384;19;624877279;6384;278;7250;7299;8.23;0.50;260.86;5.26;866;19;2499.00;49
6387;19;624877291;6387;269;7252;7300;8.16;0.50;260.79;5.28;865;19;2500.00;48
6389;19;624877306;6389;261;7252;7300;8.19;0.50;260.74;5.28;863;19;2501.00;48
6391;19;624877322;6391;262;7255;7303;8.22;0.50;260.73;5.28;864;19;2502.00;48
6392;19;624877334;6392;257;7256;7303;8.20;0.50;260.70;5.28;864;19;2503.00;47
6393;19;624877345;6393;255;7257;7303;8.23;0.50;260.67;5.29;864;19;2504.00;46
6394;19;624877356;6394;256;7258;7303;8.22;0.50;260.68;5.30;864;19;2505.00;45
6396;19;624877366;6396;259;7263;7309;8.33;0.51;260.65;5.29;867;19;2506.00;46
6397;19;624877377;6397;256;7263;7309;8.34;0.51;260.63;5.29;866;19;2507.00;46
6398;19;624877389;6398;260;7264;7309;8.33;0.51;260.62;5.30;866;19;2508.00;45
6400;19;624877407;6400;260;7264;7309;8.27;0.50;260.65;5.30;864;19;2509.00;45
6400;19;624877417;6400;264;7268;7313;8.23;0.50;260.65;5.31;868;19;2510.00;45
6401;19;624877427;6401;266;7270;7314;8.19;0.50;260.62;5.31;869;19;2511.00;44
6402;19;624877439;6402;271;7271;7314;8.12;0.49;260.65;5.32;869;19;2512.00;43
6403;19;624877455;6403;273;7273;7315;8.07;0.49;260.66;5.33;870;19;2513.00;42
6404;19;624877474;6404;273;7275;7315;8.00;0.49;260.65;5.35;871;19;2514.00;40
6406;19;624877484;6406;275;7277;7315;7.92;0.48;260.67;5.37;871;19;2515.00;38
6406;19;624877495;6406;279;7277;7315;7.86;0.48;260.67;5.37;871;19;2516.00;38
6406;19;624877505;6406;283;7278;7315;7.81;0.48;260.67;5.37;872;19;2517.00;37
6406;19;624877514;6406;283;7280;7315;7.78;0.47;260.67;5.39;874;19;2518.00;35
6406;19;624877524;6406;281;7281;7315;7.75;0.47;260.67;5.40;875;19;2519.00;34
6410;19;624877536;6410;292;7337;7440;7.93;0.49;260.71;5.36;927;19;2520.00;103
6413;19;624877556;6413;290;7341;7441;7.90;0.49;260.70;5.37;928;19;2521.00;100
6414;19;624877567;6414;289;7354;7441;7.92;0.49;260.71;5.36;940;19;2522.00;87
6417;19;624877578;6417;292;7363;7441;7.89;0.49;260.74;5.37;946;19;2523.00;78
6419;19;624877591;6419;291;7368;7441;7.79;0.48;260.72;5.37;949;19;2524.00;73
6422;19;624877603;6422;292;7373;7441;7.69;0.47;260.71;5.37;951;19;2525.00;68
6425;19;624877614;6425;292;7378;7441;7.59;0.47;260.73;5.39;953;19;2526.00;63
6428;19;624877624;6428;291;7384;7441;7.49;0.46;260.78;5.39;956;19;2527.00;57
6430;19;624877635;6430;295;7389;7442;7.39;0.45;260.72;5.39;959;19;2528.00;53
6436;19;624877647;6436;306;7393;7443;7.23;0.44;260.85;5.40;957;19;2529.00;50
6437;19;624877658;6437;307;7396;7443;7.21;0.44;260.84;5.40;959;19;2530.00;47
6441;19;624877670;6441;306;7402;7447;7.08;0.43;260.83;5.41;961;19;2531.00;45
6445;19;624877681;6445;312;7403;7447;7.00;0.43;260.82;5.41;958;19;2532.00;44
6449;19;624877692;6449;304;7404;7447;6.94;0.42;260.89;5.41;955;19;2533.00;43
6451;19;624877703;6451;314;7404;7447;6.86;0.42;260.88;5.41;953;19;2534.00;43
6452;19;624877714;6452;317;7411;7453;6.82;0.42;260.90;5.42;959;19;2535.00;42
6455;19;624877727;6455;323;7411;7453;6.82;0.42;260.91;5.42;956;19;2536.00;42
6459;19;624877742;6459;329;7412;7455;6.75;0.41;260.94;5.42;953;19;2537.00;43
6462;19;624877754;6462;333;7415;7458;6.70;0.41;260.97;5.42;953;19;2538.00;43
6464;19;624877771;6464;339;7416;7458;6.70;0.41;260.98;5.42;952;19;2539.00;42
6466;19;624877783;6466;343;7417;7458;6.70;0.41;260.99;5.43;951;19;2540.00;41
6468;19;624877793;6468;351;7419;7459;6.64;0.41;261.02;5.44;951;19;2541.00;40
6470;19;624877809;6470;355;7421;7460;6.58;0.40;261.03;5.44;951;19;2542.00;39
6473;19;624877819;6473;356;7421;7460;6.54;0.40;261.08;5.44;948;19;2543.00;39
6476;19;624877830;6476;357;7431;7473;6.48;0.40;261.17;5.44;955;19;2544.00;42
6478;19;624877841;6478;352;7433;7473;6.47;0.40;261.17;5.44;955;19;2545.00;40
6482;19;624877852;6482;359;7434;7473;6.40;0.39;261.16;5.44;952;19;2546.00;39
6487;19;624877867;6487;360;7434;7474;6.26;0.38;261.22;5.44;947;19;2547.00;40
6490;19;624877888;6490;361;7435;7474;6.21;0.38;261.22;5.45;945;19;2548.00;39
6493;19;624877898;6493;359;7441;7478;6.14;0.38;261.21;5.45;948;19;2549.00;37
6497;19;624877910;6497;350;7443;7481;6.11;0.38;261.35;5.45;946;19;2550.00;38
6497;19;624877921;6497;350;7449;7485;6.09;0.38;261.35;5.45;952;19;2551.00;36
6501;19;624877931;6501;343;7449;7485;6.07;0.38;261.43;5.45;948;19;2552.00;36
6503;19;624877942;6503;339;7450;7485;6.08;0.38;261.49;5.45;947;19;2553.00;35
6507;19;624877951;6507;340;7450;7485;6.10;0.38;261.62;5.45;943;19;2554.00;35
6511;19;624877961;6511;338;7453;7485;6.08;0.38;261.66;5.45;942;19;2555.00;32
6513;19;624877978;6513;338;7464;7497;6.15;0.38;261.69;5.44;951;19;2556.00;33
6518;19;624877990;6518;332;7465;7497;6.16;0.38;261.83;5.44;947;19;2557.00;32
6520;19;624878001;6520;321;7465;7497;6.21;0.39;261.88;5.44;945;19;2558.00;32
6524;19;624878011;6524;313;7465;7497;6.28;0.39;262.00;5.44;941;19;2559.00;32
6527;19;624878022;6527;310;7465;7497;6.35;0.40;261.99;5.44;938;19;2560.00;32
6529;19;624878032;6529;313;7466;7497;6.44;0.40;262.02;5.49;937;19;2561.00;31
6535;19;624878043;6535;308;7467;7498;6.44;0.40;262.19;5.49;932;19;2562.00;31
6539;19;624878054;6539;307;7467;7498;6.51;0.41;262.33;5.49;928;19;2563.00;31
6544;19;624878065;6544;309;7472;7504;6.66;0.41;262.32;5.49;928;19;2564.00;32
6548;19;624878076;6548;308;7474;7506;6.71;0.42;262.42;5.49;926;19;2565.00;32
6553;19;624878087;6553;309;7474;7506;6.77;0.42;262.38;5.49;921;19;2566.00;32
6557;19;624878098;6557;302;7474;7506;6.81;0.42;262.61;5.49;917;19;2567.00;32
6564;19;624878109;6564;291;7477;7510;6.86;0.42;262.53;5.48;913;19;2568.00;33
6570;19;624878120;6570;286;7477;7510;6.87;0.42;262.56;5.48;907;19;2569.00;33
6577;19;624878131;6577;283;7477;7510;6.88;0.42;262.61;5.48;900;19;2570.00;33
6581;19;624878142;6581;278;7478;7511;6.89;0.42;262.61;5.48;897;19;2571.00;33
6585;19;624878153;6585;279;7481;7515;6.90;0.42;262.70;5.48;896;19;2572.00;34
6588;19;624878164;6588;281;7481;7515;6.93;0.42;262.64;5.48;893;19;2573.00;34
6592;19;624878175;6592;277;7483;7518;6.95;0.43;262.63;5.48;891;19;2574.00;35
6598;19;624878186;6598;282;7483;7518;6.92;0.42;262.68;5.48;885;19;2575.00;35
6600;19;624878196;6600;281;7484;7518;6.98;0.43;262.68;5.48;884;19;2576.00;34
6607;19;624878207;6607;281;7484;7518;7.00;0.43;262.79;5.48;877;19;2577.00;34
6610;19;624878218;6610;270;7488;7522;7.07;0.43;262.82;5.48;878;19;2578.00;34
6614;19;624878229;6614;272;7488;7522;7.08;0.43;262.82;5.48;874;19;2579.00;34
6621;19;624878241;6621;266;7488;7522;7.10;0.43;262.89;5.48;867;19;2580.00;34
6623;19;624878252;6623;273;7488;7522;7.10;0.43;262.91;5.48;865;19;2581.00;34
6627;19;624878262;6627;269;7488;7523;7.08;0.43;262.97;5.48;861;19;2582.00;35
6634;19;624878273;6634;269;7489;7524;6.99;0.43;262.97;5.48;855;19;2583.00;35
6639;19;624878284;6639;271;7489;7524;6.94;0.42;263.03;5.48;850;19;2584.00;35
6642;19;624878294;6642;268;7490;7525;7.02;0.43;263.05;5.48;848;19;2585.00;35
6647;19;624878305;6647;274;7490;7525;7.05;0.43;263.11;5.48;843;19;2586.00;35
6650;19;624878315;6650;276;7490;7525;7.03;0.43;263.09;5.48;840;19;2587.00;35
6653;19;624878325;6653;276;7490;7525;6.99;0.43;263.14;5.48;837;19;2588.00;35
6657;19;624878335;6657;278;7490;7525;6.89;0.42;263.23;5.48;833;19;2589.00;35
6659;19;624878345;6659;284;7490;7525;6.81;0.42;263.21;5.48;831;19;2590.00;35
6668;19;624878355;6668;283;7490;7525;6.58;0.40;263.23;5.48;822;19;2591.00;35
6672;19;624878365;6672;305;7557;7652;6.73;0.42;263.19;5.43;885;19;2592.00;95
6672;19;624878384;6672;293;7562;7653;6.76;0.42;263.19;5.48;890;19;2593.00;91
6675;19;624878395;6675;285;7569;7653;6.86;0.42;263.27;5.48;894;19;2594.00;84
6678;19;624878405;6678;283;7572;7653;6.90;0.43;263.31;5.48;894;19;2595.00;81
6679;19;624878416;6679;280;7577;7653;7.00;0.43;263.31;5.48;898;19;2596.00;76
6682;19;624878427;6682;270;7579;7653;7.03;0.43;263.33;5.48;897;19;2597.00;74
6683;19;624878438;6683;262;7581;7653;7.14;0.44;263.33;5.48;898;19;2598.00;72
6685;19;624878449;6685;263;7584;7653;7.20;0.44;263.29;5.48;899;19;2599.00;69
6687;19;624878460;6687;263;7586;7654;7.26;0.45;263.33;5.48;899;19;2600.00;68
6691;19;624878476;6691;268;7593;7655;7.36;0.45;263.39;5.48;902;19;2601.00;62
6694;19;624878487;6694;273;7595;7655;7.38;0.45;263.39;5.48;901;19;2602.00;60
6696;19;624878498;6696;273;7597;7656;7.29;0.45;263.45;5.48;901;19;2603.00;59
6698;19;624878510;6698;276;7598;7656;7.30;0.45;263.45;5.48;900;19;2604.00;58
6702;19;624878521;6702;273;7601;7656;7.29;0.45;263.40;5.49;899;19;2605.00;55
6703;19;624878532;6703;269;7602;7656;7.27;0.45;263.47;5.49;899;19;2606.00;54
6707;19;624878543;6707;264;7607;7660;7.31;0.45;263.53;5.55;900;19;2607.00;53
6709;19;624878555;6709;267;7609;7660;7.37;0.45;263.51;5.55;900;19;2608.00;51
6711;19;624878567;6711;263;7611;7660;7.45;0.46;263.54;5.55;900;19;2609.00;49
6712;19;624878580;6712;268;7615;7666;7.49;0.46;263.53;5.61;903;19;2610.00;51
6718;19;624878592;6718;262;7616;7666;7.50;0.46;263.47;5.61;898;19;2611.00;50
6719;19;624878604;6719;258;7618;7666;7.57;0.46;263.43;5.61;899;19;2612.00;48
6722;19;624878615;6722;259;7621;7670;7.56;0.46;263.53;5.61;899;19;2613.00;49
6724;19;624878627;6724;260;7624;7671;7.59;0.46;263.62;5.61;900;19;2614.00;47
6725;19;624878639;6725;264;7625;7671;7.54;0.46;263.60;5.61;900;19;2615.00;46
6727;19;624878650;6727;264;7628;7675;7.54;0.46;263.69;5.61;901;19;2616.00;47
6732;19;624878662;6732;266;7630;7675;7.59;0.46;263.78;5.61;898;19;2617.00;45
6734;19;624878674;6734;270;7630;7675;7.54;0.46;263.86;5.61;896;19;2618.00;45
6736;19;624878686;6736;270;7631;7676;7.54;0.46;263.85;5.61;895;19;2619.00;45
6740;19;624878697;6740;266;7631;7676;7.56;0.46;263.81;5.61;891;19;2620.00;45
6742;19;624878708;6742;267;7636;7682;7.61;0.46;263.85;5.61;894;19;2621.00;46
6742;19;624878720;6742;267;7636;7682;7.63;0.46;263.85;5.61;894;19;2622.00;46
6745;19;624878731;6745;266;7636;7683;7.63;0.46;263.85;5.61;891;19;2623.00;47
6748;19;624878747;6748;268;7636;7683;7.65;0.46;263.89;5.61;888;19;2624.00;47
6750;19;624878768;6750;265;7636;7683;7.67;0.46;263.98;5.61;886;19;2625.00;47
6754;19;624878784;6754;264;7636;7683;7.62;0.46;264.00;5.61;882;19;2626.00;47
6755;19;624878805;6755;266;7636;7683;7.61;0.46;264.00;5.61;881;19;2627.00;47
6756;19;624878822;6756;267;7646;7695;7.68;0.47;263.97;5.60;890;19;2628.00;49
6758;19;624878840;6758;267;7646;7695;7.71;0.47;263.94;5.60;888;19;2629.00;49
6759;19;624878856;6759;263;7647;7695;7.76;0.47;263.92;5.60;888;19;2630.00;48
6763;19;624878868;6763;261;7647;7695;7.76;0.47;263.87;5.60;884;19;2631.00;48
6765;19;624878881;6765;260;7647;7695;7.82;0.48;263.86;5.60;882;19;2632.00;48
6767;19;624878893;6767;260;7647;7695;7.88;0.48;263.84;5.60;880;19;2633.00;48
6768;19;624878905;6768;257;7650;7699;7.95;0.48;263.82;5.60;882;19;2634.00;49
6770;19;624878916;6770;258;7650;7699;8.02;0.49;263.78;5.60;880;19;2635.00;49
6772;19;624878928;6772;254;7654;7703;8.11;0.49;263.77;5.59;882;19;2636.00;49
6774;19;624878941;6774;258;7655;7704;8.13;0.49;263.73;5.59;881;19;2637.00;49
6778;19;624878953;6778;260;7655;7704;8.15;0.50;263.76;5.59;877;19;2638.00;49
6778;19;624878965;6778;263;7655;7704;8.20;0.50;263.76;5.59;877;19;2639.00;49
6780;19;624878979;6780;268;7678;7733;8.18;0.50;263.82;5.58;898;19;2640.00;55
6780;19;624878993;6780;267;7678;7733;8.16;0.50;263.82;5.58;898;19;2641.00;55
6783;19;624879004;6783;262;7680;7733;8.22;0.50;263.83;5.58;897;19;2642.00;53
6786;19;624879016;6786;265;7682;7734;8.25;0.50;263.79;5.64;896;19;2643.00;52
6788;19;624879028;6788;261;7682;7735;8.26;0.50;263.78;5.64;894;19;2644.00;53
6793;19;624879039;6793;262;7682;7735;8.24;0.50;263.73;5.64;889;19;2645.00;53
6795;19;624879050;6795;259;7684;7738;8.22;0.50;263.69;5.64;889;19;2646.00;54
6795;19;624879061;6795;263;7684;7738;8.18;0.50;263.69;5.64;889;19;2647.00;54
6797;19;624879072;6797;271;7685;7738;8.19;0.50;263.70;5.64;888;19;2648.00;53
6798;19;624879083;6798;269;7685;7738;8.14;0.49;263.75;5.64;887;19;2649.00;53
6800;19;624879095;6800;268;7690;7744;8.07;0.49;263.70;5.63;890;19;2650.00;54
6800;19;624879106;6800;260;7690;7744;8.04;0.49;263.70;5.63;890;19;2651.00;54
6803;19;624879117;6803;249;7690;7744;7.96;0.48;263.70;5.63;887;19;2652.00;54
6806;19;624879135;6806;246;7690;7744;7.92;0.48;263.69;5.63;884;19;2653.00;54
6807;19;624879148;6807;242;7694;7748;7.94;0.48;263.67;5.64;887;19;2654.00;54
6809;19;624879161;6809;236;7697;7750;7.95;0.48;263.68;5.65;888;19;2655.00;53
6809;19;624879172;6809;232;7697;7750;8.01;0.49;263.68;5.65;888;19;2656.00;53
6810;19;624879183;6810;230;7698;7751;8.11;0.49;263.67;5.65;888;19;2657.00;53
6813;19;624879194;6813;232;7698;7751;8.17;0.49;263.60;5.65;885;19;2658.00;53
6815;19;624879206;6815;237;7699;7751;8.26;0.50;263.56;5.71;884;19;2659.00;52
6819;19;624879217;6819;230;7699;7751;8.36;0.51;263.52;5.71;880;19;2660.00;52
6821;19;624879228;6821;231;7699;7751;8.50;0.51;263.61;5.71;878;19;2661.00;52
6823;19;624879239;6823;233;7699;7751;8.59;0.52;263.57;5.71;876;19;2662.00;52
6825;19;624879250;6825;232;7699;7751;8.68;0.53;263.55;5.71;874;19;2663.00;52
6826;19;624879262;6826;233;7732;7821;8.89;0.54;263.55;5.69;906;19;2664.00;89
6827;19;624879280;6827;230;7735;7822;8.87;0.54;263.53;5.69;908;19;2665.00;87
6831;19;624879297;6831;230;7742;7822;8.76;0.53;263.48;5.68;911;19;2666.00;80
6832;19;624879316;6832;232;7747;7822;8.67;0.52;263.49;5.68;915;19;2667.00;75
6832;19;624879328;6832;224;7748;7822;8.67;0.53;263.49;5.68;916;19;2668.00;74
6833;19;624879339;6833;222;7751;7822;8.67;0.53;263.50;5.68;918;19;2669.00;71
6835;19;624879352;6835;226;7752;7822;8.63;0.52;263.54;5.68;917;19;2670.00;70
6835;19;624879370;6835;225;7755;7822;8.62;0.52;263.54;5.68;920;19;2671.00;67
6838;19;624879382;6838;228;7757;7823;8.56;0.52;263.56;5.68;919;19;2672.00;66
6842;19;624879394;6842;229;7760;7824;8.51;0.52;263.53;5.68;918;19;2673.00;64
6843;19;624879407;6843;228;7763;7824;8.48;0.51;263.51;5.69;920;19;2674.00;61
6846;19;624879419;6846;224;7769;7828;8.44;0.51;263.53;5.69;923;19;2675.00;59
6849;19;624879432;6849;233;7771;7828;8.39;0.51;263.55;5.75;922;19;2676.00;57
6850;19;624879446;6850;233;7772;7828;8.37;0.51;263.54;5.76;922;19;2677.00;56
6853;19;624879460;6853;239;7772;7828;8.27;0.50;263.49;5.76;919;19;2678.00;56
6857;19;624879472;6857;243;7777;7834;8.24;0.50;263.52;5.76;920;19;2679.00;57
6859;19;624879485;6859;250;7778;7834;8.21;0.50;263.60;5.77;919;19;2680.00;56
6861;19;624879499;6861;260;7778;7834;8.19;0.50;263.62;5.77;917;19;2681.00;56
6861;19;624879511;6861;264;7781;7837;8.18;0.50;263.62;5.78;920;19;2682.00;56
6863;19;624879524;6863;272;7782;7837;8.14;0.49;263.61;5.79;919;19;2683.00;55
6864;19;624879536;6864;277;7784;7837;8.10;0.49;263.60;5.80;920;19;2684.00;53
6865;19;624879548;6865;277;7784;7838;7.96;0.48;263.63;5.80;919;19;2685.00;54
6870;19;624879559;6870;278;7787;7839;7.83;0.47;263.57;5.82;917;19;2686.00;52
6872;19;624879577;6872;283;7787;7839;7.78;0.47;263.61;5.82;915;19;2687.00;52
6872;19;624879590;6872;293;7798;7852;7.77;0.47;263.61;5.82;926;19;2688.00;54
6875;19;624879603;6875;303;7799;7852;7.72;0.47;263.66;5.82;924;19;2689.00;53
6876;19;624879614;6876;310;7800;7852;7.67;0.47;263.67;5.82;924;19;2690.00;52
6879;19;624879626;6879;306;7802;7853;7.60;0.46;263.78;5.83;923;19;2691.00;51
6880;19;624879638;6880;310;7802;7853;7.56;0.46;263.80;5.83;922;19;2692.00;51
6882;19;624879650;6882;316;7807;7857;7.52;0.46;263.85;5.83;925;19;2693.00;50
6883;19;624879662;6883;316;7808;7857;7.41;0.45;263.85;5.84;925;19;2694.00;49
6885;19;624879673;6885;322;7811;7861;7.29;0.44;263.88;5.84;926;19;2695.00;50
6887;19;624879684;6887;326;7813;7861;7.19;0.44;263.86;5.87;926;19;2696.00;48
6887;19;624879701;6887;330;7813;7861;7.11;0.43;263.86;5.87;926;19;2697.00;48
6890;19;624879712;6890;334;7815;7861;6.99;0.43;263.92;5.89;925;19;2698.00;46
6891;19;624879724;6891;334;7815;7861;6.92;0.42;263.93;5.89;924;19;2699.00;46
6893;19;624879740;6893;332;7841;7910;7.04;0.43;263.95;5.87;948;19;2700.00;69
6895;19;624879761;6895;337;7843;7910;6.98;0.43;263.99;5.88;948;19;2701.00;67
6898;19;624879771;6898;333;7847;7910;6.97;0.43;264.08;5.88;949;19;2702.00;63
6901;19;624879782;6901;332;7848;7910;6.87;0.42;264.12;5.89;947;19;2703.00;62
6904;19;624879792;6904;335;7851;7910;6.83;0.42;264.12;5.89;947;19;2704.00;59
6905;19;624879803;6905;336;7851;7910;6.82;0.42;264.19;5.89;946;19;2705.00;59
6907;19;624879814;6907;338;7855;7911;6.75;0.41;264.23;5.91;948;19;2706.00;56
6910;19;624879824;6910;336;7856;7911;6.75;0.41;264.28;5.91;946;19;2707.00;55
6913;19;624879834;6913;341;7861;7917;6.82;0.42;264.40;5.91;948;19;2708.00;56
6914;19;624879846;6914;339;7863;7918;6.81;0.42;264.38;5.92;949;19;2709.00;55
6918;19;624879857;6918;335;7863;7918;6.77;0.41;264.49;5.92;945;19;2710.00;55
6919;19;624879868;6919;338;7865;7918;6.71;0.41;264.51;5.93;946;19;2711.00;53
6920;19;624879878;6920;346;7870;7922;6.68;0.41;264.50;5.93;950;19;2712.00;52
6927;19;624879889;6927;348;7872;7922;6.58;0.40;264.52;5.94;945;19;2713.00;50
6928;19;624879900;6928;347;7872;7922;6.58;0.40;264.54;5.94;944;19;2714.00;50
6935;19;624879910;6935;354;7873;7923;6.49;0.40;264.54;5.94;938;19;2715.00;50
6940;19;624879920;6940;353;7878;7927;6.35;0.39;264.55;5.95;938;19;2716.00;49
6943;19;624879931;6943;353;7879;7927;6.27;0.38;264.62;5.95;936;19;2717.00;48
6947;19;624879941;6947;354;7884;7930;6.22;0.38;264.66;5.96;937;19;2718.00;46
6951;19;624879951;6951;358;7885;7930;6.17;0.38;264.60;5.96;934;19;2719.00;45
6958;19;624879961;6958;350;7886;7930;6.11;0.37;264.61;5.96;928;19;2720.00;44
6959;19;624879972;6959;348;7887;7930;6.03;0.37;264.66;5.96;928;19;2721.00;43
6962;19;624879981;6962;349;7891;7934;6.01;0.37;264.71;5.96;929;19;2722.00;43
6964;19;624879991;6964;345;7893;7934;5.98;0.37;264.79;5.97;929;19;2723.00;41
6968;19;624880001;6968;345;7894;7934;6.01;0.37;264.89;5.97;926;19;2724.00;40
6970;19;624880011;6970;345;7894;7934;6.11;0.37;264.95;5.97;924;19;2725.00;40
6975;19;624880021;6975;352;7896;7935;6.09;0.37;264.99;5.97;921;19;2726.00;39
6978;19;624880030;6978;341;7897;7936;6.14;0.38;265.06;5.97;919;19;2727.00;39
6980;19;624880040;6980;340;7900;7936;6.18;0.38;265.17;5.97;920;19;2728.00;36
6984;19;624880050;6984;340;7901;7937;6.24;0.38;265.35;5.97;917;19;2729.00;36
6988;20;624880061;6988;340;7902;7937;6.25;0.38;265.42;5.98;914;20;2730.00;35
6990;20;624880077;6990;339;7903;7937;6.34;0.39;265.50;5.98;913;20;2731.00;34
6993;20;624880087;6993;338;7904;7937;6.42;0.40;265.59;5.98;911;20;2732.00;33
7000;20;624880097;7000;344;7904;7937;6.46;0.40;265.72;5.98;904;20;2733.00;33
7005;20;624880108;7005;339;7904;7937;6.47;0.40;265.77;5.98;899;20;2734.00;33
7010;20;624880118;7010;339;7904;7937;6.45;0.40;265.83;5.98;894;20;2735.00;33
7013;20;624880128;7013;348;7971;8064;6.79;0.42;265.81;5.93;958;20;2736.00;93
7019;20;624880151;7019;344;7975;8065;6.80;0.42;265.93;5.93;956;20;2737.00;90
7025;20;624880163;7025;345;7983;8065;6.83;0.42;265.94;5.93;958;20;2738.00;82
7031;20;624880173;7031;338;7987;8065;6.80;0.42;265.94;5.93;956;20;2739.00;78
7033;20;624880184;7033;343;7994;8065;6.76;0.42;265.98;5.92;961;20;2740.00;71
7036;20;624880195;7036;339;7996;8065;6.75;0.42;266.09;5.92;960;20;2741.00;69
7039;20;624880205;7039;340;7999;8065;6.71;0.41;266.08;5.92;960;20;2742.00;66
7044;20;624880220;7044;337;8001;8065;6.61;0.41;266.22;5.92;957;20;2743.00;64
7047;20;624880230;7047;335;8003;8066;6.58;0.40;266.30;5.92;956;20;2744.00;63
7052;20;624880242;7052;337;8004;8068;6.55;0.40;266.30;5.92;952;20;2745.00;64
7057;20;624880253;7057;339;8006;8068;6.55;0.40;266.29;5.92;949;20;2746.00;62
7060;20;624880264;7060;342;8008;8069;6.56;0.40;266.29;5.93;948;20;2747.00;61
7064;20;624880275;7064;346;8010;8069;6.56;0.40;266.39;5.93;946;20;2748.00;59
7068;20;624880286;7068;348;8014;8069;6.64;0.41;266.51;5.93;946;20;2749.00;55
7071;20;624880297;7071;353;8017;8069;6.70;0.41;266.49;5.93;946;20;2750.00;52
7076;20;624880308;7076;355;8023;8073;6.73;0.41;266.50;5.94;947;20;2751.00;50
7080;20;624880320;7080;362;8025;8073;6.73;0.42;266.49;5.94;945;20;2752.00;48
7088;20;624880331;7088;362;8026;8073;6.70;0.41;266.44;5.94;938;20;2753.00;47
7095;20;624880342;7095;373;8028;8076;6.65;0.41;266.50;5.94;933;20;2754.00;48
7098;20;624880353;7098;380;8029;8076;6.60;0.40;266.54;5.94;931;20;2755.00;47
7105;20;624880364;7105;388;8030;8076;6.48;0.40;266.64;5.94;925;20;2756.00;46
7110;20;624880375;7110;388;8034;8080;6.34;0.39;266.64;5.94;924;20;2757.00;46
7113;20;624880386;7113;398;8037;8081;6.19;0.38;266.74;6.02;924;20;2758.00;44
7119;20;624880397;7119;399;8038;8081;6.05;0.37;266.77;6.02;919;20;2759.00;43
7121;20;624880409;7121;402;8042;8086;5.99;0.37;266.77;6.01;921;20;2760.00;44
7125;20;624880420;7125;406;8042;8086;5.86;0.36;266.82;6.01;917;20;2761.00;44
7127;20;624880430;7127;405;8044;8086;5.85;0.36;266.90;6.01;917;20;2762.00;42
7129;20;624880440;7129;412;8045;8087;5.84;0.36;266.88;6.01;916;20;2763.00;42
7130;20;624880451;7130;414;8045;8087;5.79;0.35;266.93;6.01;915;20;2764.00;42
7131;20;624880461;7131;409;8050;8093;5.86;0.36;266.93;6.01;919;20;2765.00;43
7134;20;624880473;7134;410;8050;8093;5.84;0.36;266.92;6.01;916;20;2766.00;43
7135;20;624880483;7135;397;8050;8094;5.85;0.36;266.98;6.01;915;20;2767.00;44
7136;20;624880493;7136;392;8050;8094;5.87;0.36;266.94;6.01;914;20;2768.00;44
7140;20;624880504;7140;382;8050;8094;5.85;0.36;266.98;6.01;910;20;2769.00;44
7144;20;624880514;7144;382;8050;8094;5.86;0.36;267.06;6.01;906;20;2770.00;44
7146;20;624880525;7146;380;8050;8094;5.88;0.36;267.11;6.01;904;20;2771.00;44
7147;20;624880536;7147;391;8060;8106;5.98;0.37;267.15;6.00;913;20;2772.00;46
7148;20;624880552;7148;395;8060;8106;5.99;0.37;267.15;6.00;912;20;2773.00;46
7150;20;624880562;7150;395;8061;8106;5.98;0.37;267.11;6.00;911;20;2774.00;45
7154;20;624880573;7154;400;8061;8106;5.99;0.37;267.12;6.00;907;20;2775.00;45
7154;20;624880583;7154;387;8061;8106;6.04;0.37;267.12;6.00;907;20;2776.00;45
7156;20;624880593;7156;371;8061;8106;6.08;0.37;267.10;6.00;905;20;2777.00;45
7159;20;624880604;7159;372;8064;8110;6.09;0.37;267.03;6.00;905;20;2778.00;46
7160;20;624880615;7160;364;8064;8110;6.20;0.38;267.03;6.00;904;20;2779.00;46
7160;20;624880626;7160;358;8068;8114;6.36;0.39;267.03;6.00;908;20;2780.00;46
7163;20;624880637;7163;352;8069;8115;6.47;0.40;267.00;6.00;906;20;2781.00;46
7164;20;624880649;7164;344;8069;8115;6.58;0.40;266.99;6.00;905;20;2782.00;46
7165;20;624880660;7165;333;8069;8115;6.66;0.41;266.96;6.00;904;20;2783.00;46
7166;20;624880671;7166;326;8080;8128;6.83;0.42;266.97;5.99;914;20;2784.00;48
7166;20;624880683;7166;330;8080;8128;6.88;0.42;266.97;5.99;914;20;2785.00;48
7169;20;624880694;7169;325;8080;8128;6.91;0.42;266.92;5.99;911;20;2786.00;48
7170;20;624880704;7170;321;8081;8129;6.98;0.43;267.00;5.99;911;20;2787.00;48
7175;20;624880715;7175;318;8082;8130;6.92;0.42;266.96;6.07;907;20;2788.00;48
7178;20;624880726;7178;312;8082;8130;6.94;0.43;266.93;6.07;904;20;2789.00;48
7182;20;624880741;7182;305;8086;8136;7.00;0.43;266.95;6.06;904;20;2790.00;50
7184;20;624880759;7184;298;8086;8136;7.03;0.43;266.94;6.06;902;20;2791.00;50
7186;20;624880776;7186;296;8088;8136;7.09;0.44;266.96;6.06;902;20;2792.00;48
7189;20;624880794;7189;299;8088;8136;7.15;0.44;266.94;6.06;899;20;2793.00;48
7190;20;624880811;7190;294;8093;8142;7.23;0.44;266.97;6.06;903;20;2794.00;49
7193;20;624880828;7193;288;8093;8142;7.27;0.44;266.98;6.06;900;20;2795.00;49
7196;21;624880849;7196;290;8093;8142;7.29;0.44;266.98;6.06;897;21;2796.00;49
7197;21;624880887;7197;287;8093;8142;7.36;0.45;267.01;6.06;896;21;2797.00;49
7197;21;624880899;7197;284;8096;8146;7.44;0.45;267.01;6.06;899;21;2798.00;50
7200;21;624880911;7200;284;8097;8147;7.47;0.46;266.97;6.06;897;21;2799.00;50
7202;21;624880924;7202;281;8097;8147;7.54;0.46;266.95;6.06;895;21;2800.00;50
7204;21;624880949;7204;283;8098;8148;7.62;0.46;266.95;6.06;894;21;2801.00;50
7207;21;624880960;7207;277;8098;8148;7.62;0.46;266.92;6.06;891;21;2802.00;50
7208;21;624880972;7208;267;8098;8148;7.68;0.47;266.90;6.06;890;21;2803.00;50
7209;21;624880983;7209;254;8098;8148;7.78;0.47;266.90;6.06;889;21;2804.00;50
7211;21;624881009;7211;246;8098;8148;7.88;0.48;266.87;6.06;887;21;2805.00;50
7212;21;624881021;7212;243;8098;8148;8.00;0.49;266.87;6.06;886;21;2806.00;50
7214;21;624881033;7214;238;8098;8148;8.16;0.49;266.85;6.06;884;21;2807.00;50
7215;21;624881044;7215;244;8137;8218;8.25;0.50;266.87;6.10;922;21;2808.00;81
7216;21;624881061;7216;234;8137;8219;8.37;0.51;266.87;6.10;921;21;2809.00;82
7216;21;624881073;7216;222;8144;8219;8.56;0.52;266.87;6.09;928;21;2810.00;75
7218;21;624881084;7218;219;8149;8219;8.70;0.53;266.97;6.09;931;21;2811.00;70
7219;21;624881104;7219;216;8151;8219;8.79;0.53;266.96;6.09;932;21;2812.00;68
7221;21;624881116;7221;210;8152;8219;8.85;0.54;267.00;6.09;931;21;2813.00;67
7223;21;624881129;7223;212;8155;8219;8.95;0.54;266.98;6.09;932;21;2814.00;64
7224;22;624881142;7224;214;8157;8219;9.06;0.55;266.98;6.09;933;22;2815.00;62
7225;22;624881162;7225;212;8159;8220;9.15;0.55;267.01;6.09;934;22;2816.00;61
7227;22;624881175;7227;214;8161;8221;9.21;0.56;267.02;6.09;934;22;2817.00;60
7230;22;624881196;7230;209;8163;8221;9.25;0.56;267.04;6.09;933;22;2818.00;58
7231;22;624881214;7231;212;8169;8225;9.19;0.56;267.05;6.09;938;22;2819.00;56
7233;22;624881229;7233;210;8170;8225;9.16;0.55;267.09;6.09;937;22;2820.00;55
7235;22;624881241;7235;209;8170;8225;9.06;0.55;267.07;6.09;935;22;2821.00;55
7236;22;624881255;7236;209;8170;8225;8.99;0.55;267.08;6.09;934;22;2822.00;55
7239;22;624881268;7239;205;8175;8231;8.90;0.54;267.05;6.09;936;22;2823.00;56
7241;22;624881282;7241;209;8176;8231;8.84;0.54;267.01;6.15;935;22;2824.00;55
7243;22;624881294;7243;212;8178;8231;8.77;0.53;267.06;6.17;935;22;2825.00;53
7245;22;624881307;7245;214;8180;8234;8.74;0.53;267.05;6.17;935;22;2826.00;54
7246;22;624881320;7246;220;8181;8234;8.70;0.53;267.06;6.17;935;22;2827.00;53
7248;22;624881331;7248;222;8181;8234;8.65;0.52;267.15;6.17;933;22;2828.00;53
7251;22;624881343;7251;212;8181;8235;8.57;0.52;267.17;6.17;930;22;2829.00;54
7253;22;624881355;7253;209;8182;8236;8.61;0.52;267.21;6.17;929;22;2830.00;54
7256;22;624881367;7256;204;8182;8236;8.61;0.52;267.22;6.17;926;22;2831.00;54
7259;22;624881379;7259;208;8192;8249;8.62;0.52;267.18;6.16;933;22;2832.00;57
7264;22;624881392;7264;210;8193;8249;8.59;0.52;267.16;6.16;929;22;2833.00;56
7266;22;624881404;7266;211;8193;8249;8.59;0.52;267.14;6.16;927;22;2834.00;56
7268;22;624881421;7268;220;8195;8251;8.56;0.52;267.16;6.16;927;22;2835.00;56
7273;22;624881434;7273;219;8195;8251;8.52;0.52;267.12;6.16;922;22;2836.00;56
7274;23;624881446;7274;218;8199;8255;8.55;0.52;267.10;6.16;925;23;2837.00;56
7279;23;624881470;7279;222;8199;8255;8.45;0.51;267.09;6.16;920;23;2838.00;56
7281;23;624881482;7281;231;8202;8259;8.43;0.51;267.10;6.16;921;23;2839.00;57
7283;23;624881494;7283;227;8202;8259;8.42;0.51;267.09;6.16;919;23;2840.00;57
7286;24;624881506;7286;232;8202;8259;8.39;0.51;267.18;6.16;916;24;2841.00;57
7287;24;624881532;7287;235;8202;8259;8.41;0.51;267.20;6.16;915;24;2842.00;57
7287;24;624881543;7287;238;8202;8259;8.46;0.51;267.20;6.16;915;24;2843.00;57
7288;24;624881555;7288;235;8211;8271;8.52;0.52;267.19;6.15;923;24;2844.00;60
7289;24;624881567;7289;239;8213;8271;8.55;0.52;267.19;6.21;924;24;2845.00;58
7291;24;624881579;7291;236;8214;8271;8.51;0.52;267.19;6.21;923;24;2846.00;57
7296;24;624881591;7296;240;8214;8271;8.40;0.51;267.24;6.21;918;24;2847.00;57
7296;24;624881603;7296;241;8214;8271;8.37;0.51;267.24;6.21;918;24;2848.00;57
7299;24;624881615;7299;242;8214;8271;8.34;0.51;267.31;6.21;915;24;2849.00;57
7301;24;624881628;7301;250;8216;8274;8.26;0.50;267.37;6.21;915;24;2850.00;58
7302;24;624881640;7302;251;8218;8274;8.29;0.51;267.37;6.24;916;24;2851.00;56
7306;24;624881651;7306;255;8223;8280;8.38;0.51;267.47;6.23;917;24;2852.00;57
7308;24;624881664;7308;257;8224;8281;8.36;0.51;267.53;6.23;916;24;2853.00;57
7309;24;624881676;7309;260;8226;8281;8.38;0.51;267.52;6.26;917;24;2854.00;55
7314;24;624881688;7314;264;8226;8281;8.35;0.51;267.61;6.26;912;24;2855.00;55
7315;24;624881705;7315;275;8231;8285;8.35;0.51;267.63;6.28;916;24;2856.00;54
7319;24;624881716;7319;278;8232;8285;8.25;0.50;267.66;6.29;913;24;2857.00;53
7322;24;624881729;7322;285;8233;8285;8.20;0.50;267.68;6.30;911;24;2858.00;52
7324;24;624881750;7324;287;8236;8286;8.13;0.50;267.71;6.32;912;24;2859.00;50
7326;24;624881764;7326;296;8240;8290;8.10;0.50;267.82;6.33;914;24;2860.00;50
7331;24;624881776;7331;300;8241;8290;8.03;0.49;267.98;6.34;910;24;2861.00;49
7332;24;624881788;7332;305;8244;8293;8.04;0.49;267.98;6.35;912;24;2862.00;49
7335;24;624881800;7335;306;8245;8293;8.10;0.50;268.08;6.35;910;24;2863.00;48
7338;24;624881811;7338;310;8249;8295;8.04;0.49;268.12;6.36;911;24;2864.00;46
7341;24;624881822;7341;308;8250;8295;8.00;0.49;268.16;6.37;909;24;2865.00;45
7344;24;624881832;7344;313;8255;8299;7.96;0.49;268.23;6.37;911;24;2866.00;44
7346;24;624881844;7346;318;8256;8299;7.84;0.48;268.21;6.38;910;24;2867.00;43
7350;24;624881854;7350;321;8257;8299;7.76;0.48;268.25;6.38;907;24;2868.00;42
7354;24;624881864;7354;313;8258;8299;7.64;0.47;268.30;6.39;904;24;2869.00;41
7357;24;624881875;7357;309;8259;8300;7.49;0.46;268.35;6.39;902;24;2870.00;41
7361;24;624881885;7361;312;8261;8301;7.40;0.45;268.50;6.40;900;24;2871.00;40
7363;24;624881903;7363;312;8261;8301;7.29;0.45;268.49;6.40;898;24;2872.00;40
7367;24;624881914;7367;307;8262;8302;7.18;0.44;268.51;6.40;895;24;2873.00;40
7371;24;624881923;7371;310;8265;8302;7.11;0.43;268.54;6.41;894;24;2874.00;37
7373;24;624881934;7373;307;8265;8302;7.07;0.43;268.54;6.41;892;24;2875.00;37
7374;24;624881943;7374;309;8266;8302;7.10;0.43;268.53;6.42;892;24;2876.00;36
7376;24;624881953;7376;309;8266;8302;7.13;0.44;268.52;6.42;890;24;2877.00;36
7380;24;624881963;7380;308;8266;8302;7.12;0.43;268.62;6.42;886;24;2878.00;36
7384;24;624881973;7384;312;8269;8302;7.15;0.44;268.64;6.43;885;24;2879.00;33
7388;24;624881984;7388;357;8369;8532;7.25;0.45;268.63;6.35;981;24;2880.00;163
7391;24;624882011;7391;347;8372;8533;7.21;0.45;268.67;6.35;981;24;2881.00;161
7395;24;624882021;7395;338;8381;8533;7.19;0.45;268.71;6.35;986;24;2882.00;152
7399;24;624882031;7399;341;8387;8533;7.14;0.45;268.67;6.34;988;24;2883.00;146
7403;24;624882042;7403;339;8396;8533;7.09;0.44;268.73;6.34;993;24;2884.00;137
7406;24;624882057;7406;336;8402;8533;6.99;0.44;268.75;6.34;996;24;2885.00;131
7409;24;624882067;7409;340;8410;8533;6.93;0.43;268.78;6.34;1001;24;2886.00;123
7416;24;624882077;7416;340;8418;8533;6.85;0.43;268.92;6.35;1002;24;2887.00;115
7418;24;624882088;7418;354;8425;8534;6.83;0.42;268.97;6.35;1007;24;2888.00;109
7421;24;624882098;7421;360;8433;8535;6.69;0.42;269.02;6.35;1012;24;2889.00;102
7424;24;624882108;7424;354;8437;8535;6.60;0.41;269.10;6.35;1013;24;2890.00;98
7427;24;624882124;7427;363;8442;8536;6.50;0.40;269.12;6.35;1015;24;2891.00;94
7433;24;624882134;7433;361;8447;8536;6.31;0.39;269.27;6.36;1014;24;2892.00;89
7438;24;624882145;7438;367;8450;8536;6.14;0.38;269.29;6.36;1012;24;2893.00;86
7441;24;624882155;7441;372;8453;8536;5.97;0.37;269.41;6.36;1012;24;2894.00;83
7445;24;624882166;7445;384;8459;8540;5.77;0.36;269.50;6.36;1014;24;2895.00;81
7449;24;624882177;7449;391;8461;8540;5.65;0.35;269.57;6.37;1012;24;2896.00;79
7451;24;624882188;7451;393;8465;8540;5.60;0.35;269.63;6.37;1014;24;2897.00;75
7456;24;624882198;7456;389;8468;8543;5.57;0.34;269.72;6.38;1012;24;2898.00;75
7458;24;624882208;7458;398;8470;8543;5.56;0.34;269.76;6.38;1012;24;2899.00;73
7462;24;624882220;7462;400;8474;8543;5.57;0.34;269.79;6.38;1012;24;2900.00;69
7466;24;624882234;7466;394;8478;8547;5.57;0.34;269.89;6.38;1012;24;2901.00;69
7467;24;624882245;7467;397;8480;8548;5.64;0.35;269.93;6.38;1013;24;2902.00;68
7470;24;624882256;7470;389;8481;8548;5.71;0.35;269.93;6.39;1011;24;2903.00;67
7475;24;624882268;7475;392;8485;8552;5.69;0.35;269.95;6.39;1010;24;2904.00;67
7476;24;624882279;7476;393;8490;8552;5.79;0.36;269.98;6.39;1014;24;2905.00;62
7477;24;624882290;7477;399;8492;8552;5.89;0.37;269.99;6.40;1015;24;2906.00;60
7483;24;624882300;7483;400;8492;8553;5.95;0.37;270.05;6.40;1009;24;2907.00;61
7485;24;624882312;7485;400;8492;8553;6.03;0.37;270.07;6.40;1007;24;2908.00;61
7491;24;624882322;7491;406;8497;8559;6.07;0.38;270.12;6.40;1006;24;2909.00;62
7493;24;624882336;7493;410;8498;8559;6.10;0.38;270.15;6.40;1005;24;2910.00;61
7498;24;624882347;7498;413;8499;8560;6.05;0.37;270.18;6.40;1001;24;2911.00;61
7505;24;624882358;7505;418;8499;8560;5.97;0.37;270.30;6.40;994;24;2912.00;61
7507;24;624882370;7507;420;8500;8560;5.95;0.37;270.26;6.40;993;24;2913.00;60
7515;24;624882380;7515;421;8501;8560;5.82;0.36;270.26;6.40;986;24;2914.00;59
7519;24;624882392;7519;423;8501;8560;5.78;0.36;270.27;6.40;982;24;2915.00;59
7522;24;624882402;7522;426;8512;8572;5.80;0.36;270.34;6.40;990;24;2916.00;60
7527;24;624882414;7527;439;8513;8572;5.69;0.35;270.30;6.41;986;24;2917.00;59
7530;24;624882425;7530;442;8513;8572;5.67;0.35;270.28;6.41;983;24;2918.00;59
7532;24;624882436;7532;443;8514;8572;5.65;0.35;270.26;6.41;982;24;2919.00;58
7536;24;624882446;7536;443;8516;8572;5.64;0.35;270.28;6.41;980;24;2920.00;56
7537;24;624882457;7537;448;8517;8572;5.63;0.35;270.28;6.41;980;24;2921.00;55
7542;24;624882467;7542;450;8520;8576;5.60;0.34;270.25;6.41;978;24;2922.00;56
7544;24;624882478;7544;461;8521;8576;5.54;0.34;270.23;6.41;977;24;2923.00;55
7546;24;624882489;7546;461;8524;8580;5.53;0.34;270.23;6.41;978;24;2924.00;56
7549;24;624882499;7549;468;8527;8582;5.53;0.34;270.26;6.41;978;24;2925.00;55
7553;24;624882510;7553;473;8527;8582;5.49;0.34;270.23;6.41;974;24;2926.00;55
7553;24;624882521;7553;478;8527;8582;5.50;0.34;270.23;6.41;974;24;2927.00;55
7558;24;624882531;7558;476;8537;8595;5.54;0.34;270.24;6.40;979;24;2928.00;58
7561;24;624882542;7561;480;8537;8595;5.50;0.34;270.19;6.40;976;24;2929.00;58
7564;24;624882551;7564;483;8537;8595;5.48;0.34;270.16;6.40;973;24;2930.00;58
7566;24;624882562;7566;480;8538;8596;5.47;0.34;270.13;6.40;972;24;2931.00;58
7567;24;624882572;7567;480;8538;8597;5.44;0.34;270.11;6.40;971;24;2932.00;59
7570;24;624882582;7570;480;8538;8597;5.39;0.33;270.10;6.40;968;24;2933.00;59
7574;24;624882592;7574;486;8540;8600;5.39;0.33;270.12;6.40;966;24;2934.00;60
7579;24;624882604;7579;492;8540;8600;5.34;0.33;270.05;6.40;961;24;2935.00;60
7581;24;624882615;7581;496;8541;8600;5.33;0.33;270.00;6.40;960;24;2936.00;59
7585;24;624882624;7585;484;8541;8600;5.32;0.33;269.96;6.40;956;24;2937.00;59
7586;24;624882635;7586;472;8546;8606;5.40;0.33;269.95;6.39;960;24;2938.00;60
7589;24;624882646;7589;471;8546;8606;5.45;0.33;270.00;6.39;957;24;2939.00;60
7593;24;624882659;7593;460;8546;8606;5.47;0.34;269.93;6.39;953;24;2940.00;60
7595;24;624882669;7595;458;8546;8606;5.51;0.34;270.01;6.39;951;24;2941.00;60
7599;24;624882679;7599;451;8549;8610;5.58;0.34;269.96;6.39;950;24;2942.00;61
7603;24;624882690;7603;448;8550;8611;5.59;0.34;269.97;6.39;947;24;2943.00;61
7605;24;624882701;7605;451;8550;8611;5.61;0.34;269.96;6.39;945;24;2944.00;61
7608;24;624882711;7608;455;8551;8612;5.58;0.34;269.93;6.39;943;24;2945.00;61
7611;24;624882722;7611;435;8551;8612;5.62;0.34;269.86;6.39;940;24;2946.00;61
7616;24;624882733;7616;424;8551;8612;5.65;0.34;269.80;6.39;935;24;2947.00;61
7619;24;624882748;7619;409;8551;8612;5.73;0.35;269.75;6.39;932;24;2948.00;61
7620;24;624882765;7620;397;8551;8612;5.83;0.35;269.77;6.39;931;24;2949.00;61
7620;24;624882782;7620;390;8551;8612;5.96;0.36;269.77;6.39;931;24;2950.00;61
7620;24;624882798;7620;380;8551;8612;6.06;0.37;269.77;6.39;931;24;2951.00;61
7621;24;624882815;7621;377;8586;8682;6.36;0.39;269.78;6.37;965;24;2952.00;96
7622;24;624882839;7622;371;8587;8683;6.44;0.39;269.79;6.36;965;24;2953.00;96
7622;24;624882856;7622;361;8594;8683;6.58;0.40;269.79;6.36;972;24;2954.00;89
7625;24;624882868;7625;351;8597;8683;6.61;0.40;269.78;6.36;972;24;2955.00;86
7627;24;624882882;7627;346;8599;8683;6.69;0.41;269.81;6.36;972;24;2956.00;84
7629;24;624882895;7629;334;8601;8683;6.81;0.41;269.78;6.36;972;24;2957.00;82
7629;24;624882909;7629;330;8604;8683;6.93;0.42;269.78;6.36;975;24;2958.00;79
7631;24;624882922;7631;323;8607;8683;6.99;0.42;269.79;6.36;976;24;2959.00;76
7632;24;624882935;7632;313;8610;8684;7.08;0.43;269.81;6.43;978;24;2960.00;74
7634;24;624882950;7634;313;8612;8685;7.14;0.43;269.82;6.43;978;24;2961.00;73
7635;24;624882972;7635;304;8613;8685;7.19;0.43;269.83;6.43;978;24;2962.00;72
7637;24;624882986;7637;302;8617;8689;7.27;0.44;269.84;6.43;980;24;2963.00;72
7639;24;624882999;7639;296;8618;8689;7.36;0.45;269.87;6.43;979;24;2964.00;71
7639;24;624883012;7639;287;8618;8689;7.45;0.45;269.87;6.43;979;24;2965.00;71
7642;24;624883026;7642;293;8618;8689;7.50;0.45;269.86;6.43;976;24;2966.00;71
7643;24;624883039;7643;290;8622;8695;7.59;0.46;269.88;6.43;979;24;2967.00;73
7644;24;624883052;7644;283;8622;8695;7.62;0.46;269.86;6.43;978;24;2968.00;73
7647;24;624883065;7647;286;8622;8695;7.69;0.46;269.85;6.43;975;24;2969.00;73
7647;24;624883080;7647;282;8626;8701;7.76;0.47;269.85;6.42;979;24;2970.00;75
7647;24;624883094;7647;283;8626;8701;7.82;0.47;269.85;6.42;979;24;2971.00;75
7647;24;624883107;7647;276;8628;8701;7.94;0.48;269.85;6.42;981;24;2972.00;73
7647;24;624883119;7647;273;8628;8702;8.09;0.49;269.85;6.42;981;24;2973.00;74
7649;24;624883132;7649;267;8629;8703;8.20;0.50;269.85;6.42;980;24;2974.00;74
7649;24;624883145;7649;258;8629;8703;8.30;0.50;269.85;6.42;980;24;2975.00;74
7652;24;624883159;7652;256;8638;8716;8.40;0.51;269.86;6.42;986;24;2976.00;78
7654;24;624883173;7654;245;8638;8716;8.51;0.51;269.85;6.42;984;24;2977.00;78
7659;24;624883186;7659;241;8638;8716;8.56;0.52;269.95;6.42;979;24;2978.00;78
7659;24;624883199;7659;245;8640;8717;8.65;0.52;269.95;6.49;981;24;2979.00;77
7662;24;624883212;7662;243;8640;8717;8.70;0.52;270.02;6.49;978;24;2980.00;77
7662;24;624883225;7662;238;8643;8721;8.79;0.53;270.02;6.49;981;24;2981.00;78
7665;24;624883238;7665;241;8643;8721;8.81;0.53;270.02;6.49;978;24;2982.00;78
7666;24;624883253;7666;243;8646;8725;8.79;0.53;270.01;6.48;980;24;2983.00;79
7671;24;624883268;7671;242;8646;8725;8.80;0.53;270.07;6.48;975;24;2984.00;79
7672;24;624883282;7672;237;8646;8725;8.79;0.53;270.14;6.48;974;24;2985.00;79
7674;24;624883296;7674;238;8646;8725;8.76;0.53;270.13;6.48;972;24;2986.00;79
7676;24;624883309;7676;237;8646;8725;8.75;0.53;270.20;6.48;970;24;2987.00;79
7678;24;624883324;7678;238;8656;8737;8.72;0.53;270.24;6.48;978;24;2988.00;81
7678;24;624883337;7678;233;8656;8737;8.69;0.53;270.24;6.48;978;24;2989.00;81
7682;24;624883350;7682;232;8657;8737;8.64;0.52;270.23;6.48;975;24;2990.00;80
7682;24;624883370;7682;231;8657;8737;8.63;0.52;270.23;6.48;975;24;2991.00;80
7687;24;624883383;7687;230;8657;8737;8.64;0.52;270.38;6.48;970;24;2992.00;80
7688;24;624883398;7688;233;8657;8737;8.57;0.52;270.37;6.48;969;24;2993.00;80
7693;24;624883411;7693;226;8659;8738;8.53;0.52;270.40;6.48;966;24;2994.00;79
7695;24;624883425;7695;225;8661;8738;8.47;0.51;270.47;6.51;966;24;2995.00;77
7696;24;624883440;7696;227;8665;8744;8.46;0.51;270.54;6.51;969;24;2996.00;79
7700;24;624883452;7700;227;8667;8745;8.37;0.51;270.61;6.52;967;24;2997.00;78
7706;24;624883464;7706;217;8667;8745;8.34;0.51;270.61;6.52;961;24;2998.00;78
7707;24;624883485;7707;218;8667;8745;8.34;0.51;270.65;6.52;960;24;2999.00;78
7710;24;624883500;7710;217;8673;8765;8.31;0.50;270.64;6.51;963;24;3000.00;92
7712;24;624883520;7712;210;8673;8765;8.37;0.51;270.71;6.51;961;24;3001.00;92
7716;24;624883534;7716;212;8673;8765;8.37;0.51;270.69;6.51;957;24;3002.00;92
7720;24;624883550;7720;208;8674;8766;8.40;0.51;270.70;6.51;954;24;3003.00;92
7721;24;624883563;7721;204;8677;8770;8.40;0.51;270.67;6.51;956;24;3004.00;93
7722;24;624883576;7722;206;8677;8770;8.43;0.51;270.67;6.51;955;24;3005.00;93
7726;24;624883590;7726;210;8681;8773;8.40;0.51;270.74;6.51;955;24;3006.00;92
7728;24;624883607;7728;207;8683;8773;8.44;0.51;270.75;6.52;955;24;3007.00;90
7730;24;624883620;7730;208;8685;8773;8.48;0.51;270.73;6.53;955;24;3008.00;88
7735;24;624883633;7735;208;8685;8773;8.48;0.51;270.89;6.53;950;24;3009.00;88
7735;24;624883646;7735;210;8688;8777;8.54;0.52;270.89;6.53;953;24;3010.00;89
7738;24;624883659;7738;210;8690;8777;8.54;0.52;270.92;6.54;952;24;3011.00;87
7742;24;624883672;7742;217;8692;8777;8.48;0.51;270.98;6.54;950;24;3012.00;85
7747;24;624883685;7747;214;8693;8777;8.47;0.51;271.04;6.54;946;24;3013.00;84
7748;24;624883699;7748;220;8695;8778;8.49;0.52;271.03;6.55;947;24;3014.00;83
7752;24;624883712;7752;219;8699;8780;8.48;0.51;271.16;6.55;947;24;3015.00;81
7753;24;624883725;7753;220;8700;8780;8.45;0.51;271.22;6.55;947;24;3016.00;80
7756;24;624883739;7756;222;8701;8781;8.45;0.51;271.26;6.55;945;24;3017.00;80
7762;24;624883755;7762;232;8702;8781;8.36;0.51;271.28;6.55;940;24;3018.00;79
7763;24;624883777;7763;234;8702;8781;8.37;0.51;271.32;6.55;939;24;3019.00;79
7767;24;624883790;7767;236;8704;8781;8.34;0.51;271.35;6.56;937;24;3020.00;77
7773;24;624883802;7773;233;8705;8781;8.32;0.51;271.41;6.58;932;24;3021.00;76
7776;24;624883815;7776;232;8705;8781;8.33;0.51;271.41;6.58;929;24;3022.00;76
7779;24;624883826;7779;237;8706;8781;8.33;0.51;271.43;6.59;927;24;3023.00;75
7782;24;624883839;7782;266;8775;8908;8.25;0.51;271.47;6.55;993;24;3024.00;133
7784;24;624883861;7784;257;8779;8909;8.21;0.50;271.54;6.55;995;24;3025.00;130
7787;24;624883873;7787;257;8788;8909;8.19;0.50;271.58;6.56;1001;24;3026.00;121
7787;24;624883886;7787;257;8792;8909;8.16;0.50;271.58;6.57;1005;24;3027.00;117
7791;24;624883897;7791;257;8799;8909;8.07;0.49;271.72;6.58;1008;24;3028.00;110
7792;24;624883910;7792;266;8801;8909;7.96;0.49;271.75;6.58;1009;24;3029.00;108
7794;24;624883924;7794;274;8805;8909;7.90;0.49;271.84;6.59;1011;24;3030.00;104
7795;24;624883937;7795;272;8809;8909;7.89;0.49;271.83;6.60;1014;24;3031.00;100
7797;24;624883952;7797;280;8812;8910;7.90;0.48;271.88;6.60;1015;24;3032.00;98
7798;24;624883974;7798;282;8817;8911;7.88;0.48;271.87;6.61;1019;24;3033.00;94
7801;24;624883987;7801;287;8819;8911;7.88;0.48;271.91;6.61;1018;24;3034.00;92
7802;24;624884001;7802;294;8821;8912;7.86;0.48;271.95;6.63;1019;24;3035.00;91
7804;24;624884015;7804;297;8827;8912;7.79;0.48;271.98;6.64;1023;24;3036.00;85
7808;24;624884029;7808;303;8832;8912;7.70;0.47;271.96;6.66;1024;24;3037.00;80
7811;24;624884043;7811;305;8835;8912;7.61;0.47;271.97;6.66;1024;24;3038.00;77
7812;24;624884056;7812;313;8842;8916;7.56;0.46;271.96;6.68;1030;24;3039.00;74
7814;24;624884070;7814;314;8842;8916;7.47;0.46;271.95;6.68;1028;24;3040.00;74
7815;24;624884084;7815;317;8842;8916;7.43;0.46;272.01;6.68;1027;24;3041.00;74
7818;24;624884097;7818;320;8847;8919;7.37;0.45;272.05;6.70;1029;24;3042.00;72
7822;24;624884111;7822;320;8849;8919;7.32;0.45;272.05;6.71;1027;24;3043.00;70
7824;24;624884125;7824;317;8851;8919;7.20;0.44;272.02;6.72;1027;24;3044.00;68
7827;24;624884140;7827;319;8854;8923;7.08;0.43;272.09;6.71;1027;24;3045.00;69
7832;24;624884162;7832;325;8858;8924;6.99;0.43;272.19;6.73;1026;24;3046.00;66
7836;24;624884176;7836;329;8859;8924;6.91;0.42;272.20;6.73;1023;24;3047.00;65
7841;24;624884190;7841;330;8862;8928;6.82;0.42;272.28;6.72;1021;24;3048.00;66
7843;24;624884203;7843;337;8864;8928;6.70;0.41;272.28;6.73;1021;24;3049.00;64
7845;24;624884217;7845;343;8864;8928;6.61;0.40;272.28;6.73;1019;24;3050.00;64
7849;24;624884230;7849;345;8866;8929;6.53;0.40;272.33;6.74;1017;24;3051.00;63
7853;24;624884243;7853;347;8866;8929;6.40;0.39;272.31;6.74;1013;24;3052.00;63
7855;24;624884264;7855;344;8875;8935;6.33;0.39;272.36;6.75;1020;24;3053.00;60
7860;24;624884277;7860;347;8875;8935;6.20;0.38;272.39;6.75;1015;24;3054.00;60
7861;24;624884290;7861;346;8878;8936;6.07;0.37;272.40;6.75;1017;24;3055.00;58
7863;24;624884302;7863;346;8878;8936;5.95;0.37;272.40;6.75;1015;24;3056.00;58
7867;24;624884314;7867;354;8878;8936;5.76;0.35;272.48;6.75;1011;24;3057.00;58
7870;24;624884326;7870;360;8880;8936;5.59;0.34;272.47;6.76;1010;24;3058.00;56
7872;24;624884338;7872;368;8880;8936;5.49;0.34;272.55;6.76;1008;24;3059.00;56
7877;24;624884350;7877;371;8908;8972;5.57;0.35;272.61;6.74;1031;24;3060.00;64
7880;24;624884368;7880;371;8909;8972;5.56;0.34;272.62;6.74;1029;24;3061.00;63
7884;24;624884380;7884;373;8911;8972;5.49;0.34;272.68;6.74;1027;24;3062.00;61
7892;24;624884391;7892;380;8912;8972;5.42;0.34;272.79;6.74;1020;24;3063.00;60
7895;24;624884402;7895;381;8914;8972;5.41;0.34;272.81;6.74;1019;24;3064.00;58
7899;24;624884414;7899;395;8914;8972;5.41;0.34;272.85;6.74;1015;24;3065.00;58
7903;24;624884425;7903;403;8919;8976;5.41;0.34;272.96;6.74;1016;24;3066.00;57
7906;24;624884437;7906;399;8919;8976;5.41;0.34;272.98;6.74;1013;24;3067.00;57
7910;24;624884448;7910;401;8924;8980;5.47;0.34;273.02;6.75;1014;24;3068.00;56
7912;24;624884460;7912;400;8925;8981;5.47;0.34;273.09;6.74;1013;24;3069.00;56
7915;24;624884472;7915;406;8925;8981;5.44;0.34;273.08;6.74;1010;24;3070.00;56
7920;24;624884483;7920;396;8925;8981;5.34;0.33;273.19;6.74;1005;24;3071.00;56
7924;24;624884495;7924;403;8936;8994;5.39;0.33;273.19;6.74;1012;24;3072.00;58
7926;24;624884507;7926;403;8936;8994;5.38;0.33;273.25;6.74;1010;24;3073.00;58
7931;24;624884519;7931;409;8936;8994;5.35;0.33;273.20;6.74;1005;24;3074.00;58
7933;24;624884531;7933;414;8937;8995;5.36;0.33;273.20;6.74;1004;24;3075.00;58
7938;24;624884542;7938;414;8937;8996;5.34;0.33;273.16;6.74;999;24;3076.00;59
7943;24;624884553;7943;419;8937;8996;5.33;0.33;273.11;6.74;994;24;3077.00;59
7946;24;624884565;7946;418;8939;8999;5.37;0.33;273.13;6.73;993;24;3078.00;60
7948;24;624884577;7948;422;8940;8999;5.34;0.33;273.13;6.81;992;24;3079.00;59
7952;24;624884591;7952;428;8941;8999;5.33;0.33;273.09;6.81;989;24;3080.00;58
7955;24;624884603;7955;434;8941;8999;5.31;0.33;273.09;6.81;986;24;3081.00;58
7958;24;624884615;7958;440;8946;9005;5.36;0.33;273.11;6.81;988;24;3082.00;59
7961;24;624884627;7961;446;8946;9005;5.36;0.33;273.09;6.81;985;24;3083.00;59
7965;24;624884638;7965;441;8946;9005;5.34;0.33;273.03;6.81;981;24;3084.00;59
7970;24;624884650;7970;447;8946;9005;5.26;0.32;273.10;6.81;976;24;3085.00;59
7973;24;624884662;7973;454;8949;9009;5.23;0.32;273.09;6.81;976;24;3086.00;60
7977;24;624884673;7977;452;8950;9010;5.17;0.32;273.05;6.81;973;24;3087.00;60
7980;24;624884684;7980;454;8950;9010;5.07;0.31;273.06;6.81;970;24;3088.00;60
7986;24;624884695;7986;459;8951;9011;4.91;0.30;273.04;6.80;965;24;3089.00;60
7988;24;624884709;7988;463;8951;9011;4.84;0.30;273.06;6.80;963;24;3090.00;60
7991;24;624884720;7991;469;8951;9011;4.73;0.29;272.99;6.80;960;24;3091.00;60
7996;24;624884731;7996;478;8951;9011;4.68;0.29;273.01;6.80;955;24;3092.00;60
7999;24;624884742;7999;477;8951;9011;4.69;0.29;272.99;6.80;952;24;3093.00;60
8004;24;624884757;8004;478;8951;9011;4.64;0.28;273.03;6.80;947;24;3094.00;60
8005;24;624884775;8005;478;8952;9011;4.63;0.28;273.05;6.88;947;24;3095.00;59
8007;24;624884790;8007;496;8991;9081;4.82;0.30;273.06;6.85;984;24;3096.00;90
8009;24;624884819;8009;495;8992;9082;4.81;0.30;273.07;6.85;983;24;3097.00;90
8011;24;624884838;8011;495;9000;9082;4.87;0.30;273.09;6.85;989;24;3098.00;82
8017;24;624884854;8017;494;9003;9082;4.81;0.30;272.99;6.85;986;24;3099.00;79
8021;24;624884871;8021;483;9006;9082;4.80;0.29;272.96;6.84;985;24;3100.00;76
8023;24;624884889;8023;489;9008;9082;4.77;0.29;272.95;6.92;985;24;3101.00;74
8028;24;624884903;8028;490;9010;9082;4.73;0.29;273.03;6.92;982;24;3102.00;72
8028;24;624884924;8028;489;9012;9082;4.79;0.29;273.03;6.92;984;24;3103.00;70
8032;24;624884938;8032;493;9015;9083;4.77;0.29;273.01;6.92;983;24;3104.00;68
8034;24;624884951;8034;487;9019;9085;4.80;0.29;272.99;6.92;985;24;3105.00;66
8037;24;624884964;8037;487;9022;9085;4.79;0.29;273.01;6.92;985;24;3106.00;63
8039;24;624884978;8039;470;9025;9089;4.79;0.29;272.98;6.92;986;24;3107.00;64
8039;24;624884993;8039;450;9025;9089;4.80;0.29;272.98;6.92;986;24;3108.00;64
8039;24;624885006;8039;435;9025;9089;4.91;0.30;272.98;6.92;986;24;3109.00;64
8042;24;624885020;8042;425;9025;9089;4.97;0.30;273.07;6.92;983;24;3110.00;64
8046;24;624885034;8046;420;9030;9095;5.02;0.31;272.98;6.92;984;24;3111.00;65
8046;24;624885049;8046;417;9030;9095;5.15;0.32;272.98;6.92;984;24;3112.00;65
8047;24;624885064;8047;418;9030;9095;5.24;0.32;273.00;6.92;983;24;3113.00;65
8050;24;624885089;8050;413;9033;9098;5.34;0.33;272.97;6.99;983;24;3114.00;65
8050;24;624885103;8050;409;9034;9098;5.42;0.33;272.97;6.99;984;24;3115.00;64
8052;24;624885117;8052;396;9034;9098;5.44;0.33;272.93;6.99;982;24;3116.00;64
8052;24;624885132;8052;386;9034;9099;5.51;0.34;272.93;6.99;982;24;3117.00;65
8054;24;624885146;8054;370;9035;9100;5.61;0.34;273.02;6.99;981;24;3118.00;65
8057;24;624885161;8057;358;9035;9100;5.72;0.35;272.99;6.99;978;24;3119.00;65
8059;24;624885177;8059;358;9057;9126;6.00;0.37;272.95;7.04;998;24;3120.00;69
8062;24;624885203;8062;345;9057;9126;6.11;0.37;272.90;7.04;995;24;3121.00;69
8063;24;624885219;8063;334;9058;9126;6.26;0.38;272.87;7.04;995;24;3122.00;68
8063;24;624885235;8063;326;9059;9127;6.40;0.39;272.87;7.04;996;24;3123.00;68
8064;24;624885251;8064;322;9059;9127;6.48;0.39;272.84;7.04;995;24;3124.00;68
8066;24;624885267;8066;312;9063;9131;6.59;0.40;272.84;7.04;997;24;3125.00;68
8067;24;624885285;8067;299;9064;9131;6.65;0.40;272.86;7.10;997;24;3126.00;67
8068;24;624885304;8068;286;9067;9135;6.72;0.41;272.88;7.10;999;24;3127.00;68
8071;24;624885321;8071;280;9067;9135;6.74;0.41;272.92;7.10;996;24;3128.00;68
8073;24;624885342;8073;277;9067;9135;6.84;0.42;272.90;7.10;994;24;3129.00;68
8078;24;624885359;8078;277;9067;9135;6.98;0.42;272.95;7.10;989;24;3130.00;68
8080;24;624885374;8080;271;9068;9135;7.08;0.43;273.01;7.17;988;24;3131.00;67
8085;24;624885390;8085;252;9077;9147;7.20;0.44;273.04;7.16;992;24;3132.00;70
8089;24;624885408;8089;252;9077;9147;7.37;0.45;273.11;7.16;988;24;3133.00;70
8090;24;624885423;8090;242;9079;9147;7.54;0.46;273.12;7.16;989;24;3134.00;68
8092;24;624885440;8092;232;9079;9147;7.68;0.47;273.20;7.16;987;24;3135.00;68
8094;24;624885456;8094;230;9079;9147;7.79;0.47;273.20;7.16;985;24;3136.00;68
8095;24;624885473;8095;220;9079;9147;7.93;0.48;273.25;7.16;984;24;3137.00;68
8095;24;624885489;8095;216;9079;9148;8.04;0.49;273.25;7.16;984;24;3138.00;69
8096;24;624885506;8096;217;9079;9148;8.14;0.49;273.26;7.16;983;24;3139.00;69
8100;24;624885523;8100;212;9085;9154;8.17;0.50;273.37;7.23;985;24;3140.00;69
8104;24;624885540;8104;212;9086;9155;8.25;0.50;273.39;7.22;982;24;3141.00;69
8106;24;624885564;8106;210;9086;9155;8.32;0.50;273.39;7.22;980;24;3142.00;69
8112;24;624885580;8112;211;9086;9155;8.38;0.51;273.46;7.22;974;24;3143.00;69
8114;24;624885598;8114;213;9089;9159;8.48;0.51;273.52;7.22;975;24;3144.00;70
8116;24;624885623;8116;209;9089;9159;8.51;0.52;273.55;7.22;973;24;3145.00;70
8117;24;624885639;8117;209;9090;9159;8.50;0.51;273.55;7.29;973;24;3146.00;69
8118;24;624885656;8118;203;9091;9160;8.53;0.52;273.62;7.29;973;24;3147.00;69
8119;24;624885672;8119;197;9094;9164;8.54;0.52;273.61;7.29;975;24;3148.00;70
8123;24;624885689;8123;191;9094;9164;8.54;0.52;273.67;7.29;971;24;3149.00;70
8125;24;624885708;8125;184;9098;9170;8.63;0.52;273.73;7.28;973;24;3150.00;72
8125;24;624885725;8125;187;9098;9170;8.74;0.53;273.73;7.28;973;24;3151.00;72
8125;24;624885742;8125;186;9100;9170;8.82;0.53;273.73;7.28;975;24;3152.00;70
8127;24;624885758;8127;186;9101;9170;8.82;0.53;273.79;7.35;974;24;3153.00;69
8129;24;624885775;8129;188;9105;9174;8.87;0.54;273.85;7.35;976;24;3154.00;69
8130;24;624885792;8130;187;9105;9174;8.90;0.54;273.92;7.35;975;24;3155.00;69
8132;24;624885807;8132;188;9105;9174;8.92;0.54;273.98;7.35;973;24;3156.00;69
8134;24;624885821;8134;192;9105;9174;8.91;0.54;273.97;7.35;971;24;3157.00;69
8137;24;624885836;8137;194;9106;9175;8.87;0.54;274.08;7.42;969;24;3158.00;69
8139;24;624885850;8139;185;9107;9176;8.83;0.54;274.19;7.42;968;24;3159.00;69
8144;24;624885865;8144;185;9107;9176;8.72;0.53;274.22;7.42;963;24;3160.00;69
8146;24;624885879;8146;185;9108;9177;8.67;0.53;274.23;7.42;962;24;3161.00;69
8148;24;624885896;8148;178;9108;9177;8.53;0.52;274.29;7.42;960;24;3162.00;69
8154;24;624885910;8154;177;9108;9177;8.46;0.51;274.36;7.42;954;24;3163.00;69
8155;24;624885923;8155;175;9109;9177;8.43;0.51;274.34;7.43;954;24;3164.00;68
8160;24;624885938;8160;182;9109;9177;8.45;0.51;274.40;7.43;949;24;3165.00;68
8163;25;624885952;8163;185;9110;9177;8.46;0.51;274.43;7.44;947;25;3166.00;67
8165;25;624885974;8165;180;9111;9177;8.46;0.51;274.41;7.51;946;25;3167.00;66
8169;25;624885988;8169;200;9177;9304;8.39;0.52;274.47;7.46;1008;25;3168.00;127
8171;25;624886013;8171;193;9180;9305;8.41;0.52;274.45;7.46;1009;25;3169.00;125
8177;25;624886027;8177;196;9186;9305;8.44;0.52;274.59;7.45;1009;25;3170.00;119
8181;25;624886042;8181;197;9189;9305;8.45;0.52;274.64;7.45;1008;25;3171.00;116
8185;25;624886057;8185;197;9197;9305;8.50;0.52;274.68;7.52;1012;25;3172.00;108
8187;25;624886071;8187;199;9199;9305;8.54;0.52;274.73;7.52;1012;25;3173.00;106
8192;25;624886085;8192;200;9202;9305;8.54;0.52;274.79;7.52;1010;25;3174.00;103
8196;25;624886100;8196;205;9204;9305;8.52;0.52;274.83;7.52;1008;25;3175.00;101
8197;25;624886121;8197;211;9206;9306;8.60;0.52;274.84;7.52;1009;25;3176.00;100
8201;25;624886143;8201;216;9211;9307;8.56;0.52;274.91;7.52;1010;25;3177.00;96
8203;25;624886164;8203;214;9215;9307;8.54;0.52;274.95;7.52;1012;25;3178.00;92
8206;25;624886183;8206;218;9216;9308;8.54;0.52;274.99;7.52;1010;25;3179.00;92
8209;25;624886202;8209;225;9221;9308;8.42;0.51;275.07;7.52;1012;25;3180.00;87
8214;25;624886218;8214;223;9222;9308;8.34;0.51;275.15;7.52;1008;25;3181.00;86
8217;25;624886237;8217;222;9223;9308;8.35;0.51;275.21;7.52;1006;25;3182.00;85
8220;25;624886257;8220;223;9228;9312;8.28;0.51;275.24;7.52;1008;25;3183.00;84
8224;25;624886280;8224;226;9229;9312;8.21;0.50;275.30;7.52;1005;25;3184.00;83
8226;25;624886295;8226;232;9231;9312;8.20;0.50;275.32;7.52;1005;25;3185.00;81
8229;25;624886311;8229;236;9234;9315;8.17;0.50;275.29;7.53;1005;25;3186.00;81
8230;25;624886326;8230;239;9236;9315;8.22;0.50;275.32;7.55;1006;25;3187.00;79
8233;25;624886341;8233;249;9237;9315;8.22;0.50;275.43;7.55;1004;25;3188.00;78
8235;25;624886356;8235;250;9242;9319;8.15;0.50;275.48;7.56;1007;25;3189.00;77
8239;25;624886371;8239;256;9244;9320;8.15;0.50;275.55;7.57;1005;25;3190.00;76
8244;25;624886386;8244;267;9248;9322;8.09;0.49;275.62;7.58;1004;25;3191.00;74
8250;25;624886410;8250;268;9253;9326;8.15;0.50;275.71;7.58;1003;25;3192.00;73
8251;25;624886426;8251;276;9254;9326;8.12;0.49;275.72;7.59;1003;25;3193.00;72
8255;25;624886440;8255;278;9254;9326;8.11;0.49;275.77;7.59;999;25;3194.00;72
8258;25;624886454;8258;283;9259;9328;8.07;0.49;275.75;7.61;1001;25;3195.00;69
8261;25;624886470;8261;291;9259;9328;8.08;0.49;275.79;7.61;998;25;3196.00;69
8262;25;624886488;8262;299;9266;9334;8.06;0.49;275.78;7.62;1004;25;3197.00;68
8264;25;624886505;8264;296;9266;9334;7.93;0.48;275.89;7.62;1002;25;3198.00;68
8267;25;624886519;8267;302;9267;9335;7.85;0.48;275.92;7.64;1000;25;3199.00;68
8269;25;624886536;8269;305;9268;9335;7.69;0.47;275.96;7.63;999;25;3200.00;67
8269;25;624886560;8269;304;9268;9335;7.57;0.46;275.96;7.63;999;25;3201.00;67
8269;25;624886577;8269;310;9268;9335;7.49;0.46;275.96;7.63;999;25;3202.00;67
8271;25;624886593;8271;314;9270;9335;7.46;0.46;276.00;7.66;999;25;3203.00;65
8273;25;624886608;8273;319;9280;9347;7.44;0.46;275.98;7.65;1007;25;3204.00;67
8277;25;624886623;8277;324;9281;9347;7.29;0.45;276.12;7.66;1004;25;3205.00;66
8280;25;624886636;8280;327;9282;9347;7.15;0.44;276.19;7.66;1002;25;3206.00;65
8283;25;624886650;8283;332;9283;9347;7.04;0.43;276.19;7.67;1000;25;3207.00;64
8286;25;624886664;8286;333;9283;9347;6.96;0.43;276.23;7.67;997;25;3208.00;64
8292;25;624886676;8292;333;9283;9347;6.88;0.42;276.28;7.67;991;25;3209.00;64
8293;25;624886691;8293;328;9289;9351;6.83;0.42;276.28;7.70;996;25;3210.00;62
8297;25;624886705;8297;329;9289;9351;6.77;0.42;276.39;7.70;992;25;3211.00;62
8299;25;624886718;8299;333;9293;9355;6.85;0.42;276.42;7.70;994;25;3212.00;62
8303;25;624886732;8303;336;9295;9356;6.86;0.42;276.48;7.71;992;25;3213.00;61
8307;25;624886747;8307;340;9298;9356;6.88;0.42;276.56;7.73;991;25;3214.00;58
8312;25;624886766;8312;341;9298;9356;6.84;0.42;276.51;7.73;986;25;3215.00;58
8316;25;624886785;8316;344;9310;9369;6.81;0.42;276.60;7.73;994;25;3216.00;59
8319;25;624886806;8319;350;9310;9369;6.74;0.41;276.68;7.73;991;25;3217.00;59
8320;25;624886836;8320;358;9313;9369;6.70;0.41;276.66;7.75;993;25;3218.00;56
8325;25;624886854;8325;363;9314;9370;6.61;0.40;276.73;7.75;989;25;3219.00;56
8328;25;624886871;8328;369;9315;9371;6.54;0.40;276.70;7.76;987;25;3220.00;56
8329;25;624886886;8329;374;9315;9371;6.41;0.39;276.73;7.76;986;25;3221.00;56
8332;25;624886900;8332;380;9318;9374;6.19;0.38;276.76;7.75;986;25;3222.00;56
8335;25;624886914;8335;377;9321;9374;6.04;0.37;276.78;7.77;986;25;3223.00;53
8337;25;624886929;8337;380;9321;9374;5.95;0.36;276.77;7.77;984;25;3224.00;53
8341;25;624886943;8341;388;9321;9374;5.81;0.36;276.81;7.77;980;25;3225.00;53
8347;25;624886956;8347;381;9328;9380;5.70;0.35;276.77;7.77;981;25;3226.00;52
8351;25;624886970;8351;385;9328;9380;5.54;0.34;276.72;7.77;977;25;3227.00;52
8355;25;624886983;8355;397;9329;9380;5.31;0.33;276.77;7.77;974;25;3228.00;51
8359;25;624886996;8359;401;9329;9380;5.17;0.32;276.74;7.77;970;25;3229.00;51
8363;25;624887011;8363;403;9332;9384;5.04;0.31;276.75;7.77;969;25;3230.00;52
8368;25;624887026;8368;400;9336;9385;4.91;0.30;276.72;7.78;968;25;3231.00;49
8371;25;624887039;8371;409;9336;9385;4.79;0.29;276.72;7.78;965;25;3232.00;49
8375;25;624887052;8375;410;9337;9386;4.70;0.29;276.74;7.78;962;25;3233.00;49
8380;25;624887066;8380;409;9338;9386;4.65;0.29;276.72;7.79;958;25;3234.00;48
8385;25;624887079;8385;412;9338;9386;4.60;0.28;276.68;7.79;953;25;3235.00;48
8389;25;624887093;8389;419;9338;9386;4.56;0.28;276.65;7.79;949;25;3236.00;48
8391;25;624887110;8391;419;9341;9386;4.58;0.28;276.63;7.79;950;25;3237.00;45
8393;25;624887125;8393;422;9341;9386;4.62;0.28;276.68;7.79;948;25;3238.00;45
8395;25;624887139;8395;419;9342;9386;4.64;0.29;276.68;7.79;947;25;3239.00;44
8397;25;624887154;8397;425;9401;9511;5.07;0.32;276.68;7.75;1004;25;3240.00;110
8402;25;624887175;8402;425;9406;9512;5.11;0.32;276.64;7.74;1004;25;3241.00;106
8407;25;624887187;8407;420;9417;9512;5.20;0.32;276.74;7.73;1010;25;3242.00;95
8407;25;624887198;8407;425;9421;9512;5.26;0.33;276.74;7.73;1014;25;3243.00;91
8410;25;624887209;8410;430;9426;9512;5.27;0.33;276.75;7.73;1016;25;3244.00;86
8413;25;624887220;8413;438;9427;9512;5.21;0.32;276.70;7.73;1014;25;3245.00;85
8414;25;624887231;8414;438;9432;9512;5.27;0.33;276.68;7.73;1018;25;3246.00;80
8417;25;624887251;8417;438;9437;9512;5.21;0.32;276.67;7.73;1020;25;3247.00;75
8421;25;624887262;8421;447;9440;9513;5.17;0.32;276.70;7.73;1019;25;3248.00;73
8422;25;624887274;8422;453;9445;9514;5.17;0.32;276.71;7.73;1023;25;3249.00;69
8428;25;624887286;8428;463;9447;9514;5.08;0.31;276.73;7.73;1019;25;3250.00;67
8431;25;624887297;8431;468;9452;9518;5.07;0.31;276.71;7.73;1021;25;3251.00;66
8437;25;624887309;8437;475;9453;9518;4.98;0.31;276.70;7.80;1016;25;3252.00;65
8439;25;624887322;8439;477;9453;9518;4.94;0.31;276.68;7.80;1014;25;3253.00;65
8442;25;624887333;8442;478;9453;9518;4.89;0.30;276.65;7.80;1011;25;3254.00;65
8444;25;624887345;8444;476;9457;9524;4.85;0.30;276.68;7.80;1013;25;3255.00;67
8448;25;624887356;8448;482;9457;9524;4.78;0.29;276.66;7.80;1009;25;3256.00;67
8450;25;624887368;8450;488;9457;9524;4.75;0.29;276.68;7.80;1007;25;3257.00;67
8455;25;624887379;8455;484;9458;9527;4.69;0.29;276.67;7.80;1003;25;3258.00;69
8457;25;624887390;8457;473;9459;9527;4.67;0.29;276.65;7.80;1002;25;3259.00;68
8460;25;624887404;8460;470;9459;9527;4.59;0.28;276.65;7.80;999;25;3260.00;68
8461;25;624887417;8461;468;9459;9528;4.58;0.28;276.65;7.80;998;25;3261.00;69
8462;25;624887428;8462;463;9461;9529;4.67;0.29;276.66;7.80;999;25;3262.00;68
8466;25;624887440;8466;468;9461;9529;4.68;0.29;276.58;7.80;995;25;3263.00;68
8469;25;624887451;8469;473;9471;9542;4.86;0.30;276.53;7.79;1002;25;3264.00;71
8475;25;624887466;8475;470;9472;9542;4.93;0.30;276.50;7.79;997;25;3265.00;70
8478;25;624887486;8478;468;9472;9542;5.02;0.31;276.53;7.79;994;25;3266.00;70
8482;25;624887500;8482;475;9474;9543;5.03;0.31;276.52;7.79;992;25;3267.00;69
8483;25;624887515;8483;473;9474;9543;5.09;0.31;276.49;7.79;991;25;3268.00;69
8483;25;624887542;8483;470;9478;9547;5.18;0.32;276.49;7.79;995;25;3269.00;69
8484;25;624887567;8484;472;9478;9547;5.21;0.32;276.50;7.79;994;25;3270.00;69
8485;25;624887581;8485;471;9481;9551;5.22;0.32;276.51;7.78;996;25;3271.00;70
8486;25;624887597;8486;476;9481;9551;5.21;0.32;276.50;7.78;995;25;3272.00;70
8487;25;624887618;8487;474;9481;9551;5.22;0.32;276.47;7.78;994;25;3273.00;70
8489;25;624887640;8489;473;9481;9551;5.25;0.32;276.46;7.78;992;25;3274.00;70
8491;25;624887655;8491;470;9481;9551;5.30;0.32;276.43;7.78;990;25;3275.00;70
8491;25;624887669;8491;468;9490;9563;5.44;0.33;276.43;7.78;999;25;3276.00;73
8491;25;624887684;8491;447;9490;9563;5.53;0.34;276.43;7.78;999;25;3277.00;73
8492;25;624887699;8492;446;9492;9563;5.62;0.34;276.43;7.78;1000;25;3278.00;71
8494;25;624887713;8494;434;9492;9563;5.69;0.35;276.42;7.78;998;25;3279.00;71
8495;25;624887727;8495;423;9492;9563;5.76;0.35;276.43;7.78;997;25;3280.00;71
8498;25;624887742;8498;414;9492;9563;5.84;0.36;276.43;7.78;994;25;3281.00;71
8499;25;624887758;8499;409;9492;9564;5.97;0.36;276.44;7.78;993;25;3282.00;72
8502;25;624887773;8502;402;9492;9564;6.04;0.37;276.48;7.78;990;25;3283.00;72
8502;25;624887786;8502;402;9497;9570;6.21;0.38;276.48;7.77;995;25;3284.00;73
8505;25;624887799;8505;400;9499;9572;6.32;0.38;276.51;7.77;994;25;3285.00;73
8510;25;624887815;8510;388;9499;9572;6.43;0.39;276.56;7.77;989;25;3286.00;73
8513;25;624887828;8513;372;9499;9572;6.56;0.40;276.62;7.77;986;25;3287.00;73
8515;25;624887840;8515;356;9502;9576;6.78;0.41;276.64;7.77;987;25;3288.00;74
8517;25;624887853;8517;340;9502;9576;6.95;0.42;276.61;7.77;985;25;3289.00;74
8519;25;624887867;8519;326;9502;9576;7.15;0.43;276.66;7.77;983;25;3290.00;74
8520;25;624887880;8520;318;9504;9577;7.37;0.45;276.68;7.85;984;25;3291.00;73
8524;25;624887892;8524;301;9507;9581;7.56;0.46;276.74;7.85;983;25;3292.00;74
8529;25;624887906;8529;292;9507;9581;7.70;0.47;276.83;7.85;978;25;3293.00;74
8529;25;624887919;8529;283;9509;9584;7.84;0.47;276.83;7.84;980;25;3294.00;75
8533;25;624887933;8533;279;9509;9584;7.92;0.48;276.87;7.84;976;25;3295.00;75
8534;25;624887947;8534;276;9510;9584;8.01;0.48;276.93;7.84;976;25;3296.00;74
8536;25;624887961;8536;264;9510;9584;8.10;0.49;276.91;7.84;974;25;3297.00;74
8538;25;624887975;8538;258;9514;9588;8.19;0.50;276.95;7.84;976;25;3298.00;74
8540;25;624887990;8540;245;9514;9588;8.25;0.50;276.98;7.84;974;25;3299.00;74
8542;25;624888009;8542;245;9519;9607;8.20;0.50;276.95;7.84;977;25;3300.00;88
8544;25;624888030;8544;241;9519;9607;8.25;0.50;277.03;7.84;975;25;3301.00;88
8548;25;624888044;8548;236;9519;9608;8.31;0.50;277.03;7.84;971;25;3302.00;89
8550;25;624888059;8550;236;9520;9609;8.37;0.51;276.99;7.84;970;25;3303.00;89
8553;25;624888074;8553;239;9520;9609;8.48;0.51;277.04;7.84;967;25;3304.00;89
8554;25;624888087;8554;241;9523;9610;8.52;0.52;277.03;7.83;969;25;3305.00;87
8556;25;624888102;8556;238;9523;9610;8.55;0.52;277.11;7.83;967;25;3306.00;87
8559;25;624888116;8559;242;9524;9610;8.55;0.52;277.18;7.92;965;25;3307.00;86
8561;25;624888130;8561;237;9524;9610;8.64;0.52;277.18;7.92;963;25;3308.00;86
8567;25;624888145;8567;232;9524;9610;8.70;0.53;277.20;7.92;957;25;3309.00;86
8569;25;624888159;8569;227;9524;9610;8.73;0.53;277.19;7.92;955;25;3310.00;86
8573;25;624888173;8573;227;9525;9610;8.74;0.53;277.24;7.92;952;25;3311.00;85
8576;25;624888186;8576;248;9596;9737;8.67;0.53;277.30;7.86;1020;25;3312.00;141
8579;25;624888210;8579;238;9596;9738;8.69;0.53;277.37;7.86;1017;25;3313.00;142
8581;25;624888225;8581;229;9600;9738;8.77;0.54;277.40;7.86;1019;25;3314.00;138
8582;25;624888239;8582;235;9602;9738;8.88;0.54;277.46;7.86;1020;25;3315.00;136
8585;25;624888254;8585;230;9606;9738;8.90;0.54;277.54;7.94;1021;25;3316.00;132
8588;25;624888268;8588;224;9608;9738;8.96;0.55;277.61;7.94;1020;25;3317.00;130
8590;25;624888283;8590;222;9612;9738;8.99;0.55;277.68;7.94;1022;25;3318.00;126
8593;25;624888298;8593;220;9614;9738;9.02;0.55;277.74;7.94;1021;25;3319.00;124
8594;25;624888312;8594;221;9617;9739;9.10;0.55;277.72;7.94;1023;25;3320.00;122
8597;25;624888327;8597;225;9618;9740;9.05;0.55;277.78;7.94;1021;25;3321.00;122
8598;25;624888341;8598;221;9620;9740;9.06;0.55;277.79;7.94;1022;25;3322.00;120
8600;25;624888356;8600;229;9623;9741;9.06;0.55;277.87;7.94;1023;25;3323.00;118
8604;25;624888371;8604;234;9625;9741;8.94;0.54;277.88;7.94;1021;25;3324.00;116
8606;25;624888392;8606;231;9628;9741;8.91;0.54;277.89;7.94;1022;25;3325.00;113
8610;25;624888410;8610;232;9630;9741;8.88;0.54;277.96;7.94;1020;25;3326.00;111
8613;25;624888428;8613;235;9632;9745;8.82;0.54;278.06;7.95;1019;25;3327.00;113
8615;25;624888445;8615;235;9634;9745;8.83;0.54;278.08;7.95;1019;25;3328.00;111
8617;25;624888461;8617;248;9637;9745;8.79;0.54;278.17;7.95;1020;25;3329.00;108
8619;25;624888484;8619;243;9640;9751;8.68;0.53;278.21;7.95;1021;25;3330.00;111
8621;25;624888505;8621;248;9643;9751;8.58;0.52;278.24;7.95;1022;25;3331.00;108
8625;25;624888519;8625;241;9645;9751;8.45;0.51;278.31;8.04;1020;25;3332.00;106
8626;25;624888533;8626;248;9651;9755;8.42;0.51;278.31;8.04;1025;25;3333.00;104
8629;25;624888547;8629;242;9652;9756;8.38;0.51;278.32;8.04;1023;25;3334.00;104
8635;25;624888561;8635;240;9659;9756;8.32;0.51;278.43;8.06;1024;25;3335.00;97
8638;25;624888576;8638;243;9661;9760;8.29;0.50;278.39;8.06;1023;25;3336.00;99
8643;25;624888590;8643;237;9663;9760;8.22;0.50;278.48;8.06;1020;25;3337.00;97
8648;25;624888610;8648;231;9665;9760;8.18;0.50;278.59;8.14;1017;25;3338.00;95
8651;25;624888625;8651;229;9666;9761;8.20;0.50;278.58;8.14;1015;25;3339.00;95
8655;25;624888643;8655;228;9666;9761;8.29;0.50;278.63;8.14;1011;25;3340.00;95
8660;25;624888659;8660;232;9672;9767;8.35;0.51;278.62;8.14;1012;25;3341.00;95
8662;25;624888673;8662;229;9672;9767;8.35;0.51;278.64;8.14;1010;25;3342.00;95
8665;25;624888687;8665;232;9674;9768;8.36;0.51;278.69;8.15;1009;25;3343.00;94
8668;25;624888701;8668;232;9674;9768;8.31;0.51;278.66;8.15;1006;25;3344.00;94
8673;25;624888720;8673;237;9674;9768;8.31;0.51;278.68;8.15;1001;25;3345.00;94
8676;25;624888733;8676;236;9676;9768;8.27;0.50;278.71;8.15;1000;25;3346.00;92
8679;25;624888747;8679;241;9676;9768;8.24;0.50;278.68;8.15;997;25;3347.00;92
8682;25;624888768;8682;245;9687;9780;8.22;0.50;278.64;8.14;1005;25;3348.00;93
8688;25;624888787;8688;248;9688;9780;8.09;0.49;278.69;8.14;1000;25;3349.00;92
8690;25;624888813;8690;257;9690;9780;7.96;0.48;278.69;8.15;1000;25;3350.00;90
8692;25;624888834;8692;261;9691;9780;7.82;0.47;278.66;8.15;999;25;3351.00;89
8693;25;624888854;8693;269;9691;9780;7.70;0.47;278.71;8.15;998;25;3352.00;89
8694;25;624888872;8694;269;9693;9780;7.66;0.47;278.71;8.15;999;25;3353.00;87
8696;25;624888887;8696;273;9696;9784;7.60;0.46;278.71;8.15;1000;25;3354.00;88
8697;25;624888903;8697;273;9696;9784;7.59;0.46;278.73;8.15;999;25;3355.00;88
8699;25;624888917;8699;276;9700;9788;7.63;0.46;278.83;8.15;1001;25;3356.00;88
8702;25;624888933;8702;278;9701;9789;7.68;0.47;278.81;8.15;999;25;3357.00;88
8705;25;624888949;8705;280;9701;9789;7.70;0.47;278.78;8.15;996;25;3358.00;88
8711;25;624888963;8711;287;9701;9789;7.69;0.47;278.87;8.15;990;25;3359.00;88
8711;25;624888981;8711;298;9721;9818;7.70;0.47;278.87;8.13;1010;25;3360.00;97
8712;25;624888998;8712;300;9723;9818;7.69;0.47;278.86;8.15;1011;25;3361.00;95
8715;25;624889013;8715;306;9725;9818;7.61;0.46;278.91;8.15;1010;25;3362.00;93
8717;25;624889027;8717;308;9730;9819;7.56;0.46;278.93;8.17;1013;25;3363.00;89
8718;25;624889042;8718;312;9731;9820;7.52;0.46;278.99;8.17;1013;25;3364.00;89
8722;25;624889057;8722;312;9731;9820;7.45;0.45;278.96;8.17;1009;25;3365.00;89
8724;25;624889074;8724;323;9735;9823;7.45;0.45;278.98;8.20;1011;25;3366.00;88
8727;25;624889089;8727;334;9736;9823;7.37;0.45;279.10;8.21;1009;25;3367.00;87
8729;25;624889104;8729;347;9737;9823;7.37;0.45;279.14;8.21;1008;25;3368.00;86
8730;25;624889121;8730;347;9740;9823;7.33;0.45;279.13;8.24;1010;25;3369.00;83
8732;25;624889136;8732;351;9745;9829;7.34;0.45;279.12;8.24;1013;25;3370.00;84
8733;25;624889151;8733;357;9745;9829;7.25;0.45;279.16;8.24;1012;25;3371.00;84
8736;25;624889167;8736;363;9747;9829;7.13;0.44;279.17;8.26;1011;25;3372.00;82
8739;25;624889180;8739;376;9748;9829;7.01;0.43;279.16;8.27;1009;25;3373.00;81
8741;25;624889195;8741;383;9751;9833;6.87;0.42;279.17;8.27;1010;25;3374.00;82
8743;25;624889208;8743;384;9755;9835;6.76;0.42;279.14;8.29;1012;25;3375.00;80
8745;25;624889226;8745;394;9756;9835;6.70;0.41;279.21;8.29;1011;25;3376.00;79
8748;25;624889242;8748;399;9759;9836;6.64;0.41;279.26;8.31;1011;25;3377.00;77
8751;25;624889259;8751;406;9759;9836;6.53;0.40;279.26;8.31;1008;25;3378.00;77
8753;25;624889275;8753;408;9761;9836;6.48;0.40;279.23;8.33;1008;25;3379.00;75
8755;25;624889292;8755;406;9761;9836;6.43;0.40;279.24;8.33;1006;25;3380.00;75
8756;25;624889309;8756;401;9761;9836;6.37;0.39;279.21;8.33;1005;25;3381.00;75
8757;25;624889327;8757;407;9761;9836;6.33;0.39;279.19;8.33;1004;25;3382.00;75
8762;25;624889342;8762;400;9764;9836;6.28;0.39;279.10;8.35;1002;25;3383.00;72
8763;25;624889358;8763;402;9800;9906;6.44;0.40;279.09;8.32;1037;25;3384.00;106
8765;25;624889381;8765;405;9804;9907;6.33;0.39;279.05;8.32;1039;25;3385.00;103
8768;25;624889398;8768;405;9812;9907;6.34;0.39;279.01;8.32;1044;25;3386.00;95
8771;25;624889414;8771;409;9817;9907;6.32;0.39;279.09;8.31;1046;25;3387.00;90
8774;25;624889428;8774;409;9823;9907;6.28;0.39;279.17;8.33;1049;25;3388.00;84
8777;25;624889444;8777;415;9826;9907;6.23;0.38;279.14;8.34;1049;25;3389.00;81
8781;25;624889461;8781;416;9831;9907;6.16;0.38;279.07;8.35;1050;25;3390.00;76
8786;25;624889476;8786;421;9833;9907;6.01;0.37;279.04;8.35;1047;25;3391.00;74
8790;25;624889497;8790;429;9836;9908;5.93;0.36;279.07;8.36;1046;25;3392.00;72
8793;25;624889511;8793;433;9838;9909;5.81;0.36;279.05;8.36;1045;25;3393.00;71
8801;25;624889525;8801;441;9840;9909;5.70;0.35;279.03;8.37;1039;25;3394.00;69
8804;25;624889539;8804;452;9845;9913;5.60;0.34;278.99;8.37;1041;25;3395.00;68
8809;25;624889553;8809;461;9845;9913;5.46;0.33;278.92;8.37;1036;25;3396.00;68
8811;25;624889567;8811;461;9846;9913;5.34;0.33;278.96;8.37;1035;25;3397.00;67
8814;25;624889580;8814;471;9847;9913;5.19;0.32;278.96;8.38;1033;25;3398.00;66
8817;25;624889594;8817;479;9852;9919;5.09;0.31;278.96;8.38;1035;25;3399.00;67
8820;25;624889611;8820;475;9853;9919;4.96;0.30;278.95;8.38;1033;25;3400.00;66
8824;25;624889631;8824;477;9854;9919;4.84;0.30;278.95;8.38;1030;25;3401.00;65
8826;25;624889645;8826;479;9856;9922;4.75;0.29;278.94;8.38;1030;25;3402.00;66
8828;25;624889660;8828;486;9857;9922;4.65;0.29;278.96;8.38;1029;25;3403.00;65
8831;25;624889674;8831;483;9857;9922;4.55;0.28;278.94;8.38;1026;25;3404.00;65
8832;25;624889688;8832;475;9857;9923;4.50;0.28;278.93;8.38;1025;25;3405.00;66
8836;25;624889703;8836;478;9859;9924;4.45;0.27;278.92;8.39;1023;25;3406.00;65
8839;25;624889718;8839;476;9859;9924;4.43;0.27;278.93;8.39;1020;25;3407.00;65
8841;25;624889731;8841;473;9870;9937;4.52;0.28;278.93;8.38;1029;25;3408.00;67
8843;25;624889746;8843;471;9870;9937;4.54;0.28;278.93;8.38;1027;25;3409.00;67
8845;25;624889759;8845;468;9870;9937;4.57;0.28;278.87;8.38;1025;25;3410.00;67
8850;25;624889771;8850;456;9871;9938;4.58;0.28;278.87;8.38;1021;25;3411.00;67
8853;25;624889785;8853;439;9871;9938;4.67;0.28;278.85;8.38;1018;25;3412.00;67
8854;25;624889798;8854;438;9874;9942;4.81;0.29;278.87;8.38;1020;25;3413.00;68
8856;25;624889810;8856;436;9875;9942;4.96;0.30;278.84;8.38;1019;25;3414.00;67
8859;25;624889822;8859;435;9879;9946;5.03;0.31;278.87;8.37;1020;25;3415.00;67
8866;25;624889835;8866;427;9879;9946;5.05;0.31;278.87;8.37;1013;25;3416.00;67
8866;25;624889850;8866;426;9880;9946;5.11;0.31;278.87;8.37;1014;25;3417.00;66
8868;25;624889874;8868;430;9880;9946;5.16;0.31;278.89;8.37;1012;25;3418.00;66
8873;25;624889888;8873;427;9880;9946;5.17;0.31;278.86;8.37;1007;25;3419.00;66
8874;25;624889906;8874;433;9906;9980;5.33;0.33;278.84;8.35;1032;25;3420.00;74
8877;25;624889927;8877;442;9908;9980;5.34;0.33;278.88;8.35;1031;25;3421.00;72
8882;25;624889946;8882;444;9909;9980;5.29;0.32;278.82;8.35;1027;25;3422.00;71
8883;25;624889966;8883;444;9909;9980;5.28;0.32;278.83;8.35;1026;25;3423.00;71
8885;25;624889984;8885;447;9910;9980;5.29;0.32;278.84;8.35;1025;25;3424.00;70
8888;25;624890003;8888;444;9910;9980;5.30;0.32;278.85;8.35;1022;25;3425.00;70
8889;25;624890018;8889;442;9910;9981;5.32;0.32;278.93;8.35;1021;25;3426.00;71
8892;25;624890032;8892;436;9910;9981;5.27;0.32;278.94;8.35;1018;25;3427.00;71
8894;25;624890045;8894;430;9915;9987;5.33;0.33;278.95;8.35;1021;25;3428.00;72
8896;25;624890059;8896;427;9916;9988;5.37;0.33;278.93;8.35;1020;25;3429.00;72
8900;25;624890075;8900;438;9916;9988;5.35;0.33;278.97;8.35;1016;25;3430.00;72
8905;25;624890088;8905;437;9916;9988;5.34;0.33;278.93;8.35;1011;25;3431.00;72
8906;25;624890101;8906;436;9919;9992;5.40;0.33;278.93;8.34;1013;25;3432.00;73
8912;25;624890115;8912;433;9919;9992;5.39;0.33;279.00;8.34;1007;25;3433.00;73
8919;25;624890129;8919;435;9919;9992;5.35;0.33;279.10;8.34;1000;25;3434.00;73
8921;25;624890142;8921;436;9920;9993;5.39;0.33;279.11;8.34;999;25;3435.00;73
8926;25;624890156;8926;431;9923;9997;5.41;0.33;279.11;8.34;997;25;3436.00;74
8927;25;624890170;8927;437;9923;9997;5.45;0.33;279.12;8.34;996;25;3437.00;74
8929;25;624890184;8929;440;9925;10000;5.56;0.34;279.13;8.34;996;25;3438.00;75
8932;25;624890198;8932;433;9925;10000;5.61;0.34;279.12;8.34;993;25;3439.00;75
8934;25;624890211;8934;433;9926;10000;5.67;0.35;279.12;8.34;992;25;3440.00;74
8938;25;624890224;8938;434;9926;10000;5.73;0.35;279.16;8.34;988;25;3441.00;74
8940;25;624890237;8940;432;9930;10004;5.83;0.36;279.18;8.33;990;25;3442.00;74
8942;26;624890252;8942;430;9930;10004;5.88;0.36;279.20;8.33;988;26;3443.00;74
8943;26;624890281;8943;430;9930;10004;5.94;0.36;279.21;8.33;987;26;3444.00;74
8945;26;624890300;8945;427;9930;10004;5.95;0.36;279.21;8.33;985;26;3445.00;74
8947;26;624890315;8947;419;9930;10005;5.96;0.37;279.21;8.33;983;26;3446.00;75
8951;26;624890328;8951;398;9931;10006;6.00;0.37;279.29;8.33;980;26;3447.00;75
8952;26;624890341;8952;381;9931;10006;6.05;0.37;279.31;8.33;979;26;3448.00;75
8957;26;624890353;8957;373;9932;10007;6.10;0.37;279.45;8.33;975;26;3449.00;75
8961;26;624890368;8961;365;9932;10007;6.11;0.38;279.52;8.33;971;26;3450.00;75
8965;26;624890382;8965;361;9932;10007;6.19;0.38;279.63;8.33;967;26;3451.00;75
8969;26;624890396;8969;361;9933;10007;6.20;0.38;279.65;8.42;964;26;3452.00;74
8971;26;624890411;8971;361;9933;10007;6.24;0.38;279.73;8.42;962;26;3453.00;74
8972;26;624890424;8972;366;9933;10007;6.33;0.39;279.75;8.42;961;26;3454.00;74
8976;26;624890437;8976;367;9933;10007;6.36;0.39;279.79;8.42;957;26;3455.00;74
8981;26;624890457;8981;375;10010;10134;6.50;0.40;279.83;8.35;1029;26;3456.00;124
8981;27;624890482;8981;350;10010;10135;6.61;0.41;279.83;8.35;1029;27;3457.00;125
8984;27;624890503;8984;320;10016;10135;6.84;0.42;279.86;8.43;1032;27;3458.00;119
8989;27;624890518;8989;303;10018;10135;7.01;0.43;279.93;8.43;1029;27;3459.00;117
8989;27;624890534;8989;292;10023;10135;7.23;0.44;279.93;8.43;1034;27;3460.00;112
8992;27;624890549;8992;283;10025;10135;7.36;0.45;279.98;8.43;1033;27;3461.00;110
8994;27;624890567;8994;277;10028;10135;7.50;0.46;280.04;8.43;1034;27;3462.00;107
8994;27;624890587;8994;273;10030;10135;7.63;0.47;280.04;8.43;1036;27;3463.00;105
8997;27;624890608;8997;268;10032;10136;7.76;0.47;280.10;8.43;1035;27;3464.00;104
8999;27;624890630;8999;266;10037;10138;7.81;0.48;280.15;8.43;1038;27;3465.00;101
9001;27;624890649;9001;264;10039;10138;7.86;0.48;280.19;8.43;1038;28;3466.00;99
9005;27;624890677;9005;265;10041;10139;7.92;0.48;280.23;8.43;1036;28;3467.00;98
9009;27;624890692;9009;267;10044;10139;7.89;0.48;280.33;8.43;1035;28;3468.00;95
9012;27;624890709;9012;277;10047;10139;7.85;0.48;280.37;8.43;1035;28;3469.00;92
9013;27;624890725;9013;285;10047;10139;7.88;0.48;280.45;8.43;1034;28;3470.00;92
9015;28;624890740;9015;286;10052;10143;7.88;0.48;280.57;8.43;1037;29;3471.00;91
9016;28;624890785;9016;289;10054;10143;7.87;0.48;280.58;8.51;1038;29;3472.00;89
9020;28;624890819;9020;291;10055;10143;7.91;0.48;280.61;8.51;1035;29;3473.00;88
9023;28;624890841;9023;291;10057;10146;7.94;0.48;280.66;8.51;1034;29;3474.00;89
9026;28;624890864;9026;287;10058;10146;7.90;0.48;280.76;8.51;1032;29;3475.00;88
9029;28;624890883;9029;292;10060;10146;7.90;0.48;280.79;8.51;1031;29;3476.00;86
9031;28;624890901;9031;284;10063;10150;7.93;0.48;280.83;8.51;1032;29;3477.00;87
9032;28;624890917;9032;282;10064;10151;7.96;0.49;280.89;8.51;1032;29;3478.00;87
9035;28;624890941;9035;278;10065;10151;8.07;0.49;280.86;8.51;1030;29;3479.00;86
9037;28;624890960;9037;273;10071;10156;8.16;0.50;280.90;8.51;1034;29;3480.00;85
9039;28;624890980;9039;268;10071;10156;8.23;0.50;280.94;8.51;1032;29;3481.00;85
9041;28;624890997;9041;255;10071;10156;8.31;0.51;280.93;8.51;1030;29;3482.00;85
9042;28;624891013;9042;254;10072;10157;8.46;0.52;280.96;8.51;1030;29;3483.00;85
9045;28;624891031;9045;250;10072;10157;8.52;0.52;280.93;8.51;1027;29;3484.00;85
9050;28;624891048;9050;241;10077;10163;8.60;0.52;281.00;8.50;1027;29;3485.00;86
9052;28;624891065;9052;231;10077;10163;8.67;0.53;281.09;8.50;1025;29;3486.00;86
9055;28;624891079;9055;229;10077;10164;8.74;0.53;281.13;8.50;1022;29;3487.00;87
9058;28;624891097;9058;226;10077;10164;8.74;0.53;281.15;8.50;1019;29;3488.00;87
9061;28;624891113;9061;223;10077;10164;8.75;0.53;281.23;8.50;1016;29;3489.00;87
9063;28;624891129;9063;226;10077;10164;8.81;0.53;281.29;8.50;1014;29;3490.00;87
9067;28;624891146;9067;220;10077;10164;8.83;0.54;281.36;8.50;1010;29;3491.00;87
9071;28;624891162;9071;223;10087;10176;8.92;0.54;281.45;8.49;1016;29;3492.00;89
9075;28;624891181;9075;210;10088;10176;8.95;0.54;281.43;8.49;1013;29;3493.00;88
9080;28;624891195;9080;215;10089;10176;8.97;0.54;281.57;8.57;1009;29;3494.00;87
9086;28;624891208;9086;210;10089;10176;8.98;0.54;281.65;8.57;1003;29;3495.00;87
9088;28;624891222;9088;210;10089;10176;8.97;0.54;281.67;8.57;1001;29;3496.00;87
9090;28;624891236;9090;214;10089;10176;8.95;0.54;281.74;8.57;999;29;3497.00;87
9093;28;624891250;9093;219;10092;10180;8.89;0.54;281.73;8.57;999;29;3498.00;88
9096;28;624891263;9096;209;10092;10180;8.83;0.54;281.73;8.57;996;29;3499.00;88
9100;28;624891279;9100;216;10096;10184;8.79;0.53;281.72;8.57;996;29;3500.00;88
9102;28;624891299;9102;207;10096;10185;8.72;0.53;281.81;8.57;994;29;3501.00;89
9105;28;624891313;9105;202;10097;10185;8.61;0.52;281.83;8.57;992;29;3502.00;88
9107;28;624891326;9107;199;10097;10185;8.52;0.52;281.84;8.57;990;29;3503.00;88
9109;28;624891340;9109;204;10109;10198;8.41;0.51;281.83;8.57;1000;29;3504.00;89
9113;28;624891354;9113;199;10110;10198;8.32;0.50;281.79;8.59;997;29;3505.00;88
9120;28;624891368;9120;196;10110;10198;8.28;0.50;281.79;8.59;990;29;3506.00;88
9124;28;624891381;9124;202;10111;10199;8.25;0.50;281.77;8.59;987;29;3507.00;88
9127;28;624891394;9127;205;10111;10200;8.23;0.50;281.79;8.59;984;29;3508.00;89
9128;28;624891406;9128;205;10111;10200;8.23;0.50;281.77;8.59;983;29;3509.00;89
9132;28;624891421;9132;197;10116;10206;8.25;0.50;281.82;8.66;984;29;3510.00;90
9134;28;624891434;9134;200;10117;10206;8.24;0.50;281.89;8.66;983;29;3511.00;89
9135;28;624891447;9135;205;10118;10206;8.29;0.50;281.87;8.66;983;29;3512.00;88
9136;28;624891462;9136;208;10118;10206;8.32;0.51;281.91;8.66;982;29;3513.00;88
9140;28;624891476;9140;217;10123;10212;8.31;0.51;281.91;8.66;983;29;3514.00;89
9143;28;624891489;9143;219;10123;10212;8.27;0.50;281.92;8.66;980;29;3515.00;89
9148;28;624891501;9148;223;10123;10212;8.17;0.50;282.08;8.66;975;29;3516.00;89
9150;28;624891513;9150;227;10123;10212;8.13;0.50;282.15;8.66;973;29;3517.00;89
9152;28;624891525;9152;222;10126;10216;8.12;0.50;282.21;8.65;974;29;3518.00;90
9156;28;624891538;9156;231;10129;10219;8.06;0.49;282.24;8.65;973;29;3519.00;90
9158;28;624891550;9158;232;10129;10219;8.11;0.50;282.24;8.65;971;29;3520.00;90
9164;28;624891563;9164;234;10131;10220;8.11;0.49;282.36;8.66;967;29;3521.00;89
9165;28;624891576;9165;235;10131;10220;8.11;0.49;282.35;8.66;966;29;3522.00;89
9166;28;624891588;9166;238;10131;10220;8.13;0.50;282.33;8.66;965;29;3523.00;89
9170;28;624891601;9170;243;10131;10220;8.13;0.49;282.40;8.66;961;29;3524.00;89
9170;28;624891612;9170;248;10132;10220;8.16;0.50;282.40;8.67;962;29;3525.00;88
9171;28;624891624;9171;254;10132;10220;8.19;0.50;282.45;8.67;961;29;3526.00;88
9177;28;624891642;9177;259;10132;10220;8.17;0.50;282.44;8.67;955;29;3527.00;88
9179;28;624891654;9179;264;10170;10290;8.26;0.51;282.47;8.65;991;29;3528.00;120
9181;28;624891672;9181;264;10173;10291;8.23;0.50;282.48;8.64;992;29;3529.00;118
9187;28;624891687;9187;269;10182;10291;8.21;0.50;282.40;8.65;995;29;3530.00;109
9190;28;624891700;9190;276;10188;10291;8.14;0.50;282.38;8.66;998;29;3531.00;103
9191;28;624891712;9191;281;10191;10291;8.11;0.50;282.38;8.66;1000;29;3532.00;100
9194;28;624891725;9194;285;10193;10291;8.05;0.49;282.37;8.67;999;29;3533.00;98
9195;28;624891739;9195;289;10196;10291;7.96;0.49;282.38;8.68;1001;29;3534.00;95
9199;28;624891754;9199;294;10198;10291;7.88;0.48;282.33;8.68;999;29;3535.00;93
9201;28;624891766;9201;296;10201;10292;7.76;0.48;282.29;8.69;1000;29;3536.00;91
9203;28;624891785;9203;304;10205;10293;7.65;0.47;282.27;8.69;1002;29;3537.00;88
9204;28;624891797;9204;308;10207;10293;7.50;0.46;282.27;8.71;1003;29;3538.00;86
9209;28;624891810;9209;317;10212;10297;7.30;0.45;282.25;8.71;1003;29;3539.00;85
9213;28;624891824;9213;322;10212;10297;7.12;0.44;282.28;8.71;999;29;3540.00;85
9215;28;624891836;9215;328;10214;10297;6.99;0.43;282.35;8.72;999;29;3541.00;83
9217;28;624891846;9217;335;10215;10297;6.89;0.42;282.30;8.73;998;29;3542.00;82
9219;28;624891857;9219;343;10221;10303;6.85;0.42;282.27;8.73;1002;29;3543.00;82
9221;28;624891869;9221;343;10222;10303;6.69;0.41;282.23;8.74;1001;29;3544.00;81
9221;28;624891880;9221;349;10222;10303;6.53;0.40;282.23;8.74;1001;29;3545.00;81
9222;28;624891893;9222;359;10224;10306;6.41;0.39;282.22;8.74;1002;29;3546.00;82
9223;28;624891904;9223;369;10225;10306;6.28;0.39;282.26;8.75;1002;29;3547.00;81
9225;28;624891915;9225;373;10226;10306;6.19;0.38;282.23;8.75;1001;29;3548.00;80
9228;28;624891925;9228;377;10229;10307;6.12;0.38;282.19;8.79;1001;29;3549.00;78
9231;28;624891935;9231;378;10230;10308;6.11;0.37;282.18;8.79;999;29;3550.00;78
9231;28;624891945;9231;376;10231;10308;6.10;0.37;282.18;8.80;1000;29;3551.00;77
9234;28;624891955;9234;378;10241;10321;6.09;0.37;282.13;8.79;1007;29;3552.00;80
9235;28;624891966;9235;375;10245;10321;6.05;0.37;282.10;8.82;1010;29;3553.00;76
9237;28;624891977;9237;375;10245;10321;6.02;0.37;282.07;8.82;1008;29;3554.00;76
9239;28;624891988;9239;381;10248;10323;6.03;0.37;282.02;8.82;1009;29;3555.00;75
9239;28;624891998;9239;384;10248;10323;6.02;0.37;282.02;8.82;1009;29;3556.00;75
9240;28;624892008;9240;388;10255;10327;6.03;0.37;282.01;8.85;1015;29;3557.00;72
9245;28;624892018;9245;386;10255;10327;5.92;0.36;281.91;8.85;1010;29;3558.00;72
9247;28;624892029;9247;392;10258;10331;5.84;0.36;281.91;8.85;1011;29;3559.00;73
9249;28;624892039;9249;394;10259;10331;5.74;0.35;281.93;8.85;1010;29;3560.00;72
9252;28;624892049;9252;399;10259;10331;5.60;0.34;281.92;8.85;1007;29;3561.00;72
9254;28;624892059;9254;399;10259;10331;5.44;0.33;281.92;8.85;1005;29;3562.00;72
9256;28;624892068;9256;389;10262;10331;5.33;0.32;281.87;8.88;1006;29;3563.00;69
9259;28;624892078;9259;385;10272;10343;5.34;0.33;281.88;8.87;1013;29;3564.00;71
9262;28;624892089;9262;381;10273;10343;5.28;0.32;281.86;8.88;1011;29;3565.00;70
9265;28;624892099;9265;380;10274;10343;5.24;0.32;281.85;8.88;1009;29;3566.00;69
9266;28;624892110;9266;381;10274;10343;5.24;0.32;281.83;8.88;1008;29;3567.00;69
9266;28;624892120;9266;384;10277;10343;5.19;0.32;281.83;8.89;1011;29;3568.00;66
9270;28;624892130;9270;382;10277;10343;5.13;0.31;281.80;8.89;1007;29;3569.00;66
9271;28;624892147;9271;379;10277;10344;5.11;0.31;281.82;8.89;1006;29;3570.00;67
9274;28;624892157;9274;377;10278;10344;5.09;0.31;281.87;8.90;1004;29;3571.00;66
9276;28;624892167;9276;379;10284;10350;5.17;0.31;281.87;8.89;1008;29;3572.00;66
9279;28;624892177;9279;383;10285;10351;5.18;0.32;281.88;8.90;1006;29;3573.00;66
9280;28;624892188;9280;378;10286;10351;5.25;0.32;281.86;8.90;1006;29;3574.00;65
9283;28;624892198;9283;379;10286;10351;5.22;0.32;281.90;8.90;1003;29;3575.00;65
9283;29;624892208;9283;374;10292;10355;5.30;0.32;281.90;8.91;1009;30;3576.00;63
9286;29;624892225;9286;362;10292;10355;5.34;0.33;281.93;8.91;1006;30;3577.00;63
9288;29;624892236;9288;357;10292;10355;5.39;0.33;281.93;8.91;1004;30;3578.00;63
9289;29;624892246;9289;352;10294;10356;5.43;0.33;281.97;8.91;1005;30;3579.00;62
9294;29;624892260;9294;351;10297;10360;5.44;0.33;281.98;8.91;1003;30;3580.00;63
9297;29;624892271;9297;350;10297;10360;5.40;0.33;282.01;8.91;1000;30;3581.00;63
9298;29;624892281;9298;348;10299;10363;5.43;0.33;281.99;8.91;1001;30;3582.00;64
9302;29;624892291;9302;345;10299;10363;5.43;0.33;281.98;8.91;997;30;3583.00;64
9303;29;624892302;9303;352;10300;10363;5.43;0.33;282.00;8.91;997;30;3584.00;63
9307;29;624892312;9307;347;10300;10363;5.41;0.33;282.02;8.91;993;30;3585.00;63
9311;29;624892322;9311;345;10304;10367;5.43;0.33;282.08;8.90;993;30;3586.00;63
9312;30;624892334;9312;340;10304;10367;5.45;0.33;282.07;8.90;992;31;3587.00;63
9316;30;624892351;9316;332;10304;10367;5.49;0.33;282.11;8.90;988;31;3588.00;63
9324;30;624892362;9324;322;10304;10367;5.49;0.33;282.05;8.90;980;31;3589.00;63
9325;30;624892373;9325;314;10304;10368;5.57;0.34;282.12;8.90;979;31;3590.00;64
9329;30;624892384;9329;316;10305;10369;5.63;0.34;282.14;8.90;976;31;3591.00;64
9331;30;624892395;9331;312;10305;10369;5.69;0.34;282.15;8.90;974;31;3592.00;64
9333;30;624892405;9333;315;10306;10370;5.78;0.35;282.19;8.90;973;31;3593.00;64
9339;30;624892415;9339;319;10306;10370;5.80;0.35;282.26;8.90;967;31;3594.00;64
9342;30;624892430;9342;313;10306;10370;5.80;0.35;282.26;8.90;964;31;3595.00;64
9343;30;624892441;9343;311;10306;10370;5.86;0.36;282.31;8.90;963;31;3596.00;64
9346;30;624892451;9346;311;10306;10370;5.90;0.36;282.36;8.90;960;31;3597.00;64
9349;30;624892461;9349;318;10306;10370;5.91;0.36;282.37;8.90;957;31;3598.00;64
9355;30;624892472;9355;315;10306;10370;5.85;0.36;282.52;8.90;951;31;3599.00;64
9358;30;624892485;9358;347;10417;10623;6.21;0.39;282.50;8.81;1059;31;3600.00;206
9362;30;624892518;9362;346;10425;10624;6.22;0.39;282.56;8.89;1063;31;3601.00;199
9365;30;624892531;9365;338;10439;10624;6.33;0.40;282.55;8.88;1074;31;3602.00;185
9369;30;624892543;9369;331;10446;10624;6.35;0.40;282.56;8.88;1077;31;3603.00;178
9373;30;624892555;9373;327;10454;10624;6.37;0.40;282.63;8.87;1081;31;3604.00;170
9377;30;624892567;9377;331;10458;10624;6.36;0.40;282.67;8.87;1081;31;3605.00;166
9380;30;624892579;9380;326;10464;10624;6.40;0.40;282.71;8.87;1084;31;3606.00;160
9385;30;624892592;9385;327;10468;10624;6.33;0.39;282.73;8.87;1083;31;3607.00;156
9388;30;624892604;9388;328;10474;10625;6.30;0.39;282.76;8.87;1086;31;3608.00;151
9393;30;624892616;9393;332;10479;10626;6.18;0.38;282.83;8.87;1086;31;3609.00;147
9396;30;624892629;9396;329;10487;10626;6.13;0.38;282.92;8.87;1091;31;3610.00;139
9400;30;624892641;9400;338;10488;10627;6.11;0.38;283.03;8.87;1088;31;3611.00;139
9402;30;624892654;9402;346;10492;10627;6.13;0.38;283.05;8.87;1090;31;3612.00;135
9407;30;624892666;9407;352;10495;10627;6.13;0.38;283.11;8.87;1088;31;3613.00;132
9410;30;624892679;9410;355;10497;10627;6.12;0.38;283.18;8.87;1087;31;3614.00;130
9412;30;624892691;9412;361;10501;10631;6.17;0.38;283.25;8.87;1089;31;3615.00;130
9415;30;624892710;9415;366;10503;10631;6.20;0.39;283.29;8.87;1088;31;3616.00;128
9419;30;624892723;9419;357;10507;10631;6.17;0.38;283.34;8.96;1088;31;3617.00;124
9425;30;624892736;9425;353;10508;10634;6.16;0.38;283.44;8.96;1083;31;3618.00;126
9430;30;624892750;9430;348;10510;10634;6.17;0.38;283.44;8.96;1080;31;3619.00;124
9433;30;624892785;9433;346;10511;10634;6.20;0.38;283.42;8.96;1078;31;3620.00;123
9436;30;624892806;9436;350;10515;10638;6.22;0.38;283.48;8.96;1079;31;3621.00;123
9441;30;624892826;9441;352;10516;10639;6.26;0.39;283.60;8.96;1075;31;3622.00;123
9446;30;624892846;9446;346;10517;10639;6.30;0.39;283.70;8.96;1071;31;3623.00;122
9451;30;624892875;9451;344;10518;10643;6.33;0.39;283.74;8.96;1067;31;3624.00;125
9453;30;624892891;9453;345;10520;10643;6.35;0.39;283.78;8.96;1067;31;3625.00;123
9456;30;624892905;9456;331;10522;10643;6.44;0.40;283.80;8.97;1066;31;3626.00;121
9460;30;624892920;9460;317;10523;10644;6.51;0.40;283.78;8.96;1063;31;3627.00;121
9461;30;624892935;9461;305;10524;10644;6.58;0.40;283.80;8.96;1063;31;3628.00;120
9464;30;624892950;9464;303;10530;10650;6.65;0.41;283.84;9.05;1066;31;3629.00;120
9465;30;624892968;9465;291;10531;10650;6.73;0.41;283.81;9.05;1066;31;3630.00;119
9466;30;624892984;9466;284;10534;10651;6.86;0.42;283.86;9.05;1068;31;3631.00;117
9469;30;624893001;9469;265;10535;10651;7.01;0.43;283.90;9.05;1066;31;3632.00;116
9471;30;624893035;9471;262;10535;10651;7.09;0.43;283.97;9.05;1064;31;3633.00;116
9475;30;624893050;9475;260;10537;10651;7.13;0.44;284.05;9.13;1062;31;3634.00;114
9477;30;624893065;9477;256;10538;10651;7.23;0.44;284.08;9.13;1061;31;3635.00;113
9479;30;624893079;9479;256;10546;10663;7.38;0.45;284.11;9.13;1067;31;3636.00;117
9481;30;624893095;9481;251;10548;10663;7.45;0.45;284.17;9.14;1067;31;3637.00;115
9484;30;624893109;9484;243;10552;10663;7.51;0.46;284.22;9.14;1068;31;3638.00;111
9488;30;624893134;9488;245;10552;10663;7.57;0.46;284.30;9.14;1064;31;3639.00;111
9494;30;624893148;9494;254;10553;10663;7.59;0.46;284.42;9.14;1059;31;3640.00;110
9498;30;624893163;9498;246;10553;10663;7.62;0.46;284.50;9.14;1055;31;3641.00;110
9501;30;624893178;9501;251;10557;10667;7.60;0.46;284.63;9.13;1056;31;3642.00;110
9503;30;624893192;9503;256;10558;10667;7.68;0.47;284.65;9.13;1055;31;3643.00;109
9508;30;624893207;9508;257;10562;10671;7.81;0.47;284.63;9.13;1054;31;3644.00;109
9509;30;624893222;9509;263;10564;10673;7.87;0.48;284.62;9.13;1055;31;3645.00;109
9512;30;624893237;9512;267;10564;10673;7.89;0.48;284.71;9.13;1052;31;3646.00;109
9514;30;624893253;9514;270;10564;10673;7.91;0.48;284.75;9.13;1050;31;3647.00;109
9518;30;624893268;9518;266;10573;10686;7.93;0.48;284.88;9.12;1055;31;3648.00;113
9519;30;624893283;9519;259;10573;10686;7.97;0.48;284.93;9.12;1054;31;3649.00;113
9521;30;624893298;9521;260;10573;10686;8.05;0.49;284.94;9.12;1052;31;3650.00;113
9523;30;624893312;9523;258;10575;10687;8.07;0.49;284.96;9.19;1052;31;3651.00;112
9526;30;624893326;9526;261;10575;10688;8.06;0.49;284.93;9.19;1049;31;3652.00;113
9528;30;624893340;9528;264;10575;10688;8.01;0.49;284.91;9.19;1047;31;3653.00;113
9530;30;624893355;9530;263;10577;10691;7.98;0.48;284.97;9.19;1047;31;3654.00;114
9531;30;624893368;9531;263;10577;10691;7.91;0.48;284.97;9.19;1046;31;3655.00;114
9533;30;624893382;9533;264;10578;10691;7.86;0.48;285.00;9.19;1045;31;3656.00;113
9537;30;624893397;9537;263;10578;10691;7.84;0.48;285.08;9.19;1041;31;3657.00;113
9538;30;624893411;9538;258;10583;10697;7.94;0.48;285.09;9.19;1045;31;3658.00;114
9541;30;624893426;9541;257;10583;10697;7.97;0.49;285.12;9.19;1042;31;3659.00;114
9543;30;624893441;9543;257;10583;10697;8.02;0.49;285.17;9.19;1040;31;3660.00;114
9547;30;624893455;9547;253;10583;10697;8.10;0.49;285.17;9.19;1036;31;3661.00;114
9549;30;624893470;9549;252;10585;10701;8.14;0.50;285.18;9.18;1036;31;3662.00;116
9552;30;624893485;9552;258;10587;10702;8.20;0.50;285.20;9.18;1035;31;3663.00;115
9556;30;624893499;9556;258;10587;10702;8.25;0.50;285.23;9.18;1031;31;3664.00;115
9560;30;624893513;9560;260;10588;10703;8.21;0.50;285.24;9.18;1028;31;3665.00;115
9564;30;624893527;9564;261;10588;10703;8.19;0.50;285.29;9.18;1024;31;3666.00;115
9567;30;624893541;9567;261;10588;10703;8.19;0.50;285.32;9.18;1021;31;3667.00;115
9569;30;624893554;9569;265;10589;10703;8.14;0.49;285.33;9.26;1020;31;3668.00;114
9572;30;624893568;9572;267;10589;10703;8.14;0.49;285.37;9.26;1017;31;3669.00;114
9578;30;624893581;9578;264;10589;10703;7.99;0.48;285.55;9.26;1011;31;3670.00;114
9581;30;624893595;9581;264;10589;10703;7.87;0.48;285.62;9.26;1008;31;3671.00;114
9584;30;624893608;9584;264;10621;10773;7.81;0.47;285.63;9.23;1037;31;3672.00;152
9587;30;624893628;9587;261;10621;10774;7.74;0.47;285.66;9.23;1034;31;3673.00;153
9589;30;624893641;9589;258;10627;10774;7.68;0.47;285.69;9.23;1038;31;3674.00;147
9589;30;624893655;9589;260;10633;10774;7.62;0.46;285.69;9.25;1044;31;3675.00;141
9592;30;624893669;9592;265;10637;10774;7.54;0.46;285.78;9.25;1045;31;3676.00;137
9597;30;624893682;9597;270;10642;10774;7.43;0.45;285.72;9.33;1045;31;3677.00;132
9601;30;624893696;9601;269;10646;10774;7.38;0.45;285.71;9.33;1045;31;3678.00;128
9606;30;624893709;9606;269;10649;10774;7.31;0.44;285.82;9.33;1043;31;3679.00;125
9608;30;624893722;9608;271;10650;10775;7.33;0.44;285.83;9.33;1042;31;3680.00;125
9611;30;624893735;9611;274;10654;10776;7.31;0.44;285.87;9.33;1043;31;3681.00;122
9613;30;624893749;9613;271;10655;10776;7.28;0.44;285.88;9.33;1042;31;3682.00;121
9613;30;624893766;9613;276;10659;10780;7.24;0.44;285.88;9.33;1046;31;3683.00;121
9614;30;624893787;9614;277;10660;10780;7.17;0.44;285.86;9.33;1046;31;3684.00;120
9618;30;624893801;9618;287;10660;10780;7.14;0.43;285.86;9.33;1042;31;3685.00;120
9619;30;624893815;9619;302;10660;10780;7.09;0.43;285.85;9.33;1041;31;3686.00;120
9621;30;624893828;9621;298;10665;10786;7.09;0.43;285.89;9.33;1044;31;3687.00;121
9622;30;624893842;9622;302;10665;10786;7.09;0.43;285.87;9.33;1043;31;3688.00;121
9625;30;624893855;9625;312;10665;10786;7.11;0.43;285.85;9.33;1040;31;3689.00;121
9626;30;624893869;9626;318;10670;10792;7.14;0.44;285.84;9.34;1044;31;3690.00;122
9629;30;624893883;9629;327;10670;10792;7.04;0.43;285.93;9.34;1041;31;3691.00;122
9630;30;624893896;9630;332;10675;10792;7.02;0.43;285.91;9.35;1045;31;3692.00;117
9634;30;624893909;9634;340;10675;10793;6.99;0.43;286.03;9.35;1041;31;3693.00;118
9639;31;624893921;9639;341;10676;10794;6.97;0.43;285.98;9.34;1037;32;3694.00;118
9642;31;624893947;9642;345;10679;10794;6.94;0.42;286.00;9.36;1037;32;3695.00;115
9647;31;624893959;9647;352;10687;10807;6.92;0.42;286.00;9.35;1040;32;3696.00;120
9648;31;624893972;9648;359;10689;10807;6.96;0.42;286.04;9.35;1041;32;3697.00;118
9651;31;624893988;9651;359;10690;10807;6.91;0.42;286.04;9.36;1039;32;3698.00;117
9655;31;624894000;9655;366;10692;10808;6.92;0.42;286.07;9.36;1037;32;3699.00;116
9658;31;624894012;9658;367;10694;10808;6.86;0.42;286.03;9.39;1036;32;3700.00;114
9663;31;624894028;9663;371;10698;10812;6.78;0.41;286.04;9.38;1035;32;3701.00;114
9667;31;624894042;9667;375;10699;10812;6.68;0.41;285.97;9.39;1032;32;3702.00;113
9671;31;624894053;9671;384;10704;10816;6.57;0.40;285.96;9.41;1033;32;3703.00;112
9673;31;624894066;9673;390;10704;10816;6.49;0.39;285.92;9.41;1031;32;3704.00;112
9674;31;624894078;9674;397;10707;10816;6.43;0.39;285.93;9.45;1033;32;3705.00;109
9674;31;624894090;9674;407;10708;10816;6.35;0.39;285.93;9.46;1034;32;3706.00;108
9676;31;624894102;9676;412;10709;10816;6.21;0.38;285.91;9.47;1033;32;3707.00;107
9679;31;624894113;9679;414;10718;10828;6.16;0.38;285.92;9.47;1039;32;3708.00;110
9681;31;624894126;9681;421;10719;10828;6.09;0.37;285.89;9.47;1038;32;3709.00;109
9683;31;624894137;9683;427;10722;10828;6.05;0.37;285.91;9.49;1039;32;3710.00;106
9687;31;624894149;9687;437;10724;10828;5.94;0.36;285.89;9.51;1037;32;3711.00;104
9687;31;624894160;9687;434;10725;10828;5.87;0.36;285.89;9.52;1038;32;3712.00;103
9690;31;624894171;9690;441;10725;10828;5.75;0.35;285.90;9.52;1035;32;3713.00;103
9692;31;624894183;9692;451;10727;10829;5.63;0.34;285.85;9.54;1035;32;3714.00;102
9695;31;624894194;9695;441;10729;10829;5.55;0.34;285.87;9.55;1034;32;3715.00;100
9696;31;624894204;9696;445;10737;10835;5.59;0.34;285.85;9.57;1041;32;3716.00;98
9696;31;624894216;9696;436;10739;10836;5.58;0.34;285.85;9.58;1043;32;3717.00;97
9698;31;624894227;9698;440;10742;10836;5.56;0.34;285.82;9.60;1044;32;3718.00;94
9699;31;624894239;9699;432;10742;10836;5.49;0.34;285.81;9.60;1043;32;3719.00;94
9701;31;624894252;9701;421;10746;10841;5.53;0.34;285.77;9.60;1045;32;3720.00;95
9701;31;624894265;9701;415;10749;10841;5.53;0.34;285.77;9.62;1048;32;3721.00;92
9704;31;624894289;9704;411;10750;10841;5.53;0.34;285.71;9.62;1046;32;3722.00;91
9707;31;624894300;9707;402;10751;10842;5.55;0.34;285.80;9.62;1044;32;3723.00;91
9708;31;624894311;9708;402;10754;10846;5.59;0.34;285.78;9.62;1046;32;3724.00;92
9710;31;624894329;9710;400;10757;10846;5.63;0.35;285.75;9.64;1047;32;3725.00;89
9713;31;624894341;9713;399;10759;10849;5.71;0.35;285.71;9.64;1046;32;3726.00;90
9714;31;624894353;9714;393;10763;10849;5.76;0.35;285.70;9.66;1049;32;3727.00;86
9715;31;624894364;9715;390;10763;10849;5.79;0.36;285.68;9.66;1048;32;3728.00;86
9716;31;624894377;9716;392;10764;10849;5.80;0.36;285.68;9.67;1048;32;3729.00;85
9719;31;624894388;9719;391;10770;10853;5.79;0.35;285.63;9.68;1051;32;3730.00;83
9724;31;624894400;9724;398;10770;10853;5.69;0.35;285.59;9.68;1046;32;3731.00;83
9726;31;624894412;9726;401;10771;10853;5.62;0.34;285.58;9.68;1045;32;3732.00;82
9729;31;624894422;9729;405;10772;10853;5.50;0.33;285.55;9.68;1043;32;3733.00;81
9732;31;624894433;9732;406;10772;10854;5.42;0.33;285.50;9.68;1040;32;3734.00;82
9734;31;624894443;9734;409;10775;10856;5.34;0.33;285.49;9.69;1041;32;3735.00;81
9737;31;624894454;9737;406;10775;10856;5.28;0.32;285.50;9.69;1038;32;3736.00;81
9740;31;624894463;9740;412;10777;10857;5.28;0.32;285.49;9.70;1037;32;3737.00;80
9746;31;624894474;9746;418;10777;10857;5.24;0.32;285.60;9.70;1031;32;3738.00;80
9748;31;624894485;9748;423;10777;10857;5.23;0.32;285.59;9.70;1029;32;3739.00;80
9751;31;624894494;9751;422;10778;10857;5.27;0.32;285.60;9.70;1027;32;3740.00;79
9755;31;624894505;9755;419;10781;10857;5.25;0.32;285.60;9.72;1026;32;3741.00;76
9762;31;624894515;9762;413;10782;10857;5.20;0.32;285.59;9.72;1020;32;3742.00;75
9765;31;624894526;9765;410;10782;10857;5.20;0.32;285.66;9.72;1017;32;3743.00;75
9769;31;624894537;9769;411;10839;10984;5.53;0.34;285.72;9.68;1070;32;3744.00;145
9771;31;624894557;9771;412;10843;10985;5.49;0.34;285.79;9.68;1072;32;3745.00;142
9775;31;624894568;9775;410;10853;10985;5.48;0.34;285.82;9.67;1078;32;3746.00;132
9778;31;624894579;9778;412;10859;10985;5.47;0.34;285.82;9.67;1081;32;3747.00;126
9780;31;624894590;9780;410;10864;10985;5.47;0.34;285.88;9.67;1084;32;3748.00;121
9783;31;624894601;9783;406;10866;10985;5.45;0.34;285.98;9.67;1083;32;3749.00;119
9788;31;624894614;9788;406;10870;10990;5.42;0.34;286.13;9.67;1082;32;3750.00;120
9788;31;624894627;9788;399;10872;10990;5.48;0.34;286.13;9.66;1084;32;3751.00;118
9791;31;624894638;9791;401;10875;10991;5.54;0.34;286.17;9.66;1084;32;3752.00;116
9793;31;624894650;9793;399;10878;10992;5.57;0.34;286.16;9.66;1085;32;3753.00;114
9795;31;624894662;9795;404;10880;10992;5.61;0.35;286.18;9.66;1085;32;3754.00;112
9800;31;624894674;9800;403;10882;10993;5.65;0.35;286.13;9.66;1082;32;3755.00;111
9803;31;624894686;9803;407;10889;10993;5.69;0.35;286.15;9.66;1086;32;3756.00;104
9806;31;624894698;9806;401;10891;10993;5.72;0.35;286.16;9.66;1085;32;3757.00;102
9810;31;624894710;9810;401;10892;10993;5.78;0.36;286.18;9.67;1082;32;3758.00;101
9813;31;624894722;9813;394;10897;10997;5.86;0.36;286.19;9.66;1084;32;3759.00;100
9817;31;624894735;9817;397;10899;10997;5.88;0.36;286.20;9.74;1082;32;3760.00;98
9821;31;624894749;9821;396;10900;10997;5.94;0.37;286.25;9.74;1079;32;3761.00;97
9823;31;624894766;9823;390;10902;11000;6.02;0.37;286.27;9.74;1079;32;3762.00;98
9826;31;624894793;9826;395;10903;11000;6.04;0.37;286.34;9.74;1077;32;3763.00;97
9829;31;624894822;9829;395;10903;11000;6.11;0.37;286.35;9.74;1074;32;3764.00;97
9831;31;624894843;9831;390;10908;11004;6.25;0.38;286.35;9.74;1077;32;3765.00;96
9834;31;624894863;9834;389;10911;11005;6.29;0.39;286.39;9.74;1077;32;3766.00;94
9835;31;624894880;9835;386;10911;11005;6.30;0.39;286.40;9.74;1076;32;3767.00;94
9840;31;624894894;9840;392;10915;11009;6.30;0.39;286.44;9.74;1075;32;3768.00;94
9844;31;624894910;9844;391;10915;11009;6.28;0.38;286.49;9.74;1071;32;3769.00;94
9848;31;624894924;9848;392;10916;11009;6.26;0.38;286.48;9.74;1068;32;3770.00;93
9853;31;624894937;9853;392;10917;11010;6.20;0.38;286.44;9.74;1064;32;3771.00;93
9857;31;624894960;9857;391;10918;11010;6.17;0.37;286.52;9.74;1061;32;3772.00;92
9860;31;624894974;9860;389;10923;11016;6.19;0.38;286.52;9.74;1063;32;3773.00;93
9865;31;624894988;9865;381;10924;11016;6.14;0.37;286.51;9.74;1059;32;3774.00;92
9866;31;624895001;9866;389;10924;11017;6.16;0.37;286.53;9.74;1058;32;3775.00;93
9870;31;624895014;9870;387;10924;11017;6.09;0.37;286.58;9.74;1054;32;3776.00;93
9875;31;624895027;9875;392;10924;11017;6.05;0.37;286.58;9.74;1049;32;3777.00;93
9878;31;624895040;9878;404;10924;11017;6.05;0.37;286.66;9.74;1046;32;3778.00;93
9882;31;624895053;9882;402;10924;11017;6.02;0.36;286.66;9.74;1042;32;3779.00;93
9886;31;624895068;9886;397;10948;11053;6.20;0.38;286.67;9.72;1062;32;3780.00;105
9888;31;624895084;9888;397;10950;11053;6.18;0.38;286.66;9.80;1062;32;3781.00;103
9893;31;624895098;9893;399;10952;11053;6.22;0.38;286.64;9.80;1059;32;3782.00;101
9896;31;624895112;9896;400;10952;11053;6.24;0.38;286.68;9.80;1056;32;3783.00;101
9897;31;624895124;9897;396;10953;11053;6.27;0.38;286.66;9.80;1056;32;3784.00;100
9898;31;624895139;9898;389;10954;11053;6.30;0.38;286.70;9.80;1056;32;3785.00;99
9900;31;624895151;9900;386;10958;11057;6.29;0.38;286.78;9.80;1058;32;3786.00;99
9904;31;624895165;9904;370;10958;11057;6.28;0.38;286.86;9.80;1054;32;3787.00;99
9906;31;624895179;9906;359;10962;11061;6.31;0.38;286.91;9.79;1056;32;3788.00;99
9909;31;624895193;9909;348;10963;11062;6.29;0.38;287.01;9.79;1054;32;3789.00;99
9910;31;624895207;9910;349;10963;11062;6.35;0.39;287.00;9.79;1053;32;3790.00;99
9912;31;624895220;9912;349;10964;11062;6.40;0.39;287.02;9.80;1052;32;3791.00;98
9916;31;624895233;9916;345;10974;11075;6.50;0.40;287.03;9.79;1058;32;3792.00;101
9920;31;624895248;9920;347;10974;11075;6.54;0.40;287.08;9.79;1054;32;3793.00;101
9923;31;624895263;9923;344;10975;11075;6.55;0.40;287.09;9.80;1052;32;3794.00;100
9925;31;624895276;9925;345;10976;11076;6.60;0.40;287.12;9.79;1051;32;3795.00;100
9930;31;624895290;9930;337;10976;11077;6.69;0.41;287.10;9.79;1046;32;3796.00;101
9935;31;624895303;9935;333;10978;11077;6.70;0.41;287.23;9.88;1043;32;3797.00;99
9937;31;624895332;9937;327;10981;11080;6.75;0.41;287.30;9.88;1044;32;3798.00;99
9939;31;624895346;9939;321;10981;11080;6.78;0.41;287.41;9.88;1042;32;3799.00;99
9943;31;624895360;9943;309;10983;11080;6.72;0.41;287.44;9.89;1040;32;3800.00;97
9946;31;624895378;9946;311;10983;11080;6.71;0.41;287.51;9.89;1037;32;3801.00;97
9948;31;624895393;9948;308;10988;11086;6.72;0.41;287.64;9.88;1040;32;3802.00;98
9952;31;624895407;9952;307;10989;11086;6.72;0.41;287.74;9.88;1037;32;3803.00;97
9954;31;624895421;9954;302;10990;11086;6.72;0.41;287.80;9.88;1036;32;3804.00;96
9959;31;624895434;9959;299;10991;11086;6.71;0.41;287.85;9.89;1032;32;3805.00;95
9961;31;624895448;9961;294;10994;11090;6.71;0.41;287.93;9.97;1033;32;3806.00;96
9965;31;624895462;9965;291;10996;11091;6.72;0.41;287.99;9.97;1031;32;3807.00;95
9968;31;624895476;9968;286;10996;11091;6.72;0.41;288.02;9.97;1028;32;3808.00;95
9969;31;624895490;9969;282;10997;11092;6.77;0.41;288.08;9.97;1028;32;3809.00;95
9973;31;624895505;9973;285;10998;11092;6.82;0.42;288.14;9.97;1025;32;3810.00;94
9978;31;624895518;9978;279;10998;11092;6.85;0.42;288.20;9.97;1020;32;3811.00;94
9981;31;624895531;9981;274;10998;11092;6.95;0.42;288.24;9.97;1017;32;3812.00;94
9984;31;624895545;9984;274;10999;11092;7.00;0.43;288.19;10.05;1015;32;3813.00;93
9988;31;624895558;9988;276;10999;11092;7.03;0.43;288.23;10.05;1011;32;3814.00;93
9992;31;624895571;9992;276;10999;11092;7.11;0.43;288.27;10.05;1007;32;3815.00;93
9996;31;624895585;9996;276;11034;11162;7.11;0.43;288.36;10.02;1038;32;3816.00;128
9998;31;624895605;9998;270;11034;11163;7.23;0.44;288.41;10.02;1036;32;3817.00;129
10001;31;624895618;10001;272;11040;11163;7.32;0.45;288.49;10.01;1039;32;3818.00;123
10003;31;624895632;10003;275;11044;11163;7.41;0.45;288.50;10.01;1041;32;3819.00;119
10007;31;624895645;10007;277;11047;11163;7.49;0.45;288.51;10.01;1040;32;3820.00;116
10009;31;624895659;10009;274;11052;11163;7.52;0.46;288.53;10.01;1043;32;3821.00;111
10012;31;624895672;10012;279;11056;11163;7.48;0.45;288.56;10.01;1044;32;3822.00;107
10015;31;624895686;10015;286;11059;11163;7.44;0.45;288.56;10.00;1044;32;3823.00;104
10017;31;624895698;10017;285;11060;11164;7.39;0.45;288.56;10.00;1043;32;3824.00;104
10019;31;624895713;10019;289;11063;11166;7.37;0.45;288.58;10.00;1044;32;3825.00;103
10022;31;624895729;10022;288;11066;11166;7.37;0.45;288.67;10.09;1044;32;3826.00;100
10024;31;624895744;10024;293;11070;11170;7.41;0.45;288.70;10.08;1046;32;3827.00;100
10025;31;624895762;10025;291;11071;11170;7.43;0.45;288.71;10.08;1046;32;3828.00;99
10027;31;624895777;10027;296;11071;11170;7.43;0.45;288.74;10.08;1044;32;3829.00;99
10029;31;624895792;10029;300;11071;11170;7.42;0.45;288.81;10.08;1042;32;3830.00;99
10030;31;624895807;10030;299;11075;11176;7.44;0.45;288.80;10.08;1045;32;3831.00;101
10034;31;624895822;10034;294;11075;11176;7.43;0.45;288.86;10.08;1041;32;3832.00;101
10036;31;624895837;10036;294;11075;11176;7.43;0.45;288.83;10.08;1039;32;3833.00;101
10037;31;624895852;10037;297;11077;11179;7.43;0.45;288.84;10.08;1040;32;3834.00;102
10038;31;624895867;10038;297;11077;11179;7.46;0.46;288.84;10.08;1039;32;3835.00;102
10042;31;624895882;10042;299;11078;11179;7.49;0.46;288.97;10.08;1036;32;3836.00;101
10046;31;624895896;10046;298;11078;11180;7.49;0.46;289.03;10.08;1032;32;3837.00;102
10051;31;624895911;10051;304;11079;11181;7.48;0.46;289.03;10.08;1028;32;3838.00;102
10055;31;624895925;10055;302;11079;11181;7.46;0.45;289.03;10.08;1024;32;3839.00;102
10058;31;624895941;10058;307;11095;11207;7.42;0.45;289.03;10.06;1037;32;3840.00;112
10061;31;624895956;10061;306;11095;11207;7.36;0.45;289.02;10.06;1034;32;3841.00;112
10065;31;624895971;10065;303;11097;11207;7.37;0.45;288.98;10.06;1032;32;3842.00;110
10068;31;624895985;10068;306;11100;11208;7.34;0.45;288.93;10.06;1032;32;3843.00;108
10069;31;624895998;10069;301;11101;11208;7.31;0.44;288.98;10.07;1032;32;3844.00;107
10073;31;624896012;10073;305;11105;11212;7.31;0.44;288.95;10.08;1032;32;3845.00;107
10075;31;624896026;10075;311;11107;11214;7.27;0.44;288.95;10.08;1032;32;3846.00;107
10083;31;624896039;10083;310;11110;11218;7.20;0.44;289.03;10.08;1027;32;3847.00;108
10086;31;624896053;10086;310;11110;11218;7.18;0.44;288.98;10.08;1024;32;3848.00;108
10091;31;624896065;10091;315;11110;11218;7.14;0.43;288.93;10.08;1019;32;3849.00;108
10094;31;624896079;10094;313;11110;11218;7.11;0.43;288.92;10.08;1016;32;3850.00;108
10097;31;624896090;10097;318;11110;11218;7.09;0.43;288.89;10.08;1013;32;3851.00;108
10100;31;624896102;10100;322;11120;11230;7.08;0.43;288.84;10.07;1020;32;3852.00;110
10103;31;624896114;10103;326;11121;11230;7.02;0.43;288.81;10.07;1018;32;3853.00;109
10105;31;624896126;10105;326;11121;11230;6.94;0.42;288.78;10.07;1016;32;3854.00;109
10105;31;624896138;10105;327;11121;11230;6.92;0.42;288.78;10.07;1016;32;3855.00;109
10110;31;624896149;10110;330;11121;11230;6.88;0.42;288.75;10.07;1011;32;3856.00;109
10112;31;624896161;10112;336;11122;11230;6.89;0.42;288.76;10.07;1010;32;3857.00;108
10115;31;624896172;10115;338;11122;11231;6.80;0.41;288.73;10.07;1007;32;3858.00;109
10116;31;624896183;10116;351;11122;11231;6.75;0.41;288.75;10.07;1006;32;3859.00;109
10118;31;624896194;10118;353;11129;11237;6.72;0.41;288.72;10.07;1011;32;3860.00;108
10121;31;624896212;10121;359;11129;11238;6.63;0.40;288.76;10.07;1008;32;3861.00;109
10122;31;624896224;10122;363;11130;11238;6.59;0.40;288.74;10.07;1008;32;3862.00;108
10123;31;624896234;10123;373;11131;11238;6.54;0.39;288.71;10.08;1008;32;3863.00;107
10124;31;624896245;10124;373;11136;11242;6.45;0.39;288.69;10.08;1012;32;3864.00;106
10126;31;624896256;10126;382;11137;11242;6.40;0.39;288.67;10.10;1011;32;3865.00;105
10126;31;624896268;10126;384;11137;11242;6.39;0.39;288.67;10.10;1011;32;3866.00;105
10127;31;624896278;10127;374;11138;11243;6.43;0.39;288.69;10.09;1011;32;3867.00;105
10129;31;624896290;10129;364;11141;11247;6.38;0.39;288.64;10.09;1012;32;3868.00;106
10129;31;624896301;10129;361;11142;11247;6.44;0.39;288.64;10.10;1013;32;3869.00;105
10130;31;624896314;10130;361;11147;11253;6.51;0.39;288.63;10.11;1017;32;3870.00;106
10130;31;624896325;10130;355;11148;11253;6.57;0.40;288.63;10.11;1018;32;3871.00;105
10132;31;624896337;10132;351;11150;11253;6.59;0.40;288.62;10.12;1018;32;3872.00;103
10133;31;624896348;10133;346;11151;11253;6.53;0.40;288.60;10.13;1018;32;3873.00;102
10134;31;624896366;10134;349;11155;11257;6.56;0.40;288.58;10.13;1021;32;3874.00;102
10134;32;624896379;10134;351;11157;11257;6.58;0.40;288.58;10.15;1023;33;3875.00;100
10136;32;624896402;10136;352;11157;11257;6.55;0.40;288.56;10.15;1021;33;3876.00;100
10136;32;624896414;10136;357;11158;11257;6.48;0.39;288.56;10.16;1022;33;3877.00;99
10136;32;624896425;10136;360;11159;11258;6.44;0.39;288.56;10.17;1023;33;3878.00;99
10137;32;624896436;10137;360;11160;11259;6.39;0.39;288.56;10.17;1023;33;3879.00;99
10137;32;624896448;10137;364;11162;11259;6.32;0.38;288.56;10.19;1025;33;3880.00;97
10138;32;624896459;10138;364;11163;11260;6.27;0.38;288.55;10.19;1025;33;3881.00;97
10140;32;624896470;10140;368;11164;11260;6.25;0.38;288.53;10.20;1024;33;3882.00;96
10140;32;624896481;10140;375;11165;11260;6.24;0.38;288.53;10.20;1025;33;3883.00;95
10143;32;624896497;10143;390;11168;11260;6.18;0.38;288.53;10.22;1025;33;3884.00;92
10147;32;624896508;10147;398;11168;11260;6.11;0.37;288.58;10.22;1021;33;3885.00;92
10147;32;624896519;10147;403;11169;11260;6.07;0.37;288.58;10.23;1022;33;3886.00;91
10148;32;624896530;10148;409;11169;11260;6.03;0.37;288.60;10.23;1021;33;3887.00;91
10148;32;624896541;10148;426;11227;11387;6.24;0.39;288.60;10.18;1079;33;3888.00;160
10150;32;624896561;10150;420;11229;11388;6.22;0.39;288.60;10.19;1079;33;3889.00;159
10150;32;624896572;10150;410;11241;11388;6.29;0.39;288.60;10.20;1091;33;3890.00;147
10150;32;624896584;10150;412;11246;11388;6.26;0.39;288.60;10.19;1096;33;3891.00;142
10153;32;624896595;10153;409;11254;11388;6.22;0.39;288.60;10.20;1101;33;3892.00;134
10155;32;624896607;10155;412;11257;11388;6.12;0.38;288.66;10.20;1102;33;3893.00;131
10157;32;624896618;10157;413;11259;11388;6.09;0.38;288.63;10.21;1102;33;3894.00;129
10160;32;624896630;10160;419;11262;11388;6.09;0.38;288.63;10.21;1102;33;3895.00;126
10163;32;624896642;10163;417;11263;11389;6.07;0.37;288.60;10.21;1100;33;3896.00;126
10164;32;624896653;10164;420;11269;11390;6.06;0.37;288.60;10.24;1105;33;3897.00;121
10168;32;624896666;10168;415;11271;11390;5.99;0.37;288.55;10.24;1103;33;3898.00;119
10170;32;624896678;10170;417;11274;11391;5.96;0.37;288.53;10.24;1104;33;3899.00;117
10173;32;624896692;10173;427;11281;11406;5.89;0.36;288.62;10.24;1108;33;3900.00;125
10175;33;624896715;10175;418;11284;11406;5.86;0.36;288.59;10.25;1109;34;3901.00;122
10177;33;624896734;10177;431;11286;11406;5.77;0.36;288.59;10.25;1109;34;3902.00;120
10182;33;624896746;10182;434;11294;11410;5.66;0.35;288.58;10.26;1112;34;3903.00;116
10187;33;624896761;10187;441;11295;11410;5.55;0.34;288.61;10.26;1108;34;3904.00;115
10190;33;624896778;10190;446;11298;11410;5.47;0.34;288.62;10.26;1108;34;3905.00;112
10193;33;624896799;10193;445;11303;11413;5.44;0.34;288.73;10.26;1110;34;3906.00;110
10196;33;624896819;10196;461;11304;11413;5.42;0.33;288.77;10.27;1108;34;3907.00;109
10198;33;624896838;10198;465;11306;11413;5.42;0.33;288.80;10.28;1108;34;3908.00;107
10202;33;624896857;10202;473;11312;11417;5.39;0.33;288.85;10.29;1110;34;3909.00;105
10204;33;624896874;10204;460;11315;11418;5.36;0.33;288.87;10.30;1111;34;3910.00;103
10210;33;624896889;10210;458;11316;11418;5.37;0.33;288.85;10.30;1106;34;3911.00;102
10215;33;624896902;10215;456;11322;11422;5.41;0.33;288.84;10.30;1107;34;3912.00;100
10219;33;624896915;10219;453;11324;11422;5.42;0.33;288.95;10.32;1105;34;3913.00;98
10220;33;624896943;10220;447;11325;11422;5.46;0.33;288.93;10.32;1105;34;3914.00;97
10224;33;624896964;10224;443;11328;11424;5.50;0.34;289.01;10.32;1104;34;3915.00;96
10229;33;624896978;10229;449;11330;11424;5.52;0.34;289.09;10.32;1101;34;3916.00;94
10230;33;624896992;10230;447;11335;11430;5.66;0.35;289.08;10.33;1105;34;3917.00;95
10234;33;624897005;10234;439;11336;11430;5.70;0.35;289.18;10.33;1102;34;3918.00;94
10237;33;624897018;10237;435;11336;11431;5.74;0.35;289.28;10.33;1099;34;3919.00;95
10240;33;624897031;10240;430;11336;11431;5.75;0.35;289.28;10.33;1096;34;3920.00;95
10243;33;624897044;10243;428;11337;11431;5.75;0.35;289.34;10.33;1094;34;3921.00;94
10246;33;624897056;10246;428;11337;11431;5.75;0.35;289.42;10.33;1091;34;3922.00;94
10249;33;624897069;10249;423;11338;11431;5.77;0.35;289.45;10.33;1089;34;3923.00;93
10251;33;624897081;10251;427;11345;11443;5.87;0.36;289.55;10.32;1094;34;3924.00;98
10259;33;624897095;10259;426;11345;11443;5.86;0.36;289.57;10.32;1086;34;3925.00;98
10263;33;624897108;10263;429;11348;11443;5.86;0.36;289.58;10.32;1085;34;3926.00;95
10267;33;624897121;10267;428;11349;11443;5.83;0.36;289.59;10.32;1082;34;3927.00;94
10273;33;624897133;10273;426;11349;11443;5.85;0.36;289.59;10.32;1076;34;3928.00;94
10275;33;624897147;10275;426;11350;11443;5.89;0.36;289.57;10.32;1075;34;3929.00;93
10278;33;624897161;10278;432;11353;11447;5.88;0.36;289.63;10.32;1075;34;3930.00;94
10283;33;624897175;10283;429;11353;11447;5.91;0.36;289.59;10.32;1070;34;3931.00;94
10284;33;624897187;10284;428;11357;11451;5.99;0.36;289.65;10.32;1073;34;3932.00;94
10290;33;624897200;10290;428;11358;11452;5.98;0.36;289.75;10.32;1068;34;3933.00;94
10295;33;624897214;10295;429;11358;11452;5.95;0.36;289.79;10.32;1063;34;3934.00;94
10295;33;624897226;10295;424;11358;11452;5.98;0.36;289.79;10.32;1063;34;3935.00;94
10300;33;624897238;10300;422;11366;11465;6.01;0.37;289.82;10.31;1066;34;3936.00;99
10303;33;624897252;10303;422;11367;11465;6.02;0.37;289.81;10.31;1064;34;3937.00;98
10307;33;624897266;10307;420;11367;11465;5.96;0.36;289.86;10.31;1060;34;3938.00;98
10312;33;624897278;10312;420;11368;11466;5.94;0.36;289.89;10.31;1056;34;3939.00;98
10319;33;624897290;10319;425;11368;11467;5.88;0.36;289.87;10.31;1049;34;3940.00;99
10321;33;624897304;10321;425;11369;11467;5.87;0.36;289.90;10.31;1048;34;3941.00;98
10327;33;624897317;10327;423;11372;11470;5.82;0.35;289.95;10.31;1045;34;3942.00;98
10328;33;624897330;10328;430;11372;11470;5.78;0.35;289.98;10.31;1044;34;3943.00;98
10329;33;624897342;10329;428;11374;11470;5.74;0.35;289.98;10.32;1045;34;3944.00;96
10335;33;624897355;10335;427;11374;11470;5.64;0.34;289.98;10.32;1039;34;3945.00;96
10339;33;624897368;10339;427;11379;11476;5.61;0.34;290.07;10.31;1040;34;3946.00;97
10340;33;624897381;10340;428;11380;11476;5.62;0.34;290.08;10.32;1040;34;3947.00;96
10344;33;624897394;10344;420;11380;11476;5.59;0.34;290.10;10.32;1036;34;3948.00;96
10347;33;624897406;10347;417;11382;11476;5.56;0.34;290.15;10.42;1035;34;3949.00;94
10351;33;624897419;10351;418;11385;11480;5.55;0.34;290.21;10.41;1034;34;3950.00;95
10354;33;624897431;10354;418;11387;11481;5.52;0.34;290.18;10.41;1033;34;3951.00;94
10359;33;624897443;10359;423;11387;11481;5.48;0.33;290.35;10.41;1028;34;3952.00;94
10362;33;624897455;10362;424;11389;11482;5.45;0.33;290.40;10.41;1027;34;3953.00;93
10363;33;624897468;10363;427;11389;11482;5.44;0.33;290.43;10.41;1026;34;3954.00;93
10364;33;624897480;10364;426;11390;11482;5.42;0.33;290.44;10.42;1026;34;3955.00;92
10368;33;624897492;10368;428;11391;11482;5.41;0.33;290.48;10.42;1023;34;3956.00;91
10370;33;624897505;10370;417;11391;11482;5.43;0.33;290.50;10.42;1021;34;3957.00;91
10373;33;624897517;10373;410;11391;11482;5.44;0.33;290.59;10.42;1018;34;3958.00;91
10376;33;624897529;10376;404;11391;11482;5.39;0.33;290.64;10.42;1015;34;3959.00;91
10379;33;624897543;10379;418;11459;11607;5.61;0.35;290.72;10.35;1080;34;3960.00;148
10383;33;624897565;10383;403;11462;11608;5.63;0.35;290.81;10.35;1079;34;3961.00;146
10386;33;624897578;10386;398;11469;11608;5.74;0.36;290.79;10.35;1083;34;3962.00;139
10388;33;624897591;10388;402;11470;11608;5.74;0.36;290.81;10.35;1082;34;3963.00;138
10390;33;624897604;10390;407;11477;11608;5.79;0.36;290.81;10.34;1087;34;3964.00;131
10395;33;624897618;10395;407;11480;11608;5.79;0.36;290.89;10.43;1085;34;3965.00;128
10399;33;624897631;10399;404;11484;11608;5.79;0.36;290.93;10.43;1085;34;3966.00;124
10402;33;624897647;10402;391;11485;11608;5.81;0.36;291.00;10.43;1083;34;3967.00;123
10406;33;624897661;10406;391;11489;11609;5.82;0.36;291.08;10.43;1083;34;3968.00;120
10407;33;624897674;10407;398;11494;11610;5.85;0.36;291.15;10.43;1087;34;3969.00;116
10409;33;624897696;10409;400;11498;11610;5.90;0.36;291.19;10.43;1089;34;3970.00;112
10410;33;624897710;10410;400;11502;11614;5.90;0.36;291.24;10.43;1092;34;3971.00;112
10413;33;624897725;10413;401;11502;11614;5.94;0.37;291.20;10.43;1089;34;3972.00;112
10416;33;624897738;10416;404;11503;11614;5.97;0.37;291.21;10.52;1087;34;3973.00;111
10419;33;624897753;10419;404;11503;11614;6.01;0.37;291.29;10.52;1084;34;3974.00;111
10423;33;624897771;10423;409;11508;11620;6.05;0.37;291.32;10.52;1085;34;3975.00;112
10426;33;624897788;10426;405;11508;11620;6.12;0.38;291.42;10.52;1082;35;3976.00;112
10431;33;624897833;10431;414;11508;11620;6.15;0.38;291.46;10.52;1077;35;3977.00;112
10436;33;624897864;10436;422;11511;11623;6.17;0.38;291.64;10.61;1075;35;3978.00;112
10440;33;624897888;10440;431;11511;11623;6.18;0.38;291.72;10.61;1071;35;3979.00;112
10442;33;624897903;10442;425;11511;11623;6.18;0.38;291.73;10.61;1069;35;3980.00;112
10444;33;624897919;10444;426;11511;11624;6.19;0.38;291.77;10.61;1067;35;3981.00;113
10445;33;624897934;10445;422;11512;11625;6.23;0.38;291.78;10.61;1067;35;3982.00;113
10448;33;624897949;10448;425;11512;11625;6.23;0.38;291.89;10.61;1064;35;3983.00;113
10452;33;624897963;10452;422;11521;11638;6.26;0.38;291.97;10.60;1069;35;3984.00;117
10455;33;624897978;10455;423;11523;11638;6.27;0.38;291.95;10.60;1068;35;3985.00;115
10460;33;624897992;10460;418;11523;11638;6.31;0.38;291.97;10.60;1063;35;3986.00;115
10461;33;624898006;10461;413;11524;11639;6.32;0.38;291.96;10.60;1063;35;3987.00;115
10461;33;624898022;10461;411;11524;11639;6.37;0.39;291.96;10.60;1063;35;3988.00;115
10462;33;624898037;10462;412;11528;11643;6.40;0.39;292.01;10.69;1066;35;3989.00;115
10463;33;624898053;10463;412;11528;11643;6.41;0.39;292.05;10.69;1065;35;3990.00;115
10465;33;624898070;10465;413;11531;11647;6.45;0.39;292.11;10.69;1066;35;3991.00;116
10470;33;624898084;10470;412;11532;11647;6.39;0.39;292.06;10.69;1062;35;3992.00;115
10471;33;624898099;10471;415;11532;11647;6.38;0.39;292.07;10.69;1061;35;3993.00;115
10472;33;624898114;10472;412;11532;11647;6.38;0.39;292.08;10.69;1060;35;3994.00;115
10474;33;624898128;10474;412;11533;11647;6.40;0.39;292.10;10.69;1059;35;3995.00;114
10477;33;624898143;10477;413;11542;11659;6.38;0.39;292.12;10.68;1065;35;3996.00;117
10480;33;624898165;10480;417;11542;11659;6.39;0.39;292.09;10.68;1062;35;3997.00;117
10484;33;624898179;10484;415;11544;11659;6.40;0.39;292.07;10.68;1060;35;3998.00;115
10485;33;624898197;10485;415;11544;11659;6.48;0.39;292.05;10.68;1059;35;3999.00;115
10488;33;624898213;10488;420;11544;11659;6.52;0.40;292.01;10.68;1056;35;4000.00;115
10488;33;624898232;10488;417;11544;11659;6.58;0.40;292.01;10.68;1056;35;4001.00;115
10489;33;624898247;10489;415;11544;11660;6.60;0.40;292.01;10.68;1055;35;4002.00;116
10491;33;624898261;10491;414;11544;11660;6.56;0.40;292.07;10.68;1053;35;4003.00;116
10492;33;624898275;10492;409;11549;11666;6.58;0.40;292.07;10.67;1057;35;4004.00;117
10495;33;624898296;10495;405;11551;11668;6.55;0.40;292.07;10.67;1056;35;4005.00;117
10497;33;624898310;10497;408;11551;11668;6.55;0.40;292.06;10.67;1054;35;4006.00;117
10500;33;624898324;10500;412;11551;11668;6.50;0.39;292.10;10.67;1051;35;4007.00;117
10503;33;624898338;10503;414;11554;11672;6.51;0.39;292.04;10.67;1051;35;4008.00;118
10505;33;624898352;10505;413;11554;11672;6.45;0.39;292.01;10.67;1049;35;4009.00;118
10507;33;624898366;10507;404;11554;11672;6.37;0.39;292.00;10.67;1047;35;4010.00;118
10507;33;624898379;10507;407;11555;11673;6.37;0.39;292.00;10.67;1048;35;4011.00;118
10509;33;624898394;10509;406;11558;11677;6.31;0.38;292.04;10.67;1049;35;4012.00;119
10512;33;624898407;10512;407;11558;11677;6.28;0.38;292.03;10.67;1046;35;4013.00;119
10515;33;624898419;10515;403;11561;11680;6.30;0.38;292.01;10.68;1046;35;4014.00;119
10520;33;624898435;10520;409;11563;11680;6.30;0.38;291.97;10.69;1043;35;4015.00;117
10522;33;624898449;10522;407;11563;11680;6.31;0.38;291.94;10.69;1041;35;4016.00;117
10522;33;624898463;10522;405;11563;11680;6.31;0.38;291.94;10.69;1041;35;4017.00;117
10525;33;624898476;10525;410;11567;11684;6.39;0.39;291.99;10.69;1042;35;4018.00;117
10527;33;624898489;10527;399;11567;11684;6.41;0.39;291.96;10.69;1040;35;4019.00;117
10529;33;624898504;10529;394;11567;11684;6.47;0.39;291.96;10.69;1038;35;4020.00;117
10529;33;624898518;10529;382;11567;11684;6.51;0.39;291.96;10.69;1038;35;4021.00;117
10530;33;624898531;10530;380;11567;11685;6.55;0.40;291.96;10.69;1037;35;4022.00;118
10530;33;624898543;10530;380;11568;11686;6.59;0.40;291.96;10.69;1038;35;4023.00;118
10533;33;624898556;10533;376;11568;11686;6.59;0.40;291.92;10.69;1035;35;4024.00;118
10535;33;624898570;10535;375;11569;11687;6.65;0.40;291.89;10.69;1034;35;4025.00;118
10536;33;624898592;10536;364;11569;11687;6.64;0.40;291.87;10.69;1033;35;4026.00;118
10538;33;624898607;10538;361;11569;11687;6.66;0.40;291.93;10.69;1031;35;4027.00;118
10538;33;624898621;10538;362;11569;11687;6.72;0.41;291.93;10.69;1031;35;4028.00;118
10539;33;624898643;10539;362;11569;11687;6.69;0.41;291.93;10.69;1030;35;4029.00;118
10541;33;624898656;10541;361;11569;11687;6.72;0.41;291.94;10.69;1028;35;4030.00;118
10543;33;624898676;10543;351;11569;11687;6.67;0.40;291.93;10.69;1026;35;4031.00;118
10543;33;624898688;10543;366;11636;11814;6.81;0.42;291.93;10.63;1093;35;4032.00;178
10543;33;624898712;10543;357;11638;11815;6.83;0.42;291.93;10.62;1095;35;4033.00;177
10545;33;624898727;10545;359;11646;11815;6.90;0.42;291.91;10.62;1101;35;4034.00;169
10547;33;624898754;10547;359;11651;11815;6.90;0.42;291.90;10.61;1104;35;4035.00;164
10547;33;624898774;10547;358;11657;11815;6.89;0.42;291.90;10.62;1110;35;4036.00;158
10548;33;624898797;10548;354;11659;11815;6.86;0.42;291.90;10.62;1111;35;4037.00;156
10549;33;624898825;10549;346;11662;11815;6.88;0.42;291.90;10.62;1113;35;4038.00;153
10549;34;624898849;10549;347;11664;11815;6.87;0.42;291.90;10.62;1115;36;4039.00;151
10553;34;624898879;10553;346;11668;11816;6.83;0.42;291.96;10.64;1115;36;4040.00;148
10556;34;624898896;10556;357;11672;11817;6.80;0.42;291.96;10.64;1116;36;4041.00;145
10561;34;624898915;10561;358;11676;11817;6.71;0.41;292.03;10.66;1115;36;4042.00;141
10563;34;624898932;10563;357;11679;11818;6.63;0.41;292.03;10.66;1116;36;4043.00;139
10566;34;624898950;10566;367;11680;11818;6.54;0.40;292.01;10.66;1114;36;4044.00;138
10568;34;624898968;10568;369;11684;11818;6.44;0.40;292.05;10.68;1116;36;4045.00;134
10573;34;624898985;10573;381;11685;11818;6.31;0.39;292.00;10.68;1112;36;4046.00;133
10574;34;624899004;10574;393;11696;11822;6.25;0.38;291.98;10.72;1122;36;4047.00;126
10576;34;624899020;10576;397;11697;11822;6.22;0.38;292.06;10.72;1121;36;4048.00;125
10578;34;624899037;10578;396;11701;11822;6.17;0.38;292.08;10.74;1123;36;4049.00;121
10580;34;624899054;10580;405;11705;11828;6.13;0.38;292.11;10.74;1125;36;4050.00;123
10583;34;624899071;10583;406;11707;11828;6.13;0.38;292.08;10.76;1124;36;4051.00;121
10584;34;624899092;10584;419;11710;11828;6.15;0.38;292.07;10.77;1126;36;4052.00;118
10586;34;624899108;10586;420;11715;11832;6.06;0.37;292.11;10.78;1129;36;4053.00;117
10587;34;624899125;10587;425;11717;11833;6.06;0.37;292.09;10.79;1130;36;4054.00;116
10590;34;624899141;10590;428;11719;11833;5.99;0.37;292.14;10.80;1129;36;4055.00;114
10590;34;624899158;10590;435;11721;11837;6.00;0.37;292.14;10.79;1131;36;4056.00;116
10593;34;624899174;10593;444;11724;11837;5.91;0.36;292.13;10.81;1131;36;4057.00;113
10595;34;624899189;10595;438;11727;11837;5.86;0.36;292.18;10.82;1132;36;4058.00;110
10597;34;624899205;10597;440;11728;11838;5.80;0.36;292.20;10.82;1131;36;4059.00;110
10599;34;624899222;10599;441;11730;11838;5.78;0.36;292.27;10.85;1131;36;4060.00;108
10600;34;624899237;10600;447;11735;11844;5.79;0.36;292.26;10.84;1135;36;4061.00;109
10603;34;624899253;10603;445;11737;11844;5.77;0.35;292.32;10.86;1134;36;4062.00;107
10607;34;624899270;10607;443;11737;11845;5.75;0.35;292.32;10.86;1130;36;4063.00;108
10609;34;624899293;10609;436;11737;11845;5.72;0.35;292.34;10.86;1128;36;4064.00;108
10612;34;624899310;10612;435;11739;11845;5.69;0.35;292.37;10.89;1127;36;4065.00;106
10616;34;624899325;10616;429;11739;11845;5.64;0.34;292.40;10.89;1123;36;4066.00;106
10619;34;624899341;10619;427;11741;11845;5.64;0.34;292.44;10.91;1122;36;4067.00;104
10623;34;624899356;10623;431;11751;11857;5.66;0.35;292.56;10.90;1128;36;4068.00;106
10624;34;624899372;10624;426;11753;11857;5.59;0.34;292.61;10.91;1129;36;4069.00;104
10626;34;624899390;10626;432;11754;11857;5.58;0.34;292.65;10.91;1128;36;4070.00;103
10631;34;624899405;10631;437;11755;11857;5.56;0.34;292.80;10.92;1124;36;4071.00;102
10635;34;624899420;10635;439;11755;11857;5.52;0.34;292.89;10.92;1120;36;4072.00;102
10637;34;624899434;10637;438;11756;11857;5.51;0.34;292.87;10.92;1119;36;4073.00;101
10638;34;624899449;10638;436;11759;11861;5.53;0.34;292.87;10.92;1121;36;4074.00;102
10641;34;624899463;10641;434;11761;11861;5.51;0.34;292.85;10.94;1120;36;4075.00;100
10644;34;624899486;10644;430;11765;11865;5.54;0.34;292.91;10.93;1121;36;4076.00;100
10649;34;624899503;10649;431;11767;11866;5.51;0.34;292.98;10.94;1118;36;4077.00;99
10656;34;624899522;10656;430;11768;11866;5.44;0.33;293.08;10.94;1112;36;4078.00;98
10659;34;624899538;10659;429;11768;11866;5.41;0.33;293.13;10.94;1109;36;4079.00;98
10665;34;624899556;10665;436;11792;11895;5.39;0.33;293.18;10.94;1127;36;4080.00;103
10670;34;624899576;10670;432;11792;11895;5.36;0.33;293.19;10.94;1122;36;4081.00;103
10673;34;624899594;10673;436;11795;11895;5.40;0.33;293.23;10.94;1122;36;4082.00;100
10677;34;624899608;10677;439;11798;11896;5.47;0.33;293.25;10.94;1121;36;4083.00;98
10679;34;624899623;10679;435;11798;11897;5.52;0.34;293.29;10.94;1119;36;4084.00;99
10682;34;624899639;10682;442;11798;11897;5.56;0.34;293.37;10.94;1116;36;4085.00;99
10687;34;624899657;10687;445;11803;11900;5.62;0.34;293.39;10.95;1116;36;4086.00;97
10690;34;624899673;10690;440;11803;11900;5.72;0.35;293.45;10.95;1113;36;4087.00;97
10694;34;624899689;10694;432;11803;11900;5.75;0.35;293.46;10.95;1109;36;4088.00;97
10698;34;624899706;10698;430;11803;11900;5.79;0.35;293.48;10.95;1105;36;4089.00;97
10701;34;624899721;10701;430;11808;11906;5.86;0.36;293.54;10.95;1107;36;4090.00;98
10709;34;624899739;10709;424;11808;11906;5.82;0.35;293.59;10.95;1099;36;4091.00;98
10710;34;624899753;10710;418;11808;11906;5.86;0.36;293.60;10.95;1098;36;4092.00;98
10715;34;624899770;10715;414;11808;11906;5.90;0.36;293.66;10.95;1093;36;4093.00;98
10720;34;624899785;10720;412;11811;11910;5.91;0.36;293.76;10.95;1091;36;4094.00;99
10723;34;624899800;10723;412;11813;11912;5.97;0.36;293.75;10.94;1090;36;4095.00;99
10727;34;624899815;10727;408;11813;11912;5.98;0.36;293.83;10.94;1086;36;4096.00;99
10732;34;624899830;10732;406;11814;11913;6.00;0.37;293.92;10.94;1082;36;4097.00;99
10737;34;624899844;10737;406;11815;11913;5.93;0.36;293.93;11.05;1078;36;4098.00;98
10739;34;624899860;10739;408;11815;11913;5.96;0.36;293.98;11.05;1076;36;4099.00;98
10744;34;624899876;10744;407;11815;11913;5.92;0.36;293.98;11.05;1071;36;4100.00;98
10748;34;624899895;10748;406;11815;11913;5.89;0.36;294.08;11.05;1067;36;4101.00;98
10755;34;624899908;10755;413;11815;11913;5.84;0.36;294.19;11.05;1060;36;4102.00;98
10760;34;624899929;10760;413;11815;11913;5.83;0.35;294.19;11.05;1055;36;4103.00;98
10763;34;624899945;10763;421;11848;11983;5.81;0.35;294.27;11.02;1085;36;4104.00;135
10766;34;624899968;10766;419;11849;11984;5.78;0.35;294.30;11.01;1083;36;4105.00;135
10770;34;624899982;10770;416;11854;11984;5.81;0.35;294.35;11.01;1084;36;4106.00;130
10772;34;624899996;10772;424;11854;11984;5.80;0.35;294.39;11.01;1082;36;4107.00;130
10775;34;624900016;10775;424;11857;11984;5.81;0.35;294.40;11.01;1082;36;4108.00;127
10779;34;624900035;10779;420;11860;11984;5.83;0.36;294.44;11.01;1081;36;4109.00;124
10781;34;624900054;10781;417;11863;11984;5.81;0.35;294.51;11.01;1082;36;4110.00;121
10784;34;624900067;10784;412;11866;11984;5.79;0.35;294.57;11.01;1082;36;4111.00;118
10791;34;624900081;10791;422;11867;11985;5.73;0.35;294.58;11.00;1076;36;4112.00;118
10795;34;624900101;10795;421;11870;11986;5.63;0.34;294.63;11.00;1075;36;4113.00;116
10797;34;624900113;10797;432;11875;11986;5.58;0.34;294.62;11.11;1078;36;4114.00;111
10800;34;624900127;10800;432;11879;11990;5.56;0.34;294.65;11.10;1079;36;4115.00;111
10804;34;624900141;10804;430;11880;11990;5.56;0.34;294.70;11.10;1076;36;4116.00;110
10806;34;624900155;10806;434;11881;11990;5.58;0.34;294.70;11.10;1075;36;4117.00;109
10808;34;624900169;10808;431;11881;11990;5.54;0.34;294.71;11.10;1073;36;4118.00;109
10813;34;624900183;10813;433;11886;11996;5.56;0.34;294.72;11.10;1073;36;4119.00;110
10819;34;624900200;10819;437;11888;11996;5.50;0.34;294.71;11.10;1069;36;4120.00;108
10823;34;624900223;10823;440;11888;11996;5.48;0.34;294.79;11.10;1065;36;4121.00;108
10826;34;624900241;10826;440;11891;11999;5.48;0.34;294.78;11.10;1065;36;4122.00;108
10828;34;624900256;10828;449;11892;11999;5.49;0.34;294.82;11.10;1064;36;4123.00;107
10830;34;624900269;10830;452;11894;11999;5.43;0.33;294.86;11.10;1064;36;4124.00;105
10831;34;624900284;10831;454;11894;12000;5.38;0.33;294.86;11.10;1063;36;4125.00;106
10833;34;624900299;10833;464;11896;12001;5.34;0.33;294.91;11.20;1063;36;4126.00;105
10840;34;624900313;10840;457;11897;12001;5.26;0.32;295.04;11.20;1057;36;4127.00;104
10846;34;624900328;10846;458;11907;12014;5.26;0.32;295.06;11.19;1061;36;4128.00;107
10850;34;624900344;10850;460;11908;12014;5.24;0.32;295.06;11.19;1058;36;4129.00;106
10852;34;624900359;10852;460;11908;12014;5.24;0.32;295.11;11.19;1056;36;4130.00;106
10855;34;624900372;10855;460;11909;12015;5.21;0.32;295.11;11.19;1054;36;4131.00;106
10857;34;624900386;10857;464;11909;12015;5.21;0.32;295.16;11.19;1052;36;4132.00;106
10860;34;624900399;10860;470;11913;12019;5.24;0.32;295.22;11.18;1053;36;4133.00;106
10862;34;624900416;10862;474;11913;12019;5.25;0.32;295.20;11.18;1051;36;4134.00;106
10865;34;624900430;10865;477;11916;12023;5.22;0.32;295.28;11.18;1051;36;4135.00;107
10865;34;624900445;10865;475;11916;12023;5.20;0.32;295.28;11.18;1051;36;4136.00;107
10871;34;624900458;10871;469;11916;12023;5.23;0.32;295.28;11.18;1045;36;4137.00;107
10872;34;624900473;10872;466;11916;12023;5.27;0.32;295.27;11.18;1044;36;4138.00;107
10874;34;624900487;10874;462;11916;12023;5.33;0.33;295.27;11.18;1042;36;4139.00;107
10875;34;624900504;10875;463;11941;12057;5.47;0.34;295.27;11.16;1066;36;4140.00;116
10876;34;624900519;10876;460;11941;12057;5.51;0.34;295.24;11.16;1065;36;4141.00;116
10877;34;624900534;10877;463;11944;12057;5.62;0.35;295.26;11.15;1067;36;4142.00;113
10879;34;624900549;10879;459;11944;12057;5.63;0.35;295.29;11.15;1065;36;4143.00;113
10881;34;624900565;10881;465;11945;12057;5.74;0.35;295.30;11.15;1064;36;4144.00;112
10883;34;624900579;10883;462;11945;12057;5.80;0.36;295.33;11.15;1062;36;4145.00;112
10885;34;624900593;10885;463;11945;12058;5.89;0.36;295.37;11.15;1060;36;4146.00;113
10890;34;624900609;10890;466;11945;12058;5.87;0.36;295.39;11.15;1055;36;4147.00;113
10894;34;624900624;10894;464;11950;12064;5.88;0.36;295.34;11.15;1056;36;4148.00;114
10894;34;624900641;10894;464;11951;12065;5.91;0.36;295.34;11.15;1057;36;4149.00;114
10894;34;624900657;10894;465;11951;12065;5.92;0.36;295.34;11.15;1057;36;4150.00;114
10897;34;624900671;10897;461;11951;12065;5.91;0.36;295.40;11.15;1054;36;4151.00;114
10899;34;624900685;10899;465;11954;12069;5.94;0.36;295.39;11.15;1055;36;4152.00;115
10900;34;624900700;10900;464;11954;12069;5.93;0.36;295.38;11.15;1054;36;4153.00;115
10901;34;624900714;10901;463;11955;12069;5.91;0.36;295.39;11.24;1054;36;4154.00;114
10904;34;624900732;10904;465;11956;12070;5.90;0.36;295.43;11.24;1052;36;4155.00;114
10906;34;624900749;10906;469;11959;12074;5.86;0.36;295.42;11.24;1053;36;4156.00;115
10910;34;624900767;10910;465;11959;12074;5.81;0.36;295.36;11.24;1049;36;4157.00;115
10913;34;624900788;10913;470;11961;12077;5.84;0.36;295.38;11.23;1048;36;4158.00;116
10914;34;624900812;10914;463;11961;12077;5.86;0.36;295.42;11.23;1047;36;4159.00;116
10915;34;624900843;10915;457;11962;12077;5.93;0.36;295.40;11.23;1047;36;4160.00;115
10918;34;624900870;10918;451;11962;12077;5.92;0.36;295.38;11.23;1044;36;4161.00;115
10920;34;624900892;10920;451;11966;12081;5.95;0.36;295.42;11.23;1046;36;4162.00;115
10921;34;624900909;10921;453;11966;12081;5.94;0.36;295.41;11.23;1045;36;4163.00;115
10921;34;624900926;10921;445;11966;12081;5.90;0.36;295.41;11.23;1045;36;4164.00;115
10923;34;624900942;10923;441;11966;12081;5.94;0.36;295.39;11.23;1043;36;4165.00;115
10926;34;624900958;10926;440;11966;12082;5.93;0.36;295.36;11.23;1040;36;4166.00;116
10928;34;624900981;10928;435;11967;12083;5.95;0.36;295.36;11.23;1039;36;4167.00;116
10929;34;624900997;10929;436;11967;12083;5.95;0.36;295.36;11.23;1038;36;4168.00;116
10930;34;624901011;10930;432;11968;12084;5.98;0.36;295.36;11.23;1038;36;4169.00;116
10933;34;624901034;10933;428;11968;12084;5.98;0.36;295.37;11.23;1035;36;4170.00;116
10933;34;624901050;10933;413;11968;12084;6.05;0.37;295.37;11.23;1035;36;4171.00;116
10934;34;624901068;10934;408;11968;12084;6.14;0.37;295.37;11.23;1034;36;4172.00;116
10936;34;624901093;10936;404;11970;12086;6.15;0.37;295.36;11.23;1034;36;4173.00;116
10940;34;624901110;10940;400;11970;12086;6.16;0.37;295.45;11.23;1030;36;4174.00;116
10942;34;624901136;10942;399;11971;12086;6.19;0.37;295.50;11.32;1029;36;4175.00;115
10943;34;624901153;10943;416;12039;12213;6.37;0.39;295.49;11.26;1096;36;4176.00;174
10943;34;624901183;10943;404;12040;12214;6.46;0.40;295.49;11.26;1097;36;4177.00;174
10945;34;624901200;10945;394;12047;12214;6.58;0.40;295.50;11.25;1102;36;4178.00;167
10948;34;624901227;10948;386;12049;12214;6.62;0.41;295.47;11.25;1101;36;4179.00;165
10950;34;624901244;10950;381;12053;12214;6.67;0.41;295.46;11.25;1103;36;4180.00;161
10951;34;624901261;10951;373;12058;12214;6.69;0.41;295.45;11.25;1107;36;4181.00;156
10953;34;624901286;10953;365;12059;12214;6.75;0.41;295.45;11.24;1106;36;4182.00;155
10954;34;624901300;10954;349;12065;12214;6.76;0.41;295.44;11.24;1111;36;4183.00;149
10955;34;624901317;10955;350;12068;12215;6.78;0.41;295.43;11.24;1113;36;4184.00;147
10956;34;624901338;10956;350;12071;12217;6.79;0.41;295.43;11.27;1115;36;4185.00;146
10957;34;624901360;10957;349;12074;12217;6.84;0.42;295.43;11.27;1117;36;4186.00;143
10958;34;624901377;10958;347;12075;12218;6.82;0.42;295.46;11.27;1117;36;4187.00;143
10959;34;624901395;10959;347;12078;12218;6.85;0.42;295.47;11.27;1119;36;4188.00;140
10961;34;624901413;10961;347;12081;12218;6.81;0.42;295.44;11.27;1120;36;4189.00;137
10963;34;624901431;10963;351;12082;12218;6.79;0.42;295.43;11.27;1119;36;4190.00;136
10965;34;624901445;10965;357;12085;12222;6.81;0.42;295.45;11.36;1120;36;4191.00;137
10969;34;624901460;10969;357;12087;12222;6.80;0.41;295.47;11.36;1118;36;4192.00;135
10970;34;624901474;10970;355;12088;12222;6.81;0.42;295.50;11.36;1118;36;4193.00;134
10974;34;624901488;10974;356;12090;12225;6.83;0.42;295.47;11.36;1116;36;4194.00;135
10978;34;624901502;10978;357;12091;12225;6.78;0.41;295.49;11.36;1113;36;4195.00;134
10980;34;624901516;10980;352;12092;12225;6.80;0.41;295.47;11.36;1112;36;4196.00;133
10982;34;624901536;10982;357;12097;12229;6.73;0.41;295.46;11.45;1115;36;4197.00;132
10985;34;624901550;10985;359;12099;12230;6.70;0.41;295.49;11.45;1114;36;4198.00;131
10989;34;624901563;10989;358;12100;12230;6.67;0.41;295.53;11.45;1111;36;4199.00;130
10991;34;624901579;10991;364;12109;12264;6.69;0.41;295.48;11.44;1118;36;4200.00;155
10993;34;624901601;10993;362;12114;12264;6.67;0.41;295.50;11.44;1121;36;4201.00;150
10995;34;624901616;10995;362;12116;12264;6.68;0.41;295.56;11.44;1121;36;4202.00;148
10997;34;624901629;10997;360;12119;12265;6.65;0.41;295.54;11.44;1122;36;4203.00;146
10999;34;624901644;10999;367;12119;12265;6.62;0.40;295.53;11.44;1120;36;4204.00;146
11000;34;624901657;11000;369;12124;12271;6.67;0.41;295.54;11.44;1124;36;4205.00;147
11002;34;624901671;11002;370;12127;12271;6.66;0.41;295.61;11.44;1125;36;4206.00;144
11004;34;624901684;11004;373;12128;12272;6.62;0.41;295.67;11.44;1124;36;4207.00;144
11007;34;624901698;11007;379;12129;12272;6.60;0.40;295.73;11.44;1122;36;4208.00;143
11010;34;624901719;11010;380;12129;12272;6.56;0.40;295.79;11.44;1119;36;4209.00;143
11012;34;624901732;11012;391;12131;12272;6.49;0.40;295.80;11.47;1119;36;4210.00;141
11014;34;624901745;11014;400;12132;12272;6.47;0.40;295.83;11.47;1118;36;4211.00;140
11018;34;624901758;11018;401;12143;12284;6.44;0.39;295.87;11.47;1125;36;4212.00;141
11020;34;624901774;11020;406;12144;12284;6.40;0.39;295.91;11.48;1124;36;4213.00;140
11026;34;624901795;11026;411;12147;12284;6.36;0.39;295.93;11.48;1121;36;4214.00;137
11028;34;624901808;11028;412;12148;12284;6.32;0.39;295.98;11.49;1120;36;4215.00;136
11029;34;624901822;11029;413;12149;12284;6.29;0.39;295.98;11.50;1120;36;4216.00;135
11033;34;624901834;11033;415;12150;12284;6.22;0.38;295.98;11.50;1117;36;4217.00;134
11036;34;624901847;11036;423;12156;12288;6.21;0.38;296.01;11.52;1120;36;4218.00;132
11039;34;624901860;11039;426;12157;12288;6.14;0.38;296.05;11.54;1118;36;4219.00;131
11042;34;624901872;11042;431;12162;12292;6.12;0.37;296.04;11.54;1120;36;4220.00;130
11045;34;624901885;11045;432;12163;12293;6.09;0.37;296.02;11.54;1118;36;4221.00;130
11046;34;624901897;11046;439;12165;12293;6.05;0.37;296.07;11.56;1119;36;4222.00;128
11050;34;624901910;11050;442;12166;12293;5.98;0.37;296.05;11.56;1116;36;4223.00;127
11054;34;624901923;11054;454;12179;12306;5.96;0.36;296.07;11.57;1125;36;4224.00;127
11057;34;624901937;11057;452;12180;12306;5.92;0.36;296.10;11.58;1123;36;4225.00;126
11058;34;624901949;11058;456;12183;12306;5.91;0.36;296.14;11.59;1125;36;4226.00;123
11058;34;624901961;11058;457;12184;12307;5.90;0.36;296.14;11.59;1126;36;4227.00;123
11062;34;624901974;11062;464;12186;12308;5.83;0.36;296.21;11.61;1124;36;4228.00;122
11062;34;624901987;11062;455;12186;12308;5.85;0.36;296.21;11.61;1124;36;4229.00;122
11065;34;624902000;11065;458;12192;12314;5.81;0.36;296.25;11.62;1127;36;4230.00;122
11069;34;624902014;11069;450;12192;12314;5.79;0.35;296.31;11.62;1123;36;4231.00;122
11071;34;624902026;11071;451;12197;12314;5.78;0.35;296.32;11.65;1126;36;4232.00;117
11071;34;624902038;11071;451;12197;12314;5.78;0.35;296.32;11.65;1126;36;4233.00;117
11075;34;624902050;11075;452;12202;12320;5.76;0.35;296.40;11.65;1127;36;4234.00;118
11076;34;624902063;11076;461;12204;12320;5.71;0.35;296.38;11.66;1128;36;4235.00;116
11078;34;624902076;11078;458;12205;12320;5.72;0.35;296.37;11.66;1127;36;4236.00;115
11081;34;624902088;11081;459;12206;12320;5.71;0.35;296.40;11.66;1125;36;4237.00;114
11084;34;624902106;11084;459;12211;12324;5.69;0.35;296.46;11.67;1127;36;4238.00;113
11086;34;624902119;11086;460;12212;12325;5.68;0.35;296.44;11.67;1126;36;4239.00;113
11088;34;624902131;11088;467;12213;12325;5.66;0.35;296.47;11.68;1125;36;4240.00;112
11093;34;624902143;11093;462;12215;12326;5.64;0.35;296.46;11.68;1122;36;4241.00;111
11095;34;624902156;11095;465;12215;12326;5.60;0.34;296.44;11.68;1120;36;4242.00;111
11099;34;624902168;11099;469;12215;12326;5.54;0.34;296.44;11.68;1116;36;4243.00;111
11102;34;624902184;11102;457;12219;12326;5.49;0.34;296.44;11.73;1117;36;4244.00;107
11105;34;624902196;11105;456;12219;12326;5.42;0.33;296.40;11.73;1114;36;4245.00;107
11107;34;624902207;11107;456;12220;12326;5.34;0.33;296.40;11.73;1113;36;4246.00;106
11113;34;624902219;11113;455;12222;12326;5.20;0.32;296.45;11.75;1109;36;4247.00;104
11115;34;624902231;11115;457;12265;12396;5.23;0.32;296.44;11.70;1150;36;4248.00;131
11118;34;624902248;11118;454;12269;12397;5.16;0.32;296.49;11.71;1151;36;4249.00;128
11122;34;624902260;11122;429;12273;12397;5.13;0.32;296.59;11.71;1151;36;4250.00;124
11126;34;624902272;11126;433;12274;12397;5.12;0.32;296.64;11.72;1148;36;4251.00;123
11131;34;624902284;11131;425;12277;12397;5.08;0.31;296.68;11.72;1146;36;4252.00;120
11135;34;624902296;11135;427;12282;12397;5.11;0.32;296.71;11.73;1147;36;4253.00;115
11139;34;624902308;11139;421;12285;12397;5.13;0.32;296.76;11.73;1146;36;4254.00;112
11143;34;624902320;11143;414;12291;12397;5.13;0.32;296.84;11.74;1148;36;4255.00;106
11144;34;624902332;11144;414;12293;12398;5.17;0.32;296.85;11.74;1149;36;4256.00;105
11149;34;624902344;11149;404;12295;12399;5.20;0.32;296.90;11.75;1146;36;4257.00;104
11153;34;624902356;11153;405;12295;12399;5.24;0.32;297.01;11.75;1142;36;4258.00;104
11157;34;624902368;11157;403;12297;12403;5.30;0.33;297.08;11.75;1140;36;4259.00;106
11162;34;624902383;11162;399;12298;12403;5.38;0.33;297.13;11.75;1136;36;4260.00;105
11167;34;624902395;11167;398;12298;12403;5.46;0.34;297.23;11.75;1131;36;4261.00;105
11171;34;624902407;11171;389;12299;12403;5.52;0.34;297.25;11.75;1128;36;4262.00;104
11177;34;624902420;11177;388;12305;12409;5.56;0.34;297.29;11.84;1128;36;4263.00;104
11179;34;624902433;11179;389;12306;12409;5.63;0.34;297.29;11.84;1127;36;4264.00;103
11180;34;624902446;11180;383;12307;12409;5.69;0.35;297.28;11.84;1127;36;4265.00;102
11182;34;624902458;11182;381;12309;12412;5.77;0.35;297.33;11.83;1127;36;4266.00;103
11184;34;624902471;11184;385;12310;12412;5.82;0.36;297.37;11.83;1126;36;4267.00;102
11189;34;624902483;11189;390;12311;12412;5.79;0.35;297.47;11.83;1122;36;4268.00;101
11193;34;624902495;11193;393;12311;12413;5.77;0.35;297.49;11.83;1118;36;4269.00;102
11196;34;624902507;11196;392;12313;12414;5.77;0.35;297.59;11.83;1117;36;4270.00;101
11200;34;624902520;11200;399;12313;12414;5.67;0.35;297.65;11.83;1113;36;4271.00;101
11203;34;624902532;11203;401;12323;12427;5.68;0.35;297.65;11.82;1120;36;4272.00;104
11210;34;624902545;11210;397;12324;12427;5.57;0.34;297.64;11.82;1114;36;4273.00;103
11214;34;624902558;11214;398;12324;12427;5.52;0.34;297.67;11.82;1110;36;4274.00;103
11216;34;624902570;11216;405;12326;12429;5.57;0.34;297.69;11.82;1110;36;4275.00;103
11223;34;624902582;11223;402;12326;12429;5.53;0.34;297.78;11.82;1103;36;4276.00;103
11227;34;624902596;11227;406;12330;12433;5.55;0.34;297.78;11.82;1103;36;4277.00;103
11231;34;624902608;11231;413;12330;12433;5.49;0.33;297.79;11.82;1099;36;4278.00;103
11237;34;624902621;11237;419;12333;12437;5.42;0.33;297.86;11.81;1096;36;4279.00;104
11239;34;624902633;11239;415;12333;12437;5.40;0.33;297.87;11.81;1094;36;4280.00;104
11244;34;624902645;11244;424;12333;12437;5.34;0.32;297.88;11.81;1089;36;4281.00;104
11246;34;624902657;11246;428;12333;12437;5.30;0.32;297.92;11.81;1087;36;4282.00;104
11250;34;624902668;11250;431;12333;12437;5.18;0.31;297.96;11.81;1083;36;4283.00;104
11255;34;624902680;11255;432;12342;12449;5.17;0.31;297.99;11.81;1087;36;4284.00;107
11257;34;624902692;11257;434;12342;12449;5.09;0.31;298.05;11.81;1085;36;4285.00;107
11262;34;624902703;11262;439;12344;12449;5.02;0.31;298.04;11.80;1082;36;4286.00;105
11265;34;624902714;11265;441;12345;12449;5.00;0.30;298.03;11.90;1080;36;4287.00;104
11270;34;624902727;11270;439;12345;12449;4.97;0.30;298.13;11.90;1075;36;4288.00;104
11274;34;624902738;11274;441;12345;12449;4.93;0.30;298.15;11.90;1071;36;4289.00;104
11278;34;624902750;11278;439;12345;12450;4.83;0.30;298.18;11.90;1067;36;4290.00;105
11282;34;624902762;11282;443;12345;12450;4.77;0.29;298.13;11.90;1063;36;4291.00;105
11284;34;624902779;11284;450;12350;12456;4.74;0.29;298.10;11.89;1066;36;4292.00;106
11287;34;624902800;11287;455;12351;12457;4.69;0.29;298.15;11.89;1064;36;4293.00;106
11289;34;624902818;11289;461;12351;12457;4.63;0.28;298.16;11.89;1062;36;4294.00;106
11296;34;624902835;11296;471;12351;12457;4.50;0.28;298.19;11.89;1055;36;4295.00;106
11296;34;624902853;11296;475;12354;12461;4.49;0.27;298.19;11.89;1058;36;4296.00;107
11297;34;624902871;11297;459;12354;12461;4.50;0.28;298.23;11.89;1057;36;4297.00;107
11298;34;624902886;11298;462;12354;12461;4.55;0.28;298.22;11.89;1056;36;4298.00;107
11302;34;624902898;11302;467;12355;12462;4.56;0.28;298.27;11.89;1053;36;4299.00;107
11304;34;624902912;11304;464;12358;12466;4.62;0.28;298.22;11.89;1054;36;4300.00;108
11306;34;624902929;11306;471;12358;12466;4.62;0.28;298.19;11.89;1052;36;4301.00;108
11309;34;624902943;11309;467;12360;12469;4.64;0.29;298.16;11.88;1051;36;4302.00;109
11312;34;624902956;11312;471;12360;12469;4.60;0.28;298.21;11.88;1048;36;4303.00;109
11313;34;624902969;11313;471;12361;12469;4.62;0.28;298.19;11.88;1048;36;4304.00;108
11318;34;624902982;11318;476;12361;12469;4.59;0.28;298.14;11.88;1043;36;4305.00;108
11320;35;624902994;11320;462;12365;12473;4.70;0.29;298.11;11.88;1045;37;4306.00;108
11321;35;624903021;11321;453;12365;12473;4.77;0.29;298.10;11.88;1044;37;4307.00;108
11323;35;624903034;11323;433;12365;12473;4.82;0.30;298.07;11.88;1042;37;4308.00;108
11325;35;624903047;11325;425;12365;12473;4.93;0.30;298.06;11.88;1040;37;4309.00;108
11330;35;624903059;11330;426;12365;12474;4.94;0.30;298.08;11.88;1035;37;4310.00;109
11332;35;624903072;11332;424;12367;12475;5.02;0.31;298.10;11.98;1035;37;4311.00;108
11335;35;624903085;11335;415;12367;12475;5.06;0.31;298.10;11.98;1032;37;4312.00;108
11335;35;624903098;11335;410;12368;12476;5.13;0.31;298.10;11.98;1033;37;4313.00;108
11337;35;624903110;11337;410;12369;12476;5.23;0.32;298.11;12.08;1032;37;4314.00;107
11337;35;624903123;11337;405;12369;12476;5.37;0.33;298.11;12.08;1032;37;4315.00;107
11338;35;624903135;11338;402;12369;12476;5.48;0.33;298.11;12.08;1031;37;4316.00;107
11340;35;624903148;11340;398;12369;12476;5.59;0.34;298.11;12.08;1029;37;4317.00;107
11343;35;624903168;11343;389;12369;12476;5.75;0.35;298.08;12.08;1026;37;4318.00;107
11345;35;624903180;11345;389;12369;12476;5.85;0.35;298.07;12.08;1024;37;4319.00;107
11346;35;624903195;11346;441;12489;12706;6.09;0.38;298.08;11.96;1143;37;4320.00;217
11348;35;624903225;11348;427;12491;12707;6.19;0.39;298.12;11.96;1143;37;4321.00;216
11350;35;624903239;11350;421;12500;12707;6.28;0.39;298.12;11.95;1150;37;4322.00;207
11352;35;624903253;11352;398;12505;12707;6.34;0.39;298.14;11.95;1153;37;4323.00;202
11355;35;624903267;11355;386;12512;12707;6.43;0.40;298.16;11.95;1157;37;4324.00;195
11357;35;624903281;11357;373;12516;12707;6.47;0.40;298.27;11.94;1159;37;4325.00;191
11359;35;624903295;11359;365;12523;12707;6.51;0.40;298.26;11.94;1164;37;4326.00;184
11359;35;624903308;11359;354;12528;12707;6.56;0.40;298.26;11.94;1169;37;4327.00;179
11360;35;624903322;11360;350;12532;12708;6.59;0.41;298.25;11.94;1172;37;4328.00;176
11360;35;624903337;11360;352;12536;12709;6.64;0.41;298.25;11.94;1176;37;4329.00;173
11360;35;624903351;11360;341;12541;12709;6.67;0.41;298.25;11.94;1181;37;4330.00;168
11361;35;624903365;11361;343;12542;12710;6.65;0.41;298.25;11.93;1181;37;4331.00;168
11361;35;624903379;11361;347;12545;12710;6.62;0.41;298.25;11.93;1184;37;4332.00;165
11363;35;624903402;11363;349;12545;12710;6.62;0.41;298.25;11.93;1182;37;4333.00;165
11364;35;624903417;11364;351;12547;12710;6.57;0.40;298.25;11.94;1183;37;4334.00;163
11364;35;624903431;11364;356;12549;12714;6.55;0.40;298.25;11.93;1185;37;4335.00;165
11364;35;624903446;11364;357;12549;12714;6.52;0.40;298.25;11.93;1185;37;4336.00;165
11366;35;624903461;11366;352;12551;12714;6.48;0.40;298.26;11.93;1185;37;4337.00;163
11367;35;624903476;11367;356;12552;12717;6.49;0.40;298.27;11.93;1185;37;4338.00;165
11368;35;624903490;11368;347;12552;12717;6.47;0.39;298.27;11.93;1184;37;4339.00;165
11370;35;624903504;11370;332;12553;12717;6.51;0.40;298.26;11.93;1183;37;4340.00;164
11371;35;624903520;11371;331;12558;12721;6.56;0.40;298.26;12.02;1187;37;4341.00;163
11371;35;624903554;11371;329;12559;12722;6.64;0.41;298.26;12.02;1188;37;4342.00;163
11372;35;624903575;11372;331;12559;12722;6.67;0.41;298.26;12.02;1187;37;4343.00;163
11376;35;624903607;11376;329;12561;12726;6.69;0.41;298.29;12.02;1185;37;4344.00;165
11377;35;624903638;11377;330;12561;12726;6.73;0.41;298.28;12.02;1184;37;4345.00;165
11381;35;624903660;11381;334;12562;12726;6.73;0.41;298.32;12.02;1181;37;4346.00;164
11384;35;624903692;11384;336;12562;12727;6.71;0.41;298.31;12.02;1178;37;4347.00;165
11388;35;624903713;11388;324;12563;12727;6.70;0.41;298.36;12.02;1175;37;4348.00;164
11391;35;624903736;11391;331;12567;12733;6.68;0.41;298.40;12.02;1176;37;4349.00;166
11394;35;624903759;11394;325;12567;12733;6.70;0.41;298.36;12.02;1173;37;4350.00;166
11395;35;624903778;11395;325;12568;12734;6.68;0.41;298.37;12.02;1173;37;4351.00;166
11397;35;624903794;11397;321;12569;12734;6.65;0.40;298.41;12.02;1172;37;4352.00;165
11399;35;624903811;11399;323;12572;12734;6.57;0.40;298.47;12.03;1173;37;4353.00;162
11401;35;624903824;11401;322;12573;12734;6.56;0.40;298.47;12.04;1172;37;4354.00;161
11405;35;624903841;11405;319;12575;12734;6.54;0.40;298.46;12.06;1170;37;4355.00;159
11407;35;624903855;11407;322;12583;12746;6.62;0.40;298.50;12.05;1176;37;4356.00;163
11412;35;624903870;11412;321;12584;12746;6.60;0.40;298.50;12.05;1172;37;4357.00;162
11414;35;624903884;11414;321;12586;12746;6.62;0.40;298.49;12.05;1172;37;4358.00;160
11417;35;624903899;11417;315;12586;12746;6.61;0.40;298.58;12.05;1169;37;4359.00;160
11418;35;624903913;11418;318;12587;12746;6.62;0.40;298.56;12.05;1169;37;4360.00;159
11421;35;624903927;11421;315;12588;12746;6.64;0.40;298.58;12.05;1167;37;4361.00;158
11425;35;624903940;11425;316;12591;12750;6.67;0.41;298.59;12.05;1166;37;4362.00;159
11428;35;624903955;11428;314;12592;12750;6.68;0.41;298.64;12.05;1164;37;4363.00;158
11431;35;624903969;11431;313;12596;12754;6.77;0.41;298.67;12.05;1165;37;4364.00;158
11434;35;624903983;11434;307;12598;12756;6.79;0.41;298.71;12.05;1164;37;4365.00;158
11435;35;624903997;11435;311;12598;12756;6.79;0.41;298.70;12.05;1163;37;4366.00;158
11437;35;624904011;11437;316;12602;12756;6.78;0.41;298.71;12.05;1165;37;4367.00;154
11439;35;624904025;11439;321;12612;12769;6.74;0.41;298.75;12.05;1173;37;4368.00;157
11441;35;624904041;11441;322;12612;12769;6.72;0.41;298.79;12.05;1171;37;4369.00;157
11441;35;624904065;11441;331;12613;12769;6.71;0.41;298.79;12.05;1172;37;4370.00;156
11442;35;624904081;11442;332;12615;12770;6.72;0.41;298.80;12.05;1173;37;4371.00;155
11444;35;624904096;11444;343;12617;12771;6.68;0.41;298.84;12.06;1173;37;4372.00;154
11446;35;624904112;11446;350;12619;12771;6.66;0.41;298.87;12.06;1173;37;4373.00;152
11449;35;624904127;11449;354;12622;12774;6.68;0.41;298.90;12.06;1173;37;4374.00;152
11452;35;624904141;11452;356;12623;12774;6.66;0.41;298.91;12.06;1171;37;4375.00;151
11455;35;624904155;11455;358;12624;12774;6.62;0.40;298.91;12.07;1169;37;4376.00;150
11457;35;624904169;11457;360;12624;12774;6.62;0.40;298.96;12.07;1167;37;4377.00;150
11459;35;624904183;11459;361;12630;12780;6.62;0.40;298.96;12.07;1171;37;4378.00;150
11462;35;624904197;11462;360;12631;12780;6.56;0.40;298.99;12.07;1169;37;4379.00;149
11466;35;624904212;11466;374;12632;12780;6.47;0.40;299.03;12.09;1166;37;4380.00;148
11468;35;624904226;11468;378;12633;12780;6.42;0.39;299.05;12.09;1165;37;4381.00;147
11472;35;624904240;11472;379;12637;12784;6.39;0.39;299.02;12.09;1165;37;4382.00;147
11475;35;624904254;11475;377;12640;12785;6.37;0.39;299.13;12.11;1165;37;4383.00;145
11478;35;624904269;11478;375;12640;12785;6.37;0.39;299.14;12.11;1162;37;4384.00;145
11481;35;624904282;11481;381;12644;12786;6.36;0.39;299.16;12.14;1163;37;4385.00;142
11487;35;624904296;11487;377;12645;12786;6.33;0.39;299.26;12.14;1158;37;4386.00;141
11491;35;624904310;11491;384;12645;12786;6.30;0.39;299.32;12.14;1154;37;4387.00;141
11496;35;624904323;11496;381;12648;12786;6.27;0.38;299.34;12.16;1152;37;4388.00;138
11503;35;624904337;11503;381;12649;12786;6.20;0.38;299.42;12.17;1146;37;4389.00;137
11503;35;624904350;11503;385;12650;12786;6.17;0.38;299.42;12.17;1147;37;4390.00;136
11508;35;624904363;11508;390;12653;12786;6.09;0.37;299.46;12.19;1145;37;4391.00;133
11511;35;624904376;11511;400;12690;12856;6.11;0.37;299.53;12.16;1179;37;4392.00;166
11511;35;624904395;11511;407;12693;12857;6.10;0.37;299.53;12.16;1182;37;4393.00;164
11512;35;624904409;11512;405;12701;12857;6.13;0.38;299.56;12.18;1189;37;4394.00;156
11518;35;624904422;11518;411;12703;12857;6.12;0.37;299.55;12.18;1185;37;4395.00;154
11518;35;624904436;11518;412;12708;12857;6.14;0.38;299.55;12.19;1190;37;4396.00;149
11521;35;624904449;11521;409;12708;12857;6.11;0.37;299.59;12.19;1187;37;4397.00;149
11525;35;624904462;11525;419;12714;12857;6.10;0.37;299.63;12.20;1189;37;4398.00;143
11528;35;624904476;11528;408;12717;12857;6.12;0.37;299.66;12.20;1189;37;4399.00;140
11531;35;624904490;11531;405;12720;12858;6.13;0.37;299.68;12.21;1189;37;4400.00;138
11534;35;624904508;11534;394;12723;12859;6.16;0.38;299.71;12.21;1189;37;4401.00;136
11537;35;624904522;11537;394;12726;12859;6.16;0.38;299.70;12.24;1189;37;4402.00;133
11537;35;624904536;11537;397;12728;12863;6.15;0.38;299.70;12.24;1191;37;4403.00;135
11539;35;624904550;11539;396;12728;12863;6.12;0.37;299.68;12.24;1189;37;4404.00;135
11540;35;624904565;11540;404;12731;12863;6.15;0.38;299.67;12.28;1191;37;4405.00;132
11543;35;624904579;11543;406;12731;12863;6.18;0.38;299.74;12.28;1188;37;4406.00;132
11545;35;624904594;11545;413;12736;12869;6.25;0.38;299.80;12.27;1191;37;4407.00;133
11548;35;624904608;11548;421;12737;12869;6.28;0.38;299.82;12.28;1189;37;4408.00;132
11553;35;624904622;11553;416;12737;12869;6.26;0.38;299.90;12.28;1184;37;4409.00;132
11559;35;624904639;11559;414;12741;12875;6.23;0.38;299.93;12.29;1182;37;4410.00;134
11562;35;624904653;11562;413;12741;12875;6.20;0.38;299.94;12.29;1179;37;4411.00;134
11563;35;624904666;11563;409;12746;12875;6.20;0.38;299.98;12.34;1183;37;4412.00;129
11568;35;624904680;11568;415;12746;12876;6.12;0.37;300.07;12.34;1178;37;4413.00;130
11571;35;624904694;11571;414;12749;12877;6.06;0.37;300.13;12.36;1178;37;4414.00;128
11574;35;624904707;11574;413;12749;12877;5.97;0.36;300.09;12.36;1175;37;4415.00;128
11579;35;624904720;11579;414;12758;12890;5.84;0.36;300.16;12.35;1179;37;4416.00;132
11582;35;624904735;11582;406;12761;12890;5.73;0.35;300.22;12.37;1179;37;4417.00;129
11585;35;624904748;11585;409;12762;12890;5.55;0.34;300.23;12.37;1177;37;4418.00;128
11588;35;624904760;11588;416;12762;12891;5.45;0.33;300.24;12.37;1174;37;4419.00;129
11591;35;624904778;11591;407;12764;12891;5.35;0.33;300.29;12.39;1173;37;4420.00;127
11593;35;624904799;11593;406;12768;12895;5.32;0.33;300.30;12.38;1175;37;4421.00;127
11597;35;624904819;11597;402;12770;12895;5.29;0.32;300.30;12.40;1173;37;4422.00;125
11598;35;624904839;11598;401;12773;12899;5.31;0.32;300.31;12.40;1175;37;4423.00;126
11601;35;624904857;11601;402;12774;12899;5.33;0.33;300.35;12.40;1173;37;4424.00;125
11605;35;624904875;11605;391;12776;12899;5.37;0.33;300.46;12.42;1171;37;4425.00;123
11607;35;624904891;11607;390;12779;12899;5.39;0.33;300.50;12.42;1172;37;4426.00;120
11612;35;624904905;11612;390;12779;12899;5.44;0.33;300.58;12.42;1167;37;4427.00;120
11616;35;624904920;11616;386;12790;12911;5.52;0.34;300.68;12.43;1174;37;4428.00;121
11620;35;624904935;11620;378;12792;12911;5.54;0.34;300.69;12.43;1172;37;4429.00;119
11624;35;624904949;11624;370;12793;12911;5.58;0.34;300.74;12.43;1169;37;4430.00;118
11627;35;624904963;11627;371;12793;12911;5.63;0.34;300.78;12.43;1166;37;4431.00;118
11630;35;624904977;11630;367;12794;12911;5.68;0.35;300.81;12.43;1164;37;4432.00;117
11633;35;624904991;11633;369;12796;12911;5.71;0.35;300.84;12.43;1163;37;4433.00;115
11636;35;624905008;11636;370;12797;12912;5.74;0.35;300.90;12.43;1161;37;4434.00;115
11641;35;624905033;11641;365;12798;12912;5.75;0.35;300.99;12.43;1157;37;4435.00;114
11645;35;624905051;11645;376;12802;12918;5.80;0.35;300.97;12.42;1157;37;4436.00;116
11651;35;624905070;11651;372;12803;12919;5.75;0.35;301.03;12.42;1152;37;4437.00;116
11655;35;624905086;11655;377;12804;12919;5.78;0.35;301.04;12.42;1149;37;4438.00;115
11661;35;624905101;11661;381;12805;12919;5.76;0.35;301.07;12.42;1144;37;4439.00;114
11665;35;624905119;11665;382;12809;12924;5.75;0.35;301.06;12.42;1144;37;4440.00;115
11668;35;624905135;11668;393;12809;12924;5.72;0.35;301.11;12.42;1141;37;4441.00;115
11672;35;624905149;11672;395;12809;12924;5.68;0.35;301.07;12.42;1137;37;4442.00;115
11677;35;624905163;11677;399;12810;12925;5.60;0.34;301.07;12.42;1133;37;4443.00;115
11679;35;624905177;11679;397;12813;12929;5.59;0.34;301.08;12.42;1134;37;4444.00;116
11684;35;624905191;11684;400;12813;12929;5.51;0.34;301.03;12.42;1129;37;4445.00;116
11689;35;624905206;11689;410;12815;12932;5.44;0.33;301.07;12.41;1126;37;4446.00;117
11690;35;624905221;11690;412;12815;12932;5.43;0.33;301.08;12.41;1125;37;4447.00;117
11694;35;624905235;11694;415;12816;12932;5.42;0.33;301.08;12.41;1122;37;4448.00;116
11701;35;624905250;11701;414;12816;12932;5.35;0.33;301.13;12.41;1115;37;4449.00;116
11705;35;624905264;11705;417;12820;12936;5.38;0.33;301.11;12.41;1115;37;4450.00;116
11711;35;624905279;11711;419;12820;12936;5.29;0.32;301.15;12.41;1109;37;4451.00;116
11715;35;624905292;11715;416;12820;12936;5.24;0.32;301.15;12.41;1105;37;4452.00;116
11719;35;624905306;11719;422;12820;12936;5.13;0.31;301.13;12.41;1101;37;4453.00;116
11724;35;624905319;11724;422;12820;12937;5.08;0.31;301.11;12.41;1096;37;4454.00;117
11728;35;624905333;11728;429;12822;12939;5.02;0.31;301.10;12.41;1094;37;4455.00;117
11730;35;624905347;11730;428;12822;12939;4.99;0.31;301.11;12.41;1092;37;4456.00;117
11734;35;624905359;11734;439;12823;12940;4.94;0.30;301.13;12.41;1089;37;4457.00;117
11739;35;624905372;11739;435;12823;12940;4.91;0.30;301.25;12.41;1084;37;4458.00;117
11747;35;624905386;11747;439;12823;12940;4.86;0.30;301.27;12.41;1076;37;4459.00;117
11750;35;624905399;11750;445;12823;12940;4.81;0.30;301.26;12.41;1073;37;4460.00;117
11755;35;624905413;11755;448;12823;12940;4.73;0.29;301.29;12.41;1068;37;4461.00;117
11758;35;624905426;11758;453;12823;12940;4.65;0.29;301.27;12.41;1065;37;4462.00;117
11760;35;624905439;11760;457;12823;12940;4.63;0.29;301.26;12.41;1063;37;4463.00;117
11766;35;624905452;11766;466;12889;13067;4.97;0.31;301.18;12.34;1123;37;4464.00;178
11770;35;624905478;11770;466;12893;13068;4.98;0.31;301.20;12.34;1123;37;4465.00;175
11771;35;624905491;11771;466;12901;13068;5.07;0.32;301.18;12.33;1130;37;4466.00;167
11771;35;624905503;11771;453;12904;13068;5.10;0.32;301.18;12.33;1133;37;4467.00;164
11773;35;624905516;11773;445;12910;13068;5.13;0.32;301.16;12.43;1137;37;4468.00;158
11777;35;624905531;11777;441;12912;13068;5.09;0.32;301.14;12.43;1135;37;4469.00;156
11781;35;624905547;11781;438;12915;13068;5.08;0.31;301.13;12.42;1134;37;4470.00;153
11784;35;624905569;11784;442;12919;13068;5.03;0.31;301.09;12.42;1135;37;4471.00;149
11786;35;624905583;11786;439;12922;13069;4.96;0.31;301.08;12.42;1136;37;4472.00;147
11788;35;624905596;11788;447;12926;13070;4.88;0.30;301.07;12.42;1138;37;4473.00;144
11788;35;624905609;11788;455;12929;13070;4.83;0.30;301.07;12.42;1141;37;4474.00;141
11790;35;624905623;11790;460;12931;13071;4.82;0.30;301.06;12.42;1141;37;4475.00;140
11790;35;624905636;11790;433;12932;13071;4.88;0.30;301.06;12.42;1142;37;4476.00;139
11792;35;624905650;11792;425;12932;13071;4.97;0.31;301.05;12.42;1140;37;4477.00;139
11795;35;624905664;11795;411;12937;13071;5.09;0.31;301.06;12.42;1142;37;4478.00;134
11797;35;624905678;11797;393;12940;13075;5.24;0.32;301.05;12.42;1143;37;4479.00;135
11799;35;624905693;11799;390;12942;13075;5.40;0.33;301.03;12.42;1143;37;4480.00;133
11799;35;624905707;11799;380;12943;13075;5.59;0.34;301.03;12.42;1144;37;4481.00;132
11800;35;624905722;11800;372;12945;13078;5.78;0.35;301.03;12.42;1145;37;4482.00;133
11802;35;624905737;11802;368;12946;13078;5.95;0.36;301.02;12.42;1144;37;4483.00;132
11804;35;624905767;11804;362;12948;13078;6.08;0.37;301.01;12.51;1144;37;4484.00;130
11804;35;624905790;11804;360;12951;13082;6.18;0.38;301.01;12.51;1147;37;4485.00;131
11806;35;624905813;11806;353;12954;13083;6.24;0.38;301.02;12.51;1148;37;4486.00;129
11808;35;624905828;11808;351;12954;13083;6.25;0.38;300.99;12.51;1146;37;4487.00;129
11809;35;624905842;11809;349;12958;13087;6.30;0.38;301.01;12.51;1149;37;4488.00;129
11812;35;624905856;11812;351;12958;13087;6.35;0.39;301.00;12.51;1146;37;4489.00;129
11814;35;624905871;11814;350;12959;13087;6.41;0.39;301.00;12.51;1145;37;4490.00;128
11816;35;624905885;11816;342;12960;13088;6.52;0.39;301.01;12.51;1144;37;4491.00;128
11818;35;624905899;11818;335;12960;13088;6.59;0.40;301.05;12.51;1142;37;4492.00;128
11819;35;624905913;11819;329;12965;13094;6.66;0.40;301.04;12.50;1146;37;4493.00;129
11821;35;624905928;11821;323;12965;13094;6.71;0.41;301.03;12.50;1144;37;4494.00;129
11821;35;624905943;11821;317;12965;13095;6.77;0.41;301.03;12.50;1144;37;4495.00;130
11821;35;624905956;11821;314;12965;13095;6.82;0.41;301.03;12.50;1144;37;4496.00;130
11822;35;624905971;11822;306;12965;13095;6.85;0.42;301.02;12.50;1143;37;4497.00;130
11824;35;624905985;11824;304;12965;13095;6.89;0.42;301.05;12.50;1141;37;4498.00;130
11827;35;624905999;11827;299;12965;13095;6.93;0.42;301.09;12.50;1138;37;4499.00;130
11829;35;624906018;11829;297;12991;13145;7.04;0.43;301.08;12.48;1162;37;4500.00;154
11832;35;624906040;11832;294;12991;13147;7.04;0.43;301.12;12.48;1159;37;4501.00;156
11832;35;624906055;11832;296;12995;13147;7.12;0.43;301.12;12.47;1163;37;4502.00;152
11834;35;624906070;11834;293;12996;13147;7.19;0.44;301.16;12.57;1162;37;4503.00;151
11834;35;624906085;11834;286;12998;13147;7.24;0.44;301.16;12.57;1164;37;4504.00;149
11836;35;624906100;11836;289;12999;13147;7.23;0.44;301.22;12.57;1163;37;4505.00;148
11837;35;624906115;11837;290;13003;13151;7.26;0.44;301.27;12.56;1166;37;4506.00;148
11840;35;624906129;11840;290;13003;13151;7.28;0.44;301.33;12.56;1163;37;4507.00;148
11843;35;624906144;11843;286;13007;13155;7.30;0.44;301.44;12.56;1164;37;4508.00;148
11845;35;624906159;11845;288;13008;13156;7.32;0.44;301.49;12.56;1163;37;4509.00;148
11846;35;624906173;11846;291;13008;13156;7.35;0.45;301.51;12.56;1162;37;4510.00;148
11848;35;624906188;11848;286;13008;13156;7.30;0.44;301.49;12.56;1160;37;4511.00;148
11850;35;624906202;11850;287;13019;13169;7.33;0.44;301.52;12.55;1169;37;4512.00;150
11853;35;624906218;11853;284;13019;13169;7.35;0.45;301.52;12.55;1166;37;4513.00;150
11854;35;624906233;11854;290;13020;13169;7.41;0.45;301.51;12.55;1166;37;4514.00;149
11855;35;624906248;11855;286;13021;13170;7.45;0.45;301.50;12.55;1166;37;4515.00;149
11857;35;624906263;11857;291;13021;13171;7.43;0.45;301.59;12.55;1164;37;4516.00;150
11860;35;624906278;11860;292;13021;13171;7.39;0.45;301.69;12.55;1161;37;4517.00;150
11862;35;624906293;11862;291;13024;13174;7.36;0.45;301.67;12.55;1162;37;4518.00;150
11868;35;624906307;11868;288;13024;13174;7.30;0.44;301.78;12.55;1156;37;4519.00;150
11871;35;624906322;11871;284;13027;13174;7.29;0.44;301.79;12.65;1156;37;4520.00;147
11875;35;624906337;11875;282;13027;13174;7.29;0.44;301.73;12.65;1152;37;4521.00;147
11878;35;624906351;11878;281;13031;13180;7.32;0.44;301.78;12.64;1153;37;4522.00;149
11881;35;624906367;11881;283;13031;13180;7.34;0.45;301.76;12.64;1150;37;4523.00;149
11883;35;624906381;11883;276;13032;13180;7.38;0.45;301.79;12.64;1149;37;4524.00;148
11885;35;624906395;11885;273;13034;13180;7.36;0.45;301.81;12.67;1149;37;4525.00;146
11887;35;624906411;11887;271;13038;13184;7.31;0.44;301.78;12.67;1151;37;4526.00;146
11887;35;624906425;11887;272;13039;13185;7.31;0.44;301.78;12.67;1152;37;4527.00;146
11891;35;624906439;11891;274;13039;13185;7.27;0.44;301.85;12.67;1148;37;4528.00;146
11895;35;624906458;11895;273;13040;13186;7.26;0.44;301.80;12.67;1145;37;4529.00;146
11897;35;624906475;11897;273;13041;13186;7.22;0.44;301.81;12.67;1144;37;4530.00;145
11897;35;624906489;11897;277;13041;13186;7.28;0.44;301.81;12.67;1144;37;4531.00;145
11903;35;624906509;11903;283;13042;13186;7.26;0.44;301.80;12.67;1139;37;4532.00;144
11906;35;624906523;11906;289;13042;13186;7.24;0.44;301.88;12.67;1136;37;4533.00;144
11910;35;624906536;11910;293;13042;13186;7.23;0.44;301.93;12.67;1132;37;4534.00;144
11915;35;624906556;11915;299;13042;13186;7.22;0.44;301.96;12.67;1127;37;4535.00;144
11917;35;624906569;11917;307;13076;13256;7.27;0.44;301.97;12.64;1159;37;4536.00;180
11920;35;624906589;11920;304;13080;13257;7.25;0.44;301.98;12.64;1160;37;4537.00;177
11923;35;624906604;11923;313;13084;13257;7.24;0.44;301.99;12.64;1161;37;4538.00;173
11924;35;624906618;11924;314;13087;13257;7.18;0.44;302.06;12.64;1163;37;4539.00;170
11925;35;624906637;11925;312;13090;13257;7.16;0.44;302.05;12.64;1165;37;4540.00;167
11927;35;624906651;11927;312;13098;13257;7.19;0.44;302.02;12.63;1171;37;4541.00;159
11929;35;624906666;11929;314;13102;13257;7.17;0.44;302.05;12.63;1173;37;4542.00;155
11932;35;624906680;11932;315;13105;13257;7.14;0.43;302.08;12.63;1173;37;4543.00;152
11936;35;624906700;11936;314;13110;13258;7.11;0.43;302.26;12.63;1174;37;4544.00;148
11939;35;624906714;11939;317;13113;13260;7.07;0.43;302.30;12.63;1174;37;4545.00;147
11942;35;624906728;11942;315;13116;13260;7.05;0.43;302.29;12.63;1174;37;4546.00;144
11946;35;624906742;11946;312;13119;13264;7.00;0.43;302.30;12.63;1173;37;4547.00;145
11949;35;624906756;11949;316;13120;13264;6.91;0.42;302.32;12.62;1171;37;4548.00;144
11952;35;624906771;11952;307;13120;13264;6.86;0.42;302.35;12.62;1168;37;4549.00;144
11955;35;624906792;11955;315;13122;13264;6.77;0.41;302.44;12.65;1167;37;4550.00;142
11958;35;624906829;11958;317;13127;13270;6.72;0.41;302.44;12.64;1169;37;4551.00;143
11961;35;624906848;11961;329;13128;13270;6.71;0.41;302.51;12.66;1167;37;4552.00;142
11966;35;624906868;11966;335;13129;13270;6.64;0.40;302.56;12.67;1163;37;4553.00;141
11969;35;624906891;11969;338;13132;13273;6.61;0.40;302.58;12.66;1163;37;4554.00;141
11972;35;624906908;11972;342;13133;13273;6.59;0.40;302.53;12.68;1161;37;4555.00;140
11976;35;624906923;11976;341;13134;13273;6.52;0.40;302.53;12.68;1158;37;4556.00;139
11977;35;624906939;11977;347;13135;13274;6.48;0.39;302.58;12.70;1158;37;4557.00;139
11980;35;624906953;11980;344;13137;13275;6.48;0.40;302.68;12.70;1157;37;4558.00;138
11985;35;624906970;11985;351;13137;13275;6.41;0.39;302.70;12.70;1152;37;4559.00;138
11986;35;624906988;11986;353;13154;13301;6.41;0.39;302.71;12.70;1168;37;4560.00;147
11989;35;624907004;11989;359;13156;13301;6.42;0.39;302.79;12.70;1167;37;4561.00;145
11992;35;624907019;11992;357;13159;13301;6.39;0.39;302.80;12.70;1167;37;4562.00;142
11994;35;624907033;11994;361;13163;13302;6.41;0.39;302.76;12.73;1169;37;4563.00;139
11996;35;624907047;11996;368;13164;13302;6.37;0.39;302.79;12.73;1168;37;4564.00;138
11999;35;624907061;11999;370;13168;13306;6.32;0.38;302.89;12.73;1169;37;4565.00;138
12001;35;624907075;12001;377;13169;13306;6.19;0.38;302.92;12.74;1168;37;4566.00;137
12005;35;624907089;12005;387;13173;13310;6.05;0.37;302.99;12.74;1168;37;4567.00;137
12006;35;624907103;12006;392;13174;13310;5.96;0.36;302.98;12.76;1168;37;4568.00;136
12010;35;624907116;12010;392;13176;13310;5.87;0.36;303.08;12.76;1166;37;4569.00;134
12011;35;624907130;12011;390;13177;13310;5.83;0.35;303.14;12.77;1166;37;4570.00;133
12014;35;624907142;12014;398;13178;13310;5.77;0.35;303.22;12.78;1164;37;4571.00;132
12017;35;624907155;12017;401;13189;13322;5.80;0.35;303.22;12.78;1172;37;4572.00;133
12018;35;624907170;12018;406;13189;13322;5.77;0.35;303.24;12.78;1171;37;4573.00;133
12019;35;624907183;12019;401;13192;13322;5.77;0.35;303.21;12.79;1173;37;4574.00;130
12023;35;624907196;12023;409;13194;13322;5.72;0.35;303.23;12.82;1171;37;4575.00;128
12023;35;624907209;12023;409;13195;13322;5.69;0.35;303.23;12.83;1172;37;4576.00;127
12026;35;624907222;12026;408;13195;13322;5.68;0.35;303.30;12.83;1169;37;4577.00;127
12029;35;624907235;12029;415;13195;13323;5.62;0.34;303.28;12.83;1166;37;4578.00;128
12029;35;624907249;12029;419;13196;13323;5.59;0.34;303.28;12.84;1167;37;4579.00;127
12031;35;624907268;12031;422;13204;13329;5.63;0.34;303.28;12.87;1173;37;4580.00;125
12034;35;624907288;12034;430;13205;13330;5.47;0.33;303.39;12.87;1171;37;4581.00;125
12035;35;624907301;12035;435;13207;13330;5.39;0.33;303.37;12.88;1172;37;4582.00;123
12038;35;624907315;12038;441;13207;13330;5.28;0.32;303.45;12.88;1169;37;4583.00;123
12042;35;624907328;12042;435;13210;13334;5.18;0.32;303.47;12.87;1168;37;4584.00;124
12045;35;624907341;12045;437;13211;13334;5.05;0.31;303.47;12.88;1166;37;4585.00;123
12049;35;624907353;12049;439;13212;13334;4.92;0.30;303.52;12.89;1163;37;4586.00;122
12050;35;624907364;12050;430;13213;13335;4.82;0.29;303.53;12.89;1163;37;4587.00;122
12055;35;624907377;12055;439;13217;13339;4.66;0.28;303.61;12.90;1162;37;4588.00;122
12057;35;624907389;12057;447;13218;13339;4.56;0.28;303.68;12.91;1161;37;4589.00;121
12061;35;624907402;12061;450;13222;13345;4.49;0.28;303.72;12.90;1161;37;4590.00;123
12063;35;624907415;12063;451;13224;13345;4.45;0.27;303.72;12.91;1161;37;4591.00;121
12068;35;624907426;12068;445;13226;13345;4.43;0.27;303.85;12.92;1158;37;4592.00;119
12070;35;624907438;12070;446;13227;13345;4.43;0.27;303.83;12.93;1157;37;4593.00;118
12074;35;624907450;12074;446;13232;13349;4.47;0.27;303.81;12.93;1158;37;4594.00;117
12077;35;624907462;12077;453;13233;13349;4.48;0.27;303.80;12.94;1156;37;4595.00;116
12081;35;624907475;12081;450;13234;13349;4.45;0.27;303.80;12.95;1153;37;4596.00;115
12085;35;624907487;12085;446;13234;13349;4.44;0.27;303.84;12.95;1149;37;4597.00;115
12089;35;624907499;12089;445;13235;13350;4.46;0.27;303.85;12.96;1146;37;4598.00;115
12093;35;624907511;12093;443;13236;13351;4.46;0.27;303.91;12.96;1143;37;4599.00;115
12096;35;624907525;12096;439;13236;13351;4.47;0.27;303.93;12.96;1140;37;4600.00;115
12097;35;624907542;12097;434;13237;13352;4.51;0.28;303.91;12.95;1140;37;4601.00;115
12100;35;624907555;12100;443;13237;13352;4.54;0.28;303.90;12.95;1137;37;4602.00;115
12105;35;624907566;12105;450;13237;13352;4.52;0.28;303.89;12.95;1132;37;4603.00;115
12109;35;624907578;12109;451;13237;13352;4.52;0.28;303.85;12.95;1128;37;4604.00;115
12115;35;624907591;12115;448;13237;13352;4.48;0.27;303.82;12.95;1122;37;4605.00;115
12120;35;624907603;12120;441;13237;13352;4.47;0.27;303.80;12.95;1117;37;4606.00;115
12122;35;624907616;12122;442;13237;13352;4.52;0.28;303.80;12.95;1115;37;4607.00;115
12125;35;624907627;12125;441;13302;13479;5.00;0.31;303.78;12.89;1177;37;4608.00;177
12128;35;624907650;12128;440;13305;13480;5.00;0.31;303.81;12.89;1177;37;4609.00;175
12131;35;624907663;12131;432;13317;13480;5.07;0.31;303.81;12.98;1186;37;4610.00;163
12135;35;624907679;12135;430;13320;13480;5.05;0.31;303.81;12.98;1185;37;4611.00;160
12136;35;624907692;12136;430;13327;13480;5.09;0.32;303.82;12.98;1191;37;4612.00;153
12139;35;624907705;12139;437;13330;13480;5.06;0.31;303.80;12.97;1191;37;4613.00;150
12143;35;624907718;12143;438;13332;13480;5.01;0.31;303.79;12.97;1189;37;4614.00;148
12145;35;624907732;12145;446;13334;13480;5.00;0.31;303.75;12.97;1189;37;4615.00;146
12151;35;624907745;12151;451;13336;13481;4.98;0.31;303.80;12.97;1185;37;4616.00;145
12155;35;624907759;12155;452;13341;13482;4.93;0.30;303.76;12.97;1186;37;4617.00;141
12157;35;624907775;12157;457;13343;13482;4.90;0.30;303.75;12.97;1186;37;4618.00;139
12160;35;624907789;12160;459;13345;13483;4.86;0.30;303.80;12.97;1185;37;4619.00;138
12164;35;624907804;12164;463;13347;13483;4.77;0.30;303.77;12.97;1183;37;4620.00;136
12167;35;624907825;12167;472;13349;13483;4.72;0.29;303.73;12.97;1182;37;4621.00;134
12170;35;624907838;12170;482;13351;13483;4.64;0.29;303.74;12.97;1181;37;4622.00;132
12172;35;624907851;12172;490;13356;13487;4.58;0.28;303.74;12.96;1184;37;4623.00;131
12175;35;624907863;12175;494;13357;13487;4.50;0.28;303.72;12.96;1182;37;4624.00;130
12177;35;624907875;12177;494;13357;13487;4.41;0.27;303.71;12.96;1180;37;4625.00;130
12180;35;624907888;12180;498;13359;13490;4.34;0.27;303.68;12.96;1179;37;4626.00;131
12183;35;624907900;12183;493;13360;13490;4.31;0.27;303.69;13.07;1177;37;4627.00;130
12183;35;624907913;12183;491;13361;13490;4.34;0.27;303.69;13.07;1178;37;4628.00;129
12186;35;624907925;12186;485;13366;13494;4.40;0.27;303.67;13.06;1180;37;4629.00;128
12189;35;624907938;12189;484;13368;13495;4.42;0.27;303.67;13.06;1179;37;4630.00;127
12191;35;624907951;12191;472;13369;13495;4.50;0.28;303.67;13.06;1178;37;4631.00;126
12193;35;624907964;12193;469;13371;13499;4.55;0.28;303.66;13.06;1178;37;4632.00;128
12197;35;624907978;12197;463;13372;13499;4.54;0.28;303.64;13.06;1175;37;4633.00;127
12200;35;624907991;12200;470;13373;13499;4.57;0.28;303.61;13.06;1173;37;4634.00;126
12202;35;624908009;12202;471;13375;13501;4.55;0.28;303.60;13.06;1173;37;4635.00;126
12206;35;624908022;12206;464;13375;13501;4.48;0.28;303.57;13.06;1169;37;4636.00;126
12210;35;624908035;12210;459;13380;13507;4.47;0.28;303.51;13.05;1170;37;4637.00;127
12213;35;624908053;12213;444;13380;13507;4.48;0.28;303.49;13.05;1167;37;4638.00;127
12219;35;624908066;12219;428;13380;13508;4.48;0.28;303.48;13.05;1161;37;4639.00;128
12223;35;624908079;12223;422;13381;13508;4.53;0.28;303.46;13.16;1158;37;4640.00;127
12226;35;624908093;12226;415;13381;13508;4.60;0.28;303.48;13.16;1155;37;4641.00;127
12227;35;624908106;12227;409;13381;13508;4.69;0.29;303.48;13.16;1154;37;4642.00;127
12229;35;624908120;12229;406;13381;13508;4.80;0.29;303.48;13.16;1152;37;4643.00;127
12231;35;624908134;12231;403;13391;13520;5.04;0.31;303.47;13.15;1160;37;4644.00;129
12234;35;624908148;12234;404;13392;13520;5.17;0.32;303.48;13.15;1158;37;4645.00;128
12235;35;624908169;12235;391;13392;13520;5.29;0.32;303.50;13.15;1157;37;4646.00;128
12238;35;624908183;12238;377;13392;13520;5.37;0.33;303.47;13.15;1154;37;4647.00;128
12241;35;624908198;12241;364;13392;13520;5.47;0.33;303.45;13.15;1151;37;4648.00;128
12244;35;624908213;12244;353;13392;13520;5.53;0.34;303.46;13.15;1148;37;4649.00;128
12246;35;624908229;12246;348;13397;13526;5.69;0.35;303.48;13.14;1151;37;4650.00;129
12248;35;624908243;12248;343;13397;13526;5.79;0.35;303.49;13.14;1149;37;4651.00;129
12251;35;624908258;12251;332;13401;13530;5.92;0.36;303.52;13.14;1150;37;4652.00;129
12254;35;624908273;12254;331;13402;13531;6.03;0.37;303.60;13.14;1148;37;4653.00;129
12255;35;624908288;12255;331;13402;13531;6.12;0.37;303.62;13.14;1147;37;4654.00;129
12260;35;624908302;12260;329;13402;13531;6.21;0.38;303.71;13.14;1142;37;4655.00;129
12264;35;624908316;12264;330;13413;13544;6.36;0.39;303.71;13.13;1149;37;4656.00;131
12265;35;624908331;12265;325;13413;13544;6.48;0.39;303.70;13.13;1148;37;4657.00;131
12268;35;624908345;12268;318;13413;13544;6.52;0.39;303.78;13.13;1145;37;4658.00;131
12269;35;624908359;12269;314;13414;13545;6.65;0.40;303.78;13.13;1145;37;4659.00;131
12272;35;624908374;12272;310;13414;13546;6.65;0.40;303.81;13.13;1142;37;4660.00;132
12274;35;624908395;12274;312;13414;13546;6.66;0.40;303.82;13.13;1140;37;4661.00;132
12275;35;624908410;12275;312;13416;13549;6.68;0.40;303.86;13.12;1141;37;4662.00;133
12278;35;624908424;12278;310;13416;13549;6.70;0.41;303.92;13.12;1138;37;4663.00;133
12278;35;624908438;12278;311;13417;13549;6.78;0.41;303.92;13.12;1139;37;4664.00;132
12281;35;624908452;12281;314;13417;13549;6.78;0.41;303.97;13.12;1136;37;4665.00;132
12284;35;624908468;12284;318;13422;13555;6.82;0.41;304.02;13.12;1138;37;4666.00;133
12286;35;624908484;12286;311;13422;13555;6.83;0.41;304.03;13.12;1136;37;4667.00;133
12288;35;624908498;12288;306;13422;13555;6.86;0.42;304.10;13.12;1134;37;4668.00;133
12290;35;624908512;12290;309;13422;13555;6.91;0.42;304.10;13.12;1132;37;4669.00;133
12291;35;624908527;12291;313;13425;13559;6.91;0.42;304.16;13.12;1134;37;4670.00;134
12294;35;624908541;12294;305;13426;13560;6.98;0.42;304.22;13.12;1132;37;4671.00;134
12298;35;624908555;12298;303;13426;13560;7.01;0.42;304.35;13.12;1128;37;4672.00;134
12301;35;624908570;12301;307;13427;13561;7.01;0.42;304.41;13.11;1126;37;4673.00;134
12304;35;624908584;12304;307;13427;13561;7.05;0.43;304.43;13.11;1123;37;4674.00;134
12306;35;624908599;12306;307;13427;13561;7.07;0.43;304.49;13.11;1121;37;4675.00;134
12310;35;624908612;12310;297;13427;13561;7.09;0.43;304.57;13.11;1117;37;4676.00;134
12315;35;624908627;12315;302;13427;13561;7.11;0.43;304.69;13.11;1112;37;4677.00;134
12316;35;624908642;12316;300;13427;13561;7.15;0.43;304.71;13.11;1111;37;4678.00;134
12319;35;624908656;12319;292;13427;13561;7.18;0.43;304.81;13.11;1108;37;4679.00;134
12323;35;624908671;12323;314;13491;13686;7.20;0.44;304.89;13.05;1168;37;4680.00;195
12325;35;624908694;12325;303;13491;13687;7.27;0.44;304.87;13.05;1166;37;4681.00;196
12327;35;624908711;12327;291;13499;13687;7.38;0.45;304.93;13.05;1172;37;4682.00;188
12329;35;624908729;12329;283;13501;13687;7.40;0.45;305.01;13.04;1172;37;4683.00;186
12332;35;624908746;12332;285;13506;13687;7.40;0.45;305.00;13.04;1174;37;4684.00;181
12333;35;624908761;12333;295;13506;13687;7.40;0.45;305.04;13.04;1173;37;4685.00;181
12335;35;624908780;12335;294;13512;13687;7.42;0.45;305.06;13.04;1177;37;4686.00;175
12339;35;624908802;12339;303;13514;13687;7.38;0.45;305.11;13.04;1175;37;4687.00;173
12344;35;624908834;12344;314;13519;13688;7.33;0.45;305.17;13.04;1175;37;4688.00;169
12348;35;624908857;12348;314;13522;13689;7.27;0.44;305.17;13.03;1174;37;4689.00;167
12353;35;624908879;12353;310;13526;13689;7.19;0.44;305.19;13.03;1173;37;4690.00;163
12356;35;624908898;12356;309;13531;13693;7.09;0.43;305.20;13.03;1175;37;4691.00;162
12361;35;624908914;12361;312;13533;13693;7.03;0.43;305.20;13.14;1172;37;4692.00;160
12362;35;624908930;12362;318;13535;13693;6.94;0.42;305.21;13.14;1173;37;4693.00;158
12369;35;624908952;12369;317;13536;13693;6.83;0.42;305.26;13.15;1167;37;4694.00;157
12372;35;624908971;12372;324;13540;13699;6.84;0.42;305.32;13.15;1168;37;4695.00;159
12374;35;624908989;12374;323;13541;13699;6.83;0.42;305.36;13.16;1167;37;4696.00;158
12376;35;624909006;12376;327;13542;13699;6.84;0.42;305.43;13.27;1166;37;4697.00;157
12378;35;624909021;12378;333;13544;13702;6.85;0.42;305.45;13.26;1166;37;4698.00;158
12382;35;624909037;12382;337;13544;13702;6.87;0.42;305.51;13.26;1162;37;4699.00;158
12387;35;624909055;12387;336;13545;13702;6.86;0.42;305.48;13.26;1158;37;4700.00;157
12390;35;624909076;12390;331;13546;13703;6.87;0.42;305.45;13.37;1156;37;4701.00;157
12399;35;624909092;12399;323;13547;13704;6.86;0.42;305.46;13.37;1148;37;4702.00;157
12401;35;624909109;12401;310;13547;13704;6.89;0.42;305.46;13.37;1146;37;4703.00;157
12403;35;624909124;12403;317;13556;13717;6.91;0.42;305.50;13.36;1153;37;4704.00;161
12408;35;624909141;12408;313;13557;13717;6.88;0.42;305.65;13.36;1149;37;4705.00;160
12412;35;624909159;12412;306;13557;13717;6.88;0.42;305.70;13.36;1145;37;4706.00;160
12415;35;624909174;12415;308;13559;13718;6.87;0.42;305.76;13.36;1144;37;4707.00;159
12419;35;624909189;12419;302;13559;13718;6.81;0.42;305.77;13.36;1140;37;4708.00;159
12420;35;624909205;12420;311;13562;13722;6.84;0.42;305.78;13.36;1142;37;4709.00;160
12425;35;624909222;12425;312;13562;13722;6.81;0.42;305.92;13.36;1137;37;4710.00;160
12427;35;624909237;12427;313;13567;13726;6.75;0.41;305.92;13.36;1140;37;4711.00;159
12430;35;624909252;12430;318;13567;13726;6.70;0.41;305.94;13.36;1137;37;4712.00;159
12433;35;624909267;12433;325;13568;13726;6.70;0.41;305.97;13.36;1135;37;4713.00;158
12435;35;624909282;12435;325;13568;13726;6.64;0.40;305.98;13.36;1133;37;4714.00;158
12437;35;624909296;12437;323;13568;13726;6.61;0.40;306.02;13.36;1131;37;4715.00;158
12438;35;624909311;12438;327;13579;13738;6.60;0.40;306.04;13.36;1141;37;4716.00;159
12442;35;624909326;12442;336;13581;13738;6.49;0.40;306.11;13.35;1139;37;4717.00;157
12442;35;624909340;12442;345;13582;13738;6.44;0.39;306.11;13.35;1140;37;4718.00;156
12444;35;624909354;12444;362;13583;13738;6.41;0.39;306.16;13.36;1139;37;4719.00;155
12445;35;624909368;12445;366;13584;13738;6.32;0.39;306.18;13.38;1139;37;4720.00;154
12448;35;624909382;12448;368;13584;13738;6.29;0.38;306.19;13.38;1136;37;4721.00;154
12450;35;624909396;12450;375;13585;13739;6.27;0.38;306.19;13.38;1135;37;4722.00;154
12453;35;624909411;12453;377;13585;13739;6.24;0.38;306.19;13.38;1132;37;4723.00;154
12456;35;624909424;12456;383;13591;13745;6.24;0.38;306.22;13.39;1135;37;4724.00;154
12456;35;624909439;12456;382;13594;13747;6.25;0.38;306.22;13.39;1138;37;4725.00;153
12460;35;624909452;12460;382;13595;13747;6.20;0.38;306.25;13.41;1135;37;4726.00;152
12464;35;624909466;12464;389;13597;13747;6.17;0.38;306.20;13.43;1133;37;4727.00;150
12469;35;624909480;12469;383;13600;13751;6.15;0.37;306.27;13.42;1131;37;4728.00;151
12472;35;624909493;12472;386;13601;13751;6.13;0.37;306.31;13.44;1129;37;4729.00;150
12473;35;624909507;12473;396;13603;13751;6.08;0.37;306.31;13.45;1130;37;4730.00;148
12475;35;624909521;12475;398;13604;13752;6.06;0.37;306.39;13.45;1129;37;4731.00;148
12478;35;624909534;12478;402;13609;13756;6.02;0.37;306.39;13.47;1131;37;4732.00;147
12480;35;624909548;12480;406;13609;13756;6.01;0.37;306.36;13.47;1129;37;4733.00;147
12484;35;624909562;12484;397;13612;13759;5.94;0.36;306.52;13.48;1128;37;4734.00;147
12487;35;624909576;12487;399;13614;13759;5.91;0.36;306.60;13.48;1127;37;4735.00;145
12489;35;624909590;12489;403;13616;13759;5.87;0.36;306.64;13.51;1127;37;4736.00;143
12489;35;624909604;12489;410;13618;13759;5.84;0.36;306.64;13.52;1129;37;4737.00;141
12491;35;624909618;12491;413;13623;13763;5.83;0.36;306.65;13.53;1132;37;4738.00;140
12493;35;624909631;12493;413;13624;13763;5.81;0.35;306.70;13.53;1131;37;4739.00;139
12496;35;624909645;12496;409;13625;13763;5.72;0.35;306.73;13.55;1129;37;4740.00;138
12498;35;624909659;12498;411;13626;13763;5.65;0.35;306.71;13.55;1128;37;4741.00;137
12500;35;624909671;12500;414;13627;13764;5.63;0.34;306.80;13.56;1127;37;4742.00;137
12501;35;624909685;12501;413;13629;13765;5.60;0.34;306.86;13.57;1128;37;4743.00;136
12501;35;624909697;12501;418;13629;13765;5.54;0.34;306.86;13.57;1128;37;4744.00;136
12503;35;624909709;12503;417;13632;13766;5.46;0.33;306.82;13.59;1129;37;4745.00;134
12505;35;624909722;12505;422;13632;13766;5.43;0.33;306.82;13.59;1127;37;4746.00;134
12506;35;624909735;12506;425;13634;13766;5.39;0.33;306.81;13.61;1128;37;4747.00;132
12508;35;624909748;12508;429;13634;13766;5.35;0.33;306.85;13.61;1126;37;4748.00;132
12509;35;624909760;12509;431;13634;13766;5.31;0.33;306.83;13.61;1125;37;4749.00;132
12513;35;624909773;12513;429;13636;13766;5.27;0.32;306.78;13.63;1123;37;4750.00;130
12514;35;624909785;12514;433;13636;13766;5.23;0.32;306.76;13.63;1122;37;4751.00;130
12517;35;624909797;12517;450;13701;13893;5.43;0.34;306.76;13.59;1184;37;4752.00;192
12521;35;624909821;12521;443;13705;13894;5.36;0.33;306.75;13.58;1184;37;4753.00;189
12526;35;624909833;12526;429;13718;13894;5.33;0.33;306.69;13.59;1192;37;4754.00;176
12529;35;624909846;12529;432;13720;13894;5.30;0.33;306.68;13.59;1191;37;4755.00;174
12531;35;624909857;12531;430;13727;13894;5.28;0.33;306.67;13.59;1196;37;4756.00;167
12535;35;624909869;12535;441;13732;13894;5.19;0.32;306.65;13.60;1197;37;4757.00;162
12537;35;624909881;12537;443;13736;13894;5.11;0.32;306.70;13.60;1199;37;4758.00;158
12541;35;624909893;12541;444;13739;13894;5.05;0.31;306.76;13.60;1198;37;4759.00;155
12544;35;624909905;12544;441;13743;13895;5.06;0.31;306.76;13.61;1199;37;4760.00;152
12548;35;624909918;12548;437;13746;13896;5.04;0.31;306.72;13.61;1198;37;4761.00;150
12552;35;624909930;12552;438;13749;13896;5.01;0.31;306.73;13.61;1197;37;4762.00;147
12552;35;624909943;12552;438;13751;13897;5.02;0.31;306.73;13.63;1199;37;4763.00;146
12554;35;624909955;12554;452;13754;13897;5.04;0.31;306.74;13.63;1200;37;4764.00;143
12558;35;624909967;12558;453;13757;13897;5.00;0.31;306.74;13.64;1199;37;4765.00;140
12558;35;624909980;12558;456;13762;13897;5.05;0.31;306.74;13.64;1204;37;4766.00;135
12559;35;624909992;12559;455;13765;13901;5.05;0.31;306.75;13.64;1206;37;4767.00;136
12563;35;624910004;12563;455;13767;13901;5.01;0.31;306.77;13.64;1204;37;4768.00;134
12564;35;624910017;12564;457;13767;13901;4.99;0.31;306.78;13.64;1203;37;4769.00;134
12564;35;624910031;12564;461;13770;13907;5.06;0.31;306.78;13.63;1206;37;4770.00;137
12568;35;624910044;12568;464;13772;13907;5.04;0.31;306.80;13.63;1204;37;4771.00;135
12571;35;624910056;12571;459;13775;13907;5.00;0.31;306.80;13.63;1204;37;4772.00;132
12572;35;624910069;12572;460;13779;13911;5.02;0.31;306.79;13.63;1207;37;4773.00;132
12575;35;624910081;12575;462;13781;13912;5.00;0.31;306.80;13.63;1206;37;4774.00;131
12581;35;624910094;12581;463;13782;13912;5.00;0.31;306.74;13.63;1201;37;4775.00;130
12586;35;624910107;12586;462;13785;13916;5.01;0.31;306.73;13.63;1199;37;4776.00;131
12591;35;624910120;12591;460;13785;13916;4.98;0.31;306.71;13.63;1194;37;4777.00;131
12592;35;624910133;12592;465;13785;13916;4.96;0.30;306.72;13.63;1193;37;4778.00;131
12594;35;624910145;12594;449;13786;13917;4.96;0.30;306.73;13.62;1192;37;4779.00;131
12598;35;624910158;12598;437;13786;13917;4.95;0.30;306.73;13.62;1188;37;4780.00;131
12601;35;624910171;12601;431;13791;13923;4.97;0.30;306.73;13.62;1190;37;4781.00;132
12607;35;624910184;12607;415;13791;13923;4.95;0.30;306.75;13.62;1184;37;4782.00;132
12609;35;624910197;12609;415;13791;13924;4.96;0.30;306.74;13.62;1182;37;4783.00;133
12612;35;624910210;12612;419;13791;13924;4.95;0.30;306.72;13.62;1179;37;4784.00;133
12616;35;624910223;12616;421;13791;13924;4.91;0.30;306.68;13.62;1175;37;4785.00;133
12619;35;624910235;12619;416;13791;13924;4.95;0.30;306.66;13.62;1172;37;4786.00;133
12623;36;624910249;12623;415;13791;13924;4.98;0.30;306.71;13.62;1168;38;4787.00;133
12627;36;624910272;12627;411;13801;13936;5.08;0.31;306.69;13.61;1174;38;4788.00;135
12632;36;624910287;12632;419;13801;13936;5.07;0.31;306.65;13.61;1169;38;4789.00;135
12634;36;624910306;12634;416;13802;13936;5.06;0.31;306.66;13.61;1168;38;4790.00;134
12638;36;624910319;12638;423;13802;13936;5.03;0.31;306.63;13.61;1164;38;4791.00;134
12641;36;624910332;12641;421;13802;13936;5.00;0.30;306.61;13.61;1161;38;4792.00;134
12642;36;624910350;12642;421;13802;13936;4.98;0.30;306.61;13.61;1160;38;4793.00;134
12644;36;624910363;12644;418;13805;13940;5.05;0.31;306.59;13.61;1161;38;4794.00;135
12646;36;624910376;12646;422;13806;13940;5.01;0.30;306.60;13.72;1160;38;4795.00;134
12649;36;624910391;12649;413;13810;13944;5.08;0.31;306.62;13.71;1161;38;4796.00;134
12649;36;624910404;12649;412;13811;13945;5.12;0.31;306.62;13.71;1162;38;4797.00;134
12653;36;624910416;12653;410;13811;13945;5.09;0.31;306.63;13.71;1158;38;4798.00;134
12656;36;624910429;12656;410;13811;13945;5.06;0.31;306.62;13.71;1155;38;4799.00;134
12658;36;624910444;12658;416;13835;13986;5.18;0.31;306.64;13.69;1177;38;4800.00;151
12662;36;624910464;12662;405;13836;13986;5.19;0.32;306.64;13.69;1174;38;4801.00;150
12662;36;624910478;12662;405;13837;13986;5.19;0.32;306.64;13.69;1175;38;4802.00;149
12664;36;624910491;12664;403;13839;13987;5.20;0.32;306.70;13.69;1175;38;4803.00;148
12667;36;624910504;12667;401;13839;13988;5.20;0.32;306.70;13.69;1172;38;4804.00;149
12669;36;624910517;12669;401;13839;13988;5.24;0.32;306.77;13.69;1170;38;4805.00;149
12671;36;624910530;12671;401;13843;13991;5.29;0.32;306.76;13.68;1172;38;4806.00;148
12671;36;624910543;12671;390;13844;13991;5.31;0.32;306.76;13.68;1173;38;4807.00;147
12673;36;624910556;12673;383;13845;13991;5.32;0.33;306.77;13.68;1172;38;4808.00;146
12678;36;624910569;12678;387;13847;13991;5.33;0.33;306.81;13.68;1169;38;4809.00;144
12679;36;624910582;12679;383;13853;13997;5.42;0.33;306.86;13.79;1174;38;4810.00;144
12683;36;624910597;12683;374;13853;13997;5.47;0.33;306.93;13.79;1170;38;4811.00;144
12686;36;624910611;12686;374;13853;13997;5.55;0.34;307.06;13.79;1167;38;4812.00;144
12689;36;624910624;12689;376;13853;13997;5.63;0.34;307.12;13.79;1164;38;4813.00;144
12692;36;624910637;12692;374;13857;14001;5.68;0.35;307.14;13.79;1165;38;4814.00;144
12696;36;624910653;12696;370;13859;14003;5.76;0.35;307.12;13.78;1163;38;4815.00;144
12696;36;624910667;12696;365;13859;14003;5.87;0.36;307.12;13.78;1163;38;4816.00;144
12698;36;624910680;12698;349;13860;14004;5.99;0.36;307.14;13.78;1162;38;4817.00;144
12702;36;624910695;12702;339;13860;14004;6.10;0.37;307.10;13.78;1158;38;4818.00;144
12704;36;624910710;12704;330;13860;14004;6.24;0.38;307.12;13.78;1156;38;4819.00;144
12710;36;624910724;12710;324;13861;14004;6.32;0.38;307.10;13.78;1151;38;4820.00;143
12713;36;624910744;12713;316;13861;14004;6.44;0.39;307.15;13.78;1148;38;4821.00;143
12713;36;624910759;12713;310;13861;14004;6.59;0.40;307.15;13.78;1148;38;4822.00;143
12715;36;624910774;12715;308;13861;14004;6.68;0.41;307.21;13.78;1146;38;4823.00;143
12719;36;624910793;12719;322;13904;14074;6.74;0.41;307.29;13.74;1185;38;4824.00;170
12722;36;624910836;12722;314;13905;14075;6.79;0.41;307.31;13.85;1183;38;4825.00;170
12726;36;624910859;12726;311;13911;14075;6.88;0.42;307.41;13.85;1185;38;4826.00;164
12727;36;624910880;12727;303;13912;14075;6.92;0.42;307.39;13.85;1185;38;4827.00;163
12729;36;624910899;12729;293;13914;14077;6.91;0.42;307.44;13.85;1185;38;4828.00;163
12732;36;624910915;12732;288;13916;14077;6.92;0.42;307.50;13.85;1184;38;4829.00;161
12734;36;624910936;12734;287;13918;14077;6.92;0.42;307.54;13.85;1184;38;4830.00;159
12739;36;624910952;12739;288;13922;14077;6.91;0.42;307.63;13.85;1183;38;4831.00;155
12742;36;624910968;12742;294;13924;14078;6.99;0.42;307.75;13.84;1182;38;4832.00;154
12743;36;624911002;12743;289;13926;14079;7.06;0.43;307.73;13.84;1183;38;4833.00;153
12746;36;624911019;12746;288;13928;14079;7.10;0.43;307.81;13.84;1182;38;4834.00;151
12748;36;624911035;12748;284;13933;14083;7.10;0.43;307.85;13.84;1185;38;4835.00;150
12750;36;624911051;12750;291;13934;14083;7.12;0.43;307.91;13.84;1184;38;4836.00;149
12753;36;624911068;12753;290;13936;14083;7.11;0.43;308.05;13.84;1183;38;4837.00;147
12754;36;624911084;12754;297;13938;14083;7.13;0.43;308.11;13.95;1184;38;4838.00;145
12758;36;624911100;12758;290;13943;14089;7.17;0.43;308.21;13.95;1185;38;4839.00;146
12760;36;624911116;12760;291;13943;14089;7.17;0.43;308.20;13.95;1183;38;4840.00;146
12763;36;624911132;12763;284;13943;14089;7.19;0.44;308.28;13.95;1180;38;4841.00;146
12766;36;624911148;12766;289;13945;14092;7.23;0.44;308.37;13.95;1179;38;4842.00;147
12768;36;624911164;12768;281;13945;14092;7.24;0.44;308.43;13.95;1177;38;4843.00;147
12771;36;624911184;12771;284;13946;14092;7.23;0.44;308.57;13.95;1175;38;4844.00;146
12774;36;624911200;12774;282;13946;14093;7.20;0.44;308.55;13.95;1172;38;4845.00;147
12778;36;624911216;12778;278;13947;14094;7.18;0.44;308.61;13.94;1169;38;4846.00;147
12782;36;624911232;12782;278;13947;14094;7.16;0.44;308.70;13.94;1165;38;4847.00;147
12784;36;624911248;12784;283;13957;14107;7.16;0.44;308.72;13.93;1173;38;4848.00;150
12785;36;624911264;12785;283;13957;14107;7.17;0.44;308.74;13.93;1172;38;4849.00;150
12792;36;624911280;12792;287;13958;14107;7.15;0.43;308.87;13.93;1166;38;4850.00;149
12792;36;624911296;12792;292;13959;14108;7.15;0.43;308.87;13.93;1167;38;4851.00;149
12797;36;624911311;12797;277;13959;14108;7.12;0.43;308.99;13.93;1162;38;4852.00;149
12799;36;624911327;12799;275;13963;14112;7.16;0.43;309.04;13.93;1164;38;4853.00;149
12802;36;624911343;12802;285;13964;14112;7.17;0.44;309.10;14.04;1162;38;4854.00;148
12808;36;624911359;12808;285;13967;14116;7.13;0.43;309.18;14.04;1159;38;4855.00;149
12811;36;624911376;12811;285;13967;14116;7.15;0.43;309.23;14.04;1156;38;4856.00;149
12814;36;624911391;12814;281;13967;14116;7.17;0.44;309.27;14.04;1153;38;4857.00;149
12819;36;624911407;12819;280;13968;14116;7.14;0.43;309.34;14.14;1149;38;4858.00;148
12819;36;624911422;12819;280;13968;14116;7.07;0.43;309.34;14.14;1149;38;4859.00;148
12822;36;624911438;12822;282;13988;14150;6.99;0.43;309.33;14.12;1166;38;4860.00;162
12825;36;624911456;12825;276;13989;14150;6.91;0.42;309.38;14.12;1164;38;4861.00;161
12828;36;624911472;12828;277;13991;14150;6.89;0.42;309.39;14.12;1163;38;4862.00;159
12833;36;624911487;12833;270;13993;14150;6.87;0.42;309.42;14.23;1160;38;4863.00;157
12837;36;624911502;12837;269;13995;14150;6.87;0.42;309.44;14.23;1158;38;4864.00;155
12837;36;624911517;12837;265;13997;14150;6.91;0.42;309.44;14.25;1160;38;4865.00;153
12842;36;624911532;12842;261;13997;14151;6.88;0.42;309.43;14.25;1155;38;4866.00;154
12847;36;624911553;12847;261;13997;14151;6.86;0.42;309.48;14.25;1150;38;4867.00;154
12851;36;624911568;12851;255;14001;14157;6.87;0.42;309.58;14.25;1150;38;4868.00;156
12855;36;624911584;12855;252;14002;14158;6.82;0.42;309.56;14.25;1147;38;4869.00;156
12858;36;624911600;12858;258;14003;14158;6.76;0.41;309.58;14.25;1145;38;4870.00;155
12862;36;624911616;12862;264;14004;14158;6.74;0.41;309.60;14.25;1142;38;4871.00;154
12863;36;624911631;12863;263;14006;14162;6.72;0.41;309.59;14.25;1143;38;4872.00;156
12869;36;624911647;12869;259;14007;14162;6.64;0.40;309.62;14.24;1138;38;4873.00;155
12872;36;624911663;12872;271;14008;14162;6.61;0.40;309.64;14.24;1136;38;4874.00;154
12876;36;624911677;12876;271;14009;14163;6.63;0.40;309.67;14.24;1133;38;4875.00;154
12879;36;624911692;12879;270;14012;14167;6.56;0.40;309.67;14.24;1133;38;4876.00;155
12885;36;624911707;12885;270;14013;14167;6.50;0.39;309.63;14.24;1128;38;4877.00;154
12889;36;624911722;12889;271;14015;14170;6.50;0.39;309.65;14.24;1126;38;4878.00;155
12890;36;624911738;12890;278;14016;14170;6.49;0.39;309.65;14.24;1126;38;4879.00;154
12895;36;624911752;12895;284;14016;14170;6.51;0.40;309.69;14.24;1121;38;4880.00;154
12895;36;624911768;12895;287;14016;14170;6.53;0.40;309.69;14.24;1121;38;4881.00;154
12898;36;624911785;12898;294;14020;14174;6.57;0.40;309.73;14.23;1122;38;4882.00;154
12903;36;624911801;12903;289;14020;14174;6.56;0.40;309.75;14.23;1117;38;4883.00;154
12905;36;624911816;12905;289;14020;14174;6.57;0.40;309.76;14.23;1115;38;4884.00;154
12906;36;624911830;12906;288;14020;14174;6.55;0.40;309.76;14.23;1114;38;4885.00;154
12906;36;624911844;12906;285;14020;14175;6.48;0.40;309.76;14.23;1114;38;4886.00;155
12910;36;624911857;12910;286;14021;14176;6.39;0.39;309.79;14.23;1111;38;4887.00;155
12912;36;624911871;12912;294;14021;14176;6.32;0.39;309.85;14.23;1109;38;4888.00;155
12916;36;624911885;12916;297;14023;14177;6.23;0.38;309.87;14.25;1107;38;4889.00;154
12917;36;624911901;12917;305;14024;14177;6.19;0.38;309.88;14.26;1107;38;4890.00;153
12920;36;624911914;12920;316;14024;14177;6.09;0.37;309.90;14.26;1104;38;4891.00;153
12921;36;624911926;12921;328;14026;14177;6.05;0.37;309.96;14.29;1105;38;4892.00;151
12925;36;624911939;12925;328;14026;14177;5.98;0.36;310.06;14.29;1101;38;4893.00;151
12926;36;624911951;12926;326;14026;14177;5.96;0.36;310.08;14.29;1100;38;4894.00;151
12927;36;624911963;12927;326;14028;14177;5.92;0.36;310.12;14.31;1101;38;4895.00;149
12928;36;624911975;12928;346;14092;14304;6.14;0.38;310.10;14.25;1164;38;4896.00;212
12928;36;624911997;12928;346;14096;14305;6.14;0.38;310.10;14.24;1168;38;4897.00;209
12931;36;624912010;12931;349;14108;14305;6.17;0.38;310.13;14.26;1177;38;4898.00;197
12933;36;624912023;12933;348;14109;14305;6.12;0.38;310.17;14.26;1176;38;4899.00;196
12935;36;624912036;12935;354;14116;14305;6.07;0.38;310.21;14.28;1181;38;4900.00;189
12935;36;624912051;12935;356;14120;14305;5.99;0.37;310.21;14.29;1185;38;4901.00;185
12939;36;624912064;12939;354;14121;14305;5.86;0.36;310.22;14.29;1182;38;4902.00;184
12943;36;624912076;12943;353;14123;14305;5.77;0.36;310.20;14.29;1180;38;4903.00;182
12946;36;624912088;12946;354;14126;14306;5.68;0.35;310.23;14.31;1180;38;4904.00;180
12947;36;624912101;12947;363;14130;14308;5.62;0.35;310.24;14.31;1183;38;4905.00;178
12949;36;624912113;12949;359;14135;14308;5.56;0.34;310.21;14.33;1186;38;4906.00;173
12951;36;624912125;12951;370;14138;14309;5.46;0.34;310.18;14.32;1187;38;4907.00;171
12954;36;624912137;12954;374;14143;14309;5.34;0.33;310.18;14.34;1189;38;4908.00;166
12957;36;624912149;12957;376;14146;14309;5.22;0.32;310.15;14.34;1189;38;4909.00;163
12959;36;624912162;12959;383;14152;14309;5.11;0.32;310.18;14.36;1193;38;4910.00;157
12960;36;624912174;12960;386;14156;14313;5.07;0.31;310.24;14.36;1196;38;4911.00;157
12961;36;624912186;12961;388;14159;14313;5.01;0.31;310.22;14.36;1198;38;4912.00;154
12963;36;624912198;12963;393;14163;14313;4.97;0.31;310.23;14.38;1200;38;4913.00;150
12965;36;624912211;12965;399;14165;14316;4.93;0.30;310.20;14.38;1200;38;4914.00;151
12966;36;624912223;12966;398;14167;14316;4.89;0.30;310.24;14.38;1201;38;4915.00;149
12969;36;624912235;12969;402;14170;14316;4.87;0.30;310.19;14.40;1201;38;4916.00;146
12971;36;624912249;12971;410;14173;14320;4.83;0.30;310.16;14.40;1202;38;4917.00;147
12973;36;624912264;12973;413;14177;14321;4.82;0.30;310.13;14.41;1204;38;4918.00;144
12975;36;624912276;12975;414;14178;14321;4.78;0.29;310.15;14.41;1203;38;4919.00;143
12975;36;624912291;12975;421;14184;14326;4.76;0.29;310.15;14.42;1209;38;4920.00;142
12979;36;624912303;12979;434;14185;14326;4.69;0.29;310.14;14.43;1206;38;4921.00;141
12982;36;624912316;12982;438;14185;14326;4.58;0.28;310.10;14.43;1203;38;4922.00;141
12983;36;624912329;12983;444;14188;14327;4.50;0.28;310.08;14.44;1205;38;4923.00;139
12987;36;624912340;12987;442;14188;14327;4.43;0.27;310.03;14.44;1201;38;4924.00;139
12990;36;624912366;12990;442;14193;14333;4.38;0.27;310.06;14.44;1203;38;4925.00;140
12994;36;624912379;12994;453;14195;14333;4.29;0.26;310.02;14.45;1201;38;4926.00;138
12999;36;624912390;12999;449;14195;14334;4.18;0.26;310.03;14.45;1196;38;4927.00;139
13002;36;624912402;13002;459;14195;14334;4.10;0.25;310.04;14.45;1193;38;4928.00;139
13005;36;624912413;13005;463;14195;14334;4.02;0.25;310.05;14.45;1190;38;4929.00;139
13008;36;624912424;13008;458;14198;14334;3.97;0.24;310.02;14.47;1190;38;4930.00;136
13010;36;624912435;13010;436;14198;14334;3.94;0.24;310.00;14.47;1188;38;4931.00;136
13013;36;624912447;13013;422;14212;14346;3.99;0.25;309.95;14.48;1199;38;4932.00;134
13016;36;624912459;13016;409;14212;14346;4.03;0.25;309.98;14.48;1196;38;4933.00;134
13017;36;624912471;13017;409;14212;14346;4.09;0.25;309.98;14.48;1195;38;4934.00;134
13020;36;624912488;13020;408;14214;14346;4.12;0.25;309.98;14.50;1194;38;4935.00;132
13025;36;624912500;13025;409;14214;14346;4.17;0.26;309.91;14.50;1189;38;4936.00;132
13028;36;624912512;13028;406;14215;14346;4.23;0.26;309.94;14.50;1187;38;4937.00;131
13029;36;624912530;13029;390;14219;14350;4.37;0.27;309.93;14.50;1190;38;4938.00;131
13034;36;624912542;13034;387;14220;14350;4.43;0.27;309.94;14.51;1186;38;4939.00;130
13037;36;624912554;13037;377;14224;14354;4.59;0.28;309.97;14.50;1187;38;4940.00;130
13037;36;624912568;13037;376;14225;14355;4.67;0.28;309.97;14.50;1188;38;4941.00;130
13044;36;624912585;13044;374;14225;14355;4.74;0.29;310.01;14.50;1181;38;4942.00;130
13045;36;624912599;13045;376;14225;14355;4.80;0.29;310.02;14.50;1180;38;4943.00;130
13046;36;624912611;13046;373;14236;14368;4.95;0.30;310.03;14.49;1190;38;4944.00;132
13050;36;624912625;13050;376;14236;14368;4.97;0.30;310.03;14.49;1186;38;4945.00;132
13053;36;624912638;13053;387;14236;14368;5.02;0.30;310.03;14.49;1183;38;4946.00;132
13056;36;624912651;13056;393;14237;14369;5.11;0.31;310.00;14.49;1181;38;4947.00;132
13060;36;624912664;13060;396;14237;14370;5.08;0.31;310.01;14.49;1177;38;4948.00;133
13063;36;624912677;13063;392;14237;14370;5.12;0.31;309.98;14.49;1174;38;4949.00;133
13065;36;624912692;13065;392;14243;14379;5.17;0.31;310.03;14.48;1178;38;4950.00;136
13070;36;624912705;13070;391;14243;14379;5.15;0.31;310.13;14.48;1173;38;4951.00;136
13073;36;624912717;13073;384;14245;14379;5.23;0.32;310.13;14.48;1172;38;4952.00;134
13075;36;624912730;13075;372;14245;14379;5.29;0.32;310.17;14.48;1170;38;4953.00;134
13076;36;624912743;13076;371;14250;14385;5.36;0.32;310.18;14.48;1174;38;4954.00;135
13079;36;624912756;13079;361;14251;14385;5.37;0.33;310.33;14.48;1172;38;4955.00;134
13081;36;624912770;13081;365;14251;14385;5.35;0.32;310.35;14.48;1170;38;4956.00;134
13086;36;624912785;13086;359;14251;14385;5.32;0.32;310.35;14.48;1165;38;4957.00;134
13089;36;624912808;13089;362;14254;14389;5.37;0.33;310.35;14.47;1165;38;4958.00;135
13095;36;624912831;13095;357;14255;14390;5.38;0.33;310.36;14.47;1160;38;4959.00;135
13099;36;624912853;13099;350;14255;14390;5.42;0.33;310.36;14.47;1156;38;4960.00;135
13104;36;624912872;13104;354;14256;14391;5.44;0.33;310.39;14.47;1152;38;4961.00;135
13108;36;624912895;13108;356;14256;14391;5.43;0.33;310.40;14.47;1148;38;4962.00;135
13112;36;624912912;13112;355;14256;14391;5.38;0.33;310.48;14.47;1144;38;4963.00;135
13114;36;624912928;13114;351;14256;14391;5.32;0.33;310.53;14.47;1142;38;4964.00;135
13116;36;624912942;13116;353;14257;14391;5.29;0.32;310.52;14.58;1141;38;4965.00;134
13119;36;624912957;13119;357;14257;14391;5.30;0.33;310.57;14.58;1138;38;4966.00;134
13122;36;624912971;13122;366;14257;14391;5.30;0.32;310.61;14.58;1135;38;4967.00;134
13126;36;624912985;13126;371;14298;14461;5.44;0.34;310.66;14.54;1172;38;4968.00;163
13130;36;624913005;13130;367;14299;14462;5.47;0.34;310.64;14.54;1169;38;4969.00;163
13132;36;624913019;13132;362;14304;14462;5.55;0.34;310.65;14.54;1172;38;4970.00;158
13136;36;624913033;13136;359;14304;14462;5.58;0.34;310.65;14.54;1168;38;4971.00;158
13141;36;624913047;13141;367;14306;14462;5.56;0.34;310.69;14.53;1165;38;4972.00;156
13144;36;624913061;13144;351;14307;14462;5.58;0.34;310.70;14.53;1163;38;4973.00;155
13148;36;624913075;13148;362;14310;14462;5.61;0.34;310.69;14.53;1162;38;4974.00;152
13150;36;624913089;13150;361;14311;14462;5.63;0.35;310.72;14.53;1161;38;4975.00;151
13152;36;624913110;13152;368;14314;14463;5.63;0.35;310.70;14.53;1162;38;4976.00;149
13155;36;624913127;13155;361;14317;14464;5.66;0.35;310.72;14.53;1162;38;4977.00;147
13159;36;624913143;13159;354;14320;14464;5.68;0.35;310.70;14.53;1161;38;4978.00;144
13160;36;624913160;13160;358;14326;14468;5.69;0.35;310.71;14.52;1166;38;4979.00;142
13165;36;624913178;13165;360;14328;14468;5.72;0.35;310.76;14.52;1163;38;4980.00;140
13168;36;624913194;13168;353;14328;14468;5.74;0.35;310.76;14.52;1160;38;4981.00;140
13170;36;624913210;13170;359;14328;14468;5.82;0.36;310.81;14.52;1158;38;4982.00;140
13174;36;624913226;13174;364;14333;14474;5.88;0.36;310.85;14.52;1159;38;4983.00;141
13176;36;624913242;13176;367;14333;14474;5.98;0.36;310.90;14.52;1157;38;4984.00;141
13180;36;624913258;13180;367;14333;14474;6.05;0.37;310.96;14.52;1153;38;4985.00;141
13183;36;624913280;13183;355;14335;14477;6.14;0.37;311.02;14.52;1152;38;4986.00;142
13185;36;624913296;13185;341;14335;14477;6.23;0.38;311.10;14.52;1150;38;4987.00;142
13188;36;624913311;13188;329;14336;14477;6.34;0.39;311.14;14.52;1148;38;4988.00;141
13190;36;624913327;13190;321;14336;14478;6.43;0.39;311.20;14.52;1146;38;4989.00;142
13191;36;624913343;13191;315;14337;14479;6.52;0.40;311.19;14.51;1146;38;4990.00;142
13195;36;624913358;13195;308;14337;14479;6.59;0.40;311.27;14.51;1142;38;4991.00;142
13199;36;624913375;13199;304;14348;14492;6.74;0.41;311.35;14.50;1149;38;4992.00;144
13201;36;624913392;13201;306;14348;14492;6.79;0.41;311.36;14.50;1147;38;4993.00;144
13208;36;624913408;13208;307;14348;14492;6.78;0.41;311.49;14.50;1140;38;4994.00;144
13209;36;624913424;13209;298;14350;14494;6.84;0.42;311.52;14.50;1141;38;4995.00;144
13214;36;624913440;13214;297;14350;14494;6.88;0.42;311.61;14.50;1136;38;4996.00;144
13216;36;624913455;13216;285;14354;14498;6.95;0.42;311.65;14.50;1138;38;4997.00;144
13219;36;624913471;13219;284;14354;14498;6.94;0.42;311.75;14.50;1135;38;4998.00;144
13221;36;624913486;13221;288;14357;14502;6.94;0.42;311.78;14.49;1136;38;4999.00;145
13222;36;624913502;13222;275;14357;14502;7.02;0.43;311.79;14.49;1135;38;5000.00;145
13224;36;624913522;13224;262;14357;14502;7.10;0.43;311.84;14.49;1133;38;5001.00;145
13228;36;624913538;13228;257;14357;14502;7.15;0.43;311.92;14.49;1129;38;5002.00;145
13229;36;624913553;13229;253;14357;14502;7.21;0.44;311.92;14.49;1128;38;5003.00;145
13233;36;624913569;13233;255;14367;14514;7.23;0.44;312.02;14.60;1134;38;5004.00;147
13233;36;624913585;13233;246;14367;14514;7.24;0.44;312.02;14.60;1134;38;5005.00;147
13239;36;624913601;13239;248;14369;14514;7.22;0.44;312.15;14.60;1130;38;5006.00;145
13240;36;624913616;13240;245;14369;14514;7.23;0.44;312.17;14.60;1129;38;5007.00;145
13241;36;624913631;13241;247;14369;14514;7.21;0.44;312.16;14.60;1128;38;5008.00;145
13244;36;624913646;13244;252;14369;14514;7.12;0.43;312.18;14.60;1125;38;5009.00;145
13245;36;624913663;13245;243;14369;14515;7.08;0.43;312.17;14.60;1124;38;5010.00;146
13249;36;624913677;13249;237;14369;14515;7.03;0.43;312.26;14.60;1120;38;5011.00;146
13250;36;624913693;13250;239;14374;14521;7.05;0.43;312.30;14.59;1124;38;5012.00;147
13254;36;624913709;13254;239;14375;14522;7.02;0.43;312.34;14.59;1121;38;5013.00;147
13258;36;624913724;13258;232;14375;14522;7.02;0.43;312.32;14.59;1117;38;5014.00;147
13261;36;624913739;13261;232;14375;14522;6.98;0.42;312.35;14.59;1114;38;5015.00;147
13265;36;624913755;13265;231;14378;14526;6.99;0.42;312.43;14.59;1113;38;5016.00;148
13267;36;624913771;13267;229;14378;14526;7.01;0.42;312.41;14.59;1111;38;5017.00;148
13268;36;624913792;13268;227;14378;14526;7.02;0.42;312.40;14.59;1110;38;5018.00;148
13269;36;624913806;13269;224;14379;14527;7.06;0.43;312.42;14.59;1110;38;5019.00;148
13272;36;624913821;13272;224;14382;14531;7.12;0.43;312.47;14.58;1110;38;5020.00;149
13277;36;624913838;13277;218;14383;14531;7.10;0.43;312.48;14.69;1106;38;5021.00;148
13279;36;624913853;13279;219;14385;14534;7.12;0.43;312.54;14.69;1106;38;5022.00;149
13280;36;624913868;13280;211;14385;14534;7.09;0.43;312.57;14.69;1105;38;5023.00;149
13283;36;624913882;13283;220;14386;14534;7.06;0.43;312.62;14.69;1103;38;5024.00;148
13287;36;624913896;13287;211;14386;14534;7.03;0.42;312.64;14.69;1099;38;5025.00;148
13289;36;624913910;13289;222;14390;14538;7.11;0.43;312.69;14.69;1101;38;5026.00;148
13290;36;624913924;13290;217;14390;14538;7.17;0.43;312.70;14.69;1100;38;5027.00;148
13295;36;624913937;13295;216;14390;14538;7.10;0.43;312.72;14.69;1095;38;5028.00;148
13298;36;624913951;13298;220;14390;14538;7.10;0.43;312.74;14.69;1092;38;5029.00;148
13299;36;624913964;13299;215;14390;14539;7.14;0.43;312.78;14.69;1091;38;5030.00;149
13305;36;624913980;13305;213;14391;14540;7.09;0.43;312.84;14.69;1086;38;5031.00;149
13311;36;624913993;13311;212;14391;14540;6.99;0.42;312.85;14.69;1080;38;5032.00;149
13313;36;624914006;13313;216;14392;14541;6.94;0.42;312.84;14.68;1079;38;5033.00;149
13315;36;624914019;13315;219;14392;14541;6.89;0.42;312.86;14.68;1077;38;5034.00;149
13319;36;624914033;13319;224;14393;14541;6.80;0.41;312.91;14.70;1074;38;5035.00;148
13321;36;624914046;13321;224;14393;14541;6.80;0.41;312.88;14.70;1072;38;5036.00;148
13323;36;624914059;13323;232;14393;14541;6.81;0.42;312.90;14.70;1070;38;5037.00;148
13326;36;624914072;13326;226;14393;14541;6.77;0.41;312.91;14.70;1067;38;5038.00;148
13329;36;624914084;13329;229;14393;14541;6.76;0.41;312.91;14.70;1064;38;5039.00;148
13334;36;624914098;13334;260;14496;14771;6.83;0.43;312.89;14.59;1162;38;5040.00;275
13337;36;624914128;13337;258;14499;14772;6.74;0.42;312.91;14.59;1162;38;5041.00;273
13338;36;624914141;13338;247;14508;14772;6.78;0.43;312.91;14.58;1170;38;5042.00;264
13343;36;624914155;13343;248;14514;14772;6.74;0.42;312.97;14.58;1171;38;5043.00;258
13344;36;624914174;13344;256;14522;14772;6.79;0.42;312.97;14.57;1178;38;5044.00;250
13347;36;624914187;13347;250;14527;14772;6.76;0.42;313.02;14.57;1180;38;5045.00;245
13347;36;624914200;13347;240;14534;14772;6.78;0.42;313.02;14.56;1187;38;5046.00;238
13351;36;624914219;13351;246;14540;14772;6.79;0.42;313.05;14.56;1189;38;5047.00;232
13355;36;624914232;13355;251;14548;14773;6.81;0.42;313.10;14.56;1193;38;5048.00;225
13359;36;624914245;13359;248;14552;14774;6.81;0.42;313.13;14.56;1193;38;5049.00;222
13361;36;624914259;13361;248;14558;14774;6.82;0.42;313.13;14.55;1197;38;5050.00;216
13367;36;624914273;13367;260;14562;14775;6.79;0.42;313.14;14.55;1195;38;5051.00;213
13371;36;624914286;13371;258;14568;14775;6.74;0.42;313.29;14.55;1197;38;5052.00;207
13373;36;624914299;13373;269;14571;14775;6.64;0.41;313.25;14.55;1198;38;5053.00;204
13378;36;624914318;13378;278;14573;14775;6.51;0.40;313.35;14.55;1195;38;5054.00;202
13380;36;624914331;13380;283;14577;14779;6.41;0.40;313.33;14.56;1197;38;5055.00;202
13384;36;624914346;13384;298;14579;14779;6.28;0.39;313.38;14.56;1195;38;5056.00;200
13388;36;624914359;13388;306;14579;14779;6.15;0.38;313.37;14.56;1191;38;5057.00;200
13396;36;624914373;13396;316;14582;14782;6.02;0.37;313.39;14.56;1186;38;5058.00;200
13401;36;624914387;13401;324;14582;14782;5.88;0.36;313.43;14.56;1181;38;5059.00;200
13403;36;624914400;13403;334;14587;14782;5.81;0.36;313.40;14.59;1184;38;5060.00;195
13405;36;624914412;13405;339;14591;14786;5.79;0.36;313.42;14.59;1186;38;5061.00;195
13408;36;624914425;13408;339;14593;14787;5.79;0.36;313.45;14.58;1185;38;5062.00;194
13410;36;624914439;13410;354;14596;14787;5.79;0.36;313.42;14.61;1186;38;5063.00;191
13414;36;624914452;13414;353;14599;14791;5.78;0.35;313.45;14.61;1185;38;5064.00;192
13415;36;624914465;13415;366;14601;14791;5.78;0.35;313.48;14.62;1186;38;5065.00;190
13417;36;624914478;13417;361;14605;14791;5.81;0.36;313.50;14.64;1188;38;5066.00;186
13418;36;624914491;13418;369;14608;14792;5.78;0.36;313.52;14.65;1190;38;5067.00;184
13419;36;624914503;13419;377;14611;14792;5.73;0.35;313.54;14.67;1192;38;5068.00;181
13422;36;624914516;13422;389;14615;14798;5.66;0.35;313.54;14.66;1193;38;5069.00;183
13423;36;624914537;13423;389;14617;14798;5.61;0.34;313.54;14.66;1194;38;5070.00;181
13426;36;624914549;13426;394;14621;14799;5.54;0.34;313.55;14.68;1195;38;5071.00;178
13429;36;624914562;13429;400;14621;14799;5.45;0.33;313.54;14.68;1192;38;5072.00;178
13430;36;624914575;13430;407;14622;14799;5.41;0.33;313.53;14.69;1192;38;5073.00;177
13432;36;624914588;13432;425;14625;14799;5.34;0.33;313.52;14.71;1193;38;5074.00;174
13436;36;624914601;13436;431;14625;14799;5.29;0.33;313.51;14.71;1189;38;5075.00;174
13438;36;624914613;13438;443;14636;14811;5.29;0.33;313.49;14.71;1198;38;5076.00;175
13441;36;624914626;13441;449;14637;14811;5.19;0.32;313.44;14.71;1196;38;5077.00;174
13441;36;624914638;13441;459;14638;14811;5.11;0.31;313.44;14.72;1197;38;5078.00;173
13443;36;624914650;13443;465;14640;14811;5.00;0.31;313.41;14.73;1197;38;5079.00;171
13444;36;624914663;13444;465;14642;14811;4.92;0.30;313.39;14.74;1198;38;5080.00;169
13445;36;624914676;13445;466;14642;14811;4.85;0.30;313.45;14.74;1197;38;5081.00;169
13448;36;624914688;13448;469;14648;14815;4.78;0.29;313.45;14.75;1200;38;5082.00;167
13448;36;624914700;13448;457;14650;14815;4.77;0.29;313.45;14.76;1202;38;5083.00;165
13451;36;624914713;13451;450;14655;14819;4.81;0.30;313.43;14.76;1204;38;5084.00;164
13456;36;624914732;13456;444;14657;14821;4.80;0.29;313.36;14.78;1201;38;5085.00;164
13458;36;624914744;13458;437;14660;14821;4.81;0.29;313.33;14.78;1202;38;5086.00;161
13460;36;624914760;13460;428;14661;14821;4.87;0.30;313.32;14.79;1201;38;5087.00;160
13461;36;624914773;13461;430;14670;14834;4.92;0.30;313.30;14.78;1209;38;5088.00;164
13463;36;624914791;13463;428;14673;14834;5.01;0.31;313.28;14.78;1210;38;5089.00;161
13463;36;624914813;13463;425;14676;14834;5.06;0.31;313.28;14.80;1213;38;5090.00;158
13467;36;624914831;13467;417;14679;14835;5.06;0.31;313.27;14.82;1212;38;5091.00;156
13469;36;624914860;13469;421;14682;14836;5.04;0.31;313.32;14.84;1213;38;5092.00;154
13471;36;624914889;13471;422;14682;14836;5.02;0.31;313.30;14.84;1211;38;5093.00;154
13471;36;624914908;13471;421;14684;14839;4.99;0.30;313.30;14.84;1213;38;5094.00;155
13472;36;624914922;13472;432;14687;14839;4.97;0.30;313.29;14.86;1215;38;5095.00;152
13474;37;624914936;13474;433;14687;14839;4.93;0.30;313.27;14.86;1213;39;5096.00;152
13476;37;624914957;13476;435;14689;14839;4.88;0.30;313.24;14.87;1213;39;5097.00;150
13479;37;624914971;13479;441;14694;14845;4.84;0.30;313.30;14.87;1215;39;5098.00;151
13480;37;624914985;13480;447;14694;14845;4.78;0.29;313.30;14.87;1214;39;5099.00;151
13481;37;624915012;13481;439;14702;14864;4.68;0.29;313.31;14.88;1221;39;5100.00;162
13484;37;624915031;13484;428;14702;14864;4.62;0.28;313.37;14.88;1218;39;5101.00;162
13488;37;624915044;13488;427;14705;14868;4.63;0.28;313.32;14.88;1217;39;5102.00;163
13493;37;624915058;13493;416;14708;14869;4.67;0.29;313.31;14.89;1215;39;5103.00;161
13495;37;624915072;13495;419;14708;14869;4.76;0.29;313.35;14.89;1213;39;5104.00;161
13500;37;624915084;13500;410;14711;14870;4.81;0.30;313.37;14.89;1211;39;5105.00;159
13504;37;624915098;13504;410;14714;14870;4.86;0.30;313.38;14.90;1210;39;5106.00;156
13504;37;624915111;13504;398;14714;14870;5.04;0.31;313.38;14.90;1210;39;5107.00;156
13507;37;624915124;13507;394;14714;14870;5.11;0.31;313.38;14.90;1207;39;5108.00;156
13509;37;624915138;13509;386;14714;14870;5.19;0.32;313.44;14.90;1205;39;5109.00;156
13511;37;624915152;13511;381;14714;14870;5.28;0.33;313.48;14.90;1203;39;5110.00;156
13515;37;624915165;13515;375;14715;14870;5.36;0.33;313.55;14.90;1200;39;5111.00;155
13518;37;624915178;13518;383;14752;14940;5.54;0.34;313.54;14.87;1234;39;5112.00;188
13521;37;624915199;13521;377;14754;14941;5.63;0.35;313.60;14.86;1233;39;5113.00;187
13525;37;624915213;13525;377;14760;14941;5.72;0.35;313.58;14.86;1235;39;5114.00;181
13529;37;624915228;13529;378;14760;14941;5.77;0.35;313.58;14.86;1231;39;5115.00;181
13533;37;624915243;13533;373;14766;14941;5.82;0.36;313.61;14.86;1233;39;5116.00;175
13537;37;624915257;13537;375;14766;14941;5.82;0.36;313.64;14.86;1229;39;5117.00;175
13540;37;624915272;13540;373;14771;14941;5.84;0.36;313.63;14.85;1231;39;5118.00;170
13545;37;624915288;13545;374;14773;14941;5.85;0.36;313.67;14.85;1228;39;5119.00;168
13552;37;624915302;13552;380;14775;14942;5.84;0.36;313.68;14.85;1223;39;5120.00;167
13556;37;624915317;13556;388;14777;14943;5.86;0.36;313.75;14.85;1221;39;5121.00;166
13559;37;624915333;13559;393;14781;14943;5.88;0.36;313.79;14.85;1222;39;5122.00;162
13563;37;624915348;13563;395;14786;14947;5.87;0.36;313.80;14.85;1223;39;5123.00;161
13566;37;624915363;13566;394;14788;14947;5.85;0.36;313.84;14.85;1222;39;5124.00;159
13574;37;624915378;13574;396;14788;14947;5.81;0.36;313.87;14.85;1214;39;5125.00;159
13579;37;624915393;13579;403;14788;14947;5.84;0.36;313.90;14.85;1209;39;5126.00;159
13582;37;624915410;13582;408;14792;14953;5.83;0.36;313.93;14.84;1210;39;5127.00;161
13585;37;624915425;13585;411;14793;14953;5.84;0.36;313.99;14.84;1208;39;5128.00;160
13587;37;624915440;13587;406;14793;14953;5.88;0.36;314.05;14.84;1206;39;5129.00;160
13592;37;624915457;13592;407;14798;14959;5.88;0.36;314.12;14.84;1206;39;5130.00;161
13597;37;624915473;13597;408;14799;14959;5.90;0.36;314.15;14.84;1202;39;5131.00;160
13600;37;624915488;13600;407;14800;14959;5.91;0.36;314.16;14.84;1200;39;5132.00;159
13606;37;624915503;13606;410;14801;14960;5.90;0.36;314.31;14.84;1195;39;5133.00;159
13612;37;624915519;13612;409;14803;14961;5.88;0.36;314.46;14.84;1191;39;5134.00;158
13615;37;624915535;13615;402;14803;14961;5.82;0.35;314.45;14.84;1188;39;5135.00;158
13617;37;624915549;13617;403;14814;14974;5.87;0.36;314.50;14.83;1197;39;5136.00;160
13623;37;624915564;13623;393;14815;14974;5.80;0.35;314.54;14.83;1192;39;5137.00;159
13626;37;624915579;13626;393;14815;14974;5.79;0.35;314.52;14.83;1189;39;5138.00;159
13630;37;624915595;13630;389;14816;14975;5.82;0.35;314.52;14.83;1186;39;5139.00;159
13634;37;624915609;13634;393;14816;14975;5.80;0.35;314.55;14.83;1182;39;5140.00;159
13637;37;624915624;13637;393;14820;14979;5.80;0.35;314.55;14.82;1183;39;5141.00;159
13642;37;624915640;13642;394;14822;14979;5.69;0.35;314.51;14.83;1180;39;5142.00;157
13644;37;624915655;13644;394;14825;14983;5.69;0.35;314.51;14.82;1181;39;5143.00;158
13646;37;624915670;13646;389;14826;14983;5.67;0.34;314.54;14.82;1180;39;5144.00;157
13650;37;624915684;13650;390;14826;14983;5.68;0.35;314.57;14.82;1176;39;5145.00;157
13654;37;624915698;13654;394;14826;14983;5.69;0.35;314.65;14.82;1172;39;5146.00;157
13658;37;624915713;13658;381;14826;14983;5.69;0.35;314.67;14.82;1168;39;5147.00;157
13662;37;624915728;13662;375;14836;14995;5.74;0.35;314.74;14.81;1174;39;5148.00;159
13664;37;624915746;13664;366;14836;14995;5.80;0.35;314.81;14.81;1172;39;5149.00;159
13668;37;624915761;13668;351;14837;14995;5.87;0.36;314.83;14.81;1169;39;5150.00;158
13672;37;624915776;13672;345;14837;14995;5.87;0.36;314.84;14.81;1165;39;5151.00;158
13676;37;624915798;13676;343;14837;14995;5.88;0.36;314.95;14.81;1161;39;5152.00;158
13678;37;624915814;13678;346;14837;14995;5.91;0.36;314.97;14.81;1159;39;5153.00;158
13680;37;624915829;13680;340;14837;14996;5.94;0.36;314.99;14.81;1157;39;5154.00;159
13682;37;624915845;13682;347;14839;14998;5.93;0.36;315.01;14.81;1157;39;5155.00;159
13687;37;624915859;13687;328;14844;15004;6.00;0.36;315.08;14.81;1157;39;5156.00;160
13688;37;624915874;13688;318;14845;15005;6.06;0.37;315.06;14.81;1157;39;5157.00;160
13690;37;624915889;13690;309;14845;15005;6.13;0.37;315.06;14.81;1155;39;5158.00;160
13691;37;624915904;13691;301;14845;15005;6.22;0.38;315.07;14.81;1154;39;5159.00;160
13695;37;624915920;13695;289;14849;15010;6.34;0.39;315.08;14.80;1154;39;5160.00;161
13698;37;624915935;13698;285;14849;15010;6.44;0.39;315.10;14.80;1151;39;5161.00;161
13701;37;624915950;13701;272;14849;15010;6.53;0.40;315.11;14.80;1148;39;5162.00;161
13703;37;624915964;13703;274;14850;15011;6.58;0.40;315.18;14.80;1147;39;5163.00;161
13705;37;624915980;13705;280;14853;15015;6.58;0.40;315.22;14.80;1148;39;5164.00;162
13711;37;624915994;13711;276;14853;15015;6.54;0.40;315.31;14.80;1142;39;5165.00;162
13713;37;624916009;13713;284;14855;15018;6.55;0.40;315.35;14.80;1142;39;5166.00;163
13715;37;624916024;13715;281;14855;15018;6.57;0.40;315.38;14.80;1140;39;5167.00;163
13716;37;624916038;13716;286;14856;15018;6.63;0.40;315.36;14.80;1140;39;5168.00;162
13719;37;624916052;13719;282;14856;15018;6.68;0.41;315.38;14.80;1137;39;5169.00;162
13722;37;624916066;13722;281;14860;15022;6.70;0.41;315.41;14.79;1138;39;5170.00;162
13724;37;624916081;13724;283;14860;15022;6.71;0.41;315.49;14.79;1136;39;5171.00;162
13727;37;624916095;13727;278;14860;15022;6.72;0.41;315.50;14.79;1133;39;5172.00;162
13730;37;624916110;13730;278;14860;15022;6.74;0.41;315.52;14.79;1130;39;5173.00;162
13734;37;624916123;13734;276;14860;15023;6.68;0.41;315.55;14.79;1126;39;5174.00;163
13738;37;624916138;13738;273;14862;15025;6.64;0.40;315.55;14.79;1124;39;5175.00;163
13741;37;624916152;13741;262;14862;15025;6.57;0.40;315.57;14.79;1121;39;5176.00;163
13741;37;624916165;13741;258;14864;15026;6.58;0.40;315.57;14.91;1123;39;5177.00;162
13743;37;624916181;13743;257;14864;15026;6.54;0.40;315.60;14.91;1121;39;5178.00;162
13746;37;624916194;13746;264;14864;15026;6.51;0.40;315.65;14.91;1118;39;5179.00;162
13747;37;624916207;13747;258;14864;15026;6.50;0.40;315.63;14.91;1117;39;5180.00;162
13750;37;624916221;13750;260;14864;15026;6.51;0.40;315.62;14.91;1114;39;5181.00;162
13753;37;624916234;13753;249;14864;15026;6.49;0.40;315.66;14.91;1111;39;5182.00;162
13757;37;624916248;13757;250;14864;15026;6.50;0.40;315.66;14.91;1107;39;5183.00;162
13762;37;624916262;13762;272;14939;15153;6.62;0.41;315.69;14.83;1177;39;5184.00;214
13764;37;624916286;13764;264;14940;15154;6.64;0.41;315.68;14.83;1176;39;5185.00;214
13766;37;624916300;13766;258;14945;15154;6.67;0.41;315.69;14.83;1179;39;5186.00;209
13771;37;624916315;13771;252;14946;15154;6.68;0.41;315.80;14.83;1175;39;5187.00;208
13772;37;624916330;13772;248;14950;15154;6.67;0.41;315.80;14.82;1178;39;5188.00;204
13774;37;624916345;13774;242;14951;15154;6.65;0.41;315.83;14.82;1177;39;5189.00;203
13779;37;624916363;13779;250;14953;15154;6.66;0.41;315.93;14.82;1174;39;5190.00;201
13780;37;624916378;13780;255;14955;15154;6.72;0.41;315.94;14.82;1175;39;5191.00;199
13784;37;624916393;13784;264;14957;15155;6.71;0.41;315.96;14.82;1173;39;5192.00;198
13788;37;624916409;13788;268;14960;15156;6.71;0.41;315.95;14.82;1172;39;5193.00;196
13790;37;624916424;13790;275;14962;15156;6.77;0.41;315.98;14.82;1172;39;5194.00;194
13790;37;624916438;13790;275;14963;15157;6.72;0.41;315.98;14.82;1173;39;5195.00;194
13795;37;624916453;13795;277;14967;15157;6.69;0.41;316.02;14.82;1172;39;5196.00;190
13795;37;624916467;13795;279;14969;15157;6.71;0.41;316.02;14.82;1174;39;5197.00;188
13800;37;624916482;13800;278;14970;15157;6.66;0.41;316.03;14.82;1170;39;5198.00;187
13805;37;624916495;13805;281;14974;15161;6.57;0.40;315.99;14.81;1169;39;5199.00;187
13806;37;624916511;13806;287;14975;15161;6.54;0.40;316.01;14.81;1169;39;5200.00;186
13811;37;624916530;13811;282;14977;15161;6.43;0.39;316.03;14.81;1166;39;5201.00;184
13816;37;624916549;13816;288;14979;15164;6.35;0.39;315.99;14.81;1163;39;5202.00;185
13819;37;624916564;13819;285;14981;15164;6.34;0.39;316.04;14.81;1162;39;5203.00;183
13824;37;624916577;13824;284;14984;15164;6.28;0.38;316.00;14.81;1160;39;5204.00;180
13826;37;624916597;13826;289;14991;15168;6.27;0.38;316.00;14.84;1165;39;5205.00;177
13828;37;624916613;13828;288;14993;15169;6.24;0.38;316.00;14.84;1165;39;5206.00;176
13830;37;624916627;13830;293;14993;15169;6.27;0.38;316.03;14.84;1163;39;5207.00;176
13833;37;624916641;13833;290;14996;15173;6.32;0.39;316.10;14.83;1163;39;5208.00;177
13837;37;624916655;13837;293;14997;15173;6.36;0.39;316.07;14.83;1160;39;5209.00;176
13839;37;624916668;13839;297;14997;15173;6.38;0.39;316.07;14.83;1158;39;5210.00;176
13844;37;624916681;13844;301;14998;15174;6.36;0.39;316.05;14.83;1154;39;5211.00;176
13846;37;624916695;13846;303;14998;15174;6.34;0.38;316.02;14.83;1152;39;5212.00;176
13847;37;624916707;13847;308;15003;15180;6.39;0.39;316.01;14.83;1156;39;5213.00;177
13847;37;624916721;13847;308;15003;15180;6.31;0.38;316.01;14.83;1156;39;5214.00;177
13852;37;624916734;13852;311;15003;15180;6.22;0.38;316.01;14.83;1151;39;5215.00;177
13852;37;624916748;13852;316;15003;15181;6.18;0.38;316.01;14.83;1151;39;5216.00;178
13854;37;624916760;13854;319;15005;15181;6.12;0.37;315.98;14.83;1151;39;5217.00;176
13857;37;624916773;13857;327;15006;15181;6.05;0.37;315.93;14.83;1149;39;5218.00;175
13860;37;624916785;13860;341;15006;15181;6.01;0.37;315.89;14.83;1146;39;5219.00;175
13862;37;624916808;13862;342;15029;15217;5.95;0.36;315.89;14.81;1167;39;5220.00;188
13864;37;624916835;13864;345;15030;15217;5.93;0.36;315.91;14.81;1166;39;5221.00;187
13867;37;624916859;13867;346;15033;15217;5.94;0.36;315.86;14.80;1166;39;5222.00;184
13870;37;624916880;13870;346;15033;15217;5.88;0.36;315.93;14.80;1163;39;5223.00;184
13875;37;624916899;13875;352;15036;15217;5.80;0.35;315.91;14.80;1161;39;5224.00;181
13877;37;624916916;13877;360;15036;15217;5.72;0.35;315.90;14.80;1159;39;5225.00;181
13878;37;624916930;13878;361;15040;15221;5.70;0.35;315.89;14.80;1162;39;5226.00;181
13880;37;624916945;13880;357;15040;15221;5.63;0.34;315.87;14.80;1160;39;5227.00;181
13881;37;624916959;13881;363;15044;15225;5.62;0.34;315.86;14.79;1163;39;5228.00;181
13884;37;624916973;13884;371;15045;15226;5.59;0.34;315.82;14.79;1161;39;5229.00;181
13884;37;624916987;13884;378;15046;15226;5.56;0.34;315.82;14.81;1162;39;5230.00;180
13887;37;624917001;13887;385;15047;15226;5.48;0.33;315.80;14.82;1160;39;5231.00;179
13889;37;624917014;13889;391;15059;15239;5.39;0.33;315.76;14.82;1170;39;5232.00;180
13889;37;624917028;13889;397;15059;15239;5.34;0.32;315.76;14.82;1170;39;5233.00;180
13890;37;624917041;13890;403;15060;15239;5.30;0.32;315.76;14.83;1170;39;5234.00;179
13890;37;624917053;13890;394;15061;15240;5.30;0.32;315.76;14.83;1171;39;5235.00;179
13891;37;624917066;13891;395;15063;15241;5.27;0.32;315.81;14.85;1172;39;5236.00;178
13892;37;624917079;13892;401;15063;15241;5.25;0.32;315.80;14.85;1171;39;5237.00;178
13893;37;624917091;13893;402;15066;15244;5.26;0.32;315.78;14.86;1173;39;5238.00;178
13895;37;624917104;13895;405;15067;15244;5.30;0.32;315.78;14.87;1172;39;5239.00;177
13897;37;624917116;13897;408;15069;15244;5.32;0.32;315.78;14.88;1172;39;5240.00;175
13897;37;624917128;13897;405;15070;15244;5.35;0.33;315.78;14.89;1173;39;5241.00;174
13900;37;624917150;13900;407;15076;15250;5.38;0.33;315.82;14.90;1176;39;5242.00;174
13903;37;624917164;13903;405;15078;15250;5.35;0.33;315.78;14.92;1175;39;5243.00;172
13903;37;624917177;13903;405;15078;15250;5.33;0.33;315.78;14.92;1175;39;5244.00;172
13904;37;624917190;13904;409;15080;15250;5.31;0.32;315.78;14.94;1176;39;5245.00;170
13904;37;624917203;13904;402;15083;15254;5.30;0.32;315.78;14.93;1179;39;5246.00;171
13905;37;624917216;13905;406;15085;15255;5.26;0.32;315.79;14.94;1180;39;5247.00;170
13907;37;624917229;13907;406;15087;15255;5.22;0.32;315.75;14.95;1180;39;5248.00;168
13908;37;624917248;13908;412;15088;15256;5.20;0.32;315.76;14.95;1180;39;5249.00;168
13909;37;624917262;13909;405;15090;15256;5.15;0.32;315.75;14.97;1181;39;5250.00;166
13909;37;624917275;13909;410;15090;15256;5.09;0.31;315.75;14.97;1181;39;5251.00;166
13911;37;624917288;13911;404;15092;15256;5.07;0.31;315.77;14.98;1181;39;5252.00;164
13913;37;624917301;13913;401;15092;15256;5.06;0.31;315.75;14.98;1179;39;5253.00;164
13915;37;624917313;13915;398;15095;15256;5.03;0.31;315.74;14.99;1180;39;5254.00;161
13917;37;624917327;13917;397;15095;15256;5.04;0.31;315.75;14.99;1178;39;5255.00;161
13918;37;624917339;13918;397;15126;15326;5.21;0.32;315.77;14.96;1208;39;5256.00;200
13921;37;624917359;13921;403;15129;15327;5.16;0.32;315.83;14.97;1208;39;5257.00;198
13921;37;624917378;13921;394;15137;15327;5.23;0.32;315.83;14.97;1216;39;5258.00;190
13925;37;624917391;13925;398;15144;15327;5.20;0.32;315.87;14.97;1219;39;5259.00;183
13925;37;624917403;13925;398;15150;15327;5.20;0.32;315.87;14.97;1225;39;5260.00;177
13928;37;624917416;13928;401;15154;15327;5.16;0.32;315.83;14.98;1226;39;5261.00;173
13931;37;624917429;13931;395;15156;15327;5.13;0.31;315.80;14.98;1225;39;5262.00;171
13936;38;624917442;13936;399;15158;15327;5.06;0.31;315.77;14.98;1222;40;5263.00;169
13938;38;624917462;13938;391;15161;15328;5.04;0.31;315.83;14.99;1223;40;5264.00;167
13943;38;624917476;13943;403;15165;15330;4.99;0.30;315.88;15.00;1222;40;5265.00;165
13946;38;624917490;13946;400;15166;15330;4.95;0.30;315.91;15.00;1220;40;5266.00;164
13949;38;624917504;13949;409;15172;15334;4.92;0.30;315.90;15.00;1223;40;5267.00;162
13952;38;624917518;13952;415;15174;15334;4.93;0.30;315.90;15.01;1222;40;5268.00;160
13956;38;624917531;13956;411;15174;15334;4.91;0.30;315.93;15.01;1218;40;5269.00;160
13960;38;624917544;13960;411;15175;15334;4.94;0.30;315.95;15.02;1215;40;5270.00;159
13963;38;624917557;13963;414;15180;15340;5.01;0.31;316.00;15.03;1217;40;5271.00;160
13966;38;624917572;13966;410;15182;15340;5.05;0.31;316.07;15.04;1216;40;5272.00;158
13968;38;624917589;13968;407;15183;15340;5.10;0.31;316.08;15.05;1215;40;5273.00;157
13971;38;624917604;13971;403;15184;15343;5.14;0.31;316.07;15.05;1213;40;5274.00;159
13974;38;624917618;13974;397;15185;15343;5.17;0.32;316.11;15.06;1211;40;5275.00;158
13977;38;624917639;13977;400;15186;15343;5.18;0.32;316.13;15.07;1209;40;5276.00;157
13981;38;624917652;13981;395;15187;15344;5.17;0.32;316.21;15.07;1206;40;5277.00;157
13983;38;624917666;13983;389;15189;15345;5.27;0.32;316.23;15.07;1206;40;5278.00;156
13986;38;624917680;13986;390;15189;15345;5.30;0.32;316.30;15.07;1203;40;5279.00;156
13989;38;624917695;13989;387;15204;15371;5.42;0.33;316.33;15.06;1215;40;5280.00;167
13993;38;624917711;13993;378;15205;15371;5.48;0.33;316.33;15.06;1212;40;5281.00;166
13997;38;624917726;13997;373;15208;15371;5.55;0.34;316.31;15.06;1211;40;5282.00;163
14000;38;624917741;14000;368;15210;15372;5.66;0.35;316.39;15.05;1210;40;5283.00;162
14003;38;624917757;14003;365;15212;15372;5.73;0.35;316.40;15.05;1209;40;5284.00;160
14006;38;624917771;14006;364;15216;15376;5.81;0.35;316.41;15.05;1210;40;5285.00;160
14012;38;624917787;14012;357;15216;15376;5.85;0.36;316.50;15.05;1204;40;5286.00;160
14018;38;624917819;14018;358;15221;15379;5.87;0.36;316.51;15.17;1203;40;5287.00;158
14023;38;624917836;14023;357;15221;15380;5.89;0.36;316.68;15.17;1198;40;5288.00;159
14027;38;624917850;14027;356;15221;15380;5.90;0.36;316.73;15.17;1194;40;5289.00;159
14034;38;624917864;14034;357;15222;15380;5.87;0.36;316.78;15.17;1188;40;5290.00;158
14037;38;624917878;14037;351;15222;15380;5.89;0.36;316.85;15.17;1185;40;5291.00;158
14043;38;624917892;14043;349;15232;15392;5.96;0.36;316.82;15.16;1189;40;5292.00;160
14047;38;624917907;14047;357;15233;15392;5.97;0.36;316.91;15.15;1186;40;5293.00;159
14048;38;624917921;14048;360;15233;15392;5.99;0.36;316.94;15.15;1185;40;5294.00;159
14052;38;624917935;14052;355;15233;15392;5.97;0.36;317.05;15.15;1181;40;5295.00;159
14054;38;624917949;14054;362;15233;15392;5.93;0.36;317.08;15.15;1179;40;5296.00;159
14055;38;624917962;14055;364;15233;15392;5.92;0.36;317.12;15.15;1178;40;5297.00;159
14062;38;624917977;14062;366;15233;15393;5.84;0.35;317.16;15.15;1171;40;5298.00;160
14064;38;624917990;14064;368;15233;15393;5.85;0.35;317.17;15.15;1169;40;5299.00;160
14068;38;624918006;14068;375;15238;15399;5.85;0.35;317.17;15.15;1170;40;5300.00;161
14071;38;624918028;14071;372;15239;15400;5.83;0.35;317.21;15.15;1168;40;5301.00;161
14075;38;624918042;14075;375;15239;15400;5.80;0.35;317.19;15.15;1164;40;5302.00;161
14080;38;624918062;14080;380;15239;15400;5.82;0.35;317.29;15.15;1159;40;5303.00;161
14087;38;624918075;14087;380;15242;15404;5.79;0.35;317.38;15.15;1155;40;5304.00;162
14091;38;624918089;14091;377;15242;15404;5.77;0.35;317.47;15.15;1151;40;5305.00;162
14094;38;624918103;14094;388;15242;15404;5.73;0.35;317.52;15.15;1148;40;5306.00;162
14097;38;624918116;14097;382;15243;15405;5.70;0.35;317.55;15.15;1146;40;5307.00;162
14100;38;624918129;14100;382;15246;15409;5.70;0.35;317.53;15.14;1146;40;5308.00;163
14103;38;624918142;14103;382;15246;15409;5.70;0.35;317.55;15.14;1143;40;5309.00;163
14107;38;624918158;14107;390;15250;15415;5.68;0.35;317.53;15.14;1143;40;5310.00;165
14111;38;624918171;14111;389;15251;15415;5.67;0.35;317.58;15.14;1140;40;5311.00;164
14113;38;624918184;14113;390;15252;15415;5.71;0.35;317.56;15.14;1139;40;5312.00;163
14120;38;624918197;14120;396;15252;15415;5.72;0.35;317.68;15.14;1132;40;5313.00;163
14121;38;624918213;14121;401;15256;15419;5.77;0.35;317.68;15.13;1135;40;5314.00;163
14126;38;624918227;14126;405;15256;15419;5.75;0.35;317.74;15.13;1130;40;5315.00;163
14129;38;624918240;14129;406;15256;15419;5.73;0.35;317.73;15.13;1127;40;5316.00;163
14134;38;624918253;14134;395;15256;15419;5.72;0.35;317.83;15.13;1122;40;5317.00;163
14139;38;624918267;14139;389;15256;15420;5.64;0.34;317.91;15.13;1117;40;5318.00;164
14141;38;624918280;14141;386;15257;15421;5.61;0.34;317.93;15.13;1116;40;5319.00;164
14143;38;624918293;14143;391;15257;15421;5.56;0.34;317.94;15.13;1114;40;5320.00;164
14145;38;624918306;14145;387;15258;15422;5.56;0.34;318.00;15.13;1113;40;5321.00;164
14149;38;624918319;14149;390;15258;15422;5.54;0.34;318.01;15.13;1109;40;5322.00;164
14152;38;624918332;14152;389;15258;15422;5.55;0.34;318.07;15.13;1106;40;5323.00;164
14155;38;624918345;14155;396;15258;15422;5.56;0.34;318.10;15.13;1103;40;5324.00;164
14157;38;624918358;14157;400;15258;15422;5.56;0.34;318.12;15.13;1101;40;5325.00;164
14162;38;624918371;14162;390;15258;15422;5.54;0.34;318.12;15.13;1096;40;5326.00;164
14164;38;624918385;14164;387;15258;15422;5.53;0.34;318.11;15.13;1094;40;5327.00;164
14166;38;624918398;14166;405;15328;15549;5.67;0.35;318.11;15.06;1162;40;5328.00;221
14170;38;624918421;14170;391;15330;15550;5.67;0.35;318.18;15.06;1160;40;5329.00;220
14172;38;624918435;14172;378;15337;15550;5.80;0.36;318.17;15.05;1165;40;5330.00;213
14174;38;624918449;14174;372;15338;15550;5.89;0.36;318.19;15.05;1164;40;5331.00;212
14176;38;624918462;14176;366;15343;15550;6.06;0.37;318.20;15.05;1167;40;5332.00;207
14180;38;624918477;14180;361;15343;15550;6.12;0.38;318.26;15.05;1163;40;5333.00;207
14180;38;624918491;14180;372;15346;15550;6.26;0.38;318.26;15.05;1166;40;5334.00;204
14185;38;624918505;14185;370;15349;15550;6.35;0.39;318.34;15.05;1164;40;5335.00;201
14190;38;624918519;14190;366;15353;15551;6.41;0.39;318.36;15.04;1163;40;5336.00;198
14192;38;624918534;14192;361;15359;15552;6.45;0.39;318.37;15.04;1167;40;5337.00;193
14193;38;624918547;14193;368;15363;15552;6.45;0.39;318.36;15.04;1170;40;5338.00;189
14198;38;624918562;14198;368;15365;15553;6.44;0.39;318.39;15.04;1167;40;5339.00;188
14205;38;624918578;14205;367;15365;15553;6.42;0.39;318.51;15.04;1160;40;5340.00;188
14205;38;624918593;14205;365;15369;15553;6.43;0.39;318.51;15.04;1164;40;5341.00;184
14207;38;624918607;14207;361;15369;15553;6.42;0.39;318.52;15.04;1162;40;5342.00;184
14209;38;624918621;14209;361;15374;15557;6.45;0.39;318.56;15.04;1165;40;5343.00;183
14213;38;624918635;14213;367;15374;15557;6.41;0.39;318.56;15.04;1161;40;5344.00;183
14215;38;624918650;14215;370;15375;15557;6.34;0.39;318.58;15.04;1160;40;5345.00;182
14218;38;624918664;14218;374;15377;15560;6.30;0.39;318.57;15.03;1159;40;5346.00;183
14223;38;624918678;14223;375;15378;15560;6.30;0.38;318.63;15.03;1155;40;5347.00;182
14223;38;624918692;14223;379;15379;15560;6.28;0.38;318.63;15.03;1156;40;5348.00;181
14227;38;624918712;14227;385;15383;15564;6.30;0.38;318.62;15.03;1156;40;5349.00;181
14228;38;624918726;14228;383;15385;15565;6.34;0.39;318.62;15.03;1157;40;5350.00;180
14228;38;624918740;14228;393;15386;15565;6.32;0.39;318.62;15.03;1158;40;5351.00;179
14231;38;624918754;14231;390;15389;15569;6.28;0.38;318.58;15.03;1158;40;5352.00;180
14234;38;624918768;14234;392;15391;15569;6.30;0.38;318.60;15.03;1157;40;5353.00;178
14238;38;624918781;14238;399;15391;15569;6.29;0.38;318.64;15.03;1153;40;5354.00;178
14240;38;624918799;14240;386;15393;15571;6.29;0.38;318.62;15.03;1153;40;5355.00;178
14242;38;624918820;14242;389;15394;15571;6.30;0.38;318.64;15.03;1152;40;5356.00;177
14244;38;624918845;14244;391;15398;15577;6.30;0.38;318.68;15.02;1154;40;5357.00;179
14247;38;624918866;14247;396;15399;15577;6.28;0.38;318.65;15.02;1152;40;5358.00;178
14249;38;624918886;14249;402;15399;15577;6.24;0.38;318.72;15.02;1150;40;5359.00;178
14251;38;624918906;14251;404;15399;15578;6.22;0.38;318.69;15.02;1148;40;5360.00;179
14253;38;624918922;14253;406;15399;15578;6.24;0.38;318.71;15.02;1146;40;5361.00;179
14255;38;624918938;14255;402;15399;15578;6.22;0.38;318.69;15.02;1144;40;5362.00;179
14258;38;624918953;14258;399;15399;15578;6.20;0.38;318.71;15.02;1141;40;5363.00;179
14261;38;624918968;14261;405;15408;15590;6.23;0.38;318.71;15.01;1147;40;5364.00;182
14263;38;624918984;14263;407;15408;15590;6.24;0.38;318.70;15.01;1145;40;5365.00;182
14266;38;624918998;14266;410;15410;15590;6.23;0.38;318.68;15.01;1144;40;5366.00;180
14267;38;624919013;14267;407;15410;15590;6.21;0.38;318.68;15.01;1143;40;5367.00;180
14272;38;624919026;14272;408;15410;15590;6.15;0.37;318.66;15.01;1138;40;5368.00;180
14276;38;624919040;14276;409;15410;15590;6.11;0.37;318.71;15.01;1134;40;5369.00;180
14280;38;624919055;14280;403;15413;15594;6.06;0.37;318.66;15.01;1133;40;5370.00;181
14281;38;624919069;14281;399;15413;15594;6.04;0.37;318.64;15.01;1132;40;5371.00;181
14283;38;624919081;14283;394;15417;15598;6.04;0.37;318.62;15.01;1134;40;5372.00;181
14289;38;624919104;14289;401;15418;15599;5.95;0.36;318.55;15.01;1129;40;5373.00;181
14293;38;624919119;14293;397;15419;15599;5.89;0.36;318.48;15.02;1126;40;5374.00;180
14296;38;624919134;14296;396;15420;15599;5.82;0.35;318.51;15.03;1124;40;5375.00;179
14297;38;624919148;14297;402;15431;15612;5.77;0.35;318.49;15.02;1134;40;5376.00;181
14298;38;624919164;14298;392;15432;15612;5.74;0.35;318.47;15.15;1134;40;5377.00;180
14300;38;624919178;14300;398;15432;15612;5.74;0.35;318.48;15.15;1132;40;5378.00;180
14302;38;624919191;14302;397;15433;15613;5.74;0.35;318.48;15.15;1131;40;5379.00;180
14307;38;624919205;14307;403;15433;15614;5.76;0.35;318.45;15.15;1126;40;5380.00;181
14308;38;624919221;14308;406;15433;15614;5.79;0.35;318.43;15.15;1125;40;5381.00;181
14310;38;624919234;14310;399;15435;15617;5.80;0.35;318.41;15.14;1125;40;5382.00;182
14313;38;624919248;14313;406;15436;15617;5.78;0.35;318.48;15.14;1123;40;5383.00;181
14317;38;624919261;14317;414;15436;15617;5.76;0.35;318.46;15.14;1119;40;5384.00;181
14317;38;624919276;14317;416;15436;15617;5.75;0.35;318.46;15.14;1119;40;5385.00;181
14317;38;624919290;14317;423;15441;15623;5.74;0.35;318.46;15.14;1124;40;5386.00;182
14318;38;624919304;14318;411;15441;15623;5.68;0.35;318.46;15.14;1123;40;5387.00;182
14318;38;624919318;14318;401;15441;15623;5.66;0.35;318.46;15.14;1123;40;5388.00;182
14319;38;624919331;14319;393;15441;15623;5.63;0.34;318.47;15.14;1122;40;5389.00;182
14321;38;624919344;14321;392;15444;15627;5.62;0.34;318.48;15.14;1123;40;5390.00;183
14322;38;624919358;14322;392;15445;15628;5.61;0.34;318.47;15.14;1123;40;5391.00;183
14324;38;624919370;14324;393;15445;15628;5.62;0.34;318.45;15.14;1121;40;5392.00;183
14327;38;624919383;14327;395;15446;15629;5.61;0.34;318.52;15.13;1119;40;5393.00;183
14331;38;624919410;14331;389;15446;15629;5.55;0.34;318.52;15.13;1115;40;5394.00;183
14332;38;624919423;14332;389;15446;15629;5.59;0.34;318.51;15.13;1114;40;5395.00;183
14333;38;624919436;14333;390;15447;15629;5.64;0.34;318.50;15.14;1114;40;5396.00;182
14335;38;624919449;14335;404;15447;15629;5.62;0.34;318.48;15.14;1112;40;5397.00;182
14336;38;624919462;14336;397;15447;15629;5.60;0.34;318.48;15.14;1111;40;5398.00;182
14338;38;624919476;14338;402;15447;15629;5.59;0.34;318.49;15.14;1109;40;5399.00;182
