step_arrived;step_collisions;step_duration;step_ended;step_halting;step_inserted;step_loaded;step_meanSpeed;step_meanSpeedRelative;step_meanTravelTime;step_meanWaitingTime;step_running;step_teleports;step_time;step_waiting
0;0;621437867;0;1;86;245;16.13;1.14;-1.00;0.00;86;0;0.00;159
0;0;621437894;0;0;99;245;15.27;1.06;-1.00;0.13;99;0;1.00;146
0;0;621437895;0;2;120;245;14.34;0.98;-1.00;0.46;120;0;2.00;125
0;0;621437896;0;3;133;245;13.38;0.90;-1.00;0.71;133;0;3.00;112
0;0;621437897;0;4;149;245;12.40;0.83;-1.00;1.06;149;0;4.00;96
0;0;621437898;0;5;157;245;11.64;0.78;-1.00;1.26;157;0;5.00;88
0;0;621437900;0;9;169;245;10.75;0.72;-1.00;1.60;169;0;6.00;76
0;0;621437901;0;11;178;245;9.91;0.66;-1.00;1.87;178;0;7.00;67
0;0;621437903;0;17;184;246;9.49;0.63;-1.00;2.07;184;0;8.00;62
0;0;621437905;0;19;191;247;9.19;0.61;-1.00;2.32;191;0;9.00;56
0;0;621437907;0;23;199;247;8.76;0.58;-1.00;2.63;199;0;10.00;48
0;0;621437909;0;23;202;248;8.57;0.56;-1.00;2.71;202;0;11.00;46
1;0;621437911;1;31;207;248;8.38;0.55;12.00;2.93;206;0;12.00;41
1;0;621437913;1;38;211;248;8.31;0.54;12.00;3.12;210;0;13.00;37
1;0;621437916;1;38;213;248;8.38;0.54;12.00;3.23;212;0;14.00;35
1;0;621437918;1;43;219;252;8.05;0.52;12.00;3.42;218;0;15.00;33
1;0;621437921;1;48;221;252;7.96;0.51;12.00;3.53;220;0;16.00;31
2;0;621437923;2;55;225;252;7.83;0.50;14.50;3.74;223;0;17.00;27
2;0;621437926;2;58;230;255;7.72;0.49;14.50;3.99;228;0;18.00;25
2;0;621437928;2;64;232;255;7.91;0.50;14.50;4.04;230;0;19.00;23
3;0;621437931;3;69;233;255;7.94;0.50;16.33;4.11;230;0;20.00;22
4;0;621437933;4;75;240;259;8.03;0.51;17.50;4.27;236;0;21.00;19
5;0;621437936;5;77;242;260;8.04;0.51;18.20;4.33;237;0;22.00;18
5;0;621437939;5;80;243;260;8.10;0.51;18.20;4.41;238;0;23.00;17
5;0;621437942;5;84;248;264;8.14;0.52;18.20;4.51;243;0;24.00;16
5;0;621437945;5;83;248;264;8.16;0.51;18.20;4.51;243;0;25.00;16
5;0;621437948;5;86;251;264;8.13;0.51;18.20;4.67;246;0;26.00;13
5;0;621437950;5;86;251;265;8.13;0.51;18.20;4.67;246;0;27.00;14
5;0;621437953;5;88;251;265;8.16;0.51;18.20;4.67;246;0;28.00;14
5;0;621437956;5;87;257;271;8.23;0.51;18.20;4.64;252;0;29.00;14
6;0;621437961;6;90;258;271;8.25;0.51;20.17;4.74;252;0;30.00;13
7;0;621437972;7;91;259;272;8.13;0.50;21.29;4.73;252;0;31.00;13
7;0;621437975;7;93;260;272;8.16;0.51;21.29;4.83;253;0;32.00;12
8;0;621437977;8;95;261;272;8.22;0.51;22.75;4.94;253;0;33.00;11
9;0;621437981;9;99;262;272;8.30;0.51;24.00;5.05;253;0;34.00;10
10;0;621437983;10;102;263;272;8.30;0.52;24.40;5.16;253;0;35.00;9
10;0;621437986;10;105;273;284;8.51;0.53;24.40;5.07;263;0;36.00;11
10;0;621437990;10;110;273;284;8.48;0.53;24.40;5.07;263;0;37.00;11
11;0;621437993;11;113;274;284;8.44;0.52;25.27;5.06;263;0;38.00;10
11;0;621437995;11;115;277;284;8.36;0.52;25.27;5.20;266;0;39.00;7
12;0;621437998;12;117;279;284;8.26;0.51;26.25;5.22;267;0;40.00;5
13;0;621438001;13;120;280;284;8.11;0.50;27.00;5.22;267;0;41.00;4
13;0;621438004;13;123;284;288;8.04;0.50;27.00;5.16;271;0;42.00;4
15;0;621438007;15;128;284;288;7.85;0.49;27.60;5.16;269;0;43.00;4
16;0;621438009;16;130;288;292;7.75;0.48;28.13;5.10;272;0;44.00;4
17;0;621438013;17;133;290;294;7.62;0.47;28.71;5.07;273;0;45.00;4
18;0;621438016;18;138;290;294;7.44;0.46;29.67;5.07;272;0;46.00;4
18;0;621438019;18;137;290;294;7.37;0.46;29.67;5.07;272;0;47.00;4
18;0;621438021;18;137;301;307;7.77;0.48;29.67;4.88;283;0;48.00;6
18;0;621438025;18;142;301;307;7.74;0.48;29.67;4.88;283;0;49.00;6
18;0;621438027;18;143;301;307;7.63;0.47;29.67;4.88;283;0;50.00;6
18;0;621438030;18;145;302;308;7.59;0.47;29.67;4.87;284;0;51.00;6
18;0;621438033;18;148;303;309;7.46;0.46;29.67;4.86;285;0;52.00;6
19;0;621438036;19;149;303;309;7.42;0.46;30.84;4.86;284;0;53.00;6
19;0;621438039;19;150;305;312;7.42;0.46;30.84;4.83;286;0;54.00;7
21;0;621438042;21;154;305;312;7.29;0.45;32.86;4.83;284;0;55.00;7
22;0;621438044;22;142;306;312;7.29;0.45;32.27;4.82;284;0;56.00;6
23;0;621438047;23;137;306;312;7.23;0.45;33.35;4.82;283;0;57.00;6
25;0;621438050;25;140;311;318;7.32;0.45;33.32;4.76;286;0;58.00;7
26;0;621438053;26;142;311;318;7.29;0.45;34.31;4.76;285;0;59.00;7
26;0;621438057;26;144;311;318;7.36;0.45;34.31;4.76;285;0;60.00;7
26;0;621438060;26;147;311;318;7.46;0.46;34.31;4.76;285;0;61.00;7
28;0;621438063;28;150;315;322;7.46;0.46;36.14;4.71;287;0;62.00;7
29;0;621438066;29;151;316;323;7.58;0.47;35.62;4.69;287;0;63.00;7
29;0;621438069;29;150;316;323;7.62;0.47;35.62;4.69;287;0;64.00;7
29;0;621438072;29;152;317;324;7.75;0.48;35.62;4.68;288;0;65.00;7
29;0;621438075;29;152;317;324;7.75;0.48;35.62;4.68;288;0;66.00;7
30;0;621438078;30;142;317;324;7.80;0.48;36.67;4.68;287;0;67.00;7
31;0;621438081;31;138;317;324;7.87;0.48;37.68;4.68;286;0;68.00;7
32;0;621438084;32;135;317;324;7.92;0.48;38.44;4.68;285;0;69.00;7
32;0;621438087;32;133;317;324;8.03;0.49;38.44;4.68;285;0;70.00;7
33;0;621438090;33;129;317;324;8.10;0.49;39.24;4.68;284;0;71.00;7
33;0;621438094;33;134;351;394;8.33;0.51;39.24;4.23;318;0;72.00;43
33;0;621438105;33;129;352;395;8.47;0.52;39.24;4.22;319;0;73.00;43
35;0;621438108;35;121;359;395;8.80;0.54;41.11;4.18;324;0;74.00;36
35;0;621438112;35;117;363;395;9.05;0.55;41.11;4.16;328;0;75.00;32
35;0;621438115;35;114;365;395;9.24;0.56;41.11;4.16;330;0;76.00;30
36;0;621438124;36;112;367;395;9.34;0.57;41.53;4.17;331;0;77.00;28
36;0;621438127;36;112;369;395;9.38;0.57;41.53;4.18;333;0;78.00;26
36;0;621438130;36;115;371;395;9.53;0.58;41.53;4.19;335;0;79.00;24
36;0;621438134;36;116;373;396;9.55;0.58;41.53;4.21;337;0;80.00;23
38;0;621438138;38;119;375;397;9.46;0.57;43.61;4.24;337;0;81.00;22
38;0;621438144;38;122;377;397;9.49;0.58;43.61;4.27;339;0;82.00;20
40;0;621438147;40;124;383;401;9.43;0.57;45.13;4.25;343;0;83.00;18
40;0;621438152;40;128;384;401;9.39;0.57;45.13;4.25;344;0;84.00;17
40;0;621438155;40;126;384;401;9.27;0.56;45.13;4.25;344;0;85.00;17
40;0;621438159;40;124;384;401;9.14;0.56;45.13;4.25;344;0;86.00;17
41;0;621438163;41;129;389;407;9.04;0.55;46.15;4.21;348;0;87.00;18
43;0;621438167;43;129;389;407;8.86;0.54;47.88;4.21;346;0;88.00;18
44;0;621438171;44;128;389;407;8.73;0.53;48.82;4.21;345;0;89.00;18
47;0;621438177;47;129;393;413;8.66;0.53;51.45;4.16;346;0;90.00;20
49;0;621438182;49;127;393;413;8.60;0.52;53.04;4.16;344;0;91.00;20
50;0;621438187;50;130;395;413;8.65;0.53;53.82;4.15;345;0;92.00;18
50;0;621438191;50;130;396;414;8.56;0.52;53.82;4.14;346;0;93.00;18
50;0;621438194;50;130;397;415;8.59;0.52;53.82;4.14;347;0;94.00;18
52;0;621438198;52;133;397;415;8.59;0.52;55.29;4.14;345;0;95.00;18
52;0;621438203;52;136;408;428;8.62;0.53;55.29;4.02;356;0;96.00;20
54;0;621438208;54;134;408;428;8.65;0.53;55.50;4.02;354;0;97.00;20
57;0;621438212;57;134;408;428;8.62;0.53;57.74;4.02;351;0;98.00;20
57;0;621438216;57;132;409;429;8.73;0.53;57.74;4.01;352;0;99.00;20
59;0;621438220;59;130;409;429;8.74;0.53;59.17;4.01;350;0;100.00;20
61;0;621438228;61;128;412;433;8.80;0.54;60.51;3.99;351;0;101.00;21
62;0;621438232;62;125;412;433;8.84;0.54;60.84;3.99;350;0;102.00;21
64;0;621438236;64;120;419;437;8.79;0.54;62.09;4.37;355;0;103.00;18
64;0;621438241;64;114;419;437;8.91;0.54;62.09;4.37;355;0;104.00;18
65;0;621438245;65;110;419;437;9.01;0.55;62.72;4.37;354;0;105.00;18
65;0;621438250;65;104;419;437;9.05;0.55;62.72;4.37;354;0;106.00;18
65;0;621438254;65;97;419;437;9.14;0.56;62.72;4.37;354;0;107.00;18
65;0;621438258;65;92;430;449;9.27;0.57;62.72;4.25;365;0;108.00;19
66;0;621438263;66;87;430;449;9.27;0.57;63.38;4.25;364;0;109.00;19
67;0;621438268;67;79;431;449;9.45;0.58;63.97;4.25;364;0;110.00;18
68;0;621438272;68;78;431;449;9.57;0.59;64.66;4.25;363;0;111.00;18
68;0;621438277;68;75;431;449;9.79;0.60;64.66;4.25;363;0;112.00;18
68;0;621438281;68;73;431;449;10.01;0.61;64.66;4.25;363;0;113.00;18
68;0;621438286;68;73;432;450;10.22;0.63;64.66;4.24;364;0;114.00;18
68;0;621438290;68;72;432;450;10.27;0.63;64.66;4.24;364;0;115.00;18
69;0;621438295;69;72;437;456;10.34;0.64;65.38;4.20;368;0;116.00;19
70;0;621438301;70;70;438;457;10.37;0.64;66.03;4.46;368;0;117.00;19
73;0;621438305;73;70;439;457;10.42;0.64;68.05;4.45;366;0;118.00;18
76;0;621438310;76;71;440;457;10.49;0.64;70.05;4.71;364;0;119.00;17
78;0;621438317;78;74;445;462;10.61;0.65;71.27;4.77;367;0;120.00;17
80;0;621438322;80;73;447;462;10.67;0.65;72.44;5.13;367;0;121.00;15
80;0;621438328;80;74;447;462;10.76;0.65;72.44;5.13;367;0;122.00;15
81;0;621438333;81;74;451;463;10.79;0.65;73.06;5.48;370;0;123.00;12
82;0;621438338;82;78;455;467;10.81;0.65;73.66;5.44;373;0;124.00;12
83;0;621438344;83;82;456;467;10.89;0.66;73.84;5.59;373;0;125.00;11
84;0;621438349;84;85;460;470;11.05;0.67;74.31;5.78;376;0;126.00;10
85;0;621438355;85;86;461;470;11.17;0.68;74.51;5.89;376;0;127.00;9
87;0;621438360;87;84;462;470;11.37;0.69;75.74;5.88;375;0;128.00;8
87;0;621438366;87;85;463;470;11.49;0.70;75.74;5.99;376;0;129.00;7
88;0;621438372;88;83;467;474;11.71;0.72;76.35;6.07;379;0;130.00;7
88;0;621438378;88;86;470;474;11.80;0.72;76.35;6.27;382;0;131.00;4
89;0;621438385;89;87;471;474;11.91;0.73;76.17;6.29;382;0;132.00;3
91;0;621438392;91;87;472;474;11.98;0.73;76.22;6.28;381;0;133.00;2
91;0;621438399;91;88;474;475;11.93;0.73;76.22;6.34;383;0;134.00;1
91;0;621438405;91;88;476;477;11.86;0.73;76.22;6.31;385;0;135.00;1
93;0;621438411;93;89;476;477;11.88;0.73;77.26;6.31;383;0;136.00;1
93;0;621438417;93;90;478;478;11.81;0.72;77.26;6.32;385;0;137.00;0
94;0;621438423;94;92;478;478;11.66;0.71;77.90;6.32;384;0;138.00;0
96;0;621438436;96;92;478;478;11.60;0.71;78.40;6.32;382;0;139.00;0
96;0;621438441;96;94;478;478;11.52;0.71;78.40;6.32;382;0;140.00;0
97;0;621438446;97;94;478;478;11.43;0.70;79.04;6.32;381;0;141.00;0
98;0;621438452;98;97;478;478;11.31;0.70;78.95;6.32;380;0;142.00;0
99;0;621438457;99;100;478;478;11.24;0.70;79.54;6.32;379;0;143.00;0
99;0;621438462;99;120;548;605;11.00;0.70;79.54;5.52;449;0;144.00;57
103;0;621438478;103;112;553;606;11.01;0.70;81.80;5.48;450;0;145.00;53
104;0;621438484;104;111;563;606;11.09;0.70;82.13;5.42;459;0;146.00;43
107;0;621438490;107;114;567;606;11.00;0.69;83.14;5.40;460;0;147.00;39
108;0;621438496;108;115;573;606;10.98;0.69;83.74;5.39;465;0;148.00;33
111;0;621438502;111;115;576;606;10.88;0.68;84.36;5.39;465;0;149.00;30
112;0;621438510;112;112;581;611;10.74;0.67;84.95;5.37;469;0;150.00;30
115;0;621438517;115;112;584;611;10.69;0.67;86.52;5.38;469;0;151.00;27
115;0;621438524;115;113;587;612;10.53;0.66;86.52;5.39;472;0;152.00;25
120;0;621438530;120;115;590;613;10.49;0.65;88.72;5.41;470;0;153.00;23
124;0;621438537;124;120;592;613;10.55;0.65;90.38;5.43;468;0;154.00;21
127;0;621438542;127;122;596;614;10.48;0.65;91.30;5.44;469;0;155.00;18
128;0;621438549;128;122;601;614;10.38;0.64;91.24;5.48;473;0;156.00;13
131;0;621438555;131;126;604;614;10.30;0.64;91.48;5.51;473;0;157.00;10
132;0;621438561;132;130;604;614;10.29;0.64;90.89;5.51;472;0;158.00;10
132;0;621438567;132;134;608;618;10.25;0.63;90.89;5.50;476;0;159.00;10
133;0;621438573;133;140;609;618;10.17;0.63;90.97;5.49;476;0;160.00;9
134;0;621438578;134;144;610;618;10.06;0.62;90.96;5.51;476;0;161.00;8
135;0;621438594;135;142;612;621;9.96;0.62;91.48;5.52;477;0;162.00;9
137;0;621438603;137;145;613;621;9.85;0.61;92.47;5.55;476;0;163.00;8
140;0;621438611;140;145;614;621;9.71;0.60;92.46;5.57;474;0;164.00;7
141;0;621438619;141;144;619;625;9.57;0.59;92.97;5.60;478;0;165.00;6
143;0;621438627;143;141;620;626;9.46;0.59;92.93;5.59;477;0;166.00;6
144;0;621438648;144;143;622;626;9.25;0.57;93.44;5.63;478;0;167.00;4
146;0;621438655;146;143;627;630;9.04;0.56;94.22;5.59;481;0;168.00;3
146;0;621438663;146;151;628;630;8.90;0.55;94.22;5.60;482;0;169.00;2
146;0;621438669;146;142;628;630;8.87;0.55;94.22;5.60;482;0;170.00;2
149;0;621438676;149;136;630;631;8.81;0.55;95.02;5.59;481;0;171.00;1
149;0;621438682;149;128;630;631;8.90;0.55;95.02;5.59;481;0;172.00;1
151;0;621438688;151;126;636;637;8.99;0.56;96.05;5.55;485;0;173.00;1
153;0;621438695;153;125;636;637;8.94;0.55;96.97;5.55;483;0;174.00;1
154;0;621438701;154;126;637;638;8.96;0.55;97.32;5.54;483;0;175.00;1
154;0;621438708;154;132;637;638;9.02;0.56;97.32;5.54;483;0;176.00;1
154;0;621438715;154;126;637;638;9.12;0.57;97.32;5.54;483;0;177.00;1
155;0;621438721;155;123;638;638;9.21;0.57;97.70;5.58;483;0;178.00;0
156;0;621438727;156;123;638;638;9.34;0.58;98.13;5.58;482;0;179.00;0
158;0;621438734;158;125;669;672;9.49;0.59;97.92;5.32;511;0;180.00;3
160;0;621438745;160;118;670;672;9.55;0.59;98.90;5.31;510;0;181.00;2
160;0;621438753;160;115;671;672;9.54;0.59;98.90;5.31;511;0;182.00;1
162;0;621438760;162;123;671;672;9.58;0.59;99.37;5.31;509;0;183.00;1
165;0;621438767;165;129;672;672;9.57;0.59;100.24;5.31;507;0;184.00;0
168;0;621438774;168;129;672;672;9.54;0.59;99.69;5.31;504;0;185.00;0
170;0;621438782;170;140;676;676;9.57;0.59;99.72;5.28;506;0;186.00;0
171;0;621438789;171;149;676;676;9.61;0.59;99.79;5.28;505;0;187.00;0
175;0;621438795;175;153;680;680;9.55;0.59;100.83;5.25;505;0;188.00;0
176;0;621438803;176;156;681;681;9.43;0.58;101.31;5.25;505;0;189.00;0
180;0;621438810;180;160;681;681;9.29;0.57;101.79;5.25;501;0;190.00;0
181;0;621438817;181;168;681;681;9.16;0.56;101.52;5.25;500;0;191.00;0
183;0;621438823;183;176;694;694;9.11;0.56;100.93;5.15;511;0;192.00;0
187;0;621438831;187;176;694;694;8.96;0.55;101.20;5.15;507;0;193.00;0
190;0;621438838;190;180;694;694;8.88;0.54;101.41;5.15;504;0;194.00;0
192;0;621438844;192;181;695;695;8.82;0.54;101.13;5.14;503;0;195.00;0
192;0;621438850;192;186;696;696;8.70;0.53;101.13;5.14;504;0;196.00;0
194;0;621438856;194;190;696;696;8.60;0.53;100.88;5.14;502;0;197.00;0
195;0;621438862;195;196;698;699;8.48;0.52;101.17;5.12;503;0;198.00;1
195;0;621438868;195;200;698;699;8.27;0.51;101.17;5.12;503;0;199.00;1
195;0;621438874;195;203;699;699;8.14;0.50;101.17;5.12;504;0;200.00;0
199;0;621438884;199;208;699;699;7.92;0.49;100.47;5.12;500;0;201.00;0
202;0;621438890;202;213;705;705;7.77;0.48;100.36;5.08;503;0;202.00;0
202;0;621438896;202;215;705;705;7.69;0.47;100.36;5.08;503;0;203.00;0
205;0;621438901;205;222;705;705;7.56;0.46;101.50;5.08;500;0;204.00;0
207;0;621438907;207;225;705;705;7.42;0.46;101.33;5.08;498;0;205.00;0
209;0;621438912;209;232;709;709;7.39;0.45;100.78;5.06;500;0;206.00;0
209;0;621438918;209;236;710;710;7.40;0.45;100.78;5.05;501;0;207.00;0
210;0;621438923;210;239;710;710;7.34;0.45;100.93;5.05;500;0;208.00;0
211;0;621438935;211;242;711;711;7.25;0.45;101.42;5.05;500;0;209.00;0
213;0;621438943;213;246;711;711;7.15;0.44;101.20;5.05;498;0;210.00;0
213;0;621438948;213;251;711;711;7.05;0.43;101.20;5.05;498;0;211.00;0
214;0;621438954;214;259;711;711;6.93;0.43;100.82;5.05;497;0;212.00;0
217;0;621438960;217;263;711;711;6.86;0.42;100.59;5.05;494;0;213.00;0
219;0;621438966;219;267;711;711;6.73;0.41;101.40;5.05;492;0;214.00;0
220;0;621438972;220;270;711;711;6.68;0.41;101.89;5.05;491;0;215.00;0
222;0;621438977;222;287;754;781;6.89;0.43;102.27;4.76;532;0;216.00;27
222;0;621438988;222;272;756;782;6.88;0.43;102.27;4.75;534;0;217.00;26
223;0;621438995;223;262;762;782;6.92;0.43;102.76;4.73;539;0;218.00;20
224;0;621439000;224;242;763;782;6.95;0.43;102.87;4.72;539;0;219.00;19
225;0;621439007;225;232;765;782;7.10;0.44;103.38;4.72;540;0;220.00;17
227;0;621439014;227;230;767;782;7.21;0.44;104.14;4.72;540;0;221.00;15
227;0;621439020;227;229;769;782;7.38;0.45;104.14;4.73;542;0;222.00;13
227;0;621439026;227;229;770;782;7.56;0.46;104.14;4.73;543;0;223.00;12
229;0;621439033;229;230;772;783;7.66;0.47;105.17;4.74;543;0;224.00;11
230;0;621439040;230;233;774;785;7.66;0.47;105.67;4.74;544;0;225.00;11
231;0;621439047;231;217;777;785;7.75;0.47;105.78;4.76;546;0;226.00;8
232;0;621439054;232;206;784;789;7.81;0.48;106.09;4.76;552;0;227.00;5
234;0;621439062;234;208;787;789;7.84;0.48;107.09;4.78;553;0;228.00;2
234;0;621439069;234;196;789;789;7.92;0.48;107.09;4.79;555;0;229.00;0
235;0;621439083;235;194;789;789;8.01;0.49;106.74;4.79;554;0;230.00;0
235;0;621439092;235;189;795;795;8.20;0.50;106.74;4.76;560;0;231.00;0
237;0;621439100;237;189;795;795;8.30;0.51;107.41;4.76;558;0;232.00;0
238;0;621439107;238;181;795;795;8.41;0.51;107.92;4.76;557;0;233.00;0
240;0;621439114;240;179;797;798;8.54;0.52;107.80;4.75;557;0;234.00;1
241;0;621439122;241;177;797;798;8.62;0.53;108.32;4.75;556;0;235.00;1
243;0;621439129;243;177;798;798;8.69;0.53;108.99;4.75;555;0;236.00;0
244;0;621439136;244;169;799;799;8.75;0.54;109.00;4.74;555;0;237.00;0
244;0;621439144;244;162;800;800;8.84;0.54;109.00;4.74;556;0;238.00;0
246;0;621439151;246;153;800;800;8.90;0.55;109.18;4.74;554;0;239.00;0
249;0;621439160;249;154;825;826;8.91;0.55;109.98;4.59;576;0;240.00;1
252;0;621439170;252;145;825;826;8.96;0.55;110.01;4.59;573;0;241.00;1
256;0;621439177;256;142;826;826;9.07;0.55;110.93;4.59;570;0;242.00;0
257;0;621439186;257;137;827;827;9.15;0.56;111.20;4.59;570;0;243.00;0
259;0;621439193;259;136;827;827;9.22;0.56;111.58;4.59;568;0;244.00;0
262;0;621439200;262;133;831;831;9.30;0.57;112.37;4.57;569;0;245.00;0
262;0;621439208;262;131;831;831;9.41;0.57;112.37;4.57;569;0;246.00;0
266;0;621439215;266;133;835;835;9.40;0.57;113.05;4.55;569;0;247.00;0
268;0;621439224;268;136;835;835;9.51;0.58;113.12;4.55;567;0;248.00;0
271;0;621439231;271;131;835;835;9.61;0.58;113.75;4.55;564;0;249.00;0
272;0;621439237;272;129;835;835;9.70;0.59;114.25;4.55;563;0;250.00;0
272;0;621439244;272;129;835;835;9.79;0.60;114.25;4.55;563;0;251.00;0
276;0;621439251;276;132;846;847;9.81;0.60;114.78;4.49;570;0;252.00;1
276;0;621439259;276;135;846;847;9.83;0.60;114.78;4.49;570;0;253.00;1
277;0;621439266;277;137;847;847;9.86;0.60;115.25;4.49;570;0;254.00;0
278;0;621439273;278;140;847;847;9.81;0.60;115.41;4.49;569;0;255.00;0
280;0;621439280;280;147;847;847;9.84;0.60;116.36;4.49;567;0;256.00;0
281;0;621439286;281;149;847;847;9.91;0.60;116.42;4.49;566;0;257.00;0
281;0;621439293;281;153;848;848;9.90;0.60;116.42;4.48;567;0;258.00;0
281;1;621439300;281;156;848;848;9.91;0.60;116.42;4.48;567;1;259.00;0
281;1;621439313;281;152;854;854;9.92;0.60;116.42;4.46;573;1;260.00;0
281;1;621439320;281;148;855;855;9.92;0.60;116.42;4.45;574;1;261.00;0
283;1;621439327;283;146;855;855;9.97;0.61;116.57;4.45;572;1;262.00;0
285;1;621439339;285;145;855;855;9.98;0.61;116.95;4.45;570;1;263.00;0
286;1;621439346;286;138;859;859;10.06;0.61;117.44;4.43;573;1;264.00;0
288;1;621439353;288;136;859;859;10.12;0.61;117.74;4.43;571;1;265.00;0
292;1;621439364;292;137;859;859;10.17;0.62;118.62;4.43;567;1;266.00;0
294;1;621439371;294;134;860;860;10.22;0.62;118.89;4.43;566;1;267.00;0
296;1;621439378;296;133;864;864;10.16;0.62;119.47;4.41;568;1;268.00;0
297;1;621439385;297;132;864;864;10.17;0.62;119.98;4.41;567;1;269.00;0
299;1;621439399;299;126;868;870;10.19;0.62;120.41;4.39;569;1;270.00;2
303;1;621439410;303;122;868;870;10.22;0.62;120.46;4.39;565;1;271.00;2
307;1;621439422;307;118;870;870;10.21;0.62;121.46;4.39;563;1;272.00;0
311;1;621439431;311;114;870;870;10.23;0.62;122.14;4.39;559;1;273.00;0
313;1;621439445;313;108;874;874;10.38;0.63;122.31;4.37;561;1;274.00;0
316;1;621439456;316;105;874;874;10.51;0.64;122.47;4.37;558;1;275.00;0
318;1;621439466;318;97;874;874;10.64;0.64;122.53;4.37;556;1;276.00;0
322;1;621439476;322;95;874;874;10.75;0.65;122.57;4.37;552;1;277.00;0
324;1;621439487;324;89;875;875;10.80;0.65;123.08;4.37;551;1;278.00;0
326;1;621439497;326;85;876;876;10.96;0.66;123.04;4.36;550;1;279.00;0
328;1;621439507;328;81;876;876;10.98;0.67;122.99;4.36;548;1;280.00;0
328;1;621439514;328;81;877;877;11.03;0.67;122.99;4.36;549;1;281.00;0
331;1;621439523;331;75;877;877;11.11;0.67;123.23;4.36;546;1;282.00;0
331;1;621439530;331;75;877;877;11.20;0.68;123.23;4.36;546;1;283.00;0
335;1;621439538;335;75;877;877;11.26;0.68;123.59;4.36;542;1;284.00;0
336;1;621439546;336;82;877;877;11.27;0.68;123.65;4.36;541;1;285.00;0
338;1;621439554;338;82;877;877;11.36;0.69;123.94;4.36;539;1;286.00;0
339;1;621439562;339;84;877;877;11.46;0.69;124.38;4.36;538;1;287.00;0
340;1;621439570;340;102;947;1004;11.16;0.69;124.34;4.04;607;1;288.00;57
342;1;621439590;342;97;952;1005;11.15;0.69;125.28;4.03;610;1;289.00;53
342;1;621439598;342;88;957;1005;11.26;0.69;125.28;4.01;615;1;290.00;48
342;1;621439606;342;87;958;1005;11.24;0.69;125.28;4.01;616;1;291.00;47
343;1;621439614;343;90;966;1005;11.22;0.69;125.34;4.01;623;1;292.00;39
344;1;621439623;344;88;966;1005;11.17;0.69;125.81;4.01;622;1;293.00;39
344;1;621439631;344;89;970;1005;11.20;0.69;125.81;4.02;626;1;294.00;35
348;1;621439641;348;87;974;1005;11.29;0.69;126.86;4.03;626;1;295.00;31
350;1;621439650;350;88;976;1006;11.34;0.70;126.53;4.04;626;1;296.00;30
352;1;621439658;352;92;980;1007;11.38;0.70;127.41;4.06;628;1;297.00;27
353;1;621439667;353;87;983;1007;11.45;0.70;127.84;4.08;630;1;298.00;24
353;1;621439675;353;93;986;1008;11.46;0.70;127.84;4.10;633;1;299.00;22
354;1;621439687;354;95;992;1014;11.35;0.70;127.51;4.13;638;1;300.00;22
356;1;621439703;356;96;994;1014;11.26;0.69;128.00;4.14;638;1;301.00;20
360;1;621439712;360;101;997;1014;11.28;0.69;128.53;4.17;637;1;302.00;17
360;1;621439722;360;107;1002;1018;11.26;0.69;128.53;4.21;642;1;303.00;16
365;1;621439731;365;112;1004;1018;11.23;0.69;130.03;4.20;639;1;304.00;14
367;1;621439742;367;116;1008;1018;11.20;0.69;130.15;4.22;641;1;305.00;10
368;1;621439754;368;123;1010;1021;11.20;0.69;130.17;4.21;642;1;306.00;11
372;1;621439763;372;128;1011;1021;11.21;0.69;130.66;4.22;639;1;307.00;10
374;1;621439773;374;131;1011;1021;11.19;0.69;131.22;4.22;637;1;308.00;10
377;1;621439781;377;134;1014;1025;11.08;0.68;131.35;4.21;637;1;309.00;11
377;1;621439790;377;141;1018;1026;11.01;0.68;131.35;4.25;641;1;310.00;8
380;1;621439799;380;146;1020;1026;10.82;0.66;132.74;4.27;640;1;311.00;6
380;1;621439806;380;151;1025;1030;10.70;0.66;132.74;4.25;645;1;312.00;5
384;1;621439823;384;152;1026;1030;10.46;0.64;133.58;4.26;642;1;313.00;4
386;1;621439832;386;156;1027;1030;10.24;0.63;134.09;4.28;641;1;314.00;3
388;1;621439839;388;163;1029;1032;10.01;0.62;134.43;4.27;641;1;315.00;3
390;1;621439854;390;169;1029;1032;9.77;0.60;134.58;4.27;639;1;316.00;3
391;1;621439861;391;174;1036;1038;9.58;0.59;134.94;4.28;645;1;317.00;2
394;1;621439869;394;176;1036;1038;9.34;0.57;135.84;4.28;642;1;318.00;2
398;1;621439877;398;176;1037;1039;9.17;0.56;136.41;4.27;639;1;319.00;2
400;1;621439884;400;178;1037;1039;8.98;0.55;136.77;4.27;637;1;320.00;2
402;1;621439893;402;185;1038;1039;8.87;0.54;136.67;4.30;636;1;321.00;1
405;1;621439900;405;191;1038;1039;8.86;0.54;136.43;4.30;633;1;322.00;1
406;1;621439908;406;194;1039;1039;8.89;0.54;136.58;4.31;633;1;323.00;0
407;1;621439915;407;197;1050;1051;8.95;0.55;136.72;4.27;643;1;324.00;1
409;1;621439923;409;196;1050;1051;9.02;0.55;136.99;4.27;641;1;325.00;1
412;1;621439931;412;197;1051;1051;9.10;0.56;137.16;4.27;639;1;326.00;0
412;1;621439938;412;198;1051;1051;9.17;0.56;137.16;4.27;639;1;327.00;0
412;1;621439945;412;199;1051;1051;9.24;0.57;137.16;4.27;639;1;328.00;0
413;1;621439952;413;203;1051;1051;9.27;0.57;137.32;4.27;638;1;329.00;0
414;1;621439963;414;207;1055;1055;9.21;0.56;137.47;4.25;641;1;330.00;0
416;1;621439972;416;211;1055;1055;9.16;0.56;137.94;4.25;639;1;331.00;0
418;1;621439979;418;211;1059;1059;9.09;0.56;138.17;4.24;641;1;332.00;0
421;1;621439987;421;215;1060;1060;8.98;0.55;138.71;4.24;639;1;333.00;0
426;1;621439995;426;217;1060;1060;8.82;0.54;138.94;4.24;634;1;334.00;0
429;1;621440002;429;219;1060;1060;8.64;0.53;139.98;4.24;631;1;335.00;0
431;1;621440009;431;221;1072;1073;8.41;0.51;140.25;4.19;641;1;336.00;1
436;1;621440018;436;231;1073;1073;8.32;0.51;140.77;4.19;637;1;337.00;0
440;1;621440025;440;235;1073;1073;8.23;0.51;142.23;4.19;633;1;338.00;0
443;1;621440032;443;235;1074;1074;8.14;0.50;143.05;4.18;631;1;339.00;0
446;1;621440039;446;224;1075;1075;8.08;0.50;143.31;4.18;629;1;340.00;0
450;1;621440046;450;218;1075;1075;8.00;0.49;143.83;4.18;625;1;341.00;0
450;1;621440053;450;220;1078;1078;8.03;0.49;143.83;4.17;628;1;342.00;0
453;1;621440060;453;214;1078;1078;8.10;0.50;144.19;4.17;625;1;343.00;0
456;1;621440067;456;218;1078;1078;8.13;0.50;144.98;4.17;622;1;344.00;0
457;1;621440074;457;221;1078;1078;8.13;0.50;144.78;4.17;621;1;345.00;0
461;1;621440081;461;221;1084;1084;8.21;0.51;146.37;4.15;623;1;346.00;0
465;1;621440089;465;213;1084;1084;8.17;0.50;146.73;4.15;619;1;347.00;0
469;1;621440097;469;207;1084;1084;8.12;0.50;146.97;4.15;615;1;348.00;0
471;1;621440104;471;206;1084;1084;8.17;0.50;147.09;4.15;613;1;349.00;0
474;1;621440112;474;203;1088;1088;8.15;0.50;147.20;4.14;614;1;350.00;0
477;1;621440119;477;202;1089;1089;8.12;0.50;147.07;4.14;612;1;351.00;0
478;1;621440126;478;201;1089;1089;8.05;0.50;146.83;4.14;611;1;352.00;0
481;1;621440133;481;203;1090;1090;7.95;0.49;146.64;4.13;609;1;353.00;0
485;1;621440148;485;208;1090;1090;7.81;0.48;146.87;4.13;605;1;354.00;0
487;1;621440155;487;217;1090;1090;7.66;0.47;147.20;4.13;603;1;355.00;0
490;1;621440162;490;220;1090;1090;7.52;0.46;147.58;4.13;600;1;356.00;0
496;1;621440169;496;225;1090;1090;7.32;0.45;148.03;4.13;594;1;357.00;0
499;1;621440176;499;230;1090;1090;7.12;0.44;148.23;4.13;591;1;358.00;0
503;1;621440183;503;237;1090;1090;7.03;0.43;148.37;4.13;587;1;359.00;0
505;1;621440192;505;251;1151;1215;7.49;0.47;148.35;3.91;646;1;360.00;64
505;1;621440209;505;251;1158;1216;7.53;0.47;148.35;3.90;653;1;361.00;58
507;1;621440217;507;251;1172;1216;7.63;0.48;148.41;3.87;665;1;362.00;44
508;1;621440224;508;252;1177;1216;7.61;0.48;148.27;3.87;669;1;363.00;39
510;1;621440231;510;250;1184;1216;7.50;0.47;148.23;3.87;674;1;364.00;32
512;1;621440247;512;256;1186;1216;7.42;0.46;147.86;3.87;674;1;365.00;30
513;1;621440255;513;260;1193;1216;7.30;0.45;148.25;3.89;680;1;366.00;23
515;1;621440264;515;264;1196;1216;7.15;0.44;148.32;3.89;681;1;367.00;20
518;1;621440272;518;273;1201;1217;7.08;0.44;148.48;3.91;683;1;368.00;16
519;1;621440280;519;279;1208;1218;6.96;0.43;148.54;3.94;689;1;369.00;10
521;1;621440288;521;283;1212;1218;6.86;0.43;148.82;3.96;691;1;370.00;6
524;1;621440297;524;277;1218;1222;6.84;0.42;148.67;3.95;694;1;371.00;4
524;1;621440305;524;279;1218;1222;6.82;0.42;148.67;3.95;694;1;372.00;4
527;1;621440313;527;273;1219;1222;6.76;0.42;148.32;3.96;692;1;373.00;3
528;1;621440321;528;278;1219;1222;6.75;0.42;148.39;3.96;691;1;374.00;3
529;1;621440330;529;278;1224;1228;6.73;0.41;148.39;3.94;695;1;375.00;4
530;1;621440339;530;275;1226;1228;6.71;0.41;148.28;3.95;696;1;376.00;2
533;1;621440347;533;276;1226;1228;6.80;0.42;148.45;3.95;693;1;377.00;2
533;1;621440364;533;278;1228;1231;6.87;0.42;148.45;3.95;695;1;378.00;3
535;1;621440381;535;274;1229;1231;6.93;0.42;148.57;3.96;694;1;379.00;2
535;1;621440394;535;271;1229;1231;6.95;0.43;148.57;3.96;694;1;380.00;2
537;1;621440406;537;272;1231;1232;7.01;0.43;148.93;3.97;694;1;381.00;1
538;1;621440415;538;274;1233;1233;7.07;0.43;148.69;3.97;695;1;382.00;0
540;1;621440424;540;271;1233;1233;7.15;0.44;148.47;3.97;693;1;383.00;0
542;1;621440432;542;273;1244;1246;7.27;0.44;148.46;3.93;702;1;384.00;2
543;1;621440442;543;272;1246;1246;7.35;0.45;148.45;3.93;703;1;385.00;0
544;1;621440452;544;271;1246;1246;7.42;0.45;148.56;3.93;702;1;386.00;0
544;1;621440460;544;259;1247;1247;7.52;0.46;148.56;3.92;703;1;387.00;0
545;1;621440478;545;255;1247;1247;7.62;0.46;148.72;3.92;702;1;388.00;0
547;1;621440487;547;256;1250;1251;7.70;0.47;148.28;3.92;703;1;389.00;1
550;1;621440497;550;255;1251;1251;7.69;0.47;149.21;3.92;701;1;390.00;0
552;1;621440506;552;257;1255;1255;7.77;0.47;149.35;3.91;703;1;391.00;0
555;1;621440515;555;257;1255;1255;7.74;0.47;149.90;3.91;700;1;392.00;0
557;1;621440524;557;258;1255;1255;7.73;0.47;150.46;3.91;698;1;393.00;0
560;1;621440532;560;261;1255;1255;7.76;0.47;150.94;3.91;695;1;394.00;0
562;1;621440541;562;262;1255;1255;7.77;0.47;150.84;3.91;693;1;395.00;0
564;1;621440555;564;249;1266;1267;7.91;0.48;151.14;3.87;702;1;396.00;1
566;1;621440565;566;244;1266;1267;8.01;0.49;151.24;3.87;700;1;397.00;1
567;1;621440573;567;231;1267;1267;8.18;0.50;151.30;3.87;700;1;398.00;0
568;1;621440582;568;222;1267;1267;8.30;0.51;151.44;3.87;699;1;399.00;0
570;1;621440592;570;213;1267;1267;8.40;0.51;151.57;3.87;697;1;400.00;0
572;1;621440604;572;212;1267;1267;8.58;0.52;152.03;3.87;695;1;401.00;0
576;1;621440614;576;205;1268;1268;8.64;0.53;152.81;3.87;692;1;402.00;0
579;1;621440624;579;206;1268;1268;8.72;0.53;153.67;3.87;689;1;403.00;0
582;1;621440633;582;206;1274;1274;8.84;0.54;154.05;3.85;692;1;404.00;0
584;1;621440643;584;205;1276;1276;8.82;0.54;154.44;3.85;692;1;405.00;0
587;1;621440653;587;205;1276;1276;8.89;0.54;154.85;3.85;689;1;406.00;0
589;1;621440662;589;199;1276;1276;8.93;0.54;155.07;3.85;687;1;407.00;0
592;1;621440672;592;192;1280;1280;8.98;0.55;155.37;3.84;688;1;408.00;0
594;1;621440682;594;188;1280;1280;9.08;0.55;156.14;3.84;686;1;409.00;0
595;1;621440691;595;185;1280;1280;9.25;0.56;156.18;3.84;685;1;410.00;0
596;1;621440703;596;179;1281;1281;9.34;0.57;156.24;3.83;685;1;411.00;0
599;1;621440712;599;176;1285;1285;9.36;0.57;156.92;3.83;686;1;412.00;0
599;1;621440721;599;177;1285;1285;9.40;0.57;156.92;3.83;686;1;413.00;0
603;1;621440730;603;175;1287;1288;9.39;0.57;157.55;3.82;684;1;414.00;1
608;1;621440739;608;173;1287;1288;9.44;0.58;157.96;3.82;679;1;415.00;1
612;1;621440748;612;178;1288;1288;9.44;0.57;158.67;3.82;676;1;416.00;0
613;1;621440758;613;177;1288;1288;9.42;0.57;158.85;3.82;675;1;417.00;0
614;1;621440767;614;173;1292;1292;9.46;0.58;159.26;3.81;678;1;418.00;0
617;1;621440776;617;171;1292;1292;9.46;0.58;159.97;3.81;675;1;419.00;0
621;1;621440786;621;168;1292;1292;9.42;0.58;161.12;3.81;671;1;420.00;0
624;1;621440794;624;169;1292;1292;9.45;0.58;161.25;3.81;668;1;421.00;0
627;1;621440803;627;166;1293;1293;9.48;0.58;161.86;3.81;666;1;422.00;0
630;1;621440811;630;167;1294;1294;9.47;0.58;161.90;3.80;664;1;423.00;0
633;1;621440820;633;174;1294;1294;9.47;0.58;162.67;3.80;661;1;424.00;0
635;1;621440828;635;177;1295;1295;9.47;0.58;163.20;3.80;660;1;425.00;0
636;1;621440837;636;177;1295;1295;9.50;0.58;163.05;3.80;659;1;426.00;0
638;1;621440845;638;174;1295;1295;9.57;0.58;163.17;3.80;657;1;427.00;0
640;1;621440853;640;174;1295;1295;9.63;0.59;163.52;3.80;655;1;428.00;0
642;1;621440861;642;179;1295;1295;9.70;0.59;163.77;3.80;653;1;429.00;0
643;1;621440869;643;175;1295;1295;9.81;0.60;163.62;3.80;652;1;430.00;0
644;1;621440877;644;167;1295;1295;9.90;0.60;163.63;3.80;651;1;431.00;0
650;1;621440885;650;199;1376;1422;9.52;0.59;164.55;3.58;726;1;432.00;46
654;1;621440903;654;175;1376;1423;9.62;0.59;164.89;3.58;722;1;433.00;47
656;1;621440912;656;164;1380;1423;9.77;0.60;165.32;3.58;724;1;434.00;43
659;1;621440921;659;156;1380;1423;9.91;0.61;165.76;3.58;721;1;435.00;43
663;1;621440931;663;153;1384;1423;10.07;0.62;166.06;3.58;721;1;436.00;39
664;1;621440940;664;150;1385;1423;10.16;0.62;166.14;3.58;721;1;437.00;38
666;1;621440949;666;150;1389;1423;10.29;0.63;165.98;3.59;723;1;438.00;34
669;1;621440957;669;151;1390;1423;10.36;0.64;166.47;3.59;721;1;439.00;33
672;1;621440966;672;151;1393;1424;10.40;0.64;166.71;3.60;721;1;440.00;31
677;1;621440975;677;145;1398;1425;10.38;0.64;167.28;3.62;721;1;441.00;27
681;1;621440984;681;135;1400;1425;10.40;0.64;168.45;3.63;719;1;442.00;25
683;1;621440994;683;130;1403;1426;10.36;0.63;168.71;3.64;720;1;443.00;23
683;1;621441002;683;126;1407;1426;10.32;0.63;168.71;3.67;724;1;444.00;19
685;1;621441011;685;122;1409;1426;10.32;0.63;169.16;3.67;724;1;445.00;17
689;1;621441020;689;122;1413;1426;10.29;0.63;169.89;3.70;724;1;446.00;13
692;1;621441029;692;120;1417;1430;10.20;0.63;170.19;3.71;725;1;447.00;13
695;1;621441040;695;119;1418;1430;10.17;0.62;170.66;3.72;723;1;448.00;12
697;1;621441049;697;119;1420;1430;10.12;0.62;171.00;3.74;723;1;449.00;10
700;1;621441059;700;121;1424;1436;10.19;0.63;171.16;3.73;724;1;450.00;12
703;1;621441069;703;121;1426;1436;10.25;0.63;171.77;3.74;723;1;451.00;10
705;1;621441078;705;120;1428;1436;10.28;0.63;171.90;3.75;723;1;452.00;8
709;1;621441087;709;122;1432;1440;10.25;0.63;171.97;3.75;723;1;453.00;8
711;1;621441098;711;123;1434;1441;10.26;0.63;172.11;3.76;723;1;454.00;7
713;1;621441107;713;120;1435;1441;10.30;0.63;171.96;3.77;722;1;455.00;6
718;1;621441116;718;122;1437;1445;10.31;0.63;172.21;3.77;719;1;456.00;8
724;1;621441126;724;123;1438;1445;10.33;0.63;172.51;3.77;714;1;457.00;7
725;1;621441136;725;123;1439;1445;10.42;0.64;172.41;3.77;714;1;458.00;6
730;1;621441144;730;124;1440;1446;10.46;0.64;172.83;3.76;710;1;459.00;6
736;1;621441153;736;125;1440;1446;10.48;0.64;173.43;3.76;704;1;460.00;6
738;1;621441162;738;126;1446;1452;10.41;0.63;173.55;3.79;708;1;461.00;6
739;1;621441172;739;127;1446;1452;10.30;0.63;173.57;3.79;707;1;462.00;6
739;1;621441181;739;131;1448;1453;10.16;0.62;173.57;3.82;709;1;463.00;5
740;1;621441189;740;136;1448;1453;10.09;0.61;173.57;3.82;708;1;464.00;5
743;1;621441198;743;138;1448;1453;10.06;0.61;173.77;3.82;705;1;465.00;5
744;1;621441207;744;141;1449;1453;10.02;0.61;173.92;3.82;705;1;466.00;4
749;1;621441216;749;141;1449;1453;9.95;0.60;174.15;3.82;700;1;467.00;4
750;1;621441225;750;148;1459;1465;9.94;0.60;174.15;3.79;709;1;468.00;6
753;1;621441234;753;150;1459;1465;9.91;0.60;174.51;3.79;706;1;469.00;6
756;1;621441243;756;148;1461;1465;9.87;0.60;174.82;3.80;705;1;470.00;4
756;1;621441252;756;155;1462;1465;9.96;0.61;174.82;3.81;706;1;471.00;3
760;1;621441260;760;159;1463;1465;9.92;0.60;175.30;3.82;703;1;472.00;2
762;1;621441270;762;159;1463;1465;9.91;0.60;175.32;3.82;701;1;473.00;2
763;1;621441279;763;164;1466;1469;9.84;0.60;175.23;3.81;703;1;474.00;3
765;1;621441288;765;169;1467;1469;9.74;0.59;175.33;3.82;702;1;475.00;2
768;1;621441296;768;174;1471;1473;9.77;0.60;175.18;3.81;703;1;476.00;2
768;1;621441305;768;179;1474;1474;9.80;0.60;175.18;3.81;706;1;477.00;0
770;1;621441314;770;185;1474;1474;9.75;0.60;175.04;3.81;704;1;478.00;0
772;1;621441322;772;188;1474;1474;9.61;0.59;174.72;3.81;702;1;479.00;0
774;1;621441333;774;197;1495;1500;9.57;0.59;174.76;3.76;721;1;480.00;5
774;1;621441344;774;199;1497;1500;9.55;0.59;174.76;3.75;723;1;481.00;3
775;1;621441352;775;205;1500;1500;9.55;0.59;174.79;3.75;725;1;482.00;0
777;1;621441360;777;213;1501;1501;9.51;0.59;174.74;3.75;724;1;483.00;0
777;1;621441368;777;214;1502;1502;9.47;0.58;174.74;3.75;725;1;484.00;0
778;1;621441376;778;219;1502;1502;9.39;0.58;174.72;3.75;724;1;485.00;0
782;1;621441385;782;220;1504;1505;9.31;0.57;174.86;3.74;722;1;486.00;1
784;1;621441396;784;226;1504;1505;9.23;0.57;174.72;3.74;720;1;487.00;1
784;1;621441408;784;232;1505;1505;9.14;0.56;174.72;3.74;721;1;488.00;0
787;1;621441426;787;235;1505;1505;9.07;0.56;174.90;3.74;718;1;489.00;0
791;1;621441440;791;240;1510;1511;9.01;0.55;175.07;3.73;719;1;490.00;1
794;1;621441455;794;243;1510;1511;8.91;0.55;175.11;3.73;716;1;491.00;1
794;1;621441469;794;244;1510;1511;8.80;0.54;175.11;3.73;716;1;492.00;1
798;1;621441480;798;242;1511;1511;8.74;0.54;174.81;3.73;713;1;493.00;0
801;1;621441493;801;247;1515;1515;8.70;0.53;174.59;3.72;714;1;494.00;0
802;1;621441505;802;251;1517;1517;8.68;0.53;174.45;3.72;715;1;495.00;0
804;1;621441515;804;249;1517;1517;8.65;0.53;174.44;3.72;713;1;496.00;0
806;1;621441524;806;253;1518;1518;8.70;0.53;174.26;3.72;712;1;497.00;0
808;1;621441532;808;253;1518;1518;8.68;0.53;174.16;3.72;710;1;498.00;0
810;1;621441541;810;260;1518;1518;8.68;0.53;173.84;3.72;708;1;499.00;0
813;1;621441550;813;260;1518;1518;8.61;0.53;174.04;3.72;705;1;500.00;0
815;1;621441563;815;262;1518;1518;8.56;0.52;174.31;3.72;703;1;501.00;0
817;1;621441571;817;262;1518;1518;8.47;0.52;174.11;3.72;701;1;502.00;0
821;1;621441578;821;265;1518;1518;8.34;0.51;173.96;3.72;697;1;503.00;0
824;1;621441586;824;273;1561;1588;8.37;0.51;174.24;3.61;737;1;504.00;27
826;1;621441599;826;273;1564;1589;8.26;0.51;174.08;3.61;738;1;505.00;25
832;1;621441607;832;271;1573;1589;8.08;0.50;174.35;3.60;741;1;506.00;16
833;1;621441615;833;274;1574;1589;7.98;0.49;174.63;3.60;741;1;507.00;15
835;1;621441623;835;274;1576;1589;7.86;0.48;175.31;3.60;741;1;508.00;13
837;1;621441630;837;276;1577;1589;7.72;0.47;175.21;3.60;740;1;509.00;12
839;1;621441639;839;268;1579;1589;7.67;0.47;175.47;3.60;740;1;510.00;10
842;1;621441647;842;262;1582;1589;7.61;0.47;176.00;3.61;740;1;511.00;7
845;1;621441654;845;262;1583;1590;7.51;0.46;176.82;3.61;738;1;512.00;7
849;1;621441662;849;259;1585;1591;7.42;0.45;177.33;3.62;736;1;513.00;6
850;1;621441670;850;258;1587;1591;7.38;0.45;177.22;3.63;737;1;514.00;4
853;1;621441677;853;264;1594;1595;7.31;0.45;177.62;3.63;741;1;515.00;1
855;1;621441686;855;272;1594;1595;7.22;0.44;178.13;3.63;739;1;516.00;1
856;1;621441693;856;271;1594;1595;7.20;0.44;178.45;3.63;738;1;517.00;1
859;1;621441701;859;272;1595;1595;7.08;0.43;179.07;3.63;736;1;518.00;0
859;1;621441709;859;271;1600;1601;7.02;0.43;179.07;3.62;741;1;519.00;1
862;1;621441718;862;270;1601;1601;6.89;0.42;180.01;3.62;739;1;520.00;0
862;1;621441725;862;275;1601;1601;6.95;0.43;180.01;3.62;739;1;521.00;0
863;1;621441733;863;279;1604;1604;6.89;0.42;180.32;3.62;741;1;522.00;0
865;1;621441740;865;267;1604;1604;6.91;0.42;180.28;3.62;739;1;523.00;0
869;1;621441749;869;257;1604;1604;6.91;0.42;180.23;3.62;735;1;524.00;0
871;1;621441758;871;257;1605;1605;6.87;0.42;180.54;3.61;734;1;525.00;0
872;1;621441767;872;257;1606;1606;6.89;0.42;180.77;3.61;734;1;526.00;0
875;1;621441776;875;255;1606;1606;6.91;0.42;181.11;3.61;731;1;527.00;0
880;1;621441785;880;257;1618;1619;7.07;0.43;181.22;3.59;738;1;528.00;1
884;1;621441794;884;255;1618;1619;7.04;0.43;181.48;3.59;734;1;529.00;1
885;1;621441810;885;251;1619;1619;7.11;0.44;181.80;3.58;734;1;530.00;0
889;1;621441818;889;252;1620;1620;7.18;0.44;181.97;3.58;731;1;531.00;0
893;1;621441827;893;246;1620;1620;7.14;0.44;181.76;3.58;727;1;532.00;0
896;1;621441843;896;243;1624;1624;7.25;0.44;182.00;3.58;728;1;533.00;0
901;1;621441852;901;246;1624;1624;7.30;0.45;182.22;3.58;723;1;534.00;0
903;1;621441861;903;245;1628;1628;7.40;0.45;182.08;3.57;725;1;535.00;0
907;1;621441876;907;245;1628;1628;7.44;0.46;181.91;3.57;721;1;536.00;0
908;1;621441885;908;243;1628;1628;7.51;0.46;181.92;3.57;720;1;537.00;0
911;1;621441893;911;234;1628;1628;7.53;0.46;182.10;3.57;717;1;538.00;0
916;1;621441902;916;238;1628;1628;7.61;0.46;182.44;3.57;712;1;539.00;0
918;1;621441912;918;238;1657;1662;7.84;0.48;182.66;3.51;739;1;540.00;5
921;1;621441924;921;235;1657;1662;7.94;0.48;182.88;3.51;736;1;541.00;5
923;1;621441934;923;232;1661;1662;8.01;0.49;182.97;3.50;738;1;542.00;1
927;1;621441943;927;233;1661;1662;7.98;0.49;182.81;3.50;734;1;543.00;1
929;1;621441952;929;230;1662;1662;7.94;0.48;182.66;3.50;733;1;544.00;0
929;1;621441960;929;232;1662;1662;7.96;0.48;182.66;3.50;733;1;545.00;0
932;1;621441970;932;229;1663;1663;7.86;0.48;182.56;3.50;731;1;546.00;0
936;1;621441985;936;235;1663;1663;7.78;0.47;183.18;3.50;727;1;547.00;0
939;1;621441995;939;236;1669;1669;7.80;0.48;182.84;3.49;730;1;548.00;0
940;1;621442004;940;241;1670;1670;7.84;0.48;183.00;3.49;730;1;549.00;0
941;1;621442013;941;245;1670;1670;7.80;0.48;183.19;3.49;729;1;550.00;0
944;1;621442022;944;244;1670;1670;7.78;0.47;183.39;3.49;726;1;551.00;0
944;1;621442031;944;244;1674;1674;7.72;0.47;183.39;3.48;730;1;552.00;0
946;1;621442041;946;246;1674;1674;7.58;0.46;183.48;3.48;728;1;553.00;0
947;1;621442050;947;253;1674;1674;7.51;0.46;183.57;3.48;727;1;554.00;0
948;1;621442058;948;259;1675;1675;7.43;0.45;183.72;3.48;727;1;555.00;0
951;1;621442067;951;263;1679;1679;7.37;0.45;183.92;3.48;728;1;556.00;0
951;1;621442075;951;250;1679;1679;7.32;0.45;183.92;3.48;728;1;557.00;0
953;1;621442084;953;247;1681;1682;7.32;0.45;184.08;3.47;728;1;558.00;1
956;1;621442094;956;237;1681;1682;7.27;0.44;184.02;3.47;725;1;559.00;1
958;1;621442102;958;234;1682;1682;7.23;0.44;184.02;3.47;724;1;560.00;0
960;1;621442110;960;237;1682;1682;7.27;0.44;184.35;3.47;722;1;561.00;0
963;1;621442119;963;241;1686;1686;7.40;0.45;184.46;3.47;723;1;562.00;0
968;1;621442128;968;240;1686;1686;7.49;0.46;184.84;3.47;718;1;563.00;0
968;1;621442138;968;232;1686;1686;7.58;0.46;184.84;3.47;718;1;564.00;0
971;1;621442147;971;237;1686;1686;7.60;0.46;185.04;3.47;715;1;565.00;0
973;1;621442156;973;225;1687;1687;7.65;0.47;185.26;3.46;714;1;566.00;0
974;1;621442165;974;217;1688;1688;7.74;0.47;185.21;3.46;714;1;567.00;0
980;1;621442174;980;217;1688;1688;7.73;0.47;185.64;3.46;708;1;568.00;0
982;1;621442184;982;214;1689;1689;7.81;0.47;185.76;3.46;707;1;569.00;0
985;1;621442196;985;208;1689;1689;7.87;0.48;185.97;3.46;704;1;570.00;0
986;1;621442207;986;204;1689;1689;7.95;0.48;186.06;3.46;703;1;571.00;0
987;1;621442217;987;206;1689;1689;7.96;0.48;186.22;3.46;702;1;572.00;0
988;1;621442227;988;206;1689;1689;8.08;0.49;186.32;3.46;701;1;573.00;0
991;1;621442236;991;211;1689;1689;8.13;0.49;186.52;3.46;698;1;574.00;0
991;1;621442245;991;212;1689;1689;8.22;0.50;186.52;3.46;698;1;575.00;0
992;1;621442255;992;238;1771;1816;8.31;0.51;186.89;3.30;779;1;576.00;45
994;1;621442275;994;223;1774;1817;8.30;0.51;187.46;3.30;780;1;577.00;43
996;1;621442285;996;204;1781;1817;8.36;0.52;187.60;3.29;785;1;578.00;36
997;1;621442295;997;199;1782;1817;8.38;0.52;187.94;3.29;785;1;579.00;35
1002;1;621442305;1002;200;1787;1817;8.36;0.52;188.46;3.29;785;1;580.00;30
1003;1;621442315;1003;199;1787;1817;8.41;0.52;188.47;3.29;784;1;581.00;30
1006;1;621442325;1006;199;1790;1817;8.42;0.52;188.71;3.30;784;1;582.00;27
1009;1;621442336;1009;195;1793;1817;8.46;0.52;189.22;3.31;784;1;583.00;24
1012;1;621442354;1012;192;1797;1818;8.51;0.52;189.55;3.32;785;1;584.00;21
1015;1;621442364;1015;198;1803;1820;8.58;0.52;190.03;3.33;788;1;585.00;17
1016;1;621442381;1016;202;1806;1820;8.68;0.53;190.10;3.34;790;1;586.00;14
1019;1;621442392;1019;204;1810;1821;8.72;0.53;190.21;3.35;791;1;587.00;11
1021;1;621442402;1021;209;1812;1821;8.84;0.54;190.56;3.36;791;1;588.00;9
1022;1;621442412;1022;214;1815;1821;8.91;0.54;190.59;3.37;793;1;589.00;6
1026;1;621442422;1026;219;1815;1821;8.97;0.55;190.92;3.37;789;1;590.00;6
1030;1;621442433;1030;220;1820;1825;8.99;0.55;191.64;3.37;790;1;591.00;5
1034;1;621442443;1034;220;1821;1825;9.02;0.55;192.30;3.38;787;1;592.00;4
1036;1;621442454;1036;223;1821;1825;9.05;0.55;192.38;3.38;785;1;593.00;4
1040;1;621442463;1040;228;1825;1828;9.04;0.55;193.00;3.40;785;1;594.00;3
1042;1;621442474;1042;233;1825;1828;9.05;0.55;192.99;3.40;783;1;595.00;3
1045;1;621442486;1045;233;1825;1828;8.99;0.55;193.44;3.40;780;1;596.00;3
1045;1;621442497;1045;232;1830;1832;8.96;0.55;193.44;3.40;785;1;597.00;2
1047;1;621442507;1047;237;1831;1833;9.02;0.55;193.64;3.40;784;1;598.00;2
1048;1;621442517;1048;233;1833;1833;9.06;0.55;193.48;3.40;785;1;599.00;0
1048;1;621442529;1048;237;1845;1859;9.04;0.55;193.48;3.38;797;1;600.00;14
1050;1;621442547;1050;221;1845;1859;9.11;0.56;193.77;3.38;795;1;601.00;14
1051;1;621442558;1051;220;1846;1859;9.16;0.56;193.80;3.38;795;1;602.00;13
1051;1;621442568;1051;216;1847;1860;9.27;0.57;193.80;3.38;796;1;603.00;13
1053;1;621442578;1053;216;1848;1860;9.34;0.57;193.78;3.38;795;1;604.00;12
1055;1;621442588;1055;212;1852;1866;9.45;0.57;194.00;3.37;797;1;605.00;14
1058;1;621442599;1058;213;1854;1866;9.38;0.57;194.60;3.38;796;1;606.00;12
1062;1;621442609;1062;211;1856;1867;9.35;0.57;195.17;3.38;794;1;607.00;11
1064;1;621442618;1064;208;1857;1867;9.37;0.57;195.66;3.38;793;1;608.00;10
1067;1;621442628;1067;205;1857;1867;9.37;0.57;196.08;3.38;790;1;609.00;10
1068;1;621442638;1068;201;1857;1867;9.46;0.58;196.27;3.38;789;1;610.00;10
1072;1;621442648;1072;194;1858;1867;9.45;0.57;196.80;3.38;786;1;611.00;9
1076;1;621442657;1076;188;1866;1879;9.44;0.58;197.12;3.37;790;1;612.00;13
1081;2;621442668;1081;184;1867;1879;9.40;0.57;197.39;3.37;786;2;613.00;12
1082;2;621442692;1082;179;1869;1879;9.43;0.57;197.66;3.37;787;2;614.00;10
1089;2;621442701;1089;179;1870;1879;9.38;0.57;198.72;3.37;781;2;615.00;9
1092;2;621442716;1092;178;1870;1879;9.42;0.57;198.99;3.37;778;2;616.00;9
1096;2;621442725;1096;173;1871;1879;9.46;0.58;199.49;3.38;775;2;617.00;8
1102;2;621442735;1102;171;1875;1883;9.36;0.57;200.19;3.37;773;2;618.00;8
1104;2;621442745;1104;166;1875;1883;9.37;0.57;200.35;3.37;771;2;619.00;8
1109;2;621442755;1109;169;1879;1887;9.34;0.57;200.81;3.38;770;2;620.00;8
1111;2;621442766;1111;163;1879;1888;9.33;0.57;201.35;3.38;768;2;621.00;9
1115;2;621442776;1115;159;1880;1888;9.30;0.56;201.52;3.38;765;2;622.00;8
1119;2;621442786;1119;164;1881;1888;9.29;0.56;201.73;3.39;762;2;623.00;7
1122;2;621442795;1122;165;1889;1901;9.25;0.56;201.83;3.37;767;2;624.00;12
1124;2;621442806;1124;167;1889;1901;9.16;0.55;202.12;3.37;765;2;625.00;12
1127;2;621442815;1127;170;1889;1901;9.14;0.55;202.27;3.37;762;2;626.00;12
1129;2;621442823;1129;170;1892;1902;9.13;0.55;202.65;3.38;763;2;627.00;10
1131;3;621442833;1131;175;1893;1903;9.06;0.55;202.92;3.40;762;3;628.00;10
1131;3;621442854;1131;178;1895;1903;9.06;0.55;202.92;3.42;764;3;629.00;8
1132;3;621442864;1132;178;1899;1909;9.08;0.55;202.87;3.41;767;3;630.00;10
1133;3;621442874;1133;181;1901;1909;9.08;0.55;202.72;3.41;768;3;631.00;8
1139;3;621442883;1139;182;1902;1909;9.07;0.55;202.42;3.41;763;3;632.00;7
1141;3;621442892;1141;187;1903;1909;9.07;0.55;202.33;3.43;762;3;633.00;6
1142;3;621442901;1142;193;1908;1915;9.12;0.55;202.27;3.42;766;3;634.00;7
1142;3;621442910;1142;198;1908;1915;9.14;0.56;202.27;3.42;766;3;635.00;7
1143;3;621442923;1143;197;1908;1915;9.11;0.55;202.39;3.42;765;3;636.00;7
1145;3;621442932;1145;200;1908;1915;9.07;0.55;202.40;3.42;763;3;637.00;7
1148;3;621442942;1148;205;1911;1919;9.00;0.55;202.60;3.42;763;3;638.00;8
1149;3;621442951;1149;219;1914;1920;8.98;0.55;202.66;3.44;765;3;639.00;6
1150;3;621442960;1150;221;1916;1920;8.91;0.54;202.52;3.45;766;3;640.00;4
1151;3;621442970;1151;225;1918;1921;8.85;0.54;202.42;3.46;767;3;641.00;3
1151;3;621442979;1151;232;1918;1921;8.74;0.53;202.42;3.46;767;3;642.00;3
1154;3;621442987;1154;239;1920;1921;8.64;0.53;202.41;3.47;766;3;643.00;1
1156;3;621442996;1156;239;1920;1921;8.51;0.52;202.25;3.47;764;3;644.00;1
1159;3;621443005;1159;248;1921;1921;8.41;0.51;202.09;3.47;762;3;645.00;0
1160;3;621443013;1160;251;1921;1921;8.38;0.51;202.16;3.47;761;3;646.00;0
1161;3;621443022;1161;252;1921;1921;8.36;0.51;202.24;3.47;760;3;647.00;0
1164;3;621443030;1164;261;1959;1991;8.54;0.52;202.07;3.40;795;3;648.00;32
1164;3;621443044;1164;265;1962;1992;8.51;0.52;202.07;3.40;798;3;649.00;30
1165;3;621443052;1165;264;1972;1992;8.51;0.52;201.94;3.39;807;3;650.00;20
1166;3;621443062;1166;266;1975;1992;8.46;0.52;201.95;3.39;809;3;651.00;17
1167;3;621443070;1167;265;1977;1992;8.39;0.52;201.95;3.39;810;3;652.00;15
1170;3;621443078;1170;271;1979;1992;8.36;0.51;201.72;3.39;809;3;653.00;13
1171;3;621443087;1171;277;1980;1992;8.24;0.51;201.62;3.40;809;3;654.00;12
1171;3;621443101;1171;283;1983;1992;8.12;0.50;201.62;3.40;812;3;655.00;9
1174;3;621443109;1174;284;1986;1993;8.02;0.49;201.21;3.41;812;3;656.00;7
1177;3;621443118;1177;292;1989;1994;7.90;0.48;201.08;3.42;812;3;657.00;5
1179;3;621443127;1179;298;1991;1994;7.77;0.48;201.21;3.42;812;3;658.00;3
1186;3;621443135;1186;296;1998;1998;7.65;0.47;201.07;3.42;812;3;659.00;0
1187;3;621443146;1187;299;1998;1998;7.54;0.46;200.92;3.42;811;3;660.00;0
1189;3;621443155;1189;297;1998;1998;7.42;0.46;201.02;3.42;809;3;661.00;0
1191;3;621443166;1191;295;1998;1998;7.35;0.45;200.96;3.42;807;3;662.00;0
1192;3;621443175;1192;302;2004;2004;7.40;0.45;201.02;3.41;812;3;663.00;0
1193;3;621443184;1193;301;2004;2004;7.30;0.45;200.93;3.41;811;3;664.00;0
1195;3;621443195;1195;309;2004;2004;7.21;0.44;201.00;3.41;809;3;665.00;0
1198;3;621443205;1198;308;2006;2007;7.13;0.44;200.89;3.41;808;3;666.00;1
1201;3;621443214;1201;310;2006;2007;7.02;0.43;200.75;3.41;805;3;667.00;1
1203;3;621443222;1203;312;2007;2007;6.99;0.43;200.64;3.41;804;3;668.00;0
1203;3;621443230;1203;314;2008;2008;6.93;0.42;200.64;3.41;805;3;669.00;0
1205;3;621443238;1205;314;2009;2009;6.93;0.42;200.72;3.41;804;3;670.00;0
1210;3;621443246;1210;316;2009;2009;6.83;0.42;200.40;3.41;799;3;671.00;0
1213;3;621443254;1213;319;2022;2022;6.74;0.41;200.32;3.39;809;3;672.00;0
1215;3;621443262;1215;328;2022;2022;6.63;0.40;200.35;3.39;807;3;673.00;0
1217;3;621443270;1217;334;2022;2022;6.55;0.40;200.35;3.39;805;3;674.00;0
1217;3;621443281;1217;327;2024;2024;6.57;0.40;200.35;3.38;807;3;675.00;0
1222;3;621443294;1222;313;2024;2024;6.46;0.40;200.92;3.38;802;3;676.00;0
1224;3;621443305;1224;311;2028;2028;6.44;0.39;201.00;3.38;804;3;677.00;0
1227;3;621443314;1227;309;2028;2028;6.39;0.39;201.25;3.38;801;3;678.00;0
1232;3;621443322;1232;306;2032;2032;6.27;0.38;201.65;3.37;800;3;679.00;0
1234;3;621443330;1234;293;2032;2032;6.27;0.38;201.71;3.37;798;3;680.00;0
1236;3;621443339;1236;290;2032;2032;6.28;0.38;201.61;3.37;796;3;681.00;0
1240;3;621443352;1240;281;2032;2032;6.26;0.38;201.55;3.37;792;3;682.00;0
1243;3;621443360;1243;280;2032;2032;6.25;0.38;201.57;3.37;789;3;683.00;0
1245;3;621443368;1245;276;2043;2044;6.33;0.39;201.42;3.35;798;3;684.00;1
1248;3;621443378;1248;277;2043;2044;6.37;0.39;201.40;3.35;795;3;685.00;1
1251;3;621443387;1251;276;2044;2044;6.42;0.39;201.66;3.35;793;3;686.00;0
1252;3;621443409;1252;265;2044;2044;6.46;0.39;201.87;3.35;792;3;687.00;0
1254;3;621443422;1254;266;2044;2044;6.53;0.40;202.19;3.35;790;3;688.00;0
1257;3;621443434;1257;257;2044;2044;6.67;0.41;202.67;3.35;787;3;689.00;0
1259;3;621443452;1259;250;2045;2045;6.78;0.42;203.01;3.35;786;3;690.00;0
1261;3;621443466;1261;247;2045;2045;6.87;0.42;203.33;3.35;784;3;691.00;0
1264;3;621443482;1264;243;2051;2051;7.04;0.43;203.63;3.35;787;3;692.00;0
1265;3;621443497;1265;241;2052;2052;7.17;0.44;203.85;3.34;787;3;693.00;0
1267;3;621443511;1267;240;2052;2052;7.32;0.45;204.06;3.34;785;3;694.00;0
1269;3;621443522;1269;242;2052;2052;7.41;0.45;204.38;3.34;783;3;695.00;0
1273;3;621443531;1273;244;2056;2056;7.52;0.46;204.58;3.34;783;3;696.00;0
1278;3;621443541;1278;246;2056;2056;7.59;0.47;204.58;3.34;778;3;697.00;0
1280;3;621443551;1280;242;2056;2056;7.72;0.47;204.67;3.34;776;3;698.00;0
1287;3;621443561;1287;235;2057;2057;7.83;0.48;204.73;3.34;770;3;699.00;0
1288;3;621443572;1288;233;2061;2061;7.93;0.49;204.81;3.33;773;3;700.00;0
1292;3;621443586;1292;231;2061;2061;8.00;0.49;204.97;3.33;769;3;701.00;0
1298;3;621443596;1298;225;2063;2064;8.06;0.49;205.46;3.33;765;3;702.00;1
1303;3;621443607;1303;224;2064;2064;8.12;0.50;205.11;3.33;761;3;703.00;0
1309;3;621443617;1309;219;2064;2064;8.08;0.49;205.66;3.33;755;3;704.00;0
1313;3;621443627;1313;217;2064;2064;8.07;0.49;205.69;3.33;751;3;705.00;0
1318;3;621443637;1318;216;2068;2068;8.13;0.50;206.28;3.32;750;3;706.00;0
1320;3;621443649;1320;219;2068;2068;8.20;0.50;206.60;3.32;748;3;707.00;0
1323;3;621443658;1323;222;2068;2068;8.18;0.50;206.54;3.32;745;3;708.00;0
1327;3;621443668;1327;220;2068;2068;8.19;0.50;206.94;3.32;741;3;709.00;0
1332;3;621443679;1332;220;2069;2069;8.14;0.50;207.15;3.32;737;3;710.00;0
1336;3;621443689;1336;220;2070;2070;8.18;0.50;207.43;3.32;734;3;711.00;0
1337;3;621443699;1337;222;2070;2070;8.26;0.50;207.63;3.32;733;3;712.00;0
1345;3;621443708;1345;224;2071;2071;8.30;0.50;208.31;3.32;726;3;713.00;0
1348;3;621443719;1348;222;2071;2071;8.41;0.51;208.82;3.32;723;3;714.00;0
1352;3;621443728;1352;220;2071;2071;8.42;0.51;208.99;3.32;719;3;715.00;0
1359;3;621443738;1359;223;2071;2071;8.37;0.51;209.56;3.32;712;3;716.00;0
1362;3;621443748;1362;221;2071;2071;8.40;0.51;209.58;3.32;709;3;717.00;0
1367;3;621443757;1367;220;2071;2071;8.35;0.51;210.06;3.32;704;3;718.00;0
1371;3;621443767;1371;220;2071;2071;8.30;0.50;210.57;3.32;700;3;719.00;0
1372;3;621443778;1372;257;2191;2301;8.47;0.53;210.68;3.14;819;3;720.00;110
1375;3;621443807;1375;255;2202;2302;8.46;0.53;210.88;3.13;827;3;721.00;100
1379;3;621443818;1379;243;2214;2302;8.40;0.52;211.52;3.12;835;3;722.00;88
1381;3;621443827;1381;236;2220;2302;8.37;0.52;211.75;3.12;839;3;723.00;82
1383;3;621443839;1383;241;2232;2302;8.25;0.52;212.26;3.13;849;3;724.00;70
1386;3;621443849;1386;243;2235;2302;8.15;0.51;212.40;3.13;849;3;725.00;67
1389;3;621443859;1389;251;2244;2302;8.00;0.50;212.76;3.14;855;3;726.00;58
1391;3;621443870;1391;245;2248;2302;7.92;0.49;213.19;3.15;857;3;727.00;54
1394;4;621443881;1394;244;2252;2303;7.82;0.49;213.29;3.16;858;4;728.00;51
1398;4;621443907;1398;249;2256;2304;7.71;0.48;213.44;3.17;858;4;729.00;48
1400;4;621443918;1400;252;2262;2304;7.64;0.47;213.41;3.18;862;4;730.00;42
1401;4;621443929;1401;254;2268;2305;7.54;0.47;213.33;3.20;867;4;731.00;37
1404;4;621443940;1404;256;2269;2305;7.42;0.46;213.26;3.20;865;4;732.00;36
1405;4;621443951;1405;266;2272;2305;7.32;0.45;213.27;3.22;867;4;733.00;33
1408;4;621443963;1408;274;2274;2305;7.25;0.45;213.50;3.23;866;4;734.00;31
1410;4;621443980;1410;270;2277;2309;7.24;0.45;213.39;3.23;867;4;735.00;32
1414;4;621443991;1414;266;2279;2309;7.21;0.45;213.62;3.24;865;4;736.00;30
1418;4;621444008;1418;263;2281;2309;7.18;0.44;213.93;3.25;863;4;737.00;28
1421;4;621444027;1421;265;2283;2312;7.18;0.44;213.82;3.27;862;4;738.00;29
1423;4;621444039;1423;269;2284;2312;7.22;0.44;213.87;3.27;861;4;739.00;28
1426;4;621444050;1426;273;2285;2312;7.27;0.45;213.92;3.28;859;4;740.00;27
1427;4;621444074;1427;275;2290;2316;7.32;0.45;213.78;3.28;863;4;741.00;26
1430;4;621444087;1430;279;2291;2317;7.38;0.45;214.10;3.29;861;4;742.00;26
1432;4;621444098;1432;281;2294;2317;7.44;0.46;214.03;3.32;862;4;743.00;23
1435;4;621444109;1435;284;2297;2321;7.44;0.46;213.96;3.32;862;4;744.00;24
1436;4;621444121;1436;292;2299;2321;7.45;0.46;213.96;3.32;863;4;745.00;22
1440;4;621444131;1440;292;2301;2321;7.47;0.46;214.03;3.33;861;4;746.00;20
1441;4;621444142;1441;291;2303;2322;7.56;0.46;214.15;3.34;862;4;747.00;19
1444;4;621444153;1444;285;2304;2322;7.60;0.46;214.18;3.35;860;4;748.00;18
1447;4;621444164;1447;281;2310;2328;7.64;0.47;214.26;3.37;863;4;749.00;18
1448;4;621444178;1448;282;2312;2328;7.70;0.47;214.33;3.38;864;4;750.00;16
1451;4;621444189;1451;282;2315;2329;7.69;0.47;214.48;3.39;864;4;751.00;14
1453;4;621444200;1453;280;2316;2329;7.73;0.47;214.49;3.40;863;4;752.00;13
1455;4;621444211;1455;284;2317;2329;7.72;0.47;214.56;3.41;862;4;753.00;12
1456;4;621444222;1456;279;2317;2329;7.80;0.48;214.76;3.41;861;4;754.00;12
1457;4;621444232;1457;271;2319;2329;7.86;0.48;214.88;3.41;862;4;755.00;10
1459;5;621444242;1459;263;2328;2341;7.92;0.48;214.95;3.40;869;5;756.00;13
1459;5;621444266;1459;274;2329;2341;7.98;0.49;214.95;3.40;870;5;757.00;12
1459;5;621444276;1459;261;2329;2341;8.01;0.49;214.95;3.40;870;5;758.00;12
1462;5;621444287;1462;261;2332;2341;8.04;0.49;214.81;3.40;870;5;759.00;9
1464;5;621444298;1464;259;2332;2341;8.04;0.49;214.87;3.40;868;5;760.00;9
1465;5;621444308;1465;263;2332;2341;8.06;0.49;215.10;3.40;867;5;761.00;9
1466;5;621444319;1466;265;2336;2345;8.04;0.49;214.99;3.40;870;5;762.00;9
1468;5;621444330;1468;270;2336;2345;8.10;0.49;215.02;3.40;868;5;763.00;9
1470;5;621444341;1470;267;2340;2349;8.14;0.50;215.14;3.40;870;5;764.00;9
1471;5;621444352;1471;270;2342;2351;8.10;0.49;215.02;3.39;871;5;765.00;9
1473;5;621444362;1473;279;2342;2351;8.00;0.49;215.10;3.39;869;5;766.00;9
1474;5;621444373;1474;281;2342;2351;7.87;0.48;215.08;3.39;868;5;767.00;9
1474;5;621444383;1474;284;2353;2364;7.78;0.47;215.08;3.38;879;5;768.00;11
1476;5;621444396;1476;286;2353;2364;7.67;0.47;215.15;3.38;877;5;769.00;11
1476;5;621444406;1476;287;2353;2364;7.56;0.46;215.15;3.38;877;5;770.00;11
1477;5;621444416;1477;278;2354;2365;7.55;0.46;215.13;3.38;877;5;771.00;11
1479;5;621444426;1479;282;2355;2366;7.53;0.46;215.33;3.37;876;5;772.00;11
1480;5;621444436;1480;280;2355;2366;7.56;0.46;215.41;3.37;875;5;773.00;11
1482;5;621444447;1482;277;2357;2369;7.62;0.47;215.47;3.37;875;5;774.00;12
1483;5;621444457;1483;278;2357;2369;7.63;0.47;215.50;3.37;874;5;775.00;12
1485;5;621444467;1485;272;2358;2369;7.72;0.47;215.45;3.37;873;5;776.00;11
1486;5;621444476;1486;277;2358;2369;7.73;0.47;215.53;3.37;872;5;777.00;11
1488;5;621444486;1488;277;2363;2375;7.76;0.47;215.66;3.37;875;5;778.00;12
1493;5;621444497;1493;277;2363;2375;7.78;0.47;215.98;3.37;870;5;779.00;12
1496;5;621444508;1496;270;2363;2375;7.76;0.47;216.08;3.37;867;5;780.00;12
1497;5;621444518;1497;269;2363;2375;7.70;0.47;216.26;3.37;866;5;781.00;12
1497;5;621444528;1497;264;2366;2379;7.69;0.47;216.26;3.36;869;5;782.00;13
1499;5;621444537;1499;266;2367;2380;7.72;0.47;216.30;3.36;868;5;783.00;13
1504;5;621444546;1504;258;2367;2380;7.62;0.46;216.47;3.36;863;5;784.00;13
1509;5;621444556;1509;250;2370;2381;7.54;0.46;216.85;3.36;861;5;785.00;11
1513;5;621444566;1513;250;2370;2381;7.46;0.45;217.22;3.36;857;5;786.00;11
1515;5;621444575;1515;250;2370;2381;7.40;0.45;217.38;3.36;855;5;787.00;11
1519;5;621444584;1519;251;2370;2381;7.38;0.45;217.42;3.36;851;5;788.00;11
1522;5;621444594;1522;256;2370;2381;7.39;0.45;217.77;3.36;848;5;789.00;11
1524;5;621444603;1524;253;2370;2381;7.46;0.45;217.90;3.36;846;5;790.00;11
1524;5;621444612;1524;252;2370;2381;7.49;0.46;217.90;3.36;846;5;791.00;11
1526;5;621444621;1526;257;2403;2451;7.66;0.47;217.81;3.32;877;5;792.00;48
1529;5;621444635;1529;262;2403;2452;7.62;0.47;217.81;3.32;874;5;793.00;49
1529;5;621444645;1529;258;2412;2452;7.69;0.47;217.81;3.31;883;5;794.00;40
1531;5;621444654;1531;265;2413;2452;7.65;0.47;217.69;3.31;882;5;795.00;39
1532;5;621444664;1532;269;2416;2452;7.60;0.46;217.60;3.34;884;5;796.00;36
1536;5;621444674;1536;266;2418;2452;7.56;0.46;217.84;3.34;882;5;797.00;34
1537;5;621444683;1537;269;2422;2452;7.56;0.46;217.84;3.35;885;5;798.00;30
1539;5;621444693;1539;272;2426;2452;7.53;0.46;217.89;3.38;887;5;799.00;26
1541;5;621444703;1541;275;2429;2453;7.47;0.46;217.71;3.39;888;5;800.00;24
1543;5;621444717;1543;279;2432;2454;7.44;0.45;217.68;3.43;889;5;801.00;22
1544;5;621444727;1544;289;2434;2454;7.43;0.45;217.59;3.43;890;5;802.00;20
1546;5;621444737;1546;293;2441;2458;7.43;0.45;217.40;3.47;895;5;803.00;17
1549;5;621444747;1549;293;2443;2458;7.37;0.45;217.33;3.47;894;5;804.00;15
1552;5;621444757;1552;299;2445;2458;7.29;0.44;217.18;3.51;893;5;805.00;13
1553;5;621444767;1553;299;2445;2458;7.33;0.44;217.09;3.51;892;5;806.00;13
1554;5;621444778;1554;303;2450;2464;7.32;0.44;217.12;3.50;896;5;807.00;14
1557;5;621444788;1557;307;2450;2464;7.27;0.44;216.90;3.50;893;5;808.00;14
1557;5;621444801;1557;315;2451;2464;7.22;0.44;216.90;3.54;894;5;809.00;13
1558;5;621444815;1558;318;2457;2470;7.21;0.44;216.82;3.54;899;5;810.00;13
1561;5;621444828;1561;321;2459;2470;7.06;0.43;216.61;3.61;898;5;811.00;11
1562;5;621444840;1562;325;2463;2470;7.04;0.43;216.50;3.62;901;5;812.00;7
1562;5;621444850;1562;330;2464;2471;6.93;0.42;216.50;3.66;902;5;813.00;7
1562;5;621444861;1562;340;2465;2472;6.86;0.42;216.50;3.66;903;5;814.00;7
1562;5;621444871;1562;350;2467;2472;6.77;0.41;216.50;3.68;905;5;815.00;5
1565;5;621444880;1565;356;2476;2485;6.75;0.41;216.26;3.67;911;5;816.00;9
1567;5;621444891;1567;363;2478;2485;6.72;0.41;216.11;3.69;911;5;817.00;7
1568;5;621444900;1568;369;2479;2485;6.68;0.41;216.12;3.70;911;5;818.00;6
1570;5;621444909;1570;372;2483;2486;6.66;0.41;216.01;3.71;913;5;819.00;3
1574;5;621444919;1574;377;2484;2486;6.61;0.41;215.84;3.71;910;5;820.00;2
1576;5;621444929;1576;387;2489;2490;6.60;0.40;215.65;3.71;913;5;821.00;1
1577;5;621444939;1577;391;2489;2490;6.60;0.41;215.67;3.71;912;5;822.00;1
1580;5;621444948;1580;400;2494;2494;6.54;0.40;215.46;3.70;914;5;823.00;0
1580;5;621444958;1580;404;2494;2494;6.46;0.40;215.46;3.70;914;5;824.00;0
1584;5;621444968;1584;405;2494;2494;6.35;0.39;215.29;3.70;910;5;825.00;0
1587;5;621444977;1587;408;2494;2494;6.24;0.38;215.20;3.70;907;5;826.00;0
1587;5;621444986;1587;406;2494;2494;6.17;0.38;215.20;3.70;907;5;827.00;0
1588;5;621444995;1588;402;2505;2506;6.24;0.38;215.27;3.69;917;5;828.00;1
1590;5;621445005;1590;388;2505;2506;6.25;0.38;215.21;3.69;915;5;829.00;1
1590;5;621445015;1590;377;2506;2506;6.31;0.39;215.21;3.69;916;5;830.00;0
1590;5;621445024;1590;371;2506;2506;6.37;0.39;215.21;3.69;916;5;831.00;0
1591;5;621445034;1591;362;2506;2506;6.41;0.39;215.18;3.69;915;5;832.00;0
1593;5;621445044;1593;358;2506;2506;6.44;0.39;215.13;3.69;913;5;833.00;0
1594;5;621445059;1594;346;2507;2507;6.49;0.40;215.24;3.68;913;5;834.00;0
1594;5;621445069;1594;339;2507;2507;6.58;0.40;215.24;3.68;913;5;835.00;0
1595;5;621445079;1595;334;2513;2513;6.72;0.41;215.35;3.68;918;5;836.00;0
1595;5;621445089;1595;332;2514;2514;6.79;0.42;215.35;3.68;919;5;837.00;0
1597;5;621445099;1597;330;2514;2514;6.81;0.42;215.31;3.68;917;5;838.00;0
1598;5;621445109;1598;325;2514;2514;6.83;0.42;215.25;3.68;916;5;839.00;0
1599;5;621445120;1599;322;2518;2519;6.85;0.42;215.19;3.67;919;5;840.00;1
1601;5;621445136;1601;324;2519;2519;6.86;0.42;215.14;3.67;918;5;841.00;0
1607;5;621445145;1607;326;2519;2519;6.80;0.41;215.10;3.67;912;5;842.00;0
1607;5;621445155;1607;332;2520;2520;6.80;0.41;215.10;3.67;913;5;843.00;0
1610;5;621445164;1610;332;2524;2524;6.68;0.41;215.27;3.66;914;5;844.00;0
1613;5;621445179;1613;333;2524;2524;6.59;0.40;215.46;3.66;911;5;845.00;0
1616;5;621445189;1616;334;2526;2527;6.54;0.40;215.85;3.66;910;5;846.00;1
1619;5;621445199;1619;337;2526;2527;6.47;0.40;215.94;3.66;907;5;847.00;1
1621;5;621445208;1621;344;2527;2527;6.45;0.39;216.19;3.66;906;5;848.00;0
1626;5;621445217;1626;351;2527;2527;6.38;0.39;216.26;3.66;901;5;849.00;0
1629;5;621445226;1629;340;2531;2531;6.43;0.39;216.44;3.66;902;5;850.00;0
1634;5;621445236;1634;334;2531;2531;6.45;0.39;216.93;3.66;897;5;851.00;0
1638;5;621445246;1638;327;2531;2531;6.44;0.39;217.00;3.66;893;5;852.00;0
1640;5;621445255;1640;326;2531;2531;6.44;0.39;217.04;3.66;891;5;853.00;0
1647;5;621445264;1647;316;2532;2532;6.38;0.39;217.53;3.66;885;5;854.00;0
1653;5;621445273;1653;318;2534;2534;6.45;0.39;218.00;3.65;881;5;855.00;0
1656;5;621445283;1656;309;2534;2534;6.49;0.40;218.34;3.65;878;5;856.00;0
1659;5;621445292;1659;297;2535;2535;6.54;0.40;218.67;3.65;876;5;857.00;0
1661;5;621445302;1661;290;2535;2535;6.63;0.40;218.88;3.65;874;5;858.00;0
1664;5;621445312;1664;278;2535;2535;6.71;0.41;219.19;3.65;871;5;859.00;0
1667;5;621445321;1667;272;2535;2535;6.78;0.41;219.48;3.65;868;5;860.00;0
1670;5;621445331;1670;264;2535;2535;6.80;0.41;219.73;3.65;865;5;861.00;0
1675;5;621445340;1675;262;2535;2535;6.80;0.41;220.35;3.65;860;5;862.00;0
1677;5;621445350;1677;260;2535;2535;6.84;0.42;220.41;3.65;858;5;863.00;0
1681;5;621445360;1681;266;2620;2662;7.11;0.44;220.55;3.53;939;5;864.00;42
1684;5;621445380;1684;256;2624;2663;7.10;0.44;220.59;3.53;940;5;865.00;39
1686;5;621445391;1686;251;2632;2663;7.13;0.44;220.78;3.53;946;5;866.00;31
1691;5;621445406;1691;250;2633;2663;7.16;0.44;221.08;3.53;942;5;867.00;30
1696;5;621445435;1696;243;2636;2663;7.18;0.44;221.44;3.53;940;5;868.00;27
1699;5;621445452;1699;245;2638;2663;7.13;0.44;221.47;3.53;939;5;869.00;25
1703;5;621445470;1703;235;2639;2663;7.07;0.43;221.77;3.53;936;5;870.00;24
1704;5;621445488;1704;235;2640;2663;7.02;0.43;221.79;3.53;936;5;871.00;23
1708;5;621445505;1708;239;2643;2664;6.94;0.43;222.34;3.53;935;5;872.00;21
1713;5;621445521;1713;241;2647;2665;6.89;0.42;222.58;3.54;934;5;873.00;18
1716;5;621445533;1716;239;2649;2665;6.88;0.42;222.81;3.55;933;5;874.00;16
1721;5;621445545;1721;249;2651;2666;6.84;0.42;222.91;3.55;930;5;875.00;15
1726;5;621445558;1726;255;2651;2666;6.83;0.42;223.27;3.55;925;5;876.00;15
1730;5;621445570;1730;255;2652;2666;6.82;0.42;223.83;3.55;922;5;877.00;14
1734;5;621445582;1734;262;2656;2666;6.81;0.42;224.12;3.57;922;5;878.00;10
1738;5;621445595;1738;264;2659;2670;6.82;0.42;224.24;3.57;921;5;879.00;11
1740;5;621445608;1740;268;2659;2670;6.88;0.42;224.34;3.57;919;5;880.00;11
1746;5;621445620;1746;266;2659;2670;6.93;0.42;224.79;3.57;913;5;881.00;11
1748;5;621445632;1748;269;2660;2673;6.96;0.43;225.12;3.58;912;5;882.00;13
1752;5;621445644;1752;275;2662;2673;6.98;0.43;225.20;3.59;910;5;883.00;11
1754;5;621445655;1754;274;2662;2673;7.05;0.43;225.61;3.59;908;5;884.00;11
1758;5;621445666;1758;272;2666;2677;7.12;0.43;225.83;3.58;908;5;885.00;11
1764;5;621445678;1764;267;2668;2678;7.20;0.44;226.70;3.59;904;5;886.00;10
1768;5;621445690;1768;269;2670;2678;7.28;0.44;226.96;3.60;902;5;887.00;8
1774;5;621445702;1774;261;2673;2682;7.31;0.45;227.28;3.60;899;5;888.00;9
1776;5;621445714;1776;263;2675;2682;7.38;0.45;227.65;3.61;899;5;889.00;7
1778;5;621445725;1778;267;2675;2682;7.44;0.45;227.72;3.61;897;5;890.00;7
1781;5;621445737;1781;269;2676;2683;7.48;0.46;228.09;3.61;895;5;891.00;7
1784;5;621445749;1784;276;2676;2683;7.46;0.46;228.20;3.61;892;5;892.00;7
1787;5;621445761;1787;270;2681;2689;7.44;0.45;228.31;3.61;894;5;893.00;8
1790;5;621445773;1790;276;2682;2689;7.40;0.45;228.72;3.62;892;5;894.00;7
1793;5;621445785;1793;282;2683;2690;7.34;0.45;229.21;3.61;890;5;895.00;7
1796;5;621445796;1796;287;2683;2690;7.29;0.45;229.18;3.61;887;5;896.00;7
1798;5;621445812;1798;275;2683;2690;7.30;0.45;229.41;3.61;885;5;897.00;7
1798;5;621445824;1798;275;2684;2690;7.35;0.45;229.41;3.62;886;5;898.00;6
1800;5;621445836;1800;274;2686;2690;7.40;0.45;229.51;3.63;886;5;899.00;4
1806;5;621445850;1806;271;2715;2736;7.44;0.46;230.40;3.60;909;5;900.00;21
1808;5;621445872;1808;265;2715;2736;7.47;0.46;230.57;3.60;907;5;901.00;21
1810;5;621445884;1810;266;2719;2736;7.55;0.47;230.67;3.60;909;5;902.00;17
1813;5;621445897;1813;261;2720;2736;7.57;0.47;230.81;3.60;907;5;903.00;16
1820;5;621445909;1820;260;2722;2736;7.61;0.47;230.97;3.60;902;5;904.00;14
1821;5;621445920;1821;261;2724;2736;7.65;0.47;231.25;3.61;903;5;905.00;12
1824;5;621445939;1824;257;2729;2740;7.68;0.47;231.21;3.61;905;5;906.00;11
1827;5;621445951;1827;248;2731;2740;7.72;0.47;231.25;3.61;904;5;907.00;9
1832;5;621445963;1832;247;2734;2744;7.77;0.48;231.44;3.61;902;5;908.00;10
1834;5;621445977;1834;243;2736;2745;7.88;0.48;231.44;3.61;902;5;909.00;9
1838;5;621445988;1838;244;2737;2745;7.88;0.48;231.54;3.61;899;5;910.00;8
1843;5;621446000;1843;242;2738;2745;7.85;0.48;232.02;3.62;895;5;911.00;7
1848;5;621446013;1848;244;2749;2758;7.87;0.48;232.23;3.60;901;5;912.00;9
1851;5;621446026;1851;250;2751;2758;7.88;0.48;232.73;3.61;900;5;913.00;7
1855;5;621446039;1855;254;2751;2758;7.86;0.48;233.28;3.61;896;5;914.00;7
1858;5;621446051;1858;258;2752;2759;7.87;0.48;233.21;3.61;894;5;915.00;7
1862;5;621446064;1862;258;2754;2760;7.87;0.48;233.46;3.60;892;5;916.00;6
1866;5;621446076;1866;252;2755;2760;7.84;0.48;233.94;3.61;889;5;917.00;5
1867;5;621446088;1867;251;2758;2763;7.82;0.48;233.98;3.61;891;5;918.00;5
1870;5;621446100;1870;253;2758;2763;7.78;0.47;234.36;3.61;888;5;919.00;5
1873;5;621446111;1873;258;2759;2763;7.77;0.47;234.60;3.61;886;5;920.00;4
1875;5;621446124;1875;254;2759;2763;7.72;0.47;234.78;3.61;884;5;921.00;4
1876;5;621446135;1876;255;2764;2769;7.74;0.47;234.94;3.61;888;5;922.00;5
1878;5;621446147;1878;257;2765;2769;7.79;0.48;235.06;3.61;887;5;923.00;4
1881;5;621446158;1881;262;2767;2769;7.79;0.48;235.17;3.62;886;5;924.00;2
1883;5;621446169;1883;260;2767;2769;7.83;0.48;235.27;3.62;884;5;925.00;2
1887;5;621446180;1887;265;2773;2773;7.80;0.48;235.46;3.63;886;5;926.00;0
1889;5;621446193;1889;266;2774;2774;7.75;0.47;235.42;3.63;885;5;927.00;0
1891;5;621446204;1891;269;2774;2774;7.74;0.47;235.47;3.63;883;5;928.00;0
1893;5;621446214;1893;265;2775;2775;7.75;0.47;235.55;3.62;882;5;929.00;0
1896;5;621446227;1896;271;2775;2775;7.73;0.47;235.55;3.62;879;5;930.00;0
1902;5;621446243;1902;272;2775;2775;7.64;0.46;235.75;3.62;873;5;931.00;0
1904;5;621446262;1904;280;2775;2775;7.53;0.46;235.72;3.62;871;5;932.00;0
1904;5;621446273;1904;283;2775;2775;7.48;0.45;235.72;3.62;871;5;933.00;0
1906;5;621446285;1906;292;2775;2775;7.43;0.45;235.77;3.62;869;5;934.00;0
1906;5;621446302;1906;301;2775;2775;7.38;0.45;235.77;3.62;869;5;935.00;0
1910;5;621446311;1910;310;2814;2845;7.32;0.44;235.97;3.57;904;5;936.00;31
1911;5;621446328;1911;312;2814;2846;7.30;0.44;236.03;3.57;903;5;937.00;32
1912;5;621446346;1912;317;2822;2846;7.32;0.44;236.04;3.57;910;5;938.00;24
1912;5;621446362;1912;325;2823;2846;7.30;0.44;236.04;3.57;911;5;939.00;23
1913;5;621446373;1913;328;2826;2846;7.30;0.44;236.03;3.57;913;5;940.00;20
1914;5;621446383;1914;330;2828;2846;7.35;0.45;236.06;3.57;914;5;941.00;18
1916;5;621446393;1916;325;2831;2846;7.35;0.45;236.04;3.57;915;5;942.00;15
1916;5;621446404;1916;324;2834;2846;7.39;0.45;236.04;3.58;918;5;943.00;12
1916;5;621446415;1916;321;2837;2847;7.39;0.45;236.04;3.58;921;5;944.00;10
1918;5;621446425;1918;320;2840;2849;7.40;0.45;235.97;3.58;922;5;945.00;9
1922;5;621446436;1922;309;2842;2849;7.40;0.45;235.88;3.59;920;5;946.00;7
1923;5;621446447;1923;309;2846;2853;7.38;0.45;235.80;3.59;923;5;947.00;7
1926;5;621446458;1926;313;2847;2853;7.36;0.45;235.86;3.59;921;5;948.00;6
1930;5;621446468;1930;312;2847;2853;7.27;0.44;236.13;3.59;917;5;949.00;6
1934;5;621446479;1934;311;2847;2853;7.14;0.43;236.21;3.59;913;5;950.00;6
1935;5;621446489;1935;307;2851;2859;7.05;0.43;236.20;3.58;916;5;951.00;8
1939;5;621446498;1939;305;2851;2859;6.91;0.42;236.25;3.58;912;5;952.00;8
1944;5;621446509;1944;302;2851;2859;6.76;0.41;236.36;3.58;907;5;953.00;8
1945;5;621446518;1945;303;2853;2862;6.74;0.41;236.28;3.58;908;5;954.00;9
1947;5;621446528;1947;305;2856;2862;6.67;0.40;236.47;3.59;909;5;955.00;6
1951;5;621446537;1951;307;2857;2862;6.59;0.40;236.37;3.59;906;5;956.00;5
1952;5;621446547;1952;315;2858;2863;6.57;0.40;236.28;3.59;906;5;957.00;5
1955;5;621446557;1955;314;2859;2864;6.59;0.40;236.40;3.59;904;5;958.00;5
1957;5;621446566;1957;316;2859;2864;6.60;0.40;236.26;3.59;902;5;959.00;5
1959;5;621446577;1959;322;2876;2890;6.67;0.41;236.31;3.57;917;5;960.00;14
1960;5;621446589;1960;306;2876;2890;6.69;0.41;236.53;3.57;916;5;961.00;14
1964;5;621446599;1964;316;2878;2890;6.72;0.41;236.38;3.57;914;5;962.00;12
1966;5;621446609;1966;317;2882;2891;6.77;0.41;236.22;3.57;916;5;963.00;9
1968;5;621446619;1968;313;2882;2891;6.79;0.41;236.08;3.57;914;5;964.00;9
1969;5;621446628;1969;316;2885;2895;6.84;0.41;236.10;3.57;916;5;965.00;10
1971;5;621446638;1971;312;2886;2895;6.86;0.42;236.00;3.57;915;5;966.00;9
1972;5;621446647;1972;323;2889;2899;6.86;0.42;235.89;3.57;917;5;967.00;10
1973;5;621446657;1973;321;2889;2899;6.86;0.42;235.79;3.57;916;5;968.00;10
1974;5;621446667;1974;319;2890;2899;6.84;0.41;235.86;3.57;916;5;969.00;9
1974;5;621446676;1974;321;2890;2899;6.89;0.42;235.86;3.57;916;5;970.00;9
1977;5;621446686;1977;325;2891;2899;6.81;0.41;235.64;3.58;914;5;971.00;8
1978;5;621446696;1978;327;2901;2911;6.85;0.42;235.69;3.57;923;5;972.00;10
1979;5;621446707;1979;327;2903;2911;6.85;0.42;235.73;3.58;924;5;973.00;8
1979;5;621446717;1979;325;2905;2911;6.85;0.42;235.73;3.59;926;5;974.00;6
1984;5;621446726;1984;321;2907;2911;6.80;0.41;235.74;3.60;923;5;975.00;4
1985;5;621446735;1985;332;2907;2911;6.79;0.41;235.66;3.60;922;5;976.00;4
1985;5;621446745;1985;328;2907;2911;6.74;0.41;235.66;3.60;922;5;977.00;4
1987;5;621446754;1987;337;2907;2912;6.70;0.41;235.67;3.60;920;5;978.00;5
1987;5;621446764;1987;325;2907;2912;6.69;0.41;235.67;3.60;920;5;979.00;5
1987;5;621446774;1987;321;2914;2918;6.75;0.41;235.67;3.61;927;5;980.00;4
1988;5;621446784;1988;318;2915;2919;6.79;0.41;235.64;3.61;927;5;981.00;4
1989;5;621446794;1989;316;2915;2919;6.78;0.41;235.53;3.61;926;5;982.00;4
1992;5;621446805;1992;316;2917;2919;6.74;0.41;235.47;3.61;925;5;983.00;2
1992;5;621446815;1992;318;2920;2923;6.73;0.41;235.47;3.61;928;5;984.00;3
1994;5;621446825;1994;323;2920;2923;6.74;0.41;235.38;3.61;926;5;985.00;3
1996;5;621446840;1996;328;2921;2923;6.75;0.41;235.54;3.61;925;5;986.00;2
1996;5;621446850;1996;329;2922;2924;6.75;0.41;235.54;3.61;926;5;987.00;2
1996;5;621446860;1996;332;2926;2928;6.85;0.42;235.54;3.61;930;5;988.00;2
1999;5;621446870;1999;339;2928;2928;6.85;0.42;235.52;3.61;929;5;989.00;0
2000;5;621446882;2000;337;2932;2934;6.95;0.42;235.42;3.61;932;5;990.00;2
2001;5;621446892;2001;336;2933;2934;7.01;0.43;235.39;3.60;932;5;991.00;1
2002;5;621446903;2002;336;2934;2934;7.05;0.43;235.41;3.60;932;5;992.00;0
2003;5;621446913;2003;326;2934;2934;7.03;0.43;235.35;3.60;931;5;993.00;0
2005;5;621446927;2005;328;2938;2938;7.07;0.43;235.26;3.60;933;5;994.00;0
2006;5;621446938;2006;332;2938;2938;7.05;0.43;235.23;3.60;932;5;995.00;0
2006;5;621446948;2006;325;2938;2938;7.01;0.43;235.23;3.60;932;5;996.00;0
2007;5;621446963;2007;323;2938;2938;6.96;0.43;235.19;3.60;931;5;997.00;0
2008;5;621446973;2008;324;2939;2939;6.88;0.42;235.27;3.60;931;5;998.00;0
2010;5;621446983;2010;318;2940;2940;6.83;0.42;235.31;3.60;930;5;999.00;0
2013;5;621446993;2013;316;2940;2940;6.77;0.41;235.23;3.60;927;5;1000.00;0
2016;5;621447006;2016;310;2941;2941;6.77;0.41;235.18;3.60;925;5;1001.00;0
2019;5;621447016;2019;305;2941;2941;6.77;0.41;235.41;3.60;922;5;1002.00;0
2021;5;621447026;2021;300;2941;2941;6.73;0.41;235.38;3.60;920;5;1003.00;0
2021;5;621447036;2021;294;2941;2941;6.68;0.41;235.38;3.60;920;5;1004.00;0
2023;5;621447045;2023;291;2941;2941;6.66;0.41;235.48;3.60;918;5;1005.00;0
2028;5;621447055;2028;288;2941;2941;6.60;0.40;235.82;3.60;913;5;1006.00;0
2031;5;621447064;2031;291;2941;2941;6.61;0.40;235.70;3.60;910;5;1007.00;0
2032;5;621447074;2032;306;3016;3068;6.89;0.43;235.80;3.51;984;5;1008.00;52
2034;5;621447093;2034;295;3020;3069;6.89;0.43;235.86;3.51;986;5;1009.00;49
2037;5;621447103;2037;288;3030;3069;6.91;0.43;235.95;3.50;993;5;1010.00;39
2040;5;621447113;2040;285;3035;3069;6.87;0.43;235.94;3.50;995;5;1011.00;34
2040;5;621447123;2040;282;3041;3069;6.91;0.43;235.94;3.50;1001;5;1012.00;28
2044;5;621447133;2044;283;3043;3069;6.84;0.42;236.03;3.50;999;5;1013.00;26
2049;5;621447144;2049;285;3045;3069;6.72;0.41;235.96;3.50;996;5;1014.00;24
2051;5;621447154;2051;287;3047;3069;6.74;0.42;235.99;3.51;996;5;1015.00;22
2054;5;621447164;2054;295;3050;3070;6.70;0.41;235.87;3.51;996;5;1016.00;20
2056;5;621447175;2056;296;3052;3071;6.67;0.41;236.04;3.51;996;5;1017.00;19
2060;5;621447185;2060;292;3054;3071;6.62;0.41;236.14;3.52;994;5;1018.00;17
2063;5;621447196;2063;297;3056;3072;6.50;0.40;236.23;3.52;993;5;1019.00;16
2066;5;621447207;2066;289;3059;3072;6.48;0.40;236.33;3.53;993;5;1020.00;13
2069;5;621447218;2069;282;3061;3072;6.45;0.40;236.18;3.53;992;5;1021.00;11
2072;5;621447229;2072;277;3062;3072;6.43;0.40;236.24;3.54;990;5;1022.00;10
2078;5;621447240;2078;277;3068;3076;6.51;0.40;236.24;3.55;990;5;1023.00;8
2079;5;621447251;2079;278;3068;3076;6.60;0.41;236.31;3.55;989;5;1024.00;8
2084;5;621447262;2084;276;3069;3076;6.68;0.41;236.69;3.55;985;5;1025.00;7
2086;5;621447274;2086;273;3071;3079;6.74;0.42;236.77;3.56;985;5;1026.00;8
2088;5;621447284;2088;267;3073;3079;6.81;0.42;236.80;3.56;985;5;1027.00;6
2093;5;621447295;2093;262;3074;3079;6.80;0.42;237.15;3.57;981;5;1028.00;5
2095;5;621447306;2095;258;3079;3083;6.86;0.42;237.33;3.57;984;5;1029.00;4
2098;5;621447318;2098;253;3080;3084;6.93;0.43;237.46;3.57;982;5;1030.00;4
2106;5;621447329;2106;251;3082;3084;6.99;0.43;237.81;3.57;976;5;1031.00;2
2113;5;621447341;2113;242;3085;3088;7.05;0.43;237.93;3.57;972;5;1032.00;3
2116;5;621447353;2116;249;3085;3088;7.08;0.44;237.97;3.57;969;5;1033.00;3
2120;5;621447364;2120;248;3086;3088;7.11;0.44;238.33;3.57;966;5;1034.00;2
2124;5;621447375;2124;243;3088;3090;7.17;0.44;238.45;3.57;964;5;1035.00;2
2127;5;621447388;2127;246;3088;3090;7.21;0.44;238.64;3.57;961;5;1036.00;2
2130;5;621447399;2130;246;3093;3096;7.27;0.45;239.07;3.57;963;5;1037.00;3
2131;5;621447418;2131;241;3093;3096;7.29;0.45;239.19;3.57;962;5;1038.00;3
2139;5;621447436;2139;243;3094;3097;7.25;0.45;239.33;3.57;955;5;1039.00;3
2145;5;621447456;2145;245;3095;3097;7.26;0.45;239.50;3.57;950;5;1040.00;2
2145;5;621447473;2145;244;3095;3097;7.32;0.45;239.50;3.57;950;5;1041.00;2
2152;5;621447492;2152;245;3095;3097;7.32;0.45;239.93;3.57;943;5;1042.00;2
2156;5;621447510;2156;248;3096;3097;7.29;0.45;240.39;3.57;940;5;1043.00;1
2166;5;621447532;2166;253;3103;3109;7.28;0.45;240.63;3.56;937;5;1044.00;6
2170;5;621447546;2170;256;3103;3109;7.28;0.45;240.99;3.56;933;5;1045.00;6
2173;5;621447559;2173;253;3105;3109;7.34;0.45;241.16;3.56;932;5;1046.00;4
2177;5;621447572;2177;253;3106;3109;7.38;0.45;241.39;3.56;929;5;1047.00;3
2184;5;621447584;2184;250;3107;3109;7.39;0.45;241.74;3.56;923;5;1048.00;2
2190;5;621447598;2190;252;3107;3109;7.43;0.46;241.97;3.56;917;5;1049.00;2
2193;5;621447612;2193;250;3114;3115;7.48;0.46;241.90;3.56;921;5;1050.00;1
2200;5;621447625;2200;255;3115;3115;7.51;0.46;242.36;3.56;915;5;1051.00;0
2206;5;621447638;2206;255;3118;3119;7.55;0.46;242.73;3.56;912;5;1052.00;1
2209;5;621447651;2209;258;3120;3120;7.63;0.47;242.81;3.56;911;5;1053.00;0
2214;5;621447663;2214;263;3120;3120;7.64;0.47;243.08;3.56;906;5;1054.00;0
2218;5;621447675;2218;266;3120;3120;7.59;0.46;243.47;3.56;902;5;1055.00;0
2220;5;621447687;2220;264;3133;3133;7.64;0.47;243.51;3.54;913;5;1056.00;0
2224;5;621447700;2224;258;3133;3133;7.67;0.47;243.50;3.54;909;5;1057.00;0
2228;5;621447712;2228;257;3133;3133;7.70;0.47;243.64;3.54;905;5;1058.00;0
2234;5;621447724;2234;255;3134;3134;7.69;0.47;243.98;3.54;900;5;1059.00;0
2236;5;621447736;2236;256;3135;3135;7.70;0.47;244.14;3.54;899;5;1060.00;0
2240;5;621447747;2240;257;3135;3135;7.69;0.47;244.27;3.54;895;5;1061.00;0
2245;5;621447760;2245;260;3137;3138;7.69;0.47;244.40;3.54;892;5;1062.00;1
2245;5;621447773;2245;259;3137;3138;7.71;0.47;244.40;3.54;892;5;1063.00;1
2248;5;621447784;2248;262;3138;3138;7.69;0.47;244.52;3.54;890;5;1064.00;0
2249;5;621447796;2249;267;3138;3138;7.73;0.47;244.75;3.54;889;5;1065.00;0
2254;5;621447807;2254;272;3144;3144;7.66;0.47;244.84;3.53;890;5;1066.00;0
2258;5;621447819;2258;269;3144;3144;7.59;0.46;245.14;3.53;886;5;1067.00;0
2262;5;621447837;2262;264;3144;3144;7.48;0.46;245.49;3.53;882;5;1068.00;0
2266;5;621447849;2266;265;3144;3144;7.42;0.45;245.62;3.53;878;5;1069.00;0
2271;5;621447860;2271;268;3148;3148;7.38;0.45;245.83;3.53;877;5;1070.00;0
2277;5;621447873;2277;274;3149;3149;7.32;0.45;246.23;3.53;872;5;1071.00;0
2281;5;621447884;2281;282;3149;3149;7.34;0.45;246.38;3.53;868;5;1072.00;0
2287;5;621447896;2287;280;3150;3150;7.37;0.45;246.68;3.53;863;5;1073.00;0
2290;5;621447919;2290;286;3150;3150;7.41;0.45;246.90;3.53;860;5;1074.00;0
2295;5;621447931;2295;291;3150;3150;7.41;0.45;247.29;3.53;855;5;1075.00;0
2297;5;621447942;2297;278;3150;3150;7.41;0.45;247.20;3.53;853;5;1076.00;0
2300;5;621447953;2300;268;3150;3150;7.45;0.45;247.54;3.53;850;5;1077.00;0
2302;5;621447965;2302;267;3150;3150;7.45;0.45;247.70;3.53;848;5;1078.00;0
2304;5;621447976;2304;264;3150;3150;7.46;0.45;247.79;3.53;846;5;1079.00;0
2306;5;621447989;2306;287;3227;3275;7.62;0.47;247.97;3.44;921;5;1080.00;48
2307;5;621448011;2307;283;3233;3276;7.61;0.47;248.16;3.44;926;5;1081.00;43
2311;5;621448023;2311;269;3240;3276;7.71;0.47;248.34;3.44;929;5;1082.00;36
2314;5;621448035;2314;275;3242;3276;7.74;0.48;248.46;3.43;928;5;1083.00;34
2317;5;621448047;2317;273;3248;3276;7.74;0.48;248.60;3.44;931;5;1084.00;28
2320;5;621448065;2320;270;3250;3276;7.74;0.48;248.83;3.44;930;5;1085.00;26
2323;5;621448077;2323;278;3256;3276;7.70;0.47;248.92;3.44;933;5;1086.00;20
2324;5;621448088;2324;279;3261;3276;7.62;0.47;248.97;3.45;937;5;1087.00;15
2327;5;621448100;2327;276;3265;3277;7.54;0.46;249.31;3.45;938;5;1088.00;12
2328;5;621448112;2328;279;3269;3278;7.38;0.45;249.24;3.46;941;5;1089.00;9
2330;5;621448124;2330;277;3271;3278;7.26;0.45;249.42;3.46;941;5;1090.00;7
2332;5;621448137;2332;274;3278;3282;7.22;0.44;249.39;3.46;946;5;1091.00;4
2336;5;621448150;2336;278;3278;3282;7.17;0.44;249.65;3.46;942;5;1092.00;4
2338;5;621448161;2338;278;3279;3282;7.20;0.44;249.68;3.47;941;5;1093.00;3
2340;5;621448179;2340;284;3279;3282;7.23;0.44;249.96;3.47;939;5;1094.00;3
2342;5;621448191;2342;285;3285;3288;7.23;0.44;249.97;3.47;943;5;1095.00;3
2346;5;621448203;2346;284;3286;3288;7.27;0.45;250.09;3.47;940;5;1096.00;2
2348;5;621448215;2348;290;3286;3288;7.22;0.44;249.99;3.47;938;5;1097.00;2
2350;5;621448227;2350;293;3290;3291;7.20;0.44;250.30;3.47;940;5;1098.00;1
2354;5;621448239;2354;291;3290;3291;7.13;0.44;250.17;3.47;936;5;1099.00;1
2355;5;621448252;2355;296;3290;3291;7.17;0.44;250.10;3.47;935;5;1100.00;1
2356;5;621448268;2356;298;3291;3292;7.16;0.44;250.12;3.47;935;5;1101.00;1
2360;5;621448279;2360;301;3293;3293;7.14;0.44;249.91;3.47;933;5;1102.00;0
2362;5;621448291;2362;305;3293;3293;7.12;0.44;249.94;3.47;931;5;1103.00;0
2364;5;621448301;2364;320;3305;3306;7.06;0.43;249.97;3.46;941;5;1104.00;1
2365;5;621448313;2365;316;3305;3306;7.05;0.43;249.99;3.46;940;5;1105.00;1
2366;5;621448325;2366;323;3305;3306;7.07;0.43;250.03;3.46;939;5;1106.00;1
2368;5;621448336;2368;323;3306;3307;7.04;0.43;249.98;3.46;938;5;1107.00;1
2371;5;621448347;2371;328;3306;3307;7.06;0.43;249.85;3.46;935;5;1108.00;1
2374;5;621448358;2374;332;3310;3311;7.04;0.43;249.83;3.45;936;5;1109.00;1
2376;5;621448372;2376;324;3310;3311;6.99;0.43;249.84;3.45;934;5;1110.00;1
2378;5;621448391;2378;324;3313;3315;6.99;0.43;249.75;3.45;935;5;1111.00;2
2382;5;621448405;2382;322;3313;3315;6.98;0.43;249.67;3.45;931;5;1112.00;2
2385;5;621448418;2385;321;3313;3315;7.01;0.43;249.68;3.45;928;5;1113.00;2
2388;5;621448430;2388;318;3313;3315;7.02;0.43;249.61;3.45;925;5;1114.00;2
2390;5;621448442;2390;313;3313;3315;6.99;0.43;249.49;3.45;923;5;1115.00;2
2395;5;621448454;2395;316;3323;3327;7.00;0.43;249.37;3.44;928;5;1116.00;4
2395;5;621448467;2395;313;3323;3327;6.97;0.43;249.37;3.44;928;5;1117.00;4
2397;5;621448478;2397;315;3324;3327;6.99;0.43;249.38;3.44;927;5;1118.00;3
2399;5;621448489;2399;310;3324;3327;6.95;0.42;249.31;3.44;925;5;1119.00;3
2401;5;621448500;2401;310;3324;3327;6.92;0.42;249.43;3.44;923;5;1120.00;3
2403;5;621448511;2403;312;3324;3327;6.82;0.42;249.55;3.44;921;5;1121.00;3
2406;5;621448522;2406;307;3324;3328;6.73;0.41;249.73;3.44;918;5;1122.00;4
2411;5;621448532;2411;308;3324;3328;6.61;0.40;249.63;3.44;913;5;1123.00;4
2414;5;621448541;2414;302;3329;3334;6.56;0.40;249.84;3.44;915;5;1124.00;5
2414;5;621448551;2414;305;3333;3336;6.55;0.40;249.84;3.44;919;5;1125.00;3
2416;5;621448561;2416;299;3333;3336;6.47;0.39;249.89;3.44;917;5;1126.00;3
2418;5;621448571;2418;299;3333;3336;6.45;0.39;250.02;3.44;915;5;1127.00;3
2419;5;621448581;2419;295;3336;3340;6.51;0.40;250.02;3.44;917;5;1128.00;4
2422;5;621448591;2422;301;3336;3340;6.52;0.40;249.90;3.44;914;5;1129.00;4
2422;5;621448601;2422;300;3336;3340;6.55;0.40;249.90;3.44;914;5;1130.00;4
2422;5;621448610;2422;286;3337;3341;6.59;0.40;249.90;3.44;915;5;1131.00;4
2425;5;621448620;2425;275;3340;3345;6.67;0.40;249.79;3.44;915;5;1132.00;5
2426;6;621448630;2426;265;3340;3345;6.76;0.41;249.79;3.44;914;6;1133.00;5
2426;6;621448651;2426;261;3342;3348;6.91;0.42;249.79;3.44;916;6;1134.00;6
2426;6;621448661;2426;262;3343;3348;7.07;0.43;249.79;3.43;917;6;1135.00;5
2428;6;621448671;2428;253;3343;3348;7.16;0.43;249.69;3.43;915;6;1136.00;5
2429;6;621448681;2429;251;3343;3348;7.25;0.44;249.73;3.43;914;6;1137.00;5
2429;6;621448697;2429;237;3347;3352;7.35;0.45;249.73;3.43;918;6;1138.00;5
2430;6;621448708;2430;237;3347;3352;7.41;0.45;249.65;3.43;917;6;1139.00;5
2431;6;621448720;2431;232;3347;3352;7.45;0.45;249.62;3.43;916;6;1140.00;5
2431;6;621448736;2431;229;3347;3352;7.48;0.45;249.62;3.43;916;6;1141.00;5
2433;6;621448746;2433;228;3347;3353;7.49;0.45;249.46;3.43;914;6;1142.00;6
2433;6;621448756;2433;224;3348;3354;7.54;0.46;249.46;3.43;915;6;1143.00;6
2434;6;621448773;2434;215;3348;3354;7.55;0.46;249.39;3.43;914;6;1144.00;6
2435;6;621448789;2435;214;3349;3355;7.60;0.46;249.40;3.43;914;6;1145.00;6
2438;6;621448800;2438;218;3349;3355;7.58;0.46;249.32;3.43;911;6;1146.00;6
2439;6;621448810;2439;219;3349;3355;7.62;0.46;249.30;3.43;910;6;1147.00;6
2439;6;621448821;2439;219;3349;3355;7.70;0.47;249.30;3.43;910;6;1148.00;6
2441;6;621448831;2441;225;3349;3355;7.78;0.47;249.18;3.43;908;6;1149.00;6
2443;6;621448842;2443;217;3351;3355;7.81;0.48;249.18;3.45;908;6;1150.00;4
2444;6;621448852;2444;216;3351;3355;7.84;0.48;249.21;3.45;907;6;1151.00;4
2447;6;621448863;2447;230;3415;3482;8.02;0.49;249.36;3.38;968;6;1152.00;67
2449;6;621448883;2449;227;3419;3483;8.02;0.49;249.45;3.39;970;6;1153.00;64
2450;6;621448894;2450;223;3428;3483;8.07;0.50;249.41;3.39;978;6;1154.00;55
2451;6;621448907;2451;222;3435;3483;8.03;0.50;249.37;3.39;984;6;1155.00;48
2453;6;621448918;2453;220;3444;3483;8.08;0.50;249.34;3.39;991;6;1156.00;39
2455;6;621448930;2455;224;3445;3483;7.96;0.49;249.55;3.39;990;6;1157.00;38
2456;6;621448942;2456;230;3447;3483;7.93;0.49;249.55;3.39;991;6;1158.00;36
2459;6;621448959;2459;235;3452;3483;7.82;0.48;249.54;3.41;993;6;1159.00;31
2460;6;621448972;2460;233;3454;3484;7.76;0.48;249.54;3.41;994;6;1160.00;30
2464;6;621448983;2464;235;3459;3485;7.70;0.47;249.49;3.42;995;6;1161.00;26
2468;6;621448994;2468;234;3461;3485;7.59;0.47;249.43;3.42;993;6;1162.00;24
2468;6;621449005;2468;241;3466;3486;7.54;0.46;249.43;3.43;998;6;1163.00;20
2470;6;621449021;2470;247;3470;3486;7.48;0.46;249.43;3.44;1000;6;1164.00;16
2473;6;621449032;2473;259;3472;3486;7.38;0.45;249.38;3.45;999;6;1165.00;14
2473;6;621449042;2473;261;3474;3486;7.29;0.45;249.38;3.45;1001;6;1166.00;12
2476;6;621449052;2476;266;3479;3490;7.24;0.45;249.37;3.46;1003;6;1167.00;11
2477;6;621449064;2477;275;3481;3490;7.22;0.44;249.32;3.47;1004;6;1168.00;9
2479;6;621449075;2479;277;3484;3490;7.20;0.44;249.48;3.48;1005;6;1169.00;6
2483;6;621449087;2483;277;3488;3496;7.10;0.44;249.38;3.48;1005;6;1170.00;8
2484;6;621449105;2484;284;3491;3496;7.07;0.44;249.37;3.49;1007;6;1171.00;5
2490;6;621449116;2490;287;3494;3496;6.98;0.43;249.52;3.49;1004;6;1172.00;2
2494;6;621449127;2494;280;3498;3500;6.91;0.42;249.76;3.49;1004;6;1173.00;2
2497;6;621449139;2497;281;3499;3501;6.90;0.42;249.82;3.49;1002;6;1174.00;2
2501;6;621449150;2501;275;3501;3501;6.89;0.42;249.93;3.49;1000;6;1175.00;0
2505;6;621449161;2505;270;3505;3505;6.91;0.42;250.03;3.49;1000;6;1176.00;0
2507;6;621449173;2507;270;3505;3505;6.91;0.42;250.13;3.49;998;6;1177.00;0
2509;6;621449184;2509;273;3505;3505;6.95;0.43;250.28;3.49;996;6;1178.00;0
2511;6;621449194;2511;277;3506;3506;6.99;0.43;250.34;3.48;995;6;1179.00;0
2512;6;621449206;2512;277;3506;3506;7.01;0.43;250.28;3.48;994;6;1180.00;0
2514;6;621449216;2514;281;3512;3512;7.02;0.43;250.37;3.48;998;6;1181.00;0
2516;6;621449227;2516;281;3512;3512;6.99;0.43;250.47;3.48;996;6;1182.00;0
2520;6;621449238;2520;281;3513;3513;6.94;0.43;250.63;3.48;993;6;1183.00;0
2523;6;621449248;2523;281;3513;3513;6.92;0.43;250.66;3.48;990;6;1184.00;0
2528;6;621449259;2528;285;3513;3513;6.90;0.42;250.74;3.48;985;6;1185.00;0
2534;6;621449269;2534;295;3513;3513;6.85;0.42;250.96;3.48;979;6;1186.00;0
2538;6;621449280;2538;296;3513;3513;6.89;0.42;251.07;3.48;975;6;1187.00;0
2543;6;621449290;2543;304;3524;3525;6.83;0.42;251.13;3.47;981;6;1188.00;1
2547;6;621449301;2547;305;3524;3525;6.84;0.42;251.36;3.47;977;6;1189.00;1
2552;6;621449311;2552;293;3525;3525;6.90;0.42;251.47;3.47;973;6;1190.00;0
2557;6;621449321;2557;293;3525;3525;6.92;0.42;251.50;3.47;968;6;1191.00;0
2564;6;621449332;2564;285;3525;3525;6.93;0.42;251.68;3.47;961;6;1192.00;0
2566;6;621449343;2566;282;3525;3525;6.98;0.43;251.78;3.47;959;6;1193.00;0
2573;6;621449353;2573;276;3529;3529;6.94;0.42;252.00;3.47;956;6;1194.00;0
2576;6;621449364;2576;277;3529;3529;6.93;0.42;252.27;3.47;953;6;1195.00;0
2579;6;621449374;2579;274;3533;3533;7.04;0.43;252.53;3.46;954;6;1196.00;0
2582;6;621449385;2582;274;3534;3534;7.05;0.43;252.81;3.46;952;6;1197.00;0
2588;6;621449396;2588;265;3534;3534;6.99;0.43;253.12;3.46;946;6;1198.00;0
2590;6;621449412;2590;259;3534;3534;7.01;0.43;253.28;3.46;944;6;1199.00;0
2593;6;621449433;2593;260;3559;3575;6.97;0.43;253.56;3.44;966;6;1200.00;16
2599;6;621449467;2599;260;3561;3575;6.98;0.43;253.68;3.44;962;6;1201.00;14
2600;6;621449486;2600;257;3564;3575;6.98;0.43;253.78;3.43;964;6;1202.00;11
2605;6;621449500;2605;260;3565;3576;6.99;0.43;254.35;3.43;960;6;1203.00;11
2608;6;621449518;2608;267;3568;3577;6.96;0.43;254.56;3.43;960;6;1204.00;9
2611;6;621449532;2611;259;3569;3577;7.00;0.43;254.67;3.43;958;6;1205.00;8
2618;6;621449545;2618;257;3572;3580;7.04;0.43;255.00;3.43;954;6;1206.00;8
2623;6;621449557;2623;255;3573;3580;7.02;0.43;255.19;3.43;950;6;1207.00;7
2626;6;621449570;2626;251;3575;3580;7.00;0.43;255.50;3.43;949;6;1208.00;5
2631;6;621449582;2631;249;3575;3580;6.91;0.42;255.71;3.43;944;6;1209.00;5
2635;6;621449595;2635;250;3582;3586;6.89;0.42;255.77;3.43;947;6;1210.00;4
2639;6;621449609;2639;257;3582;3586;6.93;0.42;256.01;3.43;943;6;1211.00;4
2641;7;621449621;2641;256;3582;3586;6.93;0.42;256.24;3.43;941;7;1212.00;4
2644;7;621449640;2644;254;3582;3586;6.94;0.43;256.56;3.43;938;7;1213.00;4
2645;7;621449653;2645;254;3586;3590;6.97;0.43;256.67;3.43;941;7;1214.00;4
2652;7;621449665;2652;261;3588;3592;7.00;0.43;256.89;3.43;936;7;1215.00;4
2657;7;621449677;2657;267;3589;3592;7.00;0.43;256.94;3.43;932;7;1216.00;3
2662;7;621449688;2662;269;3590;3593;7.04;0.43;257.50;3.43;928;7;1217.00;3
2667;7;621449700;2667;269;3590;3593;7.08;0.43;257.47;3.43;923;7;1218.00;3
2672;7;621449711;2672;271;3590;3593;7.04;0.43;257.73;3.43;918;7;1219.00;3
2676;7;621449723;2676;275;3590;3593;7.01;0.43;257.71;3.43;914;7;1220.00;3
2681;7;621449734;2681;286;3591;3593;6.86;0.42;257.93;3.44;910;7;1221.00;2
2686;7;621449752;2686;290;3591;3593;6.74;0.41;258.01;3.44;905;7;1222.00;2
2690;7;621449772;2690;296;3591;3593;6.62;0.41;257.93;3.44;901;7;1223.00;2
2696;7;621449791;2696;313;3634;3663;6.54;0.40;258.16;3.39;938;7;1224.00;29
2698;7;621449808;2698;307;3635;3664;6.53;0.40;258.23;3.39;937;7;1225.00;29
2704;7;621449820;2704;312;3641;3664;6.61;0.41;258.40;3.39;937;7;1226.00;23
2711;7;621449831;2711;319;3642;3664;6.60;0.41;258.19;3.40;931;7;1227.00;22
2714;7;621449843;2714;320;3646;3666;6.70;0.41;258.31;3.40;932;7;1228.00;20
2716;7;621449854;2716;317;3647;3666;6.79;0.42;258.33;3.40;931;7;1229.00;19
2719;7;621449867;2719;315;3650;3666;6.77;0.41;258.41;3.40;931;7;1230.00;16
2719;7;621449878;2719;317;3653;3666;6.83;0.42;258.41;3.40;934;7;1231.00;13
2725;7;621449889;2725;318;3655;3667;6.74;0.41;258.56;3.41;930;7;1232.00;12
2727;7;621449900;2727;330;3660;3668;6.69;0.41;258.53;3.42;933;7;1233.00;8
2732;7;621449913;2732;337;3663;3668;6.58;0.40;258.83;3.42;931;7;1234.00;5
2737;7;621449924;2737;350;3667;3672;6.45;0.39;259.09;3.42;930;7;1235.00;5
2738;7;621449936;2738;356;3669;3672;6.44;0.39;259.13;3.43;931;7;1236.00;3
2741;7;621449948;2741;354;3670;3672;6.39;0.39;259.25;3.43;929;7;1237.00;2
2743;7;621449961;2743;355;3672;3672;6.41;0.39;259.26;3.43;929;7;1238.00;0
2745;7;621449973;2745;353;3678;3678;6.44;0.39;259.37;3.43;933;7;1239.00;0
2748;7;621449985;2748;354;3678;3678;6.51;0.40;259.43;3.43;930;7;1240.00;0
2751;7;621449996;2751;354;3678;3678;6.54;0.40;259.54;3.43;927;7;1241.00;0
2753;7;621450009;2753;357;3680;3681;6.58;0.40;259.57;3.42;927;7;1242.00;1
2757;7;621450022;2757;355;3680;3681;6.60;0.40;259.72;3.42;923;7;1243.00;1
2761;7;621450035;2761;355;3681;3681;6.64;0.40;259.83;3.42;920;7;1244.00;0
2763;7;621450049;2763;359;3682;3682;6.68;0.41;259.89;3.42;919;7;1245.00;0
2767;7;621450062;2767;342;3683;3683;6.64;0.40;260.02;3.42;916;7;1246.00;0
2768;7;621450075;2768;339;3683;3683;6.66;0.40;260.06;3.42;915;7;1247.00;0
2770;7;621450086;2770;342;3695;3696;6.78;0.41;260.03;3.41;925;7;1248.00;1
2771;7;621450099;2771;335;3696;3696;6.79;0.41;260.10;3.41;925;7;1249.00;0
2773;7;621450110;2773;330;3696;3696;6.83;0.42;260.09;3.41;923;7;1250.00;0
2778;7;621450121;2778;328;3697;3697;6.83;0.42;260.02;3.41;919;7;1251.00;0
2780;7;621450133;2780;326;3697;3697;6.83;0.42;259.88;3.41;917;7;1252.00;0
2782;7;621450145;2782;328;3701;3701;6.82;0.42;259.90;3.41;919;7;1253.00;0
2783;7;621450156;2783;324;3701;3701;6.87;0.42;259.95;3.41;918;7;1254.00;0
2785;7;621450167;2785;325;3705;3705;6.89;0.42;259.92;3.41;920;7;1255.00;0
2786;7;621450179;2786;330;3705;3705;6.90;0.42;259.93;3.41;919;7;1256.00;0
2789;7;621450191;2789;329;3705;3705;6.88;0.42;260.07;3.41;916;7;1257.00;0
2792;7;621450202;2792;321;3705;3705;6.87;0.42;260.09;3.41;913;7;1258.00;0
2799;7;621450213;2799;327;3705;3705;6.88;0.42;260.29;3.41;906;7;1259.00;0
2799;7;621450227;2799;334;3735;3739;6.93;0.43;260.29;3.38;936;7;1260.00;4
2801;7;621450240;2801;328;3735;3739;6.95;0.43;260.42;3.38;934;7;1261.00;4
2806;7;621450251;2806;328;3737;3739;6.97;0.43;260.32;3.38;931;7;1262.00;2
2807;7;621450263;2807;329;3737;3739;6.96;0.43;260.26;3.38;930;7;1263.00;2
2809;7;621450274;2809;331;3738;3739;7.04;0.43;260.21;3.38;929;7;1264.00;1
2811;7;621450285;2811;332;3738;3739;7.03;0.43;260.21;3.38;927;7;1265.00;1
2812;7;621450296;2812;328;3738;3740;7.02;0.43;260.13;3.38;926;7;1266.00;2
2815;7;621450307;2815;335;3738;3740;6.96;0.43;260.03;3.38;923;7;1267.00;2
2819;7;621450318;2819;337;3743;3746;6.99;0.43;259.97;3.37;924;7;1268.00;3
2821;7;621450329;2821;343;3744;3747;6.99;0.43;259.96;3.37;923;7;1269.00;3
2824;7;621450340;2824;343;3744;3747;6.97;0.42;259.76;3.37;920;7;1270.00;3
2824;7;621450350;2824;348;3744;3747;6.89;0.42;259.76;3.37;920;7;1271.00;3
2825;7;621450360;2825;351;3747;3751;6.79;0.41;259.76;3.37;922;7;1272.00;4
2827;7;621450370;2827;356;3747;3751;6.70;0.41;259.83;3.37;920;7;1273.00;4
2830;7;621450380;2830;359;3747;3751;6.62;0.40;259.95;3.37;917;7;1274.00;4
2832;7;621450391;2832;358;3748;3752;6.55;0.40;260.04;3.37;916;7;1275.00;4
2835;7;621450403;2835;364;3751;3756;6.49;0.39;260.03;3.37;916;7;1276.00;5
2836;7;621450414;2836;373;3751;3756;6.51;0.39;260.09;3.37;915;7;1277.00;5
2839;7;621450424;2839;374;3753;3759;6.47;0.39;260.24;3.37;914;7;1278.00;6
2842;7;621450433;2842;375;3753;3759;6.45;0.39;260.23;3.37;911;7;1279.00;6
2844;7;621450444;2844;373;3754;3759;6.46;0.39;260.14;3.37;910;7;1280.00;5
2844;7;621450455;2844;370;3754;3759;6.43;0.39;260.14;3.37;910;7;1281.00;5
2845;7;621450465;2845;365;3758;3763;6.45;0.39;260.13;3.36;913;7;1282.00;5
2846;7;621450475;2846;347;3758;3763;6.44;0.39;260.18;3.36;912;7;1283.00;5
2847;7;621450485;2847;333;3758;3763;6.47;0.39;260.25;3.36;911;7;1284.00;5
2848;7;621450495;2848;318;3758;3763;6.46;0.39;260.26;3.36;910;7;1285.00;5
2850;7;621450505;2850;309;3758;3764;6.51;0.39;260.28;3.36;908;7;1286.00;6
2851;7;621450516;2851;310;3759;3765;6.63;0.40;260.26;3.36;908;7;1287.00;6
2851;7;621450528;2851;299;3759;3765;6.76;0.41;260.26;3.36;908;7;1288.00;6
2853;7;621450541;2853;291;3760;3766;6.85;0.41;260.45;3.36;907;7;1289.00;6
2853;7;621450554;2853;279;3760;3766;6.94;0.42;260.45;3.36;907;7;1290.00;6
2854;7;621450564;2854;272;3760;3766;7.03;0.42;260.46;3.36;906;7;1291.00;6
2857;7;621450574;2857;261;3760;3766;7.03;0.42;260.55;3.36;903;7;1292.00;6
2859;7;621450585;2859;248;3760;3766;7.09;0.43;260.62;3.36;901;7;1293.00;6
2860;7;621450595;2860;242;3761;3766;7.08;0.43;260.61;3.37;901;7;1294.00;5
2861;7;621450605;2861;236;3761;3766;7.12;0.43;260.63;3.37;900;7;1295.00;5
2862;7;621450614;2862;247;3827;3893;7.26;0.45;260.61;3.32;965;7;1296.00;66
2865;7;621450634;2865;233;3827;3894;7.24;0.44;260.64;3.32;962;7;1297.00;67
2866;7;621450646;2866;222;3835;3894;7.33;0.45;260.64;3.32;969;7;1298.00;59
2869;7;621450658;2869;218;3838;3894;7.37;0.45;260.62;3.32;969;7;1299.00;56
2870;7;621450669;2870;210;3843;3894;7.42;0.45;260.60;3.32;973;7;1300.00;51
2870;7;621450684;2870;211;3845;3894;7.47;0.46;260.60;3.32;975;7;1301.00;49
2872;7;621450695;2872;198;3848;3894;7.50;0.46;260.60;3.32;976;7;1302.00;46
2876;7;621450711;2876;200;3852;3894;7.46;0.45;260.53;3.33;976;7;1303.00;42
2877;7;621450728;2877;199;3855;3895;7.49;0.45;260.54;3.33;978;7;1304.00;40
2880;7;621450740;2880;198;3860;3897;7.52;0.46;260.54;3.33;980;7;1305.00;37
2882;7;621450751;2882;196;3863;3897;7.54;0.46;260.54;3.34;981;7;1306.00;34
2882;7;621450762;2882;198;3866;3898;7.64;0.46;260.54;3.35;984;7;1307.00;32
2883;7;621450773;2883;194;3868;3898;7.66;0.47;260.50;3.35;985;7;1308.00;30
2884;7;621450784;2884;192;3871;3898;7.77;0.47;260.49;3.36;987;7;1309.00;27
2885;7;621450795;2885;193;3873;3898;7.83;0.48;260.41;3.36;988;7;1310.00;25
2887;7;621450806;2887;185;3879;3902;7.85;0.48;260.53;3.37;992;7;1311.00;23
2892;7;621450818;2892;189;3881;3902;7.82;0.48;260.45;3.37;989;7;1312.00;21
2895;7;621450829;2895;189;3881;3902;7.78;0.47;260.50;3.37;986;7;1313.00;21
2897;7;621450840;2897;195;3886;3905;7.79;0.47;260.48;3.40;989;7;1314.00;19
2897;7;621450852;2897;207;3888;3905;7.79;0.47;260.48;3.40;991;7;1315.00;17
2901;7;621450863;2901;211;3889;3905;7.80;0.47;260.63;3.41;988;7;1316.00;16
2905;7;621450874;2905;220;3894;3909;7.81;0.47;260.54;3.41;989;7;1317.00;15
2907;7;621450886;2907;219;3896;3910;7.90;0.48;260.78;3.41;989;7;1318.00;14
2910;7;621450897;2910;226;3897;3910;7.90;0.48;260.91;3.41;987;7;1319.00;13
2913;7;621450916;2913;230;3904;3915;7.87;0.48;261.05;3.43;991;7;1320.00;11
2918;7;621450928;2918;228;3904;3915;7.88;0.48;261.54;3.43;986;7;1321.00;11
2920;7;621450940;2920;232;3904;3915;7.88;0.48;261.61;3.43;984;7;1322.00;11
2921;7;621450951;2921;239;3906;3916;7.84;0.47;261.72;3.44;985;7;1323.00;10
2923;7;621450963;2923;242;3906;3916;7.78;0.47;261.85;3.44;983;7;1324.00;10
2925;7;621450974;2925;248;3913;3922;7.76;0.47;262.07;3.45;988;7;1325.00;9
2929;7;621450986;2929;253;3914;3922;7.66;0.46;262.16;3.45;985;7;1326.00;8
2931;7;621450997;2931;260;3914;3923;7.57;0.46;262.26;3.45;983;7;1327.00;9
2934;7;621451008;2934;267;3914;3923;7.56;0.46;262.38;3.45;980;7;1328.00;9
2935;7;621451020;2935;271;3916;3923;7.53;0.46;262.45;3.47;981;7;1329.00;7
2937;7;621451031;2937;274;3916;3923;7.47;0.45;262.55;3.47;979;7;1330.00;7
2938;7;621451042;2938;276;3919;3923;7.40;0.45;262.62;3.49;981;7;1331.00;4
2939;7;621451053;2939;281;3929;3935;7.44;0.45;262.58;3.49;990;7;1332.00;6
2940;7;621451065;2940;277;3929;3935;7.43;0.45;262.66;3.49;989;7;1333.00;6
2943;7;621451076;2943;277;3932;3935;7.42;0.45;262.67;3.49;989;7;1334.00;3
2943;7;621451092;2943;279;3932;3935;7.44;0.45;262.67;3.49;989;7;1335.00;3
2944;7;621451102;2944;279;3932;3935;7.40;0.45;262.63;3.49;988;7;1336.00;3
2946;7;621451113;2946;280;3935;3935;7.32;0.45;262.63;3.50;989;7;1337.00;0
2948;7;621451124;2948;288;3938;3939;7.31;0.45;262.74;3.49;990;7;1338.00;1
2950;7;621451135;2950;285;3938;3939;7.32;0.45;262.70;3.49;988;7;1339.00;1
2951;7;621451146;2951;287;3943;3943;7.33;0.45;262.74;3.49;992;7;1340.00;0
2954;7;621451162;2954;283;3944;3944;7.34;0.45;262.72;3.49;990;7;1341.00;0
2958;7;621451179;2958;279;3944;3944;7.32;0.45;262.78;3.49;986;7;1342.00;0
2961;7;621451190;2961;277;3944;3944;7.26;0.44;262.81;3.49;983;7;1343.00;0
2962;7;621451201;2962;279;3956;3957;7.31;0.45;262.88;3.48;994;7;1344.00;1
2967;7;621451213;2967;279;3956;3957;7.27;0.44;262.96;3.48;989;7;1345.00;1
2970;7;621451223;2970;284;3957;3957;7.22;0.44;262.97;3.48;987;7;1346.00;0
2972;7;621451234;2972;287;3958;3958;7.22;0.44;263.07;3.48;986;7;1347.00;0
2973;7;621451244;2973;287;3959;3959;7.23;0.44;263.14;3.48;986;7;1348.00;0
2975;7;621451255;2975;285;3959;3959;7.21;0.44;263.18;3.48;984;7;1349.00;0
2978;7;621451267;2978;288;3966;3968;7.21;0.44;263.42;3.47;988;7;1350.00;2
2982;7;621451278;2982;290;3966;3968;7.20;0.44;263.67;3.47;984;7;1351.00;2
2984;7;621451289;2984;295;3967;3968;7.18;0.44;263.76;3.47;983;7;1352.00;1
2989;7;621451299;2989;299;3967;3968;7.15;0.44;264.09;3.47;978;7;1353.00;1
2993;7;621451310;2993;298;3973;3974;7.12;0.43;264.01;3.47;980;7;1354.00;1
2997;7;621451321;2997;297;3974;3974;7.04;0.43;264.05;3.47;977;7;1355.00;0
3000;7;621451332;3000;302;3974;3974;6.95;0.43;264.03;3.47;974;7;1356.00;0
3003;7;621451343;3003;302;3974;3974;6.85;0.42;263.94;3.47;971;7;1357.00;0
3005;7;621451352;3005;304;3978;3978;6.70;0.41;264.00;3.47;973;7;1358.00;0
3008;7;621451362;3008;313;3979;3979;6.57;0.40;264.12;3.47;971;7;1359.00;0
3014;7;621451372;3014;307;3979;3979;6.50;0.40;264.09;3.47;965;7;1360.00;0
3017;7;621451382;3017;299;3980;3980;6.52;0.40;264.21;3.47;963;7;1361.00;0
3023;7;621451393;3023;293;3980;3980;6.55;0.40;264.41;3.47;957;7;1362.00;0
3027;7;621451403;3027;289;3980;3980;6.57;0.40;264.43;3.47;953;7;1363.00;0
3031;7;621451418;3031;285;3980;3980;6.61;0.40;264.54;3.47;949;7;1364.00;0
3036;7;621451436;3036;289;3980;3980;6.59;0.40;264.67;3.47;944;7;1365.00;0
3037;7;621451452;3037;285;3980;3980;6.64;0.41;264.72;3.47;943;7;1366.00;0
3041;7;621451471;3041;277;3980;3980;6.64;0.41;264.82;3.47;939;7;1367.00;0
3047;7;621451486;3047;277;4018;4050;6.79;0.42;264.94;3.43;971;7;1368.00;32
3047;7;621451511;3047;265;4022;4051;6.80;0.42;264.94;3.43;975;7;1369.00;29
3052;7;621451527;3052;268;4029;4051;6.87;0.42;264.98;3.43;977;7;1370.00;22
3056;7;621451541;3056;271;4031;4051;6.89;0.42;265.05;3.43;975;7;1371.00;20
3058;7;621451561;3058;274;4033;4051;6.88;0.42;265.09;3.43;975;7;1372.00;18
3063;7;621451573;3063;279;4035;4051;6.88;0.42;265.29;3.43;972;7;1373.00;16
3069;7;621451586;3069;287;4038;4051;6.91;0.42;265.28;3.43;969;7;1374.00;13
3071;7;621451598;3071;293;4040;4051;6.88;0.42;265.33;3.43;969;7;1375.00;11
3075;7;621451611;3075;296;4042;4052;6.81;0.42;265.39;3.43;967;7;1376.00;10
3076;7;621451622;3076;305;4043;4053;6.85;0.42;265.55;3.44;967;7;1377.00;10
3081;7;621451633;3081;311;4045;4053;6.77;0.41;265.71;3.44;964;7;1378.00;8
3088;7;621451646;3088;318;4050;4057;6.73;0.41;265.83;3.44;962;7;1379.00;7
3089;7;621451659;3089;324;4052;4057;6.73;0.41;265.84;3.44;963;7;1380.00;5
3093;7;621451671;3093;328;4052;4057;6.72;0.41;265.87;3.44;959;7;1381.00;5
3097;7;621451682;3097;331;4052;4057;6.72;0.41;266.10;3.44;955;7;1382.00;5
3102;7;621451694;3102;332;4059;4063;6.73;0.41;266.27;3.44;957;7;1383.00;4
3106;7;621451706;3106;338;4059;4063;6.67;0.41;266.30;3.44;953;7;1384.00;4
3112;7;621451724;3112;346;4059;4063;6.53;0.40;266.43;3.44;947;7;1385.00;4
3121;7;621451735;3121;351;4061;4066;6.40;0.39;266.49;3.44;940;7;1386.00;5
3122;7;621451747;3122;355;4062;4066;6.38;0.39;266.61;3.44;940;7;1387.00;4
3129;7;621451758;3129;361;4064;4066;6.31;0.39;267.04;3.45;935;7;1388.00;2
3132;7;621451770;3132;365;4067;4067;6.26;0.38;267.23;3.45;935;7;1389.00;0
3135;7;621451781;3135;370;4068;4068;6.18;0.38;267.51;3.45;933;7;1390.00;0
3140;7;621451792;3140;376;4068;4068;6.13;0.38;267.47;3.45;928;7;1391.00;0
3144;7;621451803;3144;373;4080;4081;6.15;0.38;267.81;3.44;936;7;1392.00;1
3148;7;621451815;3148;378;4081;4081;6.12;0.38;267.98;3.44;933;7;1393.00;0
3153;7;621451826;3153;382;4081;4081;6.06;0.37;268.00;3.44;928;7;1394.00;0
3154;7;621451837;3154;384;4083;4083;6.06;0.37;268.15;3.44;929;7;1395.00;0
3159;7;621451849;3159;394;4083;4083;5.99;0.37;268.46;3.44;924;7;1396.00;0
3162;7;621451860;3162;398;4087;4087;6.00;0.37;268.47;3.44;925;7;1397.00;0
3165;7;621451871;3165;402;4087;4087;5.95;0.37;268.59;3.44;922;7;1398.00;0
3170;7;621451881;3170;402;4091;4091;5.92;0.36;268.84;3.43;921;7;1399.00;0
3173;7;621451894;3173;406;4091;4091;5.83;0.36;268.81;3.43;918;7;1400.00;0
3176;7;621451908;3176;406;4091;4091;5.75;0.35;269.08;3.43;915;7;1401.00;0
3180;7;621451919;3180;418;4091;4091;5.67;0.35;269.12;3.43;911;7;1402.00;0
3185;7;621451930;3185;417;4091;4091;5.54;0.34;269.22;3.43;906;7;1403.00;0
3188;7;621451942;3188;427;4102;4103;5.61;0.34;269.28;3.42;914;7;1404.00;1
3191;7;621451954;3191;433;4102;4103;5.51;0.34;269.25;3.42;911;7;1405.00;1
3193;7;621451964;3193;432;4103;4103;5.47;0.34;269.21;3.42;910;7;1406.00;0
3194;7;621451976;3194;426;4103;4103;5.49;0.34;269.16;3.42;909;7;1407.00;0
3199;7;621451986;3199;423;4103;4103;5.52;0.34;269.24;3.42;904;7;1408.00;0
3201;7;621451997;3201;423;4103;4103;5.60;0.35;269.14;3.42;902;7;1409.00;0
3205;7;621452009;3205;422;4104;4104;5.65;0.35;268.98;3.42;899;7;1410.00;0
3205;7;621452020;3205;416;4104;4104;5.72;0.35;268.98;3.42;899;7;1411.00;0
3207;7;621452030;3207;420;4110;4110;5.82;0.36;268.92;3.42;903;7;1412.00;0
3210;7;621452041;3210;417;4111;4111;5.84;0.36;268.97;3.42;901;7;1413.00;0
3211;7;621452052;3211;417;4111;4111;5.92;0.36;268.98;3.42;900;7;1414.00;0
3217;7;621452063;3217;415;4111;4111;5.87;0.36;268.86;3.42;894;7;1415.00;0
3218;7;621452080;3218;403;4115;4115;5.96;0.36;268.79;3.42;897;7;1416.00;0
3220;7;621452091;3220;392;4115;4115;6.03;0.37;268.80;3.42;895;7;1417.00;0
3223;7;621452102;3223;389;4115;4115;6.10;0.37;268.64;3.42;892;7;1418.00;0
3224;7;621452113;3224;385;4116;4116;6.22;0.38;268.56;3.42;892;7;1419.00;0
3225;7;621452124;3225;384;4120;4120;6.30;0.38;268.67;3.41;895;7;1420.00;0
3227;7;621452140;3227;382;4120;4120;6.40;0.39;268.77;3.41;893;7;1421.00;0
3228;7;621452152;3228;377;4122;4123;6.53;0.40;268.70;3.41;894;7;1422.00;1
3229;7;621452169;3229;381;4122;4123;6.59;0.40;268.65;3.41;893;7;1423.00;1
3229;7;621452180;3229;382;4123;4123;6.63;0.40;268.65;3.41;894;7;1424.00;0
3233;7;621452191;3233;384;4123;4123;6.60;0.40;268.76;3.41;890;7;1425.00;0
3233;7;621452202;3233;381;4127;4127;6.63;0.40;268.76;3.41;894;7;1426.00;0
3236;7;621452220;3236;384;4127;4127;6.63;0.40;268.81;3.41;891;7;1427.00;0
3238;7;621452231;3238;383;4127;4127;6.59;0.40;268.84;3.41;889;7;1428.00;0
3238;7;621452242;3238;381;4127;4127;6.50;0.39;268.84;3.41;889;7;1429.00;0
3238;7;621452254;3238;386;4128;4128;6.45;0.39;268.84;3.41;890;7;1430.00;0
3238;7;621452265;3238;381;4129;4129;6.39;0.39;268.84;3.41;891;7;1431.00;0
3240;7;621452275;3240;389;4129;4129;6.32;0.38;268.98;3.41;889;7;1432.00;0
3244;7;621452287;3244;385;4130;4130;6.26;0.38;269.02;3.41;886;7;1433.00;0
3244;7;621452298;3244;383;4130;4130;6.32;0.38;269.02;3.41;886;7;1434.00;0
3245;7;621452308;3245;372;4130;4130;6.39;0.39;269.00;3.41;885;7;1435.00;0
3245;7;621452318;3245;359;4130;4130;6.48;0.39;269.00;3.41;885;7;1436.00;0
3246;7;621452329;3246;351;4130;4130;6.56;0.40;269.02;3.41;884;7;1437.00;0
3248;7;621452339;3248;351;4130;4130;6.67;0.40;268.98;3.41;882;7;1438.00;0
3250;7;621452350;3250;343;4130;4130;6.72;0.41;269.03;3.41;880;7;1439.00;0
3252;8;621452363;3252;390;4252;4360;6.91;0.43;269.02;3.31;1000;8;1440.00;108
3252;8;621452405;3252;372;4256;4361;7.00;0.44;269.02;3.31;1004;8;1441.00;105
3254;8;621452419;3254;355;4266;4361;7.13;0.45;269.02;3.30;1012;8;1442.00;95
3255;8;621452431;3255;351;4272;4361;7.19;0.45;269.08;3.30;1017;8;1443.00;89
3257;8;621452443;3257;349;4279;4361;7.25;0.45;269.02;3.31;1022;8;1444.00;82
3258;8;621452464;3258;349;4283;4361;7.29;0.45;269.05;3.31;1025;8;1445.00;78
3262;8;621452476;3262;348;4290;4361;7.30;0.45;269.12;3.31;1028;8;1446.00;71
3264;8;621452488;3264;350;4295;4361;7.23;0.45;269.16;3.32;1031;8;1447.00;66
3264;8;621452506;3264;358;4300;4362;7.23;0.45;269.16;3.32;1036;8;1448.00;62
3265;8;621452518;3265;367;4302;4363;7.24;0.45;269.16;3.32;1037;8;1449.00;61
3266;8;621452529;3266;355;4307;4363;7.20;0.44;269.21;3.33;1041;8;1450.00;56
3269;8;621452541;3269;352;4310;4364;7.18;0.44;269.31;3.34;1041;8;1451.00;54
3270;8;621452553;3270;346;4314;4364;7.15;0.44;269.30;3.34;1044;8;1452.00;50
3272;8;621452564;3272;343;4316;4364;7.13;0.44;269.33;3.35;1044;8;1453.00;48
3274;8;621452575;3274;343;4318;4364;7.15;0.44;269.31;3.35;1044;8;1454.00;46
3277;8;621452587;3277;342;4320;4368;7.10;0.43;269.43;3.36;1043;8;1455.00;48
3279;8;621452600;3279;340;4322;4368;7.14;0.44;269.54;3.36;1043;8;1456.00;46
3280;8;621452611;3280;333;4323;4368;7.18;0.44;269.62;3.37;1043;8;1457.00;45
3284;8;621452623;3284;330;4325;4371;7.20;0.44;269.94;3.37;1041;8;1458.00;46
3289;8;621452635;3289;324;4326;4371;7.22;0.44;269.88;3.37;1037;8;1459.00;45
3290;8;621452647;3290;318;4329;4371;7.21;0.44;269.85;3.38;1039;8;1460.00;42
3294;8;621452658;3294;317;4333;4375;7.18;0.44;269.85;3.38;1039;8;1461.00;42
3297;8;621452671;3297;305;4334;4376;7.17;0.44;269.95;3.38;1037;8;1462.00;42
3303;8;621452684;3303;306;4338;4376;7.08;0.43;269.92;3.40;1035;8;1463.00;38
3304;8;621452696;3304;298;4340;4380;7.10;0.43;269.97;3.40;1036;8;1464.00;40
3306;8;621452708;3306;297;4344;4380;7.05;0.43;270.12;3.41;1038;8;1465.00;36
3310;8;621452720;3310;293;4344;4380;7.08;0.43;270.35;3.41;1034;8;1466.00;36
3311;8;621452732;3311;284;4345;4381;7.11;0.43;270.41;3.42;1034;8;1467.00;36
3316;8;621452750;3316;284;4347;4381;7.12;0.43;270.47;3.43;1031;8;1468.00;34
3317;8;621452773;3317;279;4351;4387;7.20;0.44;270.44;3.43;1034;8;1469.00;36
3317;8;621452787;3317;267;4351;4387;7.30;0.44;270.44;3.43;1034;8;1470.00;36
3319;8;621452799;3319;266;4352;4388;7.36;0.45;270.38;3.43;1033;8;1471.00;36
3321;8;621452811;3321;267;4353;4388;7.44;0.45;270.44;3.44;1032;8;1472.00;35
3323;8;621452822;3323;264;4353;4388;7.54;0.46;270.44;3.44;1030;8;1473.00;35
3330;8;621452834;3330;262;4354;4388;7.63;0.46;270.51;3.44;1024;8;1474.00;34
3332;8;621452846;3332;257;4355;4388;7.68;0.47;270.48;3.45;1023;8;1475.00;33
3334;8;621452858;3334;258;4363;4400;7.75;0.47;270.44;3.44;1029;8;1476.00;37
3336;8;621452871;3336;260;4366;4400;7.76;0.47;270.53;3.46;1030;8;1477.00;34
3338;8;621452882;3338;252;4368;4400;7.76;0.47;270.67;3.46;1030;8;1478.00;32
3341;8;621452894;3341;252;4370;4400;7.77;0.47;270.71;3.48;1029;8;1479.00;30
3344;8;621452906;3344;251;4370;4400;7.77;0.47;270.82;3.48;1026;8;1480.00;30
3347;8;621452918;3347;259;4374;4400;7.77;0.47;270.99;3.51;1027;8;1481.00;26
3349;8;621452930;3349;261;4378;4404;7.75;0.47;270.99;3.50;1029;8;1482.00;26
3352;8;621452943;3352;257;4378;4404;7.66;0.47;271.05;3.50;1026;8;1483.00;26
3354;8;621452954;3354;252;4384;4408;7.63;0.46;271.19;3.52;1030;8;1484.00;24
3355;8;621452967;3355;248;4386;4410;7.62;0.46;271.24;3.52;1031;8;1485.00;24
3358;8;621452979;3358;255;4387;4410;7.57;0.46;271.14;3.52;1029;8;1486.00;23
3359;8;621452992;3359;248;4388;4410;7.59;0.46;271.28;3.53;1029;8;1487.00;22
3360;8;621453006;3360;259;4397;4423;7.65;0.47;271.21;3.52;1037;8;1488.00;26
3362;8;621453019;3362;265;4398;4423;7.68;0.47;271.33;3.53;1036;8;1489.00;25
3365;8;621453032;3365;263;4399;4423;7.67;0.47;271.45;3.54;1034;8;1490.00;24
3368;8;621453044;3368;270;4402;4424;7.69;0.47;271.55;3.56;1034;8;1491.00;22
3370;8;621453055;3370;266;4403;4425;7.63;0.47;271.64;3.57;1033;8;1492.00;22
3374;8;621453070;3374;271;4404;4425;7.60;0.46;271.74;3.59;1030;8;1493.00;21
3376;8;621453082;3376;275;4407;4428;7.56;0.46;271.84;3.60;1031;8;1494.00;21
3379;8;621453094;3379;271;4409;4428;7.49;0.46;271.87;3.62;1030;8;1495.00;19
3381;8;621453106;3381;279;4411;4428;7.48;0.46;271.99;3.63;1030;8;1496.00;17
3385;8;621453118;3385;282;4413;4428;7.45;0.45;271.99;3.65;1028;8;1497.00;15
3388;8;621453129;3388;285;4418;4434;7.49;0.46;271.93;3.64;1030;8;1498.00;16
3390;8;621453142;3390;282;4420;4434;7.53;0.46;271.96;3.66;1030;8;1499.00;14
3392;8;621453156;3392;292;4425;4453;7.52;0.46;272.13;3.67;1033;8;1500.00;28
3395;8;621453176;3395;285;4427;4453;7.50;0.46;272.13;3.69;1032;8;1501.00;26
3397;8;621453189;3397;288;4432;4457;7.47;0.46;272.26;3.71;1035;8;1502.00;25
3399;8;621453201;3399;288;4435;4458;7.48;0.46;272.27;3.72;1036;8;1503.00;23
3402;8;621453213;3402;289;4438;4458;7.48;0.46;272.28;3.73;1036;8;1504.00;20
3403;8;621453225;3403;294;4442;4459;7.43;0.45;272.44;3.74;1039;8;1505.00;17
3405;8;621453236;3405;299;4443;4459;7.39;0.45;272.36;3.74;1038;8;1506.00;16
3407;8;621453247;3407;301;4443;4459;7.35;0.45;272.47;3.74;1036;8;1507.00;16
3411;8;621453259;3411;302;4444;4459;7.32;0.45;272.54;3.74;1033;8;1508.00;15
3413;8;621453270;3413;305;4445;4459;7.25;0.44;272.62;3.74;1032;8;1509.00;14
3416;8;621453282;3416;306;4447;4459;7.17;0.44;272.71;3.75;1031;8;1510.00;12
3420;8;621453293;3420;300;4449;4459;7.17;0.44;272.94;3.75;1029;8;1511.00;10
3421;8;621453305;3421;303;4484;4529;7.16;0.44;272.88;3.72;1063;8;1512.00;45
3426;8;621453322;3426;300;4488;4530;7.10;0.44;272.99;3.72;1062;8;1513.00;42
3431;9;621453334;3431;298;4494;4530;7.07;0.43;272.85;3.72;1063;9;1514.00;36
3434;9;621453363;3434;297;4497;4530;7.08;0.43;272.83;3.72;1063;9;1515.00;33
3437;9;621453375;3437;303;4503;4530;7.17;0.44;272.97;3.72;1066;9;1516.00;27
3439;9;621453387;3439;304;4507;4530;7.26;0.44;273.06;3.73;1068;9;1517.00;23
3442;9;621453399;3442;303;4511;4530;7.22;0.44;273.23;3.73;1069;9;1518.00;19
3446;9;621453416;3446;300;4512;4530;7.24;0.44;273.18;3.73;1066;9;1519.00;18
3450;9;621453444;3450;304;4516;4531;7.24;0.44;273.14;3.73;1066;9;1520.00;15
3452;9;621453464;3452;302;4518;4532;7.23;0.44;273.31;3.74;1066;9;1521.00;14
3454;9;621453483;3454;305;4519;4532;7.26;0.44;273.34;3.74;1065;9;1522.00;13
3457;9;621453500;3457;306;4523;4536;7.22;0.44;273.56;3.74;1066;9;1523.00;13
3462;9;621453520;3462;304;4523;4536;7.12;0.44;273.86;3.74;1061;9;1524.00;13
3465;9;621453535;3465;302;4523;4536;7.09;0.43;273.94;3.74;1058;9;1525.00;13
3470;9;621453547;3470;308;4523;4536;7.01;0.43;274.30;3.74;1053;9;1526.00;13
3476;9;621453559;3476;309;4528;4542;6.88;0.42;274.29;3.74;1052;9;1527.00;14
3481;9;621453573;3481;324;4528;4542;6.71;0.41;274.26;3.74;1047;9;1528.00;14
3482;9;621453589;3482;325;4529;4542;6.58;0.40;274.28;3.75;1047;9;1529.00;13
3487;9;621453602;3487;318;4533;4548;6.46;0.39;274.26;3.75;1046;9;1530.00;15
3489;9;621453615;3489;314;4533;4548;6.41;0.39;274.25;3.75;1044;9;1531.00;15
3491;9;621453627;3491;311;4535;4548;6.40;0.39;274.27;3.76;1044;9;1532.00;13
3498;9;621453638;3498;307;4536;4549;6.40;0.39;274.27;3.76;1038;9;1533.00;13
3499;9;621453651;3499;303;4538;4550;6.52;0.40;274.28;3.76;1039;9;1534.00;12
3503;9;621453662;3503;310;4542;4550;6.53;0.40;274.34;3.78;1039;9;1535.00;8
3506;9;621453679;3506;308;4554;4563;6.59;0.40;274.31;3.77;1048;9;1536.00;9
3510;9;621453693;3510;304;4555;4563;6.61;0.40;274.48;3.77;1045;9;1537.00;8
3516;9;621453705;3516;313;4556;4563;6.62;0.40;274.68;3.77;1040;9;1538.00;7
3518;9;621453717;3518;312;4558;4564;6.61;0.40;274.68;3.78;1040;9;1539.00;6
3522;9;621453729;3522;313;4558;4564;6.57;0.40;274.75;3.78;1036;9;1540.00;6
3525;9;621453742;3525;318;4565;4568;6.49;0.40;274.83;3.79;1040;9;1541.00;3
3526;9;621453754;3526;320;4565;4568;6.40;0.39;274.77;3.79;1039;9;1542.00;3
3532;9;621453766;3532;326;4570;4572;6.30;0.38;274.88;3.79;1038;9;1543.00;2
3538;9;621453779;3538;331;4570;4572;6.22;0.38;274.97;3.79;1032;9;1544.00;2
3539;9;621453791;3539;327;4571;4572;6.23;0.38;274.94;3.79;1032;9;1545.00;1
3542;9;621453804;3542;332;4571;4572;6.19;0.38;275.07;3.79;1029;9;1546.00;1
3551;9;621453815;3551;338;4572;4572;6.05;0.37;275.18;3.79;1021;9;1547.00;0
3554;9;621453828;3554;336;4584;4584;6.04;0.37;275.42;3.78;1030;9;1548.00;0
3555;9;621453842;3555;336;4584;4584;5.94;0.36;275.41;3.78;1029;9;1549.00;0
3560;9;621453853;3560;343;4584;4584;5.84;0.36;275.48;3.78;1024;9;1550.00;0
3563;9;621453865;3563;346;4584;4584;5.76;0.35;275.65;3.78;1021;9;1551.00;0
3568;9;621453878;3568;359;4584;4584;5.71;0.35;275.71;3.78;1016;9;1552.00;0
3572;9;621453889;3572;359;4584;4584;5.60;0.34;275.73;3.78;1012;9;1553.00;0
3575;9;621453901;3575;364;4585;4585;5.61;0.34;275.77;3.78;1010;9;1554.00;0
3577;9;621453913;3577;372;4587;4587;5.58;0.34;275.77;3.78;1010;9;1555.00;0
3581;9;621453924;3581;378;4593;4593;5.54;0.34;275.86;3.77;1012;9;1556.00;0
3585;9;621453937;3585;380;4594;4594;5.51;0.34;276.02;3.77;1009;9;1557.00;0
3588;9;621453949;3588;389;4594;4594;5.52;0.34;276.05;3.77;1006;9;1558.00;0
3593;9;621453961;3593;393;4594;4594;5.43;0.33;276.07;3.77;1001;9;1559.00;0
3598;9;621453975;3598;405;4599;4599;5.41;0.33;276.11;3.77;1001;9;1560.00;0
3602;9;621453986;3602;406;4599;4599;5.38;0.33;276.14;3.77;997;9;1561.00;0
3605;9;621453998;3605;412;4599;4599;5.36;0.33;276.22;3.77;994;9;1562.00;0
3610;9;621454011;3610;416;4600;4600;5.35;0.33;276.26;3.77;990;9;1563.00;0
3616;9;621454023;3616;419;4604;4604;5.31;0.32;276.06;3.77;988;9;1564.00;0
3619;9;621454040;3619;424;4604;4604;5.27;0.32;275.99;3.77;985;9;1565.00;0
3623;9;621454052;3623;431;4606;4607;5.25;0.32;276.05;3.77;983;9;1566.00;1
3626;9;621454062;3626;431;4606;4607;5.19;0.32;275.95;3.77;980;9;1567.00;1
3627;9;621454073;3627;430;4607;4607;5.14;0.31;275.88;3.76;980;9;1568.00;0
3629;9;621454083;3629;440;4607;4607;5.08;0.31;275.85;3.76;978;9;1569.00;0
3631;9;621454094;3631;436;4611;4611;5.04;0.31;275.83;3.76;980;9;1570.00;0
3634;9;621454105;3634;445;4611;4611;4.95;0.30;275.67;3.76;977;9;1571.00;0
3636;9;621454115;3636;443;4611;4611;4.88;0.30;275.63;3.76;975;9;1572.00;0
3639;9;621454125;3639;455;4611;4611;4.82;0.29;275.45;3.76;972;9;1573.00;0
3643;9;621454135;3643;460;4612;4612;4.72;0.29;275.48;3.76;969;9;1574.00;0
3646;9;621454145;3646;463;4614;4614;4.68;0.28;275.34;3.76;968;9;1575.00;0
3646;9;621454155;3646;467;4614;4614;4.66;0.28;275.34;3.76;968;9;1576.00;0
3646;9;621454165;3646;462;4615;4615;4.68;0.29;275.34;3.76;969;9;1577.00;0
3647;9;621454176;3647;456;4615;4615;4.64;0.28;275.30;3.76;968;9;1578.00;0
3648;9;621454186;3648;450;4615;4615;4.66;0.29;275.33;3.76;967;9;1579.00;0
3648;9;621454196;3648;447;4615;4615;4.71;0.29;275.33;3.76;967;9;1580.00;0
3649;9;621454207;3649;456;4615;4615;4.84;0.30;275.30;3.76;966;9;1581.00;0
3649;9;621454218;3649;451;4615;4615;4.92;0.30;275.30;3.76;966;9;1582.00;0
3649;9;621454229;3649;451;4615;4615;5.04;0.31;275.30;3.76;966;9;1583.00;0
3652;9;621454239;3652;469;4687;4742;5.53;0.35;275.25;3.70;1035;9;1584.00;55
3652;9;621454260;3652;463;4690;4743;5.63;0.35;275.25;3.70;1038;9;1585.00;53
3655;9;621454278;3655;450;4699;4743;5.77;0.36;275.24;3.70;1044;9;1586.00;44
3656;9;621454290;3656;419;4701;4743;5.84;0.36;275.24;3.70;1045;9;1587.00;42
3658;9;621454308;3658;399;4707;4743;5.93;0.37;275.20;3.70;1049;9;1588.00;36
3658;9;621454320;3658;382;4710;4743;6.04;0.38;275.20;3.70;1052;9;1589.00;33
3659;9;621454333;3659;368;4713;4743;6.11;0.38;275.21;3.70;1054;9;1590.00;30
3660;9;621454345;3660;366;4716;4743;6.26;0.39;275.24;3.70;1056;9;1591.00;27
3661;9;621454358;3661;356;4719;4744;6.35;0.39;275.28;3.70;1058;9;1592.00;25
3663;9;621454370;3663;348;4723;4745;6.44;0.40;275.29;3.71;1060;9;1593.00;22
3666;9;621454393;3666;341;4725;4745;6.52;0.40;275.24;3.71;1059;9;1594.00;20
3666;9;621454409;3666;345;4729;4746;6.63;0.41;275.24;3.72;1063;10;1595.00;17
3669;9;621454434;3669;349;4730;4746;6.76;0.42;275.29;3.72;1061;10;1596.00;16
3669;9;621454448;3669;354;4733;4746;6.93;0.43;275.29;3.73;1064;10;1597.00;13
3672;9;621454462;3672;352;4735;4746;6.99;0.43;275.27;3.73;1063;10;1598.00;11
3676;9;621454476;3676;352;4739;4750;7.08;0.43;275.24;3.73;1063;10;1599.00;11
3678;9;621454491;3678;356;4741;4750;7.08;0.43;275.31;3.73;1063;10;1600.00;9
3680;9;621454508;3680;353;4742;4750;7.10;0.43;275.30;3.74;1062;10;1601.00;8
3681;9;621454522;3681;344;4743;4753;7.16;0.44;275.32;3.74;1062;10;1602.00;10
3682;9;621454535;3682;343;4745;4753;7.16;0.44;275.30;3.74;1063;10;1603.00;8
3685;9;621454548;3685;339;4746;4753;7.20;0.44;275.34;3.74;1061;10;1604.00;7
3685;9;621454560;3685;341;4750;4757;7.24;0.44;275.34;3.74;1065;10;1605.00;7
3688;9;621454573;3688;336;4752;4758;7.26;0.44;275.30;3.74;1064;10;1606.00;6
3691;9;621454586;3691;339;4752;4758;7.28;0.44;275.21;3.74;1061;10;1607.00;6
3693;9;621454600;3693;342;4755;4762;7.32;0.45;275.22;3.74;1062;10;1608.00;7
3695;9;621454612;3695;343;4755;4762;7.36;0.45;275.17;3.74;1060;10;1609.00;7
3700;9;621454625;3700;342;4755;4762;7.41;0.45;275.55;3.74;1055;10;1610.00;7
3703;9;621454638;3703;343;4756;4763;7.46;0.45;275.60;3.74;1053;10;1611.00;7
3705;9;621454656;3705;343;4756;4763;7.50;0.46;275.61;3.74;1051;10;1612.00;7
3710;9;621454670;3710;343;4761;4769;7.48;0.45;275.70;3.73;1051;10;1613.00;8
3712;9;621454684;3712;341;4761;4769;7.48;0.45;275.76;3.73;1049;10;1614.00;8
3716;9;621454696;3716;341;4761;4770;7.51;0.46;275.80;3.73;1045;10;1615.00;9
3719;9;621454709;3719;345;4761;4770;7.47;0.45;276.07;3.73;1042;10;1616.00;9
3723;9;621454722;3723;352;4761;4770;7.44;0.45;276.13;3.73;1038;10;1617.00;9
3724;9;621454734;3724;342;4761;4770;7.45;0.45;276.21;3.73;1037;10;1618.00;9
3729;9;621454747;3729;346;4761;4770;7.38;0.45;276.43;3.73;1032;10;1619.00;9
3731;9;621454761;3731;341;4789;4806;7.34;0.45;276.53;3.71;1058;10;1620.00;17
3732;9;621454776;3732;333;4790;4806;7.33;0.45;276.53;3.71;1058;10;1621.00;16
3735;9;621454789;3735;328;4792;4806;7.30;0.44;276.49;3.71;1057;10;1622.00;14
3736;9;621454802;3736;325;4793;4806;7.32;0.45;276.63;3.71;1057;10;1623.00;13
3740;9;621454822;3740;322;4793;4806;7.25;0.44;276.82;3.71;1053;10;1624.00;13
3741;9;621454834;3741;322;4794;4806;7.27;0.44;276.84;3.71;1053;10;1625.00;12
3744;10;621454847;3744;320;4797;4810;7.29;0.44;276.93;3.71;1053;11;1626.00;13
3745;10;621454871;3745;329;4797;4810;7.31;0.44;277.06;3.71;1052;11;1627.00;13
3747;10;621454883;3747;327;4801;4814;7.34;0.45;277.26;3.71;1054;11;1628.00;13
3749;10;621454896;3749;320;4802;4815;7.30;0.44;277.47;3.71;1053;11;1629.00;13
3751;10;621454913;3751;312;4802;4815;7.27;0.44;277.65;3.71;1051;11;1630.00;13
3752;10;621454926;3752;314;4802;4815;7.25;0.44;277.66;3.71;1050;11;1631.00;13
3754;10;621454937;3754;309;4813;4828;7.19;0.44;277.64;3.70;1059;11;1632.00;15
3756;10;621454950;3756;306;4813;4828;7.10;0.43;277.77;3.70;1057;11;1633.00;15
3757;10;621454962;3757;310;4813;4828;7.03;0.43;277.87;3.70;1056;11;1634.00;15
3760;10;621454975;3760;300;4815;4829;6.99;0.43;278.01;3.71;1055;11;1635.00;14
3765;10;621454987;3765;303;4815;4830;6.96;0.42;278.10;3.71;1050;11;1636.00;15
3767;10;621454999;3767;298;4815;4830;6.98;0.43;278.21;3.71;1048;11;1637.00;15
3772;10;621455010;3772;294;4817;4833;7.00;0.43;278.38;3.70;1045;11;1638.00;16
3777;10;621455023;3777;287;4818;4833;7.09;0.43;278.40;3.70;1041;11;1639.00;15
3778;10;621455035;3778;288;4818;4833;7.17;0.44;278.41;3.70;1040;11;1640.00;15
3781;10;621455046;3781;290;4818;4833;7.24;0.44;278.41;3.70;1037;11;1641.00;15
3786;10;621455062;3786;285;4823;4839;7.26;0.44;278.43;3.70;1037;11;1642.00;16
3788;10;621455075;3788;287;4824;4839;7.28;0.44;278.55;3.71;1036;11;1643.00;15
3790;10;621455087;3790;282;4824;4839;7.30;0.44;278.61;3.71;1034;11;1644.00;15
3791;10;621455099;3791;281;4824;4839;7.26;0.44;278.62;3.71;1033;11;1645.00;15
3793;10;621455111;3793;284;4827;4843;7.25;0.44;278.50;3.71;1034;11;1646.00;16
3796;10;621455123;3796;284;4828;4844;7.25;0.44;278.66;3.71;1032;11;1647.00;16
3799;10;621455136;3799;285;4829;4844;7.22;0.44;278.81;3.72;1030;11;1648.00;15
3801;10;621455147;3801;281;4830;4845;7.25;0.44;278.96;3.72;1029;11;1649.00;15
3803;10;621455161;3803;286;4830;4845;7.29;0.44;279.00;3.72;1027;11;1650.00;15
3804;10;621455172;3804;279;4830;4845;7.31;0.44;279.00;3.72;1026;11;1651.00;15
3804;10;621455184;3804;278;4830;4845;7.31;0.44;279.00;3.72;1026;11;1652.00;15
3807;10;621455195;3807;280;4830;4845;7.33;0.44;279.01;3.72;1023;11;1653.00;15
3808;10;621455207;3808;278;4830;4845;7.41;0.45;279.13;3.72;1022;11;1654.00;15
3812;10;621455219;3812;273;4830;4845;7.42;0.45;279.17;3.72;1018;11;1655.00;15
3815;10;621455230;3815;286;4870;4915;7.51;0.46;279.32;3.69;1055;11;1656.00;45
3818;10;621455248;3818;281;4873;4916;7.54;0.46;279.54;3.70;1055;11;1657.00;43
3821;10;621455260;3821;273;4878;4916;7.59;0.46;279.71;3.70;1057;11;1658.00;38
3824;10;621455272;3824;275;4880;4916;7.55;0.46;279.78;3.70;1056;11;1659.00;36
3827;10;621455285;3827;274;4885;4916;7.57;0.46;279.82;3.72;1058;11;1660.00;31
3832;10;621455298;3832;276;4889;4916;7.56;0.46;280.01;3.72;1057;11;1661.00;27
3832;10;621455309;3832;273;4893;4916;7.50;0.46;280.01;3.73;1061;11;1662.00;23
3834;10;621455321;3834;277;4897;4916;7.54;0.46;280.05;3.74;1063;11;1663.00;19
3838;10;621455333;3838;278;4901;4917;7.54;0.46;280.08;3.76;1063;11;1664.00;16
3841;10;621455351;3841;276;4902;4919;7.53;0.46;280.13;3.76;1061;11;1665.00;17
3845;10;621455364;3845;273;4904;4919;7.56;0.46;280.20;3.76;1059;11;1666.00;15
3848;10;621455376;3848;275;4908;4923;7.51;0.46;280.23;3.77;1060;11;1667.00;15
3851;10;621455389;3851;278;4909;4923;7.52;0.46;280.22;3.77;1058;11;1668.00;14
3854;10;621455401;3854;281;4910;4923;7.48;0.46;280.25;3.78;1056;11;1669.00;13
3857;10;621455416;3857;285;4911;4923;7.49;0.46;280.36;3.79;1054;11;1670.00;12
3859;10;621455435;3859;283;4917;4929;7.55;0.46;280.31;3.78;1058;11;1671.00;12
3862;10;621455457;3862;284;4917;4929;7.49;0.46;280.33;3.78;1055;11;1672.00;12
3865;10;621455480;3865;287;4918;4929;7.40;0.45;280.41;3.79;1053;11;1673.00;11
3866;10;621455498;3866;294;4921;4932;7.42;0.45;280.37;3.80;1055;11;1674.00;11
3869;10;621455517;3869;297;4921;4932;7.37;0.45;280.59;3.80;1052;11;1675.00;11
3872;10;621455540;3872;302;4923;4932;7.29;0.45;280.69;3.81;1051;11;1676.00;9
3875;10;621455552;3875;309;4923;4933;7.20;0.44;280.72;3.81;1048;11;1677.00;10
3879;10;621455565;3879;313;4927;4934;7.13;0.44;280.73;3.83;1048;11;1678.00;7
3882;10;621455579;3882;317;4927;4934;7.03;0.43;280.77;3.83;1045;11;1679.00;7
3888;10;621455594;3888;316;4945;4960;6.97;0.43;280.82;3.82;1057;11;1680.00;15
3890;10;621455609;3890;312;4948;4960;6.94;0.42;280.96;3.82;1058;11;1681.00;12
3891;10;621455621;3891;309;4954;4960;6.93;0.42;280.91;3.83;1063;11;1682.00;6
3896;10;621455632;3896;310;4955;4961;6.88;0.42;280.90;3.83;1059;11;1683.00;6
3900;10;621455645;3900;316;4956;4961;6.84;0.42;280.93;3.83;1056;11;1684.00;5
3901;10;621455657;3901;314;4961;4965;6.86;0.42;280.95;3.84;1060;11;1685.00;4
3905;10;621455670;3905;321;4962;4965;6.78;0.41;280.94;3.84;1057;11;1686.00;3
3906;10;621455682;3906;324;4966;4969;6.73;0.41;280.98;3.83;1060;11;1687.00;3
3908;10;621455694;3908;327;4967;4969;6.68;0.41;281.00;3.84;1059;11;1688.00;2
3910;10;621455706;3910;324;4968;4969;6.60;0.40;281.00;3.84;1058;11;1689.00;1
3911;10;621455718;3911;330;4969;4969;6.55;0.40;281.02;3.84;1058;11;1690.00;0
3915;10;621455729;3915;332;4969;4969;6.46;0.39;281.16;3.84;1054;11;1691.00;0
3919;10;621455740;3919;343;4979;4981;6.43;0.39;281.10;3.83;1060;11;1692.00;2
3925;10;621455752;3925;339;4979;4981;6.32;0.39;281.22;3.83;1054;11;1693.00;2
3929;10;621455764;3929;344;4981;4981;6.30;0.38;281.46;3.83;1052;11;1694.00;0
3931;10;621455775;3931;353;4981;4981;6.24;0.38;281.52;3.83;1050;11;1695.00;0
3938;10;621455785;3938;360;4981;4981;6.13;0.37;281.67;3.83;1043;11;1696.00;0
3941;10;621455797;3941;368;4981;4981;6.01;0.37;281.68;3.83;1040;11;1697.00;0
3946;10;621455808;3946;376;4982;4982;5.88;0.36;281.71;3.83;1036;11;1698.00;0
3948;10;621455818;3948;386;4982;4982;5.75;0.35;281.89;3.83;1034;11;1699.00;0
3951;10;621455829;3951;380;4988;4988;5.74;0.35;281.96;3.82;1037;11;1700.00;0
3956;10;621455846;3956;375;4989;4989;5.67;0.35;282.20;3.82;1033;11;1701.00;0
3961;10;621455858;3961;380;4989;4989;5.60;0.34;282.15;3.82;1028;11;1702.00;0
3962;10;621455868;3962;376;4989;4989;5.56;0.34;282.11;3.82;1027;11;1703.00;0
3966;10;621455878;3966;374;4993;4993;5.52;0.34;282.12;3.82;1027;11;1704.00;0
3969;10;621455889;3969;372;4993;4993;5.51;0.34;282.16;3.82;1024;11;1705.00;0
3971;10;621455899;3971;376;4993;4993;5.51;0.34;282.16;3.82;1022;11;1706.00;0
3973;10;621455911;3973;378;4994;4994;5.56;0.34;282.26;3.82;1021;11;1707.00;0
3975;10;621455922;3975;375;4998;4998;5.62;0.34;282.26;3.82;1023;11;1708.00;0
3979;10;621455934;3979;373;4998;4998;5.58;0.34;282.40;3.82;1019;11;1709.00;0
3982;10;621455949;3982;372;5002;5004;5.61;0.34;282.35;3.81;1020;11;1710.00;2
3985;10;621455961;3985;376;5003;5004;5.60;0.34;282.30;3.81;1018;11;1711.00;1
3987;10;621455972;3987;374;5004;5004;5.57;0.34;282.30;3.81;1017;11;1712.00;0
3990;10;621455984;3990;382;5004;5004;5.55;0.34;282.29;3.81;1014;11;1713.00;0
3993;10;621455994;3993;385;5008;5008;5.53;0.34;282.16;3.81;1015;11;1714.00;0
3998;10;621456005;3998;385;5008;5008;5.49;0.34;282.10;3.81;1010;11;1715.00;0
4004;10;621456016;4004;388;5008;5008;5.44;0.33;282.05;3.81;1004;11;1716.00;0
4007;10;621456027;4007;388;5008;5008;5.42;0.33;281.91;3.81;1001;11;1717.00;0
4011;10;621456038;4011;395;5009;5009;5.35;0.33;281.89;3.81;998;11;1718.00;0
4013;10;621456049;4013;398;5010;5010;5.35;0.33;281.92;3.81;997;11;1719.00;0
4015;10;621456059;4015;404;5010;5010;5.32;0.33;281.92;3.81;995;11;1720.00;0
4022;10;621456069;4022;416;5011;5011;5.23;0.32;281.75;3.81;989;11;1721.00;0
4026;10;621456081;4026;416;5011;5011;5.17;0.32;281.82;3.81;985;11;1722.00;0
4030;10;621456093;4030;422;5011;5011;5.11;0.31;281.78;3.81;981;11;1723.00;0
4032;10;621456103;4032;425;5011;5011;5.07;0.31;281.77;3.81;979;11;1724.00;0
4040;10;621456113;4040;427;5011;5011;4.94;0.30;281.57;3.81;971;11;1725.00;0
4041;10;621456124;4041;429;5011;5011;4.93;0.30;281.53;3.81;970;11;1726.00;0
4045;10;621456134;4045;436;5011;5011;4.86;0.30;281.49;3.81;966;11;1727.00;0
4051;10;621456151;4051;457;5090;5138;5.14;0.32;281.38;3.75;1039;11;1728.00;48
4055;10;621456174;4055;453;5094;5139;5.12;0.32;281.31;3.75;1039;11;1729.00;45
4057;10;621456186;4057;451;5099;5139;5.15;0.32;281.37;3.75;1042;11;1730.00;40
4058;10;621456197;4058;453;5099;5139;5.16;0.32;281.41;3.75;1041;11;1731.00;40
4063;10;621456209;4063;458;5105;5139;5.17;0.32;281.40;3.75;1042;11;1732.00;34
4064;10;621456220;4064;459;5106;5139;5.22;0.32;281.45;3.75;1042;11;1733.00;33
4067;10;621456231;4067;463;5111;5139;5.27;0.33;281.52;3.75;1044;11;1734.00;28
4069;10;621456243;4069;466;5112;5139;5.28;0.33;281.50;3.75;1043;11;1735.00;27
4073;10;621456254;4073;463;5115;5140;5.26;0.32;281.59;3.75;1042;11;1736.00;25
4076;10;621456266;4076;476;5120;5141;5.21;0.32;281.65;3.76;1044;11;1737.00;21
4077;10;621456277;4077;480;5123;5141;5.20;0.32;281.70;3.76;1046;11;1738.00;18
4079;10;621456288;4079;476;5126;5142;5.16;0.32;281.74;3.76;1047;11;1739.00;16
4085;10;621456302;4085;470;5128;5142;5.17;0.32;281.81;3.77;1043;11;1740.00;14
4088;10;621456313;4088;468;5131;5142;5.28;0.33;281.83;3.77;1043;11;1741.00;11
4091;10;621456331;4091;471;5134;5142;5.32;0.33;281.91;3.78;1043;11;1742.00;8
4092;10;621456342;4092;468;5138;5146;5.41;0.33;281.86;3.78;1046;11;1743.00;8
4096;10;621456354;4096;471;5139;5146;5.44;0.33;281.95;3.78;1043;11;1744.00;7
4098;10;621456366;4098;469;5142;5146;5.48;0.34;282.01;3.79;1044;11;1745.00;4
4099;10;621456378;4099;471;5144;5149;5.61;0.34;281.97;3.79;1045;11;1746.00;5
4102;10;621456391;4102;459;5145;5149;5.65;0.35;281.95;3.79;1043;11;1747.00;4
4102;10;621456405;4102;456;5146;5149;5.72;0.35;281.95;3.79;1044;11;1748.00;3
4105;10;621456431;4105;447;5151;5153;5.79;0.35;281.85;3.79;1046;11;1749.00;2
4108;10;621456444;4108;441;5152;5154;5.85;0.36;282.04;3.79;1044;11;1750.00;2
4109;10;621456457;4109;433;5153;5154;5.91;0.36;282.07;3.79;1044;11;1751.00;1
4112;10;621456470;4112;432;5158;5158;5.96;0.37;282.12;3.79;1046;11;1752.00;0
4113;10;621456488;4113;427;5158;5158;6.00;0.37;282.05;3.79;1045;11;1753.00;0
4118;10;621456500;4118;424;5158;5158;5.97;0.37;282.12;3.79;1040;11;1754.00;0
4119;10;621456512;4119;417;5160;5160;6.04;0.37;282.05;3.79;1041;11;1755.00;0
4122;10;621456529;4122;411;5160;5160;6.06;0.37;282.00;3.79;1038;11;1756.00;0
4123;10;621456541;4123;403;5165;5166;6.14;0.38;282.01;3.79;1042;11;1757.00;1
4127;10;621456554;4127;400;5165;5166;6.21;0.38;282.00;3.79;1038;11;1758.00;1
4129;10;621456565;4129;396;5165;5167;6.29;0.38;281.99;3.79;1036;11;1759.00;2
4134;10;621456583;4134;392;5165;5167;6.28;0.38;281.99;3.79;1031;11;1760.00;2
4137;10;621456595;4137;392;5165;5167;6.25;0.38;282.10;3.79;1028;11;1761.00;2
4141;10;621456607;4141;399;5165;5167;6.24;0.38;282.21;3.79;1024;11;1762.00;2
4143;10;621456620;4143;399;5165;5167;6.25;0.38;282.24;3.79;1022;11;1763.00;2
4143;10;621456631;4143;394;5174;5179;6.39;0.39;282.24;3.78;1031;11;1764.00;5
4148;10;621456644;4148;397;5174;5179;6.43;0.39;282.31;3.78;1026;11;1765.00;5
4150;10;621456656;4150;397;5176;5179;6.49;0.39;282.30;3.78;1026;11;1766.00;3
4152;10;621456668;4152;389;5176;5179;6.50;0.39;282.37;3.78;1024;11;1767.00;3
4155;10;621456680;4155;384;5176;5179;6.48;0.39;282.38;3.78;1021;11;1768.00;3
4156;10;621456692;4156;376;5176;5179;6.52;0.40;282.47;3.78;1020;11;1769.00;3
4159;10;621456705;4159;373;5179;5183;6.51;0.39;282.67;3.78;1020;11;1770.00;4
4161;10;621456718;4161;372;5179;5183;6.56;0.40;282.69;3.78;1018;11;1771.00;4
4162;10;621456729;4162;367;5183;5187;6.65;0.40;282.76;3.77;1021;11;1772.00;4
4162;10;621456741;4162;369;5184;5188;6.77;0.41;282.76;3.77;1022;11;1773.00;4
4164;10;621456753;4164;366;5184;5188;6.83;0.41;282.77;3.77;1020;11;1774.00;4
4169;10;621456767;4169;368;5184;5188;6.80;0.41;283.05;3.77;1015;11;1775.00;4
4171;10;621456779;4171;370;5195;5201;6.95;0.42;283.09;3.77;1024;11;1776.00;6
4172;10;621456791;4172;374;5195;5201;7.03;0.43;283.09;3.77;1023;11;1777.00;6
4174;10;621456802;4174;375;5195;5201;7.03;0.43;283.19;3.77;1021;11;1778.00;6
4176;10;621456814;4176;376;5196;5202;7.06;0.43;283.42;3.77;1020;11;1779.00;6
4178;10;621456826;4178;377;5196;5203;7.06;0.43;283.43;3.77;1018;11;1780.00;7
4182;10;621456837;4182;378;5196;5203;7.05;0.43;283.68;3.77;1014;11;1781.00;7
4185;10;621456849;4185;384;5198;5206;7.04;0.43;283.78;3.76;1013;11;1782.00;8
4189;10;621456861;4189;386;5198;5206;7.02;0.43;284.11;3.76;1009;11;1783.00;8
4193;10;621456873;4193;391;5199;5206;6.96;0.42;284.24;3.76;1006;11;1784.00;7
4194;10;621456885;4194;394;5199;5206;6.95;0.42;284.36;3.76;1005;11;1785.00;7
4195;10;621456897;4195;393;5204;5212;6.95;0.42;284.47;3.76;1009;11;1786.00;8
4198;10;621456908;4198;393;5204;5212;6.88;0.42;284.48;3.76;1006;11;1787.00;8
4201;10;621456920;4201;394;5204;5212;6.76;0.41;284.67;3.76;1003;11;1788.00;8
4204;10;621456938;4204;398;5204;5212;6.68;0.41;284.71;3.76;1000;11;1789.00;8
4207;10;621456949;4207;390;5207;5216;6.60;0.40;284.81;3.76;1000;11;1790.00;9
4209;10;621456961;4209;384;5208;5217;6.57;0.40;284.89;3.76;999;11;1791.00;9
4216;10;621456973;4216;374;5208;5217;6.54;0.40;285.08;3.76;992;11;1792.00;9
4216;10;621456985;4216;372;5209;5218;6.58;0.40;285.08;3.76;993;11;1793.00;9
4218;10;621456996;4218;352;5209;5218;6.58;0.40;285.11;3.76;991;11;1794.00;9
4221;10;621457007;4221;348;5209;5218;6.56;0.40;285.32;3.76;988;11;1795.00;9
4225;10;621457019;4225;341;5209;5218;6.58;0.40;285.52;3.76;984;11;1796.00;9
4227;10;621457030;4227;340;5209;5218;6.65;0.40;285.59;3.76;982;11;1797.00;9
4227;10;621457041;4227;338;5209;5218;6.78;0.41;285.59;3.76;982;11;1798.00;9
4230;10;621457052;4230;325;5209;5218;6.79;0.41;285.76;3.76;979;11;1799.00;9
4233;10;621457066;4233;341;5275;5356;6.84;0.42;285.77;3.71;1042;11;1800.00;81
4235;10;621457093;4235;322;5275;5357;6.90;0.42;285.84;3.71;1040;11;1801.00;82
4241;10;621457106;4241;305;5284;5357;6.87;0.42;285.97;3.71;1043;11;1802.00;73
4243;10;621457118;4243;299;5286;5357;6.90;0.42;286.12;3.71;1043;11;1803.00;71
4248;10;621457136;4248;292;5293;5357;6.87;0.42;286.20;3.71;1045;11;1804.00;64
4252;10;621457149;4252;295;5297;5357;6.90;0.42;286.28;3.73;1045;11;1805.00;60
4255;10;621457163;4255;286;5303;5357;6.96;0.43;286.32;3.73;1048;11;1806.00;54
4258;10;621457175;4258;292;5307;5357;6.98;0.43;286.41;3.73;1049;11;1807.00;50
4262;10;621457187;4262;289;5314;5358;6.95;0.42;286.63;3.74;1052;11;1808.00;44
4265;10;621457199;4265;291;5317;5359;6.97;0.43;286.66;3.74;1052;11;1809.00;42
4269;10;621457210;4269;289;5320;5359;7.00;0.43;286.66;3.74;1051;11;1810.00;39
4271;10;621457222;4271;293;5325;5363;6.92;0.42;286.70;3.74;1054;11;1811.00;38
4274;10;621457234;4274;294;5327;5363;6.87;0.42;286.81;3.75;1053;11;1812.00;36
4275;10;621457246;4275;284;5329;5363;6.85;0.42;286.76;3.75;1054;11;1813.00;34
4280;10;621457258;4280;280;5331;5363;6.77;0.41;286.93;3.75;1051;11;1814.00;32
4282;10;621457270;4282;283;5335;5369;6.75;0.41;286.98;3.75;1053;11;1815.00;34
4286;10;621457283;4286;279;5337;5369;6.73;0.41;286.99;3.76;1051;11;1816.00;32
4288;10;621457295;4288;275;5338;5369;6.78;0.41;287.12;3.76;1050;11;1817.00;31
4290;10;621457307;4290;284;5341;5372;6.84;0.42;287.16;3.76;1051;11;1818.00;31
4291;10;621457319;4291;286;5344;5372;6.88;0.42;287.18;3.77;1053;11;1819.00;28
4291;10;621457331;4291;277;5344;5372;6.92;0.42;287.18;3.77;1053;11;1820.00;28
4293;10;621457343;4293;271;5346;5373;6.91;0.42;287.18;3.77;1053;11;1821.00;27
4296;10;621457355;4296;273;5348;5374;6.91;0.42;287.22;3.78;1052;11;1822.00;26
4298;10;621457367;4298;275;5351;5374;6.97;0.43;287.23;3.78;1053;11;1823.00;23
4300;10;621457380;4300;275;5358;5387;7.00;0.43;287.18;3.78;1058;11;1824.00;29
4303;10;621457393;4303;266;5361;5387;7.07;0.43;287.37;3.78;1058;11;1825.00;26
4306;10;621457406;4306;270;5362;5387;7.11;0.43;287.48;3.78;1056;11;1826.00;25
4309;10;621457423;4309;271;5364;5388;7.15;0.44;287.58;3.79;1055;11;1827.00;24
4311;10;621457444;4311;271;5365;5388;7.19;0.44;287.58;3.79;1054;11;1828.00;23
4315;10;621457464;4315;276;5369;5392;7.20;0.44;287.49;3.78;1054;11;1829.00;23
4315;10;621457488;4315;266;5372;5392;7.16;0.44;287.49;3.81;1057;11;1830.00;20
4320;10;621457515;4320;270;5375;5396;7.04;0.43;287.90;3.81;1055;11;1831.00;21
4324;10;621457534;4324;276;5376;5396;6.99;0.43;287.88;3.81;1052;11;1832.00;20
4326;10;621457549;4326;276;5377;5396;6.99;0.43;287.96;3.82;1051;11;1833.00;19
4330;10;621457562;4330;289;5377;5396;6.95;0.42;288.06;3.82;1047;11;1834.00;19
4333;10;621457575;4333;293;5379;5396;6.93;0.42;288.13;3.84;1046;11;1835.00;17
4339;10;621457589;4339;301;5388;5408;6.92;0.42;288.16;3.83;1049;11;1836.00;20
4343;10;621457604;4343;298;5389;5408;6.83;0.42;288.29;3.84;1046;11;1837.00;19
4345;10;621457616;4345;301;5392;5408;6.77;0.41;288.32;3.85;1047;11;1838.00;16
4347;10;621457628;4347;303;5392;5408;6.70;0.41;288.42;3.85;1045;11;1839.00;16
4349;10;621457641;4349;315;5394;5408;6.62;0.40;288.46;3.86;1045;11;1840.00;14
4352;10;621457653;4352;318;5394;5408;6.54;0.40;288.55;3.86;1042;11;1841.00;14
4356;10;621457665;4356;314;5395;5409;6.50;0.40;288.58;3.87;1039;11;1842.00;14
4357;10;621457676;4357;329;5395;5409;6.43;0.39;288.62;3.87;1038;11;1843.00;14
4360;10;621457689;4360;339;5400;5415;6.42;0.39;288.64;3.87;1040;11;1844.00;15
4362;10;621457701;4362;348;5404;5417;6.40;0.39;288.62;3.88;1042;11;1845.00;13
4364;10;621457713;4364;352;5405;5417;6.41;0.39;288.76;3.89;1041;11;1846.00;12
4367;10;621457724;4367;356;5406;5417;6.37;0.39;288.69;3.90;1039;11;1847.00;11
4369;10;621457736;4369;359;5409;5421;6.35;0.39;288.77;3.89;1040;11;1848.00;12
4374;10;621457747;4374;355;5411;5421;6.26;0.38;288.89;3.91;1037;11;1849.00;10
4376;10;621457760;4376;351;5411;5421;6.21;0.38;289.05;3.91;1035;11;1850.00;10
4377;10;621457772;4377;342;5412;5422;6.19;0.38;289.07;3.91;1035;11;1851.00;10
4379;10;621457783;4379;340;5415;5426;6.20;0.38;289.03;3.90;1036;11;1852.00;11
4382;10;621457795;4382;341;5415;5426;6.19;0.38;289.04;3.90;1033;11;1853.00;11
4383;10;621457806;4383;340;5417;5429;6.26;0.39;289.09;3.90;1034;11;1854.00;12
4384;10;621457818;4384;341;5417;5429;6.27;0.39;289.08;3.90;1033;11;1855.00;12
4387;10;621457828;4387;339;5418;5429;6.29;0.39;288.98;3.90;1031;11;1856.00;11
4389;10;621457840;4389;342;5425;5429;6.33;0.39;288.95;3.94;1036;11;1857.00;4
4392;10;621457852;4392;340;5429;5433;6.35;0.39;288.82;3.94;1037;11;1858.00;4
4396;10;621457864;4396;344;5430;5433;6.30;0.39;288.71;3.94;1034;11;1859.00;3
4398;10;621457877;4398;346;5431;5433;6.25;0.38;288.69;3.94;1033;11;1860.00;2
4399;10;621457888;4399;352;5431;5433;6.20;0.38;288.65;3.94;1032;11;1861.00;2
4403;10;621457899;4403;359;5432;5434;6.07;0.37;288.64;3.94;1029;11;1862.00;2
4405;10;621457909;4405;360;5434;5435;5.99;0.37;288.69;3.94;1029;11;1863.00;1
4408;10;621457920;4408;365;5434;5435;5.90;0.36;288.60;3.94;1026;11;1864.00;1
4412;10;621457931;4412;367;5435;5436;5.84;0.36;288.75;3.94;1023;11;1865.00;1
4415;10;621457943;4415;369;5435;5436;5.74;0.35;288.64;3.94;1020;11;1866.00;1
4417;10;621457954;4417;369;5435;5436;5.63;0.35;288.62;3.94;1018;11;1867.00;1
4419;10;621457964;4419;375;5435;5436;5.54;0.34;288.58;3.94;1016;11;1868.00;1
4421;10;621457974;4421;385;5435;5436;5.46;0.34;288.55;3.94;1014;11;1869.00;1
4423;10;621457984;4423;379;5435;5436;5.39;0.33;288.59;3.94;1012;11;1870.00;1
4425;10;621457994;4425;376;5435;5436;5.25;0.32;288.49;3.94;1010;11;1871.00;1
4427;10;621458004;4427;389;5504;5563;5.49;0.34;288.57;3.89;1077;11;1872.00;59
4433;10;621458025;4433;381;5506;5564;5.41;0.34;288.27;3.89;1073;11;1873.00;58
4436;10;621458036;4436;380;5516;5564;5.48;0.34;288.33;3.89;1080;11;1874.00;48
4438;10;621458046;4438;377;5521;5564;5.41;0.34;288.31;3.89;1083;11;1875.00;43
4441;10;621458056;4441;381;5530;5564;5.41;0.34;288.24;3.89;1089;11;1876.00;34
4445;10;621458067;4445;376;5534;5564;5.40;0.34;288.21;3.89;1089;11;1877.00;30
4450;10;621458078;4450;368;5537;5564;5.32;0.33;288.18;3.89;1087;11;1878.00;27
4453;10;621458088;4453;375;5541;5564;5.35;0.33;288.19;3.89;1088;11;1879.00;23
4456;10;621458099;4456;386;5543;5565;5.30;0.33;288.12;3.89;1087;11;1880.00;22
4457;10;621458110;4457;395;5545;5566;5.26;0.32;288.12;3.89;1088;11;1881.00;21
4460;10;621458122;4460;406;5549;5568;5.22;0.32;288.08;3.90;1089;11;1882.00;19
4464;10;621458134;4464;409;5551;5569;5.21;0.32;288.08;3.90;1087;11;1883.00;18
4465;10;621458145;4465;424;5555;5569;5.22;0.32;288.07;3.90;1090;11;1884.00;14
4471;10;621458156;4471;427;5559;5569;5.18;0.32;288.22;3.91;1088;11;1885.00;10
4472;10;621458167;4472;433;5560;5569;5.14;0.32;288.26;3.91;1088;11;1886.00;9
4473;10;621458180;4473;440;5564;5573;5.14;0.32;288.29;3.91;1091;11;1887.00;9
4475;10;621458191;4475;444;5565;5573;5.12;0.32;288.37;3.91;1090;11;1888.00;8
4478;10;621458203;4478;445;5565;5573;5.13;0.32;288.36;3.91;1087;11;1889.00;8
4480;10;621458217;4480;451;5569;5579;5.11;0.32;288.44;3.91;1089;11;1890.00;10
4482;10;621458229;4482;450;5570;5579;5.08;0.31;288.45;3.91;1088;11;1891.00;9
4488;10;621458246;4488;436;5570;5579;5.01;0.31;288.34;3.91;1082;11;1892.00;9
4493;10;621458259;4493;427;5575;5583;5.03;0.31;288.28;3.92;1082;11;1893.00;8
4495;10;621458271;4495;427;5576;5584;5.10;0.31;288.25;3.92;1081;11;1894.00;8
4503;10;621458284;4503;420;5576;5584;5.07;0.31;288.39;3.92;1073;11;1895.00;8
4506;10;621458296;4506;424;5581;5588;5.09;0.31;288.27;3.92;1075;11;1896.00;7
4508;10;621458309;4508;421;5582;5588;5.12;0.31;288.22;3.92;1074;11;1897.00;6
4512;10;621458332;4512;419;5583;5588;5.08;0.31;288.31;3.92;1071;11;1898.00;5
4513;10;621458344;4513;419;5583;5589;5.07;0.31;288.33;3.92;1070;11;1899.00;6
4516;10;621458358;4516;422;5584;5589;5.13;0.32;288.36;3.92;1068;11;1900.00;5
4521;10;621458373;4521;426;5589;5595;5.20;0.32;288.42;3.92;1068;11;1901.00;6
4526;10;621458385;4526;426;5589;5595;5.19;0.32;288.30;3.92;1063;11;1902.00;6
4529;10;621458399;4529;429;5590;5596;5.20;0.32;288.39;3.92;1061;11;1903.00;6
4531;10;621458411;4531;432;5590;5596;5.23;0.32;288.35;3.92;1059;11;1904.00;6
4537;10;621458425;4537;433;5590;5596;5.28;0.32;288.46;3.92;1053;11;1905.00;6
4541;10;621458437;4541;434;5590;5596;5.32;0.32;288.41;3.92;1049;11;1906.00;6
4542;10;621458448;4542;433;5590;5596;5.38;0.33;288.45;3.92;1048;11;1907.00;6
4543;10;621458460;4543;436;5600;5608;5.53;0.34;288.49;3.91;1057;11;1908.00;8
4545;10;621458472;4545;432;5601;5608;5.62;0.34;288.49;3.92;1056;11;1909.00;7
4549;10;621458483;4549;440;5602;5608;5.64;0.34;288.39;3.92;1053;11;1910.00;6
4551;10;621458495;4551;433;5602;5608;5.70;0.35;288.43;3.92;1051;11;1911.00;6
4552;10;621458506;4552;435;5602;5608;5.73;0.35;288.44;3.92;1050;11;1912.00;6
4555;10;621458517;4555;441;5602;5608;5.71;0.35;288.50;3.92;1047;11;1913.00;6
4555;10;621458528;4555;443;5605;5612;5.77;0.35;288.50;3.92;1050;11;1914.00;7
4557;10;621458540;4557;449;5605;5612;5.79;0.35;288.50;3.92;1048;11;1915.00;7
4559;10;621458551;4559;450;5609;5616;5.78;0.35;288.58;3.92;1050;11;1916.00;7
4560;10;621458563;4560;441;5610;5617;5.78;0.35;288.57;3.91;1050;11;1917.00;7
4563;10;621458575;4563;436;5610;5617;5.76;0.35;288.66;3.91;1047;11;1918.00;7
4565;10;621458586;4565;440;5610;5617;5.72;0.35;288.72;3.91;1045;11;1919.00;7
4567;10;621458606;4567;446;5633;5646;5.81;0.36;288.71;3.90;1066;11;1920.00;13
4571;10;621458619;4571;438;5633;5646;5.81;0.36;288.71;3.90;1062;11;1921.00;13
4576;10;621458631;4576;432;5634;5646;5.83;0.36;288.68;3.90;1058;11;1922.00;12
4579;10;621458643;4579;433;5636;5647;5.83;0.35;288.70;3.90;1057;11;1923.00;11
4580;10;621458654;4580;435;5636;5648;5.87;0.36;288.74;3.90;1056;11;1924.00;12
4581;10;621458666;4581;439;5637;5648;5.88;0.36;288.77;3.90;1056;11;1925.00;11
4583;10;621458683;4583;425;5639;5651;5.85;0.36;288.84;3.90;1056;11;1926.00;12
4586;10;621458696;4586;414;5640;5651;5.83;0.36;288.91;3.90;1054;11;1927.00;11
4587;10;621458707;4587;407;5640;5651;5.82;0.35;288.95;3.90;1053;11;1928.00;11
4590;10;621458719;4590;404;5640;5651;5.85;0.36;289.19;3.90;1050;11;1929.00;11
4592;10;621458731;4592;401;5645;5657;5.91;0.36;289.29;3.89;1053;11;1930.00;12
4593;10;621458744;4593;402;5645;5657;5.97;0.36;289.40;3.89;1052;11;1931.00;12
4597;10;621458756;4597;398;5645;5657;5.97;0.36;289.55;3.89;1048;11;1932.00;12
4598;10;621458768;4598;402;5645;5657;6.02;0.37;289.57;3.89;1047;11;1933.00;12
4602;10;621458780;4602;395;5648;5661;6.00;0.37;289.75;3.89;1046;11;1934.00;13
4607;10;621458799;4607;392;5650;5663;5.97;0.36;289.92;3.89;1043;11;1935.00;13
4608;10;621458811;4608;396;5650;5663;5.95;0.36;289.96;3.89;1042;11;1936.00;13
4610;10;621458823;4610;394;5651;5664;6.02;0.37;290.10;3.89;1041;11;1937.00;13
4613;10;621458836;4613;394;5651;5664;6.01;0.37;290.14;3.89;1038;11;1938.00;13
4617;10;621458848;4617;392;5651;5664;5.96;0.36;290.35;3.89;1034;11;1939.00;13
4618;10;621458860;4618;388;5651;5664;5.96;0.36;290.39;3.89;1033;11;1940.00;13
4622;10;621458872;4622;388;5651;5664;6.01;0.37;290.57;3.89;1029;11;1941.00;13
4623;10;621458883;4623;386;5651;5664;6.07;0.37;290.62;3.89;1028;11;1942.00;13
4626;10;621458895;4626;383;5651;5664;6.08;0.37;290.74;3.89;1025;11;1943.00;13
4630;10;621458906;4630;402;5694;5734;6.08;0.37;290.85;3.86;1064;11;1944.00;40
4631;10;621458923;4631;389;5694;5735;6.14;0.37;290.88;3.86;1063;11;1945.00;41
4633;10;621458940;4633;385;5700;5735;6.23;0.38;291.01;3.88;1067;11;1946.00;35
4635;10;621458952;4635;381;5700;5735;6.26;0.38;291.08;3.88;1065;11;1947.00;35
4637;10;621458963;4637;379;5703;5735;6.27;0.38;291.14;3.89;1066;11;1948.00;32
4641;10;621458976;4641;383;5704;5735;6.23;0.38;291.26;3.89;1063;11;1949.00;31
4643;10;621458989;4643;392;5708;5737;6.26;0.38;291.39;3.89;1065;11;1950.00;29
4646;10;621459001;4646;398;5711;5737;6.25;0.38;291.52;3.89;1065;11;1951.00;26
4648;10;621459012;4648;395;5711;5738;6.22;0.38;291.61;3.89;1063;11;1952.00;27
4648;10;621459029;4648;401;5714;5739;6.23;0.38;291.61;3.89;1066;11;1953.00;25
4649;10;621459041;4649;409;5715;5739;6.22;0.38;291.63;3.89;1066;11;1954.00;24
4650;10;621459052;4650;405;5721;5743;6.27;0.38;291.65;3.90;1071;11;1955.00;22
4651;10;621459069;4651;410;5724;5743;6.27;0.38;291.63;3.90;1073;11;1956.00;19
4651;10;621459081;4651;406;5726;5743;6.26;0.38;291.63;3.90;1075;11;1957.00;17
4652;10;621459093;4652;407;5727;5743;6.22;0.38;291.60;3.90;1075;11;1958.00;16
4652;10;621459104;4652;406;5732;5749;6.22;0.38;291.60;3.90;1080;11;1959.00;17
4652;10;621459116;4652;404;5732;5749;6.17;0.38;291.60;3.90;1080;11;1960.00;17
4654;10;621459133;4654;408;5732;5749;6.16;0.37;291.58;3.90;1078;11;1961.00;17
4657;10;621459145;4657;402;5735;5752;6.14;0.37;291.63;3.90;1078;11;1962.00;17
4661;10;621459158;4661;387;5735;5752;6.10;0.37;291.65;3.90;1074;11;1963.00;17
4661;10;621459170;4661;382;5735;5752;6.13;0.37;291.65;3.90;1074;11;1964.00;17
4663;10;621459182;4663;381;5735;5753;6.15;0.37;291.73;3.90;1072;11;1965.00;18
4665;10;621459194;4665;380;5736;5754;6.16;0.37;291.77;3.90;1071;11;1966.00;18
4667;10;621459206;4667;374;5736;5754;6.19;0.37;291.76;3.90;1069;11;1967.00;18
4668;10;621459218;4668;369;5746;5767;6.26;0.38;291.84;3.89;1078;11;1968.00;21
4670;10;621459231;4670;358;5746;5767;6.27;0.38;292.06;3.89;1076;11;1969.00;21
4673;10;621459242;4673;350;5746;5767;6.25;0.38;292.19;3.89;1073;11;1970.00;21
4677;10;621459254;4677;343;5747;5768;6.29;0.38;292.34;3.89;1070;11;1971.00;21
4680;10;621459266;4680;338;5747;5768;6.33;0.39;292.51;3.89;1067;11;1972.00;21
4682;10;621459278;4682;327;5752;5772;6.32;0.39;292.57;3.89;1070;11;1973.00;20
4687;10;621459290;4687;320;5753;5772;6.26;0.38;292.82;3.90;1066;11;1974.00;19
4688;10;621459303;4688;308;5756;5776;6.29;0.38;292.91;3.90;1068;11;1975.00;20
4690;10;621459315;4690;300;5757;5776;6.33;0.39;292.89;3.91;1067;11;1976.00;19
4695;10;621459327;4695;301;5757;5776;6.34;0.38;292.99;3.91;1062;11;1977.00;19
4698;10;621459339;4698;301;5757;5776;6.34;0.38;293.03;3.91;1059;11;1978.00;19
4699;10;621459351;4699;294;5757;5776;6.39;0.39;293.05;3.91;1058;11;1979.00;19
4704;10;621459376;4704;285;5780;5810;6.46;0.39;293.11;3.90;1076;11;1980.00;30
4707;10;621459390;4707;277;5781;5810;6.48;0.40;293.17;3.90;1074;11;1981.00;29
4711;10;621459402;4711;270;5782;5810;6.46;0.40;293.27;3.90;1071;11;1982.00;28
4712;10;621459414;4712;269;5783;5810;6.49;0.40;293.29;3.90;1071;11;1983.00;27
4714;10;621459435;4714;261;5783;5810;6.48;0.40;293.36;3.90;1069;11;1984.00;27
4717;10;621459454;4717;263;5783;5810;6.41;0.39;293.39;3.90;1066;11;1985.00;27
4719;11;621459482;4719;259;5783;5811;6.43;0.39;293.37;3.90;1064;12;1986.00;28
4721;11;621459534;4721;263;5784;5811;6.48;0.39;293.33;3.90;1063;12;1987.00;27
4722;11;621459547;4722;266;5788;5817;6.59;0.40;293.29;3.89;1066;12;1988.00;29
4727;11;621459564;4727;264;5789;5818;6.61;0.40;293.40;3.89;1062;12;1989.00;29
4728;11;621459577;4728;267;5790;5818;6.58;0.40;293.46;3.89;1062;12;1990.00;28
4731;11;621459590;4731;266;5791;5818;6.57;0.40;293.46;3.90;1060;12;1991.00;27
4731;11;621459605;4731;265;5794;5822;6.60;0.40;293.46;3.89;1063;12;1992.00;28
4733;11;621459619;4733;266;5796;5822;6.60;0.40;293.39;3.90;1063;12;1993.00;26
4734;11;621459631;4734;278;5796;5822;6.58;0.40;293.38;3.90;1062;12;1994.00;26
4737;11;621459645;4737;280;5798;5823;6.62;0.40;293.48;3.91;1061;12;1995.00;25
4741;11;621459658;4741;279;5803;5827;6.59;0.40;293.40;3.92;1062;12;1996.00;24
4746;11;621459671;4746;281;5803;5827;6.56;0.40;293.48;3.92;1057;12;1997.00;24
4749;11;621459684;4749;284;5805;5830;6.59;0.40;293.62;3.92;1056;12;1998.00;25
4750;11;621459697;4750;285;5806;5830;6.55;0.40;293.73;3.92;1056;12;1999.00;24
4751;11;621459710;4751;285;5808;5830;6.52;0.40;293.82;3.95;1057;12;2000.00;22
4754;11;621459727;4754;292;5808;5830;6.54;0.40;293.80;3.95;1054;12;2001.00;22
4756;11;621459739;4756;300;5813;5834;6.58;0.40;293.84;3.96;1057;12;2002.00;21
4759;11;621459752;4759;300;5814;5834;6.57;0.40;294.05;3.97;1055;12;2003.00;20
4760;11;621459764;4760;305;5815;5834;6.59;0.40;294.07;3.98;1055;12;2004.00;19
4764;11;621459777;4764;311;5816;5834;6.56;0.40;294.06;3.99;1052;12;2005.00;18
4764;11;621459789;4764;313;5816;5835;6.57;0.40;294.06;3.99;1052;12;2006.00;19
4767;11;621459801;4767;318;5819;5836;6.49;0.40;294.07;4.00;1052;12;2007.00;17
4769;11;621459813;4769;319;5820;5836;6.41;0.39;294.06;4.01;1051;12;2008.00;16
4772;11;621459825;4772;325;5821;5837;6.34;0.39;294.03;4.00;1049;12;2009.00;16
4774;11;621459840;4774;324;5822;5837;6.25;0.38;293.99;4.02;1048;12;2010.00;15
4777;11;621459852;4777;332;5822;5837;6.17;0.38;293.90;4.02;1045;12;2011.00;15
4778;11;621459864;4778;338;5824;5837;6.11;0.37;293.92;4.05;1046;12;2012.00;13
4780;11;621459875;4780;338;5826;5837;6.04;0.37;293.84;4.07;1046;12;2013.00;11
4781;11;621459887;4781;343;5826;5837;5.99;0.37;293.80;4.07;1045;12;2014.00;11
4783;11;621459899;4783;348;5828;5837;5.97;0.37;293.73;4.09;1045;12;2015.00;9
4784;11;621459911;4784;368;5895;5964;6.14;0.38;293.72;4.04;1111;12;2016.00;69
4786;11;621459932;4786;367;5900;5965;6.08;0.38;293.73;4.06;1114;12;2017.00;65
4787;11;621459945;4787;360;5909;5965;6.11;0.38;293.72;4.06;1122;12;2018.00;56
4790;11;621459957;4790;359;5914;5965;6.04;0.37;293.72;4.07;1124;12;2019.00;51
4794;11;621459969;4794;359;5919;5965;6.04;0.37;293.63;4.07;1125;12;2020.00;46
4797;11;621459981;4797;362;5920;5965;5.97;0.37;293.60;4.07;1123;12;2021.00;45
4800;11;621459993;4800;358;5926;5965;5.95;0.37;293.60;4.08;1126;12;2022.00;39
4802;11;621460005;4802;356;5928;5965;5.95;0.37;293.60;4.08;1126;12;2023.00;37
4803;11;621460018;4803;367;5931;5966;5.96;0.37;293.56;4.09;1128;12;2024.00;35
4808;11;621460036;4808;368;5939;5968;5.96;0.37;293.37;4.10;1131;12;2025.00;29
4810;11;621460048;4810;364;5942;5968;5.94;0.37;293.42;4.10;1132;12;2026.00;26
4810;11;621460060;4810;367;5946;5969;5.92;0.36;293.42;4.11;1136;12;2027.00;23
4813;11;621460072;4813;373;5950;5969;5.93;0.36;293.45;4.11;1137;12;2028.00;19
4814;11;621460084;4814;375;5952;5969;5.94;0.37;293.41;4.12;1138;12;2029.00;17
4816;11;621460096;4816;382;5956;5969;5.89;0.36;293.34;4.12;1140;12;2030.00;13
4818;11;621460108;4818;386;5961;5973;5.85;0.36;293.31;4.12;1143;12;2031.00;12
4819;11;621460121;4819;394;5962;5973;5.75;0.35;293.34;4.12;1143;12;2032.00;11
4820;11;621460132;4820;402;5965;5973;5.64;0.35;293.33;4.13;1145;12;2033.00;8
4823;11;621460144;4823;413;5967;5976;5.53;0.34;293.33;4.13;1144;12;2034.00;9
4827;11;621460156;4827;428;5967;5976;5.38;0.33;293.35;4.13;1140;12;2035.00;9
4830;11;621460167;4830;433;5970;5976;5.18;0.32;293.34;4.14;1140;12;2036.00;6
4833;11;621460179;4833;440;5974;5980;5.06;0.31;293.34;4.14;1141;12;2037.00;6
4837;11;621460191;4837;449;5978;5981;4.89;0.30;293.30;4.15;1141;12;2038.00;3
4839;11;621460208;4839;460;5978;5981;4.76;0.29;293.26;4.15;1139;12;2039.00;3
4842;11;621460221;4842;456;5984;5986;4.70;0.29;293.22;4.14;1142;12;2040.00;2
4845;11;621460233;4845;452;5985;5986;4.61;0.28;293.12;4.14;1140;12;2041.00;1
4846;11;621460244;4846;454;5985;5986;4.56;0.28;293.13;4.14;1139;12;2042.00;1
4849;11;621460255;4849;438;5986;5987;4.55;0.28;293.05;4.14;1137;12;2043.00;1
4852;11;621460268;4852;420;5987;5987;4.58;0.28;292.96;4.14;1135;12;2044.00;0
4854;11;621460279;4854;424;5992;5993;4.70;0.29;292.93;4.14;1138;12;2045.00;1
4857;11;621460291;4857;431;5992;5993;4.74;0.29;292.85;4.14;1135;12;2046.00;1
4858;11;621460303;4858;423;5992;5994;4.82;0.30;292.80;4.14;1134;12;2047.00;2
4861;11;621460316;4861;413;5992;5994;4.87;0.30;292.85;4.14;1131;12;2048.00;2
4863;11;621460328;4863;402;5992;5994;4.93;0.30;292.91;4.14;1129;12;2049.00;2
4865;11;621460346;4865;403;5992;5994;5.02;0.31;292.98;4.14;1127;12;2050.00;2
4869;11;621460358;4869;401;5992;5994;5.09;0.31;292.97;4.14;1123;12;2051.00;2
4871;11;621460376;4871;402;6003;6006;5.20;0.32;292.93;4.13;1132;12;2052.00;3
4874;11;621460390;4874;390;6003;6006;5.24;0.32;292.87;4.13;1129;12;2053.00;3
4877;11;621460409;4877;392;6003;6006;5.27;0.32;292.89;4.13;1126;12;2054.00;3
4879;11;621460427;4879;393;6003;6006;5.29;0.32;292.80;4.13;1124;12;2055.00;3
4881;11;621460444;4881;393;6003;6006;5.31;0.32;292.79;4.13;1122;12;2056.00;3
4884;11;621460464;4884;385;6003;6006;5.32;0.33;292.81;4.13;1119;12;2057.00;3
4886;11;621460479;4886;389;6006;6010;5.39;0.33;292.78;4.13;1120;12;2058.00;4
4890;11;621460496;4890;390;6006;6010;5.45;0.33;292.87;4.13;1116;12;2059.00;4
4893;11;621460529;4893;385;6010;6014;5.54;0.34;292.98;4.13;1117;12;2060.00;4
4896;11;621460559;4896;383;6010;6015;5.55;0.34;292.94;4.13;1114;12;2061.00;5
4900;11;621460587;4900;391;6011;6015;5.52;0.34;293.01;4.13;1111;12;2062.00;4
4900;11;621460611;4900;389;6011;6015;5.60;0.34;293.01;4.13;1111;12;2063.00;4
4904;11;621460631;4904;392;6022;6028;5.68;0.35;293.21;4.12;1118;12;2064.00;6
4906;11;621460653;4906;389;6022;6028;5.70;0.35;293.27;4.12;1116;12;2065.00;6
4914;11;621460670;4914;382;6022;6028;5.70;0.35;293.21;4.12;1108;12;2066.00;6
4919;11;621460684;4919;382;6023;6029;5.70;0.35;293.20;4.12;1104;12;2067.00;6
4925;11;621460698;4925;383;6023;6030;5.69;0.35;293.21;4.12;1098;12;2068.00;7
4931;11;621460711;4931;381;6023;6030;5.67;0.34;293.29;4.12;1092;12;2069.00;7
4933;11;621460725;4933;374;6027;6036;5.71;0.35;293.27;4.12;1094;12;2070.00;9
4936;11;621460739;4936;378;6027;6036;5.73;0.35;293.47;4.12;1091;12;2071.00;9
4940;11;621460754;4940;377;6029;6036;5.74;0.35;293.66;4.12;1089;12;2072.00;7
4944;11;621460769;4944;383;6029;6036;5.76;0.35;293.73;4.12;1085;12;2073.00;7
4949;11;621460782;4949;384;6034;6042;5.80;0.35;293.97;4.12;1085;12;2074.00;8
4954;11;621460795;4954;386;6034;6042;5.81;0.35;294.12;4.12;1080;12;2075.00;8
4960;11;621460809;4960;394;6034;6042;5.82;0.35;294.08;4.12;1074;12;2076.00;8
4962;11;621460824;4962;394;6034;6042;5.81;0.35;294.23;4.12;1072;12;2077.00;8
4965;11;621460837;4965;392;6037;6046;5.87;0.36;294.31;4.11;1072;12;2078.00;9
4968;11;621460851;4968;396;6038;6047;5.89;0.36;294.57;4.11;1070;12;2079.00;9
4972;11;621460864;4972;396;6038;6047;5.87;0.36;294.64;4.11;1066;12;2080.00;9
4974;11;621460878;4974;405;6039;6048;5.86;0.36;294.78;4.11;1065;12;2081.00;9
4976;11;621460891;4976;412;6039;6048;5.83;0.35;294.96;4.11;1063;12;2082.00;9
4982;11;621460903;4982;414;6039;6048;5.75;0.35;294.94;4.11;1057;12;2083.00;9
4982;11;621460916;4982;413;6039;6048;5.67;0.34;294.94;4.11;1057;12;2084.00;9
4985;11;621460930;4985;412;6039;6048;5.62;0.34;295.19;4.11;1054;12;2085.00;9
4990;11;621460947;4990;421;6039;6048;5.53;0.34;295.25;4.11;1049;12;2086.00;9
4990;11;621460966;4990;412;6039;6048;5.50;0.33;295.25;4.11;1049;12;2087.00;9
4993;11;621460986;4993;421;6082;6118;5.60;0.34;295.47;4.08;1089;12;2088.00;36
4995;11;621461021;4995;411;6083;6119;5.58;0.34;295.62;4.08;1088;12;2089.00;36
4997;11;621461041;4997;406;6087;6119;5.63;0.34;295.67;4.08;1090;12;2090.00;32
4999;11;621461060;4999;401;6088;6119;5.68;0.35;295.77;4.08;1089;12;2091.00;31
5003;11;621461077;5003;403;6090;6119;5.75;0.35;296.01;4.08;1087;12;2092.00;29
5005;11;621461091;5005;404;6092;6119;5.81;0.35;296.03;4.08;1087;12;2093.00;27
5006;11;621461105;5006;399;6096;6119;5.85;0.36;296.03;4.08;1090;12;2094.00;23
5008;11;621461119;5008;414;6097;6119;5.87;0.36;296.16;4.08;1089;12;2095.00;22
5010;11;621461134;5010;407;6099;6120;5.90;0.36;296.21;4.09;1089;12;2096.00;21
5012;11;621461149;5012;396;6101;6121;5.90;0.36;296.40;4.09;1089;12;2097.00;20
5014;11;621461165;5014;400;6102;6121;5.93;0.36;296.46;4.09;1088;12;2098.00;19
5021;11;621461179;5021;397;6106;6125;5.93;0.36;296.63;4.09;1085;12;2099.00;19
5023;11;621461200;5023;404;6112;6140;5.92;0.36;296.67;4.09;1089;12;2100.00;28
5025;11;621461227;5025;400;6112;6140;5.92;0.36;296.77;4.09;1087;12;2101.00;28
5027;11;621461243;5027;405;6115;6140;5.96;0.36;296.87;4.09;1088;12;2102.00;25
5029;11;621461259;5029;409;6118;6146;5.98;0.36;296.90;4.09;1089;12;2103.00;28
5032;11;621461292;5032;419;6118;6146;5.92;0.36;296.91;4.09;1086;12;2104.00;28
5034;11;621461320;5034;421;6119;6146;5.89;0.36;296.91;4.09;1085;12;2105.00;27
5036;11;621461341;5036;427;6123;6149;5.93;0.36;296.92;4.09;1087;12;2106.00;26
5038;11;621461361;5038;421;6123;6149;5.94;0.36;297.01;4.09;1085;12;2107.00;26
5041;11;621461379;5041;418;6124;6149;5.93;0.36;297.07;4.09;1083;12;2108.00;25
5044;11;621461403;5044;412;6124;6150;5.92;0.36;297.11;4.09;1080;12;2109.00;26
5045;11;621461427;5045;408;6125;6151;5.93;0.36;297.14;4.09;1080;12;2110.00;26
5048;11;621461451;5048;403;6125;6151;5.92;0.36;297.27;4.09;1077;12;2111.00;26
5048;11;621461467;5048;408;6136;6164;5.95;0.36;297.27;4.08;1088;12;2112.00;28
5051;11;621461482;5051;402;6137;6164;5.92;0.36;297.35;4.08;1086;12;2113.00;27
5053;11;621461497;5053;401;6137;6164;5.95;0.36;297.44;4.08;1084;12;2114.00;27
5054;11;621461512;5054;402;6139;6166;6.00;0.37;297.40;4.08;1085;12;2115.00;27
5058;11;621461526;5058;404;6139;6166;5.96;0.36;297.49;4.08;1081;12;2116.00;27
5060;11;621461541;5060;414;6144;6170;5.97;0.36;297.56;4.08;1084;12;2117.00;26
5063;11;621461558;5063;406;6144;6170;5.96;0.36;297.75;4.08;1081;12;2118.00;26
5066;11;621461572;5066;411;6147;6174;5.97;0.36;297.80;4.08;1081;12;2119.00;27
5069;11;621461585;5069;405;6147;6174;5.97;0.36;297.87;4.08;1078;12;2120.00;27
5071;11;621461598;5071;413;6147;6174;5.93;0.36;297.86;4.08;1076;12;2121.00;27
5075;11;621461610;5075;415;6147;6174;5.92;0.36;298.04;4.08;1072;12;2122.00;27
5077;11;621461623;5077;418;6149;6174;5.90;0.36;298.15;4.09;1072;12;2123.00;25
5079;11;621461635;5079;423;6158;6186;5.96;0.36;298.15;4.08;1079;12;2124.00;28
5083;11;621461649;5083;427;6158;6186;5.95;0.36;298.23;4.08;1075;12;2125.00;28
5086;11;621461666;5086;427;6161;6186;5.99;0.36;298.34;4.09;1075;12;2126.00;25
5089;11;621461679;5089;428;6161;6186;5.98;0.36;298.35;4.09;1072;12;2127.00;25
5090;11;621461691;5090;424;6162;6186;6.00;0.36;298.37;4.09;1072;12;2128.00;24
5092;11;621461705;5092;416;6162;6186;6.03;0.36;298.39;4.09;1070;12;2129.00;24
5094;11;621461721;5094;412;6163;6187;6.07;0.37;298.38;4.09;1069;12;2130.00;24
5095;12;621461735;5095;400;6163;6187;6.10;0.37;298.36;4.09;1068;13;2131.00;24
5097;12;621461758;5097;402;6169;6193;6.10;0.37;298.43;4.09;1072;13;2132.00;24
5097;12;621461773;5097;394;6170;6194;6.13;0.37;298.43;4.09;1073;13;2133.00;24
5099;12;621461788;5099;388;6170;6194;6.10;0.37;298.47;4.09;1071;13;2134.00;24
5101;12;621461800;5101;385;6170;6194;6.06;0.37;298.50;4.09;1069;13;2135.00;24
5104;12;621461818;5104;384;6173;6198;6.05;0.36;298.64;4.09;1069;13;2136.00;25
5107;12;621461833;5107;386;6173;6198;6.01;0.36;298.75;4.09;1066;13;2137.00;25
5108;12;621461846;5108;378;6173;6198;6.02;0.36;298.75;4.09;1065;13;2138.00;25
5110;12;621461861;5110;380;6174;6199;6.03;0.36;298.73;4.09;1064;13;2139.00;25
5112;12;621461877;5112;366;6177;6203;5.95;0.36;298.71;4.09;1065;13;2140.00;26
5117;12;621461891;5117;364;6177;6203;5.83;0.35;298.94;4.09;1060;13;2141.00;26
5118;12;621461903;5118;359;6179;6206;5.82;0.35;298.99;4.08;1061;13;2142.00;27
5121;12;621461915;5121;361;6180;6206;5.76;0.35;299.02;4.08;1059;13;2143.00;26
5126;12;621461927;5126;358;6180;6206;5.69;0.35;299.12;4.08;1054;13;2144.00;26
5129;12;621461939;5129;362;6182;6206;5.68;0.35;299.21;4.12;1053;13;2145.00;24
5130;12;621461952;5130;353;6186;6210;5.74;0.35;299.33;4.11;1056;13;2146.00;24
5134;12;621461964;5134;357;6186;6210;5.76;0.35;299.31;4.11;1052;13;2147.00;24
5137;12;621461978;5137;356;6186;6210;5.77;0.35;299.37;4.11;1049;13;2148.00;24
5141;12;621461990;5141;353;6186;6210;5.78;0.35;299.28;4.11;1045;13;2149.00;24
5143;12;621462003;5143;360;6186;6211;5.77;0.35;299.40;4.11;1043;13;2150.00;25
5149;12;621462016;5149;351;6187;6212;5.73;0.35;299.39;4.11;1038;13;2151.00;25
5151;12;621462028;5151;349;6187;6212;5.72;0.35;299.41;4.11;1036;13;2152.00;25
5152;12;621462039;5152;349;6188;6213;5.76;0.35;299.42;4.11;1036;13;2153.00;25
5155;12;621462051;5155;342;6188;6213;5.76;0.35;299.42;4.11;1033;13;2154.00;25
5156;12;621462062;5156;335;6188;6213;5.72;0.35;299.44;4.11;1032;13;2155.00;25
5156;12;621462073;5156;338;6188;6213;5.75;0.35;299.44;4.11;1032;13;2156.00;25
5160;12;621462084;5160;338;6188;6213;5.69;0.35;299.42;4.11;1028;13;2157.00;25
5161;12;621462095;5161;342;6188;6213;5.69;0.35;299.39;4.11;1027;13;2158.00;25
5163;12;621462106;5163;344;6188;6213;5.71;0.35;299.48;4.11;1025;13;2159.00;25
5164;12;621462118;5164;375;6288;6443;6.08;0.38;299.47;4.05;1124;13;2160.00;155
5166;12;621462148;5166;374;6291;6444;6.10;0.38;299.54;4.05;1125;13;2161.00;153
5168;12;621462161;5168;360;6303;6444;6.23;0.39;299.54;4.04;1135;13;2162.00;141
5170;12;621462174;5170;355;6309;6444;6.23;0.39;299.50;4.04;1139;13;2163.00;135
5171;12;621462186;5171;352;6320;6444;6.26;0.39;299.46;4.04;1149;13;2164.00;124
5172;12;621462199;5172;345;6327;6444;6.25;0.39;299.45;4.04;1155;13;2165.00;117
5174;12;621462211;5174;341;6338;6444;6.26;0.39;299.44;4.04;1164;13;2166.00;106
5176;12;621462225;5176;334;6347;6444;6.25;0.39;299.36;4.05;1171;13;2167.00;97
5177;12;621462242;5177;334;6355;6445;6.31;0.39;299.33;4.05;1178;13;2168.00;90
5177;12;621462255;5177;342;6361;6446;6.30;0.39;299.33;4.06;1184;13;2169.00;85
5180;12;621462268;5180;344;6369;6446;6.23;0.39;299.24;4.10;1189;13;2170.00;77
5182;12;621462281;5182;351;6373;6447;6.20;0.38;299.24;4.10;1191;13;2171.00;74
5187;12;621462294;5187;359;6377;6447;6.09;0.38;299.25;4.11;1190;13;2172.00;70
5187;12;621462307;5187;368;6383;6447;5.98;0.37;299.25;4.15;1196;13;2173.00;64
5188;12;621462320;5188;376;6384;6447;5.90;0.36;299.19;4.15;1196;13;2174.00;63
5188;12;621462333;5188;379;6391;6451;5.81;0.36;299.19;4.17;1203;13;2175.00;60
5193;12;621462346;5193;387;6395;6451;5.67;0.35;299.19;4.20;1202;13;2176.00;56
5194;12;621462359;5194;400;6397;6451;5.58;0.34;299.15;4.20;1203;13;2177.00;54
5194;12;621462372;5194;408;6399;6454;5.50;0.34;299.15;4.21;1205;13;2178.00;55
5196;12;621462385;5196;412;6403;6454;5.39;0.33;299.23;4.23;1207;13;2179.00;51
5196;12;621462399;5196;428;6404;6454;5.28;0.33;299.23;4.24;1208;13;2180.00;50
5201;12;621462411;5201;435;6412;6458;5.17;0.32;299.09;4.26;1211;13;2181.00;46
5205;12;621462426;5205;443;6414;6459;5.12;0.32;299.13;4.26;1209;13;2182.00;45
5207;12;621462439;5207;463;6417;6459;5.05;0.31;299.17;4.29;1210;13;2183.00;42
5207;12;621462452;5207;473;6421;6463;5.01;0.31;299.17;4.31;1214;13;2184.00;42
5208;12;621462465;5208;480;6425;6463;4.94;0.31;299.12;4.32;1217;13;2185.00;38
5210;12;621462478;5210;486;6428;6463;4.86;0.30;299.08;4.34;1218;13;2186.00;35
5213;12;621462490;5213;492;6429;6464;4.76;0.29;299.08;4.34;1216;13;2187.00;35
5215;12;621462503;5215;502;6431;6464;4.68;0.29;299.07;4.37;1216;13;2188.00;33
5216;12;621462516;5216;505;6437;6470;4.71;0.29;299.09;4.38;1221;13;2189.00;33
5216;12;621462531;5216;504;6439;6470;4.70;0.29;299.09;4.39;1223;13;2190.00;31
5220;12;621462543;5220;508;6440;6471;4.71;0.29;298.97;4.41;1220;13;2191.00;31
5221;12;621462556;5221;514;6443;6471;4.70;0.29;298.94;4.42;1222;13;2192.00;28
5223;13;621462569;5223;520;6445;6471;4.65;0.29;298.90;4.43;1222;14;2193.00;26
5224;13;621462593;5224;513;6447;6471;4.60;0.28;298.88;4.45;1223;14;2194.00;24
5226;13;621462606;5226;500;6448;6471;4.57;0.28;298.83;4.45;1222;14;2195.00;23
5227;13;621462619;5227;489;6456;6483;4.61;0.29;298.78;4.45;1229;14;2196.00;27
5230;13;621462638;5230;484;6459;6483;4.63;0.29;298.77;4.46;1229;14;2197.00;24
5233;13;621462658;5233;481;6462;6483;4.66;0.29;298.74;4.46;1229;14;2198.00;21
5233;13;621462675;5233;480;6463;6483;4.71;0.29;298.74;4.47;1230;14;2199.00;20
5234;13;621462692;5234;481;6464;6483;4.70;0.29;298.72;4.48;1230;14;2200.00;19
5235;13;621462714;5235;479;6466;6483;4.68;0.29;298.69;4.48;1231;14;2201.00;17
5237;13;621462736;5237;480;6470;6487;4.62;0.28;298.63;4.48;1233;14;2202.00;17
5239;13;621462750;5239;484;6471;6487;4.64;0.28;298.58;4.49;1232;14;2203.00;16
5242;13;621462765;5242;481;6476;6491;4.65;0.29;298.50;4.49;1234;14;2204.00;15
5247;13;621462782;5247;485;6478;6493;4.65;0.28;298.43;4.49;1231;14;2205.00;15
5250;13;621462796;5250;482;6479;6493;4.63;0.28;298.35;4.50;1229;14;2206.00;14
5253;13;621462808;5253;481;6479;6493;4.59;0.28;298.24;4.50;1226;14;2207.00;14
5255;13;621462820;5255;493;6490;6506;4.58;0.28;298.29;4.50;1235;14;2208.00;16
5257;13;621462833;5257;493;6491;6506;4.56;0.28;298.33;4.50;1234;14;2209.00;15
5259;13;621462855;5259;489;6494;6508;4.60;0.28;298.36;4.51;1235;14;2210.00;14
5260;13;621462868;5260;477;6497;6509;4.64;0.28;298.38;4.52;1237;14;2211.00;12
5263;13;621462880;5263;473;6497;6510;4.67;0.29;298.30;4.52;1234;14;2212.00;13
5266;13;621462898;5266;461;6497;6510;4.69;0.29;298.33;4.52;1231;14;2213.00;13
5268;13;621462910;5268;460;6499;6513;4.72;0.29;298.42;4.51;1231;14;2214.00;14
5271;13;621462925;5271;457;6499;6513;4.76;0.29;298.48;4.51;1228;14;2215.00;14
5273;14;621462945;5273;446;6499;6513;4.80;0.29;298.46;4.51;1226;15;2216.00;14
5278;14;621462986;5278;438;6499;6513;4.84;0.30;298.45;4.51;1221;15;2217.00;14
5282;14;621463011;5282;438;6503;6519;4.89;0.30;298.62;4.51;1221;15;2218.00;16
5287;14;621463033;5287;427;6503;6519;4.95;0.30;298.55;4.51;1216;15;2219.00;16
5291;14;621463053;5291;426;6503;6519;4.97;0.30;298.54;4.51;1212;15;2220.00;16
5294;14;621463068;5294;416;6503;6519;5.03;0.31;298.68;4.51;1209;15;2221.00;16
5294;14;621463082;5294;414;6506;6523;5.15;0.32;298.68;4.51;1212;15;2222.00;17
5297;14;621463097;5297;413;6507;6524;5.19;0.32;298.73;4.51;1210;15;2223.00;17
5302;14;621463113;5302;413;6507;6524;5.22;0.32;298.91;4.51;1205;15;2224.00;17
5304;14;621463128;5304;412;6508;6525;5.28;0.32;298.99;4.51;1204;15;2225.00;17
5308;14;621463143;5308;408;6508;6525;5.35;0.33;298.98;4.51;1200;15;2226.00;17
5311;14;621463157;5311;407;6508;6525;5.42;0.33;299.09;4.51;1197;15;2227.00;17
5314;14;621463174;5314;412;6508;6525;5.44;0.33;299.03;4.51;1194;15;2228.00;17
5321;14;621463191;5321;413;6508;6525;5.43;0.33;299.04;4.51;1187;15;2229.00;17
5325;14;621463212;5325;411;6508;6525;5.43;0.33;299.22;4.51;1183;15;2230.00;17
5327;14;621463227;5327;415;6508;6525;5.48;0.34;299.25;4.51;1181;15;2231.00;17
5332;14;621463241;5332;421;6551;6595;5.51;0.34;299.52;4.48;1219;15;2232.00;44
5335;14;621463263;5335;414;6553;6596;5.54;0.34;299.62;4.48;1218;15;2233.00;43
5337;14;621463279;5337;407;6556;6596;5.54;0.34;299.72;4.48;1219;15;2234.00;40
5340;14;621463293;5340;407;6557;6596;5.58;0.34;299.68;4.48;1217;15;2235.00;39
5348;14;621463308;5348;403;6557;6596;5.55;0.34;299.94;4.48;1209;15;2236.00;39
5352;14;621463324;5352;404;6557;6596;5.53;0.34;299.90;4.48;1205;15;2237.00;39
5358;14;621463339;5358;393;6557;6596;5.50;0.34;300.09;4.48;1199;15;2238.00;39
5361;14;621463354;5361;389;6557;6596;5.53;0.34;300.06;4.48;1196;15;2239.00;39
5365;14;621463368;5365;390;6557;6597;5.49;0.34;300.21;4.48;1192;15;2240.00;40
5369;14;621463401;5369;395;6558;6598;5.48;0.33;300.23;4.48;1189;15;2241.00;40
5373;14;621463417;5373;399;6559;6598;5.45;0.33;300.24;4.48;1186;15;2242.00;39
5374;14;621463433;5374;404;6565;6602;5.47;0.34;300.23;4.49;1191;15;2243.00;37
5377;14;621463450;5377;398;6566;6602;5.50;0.34;300.27;4.50;1189;15;2244.00;36
5379;14;621463467;5379;405;6567;6602;5.49;0.34;300.29;4.50;1188;15;2245.00;35
5383;14;621463483;5383;412;6568;6602;5.46;0.33;300.30;4.50;1185;15;2246.00;34
5387;14;621463498;5387;405;6572;6608;5.45;0.33;300.44;4.50;1185;15;2247.00;36
5390;14;621463513;5390;407;6572;6608;5.52;0.34;300.57;4.50;1182;15;2248.00;36
5391;14;621463529;5391;405;6573;6608;5.58;0.34;300.71;4.50;1182;15;2249.00;35
5394;14;621463548;5394;405;6577;6614;5.60;0.34;300.74;4.50;1183;15;2250.00;37
5395;14;621463568;5395;407;6579;6614;5.59;0.34;300.81;4.51;1184;15;2251.00;35
5399;14;621463587;5399;408;6579;6614;5.55;0.34;300.88;4.51;1180;15;2252.00;35
5400;14;621463604;5400;407;6581;6615;5.53;0.34;300.84;4.51;1181;15;2253.00;34
5403;14;621463623;5403;410;6581;6616;5.50;0.34;300.76;4.51;1178;15;2254.00;35
5406;14;621463640;5406;418;6583;6616;5.44;0.33;300.86;4.51;1177;15;2255.00;33
5408;14;621463661;5408;415;6591;6629;5.50;0.34;300.89;4.51;1183;15;2256.00;38
5413;14;621463678;5413;397;6592;6629;5.51;0.34;301.02;4.51;1179;15;2257.00;37
5415;14;621463694;5415;395;6594;6629;5.53;0.34;301.03;4.51;1179;15;2258.00;35
5417;14;621463710;5417;401;6594;6630;5.60;0.34;301.16;4.51;1177;15;2259.00;36
5422;14;621463726;5422;401;6595;6630;5.61;0.34;301.28;4.51;1173;15;2260.00;35
5423;14;621463742;5423;402;6600;6634;5.68;0.35;301.29;4.52;1177;15;2261.00;34
5426;14;621463758;5426;401;6602;6634;5.75;0.35;301.52;4.54;1176;15;2262.00;32
5429;14;621463775;5429;407;6605;6638;5.77;0.35;301.48;4.54;1176;15;2263.00;33
5433;14;621463791;5433;412;6608;6638;5.76;0.35;301.70;4.54;1175;15;2264.00;30
5433;14;621463807;5433;419;6609;6638;5.79;0.35;301.70;4.54;1176;15;2265.00;29
5437;14;621463831;5437;415;6609;6638;5.76;0.35;301.95;4.54;1172;15;2266.00;29
5441;14;621463849;5441;411;6610;6638;5.71;0.35;302.07;4.55;1169;15;2267.00;28
5443;14;621463873;5443;397;6617;6650;5.68;0.35;302.09;4.54;1174;15;2268.00;33
5446;14;621463898;5446;401;6618;6650;5.65;0.34;302.30;4.54;1172;15;2269.00;32
5450;14;621463914;5450;397;6621;6650;5.64;0.34;302.39;4.55;1171;15;2270.00;29
5452;14;621463931;5452;400;6622;6650;5.64;0.34;302.39;4.55;1170;15;2271.00;28
5455;14;621463948;5455;410;6623;6650;5.60;0.34;302.56;4.55;1168;15;2272.00;27
5458;14;621463965;5458;406;6624;6650;5.59;0.34;302.68;4.56;1166;15;2273.00;26
5462;14;621463990;5462;408;6625;6651;5.58;0.34;302.70;4.56;1163;15;2274.00;26
5463;14;621464007;5463;411;6626;6651;5.56;0.34;302.71;4.56;1163;15;2275.00;25
5465;14;621464022;5465;419;6631;6657;5.55;0.34;302.89;4.56;1166;16;2276.00;26
5466;14;621464049;5466;415;6632;6658;5.57;0.34;302.87;4.56;1166;16;2277.00;26
5469;14;621464064;5469;411;6632;6658;5.52;0.33;303.04;4.56;1163;16;2278.00;26
5472;14;621464080;5472;414;6632;6658;5.49;0.33;303.16;4.56;1160;16;2279.00;26
5475;14;621464096;5475;406;6635;6663;5.45;0.33;303.30;4.56;1160;16;2280.00;28
5477;14;621464111;5477;405;6636;6663;5.49;0.33;303.40;4.56;1159;16;2281.00;27
5479;14;621464125;5479;402;6636;6663;5.53;0.33;303.34;4.56;1157;16;2282.00;27
5482;14;621464139;5482;408;6637;6664;5.56;0.34;303.56;4.56;1155;16;2283.00;27
5485;14;621464153;5485;406;6640;6668;5.62;0.34;303.65;4.56;1155;16;2284.00;28
5490;14;621464169;5490;405;6640;6668;5.64;0.34;303.78;4.56;1150;16;2285.00;28
5493;14;621464185;5493;404;6642;6671;5.67;0.34;303.92;4.55;1149;16;2286.00;29
5496;14;621464200;5496;404;6642;6671;5.66;0.34;303.99;4.55;1146;16;2287.00;29
5499;14;621464213;5499;404;6643;6671;5.69;0.34;304.19;4.55;1144;16;2288.00;28
5500;14;621464226;5500;407;6643;6671;5.66;0.34;304.21;4.55;1143;16;2289.00;28
5504;14;621464238;5504;405;6647;6675;5.64;0.34;304.34;4.55;1143;16;2290.00;28
5505;14;621464251;5505;404;6647;6675;5.63;0.34;304.39;4.55;1142;16;2291.00;28
5507;14;621464264;5507;410;6647;6675;5.63;0.34;304.38;4.55;1140;16;2292.00;28
5510;14;621464276;5510;409;6647;6675;5.55;0.34;304.43;4.55;1137;16;2293.00;28
5514;14;621464288;5514;411;6648;6676;5.55;0.34;304.45;4.56;1134;16;2294.00;28
5518;14;621464301;5518;417;6650;6678;5.51;0.33;304.52;4.56;1132;16;2295.00;28
5522;14;621464320;5522;422;6650;6678;5.44;0.33;304.55;4.56;1128;16;2296.00;28
5523;14;621464333;5523;424;6651;6679;5.43;0.33;304.55;4.56;1128;16;2297.00;28
5524;14;621464348;5524;430;6651;6679;5.43;0.33;304.60;4.56;1127;16;2298.00;28
5525;14;621464366;5525;430;6651;6679;5.37;0.33;304.61;4.56;1126;16;2299.00;28
5525;14;621464380;5525;426;6651;6679;5.37;0.33;304.61;4.56;1126;16;2300.00;28
5527;14;621464399;5527;431;6651;6679;5.36;0.32;304.55;4.56;1124;16;2301.00;28
5528;14;621464412;5528;426;6651;6679;5.35;0.32;304.54;4.56;1123;16;2302.00;28
5529;14;621464424;5529;429;6651;6679;5.36;0.33;304.55;4.56;1122;16;2303.00;28
5532;14;621464437;5532;449;6726;6806;5.48;0.34;304.59;4.51;1194;16;2304.00;80
5535;14;621464459;5535;442;6726;6807;5.46;0.34;304.66;4.51;1191;16;2305.00;81
5536;14;621464473;5536;438;6734;6807;5.56;0.34;304.70;4.51;1198;16;2306.00;73
5537;14;621464485;5537;430;6736;6807;5.59;0.34;304.68;4.50;1199;16;2307.00;71
5538;14;621464498;5538;430;6742;6807;5.60;0.35;304.72;4.50;1204;16;2308.00;65
5540;14;621464510;5540;422;6745;6807;5.60;0.34;304.77;4.50;1205;16;2309.00;62
5544;14;621464524;5544;422;6747;6807;5.58;0.34;305.08;4.50;1203;16;2310.00;60
5547;14;621464537;5547;427;6750;6807;5.50;0.34;305.14;4.51;1203;16;2311.00;57
5549;14;621464550;5549;421;6752;6808;5.49;0.34;305.15;4.51;1203;16;2312.00;56
5552;14;621464562;5552;427;6755;6809;5.44;0.34;305.24;4.51;1203;16;2313.00;54
5557;14;621464575;5557;425;6759;6809;5.38;0.33;305.21;4.53;1202;16;2314.00;50
5560;14;621464589;5560;422;6762;6810;5.32;0.33;305.24;4.55;1202;16;2315.00;48
5561;14;621464603;5561;431;6765;6810;5.31;0.33;305.26;4.56;1204;16;2316.00;45
5562;14;621464616;5562;441;6768;6810;5.31;0.33;305.28;4.56;1206;16;2317.00;42
5565;14;621464628;5565;444;6769;6810;5.27;0.33;305.31;4.56;1204;16;2318.00;41
5570;14;621464641;5570;434;6773;6814;5.23;0.32;305.39;4.56;1203;16;2319.00;41
5573;14;621464654;5573;436;6775;6814;5.22;0.32;305.42;4.56;1202;16;2320.00;39
5576;14;621464666;5576;436;6775;6814;5.18;0.32;305.32;4.56;1199;16;2321.00;39
5580;14;621464682;5580;447;6777;6817;5.14;0.32;305.24;4.56;1197;16;2322.00;40
5585;14;621464703;5585;445;6778;6817;5.14;0.32;305.13;4.57;1193;16;2323.00;39
5587;14;621464724;5587;452;6779;6817;5.16;0.32;305.03;4.58;1192;16;2324.00;38
5587;14;621464743;5587;456;6784;6821;5.20;0.32;305.03;4.59;1197;16;2325.00;37
5590;14;621464762;5590;458;6785;6822;5.17;0.32;305.01;4.59;1195;16;2326.00;37
5593;14;621464781;5593;454;6786;6822;5.14;0.31;304.98;4.59;1193;16;2327.00;36
5594;14;621464795;5594;461;6788;6826;5.12;0.31;304.93;4.58;1194;16;2328.00;38
5596;14;621464808;5596;470;6789;6826;5.11;0.31;304.90;4.59;1193;16;2329.00;37
5596;14;621464821;5596;472;6790;6826;5.10;0.31;304.90;4.58;1194;16;2330.00;36
5599;14;621464835;5599;472;6791;6827;5.07;0.31;304.80;4.58;1192;16;2331.00;36
5599;14;621464849;5599;477;6791;6827;5.07;0.31;304.80;4.58;1192;16;2332.00;36
5602;14;621464862;5602;470;6796;6833;5.05;0.31;304.68;4.58;1194;16;2333.00;37
5605;14;621464876;5605;473;6796;6833;5.01;0.31;304.72;4.58;1191;16;2334.00;37
5605;14;621464889;5605;476;6796;6834;4.99;0.30;304.72;4.58;1191;16;2335.00;38
5606;14;621464902;5606;482;6796;6834;4.94;0.30;304.67;4.58;1190;16;2336.00;38
5606;14;621464914;5606;489;6797;6834;4.90;0.30;304.67;4.60;1191;16;2337.00;37
5608;14;621464928;5608;492;6797;6834;4.85;0.30;304.63;4.60;1189;16;2338.00;37
5608;14;621464949;5608;496;6797;6834;4.81;0.29;304.63;4.60;1189;16;2339.00;37
5610;14;621464963;5610;507;6821;6870;4.94;0.30;304.70;4.60;1211;16;2340.00;49
5612;14;621464981;5612;510;6824;6870;4.97;0.31;304.73;4.62;1212;16;2341.00;46
5613;14;621465001;5613;513;6827;6870;4.97;0.31;304.70;4.62;1214;16;2342.00;43
5613;14;621465038;5613;519;6829;6870;4.92;0.30;304.70;4.63;1216;16;2343.00;41
5615;14;621465055;5615;522;6831;6870;4.85;0.30;304.71;4.65;1216;16;2344.00;39
5616;14;621465083;5616;525;6832;6870;4.79;0.29;304.70;4.66;1216;16;2345.00;38
5616;14;621465111;5616;524;6837;6874;4.73;0.29;304.70;4.68;1221;16;2346.00;37
5619;14;621465124;5619;518;6838;6874;4.69;0.29;304.81;4.69;1219;16;2347.00;36
5619;14;621465140;5619;510;6842;6878;4.73;0.29;304.81;4.69;1223;16;2348.00;36
5620;14;621465154;5620;503;6844;6879;4.78;0.29;304.76;4.71;1224;16;2349.00;35
5622;14;621465169;5622;496;6845;6879;4.75;0.29;304.73;4.73;1223;16;2350.00;34
5623;14;621465182;5623;492;6845;6879;4.73;0.29;304.71;4.73;1222;16;2351.00;34
5625;14;621465196;5625;486;6855;6892;4.72;0.29;304.64;4.74;1230;16;2352.00;37
5626;14;621465212;5626;486;6856;6892;4.71;0.29;304.62;4.74;1230;16;2353.00;36
5627;14;621465225;5627;488;6858;6892;4.73;0.29;304.60;4.76;1231;16;2354.00;34
5629;14;621465240;5629;482;6859;6893;4.72;0.29;304.63;4.76;1230;16;2355.00;34
5633;15;621465263;5633;485;6861;6894;4.70;0.29;304.62;4.80;1228;17;2356.00;33
5635;15;621465294;5635;488;6863;6894;4.71;0.29;304.54;4.83;1228;17;2357.00;31
5636;15;621465317;5636;489;6865;6897;4.73;0.29;304.53;4.83;1229;17;2358.00;32
5637;15;621465337;5637;490;6867;6897;4.70;0.29;304.52;4.86;1230;17;2359.00;30
5638;15;621465351;5638;482;6868;6897;4.70;0.29;304.49;4.86;1230;17;2360.00;29
5640;15;621465368;5640;481;6870;6897;4.72;0.29;304.55;4.89;1230;17;2361.00;27
5643;15;621465382;5643;483;6876;6903;4.78;0.29;304.52;4.90;1233;17;2362.00;27
5643;15;621465397;5643;487;6876;6903;4.81;0.29;304.52;4.90;1233;17;2363.00;27
5646;15;621465409;5646;484;6877;6903;4.81;0.29;304.44;4.91;1231;17;2364.00;26
5647;15;621465422;5647;481;6877;6903;4.84;0.29;304.40;4.91;1230;17;2365.00;26
5648;15;621465435;5648;478;6882;6907;4.85;0.29;304.42;4.94;1234;17;2366.00;25
5648;15;621465448;5648;474;6883;6908;4.89;0.30;304.42;4.94;1235;17;2367.00;25
5650;15;621465462;5650;465;6883;6908;4.95;0.30;304.33;4.94;1233;17;2368.00;25
5653;15;621465476;5653;459;6887;6909;4.91;0.30;304.36;4.97;1234;17;2369.00;22
5655;15;621465491;5655;453;6888;6909;4.94;0.30;304.48;4.97;1233;17;2370.00;21
5658;15;621465504;5658;444;6888;6909;4.95;0.30;304.51;4.97;1230;17;2371.00;21
5661;15;621465516;5661;438;6890;6909;4.92;0.30;304.49;4.99;1229;17;2372.00;19
5663;15;621465529;5663;437;6890;6909;4.93;0.30;304.50;4.99;1227;17;2373.00;19
5667;15;621465541;5667;436;6890;6909;4.95;0.30;304.73;4.99;1223;17;2374.00;19
5671;15;621465554;5671;431;6892;6909;4.92;0.30;304.76;5.01;1221;17;2375.00;17
5672;15;621465569;5672;451;6945;6979;4.98;0.30;304.77;4.97;1273;17;2376.00;34
5678;15;621465588;5678;442;6947;6980;4.94;0.30;305.00;4.99;1269;17;2377.00;33
5680;15;621465603;5680;440;6949;6980;4.90;0.30;304.99;4.99;1269;17;2378.00;31
5682;15;621465617;5682;441;6954;6980;4.89;0.30;304.95;5.00;1272;17;2379.00;26
5684;15;621465630;5684;431;6955;6980;4.89;0.30;304.94;5.00;1271;17;2380.00;25
5687;15;621465643;5687;423;6955;6980;4.88;0.30;305.01;5.00;1268;17;2381.00;25
5689;15;621465657;5689;425;6955;6980;4.88;0.30;305.03;5.00;1266;17;2382.00;25
5691;15;621465672;5691;411;6958;6980;4.92;0.30;305.14;5.02;1267;17;2383.00;22
5697;15;621465685;5697;402;6959;6981;4.87;0.30;305.23;5.02;1262;17;2384.00;22
5703;15;621465698;5703;403;6962;6983;4.89;0.30;305.56;5.03;1259;17;2385.00;21
5707;15;621465721;5707;408;6963;6983;4.93;0.30;305.57;5.03;1256;17;2386.00;20
5713;15;621465734;5713;407;6966;6987;4.98;0.30;305.90;5.03;1253;17;2387.00;21
5715;15;621465747;5715;406;6967;6987;5.05;0.31;305.94;5.03;1252;17;2388.00;20
5719;15;621465760;5719;401;6969;6987;5.07;0.31;306.14;5.03;1250;17;2389.00;18
5722;15;621465775;5722;399;6970;6987;5.11;0.31;306.25;5.03;1248;17;2390.00;17
5726;15;621465789;5726;402;6974;6993;5.14;0.31;306.45;5.03;1248;17;2391.00;19
5731;15;621465803;5731;393;6975;6993;5.20;0.32;306.67;5.03;1244;17;2392.00;18
5735;15;621465817;5735;392;6975;6993;5.26;0.32;306.59;5.03;1240;17;2393.00;18
5740;15;621465831;5740;386;6976;6996;5.31;0.32;306.84;5.03;1236;17;2394.00;20
5743;15;621465845;5743;379;6977;6996;5.42;0.33;306.73;5.03;1234;17;2395.00;19
5747;15;621465858;5747;381;6977;6996;5.45;0.33;306.87;5.03;1230;17;2396.00;19
5751;16;621465872;5751;384;6977;6997;5.43;0.33;307.08;5.03;1226;18;2397.00;20
5755;16;621465900;5755;381;6977;6998;5.41;0.33;307.12;5.03;1222;18;2398.00;21
5757;16;621465914;5757;385;6977;6998;5.42;0.33;307.11;5.03;1220;18;2399.00;21
5760;16;621465930;5760;384;6998;7057;5.42;0.33;307.15;5.02;1238;18;2400.00;59
5760;16;621465955;5760;385;7000;7057;5.46;0.33;307.15;5.02;1240;18;2401.00;57
5764;16;621465969;5764;381;7003;7057;5.45;0.33;307.26;5.02;1239;18;2402.00;54
5769;16;621465983;5769;388;7004;7058;5.45;0.33;307.41;5.02;1235;18;2403.00;54
5771;16;621465999;5771;394;7006;7058;5.48;0.34;307.36;5.02;1235;18;2404.00;52
5777;16;621466013;5777;395;7009;7062;5.42;0.33;307.58;5.02;1232;18;2405.00;53
5780;16;621466028;5780;402;7012;7062;5.42;0.33;307.77;5.02;1232;18;2406.00;50
5786;16;621466048;5786;406;7015;7066;5.44;0.33;307.90;5.02;1229;18;2407.00;51
5791;16;621466062;5791;408;7017;7066;5.43;0.33;307.95;5.02;1226;18;2408.00;49
5795;16;621466076;5795;404;7017;7066;5.49;0.34;307.93;5.02;1222;18;2409.00;49
5800;16;621466092;5800;402;7018;7066;5.55;0.34;308.03;5.02;1218;18;2410.00;48
5803;16;621466109;5803;412;7020;7066;5.58;0.34;308.01;5.02;1217;18;2411.00;46
5806;16;621466124;5806;411;7026;7078;5.63;0.34;308.10;5.02;1220;18;2412.00;52
5810;16;621466139;5810;414;7026;7078;5.63;0.34;308.21;5.02;1216;18;2413.00;52
5814;16;621466153;5814;414;7029;7078;5.65;0.35;308.30;5.02;1215;18;2414.00;49
5817;17;621466168;5817;417;7029;7078;5.68;0.35;308.25;5.02;1212;19;2415.00;49
5821;17;621466192;5821;421;7030;7078;5.71;0.35;308.36;5.02;1209;19;2416.00;48
5825;17;621466206;5825;427;7033;7078;5.76;0.35;308.42;5.03;1208;19;2417.00;45
5828;17;621466221;5828;433;7033;7079;5.82;0.35;308.40;5.03;1205;19;2418.00;46
5836;17;621466236;5836;428;7034;7079;5.81;0.35;308.52;5.03;1198;19;2419.00;45
5837;17;621466251;5837;439;7043;7085;5.82;0.35;308.61;5.05;1206;19;2420.00;42
5840;17;621466266;5840;446;7044;7086;5.84;0.35;308.57;5.05;1204;19;2421.00;42
5843;17;621466280;5843;442;7044;7086;5.81;0.35;308.60;5.05;1201;19;2422.00;42
5846;17;621466295;5846;456;7047;7086;5.78;0.35;308.68;5.05;1201;19;2423.00;39
5848;17;621466328;5848;466;7047;7090;5.73;0.35;308.73;5.05;1199;19;2424.00;43
5853;17;621466342;5853;472;7050;7090;5.62;0.34;308.88;5.06;1197;19;2425.00;40
5855;17;621466355;5855;477;7052;7090;5.56;0.34;309.04;5.06;1197;19;2426.00;38
5857;17;621466374;5857;470;7053;7091;5.47;0.33;309.11;5.06;1196;19;2427.00;38
5861;17;621466394;5861;470;7057;7095;5.41;0.33;309.22;5.05;1196;19;2428.00;38
5861;17;621466414;5861;467;7058;7095;5.41;0.33;309.22;5.06;1197;19;2429.00;37
5866;17;621466429;5866;469;7063;7101;5.38;0.33;309.24;5.05;1197;19;2430.00;38
5869;17;621466444;5869;473;7063;7101;5.35;0.32;309.25;5.05;1194;19;2431.00;38
5870;17;621466458;5870;469;7064;7101;5.34;0.32;309.29;5.05;1194;19;2432.00;37
5872;17;621466472;5872;473;7064;7101;5.32;0.32;309.42;5.05;1192;19;2433.00;37
5877;17;621466485;5877;481;7068;7105;5.27;0.32;309.57;5.05;1191;19;2434.00;37
5877;17;621466504;5877;479;7069;7105;5.29;0.32;309.57;5.06;1192;19;2435.00;36
5880;17;621466519;5880;469;7069;7105;5.28;0.32;309.63;5.06;1189;19;2436.00;36
5883;17;621466533;5883;458;7069;7105;5.26;0.32;309.76;5.06;1186;19;2437.00;36
5885;17;621466546;5885;449;7069;7106;5.31;0.32;309.82;5.06;1184;19;2438.00;37
5888;17;621466559;5888;448;7071;7107;5.33;0.32;309.95;5.06;1183;19;2439.00;36
5891;17;621466573;5891;443;7071;7107;5.29;0.32;310.12;5.06;1180;19;2440.00;36
5892;17;621466587;5892;451;7073;7108;5.30;0.32;310.17;5.07;1181;19;2441.00;35
5898;17;621466601;5898;452;7073;7108;5.27;0.32;310.28;5.07;1175;19;2442.00;35
5901;17;621466615;5901;457;7073;7108;5.26;0.32;310.29;5.07;1172;19;2443.00;35
5903;17;621466628;5903;463;7073;7108;5.31;0.32;310.36;5.07;1170;19;2444.00;35
5906;17;621466642;5906;468;7073;7108;5.30;0.32;310.47;5.07;1167;19;2445.00;35
5909;17;621466655;5909;477;7073;7108;5.30;0.32;310.59;5.07;1164;19;2446.00;35
5910;17;621466668;5910;477;7074;7108;5.32;0.32;310.70;5.07;1164;19;2447.00;34
5912;17;621466683;5912;500;7139;7235;5.41;0.33;310.72;5.03;1227;19;2448.00;96
5917;17;621466706;5917;485;7140;7236;5.42;0.33;310.83;5.03;1223;19;2449.00;96
5919;17;621466721;5919;484;7146;7236;5.51;0.34;310.85;5.03;1227;19;2450.00;90
5923;17;621466734;5923;477;7149;7236;5.54;0.34;311.14;5.03;1226;19;2451.00;87
5925;17;621466748;5925;481;7156;7236;5.58;0.34;311.09;5.03;1231;19;2452.00;80
5926;17;621466761;5926;475;7161;7236;5.61;0.35;311.22;5.04;1235;19;2453.00;75
5929;17;621466775;5929;475;7165;7236;5.63;0.35;311.29;5.04;1236;19;2454.00;71
5933;17;621466788;5933;468;7168;7236;5.62;0.35;311.49;5.04;1235;19;2455.00;68
5935;17;621466801;5935;469;7170;7237;5.64;0.35;311.54;5.04;1235;19;2456.00;67
5937;17;621466815;5937;478;7176;7238;5.60;0.34;311.73;5.05;1239;19;2457.00;62
5938;17;621466829;5938;469;7177;7238;5.60;0.34;311.76;5.05;1239;19;2458.00;61
5941;17;621466842;5941;478;7181;7239;5.58;0.34;311.90;5.06;1240;19;2459.00;58
5944;17;621466862;5944;475;7184;7239;5.56;0.34;311.96;5.06;1240;19;2460.00;55
5947;17;621466879;5947;481;7186;7239;5.52;0.34;312.00;5.07;1239;19;2461.00;53
5950;17;621466898;5950;483;7188;7239;5.48;0.34;312.09;5.07;1238;19;2462.00;51
5951;17;621466912;5951;492;7193;7243;5.47;0.34;312.09;5.07;1242;19;2463.00;50
5954;17;621466925;5954;502;7195;7243;5.42;0.33;312.11;5.08;1241;19;2464.00;48
5956;17;621466939;5956;501;7196;7243;5.39;0.33;312.16;5.08;1240;19;2465.00;47
5961;17;621466952;5961;504;7199;7246;5.33;0.33;312.14;5.08;1238;19;2466.00;47
5962;17;621466967;5962;508;7199;7246;5.29;0.33;312.15;5.08;1237;19;2467.00;47
5963;17;621466989;5963;513;7201;7246;5.30;0.33;312.15;5.08;1238;19;2468.00;45
5966;17;621467010;5966;519;7204;7250;5.31;0.33;312.18;5.08;1238;19;2469.00;46
5968;17;621467031;5968;512;7207;7251;5.31;0.33;312.17;5.10;1239;19;2470.00;44
5969;17;621467061;5969;513;7208;7251;5.31;0.33;312.28;5.10;1239;19;2471.00;43
5972;17;621467080;5972;515;7211;7255;5.29;0.32;312.25;5.10;1239;19;2472.00;44
5974;17;621467099;5974;511;7213;7255;5.31;0.33;312.29;5.10;1239;19;2473.00;42
5976;17;621467115;5976;505;7213;7255;5.31;0.33;312.25;5.10;1237;19;2474.00;42
5978;17;621467128;5978;503;7215;7257;5.32;0.33;312.23;5.10;1237;19;2475.00;42
5980;17;621467150;5980;505;7215;7257;5.31;0.33;312.28;5.10;1235;19;2476.00;42
5983;17;621467164;5983;504;7220;7263;5.31;0.33;312.40;5.10;1237;19;2477.00;43
5989;17;621467179;5989;506;7220;7263;5.26;0.32;312.33;5.10;1231;19;2478.00;43
5991;17;621467194;5991;506;7220;7264;5.24;0.32;312.38;5.10;1229;19;2479.00;44
5996;17;621467208;5996;504;7220;7264;5.17;0.32;312.45;5.10;1224;19;2480.00;44
5999;17;621467223;5999;508;7220;7264;5.09;0.31;312.46;5.10;1221;19;2481.00;44
6002;17;621467237;6002;504;7220;7264;5.00;0.31;312.65;5.10;1218;19;2482.00;44
6005;17;621467250;6005;502;7220;7264;4.95;0.30;312.65;5.10;1215;19;2483.00;44
6005;17;621467264;6005;498;7229;7276;5.00;0.31;312.65;5.09;1224;19;2484.00;47
6007;17;621467277;6007;502;7232;7276;4.97;0.30;312.62;5.13;1225;19;2485.00;44
6012;17;621467292;6012;501;7233;7276;4.97;0.30;312.58;5.13;1221;19;2486.00;43
6014;17;621467305;6014;502;7233;7276;4.96;0.30;312.61;5.13;1219;19;2487.00;43
6017;17;621467318;6017;498;7233;7276;4.94;0.30;312.64;5.13;1216;19;2488.00;43
6022;17;621467331;6022;502;7233;7276;4.92;0.30;312.58;5.13;1211;19;2489.00;43
6026;17;621467345;6026;502;7236;7280;4.87;0.30;312.75;5.13;1210;19;2490.00;44
6030;17;621467358;6030;512;7236;7280;4.84;0.30;312.65;5.13;1206;19;2491.00;44
6033;17;621467371;6033;511;7240;7284;4.79;0.29;312.54;5.12;1207;19;2492.00;44
6036;17;621467391;6036;516;7240;7285;4.78;0.29;312.45;5.12;1204;19;2493.00;45
6036;17;621467405;6036;513;7241;7285;4.80;0.29;312.45;5.12;1205;19;2494.00;44
6037;17;621467417;6037;512;7241;7285;4.84;0.30;312.40;5.12;1204;19;2495.00;44
6040;17;621467430;6040;515;7251;7298;4.85;0.30;312.33;5.13;1211;19;2496.00;47
6042;17;621467443;6042;518;7251;7298;4.81;0.29;312.27;5.13;1209;19;2497.00;47
6047;17;621467462;6047;514;7251;7298;4.78;0.29;312.12;5.13;1204;19;2498.00;47
6048;17;621467476;6048;507;7252;7299;4.84;0.29;312.15;5.13;1204;19;2499.00;47
6052;17;621467490;6052;496;7252;7300;4.81;0.29;312.18;5.13;1200;19;2500.00;48
6053;17;621467507;6053;485;7252;7300;4.85;0.30;312.13;5.13;1199;19;2501.00;48
6055;17;621467521;6055;479;7256;7303;4.91;0.30;312.06;5.15;1201;19;2502.00;47
6057;17;621467534;6057;472;7257;7303;4.91;0.30;312.16;5.15;1200;19;2503.00;46
6059;17;621467547;6059;469;7259;7303;4.93;0.30;312.19;5.16;1200;19;2504.00;44
6060;17;621467560;6060;466;7259;7303;4.95;0.30;312.17;5.16;1199;19;2505.00;44
6061;17;621467579;6061;469;7264;7309;5.02;0.31;312.20;5.16;1203;19;2506.00;45
6062;17;621467595;6062;464;7265;7309;5.06;0.31;312.19;5.17;1203;19;2507.00;44
6062;17;621467609;6062;463;7265;7309;5.12;0.31;312.19;5.17;1203;19;2508.00;44
6065;17;621467623;6065;467;7265;7309;5.13;0.31;312.15;5.17;1200;19;2509.00;44
6066;17;621467636;6066;464;7270;7313;5.17;0.31;312.26;5.17;1204;19;2510.00;43
6067;17;621467651;6067;465;7272;7314;5.22;0.32;312.25;5.19;1205;19;2511.00;42
6067;17;621467666;6067;462;7273;7314;5.24;0.32;312.25;5.19;1206;19;2512.00;41
6069;17;621467678;6069;463;7274;7315;5.29;0.32;312.21;5.19;1205;19;2513.00;41
6071;17;621467699;6071;459;7275;7315;5.30;0.32;312.35;5.21;1204;19;2514.00;40
6073;17;621467712;6073;452;7275;7315;5.30;0.32;312.31;5.21;1202;19;2515.00;40
6073;17;621467726;6073;451;7275;7315;5.30;0.32;312.31;5.21;1202;19;2516.00;40
6075;17;621467738;6075;449;7275;7315;5.29;0.32;312.26;5.21;1200;19;2517.00;40
6076;17;621467751;6076;450;7276;7315;5.25;0.32;312.22;5.24;1200;19;2518.00;39
6079;17;621467764;6079;450;7276;7315;5.23;0.32;312.16;5.24;1197;19;2519.00;39
6082;17;621467794;6082;458;7343;7440;5.46;0.34;312.07;5.23;1261;19;2520.00;97
6086;17;621467859;6086;454;7345;7441;5.44;0.33;312.10;5.23;1259;19;2521.00;96
6087;17;621467880;6087;454;7358;7441;5.46;0.34;312.15;5.26;1271;19;2522.00;83
6089;17;621467898;6089;446;7364;7441;5.44;0.33;312.25;5.26;1275;19;2523.00;77
6089;17;621467915;6089;454;7369;7441;5.48;0.34;312.25;5.26;1280;19;2524.00;72
6091;17;621467931;6091;452;7372;7441;5.39;0.33;312.36;5.30;1281;19;2525.00;69
6095;17;621467957;6095;460;7378;7441;5.32;0.33;312.50;5.30;1283;19;2526.00;63
6096;17;621467973;6096;464;7380;7441;5.28;0.32;312.50;5.30;1284;19;2527.00;61
6099;17;621467989;6099;475;7387;7442;5.24;0.32;312.47;5.34;1288;19;2528.00;55
6100;17;621468006;6100;477;7391;7443;5.22;0.32;312.44;5.34;1291;19;2529.00;52
6102;17;621468027;6102;483;7394;7443;5.19;0.32;312.47;5.34;1292;19;2530.00;49
6104;17;621468043;6104;485;7399;7447;5.17;0.32;312.45;5.34;1295;19;2531.00;48
6104;17;621468059;6104;495;7400;7447;5.19;0.32;312.45;5.34;1296;19;2532.00;47
6105;17;621468074;6105;498;7400;7447;5.18;0.32;312.50;5.34;1295;19;2533.00;47
6107;17;621468093;6107;490;7400;7447;5.20;0.32;312.51;5.34;1293;19;2534.00;47
6110;17;621468109;6110;493;7405;7453;5.22;0.32;312.71;5.34;1295;19;2535.00;48
6112;17;621468124;6112;493;7405;7453;5.20;0.32;312.78;5.34;1293;19;2536.00;48
6114;17;621468140;6114;496;7406;7455;5.16;0.31;312.88;5.34;1292;19;2537.00;49
6115;17;621468156;6115;499;7408;7458;5.19;0.32;312.96;5.34;1293;19;2538.00;50
6117;17;621468173;6117;497;7409;7458;5.18;0.32;312.98;5.34;1292;19;2539.00;49
6121;17;621468188;6121;495;7409;7458;5.14;0.31;313.05;5.34;1288;19;2540.00;49
6124;17;621468205;6124;498;7409;7459;5.10;0.31;313.01;5.34;1285;19;2541.00;50
6125;17;621468222;6125;499;7410;7460;5.10;0.31;313.11;5.34;1285;19;2542.00;50
6127;17;621468236;6127;501;7410;7460;5.08;0.31;313.22;5.34;1283;19;2543.00;50
6129;17;621468251;6129;503;7421;7473;5.07;0.31;313.24;5.33;1292;19;2544.00;52
6132;17;621468267;6132;488;7421;7473;5.05;0.31;313.31;5.33;1289;19;2545.00;52
6135;17;621468282;6135;484;7421;7473;5.04;0.31;313.45;5.33;1286;19;2546.00;52
6138;17;621468296;6138;482;7422;7474;5.03;0.31;313.53;5.33;1284;19;2547.00;52
6141;17;621468312;6141;482;7422;7474;4.99;0.31;313.62;5.33;1281;19;2548.00;52
6146;17;621468329;6146;482;7425;7478;4.98;0.31;313.67;5.33;1279;19;2549.00;53
6148;17;621468348;6148;471;7428;7481;5.03;0.31;313.67;5.32;1280;19;2550.00;53
6151;17;621468363;6151;467;7432;7485;5.03;0.31;313.75;5.32;1281;19;2551.00;53
6152;17;621468379;6152;461;7432;7485;5.05;0.31;313.78;5.32;1280;19;2552.00;53
6156;17;621468394;6156;461;7432;7485;5.05;0.31;313.89;5.32;1276;19;2553.00;53
6160;17;621468410;6160;454;7433;7485;5.07;0.31;313.96;5.32;1273;19;2554.00;52
6163;17;621468426;6163;448;7433;7485;5.06;0.31;314.03;5.32;1270;19;2555.00;52
6169;17;621468442;6169;455;7444;7497;5.08;0.31;314.16;5.31;1275;19;2556.00;53
6173;17;621468458;6173;448;7444;7497;5.10;0.31;314.18;5.31;1271;19;2557.00;53
6177;17;621468473;6177;447;7444;7497;5.13;0.32;314.30;5.31;1267;19;2558.00;53
6181;17;621468488;6181;441;7444;7497;5.16;0.32;314.46;5.31;1263;19;2559.00;53
6184;17;621468504;6184;437;7444;7497;5.23;0.32;314.49;5.31;1260;19;2560.00;53
6188;17;621468519;6188;432;7444;7497;5.31;0.33;314.57;5.31;1256;19;2561.00;53
6189;17;621468536;6189;423;7444;7498;5.41;0.33;314.62;5.31;1255;19;2562.00;54
6194;17;621468552;6194;417;7444;7498;5.43;0.33;314.69;5.31;1250;19;2563.00;54
6199;17;621468568;6199;413;7449;7504;5.50;0.34;314.86;5.31;1250;19;2564.00;55
6203;17;621468585;6203;408;7451;7506;5.51;0.34;314.94;5.31;1248;19;2565.00;55
6207;17;621468601;6207;412;7451;7506;5.55;0.34;314.97;5.31;1244;19;2566.00;55
6211;17;621468619;6211;408;7451;7506;5.59;0.34;315.20;5.31;1240;19;2567.00;55
6216;17;621468638;6216;406;7454;7510;5.63;0.35;315.23;5.31;1238;19;2568.00;56
6218;17;621468656;6218;400;7454;7510;5.69;0.35;315.25;5.31;1236;19;2569.00;56
6225;17;621468672;6225;399;7454;7510;5.67;0.35;315.42;5.31;1229;19;2570.00;56
6232;17;621468689;6232;397;7455;7511;5.67;0.35;315.50;5.31;1223;19;2571.00;56
6234;17;621468704;6234;391;7458;7515;5.71;0.35;315.43;5.31;1224;19;2572.00;57
6242;17;621468721;6242;388;7458;7515;5.62;0.34;315.61;5.31;1216;19;2573.00;57
6248;17;621468739;6248;383;7461;7518;5.58;0.34;315.78;5.30;1213;19;2574.00;57
6252;17;621468758;6252;387;7461;7518;5.58;0.34;315.81;5.30;1209;19;2575.00;57
6260;17;621468775;6260;389;7461;7518;5.54;0.34;316.01;5.30;1201;19;2576.00;57
6262;17;621468791;6262;392;7461;7518;5.57;0.34;316.03;5.30;1199;19;2577.00;57
6269;17;621468807;6269;398;7465;7522;5.55;0.34;316.29;5.30;1196;19;2578.00;57
6273;17;621468823;6273;397;7465;7522;5.58;0.34;316.19;5.30;1192;19;2579.00;57
6277;17;621468840;6277;403;7465;7522;5.57;0.34;316.20;5.30;1188;19;2580.00;57
6281;17;621468857;6281;400;7465;7522;5.58;0.34;316.21;5.30;1184;19;2581.00;57
6283;17;621468872;6283;401;7465;7523;5.62;0.34;316.28;5.30;1182;19;2582.00;58
6290;17;621468889;6290;407;7466;7524;5.59;0.34;316.27;5.30;1176;19;2583.00;58
6292;17;621468904;6292;407;7466;7524;5.58;0.34;316.28;5.30;1174;19;2584.00;58
6294;17;621468920;6294;410;7467;7525;5.62;0.34;316.39;5.30;1173;19;2585.00;58
6298;17;621468936;6298;413;7467;7525;5.58;0.34;316.32;5.30;1169;19;2586.00;58
6303;17;621468951;6303;418;7467;7525;5.51;0.34;316.43;5.30;1164;19;2587.00;58
6307;17;621468966;6307;425;7467;7525;5.46;0.33;316.52;5.30;1160;19;2588.00;58
6312;17;621468979;6312;426;7467;7525;5.38;0.33;316.75;5.30;1155;19;2589.00;58
6316;17;621469006;6316;430;7467;7525;5.25;0.32;316.82;5.30;1151;19;2590.00;58
6318;17;621469028;6318;429;7467;7525;5.14;0.31;316.84;5.30;1149;19;2591.00;58
6322;17;621469053;6322;453;7537;7652;5.23;0.32;316.97;5.25;1215;19;2592.00;115
6325;17;621469086;6325;442;7539;7653;5.22;0.32;317.03;5.25;1214;19;2593.00;114
6327;17;621469108;6327;449;7546;7653;5.26;0.32;317.05;5.25;1219;19;2594.00;107
6330;17;621469125;6330;458;7546;7653;5.29;0.33;317.24;5.25;1216;19;2595.00;107
6333;17;621469142;6333;461;7550;7653;5.34;0.33;317.26;5.25;1217;19;2596.00;103
6336;17;621469160;6336;457;7551;7653;5.36;0.33;317.42;5.25;1215;19;2597.00;102
6340;17;621469177;6340;457;7554;7653;5.35;0.33;317.56;5.25;1214;19;2598.00;99
6342;17;621469195;6342;455;7557;7653;5.37;0.33;317.65;5.25;1215;19;2599.00;96
6344;17;621469214;6344;460;7560;7654;5.38;0.33;317.74;5.25;1216;19;2600.00;94
6346;17;621469242;6346;453;7564;7655;5.42;0.33;317.91;5.25;1218;19;2601.00;91
6346;17;621469264;6346;448;7567;7655;5.45;0.33;317.91;5.25;1221;19;2602.00;88
6348;17;621469283;6348;455;7571;7656;5.39;0.33;318.04;5.25;1223;19;2603.00;85
6351;17;621469302;6351;458;7574;7656;5.38;0.33;318.16;5.26;1223;19;2604.00;82
6356;17;621469320;6356;463;7576;7656;5.35;0.33;318.31;5.26;1220;19;2605.00;80
6358;17;621469338;6358;463;7578;7656;5.36;0.33;318.44;5.26;1220;19;2606.00;78
6361;17;621469360;6361;464;7582;7660;5.36;0.33;318.60;5.26;1221;19;2607.00;78
6365;17;621469378;6365;472;7585;7660;5.40;0.33;318.64;5.26;1220;19;2608.00;75
6367;17;621469399;6367;475;7588;7660;5.44;0.33;318.76;5.28;1221;19;2609.00;72
6370;17;621469428;6370;482;7592;7666;5.45;0.33;318.75;5.28;1222;19;2610.00;74
6373;17;621469454;6373;482;7593;7666;5.45;0.33;318.84;5.28;1220;19;2611.00;73
6374;17;621469473;6374;490;7595;7666;5.47;0.33;318.81;5.28;1221;19;2612.00;71
6374;17;621469490;6374;488;7599;7670;5.51;0.34;318.81;5.28;1225;19;2613.00;71
6376;17;621469508;6376;492;7600;7671;5.47;0.33;318.83;5.28;1224;19;2614.00;71
6377;17;621469526;6377;494;7601;7671;5.46;0.33;318.78;5.28;1224;19;2615.00;70
6382;17;621469545;6382;498;7605;7675;5.43;0.33;318.97;5.28;1223;19;2616.00;70
6384;17;621469563;6384;500;7605;7675;5.38;0.33;319.04;5.28;1221;19;2617.00;70
6387;17;621469581;6387;491;7605;7675;5.35;0.33;319.23;5.28;1218;19;2618.00;70
6391;17;621469599;6391;491;7606;7676;5.32;0.32;319.20;5.28;1215;19;2619.00;70
6393;17;621469618;6393;490;7606;7676;5.34;0.33;319.26;5.28;1213;19;2620.00;70
6397;17;621469636;6397;488;7611;7682;5.35;0.33;319.33;5.27;1214;19;2621.00;71
6397;17;621469654;6397;487;7611;7682;5.43;0.33;319.33;5.27;1214;19;2622.00;71
6399;17;621469673;6399;485;7611;7683;5.44;0.33;319.30;5.27;1212;19;2623.00;72
6399;17;621469693;6399;475;7611;7683;5.38;0.33;319.30;5.27;1212;19;2624.00;72
6402;17;621469711;6402;482;7611;7683;5.31;0.32;319.42;5.27;1209;19;2625.00;72
6406;17;621469730;6406;484;7611;7683;5.23;0.32;319.39;5.27;1205;19;2626.00;72
6406;17;621469749;6406;488;7611;7683;5.19;0.32;319.39;5.27;1205;19;2627.00;72
6407;17;621469771;6407;493;7621;7695;5.20;0.32;319.39;5.27;1214;19;2628.00;74
6408;17;621469788;6408;491;7623;7695;5.23;0.32;319.38;5.28;1215;19;2629.00;72
6409;17;621469811;6409;496;7623;7695;5.18;0.32;319.37;5.28;1214;19;2630.00;72
6410;17;621469827;6410;498;7623;7695;5.17;0.32;319.34;5.28;1213;19;2631.00;72
6414;17;621469842;6414;499;7623;7695;5.13;0.31;319.38;5.28;1209;19;2632.00;72
6416;17;621469865;6416;503;7623;7695;5.10;0.31;319.34;5.28;1207;19;2633.00;72
6417;17;621469884;6417;502;7626;7699;5.10;0.31;319.35;5.28;1209;19;2634.00;73
6420;17;621469903;6420;507;7626;7699;5.10;0.31;319.28;5.28;1206;19;2635.00;73
6422;17;621469920;6422;506;7630;7703;5.14;0.31;319.29;5.28;1208;19;2636.00;73
6423;17;621469939;6423;502;7631;7704;5.13;0.31;319.25;5.27;1208;19;2637.00;73
6427;17;621469956;6427;504;7631;7704;5.07;0.31;319.13;5.27;1204;19;2638.00;73
6429;17;621469975;6429;508;7631;7704;5.03;0.31;319.21;5.27;1202;19;2639.00;73
6430;17;621469995;6430;518;7654;7733;5.04;0.31;319.23;5.26;1224;19;2640.00;79
6434;17;621470015;6434;514;7654;7733;5.00;0.31;319.17;5.26;1220;19;2641.00;79
6436;17;621470031;6436;508;7656;7733;5.04;0.31;319.17;5.26;1220;19;2642.00;77
6438;17;621470049;6438;505;7657;7734;5.06;0.31;319.16;5.26;1219;19;2643.00;77
6442;17;621470064;6442;505;7657;7735;5.05;0.31;319.05;5.26;1215;19;2644.00;78
6444;17;621470078;6444;503;7657;7735;5.06;0.31;319.13;5.26;1213;19;2645.00;78
6446;17;621470092;6446;502;7659;7738;5.09;0.31;319.15;5.26;1213;19;2646.00;79
6449;17;621470107;6449;492;7659;7738;5.07;0.31;319.19;5.26;1210;19;2647.00;79
6452;17;621470122;6452;496;7660;7738;5.08;0.31;319.20;5.26;1208;19;2648.00;78
6455;17;621470138;6455;494;7661;7738;5.06;0.31;319.23;5.27;1206;19;2649.00;77
6460;17;621470152;6460;497;7666;7744;5.01;0.30;319.31;5.27;1206;19;2650.00;78
6463;17;621470167;6463;478;7666;7744;4.95;0.30;319.33;5.27;1203;19;2651.00;78
6467;17;621470181;6467;465;7666;7744;4.93;0.30;319.36;5.27;1199;19;2652.00;78
6468;17;621470195;6468;455;7666;7744;4.96;0.30;319.37;5.27;1198;19;2653.00;78
6473;17;621470208;6473;455;7669;7748;4.98;0.30;319.59;5.27;1196;19;2654.00;79
6475;17;621470224;6475;441;7673;7750;5.06;0.31;319.64;5.33;1198;19;2655.00;77
6477;17;621470247;6477;426;7673;7750;5.14;0.31;319.66;5.33;1196;19;2656.00;77
6480;17;621470262;6480;434;7674;7751;5.19;0.32;319.78;5.33;1194;19;2657.00;77
6484;17;621470295;6484;421;7674;7751;5.22;0.32;319.79;5.33;1190;19;2658.00;77
6486;17;621470310;6486;420;7674;7751;5.22;0.32;319.74;5.33;1188;19;2659.00;77
6488;17;621470325;6488;420;7674;7751;5.28;0.32;319.80;5.33;1186;19;2660.00;77
6489;17;621470342;6489;420;7674;7751;5.34;0.32;319.76;5.33;1185;19;2661.00;77
6491;17;621470359;6491;419;7674;7751;5.38;0.33;319.69;5.33;1183;19;2662.00;77
6493;17;621470375;6493;426;7674;7751;5.42;0.33;319.71;5.33;1181;19;2663.00;77
6494;17;621470392;6494;420;7710;7821;5.61;0.34;319.66;5.31;1216;19;2664.00;111
6496;17;621470414;6496;423;7710;7822;5.62;0.34;319.61;5.31;1214;19;2665.00;112
6499;17;621470431;6499;421;7719;7822;5.65;0.34;319.58;5.30;1220;19;2666.00;103
6499;17;621470447;6499;426;7721;7822;5.66;0.35;319.58;5.30;1222;19;2667.00;101
6503;17;621470472;6503;412;7724;7822;5.72;0.35;319.48;5.30;1221;19;2668.00;98
6503;17;621470488;6503;411;7726;7822;5.76;0.35;319.48;5.34;1223;19;2669.00;96
6504;17;621470505;6504;411;7728;7822;5.76;0.35;319.50;5.34;1224;19;2670.00;94
6506;17;621470520;6506;404;7730;7822;5.81;0.35;319.44;5.34;1224;19;2671.00;92
6508;17;621470543;6508;399;7731;7823;5.83;0.35;319.45;5.34;1223;19;2672.00;92
6512;17;621470559;6512;393;7733;7824;5.86;0.36;319.64;5.34;1221;19;2673.00;91
6515;17;621470576;6515;391;7734;7824;5.90;0.36;319.66;5.34;1219;19;2674.00;90
6518;17;621470594;6518;394;7740;7828;5.88;0.36;319.72;5.34;1222;19;2675.00;88
6518;17;621470609;6518;388;7743;7828;5.93;0.36;319.72;5.34;1225;19;2676.00;85
6521;17;621470625;6521;389;7745;7828;5.89;0.36;319.83;5.34;1224;19;2677.00;83
6525;17;621470642;6525;387;7746;7828;5.84;0.35;320.01;5.34;1221;19;2678.00;82
6526;17;621470660;6526;394;7752;7834;5.83;0.35;319.99;5.37;1226;19;2679.00;82
6528;17;621470677;6528;401;7752;7834;5.79;0.35;320.13;5.37;1224;19;2680.00;82
6530;17;621470693;6530;402;7752;7834;5.78;0.35;320.18;5.37;1222;19;2681.00;82
6532;17;621470708;6532;416;7754;7837;5.75;0.35;320.25;5.37;1222;19;2682.00;83
6533;17;621470724;6533;417;7756;7837;5.75;0.35;320.22;5.44;1223;19;2683.00;81
6535;17;621470740;6535;422;7757;7837;5.74;0.35;320.25;5.44;1222;19;2684.00;80
6537;17;621470755;6537;420;7760;7838;5.72;0.35;320.31;5.54;1223;19;2685.00;78
6540;17;621470772;6540;431;7761;7839;5.68;0.35;320.42;5.54;1221;19;2686.00;78
6541;17;621470788;6541;436;7761;7839;5.66;0.34;320.51;5.54;1220;19;2687.00;78
6543;17;621470804;6543;440;7773;7852;5.67;0.35;320.57;5.60;1230;19;2688.00;79
6544;17;621470820;6544;446;7774;7852;5.63;0.34;320.68;5.62;1230;19;2689.00;78
6545;17;621470837;6545;446;7776;7852;5.65;0.34;320.77;5.65;1231;19;2690.00;76
6547;17;621470854;6547;444;7778;7853;5.64;0.34;320.92;5.68;1231;19;2691.00;75
6548;17;621470868;6548;445;7779;7853;5.62;0.34;320.90;5.71;1231;19;2692.00;74
6554;17;621470885;6554;450;7783;7857;5.63;0.34;321.09;5.71;1229;19;2693.00;74
6557;17;621470901;6557;454;7785;7857;5.62;0.34;321.11;5.76;1228;19;2694.00;72
6561;17;621470917;6561;451;7788;7861;5.56;0.34;321.11;5.76;1227;19;2695.00;73
6563;17;621470933;6563;454;7790;7861;5.57;0.34;321.33;5.81;1227;19;2696.00;71
6565;17;621470948;6565;456;7790;7861;5.58;0.34;321.44;5.81;1225;19;2697.00;71
6568;17;621470963;6568;452;7792;7861;5.54;0.34;321.49;5.86;1224;19;2698.00;69
6572;17;621470978;6572;454;7792;7861;5.53;0.34;321.43;5.86;1220;19;2699.00;69
6574;17;621471010;6574;458;7818;7910;5.66;0.35;321.47;5.84;1244;19;2700.00;92
6576;17;621471050;6576;461;7821;7910;5.63;0.34;321.49;5.90;1245;19;2701.00;89
6579;17;621471073;6579;458;7824;7910;5.61;0.34;321.53;5.90;1245;19;2702.00;86
6583;17;621471094;6583;457;7826;7910;5.54;0.34;321.56;5.95;1243;19;2703.00;84
6584;17;621471114;6584;454;7828;7910;5.52;0.34;321.55;5.95;1244;19;2704.00;82
6585;17;621471140;6585;452;7830;7910;5.49;0.33;321.62;5.98;1245;19;2705.00;80
6587;17;621471157;6587;447;7831;7911;5.49;0.34;321.66;6.00;1244;19;2706.00;80
6589;17;621471176;6589;451;7832;7911;5.51;0.34;321.76;6.00;1243;19;2707.00;79
6592;17;621471198;6592;444;7838;7917;5.56;0.34;321.74;6.02;1246;19;2708.00;79
6593;17;621471217;6593;435;7840;7918;5.56;0.34;321.75;6.05;1247;19;2709.00;78
6595;17;621471235;6595;448;7840;7918;5.56;0.34;321.78;6.05;1245;19;2710.00;78
6600;17;621471253;6600;448;7843;7918;5.56;0.34;321.76;6.09;1243;19;2711.00;75
6606;17;621471272;6606;458;7846;7922;5.55;0.34;321.76;6.09;1240;19;2712.00;76
6607;17;621471290;6607;456;7847;7922;5.57;0.34;321.74;6.09;1240;19;2713.00;75
6612;17;621471308;6612;457;7847;7922;5.57;0.34;321.84;6.09;1235;19;2714.00;75
6619;17;621471325;6619;454;7848;7923;5.61;0.34;321.94;6.09;1229;19;2715.00;75
6620;17;621471346;6620;455;7851;7927;5.62;0.34;321.95;6.09;1231;19;2716.00;76
6623;17;621471364;6623;458;7852;7927;5.59;0.34;321.98;6.09;1229;19;2717.00;75
6627;17;621471383;6627;466;7855;7930;5.60;0.34;322.06;6.09;1228;19;2718.00;75
6630;17;621471399;6630;471;7855;7930;5.59;0.34;322.08;6.09;1225;19;2719.00;75
6635;17;621471414;6635;462;7856;7930;5.59;0.34;322.16;6.09;1221;19;2720.00;74
6642;17;621471434;6642;454;7856;7930;5.54;0.34;322.05;6.09;1214;19;2721.00;74
6646;17;621471453;6646;447;7859;7934;5.54;0.34;322.05;6.09;1213;19;2722.00;75
6648;17;621471467;6648;451;7861;7934;5.56;0.34;322.07;6.09;1213;19;2723.00;73
6653;17;621471481;6653;450;7861;7934;5.56;0.34;322.21;6.09;1208;19;2724.00;73
6656;17;621471495;6656;446;7861;7934;5.59;0.34;322.28;6.09;1205;19;2725.00;73
6658;17;621471514;6658;441;7861;7935;5.62;0.34;322.33;6.09;1203;19;2726.00;74
6664;17;621471530;6664;435;7862;7936;5.62;0.34;322.58;6.09;1198;19;2727.00;74
6666;17;621471544;6666;435;7863;7936;5.66;0.35;322.58;6.10;1197;19;2728.00;73
6668;17;621471558;6668;433;7865;7937;5.71;0.35;322.68;6.10;1197;19;2729.00;72
6671;17;621471573;6671;434;7865;7937;5.75;0.35;322.76;6.10;1194;19;2730.00;72
6675;17;621471587;6675;426;7867;7937;5.77;0.35;322.95;6.10;1192;19;2731.00;70
6679;17;621471602;6679;428;7867;7937;5.78;0.35;323.00;6.10;1188;19;2732.00;70
6685;17;621471616;6685;427;7867;7937;5.73;0.35;323.10;6.10;1182;19;2733.00;70
6688;17;621471631;6688;429;7867;7937;5.73;0.35;323.06;6.10;1179;19;2734.00;70
6693;17;621471646;6693;428;7868;7937;5.77;0.35;323.21;6.10;1175;19;2735.00;69
6698;17;621471659;6698;432;7934;8064;6.03;0.37;323.24;6.05;1236;19;2736.00;130
6701;17;621471684;6701;433;7939;8065;5.98;0.37;323.25;6.05;1238;19;2737.00;126
6704;17;621471700;6704;433;7945;8065;6.00;0.37;323.29;6.05;1241;19;2738.00;120
6708;17;621471714;6708;431;7948;8065;5.97;0.37;323.35;6.05;1240;19;2739.00;117
6711;17;621471729;6711;432;7953;8065;5.93;0.36;323.48;6.05;1242;19;2740.00;112
6715;17;621471744;6715;439;7956;8065;5.83;0.36;323.55;6.05;1241;19;2741.00;109
6719;17;621471759;6719;445;7958;8065;5.67;0.35;323.58;6.05;1239;19;2742.00;107
6725;17;621471774;6725;450;7962;8065;5.56;0.34;323.70;6.05;1237;19;2743.00;103
6728;17;621471789;6728;458;7965;8066;5.48;0.34;323.75;6.05;1237;19;2744.00;101
6730;17;621471803;6730;466;7968;8068;5.43;0.33;323.77;6.05;1238;19;2745.00;100
6733;17;621471819;6733;471;7968;8068;5.41;0.33;323.74;6.05;1235;19;2746.00;100
6737;17;621471839;6737;471;7971;8069;5.38;0.33;323.83;6.05;1234;19;2747.00;98
6740;17;621471854;6740;480;7972;8069;5.39;0.33;323.87;6.05;1232;19;2748.00;97
6744;17;621471869;6744;485;7976;8069;5.37;0.33;324.06;6.05;1232;19;2749.00;93
6746;17;621471884;6746;494;7976;8069;5.33;0.33;324.15;6.05;1230;19;2750.00;93
6750;17;621471899;6750;493;7982;8073;5.30;0.33;324.27;6.05;1232;19;2751.00;91
6754;17;621471914;6754;492;7983;8073;5.27;0.33;324.34;6.06;1229;19;2752.00;90
6758;17;621471928;6758;495;7985;8073;5.28;0.33;324.39;6.06;1227;19;2753.00;88
6763;17;621471942;6763;510;7987;8076;5.25;0.32;324.44;6.06;1224;19;2754.00;89
6770;17;621471957;6770;517;7990;8076;5.21;0.32;324.48;6.06;1220;19;2755.00;86
6775;17;621471973;6775;520;7991;8076;5.18;0.32;324.50;6.06;1216;19;2756.00;85
6778;17;621471987;6778;524;7995;8080;5.18;0.32;324.50;6.06;1217;19;2757.00;85
6784;17;621472001;6784;520;7997;8081;5.14;0.31;324.54;6.06;1213;19;2758.00;84
6788;17;621472016;6788;520;7997;8081;5.03;0.31;324.80;6.06;1209;19;2759.00;84
6790;17;621472031;6790;532;8002;8086;4.96;0.30;324.85;6.06;1212;19;2760.00;84
6793;17;621472045;6793;535;8003;8086;4.87;0.30;324.91;6.06;1210;19;2761.00;83
6796;17;621472058;6796;547;8004;8086;4.81;0.30;324.98;6.06;1208;19;2762.00;82
6800;17;621472071;6800;545;8005;8087;4.67;0.29;324.93;6.06;1205;19;2763.00;82
6802;17;621472084;6802;547;8005;8087;4.60;0.28;325.01;6.06;1203;19;2764.00;82
6807;17;621472097;6807;548;8010;8093;4.51;0.28;325.07;6.06;1203;19;2765.00;83
6808;17;621472110;6808;555;8010;8093;4.45;0.27;325.03;6.06;1202;19;2766.00;83
6810;17;621472123;6810;551;8010;8094;4.39;0.27;325.02;6.06;1200;19;2767.00;84
6812;17;621472136;6812;551;8010;8094;4.33;0.27;325.04;6.06;1198;19;2768.00;84
6816;17;621472149;6816;559;8010;8094;4.28;0.26;325.00;6.06;1194;19;2769.00;84
6818;17;621472161;6818;555;8010;8094;4.26;0.26;325.00;6.06;1192;19;2770.00;84
6819;17;621472174;6819;559;8010;8094;4.26;0.26;325.07;6.06;1191;19;2771.00;84
6822;17;621472186;6822;561;8020;8106;4.37;0.27;325.10;6.05;1198;19;2772.00;86
6825;17;621472200;6825;562;8021;8106;4.39;0.27;325.10;6.05;1196;19;2773.00;85
6826;17;621472213;6826;569;8021;8106;4.40;0.27;325.11;6.05;1195;19;2774.00;85
6831;17;621472225;6831;570;8021;8106;4.39;0.27;325.16;6.05;1190;19;2775.00;85
6833;17;621472238;6833;558;8021;8106;4.41;0.27;325.17;6.05;1188;19;2776.00;85
6835;17;621472251;6835;555;8021;8106;4.43;0.27;325.10;6.05;1186;19;2777.00;85
6839;17;621472264;6839;546;8024;8110;4.44;0.27;325.03;6.05;1185;19;2778.00;86
6841;17;621472277;6841;538;8024;8110;4.45;0.27;325.05;6.05;1183;19;2779.00;86
6845;17;621472295;6845;529;8028;8114;4.51;0.28;325.07;6.05;1183;19;2780.00;86
6846;17;621472309;6846;522;8029;8115;4.56;0.28;325.02;6.05;1183;19;2781.00;86
6847;17;621472322;6847;517;8029;8115;4.63;0.28;325.07;6.05;1182;19;2782.00;86
6848;17;621472335;6848;524;8029;8115;4.66;0.28;325.03;6.05;1181;19;2783.00;86
6850;17;621472348;6850;527;8040;8128;4.77;0.29;325.00;6.04;1190;19;2784.00;88
6852;17;621472362;6852;527;8040;8128;4.76;0.29;324.93;6.04;1188;19;2785.00;88
6852;17;621472375;6852;526;8040;8128;4.80;0.29;324.93;6.04;1188;19;2786.00;88
6856;17;621472387;6856;524;8041;8129;4.85;0.30;324.89;6.04;1185;19;2787.00;88
6861;17;621472401;6861;520;8041;8130;4.87;0.30;324.81;6.04;1180;19;2788.00;89
6863;17;621472415;6863;528;8041;8130;4.94;0.30;324.78;6.04;1178;19;2789.00;89
6864;17;621472431;6864;522;8045;8136;5.01;0.30;324.74;6.03;1181;19;2790.00;91
6866;17;621472447;6866;520;8045;8136;4.99;0.30;324.74;6.03;1179;19;2791.00;91
6868;17;621472460;6868;523;8047;8136;5.00;0.30;324.86;6.03;1179;19;2792.00;89
6872;17;621472474;6872;523;8047;8136;4.94;0.30;324.90;6.03;1175;19;2793.00;89
6874;17;621472486;6874;530;8052;8142;4.93;0.30;324.93;6.03;1178;19;2794.00;90
6878;17;621472499;6878;539;8052;8142;4.87;0.30;325.07;6.03;1174;19;2795.00;90
6879;17;621472512;6879;544;8052;8142;4.82;0.29;325.07;6.03;1173;19;2796.00;90
6879;17;621472525;6879;549;8052;8142;4.77;0.29;325.07;6.03;1173;19;2797.00;90
6880;17;621472537;6880;556;8055;8146;4.77;0.29;325.08;6.03;1175;19;2798.00;91
6883;17;621472549;6883;554;8056;8147;4.76;0.29;325.01;6.03;1173;19;2799.00;91
6884;17;621472563;6884;565;8056;8147;4.74;0.29;325.06;6.03;1172;19;2800.00;91
6887;17;621472579;6887;572;8057;8148;4.72;0.28;325.04;6.03;1170;19;2801.00;91
6888;17;621472592;6888;568;8057;8148;4.67;0.28;325.04;6.03;1169;19;2802.00;91
6888;17;621472604;6888;558;8057;8148;4.69;0.28;325.04;6.03;1169;19;2803.00;91
6889;17;621472617;6889;544;8057;8148;4.74;0.29;325.02;6.03;1168;19;2804.00;91
6890;17;621472629;6890;538;8057;8148;4.75;0.29;325.01;6.03;1167;19;2805.00;91
6890;17;621472643;6890;533;8057;8148;4.80;0.29;325.01;6.03;1167;19;2806.00;91
6891;17;621472656;6891;520;8057;8148;4.88;0.29;325.06;6.03;1166;19;2807.00;91
6891;17;621472668;6891;532;8096;8218;4.99;0.30;325.06;6.00;1205;19;2808.00;122
6892;17;621472687;6892;512;8096;8219;5.04;0.30;325.11;6.00;1204;19;2809.00;123
6892;17;621472705;6892;489;8103;8219;5.17;0.31;325.11;5.99;1211;19;2810.00;116
6893;17;621472719;6893;481;8107;8219;5.28;0.32;325.10;5.99;1214;19;2811.00;112
6893;17;621472732;6893;468;8109;8219;5.41;0.33;325.10;5.99;1216;19;2812.00;110
6893;17;621472746;6893;460;8112;8219;5.47;0.33;325.10;6.03;1219;19;2813.00;107
6893;17;621472759;6893;450;8114;8219;5.61;0.34;325.10;6.03;1221;19;2814.00;105
6895;17;621472778;6895;444;8117;8219;5.69;0.34;325.07;6.03;1222;19;2815.00;102
6896;17;621472791;6896;432;8120;8220;5.78;0.35;325.11;6.03;1224;19;2816.00;100
6897;17;621472805;6897;426;8122;8221;5.80;0.35;325.12;6.03;1225;19;2817.00;99
6897;17;621472819;6897;428;8124;8221;5.84;0.35;325.12;6.03;1227;19;2818.00;97
6897;17;621472833;6897;426;8128;8225;5.85;0.35;325.12;6.03;1231;19;2819.00;97
6899;17;621472848;6899;420;8129;8225;5.89;0.36;325.15;6.03;1230;19;2820.00;96
6900;17;621472862;6900;411;8129;8225;5.89;0.36;325.17;6.03;1229;19;2821.00;96
6900;17;621472875;6900;409;8129;8225;5.88;0.36;325.17;6.03;1229;19;2822.00;96
6903;17;621472889;6903;402;8134;8231;5.89;0.36;325.16;6.02;1231;19;2823.00;97
6904;17;621472903;6904;394;8134;8231;5.90;0.36;325.16;6.02;1230;19;2824.00;97
6907;17;621472918;6907;388;8135;8231;5.86;0.36;325.23;6.07;1228;19;2825.00;96
6909;17;621472933;6909;388;8137;8234;5.91;0.36;325.27;6.06;1228;19;2826.00;97
6910;17;621472947;6910;385;8138;8234;5.93;0.36;325.28;6.06;1228;19;2827.00;96
6912;17;621472962;6912;388;8139;8234;5.91;0.36;325.31;6.10;1227;19;2828.00;95
6913;17;621472977;6913;386;8139;8235;5.95;0.36;325.34;6.10;1226;19;2829.00;96
6914;17;621472994;6914;380;8141;8236;6.01;0.37;325.44;6.13;1227;19;2830.00;95
6917;17;621473016;6917;382;8141;8236;5.99;0.36;325.48;6.13;1224;19;2831.00;95
6921;17;621473049;6921;384;8151;8249;5.99;0.36;325.38;6.12;1230;19;2832.00;98
6924;17;621473072;6924;382;8153;8249;5.98;0.36;325.37;6.16;1229;19;2833.00;96
6926;17;621473092;6926;383;8153;8249;5.99;0.36;325.32;6.16;1227;19;2834.00;96
6928;17;621473109;6928;386;8155;8251;5.99;0.36;325.29;6.16;1227;19;2835.00;96
6931;17;621473141;6931;377;8155;8251;5.99;0.36;325.21;6.16;1224;19;2836.00;96
6933;17;621473156;6933;381;8159;8255;6.02;0.37;325.27;6.15;1226;19;2837.00;96
6936;17;621473172;6936;376;8159;8255;6.03;0.37;325.33;6.15;1223;19;2838.00;96
6938;17;621473189;6938;377;8162;8259;6.06;0.37;325.32;6.15;1224;19;2839.00;97
6941;17;621473204;6941;376;8162;8259;6.13;0.37;325.46;6.15;1221;19;2840.00;97
6943;17;621473218;6943;371;8162;8259;6.15;0.37;325.41;6.15;1219;19;2841.00;97
6947;17;621473233;6947;369;8162;8259;6.20;0.38;325.48;6.15;1215;19;2842.00;97
6950;17;621473248;6950;375;8162;8259;6.22;0.38;325.44;6.15;1212;19;2843.00;97
6953;17;621473262;6953;375;8172;8271;6.30;0.38;325.40;6.15;1219;19;2844.00;99
6955;17;621473285;6955;379;8173;8271;6.27;0.38;325.50;6.14;1218;19;2845.00;98
6958;17;621473301;6958;384;8173;8271;6.26;0.38;325.60;6.14;1215;19;2846.00;98
6960;17;621473315;6960;396;8173;8271;6.26;0.38;325.60;6.14;1213;19;2847.00;98
6964;17;621473336;6964;397;8174;8271;6.24;0.38;325.63;6.17;1210;19;2848.00;97
6967;17;621473351;6967;408;8174;8271;6.24;0.38;325.74;6.17;1207;19;2849.00;97
6968;17;621473367;6968;415;8176;8274;6.25;0.38;325.72;6.17;1208;19;2850.00;98
6970;17;621473384;6970;410;8178;8274;6.27;0.38;325.83;6.24;1208;19;2851.00;96
6975;17;621473399;6975;405;8183;8280;6.29;0.38;325.95;6.24;1208;19;2852.00;97
6976;17;621473414;6976;409;8185;8281;6.32;0.38;325.92;6.28;1209;19;2853.00;96
6979;17;621473428;6979;417;8186;8281;6.21;0.38;325.95;6.32;1207;19;2854.00;95
6983;17;621473442;6983;412;8187;8281;6.15;0.37;326.12;6.37;1204;19;2855.00;94
6983;17;621473465;6983;410;8192;8285;6.17;0.37;326.12;6.45;1209;19;2856.00;93
6984;17;621473480;6984;409;8192;8285;6.15;0.37;326.17;6.45;1208;19;2857.00;93
6986;17;621473496;6986;407;8192;8285;6.15;0.37;326.24;6.45;1206;19;2858.00;93
6987;17;621473512;6987;419;8195;8286;6.16;0.37;326.21;6.53;1208;19;2859.00;91
6989;17;621473530;6989;418;8198;8290;6.14;0.37;326.18;6.53;1209;19;2860.00;92
6989;17;621473547;6989;423;8198;8290;6.17;0.38;326.18;6.53;1209;19;2861.00;92
6991;17;621473562;6991;420;8201;8293;6.16;0.38;326.25;6.57;1210;19;2862.00;92
6993;17;621473580;6993;429;8202;8293;6.12;0.37;326.33;6.57;1209;19;2863.00;91
6995;17;621473595;6995;421;8205;8295;6.06;0.37;326.29;6.61;1210;19;2864.00;90
6998;17;621473610;6998;423;8205;8295;6.01;0.37;326.48;6.61;1207;19;2865.00;90
7002;17;621473625;7002;427;8209;8299;6.00;0.36;326.56;6.61;1207;19;2866.00;90
7004;17;621473640;7004;428;8211;8299;6.03;0.37;326.55;6.68;1207;19;2867.00;88
7006;17;621473655;7006;428;8211;8299;6.03;0.37;326.55;6.68;1205;19;2868.00;88
7009;17;621473669;7009;426;8213;8299;6.04;0.37;326.72;6.76;1204;19;2869.00;86
7013;17;621473683;7013;425;8213;8300;6.04;0.37;326.82;6.76;1200;19;2870.00;87
7015;17;621473697;7015;416;8216;8301;6.04;0.37;326.88;6.84;1201;19;2871.00;85
7017;17;621473712;7017;415;8216;8301;6.07;0.37;326.89;6.84;1199;19;2872.00;85
7019;17;621473725;7019;412;8217;8302;6.09;0.37;326.98;6.84;1198;19;2873.00;85
7021;17;621473739;7021;413;8219;8302;6.09;0.37;327.14;6.91;1198;19;2874.00;83
7024;17;621473752;7024;409;8219;8302;6.10;0.37;327.19;6.91;1195;19;2875.00;83
7025;17;621473766;7025;405;8221;8302;6.09;0.37;327.25;6.98;1196;19;2876.00;81
7029;17;621473779;7029;405;8221;8302;6.08;0.37;327.24;6.98;1192;19;2877.00;81
7031;17;621473795;7031;405;8221;8302;6.09;0.37;327.27;6.98;1190;19;2878.00;81
7034;17;621473809;7034;408;8223;8302;6.04;0.37;327.25;7.05;1189;19;2879.00;79
7037;17;621473824;7037;444;8320;8532;6.18;0.39;327.24;6.97;1283;19;2880.00;212
7042;17;621473858;7042;442;8325;8533;6.12;0.38;327.29;7.03;1283;19;2881.00;208
7046;17;621473872;7046;438;8335;8533;6.11;0.38;327.40;7.03;1289;19;2882.00;198
7048;17;621473886;7048;434;8340;8533;6.09;0.38;327.45;7.02;1292;19;2883.00;193
7052;17;621473900;7052;434;8350;8533;6.07;0.38;327.46;7.06;1298;19;2884.00;183
7056;17;621473915;7056;438;8357;8533;5.99;0.37;327.50;7.12;1301;19;2885.00;176
7058;17;621473930;7058;439;8365;8533;5.94;0.37;327.62;7.12;1307;19;2886.00;168
7060;17;621473944;7060;443;8371;8533;5.85;0.36;327.70;7.15;1311;19;2887.00;162
7066;17;621473958;7066;449;8377;8534;5.78;0.36;327.91;7.15;1311;19;2888.00;157
7070;17;621473973;7070;460;8381;8535;5.71;0.35;328.00;7.15;1311;19;2889.00;154
7071;17;621473989;7071;459;8390;8535;5.66;0.35;328.05;7.22;1319;19;2890.00;145
7077;17;621474004;7077;464;8393;8536;5.57;0.34;328.21;7.22;1316;19;2891.00;143
7080;17;621474018;7080;461;8397;8536;5.52;0.34;328.20;7.22;1317;19;2892.00;139
7083;17;621474033;7083;467;8402;8536;5.41;0.33;328.23;7.29;1319;19;2893.00;134
7087;17;621474047;7087;477;8405;8536;5.31;0.33;328.41;7.29;1318;19;2894.00;131
7093;17;621474060;7093;484;8413;8540;5.18;0.32;328.43;7.35;1320;19;2895.00;127
7095;17;621474075;7095;493;8414;8540;5.12;0.32;328.44;7.35;1319;19;2896.00;126
7096;17;621474088;7096;493;8419;8540;5.08;0.31;328.49;7.36;1323;19;2897.00;121
7099;17;621474102;7099;482;8421;8543;4.99;0.31;328.47;7.36;1322;19;2898.00;122
7103;17;621474121;7103;486;8422;8543;4.94;0.30;328.58;7.36;1319;19;2899.00;121
7105;17;621474135;7105;493;8426;8543;4.90;0.30;328.59;7.36;1321;19;2900.00;117
7109;17;621474153;7109;488;8432;8547;4.88;0.30;328.74;7.37;1323;19;2901.00;115
7114;17;621474168;7114;486;8434;8548;4.87;0.30;328.94;7.37;1320;19;2902.00;114
7116;17;621474182;7116;488;8435;8548;4.86;0.30;328.93;7.37;1319;19;2903.00;113
7118;17;621474196;7118;493;8439;8552;4.91;0.30;328.98;7.37;1321;19;2904.00;113
7126;17;621474211;7126;506;8440;8552;4.87;0.30;329.04;7.37;1314;19;2905.00;112
7127;17;621474225;7127;510;8442;8552;4.87;0.30;329.08;7.37;1315;19;2906.00;110
7132;17;621474239;7132;508;8444;8553;4.87;0.30;329.19;7.38;1312;19;2907.00;109
7135;17;621474254;7135;526;8445;8553;4.90;0.30;329.21;7.38;1310;19;2908.00;108
7142;17;621474268;7142;534;8452;8559;4.90;0.30;329.40;7.38;1310;19;2909.00;107
7145;17;621474284;7145;529;8453;8559;4.92;0.30;329.41;7.39;1308;19;2910.00;106
7152;17;621474298;7152;539;8453;8560;4.85;0.30;329.41;7.39;1301;19;2911.00;107
7154;17;621474312;7154;553;8455;8560;4.85;0.30;329.37;7.39;1301;19;2912.00;105
7161;17;621474325;7161;551;8455;8560;4.78;0.29;329.53;7.39;1294;19;2913.00;105
7164;17;621474339;7164;551;8456;8560;4.73;0.29;329.50;7.39;1292;19;2914.00;104
7170;17;621474352;7170;553;8457;8560;4.66;0.29;329.48;7.39;1287;19;2915.00;103
7172;17;621474370;7172;556;8466;8572;4.69;0.29;329.50;7.39;1294;19;2916.00;106
7178;17;621474385;7178;561;8468;8572;4.66;0.28;329.72;7.39;1290;19;2917.00;104
7185;17;621474398;7185;564;8468;8572;4.58;0.28;329.82;7.39;1283;19;2918.00;104
7189;17;621474412;7189;566;8470;8572;4.51;0.28;329.81;7.39;1281;19;2919.00;102
7192;17;621474425;7192;569;8470;8572;4.48;0.27;329.97;7.39;1278;19;2920.00;102
7197;17;621474438;7197;578;8470;8572;4.43;0.27;330.12;7.39;1273;19;2921.00;102
7200;17;621474452;7200;578;8474;8576;4.39;0.27;330.16;7.39;1274;19;2922.00;102
7204;17;621474465;7204;587;8474;8576;4.29;0.26;330.15;7.39;1270;19;2923.00;102
7207;17;621474479;7207;580;8477;8580;4.27;0.26;330.24;7.38;1270;19;2924.00;103
7209;17;621474505;7209;578;8481;8582;4.25;0.26;330.25;7.43;1272;19;2925.00;101
7215;17;621474519;7215;581;8481;8582;4.17;0.25;330.31;7.43;1266;19;2926.00;101
7220;17;621474532;7220;585;8481;8582;4.11;0.25;330.31;7.43;1261;19;2927.00;101
7223;17;621474545;7223;591;8491;8595;4.17;0.25;330.30;7.42;1268;19;2928.00;104
7225;17;621474559;7225;594;8491;8595;4.11;0.25;330.30;7.42;1266;19;2929.00;104
7228;17;621474571;7228;596;8491;8595;4.09;0.25;330.27;7.42;1263;19;2930.00;104
7232;17;621474584;7232;596;8492;8596;4.10;0.25;330.31;7.42;1260;19;2931.00;104
7235;17;621474597;7235;595;8492;8597;4.12;0.25;330.25;7.42;1257;19;2932.00;105
7236;17;621474610;7236;601;8492;8597;4.11;0.25;330.21;7.42;1256;19;2933.00;105
7240;17;621474622;7240;599;8494;8600;4.08;0.25;330.17;7.42;1254;19;2934.00;106
7242;17;621474635;7242;607;8495;8600;4.09;0.25;330.17;7.42;1253;19;2935.00;105
7244;17;621474648;7244;603;8495;8600;4.10;0.25;330.17;7.42;1251;19;2936.00;105
7247;17;621474660;7247;595;8495;8600;4.12;0.25;330.31;7.42;1248;19;2937.00;105
7248;17;621474673;7248;586;8500;8606;4.18;0.25;330.28;7.41;1252;19;2938.00;106
7250;17;621474687;7250;581;8500;8606;4.21;0.26;330.20;7.41;1250;19;2939.00;106
7255;17;621474701;7255;564;8500;8606;4.21;0.25;330.10;7.41;1245;19;2940.00;106
7256;17;621474714;7256;563;8500;8606;4.24;0.26;330.07;7.41;1244;19;2941.00;106
7258;17;621474727;7258;559;8503;8610;4.23;0.26;330.05;7.41;1245;19;2942.00;107
7259;17;621474740;7259;559;8505;8611;4.25;0.26;330.02;7.45;1246;19;2943.00;106
7260;17;621474753;7260;562;8505;8611;4.28;0.26;330.02;7.45;1245;19;2944.00;106
7264;17;621474765;7264;564;8506;8612;4.29;0.26;329.90;7.45;1242;19;2945.00;106
7266;17;621474778;7266;553;8506;8612;4.33;0.26;329.83;7.45;1240;19;2946.00;106
7267;17;621474791;7267;544;8507;8612;4.38;0.27;329.83;7.49;1240;19;2947.00;105
7269;17;621474804;7269;541;8507;8612;4.43;0.27;329.92;7.49;1238;19;2948.00;105
7272;17;621474817;7272;520;8507;8612;4.45;0.27;329.99;7.49;1235;19;2949.00;105
7273;17;621474830;7273;509;8507;8612;4.49;0.27;329.94;7.49;1234;19;2950.00;105
7274;17;621474843;7274;507;8507;8612;4.54;0.28;330.03;7.49;1233;19;2951.00;105
7278;17;621474856;7278;509;8539;8682;4.77;0.29;330.06;7.46;1261;19;2952.00;143
7279;17;621474874;7279;505;8539;8683;4.82;0.29;330.10;7.46;1260;19;2953.00;144
7280;17;621474887;7280;516;8546;8683;4.91;0.30;330.11;7.46;1266;19;2954.00;137
7282;17;621474900;7282;499;8547;8683;4.95;0.30;330.12;7.46;1265;19;2955.00;136
7282;17;621474914;7282;488;8551;8683;4.97;0.30;330.12;7.45;1269;19;2956.00;132
7286;17;621474927;7286;481;8551;8683;4.97;0.30;330.09;7.45;1265;20;2957.00;132
7286;17;621474950;7286;479;8553;8683;5.05;0.31;330.09;7.45;1267;20;2958.00;130
7287;17;621474964;7287;488;8556;8683;5.13;0.31;330.13;7.49;1269;20;2959.00;127
7288;17;621474978;7288;479;8557;8684;5.15;0.31;330.16;7.49;1269;20;2960.00;127
7289;17;621474998;7289;479;8562;8685;5.17;0.32;330.23;7.49;1273;20;2961.00;123
7291;17;621475030;7291;474;8562;8685;5.17;0.32;330.31;7.49;1271;20;2962.00;123
7291;17;621475054;7291;472;8567;8689;5.24;0.32;330.31;7.49;1276;20;2963.00;122
7293;17;621475075;7293;473;8569;8689;5.29;0.32;330.35;7.49;1276;20;2964.00;120
7295;17;621475098;7295;463;8570;8689;5.35;0.33;330.27;7.49;1275;20;2965.00;119
7300;17;621475114;7300;470;8571;8689;5.33;0.33;330.30;7.49;1271;20;2966.00;118
7301;17;621475138;7301;472;8575;8695;5.38;0.33;330.30;7.49;1274;20;2967.00;120
7302;17;621475153;7302;458;8576;8695;5.39;0.33;330.30;7.49;1274;20;2968.00;119
7302;17;621475176;7302;460;8576;8695;5.42;0.33;330.30;7.49;1274;20;2969.00;119
7304;17;621475193;7304;461;8580;8701;5.50;0.34;330.32;7.49;1276;20;2970.00;121
7306;17;621475209;7306;450;8580;8701;5.52;0.34;330.39;7.49;1274;20;2971.00;121
7307;17;621475224;7307;448;8583;8701;5.60;0.34;330.38;7.52;1276;20;2972.00;118
7309;17;621475239;7309;453;8583;8702;5.66;0.35;330.37;7.52;1274;20;2973.00;119
7309;17;621475253;7309;450;8584;8703;5.67;0.35;330.37;7.52;1275;20;2974.00;119
7309;17;621475268;7309;449;8584;8703;5.71;0.35;330.37;7.52;1275;20;2975.00;119
7311;17;621475282;7311;447;8593;8716;5.77;0.35;330.44;7.51;1282;20;2976.00;123
7316;17;621475298;7316;443;8593;8716;5.74;0.35;330.51;7.51;1277;20;2977.00;123
7318;17;621475314;7318;446;8593;8716;5.75;0.35;330.50;7.51;1275;20;2978.00;123
7319;17;621475328;7319;444;8594;8717;5.79;0.35;330.52;7.51;1275;20;2979.00;123
7322;17;621475344;7322;447;8594;8717;5.81;0.36;330.65;7.51;1272;20;2980.00;123
7327;18;621475358;7327;439;8597;8721;5.84;0.36;330.70;7.51;1270;21;2981.00;124
7332;18;621475383;7332;428;8597;8721;5.82;0.36;330.87;7.51;1265;21;2982.00;124
7334;18;621475399;7334;427;8600;8725;5.84;0.36;330.90;7.51;1266;21;2983.00;125
7335;18;621475418;7335;420;8601;8725;5.87;0.36;330.87;7.54;1266;21;2984.00;124
7337;18;621475432;7337;417;8601;8725;5.91;0.36;330.85;7.54;1264;21;2985.00;124
7342;18;621475447;7342;413;8601;8725;5.87;0.36;330.90;7.54;1259;21;2986.00;124
7343;18;621475462;7343;419;8601;8725;5.90;0.36;330.91;7.54;1258;21;2987.00;124
7346;18;621475477;7346;414;8611;8737;5.97;0.36;330.92;7.54;1265;21;2988.00;126
7348;18;621475493;7348;403;8612;8737;5.95;0.36;330.95;7.54;1264;21;2989.00;125
7350;18;621475507;7350;402;8613;8737;5.93;0.36;331.05;7.54;1263;21;2990.00;124
7353;18;621475522;7353;394;8613;8737;5.91;0.36;331.03;7.54;1260;21;2991.00;124
7358;18;621475539;7358;396;8613;8737;5.91;0.36;331.15;7.54;1255;21;2992.00;124
7361;18;621475554;7361;385;8613;8737;5.92;0.36;331.39;7.54;1252;21;2993.00;124
7364;18;621475569;7364;388;8615;8738;5.93;0.36;331.45;7.55;1251;21;2994.00;123
7366;18;621475584;7366;379;8617;8738;5.97;0.36;331.47;7.62;1251;21;2995.00;121
7369;18;621475602;7369;379;8621;8744;6.03;0.37;331.51;7.62;1252;21;2996.00;123
7373;18;621475618;7373;381;8622;8745;6.05;0.37;331.55;7.62;1249;21;2997.00;123
7374;18;621475634;7374;391;8622;8745;6.08;0.37;331.57;7.62;1248;21;2998.00;123
7380;18;621475650;7380;390;8622;8745;6.14;0.37;331.57;7.62;1242;21;2999.00;123
7382;18;621475669;7382;388;8627;8765;6.18;0.38;331.57;7.62;1245;21;3000.00;138
7384;18;621475694;7384;383;8627;8765;6.23;0.38;331.54;7.62;1243;21;3001.00;138
7387;18;621475710;7387;387;8627;8765;6.25;0.38;331.55;7.62;1240;21;3002.00;138
7391;18;621475725;7391;378;8628;8766;6.26;0.38;331.57;7.62;1237;21;3003.00;138
7397;18;621475741;7397;380;8631;8770;6.22;0.38;331.74;7.61;1234;21;3004.00;139
7399;18;621475757;7399;373;8633;8770;6.21;0.38;331.70;7.65;1234;21;3005.00;137
7400;18;621475772;7400;371;8637;8773;6.26;0.38;331.81;7.66;1237;21;3006.00;136
7404;18;621475789;7404;367;8638;8773;6.25;0.38;331.84;7.66;1234;21;3007.00;135
7406;18;621475804;7406;366;8640;8773;6.30;0.38;331.95;7.67;1234;21;3008.00;133
7409;18;621475819;7409;374;8643;8773;6.27;0.38;332.03;7.68;1234;21;3009.00;130
7412;18;621475834;7412;370;8645;8777;6.28;0.38;332.02;7.68;1233;21;3010.00;132
7416;18;621475851;7416;369;8648;8777;6.28;0.38;332.03;7.68;1232;21;3011.00;129
7418;18;621475866;7418;365;8650;8777;6.28;0.38;332.05;7.69;1232;21;3012.00;127
7421;18;621475882;7421;367;8651;8777;6.24;0.38;332.25;7.69;1230;21;3013.00;126
7422;18;621475898;7422;364;8654;8778;6.20;0.38;332.27;7.69;1232;21;3014.00;124
7425;18;621475912;7425;362;8656;8780;6.19;0.37;332.35;7.69;1231;21;3015.00;124
7428;18;621475928;7428;362;8656;8780;6.21;0.38;332.42;7.69;1228;21;3016.00;124
7431;18;621475943;7431;367;8659;8781;6.24;0.38;332.44;7.69;1228;21;3017.00;122
7435;18;621475959;7435;372;8659;8781;6.21;0.38;332.51;7.69;1224;21;3018.00;122
7437;18;621475974;7437;381;8659;8781;6.19;0.37;332.63;7.69;1222;21;3019.00;122
7440;18;621475990;7440;387;8660;8781;6.20;0.38;332.81;7.73;1220;21;3020.00;121
7442;18;621476006;7442;398;8660;8781;6.20;0.37;332.87;7.73;1218;21;3021.00;121
7445;18;621476020;7445;404;8661;8781;6.17;0.37;333.00;7.74;1216;21;3022.00;120
7447;18;621476035;7447;405;8663;8781;6.17;0.37;333.17;7.78;1216;21;3023.00;118
7448;18;621476050;7448;433;8726;8908;6.23;0.38;333.28;7.72;1278;21;3024.00;182
7451;18;621476072;7451;439;8729;8909;6.22;0.38;333.25;7.76;1278;21;3025.00;180
7454;18;621476087;7454;440;8736;8909;6.27;0.39;333.35;7.76;1282;21;3026.00;173
7455;18;621476106;7455;433;8739;8909;6.30;0.39;333.45;7.79;1284;21;3027.00;170
7459;18;621476120;7459;443;8749;8909;6.31;0.39;333.71;7.87;1290;21;3028.00;160
7460;18;621476135;7460;436;8753;8909;6.33;0.39;333.83;7.87;1293;21;3029.00;156
7461;18;621476150;7461;440;8758;8909;6.33;0.39;333.89;7.91;1297;21;3030.00;151
7466;18;621476164;7466;442;8761;8909;6.31;0.39;334.10;7.91;1295;21;3031.00;148
7467;18;621476179;7467;439;8765;8910;6.35;0.39;334.19;7.99;1298;21;3032.00;145
7471;18;621476194;7471;453;8771;8911;6.44;0.40;334.45;7.99;1300;21;3033.00;140
7476;18;621476209;7476;458;8775;8911;6.44;0.40;334.71;8.06;1299;21;3034.00;136
7480;18;621476223;7480;459;8779;8912;6.39;0.39;334.82;8.06;1299;21;3035.00;133
7483;18;621476238;7483;461;8781;8912;6.30;0.39;334.86;8.07;1298;21;3036.00;131
7486;18;621476253;7486;461;8784;8912;6.18;0.38;334.84;8.14;1298;21;3037.00;128
7492;18;621476267;7492;465;8784;8912;6.07;0.37;335.01;8.14;1292;21;3038.00;128
7493;18;621476282;7493;469;8791;8916;6.04;0.37;335.01;8.14;1298;21;3039.00;125
7495;18;621476296;7495;467;8795;8916;5.96;0.37;335.12;8.25;1300;21;3040.00;121
7501;18;621476310;7501;468;8797;8916;5.87;0.36;334.98;8.25;1296;21;3041.00;119
7505;18;621476325;7505;479;8800;8919;5.79;0.35;335.15;8.29;1295;21;3042.00;119
7507;18;621476340;7507;477;8801;8919;5.71;0.35;335.22;8.32;1294;21;3043.00;118
7509;18;621476354;7509;475;8802;8919;5.65;0.34;335.30;8.32;1293;21;3044.00;117
7511;18;621476368;7511;485;8806;8923;5.59;0.34;335.40;8.36;1295;21;3045.00;117
7514;18;621476382;7514;485;8809;8924;5.59;0.34;335.56;8.39;1295;21;3046.00;115
7517;18;621476396;7517;486;8811;8924;5.52;0.34;335.61;8.43;1294;21;3047.00;113
7518;18;621476409;7518;486;8815;8928;5.51;0.34;335.70;8.45;1297;21;3048.00;113
7524;18;621476423;7524;485;8816;8928;5.48;0.33;335.79;8.45;1292;21;3049.00;112
7526;18;621476436;7526;488;8817;8928;5.44;0.33;335.85;8.49;1291;21;3050.00;111
7527;18;621476450;7527;496;8820;8929;5.41;0.33;335.84;8.49;1293;21;3051.00;109
7529;18;621476463;7529;499;8821;8929;5.36;0.33;335.96;8.49;1292;21;3052.00;108
7532;18;621476482;7532;507;8826;8935;5.36;0.33;336.04;8.49;1294;21;3053.00;109
7537;18;621476495;7537;515;8826;8935;5.30;0.32;336.12;8.49;1289;21;3054.00;109
7543;18;621476508;7543;529;8826;8936;5.15;0.32;336.25;8.49;1283;21;3055.00;110
7550;18;621476521;7550;535;8827;8936;5.06;0.31;336.17;8.49;1277;21;3056.00;109
7553;18;621476534;7553;536;8827;8936;4.97;0.30;336.12;8.49;1274;21;3057.00;109
7556;18;621476547;7556;547;8827;8936;4.83;0.30;336.24;8.49;1271;21;3058.00;109
7559;18;621476560;7559;557;8827;8936;4.75;0.29;336.36;8.49;1268;21;3059.00;109
7561;18;621476573;7561;551;8852;8972;4.82;0.30;336.36;8.46;1291;21;3060.00;120
7564;18;621476588;7564;541;8853;8972;4.77;0.29;336.42;8.46;1289;21;3061.00;119
7568;18;621476601;7568;539;8856;8972;4.73;0.29;336.45;8.46;1288;21;3062.00;116
7571;18;621476614;7571;534;8856;8972;4.69;0.29;336.41;8.46;1285;21;3063.00;116
7573;18;621476627;7573;536;8857;8972;4.70;0.29;336.42;8.46;1284;21;3064.00;115
7580;18;621476639;7580;538;8857;8972;4.65;0.29;336.54;8.46;1277;21;3065.00;115
7585;18;621476652;7585;550;8861;8976;4.63;0.28;336.51;8.46;1276;21;3066.00;115
7586;18;621476667;7586;557;8861;8976;4.65;0.29;336.50;8.46;1275;21;3067.00;115
7589;18;621476680;7589;549;8865;8980;4.68;0.29;336.47;8.45;1276;21;3068.00;115
7592;18;621476698;7592;548;8866;8981;4.63;0.28;336.50;8.45;1274;21;3069.00;115
7596;18;621476711;7596;548;8866;8981;4.58;0.28;336.54;8.45;1270;21;3070.00;115
7598;18;621476724;7598;551;8866;8981;4.55;0.28;336.58;8.45;1268;21;3071.00;115
7599;18;621476737;7599;554;8876;8994;4.57;0.28;336.54;8.44;1277;21;3072.00;118
7601;18;621476751;7601;558;8876;8994;4.56;0.28;336.56;8.44;1275;21;3073.00;118
7607;18;621476764;7607;555;8876;8994;4.53;0.28;336.68;8.44;1269;21;3074.00;118
7610;18;621476777;7610;544;8877;8995;4.52;0.28;336.73;8.44;1267;21;3075.00;118
7614;18;621476790;7614;543;8877;8996;4.49;0.28;336.64;8.44;1263;21;3076.00;119
7617;18;621476803;7617;541;8877;8996;4.48;0.28;336.67;8.44;1260;21;3077.00;119
7624;18;621476816;7624;544;8879;8999;4.46;0.27;336.70;8.44;1255;21;3078.00;120
7630;18;621476829;7630;545;8880;8999;4.45;0.27;336.67;8.44;1250;21;3079.00;119
7632;18;621476842;7632;546;8880;8999;4.49;0.27;336.68;8.44;1248;21;3080.00;119
7636;18;621476855;7636;544;8880;8999;4.47;0.27;336.66;8.44;1244;21;3081.00;119
7639;18;621476868;7639;546;8884;9005;4.47;0.27;336.67;8.44;1245;21;3082.00;121
7643;18;621476881;7643;546;8884;9005;4.42;0.27;336.58;8.44;1241;21;3083.00;121
7646;18;621476895;7646;546;8884;9005;4.43;0.27;336.54;8.44;1238;21;3084.00;121
7651;18;621476908;7651;555;8884;9005;4.37;0.27;336.54;8.44;1233;21;3085.00;121
7655;18;621476921;7655;554;8889;9009;4.37;0.27;336.43;8.48;1234;21;3086.00;120
7659;18;621476935;7659;552;8890;9010;4.32;0.26;336.43;8.48;1231;21;3087.00;120
7661;18;621476948;7661;568;8890;9010;4.28;0.26;336.49;8.48;1229;21;3088.00;120
7664;18;621476961;7664;570;8892;9011;4.22;0.26;336.52;8.48;1228;21;3089.00;119
7667;18;621476976;7667;571;8892;9011;4.15;0.25;336.52;8.48;1225;21;3090.00;119
7668;18;621476989;7668;575;8892;9011;4.13;0.25;336.48;8.48;1224;21;3091.00;119
7675;18;621477006;7675;577;8892;9011;4.05;0.25;336.47;8.48;1217;21;3092.00;119
7677;18;621477037;7677;579;8892;9011;4.00;0.25;336.47;8.48;1215;21;3093.00;119
7679;18;621477057;7679;588;8892;9011;3.96;0.24;336.51;8.48;1213;21;3094.00;119
7681;18;621477075;7681;589;8892;9011;3.91;0.24;336.49;8.48;1211;21;3095.00;119
7684;18;621477093;7684;606;8930;9081;4.03;0.25;336.57;8.44;1246;21;3096.00;151
7685;18;621477114;7685;604;8931;9082;4.00;0.25;336.54;8.44;1246;21;3097.00;151
7689;18;621477128;7689;608;8938;9082;3.99;0.25;336.52;8.43;1249;21;3098.00;144
7691;18;621477142;7691;601;8939;9082;3.96;0.24;336.52;8.43;1248;21;3099.00;143
7695;18;621477157;7695;604;8943;9082;3.98;0.24;336.58;8.43;1248;21;3100.00;139
7696;18;621477175;7696;605;8944;9082;4.03;0.25;336.64;8.43;1248;21;3101.00;138
7699;18;621477189;7699;608;8947;9082;4.01;0.25;336.64;8.43;1248;21;3102.00;135
7701;18;621477203;7701;611;8950;9082;3.99;0.24;336.60;8.43;1249;21;3103.00;132
7702;18;621477218;7702;617;8952;9083;3.96;0.24;336.62;8.43;1250;21;3104.00;131
7703;18;621477230;7703;616;8956;9085;3.91;0.24;336.63;8.43;1253;21;3105.00;129
7707;18;621477243;7707;625;8960;9085;3.82;0.23;336.64;8.47;1253;21;3106.00;125
7707;18;621477255;7707;608;8964;9089;3.84;0.23;336.64;8.47;1257;21;3107.00;125
7709;18;621477269;7709;604;8965;9089;3.88;0.24;336.61;8.47;1256;21;3108.00;124
7710;18;621477282;7710;598;8965;9089;3.93;0.24;336.66;8.47;1255;21;3109.00;124
7710;18;621477295;7710;601;8965;9089;3.97;0.24;336.66;8.47;1255;21;3110.00;124
7712;18;621477308;7712;597;8970;9095;4.09;0.25;336.73;8.47;1258;21;3111.00;125
7714;18;621477322;7714;582;8970;9095;4.15;0.25;336.66;8.47;1256;21;3112.00;125
7714;18;621477343;7714;577;8970;9095;4.21;0.26;336.66;8.47;1256;21;3113.00;125
7715;18;621477363;7715;582;8972;9098;4.26;0.26;336.68;8.46;1257;21;3114.00;126
7717;18;621477377;7717;576;8972;9098;4.31;0.26;336.74;8.46;1255;21;3115.00;126
7718;18;621477392;7718;553;8973;9098;4.37;0.27;336.72;8.46;1255;21;3116.00;125
7718;18;621477407;7718;540;8973;9099;4.47;0.27;336.72;8.46;1255;21;3117.00;126
7722;18;621477422;7722;526;8974;9100;4.58;0.28;336.69;8.46;1252;21;3118.00;126
7722;18;621477437;7722;513;8974;9100;4.63;0.28;336.69;8.46;1252;21;3119.00;126
7723;18;621477454;7723;507;8993;9126;4.84;0.30;336.68;8.44;1270;21;3120.00;133
7726;18;621477477;7726;491;8993;9126;4.89;0.30;336.59;8.44;1267;21;3121.00;133
7727;18;621477499;7727;482;8996;9126;4.96;0.30;336.55;8.49;1269;21;3122.00;130
7729;18;621477515;7729;478;8998;9127;5.04;0.31;336.52;8.48;1269;21;3123.00;129
7730;18;621477530;7730;480;8998;9127;5.10;0.31;336.51;8.48;1268;21;3124.00;129
7730;18;621477546;7730;477;9003;9131;5.14;0.31;336.51;8.52;1273;21;3125.00;128
7730;18;621477562;7730;473;9003;9131;5.19;0.32;336.51;8.52;1273;21;3126.00;128
7731;18;621477576;7731;472;9006;9135;5.22;0.32;336.58;8.52;1275;21;3127.00;129
7733;18;621477593;7733;463;9006;9135;5.23;0.32;336.55;8.52;1273;21;3128.00;129
7734;18;621477609;7734;460;9007;9135;5.28;0.32;336.53;8.55;1273;21;3129.00;128
7738;18;621477627;7738;458;9007;9135;5.36;0.33;336.57;8.55;1269;21;3130.00;128
7742;18;621477645;7742;454;9007;9135;5.44;0.33;336.56;8.55;1265;21;3131.00;128
7744;18;621477660;7744;450;9016;9147;5.53;0.34;336.53;8.55;1272;21;3132.00;131
7747;18;621477686;7747;450;9016;9147;5.55;0.34;336.56;8.55;1269;21;3133.00;131
7749;18;621477702;7749;440;9018;9147;5.58;0.34;336.65;8.54;1269;21;3134.00;129
7752;18;621477719;7752;437;9018;9147;5.61;0.34;336.69;8.54;1266;21;3135.00;129
7753;18;621477734;7753;428;9018;9147;5.69;0.35;336.68;8.54;1265;21;3136.00;129
7754;18;621477749;7754;430;9018;9147;5.74;0.35;336.72;8.54;1264;21;3137.00;129
7759;18;621477765;7759;424;9018;9148;5.72;0.35;336.74;8.54;1259;21;3138.00;130
7761;18;621477780;7761;414;9018;9148;5.74;0.35;336.87;8.54;1257;21;3139.00;130
7765;18;621477795;7765;407;9023;9154;5.80;0.35;336.83;8.54;1258;21;3140.00;131
7769;18;621477813;7769;406;9024;9155;5.83;0.35;336.97;8.54;1255;21;3141.00;131
7770;18;621477828;7770;409;9025;9155;5.86;0.36;336.94;8.57;1255;21;3142.00;130
7771;18;621477848;7771;410;9025;9155;5.88;0.36;336.95;8.57;1254;21;3143.00;130
7774;18;621477864;7774;416;9028;9159;5.91;0.36;337.10;8.56;1254;21;3144.00;131
7774;18;621477880;7774;423;9028;9159;5.96;0.36;337.10;8.56;1254;21;3145.00;131
7777;18;621477895;7777;420;9028;9159;5.94;0.36;337.25;8.56;1251;21;3146.00;131
7778;18;621477916;7778;414;9029;9160;5.93;0.36;337.29;8.56;1251;21;3147.00;131
7781;18;621477937;7781;418;9033;9164;5.87;0.36;337.29;8.59;1252;21;3148.00;131
7782;18;621477953;7782;423;9033;9164;5.84;0.36;337.33;8.59;1251;21;3149.00;131
7784;18;621477971;7784;418;9038;9170;5.91;0.36;337.39;8.62;1254;21;3150.00;132
7787;18;621477986;7787;415;9038;9170;5.96;0.36;337.40;8.62;1251;21;3151.00;132
7790;18;621478003;7790;410;9040;9170;6.00;0.37;337.60;8.61;1250;21;3152.00;130
7792;18;621478019;7792;410;9040;9170;6.06;0.37;337.66;8.61;1248;21;3153.00;130
7795;18;621478034;7795;408;9044;9174;6.13;0.37;337.71;8.61;1249;21;3154.00;130
7797;18;621478050;7797;403;9044;9174;6.13;0.37;337.75;8.61;1247;21;3155.00;130
7800;18;621478065;7800;404;9044;9174;6.14;0.37;337.86;8.61;1244;21;3156.00;130
7804;19;621478079;7804;394;9044;9174;6.12;0.37;337.87;8.61;1240;22;3157.00;130
7805;19;621478104;7805;398;9044;9175;6.16;0.37;337.95;8.61;1239;22;3158.00;131
7809;19;621478119;7809;390;9045;9176;6.19;0.37;337.93;8.61;1236;22;3159.00;131
7811;19;621478133;7811;391;9045;9176;6.18;0.37;338.00;8.61;1234;22;3160.00;131
7816;19;621478148;7816;383;9046;9177;6.11;0.37;338.13;8.61;1230;22;3161.00;131
7820;19;621478162;7820;370;9046;9177;6.07;0.37;338.34;8.61;1226;22;3162.00;131
7823;19;621478177;7823;373;9046;9177;6.10;0.37;338.37;8.61;1223;22;3163.00;131
7830;19;621478197;7830;370;9046;9177;6.05;0.37;338.46;8.61;1216;22;3164.00;131
7832;19;621478211;7832;369;9048;9177;6.04;0.37;338.50;8.70;1216;22;3165.00;129
7837;19;621478227;7837;369;9048;9177;6.03;0.37;338.53;8.70;1211;22;3166.00;129
7841;19;621478242;7841;375;9048;9177;6.03;0.37;338.66;8.70;1207;22;3167.00;129
7848;19;621478256;7848;396;9118;9304;6.15;0.38;338.76;8.64;1270;22;3168.00;186
7850;19;621478280;7850;384;9119;9305;6.17;0.38;338.77;8.63;1269;22;3169.00;186
7854;19;621478295;7854;374;9126;9305;6.20;0.38;338.68;8.63;1272;22;3170.00;179
7855;19;621478310;7855;379;9128;9305;6.23;0.38;338.72;8.63;1273;22;3171.00;177
7857;19;621478324;7857;382;9135;9305;6.27;0.38;338.67;8.62;1278;22;3172.00;170
7860;19;621478339;7860;379;9137;9305;6.29;0.39;338.72;8.62;1277;22;3173.00;168
7862;19;621478353;7862;373;9140;9305;6.30;0.39;338.71;8.62;1278;22;3174.00;165
7864;19;621478367;7864;374;9142;9305;6.32;0.39;338.73;8.62;1278;22;3175.00;163
7865;20;621478382;7865;381;9144;9306;6.37;0.39;338.75;8.62;1279;23;3176.00;162
7868;20;621478413;7868;382;9149;9307;6.41;0.39;338.83;8.62;1281;23;3177.00;158
7871;20;621478428;7871;383;9152;9307;6.39;0.39;338.92;8.62;1281;23;3178.00;155
7874;20;621478442;7874;381;9152;9308;6.37;0.39;338.98;8.62;1278;23;3179.00;156
7877;20;621478458;7877;383;9159;9308;6.30;0.39;339.12;8.63;1282;23;3180.00;149
7877;20;621478474;7877;380;9161;9308;6.27;0.38;339.12;8.63;1284;23;3181.00;147
7879;20;621478488;7879;388;9161;9308;6.19;0.38;339.15;8.63;1282;23;3182.00;147
7880;20;621478502;7880;395;9166;9312;6.18;0.38;339.20;8.62;1286;23;3183.00;146
7882;20;621478522;7882;395;9166;9312;6.11;0.38;339.21;8.62;1284;23;3184.00;146
7882;20;621478537;7882;394;9167;9312;6.06;0.37;339.21;8.62;1285;23;3185.00;145
7887;20;621478551;7887;398;9170;9315;6.05;0.37;339.25;8.62;1283;23;3186.00;145
7891;20;621478594;7891;401;9170;9315;6.02;0.37;339.32;8.62;1279;23;3187.00;145
7894;20;621478609;7894;401;9170;9315;5.97;0.37;339.34;8.62;1276;23;3188.00;145
7900;20;621478623;7900;408;9174;9319;5.91;0.36;339.40;8.62;1274;23;3189.00;145
7902;20;621478639;7902;415;9178;9320;5.90;0.36;339.49;8.72;1276;23;3190.00;142
7905;20;621478653;7905;415;9181;9322;5.88;0.36;339.67;8.72;1276;23;3191.00;141
7907;20;621478668;7907;413;9186;9326;5.89;0.36;339.82;8.76;1279;23;3192.00;140
7908;20;621478684;7908;420;9187;9326;5.89;0.36;339.84;8.76;1279;23;3193.00;139
7911;20;621478698;7911;432;9187;9326;5.91;0.36;340.01;8.76;1276;23;3194.00;139
7915;20;621478713;7915;435;9190;9328;5.90;0.36;340.14;8.81;1275;23;3195.00;138
7918;20;621478728;7918;443;9190;9328;5.94;0.36;340.24;8.81;1272;23;3196.00;138
7921;20;621478743;7921;447;9197;9334;5.98;0.37;340.30;8.89;1276;23;3197.00;137
7924;20;621478758;7924;459;9197;9334;5.94;0.36;340.54;8.89;1273;23;3198.00;137
7927;20;621478772;7927;470;9198;9335;5.88;0.36;340.63;8.94;1271;23;3199.00;137
7929;20;621478787;7929;477;9199;9335;5.81;0.36;340.78;8.98;1270;23;3200.00;136
7932;20;621478804;7932;478;9199;9335;5.75;0.35;340.91;8.98;1267;23;3201.00;136
7934;20;621478819;7934;485;9199;9335;5.68;0.35;341.08;8.98;1265;23;3202.00;136
7937;20;621478833;7937;500;9200;9335;5.62;0.34;341.10;9.03;1263;23;3203.00;135
7940;20;621478847;7940;508;9210;9347;5.61;0.34;341.30;9.02;1270;23;3204.00;137
7942;20;621478862;7942;512;9211;9347;5.53;0.34;341.43;9.06;1269;23;3205.00;136
7948;20;621478875;7948;518;9212;9347;5.47;0.33;341.52;9.06;1264;23;3206.00;135
7952;20;621478889;7952;522;9213;9347;5.41;0.33;341.58;9.11;1261;23;3207.00;134
7954;20;621478903;7954;525;9213;9347;5.35;0.33;341.54;9.11;1259;23;3208.00;134
7958;20;621478916;7958;526;9214;9347;5.27;0.32;341.62;9.15;1256;23;3209.00;133
7960;20;621478936;7960;543;9217;9351;5.23;0.32;341.68;9.15;1257;23;3210.00;134
7963;20;621478950;7963;535;9217;9351;5.18;0.32;341.83;9.15;1254;23;3211.00;134
7964;20;621478963;7964;531;9223;9355;5.23;0.32;341.83;9.23;1259;23;3212.00;132
7968;20;621478978;7968;528;9224;9356;5.20;0.32;341.97;9.23;1256;23;3213.00;132
7971;20;621478991;7971;524;9224;9356;5.17;0.31;342.13;9.23;1253;23;3214.00;132
7972;20;621479010;7972;520;9226;9356;5.19;0.31;342.10;9.31;1254;23;3215.00;130
7974;20;621479031;7974;517;9237;9369;5.17;0.31;342.13;9.30;1263;23;3216.00;132
7977;20;621479056;7977;513;9237;9369;5.13;0.31;342.27;9.30;1260;23;3217.00;132
7980;20;621479075;7980;522;9239;9369;5.13;0.31;342.31;9.39;1259;23;3218.00;130
7981;20;621479096;7981;518;9240;9370;5.17;0.31;342.36;9.39;1259;23;3219.00;130
7985;20;621479113;7985;528;9242;9371;5.13;0.31;342.46;9.47;1257;23;3220.00;129
7989;20;621479127;7989;530;9242;9371;5.11;0.31;342.54;9.47;1253;23;3221.00;129
7993;20;621479142;7993;542;9245;9374;5.09;0.31;342.60;9.47;1252;23;3222.00;129
7996;20;621479156;7996;542;9245;9374;5.05;0.31;342.68;9.47;1249;23;3223.00;129
7998;20;621479169;7998;555;9247;9374;5.02;0.31;342.70;9.55;1249;23;3224.00;127
8003;20;621479183;8003;553;9247;9374;4.95;0.30;342.76;9.55;1244;23;3225.00;127
8005;20;621479198;8005;558;9254;9380;4.91;0.30;342.76;9.62;1249;23;3226.00;126
8011;20;621479212;8011;564;9254;9380;4.78;0.29;342.63;9.62;1243;23;3227.00;126
8015;20;621479225;8015;575;9256;9380;4.68;0.29;342.61;9.70;1241;23;3228.00;124
8019;20;621479238;8019;580;9256;9380;4.54;0.28;342.57;9.70;1237;23;3229.00;124
8022;20;621479250;8022;574;9259;9384;4.45;0.27;342.55;9.70;1237;23;3230.00;125
8024;20;621479263;8024;570;9262;9385;4.38;0.27;342.57;9.77;1238;23;3231.00;123
8026;20;621479276;8026;567;9262;9385;4.31;0.26;342.53;9.77;1236;23;3232.00;123
8032;20;621479289;8032;566;9263;9386;4.25;0.26;342.49;9.77;1231;23;3233.00;123
8032;20;621479302;8032;558;9265;9386;4.21;0.26;342.49;9.85;1233;23;3234.00;121
8034;20;621479314;8034;560;9265;9386;4.17;0.25;342.50;9.85;1231;23;3235.00;121
8037;20;621479326;8037;564;9267;9386;4.14;0.25;342.41;9.92;1230;23;3236.00;119
8038;20;621479340;8038;557;9267;9386;4.09;0.25;342.44;9.92;1229;23;3237.00;119
8040;20;621479352;8040;549;9267;9386;4.06;0.25;342.39;9.92;1227;23;3238.00;119
8043;20;621479365;8043;539;9267;9386;4.04;0.25;342.35;9.92;1224;23;3239.00;119
8045;20;621479379;8045;540;9327;9511;4.35;0.27;342.35;9.86;1282;23;3240.00;184
8047;20;621479402;8047;534;9332;9512;4.35;0.27;342.36;9.85;1285;23;3241.00;180
8050;20;621479415;8050;545;9341;9512;4.35;0.27;342.33;9.85;1291;23;3242.00;171
8054;20;621479428;8054;538;9343;9512;4.33;0.27;342.30;9.85;1289;23;3243.00;169
8056;20;621479442;8056;535;9346;9512;4.37;0.27;342.24;9.84;1290;23;3244.00;166
8058;20;621479456;8058;542;9347;9512;4.38;0.27;342.24;9.84;1289;23;3245.00;165
8060;20;621479470;8060;550;9352;9512;4.45;0.28;342.23;9.84;1292;23;3246.00;160
8063;20;621479483;8063;555;9352;9512;4.49;0.28;342.20;9.84;1289;23;3247.00;160
8069;20;621479497;8069;548;9357;9513;4.49;0.28;342.22;9.84;1288;23;3248.00;156
8074;20;621479511;8074;544;9359;9514;4.48;0.28;342.18;9.84;1285;23;3249.00;155
8075;20;621479525;8075;552;9362;9514;4.50;0.28;342.26;9.84;1287;23;3250.00;152
8080;20;621479539;8080;553;9367;9518;4.52;0.28;342.26;9.84;1287;23;3251.00;151
8083;20;621479554;8083;559;9368;9518;4.52;0.28;342.30;9.84;1285;23;3252.00;150
8085;20;621479568;8085;564;9368;9518;4.50;0.28;342.28;9.84;1283;23;3253.00;150
8086;20;621479581;8086;572;9368;9518;4.48;0.27;342.25;9.84;1282;23;3254.00;150
8089;20;621479596;8089;580;9372;9524;4.42;0.27;342.24;9.83;1283;23;3255.00;152
8089;20;621479610;8089;587;9373;9524;4.40;0.27;342.24;9.83;1284;23;3256.00;151
8092;20;621479632;8092;588;9373;9524;4.36;0.27;342.25;9.83;1281;23;3257.00;151
8096;20;621479646;8096;594;9375;9527;4.28;0.26;342.29;9.83;1279;23;3258.00;152
8098;20;621479660;8098;589;9375;9527;4.21;0.26;342.23;9.83;1277;23;3259.00;152
8102;20;621479674;8102;577;9376;9527;4.11;0.25;342.26;9.87;1274;23;3260.00;151
8105;20;621479689;8105;581;9376;9528;4.08;0.25;342.24;9.87;1271;23;3261.00;152
8106;20;621479703;8106;569;9378;9529;4.09;0.25;342.25;9.87;1272;23;3262.00;151
8110;20;621479717;8110;574;9379;9529;4.10;0.25;342.24;9.87;1269;23;3263.00;150
8115;21;621479732;8115;576;9389;9542;4.17;0.25;342.25;9.87;1274;24;3264.00;153
8115;21;621479759;8115;570;9390;9542;4.20;0.26;342.25;9.87;1275;24;3265.00;152
8122;21;621479780;8122;565;9392;9542;4.16;0.25;342.13;9.87;1270;24;3266.00;150
8124;21;621479794;8124;574;9393;9543;4.16;0.25;342.15;9.87;1269;24;3267.00;150
8128;21;621479808;8128;566;9393;9543;4.15;0.25;342.11;9.87;1265;24;3268.00;150
8133;21;621479822;8133;566;9397;9547;4.16;0.25;342.12;9.87;1264;24;3269.00;150
8135;21;621479838;8135;558;9398;9547;4.20;0.25;342.17;9.87;1263;24;3270.00;149
8139;21;621479853;8139;559;9402;9551;4.22;0.26;342.20;9.87;1263;24;3271.00;149
8141;21;621479866;8141;554;9403;9551;4.20;0.26;342.21;9.87;1262;24;3272.00;148
8143;21;621479880;8143;544;9404;9551;4.18;0.25;342.17;9.87;1261;24;3273.00;147
8149;21;621479893;8149;545;9405;9551;4.15;0.25;342.28;9.87;1256;24;3274.00;146
8151;21;621479907;8151;543;9405;9551;4.16;0.25;342.25;9.87;1254;24;3275.00;146
8154;21;621479922;8154;538;9416;9563;4.25;0.26;342.28;9.90;1262;24;3276.00;147
8156;21;621479937;8156;527;9416;9563;4.23;0.26;342.30;9.90;1260;24;3277.00;147
8157;21;621479952;8157;516;9418;9563;4.27;0.26;342.28;9.90;1261;24;3278.00;145
8157;21;621479966;8157;513;9418;9563;4.33;0.26;342.28;9.90;1261;24;3279.00;145
8158;21;621479981;8158;509;9418;9563;4.37;0.27;342.30;9.90;1260;24;3280.00;145
8162;21;621479997;8162;505;9418;9563;4.40;0.27;342.35;9.90;1256;24;3281.00;145
8164;21;621480021;8164;504;9418;9564;4.46;0.27;342.38;9.90;1254;24;3282.00;146
8165;21;621480039;8165;499;9418;9564;4.55;0.28;342.35;9.90;1253;24;3283.00;146
8167;21;621480056;8167;502;9423;9570;4.62;0.28;342.30;9.89;1256;24;3284.00;147
8168;21;621480070;8168;502;9425;9572;4.62;0.28;342.28;9.89;1257;24;3285.00;147
8168;21;621480090;8168;488;9425;9572;4.67;0.28;342.28;9.89;1257;24;3286.00;147
8170;21;621480104;8170;476;9425;9572;4.72;0.29;342.31;9.89;1255;24;3287.00;147
8171;21;621480118;8171;478;9428;9576;4.83;0.29;342.32;9.89;1257;24;3288.00;148
8173;21;621480133;8173;466;9428;9576;4.85;0.30;342.36;9.89;1255;24;3289.00;148
8174;21;621480147;8174;465;9429;9576;4.89;0.30;342.35;9.93;1255;24;3290.00;147
8175;21;621480161;8175;456;9430;9577;5.00;0.31;342.32;9.93;1255;24;3291.00;147
8176;21;621480176;8176;458;9433;9581;5.04;0.31;342.32;9.93;1257;24;3292.00;148
8180;21;621480191;8180;455;9433;9581;5.10;0.31;342.40;9.93;1253;24;3293.00;148
8181;21;621480205;8181;452;9435;9584;5.18;0.32;342.49;9.92;1254;24;3294.00;149
8183;21;621480220;8183;459;9435;9584;5.21;0.32;342.55;9.92;1252;24;3295.00;149
8184;21;621480234;8184;461;9436;9584;5.25;0.32;342.61;9.92;1252;24;3296.00;148
8188;21;621480248;8188;453;9436;9584;5.20;0.32;342.73;9.92;1248;24;3297.00;148
8191;21;621480262;8191;457;9440;9588;5.20;0.32;342.75;9.92;1249;24;3298.00;148
8192;21;621480277;8192;454;9440;9588;5.15;0.31;342.82;9.92;1248;24;3299.00;148
8196;21;621480294;8196;456;9445;9607;5.07;0.31;342.91;9.91;1249;24;3300.00;162
8199;21;621480315;8199;447;9445;9607;5.06;0.31;342.97;9.91;1246;24;3301.00;162
8200;21;621480330;8200;454;9445;9608;5.07;0.31;342.96;9.91;1245;24;3302.00;163
8203;21;621480343;8203;458;9446;9609;5.07;0.31;343.01;9.91;1243;24;3303.00;163
8206;21;621480358;8206;452;9446;9609;5.09;0.31;343.04;9.91;1240;24;3304.00;163
8208;21;621480371;8208;452;9449;9610;5.13;0.31;343.08;9.96;1241;24;3305.00;161
8210;21;621480385;8210;456;9450;9610;5.15;0.31;343.13;9.95;1240;24;3306.00;160
8212;21;621480399;8212;452;9450;9610;5.18;0.32;343.15;9.95;1238;24;3307.00;160
8215;21;621480413;8215;459;9450;9610;5.19;0.32;343.16;9.95;1235;24;3308.00;160
8216;21;621480427;8216;456;9450;9610;5.20;0.32;343.15;9.95;1234;24;3309.00;160
8218;21;621480441;8218;456;9450;9610;5.19;0.32;343.27;9.95;1232;24;3310.00;160
8223;21;621480455;8223;455;9451;9610;5.17;0.32;343.34;9.96;1228;24;3311.00;159
8226;21;621480469;8226;479;9520;9737;5.27;0.33;343.47;9.88;1294;24;3312.00;217
8228;21;621480493;8228;471;9520;9738;5.29;0.33;343.57;9.88;1292;24;3313.00;218
8231;21;621480508;8231;458;9524;9738;5.36;0.33;343.61;9.88;1293;24;3314.00;214
8233;21;621480523;8233;464;9524;9738;5.41;0.33;343.73;9.88;1291;24;3315.00;214
8236;21;621480537;8236;463;9528;9738;5.42;0.33;343.79;9.88;1292;24;3316.00;210
8236;21;621480551;8236;459;9528;9738;5.45;0.34;343.79;9.88;1292;24;3317.00;210
8242;21;621480565;8242;461;9531;9738;5.46;0.33;343.80;9.88;1289;24;3318.00;207
8243;21;621480579;8243;463;9533;9738;5.45;0.33;343.79;9.88;1290;24;3319.00;205
8244;21;621480600;8244;455;9537;9739;5.47;0.33;343.84;9.92;1293;24;3320.00;202
8245;21;621480615;8245;456;9541;9740;5.52;0.34;343.82;9.92;1296;24;3321.00;199
8246;21;621480630;8246;449;9544;9740;5.54;0.34;343.87;9.92;1298;24;3322.00;196
8249;21;621480645;8249;454;9546;9741;5.52;0.34;344.00;9.93;1297;24;3323.00;195
8252;21;621480660;8252;453;9548;9741;5.53;0.34;344.17;9.93;1296;24;3324.00;193
8255;21;621480675;8255;455;9549;9741;5.52;0.34;344.17;9.93;1294;24;3325.00;192
8256;21;621480690;8256;452;9554;9741;5.56;0.34;344.18;9.97;1298;24;3326.00;187
8257;21;621480705;8257;453;9554;9745;5.62;0.34;344.22;9.97;1297;24;3327.00;191
8259;21;621480720;8259;459;9558;9745;5.61;0.34;344.32;9.98;1299;24;3328.00;187
8262;21;621480735;8262;446;9561;9745;5.57;0.34;344.33;9.98;1299;24;3329.00;184
8268;21;621480751;8268;447;9565;9751;5.52;0.34;344.42;9.98;1297;24;3330.00;186
8271;21;621480767;8271;446;9568;9751;5.52;0.34;344.47;9.98;1297;24;3331.00;183
8275;21;621480781;8275;439;9571;9751;5.49;0.34;344.63;9.98;1296;24;3332.00;180
8281;21;621480796;8281;429;9574;9755;5.46;0.33;344.70;9.98;1293;24;3333.00;181
8282;21;621480812;8282;423;9577;9756;5.55;0.34;344.70;9.98;1295;24;3334.00;179
8285;21;621480827;8285;419;9585;9756;5.55;0.34;344.91;10.13;1300;24;3335.00;171
8287;21;621480844;8287;414;9587;9760;5.61;0.34;344.91;10.13;1300;24;3336.00;173
8287;21;621480859;8287;406;9588;9760;5.66;0.35;344.91;10.13;1301;24;3337.00;172
8293;21;621480874;8293;412;9590;9760;5.62;0.34;344.94;10.13;1297;24;3338.00;170
8297;21;621480889;8297;405;9592;9761;5.67;0.34;344.92;10.13;1295;24;3339.00;169
8298;21;621480904;8298;411;9594;9761;5.68;0.35;344.90;10.13;1296;24;3340.00;167
8301;21;621480919;8301;403;9598;9767;5.71;0.35;344.93;10.13;1297;24;3341.00;169
8305;21;621480935;8305;401;9600;9767;5.70;0.35;345.01;10.13;1295;24;3342.00;167
8308;21;621480950;8308;395;9601;9768;5.68;0.34;345.17;10.13;1293;24;3343.00;167
8310;21;621480965;8310;404;9602;9768;5.66;0.34;345.20;10.13;1292;24;3344.00;166
8313;21;621480980;8313;405;9602;9768;5.64;0.34;345.26;10.13;1289;24;3345.00;166
8317;21;621480996;8317;406;9602;9768;5.63;0.34;345.38;10.13;1285;24;3346.00;166
8319;21;621481023;8319;408;9603;9768;5.65;0.34;345.37;10.13;1284;24;3347.00;165
8323;21;621481048;8323;413;9612;9780;5.64;0.34;345.47;10.12;1289;24;3348.00;168
8324;21;621481076;8324;416;9612;9780;5.61;0.34;345.47;10.12;1288;24;3349.00;168
8326;21;621481097;8326;415;9615;9780;5.58;0.34;345.51;10.12;1289;24;3350.00;165
8328;21;621481115;8328;423;9616;9780;5.53;0.34;345.50;10.13;1288;24;3351.00;164
8329;21;621481131;8329;429;9616;9780;5.49;0.34;345.50;10.13;1287;24;3352.00;164
8333;21;621481147;8333;423;9618;9780;5.47;0.33;345.48;10.13;1285;24;3353.00;162
8336;21;621481163;8336;428;9621;9784;5.47;0.33;345.53;10.13;1285;24;3354.00;163
8337;21;621481179;8337;436;9621;9784;5.50;0.34;345.52;10.13;1284;24;3355.00;163
8340;21;621481195;8340;434;9625;9788;5.54;0.34;345.63;10.13;1285;24;3356.00;163
8344;21;621481212;8344;434;9626;9789;5.52;0.34;345.67;10.13;1282;24;3357.00;163
8345;21;621481228;8345;441;9627;9789;5.55;0.34;345.67;10.13;1282;24;3358.00;162
8348;21;621481243;8348;448;9627;9789;5.49;0.34;345.65;10.13;1279;24;3359.00;162
8353;21;621481260;8353;458;9650;9818;5.50;0.34;345.63;10.15;1297;24;3360.00;168
8353;21;621481279;8353;459;9650;9818;5.48;0.34;345.63;10.15;1297;24;3361.00;168
8359;21;621481294;8359;463;9653;9818;5.41;0.33;345.84;10.20;1294;24;3362.00;165
8360;21;621481309;8360;468;9655;9819;5.38;0.33;345.86;10.20;1295;24;3363.00;164
8364;21;621481324;8364;474;9655;9820;5.34;0.33;345.78;10.20;1291;24;3364.00;165
8368;21;621481339;8368;482;9655;9820;5.29;0.32;345.90;10.20;1287;24;3365.00;165
8371;21;621481354;8371;490;9659;9823;5.27;0.32;346.11;10.29;1288;24;3366.00;164
8373;21;621481369;8373;496;9659;9823;5.24;0.32;346.13;10.29;1286;24;3367.00;164
8375;21;621481383;8375;498;9661;9823;5.15;0.31;346.16;10.34;1286;24;3368.00;162
8376;21;621481398;8376;505;9661;9823;5.11;0.31;346.26;10.34;1285;24;3369.00;162
8379;21;621481413;8379;510;9666;9829;5.10;0.31;346.36;10.34;1287;24;3370.00;163
8381;21;621481428;8381;516;9668;9829;4.98;0.30;346.35;10.44;1287;24;3371.00;161
8384;21;621481443;8384;523;9669;9829;4.88;0.30;346.57;10.48;1285;24;3372.00;160
8384;21;621481457;8384;528;9670;9829;4.79;0.29;346.57;10.53;1286;24;3373.00;159
8387;21;621481472;8387;547;9673;9833;4.69;0.29;346.80;10.53;1286;24;3374.00;160
8388;21;621481488;8388;548;9675;9835;4.63;0.28;346.85;10.53;1287;24;3375.00;160
8391;21;621481502;8391;551;9677;9835;4.59;0.28;346.94;10.62;1286;24;3376.00;158
8393;21;621481516;8393;568;9679;9836;4.55;0.28;346.89;10.67;1286;24;3377.00;157
8396;21;621481530;8396;568;9680;9836;4.53;0.28;346.93;10.71;1284;24;3378.00;156
8401;21;621481544;8401;574;9680;9836;4.51;0.28;346.83;10.71;1279;24;3379.00;156
8401;21;621481558;8401;576;9680;9836;4.49;0.28;346.83;10.71;1279;24;3380.00;156
8402;21;621481571;8402;573;9680;9836;4.47;0.27;346.81;10.71;1278;24;3381.00;156
8404;21;621481586;8404;578;9682;9836;4.41;0.27;346.73;10.80;1278;24;3382.00;154
8407;21;621481600;8407;583;9682;9836;4.39;0.27;346.79;10.80;1275;24;3383.00;154
8410;21;621481613;8410;592;9726;9906;4.49;0.28;346.76;10.85;1316;24;3384.00;180
8411;21;621481633;8411;592;9729;9907;4.46;0.27;346.74;10.89;1318;24;3385.00;178
8414;21;621481647;8414;594;9736;9907;4.45;0.27;346.70;10.88;1322;24;3386.00;171
8415;21;621481661;8415;594;9738;9907;4.41;0.27;346.66;10.93;1323;24;3387.00;169
8416;21;621481674;8416;600;9739;9907;4.40;0.27;346.64;10.92;1323;24;3388.00;168
8417;21;621481688;8417;602;9739;9907;4.41;0.27;346.64;10.92;1322;24;3389.00;168
8419;21;621481703;8419;608;9744;9907;4.43;0.27;346.59;11.01;1325;24;3390.00;163
8423;21;621481719;8423;616;9745;9907;4.39;0.27;346.50;11.05;1322;24;3391.00;162
8428;21;621481735;8428;620;9748;9908;4.36;0.27;346.42;11.10;1320;24;3392.00;160
8433;21;621481749;8433;624;9750;9909;4.33;0.26;346.30;11.10;1317;24;3393.00;159
8437;21;621481765;8437;637;9754;9909;4.32;0.26;346.26;11.18;1317;24;3394.00;155
8440;21;621481781;8440;634;9759;9913;4.27;0.26;346.17;11.18;1319;24;3395.00;154
8446;21;621481795;8446;644;9760;9913;4.19;0.26;346.15;11.18;1314;24;3396.00;153
8447;21;621481809;8447;651;9760;9913;4.14;0.25;346.14;11.18;1313;24;3397.00;153
8448;21;621481821;8448;655;9760;9913;4.08;0.25;346.16;11.18;1312;24;3398.00;153
8451;21;621481834;8451;669;9764;9919;4.02;0.25;346.12;11.17;1313;24;3399.00;155
8452;21;621481849;8452;662;9764;9919;3.98;0.24;346.09;11.17;1312;24;3400.00;155
8456;21;621481866;8456;662;9764;9919;3.92;0.24;346.12;11.17;1308;24;3401.00;155
8459;21;621481879;8459;662;9765;9922;3.93;0.24;346.16;11.17;1306;24;3402.00;157
8460;21;621481893;8460;651;9765;9922;3.91;0.24;346.13;11.17;1305;24;3403.00;157
8463;21;621481905;8463;643;9765;9922;3.86;0.24;346.10;11.17;1302;24;3404.00;157
8465;21;621481919;8465;648;9765;9923;3.81;0.23;346.09;11.17;1300;24;3405.00;158
8468;21;621481932;8468;641;9766;9924;3.80;0.23;346.10;11.17;1298;24;3406.00;158
8471;21;621481945;8471;633;9766;9924;3.78;0.23;346.09;11.17;1295;24;3407.00;158
8473;21;621481959;8473;624;9776;9937;3.83;0.23;346.08;11.16;1303;24;3408.00;161
8476;21;621481974;8476;622;9776;9937;3.82;0.23;346.01;11.16;1300;24;3409.00;161
8479;21;621481987;8479;614;9776;9937;3.79;0.23;345.98;11.16;1297;24;3410.00;161
8480;21;621482002;8480;597;9776;9938;3.84;0.23;346.00;11.16;1296;24;3411.00;162
8481;21;621482016;8481;587;9776;9938;3.87;0.24;346.02;11.16;1295;24;3412.00;162
8486;21;621482029;8486;577;9779;9942;3.94;0.24;345.99;11.16;1293;24;3413.00;163
8487;21;621482043;8487;574;9779;9942;4.00;0.24;346.01;11.16;1292;24;3414.00;163
8488;21;621482056;8488;566;9782;9946;4.10;0.25;346.02;11.15;1294;24;3415.00;164
8492;21;621482070;8492;561;9782;9946;4.11;0.25;346.01;11.15;1290;24;3416.00;164
8496;21;621482083;8496;555;9782;9946;4.15;0.25;345.97;11.15;1286;24;3417.00;164
8498;21;621482106;8498;554;9782;9946;4.21;0.26;345.98;11.15;1284;24;3418.00;164
8502;21;621482119;8502;551;9782;9946;4.21;0.26;345.89;11.15;1280;24;3419.00;164
8504;21;621482134;8504;553;9808;9980;4.39;0.27;345.93;11.12;1304;24;3420.00;172
8508;21;621482151;8508;559;9808;9980;4.42;0.27;345.87;11.12;1300;24;3421.00;172
8511;21;621482164;8511;555;9809;9980;4.46;0.27;345.90;11.12;1298;24;3422.00;171
8515;21;621482178;8515;556;9809;9980;4.45;0.27;345.94;11.12;1294;24;3423.00;171
8520;21;621482192;8520;556;9809;9980;4.39;0.27;346.07;11.12;1289;24;3424.00;171
8523;21;621482206;8523;550;9809;9980;4.39;0.27;346.10;11.12;1286;24;3425.00;171
8525;21;621482220;8525;546;9809;9981;4.38;0.27;346.15;11.12;1284;24;3426.00;172
8528;21;621482233;8528;554;9809;9981;4.38;0.27;346.16;11.12;1281;24;3427.00;172
8532;21;621482248;8532;551;9812;9987;4.36;0.27;346.21;11.12;1280;24;3428.00;175
8533;21;621482262;8533;556;9813;9988;4.39;0.27;346.22;11.12;1280;24;3429.00;175
8534;21;621482275;8534;551;9813;9988;4.40;0.27;346.21;11.12;1279;24;3430.00;175
8538;21;621482290;8538;555;9813;9988;4.37;0.27;346.15;11.12;1275;24;3431.00;175
8540;21;621482303;8540;546;9816;9992;4.43;0.27;346.23;11.12;1276;24;3432.00;176
8545;21;621482317;8545;530;9816;9992;4.42;0.27;346.19;11.12;1271;24;3433.00;176
8547;21;621482331;8547;523;9817;9992;4.45;0.27;346.18;11.12;1270;24;3434.00;175
8551;21;621482344;8551;521;9819;9993;4.44;0.27;346.22;11.13;1268;24;3435.00;174
8553;21;621482358;8553;521;9823;9997;4.44;0.27;346.22;11.12;1270;24;3436.00;174
8556;21;621482372;8556;521;9824;9997;4.39;0.27;346.17;11.12;1268;24;3437.00;173
8561;21;621482386;8561;520;9825;10000;4.36;0.27;346.22;11.12;1264;24;3438.00;175
8565;21;621482400;8565;516;9826;10000;4.34;0.27;346.38;11.13;1261;24;3439.00;174
8568;21;621482413;8568;519;9828;10000;4.33;0.26;346.37;11.13;1260;24;3440.00;172
8569;21;621482427;8569;523;9828;10000;4.30;0.26;346.42;11.13;1259;24;3441.00;172
8572;21;621482441;8572;521;9832;10004;4.25;0.26;346.44;11.13;1260;24;3442.00;172
8573;21;621482455;8573;519;9833;10004;4.24;0.26;346.42;11.13;1260;24;3443.00;171
8575;21;621482469;8575;510;9834;10004;4.23;0.26;346.43;11.13;1259;24;3444.00;170
8577;21;621482482;8577;507;9834;10004;4.26;0.26;346.53;11.13;1257;24;3445.00;170
8579;21;621482495;8579;512;9835;10005;4.22;0.26;346.53;11.13;1256;24;3446.00;170
8582;21;621482508;8582;499;9836;10006;4.20;0.26;346.63;11.13;1254;24;3447.00;170
8586;21;621482522;8586;481;9837;10006;4.23;0.26;346.63;11.13;1251;24;3448.00;169
8587;21;621482535;8587;485;9838;10007;4.29;0.26;346.71;11.13;1251;24;3449.00;169
8589;21;621482551;8589;487;9838;10007;4.30;0.26;346.86;11.13;1249;24;3450.00;169
8591;21;621482564;8591;486;9839;10007;4.33;0.26;346.91;11.13;1248;24;3451.00;168
8593;21;621482578;8593;491;9839;10007;4.40;0.27;346.90;11.13;1246;24;3452.00;168
8594;21;621482592;8594;487;9840;10007;4.44;0.27;346.92;11.14;1246;24;3453.00;167
8597;21;621482606;8597;486;9840;10007;4.46;0.27;347.06;11.14;1243;24;3454.00;167
8601;21;621482619;8601;483;9841;10007;4.45;0.27;347.20;11.14;1240;24;3455.00;166
8602;21;621482637;8602;507;9918;10134;4.63;0.29;347.18;11.05;1316;24;3456.00;216
8603;21;621482663;8603;490;9920;10135;4.68;0.29;347.18;11.05;1317;24;3457.00;215
8604;21;621482677;8604;471;9923;10135;4.75;0.29;347.26;11.05;1319;24;3458.00;212
8607;21;621482697;8607;467;9929;10135;4.85;0.30;347.42;11.10;1322;24;3459.00;206
8608;21;621482712;8608;456;9930;10135;4.94;0.31;347.40;11.10;1322;24;3460.00;205
8612;21;621482726;8612;450;9933;10135;4.99;0.31;347.65;11.10;1321;24;3461.00;202
8613;21;621482742;8613;455;9937;10135;5.04;0.31;347.65;11.10;1324;24;3462.00;198
8617;21;621482756;8617;454;9938;10135;5.08;0.31;347.86;11.10;1321;24;3463.00;197
8622;21;621482771;8622;457;9940;10136;5.10;0.31;348.05;11.09;1318;24;3464.00;196
8622;21;621482786;8622;458;9943;10138;5.13;0.32;348.05;11.09;1321;24;3465.00;195
8623;21;621482801;8623;459;9945;10138;5.15;0.32;348.06;11.09;1322;24;3466.00;193
8625;21;621482821;8625;454;9947;10139;5.16;0.32;348.17;11.09;1322;24;3467.00;192
8628;21;621482836;8628;460;9949;10139;5.10;0.31;348.31;11.09;1321;24;3468.00;190
8628;21;621482851;8628;466;9950;10139;5.12;0.31;348.31;11.09;1322;24;3469.00;189
8632;21;621482866;8632;459;9954;10139;5.04;0.31;348.38;11.09;1322;24;3470.00;185
8633;21;621482880;8633;464;9957;10143;5.04;0.31;348.44;11.09;1324;24;3471.00;186
8634;21;621482896;8634;465;9961;10143;5.06;0.31;348.44;11.09;1327;24;3472.00;182
8639;21;621482916;8639;467;9962;10143;5.05;0.31;348.56;11.09;1323;24;3473.00;181
8643;21;621482931;8643;468;9965;10146;5.06;0.31;348.66;11.09;1322;24;3474.00;181
8643;21;621482946;8643;469;9966;10146;5.12;0.31;348.66;11.09;1323;24;3475.00;180
8647;21;621482961;8647;466;9968;10146;5.13;0.31;348.70;11.15;1321;24;3476.00;178
8649;21;621482977;8649;472;9972;10150;5.14;0.32;348.71;11.15;1323;24;3477.00;178
8653;21;621482992;8653;484;9974;10151;5.16;0.32;348.82;11.15;1321;24;3478.00;177
8658;21;621483013;8658;487;9975;10151;5.17;0.32;348.86;11.15;1317;24;3479.00;176
8662;21;621483041;8662;486;9979;10156;5.13;0.31;348.91;11.14;1317;24;3480.00;177
8663;21;621483074;8663;487;9980;10156;5.14;0.31;348.91;11.14;1317;24;3481.00;176
8665;21;621483097;8665;495;9980;10156;5.14;0.31;348.87;11.14;1315;24;3482.00;176
8667;21;621483131;8667;503;9981;10157;5.09;0.31;348.90;11.14;1314;24;3483.00;176
8669;21;621483147;8669;502;9981;10157;5.09;0.31;348.90;11.14;1312;24;3484.00;176
8669;21;621483163;8669;506;9986;10163;5.14;0.31;348.90;11.14;1317;24;3485.00;177
8672;21;621483180;8672;504;9986;10163;5.12;0.31;348.98;11.14;1314;24;3486.00;177
8673;21;621483196;8673;508;9986;10164;5.09;0.31;348.95;11.14;1313;24;3487.00;178
8674;21;621483212;8674;509;9986;10164;5.05;0.31;348.93;11.14;1312;24;3488.00;178
8677;21;621483227;8677;515;9986;10164;4.96;0.30;348.88;11.14;1309;24;3489.00;178
8681;21;621483242;8681;513;9986;10164;4.91;0.30;348.85;11.14;1305;24;3490.00;178
8682;21;621483258;8682;513;9986;10164;4.94;0.30;348.85;11.14;1304;24;3491.00;178
8683;21;621483273;8683;512;9996;10176;5.02;0.31;348.85;11.13;1313;24;3492.00;180
8686;21;621483289;8686;500;9997;10176;5.04;0.31;348.81;11.13;1311;24;3493.00;179
8686;21;621483303;8686;492;9997;10176;5.07;0.31;348.81;11.13;1311;24;3494.00;179
8687;21;621483318;8687;489;9997;10176;5.08;0.31;348.83;11.13;1310;24;3495.00;179
8692;21;621483333;8692;484;9997;10176;5.08;0.31;348.76;11.13;1305;24;3496.00;179
8694;21;621483348;8694;485;9998;10176;5.13;0.31;348.88;11.19;1304;24;3497.00;178
8697;21;621483364;8697;478;10001;10180;5.17;0.31;348.94;11.18;1304;24;3498.00;179
8699;21;621483378;8699;472;10001;10180;5.22;0.32;348.95;11.18;1302;24;3499.00;179
8701;21;621483396;8701;470;10005;10184;5.22;0.32;348.98;11.18;1304;24;3500.00;179
8703;21;621483416;8703;464;10005;10185;5.20;0.31;349.05;11.18;1302;24;3501.00;180
8708;21;621483431;8708;459;10006;10185;5.13;0.31;349.10;11.18;1298;24;3502.00;179
8710;21;621483445;8710;473;10006;10185;5.08;0.31;349.21;11.18;1296;24;3503.00;179
8711;21;621483460;8711;460;10017;10198;5.08;0.31;349.29;11.17;1306;24;3504.00;181
8714;21;621483476;8714;464;10019;10198;5.00;0.30;349.31;11.27;1305;24;3505.00;179
8718;21;621483502;8718;452;10019;10198;4.98;0.30;349.58;11.27;1301;24;3506.00;179
8719;21;621483521;8719;458;10020;10199;5.00;0.30;349.67;11.27;1301;24;3507.00;179
8720;21;621483541;8720;458;10020;10200;5.04;0.31;349.68;11.27;1300;24;3508.00;180
8725;21;621483565;8725;453;10020;10200;5.02;0.31;349.79;11.27;1295;24;3509.00;180
8728;21;621483588;8728;463;10024;10206;5.05;0.31;349.77;11.26;1296;24;3510.00;182
8730;21;621483606;8730;456;10025;10206;5.09;0.31;349.75;11.26;1295;24;3511.00;181
8733;21;621483623;8733;455;10026;10206;5.06;0.31;349.82;11.26;1293;24;3512.00;180
8735;21;621483648;8735;463;10027;10206;5.03;0.31;349.86;11.32;1292;24;3513.00;179
8739;21;621483669;8739;467;10032;10212;5.07;0.31;349.96;11.32;1293;24;3514.00;180
8741;21;621483697;8741;473;10032;10212;5.08;0.31;349.95;11.32;1291;24;3515.00;180
8744;21;621483720;8744;473;10032;10212;5.05;0.31;350.17;11.32;1288;24;3516.00;180
8746;21;621483739;8746;480;10032;10212;4.99;0.30;350.33;11.32;1286;24;3517.00;180
8746;21;621483755;8746;487;10035;10216;4.98;0.30;350.33;11.32;1289;24;3518.00;181
8749;21;621483770;8749;492;10038;10219;4.93;0.30;350.36;11.31;1289;24;3519.00;181
8753;21;621483789;8753;504;10038;10219;4.85;0.30;350.57;11.31;1285;24;3520.00;181
8755;21;621483803;8755;508;10039;10220;4.84;0.30;350.74;11.31;1284;24;3521.00;181
8759;21;621483817;8759;515;10039;10220;4.82;0.29;350.78;11.31;1280;24;3522.00;181
8765;21;621483834;8765;522;10039;10220;4.74;0.29;350.98;11.31;1274;24;3523.00;181
8766;21;621483854;8766;526;10039;10220;4.71;0.29;351.02;11.31;1273;24;3524.00;181
8769;21;621483870;8769;531;10039;10220;4.68;0.29;351.18;11.31;1270;24;3525.00;181
8771;21;621483888;8771;533;10039;10220;4.66;0.29;351.24;11.31;1268;24;3526.00;181
8774;21;621483904;8774;538;10039;10220;4.70;0.29;351.27;11.31;1265;24;3527.00;181
8777;21;621483918;8777;550;10074;10290;4.89;0.30;351.32;11.27;1297;24;3528.00;216
8778;21;621483938;8778;542;10076;10291;4.89;0.30;351.29;11.27;1298;24;3529.00;215
8779;21;621483953;8779;549;10086;10291;4.92;0.30;351.28;11.32;1307;24;3530.00;205
8782;21;621483968;8782;549;10088;10291;4.85;0.30;351.27;11.31;1306;24;3531.00;203
8785;21;621483981;8785;565;10090;10291;4.80;0.29;351.26;11.31;1305;24;3532.00;201
8785;21;621483995;8785;567;10091;10291;4.75;0.29;351.26;11.31;1306;24;3533.00;200
8785;21;621484012;8785;578;10095;10291;4.75;0.29;351.26;11.36;1310;24;3534.00;196
8789;22;621484027;8789;576;10098;10291;4.65;0.29;351.32;11.36;1309;25;3535.00;193
8791;22;621484061;8791;576;10101;10292;4.64;0.28;351.27;11.41;1310;25;3536.00;191
8795;22;621484076;8795;583;10104;10293;4.63;0.28;351.29;11.41;1309;25;3537.00;189
8795;22;621484090;8795;581;10107;10293;4.60;0.28;351.29;11.47;1312;25;3538.00;186
8798;22;621484103;8798;583;10112;10297;4.57;0.28;351.33;11.46;1314;25;3539.00;185
8801;22;621484119;8801;591;10114;10297;4.56;0.28;351.37;11.51;1313;25;3540.00;183
8803;22;621484133;8803;596;10115;10297;4.49;0.28;351.31;11.51;1312;25;3541.00;182
8804;22;621484146;8804;607;10115;10297;4.44;0.27;351.28;11.51;1311;25;3542.00;182
8807;22;621484159;8807;611;10120;10303;4.39;0.27;351.24;11.51;1313;25;3543.00;183
8808;22;621484173;8808;617;10120;10303;4.30;0.26;351.20;11.51;1312;25;3544.00;183
8812;22;621484186;8812;631;10120;10303;4.21;0.26;351.12;11.51;1308;25;3545.00;183
8813;22;621484199;8813;632;10129;10306;4.16;0.26;351.09;11.86;1316;25;3546.00;177
8815;22;621484212;8815;639;10129;10306;4.11;0.25;351.07;11.86;1314;25;3547.00;177
8817;22;621484225;8817;646;10131;10306;4.05;0.25;351.04;11.91;1314;25;3548.00;175
8818;22;621484237;8818;643;10132;10307;4.05;0.25;351.02;11.96;1314;25;3549.00;175
8821;22;621484250;8821;646;10133;10308;4.01;0.25;350.98;11.96;1312;25;3550.00;175
8823;22;621484263;8823;642;10134;10308;3.95;0.24;350.93;12.01;1311;25;3551.00;174
8825;22;621484276;8825;643;10145;10321;3.96;0.24;350.85;12.05;1320;25;3552.00;176
8826;22;621484289;8826;648;10145;10321;3.95;0.24;350.83;12.05;1319;25;3553.00;176
8829;22;621484302;8829;651;10147;10321;3.88;0.24;350.75;12.10;1318;25;3554.00;174
8832;22;621484315;8832;643;10150;10323;3.88;0.24;350.68;12.15;1318;25;3555.00;173
8834;22;621484328;8834;646;10150;10323;3.84;0.23;350.63;12.15;1316;25;3556.00;173
8836;22;621484340;8836;643;10156;10327;3.86;0.23;350.61;12.24;1320;25;3557.00;171
8836;22;621484353;8836;655;10156;10327;3.87;0.24;350.61;12.24;1320;25;3558.00;171
8838;22;621484366;8838;653;10159;10331;3.87;0.24;350.60;12.23;1321;25;3559.00;172
8838;22;621484380;8838;656;10159;10331;3.87;0.24;350.60;12.23;1321;25;3560.00;172
8841;22;621484393;8841;653;10159;10331;3.76;0.23;350.57;12.23;1318;25;3561.00;172
8841;22;621484405;8841;661;10159;10331;3.72;0.23;350.57;12.23;1318;25;3562.00;172
8843;22;621484417;8843;648;10159;10331;3.64;0.22;350.57;12.23;1316;25;3563.00;172
8844;22;621484429;8844;645;10169;10343;3.69;0.23;350.56;12.22;1325;25;3564.00;174
8845;22;621484442;8845;637;10169;10343;3.66;0.22;350.58;12.22;1324;25;3565.00;174
8847;22;621484454;8847;639;10170;10343;3.64;0.22;350.59;12.22;1323;25;3566.00;173
8850;22;621484467;8850;635;10170;10343;3.62;0.22;350.55;12.22;1320;25;3567.00;173
8850;22;621484479;8850;634;10170;10343;3.58;0.22;350.55;12.22;1320;25;3568.00;173
8852;22;621484491;8852;633;10170;10343;3.54;0.22;350.54;12.22;1318;25;3569.00;173
8853;22;621484510;8853;622;10170;10344;3.55;0.22;350.54;12.22;1317;25;3570.00;174
8856;22;621484522;8856;622;10170;10344;3.53;0.22;350.54;12.22;1314;25;3571.00;174
8857;22;621484535;8857;611;10175;10350;3.59;0.22;350.54;12.21;1318;25;3572.00;175
8859;22;621484549;8859;612;10176;10351;3.67;0.22;350.60;12.21;1317;25;3573.00;175
8862;22;621484562;8862;606;10176;10351;3.70;0.23;350.63;12.21;1314;25;3574.00;175
8866;22;621484574;8866;598;10176;10351;3.71;0.23;350.61;12.21;1310;25;3575.00;175
8867;22;621484588;8867;605;10179;10355;3.79;0.23;350.69;12.21;1312;25;3576.00;176
8871;22;621484601;8871;597;10179;10355;3.83;0.23;350.62;12.21;1308;25;3577.00;176
8871;22;621484614;8871;591;10179;10355;3.89;0.24;350.62;12.21;1308;25;3578.00;176
8875;22;621484627;8875;584;10180;10356;3.95;0.24;350.64;12.21;1305;25;3579.00;176
8875;22;621484640;8875;578;10183;10360;4.02;0.25;350.64;12.21;1308;25;3580.00;177
8879;22;621484653;8879;574;10183;10360;4.04;0.25;350.61;12.21;1304;25;3581.00;177
8881;22;621484666;8881;564;10186;10363;4.12;0.25;350.60;12.20;1305;25;3582.00;177
8882;22;621484718;8882;551;10186;10363;4.21;0.26;350.62;12.20;1304;25;3583.00;177
8884;22;621484731;8884;546;10186;10363;4.27;0.26;350.61;12.20;1302;25;3584.00;177
8888;22;621484744;8888;533;10186;10363;4.36;0.27;350.66;12.20;1298;25;3585.00;177
8890;22;621484758;8890;532;10190;10367;4.47;0.27;350.75;12.20;1300;25;3586.00;177
8895;22;621484773;8895;523;10191;10367;4.48;0.27;350.72;12.27;1296;25;3587.00;176
8899;22;621484787;8899;514;10191;10367;4.51;0.27;350.70;12.27;1292;25;3588.00;176
8905;22;621484800;8905;506;10191;10367;4.48;0.27;350.90;12.27;1286;25;3589.00;176
8907;22;621484814;8907;503;10191;10368;4.52;0.27;350.90;12.27;1284;25;3590.00;177
8913;22;621484828;8913;499;10192;10369;4.51;0.27;350.91;12.26;1279;25;3591.00;177
8914;22;621484842;8914;496;10192;10369;4.56;0.28;350.95;12.26;1278;25;3592.00;177
8918;22;621484858;8918;492;10193;10370;4.60;0.28;350.96;12.26;1275;25;3593.00;177
8923;22;621484873;8923;484;10193;10370;4.62;0.28;351.12;12.26;1270;25;3594.00;177
8925;22;621484887;8925;470;10193;10370;4.64;0.28;351.19;12.26;1268;25;3595.00;177
8931;22;621484901;8931;468;10193;10370;4.62;0.28;351.24;12.26;1262;25;3596.00;177
8937;22;621484915;8937;468;10193;10370;4.60;0.28;351.30;12.26;1256;25;3597.00;177
8940;23;621484929;8940;461;10193;10370;4.63;0.28;351.48;12.26;1253;26;3598.00;177
8941;23;621484954;8941;458;10193;10370;4.64;0.28;351.49;12.26;1252;26;3599.00;177
8946;23;621484970;8946;497;10313;10623;4.94;0.31;351.54;12.12;1367;26;3600.00;310
8947;23;621485013;8947;489;10321;10624;4.98;0.31;351.55;12.11;1374;26;3601.00;303
8949;23;621485044;8949;485;10332;10624;5.01;0.31;351.55;12.10;1383;26;3602.00;292
8953;23;621485068;8953;474;10340;10624;4.99;0.31;351.50;12.09;1387;26;3603.00;284
8956;23;621485091;8956;467;10345;10624;4.98;0.31;351.52;12.16;1389;26;3604.00;279
8959;23;621485111;8959;473;10351;10624;4.96;0.31;351.55;12.16;1392;26;3605.00;273
8961;23;621485129;8961;472;10354;10624;4.97;0.31;351.56;12.15;1393;26;3606.00;270
8964;23;621485146;8964;472;10359;10624;5.00;0.31;351.54;12.15;1395;26;3607.00;265
8967;23;621485163;8967;475;10364;10625;4.99;0.31;351.57;12.15;1397;26;3608.00;261
8969;23;621485180;8969;468;10367;10626;5.02;0.31;351.59;12.15;1398;26;3609.00;259
8972;23;621485198;8972;472;10371;10626;5.00;0.31;351.66;12.15;1399;26;3610.00;255
8976;23;621485215;8976;477;10374;10627;4.97;0.31;351.65;12.15;1398;26;3611.00;253
8979;23;621485231;8979;475;10377;10627;4.94;0.31;351.74;12.15;1398;26;3612.00;250
8979;23;621485247;8979;485;10381;10627;4.88;0.30;351.74;12.15;1402;26;3613.00;246
8981;23;621485262;8981;485;10382;10627;4.85;0.30;351.82;12.15;1401;26;3614.00;245
8984;23;621485278;8984;494;10387;10631;4.83;0.30;351.82;12.15;1403;26;3615.00;244
8988;23;621485295;8988;509;10389;10631;4.77;0.29;351.90;12.15;1401;26;3616.00;242
8993;23;621485311;8993;499;10391;10631;4.71;0.29;352.05;12.21;1398;26;3617.00;240
8995;23;621485328;8995;498;10393;10634;4.68;0.29;352.13;12.21;1398;26;3618.00;241
8997;23;621485350;8997;511;10393;10634;4.71;0.29;352.14;12.21;1396;26;3619.00;241
8999;23;621485367;8999;516;10395;10634;4.73;0.29;352.19;12.21;1396;26;3620.00;239
9003;23;621485384;9003;522;10399;10638;4.72;0.29;352.38;12.21;1396;26;3621.00;239
9004;23;621485402;9004;513;10399;10639;4.77;0.29;352.41;12.21;1395;26;3622.00;240
9006;23;621485419;9006;518;10401;10639;4.78;0.29;352.47;12.21;1395;26;3623.00;238
9010;23;621485435;9010;522;10402;10643;4.81;0.29;352.51;12.21;1392;26;3624.00;241
9013;23;621485451;9013;529;10404;10643;4.80;0.29;352.50;12.21;1391;26;3625.00;239
9018;23;621485473;9018;521;10405;10643;4.82;0.29;352.59;12.22;1387;26;3626.00;238
9020;23;621485497;9020;508;10406;10644;4.88;0.30;352.66;12.22;1386;26;3627.00;238
9023;23;621485514;9023;502;10408;10644;4.86;0.30;352.72;12.22;1385;26;3628.00;236
9026;23;621485530;9026;507;10412;10650;4.84;0.29;352.83;12.22;1386;26;3629.00;238
9029;23;621485550;9029;497;10413;10650;4.90;0.30;352.75;12.22;1384;26;3630.00;237
9032;23;621485567;9032;508;10415;10651;4.90;0.30;352.82;12.22;1383;26;3631.00;236
9034;23;621485583;9034;500;10418;10651;4.90;0.30;352.87;12.22;1384;26;3632.00;233
9036;23;621485600;9036;507;10420;10651;4.90;0.30;352.98;12.22;1384;26;3633.00;231
9038;23;621485616;9038;518;10421;10651;4.90;0.30;352.99;12.22;1383;26;3634.00;230
9040;23;621485633;9040;522;10422;10651;4.88;0.30;353.07;12.23;1382;26;3635.00;229
9040;23;621485649;9040;524;10429;10663;4.84;0.30;353.07;12.22;1389;26;3636.00;234
9042;23;621485666;9042;522;10432;10663;4.81;0.29;353.12;12.22;1390;26;3637.00;231
9042;23;621485683;9042;511;10432;10663;4.81;0.29;353.12;12.22;1390;26;3638.00;231
9044;23;621485699;9044;513;10434;10663;4.81;0.29;353.16;12.22;1390;26;3639.00;229
9047;23;621485716;9047;507;10434;10663;4.79;0.29;353.19;12.22;1387;26;3640.00;229
9047;23;621485733;9047;506;10435;10663;4.82;0.29;353.19;12.22;1388;26;3641.00;228
9050;23;621485748;9050;505;10440;10667;4.82;0.29;353.36;12.22;1390;26;3642.00;227
9054;23;621485765;9054;500;10442;10667;4.83;0.30;353.47;12.22;1388;26;3643.00;225
9056;23;621485781;9056;503;10446;10671;4.84;0.30;353.64;12.27;1390;26;3644.00;225
9059;23;621485799;9059;502;10450;10673;4.85;0.30;353.73;12.27;1391;26;3645.00;223
9061;23;621485817;9061;505;10450;10673;4.87;0.30;353.76;12.27;1389;26;3646.00;223
9064;23;621485835;9064;509;10450;10673;4.86;0.30;353.83;12.27;1386;26;3647.00;223
9065;23;621485853;9065;512;10458;10686;4.88;0.30;353.83;12.26;1393;26;3648.00;228
9068;23;621485871;9068;515;10459;10686;4.83;0.29;353.91;12.26;1391;26;3649.00;227
9071;23;621485889;9071;514;10459;10686;4.80;0.29;353.98;12.26;1388;26;3650.00;227
9074;23;621485906;9074;512;10460;10687;4.80;0.29;353.94;12.26;1386;26;3651.00;227
9077;23;621485922;9077;513;10460;10688;4.83;0.29;353.97;12.26;1383;26;3652.00;228
9080;23;621485939;9080;514;10460;10688;4.79;0.29;354.08;12.26;1380;26;3653.00;228
9081;23;621485954;9081;517;10462;10691;4.75;0.29;354.10;12.26;1381;26;3654.00;229
9082;23;621485971;9082;517;10462;10691;4.68;0.28;354.10;12.26;1380;26;3655.00;229
9084;23;621485987;9084;518;10463;10691;4.61;0.28;354.15;12.26;1379;26;3656.00;228
9085;23;621486005;9085;535;10463;10691;4.53;0.27;354.11;12.26;1378;26;3657.00;228
9086;23;621486021;9086;535;10468;10697;4.52;0.27;354.10;12.25;1382;26;3658.00;229
9088;23;621486037;9088;530;10468;10697;4.49;0.27;354.19;12.25;1380;26;3659.00;229
9089;23;621486055;9089;527;10468;10697;4.49;0.27;354.18;12.25;1379;26;3660.00;229
9091;23;621486070;9091;527;10468;10697;4.51;0.27;354.18;12.25;1377;26;3661.00;229
9092;23;621486085;9092;518;10470;10701;4.48;0.27;354.19;12.25;1378;26;3662.00;231
9092;23;621486100;9092;517;10472;10702;4.55;0.28;354.19;12.25;1380;26;3663.00;230
9097;23;621486115;9097;516;10472;10702;4.55;0.28;354.14;12.25;1375;26;3664.00;230
9099;23;621486129;9099;512;10473;10703;4.59;0.28;354.19;12.24;1374;26;3665.00;230
9099;23;621486145;9099;509;10473;10703;4.62;0.28;354.19;12.24;1374;26;3666.00;230
9103;23;621486159;9103;505;10473;10703;4.64;0.28;354.22;12.24;1370;26;3667.00;230
9104;23;621486174;9104;502;10474;10703;4.68;0.28;354.25;12.31;1370;26;3668.00;229
9106;23;621486189;9106;503;10475;10703;4.69;0.28;354.33;12.31;1369;26;3669.00;228
9107;23;621486204;9107;497;10475;10703;4.70;0.29;354.30;12.31;1368;26;3670.00;228
9109;23;621486219;9109;498;10475;10703;4.64;0.28;354.35;12.31;1366;26;3671.00;228
9113;23;621486233;9113;496;10506;10773;4.68;0.29;354.38;12.27;1393;26;3672.00;267
9116;23;621486253;9116;488;10508;10774;4.63;0.28;354.51;12.27;1392;26;3673.00;266
9118;23;621486268;9118;485;10513;10774;4.65;0.28;354.60;12.27;1395;26;3674.00;261
9121;23;621486283;9121;486;10520;10774;4.60;0.28;354.60;12.33;1399;26;3675.00;254
9123;23;621486300;9123;482;10522;10774;4.62;0.28;354.64;12.33;1399;26;3676.00;252
9125;23;621486315;9125;479;10526;10774;4.66;0.28;354.66;12.32;1401;26;3677.00;248
9126;23;621486330;9126;487;10528;10774;4.64;0.28;354.66;12.32;1402;26;3678.00;246
9129;23;621486345;9129;493;10530;10774;4.58;0.28;354.61;12.32;1401;26;3679.00;244
9131;23;621486360;9131;495;10533;10775;4.60;0.28;354.75;12.32;1402;26;3680.00;242
9132;23;621486376;9132;493;10534;10776;4.61;0.28;354.81;12.32;1402;26;3681.00;242
9135;23;621486391;9135;500;10537;10776;4.59;0.28;354.79;12.32;1402;26;3682.00;239
9138;23;621486407;9138;502;10542;10780;4.53;0.28;354.86;12.31;1404;26;3683.00;238
9140;23;621486423;9140;508;10543;10780;4.43;0.27;354.83;12.31;1403;26;3684.00;237
9143;23;621486437;9143;504;10543;10780;4.35;0.27;354.75;12.31;1400;26;3685.00;237
9145;23;621486453;9145;509;10543;10780;4.29;0.26;354.71;12.31;1398;26;3686.00;237
9147;23;621486469;9147;510;10548;10786;4.32;0.26;354.68;12.32;1401;26;3687.00;238
9149;23;621486484;9149;514;10548;10786;4.29;0.26;354.64;12.32;1399;26;3688.00;238
9149;23;621486499;9149;515;10549;10786;4.27;0.26;354.64;12.32;1400;26;3689.00;237
9151;23;621486516;9151;524;10553;10792;4.29;0.26;354.72;12.32;1402;26;3690.00;239
9152;23;621486531;9152;526;10553;10792;4.29;0.26;354.73;12.32;1401;26;3691.00;239
9153;23;621486545;9153;532;10557;10792;4.34;0.27;354.74;12.32;1404;26;3692.00;235
9155;23;621486561;9155;541;10557;10793;4.36;0.27;354.70;12.32;1402;26;3693.00;236
9160;23;621486575;9160;549;10558;10794;4.34;0.27;354.65;12.32;1398;26;3694.00;236
9162;23;621486590;9162;548;10560;10794;4.35;0.27;354.62;12.33;1398;26;3695.00;234
9164;23;621486611;9164;552;10572;10807;4.40;0.27;354.58;12.44;1408;26;3696.00;235
9166;23;621486628;9166;554;10573;10807;4.39;0.27;354.59;12.44;1407;26;3697.00;234
9168;23;621486643;9168;558;10574;10807;4.38;0.27;354.65;12.45;1406;26;3698.00;233
9169;23;621486658;9169;567;10575;10808;4.39;0.27;354.66;12.45;1406;26;3699.00;233
9172;23;621486673;9172;567;10577;10808;4.37;0.27;354.65;12.52;1405;26;3700.00;231
9176;23;621486693;9176;572;10581;10812;4.40;0.27;354.59;12.51;1405;26;3701.00;231
9179;23;621486709;9179;575;10583;10812;4.41;0.27;354.51;12.58;1404;26;3702.00;229
9182;23;621486723;9182;585;10586;10816;4.43;0.27;354.49;12.58;1404;26;3703.00;230
9184;23;621486738;9184;589;10587;10816;4.40;0.27;354.49;12.59;1403;26;3704.00;229
9187;23;621486755;9187;594;10587;10816;4.32;0.27;354.47;12.59;1400;26;3705.00;229
9191;23;621486769;9191;599;10589;10816;4.27;0.26;354.39;12.65;1398;26;3706.00;227
9192;23;621486784;9192;597;10589;10816;4.25;0.26;354.36;12.65;1397;26;3707.00;227
9194;23;621486798;9194;606;10600;10828;4.23;0.26;354.33;12.70;1406;26;3708.00;228
9195;23;621486814;9195;610;10601;10828;4.21;0.26;354.37;12.70;1406;26;3709.00;227
9198;23;621486828;9198;612;10603;10828;4.19;0.26;354.39;12.77;1405;26;3710.00;225
9200;23;621486843;9200;616;10603;10828;4.19;0.26;354.36;12.77;1403;26;3711.00;225
9201;23;621486858;9201;616;10603;10828;4.17;0.26;354.35;12.77;1402;26;3712.00;225
9202;23;621486872;9202;625;10607;10828;4.11;0.25;354.38;13.00;1405;26;3713.00;221
9202;23;621486885;9202;638;10608;10829;4.07;0.25;354.38;13.06;1406;26;3714.00;221
9205;23;621486905;9205;624;10609;10829;4.03;0.25;354.32;13.11;1404;26;3715.00;220
9206;23;621486919;9206;622;10616;10835;4.10;0.25;354.30;13.12;1410;26;3716.00;219
9207;23;621486934;9207;611;10618;10836;4.13;0.25;354.30;13.13;1411;26;3717.00;218
9207;23;621486948;9207;615;10621;10836;4.17;0.26;354.30;13.24;1414;26;3718.00;215
9211;23;621486962;9211;609;10622;10836;4.15;0.25;354.29;13.25;1411;26;3719.00;214
9213;23;621486979;9213;605;10625;10841;4.14;0.25;354.28;13.24;1412;26;3720.00;216
9213;23;621486994;9213;594;10628;10841;4.17;0.26;354.28;13.35;1415;26;3721.00;213
9215;23;621487013;9215;593;10629;10841;4.20;0.26;354.24;13.36;1414;26;3722.00;212
9217;23;621487035;9217;594;10632;10842;4.19;0.26;354.23;13.46;1415;26;3723.00;210
9219;23;621487059;9219;588;10636;10846;4.20;0.26;354.17;13.46;1417;26;3724.00;210
9220;23;621487084;9220;588;10636;10846;4.26;0.26;354.15;13.46;1416;26;3725.00;210
9220;23;621487107;9220;591;10638;10849;4.36;0.27;354.15;13.46;1418;26;3726.00;211
9220;23;621487135;9220;592;10641;10849;4.43;0.27;354.15;13.57;1421;26;3727.00;208
9222;23;621487150;9222;594;10641;10849;4.45;0.27;354.13;13.57;1419;26;3728.00;208
9225;23;621487166;9225;588;10643;10849;4.48;0.27;354.14;13.67;1418;26;3729.00;206
9228;23;621487182;9228;586;10647;10853;4.49;0.27;354.14;13.67;1419;26;3730.00;206
9230;23;621487199;9230;590;10649;10853;4.45;0.27;354.09;13.77;1419;26;3731.00;204
9234;23;621487216;9234;593;10649;10853;4.41;0.27;354.02;13.77;1415;26;3732.00;204
9236;23;621487232;9236;596;10649;10853;4.34;0.26;353.99;13.77;1413;26;3733.00;204
9238;23;621487247;9238;601;10651;10854;4.29;0.26;353.99;13.88;1413;26;3734.00;203
9240;23;621487263;9240;600;10653;10856;4.23;0.26;353.96;13.88;1413;26;3735.00;203
9245;23;621487278;9245;597;10653;10856;4.12;0.25;354.01;13.88;1408;26;3736.00;203
9246;23;621487294;9246;597;10654;10857;4.07;0.25;354.03;13.87;1408;26;3737.00;203
9249;23;621487308;9249;607;10654;10857;4.01;0.24;354.11;13.87;1405;26;3738.00;203
9252;23;621487322;9252;608;10654;10857;3.95;0.24;354.06;13.87;1402;26;3739.00;203
9257;23;621487336;9257;599;10654;10857;3.94;0.24;354.04;13.87;1397;26;3740.00;203
9260;23;621487351;9260;586;10654;10857;3.93;0.24;354.28;13.87;1394;26;3741.00;203
9264;23;621487365;9264;584;10654;10857;3.96;0.24;354.26;13.87;1390;26;3742.00;203
9268;23;621487381;9268;568;10654;10857;3.97;0.24;354.55;13.87;1386;26;3743.00;203
9271;23;621487395;9271;579;10717;10984;4.26;0.26;354.69;13.79;1446;26;3744.00;267
9274;23;621487429;9274;575;10720;10985;4.32;0.27;354.79;13.79;1446;26;3745.00;265
9277;23;621487445;9277;561;10726;10985;4.38;0.27;354.87;13.78;1449;26;3746.00;259
9279;23;621487460;9279;548;10730;10985;4.38;0.27;354.95;13.78;1451;26;3747.00;255
9281;23;621487475;9281;533;10734;10985;4.41;0.27;354.95;13.78;1453;26;3748.00;251
9285;23;621487489;9285;539;10735;10985;4.37;0.27;355.18;13.77;1450;26;3749.00;250
9290;23;621487506;9290;540;10739;10990;4.32;0.27;355.30;13.77;1449;26;3750.00;251
9293;23;621487522;9293;535;10740;10990;4.34;0.27;355.38;13.77;1447;26;3751.00;250
9298;23;621487537;9298;537;10742;10991;4.32;0.27;355.50;13.77;1444;26;3752.00;249
9299;23;621487554;9299;535;10743;10992;4.38;0.27;355.51;13.77;1444;26;3753.00;249
9301;23;621487569;9301;536;10745;10992;4.43;0.27;355.59;13.77;1444;26;3754.00;247
9306;23;621487591;9306;542;10748;10993;4.44;0.27;355.69;13.77;1442;26;3755.00;245
9308;23;621487609;9308;544;10751;10993;4.50;0.28;355.71;13.77;1443;26;3756.00;242
9309;23;621487625;9309;551;10752;10993;4.54;0.28;355.77;13.76;1443;26;3757.00;241
9315;23;621487647;9315;540;10752;10993;4.57;0.28;355.88;13.76;1437;26;3758.00;241
9322;23;621487663;9322;537;10755;10997;4.57;0.28;355.93;13.76;1433;26;3759.00;242
9324;23;621487681;9324;532;10755;10997;4.60;0.28;355.93;13.76;1431;26;3760.00;242
9328;23;621487696;9328;525;10756;10997;4.65;0.29;356.02;13.76;1428;26;3761.00;241
9330;23;621487714;9330;517;10756;11000;4.67;0.29;356.05;13.76;1426;26;3762.00;244
9331;23;621487731;9331;513;10756;11000;4.73;0.29;356.11;13.76;1425;26;3763.00;244
9338;23;621487748;9338;508;10756;11000;4.73;0.29;356.13;13.76;1418;26;3764.00;244
9343;23;621487765;9343;503;10760;11004;4.72;0.29;356.37;13.76;1417;26;3765.00;244
9347;23;621487781;9347;498;10760;11005;4.77;0.29;356.49;13.76;1413;26;3766.00;245
9352;23;621487798;9352;496;10760;11005;4.77;0.29;356.58;13.76;1408;26;3767.00;245
9358;23;621487815;9358;494;10762;11009;4.76;0.29;356.76;13.76;1404;26;3768.00;247
9361;23;621487833;9361;489;10763;11009;4.78;0.29;356.78;13.76;1402;26;3769.00;246
9364;23;621487849;9364;487;10763;11009;4.84;0.30;356.88;13.76;1399;26;3770.00;246
9368;23;621487865;9368;483;10766;11010;4.83;0.30;356.85;13.76;1398;26;3771.00;244
9373;23;621487881;9373;474;10767;11010;4.88;0.30;356.89;13.76;1394;26;3772.00;243
9378;23;621487897;9378;474;10770;11016;4.90;0.30;356.91;13.76;1392;26;3773.00;246
9383;23;621487914;9383;473;10774;11016;4.91;0.30;357.22;13.83;1391;26;3774.00;242
9388;23;621487932;9388;475;10775;11017;4.88;0.30;357.31;13.83;1387;26;3775.00;242
9390;23;621487948;9390;480;10776;11017;4.87;0.30;357.33;13.82;1386;26;3776.00;241
9394;23;621487965;9394;485;10777;11017;4.79;0.29;357.39;13.83;1383;26;3777.00;240
9396;23;621487983;9396;488;10778;11017;4.76;0.29;357.40;13.83;1382;26;3778.00;239
9400;23;621488001;9400;485;10778;11017;4.72;0.29;357.45;13.83;1378;26;3779.00;239
9407;23;621488023;9407;485;10800;11053;4.77;0.29;357.57;13.80;1393;26;3780.00;253
9410;23;621488044;9410;484;10802;11053;4.76;0.29;357.61;13.80;1392;26;3781.00;251
9413;23;621488060;9413;490;10804;11053;4.71;0.29;357.77;13.80;1391;26;3782.00;249
9415;23;621488075;9415;481;10806;11053;4.64;0.28;357.75;13.81;1391;26;3783.00;247
9417;23;621488091;9417;485;10807;11053;4.60;0.28;357.82;13.81;1390;26;3784.00;246
9421;23;621488105;9421;489;10808;11053;4.55;0.28;357.81;13.81;1387;26;3785.00;245
9424;23;621488125;9424;496;10812;11057;4.50;0.27;357.91;13.80;1388;26;3786.00;245
9424;23;621488141;9424;495;10813;11057;4.46;0.27;357.91;13.81;1389;26;3787.00;244
9426;23;621488156;9426;496;10818;11061;4.40;0.27;357.99;13.81;1392;26;3788.00;243
9428;23;621488172;9428;488;10821;11062;4.36;0.27;358.07;13.81;1393;26;3789.00;241
9432;23;621488188;9432;496;10821;11062;4.30;0.26;358.10;13.81;1389;26;3790.00;241
9433;23;621488203;9433;503;10822;11062;4.29;0.26;358.13;13.82;1389;26;3791.00;240
9435;23;621488218;9435;505;10832;11075;4.32;0.26;358.09;13.88;1397;26;3792.00;243
9436;23;621488240;9436;515;10833;11075;4.32;0.26;358.10;13.88;1397;26;3793.00;242
9438;23;621488261;9438;518;10835;11075;4.31;0.26;358.09;13.88;1397;26;3794.00;240
9439;23;621488277;9439;522;10836;11076;4.30;0.26;358.15;13.89;1397;26;3795.00;240
9439;23;621488297;9439;510;10836;11077;4.28;0.26;358.15;13.89;1397;26;3796.00;241
9441;23;621488313;9441;509;10839;11077;4.23;0.26;358.14;13.95;1398;26;3797.00;238
9444;23;621488329;9444;513;10840;11080;4.21;0.26;358.26;13.95;1396;26;3798.00;240
9447;23;621488345;9447;515;10842;11080;4.17;0.25;358.22;13.96;1395;26;3799.00;238
9448;23;621488361;9448;514;10845;11080;4.20;0.25;358.32;13.96;1397;26;3800.00;235
9450;23;621488380;9450;506;10845;11080;4.23;0.26;358.35;13.96;1395;26;3801.00;235
9451;23;621488398;9451;507;10850;11086;4.26;0.26;358.32;13.95;1399;26;3802.00;236
9452;23;621488415;9452;510;10852;11086;4.26;0.26;358.32;13.95;1400;26;3803.00;234
9455;23;621488430;9455;520;10856;11086;4.23;0.26;358.48;13.95;1401;26;3804.00;230
9457;23;621488446;9457;528;10857;11086;4.17;0.25;358.50;13.95;1400;26;3805.00;229
9458;23;621488461;9458;534;10859;11090;4.17;0.25;358.48;13.95;1401;26;3806.00;231
9460;23;621488476;9460;530;10862;11091;4.19;0.25;358.56;13.95;1402;26;3807.00;229
9464;23;621488493;9464;537;10863;11091;4.23;0.26;358.63;13.95;1399;26;3808.00;228
9466;23;621488508;9466;535;10865;11092;4.29;0.26;358.76;13.95;1399;26;3809.00;227
9468;23;621488525;9468;529;10865;11092;4.33;0.26;358.84;13.95;1397;26;3810.00;227
9470;23;621488540;9470;533;10865;11092;4.34;0.26;358.90;13.95;1395;26;3811.00;227
9473;23;621488555;9473;527;10865;11092;4.34;0.26;358.89;13.95;1392;26;3812.00;227
9477;23;621488570;9477;527;10866;11092;4.34;0.26;358.96;14.01;1389;26;3813.00;226
9480;23;621488586;9480;519;10866;11092;4.32;0.26;358.98;14.01;1386;26;3814.00;226
9483;23;621488601;9483;522;10866;11092;4.31;0.26;359.10;14.01;1383;26;3815.00;226
9485;23;621488616;9485;527;10901;11162;4.35;0.26;359.20;13.97;1416;26;3816.00;261
9487;23;621488637;9487;523;10901;11163;4.35;0.26;359.20;13.97;1414;26;3817.00;262
9488;23;621488652;9488;525;10906;11163;4.43;0.27;359.32;13.96;1418;26;3818.00;257
9491;23;621488668;9491;526;10909;11163;4.42;0.27;359.43;13.96;1418;26;3819.00;254
9491;23;621488687;9491;536;10913;11163;4.43;0.27;359.43;13.96;1422;26;3820.00;250
9494;23;621488703;9494;539;10917;11163;4.39;0.27;359.40;13.96;1423;26;3821.00;246
9496;23;621488719;9496;545;10921;11163;4.41;0.27;359.43;13.95;1425;26;3822.00;242
9499;23;621488734;9499;555;10923;11163;4.38;0.27;359.55;13.95;1424;26;3823.00;240
9500;23;621488749;9500;557;10927;11164;4.37;0.26;359.59;13.95;1427;26;3824.00;237
9502;23;621488763;9502;560;10930;11166;4.30;0.26;359.67;13.95;1428;26;3825.00;236
9504;23;621488778;9504;571;10933;11166;4.28;0.26;359.76;13.95;1429;26;3826.00;233
9505;23;621488793;9505;581;10936;11170;4.26;0.26;359.80;13.94;1431;26;3827.00;234
9510;23;621488808;9510;579;10938;11170;4.22;0.26;360.03;13.94;1428;26;3828.00;232
9511;23;621488823;9511;580;10939;11170;4.21;0.26;360.04;14.00;1428;26;3829.00;231
9513;23;621488838;9513;589;10939;11170;4.20;0.26;360.14;14.00;1426;26;3830.00;231
9515;23;621488853;9515;579;10943;11176;4.21;0.26;360.25;14.00;1428;26;3831.00;233
9516;23;621488869;9516;581;10943;11176;4.21;0.26;360.31;14.00;1427;26;3832.00;233
9516;23;621488883;9516;574;10943;11176;4.21;0.26;360.31;14.00;1427;26;3833.00;233
9519;23;621488897;9519;574;10945;11179;4.21;0.26;360.28;14.00;1426;26;3834.00;234
9523;23;621488912;9523;581;10945;11179;4.20;0.26;360.34;14.00;1422;26;3835.00;234
9525;23;621488927;9525;569;10946;11179;4.23;0.26;360.32;14.00;1421;26;3836.00;233
9528;23;621488942;9528;569;10946;11180;4.21;0.26;360.30;14.00;1418;26;3837.00;234
9532;23;621488956;9532;566;10947;11181;4.23;0.26;360.28;14.00;1415;26;3838.00;234
9534;23;621488972;9534;569;10947;11181;4.19;0.25;360.24;14.00;1413;26;3839.00;234
9537;23;621488987;9537;572;10964;11207;4.27;0.26;360.24;13.97;1427;26;3840.00;243
9540;23;621489004;9540;566;10964;11207;4.22;0.26;360.18;13.97;1424;26;3841.00;243
9543;23;621489032;9543;564;10966;11207;4.23;0.26;360.14;13.97;1423;26;3842.00;241
9547;23;621489058;9547;558;10968;11208;4.23;0.26;360.14;13.97;1421;26;3843.00;240
9550;23;621489081;9550;557;10968;11208;4.20;0.26;360.10;13.97;1418;26;3844.00;240
9552;23;621489104;9552;568;10974;11212;4.22;0.26;360.10;14.15;1422;26;3845.00;238
9555;23;621489130;9555;564;10976;11214;4.21;0.26;360.09;14.14;1421;26;3846.00;238
9557;23;621489148;9557;570;10979;11218;4.23;0.26;360.06;14.14;1422;26;3847.00;239
9561;23;621489165;9561;574;10979;11218;4.24;0.26;360.04;14.14;1418;26;3848.00;239
9562;23;621489182;9562;569;10979;11218;4.28;0.26;360.07;14.14;1417;26;3849.00;239
9565;23;621489198;9565;573;10979;11218;4.26;0.26;360.04;14.14;1414;26;3850.00;239
9566;23;621489215;9566;565;10979;11218;4.28;0.26;360.01;14.14;1413;26;3851.00;239
9567;23;621489231;9567;564;10989;11230;4.33;0.26;359.98;14.13;1422;26;3852.00;241
9572;23;621489248;9572;562;10990;11230;4.29;0.26;359.96;14.13;1418;26;3853.00;240
9573;23;621489264;9573;556;10990;11230;4.30;0.26;359.93;14.13;1417;26;3854.00;240
9576;23;621489279;9576;556;10990;11230;4.31;0.26;359.94;14.13;1414;26;3855.00;240
9577;23;621489294;9577;567;10990;11230;4.32;0.26;359.91;14.13;1413;26;3856.00;240
9580;23;621489310;9580;565;10991;11230;4.35;0.27;359.86;14.13;1411;26;3857.00;239
9583;23;621489327;9583;572;10991;11231;4.32;0.26;359.84;14.13;1408;26;3858.00;240
9584;23;621489342;9584;577;10992;11231;4.31;0.26;359.82;14.13;1408;26;3859.00;239
9587;23;621489357;9587;583;10996;11237;4.36;0.27;359.86;14.12;1409;26;3860.00;241
9588;23;621489373;9588;578;10998;11238;4.38;0.27;359.91;14.13;1410;26;3861.00;240
9591;23;621489389;9591;584;10999;11238;4.35;0.27;359.88;14.13;1408;26;3862.00;239
9594;23;621489404;9594;590;10999;11238;4.31;0.26;359.84;14.13;1405;26;3863.00;239
9595;23;621489420;9595;589;11004;11242;4.29;0.26;359.87;14.12;1409;26;3864.00;238
9597;23;621489436;9597;596;11004;11242;4.23;0.26;359.92;14.12;1407;26;3865.00;238
9598;23;621489451;9598;589;11004;11242;4.19;0.26;359.88;14.12;1406;26;3866.00;238
9600;23;621489467;9600;581;11005;11243;4.17;0.26;359.83;14.12;1405;26;3867.00;238
9600;23;621489484;9600;581;11008;11247;4.18;0.26;359.83;14.12;1408;26;3868.00;239
9601;23;621489506;9601;574;11008;11247;4.20;0.26;359.83;14.12;1407;26;3869.00;239
9605;23;621489524;9605;577;11014;11253;4.20;0.26;359.79;14.24;1409;26;3870.00;239
9608;23;621489541;9608;571;11016;11253;4.22;0.26;359.74;14.30;1408;26;3871.00;237
9610;23;621489557;9610;574;11019;11253;4.23;0.26;359.83;14.42;1409;26;3872.00;234
9611;24;621489574;9611;577;11021;11253;4.26;0.26;359.87;14.54;1410;27;3873.00;232
9614;24;621489601;9614;577;11026;11257;4.27;0.26;359.93;14.60;1412;27;3874.00;231
9616;24;621489617;9616;572;11028;11257;4.28;0.26;359.91;14.72;1412;27;3875.00;229
9617;24;621489633;9617;562;11028;11257;4.27;0.26;359.94;14.72;1411;27;3876.00;229
9618;24;621489649;9618;564;11028;11257;4.29;0.26;359.94;14.72;1410;27;3877.00;229
9619;24;621489665;9619;561;11030;11258;4.30;0.26;359.97;14.84;1411;27;3878.00;228
9620;24;621489680;9620;563;11031;11259;4.33;0.26;359.96;14.83;1411;27;3879.00;228
9621;24;621489696;9621;566;11032;11259;4.30;0.26;359.94;14.89;1411;27;3880.00;227
9621;24;621489711;9621;560;11033;11260;4.28;0.26;359.94;14.89;1412;27;3881.00;227
9621;24;621489732;9621;563;11035;11260;4.25;0.26;359.94;15.01;1414;27;3882.00;225
9623;24;621489748;9623;565;11036;11260;4.22;0.26;359.94;15.06;1413;27;3883.00;224
9626;24;621489762;9626;564;11037;11260;4.18;0.26;359.91;15.12;1411;27;3884.00;223
9627;24;621489778;9627;560;11037;11260;4.17;0.25;359.89;15.12;1410;27;3885.00;223
9630;24;621489793;9630;559;11037;11260;4.13;0.25;359.87;15.12;1407;27;3886.00;223
9631;24;621489808;9631;557;11039;11260;4.12;0.25;359.86;15.24;1408;27;3887.00;221
9634;24;621489823;9634;569;11112;11387;4.30;0.27;359.79;15.20;1478;27;3888.00;275
9634;24;621489850;9634;562;11116;11388;4.32;0.27;359.79;15.19;1482;27;3889.00;272
9635;24;621489868;9635;562;11125;11388;4.33;0.27;359.78;15.24;1490;27;3890.00;263
9636;24;621489886;9636;555;11127;11388;4.31;0.27;359.75;15.24;1491;27;3891.00;261
9637;24;621489903;9637;552;11134;11388;4.32;0.27;359.77;15.35;1497;27;3892.00;254
9639;24;621489923;9639;553;11136;11388;4.32;0.27;359.84;15.34;1497;27;3893.00;252
9641;24;621489938;9641;548;11138;11388;4.27;0.26;359.91;15.46;1497;27;3894.00;250
9645;24;621489955;9645;557;11139;11388;4.23;0.26;360.03;15.46;1494;27;3895.00;249
9645;24;621489972;9645;565;11140;11389;4.29;0.26;360.03;15.46;1495;27;3896.00;249
9647;24;621489990;9647;561;11143;11390;4.30;0.26;360.02;15.57;1496;27;3897.00;247
9648;24;621490007;9648;570;11146;11390;4.37;0.27;360.01;15.57;1498;27;3898.00;244
9650;24;621490024;9650;570;11147;11391;4.40;0.27;359.95;15.57;1497;27;3899.00;244
9652;24;621490044;9652;576;11154;11406;4.37;0.27;360.02;15.67;1502;27;3900.00;252
9655;24;621490065;9655;566;11156;11406;4.31;0.26;360.24;15.67;1501;27;3901.00;250
9658;24;621490081;9658;575;11157;11406;4.24;0.26;360.33;15.67;1499;27;3902.00;249
9660;24;621490096;9660;583;11162;11410;4.19;0.26;360.37;15.78;1502;27;3903.00;248
9665;24;621490112;9665;581;11163;11410;4.10;0.25;360.38;15.78;1498;27;3904.00;247
9667;24;621490127;9667;585;11164;11410;4.07;0.25;360.34;15.78;1497;27;3905.00;246
9669;24;621490142;9669;590;11166;11413;4.05;0.25;360.42;15.78;1497;27;3906.00;247
9672;24;621490157;9672;599;11167;11413;4.04;0.25;360.56;15.78;1495;27;3907.00;246
9676;24;621490172;9676;611;11168;11413;4.03;0.25;360.64;15.78;1492;27;3908.00;245
9681;24;621490186;9681;604;11172;11417;4.02;0.25;360.62;15.77;1491;27;3909.00;245
9682;24;621490202;9682;597;11173;11418;4.03;0.25;360.65;15.77;1491;27;3910.00;245
9685;24;621490217;9685;582;11174;11418;4.04;0.25;360.71;15.77;1489;27;3911.00;244
9689;24;621490238;9689;580;11176;11422;4.09;0.25;360.87;15.77;1487;27;3912.00;246
9691;24;621490255;9691;564;11177;11422;4.15;0.25;360.86;15.77;1486;27;3913.00;245
9696;24;621490270;9696;558;11177;11422;4.16;0.26;360.98;15.77;1481;27;3914.00;245
9698;24;621490286;9698;545;11178;11424;4.20;0.26;360.95;15.77;1480;27;3915.00;246
9704;24;621490302;9704;544;11180;11424;4.20;0.26;361.22;15.77;1476;27;3916.00;244
9707;24;621490318;9707;535;11183;11430;4.27;0.26;361.32;15.76;1476;27;3917.00;247
9710;24;621490335;9710;528;11185;11430;4.29;0.26;361.38;15.76;1475;27;3918.00;245
9714;24;621490351;9714;522;11185;11431;4.29;0.26;361.69;15.76;1471;27;3919.00;246
9716;24;621490366;9716;517;11185;11431;4.31;0.27;361.82;15.76;1469;27;3920.00;246
9718;24;621490382;9718;510;11185;11431;4.35;0.27;361.91;15.76;1467;27;3921.00;246
9727;24;621490398;9727;499;11186;11431;4.33;0.27;362.03;15.76;1459;27;3922.00;245
9731;24;621490415;9731;492;11187;11431;4.35;0.27;362.03;15.83;1456;27;3923.00;244
9735;24;621490432;9735;482;11193;11443;4.42;0.27;362.16;15.82;1458;27;3924.00;250
9739;24;621490449;9739;479;11193;11443;4.47;0.27;362.30;15.82;1454;27;3925.00;250
9743;24;621490465;9743;480;11194;11443;4.47;0.27;362.28;15.82;1451;27;3926.00;249
9744;24;621490483;9744;478;11196;11443;4.55;0.28;362.37;15.83;1452;27;3927.00;247
9748;24;621490499;9748;469;11198;11443;4.57;0.28;362.41;15.83;1450;27;3928.00;245
9753;24;621490515;9753;472;11198;11443;4.57;0.28;362.53;15.83;1445;27;3929.00;245
9758;24;621490534;9758;468;11201;11447;4.57;0.28;362.62;15.82;1443;27;3930.00;246
9765;24;621490550;9765;469;11202;11447;4.56;0.28;362.74;15.82;1437;27;3931.00;245
9765;24;621490567;9765;462;11206;11451;4.63;0.28;362.74;15.82;1441;27;3932.00;245
9771;24;621490583;9771;447;11207;11452;4.63;0.28;362.85;15.82;1436;27;3933.00;245
9775;24;621490602;9775;455;11208;11452;4.65;0.28;362.93;15.82;1433;27;3934.00;244
9779;24;621490619;9779;452;11209;11452;4.65;0.28;362.98;15.82;1430;27;3935.00;243
9782;24;621490635;9782;452;11217;11465;4.64;0.28;363.02;15.82;1435;27;3936.00;248
9788;24;621490653;9788;452;11217;11465;4.60;0.28;363.10;15.82;1429;27;3937.00;248
9791;24;621490669;9791;452;11219;11465;4.59;0.28;363.15;15.82;1428;27;3938.00;246
9796;24;621490685;9796;449;11220;11466;4.56;0.28;363.20;15.82;1424;27;3939.00;246
9800;24;621490702;9800;450;11222;11467;4.55;0.28;363.21;15.82;1422;27;3940.00;245
9803;24;621490718;9803;455;11223;11467;4.60;0.28;363.32;15.82;1420;27;3941.00;244
9808;24;621490734;9808;458;11224;11470;4.57;0.28;363.49;15.82;1416;27;3942.00;246
9810;24;621490751;9810;464;11226;11470;4.59;0.28;363.47;15.82;1416;27;3943.00;244
9812;24;621490767;9812;464;11228;11470;4.60;0.28;363.52;15.82;1416;27;3944.00;242
9817;24;621490783;9817;470;11230;11470;4.59;0.28;363.56;15.82;1413;27;3945.00;240
9820;24;621490799;9820;467;11236;11476;4.60;0.28;363.57;15.82;1416;27;3946.00;240
9822;24;621490815;9822;469;11237;11476;4.65;0.28;363.64;15.82;1415;27;3947.00;239
9828;24;621490831;9828;469;11237;11476;4.67;0.28;363.87;15.82;1409;27;3948.00;239
9832;24;621490847;9832;465;11241;11476;4.67;0.28;363.97;15.83;1409;27;3949.00;235
9835;24;621490869;9835;465;11244;11480;4.65;0.28;364.07;15.82;1409;27;3950.00;236
9839;24;621490885;9839;466;11245;11481;4.63;0.28;364.09;15.82;1406;27;3951.00;236
9840;24;621490901;9840;472;11246;11481;4.60;0.28;364.15;15.83;1406;27;3952.00;235
9844;24;621490917;9844;472;11248;11482;4.57;0.28;364.16;15.91;1404;27;3953.00;234
9845;24;621490932;9845;480;11249;11482;4.54;0.28;364.21;15.91;1404;27;3954.00;233
9849;24;621490948;9849;486;11249;11482;4.50;0.27;364.24;15.91;1400;27;3955.00;233
9851;24;621490963;9851;495;11250;11482;4.47;0.27;364.36;15.91;1399;27;3956.00;232
9853;24;621490979;9853;480;11250;11482;4.48;0.27;364.41;15.91;1397;27;3957.00;232
9857;24;621490995;9857;479;11250;11482;4.40;0.27;364.47;15.91;1393;27;3958.00;232
9860;24;621491010;9860;486;11251;11482;4.34;0.27;364.58;15.91;1391;27;3959.00;231
9863;24;621491045;9863;501;11317;11607;4.42;0.27;364.72;15.88;1454;27;3960.00;290
9867;24;621491093;9867;489;11321;11608;4.41;0.27;364.81;15.88;1454;27;3961.00;287
9869;24;621491116;9869;479;11328;11608;4.46;0.28;364.80;15.87;1459;27;3962.00;280
9873;24;621491136;9873;475;11329;11608;4.44;0.27;364.92;15.87;1456;27;3963.00;279
9879;24;621491154;9879;478;11333;11608;4.43;0.27;365.05;15.87;1454;27;3964.00;275
9882;24;621491171;9882;477;11335;11608;4.48;0.27;365.18;15.86;1453;27;3965.00;273
9884;24;621491188;9884;472;11339;11608;4.49;0.28;365.23;15.86;1455;27;3966.00;269
9886;24;621491206;9886;473;11340;11608;4.46;0.27;365.17;15.86;1454;27;3967.00;268
9889;24;621491223;9889;474;11346;11609;4.43;0.27;365.26;15.85;1457;27;3968.00;263
9891;24;621491246;9891;486;11349;11610;4.41;0.27;365.37;15.85;1458;27;3969.00;261
9892;24;621491263;9892;492;11351;11610;4.36;0.27;365.36;15.85;1459;27;3970.00;259
9894;24;621491280;9894;510;11357;11614;4.31;0.26;365.44;15.85;1463;27;3971.00;257
9899;24;621491297;9899;507;11358;11614;4.24;0.26;365.61;15.85;1459;27;3972.00;256
9901;24;621491314;9901;520;11360;11614;4.21;0.26;365.65;15.85;1459;27;3973.00;254
9903;24;621491335;9903;533;11361;11614;4.18;0.25;365.71;15.85;1458;27;3974.00;253
9907;24;621491353;9907;541;11366;11620;4.13;0.25;365.86;15.84;1459;27;3975.00;254
9909;24;621491371;9909;555;11367;11620;4.08;0.25;365.94;15.84;1458;27;3976.00;253
9912;24;621491390;9912;557;11368;11620;4.07;0.25;366.00;15.84;1456;27;3977.00;252
9912;24;621491407;9912;559;11370;11623;4.06;0.25;366.00;15.84;1458;27;3978.00;253
9915;24;621491425;9915;563;11371;11623;4.05;0.25;366.15;15.90;1456;27;3979.00;252
9916;24;621491442;9916;569;11371;11623;4.04;0.25;366.15;15.90;1455;27;3980.00;252
9920;24;621491468;9920;579;11371;11624;4.03;0.25;366.28;15.90;1451;27;3981.00;253
9922;24;621491485;9922;578;11372;11625;4.06;0.25;366.35;15.90;1450;27;3982.00;253
9926;24;621491502;9926;575;11372;11625;4.01;0.25;366.46;15.90;1446;27;3983.00;253
9926;24;621491518;9926;574;11381;11638;4.05;0.25;366.46;15.88;1455;27;3984.00;257
9931;24;621491541;9931;569;11383;11638;4.05;0.25;366.46;15.88;1452;27;3985.00;255
9933;24;621491558;9933;566;11383;11638;4.05;0.25;366.40;15.88;1450;27;3986.00;255
9934;24;621491574;9934;563;11384;11639;4.06;0.25;366.48;15.88;1450;27;3987.00;255
9936;24;621491590;9936;565;11384;11639;4.06;0.25;366.49;15.88;1448;27;3988.00;255
9937;24;621491606;9937;575;11387;11643;4.07;0.25;366.47;15.88;1450;27;3989.00;256
9940;24;621491623;9940;577;11387;11643;4.07;0.25;366.45;15.88;1447;27;3990.00;256
9944;24;621491639;9944;580;11390;11647;4.09;0.25;366.43;15.87;1446;27;3991.00;257
9946;24;621491654;9946;582;11391;11647;4.13;0.25;366.43;15.87;1445;27;3992.00;256
9949;24;621491670;9949;583;11391;11647;4.12;0.25;366.42;15.87;1442;27;3993.00;256
9950;24;621491685;9950;589;11391;11647;4.11;0.25;366.39;15.87;1441;27;3994.00;256
9955;24;621491700;9955;586;11391;11647;4.09;0.25;366.44;15.87;1436;27;3995.00;256
9957;24;621491716;9957;588;11402;11659;4.11;0.25;366.41;15.86;1445;27;3996.00;257
9958;24;621491731;9958;595;11402;11659;4.10;0.25;366.45;15.86;1444;27;3997.00;257
9961;24;621491747;9961;591;11403;11659;4.12;0.25;366.46;15.86;1442;27;3998.00;256
9964;24;621491763;9964;605;11403;11659;4.11;0.25;366.43;15.86;1439;27;3999.00;256
9967;24;621491780;9967;603;11403;11659;4.09;0.25;366.39;15.86;1436;27;4000.00;256
9969;24;621491802;9969;596;11403;11659;4.09;0.25;366.49;15.86;1434;27;4001.00;256
9970;24;621491817;9970;595;11403;11660;4.10;0.25;366.47;15.86;1433;27;4002.00;257
9971;24;621491833;9971;592;11403;11660;4.12;0.25;366.44;15.86;1432;27;4003.00;257
9973;24;621491849;9973;586;11408;11666;4.13;0.25;366.52;15.85;1435;27;4004.00;258
9974;24;621491867;9974;586;11410;11668;4.13;0.25;366.49;15.85;1436;27;4005.00;258
9974;24;621491884;9974;593;11410;11668;4.19;0.26;366.49;15.85;1436;27;4006.00;258
9977;24;621491899;9977;601;11410;11668;4.22;0.26;366.50;15.85;1433;27;4007.00;258
9979;24;621491915;9979;604;11413;11672;4.26;0.26;366.49;15.84;1434;27;4008.00;259
9982;24;621491932;9982;596;11413;11672;4.25;0.26;366.49;15.84;1431;27;4009.00;259
9984;24;621491947;9984;605;11413;11672;4.25;0.26;366.47;15.84;1429;27;4010.00;259
9986;24;621491964;9986;603;11414;11673;4.28;0.26;366.45;15.84;1428;27;4011.00;259
9987;24;621491980;9987;599;11417;11677;4.26;0.26;366.43;15.84;1430;27;4012.00;260
9988;24;621491996;9988;595;11417;11677;4.24;0.26;366.41;15.84;1429;27;4013.00;260
9993;24;621492013;9993;584;11419;11680;4.23;0.26;366.40;15.84;1426;27;4014.00;261
9994;24;621492029;9994;576;11422;11680;4.23;0.26;366.37;15.96;1428;27;4015.00;258
9997;24;621492048;9997;577;11422;11680;4.22;0.26;366.37;15.96;1425;27;4016.00;258
9999;24;621492064;9999;567;11422;11680;4.20;0.26;366.37;15.96;1423;27;4017.00;258
10000;24;621492080;10000;565;11426;11684;4.25;0.26;366.39;15.95;1426;27;4018.00;258
10005;24;621492096;10005;552;11426;11684;4.24;0.26;366.29;15.95;1421;27;4019.00;258
10005;24;621492113;10005;547;11426;11684;4.28;0.26;366.29;15.95;1421;27;4020.00;258
10006;24;621492128;10006;543;11426;11684;4.31;0.26;366.30;15.95;1420;27;4021.00;258
10008;24;621492143;10008;534;11426;11685;4.35;0.26;366.29;15.95;1418;27;4022.00;259
10011;24;621492158;10011;525;11427;11686;4.36;0.26;366.27;15.95;1416;27;4023.00;259
10013;24;621492173;10013;515;11427;11686;4.37;0.27;366.32;15.95;1414;27;4024.00;259
10014;24;621492188;10014;519;11428;11687;4.40;0.27;366.33;15.95;1414;27;4025.00;259
10017;24;621492210;10017;519;11428;11687;4.40;0.27;366.33;15.95;1411;27;4026.00;259
10020;24;621492225;10020;523;11428;11687;4.38;0.27;366.30;15.95;1408;27;4027.00;259
10021;24;621492243;10021;519;11428;11687;4.38;0.27;366.33;15.95;1407;27;4028.00;259
10021;24;621492262;10021;517;11428;11687;4.42;0.27;366.33;15.95;1407;27;4029.00;259
10022;24;621492276;10022;518;11428;11687;4.40;0.27;366.33;15.95;1406;27;4030.00;259
10022;24;621492291;10022;511;11428;11687;4.41;0.27;366.33;15.95;1406;27;4031.00;259
10023;24;621492306;10023;529;11497;11814;4.72;0.29;366.35;15.86;1474;27;4032.00;317
10025;24;621492331;10025;530;11500;11815;4.71;0.29;366.39;15.85;1475;27;4033.00;315
10027;24;621492347;10027;528;11508;11815;4.79;0.30;366.38;15.84;1481;27;4034.00;307
10027;24;621492367;10027;530;11510;11815;4.79;0.30;366.38;15.84;1483;27;4035.00;305
10028;24;621492382;10028;536;11516;11815;4.80;0.30;366.42;15.83;1488;27;4036.00;299
10028;24;621492397;10028;535;11517;11815;4.73;0.29;366.42;15.83;1489;27;4037.00;298
10028;24;621492413;10028;538;11520;11815;4.68;0.29;366.42;15.83;1492;27;4038.00;295
10032;24;621492428;10032;543;11523;11815;4.64;0.29;366.50;15.83;1491;27;4039.00;292
10035;24;621492449;10035;552;11527;11816;4.59;0.28;366.55;15.89;1492;27;4040.00;289
10038;24;621492465;10038;563;11531;11817;4.58;0.28;366.55;15.89;1493;27;4041.00;286
10038;24;621492481;10038;571;11534;11817;4.56;0.28;366.55;15.89;1496;27;4042.00;283
10039;24;621492496;10039;578;11535;11818;4.52;0.28;366.66;15.95;1496;27;4043.00;283
10042;24;621492511;10042;585;11539;11818;4.44;0.27;366.67;15.95;1497;27;4044.00;279
10044;24;621492527;10044;585;11541;11818;4.41;0.27;366.63;15.95;1497;27;4045.00;277
10047;24;621492542;10047;587;11541;11818;4.37;0.27;366.63;15.95;1494;27;4046.00;277
10047;24;621492558;10047;597;11548;11822;4.37;0.27;366.63;16.01;1501;27;4047.00;274
10051;24;621492573;10051;598;11548;11822;4.36;0.27;366.69;16.01;1497;27;4048.00;274
10052;24;621492589;10052;596;11549;11822;4.41;0.27;366.76;16.01;1497;27;4049.00;273
10053;24;621492606;10053;594;11553;11828;4.44;0.27;366.81;16.00;1500;27;4050.00;275
10055;24;621492622;10055;583;11556;11828;4.45;0.27;366.80;16.00;1501;27;4051.00;272
10058;24;621492637;10058;591;11558;11828;4.44;0.27;366.93;16.00;1500;27;4052.00;270
10062;24;621492659;10062;594;11566;11832;4.40;0.27;367.01;16.31;1504;27;4053.00;266
10063;24;621492674;10063;593;11567;11833;4.37;0.27;367.02;16.31;1504;27;4054.00;266
10065;24;621492690;10065;593;11570;11833;4.35;0.27;367.11;16.37;1505;27;4055.00;263
10067;24;621492705;10067;597;11574;11837;4.34;0.27;367.19;16.43;1507;27;4056.00;263
10071;24;621492721;10071;593;11577;11837;4.32;0.26;367.27;16.62;1506;27;4057.00;260
10072;24;621492736;10072;602;11578;11837;4.29;0.26;367.38;16.62;1506;27;4058.00;259
10073;24;621492751;10073;602;11580;11838;4.28;0.26;367.36;16.68;1507;27;4059.00;258
10076;24;621492767;10076;602;11581;11838;4.29;0.26;367.38;16.74;1505;27;4060.00;257
10080;24;621492782;10080;603;11586;11844;4.26;0.26;367.51;16.74;1506;27;4061.00;258
10081;24;621492798;10081;607;11587;11844;4.25;0.26;367.61;16.80;1506;27;4062.00;257
10085;24;621492813;10085;606;11588;11845;4.22;0.26;367.74;16.86;1503;27;4063.00;257
10086;24;621492830;10086;606;11589;11845;4.20;0.26;367.86;16.92;1503;27;4064.00;256
10088;24;621492845;10088;604;11590;11845;4.23;0.26;367.97;16.98;1502;27;4065.00;255
10089;24;621492860;10089;609;11590;11845;4.28;0.26;367.95;16.98;1501;27;4066.00;255
10090;24;621492876;10090;615;11591;11845;4.33;0.27;368.05;17.04;1501;27;4067.00;254
10095;24;621492891;10095;620;11601;11857;4.37;0.27;368.17;17.09;1506;27;4068.00;256
10096;24;621492908;10096;612;11602;11857;4.42;0.27;368.25;17.15;1506;27;4069.00;255
10100;24;621492923;10100;607;11603;11857;4.43;0.27;368.22;17.20;1503;27;4070.00;254
10102;24;621492939;10102;609;11603;11857;4.45;0.27;368.35;17.20;1501;27;4071.00;254
10103;24;621492955;10103;609;11604;11857;4.43;0.27;368.33;17.26;1501;27;4072.00;253
10109;24;621492971;10109;616;11605;11857;4.38;0.27;368.42;17.32;1496;27;4073.00;252
10111;24;621492987;10111;622;11609;11861;4.37;0.27;368.40;17.38;1498;27;4074.00;252
10113;24;621493002;10113;627;11610;11861;4.37;0.27;368.39;17.43;1497;27;4075.00;251
10114;24;621493024;10114;625;11614;11865;4.35;0.27;368.40;17.43;1500;27;4076.00;251
10121;24;621493055;10121;635;11615;11866;4.26;0.26;368.59;17.43;1494;27;4077.00;251
10124;24;621493079;10124;636;11615;11866;4.23;0.26;368.60;17.43;1491;27;4078.00;251
10128;24;621493104;10128;643;11615;11866;4.18;0.25;368.61;17.43;1487;27;4079.00;251
10135;24;621493127;10135;644;11636;11895;4.14;0.25;368.63;17.40;1501;27;4080.00;259
10138;24;621493149;10138;631;11636;11895;4.16;0.25;368.69;17.40;1498;27;4081.00;259
10142;24;621493166;10142;630;11638;11895;4.16;0.25;368.77;17.40;1496;27;4082.00;257
10147;24;621493183;10147;626;11640;11896;4.17;0.26;368.99;17.39;1493;27;4083.00;256
10149;24;621493202;10149;625;11640;11897;4.17;0.26;369.05;17.39;1491;27;4084.00;257
10150;24;621493219;10150;622;11640;11897;4.24;0.26;369.09;17.39;1490;27;4085.00;257
10154;24;621493236;10154;621;11642;11900;4.27;0.26;369.10;17.39;1488;27;4086.00;258
10155;24;621493254;10155;611;11642;11900;4.31;0.26;369.07;17.39;1487;27;4087.00;258
10159;24;621493270;10159;616;11642;11900;4.32;0.27;369.21;17.39;1483;27;4088.00;258
10160;24;621493287;10160;602;11642;11900;4.33;0.27;369.22;17.39;1482;27;4089.00;258
10162;24;621493304;10162;598;11646;11906;4.33;0.27;369.20;17.38;1484;27;4090.00;260
10167;24;621493321;10167;588;11646;11906;4.29;0.26;369.23;17.38;1479;27;4091.00;260
10170;24;621493338;10170;590;11646;11906;4.28;0.26;369.27;17.38;1476;27;4092.00;260
10175;24;621493355;10175;595;11646;11906;4.27;0.26;369.34;17.38;1471;27;4093.00;260
10180;24;621493373;10180;591;11649;11910;4.28;0.26;369.51;17.38;1469;27;4094.00;261
10182;24;621493393;10182;587;11651;11912;4.31;0.26;369.55;17.38;1469;27;4095.00;261
10184;24;621493410;10184;577;11652;11912;4.36;0.27;369.55;17.45;1468;27;4096.00;260
10190;24;621493428;10190;575;11653;11913;4.38;0.27;369.56;17.45;1463;27;4097.00;260
10191;24;621493446;10191;567;11653;11913;4.43;0.27;369.54;17.45;1462;27;4098.00;260
10194;24;621493462;10194;559;11653;11913;4.45;0.27;369.55;17.45;1459;27;4099.00;260
10197;24;621493480;10197;561;11653;11913;4.47;0.27;369.56;17.45;1456;27;4100.00;260
10202;24;621493500;10202;556;11653;11913;4.47;0.27;369.52;17.45;1451;27;4101.00;260
10209;24;621493518;10209;555;11653;11913;4.44;0.27;369.64;17.45;1444;27;4102.00;260
10213;24;621493535;10213;554;11653;11913;4.43;0.27;369.69;17.45;1440;27;4103.00;260
10215;24;621493553;10215;563;11685;11983;4.47;0.27;369.69;17.40;1470;27;4104.00;298
10217;24;621493577;10217;567;11685;11984;4.47;0.27;369.71;17.40;1468;27;4105.00;299
10218;24;621493596;10218;567;11687;11984;4.50;0.27;369.73;17.40;1469;27;4106.00;297
10220;24;621493612;10220;560;11689;11984;4.50;0.27;369.72;17.39;1469;27;4107.00;295
10224;24;621493631;10224;568;11691;11984;4.48;0.27;369.75;17.39;1467;27;4108.00;293
10229;24;621493647;10229;578;11693;11984;4.48;0.27;369.84;17.39;1464;27;4109.00;291
10233;24;621493666;10233;570;11694;11984;4.47;0.27;369.93;17.39;1461;27;4110.00;290
10237;24;621493682;10237;570;11699;11984;4.47;0.27;370.05;17.39;1462;27;4111.00;285
10243;24;621493699;10243;584;11701;11985;4.38;0.27;370.12;17.39;1458;27;4112.00;284
10245;24;621493715;10245;590;11702;11986;4.32;0.26;370.26;17.39;1457;27;4113.00;284
10246;24;621493732;10246;598;11708;11986;4.25;0.26;370.24;17.39;1462;27;4114.00;278
10248;24;621493748;10248;598;11711;11990;4.22;0.26;370.27;17.38;1463;27;4115.00;279
10252;24;621493765;10252;611;11714;11990;4.16;0.25;370.34;17.38;1462;27;4116.00;276
10253;24;621493781;10253;616;11714;11990;4.13;0.25;370.32;17.38;1461;27;4117.00;276
10257;24;621493803;10257;622;11714;11990;4.11;0.25;370.36;17.38;1457;27;4118.00;276
10260;24;621493819;10260;630;11721;11996;4.09;0.25;370.32;17.38;1461;27;4119.00;275
10266;24;621493837;10266;637;11722;11996;4.01;0.24;370.34;17.38;1456;27;4120.00;274
10267;24;621493854;10267;644;11723;11996;3.96;0.24;370.42;17.38;1456;27;4121.00;273
10270;24;621493870;10270;649;11727;11999;3.89;0.24;370.49;17.37;1457;27;4122.00;272
10273;24;621493887;10273;657;11730;11999;3.85;0.23;370.52;17.37;1457;27;4123.00;269
10275;24;621493904;10275;656;11730;11999;3.84;0.23;370.48;17.37;1455;27;4124.00;269
10279;24;621493919;10279;667;11733;12000;3.82;0.23;370.61;17.37;1454;27;4125.00;267
10280;24;621493935;10280;670;11734;12001;3.81;0.23;370.69;17.37;1454;27;4126.00;267
10284;24;621493952;10284;669;11736;12001;3.77;0.23;370.68;17.37;1452;27;4127.00;265
10287;24;621493969;10287;672;11745;12014;3.84;0.23;370.78;17.36;1458;27;4128.00;269
10293;24;621493987;10293;669;11746;12014;3.80;0.23;370.99;17.36;1453;27;4129.00;268
10294;24;621494005;10294;664;11747;12014;3.84;0.23;370.98;17.36;1453;27;4130.00;267
10296;24;621494024;10296;672;11748;12015;3.87;0.23;371.05;17.36;1452;27;4131.00;267
10298;24;621494042;10298;670;11748;12015;3.88;0.24;371.27;17.36;1450;27;4132.00;267
10298;24;621494058;10298;677;11753;12019;3.97;0.24;371.27;17.35;1455;27;4133.00;266
10301;24;621494075;10301;675;11753;12019;3.95;0.24;371.39;17.35;1452;27;4134.00;266
10304;24;621494093;10304;688;11757;12023;3.92;0.24;371.46;17.34;1453;27;4135.00;266
10306;24;621494108;10306;674;11757;12023;3.90;0.24;371.49;17.34;1451;27;4136.00;266
10309;24;621494124;10309;666;11757;12023;3.86;0.23;371.54;17.34;1448;27;4137.00;266
10310;24;621494138;10310;663;11757;12023;3.84;0.23;371.51;17.34;1447;27;4138.00;266
10315;24;621494154;10315;649;11757;12023;3.78;0.23;371.61;17.34;1442;27;4139.00;266
10317;24;621494172;10317;647;11782;12057;3.87;0.24;371.57;17.31;1465;27;4140.00;275
10319;24;621494190;10319;635;11783;12057;3.91;0.24;371.54;17.31;1464;27;4141.00;274
10322;24;621494206;10322;637;11785;12057;3.94;0.24;371.54;17.30;1463;27;4142.00;272
10323;24;621494222;10323;635;11785;12057;3.99;0.24;371.52;17.30;1462;27;4143.00;272
10325;24;621494237;10325;640;11786;12057;4.01;0.24;371.48;17.30;1461;27;4144.00;271
10325;24;621494253;10325;641;11786;12057;4.07;0.25;371.48;17.30;1461;27;4145.00;271
10328;24;621494268;10328;642;11786;12058;4.08;0.25;371.53;17.30;1458;27;4146.00;272
10329;24;621494285;10329;643;11786;12058;4.11;0.25;371.50;17.30;1457;27;4147.00;272
10332;24;621494300;10332;638;11791;12064;4.12;0.25;371.52;17.30;1459;27;4148.00;273
10336;24;621494316;10336;639;11792;12065;4.14;0.25;371.58;17.29;1456;27;4149.00;273
10337;24;621494333;10337;636;11792;12065;4.16;0.25;371.60;17.29;1455;27;4150.00;273
10341;24;621494348;10341;634;11792;12065;4.14;0.25;371.65;17.29;1451;27;4151.00;273
10343;24;621494364;10343;635;11795;12069;4.10;0.25;371.72;17.29;1452;27;4152.00;274
10345;24;621494380;10345;630;11795;12069;4.06;0.25;371.77;17.29;1450;27;4153.00;274
10349;24;621494396;10349;625;11795;12069;4.02;0.25;371.85;17.29;1446;27;4154.00;274
10353;24;621494411;10353;627;11796;12070;3.99;0.24;371.89;17.29;1443;27;4155.00;274
10356;24;621494426;10356;639;11799;12074;4.00;0.24;371.84;17.28;1443;27;4156.00;275
10358;24;621494442;10358;636;11799;12074;3.99;0.24;371.87;17.28;1441;27;4157.00;275
10361;24;621494457;10361;634;11801;12077;4.00;0.24;371.79;17.28;1440;27;4158.00;276
10362;24;621494473;10362;636;11801;12077;3.98;0.24;371.79;17.28;1439;27;4159.00;276
10364;24;621494489;10364;631;11802;12077;3.96;0.24;371.76;17.28;1438;27;4160.00;275
10366;24;621494504;10366;640;11802;12077;3.91;0.24;371.78;17.28;1436;27;4161.00;275
10368;24;621494519;10368;646;11806;12081;3.93;0.24;371.74;17.27;1438;27;4162.00;275
10370;24;621494534;10370;646;11806;12081;3.90;0.24;371.70;17.27;1436;27;4163.00;275
10371;24;621494548;10371;643;11806;12081;3.91;0.24;371.68;17.27;1435;27;4164.00;275
10373;24;621494563;10373;647;11806;12081;3.88;0.24;371.65;17.27;1433;27;4165.00;275
10375;24;621494578;10375;648;11806;12082;3.86;0.23;371.65;17.27;1431;27;4166.00;276
10375;24;621494592;10375;646;11807;12083;3.89;0.24;371.65;17.27;1432;27;4167.00;276
10378;24;621494607;10378;651;11807;12083;3.87;0.24;371.65;17.27;1429;27;4168.00;276
10380;24;621494621;10380;650;11808;12084;3.90;0.24;371.63;17.27;1428;27;4169.00;276
10381;24;621494637;10381;642;11808;12084;3.95;0.24;371.63;17.27;1427;27;4170.00;276
10381;24;621494652;10381;624;11808;12084;3.98;0.24;371.63;17.27;1427;27;4171.00;276
10382;24;621494673;10382;610;11808;12084;4.04;0.25;371.62;17.27;1426;27;4172.00;276
10382;24;621494688;10382;596;11810;12086;4.11;0.25;371.62;17.27;1428;27;4173.00;276
10383;24;621494702;10383;587;11810;12086;4.19;0.25;371.66;17.27;1427;27;4174.00;276
10384;24;621494718;10384;574;11810;12086;4.25;0.26;371.65;17.27;1426;27;4175.00;276
10384;24;621494733;10384;598;11878;12213;4.42;0.27;371.65;17.17;1494;27;4176.00;335
10388;24;621494757;10388;580;11880;12214;4.46;0.27;371.67;17.17;1492;27;4177.00;334
10390;24;621494773;10390;572;11886;12214;4.57;0.28;371.79;17.16;1496;27;4178.00;328
10391;24;621494788;10391;567;11889;12214;4.65;0.29;371.81;17.16;1498;27;4179.00;325
10395;24;621494803;10395;570;11892;12214;4.70;0.29;371.89;17.15;1497;27;4180.00;322
10398;24;621494825;10398;563;11895;12214;4.74;0.29;371.88;17.15;1497;27;4181.00;319
10400;24;621494841;10400;554;11900;12214;4.77;0.29;371.87;17.15;1500;27;4182.00;314
10402;24;621494857;10402;550;11906;12214;4.77;0.29;371.87;17.22;1504;27;4183.00;308
10404;24;621494873;10404;540;11909;12215;4.80;0.29;371.89;17.28;1505;27;4184.00;306
10406;24;621494893;10406;544;11914;12217;4.76;0.29;371.85;17.35;1508;27;4185.00;303
10407;24;621494909;10407;536;11915;12217;4.76;0.29;371.85;17.34;1508;27;4186.00;302
10408;24;621494926;10408;539;11918;12218;4.78;0.29;371.84;17.34;1510;27;4187.00;300
10409;24;621494943;10409;538;11920;12218;4.77;0.29;371.86;17.34;1511;27;4188.00;298
10411;24;621494960;10411;542;11922;12218;4.75;0.29;371.85;17.34;1511;27;4189.00;296
10411;24;621494976;10411;536;11923;12218;4.78;0.29;371.85;17.34;1512;27;4190.00;295
10412;24;621494992;10412;541;11926;12222;4.79;0.29;371.93;17.34;1514;27;4191.00;296
10412;24;621495008;10412;534;11927;12222;4.82;0.29;371.93;17.34;1515;27;4192.00;295
10416;24;621495029;10416;537;11928;12222;4.79;0.29;371.94;17.34;1512;27;4193.00;294
10418;24;621495056;10418;545;11930;12225;4.78;0.29;371.96;17.34;1512;27;4194.00;295
10423;24;621495084;10423;546;11931;12225;4.75;0.29;372.12;17.34;1508;27;4195.00;294
10425;24;621495109;10425;546;11933;12225;4.72;0.29;372.13;17.40;1508;27;4196.00;292
10428;24;621495133;10428;554;11937;12229;4.70;0.29;372.15;17.40;1509;27;4197.00;292
10430;24;621495153;10430;554;11939;12230;4.69;0.28;372.14;17.40;1509;27;4198.00;291
10432;24;621495171;10432;560;11940;12230;4.66;0.28;372.12;17.39;1508;27;4199.00;290
10435;24;621495191;10435;561;11950;12264;4.62;0.28;372.21;17.38;1515;27;4200.00;314
10435;24;621495217;10435;555;11953;12264;4.62;0.28;372.21;17.38;1518;27;4201.00;311
10440;24;621495235;10440;571;11956;12264;4.54;0.28;372.37;17.38;1516;27;4202.00;308
10441;24;621495265;10441;574;11957;12265;4.55;0.28;372.44;17.38;1516;27;4203.00;308
10442;24;621495282;10442;570;11958;12265;4.55;0.28;372.45;17.38;1516;27;4204.00;307
10445;24;621495299;10445;580;11962;12271;4.53;0.28;372.40;17.37;1517;27;4205.00;309
10447;24;621495317;10447;583;11965;12271;4.50;0.27;372.38;17.37;1518;27;4206.00;306
10449;24;621495337;10449;596;11968;12272;4.49;0.27;372.40;17.43;1519;27;4207.00;304
10453;24;621495355;10453;593;11969;12272;4.48;0.27;372.47;17.43;1516;27;4208.00;303
10456;24;621495372;10456;591;11969;12272;4.50;0.27;372.51;17.43;1513;27;4209.00;303
10457;24;621495388;10457;604;11970;12272;4.51;0.27;372.52;17.50;1513;27;4210.00;302
10457;24;621495405;10457;608;11972;12272;4.53;0.28;372.52;17.50;1515;27;4211.00;300
10459;24;621495422;10459;607;11981;12284;4.52;0.28;372.56;17.55;1522;27;4212.00;303
10462;24;621495452;10462;610;11984;12284;4.54;0.28;372.63;17.55;1522;27;4213.00;300
10465;24;621495470;10465;600;11985;12284;4.55;0.28;372.64;17.55;1520;27;4214.00;299
10466;24;621495487;10466;605;11986;12284;4.53;0.28;372.62;17.62;1520;27;4215.00;298
10469;24;621495504;10469;612;11986;12284;4.52;0.28;372.77;17.62;1517;27;4216.00;298
10471;24;621495521;10471;614;11988;12284;4.48;0.27;372.87;17.62;1517;27;4217.00;296
10474;24;621495538;10474;615;11993;12288;4.42;0.27;372.92;17.74;1519;27;4218.00;295
10476;24;621495556;10476;615;11994;12288;4.39;0.27;372.97;17.74;1518;27;4219.00;294
10479;24;621495573;10479;621;11999;12292;4.39;0.27;373.01;17.87;1520;27;4220.00;293
10481;24;621495592;10481;619;12001;12293;4.38;0.27;372.98;17.93;1520;27;4221.00;292
10484;24;621495609;10484;621;12002;12293;4.40;0.27;373.05;17.93;1518;27;4222.00;291
10488;24;621495626;10488;622;12004;12293;4.38;0.27;373.17;18.00;1516;27;4223.00;289
10491;24;621495643;10491;635;12014;12306;4.38;0.27;373.28;17.98;1523;27;4224.00;292
10496;24;621495661;10496;631;12014;12306;4.34;0.26;373.21;17.98;1518;27;4225.00;292
10498;24;621495678;10498;634;12018;12306;4.31;0.26;373.18;18.11;1520;27;4226.00;288
10500;24;621495695;10500;632;12019;12307;4.29;0.26;373.35;18.11;1519;27;4227.00;288
10502;24;621495712;10502;629;12022;12308;4.25;0.26;373.40;18.24;1520;27;4228.00;286
10503;24;621495728;10503;632;12022;12308;4.26;0.26;373.44;18.24;1519;27;4229.00;286
10504;24;621495747;10504;628;12029;12314;4.30;0.26;373.49;18.35;1525;27;4230.00;285
10504;24;621495765;10504;627;12029;12314;4.34;0.27;373.49;18.35;1525;27;4231.00;285
10509;24;621495781;10509;624;12030;12314;4.33;0.26;373.51;18.35;1521;27;4232.00;284
10510;24;621495799;10510;624;12030;12314;4.35;0.27;373.51;18.35;1520;27;4233.00;284
10513;24;621495815;10513;630;12036;12320;4.36;0.27;373.58;18.35;1523;27;4234.00;284
10515;24;621495833;10515;627;12040;12320;4.36;0.27;373.54;18.60;1525;27;4235.00;280
10517;24;621495849;10517;626;12040;12320;4.38;0.27;373.61;18.60;1523;27;4236.00;280
10518;24;621495866;10518;629;12042;12320;4.39;0.27;373.67;18.73;1524;27;4237.00;278
10519;24;621495882;10519;625;12045;12324;4.38;0.27;373.77;18.72;1526;27;4238.00;279
10523;24;621495899;10523;632;12048;12325;4.37;0.27;373.92;18.78;1525;27;4239.00;277
10527;24;621495917;10527;620;12049;12325;4.37;0.27;373.99;18.84;1522;27;4240.00;276
10530;24;621495935;10530;621;12050;12326;4.38;0.27;374.07;18.84;1520;27;4241.00;276
10534;24;621495951;10534;634;12052;12326;4.34;0.27;374.20;18.97;1518;27;4242.00;274
10536;24;621495968;10536;631;12052;12326;4.30;0.26;374.32;18.97;1516;27;4243.00;274
10543;24;621495984;10543;633;12053;12326;4.26;0.26;374.47;19.02;1510;27;4244.00;273
10544;24;621496003;10544;639;12055;12326;4.26;0.26;374.58;19.09;1511;27;4245.00;271
10548;24;621496020;10548;633;12055;12326;4.20;0.26;374.58;19.09;1507;27;4246.00;271
10552;24;621496035;10552;636;12056;12326;4.12;0.25;374.67;19.15;1504;27;4247.00;270
10555;24;621496051;10555;647;12097;12396;4.19;0.26;374.80;19.14;1542;27;4248.00;299
10559;24;621496073;10559;647;12099;12397;4.12;0.25;374.90;19.14;1540;27;4249.00;298
10565;24;621496089;10565;634;12104;12397;4.06;0.25;374.94;19.13;1539;27;4250.00;293
10567;24;621496104;10567;627;12107;12397;4.07;0.25;375.05;19.14;1540;27;4251.00;290
10571;24;621496119;10571;625;12107;12397;4.05;0.25;375.15;19.14;1536;27;4252.00;290
10573;24;621496134;10573;626;12111;12397;4.05;0.25;375.23;19.13;1538;27;4253.00;286
10577;24;621496150;10577;628;12111;12397;4.01;0.25;375.32;19.13;1534;27;4254.00;286
10579;24;621496165;10579;634;12112;12397;4.05;0.25;375.38;19.13;1533;27;4255.00;285
10584;24;621496180;10584;639;12113;12398;4.05;0.25;375.53;19.13;1529;27;4256.00;285
10586;24;621496196;10586;637;12116;12399;4.03;0.25;375.52;19.13;1530;27;4257.00;283
10590;24;621496212;10590;637;12117;12399;4.02;0.25;375.57;19.13;1527;27;4258.00;282
10593;24;621496228;10593;638;12121;12403;4.00;0.25;375.65;19.12;1528;27;4259.00;282
10599;24;621496246;10599;639;12122;12403;3.94;0.24;375.82;19.12;1523;27;4260.00;281
10601;24;621496262;10601;636;12124;12403;3.94;0.24;375.91;19.12;1523;27;4261.00;279
10604;24;621496278;10604;624;12124;12403;3.93;0.24;375.86;19.12;1520;27;4262.00;279
10610;24;621496293;10610;626;12128;12409;3.88;0.24;375.91;19.12;1518;27;4263.00;281
10613;24;621496310;10613;621;12128;12409;3.88;0.24;375.97;19.12;1515;27;4264.00;281
10618;24;621496325;10618;619;12128;12409;3.89;0.24;376.16;19.12;1510;27;4265.00;281
10622;24;621496342;10622;610;12129;12412;3.90;0.24;376.33;19.11;1507;27;4266.00;283
10626;24;621496358;10626;613;12129;12412;3.90;0.24;376.27;19.11;1503;27;4267.00;283
10630;24;621496373;10630;613;12130;12412;3.93;0.24;376.35;19.11;1500;27;4268.00;282
10632;24;621496389;10632;607;12131;12413;3.97;0.24;376.36;19.11;1499;27;4269.00;282
10636;24;621496405;10636;606;12132;12414;3.97;0.24;376.43;19.11;1496;27;4270.00;282
10639;24;621496421;10639;604;12132;12414;3.99;0.24;376.45;19.11;1493;27;4271.00;282
10642;24;621496436;10642;614;12141;12427;4.04;0.25;376.54;19.10;1499;27;4272.00;286
10649;24;621496453;10649;609;12142;12427;4.01;0.25;376.60;19.10;1493;27;4273.00;285
10656;24;621496470;10656;609;12142;12427;3.98;0.24;376.65;19.10;1486;27;4274.00;285
10659;24;621496485;10659;615;12143;12429;3.97;0.24;376.78;19.09;1484;27;4275.00;286
10664;24;621496501;10664;619;12144;12429;3.94;0.24;376.87;19.10;1480;27;4276.00;285
10670;24;621496517;10670;624;12147;12433;3.87;0.24;376.97;19.09;1477;27;4277.00;286
10671;24;621496532;10671;629;12147;12433;3.85;0.24;377.01;19.09;1476;27;4278.00;286
10680;24;621496548;10680;628;12150;12437;3.81;0.23;377.15;19.09;1470;27;4279.00;287
10685;24;621496565;10685;625;12150;12437;3.75;0.23;377.26;19.09;1465;27;4280.00;287
10689;24;621496580;10689;629;12151;12437;3.71;0.23;377.25;19.09;1462;27;4281.00;286
10694;24;621496596;10694;640;12152;12437;3.68;0.22;377.28;19.09;1458;27;4282.00;285
10698;24;621496611;10698;642;12152;12437;3.67;0.22;377.39;19.09;1454;27;4283.00;285
10701;24;621496627;10701;646;12161;12449;3.72;0.23;377.40;19.08;1460;27;4284.00;288
10707;24;621496642;10707;644;12163;12449;3.71;0.23;377.43;19.08;1456;27;4285.00;286
10711;24;621496657;10711;650;12163;12449;3.66;0.22;377.53;19.08;1452;27;4286.00;286
10713;24;621496672;10713;660;12164;12449;3.61;0.22;377.53;19.08;1451;27;4287.00;285
10718;24;621496687;10718;658;12165;12449;3.58;0.22;377.73;19.08;1447;27;4288.00;284
10723;24;621496702;10723;671;12165;12449;3.52;0.21;377.78;19.08;1442;27;4289.00;284
10724;24;621496719;10724;672;12167;12450;3.48;0.21;377.77;19.08;1443;27;4290.00;283
10727;24;621496733;10727;687;12167;12450;3.41;0.21;377.75;19.08;1440;27;4291.00;283
10731;24;621496747;10731;682;12172;12456;3.36;0.20;377.68;19.07;1441;27;4292.00;284
10733;24;621496762;10733;679;12172;12457;3.33;0.20;377.67;19.07;1439;27;4293.00;285
10736;24;621496777;10736;685;12174;12457;3.29;0.20;377.70;19.07;1438;27;4294.00;283
10737;24;621496792;10737;689;12174;12457;3.28;0.20;377.73;19.07;1437;27;4295.00;283
10741;24;621496806;10741;691;12177;12461;3.29;0.20;377.69;19.06;1436;27;4296.00;284
10745;24;621496820;10745;684;12177;12461;3.26;0.20;377.64;19.06;1432;27;4297.00;284
10750;24;621496835;10750;679;12178;12461;3.24;0.20;377.64;19.06;1428;27;4298.00;283
10750;24;621496850;10750;675;12179;12462;3.27;0.20;377.64;19.06;1429;27;4299.00;283
10752;24;621496865;10752;674;12182;12466;3.31;0.20;377.63;19.06;1430;27;4300.00;284
10754;24;621496883;10754;667;12183;12466;3.30;0.20;377.65;19.06;1429;27;4301.00;283
10758;24;621496898;10758;675;12185;12469;3.31;0.20;377.64;19.06;1427;27;4302.00;284
10759;24;621496913;10759;679;12185;12469;3.31;0.20;377.62;19.06;1426;27;4303.00;284
10765;24;621496928;10765;678;12186;12469;3.26;0.20;377.56;19.06;1421;27;4304.00;283
10765;24;621496942;10765;685;12186;12469;3.26;0.20;377.56;19.06;1421;27;4305.00;283
10768;24;621496956;10768;677;12190;12473;3.29;0.20;377.57;19.05;1422;27;4306.00;283
10772;24;621496972;10772;666;12190;12473;3.26;0.20;377.56;19.05;1418;27;4307.00;283
10774;24;621496987;10774;656;12191;12473;3.26;0.20;377.52;19.05;1417;27;4308.00;282
10777;24;621497002;10777;649;12191;12473;3.27;0.20;377.44;19.05;1414;27;4309.00;282
10779;24;621497017;10779;657;12191;12474;3.27;0.20;377.38;19.05;1412;27;4310.00;283
10780;24;621497039;10780;653;12192;12475;3.38;0.21;377.37;19.05;1412;27;4311.00;283
10780;24;621497063;10780;652;12192;12475;3.44;0.21;377.37;19.05;1412;27;4312.00;283
10781;24;621497086;10781;650;12194;12476;3.50;0.21;377.41;19.13;1413;27;4313.00;282
10781;24;621497110;10781;645;12194;12476;3.55;0.22;377.41;19.13;1413;27;4314.00;282
10782;24;621497130;10782;652;12194;12476;3.59;0.22;377.43;19.13;1412;27;4315.00;282
10784;24;621497147;10784;651;12194;12476;3.60;0.22;377.52;19.13;1410;27;4316.00;282
10784;24;621497164;10784;647;12194;12476;3.62;0.22;377.52;19.13;1410;27;4317.00;282
10784;24;621497180;10784;653;12194;12476;3.66;0.22;377.52;19.13;1410;27;4318.00;282
10784;24;621497196;10784;652;12194;12476;3.67;0.22;377.52;19.13;1410;27;4319.00;282
10784;24;621497214;10784;714;12314;12706;3.94;0.25;377.52;18.95;1530;27;4320.00;392
10784;24;621497249;10784;699;12316;12707;3.94;0.25;377.52;18.94;1532;27;4321.00;391
10785;24;621497265;10785;686;12324;12707;4.00;0.25;377.55;18.93;1539;27;4322.00;383
10785;24;621497282;10785;669;12328;12707;4.03;0.25;377.55;18.93;1543;27;4323.00;379
10786;24;621497298;10786;650;12333;12707;4.07;0.26;377.54;18.92;1547;27;4324.00;374
10787;24;621497315;10787;643;12337;12707;4.13;0.26;377.51;18.92;1550;27;4325.00;370
10793;24;621497332;10793;628;12345;12707;4.18;0.26;377.60;18.91;1552;27;4326.00;362
10795;24;621497350;10795;632;12351;12707;4.21;0.26;377.62;18.90;1556;27;4327.00;356
10795;24;621497368;10795;631;12356;12708;4.25;0.26;377.62;18.90;1561;27;4328.00;352
10796;24;621497385;10796;630;12360;12709;4.25;0.26;377.65;18.89;1564;27;4329.00;349
10796;24;621497402;10796;642;12364;12709;4.27;0.27;377.65;18.89;1568;27;4330.00;345
10798;24;621497420;10798;649;12366;12710;4.27;0.26;377.61;18.89;1568;27;4331.00;344
10801;24;621497438;10801;649;12368;12710;4.25;0.26;377.61;18.89;1567;27;4332.00;342
10801;24;621497462;10801;655;12369;12710;4.22;0.26;377.61;18.89;1568;27;4333.00;341
10801;24;621497479;10801;659;12370;12710;4.21;0.26;377.61;18.89;1569;27;4334.00;340
10802;24;621497496;10802;660;12375;12714;4.18;0.26;377.65;18.88;1573;27;4335.00;339
10803;24;621497515;10803;653;12376;12714;4.13;0.25;377.69;18.88;1573;27;4336.00;338
10806;24;621497532;10806;654;12376;12714;4.11;0.25;377.76;18.88;1570;27;4337.00;338
10807;24;621497549;10807;651;12377;12717;4.09;0.25;377.75;18.88;1570;27;4338.00;340
10809;24;621497568;10809;653;12377;12717;4.09;0.25;377.75;18.88;1568;27;4339.00;340
10810;24;621497586;10810;640;12377;12717;4.12;0.25;377.78;18.88;1567;27;4340.00;340
10811;24;621497603;10811;644;12380;12721;4.14;0.25;377.77;18.88;1569;27;4341.00;341
10813;24;621497621;10813;644;12381;12722;4.19;0.26;377.83;18.88;1568;27;4342.00;341
10815;24;621497639;10815;638;12382;12722;4.25;0.26;377.81;18.88;1567;27;4343.00;340
10816;24;621497657;10816;641;12383;12726;4.30;0.26;377.86;18.87;1567;27;4344.00;343
10817;24;621497676;10817;631;12384;12726;4.35;0.27;377.84;18.87;1567;27;4345.00;342
10819;24;621497694;10819;628;12385;12726;4.36;0.27;377.93;18.87;1566;27;4346.00;341
10821;24;621497712;10821;610;12386;12727;4.38;0.27;377.95;18.87;1565;27;4347.00;341
10827;24;621497730;10827;607;12387;12727;4.39;0.27;378.01;18.87;1560;27;4348.00;340
10831;24;621497748;10831;607;12390;12733;4.42;0.27;377.97;18.87;1559;27;4349.00;343
10832;24;621497769;10832;603;12390;12733;4.38;0.27;377.95;18.87;1558;27;4350.00;343
10837;24;621497786;10837;602;12392;12734;4.36;0.27;378.05;18.87;1555;27;4351.00;342
10843;24;621497804;10843;598;12392;12734;4.34;0.26;378.22;18.87;1549;27;4352.00;342
10844;24;621497822;10844;593;12396;12734;4.32;0.26;378.27;18.88;1552;27;4353.00;338
10847;24;621497839;10847;591;12397;12734;4.33;0.26;378.39;18.88;1550;27;4354.00;337
10849;24;621497856;10849;580;12399;12734;4.36;0.27;378.42;19.01;1550;27;4355.00;335
10851;24;621497883;10851;590;12409;12746;4.43;0.27;378.47;19.00;1558;27;4356.00;337
10856;24;621497902;10856;587;12409;12746;4.42;0.27;378.54;19.00;1553;27;4357.00;337
10860;24;621497926;10860;585;12411;12746;4.43;0.27;378.60;19.00;1551;27;4358.00;335
10862;24;621497946;10862;588;12411;12746;4.45;0.27;378.61;19.00;1549;27;4359.00;335
10866;24;621497964;10866;581;12414;12746;4.43;0.27;378.69;19.06;1548;27;4360.00;332
10871;24;621497982;10871;585;12415;12746;4.40;0.27;378.72;19.06;1544;27;4361.00;331
10872;24;621498000;10872;588;12418;12750;4.42;0.27;378.70;19.06;1546;27;4362.00;332
10873;24;621498019;10873;583;12419;12750;4.41;0.27;378.74;19.06;1546;27;4363.00;331
10875;24;621498037;10875;593;12421;12754;4.39;0.27;378.78;19.06;1546;27;4364.00;333
10876;24;621498056;10876;586;12424;12756;4.42;0.27;378.82;19.05;1548;27;4365.00;332
10878;24;621498074;10878;588;12424;12756;4.38;0.27;378.80;19.05;1546;27;4366.00;332
10880;24;621498092;10880;586;12427;12756;4.33;0.26;378.77;19.06;1547;27;4367.00;329
10882;24;621498108;10882;592;12436;12769;4.31;0.26;378.88;19.04;1554;27;4368.00;333
10885;24;621498128;10885;591;12436;12769;4.25;0.26;378.96;19.04;1551;27;4369.00;333
10886;24;621498145;10886;593;12438;12769;4.22;0.26;378.97;19.05;1552;27;4370.00;331
10886;24;621498162;10886;613;12439;12770;4.22;0.26;378.97;19.05;1553;27;4371.00;331
10889;24;621498182;10889;612;12441;12771;4.20;0.26;378.98;19.05;1552;27;4372.00;330
10889;24;621498203;10889;616;12442;12771;4.21;0.26;378.98;19.05;1553;27;4373.00;329
10892;24;621498223;10892;624;12445;12774;4.23;0.26;379.00;19.05;1553;27;4374.00;329
10895;24;621498249;10895;629;12445;12774;4.21;0.26;378.97;19.05;1550;27;4375.00;329
10896;24;621498265;10896;631;12447;12774;4.23;0.26;379.00;19.05;1551;27;4376.00;327
10898;24;621498281;10898;628;12448;12774;4.25;0.26;379.12;19.05;1550;27;4377.00;326
10899;24;621498298;10899;635;12453;12780;4.28;0.26;379.10;19.05;1554;27;4378.00;327
10902;24;621498315;10902;636;12454;12780;4.27;0.26;379.08;19.05;1552;27;4379.00;326
10904;24;621498333;10904;645;12454;12780;4.27;0.26;379.05;19.05;1550;27;4380.00;326
10909;24;621498350;10909;644;12454;12780;4.29;0.26;379.15;19.05;1545;27;4381.00;326
10912;24;621498366;10912;646;12458;12784;4.27;0.26;379.22;19.11;1546;27;4382.00;326
10915;24;621498382;10915;650;12460;12785;4.29;0.26;379.17;19.11;1545;27;4383.00;325
10920;24;621498400;10920;651;12463;12785;4.26;0.26;379.19;19.19;1543;27;4384.00;322
10922;24;621498417;10922;657;12466;12786;4.28;0.26;379.23;19.19;1544;27;4385.00;320
10926;24;621498433;10926;661;12468;12786;4.25;0.26;379.32;19.26;1542;27;4386.00;318
10928;24;621498450;10928;665;12469;12786;4.25;0.26;379.30;19.26;1541;27;4387.00;317
10933;24;621498467;10933;674;12471;12786;4.22;0.26;379.34;19.40;1538;27;4388.00;315
10935;24;621498484;10935;668;12472;12786;4.23;0.26;379.30;19.40;1537;27;4389.00;314
10936;24;621498500;10936;678;12472;12786;4.20;0.26;379.39;19.40;1536;27;4390.00;314
10940;24;621498515;10940;676;12474;12786;4.21;0.26;379.40;19.53;1534;27;4391.00;312
10941;24;621498532;10941;683;12509;12856;4.30;0.26;379.42;19.48;1568;27;4392.00;347
10942;24;621498553;10942;680;12512;12857;4.30;0.26;379.46;19.47;1570;27;4393.00;345
10944;24;621498575;10944;678;12519;12857;4.31;0.26;379.53;19.60;1575;27;4394.00;338
10946;24;621498592;10946;681;12522;12857;4.29;0.26;379.67;19.59;1576;27;4395.00;335
10947;24;621498608;10947;683;12525;12857;4.26;0.26;379.70;19.59;1578;27;4396.00;332
10948;24;621498625;10948;681;12530;12857;4.26;0.26;379.68;19.58;1582;27;4397.00;327
10949;24;621498641;10949;690;12534;12857;4.24;0.26;379.78;19.64;1585;27;4398.00;323
10951;25;621498657;10951;691;12536;12857;4.24;0.26;379.78;19.64;1585;28;4399.00;321
10953;25;621498685;10953;689;12538;12858;4.24;0.26;379.86;19.64;1585;28;4400.00;320
10958;25;621498707;10958;692;12541;12859;4.23;0.26;379.83;19.70;1583;28;4401.00;318
10961;25;621498725;10961;687;12542;12859;4.20;0.26;379.82;19.70;1581;28;4402.00;317
10963;25;621498742;10963;685;12545;12863;4.17;0.26;379.83;19.70;1582;28;4403.00;318
10964;25;621498762;10964;686;12546;12863;4.17;0.25;379.81;19.76;1582;28;4404.00;317
10967;25;621498778;10967;689;12546;12863;4.13;0.25;379.91;19.76;1579;28;4405.00;317
10969;25;621498795;10969;691;12546;12863;4.13;0.25;379.99;19.76;1577;28;4406.00;317
10971;25;621498811;10971;692;12553;12869;4.17;0.26;380.05;19.89;1582;28;4407.00;316
10977;25;621498829;10977;683;12553;12869;4.16;0.25;380.16;19.89;1576;28;4408.00;316
10980;25;621498850;10980;686;12553;12869;4.14;0.25;380.21;19.89;1573;28;4409.00;316
10980;25;621498874;10980;680;12556;12875;4.14;0.25;380.21;19.88;1576;28;4410.00;319
10982;25;621498892;10982;679;12556;12875;4.07;0.25;380.23;19.88;1574;28;4411.00;319
10983;25;621498908;10983;682;12557;12875;4.07;0.25;380.24;19.88;1574;28;4412.00;318
10985;25;621498924;10985;685;12557;12876;4.02;0.25;380.35;19.88;1572;28;4413.00;319
10992;25;621498940;10992;686;12558;12877;3.93;0.24;380.49;19.88;1566;28;4414.00;319
10997;25;621498956;10997;696;12558;12877;3.87;0.24;380.42;19.88;1561;28;4415.00;319
11001;25;621498973;11001;694;12568;12890;3.83;0.23;380.34;19.86;1567;28;4416.00;322
11005;25;621498989;11005;700;12568;12890;3.75;0.23;380.43;19.86;1563;28;4417.00;322
11007;25;621499005;11007;708;12569;12890;3.71;0.23;380.41;19.86;1562;28;4418.00;321
11010;25;621499024;11010;714;12569;12891;3.67;0.22;380.38;19.86;1559;28;4419.00;322
11011;25;621499047;11011;705;12569;12891;3.65;0.22;380.39;19.86;1558;28;4420.00;322
11013;25;621499070;11013;710;12573;12895;3.67;0.22;380.36;19.86;1560;28;4421.00;322
11018;25;621499093;11018;704;12573;12895;3.67;0.22;380.41;19.86;1555;28;4422.00;322
11020;25;621499116;11020;704;12577;12899;3.67;0.22;380.50;19.85;1557;28;4423.00;322
11024;25;621499139;11024;685;12578;12899;3.69;0.23;380.56;19.86;1554;28;4424.00;321
11029;25;621499156;11029;690;12578;12899;3.69;0.23;380.74;19.86;1549;28;4425.00;321
11031;25;621499180;11031;685;12578;12899;3.69;0.23;380.83;19.86;1547;28;4426.00;321
11034;25;621499198;11034;674;12578;12899;3.69;0.23;381.03;19.86;1544;28;4427.00;321
11037;25;621499218;11037;671;12587;12911;3.75;0.23;380.97;19.84;1550;28;4428.00;324
11040;25;621499237;11040;663;12587;12911;3.73;0.23;381.08;19.84;1547;28;4429.00;324
11042;25;621499253;11042;666;12587;12911;3.71;0.23;381.09;19.84;1545;28;4430.00;324
11048;25;621499271;11048;667;12587;12911;3.69;0.23;381.14;19.84;1539;28;4431.00;324
11052;25;621499288;11052;666;12587;12911;3.69;0.23;381.24;19.84;1535;28;4432.00;324
11057;25;621499305;11057;655;12587;12911;3.70;0.23;381.18;19.84;1530;28;4433.00;324
11060;25;621499322;11060;652;12587;12912;3.74;0.23;381.22;19.84;1527;28;4434.00;325
11062;25;621499339;11062;648;12587;12912;3.75;0.23;381.27;19.84;1525;28;4435.00;325
11066;25;621499356;11066;642;12591;12918;3.78;0.23;381.26;19.84;1525;28;4436.00;327
11068;25;621499374;11068;645;12591;12919;3.77;0.23;381.22;19.84;1523;28;4437.00;328
11071;25;621499391;11071;645;12591;12919;3.73;0.23;381.23;19.84;1520;28;4438.00;328
11076;25;621499408;11076;641;12591;12919;3.71;0.23;381.15;19.84;1515;28;4439.00;328
11078;25;621499428;11078;653;12595;12924;3.73;0.23;381.14;19.83;1517;28;4440.00;329
11080;25;621499446;11080;649;12595;12924;3.69;0.23;381.14;19.83;1515;28;4441.00;329
11083;25;621499463;11083;643;12595;12924;3.66;0.22;381.15;19.83;1512;28;4442.00;329
11085;25;621499480;11085;650;12597;12925;3.63;0.22;381.13;19.83;1512;28;4443.00;328
11087;25;621499497;11087;655;12600;12929;3.59;0.22;381.14;19.82;1513;28;4444.00;329
11089;25;621499513;11089;661;12600;12929;3.56;0.22;381.13;19.82;1511;28;4445.00;329
11095;25;621499530;11095;651;12601;12932;3.52;0.22;381.06;19.82;1506;28;4446.00;331
11098;25;621499547;11098;655;12601;12932;3.51;0.21;381.11;19.82;1503;28;4447.00;331
11103;25;621499566;11103;666;12602;12932;3.47;0.21;381.06;19.82;1499;28;4448.00;330
11104;25;621499582;11104;667;12603;12932;3.48;0.21;381.04;19.82;1499;28;4449.00;329
11107;25;621499599;11107;667;12606;12936;3.48;0.21;381.04;19.82;1499;28;4450.00;330
11109;25;621499621;11109;664;12607;12936;3.44;0.21;381.07;19.91;1498;28;4451.00;329
11114;25;621499639;11114;666;12609;12936;3.36;0.21;380.99;19.92;1495;28;4452.00;327
11120;25;621499656;11120;664;12609;12936;3.29;0.20;380.90;19.92;1489;28;4453.00;327
11125;25;621499672;11125;654;12610;12937;3.22;0.20;380.95;19.92;1485;28;4454.00;327
11127;25;621499688;11127;664;12612;12939;3.17;0.19;380.90;19.92;1485;28;4455.00;327
11130;25;621499704;11130;668;12613;12939;3.13;0.19;380.89;19.91;1483;28;4456.00;326
11136;25;621499720;11136;670;12614;12940;3.09;0.19;380.88;19.91;1478;28;4457.00;326
11142;25;621499736;11142;669;12616;12940;3.04;0.18;381.07;19.91;1474;28;4458.00;324
11143;25;621499752;11143;676;12616;12940;3.04;0.19;381.04;19.91;1473;28;4459.00;324
11145;25;621499768;11145;676;12616;12940;3.02;0.18;381.07;19.91;1471;28;4460.00;324
11149;25;621499783;11149;671;12617;12940;2.98;0.18;380.99;19.91;1468;28;4461.00;323
11151;25;621499799;11151;671;12617;12940;2.97;0.18;381.02;19.91;1466;28;4462.00;323
11154;25;621499813;11154;674;12617;12940;2.92;0.18;380.97;19.91;1463;28;4463.00;323
11154;25;621499828;11154;686;12686;13067;3.24;0.20;380.97;19.81;1532;28;4464.00;381
11159;25;621499854;11159;680;12689;13068;3.26;0.20;381.04;19.80;1530;28;4465.00;379
11159;25;621499870;11159;681;12694;13068;3.35;0.21;381.04;19.80;1535;28;4466.00;374
11163;25;621499886;11163;676;12698;13068;3.35;0.21;381.12;19.79;1535;28;4467.00;370
11164;25;621499902;11164;672;12702;13068;3.39;0.21;381.16;19.79;1538;28;4468.00;366
11166;25;621499919;11166;673;12704;13068;3.43;0.21;381.22;19.78;1538;28;4469.00;364
11167;25;621499937;11167;678;12706;13068;3.44;0.21;381.29;19.78;1539;28;4470.00;362
11168;25;621499960;11168;679;12708;13068;3.46;0.21;381.32;19.78;1540;28;4471.00;360
11168;25;621499977;11168;685;12711;13069;3.50;0.22;381.32;19.78;1543;28;4472.00;358
11168;25;621499993;11168;692;12713;13070;3.50;0.22;381.32;19.78;1545;28;4473.00;357
11171;25;621500009;11171;701;12716;13070;3.47;0.21;381.36;19.77;1545;28;4474.00;354
11172;25;621500026;11172;690;12717;13071;3.46;0.21;381.38;19.77;1545;28;4475.00;354
11172;25;621500042;11172;676;12719;13071;3.48;0.22;381.38;19.77;1547;28;4476.00;352
11174;25;621500058;11174;664;12721;13071;3.50;0.22;381.36;19.77;1547;28;4477.00;350
11176;25;621500075;11176;659;12723;13071;3.59;0.22;381.34;19.77;1547;28;4478.00;348
11177;25;621500092;11177;640;12727;13075;3.68;0.23;381.32;19.76;1550;28;4479.00;348
11177;25;621500113;11177;629;12729;13075;3.77;0.23;381.32;19.76;1552;28;4480.00;346
11178;25;621500135;11178;624;12730;13075;3.88;0.24;381.31;19.76;1552;28;4481.00;345
11178;25;621500162;11178;617;12733;13078;3.98;0.24;381.31;19.76;1555;28;4482.00;345
11180;25;621500179;11180;614;12734;13078;4.04;0.25;381.27;19.76;1554;28;4483.00;344
11181;25;621500196;11181;604;12735;13078;4.13;0.25;381.25;19.76;1554;28;4484.00;343
11182;25;621500214;11182;599;12739;13082;4.18;0.26;381.25;19.76;1557;28;4485.00;343
11183;25;621500233;11183;598;12740;13083;4.22;0.26;381.26;19.76;1557;28;4486.00;343
11185;25;621500250;11185;590;12741;13083;4.26;0.26;381.23;19.75;1556;28;4487.00;342
11187;25;621500267;11187;582;12743;13087;4.28;0.26;381.23;19.75;1556;28;4488.00;344
11189;25;621500285;11189;581;12746;13087;4.25;0.26;381.18;19.75;1557;28;4489.00;341
11190;25;621500302;11190;575;12747;13087;4.27;0.26;381.16;19.75;1557;28;4490.00;340
11193;25;621500321;11193;576;12747;13088;4.27;0.26;381.29;19.75;1554;28;4491.00;341
11196;25;621500339;11196;569;12747;13088;4.27;0.26;381.28;19.75;1551;28;4492.00;341
11198;25;621500357;11198;559;12751;13094;4.31;0.26;381.26;19.74;1553;28;4493.00;343
11199;25;621500375;11199;566;12751;13094;4.33;0.26;381.24;19.74;1552;28;4494.00;343
11199;25;621500393;11199;571;12751;13095;4.36;0.26;381.24;19.74;1552;28;4495.00;344
11200;25;621500411;11200;569;12751;13095;4.34;0.26;381.28;19.74;1551;28;4496.00;344
11201;25;621500427;11201;565;12752;13095;4.33;0.26;381.39;19.84;1551;28;4497.00;343
11206;25;621500445;11206;571;12754;13095;4.28;0.26;381.36;19.84;1548;28;4498.00;341
11209;25;621500462;11209;578;12754;13095;4.25;0.26;381.45;19.84;1545;28;4499.00;341
11209;25;621500481;11209;584;12779;13145;4.33;0.26;381.45;19.80;1570;28;4500.00;366
11211;25;621500507;11211;591;12781;13147;4.37;0.27;381.54;19.80;1570;28;4501.00;366
11212;25;621500524;11212;589;12784;13147;4.42;0.27;381.51;19.80;1572;28;4502.00;363
11214;25;621500541;11214;585;12785;13147;4.45;0.27;381.52;19.80;1571;28;4503.00;362
11215;25;621500558;11215;590;12787;13147;4.51;0.27;381.49;19.80;1572;28;4504.00;360
11219;25;621500575;11219;585;12788;13147;4.52;0.27;381.79;19.80;1569;28;4505.00;359
11221;25;621500593;11221;592;12794;13151;4.52;0.28;381.81;19.79;1573;28;4506.00;357
11225;25;621500611;11225;590;12794;13151;4.52;0.27;382.05;19.79;1569;28;4507.00;357
11227;25;621500628;11227;589;12796;13155;4.51;0.27;382.18;19.79;1569;28;4508.00;359
11229;25;621500645;11229;589;12798;13156;4.48;0.27;382.20;19.79;1569;28;4509.00;358
11229;25;621500663;11229;585;12799;13156;4.52;0.28;382.20;19.79;1570;28;4510.00;357
11232;25;621500680;11232;579;12799;13156;4.53;0.28;382.31;19.79;1567;28;4511.00;357
11236;25;621500698;11236;578;12811;13169;4.55;0.28;382.37;19.87;1575;28;4512.00;358
11238;25;621500718;11238;579;12811;13169;4.60;0.28;382.35;19.87;1573;28;4513.00;358
11241;25;621500735;11241;572;12813;13169;4.62;0.28;382.37;19.87;1572;28;4514.00;356
11245;25;621500753;11245;570;12815;13170;4.63;0.28;382.57;19.97;1570;28;4515.00;355
11246;25;621500776;11246;558;12815;13171;4.65;0.28;382.65;19.97;1569;28;4516.00;356
11249;25;621500800;11249;561;12815;13171;4.64;0.28;382.75;19.97;1566;28;4517.00;356
11252;25;621500817;11252;562;12818;13174;4.64;0.28;382.85;19.97;1566;28;4518.00;356
11253;25;621500834;11253;562;12818;13174;4.63;0.28;382.84;19.97;1565;28;4519.00;356
11254;25;621500851;11254;569;12818;13174;4.59;0.28;382.88;19.97;1564;28;4520.00;356
11256;25;621500868;11256;562;12818;13174;4.55;0.28;382.87;19.97;1562;28;4521.00;356
11257;25;621500885;11257;555;12821;13180;4.55;0.28;382.88;19.96;1564;28;4522.00;359
11259;25;621500902;11259;550;12821;13180;4.53;0.27;382.95;19.96;1562;28;4523.00;359
11262;25;621500919;11262;558;12823;13180;4.47;0.27;383.04;19.96;1561;28;4524.00;357
11264;25;621500937;11264;553;12823;13180;4.48;0.27;383.10;19.96;1559;28;4525.00;357
11265;25;621500954;11265;556;12826;13184;4.49;0.27;383.10;19.96;1561;28;4526.00;358
11269;25;621500972;11269;557;12826;13185;4.46;0.27;383.12;19.96;1557;28;4527.00;359
11271;25;621500989;11271;561;12826;13185;4.48;0.27;383.14;19.96;1555;28;4528.00;359
11277;25;621501006;11277;561;12827;13186;4.50;0.27;383.27;19.96;1550;28;4529.00;359
11280;25;621501029;11280;565;12830;13186;4.50;0.27;383.32;19.96;1550;28;4530.00;356
11283;25;621501060;11283;569;12830;13186;4.51;0.27;383.47;19.96;1547;28;4531.00;356
11286;25;621501088;11286;572;12830;13186;4.51;0.27;383.60;19.96;1544;28;4532.00;356
11290;25;621501114;11290;568;12830;13186;4.52;0.27;383.61;19.96;1540;28;4533.00;356
11292;25;621501137;11292;580;12830;13186;4.51;0.27;383.74;19.96;1538;28;4534.00;356
11299;25;621501156;11299;582;12830;13186;4.46;0.27;383.88;19.96;1531;28;4535.00;356
11304;25;621501175;11304;600;12865;13256;4.47;0.27;384.02;19.91;1561;28;4536.00;391
11305;25;621501200;11305;607;12865;13257;4.48;0.27;384.01;19.91;1560;28;4537.00;392
11307;25;621501218;11307;596;12869;13257;4.49;0.27;384.04;19.90;1562;28;4538.00;388
11309;25;621501236;11309;595;12871;13257;4.53;0.28;384.06;19.90;1562;28;4539.00;386
11313;25;621501256;11313;597;12875;13257;4.53;0.28;384.19;19.90;1562;28;4540.00;382
11315;25;621501274;11315;604;12878;13257;4.54;0.28;384.20;19.90;1563;28;4541.00;379
11317;25;621501292;11317;593;12879;13257;4.53;0.28;384.28;19.90;1562;28;4542.00;378
11320;25;621501309;11320;598;12881;13257;4.50;0.27;384.41;19.90;1561;28;4543.00;376
11320;25;621501327;11320;596;12882;13258;4.50;0.27;384.41;19.90;1562;28;4544.00;376
11323;25;621501345;11323;603;12883;13260;4.50;0.27;384.37;19.89;1560;28;4545.00;377
11325;25;621501363;11325;606;12883;13260;4.50;0.27;384.33;19.89;1558;28;4546.00;377
11328;25;621501380;11328;606;12887;13264;4.54;0.28;384.27;19.89;1559;28;4547.00;377
11329;25;621501399;11329;614;12888;13264;4.57;0.28;384.26;19.89;1559;28;4548.00;376
11331;25;621501416;11331;623;12889;13264;4.56;0.28;384.29;19.89;1558;28;4549.00;375
11332;25;621501434;11332;625;12890;13264;4.55;0.28;384.31;19.89;1558;28;4550.00;374
11333;25;621501459;11333;624;12894;13270;4.55;0.28;384.31;19.88;1561;28;4551.00;376
11336;25;621501482;11336;622;12895;13270;4.54;0.28;384.38;19.88;1559;28;4552.00;375
11338;25;621501508;11338;625;12895;13270;4.54;0.28;384.34;19.88;1557;28;4553.00;375
11340;25;621501526;11340;629;12896;13273;4.52;0.27;384.36;19.88;1556;28;4554.00;377
11341;25;621501545;11341;626;12896;13273;4.52;0.28;384.48;19.88;1555;28;4555.00;377
11344;25;621501563;11344;629;12896;13273;4.49;0.27;384.65;19.88;1552;28;4556.00;377
11345;25;621501581;11345;628;12896;13274;4.47;0.27;384.70;19.88;1551;28;4557.00;378
11349;25;621501599;11349;628;12897;13275;4.45;0.27;384.68;19.88;1548;28;4558.00;378
11351;25;621501617;11351;625;12897;13275;4.43;0.27;384.77;19.88;1546;28;4559.00;378
11352;25;621501637;11352;631;12913;13301;4.46;0.27;384.76;19.85;1561;28;4560.00;388
11355;25;621501656;11355;621;12913;13301;4.38;0.27;384.73;19.85;1558;28;4561.00;388
11357;25;621501674;11357;625;12915;13301;4.40;0.27;384.78;19.85;1558;28;4562.00;386
11361;25;621501692;11361;623;12917;13302;4.41;0.27;384.78;19.85;1556;28;4563.00;385
11363;25;621501710;11363;628;12917;13302;4.41;0.27;384.80;19.85;1554;28;4564.00;385
11367;25;621501727;11367;631;12920;13306;4.40;0.27;384.89;19.85;1553;28;4565.00;386
11370;25;621501744;11370;633;12920;13306;4.37;0.27;384.99;19.85;1550;28;4566.00;386
11374;25;621501767;11374;646;12921;13310;4.32;0.26;385.01;19.84;1547;28;4567.00;389
11378;25;621501783;11378;649;12921;13310;4.29;0.26;385.01;19.84;1543;28;4568.00;389
11379;25;621501800;11379;641;12921;13310;4.29;0.26;385.11;19.84;1542;28;4569.00;389
11382;25;621501816;11382;640;12921;13310;4.27;0.26;385.28;19.84;1539;28;4570.00;389
11386;25;621501834;11386;641;12921;13310;4.24;0.26;385.29;19.84;1535;28;4571.00;389
11390;25;621501850;11390;636;12928;13322;4.24;0.26;385.29;19.83;1538;28;4572.00;394
11392;25;621501869;11392;635;12928;13322;4.20;0.26;385.33;19.83;1536;28;4573.00;394
11395;25;621501886;11395;629;12929;13322;4.18;0.25;385.31;19.83;1534;28;4574.00;393
11396;25;621501904;11396;633;12929;13322;4.14;0.25;385.37;19.83;1533;28;4575.00;393
11400;25;621501919;11400;627;12929;13322;4.12;0.25;385.50;19.83;1529;28;4576.00;393
11402;25;621501937;11402;629;12929;13322;4.13;0.25;385.52;19.83;1527;28;4577.00;393
11404;25;621501953;11404;632;12929;13323;4.11;0.25;385.59;19.83;1525;28;4578.00;394
11410;25;621501970;11410;637;12929;13323;4.09;0.25;385.78;19.83;1519;28;4579.00;394
11412;25;621501987;11412;632;12933;13329;4.11;0.25;385.78;19.83;1521;28;4580.00;396
11415;25;621502012;11415;627;12933;13330;4.07;0.25;385.82;19.83;1518;28;4581.00;397
11422;25;621502029;11422;634;12933;13330;4.01;0.24;385.93;19.83;1511;28;4582.00;397
11425;25;621502052;11425;644;12933;13330;3.97;0.24;385.98;19.83;1508;28;4583.00;397
11427;25;621502067;11427;655;12936;13334;3.95;0.24;385.94;19.82;1509;28;4584.00;398
11431;25;621502083;11431;657;12938;13334;3.90;0.24;386.01;19.83;1507;28;4585.00;396
11436;25;621502098;11436;666;12938;13334;3.83;0.23;385.96;19.83;1502;28;4586.00;396
11440;25;621502112;11440;672;12939;13335;3.75;0.23;386.12;19.82;1499;28;4587.00;396
11445;25;621502127;11445;676;12940;13339;3.64;0.22;386.21;19.82;1495;28;4588.00;399
11446;25;621502142;11446;689;12940;13339;3.60;0.22;386.18;19.82;1494;28;4589.00;399
11451;25;621502157;11451;684;12943;13345;3.53;0.21;386.25;19.82;1492;28;4590.00;402
11455;25;621502172;11455;675;12943;13345;3.48;0.21;386.22;19.82;1488;28;4591.00;402
11458;25;621502188;11458;674;12943;13345;3.44;0.21;386.28;19.82;1485;28;4592.00;402
11460;25;621502202;11460;674;12943;13345;3.42;0.21;386.34;19.82;1483;28;4593.00;402
11463;25;621502218;11463;676;12946;13349;3.41;0.21;386.35;19.81;1483;28;4594.00;403
11465;25;621502234;11465;675;12946;13349;3.39;0.21;386.34;19.81;1481;28;4595.00;403
11468;25;621502250;11468;672;12946;13349;3.38;0.21;386.33;19.81;1478;28;4596.00;403
11471;25;621502265;11471;665;12946;13349;3.35;0.21;386.29;19.81;1475;28;4597.00;403
11474;25;621502280;11474;662;12946;13350;3.31;0.20;386.33;19.81;1472;28;4598.00;404
11477;25;621502296;11477;661;12946;13351;3.30;0.20;386.31;19.81;1469;28;4599.00;405
11482;25;621502311;11482;659;12946;13351;3.27;0.20;386.34;19.81;1464;28;4600.00;405
11484;25;621502330;11484;653;12947;13352;3.28;0.20;386.37;19.81;1463;28;4601.00;405
11485;25;621502344;11485;647;12947;13352;3.29;0.20;386.39;19.81;1462;28;4602.00;405
11488;25;621502359;11488;642;12947;13352;3.30;0.20;386.40;19.81;1459;28;4603.00;405
11489;25;621502373;11489;640;12947;13352;3.30;0.20;386.37;19.81;1458;28;4604.00;405
11493;25;621502388;11493;632;12947;13352;3.31;0.20;386.40;19.81;1454;28;4605.00;405
11497;25;621502403;11497;631;12947;13352;3.30;0.20;386.43;19.81;1450;28;4606.00;405
11504;25;621502418;11504;627;12947;13352;3.31;0.20;386.34;19.81;1443;28;4607.00;405
11508;25;621502432;11508;628;13005;13479;3.65;0.23;386.31;19.72;1497;28;4608.00;474
11512;25;621502460;11512;624;13008;13480;3.68;0.23;386.30;19.72;1496;28;4609.00;472
11516;25;621502476;11516;621;13015;13480;3.69;0.23;386.27;19.71;1499;28;4610.00;465
11524;25;621502492;11524;624;13016;13480;3.64;0.23;386.15;19.71;1492;28;4611.00;464
11525;25;621502507;11525;623;13021;13480;3.65;0.23;386.12;19.70;1496;28;4612.00;459
11526;25;621502521;11526;630;13026;13480;3.66;0.23;386.14;19.70;1500;28;4613.00;454
11531;25;621502536;11531;625;13028;13480;3.61;0.22;386.14;19.70;1497;28;4614.00;452
11533;25;621502552;11533;628;13030;13480;3.55;0.22;386.10;19.69;1497;28;4615.00;450
11536;25;621502567;11536;632;13031;13481;3.52;0.22;386.09;19.69;1495;28;4616.00;450
11539;25;621502582;11539;641;13032;13482;3.47;0.22;386.04;19.69;1493;28;4617.00;450
11542;25;621502602;11542;649;13035;13482;3.42;0.21;386.08;19.70;1493;28;4618.00;447
11545;25;621502617;11545;661;13038;13483;3.35;0.21;386.13;19.70;1493;28;4619.00;445
11545;25;621502634;11545;666;13038;13483;3.33;0.21;386.13;19.70;1493;28;4620.00;445
11548;25;621502648;11548;677;13041;13483;3.29;0.20;386.14;19.71;1493;28;4621.00;442
11554;25;621502663;11554;678;13041;13483;3.25;0.20;386.17;19.71;1487;28;4622.00;442
11556;25;621502678;11556;684;13044;13487;3.21;0.20;386.17;19.71;1488;28;4623.00;443
11560;25;621502698;11560;685;13048;13487;3.17;0.20;386.17;19.73;1488;28;4624.00;439
11561;25;621502713;11561;690;13048;13487;3.16;0.20;386.25;19.73;1487;28;4625.00;439
11567;25;621502728;11567;696;13050;13490;3.13;0.19;386.25;19.73;1483;28;4626.00;440
11568;25;621502743;11568;679;13052;13490;3.15;0.19;386.26;19.74;1484;28;4627.00;438
11573;25;621502758;11573;677;13053;13490;3.14;0.19;386.30;19.74;1480;28;4628.00;437
11576;25;621502773;11576;668;13055;13494;3.15;0.19;386.28;19.75;1479;28;4629.00;439
11577;25;621502788;11577;664;13058;13495;3.20;0.20;386.27;19.76;1481;28;4630.00;437
11578;25;621502803;11578;649;13059;13495;3.25;0.20;386.29;19.76;1481;28;4631.00;436
11583;25;621502818;11583;644;13064;13499;3.29;0.20;386.18;19.76;1481;28;4632.00;435
11584;25;621502836;11584;634;13066;13499;3.34;0.20;386.17;19.77;1482;28;4633.00;433
11588;25;621502853;11588;637;13067;13499;3.32;0.20;386.13;19.78;1479;28;4634.00;432
11591;25;621502869;11591;634;13069;13501;3.35;0.20;386.10;19.79;1478;28;4635.00;432
11595;25;621502890;11595;631;13073;13501;3.34;0.20;386.14;19.79;1478;28;4636.00;428
11599;25;621502907;11599;616;13078;13507;3.34;0.20;386.07;19.79;1479;28;4637.00;429
11602;25;621502929;11602;613;13079;13507;3.36;0.20;386.10;19.90;1477;28;4638.00;428
11603;25;621502945;11603;605;13081;13508;3.38;0.21;386.12;19.91;1478;28;4639.00;427
11606;25;621502960;11606;609;13084;13508;3.42;0.21;386.17;19.92;1478;28;4640.00;424
11608;25;621502982;11608;598;13085;13508;3.46;0.21;386.17;19.92;1477;28;4641.00;423
11610;25;621502997;11610;598;13086;13508;3.49;0.21;386.18;19.93;1476;28;4642.00;422
11611;25;621503013;11611;582;13086;13508;3.54;0.22;386.18;19.93;1475;28;4643.00;422
11614;25;621503032;11614;583;13096;13520;3.66;0.22;386.18;19.93;1482;28;4644.00;424
11615;25;621503058;11615;584;13097;13520;3.69;0.23;386.18;19.93;1482;28;4645.00;423
11615;25;621503087;11615;573;13100;13520;3.74;0.23;386.18;19.93;1485;28;4646.00;420
11619;25;621503112;11619;547;13100;13520;3.77;0.23;386.21;19.93;1481;28;4647.00;420
11620;25;621503148;11620;532;13104;13520;3.84;0.24;386.25;19.93;1484;28;4648.00;416
11623;25;621503167;11623;524;13105;13520;3.92;0.24;386.29;19.94;1482;28;4649.00;415
11624;25;621503187;11624;530;13108;13526;3.99;0.24;386.29;19.94;1484;28;4650.00;418
11628;25;621503206;11628;527;13109;13526;4.03;0.25;386.42;19.94;1481;28;4651.00;417
11630;25;621503225;11630;525;13112;13530;4.07;0.25;386.55;19.93;1482;28;4652.00;418
11631;25;621503244;11631;529;13113;13531;4.12;0.25;386.56;19.93;1482;28;4653.00;418
11634;25;621503263;11634;530;13117;13531;4.15;0.25;386.69;20.05;1483;28;4654.00;414
11636;25;621503280;11636;528;13118;13531;4.16;0.25;386.79;20.05;1482;28;4655.00;413
11638;25;621503296;11638;530;13130;13544;4.22;0.26;386.79;20.03;1492;28;4656.00;414
11640;25;621503313;11640;525;13131;13544;4.23;0.26;386.80;20.04;1491;28;4657.00;413
11644;25;621503330;11644;522;13132;13544;4.23;0.26;387.02;20.04;1488;28;4658.00;412
11645;25;621503347;11645;523;13133;13545;4.24;0.26;387.08;20.04;1488;28;4659.00;412
11646;25;621503364;11646;526;13134;13546;4.25;0.26;387.18;20.04;1488;28;4660.00;412
11649;25;621503380;11649;526;13134;13546;4.22;0.26;387.27;20.04;1485;28;4661.00;412
11651;25;621503398;11651;521;13135;13549;4.22;0.26;387.24;20.04;1484;28;4662.00;414
11651;25;621503415;11651;522;13138;13549;4.27;0.26;387.24;20.05;1487;28;4663.00;411
11654;25;621503432;11654;524;13139;13549;4.30;0.26;387.26;20.06;1485;28;4664.00;410
11657;25;621503448;11657;520;13139;13549;4.32;0.26;387.35;20.06;1482;28;4665.00;410
11661;25;621503465;11661;521;13143;13555;4.30;0.26;387.42;20.05;1482;28;4666.00;412
11663;25;621503483;11663;521;13145;13555;4.35;0.26;387.55;20.06;1482;28;4667.00;410
11665;25;621503500;11665;519;13148;13555;4.36;0.26;387.53;20.17;1483;28;4668.00;407
11667;25;621503517;11667;518;13149;13555;4.38;0.27;387.62;20.17;1482;28;4669.00;406
11669;25;621503534;11669;524;13152;13559;4.38;0.27;387.66;20.17;1483;28;4670.00;407
11671;25;621503551;11671;516;13157;13560;4.38;0.27;387.73;20.42;1486;29;4671.00;403
11674;25;621503579;11674;515;13158;13560;4.39;0.27;387.72;20.52;1484;29;4672.00;402
11679;25;621503596;11679;518;13161;13561;4.39;0.27;387.85;20.53;1482;29;4673.00;400
11681;25;621503613;11681;519;13161;13561;4.40;0.27;387.99;20.53;1480;29;4674.00;400
11683;25;621503630;11683;518;13161;13561;4.44;0.27;388.01;20.53;1478;29;4675.00;400
11685;25;621503647;11685;516;13161;13561;4.44;0.27;388.10;20.53;1476;29;4676.00;400
11687;25;621503664;11687;519;13163;13561;4.44;0.27;388.12;20.53;1476;29;4677.00;398
11689;25;621503682;11689;519;13163;13561;4.45;0.27;388.18;20.53;1474;29;4678.00;398
11692;25;621503698;11692;521;13165;13561;4.44;0.27;388.34;20.54;1473;29;4679.00;396
11695;25;621503717;11695;549;13234;13686;4.48;0.28;388.44;20.43;1539;29;4680.00;452
11698;25;621503745;11698;522;13235;13687;4.48;0.28;388.50;20.54;1537;29;4681.00;452
11701;25;621503762;11701;501;13239;13687;4.55;0.28;388.59;20.54;1538;29;4682.00;448
11704;25;621503779;11704;491;13242;13687;4.61;0.28;388.73;20.54;1538;29;4683.00;445
11706;25;621503798;11706;490;13244;13687;4.66;0.29;388.80;20.53;1538;29;4684.00;443
11707;25;621503820;11707;485;13245;13687;4.69;0.29;388.83;20.53;1538;29;4685.00;442
11708;25;621503839;11708;494;13249;13687;4.73;0.29;388.85;20.63;1541;29;4686.00;438
11710;25;621503856;11710;487;13252;13687;4.76;0.29;388.88;20.63;1542;30;4687.00;435
11714;25;621503880;11714;497;13254;13688;4.77;0.29;389.01;20.63;1540;30;4688.00;434
11717;25;621503902;11717;499;13255;13689;4.75;0.29;389.03;20.63;1538;30;4689.00;434
11718;25;621503920;11718;486;13256;13689;4.74;0.29;389.08;20.63;1538;30;4690.00;433
11723;25;621503937;11723;486;13262;13693;4.67;0.28;389.17;20.63;1539;30;4691.00;431
11723;25;621503955;11723;472;13263;13693;4.65;0.28;389.17;20.63;1540;30;4692.00;430
11726;25;621503972;11726;477;13265;13693;4.58;0.28;389.27;20.63;1539;30;4693.00;428
11731;25;621503989;11731;478;13266;13693;4.50;0.27;389.35;20.64;1535;30;4694.00;427
11734;25;621504008;11734;487;13269;13699;4.49;0.27;389.40;20.63;1535;30;4695.00;430
11738;25;621504029;11738;487;13270;13699;4.47;0.27;389.49;20.63;1532;30;4696.00;429
11743;25;621504053;11743;491;13270;13699;4.43;0.27;389.62;20.63;1527;30;4697.00;429
11745;25;621504073;11745;503;13271;13702;4.45;0.27;389.63;20.63;1526;30;4698.00;431
11751;25;621504092;11751;506;13271;13702;4.41;0.27;389.84;20.63;1520;30;4699.00;431
11753;25;621504112;11753;503;13271;13702;4.39;0.27;389.85;20.63;1518;30;4700.00;431
11756;25;621504134;11756;506;13271;13703;4.38;0.27;389.83;20.63;1515;30;4701.00;432
11762;25;621504151;11762;500;13272;13704;4.35;0.26;389.91;20.63;1510;30;4702.00;432
11765;25;621504168;11765;510;13272;13704;4.33;0.26;389.89;20.63;1507;30;4703.00;432
11769;25;621504185;11769;516;13281;13717;4.34;0.26;389.85;20.62;1512;30;4704.00;436
11774;25;621504203;11774;517;13282;13717;4.31;0.26;389.88;20.62;1508;30;4705.00;435
11774;25;621504221;11774;524;13283;13717;4.32;0.26;389.88;20.62;1509;30;4706.00;434
11777;25;621504237;11777;522;13284;13718;4.29;0.26;389.87;20.62;1507;30;4707.00;434
11783;25;621504254;11783;526;13284;13718;4.23;0.26;390.02;20.62;1501;30;4708.00;434
11786;25;621504271;11786;530;13286;13722;4.24;0.26;390.03;20.62;1500;30;4709.00;436
11790;25;621504289;11790;534;13287;13722;4.19;0.25;390.18;20.62;1497;30;4710.00;435
11792;25;621504306;11792;540;13291;13726;4.15;0.25;390.25;20.62;1499;30;4711.00;435
11794;25;621504323;11794;544;13291;13726;4.15;0.25;390.28;20.62;1497;30;4712.00;435
11795;25;621504340;11795;544;13292;13726;4.17;0.25;390.33;20.62;1497;30;4713.00;434
11797;25;621504356;11797;545;13293;13726;4.18;0.26;390.39;20.62;1496;30;4714.00;433
11798;25;621504373;11798;544;13295;13726;4.13;0.25;390.38;20.62;1497;30;4715.00;431
11801;25;621504389;11801;554;13302;13738;4.13;0.25;390.52;20.61;1501;30;4716.00;436
11802;25;621504406;11802;564;13302;13738;4.09;0.25;390.50;20.61;1500;30;4717.00;436
11806;25;621504422;11806;560;13303;13738;4.03;0.25;390.72;20.61;1497;30;4718.00;435
11807;25;621504438;11807;572;13303;13738;4.01;0.25;390.76;20.61;1496;30;4719.00;435
11808;25;621504455;11808;582;13303;13738;4.01;0.25;390.76;20.61;1495;30;4720.00;435
11809;25;621504471;11809;585;13303;13738;4.00;0.25;390.83;20.61;1494;30;4721.00;435
11810;25;621504493;11810;592;13303;13739;4.02;0.25;390.86;20.61;1493;30;4722.00;436
11812;25;621504509;11812;597;13303;13739;4.05;0.25;390.85;20.61;1491;30;4723.00;436
11814;25;621504525;11814;595;13307;13745;4.08;0.25;390.92;20.60;1493;30;4724.00;438
11817;25;621504540;11817;595;13307;13747;4.08;0.25;391.11;20.60;1490;30;4725.00;440
11820;25;621504556;11820;604;13307;13747;4.05;0.25;391.12;20.60;1487;30;4726.00;440
11825;25;621504572;11825;605;13307;13747;4.02;0.25;391.25;20.60;1482;30;4727.00;440
11827;25;621504587;11827;609;13310;13751;4.03;0.25;391.30;20.60;1483;30;4728.00;441
11829;25;621504603;11829;615;13310;13751;4.04;0.25;391.32;20.60;1481;30;4729.00;441
11831;25;621504618;11831;622;13310;13751;4.03;0.25;391.36;20.60;1479;30;4730.00;441
11834;25;621504633;11834;630;13311;13752;4.03;0.25;391.45;20.60;1477;30;4731.00;441
11837;25;621504648;11837;631;13312;13756;4.01;0.25;391.53;20.59;1475;30;4732.00;444
11840;25;621504664;11840;644;13312;13756;4.00;0.25;391.56;20.59;1472;30;4733.00;444
11845;25;621504679;11845;644;13313;13759;3.97;0.24;391.68;20.59;1468;30;4734.00;446
11846;25;621504695;11846;648;13313;13759;3.94;0.24;391.72;20.59;1467;30;4735.00;446
11846;25;621504709;11846;651;13313;13759;3.93;0.24;391.72;20.59;1467;30;4736.00;446
11847;25;621504730;11847;643;13313;13759;3.96;0.24;391.75;20.59;1466;30;4737.00;446
11847;25;621504744;11847;647;13316;13763;4.00;0.24;391.75;20.59;1469;30;4738.00;447
11851;25;621504759;11851;649;13316;13763;3.96;0.24;391.82;20.59;1465;30;4739.00;447
11855;25;621504776;11855;640;13316;13763;3.91;0.24;391.91;20.59;1461;30;4740.00;447
11856;25;621504791;11856;644;13316;13763;3.89;0.24;391.95;20.59;1460;30;4741.00;447
11861;25;621504806;11861;640;13316;13764;3.87;0.24;391.96;20.59;1455;30;4742.00;448
11863;25;621504820;11863;637;13316;13765;3.86;0.24;392.01;20.59;1453;30;4743.00;449
11865;25;621504835;11865;644;13316;13765;3.84;0.23;392.05;20.59;1451;30;4744.00;449
11867;25;621504849;11867;644;13317;13766;3.84;0.23;392.09;20.59;1450;30;4745.00;449
11868;25;621504863;11868;644;13317;13766;3.82;0.23;392.12;20.59;1449;30;4746.00;449
11871;25;621504877;11871;641;13317;13766;3.81;0.23;392.12;20.59;1446;30;4747.00;449
11873;25;621504892;11873;639;13317;13766;3.82;0.23;392.21;20.59;1444;30;4748.00;449
11876;25;621504906;11876;639;13317;13766;3.80;0.23;392.16;20.59;1441;30;4749.00;449
11878;25;621504920;11878;633;13317;13766;3.80;0.23;392.14;20.59;1439;30;4750.00;449
11882;25;621504934;11882;634;13317;13766;3.78;0.23;392.17;20.59;1435;30;4751.00;449
11884;25;621504948;11884;646;13373;13893;4.06;0.25;392.13;20.50;1489;30;4752.00;520
11886;25;621504972;11886;645;13375;13894;4.04;0.25;392.14;20.50;1489;30;4753.00;519
11889;25;621504987;11889;639;13381;13894;4.09;0.25;392.22;20.49;1492;30;4754.00;513
11893;25;621505001;11893;639;13385;13894;4.09;0.25;392.29;20.49;1492;30;4755.00;509
11896;25;621505017;11896;633;13391;13894;4.05;0.25;392.30;20.48;1495;30;4756.00;503
11898;25;621505036;11898;637;13393;13894;3.97;0.25;392.33;20.48;1495;30;4757.00;501
11903;25;621505059;11903;647;13395;13894;3.89;0.24;392.33;20.48;1492;30;4758.00;499
11905;25;621505083;11905;650;13398;13894;3.84;0.24;392.35;20.47;1493;30;4759.00;496
11913;25;621505103;11913;645;13400;13895;3.77;0.23;392.42;20.47;1487;30;4760.00;495
11915;25;621505128;11915;658;13402;13896;3.76;0.23;392.43;20.47;1487;30;4761.00;494
11919;25;621505149;11919;653;13404;13896;3.74;0.23;392.42;20.47;1485;30;4762.00;492
11922;25;621505167;11922;654;13406;13897;3.68;0.23;392.37;20.47;1484;30;4763.00;491
11924;25;621505184;11924;663;13408;13897;3.67;0.23;392.32;20.47;1484;30;4764.00;489
11926;25;621505200;11926;669;13408;13897;3.66;0.22;392.28;20.47;1482;30;4765.00;489
11930;25;621505218;11930;672;13410;13897;3.64;0.22;392.27;20.46;1480;30;4766.00;487
11932;25;621505235;11932;668;13412;13901;3.65;0.23;392.22;20.46;1480;30;4767.00;489
11936;25;621505253;11936;661;13413;13901;3.64;0.22;392.24;20.46;1477;30;4768.00;488
11938;25;621505269;11938;670;13413;13901;3.63;0.22;392.23;20.46;1475;30;4769.00;488
11942;25;621505288;11942;665;13415;13907;3.62;0.22;392.28;20.46;1473;30;4770.00;492
11947;25;621505305;11947;664;13416;13907;3.59;0.22;392.22;20.46;1469;30;4771.00;491
11950;25;621505322;11950;665;13416;13907;3.56;0.22;392.24;20.46;1466;30;4772.00;491
11954;25;621505338;11954;657;13417;13911;3.54;0.22;392.32;20.45;1463;30;4773.00;494
11957;25;621505355;11957;657;13418;13912;3.51;0.22;392.30;20.45;1461;30;4774.00;494
11961;25;621505372;11961;651;13418;13912;3.47;0.21;392.27;20.45;1457;30;4775.00;494
11965;25;621505389;11965;659;13420;13916;3.47;0.21;392.26;20.45;1455;30;4776.00;496
11969;25;621505406;11969;648;13421;13916;3.45;0.21;392.22;20.45;1452;30;4777.00;495
11969;25;621505423;11969;656;13421;13916;3.44;0.21;392.22;20.45;1452;30;4778.00;495
11972;25;621505439;11972;644;13421;13917;3.42;0.21;392.19;20.45;1449;30;4779.00;496
11977;25;621505456;11977;642;13421;13917;3.37;0.21;392.24;20.45;1444;30;4780.00;496
11979;25;621505481;11979;622;13426;13923;3.41;0.21;392.22;20.45;1447;30;4781.00;497
11983;25;621505497;11983;620;13427;13923;3.41;0.21;392.21;20.55;1444;30;4782.00;496
11985;25;621505515;11985;605;13427;13924;3.45;0.21;392.21;20.55;1442;30;4783.00;497
11987;25;621505530;11987;600;13427;13924;3.47;0.21;392.22;20.55;1440;30;4784.00;497
11989;25;621505547;11989;591;13427;13924;3.50;0.21;392.19;20.55;1438;30;4785.00;497
11994;25;621505571;11994;585;13427;13924;3.51;0.21;392.15;20.55;1433;30;4786.00;497
11998;25;621505587;11998;580;13427;13924;3.52;0.21;392.19;20.55;1429;30;4787.00;497
12001;25;621505603;12001;582;13435;13936;3.62;0.22;392.19;20.54;1434;30;4788.00;501
12004;25;621505619;12004;582;13435;13936;3.64;0.22;392.15;20.54;1431;30;4789.00;501
12008;25;621505641;12008;580;13436;13936;3.67;0.22;392.24;20.55;1428;30;4790.00;500
12011;25;621505655;12011;573;13436;13936;3.69;0.22;392.15;20.55;1425;30;4791.00;500
12013;25;621505671;12013;573;13437;13936;3.72;0.23;392.16;20.55;1424;30;4792.00;499
12014;25;621505687;12014;578;13438;13936;3.74;0.23;392.16;20.56;1424;30;4793.00;498
12016;25;621505703;12016;577;13440;13940;3.76;0.23;392.14;20.56;1424;30;4794.00;500
12017;25;621505719;12017;573;13442;13940;3.76;0.23;392.15;20.56;1425;30;4795.00;498
12020;25;621505733;12020;580;13445;13944;3.76;0.23;392.23;20.56;1425;30;4796.00;499
12021;25;621505750;12021;587;13446;13945;3.80;0.23;392.24;20.57;1425;30;4797.00;499
12023;25;621505766;12023;589;13447;13945;3.85;0.23;392.23;20.57;1424;30;4798.00;498
12028;25;621505781;12028;586;13448;13945;3.89;0.24;392.24;20.58;1420;30;4799.00;497
12030;25;621505798;12030;596;13472;13986;4.00;0.24;392.28;20.56;1442;30;4800.00;514
12031;25;621505822;12031;593;13472;13986;4.00;0.24;392.29;20.56;1441;30;4801.00;514
12032;25;621505838;12032;588;13476;13986;4.04;0.24;392.26;20.58;1444;30;4802.00;510
12034;25;621505853;12034;600;13478;13987;4.05;0.25;392.24;20.57;1444;30;4803.00;509
12036;25;621505869;12036;602;13481;13988;4.04;0.25;392.22;20.59;1445;30;4804.00;507
12037;25;621505884;12037;607;13482;13988;4.05;0.25;392.29;20.60;1445;30;4805.00;506
12040;25;621505901;12040;608;13487;13991;4.05;0.25;392.35;20.61;1447;30;4806.00;504
12044;25;621505916;12044;605;13487;13991;4.03;0.24;392.45;20.61;1443;30;4807.00;504
12044;25;621505939;12044;605;13488;13991;4.03;0.24;392.45;20.61;1444;30;4808.00;503
12050;25;621505955;12050;598;13489;13991;4.00;0.24;392.46;20.61;1439;30;4809.00;502
12051;25;621505978;12051;595;13495;13997;4.02;0.24;392.50;20.61;1444;30;4810.00;502
12055;25;621505994;12055;596;13495;13997;4.01;0.24;392.48;20.61;1440;30;4811.00;502
12058;25;621506012;12058;592;13498;13997;4.02;0.24;392.65;20.62;1440;30;4812.00;499
12060;25;621506035;12060;594;13499;13997;4.05;0.25;392.68;20.63;1439;30;4813.00;498
12062;25;621506060;12062;598;13502;14001;4.06;0.25;392.72;20.63;1440;30;4814.00;499
12063;25;621506077;12063;602;13504;14003;4.09;0.25;392.70;20.63;1441;30;4815.00;499
12065;25;621506092;12065;596;13504;14003;4.13;0.25;392.69;20.63;1439;30;4816.00;499
12067;25;621506108;12067;579;13508;14004;4.12;0.25;392.83;20.64;1441;30;4817.00;496
12069;25;621506129;12069;567;13508;14004;4.15;0.25;392.90;20.64;1439;30;4818.00;496
12073;26;621506144;12073;559;13509;14004;4.17;0.25;392.95;20.65;1436;31;4819.00;495
12073;26;621506167;12073;556;13510;14004;4.22;0.26;392.95;20.65;1437;31;4820.00;494
12076;26;621506186;12076;552;13510;14004;4.22;0.26;393.10;20.65;1434;31;4821.00;494
12076;26;621506208;12076;557;13513;14004;4.23;0.26;393.10;20.67;1437;31;4822.00;491
12077;26;621506223;12077;562;13516;14004;4.26;0.26;393.20;20.67;1439;31;4823.00;488
12080;26;621506239;12080;580;13553;14074;4.34;0.27;393.38;20.61;1473;31;4824.00;521
12082;26;621506261;12082;582;13554;14075;4.37;0.27;393.47;20.61;1472;31;4825.00;521
12084;26;621506277;12084;582;13559;14075;4.42;0.27;393.53;20.62;1475;31;4826.00;516
12090;26;621506294;12090;576;13559;14075;4.44;0.27;393.67;20.62;1469;31;4827.00;516
12091;26;621506312;12091;576;13562;14077;4.52;0.28;393.76;20.62;1471;31;4828.00;515
12093;26;621506331;12093;573;13565;14077;4.56;0.28;393.75;20.62;1472;31;4829.00;512
12095;26;621506350;12095;567;13565;14077;4.61;0.28;393.81;20.62;1470;31;4830.00;512
12097;26;621506367;12097;569;13569;14077;4.63;0.28;393.97;20.64;1472;31;4831.00;508
12100;26;621506385;12100;576;13571;14078;4.63;0.28;394.07;20.64;1471;31;4832.00;507
12101;26;621506402;12101;572;13574;14079;4.69;0.29;394.12;20.64;1473;31;4833.00;505
12103;26;621506419;12103;567;13577;14079;4.72;0.29;394.10;20.65;1474;31;4834.00;502
12105;26;621506435;12105;573;13582;14083;4.75;0.29;394.07;20.64;1477;31;4835.00;501
12107;26;621506451;12107;573;13585;14083;4.72;0.29;394.08;20.65;1478;31;4836.00;498
12109;26;621506467;12109;579;13588;14083;4.73;0.29;394.08;20.76;1479;31;4837.00;495
12112;26;621506485;12112;574;13590;14083;4.71;0.29;394.17;20.77;1478;31;4838.00;493
12116;26;621506501;12116;581;13595;14089;4.72;0.29;394.30;20.77;1479;31;4839.00;494
12119;26;621506518;12119;586;13595;14089;4.70;0.29;394.37;20.77;1476;31;4840.00;494
12122;26;621506534;12122;588;13595;14089;4.69;0.29;394.46;20.77;1473;31;4841.00;494
12124;26;621506551;12124;595;13596;14092;4.65;0.28;394.58;20.77;1472;31;4842.00;496
12126;26;621506567;12126;595;13597;14092;4.64;0.28;394.56;20.77;1471;31;4843.00;495
12132;26;621506583;12132;594;13600;14092;4.59;0.28;394.63;20.79;1468;31;4844.00;492
12134;26;621506599;12134;596;13600;14093;4.57;0.28;394.66;20.79;1466;31;4845.00;493
12136;26;621506616;12136;594;13602;14094;4.54;0.28;394.69;20.80;1466;31;4846.00;492
12138;26;621506632;12138;599;13604;14094;4.55;0.28;394.77;20.81;1466;31;4847.00;490
12142;26;621506649;12142;599;13613;14107;4.55;0.28;394.79;20.79;1471;31;4848.00;494
12144;26;621506667;12144;606;13614;14107;4.54;0.28;394.84;20.79;1470;31;4849.00;493
12146;26;621506683;12146;594;13615;14107;4.52;0.27;394.85;20.80;1469;31;4850.00;492
12148;26;621506699;12148;595;13615;14108;4.53;0.28;394.89;20.80;1467;31;4851.00;493
12151;26;621506721;12151;592;13616;14108;4.50;0.27;394.88;20.80;1465;31;4852.00;492
12156;26;621506738;12156;586;13619;14112;4.56;0.28;394.86;20.91;1463;31;4853.00;493
12157;26;621506754;12157;578;13620;14112;4.62;0.28;394.88;20.91;1463;31;4854.00;492
12159;26;621506771;12159;581;13623;14116;4.65;0.28;394.86;20.91;1464;31;4855.00;493
12162;26;621506788;12162;579;13623;14116;4.69;0.28;394.92;20.91;1461;31;4856.00;493
12164;26;621506804;12164;572;13624;14116;4.67;0.28;395.09;20.92;1460;31;4857.00;492
12168;26;621506820;12168;569;13625;14116;4.68;0.28;395.24;20.92;1457;31;4858.00;491
12170;26;621506837;12170;564;13625;14116;4.64;0.28;395.28;20.92;1455;31;4859.00;491
12170;26;621506855;12170;563;13645;14150;4.71;0.29;395.28;20.90;1475;31;4860.00;505
12172;26;621506873;12172;571;13645;14150;4.70;0.29;395.33;20.90;1473;31;4861.00;505
12175;26;621506890;12175;549;13650;14150;4.70;0.29;395.37;20.90;1475;31;4862.00;500
12180;26;621506906;12180;544;13651;14150;4.68;0.29;395.41;20.90;1471;31;4863.00;499
12183;26;621506924;12183;532;13653;14150;4.70;0.29;395.49;21.00;1470;31;4864.00;497
12186;26;621506941;12186;525;13653;14150;4.72;0.29;395.54;21.00;1467;31;4865.00;497
12192;26;621506960;12192;522;13655;14151;4.68;0.29;395.70;21.11;1463;31;4866.00;496
12194;26;621506978;12194;523;13656;14151;4.68;0.29;395.70;21.12;1462;31;4867.00;495
12198;26;621506995;12198;526;13659;14157;4.70;0.29;395.71;21.12;1461;31;4868.00;498
12200;26;621507013;12200;526;13659;14158;4.71;0.29;395.70;21.12;1459;31;4869.00;499
12207;26;621507032;12207;529;13659;14158;4.63;0.28;395.71;21.12;1452;31;4870.00;499
12209;26;621507058;12209;526;13659;14158;4.57;0.28;395.75;21.12;1450;31;4871.00;499
12210;26;621507086;12210;526;13661;14162;4.52;0.28;395.76;21.11;1451;31;4872.00;501
12215;26;621507110;12215;526;13662;14162;4.42;0.27;395.95;21.11;1447;31;4873.00;500
12217;26;621507134;12217;531;13662;14162;4.41;0.27;395.98;21.11;1445;31;4874.00;500
12220;26;621507156;12220;535;13664;14163;4.38;0.27;396.15;21.21;1444;31;4875.00;499
12226;26;621507174;12226;545;13667;14167;4.30;0.26;396.26;21.21;1441;31;4876.00;500
12227;26;621507191;12227;537;13668;14167;4.30;0.26;396.30;21.21;1441;31;4877.00;499
12229;26;621507209;12229;535;13671;14170;4.34;0.26;396.29;21.20;1442;31;4878.00;499
12232;26;621507226;12232;541;13671;14170;4.34;0.26;396.26;21.20;1439;31;4879.00;499
12234;26;621507243;12234;547;13673;14170;4.34;0.26;396.33;21.31;1439;31;4880.00;497
12236;26;621507260;12236;546;13674;14170;4.34;0.26;396.34;21.31;1438;31;4881.00;496
12238;26;621507280;12238;557;13677;14174;4.38;0.27;396.42;21.31;1439;31;4882.00;497
12240;26;621507297;12240;558;13677;14174;4.35;0.26;396.43;21.31;1437;31;4883.00;497
12244;26;621507313;12244;567;13677;14174;4.31;0.26;396.48;21.31;1433;31;4884.00;497
12244;26;621507331;12244;575;13677;14174;4.33;0.26;396.48;21.31;1433;31;4885.00;497
12247;26;621507347;12247;580;13677;14175;4.29;0.26;396.50;21.31;1430;31;4886.00;498
12251;26;621507363;12251;585;13677;14176;4.23;0.26;396.60;21.31;1426;31;4887.00;499
12251;26;621507385;12251;593;13677;14176;4.23;0.26;396.60;21.31;1426;31;4888.00;499
12254;26;621507401;12254;605;13678;14177;4.21;0.26;396.70;21.31;1424;31;4889.00;499
12254;26;621507419;12254;608;13678;14177;4.16;0.25;396.70;21.31;1424;31;4890.00;499
12258;26;621507435;12258;610;13678;14177;4.14;0.25;396.79;21.31;1420;31;4891.00;499
12260;26;621507451;12260;615;13678;14177;4.09;0.25;396.86;21.31;1418;31;4892.00;499
12260;26;621507466;12260;619;13678;14177;4.08;0.25;396.86;21.31;1418;31;4893.00;499
12265;26;621507481;12265;623;13678;14177;4.02;0.24;396.98;21.31;1413;31;4894.00;499
12267;26;621507497;12267;636;13678;14177;3.96;0.24;396.99;21.31;1411;31;4895.00;499
12269;26;621507513;12269;659;13741;14304;4.20;0.26;397.03;21.21;1472;31;4896.00;563
12270;26;621507539;12270;654;13745;14305;4.15;0.26;397.01;21.21;1475;31;4897.00;560
12272;26;621507554;12272;650;13753;14305;4.14;0.26;397.02;21.19;1481;31;4898.00;552
12274;26;621507571;12274;653;13756;14305;4.09;0.25;397.01;21.19;1482;31;4899.00;549
12277;26;621507594;12277;651;13760;14305;4.04;0.25;397.02;21.19;1483;31;4900.00;545
12277;26;621507614;12277;646;13762;14305;4.00;0.25;397.02;21.18;1485;31;4901.00;543
12278;26;621507630;12278;647;13764;14305;3.97;0.24;397.00;21.18;1486;31;4902.00;541
12280;27;621507646;12280;651;13766;14305;3.98;0.25;396.98;21.18;1486;32;4903.00;539
12281;27;621507669;12281;650;13767;14306;4.02;0.25;396.98;21.18;1486;32;4904.00;539
12281;27;621507684;12281;655;13769;14308;4.05;0.25;396.98;21.18;1488;32;4905.00;539
12282;27;621507700;12282;660;13770;14308;4.03;0.25;396.97;21.18;1488;32;4906.00;538
12285;27;621507717;12285;661;13771;14309;4.04;0.25;396.96;21.17;1486;32;4907.00;538
12287;27;621507732;12287;671;13773;14309;4.03;0.25;396.91;21.17;1486;32;4908.00;536
12288;27;621507748;12288;663;13775;14309;4.02;0.25;396.87;21.17;1487;32;4909.00;534
12291;27;621507764;12291;666;13775;14309;3.95;0.24;396.90;21.17;1484;32;4910.00;534
12291;27;621507780;12291;673;13778;14313;3.92;0.24;396.90;21.17;1487;32;4911.00;535
12294;27;621507795;12294;675;13778;14313;3.82;0.24;396.90;21.17;1484;32;4912.00;535
12300;27;621507815;12300;674;13778;14313;3.73;0.23;396.86;21.17;1478;32;4913.00;535
12301;27;621507832;12301;672;13779;14316;3.70;0.23;396.83;21.17;1478;32;4914.00;537
12301;27;621507847;12301;675;13779;14316;3.67;0.23;396.83;21.17;1478;32;4915.00;537
12304;27;621507862;12304;681;13779;14316;3.63;0.22;396.83;21.17;1475;32;4916.00;537
12306;27;621507877;12306;682;13780;14320;3.63;0.22;396.90;21.16;1474;32;4917.00;540
12309;27;621507893;12309;680;13781;14321;3.63;0.22;396.90;21.16;1472;32;4918.00;540
12309;27;621507910;12309;677;13781;14321;3.63;0.22;396.90;21.16;1472;32;4919.00;540
12310;27;621507926;12310;685;13785;14326;3.67;0.22;396.87;21.16;1475;32;4920.00;541
12312;27;621507942;12312;682;13785;14326;3.64;0.22;396.81;21.16;1473;32;4921.00;541
12315;27;621507957;12315;685;13785;14326;3.57;0.22;396.80;21.16;1470;32;4922.00;541
12317;27;621507978;12317;686;13785;14327;3.51;0.21;396.80;21.16;1468;32;4923.00;542
12319;27;621507993;12319;689;13786;14327;3.44;0.21;396.79;21.16;1467;32;4924.00;541
12319;27;621508008;12319;689;13791;14333;3.41;0.21;396.79;21.15;1472;32;4925.00;542
12320;27;621508023;12320;692;13791;14333;3.33;0.20;396.76;21.15;1471;32;4926.00;542
12322;27;621508038;12322;699;13791;14334;3.24;0.20;396.79;21.15;1469;32;4927.00;543
12328;27;621508053;12328;705;13791;14334;3.15;0.19;396.73;21.15;1463;32;4928.00;543
12328;27;621508068;12328;711;13791;14334;3.10;0.19;396.73;21.15;1463;32;4929.00;543
12333;27;621508081;12333;704;13791;14334;3.06;0.19;396.73;21.15;1458;32;4930.00;543
12334;27;621508095;12334;693;13791;14334;3.03;0.18;396.73;21.15;1457;32;4931.00;543
12336;27;621508109;12336;684;13799;14346;3.11;0.19;396.80;21.14;1463;32;4932.00;547
12341;27;621508124;12341;669;13799;14346;3.11;0.19;396.88;21.14;1458;32;4933.00;547
12344;27;621508138;12344;663;13799;14346;3.13;0.19;396.83;21.14;1455;32;4934.00;547
12345;27;621508152;12345;662;13799;14346;3.19;0.19;396.83;21.14;1454;32;4935.00;547
12348;27;621508167;12348;665;13799;14346;3.21;0.20;396.78;21.14;1451;32;4936.00;547
12349;27;621508181;12349;657;13799;14346;3.28;0.20;396.76;21.14;1450;32;4937.00;547
12354;27;621508195;12354;654;13800;14350;3.29;0.20;396.78;21.14;1446;32;4938.00;550
12355;27;621508216;12355;640;13800;14350;3.32;0.20;396.77;21.14;1445;32;4939.00;550
12359;27;621508235;12359;636;13803;14354;3.34;0.20;396.73;21.13;1444;32;4940.00;551
12360;27;621508250;12360;626;13803;14355;3.37;0.20;396.72;21.13;1443;32;4941.00;552
12361;27;621508265;12361;619;13803;14355;3.38;0.21;396.71;21.13;1442;32;4942.00;552
12364;27;621508280;12364;619;13803;14355;3.42;0.21;396.72;21.13;1439;32;4943.00;552
12367;27;621508294;12367;611;13813;14368;3.55;0.22;396.66;21.12;1446;32;4944.00;555
12370;27;621508311;12370;609;13813;14368;3.61;0.22;396.65;21.12;1443;32;4945.00;555
12370;27;621508332;12370;593;13813;14368;3.69;0.22;396.65;21.12;1443;32;4946.00;555
12373;27;621508351;12373;586;13814;14369;3.75;0.23;396.63;21.11;1441;32;4947.00;555
12377;27;621508366;12377;581;13814;14370;3.79;0.23;396.60;21.11;1437;32;4948.00;556
12378;27;621508381;12378;578;13814;14370;3.85;0.23;396.59;21.11;1436;32;4949.00;556
12382;27;621508399;12382;584;13818;14379;3.89;0.24;396.62;21.11;1436;32;4950.00;561
12384;27;621508415;12384;569;13818;14379;3.95;0.24;396.62;21.11;1434;32;4951.00;561
12386;27;621508431;12386;563;13820;14379;4.05;0.25;396.59;21.11;1434;32;4952.00;559
12390;27;621508447;12390;561;13820;14379;4.08;0.25;396.56;21.11;1430;32;4953.00;559
12390;27;621508462;12390;552;13824;14385;4.13;0.25;396.56;21.10;1434;32;4954.00;561
12393;27;621508480;12393;547;13824;14385;4.15;0.25;396.58;21.10;1431;32;4955.00;561
12396;27;621508496;12396;536;13827;14385;4.23;0.26;396.60;21.10;1431;32;4956.00;558
12399;27;621508512;12399;539;13827;14385;4.26;0.26;396.58;21.10;1428;32;4957.00;558
12403;27;621508527;12403;534;13829;14389;4.29;0.26;396.61;21.20;1426;32;4958.00;560
12407;27;621508543;12407;524;13829;14390;4.36;0.26;396.65;21.20;1422;32;4959.00;561
12412;27;621508559;12412;529;13831;14390;4.36;0.26;396.65;21.20;1419;32;4960.00;559
12415;27;621508574;12415;518;13834;14391;4.43;0.27;396.65;21.23;1419;32;4961.00;557
12419;27;621508590;12419;520;13834;14391;4.50;0.27;396.61;21.23;1415;32;4962.00;557
12424;27;621508607;12424;516;13835;14391;4.50;0.27;396.67;21.23;1411;32;4963.00;556
12430;28;621508623;12430;505;13836;14391;4.51;0.27;396.61;21.22;1406;33;4964.00;555
12432;28;621508644;12432;511;13838;14391;4.55;0.28;396.72;21.25;1406;33;4965.00;553
12437;28;621508664;12437;510;13840;14391;4.53;0.27;396.82;21.28;1403;33;4966.00;551
12440;28;621508680;12440;506;13841;14391;4.51;0.27;396.86;21.29;1401;33;4967.00;550
12443;28;621508695;12443;521;13880;14461;4.61;0.28;396.99;21.23;1437;33;4968.00;581
12446;28;621508722;12446;512;13884;14462;4.62;0.28;396.96;21.26;1438;33;4969.00;578
12450;28;621508737;12450;514;13888;14462;4.64;0.28;397.00;21.27;1438;33;4970.00;574
12453;28;621508753;12453;508;13892;14462;4.67;0.28;397.04;21.29;1439;33;4971.00;570
12458;28;621508769;12458;504;13893;14462;4.67;0.28;397.28;21.29;1435;34;4972.00;569
12463;28;621508790;12463;514;13896;14462;4.62;0.28;397.45;21.32;1433;34;4973.00;566
12467;28;621508806;12467;506;13898;14462;4.58;0.28;397.54;21.31;1431;34;4974.00;564
12467;28;621508822;12467;516;13899;14462;4.53;0.28;397.54;21.31;1432;34;4975.00;563
12471;28;621508839;12471;516;13901;14463;4.44;0.27;397.65;21.31;1430;34;4976.00;562
12473;28;621508855;12473;514;13903;14464;4.35;0.27;397.61;21.32;1430;34;4977.00;561
12477;28;621508870;12477;513;13905;14464;4.28;0.26;397.76;21.33;1428;34;4978.00;559
12479;28;621508886;12479;512;13911;14468;4.25;0.26;397.95;21.35;1432;34;4979.00;557
12482;28;621508904;12482;522;13911;14468;4.23;0.26;398.00;21.35;1429;34;4980.00;557
12486;28;621508919;12486;525;13913;14468;4.18;0.25;398.07;21.37;1427;34;4981.00;555
12488;28;621508936;12488;524;13916;14468;4.15;0.25;398.07;21.49;1428;34;4982.00;552
12489;28;621508951;12489;527;13920;14474;4.17;0.25;398.18;21.49;1431;34;4983.00;554
12493;28;621508969;12493;527;13922;14474;4.18;0.25;398.34;21.51;1429;34;4984.00;552
12495;28;621508985;12495;533;13922;14474;4.19;0.25;398.32;21.51;1427;34;4985.00;552
12497;28;621509000;12497;523;13925;14477;4.24;0.26;398.41;21.53;1428;34;4986.00;552
12501;28;621509016;12501;512;13925;14477;4.24;0.26;398.62;21.53;1424;34;4987.00;552
12504;28;621509034;12504;519;13925;14477;4.26;0.26;398.68;21.53;1421;34;4988.00;552
12506;28;621509062;12506;508;13927;14478;4.29;0.26;398.72;21.55;1421;34;4989.00;551
12508;28;621509087;12508;504;13929;14479;4.26;0.26;398.81;21.65;1421;34;4990.00;550
12510;28;621509111;12510;500;13930;14479;4.25;0.26;398.89;21.66;1420;34;4991.00;549
12511;28;621509134;12511;496;13944;14492;4.29;0.26;398.92;21.86;1433;35;4992.00;548
12514;28;621509168;12514;497;13945;14492;4.27;0.26;398.99;21.87;1431;35;4993.00;547
12515;28;621509186;12515;511;13947;14492;4.27;0.26;399.03;21.89;1432;35;4994.00;545
12519;28;621509204;12519;512;13949;14494;4.28;0.26;399.08;21.90;1430;36;4995.00;545
12520;28;621509232;12520;521;13949;14494;4.22;0.26;399.18;21.90;1429;36;4996.00;545
12522;28;621509250;12522;529;13954;14498;4.21;0.26;399.23;21.92;1432;36;4997.00;544
12524;28;621509268;12524;531;13956;14498;4.21;0.26;399.24;21.93;1432;36;4998.00;542
12526;28;621509285;12526;531;13959;14502;4.19;0.25;399.24;21.93;1433;36;4999.00;543
12528;28;621509302;12528;529;13961;14502;4.19;0.25;399.33;21.95;1433;36;5000.00;541
12529;28;621509324;12529;525;13963;14502;4.23;0.26;399.33;21.97;1434;36;5001.00;539
12531;28;621509343;12531;524;13964;14502;4.23;0.26;399.46;21.97;1433;36;5002.00;538
12533;28;621509361;12533;539;13964;14502;4.24;0.26;399.55;21.97;1431;36;5003.00;538
12539;28;621509380;12539;541;13972;14514;4.27;0.26;399.69;21.96;1433;36;5004.00;542
12541;28;621509399;12541;541;13975;14514;4.27;0.26;399.71;22.08;1434;36;5005.00;539
12545;28;621509417;12545;547;13978;14514;4.25;0.26;399.70;22.09;1433;36;5006.00;536
12546;28;621509435;12546;560;13978;14514;4.22;0.26;399.75;22.09;1432;36;5007.00;536
12549;28;621509452;12549;554;13980;14514;4.21;0.26;399.80;22.11;1431;36;5008.00;534
12551;28;621509469;12551;559;13980;14514;4.16;0.25;399.79;22.11;1429;36;5009.00;534
12552;28;621509488;12552;554;13982;14515;4.14;0.25;399.83;22.12;1430;36;5010.00;533
12553;28;621509504;12553;563;13983;14515;4.15;0.25;399.88;22.22;1430;36;5011.00;532
12553;28;621509522;12553;567;13987;14521;4.21;0.26;399.88;22.21;1434;36;5012.00;534
12556;28;621509538;12556;577;13989;14522;4.18;0.25;399.87;22.23;1433;36;5013.00;533
12558;28;621509555;12558;583;13990;14522;4.15;0.25;399.90;22.23;1432;36;5014.00;532
12562;28;621509572;12562;579;13992;14522;4.18;0.25;399.92;22.25;1430;36;5015.00;530
12564;28;621509589;12564;586;13995;14526;4.23;0.26;399.89;22.24;1431;36;5016.00;531
12565;28;621509605;12565;581;13997;14526;4.28;0.26;399.88;22.26;1432;36;5017.00;529
12565;28;621509622;12565;587;13997;14526;4.33;0.26;399.88;22.26;1432;36;5018.00;529
12566;28;621509638;12566;587;13998;14527;4.39;0.27;399.90;22.25;1432;36;5019.00;529
12567;28;621509655;12567;578;14002;14531;4.42;0.27;399.92;22.26;1435;36;5020.00;529
12570;28;621509678;12570;571;14003;14531;4.40;0.27;400.04;22.26;1433;36;5021.00;528
12570;28;621509696;12570;566;14005;14534;4.39;0.27;400.04;22.27;1435;36;5022.00;529
12571;28;621509712;12571;553;14005;14534;4.34;0.26;400.02;22.27;1434;36;5023.00;529
12572;28;621509730;12572;540;14005;14534;4.35;0.26;400.01;22.27;1433;36;5024.00;529
12573;28;621509746;12573;539;14006;14534;4.36;0.27;399.99;22.28;1433;36;5025.00;528
12574;28;621509763;12574;533;14009;14538;4.39;0.27;399.99;22.27;1435;36;5026.00;529
12575;28;621509780;12575;528;14009;14538;4.40;0.27;399.98;22.27;1434;36;5027.00;529
12577;28;621509796;12577;530;14011;14538;4.41;0.27;400.01;22.38;1434;36;5028.00;527
12579;28;621509814;12579;527;14011;14538;4.39;0.27;399.98;22.38;1432;36;5029.00;527
12582;28;621509831;12582;531;14012;14539;4.36;0.27;400.09;22.39;1430;36;5030.00;527
12584;28;621509848;12584;518;14012;14540;4.34;0.26;400.13;22.39;1428;36;5031.00;528
12590;28;621509864;12590;518;14013;14540;4.29;0.26;400.28;22.40;1423;36;5032.00;527
12595;28;621509880;12595;514;14014;14541;4.25;0.26;400.42;22.40;1419;36;5033.00;527
12599;28;621509897;12599;511;14014;14541;4.22;0.26;400.43;22.40;1415;36;5034.00;527
12604;28;621509913;12604;506;14015;14541;4.17;0.25;400.59;22.50;1411;36;5035.00;526
12607;28;621509932;12607;507;14015;14541;4.13;0.25;400.57;22.50;1408;36;5036.00;526
12609;28;621509948;12609;507;14015;14541;4.11;0.25;400.68;22.50;1406;36;5037.00;526
12610;28;621509964;12610;510;14015;14541;4.06;0.25;400.68;22.50;1405;36;5038.00;526
12613;28;621509979;12613;516;14015;14541;4.05;0.25;400.67;22.50;1402;36;5039.00;526
12614;28;621509997;12614;554;14114;14771;4.34;0.27;400.68;22.34;1500;36;5040.00;657
12618;28;621510037;12618;545;14119;14772;4.31;0.27;400.67;22.33;1501;36;5041.00;653
12620;28;621510056;12620;537;14127;14772;4.34;0.27;400.71;22.33;1507;36;5042.00;645
12621;28;621510078;12621;538;14132;14772;4.36;0.27;400.68;22.32;1511;36;5043.00;640
12622;28;621510094;12622;542;14139;14772;4.35;0.27;400.72;22.31;1517;36;5044.00;633
12625;28;621510109;12625;543;14145;14772;4.35;0.27;400.81;22.31;1520;36;5045.00;627
12625;28;621510124;12625;547;14150;14772;4.37;0.27;400.81;22.30;1525;36;5046.00;622
12628;28;621510140;12628;556;14156;14772;4.36;0.27;400.84;22.30;1528;36;5047.00;616
12628;28;621510155;12628;561;14163;14773;4.36;0.27;400.84;22.40;1535;36;5048.00;610
12633;28;621510172;12633;573;14165;14774;4.32;0.27;400.76;22.40;1532;36;5049.00;609
12637;28;621510188;12637;578;14169;14774;4.31;0.27;400.78;22.39;1532;36;5050.00;605
12641;28;621510204;12641;580;14172;14775;4.28;0.27;400.79;22.39;1531;36;5051.00;603
12642;28;621510220;12642;586;14177;14775;4.22;0.26;400.83;22.39;1535;36;5052.00;598
12645;28;621510236;12645;588;14178;14775;4.12;0.25;400.90;22.39;1533;36;5053.00;597
12646;28;621510253;12646;602;14179;14775;4.06;0.25;400.87;22.39;1533;36;5054.00;596
12649;28;621510269;12649;620;14185;14779;4.02;0.25;401.01;22.38;1536;36;5055.00;594
12652;28;621510286;12652;628;14186;14779;3.96;0.24;401.00;22.38;1534;36;5056.00;593
12652;28;621510307;12652;645;14187;14779;3.92;0.24;401.00;22.38;1535;36;5057.00;592
12652;28;621510323;12652;664;14190;14782;3.85;0.24;401.00;22.38;1538;36;5058.00;592
12653;28;621510338;12653;668;14190;14782;3.80;0.23;400.99;22.38;1537;36;5059.00;592
12657;28;621510355;12657;688;14191;14782;3.71;0.23;401.02;22.38;1534;36;5060.00;591
12659;28;621510371;12659;702;14195;14786;3.64;0.22;400.99;22.37;1536;36;5061.00;591
12660;28;621510387;12660;716;14196;14787;3.59;0.22;400.96;22.37;1536;36;5062.00;591
12662;28;621510403;12662;722;14198;14787;3.53;0.22;401.02;22.37;1536;36;5063.00;589
12663;28;621510420;12663;732;14201;14791;3.53;0.22;400.99;22.37;1538;36;5064.00;590
12665;28;621510440;12665;740;14203;14791;3.50;0.22;400.93;22.37;1538;36;5065.00;588
12666;28;621510456;12666;745;14204;14791;3.50;0.22;400.90;22.37;1538;36;5066.00;587
12669;28;621510472;12669;759;14204;14792;3.47;0.21;400.92;22.37;1535;36;5067.00;588
12671;28;621510495;12671;765;14205;14792;3.43;0.21;400.91;22.37;1534;36;5068.00;587
12673;28;621510517;12673;766;14210;14798;3.41;0.21;400.94;22.36;1537;36;5069.00;588
12676;28;621510534;12676;783;14212;14798;3.33;0.20;400.90;22.36;1536;36;5070.00;586
12678;28;621510549;12678;786;14212;14799;3.27;0.20;400.85;22.36;1534;36;5071.00;587
12680;28;621510564;12680;785;14213;14799;3.19;0.20;400.89;22.36;1533;36;5072.00;586
12681;28;621510579;12681;797;14213;14799;3.13;0.19;400.87;22.36;1532;36;5073.00;586
12682;28;621510593;12682;803;14213;14799;3.05;0.19;400.86;22.36;1531;36;5074.00;586
12684;28;621510608;12684;811;14213;14799;3.01;0.18;400.82;22.36;1529;36;5075.00;586
12685;28;621510623;12685;820;14221;14811;3.01;0.18;400.85;22.35;1536;36;5076.00;590
12686;28;621510638;12686;825;14221;14811;2.99;0.18;400.83;22.35;1535;36;5077.00;590
12687;28;621510653;12687;820;14222;14811;3.00;0.18;400.83;22.35;1535;36;5078.00;589
12690;28;621510666;12690;819;14222;14811;3.00;0.18;400.93;22.35;1532;36;5079.00;589
12690;28;621510681;12690;820;14222;14811;3.02;0.18;400.93;22.35;1532;36;5080.00;589
12690;28;621510696;12690;816;14222;14811;3.03;0.19;400.93;22.35;1532;36;5081.00;589
12691;28;621510710;12691;818;14225;14815;3.05;0.19;400.96;22.35;1534;36;5082.00;590
12691;28;621510725;12691;794;14225;14815;3.07;0.19;400.96;22.35;1534;36;5083.00;590
12691;28;621510739;12691;774;14228;14819;3.12;0.19;400.96;22.34;1537;36;5084.00;591
12693;28;621510754;12693;768;14229;14821;3.16;0.19;400.91;22.34;1536;36;5085.00;592
12694;28;621510769;12694;765;14229;14821;3.20;0.20;400.89;22.34;1535;36;5086.00;592
12694;28;621510784;12694;760;14229;14821;3.25;0.20;400.89;22.34;1535;36;5087.00;592
12696;28;621510798;12696;758;14238;14834;3.30;0.20;400.86;22.33;1542;36;5088.00;596
12696;28;621510814;12696;757;14238;14834;3.35;0.20;400.86;22.33;1542;36;5089.00;596
12696;28;621510835;12696;749;14239;14834;3.42;0.21;400.86;22.32;1543;36;5090.00;595
12699;29;621510849;12699;744;14240;14835;3.46;0.21;400.80;22.32;1541;37;5091.00;595
12701;29;621510874;12701;739;14240;14836;3.48;0.21;400.79;22.32;1539;37;5092.00;596
12704;29;621510889;12704;739;14240;14836;3.50;0.21;400.75;22.32;1536;37;5093.00;596
12706;29;621510909;12706;737;14241;14839;3.54;0.21;400.71;22.32;1535;37;5094.00;598
12708;29;621510924;12708;732;14241;14839;3.52;0.21;400.68;22.32;1533;37;5095.00;598
12708;29;621510940;12708;730;14241;14839;3.54;0.22;400.68;22.32;1533;37;5096.00;598
12710;29;621510954;12710;724;14241;14839;3.49;0.21;400.65;22.32;1531;37;5097.00;598
12712;29;621510975;12712;732;14245;14845;3.50;0.21;400.63;22.31;1533;37;5098.00;600
12715;29;621510990;12715;729;14245;14845;3.46;0.21;400.59;22.31;1530;37;5099.00;600
12718;29;621511007;12718;717;14250;14864;3.44;0.21;400.53;22.31;1532;37;5100.00;614
12719;29;621511028;12719;704;14250;14864;3.44;0.21;400.53;22.31;1531;37;5101.00;614
12725;29;621511049;12725;697;14253;14868;3.42;0.21;400.47;22.30;1528;37;5102.00;615
12728;29;621511077;12728;692;14253;14869;3.41;0.21;400.50;22.30;1525;37;5103.00;616
12730;29;621511101;12730;690;14253;14869;3.42;0.21;400.49;22.30;1523;37;5104.00;616
12732;29;621511123;12732;689;14255;14870;3.44;0.21;400.49;22.30;1523;37;5105.00;615
12735;29;621511147;12735;683;14257;14870;3.47;0.21;400.45;22.30;1522;37;5106.00;613
12737;29;621511166;12737;669;14257;14870;3.53;0.21;400.47;22.30;1520;37;5107.00;613
12739;29;621511183;12739;663;14257;14870;3.59;0.22;400.45;22.30;1518;37;5108.00;613
12741;29;621511199;12741;658;14257;14870;3.64;0.22;400.43;22.30;1516;37;5109.00;613
12745;29;621511215;12745;650;14257;14870;3.68;0.22;400.57;22.30;1512;37;5110.00;613
12748;29;621511236;12748;647;14258;14870;3.69;0.22;400.67;22.30;1510;37;5111.00;612
12750;29;621511254;12750;644;14296;14940;3.78;0.23;400.66;22.24;1546;37;5112.00;644
12752;29;621511276;12752;629;14301;14941;3.86;0.24;400.67;22.23;1549;37;5113.00;640
12755;29;621511293;12755;618;14302;14941;3.92;0.24;400.70;22.23;1547;37;5114.00;639
12760;29;621511310;12760;609;14304;14941;3.95;0.24;400.70;22.23;1544;37;5115.00;637
12766;29;621511327;12766;610;14304;14941;3.96;0.24;400.69;22.23;1538;37;5116.00;637
12772;29;621511344;12772;607;14307;14941;3.94;0.24;400.80;22.22;1535;37;5117.00;634
12775;29;621511361;12775;602;14308;14941;3.93;0.24;400.78;22.22;1533;37;5118.00;633
12779;29;621511379;12779;606;14310;14941;3.93;0.24;400.80;22.22;1531;37;5119.00;631
12782;29;621511396;12782;607;14310;14942;3.94;0.24;400.91;22.22;1528;37;5120.00;632
12785;29;621511413;12785;607;14311;14943;3.98;0.24;400.88;22.22;1526;37;5121.00;632
12788;29;621511430;12788;612;14311;14943;3.96;0.24;401.02;22.22;1523;37;5122.00;632
12792;29;621511449;12792;618;14315;14947;3.94;0.24;401.12;22.22;1523;37;5123.00;632
12795;29;621511469;12795;616;14317;14947;3.94;0.24;401.16;22.22;1522;37;5124.00;630
12797;29;621511486;12797;620;14317;14947;3.96;0.24;401.19;22.22;1520;37;5125.00;630
12803;29;621511502;12803;616;14317;14947;3.93;0.24;401.23;22.22;1514;37;5126.00;630
12807;29;621511527;12807;612;14320;14953;3.92;0.24;401.26;22.21;1513;37;5127.00;633
12812;29;621511545;12812;614;14323;14953;3.90;0.24;401.38;22.21;1511;37;5128.00;630
12816;29;621511563;12816;615;14323;14953;3.91;0.24;401.37;22.21;1507;37;5129.00;630
12817;29;621511581;12817;612;14324;14959;3.97;0.24;401.37;22.21;1507;37;5130.00;635
12823;29;621511600;12823;618;14328;14959;3.98;0.24;401.43;22.22;1505;37;5131.00;631
12826;29;621511617;12826;625;14328;14959;3.99;0.24;401.42;22.22;1502;37;5132.00;631
12830;29;621511634;12830;620;14330;14960;3.98;0.24;401.45;22.24;1500;37;5133.00;630
12832;29;621511651;12832;624;14331;14961;4.01;0.24;401.45;22.24;1499;37;5134.00;630
12834;29;621511668;12834;625;14331;14961;4.01;0.24;401.45;22.24;1497;37;5135.00;630
12839;29;621511685;12839;619;14341;14974;4.03;0.24;401.45;22.25;1502;37;5136.00;633
12840;29;621511704;12840;617;14341;14974;4.06;0.25;401.49;22.25;1501;37;5137.00;633
12844;29;621511720;12844;608;14341;14974;4.09;0.25;401.71;22.25;1497;37;5138.00;633
12845;29;621511736;12845;608;14344;14975;4.10;0.25;401.69;22.28;1499;37;5139.00;631
12848;29;621511753;12848;606;14346;14975;4.08;0.25;401.75;22.29;1498;37;5140.00;629
12850;29;621511770;12850;614;14348;14979;4.03;0.24;401.80;22.28;1498;37;5141.00;631
12854;29;621511787;12854;613;14352;14979;3.93;0.24;401.87;22.32;1498;37;5142.00;627
12857;29;621511804;12857;617;14355;14983;3.85;0.23;401.89;22.32;1498;37;5143.00;628
12858;29;621511821;12858;620;14355;14983;3.78;0.23;401.90;22.32;1497;37;5144.00;628
12859;29;621511837;12859;628;14357;14983;3.74;0.23;401.95;22.35;1498;37;5145.00;626
12862;29;621511854;12862;643;14359;14983;3.71;0.22;401.93;22.36;1497;37;5146.00;624
12866;29;621511870;12866;641;14360;14983;3.70;0.22;402.03;22.37;1494;37;5147.00;623
12869;29;621511887;12869;641;14367;14995;3.71;0.22;402.11;22.38;1498;37;5148.00;628
12870;29;621511905;12870;634;14369;14995;3.75;0.23;402.20;22.39;1499;37;5149.00;626
12870;29;621511921;12870;633;14371;14995;3.80;0.23;402.20;22.41;1501;37;5150.00;624
12871;29;621511938;12871;630;14371;14995;3.86;0.23;402.23;22.41;1500;37;5151.00;624
12874;29;621511956;12874;633;14372;14995;3.91;0.24;402.23;22.41;1498;37;5152.00;623
12876;29;621511974;12876;636;14373;14995;3.93;0.24;402.33;22.42;1497;37;5153.00;622
12877;29;621511991;12877;637;14375;14996;3.92;0.24;402.40;22.44;1498;37;5154.00;621
12879;29;621512008;12879;649;14379;14998;3.89;0.24;402.44;22.46;1500;37;5155.00;619
12881;29;621512032;12881;640;14384;15004;3.88;0.23;402.52;22.46;1503;37;5156.00;620
12883;29;621512051;12883;630;14389;15005;3.88;0.23;402.58;22.48;1506;37;5157.00;616
12887;29;621512067;12887;624;14389;15005;3.85;0.23;402.55;22.48;1502;37;5158.00;616
12892;29;621512084;12892;613;14392;15005;3.82;0.23;402.90;22.51;1500;37;5159.00;613
12893;29;621512112;12893;614;14396;15010;3.83;0.23;402.95;22.51;1503;37;5160.00;614
12894;29;621512130;12894;610;14398;15010;3.87;0.23;402.93;22.52;1504;37;5161.00;612
12898;29;621512146;12898;616;14399;15010;3.90;0.24;402.96;22.54;1501;37;5162.00;611
12898;29;621512163;12898;624;14401;15011;3.96;0.24;402.96;22.55;1503;37;5163.00;610
12899;29;621512180;12899;625;14405;15015;3.96;0.24;402.97;22.55;1506;37;5164.00;610
12901;29;621512197;12901;629;14407;15015;3.92;0.24;402.99;22.67;1506;37;5165.00;608
12904;29;621512214;12904;639;14409;15018;3.92;0.24;403.09;22.68;1505;37;5166.00;609
12906;29;621512231;12906;636;14410;15018;3.90;0.24;403.24;22.69;1504;37;5167.00;608
12908;29;621512247;12908;639;14410;15018;3.90;0.24;403.21;22.69;1502;37;5168.00;608
12910;29;621512265;12910;644;14411;15018;3.89;0.24;403.31;22.70;1501;37;5169.00;607
12912;29;621512281;12912;642;14415;15022;3.89;0.24;403.45;22.71;1503;37;5170.00;607
12914;29;621512298;12914;639;14415;15022;3.92;0.24;403.46;22.71;1501;37;5171.00;607
12915;29;621512314;12915;649;14416;15022;3.93;0.24;403.47;22.72;1501;37;5172.00;606
12919;29;621512331;12919;648;14418;15022;3.89;0.24;403.64;22.74;1499;37;5173.00;604
12922;29;621512347;12922;652;14418;15023;3.90;0.24;403.69;22.74;1496;37;5174.00;605
12924;29;621512363;12924;655;14419;15025;3.91;0.24;403.90;22.74;1495;37;5175.00;606
12925;29;621512379;12925;651;14419;15025;3.90;0.24;403.89;22.74;1494;37;5176.00;606
12929;29;621512395;12929;642;14421;15026;3.86;0.23;404.15;22.74;1492;37;5177.00;605
12929;29;621512411;12929;633;14423;15026;3.87;0.24;404.15;22.76;1494;37;5178.00;603
12931;29;621512426;12931;626;14424;15026;3.89;0.24;404.36;22.77;1493;37;5179.00;602
12932;29;621512442;12932;620;14425;15026;3.94;0.24;404.36;22.78;1493;37;5180.00;601
12936;29;621512458;12936;624;14426;15026;3.93;0.24;404.50;22.79;1490;37;5181.00;600
12938;29;621512475;12938;621;14427;15026;3.94;0.24;404.54;22.80;1489;37;5182.00;599
12941;29;621512491;12941;623;14428;15026;3.93;0.24;404.57;22.81;1487;37;5183.00;598
12943;29;621512507;12943;659;14493;15153;4.09;0.25;404.56;22.71;1550;37;5184.00;660
12945;29;621512532;12945;646;14497;15154;4.12;0.26;404.56;22.72;1552;37;5185.00;657
12949;29;621512549;12949;640;14503;15154;4.15;0.26;404.58;22.72;1554;37;5186.00;651
12951;29;621512573;12951;653;14505;15154;4.19;0.26;404.60;22.74;1554;37;5187.00;649
12955;29;621512589;12955;661;14509;15154;4.17;0.26;404.65;22.73;1554;37;5188.00;645
12957;29;621512605;12957;666;14512;15154;4.17;0.26;404.72;22.74;1555;37;5189.00;642
12959;29;621512623;12959;675;14513;15154;4.17;0.26;404.80;22.74;1554;37;5190.00;641
12966;29;621512640;12966;677;14515;15154;4.15;0.26;404.88;22.75;1549;37;5191.00;639
12968;29;621512658;12968;663;14518;15155;4.12;0.25;404.86;22.75;1550;37;5192.00;637
12971;29;621512675;12971;661;14520;15156;4.12;0.25;404.96;22.76;1549;37;5193.00;636
12974;29;621512692;12974;655;14522;15156;4.14;0.26;404.95;22.77;1548;37;5194.00;634
12977;29;621512709;12977;658;14524;15157;4.14;0.25;404.93;22.78;1547;37;5195.00;633
12980;29;621512725;12980;649;14525;15157;4.15;0.26;404.98;22.78;1545;37;5196.00;632
12982;29;621512742;12982;649;14527;15157;4.15;0.26;404.97;22.79;1545;37;5197.00;630
12983;29;621512759;12983;644;14528;15157;4.13;0.25;404.95;22.79;1545;37;5198.00;629
12985;29;621512776;12985;647;14530;15161;4.10;0.25;404.95;22.78;1545;37;5199.00;631
12986;29;621512801;12986;644;14532;15161;4.07;0.25;404.94;22.79;1546;37;5200.00;629
12990;29;621512822;12990;646;14534;15161;3.99;0.25;404.89;22.80;1544;37;5201.00;627
12994;29;621512838;12994;652;14535;15164;3.96;0.24;404.82;22.80;1541;37;5202.00;629
12998;29;621512855;12998;644;14536;15164;3.95;0.24;404.76;22.80;1538;37;5203.00;628
13004;29;621512872;13004;635;14538;15164;3.92;0.24;404.77;22.80;1534;37;5204.00;626
13005;29;621512888;13005;638;14545;15168;3.90;0.24;404.75;22.92;1540;37;5205.00;623
13008;29;621512911;13008;633;14546;15169;3.86;0.24;404.77;22.92;1538;37;5206.00;623
13014;29;621512929;13014;636;14547;15169;3.83;0.24;404.78;22.92;1533;37;5207.00;622
13015;29;621512946;13015;634;14549;15173;3.83;0.24;404.75;22.93;1534;37;5208.00;624
13017;29;621512962;13017;640;14550;15173;3.81;0.23;404.78;22.93;1533;37;5209.00;623
13020;29;621512979;13020;638;14552;15173;3.82;0.24;404.71;22.94;1532;37;5210.00;621
13021;29;621512995;13021;646;14552;15174;3.83;0.24;404.69;22.94;1531;38;5211.00;622
13023;29;621513016;13023;651;14554;15174;3.84;0.24;404.70;23.05;1531;38;5212.00;620
13024;29;621513032;13024;653;14559;15180;3.86;0.24;404.69;23.06;1535;38;5213.00;621
13026;29;621513055;13026;657;14559;15180;3.84;0.24;404.64;23.06;1533;38;5214.00;621
13028;29;621513080;13028;666;14561;15180;3.81;0.23;404.60;23.08;1533;38;5215.00;619
13033;29;621513106;13033;673;14562;15181;3.76;0.23;404.64;23.08;1529;38;5216.00;619
13034;29;621513129;13034;684;14562;15181;3.71;0.23;404.69;23.08;1528;38;5217.00;619
13037;29;621513150;13037;685;14565;15181;3.71;0.23;404.69;23.09;1528;38;5218.00;616
13039;29;621513168;13039;691;14565;15181;3.67;0.23;404.65;23.09;1526;38;5219.00;616
13042;29;621513187;13042;697;14588;15217;3.73;0.23;404.68;23.07;1546;38;5220.00;629
13047;29;621513208;13047;695;14590;15217;3.72;0.23;404.82;23.06;1543;38;5221.00;627
13048;29;621513226;13048;688;14592;15217;3.72;0.23;404.79;23.06;1544;38;5222.00;625
13050;29;621513244;13050;689;14593;15217;3.70;0.23;404.78;23.06;1543;38;5223.00;624
13053;29;621513262;13053;701;14594;15217;3.67;0.23;404.78;23.06;1541;38;5224.00;623
13054;29;621513280;13054;702;14594;15217;3.67;0.23;404.76;23.06;1540;38;5225.00;623
13054;29;621513297;13054;715;14598;15221;3.64;0.22;404.76;23.05;1544;38;5226.00;623
13054;29;621513314;13054;714;14598;15221;3.64;0.22;404.76;23.05;1544;38;5227.00;623
13056;29;621513330;13056;722;14601;15225;3.64;0.22;404.76;23.05;1545;38;5228.00;624
13060;29;621513347;13060;722;14601;15226;3.59;0.22;404.83;23.05;1541;38;5229.00;625
13061;29;621513364;13061;734;14601;15226;3.54;0.22;404.92;23.05;1540;38;5230.00;625
13062;29;621513380;13062;737;14601;15226;3.52;0.22;404.90;23.05;1539;38;5231.00;625
13064;29;621513398;13064;744;14611;15239;3.55;0.22;404.88;23.03;1547;38;5232.00;628
13066;29;621513416;13066;743;14611;15239;3.53;0.22;404.86;23.03;1545;38;5233.00;628
13068;29;621513433;13068;751;14611;15239;3.52;0.22;404.89;23.03;1543;38;5234.00;628
13069;29;621513450;13069;739;14612;15240;3.54;0.22;404.94;23.03;1543;38;5235.00;628
13070;29;621513467;13070;743;14612;15241;3.54;0.22;404.94;23.03;1542;38;5236.00;629
13072;29;621513484;13072;739;14612;15241;3.52;0.22;404.94;23.03;1540;38;5237.00;629
13072;29;621513500;13072;737;14613;15244;3.56;0.22;404.94;23.03;1541;38;5238.00;631
13072;29;621513517;13072;735;14613;15244;3.57;0.22;404.94;23.03;1541;38;5239.00;631
13073;29;621513534;13073;730;14613;15244;3.54;0.22;404.99;23.03;1540;38;5240.00;631
13073;29;621513550;13073;736;14613;15244;3.56;0.22;404.99;23.03;1540;38;5241.00;631
13075;29;621513573;13075;735;14617;15250;3.58;0.22;404.97;23.02;1542;38;5242.00;633
13077;29;621513591;13077;740;14617;15250;3.57;0.22;404.92;23.02;1540;38;5243.00;633
13077;29;621513608;13077;743;14617;15250;3.57;0.22;404.92;23.02;1540;38;5244.00;633
13078;29;621513625;13078;744;14617;15250;3.59;0.22;404.93;23.02;1539;38;5245.00;633
13078;29;621513643;13078;744;14620;15254;3.59;0.22;404.93;23.02;1542;38;5246.00;634
13080;29;621513659;13080;733;14620;15255;3.59;0.22;404.92;23.02;1540;38;5247.00;635
13081;29;621513675;13081;734;14620;15255;3.57;0.22;404.89;23.02;1539;38;5248.00;635
13082;29;621513692;13082;739;14621;15256;3.55;0.22;404.87;23.02;1539;38;5249.00;635
13084;29;621513710;13084;739;14621;15256;3.50;0.21;404.90;23.02;1537;38;5250.00;635
13086;29;621513733;13086;736;14621;15256;3.50;0.21;404.86;23.02;1535;38;5251.00;635
13087;29;621513748;13087;733;14621;15256;3.49;0.21;404.86;23.02;1534;38;5252.00;635
13090;29;621513764;13090;734;14621;15256;3.47;0.21;404.85;23.02;1531;38;5253.00;635
13090;29;621513781;13090;734;14621;15256;3.47;0.21;404.85;23.02;1531;38;5254.00;635
13093;29;621513796;13093;733;14621;15256;3.47;0.21;404.82;23.02;1528;38;5255.00;635
13095;29;621513813;13095;739;14659;15326;3.67;0.22;404.87;22.96;1564;38;5256.00;667
13095;29;621513836;13095;732;14663;15327;3.74;0.23;404.87;22.95;1568;38;5257.00;664
13097;29;621513852;13097;725;14667;15327;3.77;0.23;404.83;22.94;1570;38;5258.00;660
13099;29;621513876;13099;720;14668;15327;3.81;0.23;404.90;22.94;1569;38;5259.00;659
13100;29;621513892;13100;713;14669;15327;3.84;0.23;404.93;22.94;1569;38;5260.00;658
13101;29;621513907;13101;708;14670;15327;3.83;0.23;404.96;22.94;1569;38;5261.00;657
13102;29;621513923;13102;709;14671;15327;3.80;0.23;404.94;22.94;1569;38;5262.00;656
13106;29;621513940;13106;720;14672;15327;3.71;0.23;405.06;22.94;1566;38;5263.00;655
13113;29;621513957;13113;718;14675;15328;3.65;0.22;405.05;22.94;1562;38;5264.00;653
13115;29;621513974;13115;717;14677;15330;3.62;0.22;405.11;22.93;1562;38;5265.00;653
13120;29;621513992;13120;722;14677;15330;3.56;0.22;405.11;22.93;1557;38;5266.00;653
13123;29;621514009;13123;722;14681;15334;3.53;0.21;405.18;22.93;1558;38;5267.00;653
13125;29;621514037;13125;724;14681;15334;3.50;0.21;405.13;22.93;1556;38;5268.00;653
13128;29;621514055;13128;726;14681;15334;3.48;0.21;405.20;22.93;1553;38;5269.00;653
13130;29;621514071;13130;714;14681;15334;3.50;0.21;405.31;22.93;1551;38;5270.00;653
13132;29;621514088;13132;708;14685;15340;3.55;0.22;405.33;22.92;1553;38;5271.00;655
13133;29;621514105;13133;701;14685;15340;3.59;0.22;405.33;22.92;1552;38;5272.00;655
13135;29;621514120;13135;698;14685;15340;3.62;0.22;405.41;22.92;1550;38;5273.00;655
13139;29;621514136;13139;695;14686;15343;3.59;0.22;405.44;22.92;1547;38;5274.00;657
13142;29;621514152;13142;705;14686;15343;3.57;0.22;405.54;22.92;1544;38;5275.00;657
13143;29;621514168;13143;704;14686;15343;3.58;0.22;405.55;22.92;1543;38;5276.00;657
13148;29;621514184;13148;704;14686;15344;3.52;0.21;405.59;22.92;1538;38;5277.00;658
13150;29;621514200;13150;704;14687;15345;3.50;0.21;405.57;22.92;1537;38;5278.00;658
13153;29;621514216;13153;700;14687;15345;3.49;0.21;405.63;22.92;1534;38;5279.00;658
13157;29;621514233;13157;695;14704;15371;3.57;0.22;405.61;22.89;1547;38;5280.00;667
13160;29;621514252;13160;685;14706;15371;3.58;0.22;405.59;22.89;1546;38;5281.00;665
13163;29;621514268;13163;686;14708;15371;3.58;0.22;405.61;22.89;1545;38;5282.00;663
13168;29;621514284;13168;681;14708;15372;3.63;0.22;405.74;22.89;1540;38;5283.00;664
13173;29;621514301;13173;670;14708;15372;3.68;0.22;405.81;22.89;1535;38;5284.00;664
13178;29;621514318;13178;659;14711;15376;3.69;0.22;405.74;22.88;1533;38;5285.00;665
13182;29;621514336;13182;653;14711;15376;3.71;0.23;405.85;22.88;1529;38;5286.00;665
13185;29;621514358;13185;644;14714;15379;3.72;0.23;405.96;22.88;1529;38;5287.00;665
13189;29;621514375;13189;641;14714;15380;3.74;0.23;405.94;22.88;1525;38;5288.00;666
13194;29;621514391;13194;638;14714;15380;3.75;0.23;406.05;22.88;1520;38;5289.00;666
13198;29;621514408;13198;634;14714;15380;3.75;0.23;406.09;22.88;1516;38;5290.00;666
13201;29;621514425;13201;624;14714;15380;3.78;0.23;406.15;22.88;1513;38;5291.00;666
13205;29;621514441;13205;619;14720;15392;3.82;0.23;406.20;22.87;1515;38;5292.00;672
13208;29;621514459;13208;623;14720;15392;3.82;0.23;406.34;22.87;1512;38;5293.00;672
13211;29;621514476;13211;624;14720;15392;3.80;0.23;406.34;22.87;1509;38;5294.00;672
13217;29;621514493;13217;628;14720;15392;3.80;0.23;406.44;22.87;1503;38;5295.00;672
13222;29;621514510;13222;616;14720;15392;3.82;0.23;406.56;22.87;1498;38;5296.00;672
13225;29;621514528;13225;615;14720;15392;3.86;0.23;406.56;22.87;1495;38;5297.00;672
13228;29;621514545;13228;609;14720;15393;3.89;0.24;406.61;22.87;1492;38;5298.00;673
13232;29;621514562;13232;612;14720;15393;3.89;0.24;406.65;22.87;1488;38;5299.00;673
13238;29;621514579;13238;603;14724;15399;3.89;0.24;406.63;22.86;1486;38;5300.00;675
13242;29;621514603;13242;602;14726;15400;3.90;0.24;406.76;22.89;1484;38;5301.00;674
13245;29;621514620;13245;597;14726;15400;3.94;0.24;406.76;22.89;1481;38;5302.00;674
13247;29;621514636;13247;602;14727;15400;3.98;0.24;406.82;22.89;1480;38;5303.00;673
13252;29;621514652;13252;599;14728;15404;3.97;0.24;406.90;22.89;1476;38;5304.00;676
13257;29;621514670;13257;593;14729;15404;3.95;0.24;406.91;22.89;1472;38;5305.00;675
13260;29;621514691;13260;595;14730;15404;3.95;0.24;406.94;22.90;1470;38;5306.00;674
13264;29;621514713;13264;593;14732;15405;3.97;0.24;406.97;22.92;1468;38;5307.00;673
13267;29;621514730;13267;586;14736;15409;4.00;0.24;406.97;22.91;1469;38;5308.00;673
13273;29;621514748;13273;579;14737;15409;4.00;0.24;407.07;22.93;1464;38;5309.00;672
13277;29;621514766;13277;573;14741;15415;4.00;0.24;407.14;22.94;1464;38;5310.00;674
13279;29;621514783;13279;566;14742;15415;3.99;0.24;407.27;22.95;1463;38;5311.00;673
13282;29;621514806;13282;574;14744;15415;3.95;0.24;407.28;22.95;1462;38;5312.00;671
13286;29;621514822;13286;578;14748;15415;3.87;0.23;407.47;23.09;1462;38;5313.00;667
13288;29;621514840;13288;567;14750;15419;3.82;0.23;407.57;23.09;1462;38;5314.00;669
13291;29;621514858;13291;574;14751;15419;3.80;0.23;407.60;23.10;1460;38;5315.00;668
13293;29;621514877;13293;575;14753;15419;3.79;0.23;407.68;23.11;1460;38;5316.00;666
13297;29;621514902;13297;568;14754;15419;3.73;0.23;407.72;23.12;1457;38;5317.00;665
13301;29;621514923;13301;562;14754;15420;3.69;0.22;407.75;23.12;1453;38;5318.00;666
13303;29;621514940;13303;556;14756;15421;3.70;0.22;407.85;23.15;1453;38;5319.00;665
13305;29;621514957;13305;564;14756;15421;3.71;0.22;407.93;23.15;1451;38;5320.00;665
13309;29;621514973;13309;557;14759;15422;3.70;0.22;408.07;23.17;1450;38;5321.00;663
13311;29;621514989;13311;558;14759;15422;3.69;0.22;408.11;23.17;1448;38;5322.00;663
13313;29;621515005;13313;558;14760;15422;3.70;0.22;408.12;23.19;1447;38;5323.00;662
13317;29;621515021;13317;564;14761;15422;3.72;0.22;408.18;23.20;1444;38;5324.00;661
13318;29;621515037;13318;572;14762;15422;3.68;0.22;408.22;23.21;1444;38;5325.00;660
13321;29;621515061;13321;567;14762;15422;3.71;0.23;408.20;23.21;1441;38;5326.00;660
13324;29;621515085;13324;565;14764;15422;3.68;0.22;408.30;23.24;1440;38;5327.00;658
13325;29;621515111;13325;583;14837;15549;3.83;0.24;408.31;23.14;1512;38;5328.00;712
13329;29;621515151;13329;563;14838;15550;3.84;0.24;408.40;23.14;1509;38;5329.00;712
13331;29;621515171;13331;557;14841;15550;3.88;0.24;408.42;23.15;1510;38;5330.00;709
13333;29;621515189;13333;556;14843;15550;3.93;0.24;408.48;23.28;1510;38;5331.00;707
13334;29;621515212;13334;560;14845;15550;3.94;0.24;408.49;23.29;1511;38;5332.00;705
13334;29;621515233;13334;557;14848;15550;4.01;0.25;408.49;23.31;1514;38;5333.00;702
13339;29;621515258;13339;555;14849;15550;4.00;0.25;408.61;23.32;1510;38;5334.00;701
13341;29;621515279;13341;558;14851;15550;4.06;0.25;408.63;23.32;1510;38;5335.00;699
13342;29;621515305;13342;567;14852;15551;4.08;0.25;408.66;23.33;1510;39;5336.00;699
13346;29;621515341;13346;567;14857;15552;4.07;0.25;408.65;23.34;1511;39;5337.00;695
13348;29;621515360;13348;567;14860;15552;4.08;0.25;408.73;23.35;1512;39;5338.00;692
13352;29;621515380;13352;565;14863;15553;4.05;0.25;408.95;23.35;1511;39;5339.00;690
13353;29;621515401;13353;569;14866;15553;4.03;0.25;408.99;23.36;1513;39;5340.00;687
13354;29;621515420;13354;580;14869;15553;4.05;0.25;408.99;23.37;1515;39;5341.00;684
13356;29;621515440;13356;589;14871;15553;4.03;0.25;409.02;23.36;1515;39;5342.00;682
13359;29;621515459;13359;591;14878;15557;3.99;0.24;409.17;23.49;1519;39;5343.00;679
13359;29;621515479;13359;593;14880;15557;3.96;0.24;409.17;23.49;1521;39;5344.00;677
13362;29;621515497;13362;607;14880;15557;3.92;0.24;409.33;23.49;1518;39;5345.00;677
13367;29;621515515;13367;610;14883;15560;3.89;0.24;409.56;23.51;1516;39;5346.00;677
13368;29;621515534;13368;617;14883;15560;3.86;0.24;409.61;23.51;1515;39;5347.00;677
13369;29;621515550;13369;620;14884;15560;3.79;0.23;409.65;23.63;1515;39;5348.00;676
13370;29;621515567;13370;634;14889;15564;3.74;0.23;409.64;23.65;1519;39;5349.00;675
13372;29;621515585;13372;637;14892;15565;3.70;0.23;409.77;23.67;1520;39;5350.00;673
13374;29;621515605;13374;640;14894;15565;3.68;0.23;409.81;23.69;1520;39;5351.00;671
13375;29;621515623;13375;651;14897;15569;3.65;0.22;409.85;23.68;1522;39;5352.00;672
13376;29;621515642;13376;655;14897;15569;3.65;0.22;409.90;23.68;1521;39;5353.00;672
13379;29;621515659;13379;658;14899;15569;3.63;0.22;409.85;23.70;1520;39;5354.00;670
13381;29;621515678;13381;668;14902;15571;3.61;0.22;409.86;23.72;1521;39;5355.00;669
13381;29;621515700;13381;660;14903;15571;3.65;0.22;409.86;23.73;1522;39;5356.00;668
13381;29;621515718;13381;664;14908;15577;3.65;0.22;409.86;23.73;1527;39;5357.00;669
13383;29;621515737;13383;655;14908;15577;3.63;0.22;409.90;23.73;1525;39;5358.00;669
13385;29;621515755;13385;657;14910;15577;3.65;0.22;409.87;23.75;1525;39;5359.00;667
13387;29;621515773;13387;651;14910;15578;3.65;0.22;409.88;23.75;1523;39;5360.00;668
13390;29;621515792;13390;646;14912;15578;3.62;0.22;409.82;23.77;1522;39;5361.00;666
13392;29;621515810;13392;647;14912;15578;3.60;0.22;409.81;23.77;1520;39;5362.00;666
13396;29;621515829;13396;651;14914;15578;3.57;0.22;409.75;23.79;1518;39;5363.00;664
13396;29;621515848;13396;648;14923;15590;3.62;0.22;409.75;23.79;1527;39;5364.00;667
13400;29;621515876;13400;644;14924;15590;3.64;0.22;409.72;23.80;1524;39;5365.00;666
13403;29;621515899;13403;644;14927;15590;3.65;0.22;409.72;23.82;1524;39;5366.00;663
13404;29;621515918;13404;642;14928;15590;3.68;0.23;409.70;23.83;1524;39;5367.00;662
13407;29;621515936;13407;631;14928;15590;3.71;0.23;409.70;23.83;1521;39;5368.00;662
13411;29;621515955;13411;630;14928;15590;3.74;0.23;409.76;23.83;1517;39;5369.00;662
13415;29;621515975;13415;627;14932;15594;3.70;0.23;409.70;23.84;1517;39;5370.00;662
13419;29;621515994;13419;621;14935;15594;3.68;0.22;409.65;23.87;1516;39;5371.00;659
13423;29;621516011;13423;622;14938;15598;3.69;0.23;409.61;23.86;1515;39;5372.00;660
13426;29;621516030;13426;629;14938;15599;3.64;0.22;409.57;23.86;1512;39;5373.00;661
13428;29;621516049;13428;615;14939;15599;3.64;0.22;409.56;23.87;1511;39;5374.00;660
13430;29;621516076;13430;621;14941;15599;3.63;0.22;409.53;24.10;1511;39;5375.00;658
13432;29;621516108;13432;618;14952;15612;3.66;0.22;409.50;24.10;1520;39;5376.00;660
13436;29;621516129;13436;617;14952;15612;3.63;0.22;409.54;24.10;1516;39;5377.00;660
13438;29;621516150;13438;621;14953;15612;3.64;0.22;409.50;24.11;1515;39;5378.00;659
13441;29;621516169;13441;627;14954;15613;3.66;0.22;409.47;24.11;1513;39;5379.00;659
13444;29;621516189;13444;622;14957;15614;3.64;0.22;409.60;24.13;1513;39;5380.00;657
13446;29;621516206;13446;622;14960;15614;3.65;0.22;409.54;24.16;1514;39;5381.00;654
13449;29;621516223;13449;624;14961;15617;3.63;0.22;409.55;24.16;1512;39;5382.00;656
13452;29;621516240;13452;623;14962;15617;3.56;0.22;409.59;24.16;1510;39;5383.00;655
13453;29;621516256;13453;633;14962;15617;3.49;0.21;409.56;24.16;1509;39;5384.00;655
13455;29;621516273;13455;637;14963;15617;3.46;0.21;409.57;24.17;1508;39;5385.00;654
13457;29;621516289;13457;635;14967;15623;3.47;0.21;409.55;24.17;1510;39;5386.00;656
13458;29;621516306;13458;628;14967;15623;3.46;0.21;409.56;24.17;1509;39;5387.00;656
13459;29;621516322;13459;627;14968;15623;3.49;0.21;409.54;24.17;1509;39;5388.00;655
13460;29;621516338;13460;622;14968;15623;3.49;0.21;409.53;24.17;1508;39;5389.00;655
13462;29;621516359;13462;624;14971;15627;3.51;0.21;409.51;24.17;1509;39;5390.00;656
13464;29;621516380;13464;616;14972;15628;3.50;0.21;409.60;24.18;1508;39;5391.00;656
13464;29;621516398;13464;620;14972;15628;3.51;0.21;409.60;24.18;1508;39;5392.00;656
13465;29;621516415;13465;615;14973;15629;3.56;0.22;409.60;24.17;1508;39;5393.00;656
13465;29;621516432;13465;613;14974;15629;3.58;0.22;409.60;24.18;1509;39;5394.00;655
13469;29;621516449;13469;622;14976;15629;3.57;0.22;409.58;24.20;1507;39;5395.00;653
13469;29;621516466;13469;626;14977;15629;3.59;0.22;409.58;24.20;1508;39;5396.00;652
13471;29;621516483;13471;628;14977;15629;3.59;0.22;409.62;24.20;1506;39;5397.00;652
13473;29;621516499;13473;633;14977;15629;3.58;0.22;409.76;24.20;1504;39;5398.00;652
13473;29;621516515;13473;638;14977;15629;3.59;0.22;409.76;24.20;1504;39;5399.00;652
