step_arrived;step_collisions;step_duration;step_ended;step_halting;step_inserted;step_loaded;step_meanSpeed;step_meanSpeedRelative;step_meanTravelTime;step_meanWaitingTime;step_running;step_teleports;step_time;step_waiting
0;0;621678796;0;1;86;245;16.52;1.17;-1.00;0.00;86;0;0.00;159
0;0;621678832;0;0;99;245;15.61;1.08;-1.00;0.13;99;0;1.00;146
0;0;621678833;0;1;118;245;14.83;1.01;-1.00;0.43;118;0;2.00;127
0;0;621678835;0;2;130;245;13.96;0.95;-1.00;0.67;130;0;3.00;115
0;0;621678836;0;3;144;245;12.91;0.87;-1.00;0.99;144;0;4.00;101
0;0;621678837;0;4;153;245;11.88;0.80;-1.00;1.23;153;0;5.00;92
0;0;621678839;0;7;165;245;10.92;0.73;-1.00;1.58;165;0;6.00;80
0;0;621678841;0;10;171;245;10.34;0.69;-1.00;1.77;171;0;7.00;74
0;0;621678843;0;17;181;246;9.85;0.65;-1.00;2.11;181;0;8.00;65
0;0;621678845;0;19;185;247;9.46;0.63;-1.00;2.26;185;0;9.00;62
0;0;621678847;0;23;194;247;9.05;0.60;-1.00;2.62;194;0;10.00;53
0;0;621678849;0;27;200;248;8.68;0.57;-1.00;2.82;200;0;11.00;48
1;0;621678851;1;27;206;248;8.63;0.57;12.00;3.09;205;0;12.00;42
1;0;621678853;1;33;211;248;8.68;0.56;12.00;3.32;210;0;13.00;37
1;0;621678856;1;36;214;248;8.68;0.56;12.00;3.47;213;0;14.00;34
1;0;621678858;1;39;222;252;8.52;0.55;12.00;3.76;221;0;15.00;30
1;0;621678861;1;44;223;252;8.59;0.55;12.00;3.82;222;0;16.00;29
1;0;621678864;1;47;227;252;8.65;0.55;12.00;4.02;226;0;17.00;25
2;0;621678867;2;51;230;255;8.59;0.55;15.00;4.20;228;0;18.00;25
2;0;621678870;2;59;233;255;8.62;0.54;15.00;4.25;231;0;19.00;22
3;0;621678882;3;64;234;255;8.65;0.54;16.67;4.32;231;0;20.00;21
3;0;621678885;3;69;241;259;8.82;0.55;16.67;4.47;238;0;21.00;18
3;0;621678888;3;73;242;260;8.89;0.56;16.67;4.46;239;0;22.00;18
3;0;621678891;3;78;244;260;8.86;0.56;16.67;4.61;241;0;23.00;16
3;0;621678894;3;79;248;264;8.79;0.55;16.67;4.63;245;0;24.00;16
5;0;621678898;5;82;251;264;8.78;0.55;20.00;4.78;246;0;25.00;13
6;0;621678901;6;85;252;264;8.80;0.55;20.83;4.81;246;0;26.00;12
6;0;621678904;6;91;252;265;8.80;0.55;20.83;4.81;246;0;27.00;13
6;0;621678907;6;96;253;265;8.68;0.54;20.83;4.90;247;0;28.00;12
6;0;621678910;6;98;259;271;8.56;0.53;20.83;4.85;253;0;29.00;12
6;0;621678916;6;98;260;271;8.41;0.52;20.83;4.95;254;0;30.00;11
6;0;621678919;6;98;261;272;8.43;0.52;20.83;4.93;255;0;31.00;11
8;0;621678922;8;101;262;272;8.34;0.52;23.25;4.93;254;0;32.00;10
8;0;621678925;8;106;262;272;8.36;0.52;23.25;4.93;254;0;33.00;10
9;0;621678928;9;109;263;272;8.33;0.52;24.44;5.04;254;0;34.00;9
9;0;621678931;9;110;264;272;8.30;0.51;24.44;5.15;255;0;35.00;8
10;0;621678934;10;114;276;284;8.54;0.53;25.00;5.06;266;0;36.00;8
10;0;621678938;10;116;276;284;8.55;0.53;25.00;5.06;266;0;37.00;8
10;0;621678941;10;119;277;284;8.51;0.53;25.00;5.14;267;0;38.00;7
13;0;621678944;13;120;278;284;8.38;0.52;27.54;5.20;265;0;39.00;6
14;0;621678947;14;122;279;284;8.32;0.51;28.07;5.23;265;0;40.00;5
14;0;621678951;14;124;280;284;8.27;0.51;28.07;5.23;266;0;41.00;4
15;0;621678955;15;127;284;288;8.26;0.51;28.53;5.17;269;0;42.00;4
16;0;621678958;16;130;284;288;8.04;0.50;29.06;5.17;268;0;43.00;4
18;0;621678961;18;132;288;292;7.87;0.48;29.56;5.11;270;0;44.00;4
18;0;621678965;18;135;290;294;7.72;0.48;29.56;5.08;272;0;45.00;4
18;0;621678969;18;138;290;294;7.50;0.47;29.56;5.08;272;0;46.00;4
18;0;621678972;18;138;290;294;7.49;0.47;29.56;5.08;272;0;47.00;4
18;0;621678974;18;140;301;307;7.72;0.48;29.56;4.89;283;0;48.00;6
19;0;621678978;19;143;301;307;7.58;0.47;30.53;4.89;282;0;49.00;6
19;0;621678981;19;147;301;307;7.57;0.47;30.53;4.89;282;0;50.00;6
19;0;621678984;19;149;302;308;7.57;0.47;30.53;4.88;283;0;51.00;6
19;0;621678987;19;150;303;309;7.46;0.46;30.53;4.86;284;0;52.00;6
19;0;621678989;19;153;303;309;7.42;0.46;30.53;4.86;284;0;53.00;6
19;0;621678992;19;155;305;312;7.43;0.46;30.53;4.83;286;0;54.00;7
21;0;621678995;21;158;305;312;7.28;0.45;32.76;4.83;284;0;55.00;7
24;0;621678998;24;147;306;312;7.27;0.45;33.21;4.82;282;0;56.00;6
27;0;621679001;27;141;306;312;7.14;0.44;34.93;4.82;279;0;57.00;6
28;0;621679004;28;142;312;318;7.09;0.44;35.75;4.75;284;0;58.00;6
28;0;621679007;28;143;312;318;7.08;0.43;35.75;4.75;284;0;59.00;6
28;0;621679012;28;145;312;318;7.11;0.44;35.75;4.75;284;0;60.00;6
28;0;621679015;28;149;312;318;7.12;0.44;35.75;4.75;284;0;61.00;6
28;0;621679019;28;153;316;322;7.15;0.44;35.75;4.70;288;0;62.00;6
29;0;621679023;29;154;317;323;7.38;0.45;36.69;4.69;288;0;63.00;6
30;0;621679027;30;156;317;323;7.46;0.46;37.47;4.69;287;0;64.00;6
30;0;621679030;30;156;318;324;7.59;0.46;37.47;4.68;288;0;65.00;6
30;0;621679032;30;157;318;324;7.66;0.47;37.47;4.68;288;0;66.00;6
32;0;621679035;32;146;318;324;7.73;0.47;37.75;4.68;286;0;67.00;6
33;0;621679038;33;142;318;324;7.82;0.48;38.52;4.68;285;0;68.00;6
33;0;621679041;33;138;318;324;8.00;0.49;38.52;4.68;285;0;69.00;6
33;0;621679044;33;133;318;324;8.14;0.50;38.52;4.68;285;0;70.00;6
33;0;621679047;33;129;318;324;8.22;0.50;38.52;4.68;285;0;71.00;6
33;0;621679050;33;133;351;394;8.43;0.52;38.52;4.24;318;0;72.00;43
33;0;621679058;33;127;352;395;8.59;0.53;38.52;4.23;319;0;73.00;43
33;0;621679062;33;122;359;395;8.93;0.55;38.52;4.18;326;0;74.00;36
34;1;621679065;34;121;362;395;9.04;0.55;39.59;4.17;328;1;75.00;33
35;1;621679080;35;117;364;395;9.21;0.56;40.63;4.17;329;1;76.00;31
35;1;621679084;35;116;366;395;9.37;0.57;40.63;4.18;331;1;77.00;29
35;1;621679093;35;120;368;395;9.51;0.58;40.63;4.19;333;1;78.00;27
36;1;621679096;36;123;370;395;9.68;0.59;41.22;4.20;334;1;79.00;25
36;1;621679100;36;123;372;396;9.66;0.59;41.22;4.22;336;1;80.00;24
39;1;621679110;39;122;374;397;9.66;0.59;44.28;4.25;335;1;81.00;23
39;1;621679114;39;123;376;397;9.66;0.59;44.28;4.28;337;1;82.00;21
39;1;621679117;39;126;382;401;9.57;0.58;44.28;4.26;343;1;83.00;19
40;1;621679121;40;129;383;401;9.55;0.58;45.25;4.28;343;1;84.00;18
40;1;621679125;40;130;384;401;9.49;0.57;45.25;4.30;344;1;85.00;17
40;1;621679128;40;130;385;401;9.39;0.57;45.25;4.31;345;1;86.00;16
40;1;621679132;40;132;390;407;9.26;0.56;45.25;4.26;350;1;87.00;17
43;1;621679136;43;135;390;407;9.04;0.55;48.00;4.26;347;1;88.00;17
45;1;621679140;45;137;390;407;8.86;0.54;49.71;4.26;345;1;89.00;17
46;1;621679145;46;135;394;413;8.77;0.53;50.59;4.22;348;1;90.00;19
48;1;621679149;48;134;394;413;8.69;0.53;52.27;4.22;346;1;91.00;19
48;1;621679153;48;136;396;413;8.62;0.52;52.27;4.21;348;1;92.00;17
49;1;621679156;49;133;397;414;8.52;0.52;53.10;4.20;348;1;93.00;17
49;1;621679160;49;134;398;415;8.45;0.51;53.10;4.19;349;1;94.00;17
52;1;621679163;52;134;398;415;8.31;0.51;54.13;4.19;346;1;95.00;17
53;1;621679167;53;138;408;428;8.24;0.50;54.92;4.09;355;1;96.00;20
54;1;621679172;54;136;409;428;8.29;0.51;55.70;4.08;355;1;97.00;19
55;1;621679175;55;134;409;428;8.38;0.51;56.35;4.08;354;1;98.00;19
56;1;621679179;56;132;410;429;8.48;0.52;57.11;4.07;354;1;99.00;19
57;1;621679183;57;128;410;429;8.62;0.53;57.86;4.07;353;1;100.00;19
59;1;621679191;59;126;413;433;8.68;0.53;59.32;4.05;354;1;101.00;20
59;1;621679195;59;119;413;433;8.77;0.54;59.32;4.05;354;1;102.00;20
59;1;621679199;59;116;417;437;8.75;0.54;59.32;4.02;358;1;103.00;20
60;1;621679203;60;110;419;437;8.85;0.54;59.92;4.16;359;1;104.00;18
62;1;621679208;62;105;419;437;9.03;0.55;60.97;4.16;357;1;105.00;18
65;1;621679213;65;100;419;437;9.23;0.56;62.98;4.16;354;1;106.00;18
66;1;621679219;66;94;419;437;9.43;0.57;63.64;4.16;353;1;107.00;18
66;1;621679223;66;89;430;449;9.72;0.59;63.64;4.05;364;1;108.00;19
66;1;621679228;66;85;430;449;9.93;0.61;63.64;4.05;364;1;109.00;19
68;1;621679232;68;81;431;449;10.04;0.61;64.96;4.04;363;1;110.00;18
68;1;621679237;68;79;431;449;10.18;0.62;64.96;4.04;363;1;111.00;18
68;1;621679241;68;76;431;449;10.38;0.63;64.96;4.04;363;1;112.00;18
68;1;621679246;68;74;431;449;10.54;0.65;64.96;4.04;363;1;113.00;18
70;1;621679251;70;71;432;450;10.65;0.65;66.33;4.04;362;1;114.00;18
70;1;621679257;70;70;432;450;10.66;0.65;66.33;4.04;362;1;115.00;18
71;1;621679268;71;70;437;456;10.73;0.65;67.00;4.00;366;1;116.00;19
71;1;621679276;71;69;439;457;10.69;0.65;67.00;4.25;368;1;117.00;18
71;1;621679283;71;68;441;457;10.69;0.65;67.00;4.44;370;1;118.00;16
73;1;621679292;73;69;441;457;10.67;0.65;68.40;4.44;368;1;119.00;16
75;1;621679301;75;70;446;462;10.72;0.65;69.65;4.66;371;1;120.00;16
77;1;621679312;77;75;446;462;10.80;0.66;70.51;4.66;369;1;121.00;16
77;1;621679320;77;75;448;462;10.78;0.66;70.51;4.86;371;1;122.00;14
78;1;621679328;78;77;450;463;10.84;0.66;71.18;5.12;372;1;123.00;13
79;1;621679336;79;74;456;467;10.85;0.66;71.58;5.29;377;1;124.00;11
80;1;621679344;80;76;457;467;10.89;0.67;72.11;5.55;377;1;125.00;10
82;1;621679353;82;79;462;470;11.02;0.67;73.38;5.80;380;1;126.00;8
83;1;621679363;83;82;463;470;11.17;0.68;74.02;5.81;380;1;127.00;7
85;1;621679372;85;83;464;470;11.35;0.69;74.87;5.80;379;1;128.00;6
87;1;621679379;87;85;465;470;11.48;0.70;75.94;5.97;378;1;129.00;5
89;1;621679385;89;87;469;474;11.61;0.71;76.30;5.92;380;1;130.00;5
91;1;621679393;91;90;470;474;11.68;0.71;77.48;6.04;379;1;131.00;4
91;1;621679401;91;90;470;474;11.75;0.72;77.48;6.04;379;1;132.00;4
91;1;621679408;91;90;471;474;11.79;0.72;77.48;6.15;380;1;133.00;3
93;1;621679414;93;90;472;475;11.79;0.72;77.91;6.14;379;1;134.00;3
95;1;621679421;95;91;475;477;11.69;0.72;78.96;6.19;380;1;135.00;2
97;1;621679428;97;91;475;477;11.63;0.71;80.11;6.19;378;1;136.00;2
97;1;621679434;97;95;477;478;11.53;0.71;80.11;6.25;380;1;137.00;1
100;1;621679440;100;97;477;478;11.54;0.71;80.58;6.25;377;1;138.00;1
101;1;621679446;101;100;478;478;11.66;0.72;80.45;6.27;377;1;139.00;0
102;1;621679452;102;102;478;478;11.70;0.72;80.77;6.27;376;1;140.00;0
103;1;621679458;103;103;478;478;11.75;0.72;81.21;6.27;375;1;141.00;0
105;1;621679464;105;104;478;478;11.59;0.71;82.07;6.27;373;1;142.00;0
105;1;621679471;105;104;478;478;11.52;0.71;82.07;6.27;373;1;143.00;0
105;1;621679476;105;127;551;605;11.08;0.70;82.07;5.45;446;1;144.00;54
106;1;621679492;106;121;556;606;10.99;0.69;82.60;5.41;450;1;145.00;50
108;1;621679498;108;117;567;606;10.97;0.69;83.44;5.34;459;1;146.00;39
113;1;621679504;113;119;569;606;10.84;0.68;85.94;5.33;456;1;147.00;37
114;1;621679510;114;115;574;606;10.88;0.68;85.43;5.32;460;1;148.00;32
115;1;621679517;115;115;576;606;10.83;0.68;85.98;5.32;461;1;149.00;30
117;1;621679528;117;115;581;611;10.71;0.67;86.63;5.31;464;1;150.00;30
119;1;621679538;119;111;584;611;10.70;0.67;87.71;5.32;465;1;151.00;27
122;1;621679547;122;114;587;612;10.64;0.66;88.02;5.33;465;1;152.00;25
123;1;621679560;123;113;592;613;10.59;0.66;88.55;5.36;469;1;153.00;21
126;1;621679570;126;114;594;613;10.49;0.65;88.79;5.38;468;1;154.00;19
127;1;621679580;127;120;598;614;10.38;0.64;89.28;5.39;471;1;155.00;16
128;1;621679588;128;119;601;614;10.30;0.64;89.22;5.41;473;1;156.00;13
131;1;621679595;131;122;602;614;10.19;0.63;90.34;5.42;471;1;157.00;12
133;1;621679602;133;129;604;614;10.01;0.62;91.35;5.44;471;1;158.00;10
135;1;621679608;135;135;609;618;9.95;0.61;91.26;5.43;474;1;159.00;9
135;1;621679614;135;146;610;618;9.85;0.61;91.26;5.44;475;1;160.00;8
137;1;621679621;137;146;610;618;9.84;0.61;92.15;5.44;473;1;161.00;8
139;1;621679627;139;149;613;621;9.68;0.59;93.15;5.47;474;1;162.00;8
141;1;621679640;141;150;613;621;9.64;0.59;93.62;5.47;472;1;163.00;8
143;1;621679646;143;153;614;621;9.61;0.59;94.08;5.50;471;1;164.00;7
143;1;621679652;143;151;619;625;9.57;0.59;94.08;5.53;476;1;165.00;6
145;1;621679658;145;152;621;626;9.55;0.59;94.39;5.55;476;1;166.00;5
146;1;621679665;146;149;622;626;9.45;0.58;94.84;5.56;476;1;167.00;4
148;1;621679671;148;148;627;630;9.35;0.58;94.78;5.52;479;1;168.00;3
149;1;621679677;149;152;628;630;9.21;0.57;94.80;5.53;479;1;169.00;2
149;1;621679683;149;140;628;630;9.15;0.57;94.80;5.53;479;1;170.00;2
151;1;621679689;151;136;629;631;9.07;0.56;95.55;5.52;478;1;171.00;2
151;1;621679694;151;132;629;631;9.00;0.56;95.55;5.52;478;1;172.00;2
152;1;621679700;152;131;637;637;9.04;0.56;96.01;5.51;485;1;173.00;0
155;1;621679706;155;133;637;637;9.02;0.55;96.48;5.51;482;1;174.00;0
157;1;621679712;157;130;638;638;8.99;0.55;96.99;5.50;481;1;175.00;0
157;1;621679719;157;132;638;638;9.00;0.55;96.99;5.50;481;1;176.00;0
157;1;621679724;157;130;638;638;9.02;0.55;96.99;5.50;481;1;177.00;0
157;1;621679730;157;129;638;638;9.07;0.56;96.99;5.50;481;1;178.00;0
158;1;621679736;158;126;638;638;9.11;0.56;96.72;5.50;480;1;179.00;0
160;1;621679744;160;124;669;672;9.25;0.57;97.62;5.25;509;1;180.00;3
162;1;621679753;162;120;669;672;9.20;0.57;97.99;5.25;507;1;181.00;3
162;1;621679759;162;130;671;672;9.29;0.58;97.99;5.24;509;1;182.00;1
162;1;621679765;162;126;671;672;9.32;0.58;97.99;5.24;509;1;183.00;1
163;1;621679771;163;131;672;672;9.39;0.58;98.05;5.24;509;1;184.00;0
166;1;621679777;166;137;672;672;9.39;0.58;98.34;5.24;506;1;185.00;0
168;1;621679784;168;144;676;676;9.46;0.58;99.36;5.21;508;1;186.00;0
169;1;621679790;169;145;676;676;9.48;0.59;99.51;5.21;507;1;187.00;0
171;1;621679797;171;147;680;680;9.48;0.59;99.60;5.19;509;1;188.00;0
176;1;621679804;176;150;681;681;9.33;0.57;100.36;5.18;505;1;189.00;0
177;1;621679811;177;151;681;681;9.19;0.57;100.59;5.18;504;1;190.00;0
178;1;621679818;178;161;681;681;9.15;0.56;101.10;5.18;503;1;191.00;0
179;1;621679826;179;164;694;694;9.20;0.57;100.85;5.08;515;1;192.00;0
183;1;621679834;183;167;694;694;9.07;0.56;101.07;5.08;511;1;193.00;0
184;1;621679841;184;175;694;694;9.05;0.56;101.58;5.08;510;1;194.00;0
187;1;621679848;187;177;695;695;9.00;0.55;101.17;5.07;508;1;195.00;0
191;1;621679854;191;181;696;696;8.88;0.55;101.61;5.07;505;1;196.00;0
193;1;621679861;193;188;696;696;8.80;0.54;101.72;5.07;503;1;197.00;0
196;1;621679867;196;194;698;699;8.70;0.53;101.22;5.05;502;1;198.00;1
199;1;621679873;199;198;698;699;8.56;0.52;101.54;5.05;499;1;199.00;1
199;1;621679881;199;202;699;699;8.54;0.52;101.54;5.05;500;1;200.00;0
200;1;621679893;200;203;699;699;8.46;0.52;101.32;5.05;499;1;201.00;0
201;1;621679900;201;205;705;705;8.46;0.52;101.30;5.02;504;1;202.00;0
202;1;621679907;202;209;705;705;8.37;0.52;101.08;5.02;503;1;203.00;0
205;1;621679914;205;213;705;705;8.32;0.51;101.14;5.02;500;1;204.00;0
205;1;621679920;205;214;705;705;8.24;0.51;101.14;5.02;500;1;205.00;0
207;1;621679926;207;217;709;709;8.12;0.50;102.01;4.99;502;1;206.00;0
209;1;621679932;209;218;710;710;8.02;0.49;101.50;4.99;501;1;207.00;0
210;1;621679939;210;224;710;710;7.92;0.49;101.84;4.99;500;1;208.00;0
211;1;621679945;211;227;711;711;7.81;0.48;101.66;4.98;500;1;209.00;0
216;1;621679952;216;228;711;711;7.63;0.47;101.24;4.98;495;1;210.00;0
218;1;621679959;218;232;711;711;7.48;0.46;102.18;4.98;493;1;211.00;0
219;1;621679965;219;238;711;711;7.35;0.45;101.86;4.98;492;1;212.00;0
219;1;621679972;219;241;711;711;7.24;0.45;101.86;4.98;492;1;213.00;0
221;1;621679977;221;250;711;711;7.17;0.44;102.29;4.98;490;1;214.00;0
221;1;621679983;221;257;711;711;7.05;0.44;102.29;4.98;490;1;215.00;0
223;1;621679988;223;273;754;781;7.20;0.45;102.14;4.70;531;1;216.00;27
224;1;621679999;224;254;756;782;7.18;0.45;102.65;4.69;532;1;217.00;26
226;1;621680015;226;244;763;782;7.33;0.45;103.48;4.66;537;1;218.00;19
227;1;621680023;227;230;764;782;7.43;0.46;103.98;4.66;537;1;219.00;18
227;1;621680029;227;221;767;782;7.60;0.47;103.98;4.66;540;1;220.00;15
227;1;621680037;227;219;768;782;7.77;0.48;103.98;4.66;541;1;221.00;14
228;1;621680044;228;216;770;782;7.91;0.49;104.23;4.66;542;1;222.00;12
230;1;621680052;230;214;772;782;7.98;0.49;105.25;4.67;542;1;223.00;10
231;1;621680059;231;216;773;783;8.03;0.49;105.75;4.67;542;1;224.00;10
232;1;621680072;232;217;776;785;8.15;0.50;105.94;4.68;544;1;225.00;9
235;1;621680086;235;203;777;785;8.24;0.50;106.68;4.68;542;1;226.00;8
236;1;621680094;236;195;784;789;8.37;0.51;107.19;4.69;548;1;227.00;5
236;1;621680102;236;191;787;789;8.53;0.52;107.19;4.71;551;1;228.00;2
238;1;621680109;238;182;789;789;8.62;0.53;107.97;4.72;551;1;229.00;0
239;1;621680117;239;176;789;789;8.70;0.53;108.44;4.72;550;1;230.00;0
240;1;621680124;240;167;795;795;8.83;0.54;108.09;4.69;555;1;231.00;0
240;1;621680132;240;168;795;795;8.98;0.55;108.09;4.69;555;1;232.00;0
240;1;621680140;240;167;795;795;9.09;0.56;108.09;4.69;555;1;233.00;0
241;1;621680147;241;163;797;798;9.19;0.56;108.58;4.68;556;1;234.00;1
241;1;621680154;241;155;797;798;9.28;0.57;108.58;4.68;556;1;235.00;1
242;1;621680162;242;156;798;798;9.41;0.58;108.39;4.67;556;1;236.00;0
245;1;621680169;245;147;799;799;9.36;0.57;109.37;4.67;554;1;237.00;0
247;1;621680177;247;145;800;800;9.47;0.58;109.89;4.67;553;1;238.00;0
249;1;621680184;249;139;800;800;9.48;0.58;109.49;4.67;551;1;239.00;0
253;1;621680193;253;146;824;826;9.33;0.57;110.68;4.53;571;1;240.00;2
256;1;621680203;256;137;825;826;9.36;0.57;111.42;4.52;569;1;241.00;1
259;1;621680210;259;135;826;826;9.50;0.58;112.23;4.52;567;1;242.00;0
259;1;621680217;259;131;827;827;9.65;0.59;112.23;4.52;568;1;243.00;0
262;1;621680224;262;131;827;827;9.83;0.60;113.14;4.52;565;1;244.00;0
267;1;621680230;267;126;831;831;9.95;0.61;113.86;4.50;564;1;245.00;0
269;1;621680238;269;125;831;831;10.07;0.61;114.17;4.50;562;1;246.00;0
270;1;621680245;270;127;835;835;10.09;0.61;113.97;4.48;565;1;247.00;0
273;1;621680253;273;125;835;835;10.21;0.62;114.77;4.48;562;1;248.00;0
278;1;621680264;278;124;835;835;10.25;0.62;116.01;4.48;557;1;249.00;0
278;1;621680274;278;125;835;835;10.31;0.63;116.01;4.48;557;1;250.00;0
280;1;621680281;280;125;835;835;10.28;0.63;115.94;4.48;555;1;251.00;0
282;1;621680288;282;126;846;847;10.26;0.62;116.43;4.42;564;1;252.00;1
283;1;621680296;283;130;846;847;10.22;0.62;116.88;4.42;563;1;253.00;1
285;1;621680304;285;130;847;847;10.22;0.62;117.29;4.42;562;1;254.00;0
287;1;621680311;287;136;847;847;10.19;0.62;117.44;4.42;560;1;255.00;0
288;1;621680319;288;142;847;847;10.23;0.62;117.65;4.42;559;1;256.00;0
291;1;621680328;291;145;847;847;10.18;0.62;118.56;4.42;556;1;257.00;0
291;1;621680335;291;148;848;848;10.11;0.61;118.56;4.42;557;1;258.00;0
291;1;621680342;291;155;848;848;10.07;0.61;118.56;4.42;557;1;259.00;0
291;1;621680348;291;150;854;854;10.01;0.61;118.56;4.39;563;1;260.00;0
294;1;621680355;294;148;855;855;9.96;0.60;118.45;4.39;561;1;261.00;0
294;1;621680361;294;143;855;855;9.91;0.60;118.45;4.39;561;1;262.00;0
295;1;621680368;295;141;855;855;9.89;0.60;118.52;4.39;560;1;263.00;0
296;1;621680374;296;135;859;859;9.84;0.60;118.53;4.37;563;1;264.00;0
298;1;621680387;298;137;859;859;9.90;0.60;118.70;4.37;561;1;265.00;0
301;1;621680394;301;132;859;859;10.03;0.61;119.36;4.37;558;1;266.00;0
305;1;621680400;305;130;860;860;10.09;0.61;120.11;4.36;555;1;267.00;0
305;2;621680407;305;132;864;864;10.10;0.61;120.11;4.35;559;2;268.00;0
307;2;621680421;307;127;864;864;10.21;0.62;120.62;4.35;557;2;269.00;0
308;2;621680429;308;128;868;870;10.32;0.63;120.72;4.33;560;2;270.00;2
310;2;621680437;310;122;868;870;10.31;0.62;121.28;4.33;558;2;271.00;2
313;2;621680443;313;114;870;870;10.40;0.63;121.86;4.32;557;2;272.00;0
315;2;621680449;315;110;870;870;10.40;0.63;122.36;4.32;555;2;273.00;0
317;2;621680456;317;104;874;874;10.43;0.63;122.68;4.31;557;2;274.00;0
319;2;621680462;319;104;874;874;10.53;0.64;122.62;4.31;555;2;275.00;0
324;2;621680474;324;99;874;874;10.66;0.65;122.55;4.31;550;2;276.00;0
328;2;621680481;328;96;874;874;10.75;0.65;122.75;4.31;546;2;277.00;0
331;2;621680488;331;93;875;875;10.92;0.66;122.94;4.30;544;2;278.00;0
332;2;621680496;332;87;876;876;11.10;0.67;122.87;4.30;544;2;279.00;0
334;3;621680504;334;84;876;876;11.20;0.68;123.11;4.30;542;3;280.00;0
335;3;621680523;335;79;877;877;11.34;0.69;122.94;4.30;542;3;281.00;0
337;3;621680530;337;79;877;877;11.47;0.69;123.15;4.30;540;3;282.00;0
338;3;621680537;338;76;877;877;11.57;0.70;122.98;4.30;539;3;283.00;0
339;3;621680543;339;77;877;877;11.66;0.71;123.03;4.30;538;3;284.00;0
340;3;621680550;340;80;877;877;11.71;0.71;122.77;4.30;537;3;285.00;0
343;3;621680557;343;79;877;877;11.73;0.71;123.34;4.30;534;3;286.00;0
343;3;621680564;343;78;877;877;11.79;0.71;123.34;4.30;534;3;287.00;0
345;3;621680570;345;96;947;1004;11.47;0.71;123.86;3.98;602;3;288.00;57
346;3;621680587;346;88;951;1005;11.46;0.71;123.82;3.97;605;3;289.00;54
347;3;621680594;347;83;956;1005;11.53;0.71;123.87;3.96;609;3;290.00;49
347;3;621680606;347;84;959;1005;11.54;0.71;123.87;3.96;612;3;291.00;46
349;3;621680614;349;84;965;1005;11.56;0.71;124.79;3.96;616;3;292.00;40
350;3;621680622;350;84;968;1005;11.52;0.71;125.22;3.96;618;3;293.00;37
353;3;621680630;353;84;972;1005;11.50;0.71;126.04;3.97;619;3;294.00;33
353;3;621680639;353;82;975;1005;11.53;0.71;126.04;3.98;622;3;295.00;30
355;3;621680647;355;86;977;1006;11.48;0.71;125.71;3.98;622;3;296.00;29
357;3;621680656;357;88;980;1007;11.48;0.70;126.24;4.00;623;3;297.00;27
360;3;621680665;360;88;983;1007;11.51;0.70;125.99;4.02;623;3;298.00;24
360;3;621680673;360;93;984;1008;11.49;0.70;125.99;4.03;624;3;299.00;24
361;3;621680684;361;97;993;1014;11.38;0.70;125.87;4.07;632;3;300.00;21
365;3;621680699;365;96;994;1014;11.31;0.69;126.70;4.08;629;3;301.00;20
365;3;621680707;365;98;995;1014;11.26;0.69;126.70;4.09;630;3;302.00;19
366;3;621680715;366;104;1000;1018;11.26;0.69;126.59;4.12;634;3;303.00;18
368;3;621680724;368;112;1001;1018;11.24;0.69;127.12;4.13;633;3;304.00;17
370;3;621680732;370;118;1004;1018;11.19;0.69;127.28;4.16;634;3;305.00;14
370;3;621680740;370;123;1010;1021;11.10;0.68;127.28;4.20;640;3;306.00;11
371;3;621680748;371;124;1012;1021;11.07;0.68;127.57;4.21;641;3;307.00;9
373;3;621680756;373;129;1012;1021;11.04;0.68;127.77;4.21;639;3;308.00;9
374;3;621680764;374;135;1016;1025;10.97;0.68;127.74;4.20;642;3;309.00;9
378;4;621680773;378;143;1017;1026;10.94;0.67;128.44;4.19;639;4;310.00;9
382;4;621680794;382;146;1019;1026;10.87;0.67;129.77;4.21;637;4;311.00;7
384;4;621680803;384;155;1025;1030;10.76;0.66;129.96;4.20;641;4;312.00;5
389;4;621680816;389;154;1025;1030;10.56;0.65;131.68;4.20;636;4;313.00;5
391;4;621680824;391;161;1026;1030;10.31;0.63;132.28;4.23;635;4;314.00;4
394;4;621680832;394;167;1030;1032;10.08;0.62;132.57;4.25;636;4;315.00;2
395;4;621680845;395;173;1031;1032;9.89;0.61;132.96;4.27;636;4;316.00;1
396;4;621680859;396;181;1037;1038;9.76;0.60;132.94;4.25;641;4;317.00;1
399;4;621680868;399;184;1037;1038;9.56;0.59;133.42;4.25;638;4;318.00;1
401;4;621680875;401;180;1038;1039;9.43;0.58;133.96;4.25;637;4;319.00;1
405;4;621680884;405;183;1038;1039;9.28;0.57;134.45;4.25;633;4;320.00;1
406;4;621680892;406;187;1038;1039;9.19;0.57;134.47;4.25;632;4;321.00;1
408;4;621680899;408;186;1038;1039;9.09;0.56;134.99;4.25;630;4;322.00;1
410;4;621680907;410;194;1039;1039;9.01;0.55;134.75;4.26;629;4;323.00;0
413;4;621680915;413;194;1051;1051;9.01;0.55;135.49;4.21;638;4;324.00;0
415;4;621680924;415;193;1051;1051;9.02;0.55;135.58;4.21;636;4;325.00;0
417;4;621680932;417;193;1051;1051;9.02;0.55;135.55;4.21;634;4;326.00;0
419;4;621680942;419;193;1051;1051;9.07;0.56;135.71;4.21;632;4;327.00;0
419;4;621680953;419;196;1051;1051;9.13;0.56;135.71;4.21;632;4;328.00;0
421;4;621680963;421;196;1051;1051;9.25;0.57;136.05;4.21;630;4;329.00;0
421;4;621680973;421;200;1055;1055;9.30;0.57;136.05;4.20;634;4;330.00;0
425;4;621680981;425;206;1055;1055;9.28;0.57;137.34;4.20;630;4;331.00;0
427;4;621680988;427;207;1059;1059;9.23;0.57;137.46;4.19;632;4;332.00;0
429;4;621680995;429;210;1060;1060;9.17;0.56;137.77;4.18;631;4;333.00;0
430;4;621681002;430;207;1060;1060;9.10;0.56;137.89;4.18;630;4;334.00;0
437;4;621681009;437;213;1060;1060;8.89;0.55;138.76;4.18;623;4;335.00;0
438;4;621681016;438;215;1073;1073;8.75;0.54;139.21;4.13;635;4;336.00;0
441;4;621681024;441;217;1073;1073;8.68;0.53;140.26;4.13;632;4;337.00;0
447;4;621681030;447;222;1073;1073;8.62;0.53;141.61;4.13;626;4;338.00;0
450;4;621681037;450;231;1074;1074;8.47;0.52;142.80;4.13;624;4;339.00;0
454;4;621681043;454;218;1075;1075;8.35;0.52;142.84;4.13;621;4;340.00;0
458;4;621681051;458;212;1075;1075;8.26;0.51;143.61;4.13;617;4;341.00;0
461;4;621681057;461;208;1078;1078;8.19;0.51;143.82;4.11;617;4;342.00;0
467;4;621681064;467;210;1078;1078;8.22;0.51;144.45;4.11;611;4;343.00;0
470;4;621681070;470;210;1078;1078;8.19;0.50;145.22;4.11;608;4;344.00;0
472;4;621681077;472;210;1078;1078;8.19;0.50;145.40;4.11;606;4;345.00;0
476;4;621681084;476;206;1084;1084;8.25;0.51;145.98;4.10;608;4;346.00;0
482;4;621681092;482;200;1084;1084;8.19;0.50;147.41;4.10;602;4;347.00;0
482;4;621681099;482;199;1084;1084;8.22;0.51;147.41;4.10;602;4;348.00;0
483;4;621681106;483;201;1084;1084;8.19;0.51;147.83;4.10;601;4;349.00;0
486;4;621681112;486;203;1088;1088;8.10;0.50;148.02;4.09;602;4;350.00;0
493;4;621681119;493;203;1089;1089;7.99;0.49;148.24;4.08;596;4;351.00;0
496;4;621681126;496;209;1089;1089;7.81;0.48;148.68;4.08;593;4;352.00;0
497;4;621681133;497;216;1090;1090;7.68;0.47;148.55;4.08;593;4;353.00;0
498;4;621681146;498;222;1090;1090;7.56;0.46;148.77;4.08;592;4;354.00;0
503;4;621681152;503;225;1090;1090;7.43;0.46;148.72;4.08;587;4;355.00;0
507;4;621681159;507;228;1090;1090;7.24;0.44;149.06;4.08;583;4;356.00;0
512;4;621681165;512;232;1090;1090;7.09;0.43;148.99;4.08;578;4;357.00;0
513;4;621681172;513;237;1090;1090;6.94;0.43;149.34;4.08;577;4;358.00;0
517;4;621681177;517;243;1090;1090;6.73;0.41;149.54;4.08;573;4;359.00;0
518;4;621681185;518;258;1153;1215;7.17;0.45;149.46;3.86;635;4;360.00;62
518;4;621681201;518;260;1161;1216;7.07;0.44;149.46;3.84;643;4;361.00;55
520;4;621681208;520;260;1175;1216;7.09;0.44;149.41;3.81;655;4;362.00;41
522;4;621681215;522;259;1179;1216;6.95;0.44;149.40;3.81;657;4;363.00;37
524;4;621681221;524;265;1184;1216;6.93;0.43;149.30;3.81;660;4;364.00;32
525;4;621681228;525;267;1190;1216;6.88;0.43;149.07;3.82;665;4;365.00;26
526;4;621681235;526;270;1194;1216;6.84;0.43;149.21;3.83;668;4;366.00;22
527;4;621681241;527;278;1200;1216;6.78;0.42;149.17;3.84;673;4;367.00;16
528;4;621681249;528;280;1203;1217;6.66;0.41;149.31;3.85;675;4;368.00;14
531;4;621681268;531;288;1206;1218;6.55;0.41;149.35;3.86;675;4;369.00;12
533;4;621681278;533;294;1208;1218;6.37;0.39;149.30;3.87;675;4;370.00;10
536;4;621681296;536;285;1215;1222;6.33;0.39;149.26;3.88;679;4;371.00;7
537;4;621681309;537;282;1217;1222;6.30;0.39;149.30;3.89;680;4;372.00;5
539;4;621681320;539;284;1220;1222;6.30;0.39;148.95;3.91;681;4;373.00;2
540;4;621681331;540;283;1220;1222;6.34;0.39;148.83;3.91;680;4;374.00;2
540;4;621681355;540;276;1227;1228;6.39;0.39;148.83;3.90;687;4;375.00;1
540;4;621681369;540;281;1227;1228;6.49;0.40;148.83;3.90;687;4;376.00;1
542;4;621681379;542;284;1228;1228;6.55;0.40;149.23;3.91;686;4;377.00;0
542;4;621681400;542;278;1229;1231;6.70;0.41;149.23;3.91;687;4;378.00;2
543;4;621681409;543;274;1229;1231;6.78;0.42;148.99;3.91;686;4;379.00;2
544;4;621681418;544;273;1230;1231;6.83;0.42;148.79;3.91;686;4;380.00;1
545;4;621681427;545;274;1231;1232;6.92;0.42;148.99;3.90;686;4;381.00;1
547;5;621681437;547;276;1233;1233;6.99;0.43;149.39;3.90;686;5;382.00;0
549;5;621681452;549;274;1233;1233;6.98;0.43;148.93;3.90;684;5;383.00;0
551;5;621681462;551;274;1245;1246;7.07;0.43;148.86;3.86;694;5;384.00;1
551;5;621681479;551;270;1245;1246;7.11;0.43;148.86;3.86;694;5;385.00;1
555;5;621681488;555;267;1245;1246;7.14;0.44;149.14;3.86;690;5;386.00;1
556;5;621681503;556;255;1246;1247;7.26;0.44;148.92;3.86;690;5;387.00;1
559;5;621681517;559;250;1247;1247;7.34;0.45;149.35;3.86;688;5;388.00;0
561;5;621681527;561;243;1250;1251;7.42;0.45;149.55;3.85;689;5;389.00;1
562;5;621681537;562;242;1250;1251;7.42;0.45;149.65;3.85;688;5;390.00;1
565;5;621681546;565;241;1254;1255;7.43;0.45;149.85;3.85;689;5;391.00;1
568;5;621681555;568;245;1255;1255;7.37;0.45;150.20;3.85;687;5;392.00;0
568;5;621681564;568;244;1255;1255;7.45;0.45;150.20;3.85;687;5;393.00;0
571;5;621681573;571;250;1255;1255;7.50;0.46;150.71;3.85;684;5;394.00;0
573;5;621681583;573;249;1255;1255;7.57;0.46;150.68;3.85;682;5;395.00;0
575;5;621681592;575;237;1266;1267;7.71;0.47;150.40;3.81;691;5;396.00;1
576;5;621681602;576;227;1266;1267;7.88;0.48;150.64;3.81;690;5;397.00;1
578;5;621681611;578;222;1267;1267;8.02;0.49;151.25;3.81;689;5;398.00;0
580;5;621681620;580;208;1267;1267;8.20;0.50;151.54;3.81;687;5;399.00;0
582;5;621681630;582;204;1267;1267;8.36;0.51;152.23;3.81;685;5;400.00;0
584;5;621681644;584;204;1267;1267;8.48;0.52;152.48;3.81;683;5;401.00;0
586;5;621681654;586;198;1268;1268;8.63;0.53;152.88;3.81;682;5;402.00;0
586;5;621681663;586;193;1268;1268;8.81;0.54;152.88;3.81;682;5;403.00;0
588;5;621681672;588;188;1274;1274;8.88;0.54;152.97;3.80;686;5;404.00;0
590;5;621681701;590;190;1276;1276;8.96;0.55;153.42;3.79;686;5;405.00;0
591;5;621681711;591;189;1276;1276;9.04;0.55;153.60;3.79;685;5;406.00;0
593;5;621681720;593;188;1276;1276;9.10;0.56;153.84;3.79;683;5;407.00;0
594;5;621681729;594;182;1280;1280;9.10;0.56;153.89;3.78;686;5;408.00;0
595;5;621681739;595;176;1280;1280;9.13;0.56;153.83;3.78;685;5;409.00;0
597;5;621681748;597;173;1280;1280;9.27;0.57;153.97;3.78;683;5;410.00;0
599;5;621681758;599;173;1281;1281;9.37;0.57;154.75;3.78;682;5;411.00;0
602;5;621681767;602;172;1285;1285;9.43;0.57;154.95;3.77;683;5;412.00;0
606;5;621681776;606;166;1285;1285;9.52;0.58;155.78;3.77;679;5;413.00;0
608;5;621681786;608;164;1287;1288;9.65;0.59;156.43;3.76;679;5;414.00;1
609;5;621681795;609;162;1287;1288;9.74;0.59;156.26;3.76;678;5;415.00;1
613;5;621681805;613;159;1288;1288;9.80;0.60;156.38;3.76;675;5;416.00;0
616;5;621681813;616;159;1288;1288;9.82;0.60;157.53;3.76;672;5;417.00;0
618;5;621681823;618;161;1292;1292;9.87;0.60;157.91;3.75;674;5;418.00;0
621;5;621681832;621;160;1292;1292;9.87;0.60;158.25;3.75;671;5;419.00;0
623;5;621681844;623;162;1292;1292;9.88;0.60;158.63;3.75;669;5;420.00;0
626;5;621681853;626;166;1292;1292;9.91;0.60;159.38;3.75;666;5;421.00;0
630;5;621681862;630;171;1293;1293;9.86;0.60;160.41;3.75;663;5;422.00;0
633;5;621681872;633;174;1294;1294;9.89;0.60;161.06;3.75;661;5;423.00;0
634;5;621681881;634;176;1294;1294;9.89;0.60;161.12;3.75;660;5;424.00;0
639;5;621681889;639;173;1295;1295;9.87;0.60;162.26;3.74;656;5;425.00;0
640;5;621681899;640;171;1295;1295;9.91;0.60;162.60;3.74;655;5;426.00;0
642;5;621681907;642;171;1295;1295;9.89;0.60;163.00;3.74;653;5;427.00;0
644;5;621681916;644;173;1295;1295;9.89;0.60;162.97;3.74;651;5;428.00;0
649;5;621681925;649;175;1295;1295;9.90;0.60;163.42;3.74;646;5;429.00;0
652;5;621681941;652;169;1295;1295;9.94;0.61;163.32;3.74;643;5;430.00;0
654;5;621681950;654;163;1295;1295;9.99;0.61;163.69;3.74;641;5;431.00;0
657;5;621681960;657;188;1375;1422;9.55;0.59;163.97;3.53;718;5;432.00;47
658;5;621681980;658;171;1376;1423;9.66;0.60;164.04;3.53;718;5;433.00;47
659;5;621681990;659;161;1381;1423;9.82;0.61;164.36;3.52;722;5;434.00;42
663;5;621681998;663;153;1381;1423;9.84;0.61;164.71;3.52;718;5;435.00;42
670;5;621682007;670;147;1387;1423;9.88;0.61;165.84;3.52;717;5;436.00;36
671;6;621682018;671;147;1388;1423;9.92;0.61;165.99;3.52;717;6;437.00;35
673;6;621682038;673;148;1390;1423;9.99;0.62;166.41;3.53;717;6;438.00;33
675;6;621682048;675;153;1393;1423;10.11;0.62;166.54;3.53;718;6;439.00;30
677;6;621682056;677;149;1396;1424;10.19;0.63;167.10;3.54;719;6;440.00;28
680;6;621682066;680;146;1399;1425;10.19;0.63;166.89;3.56;719;6;441.00;26
684;6;621682075;684;138;1403;1425;10.22;0.63;167.44;3.57;719;6;442.00;22
686;6;621682085;686;137;1407;1426;10.16;0.62;167.47;3.60;721;6;443.00;19
688;6;621682094;688;130;1408;1426;10.12;0.62;168.05;3.60;720;6;444.00;18
688;6;621682103;688;133;1412;1426;10.13;0.62;168.05;3.62;724;6;445.00;14
694;6;621682112;694;128;1413;1426;10.04;0.62;168.63;3.63;719;6;446.00;13
699;6;621682121;699;125;1417;1430;10.02;0.61;169.73;3.63;718;6;447.00;13
702;6;621682131;702;128;1417;1430;10.06;0.62;169.79;3.63;715;6;448.00;13
706;6;621682141;706;123;1419;1430;10.04;0.61;170.31;3.65;713;6;449.00;11
711;6;621682152;711;119;1422;1436;10.07;0.61;170.82;3.64;711;6;450.00;14
714;6;621682162;714;118;1424;1436;10.04;0.61;171.39;3.67;710;6;451.00;12
717;6;621682172;717;119;1425;1436;9.99;0.61;171.28;3.66;708;6;452.00;11
720;6;621682181;720;118;1430;1440;9.95;0.60;171.53;3.68;710;6;453.00;10
723;6;621682192;723;122;1431;1441;9.94;0.60;171.50;3.68;708;6;454.00;10
726;6;621682201;726;125;1433;1441;9.94;0.60;171.43;3.70;707;6;455.00;8
727;6;621682211;727;126;1436;1445;9.94;0.60;171.81;3.69;709;6;456.00;9
729;6;621682220;729;128;1438;1445;9.98;0.61;171.89;3.70;709;6;457.00;7
731;6;621682229;731;128;1438;1445;9.91;0.60;171.85;3.70;707;6;458.00;7
735;6;621682239;735;130;1439;1446;9.94;0.60;172.29;3.70;704;6;459.00;7
738;6;621682257;738;136;1439;1446;9.93;0.60;172.32;3.70;701;6;460.00;7
740;6;621682267;740;138;1445;1452;9.97;0.60;172.52;3.72;705;6;461.00;7
742;6;621682277;742;138;1445;1452;9.93;0.60;172.94;3.72;703;6;462.00;7
744;6;621682287;744;141;1447;1453;9.87;0.60;172.67;3.75;703;6;463.00;6
746;6;621682297;746;141;1447;1453;9.86;0.60;172.96;3.75;701;6;464.00;6
748;6;621682306;748;148;1447;1453;9.86;0.60;173.36;3.75;699;6;465.00;6
750;6;621682317;750;153;1448;1453;9.80;0.60;173.56;3.75;698;6;466.00;5
753;6;621682325;753;155;1448;1453;9.79;0.60;173.73;3.75;695;6;467.00;5
755;6;621682334;755;160;1457;1465;9.94;0.61;173.75;3.73;702;6;468.00;8
756;6;621682344;756;167;1457;1465;10.00;0.61;173.66;3.73;701;6;469.00;8
758;6;621682353;758;170;1461;1465;10.00;0.61;173.88;3.75;703;6;470.00;4
760;6;621682362;760;175;1461;1465;10.02;0.61;173.75;3.75;701;6;471.00;4
760;6;621682370;760;177;1461;1465;10.08;0.62;173.75;3.75;701;6;472.00;4
763;6;621682378;763;183;1463;1465;10.03;0.61;173.84;3.77;700;6;473.00;2
765;6;621682387;765;189;1466;1469;9.94;0.61;173.68;3.76;701;6;474.00;3
767;6;621682396;767;191;1468;1469;9.89;0.60;173.53;3.77;701;6;475.00;1
770;6;621682411;770;189;1472;1473;9.83;0.60;173.49;3.76;702;6;476.00;1
774;6;621682420;774;193;1473;1474;9.84;0.60;173.87;3.76;699;6;477.00;1
778;6;621682429;778;200;1474;1474;9.76;0.60;173.58;3.76;696;6;478.00;0
780;6;621682438;780;205;1474;1474;9.66;0.59;173.56;3.76;694;6;479.00;0
783;6;621682447;783;209;1495;1500;9.55;0.59;173.57;3.71;712;6;480.00;5
786;6;621682457;786;210;1496;1500;9.54;0.58;173.67;3.71;710;6;481.00;4
786;6;621682469;786;211;1499;1500;9.57;0.59;173.67;3.71;713;6;482.00;1
786;6;621682479;786;219;1501;1501;9.50;0.58;173.67;3.70;715;6;483.00;0
787;6;621682488;787;222;1502;1502;9.42;0.58;173.64;3.70;715;6;484.00;0
787;6;621682497;787;228;1502;1502;9.34;0.57;173.64;3.70;715;6;485.00;0
788;6;621682506;788;232;1504;1505;9.27;0.57;173.58;3.70;716;6;486.00;1
791;6;621682515;791;236;1504;1505;9.11;0.56;173.59;3.70;713;6;487.00;1
792;6;621682524;792;240;1505;1505;8.93;0.55;173.44;3.70;713;6;488.00;0
792;6;621682532;792;245;1505;1505;8.82;0.54;173.44;3.70;713;6;489.00;0
796;6;621682541;796;249;1511;1511;8.71;0.53;173.35;3.68;715;6;490.00;0
798;6;621682550;798;252;1511;1511;8.59;0.52;173.18;3.68;713;6;491.00;0
799;6;621682558;799;253;1511;1511;8.51;0.52;173.04;3.68;712;6;492.00;0
801;6;621682567;801;260;1511;1511;8.44;0.52;173.08;3.68;710;6;493.00;0
802;6;621682575;802;260;1515;1515;8.41;0.51;173.12;3.68;713;6;494.00;0
803;6;621682585;803;267;1517;1517;8.41;0.51;173.04;3.67;714;6;495.00;0
805;6;621682593;805;267;1517;1517;8.43;0.52;172.89;3.67;712;6;496.00;0
806;6;621682601;806;271;1518;1518;8.46;0.52;173.02;3.67;712;6;497.00;0
808;6;621682610;808;272;1518;1518;8.49;0.52;173.13;3.67;710;6;498.00;0
809;6;621682618;809;270;1518;1518;8.47;0.52;173.45;3.67;709;6;499.00;0
811;6;621682626;811;271;1518;1518;8.43;0.52;173.16;3.67;707;6;500.00;0
816;6;621682638;816;271;1518;1518;8.40;0.51;172.87;3.67;702;6;501.00;0
818;6;621682646;818;272;1518;1518;8.31;0.51;172.65;3.67;700;6;502.00;0
821;6;621682653;821;274;1518;1518;8.19;0.50;172.71;3.67;697;6;503.00;0
824;6;621682660;824;288;1564;1588;8.17;0.50;172.99;3.56;740;6;504.00;24
828;6;621682673;828;287;1567;1589;8.00;0.49;172.92;3.56;739;6;505.00;22
831;6;621682681;831;283;1573;1589;7.84;0.48;173.23;3.55;742;6;506.00;16
834;6;621682688;834;286;1578;1589;7.71;0.47;172.85;3.55;744;6;507.00;11
837;6;621682695;837;287;1580;1589;7.60;0.47;173.20;3.55;743;6;508.00;9
843;6;621682702;843;290;1582;1589;7.39;0.45;174.07;3.55;739;6;509.00;7
844;6;621682711;844;278;1583;1589;7.37;0.45;174.39;3.55;739;6;510.00;6
846;6;621682719;846;275;1584;1589;7.34;0.45;174.50;3.56;738;6;511.00;5
849;6;621682732;849;270;1586;1590;7.38;0.45;174.86;3.56;737;6;512.00;4
852;6;621682739;852;271;1586;1591;7.38;0.45;175.16;3.56;734;6;513.00;5
854;6;621682747;854;269;1588;1591;7.32;0.45;175.78;3.57;734;6;514.00;3
856;6;621682755;856;269;1593;1595;7.33;0.45;175.79;3.56;737;6;515.00;2
857;6;621682763;857;278;1593;1595;7.33;0.45;176.06;3.56;736;6;516.00;2
858;6;621682771;858;275;1594;1595;7.37;0.45;176.29;3.57;736;6;517.00;1
859;6;621682779;859;271;1594;1595;7.36;0.45;176.60;3.57;735;6;518.00;1
862;6;621682787;862;270;1600;1601;7.39;0.45;177.04;3.56;738;6;519.00;1
864;6;621682797;864;270;1600;1601;7.34;0.45;177.63;3.56;736;6;520.00;1
866;6;621682805;866;265;1601;1601;7.29;0.45;177.87;3.56;735;6;521.00;0
868;6;621682813;868;264;1603;1604;7.29;0.44;178.08;3.56;735;6;522.00;1
871;6;621682821;871;256;1604;1604;7.24;0.44;178.65;3.56;733;6;523.00;0
871;6;621682829;871;251;1604;1604;7.26;0.44;178.65;3.56;733;6;524.00;0
874;6;621682837;874;246;1605;1605;7.26;0.44;178.81;3.56;731;6;525.00;0
875;6;621682847;875;250;1606;1606;7.31;0.45;178.82;3.55;731;6;526.00;0
879;6;621682856;879;250;1606;1606;7.27;0.44;178.71;3.55;727;6;527.00;0
880;6;621682864;880;242;1618;1619;7.43;0.46;178.62;3.53;738;6;528.00;1
883;6;621682874;883;240;1618;1619;7.45;0.46;178.87;3.53;735;6;529.00;1
887;6;621682883;887;240;1619;1619;7.55;0.46;178.52;3.53;732;6;530.00;0
890;6;621682891;890;242;1620;1620;7.59;0.47;178.83;3.52;730;6;531.00;0
893;6;621682899;893;240;1620;1620;7.63;0.47;178.97;3.52;727;6;532.00;0
898;6;621682908;898;238;1624;1624;7.64;0.47;179.77;3.52;726;6;533.00;0
900;6;621682917;900;239;1624;1624;7.68;0.47;179.75;3.52;724;6;534.00;0
904;6;621682926;904;236;1628;1628;7.69;0.47;180.14;3.51;724;6;535.00;0
911;6;621682941;911;240;1628;1628;7.63;0.47;180.19;3.51;717;6;536.00;0
915;6;621682949;915;241;1628;1628;7.64;0.47;180.16;3.51;713;6;537.00;0
916;6;621682957;916;240;1628;1628;7.67;0.47;180.40;3.51;712;6;538.00;0
917;6;621682966;917;242;1628;1628;7.69;0.47;180.65;3.51;711;6;539.00;0
919;6;621682976;919;244;1658;1662;7.89;0.49;180.96;3.45;739;6;540.00;4
925;6;621682987;925;241;1658;1662;7.94;0.49;181.51;3.45;733;6;541.00;4
925;6;621682996;925;235;1661;1662;8.05;0.49;181.51;3.45;736;6;542.00;1
929;6;621683005;929;237;1661;1662;8.10;0.50;181.54;3.45;732;6;543.00;1
931;6;621683014;931;236;1662;1662;8.11;0.50;181.58;3.45;731;6;544.00;0
933;6;621683023;933;236;1662;1662;8.08;0.49;181.58;3.45;729;6;545.00;0
935;6;621683031;935;235;1663;1663;8.04;0.49;181.70;3.44;728;6;546.00;0
939;6;621683040;939;236;1663;1663;7.99;0.49;181.67;3.44;724;6;547.00;0
942;6;621683049;942;238;1669;1669;7.99;0.49;181.53;3.44;727;6;548.00;0
944;6;621683058;944;242;1670;1670;8.03;0.49;181.68;3.43;726;6;549.00;0
948;6;621683067;948;251;1670;1670;8.03;0.49;181.76;3.43;722;6;550.00;0
950;6;621683075;950;254;1670;1670;8.03;0.49;182.06;3.43;720;6;551.00;0
953;6;621683084;953;258;1674;1674;7.96;0.49;182.45;3.43;721;6;552.00;0
953;6;621683093;953;261;1674;1674;7.91;0.48;182.45;3.43;721;6;553.00;0
956;6;621683102;956;259;1674;1674;7.77;0.47;182.73;3.43;718;6;554.00;0
957;6;621683115;957;259;1675;1675;7.65;0.47;182.92;3.42;718;6;555.00;0
959;6;621683124;959;265;1679;1679;7.55;0.46;182.94;3.42;720;6;556.00;0
959;6;621683133;959;255;1679;1679;7.46;0.46;182.94;3.42;720;6;557.00;0
960;6;621683141;960;242;1681;1682;7.45;0.45;182.96;3.41;721;6;558.00;1
962;6;621683156;962;236;1681;1682;7.37;0.45;183.20;3.41;719;6;559.00;1
962;6;621683165;962;234;1682;1682;7.36;0.45;183.20;3.41;720;6;560.00;0
965;6;621683174;965;229;1682;1682;7.36;0.45;183.22;3.41;717;6;561.00;0
967;6;621683183;967;224;1686;1686;7.48;0.46;183.26;3.41;719;6;562.00;0
972;6;621683192;972;218;1686;1686;7.52;0.46;183.72;3.41;714;6;563.00;0
973;6;621683201;973;221;1686;1686;7.61;0.47;183.74;3.41;713;6;564.00;0
978;6;621683210;978;222;1686;1686;7.67;0.47;183.97;3.41;708;6;565.00;0
978;6;621683219;978;207;1687;1687;7.84;0.48;183.97;3.41;709;6;566.00;0
982;6;621683228;982;199;1688;1688;7.93;0.48;184.57;3.40;706;6;567.00;0
984;6;621683237;984;198;1688;1688;8.07;0.49;184.69;3.40;704;6;568.00;0
988;6;621683246;988;188;1689;1689;8.25;0.50;184.75;3.40;701;6;569.00;0
990;6;621683257;990;191;1689;1689;8.40;0.51;185.11;3.40;699;6;570.00;0
992;6;621683273;992;186;1689;1689;8.49;0.52;185.18;3.40;697;6;571.00;0
998;6;621683288;998;186;1689;1689;8.51;0.52;185.79;3.40;691;6;572.00;0
999;6;621683305;999;184;1689;1689;8.62;0.52;185.88;3.40;690;6;573.00;0
1002;6;621683321;1002;177;1689;1689;8.58;0.52;186.28;3.40;687;6;574.00;0
1005;6;621683335;1005;184;1689;1689;8.61;0.52;186.91;3.40;684;6;575.00;0
1008;6;621683349;1008;221;1769;1816;8.59;0.53;187.41;3.25;761;6;576.00;47
1009;6;621683378;1009;209;1772;1817;8.60;0.53;187.44;3.25;763;6;577.00;45
1010;6;621683391;1010;196;1780;1817;8.77;0.54;187.71;3.24;770;6;578.00;37
1013;6;621683402;1013;189;1781;1817;8.80;0.54;188.18;3.24;768;6;579.00;36
1016;6;621683413;1016;184;1786;1817;8.86;0.55;188.66;3.24;770;6;580.00;31
1017;6;621683424;1017;184;1788;1817;8.92;0.55;188.91;3.24;771;6;581.00;29
1024;6;621683434;1024;181;1791;1817;8.91;0.55;189.47;3.25;767;6;582.00;26
1026;6;621683446;1026;189;1794;1817;8.96;0.55;189.90;3.26;768;6;583.00;23
1028;6;621683456;1028;192;1797;1818;8.93;0.55;189.88;3.26;769;6;584.00;21
1030;6;621683468;1030;194;1802;1820;8.95;0.55;189.93;3.27;772;6;585.00;18
1031;6;621683479;1031;191;1804;1820;8.92;0.55;190.00;3.28;773;6;586.00;16
1034;6;621683489;1034;193;1808;1821;8.88;0.54;190.30;3.29;774;6;587.00;13
1036;7;621683500;1036;195;1811;1821;8.87;0.54;190.64;3.31;775;7;588.00;10
1036;7;621683530;1036;209;1812;1821;8.84;0.54;190.64;3.31;776;7;589.00;9
1038;7;621683540;1038;209;1816;1821;8.80;0.54;190.68;3.33;778;7;590.00;5
1040;7;621683550;1040;212;1819;1825;8.73;0.54;190.67;3.33;779;7;591.00;6
1042;7;621683560;1042;218;1820;1825;8.66;0.53;190.68;3.33;778;7;592.00;5
1044;7;621683571;1044;224;1820;1825;8.71;0.53;190.73;3.33;776;7;593.00;5
1044;7;621683581;1044;225;1824;1828;8.75;0.53;190.73;3.34;780;7;594.00;4
1044;7;621683592;1044;227;1825;1828;8.80;0.54;190.73;3.35;781;7;595.00;3
1047;7;621683609;1047;228;1825;1828;8.86;0.54;190.63;3.35;778;7;596.00;3
1049;7;621683619;1049;229;1830;1832;8.88;0.54;190.80;3.35;781;7;597.00;2
1049;7;621683629;1049;232;1831;1833;9.02;0.55;190.80;3.35;782;7;598.00;2
1050;7;621683640;1050;232;1833;1833;9.13;0.56;190.84;3.36;783;7;599.00;0
1050;7;621683653;1050;231;1845;1859;9.14;0.56;190.84;3.34;795;7;600.00;14
1051;7;621683672;1051;218;1845;1859;9.27;0.57;190.92;3.34;794;7;601.00;14
1052;7;621683683;1052;216;1846;1859;9.36;0.57;191.03;3.34;794;7;602.00;13
1054;7;621683693;1054;216;1847;1860;9.49;0.58;191.38;3.34;793;7;603.00;13
1056;7;621683703;1056;214;1848;1860;9.57;0.58;191.30;3.34;792;7;604.00;12
1060;7;621683714;1060;206;1852;1866;9.62;0.59;191.26;3.33;792;7;605.00;14
1063;7;621683724;1063;207;1854;1866;9.75;0.59;191.20;3.33;791;7;606.00;12
1065;7;621683734;1065;199;1855;1867;9.81;0.60;191.48;3.33;790;7;607.00;12
1067;7;621683745;1067;195;1856;1867;9.85;0.60;191.58;3.33;789;7;608.00;11
1071;7;621683755;1071;188;1857;1867;9.84;0.60;192.70;3.34;786;7;609.00;10
1077;7;621683765;1077;181;1857;1867;9.77;0.59;193.26;3.34;780;7;610.00;10
1083;7;621683782;1083;181;1857;1867;9.69;0.59;194.15;3.34;774;7;611.00;10
1085;7;621683794;1085;180;1867;1879;9.66;0.59;194.66;3.32;782;7;612.00;12
1090;7;621683806;1090;172;1867;1879;9.54;0.58;195.17;3.32;777;7;613.00;12
1094;7;621683817;1094;165;1869;1879;9.46;0.57;195.56;3.33;775;7;614.00;10
1099;7;621683827;1099;164;1870;1879;9.43;0.57;196.10;3.33;771;7;615.00;9
1102;7;621683837;1102;162;1871;1879;9.43;0.57;196.63;3.33;769;7;616.00;8
1107;7;621683847;1107;162;1871;1879;9.41;0.57;197.04;3.33;764;7;617.00;8
1109;7;621683856;1109;161;1875;1883;9.38;0.57;197.34;3.34;766;7;618.00;8
1112;7;621683866;1112;156;1875;1883;9.36;0.57;197.46;3.34;763;7;619.00;8
1113;7;621683875;1113;157;1880;1887;9.34;0.56;197.39;3.34;767;7;620.00;7
1113;7;621683885;1113;158;1881;1888;9.38;0.57;197.39;3.34;768;7;621.00;7
1115;7;621683894;1115;152;1881;1888;9.38;0.57;197.51;3.34;766;7;622.00;7
1116;7;621683904;1116;153;1881;1888;9.40;0.57;197.81;3.34;765;7;623.00;7
1118;7;621683913;1118;155;1891;1901;9.40;0.57;197.63;3.34;773;7;624.00;10
1122;7;621683924;1122;154;1891;1901;9.35;0.57;197.86;3.34;769;7;625.00;10
1125;7;621683946;1125;156;1891;1901;9.32;0.56;198.39;3.34;766;7;626.00;10
1126;7;621683956;1126;160;1893;1902;9.24;0.56;198.51;3.35;767;7;627.00;9
1129;7;621683965;1129;160;1893;1903;9.18;0.56;199.05;3.35;764;7;628.00;10
1130;7;621683975;1130;165;1895;1903;9.09;0.55;199.25;3.37;765;7;629.00;8
1131;7;621683986;1131;163;1899;1909;9.11;0.55;199.36;3.36;768;7;630.00;10
1135;7;621683995;1135;170;1901;1909;9.07;0.55;199.48;3.36;766;7;631.00;8
1138;7;621684005;1138;174;1902;1909;9.09;0.55;199.87;3.36;764;7;632.00;7
1142;7;621684014;1142;175;1903;1909;9.06;0.55;199.83;3.38;761;7;633.00;6
1147;7;621684023;1147;178;1908;1915;9.11;0.55;199.96;3.37;761;7;634.00;7
1150;7;621684034;1150;181;1908;1915;9.03;0.55;200.29;3.37;758;7;635.00;7
1153;7;621684043;1153;184;1908;1915;9.01;0.55;200.62;3.37;755;7;636.00;7
1153;7;621684052;1153;194;1908;1915;8.97;0.54;200.62;3.37;755;7;637.00;7
1154;7;621684061;1154;197;1911;1919;8.99;0.55;200.56;3.37;757;7;638.00;8
1155;7;621684070;1155;203;1914;1920;8.96;0.55;200.50;3.39;759;7;639.00;6
1156;7;621684079;1156;209;1915;1920;8.89;0.54;200.88;3.40;759;7;640.00;5
1162;7;621684088;1162;215;1918;1921;8.78;0.54;200.64;3.41;756;7;641.00;3
1162;7;621684098;1162;222;1918;1921;8.70;0.53;200.64;3.41;756;7;642.00;3
1163;7;621684107;1163;226;1918;1921;8.62;0.53;200.54;3.41;755;7;643.00;3
1165;7;621684116;1165;232;1919;1921;8.57;0.52;200.50;3.42;754;7;644.00;2
1167;7;621684124;1167;238;1919;1921;8.49;0.52;200.36;3.42;752;7;645.00;2
1169;7;621684134;1169;243;1920;1921;8.39;0.51;200.30;3.42;751;7;646.00;1
1170;7;621684142;1170;249;1921;1921;8.30;0.51;200.31;3.43;751;7;647.00;0
1171;7;621684150;1171;263;1960;1991;8.43;0.52;200.20;3.36;789;7;648.00;31
1171;7;621684165;1171;264;1963;1992;8.33;0.51;200.20;3.36;792;7;649.00;29
1172;7;621684173;1172;259;1972;1992;8.35;0.51;200.13;3.35;800;7;650.00;20
1176;7;621684182;1176;260;1976;1992;8.24;0.50;199.81;3.35;800;7;651.00;16
1176;7;621684191;1176;265;1979;1992;8.19;0.50;199.81;3.35;803;7;652.00;13
1178;7;621684200;1178;263;1981;1992;8.16;0.50;199.71;3.35;803;7;653.00;11
1179;7;621684209;1179;270;1984;1992;8.11;0.50;199.57;3.35;805;7;654.00;8
1180;7;621684218;1180;279;1987;1992;8.00;0.49;199.53;3.36;807;7;655.00;5
1182;7;621684226;1182;284;1989;1993;7.88;0.48;199.37;3.37;807;7;656.00;4
1185;7;621684235;1185;289;1990;1994;7.81;0.48;199.23;3.37;805;7;657.00;4
1187;7;621684244;1187;292;1992;1994;7.62;0.47;198.98;3.37;805;7;658.00;2
1189;7;621684253;1189;289;1997;1998;7.51;0.46;199.02;3.37;808;7;659.00;1
1189;7;621684265;1189;289;1998;1998;7.41;0.46;199.02;3.37;809;7;660.00;0
1191;7;621684273;1191;293;1998;1998;7.26;0.45;198.79;3.37;807;7;661.00;0
1194;7;621684282;1194;293;1998;1998;7.25;0.45;198.89;3.37;804;7;662.00;0
1194;7;621684291;1194;298;2004;2004;7.20;0.44;198.89;3.36;810;7;663.00;0
1198;7;621684300;1198;305;2004;2004;7.14;0.44;198.74;3.36;806;7;664.00;0
1202;8;621684309;1202;307;2004;2004;7.10;0.44;198.75;3.36;802;8;665.00;0
1203;8;621684333;1203;310;2006;2007;7.13;0.44;198.82;3.36;803;8;666.00;1
1205;8;621684342;1205;314;2006;2007;7.14;0.44;198.72;3.36;801;8;667.00;1
1207;8;621684350;1207;323;2007;2007;7.11;0.43;198.82;3.36;800;8;668.00;0
1208;8;621684358;1208;325;2008;2008;7.03;0.43;198.73;3.36;800;8;669.00;0
1210;8;621684366;1210;323;2009;2009;6.94;0.42;198.61;3.36;799;8;670.00;0
1211;8;621684374;1211;328;2009;2009;6.83;0.42;198.52;3.36;798;8;671.00;0
1213;8;621684381;1213;336;2022;2022;6.68;0.41;198.82;3.33;809;8;672.00;0
1214;8;621684390;1214;335;2022;2022;6.61;0.41;198.81;3.33;808;8;673.00;0
1218;8;621684398;1218;340;2022;2022;6.46;0.40;198.80;3.33;804;8;674.00;0
1223;8;621684406;1223;333;2024;2024;6.36;0.39;198.75;3.33;801;8;675.00;0
1227;8;621684414;1227;325;2024;2024;6.27;0.38;199.21;3.33;797;8;676.00;0
1232;8;621684422;1232;322;2028;2028;6.25;0.38;199.09;3.33;796;8;677.00;0
1234;8;621684431;1234;317;2028;2028;6.24;0.38;199.19;3.33;794;8;678.00;0
1237;8;621684439;1237;319;2032;2032;6.19;0.38;199.20;3.32;795;8;679.00;0
1239;8;621684447;1239;302;2032;2032;6.22;0.38;199.60;3.32;793;8;680.00;0
1243;8;621684455;1243;301;2032;2032;6.13;0.37;199.89;3.32;789;8;681.00;0
1245;8;621684469;1245;288;2032;2032;6.17;0.38;200.01;3.32;787;8;682.00;0
1249;8;621684477;1249;283;2032;2032;6.22;0.38;199.90;3.32;783;8;683.00;0
1252;8;621684485;1252;281;2042;2044;6.36;0.39;199.91;3.31;790;8;684.00;2
1254;8;621684495;1254;279;2042;2044;6.53;0.40;200.04;3.31;788;8;685.00;2
1256;9;621684506;1256;278;2044;2044;6.74;0.41;200.37;3.30;788;9;686.00;0
1259;9;621684532;1259;271;2044;2044;6.87;0.42;200.85;3.30;785;9;687.00;0
1260;9;621684542;1260;265;2044;2044;7.01;0.43;201.00;3.30;784;9;688.00;0
1262;9;621684556;1262;258;2044;2044;7.12;0.43;201.28;3.30;782;9;689.00;0
1265;9;621684567;1265;251;2045;2045;7.13;0.43;201.70;3.30;780;9;690.00;0
1266;9;621684576;1266;254;2045;2045;7.21;0.44;201.80;3.30;779;9;691.00;0
1268;9;621684585;1268;246;2051;2051;7.36;0.45;202.11;3.30;783;9;692.00;0
1270;9;621684595;1270;248;2051;2052;7.39;0.45;202.32;3.30;781;9;693.00;1
1274;9;621684604;1274;252;2052;2052;7.47;0.46;202.72;3.30;778;9;694.00;0
1275;9;621684614;1275;249;2052;2052;7.55;0.46;202.65;3.30;777;9;695.00;0
1281;9;621684623;1281;248;2056;2056;7.56;0.46;203.15;3.29;775;9;696.00;0
1283;9;621684632;1283;246;2056;2056;7.60;0.46;203.23;3.29;773;9;697.00;0
1287;9;621684641;1287;250;2056;2056;7.66;0.47;203.36;3.29;769;9;698.00;0
1291;9;621684650;1291;243;2057;2057;7.71;0.47;203.86;3.29;766;9;699.00;0
1294;9;621684660;1294;239;2061;2061;7.74;0.47;204.03;3.28;767;9;700.00;0
1301;9;621684673;1301;246;2061;2061;7.70;0.47;204.15;3.28;760;9;701.00;0
1305;9;621684683;1305;241;2063;2064;7.74;0.47;204.41;3.28;758;9;702.00;1
1310;9;621684692;1310;234;2063;2064;7.72;0.47;204.35;3.28;753;9;703.00;1
1314;9;621684701;1314;231;2064;2064;7.70;0.47;204.81;3.28;750;9;704.00;0
1317;9;621684711;1317;227;2064;2064;7.70;0.47;204.91;3.28;747;9;705.00;0
1322;9;621684720;1322;223;2068;2068;7.75;0.47;205.46;3.28;746;9;706.00;0
1326;9;621684729;1326;223;2068;2068;7.75;0.47;205.79;3.28;742;9;707.00;0
1329;9;621684738;1329;223;2068;2068;7.77;0.47;206.19;3.28;739;9;708.00;0
1335;9;621684747;1335;220;2068;2068;7.81;0.48;206.60;3.28;733;9;709.00;0
1337;9;621684756;1337;214;2069;2069;7.83;0.48;206.63;3.27;732;9;710.00;0
1341;9;621684765;1341;219;2070;2070;7.86;0.48;207.16;3.27;729;9;711.00;0
1345;9;621684774;1345;220;2070;2070;7.96;0.49;207.61;3.27;725;9;712.00;0
1347;9;621684783;1347;218;2071;2071;8.08;0.49;207.68;3.27;724;9;713.00;0
1353;9;621684793;1353;215;2071;2071;8.17;0.50;208.19;3.27;718;9;714.00;0
1356;9;621684802;1356;213;2071;2071;8.28;0.50;208.39;3.27;715;9;715.00;0
1362;9;621684812;1362;211;2071;2071;8.27;0.50;208.74;3.27;709;9;716.00;0
1364;9;621684821;1364;206;2071;2071;8.33;0.51;208.70;3.27;707;9;717.00;0
1368;9;621684830;1368;208;2071;2071;8.37;0.51;209.29;3.27;703;9;718.00;0
1371;9;621684840;1371;205;2071;2071;8.41;0.51;209.74;3.27;700;9;719.00;0
1373;9;621684850;1373;237;2191;2301;8.56;0.54;209.73;3.09;818;9;720.00;110
1376;9;621684877;1376;231;2201;2302;8.53;0.54;210.03;3.08;825;9;721.00;101
1381;9;621684887;1381;220;2213;2302;8.50;0.53;210.02;3.08;832;9;722.00;89
1383;9;621684897;1383;220;2218;2302;8.44;0.53;210.11;3.08;835;9;723.00;84
1383;9;621684908;1383;224;2230;2302;8.35;0.52;210.11;3.08;847;9;724.00;72
1384;9;621684917;1384;232;2235;2302;8.28;0.52;210.22;3.09;851;9;725.00;67
1388;9;621684928;1388;234;2241;2302;8.14;0.51;210.79;3.10;853;9;726.00;61
1388;9;621684939;1388;226;2245;2302;8.02;0.50;210.79;3.10;857;9;727.00;57
1390;9;621684954;1390;221;2253;2303;7.95;0.50;210.77;3.12;863;9;728.00;50
1390;9;621684965;1390;225;2257;2304;7.92;0.49;210.77;3.13;867;9;729.00;47
1392;9;621684976;1392;223;2260;2304;7.86;0.49;210.92;3.14;868;9;730.00;44
1394;9;621684986;1394;231;2267;2305;7.85;0.49;210.89;3.16;873;9;731.00;38
1399;9;621684997;1399;237;2269;2305;7.76;0.48;211.26;3.17;870;9;732.00;36
1400;9;621685007;1400;244;2271;2305;7.68;0.48;211.32;3.18;871;9;733.00;34
1406;9;621685018;1406;248;2273;2305;7.58;0.47;211.37;3.19;867;9;734.00;32
1409;9;621685028;1409;261;2278;2309;7.54;0.47;211.62;3.20;869;9;735.00;31
1414;9;621685039;1414;260;2281;2309;7.53;0.46;211.92;3.22;867;9;736.00;28
1419;9;621685050;1419;258;2281;2309;7.50;0.46;212.05;3.22;862;9;737.00;28
1421;9;621685061;1421;250;2282;2312;7.57;0.47;212.19;3.22;861;9;738.00;30
1423;9;621685078;1423;254;2283;2312;7.60;0.47;212.09;3.23;860;9;739.00;29
1427;9;621685094;1427;256;2284;2312;7.61;0.47;212.14;3.24;857;9;740.00;28
1429;9;621685106;1429;255;2293;2316;7.61;0.47;212.07;3.26;864;9;741.00;23
1431;9;621685117;1431;258;2293;2317;7.70;0.47;212.34;3.26;862;9;742.00;24
1432;9;621685128;1432;261;2294;2317;7.76;0.48;212.41;3.27;862;9;743.00;23
1432;9;621685139;1432;265;2297;2321;7.77;0.48;212.41;3.27;865;9;744.00;24
1436;9;621685155;1436;273;2299;2321;7.80;0.48;212.64;3.28;863;9;745.00;22
1439;9;621685167;1439;275;2300;2321;7.84;0.48;212.74;3.28;861;9;746.00;21
1441;9;621685178;1441;275;2301;2322;7.86;0.48;212.97;3.28;860;9;747.00;21
1444;9;621685190;1444;272;2304;2322;7.87;0.48;213.14;3.31;860;9;748.00;18
1445;9;621685201;1445;273;2310;2328;7.90;0.48;213.12;3.30;865;9;749.00;18
1447;9;621685214;1447;270;2311;2328;7.89;0.48;213.27;3.31;864;9;750.00;17
1449;9;621685225;1449;267;2313;2329;7.83;0.48;213.36;3.33;864;9;751.00;16
1449;9;621685237;1449;265;2314;2329;7.86;0.48;213.36;3.34;865;9;752.00;15
1450;9;621685248;1450;255;2315;2329;7.83;0.48;213.48;3.35;865;9;753.00;14
1450;9;621685258;1450;260;2316;2329;7.90;0.48;213.48;3.36;866;9;754.00;13
1452;9;621685274;1452;252;2317;2329;7.94;0.49;213.55;3.37;865;9;755.00;12
1453;9;621685292;1453;249;2329;2341;8.04;0.49;213.52;3.37;876;9;756.00;12
1457;9;621685311;1457;248;2331;2341;8.10;0.49;213.46;3.37;874;9;757.00;10
1457;9;621685327;1457;249;2331;2341;8.20;0.50;213.46;3.37;874;9;758.00;10
1459;9;621685355;1459;251;2332;2341;8.28;0.51;213.50;3.37;873;9;759.00;9
1461;9;621685371;1461;254;2332;2341;8.30;0.51;213.53;3.37;871;9;760.00;9
1461;9;621685385;1461;259;2332;2341;8.38;0.51;213.53;3.37;871;9;761.00;9
1463;9;621685397;1463;256;2336;2345;8.35;0.51;213.57;3.36;873;9;762.00;9
1466;9;621685409;1466;254;2336;2345;8.38;0.51;213.80;3.36;870;9;763.00;9
1468;9;621685421;1468;259;2340;2349;8.47;0.52;213.99;3.36;872;9;764.00;9
1471;9;621685434;1471;264;2342;2351;8.47;0.52;214.18;3.36;871;9;765.00;9
1472;9;621685446;1472;271;2342;2351;8.48;0.52;214.26;3.36;870;9;766.00;9
1473;9;621685458;1473;272;2342;2351;8.42;0.51;214.38;3.36;869;9;767.00;9
1474;9;621685469;1474;275;2351;2364;8.41;0.51;214.38;3.34;877;9;768.00;13
1476;9;621685481;1476;277;2351;2364;8.34;0.51;214.22;3.34;875;9;769.00;13
1479;9;621685494;1479;276;2351;2364;8.23;0.50;214.46;3.34;872;9;770.00;13
1480;9;621685504;1480;279;2352;2365;8.19;0.50;214.44;3.34;872;9;771.00;13
1482;9;621685522;1482;280;2352;2366;8.16;0.50;214.61;3.34;870;9;772.00;14
1483;9;621685531;1483;276;2352;2366;8.13;0.50;214.77;3.34;869;9;773.00;14
1485;9;621685542;1485;277;2354;2369;8.13;0.50;214.80;3.34;869;9;774.00;15
1485;9;621685552;1485;274;2354;2369;8.12;0.50;214.80;3.34;869;9;775.00;15
1487;9;621685562;1487;273;2355;2369;8.10;0.49;214.77;3.34;868;9;776.00;14
1489;9;621685572;1489;277;2355;2369;8.04;0.49;214.98;3.34;866;9;777.00;14
1494;9;621685583;1494;284;2360;2375;8.00;0.49;215.06;3.34;866;9;778.00;15
1496;9;621685594;1496;282;2360;2375;7.91;0.48;214.98;3.34;864;9;779.00;15
1500;9;621685605;1500;281;2360;2375;7.74;0.47;215.17;3.34;860;9;780.00;15
1502;9;621685615;1502;283;2360;2375;7.60;0.46;215.27;3.34;858;9;781.00;15
1506;9;621685624;1506;274;2363;2379;7.48;0.45;215.65;3.33;857;9;782.00;16
1508;9;621685635;1508;272;2364;2380;7.43;0.45;215.92;3.33;856;9;783.00;16
1510;9;621685645;1510;275;2364;2380;7.46;0.45;216.00;3.33;854;9;784.00;16
1512;9;621685654;1512;269;2367;2381;7.48;0.46;216.12;3.34;855;9;785.00;14
1515;9;621685665;1515;265;2367;2381;7.46;0.46;216.18;3.34;852;9;786.00;14
1517;9;621685675;1517;261;2367;2381;7.47;0.46;216.16;3.34;850;9;787.00;14
1520;9;621685685;1520;266;2367;2381;7.45;0.45;216.30;3.34;847;9;788.00;14
1521;9;621685695;1521;265;2367;2381;7.49;0.46;216.34;3.34;846;9;789.00;14
1525;9;621685705;1525;265;2367;2381;7.49;0.46;216.58;3.34;842;9;790.00;14
1527;9;621685714;1527;264;2367;2381;7.54;0.46;216.56;3.34;840;9;791.00;14
1531;9;621685724;1531;265;2398;2451;7.64;0.47;216.52;3.30;867;9;792.00;53
1534;9;621685739;1534;262;2398;2452;7.65;0.47;216.70;3.30;864;9;793.00;54
1536;9;621685749;1536;274;2406;2452;7.74;0.47;216.98;3.29;870;9;794.00;46
1537;9;621685759;1537;270;2409;2452;7.77;0.47;216.96;3.29;872;9;795.00;43
1539;10;621685769;1539;274;2413;2452;7.72;0.47;216.79;3.32;874;10;796.00;39
1541;10;621685797;1541;273;2418;2452;7.66;0.47;216.70;3.33;877;10;797.00;34
1543;10;621685808;1543;270;2421;2452;7.62;0.47;216.57;3.33;878;10;798.00;31
1544;10;621685819;1544;275;2426;2452;7.59;0.46;216.64;3.37;882;10;799.00;26
1544;10;621685830;1544;278;2427;2453;7.57;0.46;216.64;3.37;883;10;800.00;26
1544;10;621685844;1544;276;2432;2454;7.57;0.46;216.64;3.41;888;10;801.00;22
1547;10;621685855;1547;285;2435;2454;7.55;0.46;216.56;3.42;888;10;802.00;19
1549;10;621685865;1549;293;2439;2458;7.51;0.46;216.62;3.42;890;10;803.00;19
1549;10;621685875;1549;292;2441;2458;7.54;0.46;216.62;3.45;892;10;804.00;17
1550;10;621685885;1550;295;2441;2458;7.53;0.46;216.53;3.45;891;10;805.00;17
1553;10;621685896;1553;293;2441;2458;7.49;0.46;216.30;3.45;888;10;806.00;17
1553;10;621685906;1553;303;2447;2464;7.49;0.46;216.30;3.48;894;10;807.00;17
1554;10;621685917;1554;303;2447;2464;7.49;0.46;216.29;3.48;893;10;808.00;17
1559;10;621685928;1559;308;2447;2464;7.37;0.45;216.06;3.48;888;10;809.00;17
1560;10;621685940;1560;315;2454;2470;7.38;0.45;215.98;3.56;894;10;810.00;16
1563;10;621685951;1563;326;2455;2470;7.33;0.45;215.77;3.56;892;10;811.00;15
1564;10;621685962;1564;330;2459;2470;7.32;0.45;215.73;3.62;895;10;812.00;11
1565;10;621685972;1565;334;2461;2471;7.26;0.44;215.78;3.66;896;10;813.00;10
1569;10;621685983;1569;343;2464;2472;7.15;0.44;215.59;3.68;895;10;814.00;8
1570;10;621685994;1570;344;2465;2472;7.06;0.43;215.46;3.69;895;10;815.00;7
1572;10;621686004;1572;352;2475;2485;6.98;0.42;215.26;3.71;903;10;816.00;10
1574;10;621686016;1574;361;2476;2485;6.85;0.42;215.09;3.71;902;10;817.00;9
1576;10;621686026;1576;359;2480;2485;6.82;0.42;214.90;3.72;904;10;818.00;5
1577;10;621686036;1577;360;2482;2486;6.78;0.41;214.87;3.73;905;10;819.00;4
1581;10;621686045;1581;364;2484;2486;6.66;0.41;214.69;3.73;903;10;820.00;2
1582;10;621686055;1582;371;2488;2490;6.64;0.41;214.71;3.73;906;10;821.00;2
1585;10;621686065;1585;374;2489;2490;6.61;0.40;214.75;3.73;904;10;822.00;1
1587;10;621686075;1587;379;2493;2494;6.61;0.40;214.66;3.72;906;10;823.00;1
1589;10;621686086;1589;384;2493;2494;6.58;0.40;214.67;3.72;904;10;824.00;1
1591;10;621686096;1591;392;2494;2494;6.57;0.40;214.54;3.73;903;10;825.00;0
1591;10;621686105;1591;392;2494;2494;6.47;0.40;214.54;3.73;903;10;826.00;0
1594;10;621686115;1594;387;2494;2494;6.34;0.39;214.33;3.73;900;10;827.00;0
1595;10;621686124;1595;380;2505;2506;6.36;0.39;214.28;3.71;910;10;828.00;1
1595;10;621686136;1595;364;2505;2506;6.35;0.39;214.28;3.71;910;10;829.00;1
1598;10;621686146;1598;354;2506;2506;6.40;0.39;214.37;3.71;908;10;830.00;0
1599;10;621686156;1599;356;2506;2506;6.45;0.40;214.39;3.71;907;10;831.00;0
1600;10;621686166;1600;343;2506;2506;6.49;0.40;214.47;3.71;906;10;832.00;0
1601;10;621686181;1601;339;2506;2506;6.53;0.40;214.49;3.71;905;10;833.00;0
1601;10;621686192;1601;333;2507;2507;6.59;0.40;214.49;3.71;906;10;834.00;0
1603;10;621686202;1603;331;2507;2507;6.65;0.41;214.72;3.71;904;10;835.00;0
1604;10;621686218;1604;326;2513;2513;6.74;0.41;214.71;3.70;909;10;836.00;0
1605;10;621686235;1605;331;2514;2514;6.79;0.42;214.77;3.70;909;10;837.00;0
1606;10;621686245;1606;325;2514;2514;6.83;0.42;214.71;3.70;908;10;838.00;0
1608;10;621686255;1608;317;2514;2514;6.83;0.42;214.52;3.70;906;10;839.00;0
1609;10;621686269;1609;317;2519;2519;6.86;0.42;214.46;3.69;910;10;840.00;0
1611;10;621686280;1611;319;2519;2519;6.83;0.42;214.35;3.69;908;10;841.00;0
1614;10;621686290;1614;321;2519;2519;6.78;0.41;214.50;3.69;905;10;842.00;0
1617;10;621686300;1617;325;2520;2520;6.79;0.41;214.54;3.69;903;10;843.00;0
1621;10;621686310;1621;324;2524;2524;6.75;0.41;214.53;3.69;903;10;844.00;0
1623;10;621686321;1623;322;2524;2524;6.75;0.41;214.50;3.69;901;10;845.00;0
1624;10;621686330;1624;323;2526;2527;6.74;0.41;214.44;3.68;902;10;846.00;1
1627;10;621686340;1627;326;2527;2527;6.75;0.41;214.48;3.68;900;10;847.00;0
1633;10;621686349;1633;329;2527;2527;6.68;0.41;215.01;3.68;894;10;848.00;0
1634;10;621686359;1634;332;2527;2527;6.62;0.40;215.00;3.68;893;10;849.00;0
1640;10;621686368;1640;321;2531;2531;6.64;0.40;215.47;3.68;891;10;850.00;0
1644;10;621686377;1644;314;2531;2531;6.63;0.40;215.55;3.68;887;10;851.00;0
1646;10;621686387;1646;310;2531;2531;6.59;0.40;215.74;3.68;885;10;852.00;0
1650;10;621686396;1650;305;2531;2531;6.53;0.40;215.90;3.68;881;10;853.00;0
1652;10;621686405;1652;298;2532;2532;6.52;0.40;215.81;3.68;880;10;854.00;0
1655;10;621686414;1655;298;2534;2534;6.57;0.40;216.26;3.67;879;10;855.00;0
1660;10;621686424;1660;299;2534;2534;6.59;0.40;216.68;3.67;874;10;856.00;0
1662;10;621686434;1662;296;2535;2535;6.69;0.41;216.98;3.67;873;10;857.00;0
1666;10;621686449;1666;289;2535;2535;6.74;0.41;217.24;3.67;869;10;858.00;0
1669;10;621686459;1669;281;2535;2535;6.79;0.41;217.46;3.67;866;10;859.00;0
1669;10;621686468;1669;273;2535;2535;6.87;0.42;217.46;3.67;866;10;860.00;0
1674;10;621686477;1674;269;2535;2535;6.88;0.42;217.97;3.67;861;10;861.00;0
1676;10;621686487;1676;259;2535;2535;6.93;0.42;218.18;3.67;859;10;862.00;0
1678;10;621686496;1678;254;2535;2535;6.93;0.42;218.54;3.67;857;10;863.00;0
1682;10;621686506;1682;261;2614;2662;7.23;0.45;218.83;3.56;932;10;864.00;48
1685;10;621686526;1685;249;2619;2663;7.28;0.45;218.96;3.56;934;10;865.00;44
1689;10;621686537;1689;247;2628;2663;7.34;0.45;219.50;3.55;939;10;866.00;35
1694;10;621686547;1694;244;2630;2663;7.36;0.45;219.91;3.55;936;10;867.00;33
1696;10;621686557;1696;240;2634;2663;7.38;0.45;220.11;3.55;938;10;868.00;29
1703;10;621686568;1703;243;2635;2663;7.37;0.45;220.67;3.55;932;10;869.00;28
1706;10;621686581;1706;235;2636;2663;7.35;0.45;220.79;3.56;930;10;870.00;27
1711;10;621686591;1711;246;2639;2663;7.20;0.44;221.17;3.56;928;10;871.00;24
1715;10;621686602;1715;244;2640;2664;7.16;0.44;221.16;3.56;925;10;872.00;24
1718;10;621686613;1718;247;2642;2665;7.11;0.43;221.40;3.56;924;10;873.00;23
1719;10;621686624;1719;250;2645;2665;7.06;0.43;221.55;3.57;926;10;874.00;20
1724;10;621686635;1724;252;2647;2666;7.00;0.43;221.98;3.57;923;10;875.00;19
1727;10;621686646;1727;255;2650;2666;6.95;0.43;222.28;3.58;923;10;876.00;16
1731;10;621686658;1731;258;2651;2666;6.95;0.43;222.57;3.59;920;10;877.00;15
1735;10;621686669;1735;265;2654;2666;6.91;0.42;223.01;3.60;919;10;878.00;12
1741;10;621686679;1741;272;2657;2670;6.87;0.42;222.97;3.60;916;10;879.00;13
1744;10;621686692;1744;268;2657;2670;6.95;0.43;223.22;3.60;913;10;880.00;13
1746;10;621686703;1746;269;2661;2670;6.98;0.43;223.48;3.62;915;10;881.00;9
1749;10;621686714;1749;273;2663;2673;7.05;0.43;223.71;3.63;914;10;882.00;10
1754;10;621686725;1754;272;2664;2673;7.09;0.43;223.99;3.63;910;10;883.00;9
1761;10;621686736;1761;269;2665;2673;7.13;0.44;224.43;3.63;904;10;884.00;8
1765;10;621686748;1765;265;2669;2677;7.17;0.44;224.76;3.63;904;10;885.00;8
1768;10;621686759;1768;267;2671;2678;7.22;0.44;224.87;3.64;903;10;886.00;7
1771;10;621686770;1771;262;2672;2678;7.31;0.45;224.89;3.65;901;10;887.00;6
1774;10;621686781;1774;267;2674;2682;7.40;0.45;225.16;3.64;900;10;888.00;8
1778;10;621686793;1778;270;2675;2682;7.45;0.46;225.52;3.64;897;10;889.00;7
1782;10;621686809;1782;270;2675;2682;7.46;0.46;225.60;3.64;893;10;890.00;7
1787;10;621686820;1787;273;2676;2683;7.43;0.45;225.71;3.64;889;10;891.00;7
1790;10;621686837;1790;274;2676;2683;7.38;0.45;226.13;3.64;886;10;892.00;7
1794;10;621686848;1794;275;2681;2689;7.36;0.45;226.23;3.64;887;10;893.00;8
1796;10;621686860;1796;285;2682;2689;7.34;0.45;226.33;3.65;886;10;894.00;7
1800;10;621686871;1800;285;2684;2690;7.29;0.44;226.49;3.65;884;10;895.00;6
1802;10;621686882;1802;291;2684;2690;7.27;0.44;226.51;3.65;882;10;896.00;6
1805;10;621686895;1805;281;2685;2690;7.29;0.45;226.86;3.66;880;10;897.00;5
1807;10;621686907;1807;281;2685;2690;7.35;0.45;226.95;3.66;878;10;898.00;5
1811;10;621686918;1811;281;2685;2690;7.39;0.45;227.47;3.66;874;10;899.00;5
1814;10;621686932;1814;280;2714;2736;7.41;0.46;227.93;3.63;900;10;900.00;22
1819;10;621686954;1819;276;2715;2736;7.45;0.46;228.35;3.63;896;10;901.00;21
1824;10;621686966;1824;278;2722;2736;7.50;0.46;228.94;3.64;898;10;902.00;14
1827;10;621686978;1827;278;2722;2736;7.58;0.47;229.00;3.64;895;10;903.00;14
1828;10;621686990;1828;280;2725;2736;7.70;0.47;228.97;3.64;897;10;904.00;11
1831;10;621687001;1831;281;2726;2736;7.75;0.48;229.14;3.64;895;10;905.00;10
1836;10;621687024;1836;271;2732;2740;7.79;0.48;229.24;3.64;896;10;906.00;8
1837;10;621687036;1837;259;2734;2740;7.87;0.48;229.25;3.64;897;10;907.00;6
1842;10;621687047;1842;249;2737;2744;7.91;0.48;229.65;3.64;895;10;908.00;7
1845;10;621687066;1845;246;2738;2745;7.93;0.48;229.87;3.64;893;10;909.00;7
1850;10;621687078;1850;249;2738;2745;7.98;0.49;229.92;3.64;888;10;910.00;7
1853;10;621687090;1853;248;2739;2745;7.94;0.48;230.20;3.64;886;10;911.00;6
1857;10;621687102;1857;258;2751;2758;7.90;0.48;230.74;3.62;894;10;912.00;7
1861;10;621687115;1861;255;2752;2758;7.85;0.48;230.80;3.63;891;10;913.00;6
1862;10;621687127;1862;258;2752;2758;7.90;0.48;230.90;3.63;890;10;914.00;6
1865;10;621687145;1865;261;2753;2759;7.92;0.48;231.16;3.63;888;10;915.00;6
1868;10;621687157;1868;266;2754;2760;7.90;0.48;231.36;3.62;886;10;916.00;6
1869;10;621687168;1869;266;2755;2760;7.83;0.48;231.38;3.63;886;10;917.00;5
1870;10;621687179;1870;263;2757;2763;7.83;0.48;231.38;3.63;887;10;918.00;6
1870;10;621687190;1870;265;2758;2763;7.80;0.48;231.38;3.63;888;10;919.00;5
1874;10;621687202;1874;262;2759;2763;7.77;0.47;231.46;3.63;885;10;920.00;4
1875;10;621687213;1875;264;2759;2763;7.80;0.48;231.67;3.63;884;10;921.00;4
1876;10;621687224;1876;264;2764;2769;7.82;0.48;231.63;3.63;888;10;922.00;5
1878;10;621687235;1878;262;2765;2769;7.81;0.48;231.62;3.63;887;10;923.00;4
1880;10;621687246;1880;254;2765;2769;7.83;0.48;231.71;3.63;885;10;924.00;4
1886;10;621687257;1886;255;2768;2769;7.77;0.47;231.75;3.65;882;10;925.00;1
1887;10;621687273;1887;256;2773;2773;7.71;0.47;231.85;3.65;886;10;926.00;0
1889;10;621687289;1889;255;2774;2774;7.67;0.47;232.08;3.65;885;10;927.00;0
1893;10;621687305;1893;265;2774;2774;7.62;0.46;232.25;3.65;881;10;928.00;0
1895;10;621687326;1895;269;2775;2775;7.61;0.46;232.24;3.65;880;10;929.00;0
1897;10;621687354;1897;273;2775;2775;7.60;0.46;232.29;3.65;878;10;930.00;0
1899;10;621687371;1899;275;2775;2775;7.59;0.46;232.43;3.65;876;10;931.00;0
1900;10;621687386;1900;276;2775;2775;7.60;0.46;232.34;3.65;875;10;932.00;0
1903;10;621687398;1903;285;2775;2775;7.58;0.46;232.45;3.65;872;10;933.00;0
1904;10;621687410;1904;283;2775;2775;7.57;0.46;232.65;3.65;871;10;934.00;0
1906;10;621687421;1906;291;2775;2775;7.61;0.46;232.82;3.65;869;10;935.00;0
1907;10;621687432;1907;309;2813;2845;7.59;0.46;232.81;3.60;906;10;936.00;32
1908;10;621687450;1908;306;2813;2846;7.57;0.46;232.79;3.60;905;10;937.00;33
1911;10;621687461;1911;310;2820;2846;7.60;0.46;232.84;3.59;909;10;938.00;26
1913;10;621687473;1913;312;2822;2846;7.61;0.46;232.86;3.59;909;10;939.00;24
1914;10;621687484;1914;306;2826;2846;7.61;0.46;232.95;3.59;912;10;940.00;20
1917;10;621687495;1917;308;2828;2846;7.57;0.46;233.20;3.59;911;10;941.00;18
1920;10;621687507;1920;312;2832;2846;7.56;0.46;233.37;3.60;912;10;942.00;14
1923;10;621687518;1923;310;2835;2846;7.49;0.46;233.36;3.60;912;10;943.00;11
1925;10;621687529;1925;306;2838;2847;7.45;0.45;233.40;3.60;913;10;944.00;9
1925;10;621687541;1925;308;2842;2849;7.38;0.45;233.40;3.60;917;10;945.00;7
1928;10;621687552;1928;308;2842;2849;7.32;0.45;233.38;3.60;914;10;946.00;7
1931;10;621687564;1931;302;2845;2853;7.25;0.44;233.37;3.60;914;10;947.00;8
1931;10;621687575;1931;303;2845;2853;7.23;0.44;233.37;3.60;914;10;948.00;8
1933;10;621687586;1933;301;2845;2853;7.20;0.44;233.32;3.60;912;10;949.00;8
1935;10;621687597;1935;304;2845;2853;7.16;0.44;233.29;3.60;910;10;950.00;8
1939;10;621687608;1939;297;2849;2859;7.13;0.43;233.40;3.60;910;10;951.00;10
1943;10;621687619;1943;292;2849;2859;7.07;0.43;233.52;3.60;906;10;952.00;10
1945;10;621687631;1945;293;2849;2859;7.00;0.43;233.68;3.60;904;10;953.00;10
1950;10;621687648;1950;290;2851;2862;6.96;0.42;233.88;3.59;901;10;954.00;11
1951;10;621687660;1951;293;2855;2862;6.88;0.42;233.95;3.61;904;10;955.00;7
1952;10;621687670;1952;291;2856;2862;6.86;0.42;233.88;3.62;904;10;956.00;6
1954;10;621687681;1954;296;2856;2863;6.82;0.41;233.99;3.62;902;10;957.00;7
1957;10;621687691;1957;298;2857;2864;6.83;0.42;233.87;3.61;900;10;958.00;7
1961;10;621687702;1961;301;2857;2864;6.77;0.41;234.05;3.61;896;10;959.00;7
1964;10;621687714;1964;308;2875;2890;6.81;0.42;233.82;3.59;911;10;960.00;15
1967;10;621687726;1967;307;2875;2890;6.78;0.41;233.65;3.59;908;10;961.00;15
1971;10;621687736;1971;307;2877;2890;6.84;0.42;233.41;3.59;906;10;962.00;13
1973;10;621687747;1973;308;2879;2891;6.89;0.42;233.36;3.60;906;10;963.00;12
1975;10;621687758;1975;308;2879;2891;6.92;0.42;233.26;3.60;904;10;964.00;12
1979;10;621687768;1979;309;2883;2895;6.96;0.42;233.15;3.60;904;10;965.00;12
1982;10;621687779;1982;310;2883;2895;6.95;0.42;233.01;3.60;901;10;966.00;12
1984;10;621687789;1984;309;2887;2899;6.98;0.42;233.14;3.59;903;10;967.00;12
1984;10;621687800;1984;308;2887;2899;7.05;0.43;233.14;3.59;903;10;968.00;12
1986;10;621687811;1986;313;2887;2899;7.06;0.43;232.97;3.59;901;10;969.00;12
1987;10;621687820;1987;312;2888;2899;7.03;0.43;232.97;3.60;901;10;970.00;11
1987;10;621687830;1987;318;2891;2899;7.02;0.43;232.97;3.63;904;10;971.00;8
1990;10;621687841;1990;318;2901;2911;7.05;0.43;232.85;3.61;911;10;972.00;10
1991;10;621687853;1991;317;2903;2911;7.03;0.43;232.86;3.62;912;10;973.00;8
1992;10;621687863;1992;315;2904;2911;6.98;0.42;232.98;3.62;912;10;974.00;7
1994;10;621687874;1994;319;2905;2911;6.93;0.42;232.98;3.62;911;10;975.00;6
1995;10;621687884;1995;327;2905;2911;6.89;0.42;232.98;3.62;910;10;976.00;6
1995;10;621687897;1995;331;2905;2911;6.84;0.42;232.98;3.62;910;10;977.00;6
1996;10;621687908;1996;330;2905;2912;6.81;0.41;232.98;3.62;909;10;978.00;7
1996;10;621687918;1996;320;2905;2912;6.80;0.41;232.98;3.62;909;10;979.00;7
1997;10;621687928;1997;321;2911;2918;6.92;0.42;232.90;3.63;914;10;980.00;7
1997;10;621687940;1997;318;2913;2919;6.95;0.42;232.90;3.64;916;10;981.00;6
1998;10;621687951;1998;316;2914;2919;6.96;0.42;232.98;3.64;916;10;982.00;5
2001;10;621687962;2001;318;2914;2919;6.94;0.42;232.86;3.64;913;10;983.00;5
2003;10;621687974;2003;319;2918;2923;6.97;0.42;232.70;3.64;915;10;984.00;5
2004;10;621687984;2004;316;2918;2923;6.96;0.42;232.71;3.64;914;10;985.00;5
2004;10;621688002;2004;321;2920;2923;6.96;0.42;232.71;3.65;916;10;986.00;3
2007;10;621688012;2007;318;2921;2924;7.02;0.43;232.48;3.65;914;10;987.00;3
2007;10;621688023;2007;319;2925;2928;7.09;0.43;232.48;3.65;918;10;988.00;3
2007;10;621688040;2007;321;2926;2928;7.11;0.43;232.48;3.66;919;10;989.00;2
2009;10;621688052;2009;323;2930;2934;7.12;0.43;232.47;3.65;921;10;990.00;4
2009;10;621688064;2009;320;2931;2934;7.09;0.43;232.47;3.65;922;10;991.00;3
2010;10;621688074;2010;326;2933;2934;7.07;0.43;232.47;3.65;923;10;992.00;1
2011;10;621688085;2011;330;2934;2934;7.01;0.43;232.44;3.65;923;10;993.00;0
2012;10;621688101;2012;331;2938;2938;7.01;0.43;232.42;3.65;926;10;994.00;0
2012;10;621688111;2012;335;2938;2938;6.95;0.43;232.42;3.65;926;10;995.00;0
2014;10;621688122;2014;335;2938;2938;6.95;0.43;232.34;3.65;924;10;996.00;0
2016;10;621688132;2016;337;2938;2938;6.85;0.42;232.47;3.65;922;10;997.00;0
2016;10;621688142;2016;329;2939;2939;6.78;0.42;232.47;3.65;923;10;998.00;0
2016;10;621688152;2016;324;2940;2940;6.80;0.42;232.47;3.65;924;10;999.00;0
2021;10;621688163;2021;320;2940;2940;6.80;0.42;232.45;3.65;919;10;1000.00;0
2026;10;621688179;2026;313;2941;2941;6.82;0.42;232.43;3.64;915;10;1001.00;0
2030;10;621688189;2030;310;2941;2941;6.80;0.42;232.20;3.64;911;10;1002.00;0
2032;10;621688199;2032;306;2941;2941;6.84;0.42;232.26;3.64;909;10;1003.00;0
2033;10;621688210;2033;300;2941;2941;6.88;0.42;232.36;3.64;908;10;1004.00;0
2037;10;621688220;2037;297;2941;2941;6.89;0.42;232.53;3.64;904;10;1005.00;0
2037;10;621688230;2037;296;2941;2941;6.93;0.42;232.53;3.64;904;10;1006.00;0
2040;10;621688240;2040;295;2941;2941;6.92;0.42;232.68;3.64;901;10;1007.00;0
2041;10;621688251;2041;310;3011;3068;7.20;0.45;232.68;3.56;970;10;1008.00;57
2042;10;621688273;2042;302;3013;3069;7.25;0.45;232.59;3.56;971;10;1009.00;56
2045;10;621688285;2045;291;3022;3069;7.32;0.45;232.62;3.55;977;10;1010.00;47
2050;10;621688296;2050;289;3028;3069;7.27;0.45;232.85;3.55;978;10;1011.00;41
2052;10;621688306;2052;287;3035;3069;7.26;0.45;232.98;3.55;983;10;1012.00;34
2056;10;621688318;2056;283;3036;3069;7.18;0.44;233.10;3.55;980;10;1013.00;33
2058;10;621688328;2058;287;3041;3069;7.07;0.44;233.13;3.56;983;10;1014.00;28
2060;10;621688338;2060;293;3041;3069;7.00;0.43;233.27;3.56;981;10;1015.00;28
2067;10;621688348;2067;295;3044;3070;6.96;0.43;233.29;3.56;977;10;1016.00;26
2071;10;621688359;2071;299;3045;3071;6.90;0.42;233.49;3.56;974;10;1017.00;26
2072;10;621688369;2072;294;3046;3071;6.86;0.42;233.44;3.57;974;10;1018.00;25
2077;10;621688379;2077;301;3049;3072;6.76;0.42;233.36;3.57;972;10;1019.00;23
2080;10;621688392;2080;283;3052;3072;6.74;0.41;233.40;3.58;972;10;1020.00;20
2085;10;621688402;2085;278;3055;3072;6.68;0.41;233.37;3.59;970;10;1021.00;17
2087;10;621688413;2087;272;3057;3072;6.65;0.41;233.47;3.60;970;10;1022.00;15
2091;10;621688424;2091;271;3061;3076;6.67;0.41;233.44;3.60;970;10;1023.00;15
2095;10;621688441;2095;271;3066;3076;6.65;0.41;233.42;3.62;971;10;1024.00;10
2099;10;621688452;2099;273;3067;3076;6.67;0.41;233.48;3.63;968;10;1025.00;9
2102;10;621688463;2102;275;3068;3079;6.70;0.41;233.93;3.63;966;10;1026.00;11
2105;10;621688475;2105;263;3071;3079;6.75;0.41;234.03;3.64;966;10;1027.00;8
2108;10;621688486;2108;258;3072;3079;6.79;0.41;234.30;3.64;964;10;1028.00;7
2110;10;621688497;2110;256;3078;3083;6.84;0.42;234.62;3.64;968;10;1029.00;5
2112;10;621688508;2112;254;3080;3084;6.89;0.42;234.66;3.65;968;10;1030.00;4
2116;10;621688521;2116;251;3082;3084;6.91;0.42;234.94;3.66;966;10;1031.00;2
2120;10;621688532;2120;247;3086;3088;6.89;0.42;235.22;3.65;966;10;1032.00;2
2123;10;621688544;2123;242;3087;3088;6.94;0.43;235.37;3.65;964;10;1033.00;1
2128;10;621688556;2128;243;3087;3088;6.96;0.43;235.46;3.65;959;10;1034.00;1
2133;10;621688567;2133;246;3089;3090;6.98;0.43;235.69;3.65;956;10;1035.00;1
2136;10;621688580;2136;244;3090;3090;7.00;0.43;236.01;3.65;954;10;1036.00;0
2141;10;621688591;2141;248;3096;3096;7.03;0.43;236.31;3.65;955;10;1037.00;0
2143;10;621688603;2143;255;3096;3096;7.07;0.43;236.26;3.65;953;10;1038.00;0
2147;10;621688614;2147;254;3097;3097;6.98;0.43;236.54;3.65;950;10;1039.00;0
2151;10;621688626;2151;256;3097;3097;6.96;0.42;236.94;3.65;946;10;1040.00;0
2153;10;621688637;2153;255;3097;3097;7.00;0.43;237.16;3.65;944;10;1041.00;0
2156;10;621688649;2156;259;3097;3097;6.91;0.42;237.34;3.65;941;10;1042.00;0
2160;10;621688660;2160;257;3097;3097;6.90;0.42;237.68;3.65;937;10;1043.00;0
2163;10;621688677;2163;264;3105;3109;7.01;0.43;237.89;3.64;942;10;1044.00;4
2169;10;621688689;2169;254;3107;3109;7.00;0.43;238.51;3.64;938;10;1045.00;2
2176;10;621688701;2176;250;3109;3109;7.05;0.43;238.93;3.63;933;10;1046.00;0
2181;10;621688713;2181;255;3109;3109;7.13;0.44;239.18;3.63;928;10;1047.00;0
2184;10;621688724;2184;256;3109;3109;7.19;0.44;239.32;3.63;925;10;1048.00;0
2190;10;621688736;2190;261;3109;3109;7.20;0.44;239.37;3.63;919;10;1049.00;0
2194;10;621688749;2194;266;3115;3115;7.19;0.44;239.42;3.63;921;10;1050.00;0
2195;10;621688761;2195;262;3115;3115;7.23;0.44;239.39;3.63;920;10;1051.00;0
2201;10;621688773;2201;263;3119;3119;7.29;0.45;240.04;3.62;918;10;1052.00;0
2203;10;621688785;2203;263;3120;3120;7.37;0.45;240.14;3.62;917;10;1053.00;0
2210;10;621688796;2210;274;3120;3120;7.40;0.45;240.47;3.62;910;10;1054.00;0
2215;10;621688807;2215;273;3120;3120;7.47;0.46;240.73;3.62;905;10;1055.00;0
2219;10;621688818;2219;271;3132;3133;7.58;0.46;240.83;3.61;913;10;1056.00;1
2224;10;621688832;2224;272;3133;3133;7.62;0.47;241.12;3.61;909;10;1057.00;0
2228;10;621688844;2228;269;3133;3133;7.65;0.47;241.24;3.61;905;10;1058.00;0
2232;10;621688855;2232;273;3134;3134;7.64;0.47;241.47;3.61;902;10;1059.00;0
2236;10;621688866;2236;274;3135;3135;7.59;0.46;241.91;3.61;899;10;1060.00;0
2238;10;621688877;2238;268;3135;3135;7.56;0.46;241.92;3.61;897;10;1061.00;0
2243;10;621688888;2243;271;3137;3138;7.47;0.46;242.08;3.61;894;10;1062.00;1
2247;10;621688899;2247;271;3137;3138;7.36;0.45;242.44;3.61;890;10;1063.00;1
2250;10;621688910;2250;278;3138;3138;7.28;0.44;242.50;3.60;888;10;1064.00;0
2253;10;621688921;2253;287;3138;3138;7.20;0.44;242.98;3.60;885;10;1065.00;0
2257;10;621688931;2257;293;3144;3144;7.09;0.43;243.00;3.60;887;10;1066.00;0
2258;10;621688943;2258;280;3144;3144;7.03;0.43;242.90;3.60;886;10;1067.00;0
2261;10;621688954;2261;279;3144;3144;6.99;0.42;243.17;3.60;883;10;1068.00;0
2264;10;621688964;2264;274;3144;3144;6.98;0.43;243.51;3.60;880;10;1069.00;0
2267;10;621688975;2267;278;3148;3148;6.98;0.43;243.83;3.60;881;10;1070.00;0
2271;10;621688986;2271;287;3149;3149;6.99;0.43;243.91;3.60;878;10;1071.00;0
2275;10;621688997;2275;284;3149;3149;6.97;0.42;243.96;3.60;874;10;1072.00;0
2277;10;621689008;2277;285;3150;3150;6.96;0.42;244.16;3.59;873;10;1073.00;0
2279;10;621689018;2279;287;3150;3150;6.98;0.43;244.47;3.59;871;10;1074.00;0
2284;10;621689029;2284;286;3150;3150;7.01;0.43;244.64;3.59;866;10;1075.00;0
2288;10;621689040;2288;276;3150;3150;7.08;0.43;244.63;3.59;862;10;1076.00;0
2289;10;621689050;2289;273;3150;3150;7.09;0.43;244.76;3.59;861;10;1077.00;0
2294;10;621689061;2294;270;3150;3150;7.17;0.44;244.73;3.59;856;10;1078.00;0
2295;10;621689071;2295;264;3150;3150;7.25;0.44;244.85;3.59;855;10;1079.00;0
2297;10;621689084;2297;288;3228;3275;7.39;0.46;244.96;3.51;931;10;1080.00;47
2298;10;621689103;2298;284;3235;3276;7.39;0.46;245.03;3.50;937;10;1081.00;41
2303;10;621689125;2303;272;3242;3276;7.46;0.46;245.38;3.50;939;10;1082.00;34
2306;10;621689142;2306;271;3245;3276;7.52;0.46;245.81;3.50;939;10;1083.00;31
2308;10;621689155;2308;275;3250;3276;7.53;0.46;245.96;3.50;942;10;1084.00;26
2309;10;621689167;2309;270;3251;3276;7.59;0.47;246.06;3.50;942;10;1085.00;25
2310;10;621689184;2310;283;3258;3276;7.63;0.47;246.25;3.50;948;10;1086.00;18
2315;10;621689195;2315;279;3261;3276;7.65;0.47;246.72;3.51;946;10;1087.00;15
2316;10;621689207;2316;278;3266;3277;7.64;0.47;246.77;3.52;950;10;1088.00;11
2319;10;621689218;2319;273;3268;3278;7.63;0.47;246.96;3.52;949;10;1089.00;10
2321;10;621689230;2321;272;3273;3278;7.58;0.46;247.09;3.52;952;10;1090.00;5
2321;10;621689241;2321;276;3278;3282;7.48;0.46;247.09;3.52;957;10;1091.00;4
2323;10;621689253;2323;272;3278;3282;7.48;0.46;247.18;3.52;955;10;1092.00;4
2326;10;621689264;2326;272;3279;3282;7.40;0.45;247.61;3.53;953;10;1093.00;3
2326;10;621689280;2326;279;3279;3282;7.37;0.45;247.61;3.53;953;10;1094.00;3
2330;10;621689300;2330;276;3284;3288;7.30;0.45;247.42;3.52;954;10;1095.00;4
2336;10;621689320;2336;275;3284;3288;7.29;0.45;247.70;3.52;948;10;1096.00;4
2338;10;621689338;2338;278;3284;3288;7.24;0.44;247.79;3.52;946;10;1097.00;4
2345;10;621689355;2345;287;3288;3291;7.12;0.44;247.91;3.53;943;10;1098.00;3
2345;10;621689372;2345;292;3288;3291;7.07;0.43;247.91;3.53;943;10;1099.00;3
2350;10;621689388;2350;294;3289;3291;7.03;0.43;247.99;3.53;939;10;1100.00;2
2352;10;621689410;2352;297;3289;3292;7.05;0.43;248.02;3.53;937;10;1101.00;3
2355;10;621689422;2355;301;3291;3293;7.07;0.43;247.99;3.53;936;10;1102.00;2
2357;10;621689434;2357;303;3291;3293;7.06;0.43;247.94;3.53;934;10;1103.00;2
2359;10;621689446;2359;314;3301;3306;7.12;0.44;247.90;3.52;942;10;1104.00;5
2360;10;621689459;2360;313;3301;3306;7.25;0.45;247.93;3.52;941;10;1105.00;5
2364;10;621689472;2364;315;3301;3306;7.28;0.45;248.07;3.52;937;10;1106.00;5
2369;10;621689484;2369;321;3302;3307;7.23;0.44;247.96;3.52;933;10;1107.00;5
2375;10;621689496;2375;320;3302;3307;7.25;0.44;248.12;3.52;927;10;1108.00;5
2376;10;621689508;2376;323;3306;3311;7.26;0.44;248.06;3.52;930;10;1109.00;5
2378;10;621689521;2378;322;3306;3311;7.23;0.44;248.09;3.52;928;10;1110.00;5
2382;10;621689533;2382;317;3309;3315;7.19;0.44;248.20;3.52;927;10;1111.00;6
2386;10;621689545;2386;316;3309;3315;7.16;0.44;248.24;3.52;923;10;1112.00;6
2387;10;621689556;2387;314;3309;3315;7.16;0.44;248.15;3.52;922;10;1113.00;6
2391;10;621689567;2391;307;3310;3315;7.16;0.44;247.97;3.52;919;10;1114.00;5
2395;10;621689578;2395;302;3310;3315;7.10;0.43;247.99;3.52;915;10;1115.00;5
2396;10;621689589;2396;302;3321;3327;7.13;0.43;248.11;3.51;925;10;1116.00;6
2398;10;621689602;2398;301;3321;3327;7.11;0.43;248.17;3.51;923;10;1117.00;6
2398;10;621689613;2398;300;3321;3327;7.09;0.43;248.17;3.51;923;10;1118.00;6
2401;10;621689624;2401;298;3321;3327;7.02;0.43;248.26;3.51;920;10;1119.00;6
2403;10;621689634;2403;301;3321;3327;6.98;0.42;248.39;3.51;918;10;1120.00;6
2404;10;621689646;2404;300;3321;3327;6.93;0.42;248.51;3.51;917;10;1121.00;6
2405;10;621689656;2405;296;3321;3328;6.85;0.42;248.51;3.51;916;10;1122.00;7
2405;10;621689666;2405;299;3321;3328;6.79;0.41;248.51;3.51;916;10;1123.00;7
2406;10;621689676;2406;293;3326;3334;6.75;0.41;248.54;3.50;920;10;1124.00;8
2409;10;621689688;2409;298;3329;3336;6.65;0.40;248.69;3.52;920;10;1125.00;7
2411;10;621689699;2411;293;3330;3336;6.61;0.40;248.81;3.52;919;10;1126.00;6
2413;10;621689709;2413;295;3330;3336;6.61;0.40;248.85;3.52;917;10;1127.00;6
2417;10;621689720;2417;299;3333;3340;6.63;0.40;248.93;3.51;916;10;1128.00;7
2420;10;621689730;2420;298;3333;3340;6.62;0.40;248.92;3.51;913;10;1129.00;7
2420;10;621689741;2420;301;3333;3340;6.68;0.41;248.92;3.51;913;10;1130.00;7
2421;10;621689751;2421;287;3334;3341;6.77;0.41;248.84;3.51;913;10;1131.00;7
2423;10;621689763;2423;275;3337;3345;6.84;0.41;248.82;3.51;914;10;1132.00;8
2423;10;621689775;2423;268;3337;3345;6.94;0.42;248.82;3.51;914;10;1133.00;8
2424;10;621689786;2424;263;3339;3348;7.05;0.43;248.74;3.51;915;10;1134.00;9
2425;10;621689796;2425;259;3340;3348;7.10;0.43;248.65;3.51;915;10;1135.00;8
2429;10;621689808;2429;254;3340;3348;7.06;0.43;248.70;3.51;911;10;1136.00;8
2430;10;621689819;2430;254;3340;3348;7.09;0.43;248.62;3.51;910;10;1137.00;8
2432;10;621689837;2432;249;3344;3352;7.19;0.44;248.60;3.50;912;10;1138.00;8
2432;10;621689848;2432;248;3344;3352;7.24;0.44;248.60;3.50;912;10;1139.00;8
2433;10;621689861;2433;239;3344;3352;7.29;0.44;248.58;3.50;911;10;1140.00;8
2433;10;621689872;2433;238;3344;3352;7.35;0.45;248.58;3.50;911;10;1141.00;8
2434;10;621689883;2434;238;3344;3353;7.33;0.45;248.55;3.50;910;10;1142.00;9
2435;10;621689894;2435;233;3345;3354;7.33;0.45;248.47;3.50;910;10;1143.00;9
2435;10;621689907;2435;233;3345;3354;7.39;0.45;248.47;3.50;910;10;1144.00;9
2437;10;621689918;2437;229;3346;3355;7.37;0.45;248.40;3.50;909;10;1145.00;9
2438;10;621689929;2438;230;3346;3355;7.38;0.45;248.35;3.50;908;10;1146.00;9
2439;10;621689941;2439;231;3346;3355;7.36;0.45;248.31;3.50;907;10;1147.00;9
2439;10;621689951;2439;227;3346;3355;7.40;0.45;248.31;3.50;907;10;1148.00;9
2442;10;621689962;2442;230;3346;3355;7.38;0.45;248.38;3.50;904;10;1149.00;9
2444;10;621689974;2444;228;3348;3355;7.45;0.46;248.41;3.52;904;10;1150.00;7
2446;10;621689985;2446;229;3348;3355;7.56;0.46;248.35;3.52;902;10;1151.00;7
2449;10;621689995;2449;245;3415;3482;7.78;0.48;248.45;3.47;966;10;1152.00;67
2450;10;621690019;2450;238;3419;3483;7.80;0.48;248.46;3.46;969;10;1153.00;64
2452;10;621690031;2452;236;3428;3483;7.91;0.49;248.42;3.46;976;10;1154.00;55
2453;10;621690045;2453;237;3434;3483;7.90;0.49;248.60;3.46;981;10;1155.00;49
2459;10;621690058;2459;239;3442;3483;7.89;0.49;248.30;3.47;983;10;1156.00;41
2460;10;621690070;2460;236;3445;3483;7.84;0.48;248.38;3.47;985;10;1157.00;38
2461;10;621690081;2461;240;3448;3483;7.83;0.48;248.45;3.49;987;10;1158.00;35
2463;10;621690093;2463;245;3452;3483;7.81;0.48;248.47;3.51;989;10;1159.00;31
2465;10;621690104;2465;248;3455;3484;7.86;0.48;248.49;3.52;990;10;1160.00;29
2466;10;621690116;2466;252;3461;3485;7.90;0.49;248.47;3.53;995;10;1161.00;24
2470;10;621690127;2470;253;3464;3485;7.89;0.49;248.40;3.53;994;10;1162.00;21
2473;10;621690145;2473;255;3468;3486;7.84;0.48;248.49;3.54;995;10;1163.00;18
2474;10;621690157;2474;256;3470;3486;7.82;0.48;248.51;3.55;996;10;1164.00;16
2479;11;621690168;2479;262;3473;3486;7.74;0.48;248.72;3.56;994;11;1165.00;13
2481;11;621690192;2481;268;3475;3486;7.62;0.47;248.78;3.56;994;11;1166.00;11
2482;11;621690203;2482;268;3479;3490;7.56;0.47;248.80;3.57;997;11;1167.00;11
2484;11;621690215;2484;275;3485;3490;7.44;0.46;248.64;3.58;1001;11;1168.00;5
2487;11;621690231;2487;275;3485;3490;7.32;0.45;248.61;3.58;998;11;1169.00;5
2492;11;621690244;2492;278;3490;3496;7.20;0.44;248.64;3.58;998;11;1170.00;6
2494;11;621690257;2494;280;3490;3496;7.10;0.44;248.64;3.58;996;11;1171.00;6
2497;11;621690271;2497;278;3491;3496;7.04;0.43;248.71;3.58;994;11;1172.00;5
2499;11;621690286;2499;286;3496;3500;7.00;0.43;248.78;3.58;997;11;1173.00;4
2500;11;621690301;2500;288;3497;3501;7.00;0.43;248.77;3.58;997;11;1174.00;4
2502;11;621690316;2502;285;3498;3501;7.00;0.43;248.69;3.58;996;11;1175.00;3
2505;11;621690328;2505;288;3502;3505;7.08;0.43;248.66;3.58;997;11;1176.00;3
2508;11;621690340;2508;285;3504;3505;7.04;0.43;248.63;3.59;996;11;1177.00;1
2511;11;621690352;2511;289;3504;3505;7.07;0.43;248.88;3.59;993;11;1178.00;1
2512;11;621690363;2512;285;3504;3506;7.11;0.43;249.02;3.59;992;11;1179.00;2
2517;11;621690374;2517;292;3504;3506;7.08;0.43;248.85;3.59;987;11;1180.00;2
2519;11;621690385;2519;287;3510;3512;7.10;0.43;249.02;3.59;991;11;1181.00;2
2522;11;621690396;2522;290;3511;3512;7.08;0.43;249.21;3.59;989;11;1182.00;1
2525;11;621690407;2525;291;3512;3513;7.05;0.43;249.24;3.59;987;11;1183.00;1
2528;11;621690418;2528;295;3512;3513;7.00;0.43;249.43;3.59;984;11;1184.00;1
2530;11;621690429;2530;293;3512;3513;7.06;0.43;249.45;3.59;982;11;1185.00;1
2536;11;621690439;2536;294;3512;3513;7.00;0.43;249.72;3.59;976;11;1186.00;1
2539;11;621690449;2539;295;3512;3513;6.96;0.42;249.85;3.59;973;11;1187.00;1
2545;11;621690460;2545;298;3523;3525;6.87;0.42;249.98;3.57;978;11;1188.00;2
2548;11;621690472;2548;305;3523;3525;6.80;0.41;250.13;3.57;975;11;1189.00;2
2551;11;621690482;2551;284;3523;3525;6.73;0.41;250.24;3.57;972;11;1190.00;2
2554;11;621690492;2554;290;3523;3525;6.71;0.41;250.34;3.57;969;11;1191.00;2
2557;11;621690503;2557;285;3524;3525;6.71;0.41;250.26;3.58;967;11;1192.00;1
2560;11;621690513;2560;283;3524;3525;6.71;0.41;250.43;3.58;964;11;1193.00;1
2564;11;621690524;2564;280;3528;3529;6.70;0.41;250.48;3.57;964;11;1194.00;1
2569;11;621690534;2569;281;3528;3529;6.71;0.41;250.51;3.57;959;11;1195.00;1
2573;11;621690545;2573;278;3531;3533;6.77;0.41;250.82;3.57;958;11;1196.00;2
2578;11;621690556;2578;268;3531;3534;6.83;0.42;251.15;3.57;953;11;1197.00;3
2580;11;621690567;2580;265;3533;3534;6.87;0.42;251.29;3.57;953;11;1198.00;1
2585;11;621690577;2585;260;3533;3534;6.95;0.42;251.67;3.57;948;11;1199.00;1
2588;11;621690590;2588;262;3560;3575;6.97;0.43;251.92;3.55;972;11;1200.00;15
2589;11;621690609;2589;259;3562;3575;7.04;0.43;251.95;3.55;973;11;1201.00;13
2595;11;621690620;2595;254;3565;3575;7.02;0.43;252.16;3.54;970;11;1202.00;10
2600;11;621690631;2600;254;3567;3576;6.97;0.43;252.40;3.54;967;11;1203.00;9
2602;11;621690642;2602;256;3568;3577;6.95;0.42;252.46;3.54;966;11;1204.00;9
2606;11;621690654;2606;256;3569;3577;6.95;0.42;252.73;3.54;963;11;1205.00;8
2608;11;621690665;2608;259;3572;3580;6.98;0.43;252.86;3.54;964;11;1206.00;8
2612;11;621690676;2612;259;3572;3580;7.00;0.43;253.21;3.54;960;11;1207.00;8
2618;11;621690687;2618;264;3575;3580;6.99;0.43;253.45;3.54;957;11;1208.00;5
2624;11;621690698;2624;264;3576;3580;6.93;0.42;253.65;3.55;952;11;1209.00;4
2627;11;621690709;2627;261;3582;3586;6.93;0.42;253.77;3.54;955;11;1210.00;4
2630;11;621690721;2630;269;3582;3586;6.98;0.43;253.87;3.54;952;11;1211.00;4
2635;11;621690732;2635;272;3582;3586;7.00;0.43;254.10;3.54;947;11;1212.00;4
2640;11;621690743;2640;280;3582;3586;7.03;0.43;254.45;3.54;942;11;1213.00;4
2642;11;621690754;2642;277;3587;3590;7.07;0.43;254.55;3.54;945;11;1214.00;3
2646;11;621690765;2646;270;3589;3592;7.11;0.44;254.83;3.54;943;11;1215.00;3
2648;11;621690776;2648;273;3589;3592;7.11;0.44;255.00;3.54;941;11;1216.00;3
2652;11;621690787;2652;279;3590;3593;7.08;0.44;255.15;3.54;938;11;1217.00;3
2655;11;621690798;2655;277;3590;3593;7.13;0.44;255.34;3.54;935;11;1218.00;3
2660;11;621690808;2660;281;3591;3593;7.11;0.44;255.66;3.54;931;11;1219.00;2
2663;11;621690820;2663;285;3591;3593;7.05;0.43;255.60;3.54;928;11;1220.00;2
2669;11;621690830;2669;288;3591;3593;6.93;0.43;255.70;3.54;922;11;1221.00;2
2672;11;621690842;2672;288;3591;3593;6.82;0.42;255.89;3.54;919;11;1222.00;2
2676;11;621690852;2676;298;3591;3593;6.71;0.41;255.86;3.54;915;11;1223.00;2
2680;11;621690863;2680;308;3632;3663;6.67;0.41;256.02;3.50;952;11;1224.00;31
2684;11;621690879;2684;309;3633;3664;6.70;0.41;256.00;3.51;949;11;1225.00;31
2689;11;621690890;2689;307;3641;3664;6.74;0.42;255.81;3.51;952;11;1226.00;23
2693;11;621690901;2693;307;3641;3664;6.80;0.42;256.07;3.51;948;11;1227.00;23
2694;11;621690919;2694;311;3644;3666;6.88;0.42;256.06;3.51;950;11;1228.00;22
2698;11;621690931;2698;312;3645;3666;6.87;0.42;256.01;3.51;947;11;1229.00;21
2702;11;621690943;2702;312;3647;3666;6.87;0.42;256.18;3.51;945;11;1230.00;19
2704;11;621690954;2704;319;3651;3666;6.87;0.42;256.20;3.52;947;11;1231.00;15
2708;11;621690965;2708;323;3652;3667;6.79;0.42;256.43;3.52;944;11;1232.00;15
2712;11;621690976;2712;328;3654;3668;6.69;0.41;256.38;3.52;942;11;1233.00;14
2717;11;621690988;2717;342;3655;3668;6.62;0.41;256.63;3.52;938;11;1234.00;13
2719;11;621691000;2719;354;3663;3672;6.56;0.40;256.85;3.53;944;11;1235.00;9
2722;11;621691011;2722;358;3666;3672;6.55;0.40;257.03;3.54;944;11;1236.00;6
2724;11;621691022;2724;356;3670;3672;6.51;0.40;257.19;3.55;946;11;1237.00;2
2727;11;621691034;2727;360;3672;3672;6.50;0.40;257.31;3.55;945;11;1238.00;0
2731;11;621691046;2731;353;3678;3678;6.50;0.40;257.51;3.54;947;11;1239.00;0
2736;11;621691059;2736;354;3678;3678;6.50;0.40;257.62;3.54;942;11;1240.00;0
2742;11;621691070;2742;351;3678;3678;6.51;0.40;257.60;3.54;936;11;1241.00;0
2744;11;621691081;2744;352;3680;3681;6.59;0.40;257.64;3.54;936;11;1242.00;1
2746;11;621691093;2746;352;3680;3681;6.63;0.41;257.61;3.54;934;11;1243.00;1
2750;11;621691104;2750;353;3681;3681;6.63;0.41;257.63;3.54;931;11;1244.00;0
2755;11;621691116;2755;357;3682;3682;6.60;0.40;257.65;3.54;927;11;1245.00;0
2759;11;621691136;2759;350;3683;3683;6.62;0.40;257.86;3.54;924;11;1246.00;0
2762;11;621691148;2762;340;3683;3683;6.68;0.41;257.86;3.54;921;11;1247.00;0
2765;11;621691161;2765;338;3696;3696;6.85;0.42;258.18;3.53;931;11;1248.00;0
2768;11;621691175;2768;330;3696;3696;6.87;0.42;258.15;3.53;928;11;1249.00;0
2770;11;621691187;2770;329;3696;3696;6.89;0.42;258.35;3.53;926;11;1250.00;0
2772;11;621691200;2772;326;3697;3697;6.94;0.42;258.31;3.53;925;11;1251.00;0
2775;11;621691213;2775;321;3697;3697;6.93;0.42;258.49;3.53;922;11;1252.00;0
2777;11;621691225;2777;322;3701;3701;6.98;0.42;258.52;3.52;924;11;1253.00;0
2779;11;621691237;2779;320;3701;3701;6.98;0.42;258.64;3.52;922;11;1254.00;0
2781;11;621691248;2781;330;3705;3705;6.97;0.42;258.56;3.52;924;11;1255.00;0
2785;11;621691260;2785;328;3705;3705;6.94;0.42;258.64;3.52;920;11;1256.00;0
2787;11;621691273;2787;327;3705;3705;6.93;0.42;258.78;3.52;918;11;1257.00;0
2789;11;621691289;2789;320;3705;3705;6.92;0.42;258.89;3.52;916;11;1258.00;0
2792;11;621691308;2792;320;3705;3705;6.93;0.42;258.72;3.52;913;11;1259.00;0
2793;11;621691331;2793;324;3733;3739;6.99;0.43;258.66;3.49;940;11;1260.00;6
2796;11;621691352;2796;327;3734;3739;7.05;0.43;258.58;3.49;938;11;1261.00;5
2796;11;621691372;2796;329;3736;3739;7.14;0.44;258.58;3.49;940;11;1262.00;3
2799;11;621691390;2799;329;3736;3739;7.15;0.44;258.49;3.49;937;11;1263.00;3
2801;11;621691402;2801;328;3737;3739;7.17;0.44;258.51;3.49;936;11;1264.00;2
2802;11;621691414;2802;329;3737;3739;7.18;0.44;258.43;3.49;935;11;1265.00;2
2803;11;621691426;2803;331;3737;3740;7.14;0.44;258.43;3.49;934;11;1266.00;3
2804;11;621691437;2804;336;3737;3740;7.12;0.43;258.38;3.49;933;11;1267.00;3
2808;11;621691449;2808;345;3742;3746;7.06;0.43;258.29;3.49;934;11;1268.00;4
2810;11;621691461;2810;341;3743;3747;7.01;0.43;258.21;3.49;933;11;1269.00;4
2810;11;621691475;2810;340;3743;3747;6.92;0.42;258.21;3.49;933;11;1270.00;4
2813;11;621691486;2813;340;3743;3747;6.82;0.41;258.18;3.49;930;11;1271.00;4
2814;11;621691497;2814;346;3746;3751;6.78;0.41;258.16;3.49;932;11;1272.00;5
2815;11;621691507;2815;351;3746;3751;6.70;0.41;258.26;3.49;931;11;1273.00;5
2820;11;621691518;2820;354;3746;3751;6.65;0.40;258.37;3.49;926;11;1274.00;5
2822;11;621691528;2822;357;3747;3752;6.65;0.40;258.23;3.48;925;11;1275.00;5
2824;11;621691539;2824;361;3750;3756;6.61;0.40;258.18;3.48;926;11;1276.00;6
2826;11;621691550;2826;363;3750;3756;6.55;0.40;258.21;3.48;924;11;1277.00;6
2826;11;621691560;2826;363;3752;3759;6.56;0.40;258.21;3.48;926;11;1278.00;7
2827;11;621691570;2827;362;3752;3759;6.49;0.39;258.26;3.48;925;11;1279.00;7
2830;11;621691581;2830;357;3753;3759;6.41;0.39;258.16;3.48;923;11;1280.00;6
2830;11;621691592;2830;353;3753;3759;6.41;0.39;258.16;3.48;923;11;1281.00;6
2832;11;621691603;2832;346;3757;3763;6.42;0.39;258.24;3.48;925;11;1282.00;6
2834;11;621691613;2834;331;3757;3763;6.43;0.39;258.26;3.48;923;11;1283.00;6
2837;11;621691624;2837;320;3757;3763;6.44;0.39;258.38;3.48;920;11;1284.00;6
2838;11;621691635;2838;307;3757;3763;6.42;0.39;258.41;3.48;919;11;1285.00;6
2839;11;621691650;2839;297;3757;3764;6.47;0.39;258.41;3.48;918;11;1286.00;7
2842;11;621691661;2842;287;3758;3765;6.51;0.39;258.27;3.48;916;11;1287.00;7
2844;11;621691672;2844;290;3758;3765;6.56;0.40;258.48;3.48;914;11;1288.00;7
2846;11;621691683;2846;278;3759;3766;6.62;0.40;258.52;3.48;913;11;1289.00;7
2847;11;621691713;2847;265;3759;3766;6.65;0.40;258.53;3.48;912;11;1290.00;7
2850;11;621691725;2850;255;3759;3766;6.66;0.40;258.69;3.48;909;11;1291.00;7
2851;11;621691736;2851;242;3759;3766;6.68;0.40;258.77;3.48;908;11;1292.00;7
2854;11;621691748;2854;232;3759;3766;6.77;0.41;258.90;3.48;905;11;1293.00;7
2856;11;621691760;2856;221;3760;3766;6.85;0.41;259.08;3.48;904;11;1294.00;6
2859;11;621691772;2859;211;3761;3766;6.94;0.42;259.31;3.49;902;11;1295.00;5
2860;11;621691784;2860;222;3825;3893;7.21;0.44;259.35;3.43;965;11;1296.00;68
2861;11;621691808;2861;209;3825;3894;7.26;0.45;259.42;3.43;964;11;1297.00;69
2863;11;621691821;2863;198;3833;3894;7.39;0.45;259.43;3.43;970;11;1298.00;61
2864;11;621691834;2864;187;3834;3894;7.42;0.46;259.44;3.43;970;11;1299.00;60
2868;11;621691846;2868;183;3839;3894;7.44;0.46;259.39;3.43;971;11;1300.00;55
2869;11;621691862;2869;169;3840;3894;7.48;0.46;259.40;3.43;971;11;1301.00;54
2869;11;621691874;2869;168;3843;3894;7.54;0.46;259.40;3.43;974;11;1302.00;51
2870;11;621691886;2870;168;3844;3894;7.56;0.46;259.41;3.43;974;11;1303.00;50
2872;11;621691904;2872;168;3849;3895;7.57;0.46;259.39;3.44;977;11;1304.00;46
2875;11;621691916;2875;167;3855;3897;7.63;0.47;259.47;3.45;980;11;1305.00;42
2877;11;621691928;2877;162;3858;3897;7.73;0.47;259.37;3.45;981;11;1306.00;39
2882;11;621691940;2882;167;3862;3898;7.80;0.47;259.42;3.46;980;11;1307.00;36
2885;11;621691951;2885;166;3865;3898;7.85;0.48;259.54;3.47;980;11;1308.00;33
2887;11;621691964;2887;161;3869;3898;7.86;0.48;259.61;3.48;982;11;1309.00;29
2891;11;621691976;2891;160;3874;3898;7.83;0.48;259.46;3.49;983;11;1310.00;24
2892;11;621691987;2892;162;3877;3902;7.81;0.48;259.40;3.49;985;11;1311.00;25
2893;11;621691999;2893;163;3880;3902;7.79;0.47;259.32;3.50;987;11;1312.00;22
2894;11;621692012;2894;165;3883;3902;7.82;0.48;259.50;3.52;989;11;1313.00;19
2898;11;621692025;2898;172;3884;3905;7.84;0.48;259.54;3.51;986;11;1314.00;21
2902;11;621692037;2902;167;3885;3905;7.85;0.48;259.74;3.52;983;11;1315.00;20
2905;11;621692050;2905;168;3888;3905;7.85;0.48;259.78;3.52;983;11;1316.00;17
2906;11;621692062;2906;175;3893;3909;7.86;0.48;259.93;3.54;987;11;1317.00;16
2910;11;621692074;2910;187;3894;3910;7.90;0.48;259.92;3.54;984;11;1318.00;16
2913;11;621692086;2913;184;3896;3910;7.85;0.48;259.86;3.54;983;11;1319.00;14
2917;11;621692100;2917;196;3902;3915;7.80;0.47;260.09;3.56;985;11;1320.00;13
2917;11;621692113;2917;199;3902;3915;7.80;0.47;260.09;3.56;985;11;1321.00;13
2918;11;621692124;2918;200;3903;3915;7.73;0.47;260.26;3.56;985;11;1322.00;12
2919;11;621692136;2919;205;3906;3916;7.71;0.47;260.24;3.58;987;11;1323.00;10
2919;11;621692149;2919;208;3906;3916;7.72;0.47;260.24;3.58;987;11;1324.00;10
2920;11;621692160;2920;214;3912;3922;7.74;0.47;260.25;3.57;992;11;1325.00;10
2920;11;621692173;2920;215;3913;3922;7.74;0.47;260.25;3.58;993;11;1326.00;9
2921;11;621692185;2921;224;3913;3923;7.75;0.47;260.19;3.58;992;11;1327.00;10
2923;11;621692196;2923;225;3913;3923;7.72;0.47;260.36;3.58;990;11;1328.00;10
2926;11;621692208;2926;223;3914;3923;7.70;0.47;260.42;3.59;988;11;1329.00;9
2926;11;621692220;2926;231;3914;3923;7.65;0.47;260.42;3.59;988;11;1330.00;9
2929;11;621692231;2929;236;3914;3923;7.64;0.47;260.52;3.59;985;11;1331.00;9
2933;11;621692243;2933;234;3927;3935;7.67;0.47;260.59;3.60;994;11;1332.00;8
2934;11;621692256;2934;235;3927;3935;7.64;0.47;260.58;3.60;993;11;1333.00;8
2937;11;621692268;2937;242;3929;3935;7.63;0.46;260.58;3.61;992;11;1334.00;6
2941;11;621692281;2941;245;3930;3935;7.58;0.46;260.83;3.62;989;11;1335.00;5
2944;11;621692293;2944;249;3931;3935;7.59;0.46;261.05;3.63;987;11;1336.00;4
2945;11;621692305;2945;251;3932;3935;7.53;0.46;261.03;3.63;987;11;1337.00;3
2948;11;621692317;2948;257;3936;3939;7.46;0.46;261.07;3.63;988;11;1338.00;3
2950;11;621692329;2950;255;3936;3939;7.43;0.45;261.12;3.63;986;11;1339.00;3
2952;11;621692340;2952;246;3943;3943;7.51;0.46;261.32;3.63;991;11;1340.00;0
2954;11;621692351;2954;246;3944;3944;7.50;0.46;261.41;3.63;990;11;1341.00;0
2957;11;621692363;2957;239;3944;3944;7.47;0.46;261.49;3.63;987;11;1342.00;0
2959;11;621692373;2959;237;3944;3944;7.45;0.46;261.62;3.63;985;11;1343.00;0
2961;11;621692384;2961;237;3956;3957;7.50;0.46;261.67;3.62;995;11;1344.00;1
2965;11;621692396;2965;232;3957;3957;7.45;0.46;261.76;3.62;992;11;1345.00;0
2969;11;621692407;2969;232;3957;3957;7.47;0.46;261.89;3.62;988;11;1346.00;0
2972;11;621692418;2972;230;3958;3958;7.51;0.46;261.74;3.62;986;11;1347.00;0
2973;11;621692429;2973;230;3959;3959;7.54;0.46;261.80;3.62;986;11;1348.00;0
2975;11;621692440;2975;230;3959;3959;7.56;0.46;261.75;3.62;984;11;1349.00;0
2977;11;621692452;2977;229;3966;3968;7.58;0.46;261.89;3.61;989;11;1350.00;2
2980;11;621692463;2980;233;3966;3968;7.62;0.47;262.07;3.61;986;11;1351.00;2
2983;11;621692475;2983;231;3967;3968;7.61;0.47;262.15;3.61;984;11;1352.00;1
2988;11;621692485;2988;234;3967;3968;7.51;0.46;262.26;3.61;979;11;1353.00;1
2993;11;621692496;2993;237;3973;3974;7.46;0.46;262.44;3.61;980;11;1354.00;1
2997;11;621692508;2997;237;3974;3974;7.36;0.45;262.75;3.61;977;11;1355.00;0
3000;11;621692518;3000;237;3974;3974;7.28;0.45;262.83;3.61;974;11;1356.00;0
3008;11;621692529;3008;233;3974;3974;7.18;0.44;263.08;3.61;966;11;1357.00;0
3011;11;621692539;3011;236;3978;3978;7.10;0.43;263.11;3.61;967;11;1358.00;0
3016;11;621692549;3016;241;3979;3979;6.99;0.43;263.37;3.61;963;11;1359.00;0
3022;11;621692560;3022;230;3979;3979;6.95;0.43;263.54;3.61;957;11;1360.00;0
3027;11;621692570;3027;231;3980;3980;6.94;0.43;263.42;3.61;953;11;1361.00;0
3033;11;621692581;3033;224;3980;3980;6.96;0.43;263.57;3.61;947;11;1362.00;0
3039;11;621692592;3039;225;3980;3980;7.04;0.43;263.62;3.61;941;11;1363.00;0
3043;11;621692603;3043;227;3980;3980;7.11;0.43;263.77;3.61;937;11;1364.00;0
3048;11;621692613;3048;227;3980;3980;7.13;0.44;263.83;3.61;932;11;1365.00;0
3050;11;621692624;3050;223;3980;3980;7.17;0.44;263.84;3.61;930;11;1366.00;0
3055;11;621692634;3055;225;3980;3980;7.13;0.44;263.95;3.61;925;11;1367.00;0
3062;11;621692644;3062;232;4017;4050;7.26;0.44;264.21;3.57;955;11;1368.00;33
3066;11;621692660;3066;224;4021;4051;7.31;0.45;264.21;3.57;955;11;1369.00;30
3069;11;621692671;3069;220;4026;4051;7.33;0.45;264.18;3.57;957;11;1370.00;25
3073;11;621692682;3073;225;4028;4051;7.27;0.44;264.37;3.57;955;11;1371.00;23
3077;11;621692693;3077;221;4031;4051;7.28;0.45;264.52;3.57;954;11;1372.00;20
3080;11;621692703;3080;227;4032;4051;7.25;0.44;264.70;3.57;952;11;1373.00;19
3083;11;621692714;3083;230;4035;4051;7.24;0.44;264.70;3.57;952;11;1374.00;16
3087;11;621692724;3087;235;4038;4051;7.12;0.44;264.71;3.57;951;11;1375.00;13
3092;11;621692735;3092;232;4041;4052;7.04;0.43;264.73;3.58;949;11;1376.00;11
3097;11;621692745;3097;235;4044;4053;6.98;0.43;264.78;3.58;947;11;1377.00;9
3099;11;621692762;3099;241;4047;4053;6.84;0.42;264.81;3.58;948;11;1378.00;6
3106;11;621692773;3106;251;4051;4057;6.78;0.41;265.02;3.58;945;11;1379.00;6
3108;11;621692786;3108;254;4053;4057;6.72;0.41;265.01;3.59;945;11;1380.00;4
3113;11;621692796;3113;263;4053;4057;6.63;0.41;265.18;3.59;940;11;1381.00;4
3118;11;621692807;3118;271;4053;4057;6.58;0.40;265.35;3.59;935;11;1382.00;4
3121;11;621692818;3121;273;4059;4063;6.62;0.41;265.41;3.58;938;11;1383.00;4
3126;11;621692829;3126;281;4059;4063;6.60;0.40;265.62;3.58;933;11;1384.00;4
3128;11;621692841;3128;285;4059;4063;6.59;0.40;265.65;3.58;931;11;1385.00;4
3132;11;621692851;3132;292;4061;4066;6.54;0.40;266.10;3.58;929;11;1386.00;5
3139;11;621692862;3139;300;4065;4066;6.48;0.40;266.15;3.59;926;11;1387.00;1
3142;11;621692872;3142;303;4065;4066;6.44;0.39;266.28;3.59;923;11;1388.00;1
3146;11;621692883;3146;309;4066;4067;6.40;0.39;266.51;3.59;920;11;1389.00;1
3149;11;621692894;3149;311;4068;4068;6.35;0.39;266.60;3.59;919;11;1390.00;0
3151;11;621692905;3151;321;4068;4068;6.30;0.39;266.77;3.59;917;11;1391.00;0
3155;11;621692915;3155;320;4081;4081;6.34;0.39;266.88;3.58;926;11;1392.00;0
3160;11;621692926;3160;325;4081;4081;6.28;0.38;266.84;3.58;921;11;1393.00;0
3162;11;621692937;3162;328;4081;4081;6.24;0.38;266.87;3.58;919;11;1394.00;0
3167;11;621692947;3167;330;4083;4083;6.14;0.38;266.75;3.58;916;11;1395.00;0
3169;11;621692958;3169;335;4083;4083;6.09;0.37;266.74;3.58;914;11;1396.00;0
3173;11;621692968;3173;345;4087;4087;6.02;0.37;266.92;3.58;914;11;1397.00;0
3173;11;621692979;3173;349;4087;4087;6.00;0.37;266.92;3.58;914;11;1398.00;0
3180;11;621692989;3180;352;4091;4091;5.94;0.36;267.25;3.57;911;11;1399.00;0
3182;11;621693001;3182;358;4091;4091;5.93;0.36;267.31;3.57;909;11;1400.00;0
3188;11;621693015;3188;360;4091;4091;5.87;0.36;267.36;3.57;903;11;1401.00;0
3190;11;621693025;3190;364;4091;4091;5.89;0.36;267.42;3.57;901;11;1402.00;0
3195;11;621693035;3195;372;4091;4091;5.87;0.36;267.52;3.57;896;11;1403.00;0
3196;11;621693045;3196;371;4101;4103;6.02;0.37;267.54;3.56;905;11;1404.00;2
3199;11;621693055;3199;378;4102;4103;6.02;0.37;267.55;3.56;903;11;1405.00;1
3201;11;621693066;3201;385;4103;4103;5.96;0.37;267.64;3.56;902;11;1406.00;0
3203;11;621693075;3203;379;4103;4103;5.90;0.36;267.66;3.56;900;11;1407.00;0
3209;11;621693085;3209;373;4103;4103;5.88;0.36;267.84;3.56;894;11;1408.00;0
3212;11;621693095;3212;371;4103;4103;5.86;0.36;267.82;3.56;891;11;1409.00;0
3218;11;621693106;3218;366;4104;4104;5.84;0.36;267.84;3.56;886;11;1410.00;0
3218;11;621693117;3218;367;4104;4104;5.88;0.36;267.84;3.56;886;11;1411.00;0
3222;11;621693126;3222;366;4110;4110;5.94;0.36;267.80;3.56;888;11;1412.00;0
3223;11;621693137;3223;370;4111;4111;5.97;0.37;267.82;3.56;888;11;1413.00;0
3226;11;621693147;3226;365;4111;4111;5.97;0.37;267.77;3.56;885;11;1414.00;0
3228;11;621693156;3228;366;4111;4111;5.97;0.37;267.69;3.56;883;11;1415.00;0
3230;11;621693166;3230;358;4115;4115;6.07;0.37;267.83;3.55;885;11;1416.00;0
3232;11;621693176;3232;348;4115;4115;6.16;0.38;267.75;3.55;883;11;1417.00;0
3235;11;621693187;3235;345;4115;4115;6.22;0.38;267.77;3.55;880;11;1418.00;0
3238;11;621693197;3238;341;4116;4116;6.35;0.39;267.84;3.55;878;11;1419.00;0
3238;11;621693214;3238;342;4120;4120;6.42;0.39;267.84;3.55;882;11;1420.00;0
3241;11;621693224;3241;338;4120;4120;6.45;0.39;267.74;3.55;879;11;1421.00;0
3243;11;621693234;3243;338;4122;4123;6.55;0.40;267.69;3.55;879;11;1422.00;1
3247;11;621693245;3247;342;4122;4123;6.58;0.40;267.64;3.55;875;11;1423.00;1
3247;11;621693255;3247;347;4123;4123;6.58;0.40;267.64;3.55;876;11;1424.00;0
3250;11;621693265;3250;348;4123;4123;6.60;0.40;267.84;3.55;873;11;1425.00;0
3252;11;621693280;3252;348;4127;4127;6.68;0.41;267.81;3.55;875;11;1426.00;0
3254;11;621693297;3254;348;4127;4127;6.69;0.41;267.80;3.55;873;11;1427.00;0
3255;11;621693312;3255;347;4127;4127;6.74;0.41;267.79;3.55;872;11;1428.00;0
3255;11;621693331;3255;353;4127;4127;6.80;0.41;267.79;3.55;872;11;1429.00;0
3257;11;621693347;3257;352;4128;4128;6.81;0.41;267.74;3.55;871;11;1430.00;0
3261;11;621693363;3261;349;4129;4129;6.83;0.41;267.76;3.55;868;11;1431.00;0
3261;11;621693378;3261;349;4129;4129;6.82;0.41;267.76;3.55;868;11;1432.00;0
3262;11;621693391;3262;343;4130;4130;6.81;0.41;267.81;3.55;868;11;1433.00;0
3264;11;621693403;3264;343;4130;4130;6.75;0.41;267.86;3.55;866;11;1434.00;0
3265;11;621693415;3265;334;4130;4130;6.76;0.41;267.89;3.55;865;11;1435.00;0
3267;11;621693426;3267;327;4130;4130;6.78;0.41;267.89;3.55;863;11;1436.00;0
3268;11;621693438;3268;325;4130;4130;6.79;0.41;267.92;3.55;862;11;1437.00;0
3271;11;621693449;3271;312;4130;4130;6.78;0.41;267.90;3.55;859;11;1438.00;0
3272;11;621693461;3272;306;4130;4130;6.81;0.41;267.90;3.55;858;11;1439.00;0
3274;11;621693475;3274;359;4255;4360;6.89;0.43;268.08;3.44;981;11;1440.00;105
3274;11;621693506;3274;349;4258;4361;6.94;0.43;268.08;3.44;984;11;1441.00;103
3276;11;621693525;3276;337;4268;4361;7.01;0.44;268.12;3.44;992;11;1442.00;93
3278;11;621693538;3278;324;4274;4361;7.06;0.44;268.05;3.44;996;11;1443.00;87
3278;12;621693549;3278;321;4280;4361;7.10;0.44;268.05;3.44;1002;12;1444.00;81
3278;12;621693586;3278;316;4284;4361;7.10;0.44;268.05;3.44;1006;12;1445.00;77
3278;12;621693605;3278;307;4291;4361;7.16;0.44;268.05;3.44;1013;12;1446.00;70
3280;12;621693616;3280;305;4297;4361;7.20;0.45;268.03;3.45;1017;12;1447.00;64
3282;12;621693635;3282;309;4303;4362;7.23;0.45;268.10;3.45;1021;12;1448.00;59
3282;12;621693648;3282;314;4306;4363;7.26;0.45;268.10;3.46;1024;12;1449.00;57
3283;12;621693660;3283;313;4309;4363;7.27;0.45;268.15;3.46;1026;12;1450.00;54
3285;12;621693672;3285;310;4314;4364;7.24;0.45;268.25;3.47;1029;12;1451.00;50
3285;12;621693684;3285;309;4315;4364;7.28;0.45;268.25;3.47;1030;12;1452.00;49
3287;12;621693696;3287;310;4318;4364;7.25;0.45;268.35;3.48;1031;12;1453.00;46
3289;12;621693709;3289;310;4320;4364;7.18;0.44;268.33;3.48;1031;12;1454.00;44
3292;12;621693721;3292;311;4324;4368;7.14;0.44;268.32;3.49;1032;12;1455.00;44
3294;12;621693734;3294;305;4324;4368;7.13;0.44;268.45;3.49;1030;12;1456.00;44
3299;12;621693747;3299;310;4325;4368;7.05;0.43;268.42;3.49;1026;12;1457.00;43
3302;12;621693759;3302;306;4326;4371;7.02;0.43;268.51;3.49;1024;12;1458.00;45
3304;12;621693772;3304;307;4327;4371;7.03;0.43;268.66;3.49;1023;12;1459.00;44
3307;12;621693784;3307;304;4327;4371;7.01;0.43;268.68;3.49;1020;12;1460.00;44
3309;12;621693796;3309;303;4330;4375;6.98;0.43;268.82;3.49;1021;12;1461.00;45
3310;12;621693808;3310;297;4331;4376;6.96;0.43;268.79;3.49;1021;12;1462.00;45
3314;12;621693822;3314;297;4335;4376;6.96;0.43;268.92;3.51;1021;12;1463.00;41
3314;12;621693835;3314;298;4337;4380;6.96;0.43;268.92;3.51;1023;12;1464.00;43
3317;12;621693848;3317;294;4342;4380;6.98;0.43;268.96;3.53;1025;12;1465.00;38
3317;12;621693859;3317;288;4343;4380;7.09;0.43;268.96;3.53;1026;12;1466.00;37
3319;12;621693871;3319;283;4343;4381;7.11;0.44;269.07;3.53;1024;12;1467.00;38
3323;12;621693884;3323;277;4343;4381;7.14;0.44;269.12;3.53;1020;12;1468.00;38
3326;12;621693897;3326;273;4348;4387;7.21;0.44;269.12;3.54;1022;12;1469.00;39
3330;12;621693913;3330;266;4349;4387;7.28;0.44;269.03;3.55;1019;12;1470.00;38
3334;12;621693931;3334;259;4350;4388;7.35;0.45;269.18;3.56;1016;12;1471.00;38
3337;12;621693944;3337;255;4350;4388;7.45;0.45;269.10;3.56;1013;12;1472.00;38
3339;12;621693969;3339;249;4351;4388;7.57;0.46;269.03;3.56;1012;12;1473.00;37
3344;12;621693983;3344;251;4352;4388;7.68;0.47;269.05;3.57;1008;12;1474.00;36
3345;12;621693995;3345;248;4353;4388;7.78;0.47;269.00;3.57;1008;12;1475.00;35
3346;12;621694008;3346;254;4363;4400;7.89;0.48;269.00;3.57;1017;12;1476.00;37
3350;12;621694021;3350;257;4366;4400;7.88;0.48;269.06;3.59;1016;12;1477.00;34
3352;12;621694034;3352;255;4367;4400;7.88;0.48;269.25;3.59;1015;12;1478.00;33
3353;12;621694046;3353;257;4368;4400;7.87;0.48;269.35;3.59;1015;12;1479.00;32
3360;12;621694058;3360;254;4371;4400;7.78;0.47;269.45;3.61;1011;12;1480.00;29
3360;12;621694071;3360;254;4372;4400;7.73;0.47;269.45;3.61;1012;12;1481.00;28
3362;12;621694083;3362;254;4376;4404;7.71;0.47;269.53;3.62;1014;12;1482.00;28
3364;12;621694102;3364;256;4376;4404;7.71;0.47;269.56;3.62;1012;12;1483.00;28
3365;12;621694120;3365;258;4382;4408;7.71;0.47;269.63;3.64;1017;12;1484.00;26
3367;12;621694133;3367;259;4384;4410;7.69;0.47;269.68;3.64;1017;12;1485.00;26
3368;12;621694146;3368;260;4387;4410;7.69;0.47;269.85;3.65;1019;12;1486.00;23
3375;12;621694158;3375;270;4387;4410;7.61;0.46;269.91;3.65;1012;12;1487.00;23
3377;12;621694171;3377;273;4397;4423;7.61;0.46;270.03;3.65;1020;12;1488.00;26
3378;12;621694184;3378;275;4397;4423;7.56;0.46;270.19;3.65;1019;12;1489.00;26
3382;12;621694203;3382;284;4399;4423;7.49;0.46;270.37;3.67;1017;12;1490.00;24
3386;12;621694216;3386;286;4401;4424;7.41;0.45;270.32;3.68;1015;12;1491.00;23
3387;12;621694229;3387;290;4403;4425;7.41;0.45;270.42;3.71;1016;12;1492.00;22
3389;12;621694241;3389;295;4404;4425;7.41;0.45;270.39;3.72;1015;12;1493.00;21
3390;12;621694254;3390;300;4407;4428;7.39;0.45;270.53;3.73;1017;12;1494.00;21
3392;12;621694268;3392;306;4409;4428;7.40;0.45;270.71;3.75;1017;12;1495.00;19
3394;12;621694283;3394;317;4413;4428;7.37;0.45;270.63;3.79;1019;12;1496.00;15
3397;12;621694296;3397;319;4415;4428;7.34;0.45;270.86;3.80;1018;12;1497.00;13
3398;12;621694308;3398;329;4422;4434;7.36;0.45;270.80;3.81;1024;12;1498.00;12
3401;12;621694321;3401;328;4423;4434;7.35;0.45;270.82;3.83;1022;12;1499.00;11
3404;12;621694336;3404;332;4429;4453;7.33;0.45;271.03;3.83;1025;12;1500.00;24
3406;12;621694356;3406;331;4430;4453;7.30;0.45;271.18;3.84;1024;12;1501.00;23
3409;12;621694368;3409;334;4434;4457;7.23;0.44;271.20;3.84;1025;12;1502.00;23
3411;12;621694379;3411;335;4435;4458;7.28;0.44;271.21;3.84;1024;12;1503.00;23
3417;12;621694391;3417;336;4438;4458;7.24;0.44;271.32;3.86;1021;12;1504.00;20
3421;12;621694403;3421;335;4441;4459;7.24;0.44;271.40;3.86;1020;12;1505.00;18
3422;12;621694415;3422;337;4443;4459;7.20;0.44;271.56;3.86;1021;12;1506.00;16
3424;12;621694426;3424;335;4445;4459;7.18;0.44;271.55;3.87;1021;12;1507.00;14
3429;12;621694438;3429;340;4445;4459;7.11;0.43;271.64;3.87;1016;12;1508.00;14
3431;12;621694449;3431;346;4447;4459;7.05;0.43;271.77;3.87;1016;12;1509.00;12
3434;12;621694460;3434;345;4448;4459;7.04;0.43;271.79;3.87;1014;12;1510.00;11
3438;12;621694472;3438;334;4448;4459;7.03;0.43;271.90;3.87;1010;12;1511.00;11
3439;12;621694484;3439;334;4483;4529;7.05;0.43;272.03;3.85;1044;12;1512.00;46
3442;12;621694501;3442;332;4491;4530;7.09;0.43;271.91;3.85;1049;12;1513.00;39
3444;12;621694513;3444;326;4497;4530;7.12;0.44;271.90;3.84;1053;12;1514.00;33
3449;12;621694525;3449;324;4500;4530;7.07;0.43;272.03;3.84;1051;12;1515.00;30
3450;12;621694537;3450;323;4504;4530;7.13;0.44;272.05;3.84;1054;12;1516.00;26
3456;12;621694548;3456;317;4505;4530;7.15;0.44;272.32;3.85;1049;12;1517.00;25
3462;12;621694560;3462;320;4508;4530;7.17;0.44;272.17;3.85;1046;12;1518.00;22
3463;12;621694572;3463;320;4511;4530;7.19;0.44;272.18;3.85;1048;12;1519.00;19
3466;12;621694584;3466;324;4514;4531;7.17;0.44;272.15;3.86;1048;12;1520.00;17
3469;12;621694595;3469;326;4517;4532;7.16;0.44;272.37;3.86;1048;12;1521.00;15
3470;12;621694607;3470;325;4519;4532;7.14;0.44;272.36;3.86;1049;12;1522.00;13
3474;12;621694618;3474;332;4523;4536;7.01;0.43;272.46;3.86;1049;12;1523.00;13
3481;12;621694630;3481;334;4523;4536;6.91;0.42;272.56;3.86;1042;12;1524.00;13
3482;12;621694641;3482;341;4523;4536;6.86;0.42;272.57;3.86;1041;12;1525.00;13
3487;12;621694652;3487;344;4523;4536;6.70;0.41;272.51;3.86;1036;12;1526.00;13
3490;12;621694664;3490;354;4527;4542;6.64;0.41;272.50;3.86;1037;12;1527.00;15
3492;12;621694676;3492;363;4529;4542;6.54;0.40;272.49;3.87;1037;12;1528.00;13
3497;12;621694687;3497;372;4529;4542;6.39;0.39;272.54;3.87;1032;12;1529.00;13
3499;12;621694699;3499;363;4532;4548;6.39;0.39;272.48;3.87;1033;12;1530.00;16
3502;12;621694711;3502;361;4533;4548;6.38;0.39;272.43;3.88;1031;12;1531.00;15
3506;12;621694722;3506;356;4533;4548;6.33;0.39;272.38;3.88;1027;12;1532.00;15
3508;12;621694733;3508;353;4536;4549;6.34;0.39;272.58;3.88;1028;12;1533.00;13
3510;12;621694744;3510;356;4538;4550;6.34;0.39;272.62;3.89;1028;12;1534.00;12
3518;12;621694755;3518;353;4539;4550;6.31;0.39;272.92;3.89;1021;12;1535.00;11
3521;12;621694767;3521;361;4551;4563;6.37;0.39;272.94;3.89;1030;12;1536.00;12
3527;12;621694779;3527;354;4553;4563;6.34;0.39;273.10;3.89;1026;12;1537.00;10
3531;12;621694790;3531;347;4555;4563;6.36;0.39;273.29;3.90;1024;12;1538.00;8
3534;12;621694802;3534;342;4556;4564;6.33;0.39;273.41;3.90;1022;12;1539.00;8
3537;12;621694819;3537;347;4560;4564;6.28;0.38;273.46;3.92;1023;12;1540.00;4
3541;12;621694831;3541;344;4564;4568;6.27;0.38;273.54;3.91;1023;12;1541.00;4
3547;12;621694846;3547;349;4566;4568;6.21;0.38;273.68;3.92;1019;12;1542.00;2
3550;12;621694860;3550;349;4570;4572;6.19;0.38;273.76;3.91;1020;12;1543.00;2
3558;12;621694872;3558;356;4570;4572;6.08;0.37;273.70;3.91;1012;12;1544.00;2
3563;12;621694884;3563;356;4571;4572;6.05;0.37;273.90;3.91;1008;12;1545.00;1
3566;12;621694895;3566;359;4572;4572;6.02;0.37;273.95;3.91;1006;12;1546.00;0
3569;12;621694906;3569;360;4572;4572;5.99;0.36;273.91;3.91;1003;12;1547.00;0
3571;12;621694917;3571;366;4582;4584;6.02;0.37;273.94;3.91;1011;12;1548.00;2
3574;12;621694929;3574;374;4583;4584;5.95;0.36;274.05;3.91;1009;12;1549.00;1
3575;12;621694940;3575;371;4584;4584;5.94;0.36;274.12;3.90;1009;12;1550.00;0
3576;12;621694951;3576;378;4584;4584;5.90;0.36;274.18;3.90;1008;12;1551.00;0
3579;12;621694961;3579;371;4584;4584;5.86;0.36;274.25;3.90;1005;12;1552.00;0
3581;12;621694973;3581;381;4584;4584;5.75;0.35;274.27;3.90;1003;12;1553.00;0
3583;12;621694983;3583;384;4585;4585;5.65;0.35;274.28;3.90;1002;12;1554.00;0
3585;12;621694994;3585;391;4587;4587;5.57;0.34;274.29;3.90;1002;12;1555.00;0
3592;12;621695004;3592;397;4593;4593;5.46;0.33;274.17;3.90;1001;12;1556.00;0
3595;12;621695016;3595;400;4594;4594;5.41;0.33;274.13;3.90;999;12;1557.00;0
3600;12;621695027;3600;403;4594;4594;5.32;0.33;274.17;3.90;994;12;1558.00;0
3601;12;621695038;3601;407;4594;4594;5.30;0.32;274.21;3.90;993;12;1559.00;0
3606;12;621695050;3606;416;4599;4599;5.25;0.32;274.25;3.89;993;12;1560.00;0
3610;12;621695062;3610;417;4599;4599;5.22;0.32;274.13;3.89;989;12;1561.00;0
3614;12;621695073;3614;425;4599;4599;5.18;0.32;274.23;3.89;985;12;1562.00;0
3618;12;621695084;3618;436;4600;4600;5.17;0.32;274.22;3.89;982;12;1563.00;0
3623;12;621695096;3623;438;4604;4604;5.22;0.32;274.19;3.89;981;12;1564.00;0
3627;12;621695108;3627;441;4604;4604;5.18;0.32;274.18;3.89;977;12;1565.00;0
3628;12;621695118;3628;452;4606;4607;5.16;0.32;274.11;3.89;978;12;1566.00;1
3630;12;621695129;3630;451;4606;4607;5.08;0.31;274.04;3.89;976;12;1567.00;1
3630;12;621695139;3630;457;4607;4607;5.08;0.31;274.04;3.89;977;12;1568.00;0
3632;12;621695150;3632;463;4607;4607;4.98;0.31;274.01;3.89;975;12;1569.00;0
3634;12;621695160;3634;461;4611;4611;4.95;0.30;273.93;3.89;977;12;1570.00;0
3637;12;621695170;3637;467;4611;4611;4.91;0.30;273.80;3.89;974;12;1571.00;0
3639;12;621695180;3639;467;4611;4611;4.82;0.30;273.71;3.89;972;12;1572.00;0
3642;12;621695190;3642;471;4611;4611;4.73;0.29;273.67;3.89;969;12;1573.00;0
3644;12;621695200;3644;472;4612;4612;4.67;0.29;273.61;3.89;968;12;1574.00;0
3647;12;621695215;3647;478;4614;4614;4.64;0.28;273.48;3.88;967;12;1575.00;0
3649;12;621695225;3649;478;4614;4614;4.57;0.28;273.45;3.88;965;12;1576.00;0
3650;12;621695235;3650;470;4615;4615;4.53;0.28;273.42;3.88;965;12;1577.00;0
3651;12;621695245;3651;471;4615;4615;4.50;0.28;273.45;3.88;964;12;1578.00;0
3651;12;621695255;3651;471;4615;4615;4.49;0.28;273.45;3.88;964;12;1579.00;0
3654;12;621695264;3654;477;4615;4615;4.56;0.28;273.47;3.88;961;12;1580.00;0
3655;12;621695274;3655;469;4615;4615;4.65;0.29;273.48;3.88;960;12;1581.00;0
3658;12;621695296;3658;470;4615;4615;4.71;0.29;273.45;3.88;957;12;1582.00;0
3659;12;621695315;3659;471;4615;4615;4.80;0.29;273.45;3.88;956;12;1583.00;0
3660;12;621695333;3660;485;4687;4742;5.27;0.33;273.45;3.82;1027;12;1584.00;55
3662;12;621695363;3662;479;4690;4743;5.41;0.34;273.51;3.82;1028;12;1585.00;53
3663;12;621695382;3663;455;4699;4743;5.61;0.35;273.44;3.82;1036;12;1586.00;44
3664;12;621695397;3664;423;4701;4743;5.78;0.36;273.46;3.82;1037;12;1587.00;42
3664;12;621695411;3664;406;4708;4743;6.00;0.37;273.46;3.82;1044;12;1588.00;35
3669;12;621695423;3669;389;4709;4743;6.10;0.38;273.54;3.82;1040;12;1589.00;34
3670;12;621695441;3670;378;4712;4743;6.25;0.38;273.51;3.82;1042;12;1590.00;31
3671;12;621695469;3671;372;4715;4743;6.43;0.40;273.53;3.82;1044;12;1591.00;28
3673;12;621695483;3673;367;4718;4744;6.54;0.40;273.57;3.83;1045;12;1592.00;26
3675;12;621695504;3675;362;4723;4745;6.66;0.41;273.55;3.83;1048;12;1593.00;22
3676;12;621695525;3676;363;4726;4745;6.76;0.41;273.55;3.83;1050;12;1594.00;19
3676;12;621695546;3676;360;4729;4746;6.80;0.42;273.55;3.84;1053;12;1595.00;17
3678;12;621695559;3678;361;4731;4746;6.80;0.42;273.51;3.84;1053;12;1596.00;15
3678;12;621695574;3678;359;4733;4746;6.86;0.42;273.51;3.85;1055;12;1597.00;13
3679;12;621695590;3679;363;4734;4746;6.88;0.42;273.48;3.85;1055;12;1598.00;12
3679;12;621695604;3679;370;4739;4750;6.92;0.42;273.48;3.85;1060;12;1599.00;11
3679;12;621695619;3679;375;4740;4750;6.95;0.42;273.48;3.85;1061;12;1600.00;10
3683;12;621695637;3683;374;4741;4750;6.93;0.42;273.58;3.86;1058;12;1601.00;9
3683;12;621695652;3683;371;4743;4753;6.96;0.42;273.58;3.86;1060;12;1602.00;10
3684;12;621695665;3684;374;4744;4753;6.97;0.42;273.55;3.86;1060;12;1603.00;9
3685;12;621695679;3685;374;4745;4753;7.00;0.43;273.57;3.86;1060;12;1604.00;8
3685;12;621695692;3685;372;4749;4757;7.03;0.43;273.57;3.86;1064;12;1605.00;8
3687;12;621695706;3687;366;4751;4758;6.99;0.43;273.47;3.86;1064;12;1606.00;7
3691;12;621695719;3691;359;4751;4758;6.96;0.42;273.47;3.86;1060;12;1607.00;7
3692;12;621695732;3692;358;4754;4762;6.93;0.42;273.48;3.86;1062;12;1608.00;8
3697;12;621695746;3697;356;4755;4762;6.88;0.42;273.56;3.86;1058;12;1609.00;7
3698;12;621695760;3698;359;4755;4762;6.91;0.42;273.59;3.86;1057;12;1610.00;7
3699;12;621695773;3699;355;4756;4763;6.94;0.42;273.56;3.86;1057;12;1611.00;7
3701;12;621695793;3701;349;4756;4763;6.99;0.42;273.71;3.86;1055;12;1612.00;7
3703;12;621695806;3703;344;4761;4769;6.98;0.42;273.85;3.86;1058;12;1613.00;8
3705;12;621695822;3705;341;4761;4769;6.98;0.42;273.80;3.86;1056;12;1614.00;8
3705;12;621695835;3705;342;4761;4770;6.94;0.42;273.80;3.86;1056;12;1615.00;9
3707;12;621695849;3707;345;4761;4770;6.91;0.42;273.90;3.86;1054;12;1616.00;9
3708;12;621695862;3708;339;4761;4770;6.95;0.42;273.98;3.86;1053;12;1617.00;9
3712;12;621695875;3712;339;4761;4770;6.92;0.42;274.05;3.86;1049;12;1618.00;9
3715;12;621695888;3715;346;4761;4770;6.91;0.42;274.13;3.86;1046;12;1619.00;9
3718;12;621695902;3718;353;4789;4806;6.93;0.42;274.18;3.83;1071;12;1620.00;17
3719;12;621695919;3719;344;4789;4806;7.03;0.43;274.30;3.83;1070;12;1621.00;17
3720;12;621695932;3720;340;4792;4806;7.08;0.43;274.37;3.83;1072;12;1622.00;14
3723;12;621695946;3723;341;4792;4806;7.15;0.44;274.48;3.83;1069;12;1623.00;14
3725;12;621695960;3725;337;4793;4806;7.19;0.44;274.55;3.83;1068;12;1624.00;13
3730;12;621695975;3730;337;4793;4806;7.19;0.44;274.73;3.83;1063;12;1625.00;13
3734;12;621695988;3734;334;4797;4810;7.14;0.43;274.86;3.83;1063;12;1626.00;13
3739;12;621696002;3739;329;4797;4810;7.12;0.43;274.93;3.83;1058;12;1627.00;13
3741;12;621696016;3741;334;4801;4814;7.18;0.44;275.11;3.83;1060;12;1628.00;13
3742;13;621696030;3742;330;4802;4815;7.24;0.44;275.25;3.83;1060;13;1629.00;13
3745;13;621696051;3745;326;4802;4815;7.22;0.44;275.47;3.83;1057;13;1630.00;13
3749;13;621696064;3749;327;4802;4815;7.15;0.43;275.57;3.83;1053;13;1631.00;13
3749;13;621696076;3749;323;4813;4828;7.14;0.43;275.57;3.82;1064;13;1632.00;15
3754;13;621696097;3754;315;4813;4828;7.08;0.43;275.76;3.82;1059;13;1633.00;15
3756;13;621696110;3756;310;4813;4828;7.07;0.43;275.89;3.82;1057;13;1634.00;15
3758;13;621696123;3758;304;4815;4829;7.07;0.43;276.08;3.83;1057;13;1635.00;14
3764;13;621696136;3764;303;4815;4830;7.04;0.43;276.33;3.83;1051;13;1636.00;15
3766;13;621696150;3766;306;4815;4830;7.12;0.43;276.29;3.83;1049;13;1637.00;15
3769;13;621696163;3769;296;4817;4833;7.26;0.44;276.30;3.83;1048;13;1638.00;16
3773;13;621696184;3773;290;4818;4833;7.34;0.45;276.41;3.83;1045;13;1639.00;15
3775;13;621696197;3775;285;4818;4833;7.39;0.45;276.60;3.83;1043;13;1640.00;15
3777;13;621696210;3777;286;4818;4833;7.37;0.45;276.52;3.83;1041;13;1641.00;15
3780;13;621696222;3780;290;4823;4839;7.43;0.45;276.54;3.82;1043;13;1642.00;16
3783;13;621696236;3783;296;4823;4839;7.42;0.45;276.50;3.82;1040;13;1643.00;16
3786;13;621696249;3786;298;4823;4839;7.41;0.45;276.66;3.82;1037;13;1644.00;16
3788;13;621696262;3788;300;4823;4839;7.43;0.45;276.74;3.82;1035;13;1645.00;16
3795;13;621696279;3795;304;4826;4843;7.36;0.45;276.78;3.82;1031;13;1646.00;17
3796;13;621696297;3796;305;4827;4844;7.33;0.44;276.79;3.82;1031;13;1647.00;17
3799;13;621696310;3799;305;4827;4844;7.36;0.45;277.04;3.82;1028;13;1648.00;17
3801;13;621696323;3801;306;4828;4845;7.40;0.45;277.09;3.82;1027;13;1649.00;17
3806;13;621696337;3806;303;4828;4845;7.39;0.45;277.21;3.82;1022;13;1650.00;17
3810;13;621696358;3810;301;4829;4845;7.38;0.45;277.43;3.83;1019;13;1651.00;16
3813;13;621696370;3813;294;4829;4845;7.44;0.45;277.51;3.83;1016;13;1652.00;16
3815;13;621696382;3815;288;4829;4845;7.47;0.45;277.55;3.83;1014;13;1653.00;16
3818;13;621696393;3818;290;4829;4845;7.43;0.45;277.68;3.83;1011;13;1654.00;16
3821;13;621696405;3821;285;4829;4845;7.42;0.45;277.83;3.83;1008;13;1655.00;16
3823;13;621696417;3823;290;4867;4915;7.51;0.46;277.99;3.80;1044;13;1656.00;48
3824;13;621696435;3824;289;4870;4916;7.52;0.46;278.11;3.81;1046;13;1657.00;46
3826;13;621696447;3826;289;4878;4916;7.51;0.46;278.29;3.81;1052;13;1658.00;38
3829;13;621696465;3829;290;4878;4916;7.48;0.46;278.51;3.81;1049;13;1659.00;38
3831;13;621696478;3831;291;4883;4916;7.45;0.46;278.45;3.83;1052;13;1660.00;33
3833;13;621696490;3833;298;4884;4916;7.42;0.45;278.45;3.83;1051;13;1661.00;32
3837;13;621696503;3837;298;4887;4916;7.37;0.45;278.55;3.85;1050;13;1662.00;29
3840;13;621696515;3840;303;4890;4916;7.35;0.45;278.72;3.85;1050;13;1663.00;26
3842;13;621696527;3842;295;4893;4917;7.38;0.45;278.71;3.87;1051;13;1664.00;24
3846;13;621696539;3846;299;4899;4919;7.40;0.45;278.74;3.88;1053;13;1665.00;20
3849;13;621696551;3849;298;4900;4919;7.41;0.45;278.85;3.88;1051;13;1666.00;19
3853;13;621696564;3853;297;4905;4923;7.38;0.45;278.81;3.89;1052;13;1667.00;18
3858;13;621696576;3858;296;4907;4923;7.36;0.45;278.81;3.89;1049;13;1668.00;16
3861;13;621696588;3861;297;4911;4923;7.37;0.45;278.83;3.93;1050;13;1669.00;12
3861;13;621696601;3861;303;4911;4923;7.37;0.45;278.83;3.93;1050;13;1670.00;12
3864;13;621696612;3864;309;4917;4929;7.37;0.45;278.99;3.93;1053;13;1671.00;12
3866;13;621696625;3866;310;4918;4929;7.33;0.45;279.00;3.93;1052;13;1672.00;11
3866;13;621696637;3866;312;4919;4929;7.35;0.45;279.00;3.94;1053;13;1673.00;10
3868;13;621696649;3868;318;4922;4932;7.37;0.45;279.17;3.94;1054;13;1674.00;10
3873;13;621696660;3873;326;4923;4932;7.31;0.45;279.17;3.94;1050;13;1675.00;9
3874;13;621696673;3874;332;4925;4932;7.28;0.44;279.14;3.96;1051;13;1676.00;7
3877;13;621696687;3877;338;4925;4933;7.22;0.44;279.16;3.96;1048;13;1677.00;8
3877;13;621696698;3877;345;4926;4934;7.19;0.44;279.16;3.96;1049;13;1678.00;8
3881;13;621696710;3881;340;4928;4934;7.12;0.44;279.17;3.96;1047;13;1679.00;6
3884;13;621696723;3884;347;4946;4960;7.10;0.44;279.24;3.95;1062;13;1680.00;14
3888;13;621696736;3888;343;4951;4960;7.14;0.44;279.23;3.95;1063;13;1681.00;9
3894;13;621696748;3894;336;4955;4960;7.19;0.44;279.26;3.96;1061;13;1682.00;5
3894;13;621696759;3894;334;4957;4961;7.24;0.44;279.26;3.96;1063;13;1683.00;4
3896;13;621696771;3896;333;4957;4961;7.21;0.44;279.42;3.96;1061;13;1684.00;4
3901;13;621696782;3901;329;4962;4965;7.22;0.44;279.46;3.96;1061;13;1685.00;3
3902;13;621696794;3902;327;4963;4965;7.18;0.44;279.49;3.96;1061;13;1686.00;2
3906;13;621696805;3906;332;4966;4969;7.12;0.43;279.54;3.96;1060;13;1687.00;3
3907;13;621696816;3907;335;4966;4969;7.08;0.43;279.68;3.96;1059;13;1688.00;3
3911;13;621696828;3911;334;4967;4969;7.01;0.43;279.56;3.96;1056;13;1689.00;2
3916;13;621696839;3916;339;4968;4969;6.88;0.42;279.66;3.96;1052;13;1690.00;1
3919;13;621696850;3919;347;4969;4969;6.77;0.41;279.79;3.96;1050;13;1691.00;0
3922;13;621696861;3922;345;4980;4981;6.73;0.41;279.84;3.96;1058;13;1692.00;1
3926;13;621696873;3926;359;4980;4981;6.61;0.40;280.04;3.96;1054;13;1693.00;1
3931;13;621696884;3931;357;4981;4981;6.52;0.40;280.15;3.95;1050;13;1694.00;0
3932;13;621696895;3932;367;4981;4981;6.39;0.39;280.21;3.95;1049;13;1695.00;0
3937;13;621696906;3937;375;4981;4981;6.25;0.38;280.39;3.95;1044;13;1696.00;0
3941;13;621696916;3941;380;4981;4981;6.12;0.37;280.45;3.95;1040;13;1697.00;0
3944;13;621696927;3944;384;4982;4982;5.99;0.37;280.40;3.95;1038;13;1698.00;0
3950;13;621696938;3950;391;4982;4982;5.77;0.35;280.63;3.95;1032;13;1699.00;0
3954;13;621696949;3954;389;4988;4988;5.72;0.35;280.68;3.95;1034;13;1700.00;0
3959;13;621696963;3959;389;4989;4989;5.62;0.34;280.73;3.95;1030;13;1701.00;0
3964;13;621696975;3964;397;4989;4989;5.51;0.33;281.04;3.95;1025;13;1702.00;0
3966;13;621696985;3966;394;4989;4989;5.43;0.33;281.00;3.95;1023;13;1703.00;0
3968;13;621696995;3968;398;4993;4993;5.37;0.33;281.02;3.95;1025;13;1704.00;0
3970;13;621697005;3970;404;4993;4993;5.28;0.32;281.02;3.95;1023;13;1705.00;0
3971;13;621697015;3971;401;4993;4993;5.23;0.32;281.00;3.95;1022;13;1706.00;0
3975;13;621697025;3975;403;4994;4994;5.24;0.32;281.09;3.95;1019;13;1707.00;0
3977;13;621697035;3977;401;4998;4998;5.29;0.32;281.06;3.94;1021;13;1708.00;0
3982;13;621697046;3982;404;4998;4998;5.26;0.32;281.05;3.94;1016;13;1709.00;0
3986;13;621697058;3986;406;5002;5004;5.28;0.32;280.90;3.94;1016;13;1710.00;2
3987;13;621697069;3987;406;5003;5004;5.28;0.32;280.83;3.94;1016;13;1711.00;1
3990;13;621697079;3990;411;5004;5004;5.30;0.32;280.80;3.94;1014;13;1712.00;0
3995;13;621697089;3995;414;5004;5004;5.23;0.32;280.78;3.94;1009;13;1713.00;0
3995;13;621697100;3995;413;5008;5008;5.24;0.32;280.78;3.94;1013;13;1714.00;0
3999;13;621697110;3999;411;5008;5008;5.17;0.32;280.75;3.94;1009;13;1715.00;0
4002;13;621697120;4002;424;5008;5008;5.16;0.32;280.72;3.94;1006;13;1716.00;0
4005;13;621697130;4005;428;5008;5008;5.11;0.31;280.71;3.94;1003;13;1717.00;0
4009;13;621697141;4009;430;5009;5009;5.06;0.31;280.72;3.94;1000;13;1718.00;0
4014;13;621697150;4014;422;5010;5010;5.02;0.31;280.69;3.94;996;13;1719.00;0
4016;13;621697161;4016;434;5010;5010;5.01;0.31;280.68;3.94;994;13;1720.00;0
4019;13;621697171;4019;438;5011;5011;4.96;0.31;280.67;3.94;992;13;1721.00;0
4025;13;621697181;4025;436;5011;5011;4.87;0.30;280.53;3.94;986;13;1722.00;0
4031;13;621697192;4031;441;5011;5011;4.82;0.30;280.42;3.94;980;13;1723.00;0
4036;13;621697202;4036;442;5011;5011;4.74;0.29;280.54;3.94;975;13;1724.00;0
4041;13;621697212;4041;445;5011;5011;4.72;0.29;280.60;3.94;970;13;1725.00;0
4045;13;621697221;4045;445;5011;5011;4.71;0.29;280.52;3.94;966;13;1726.00;0
4048;13;621697231;4048;451;5011;5011;4.73;0.29;280.56;3.94;963;13;1727.00;0
4050;13;621697241;4050;470;5088;5138;5.04;0.31;280.56;3.88;1038;13;1728.00;50
4053;13;621697261;4053;462;5092;5139;5.08;0.32;280.55;3.87;1039;13;1729.00;47
4058;13;621697271;4058;460;5098;5139;5.16;0.32;280.66;3.87;1040;13;1730.00;41
4063;13;621697286;4063;462;5100;5139;5.16;0.32;280.71;3.87;1037;13;1731.00;39
4067;13;621697304;4067;464;5106;5139;5.26;0.33;280.61;3.87;1039;13;1732.00;33
4070;13;621697319;4070;463;5107;5139;5.32;0.33;280.70;3.87;1037;13;1733.00;32
4074;13;621697336;4074;464;5112;5139;5.34;0.33;280.70;3.87;1038;13;1734.00;27
4077;13;621697355;4077;473;5113;5139;5.33;0.33;280.74;3.87;1036;13;1735.00;26
4079;13;621697371;4079;465;5116;5140;5.30;0.33;280.75;3.88;1037;13;1736.00;24
4082;13;621697395;4082;471;5120;5141;5.22;0.32;280.80;3.88;1038;13;1737.00;21
4084;13;621697407;4084;476;5123;5141;5.21;0.32;280.88;3.88;1039;13;1738.00;18
4086;13;621697419;4086;464;5126;5142;5.19;0.32;280.87;3.89;1040;13;1739.00;16
4087;13;621697433;4087;460;5132;5142;5.13;0.32;280.88;3.90;1045;13;1740.00;10
4091;13;621697446;4091;461;5134;5142;5.12;0.31;280.83;3.90;1043;13;1741.00;8
4091;13;621697459;4091;462;5135;5142;5.15;0.32;280.83;3.90;1044;13;1742.00;7
4093;13;621697471;4093;465;5140;5146;5.19;0.32;280.79;3.90;1047;13;1743.00;6
4095;13;621697484;4095;468;5141;5146;5.24;0.32;280.80;3.90;1046;13;1744.00;5
4095;13;621697497;4095;473;5142;5146;5.32;0.33;280.80;3.91;1047;13;1745.00;4
4096;13;621697515;4096;467;5144;5149;5.45;0.34;280.73;3.90;1048;13;1746.00;5
4098;13;621697527;4098;457;5145;5149;5.53;0.34;280.76;3.91;1047;13;1747.00;4
4100;13;621697553;4100;452;5146;5149;5.65;0.35;280.80;3.91;1046;13;1748.00;3
4101;13;621697566;4101;438;5151;5153;5.83;0.36;280.84;3.91;1050;13;1749.00;2
4105;13;621697579;4105;435;5153;5154;5.88;0.36;281.04;3.91;1048;13;1750.00;1
4108;13;621697599;4108;432;5153;5154;5.92;0.36;280.92;3.91;1045;13;1751.00;1
4110;13;621697611;4110;434;5157;5158;5.96;0.36;280.95;3.91;1047;13;1752.00;1
4111;13;621697632;4111;434;5157;5158;6.01;0.37;280.98;3.91;1046;13;1753.00;1
4116;13;621697645;4116;434;5157;5158;6.04;0.37;280.93;3.91;1041;13;1754.00;1
4117;13;621697657;4117;433;5159;5160;6.12;0.37;280.86;3.91;1042;13;1755.00;1
4121;13;621697670;4121;413;5159;5160;6.19;0.38;280.80;3.91;1038;13;1756.00;1
4121;13;621697683;4121;407;5164;5166;6.27;0.38;280.80;3.91;1043;13;1757.00;2
4124;13;621697696;4124;391;5164;5166;6.32;0.39;280.96;3.91;1040;13;1758.00;2
4125;13;621697710;4125;381;5164;5167;6.37;0.39;281.08;3.91;1039;13;1759.00;3
4131;13;621697723;4131;372;5164;5167;6.37;0.39;281.38;3.91;1033;13;1760.00;3
4134;13;621697736;4134;372;5164;5167;6.44;0.39;281.34;3.91;1030;13;1761.00;3
4136;13;621697748;4136;369;5164;5167;6.47;0.39;281.37;3.91;1028;13;1762.00;3
4139;13;621697762;4139;371;5164;5167;6.48;0.39;281.52;3.91;1025;13;1763.00;3
4140;13;621697775;4140;368;5174;5179;6.61;0.40;281.53;3.90;1034;13;1764.00;5
4141;13;621697789;4141;366;5174;5179;6.63;0.40;281.54;3.90;1033;13;1765.00;5
4144;13;621697802;4144;364;5175;5179;6.66;0.40;281.48;3.90;1031;13;1766.00;4
4146;13;621697816;4146;370;5175;5179;6.62;0.40;281.52;3.90;1029;13;1767.00;4
4149;13;621697829;4149;369;5175;5179;6.60;0.40;281.55;3.90;1026;13;1768.00;4
4151;13;621697843;4151;367;5175;5179;6.62;0.40;281.67;3.90;1024;13;1769.00;4
4152;13;621697857;4152;360;5178;5183;6.69;0.41;281.73;3.90;1026;13;1770.00;5
4156;14;621697870;4156;363;5178;5183;6.70;0.41;281.88;3.90;1022;14;1771.00;5
4158;14;621697896;4158;365;5182;5187;6.78;0.41;281.99;3.89;1024;14;1772.00;5
4162;14;621697909;4162;358;5183;5188;6.82;0.41;282.10;3.89;1021;14;1773.00;5
4165;14;621697922;4165;359;5183;5188;6.85;0.42;282.27;3.89;1018;14;1774.00;5
4167;14;621697936;4167;358;5183;5188;6.89;0.42;282.29;3.89;1016;14;1775.00;5
4169;14;621697948;4169;364;5194;5201;7.00;0.43;282.29;3.88;1025;14;1776.00;7
4171;14;621697961;4171;365;5194;5201;7.03;0.43;282.40;3.88;1023;14;1777.00;7
4173;14;621697974;4173;371;5194;5201;7.02;0.43;282.51;3.88;1021;14;1778.00;7
4176;14;621697986;4176;369;5195;5202;7.07;0.43;282.51;3.88;1019;14;1779.00;7
4178;14;621697999;4178;370;5195;5203;7.02;0.43;282.73;3.88;1017;14;1780.00;8
4183;14;621698012;4183;370;5195;5203;6.95;0.42;282.95;3.88;1012;14;1781.00;8
4184;14;621698025;4184;369;5197;5206;6.94;0.42;282.97;3.88;1013;14;1782.00;9
4190;14;621698037;4190;372;5197;5206;6.84;0.41;283.20;3.88;1007;14;1783.00;9
4192;14;621698062;4192;378;5198;5206;6.76;0.41;283.31;3.88;1006;14;1784.00;8
4196;14;621698074;4196;382;5198;5206;6.70;0.41;283.46;3.88;1002;14;1785.00;8
4199;14;621698087;4199;388;5203;5212;6.67;0.40;283.58;3.88;1004;14;1786.00;9
4202;14;621698100;4202;386;5203;5212;6.62;0.40;283.62;3.88;1001;14;1787.00;9
4203;14;621698112;4203;388;5203;5212;6.59;0.40;283.76;3.88;1000;14;1788.00;9
4207;14;621698124;4207;385;5203;5212;6.51;0.39;283.92;3.88;996;14;1789.00;9
4208;14;621698136;4208;381;5206;5216;6.49;0.39;283.95;3.88;998;14;1790.00;10
4208;14;621698149;4208;385;5207;5217;6.50;0.39;283.95;3.88;999;14;1791.00;10
4210;14;621698162;4210;378;5207;5217;6.54;0.40;284.07;3.88;997;14;1792.00;10
4212;14;621698174;4212;375;5208;5218;6.61;0.40;284.13;3.88;996;14;1793.00;10
4213;14;621698186;4213;372;5208;5218;6.64;0.40;284.18;3.88;995;14;1794.00;10
4216;14;621698198;4216;367;5208;5218;6.67;0.40;284.14;3.88;992;14;1795.00;10
4216;14;621698211;4216;363;5208;5218;6.72;0.41;284.14;3.88;992;14;1796.00;10
4217;14;621698224;4217;353;5208;5218;6.74;0.41;284.20;3.88;991;14;1797.00;10
4219;14;621698236;4219;356;5208;5218;6.76;0.41;284.29;3.88;989;14;1798.00;10
4222;14;621698247;4222;344;5208;5218;6.78;0.41;284.55;3.88;986;14;1799.00;10
4224;14;621698262;4224;367;5276;5356;6.78;0.42;284.62;3.83;1052;14;1800.00;80
4230;14;621698293;4230;352;5277;5357;6.73;0.41;284.84;3.83;1047;14;1801.00;80
4234;14;621698305;4234;335;5286;5357;6.81;0.42;285.08;3.82;1052;14;1802.00;71
4236;14;621698318;4236;328;5288;5357;6.84;0.42;285.06;3.82;1052;14;1803.00;69
4239;14;621698329;4239;318;5294;5357;6.90;0.42;285.29;3.82;1055;14;1804.00;63
4244;14;621698342;4244;316;5298;5357;6.94;0.42;285.38;3.84;1054;14;1805.00;59
4246;14;621698354;4246;315;5305;5357;7.00;0.43;285.38;3.84;1059;14;1806.00;52
4251;14;621698367;4251;316;5310;5357;7.03;0.43;285.52;3.85;1059;14;1807.00;47
4254;14;621698378;4254;313;5314;5358;7.04;0.43;285.63;3.85;1060;14;1808.00;44
4257;14;621698391;4257;313;5317;5359;7.00;0.43;285.66;3.85;1060;14;1809.00;42
4258;14;621698404;4258;316;5320;5359;6.95;0.42;285.68;3.86;1062;14;1810.00;39
4262;14;621698415;4262;319;5325;5363;6.86;0.42;285.75;3.85;1063;14;1811.00;38
4269;14;621698428;4269;314;5327;5363;6.74;0.41;285.78;3.86;1058;14;1812.00;36
4271;14;621698440;4271;314;5328;5363;6.67;0.41;285.76;3.86;1057;14;1813.00;35
4275;14;621698452;4275;307;5328;5363;6.58;0.40;285.79;3.86;1053;14;1814.00;35
4279;14;621698464;4279;308;5331;5369;6.58;0.40;285.96;3.86;1052;14;1815.00;38
4281;14;621698477;4281;303;5331;5369;6.60;0.40;286.02;3.86;1050;14;1816.00;38
4283;14;621698494;4283;307;5331;5369;6.67;0.41;286.03;3.86;1048;14;1817.00;38
4285;14;621698506;4285;301;5333;5372;6.72;0.41;286.08;3.86;1048;14;1818.00;39
4290;14;621698518;4290;307;5334;5372;6.72;0.41;286.29;3.86;1044;14;1819.00;38
4293;14;621698530;4293;308;5336;5372;6.75;0.41;286.36;3.86;1043;14;1820.00;36
4293;14;621698541;4293;305;5337;5373;6.77;0.41;286.36;3.87;1044;14;1821.00;36
4295;14;621698554;4295;304;5339;5374;6.86;0.42;286.31;3.87;1044;14;1822.00;35
4297;14;621698566;4297;305;5339;5374;6.94;0.42;286.41;3.87;1042;14;1823.00;35
4299;14;621698578;4299;302;5347;5387;7.00;0.43;286.45;3.86;1048;14;1824.00;40
4305;14;621698591;4305;296;5349;5387;7.05;0.43;286.40;3.87;1044;14;1825.00;38
4307;14;621698603;4307;298;5354;5387;7.15;0.44;286.43;3.88;1047;14;1826.00;33
4312;14;621698616;4312;293;5356;5388;7.18;0.44;286.38;3.88;1044;14;1827.00;32
4313;14;621698628;4313;289;5357;5388;7.25;0.44;286.38;3.88;1044;14;1828.00;31
4313;14;621698640;4313;287;5361;5392;7.30;0.44;286.38;3.88;1048;14;1829.00;31
4314;14;621698653;4314;289;5361;5392;7.32;0.45;286.46;3.88;1047;14;1830.00;31
4318;14;621698665;4318;296;5366;5396;7.23;0.44;286.68;3.90;1048;14;1831.00;30
4319;14;621698678;4319;300;5366;5396;7.20;0.44;286.70;3.90;1047;14;1832.00;30
4324;14;621698691;4324;308;5367;5396;7.12;0.44;286.76;3.91;1043;14;1833.00;29
4326;14;621698703;4326;313;5368;5396;7.10;0.43;286.81;3.91;1042;14;1834.00;28
4327;14;621698714;4327;312;5369;5396;7.04;0.43;286.85;3.93;1042;14;1835.00;27
4333;14;621698726;4333;316;5379;5408;7.02;0.43;286.76;3.93;1046;14;1836.00;29
4337;14;621698738;4337;320;5380;5408;6.95;0.42;286.81;3.93;1043;14;1837.00;28
4338;14;621698750;4338;328;5383;5408;6.91;0.42;286.80;3.94;1045;14;1838.00;25
4341;14;621698761;4341;339;5383;5408;6.83;0.42;286.93;3.94;1042;14;1839.00;25
4343;14;621698772;4343;340;5385;5408;6.77;0.41;287.01;3.96;1042;14;1840.00;23
4344;14;621698783;4344;345;5386;5408;6.69;0.41;287.03;3.97;1042;14;1841.00;22
4347;14;621698794;4347;358;5387;5409;6.60;0.40;287.26;3.98;1040;14;1842.00;22
4351;14;621698806;4351;361;5387;5409;6.55;0.40;287.47;3.98;1036;14;1843.00;22
4353;14;621698817;4353;369;5395;5415;6.62;0.41;287.48;4.00;1042;14;1844.00;20
4356;14;621698829;4356;378;5397;5417;6.59;0.40;287.51;4.00;1041;14;1845.00;20
4360;14;621698841;4360;388;5398;5417;6.55;0.40;287.58;4.01;1038;14;1846.00;19
4362;14;621698852;4362;384;5398;5417;6.51;0.40;287.48;4.01;1036;14;1847.00;19
4365;14;621698863;4365;383;5402;5421;6.50;0.40;287.45;4.01;1037;14;1848.00;19
4369;14;621698874;4369;381;5403;5421;6.42;0.39;287.59;4.02;1034;14;1849.00;18
4371;14;621698885;4371;374;5405;5421;6.38;0.39;287.59;4.02;1034;14;1850.00;16
4373;14;621698896;4373;368;5406;5422;6.41;0.39;287.67;4.02;1033;14;1851.00;16
4374;14;621698907;4374;367;5410;5426;6.46;0.40;287.63;4.03;1036;14;1852.00;16
4374;14;621698918;4374;362;5410;5426;6.51;0.40;287.63;4.03;1036;14;1853.00;16
4374;14;621698929;4374;360;5413;5429;6.58;0.41;287.63;4.03;1039;14;1854.00;16
4378;14;621698940;4378;359;5413;5429;6.59;0.41;287.55;4.03;1035;14;1855.00;16
4379;14;621698950;4379;355;5415;5429;6.62;0.41;287.53;4.04;1036;14;1856.00;14
4382;14;621698961;4382;356;5415;5429;6.65;0.41;287.54;4.04;1033;14;1857.00;14
4388;14;621698972;4388;352;5419;5433;6.64;0.41;287.31;4.03;1031;14;1858.00;14
4389;14;621698983;4389;357;5420;5433;6.62;0.41;287.28;4.04;1031;14;1859.00;13
4393;14;621698995;4393;359;5421;5433;6.53;0.40;287.33;4.04;1028;14;1860.00;12
4393;14;621699005;4393;361;5421;5433;6.45;0.40;287.33;4.04;1028;14;1861.00;12
4399;14;621699015;4399;370;5422;5434;6.26;0.38;287.35;4.04;1023;14;1862.00;12
4404;14;621699026;4404;377;5425;5435;6.12;0.38;287.33;4.05;1021;14;1863.00;10
4405;14;621699036;4405;381;5426;5435;6.04;0.37;287.27;4.05;1021;14;1864.00;9
4409;14;621699046;4409;386;5427;5436;5.92;0.36;287.35;4.05;1018;14;1865.00;9
4412;14;621699056;4412;388;5427;5436;5.82;0.36;287.54;4.05;1015;14;1866.00;9
4417;14;621699066;4417;402;5427;5436;5.68;0.35;287.44;4.05;1010;14;1867.00;9
4423;14;621699075;4423;400;5427;5436;5.58;0.34;287.48;4.05;1004;14;1868.00;9
4424;14;621699084;4424;407;5427;5436;5.52;0.34;287.44;4.05;1003;14;1869.00;9
4428;14;621699093;4428;393;5427;5436;5.45;0.33;287.42;4.05;999;14;1870.00;9
4431;14;621699103;4431;390;5427;5436;5.40;0.33;287.33;4.05;996;14;1871.00;9
4434;14;621699112;4434;400;5499;5563;5.63;0.35;287.41;3.99;1065;14;1872.00;64
4438;14;621699131;4438;400;5504;5564;5.59;0.35;287.32;3.99;1066;14;1873.00;60
4440;14;621699141;4440;403;5513;5564;5.62;0.35;287.26;3.99;1073;14;1874.00;51
4443;14;621699151;4443;402;5516;5564;5.58;0.35;287.17;3.99;1073;14;1875.00;48
4445;14;621699161;4445;410;5523;5564;5.60;0.35;287.14;3.99;1078;14;1876.00;41
4446;14;621699172;4446;409;5525;5564;5.63;0.35;287.12;3.99;1079;14;1877.00;39
4448;14;621699182;4448;406;5528;5564;5.59;0.35;287.16;3.99;1080;14;1878.00;36
4453;14;621699194;4453;404;5531;5564;5.56;0.34;287.24;3.99;1078;14;1879.00;33
4456;14;621699205;4456;412;5534;5565;5.54;0.34;287.20;3.99;1078;14;1880.00;31
4458;14;621699216;4458;415;5538;5566;5.48;0.34;287.10;4.00;1080;14;1881.00;28
4462;14;621699227;4462;422;5542;5568;5.38;0.33;287.16;4.00;1080;14;1882.00;26
4464;14;621699239;4464;429;5546;5569;5.31;0.33;287.17;4.00;1082;14;1883.00;23
4470;14;621699252;4470;437;5549;5569;5.22;0.32;287.12;4.01;1079;14;1884.00;20
4472;14;621699264;4472;443;5551;5569;5.19;0.32;287.14;4.01;1079;14;1885.00;18
4474;14;621699274;4474;452;5552;5569;5.15;0.32;287.14;4.01;1078;14;1886.00;17
4478;14;621699291;4478;453;5556;5573;5.10;0.31;287.11;4.01;1078;14;1887.00;17
4479;14;621699310;4479;455;5557;5573;5.08;0.31;287.13;4.01;1078;14;1888.00;16
4482;14;621699327;4482;458;5558;5573;5.08;0.31;287.28;4.01;1076;14;1889.00;15
4488;14;621699348;4488;460;5561;5579;5.05;0.31;287.21;4.01;1073;14;1890.00;18
4490;14;621699366;4490;453;5563;5579;5.07;0.31;287.30;4.01;1073;14;1891.00;16
4492;14;621699385;4492;445;5564;5579;5.10;0.31;287.31;4.02;1072;14;1892.00;15
4494;14;621699402;4494;445;5568;5583;5.14;0.32;287.31;4.01;1074;14;1893.00;15
4500;14;621699416;4500;445;5569;5584;5.14;0.31;287.27;4.01;1069;14;1894.00;15
4503;14;621699429;4503;444;5572;5584;5.20;0.32;287.35;4.02;1069;14;1895.00;12
4505;14;621699442;4505;441;5576;5588;5.21;0.32;287.39;4.01;1071;14;1896.00;12
4508;14;621699455;4508;448;5576;5588;5.20;0.32;287.48;4.01;1068;14;1897.00;12
4509;14;621699483;4509;448;5577;5588;5.26;0.32;287.52;4.01;1068;14;1898.00;11
4514;14;621699496;4514;451;5578;5589;5.24;0.32;287.62;4.01;1064;14;1899.00;11
4519;14;621699509;4519;449;5578;5589;5.23;0.32;287.51;4.01;1059;14;1900.00;11
4523;14;621699527;4523;450;5582;5595;5.26;0.32;287.57;4.01;1059;14;1901.00;13
4525;14;621699543;4525;449;5583;5595;5.34;0.33;287.57;4.01;1058;14;1902.00;12
4529;14;621699556;4529;442;5583;5596;5.34;0.32;287.49;4.01;1054;14;1903.00;13
4531;14;621699568;4531;440;5583;5596;5.39;0.33;287.45;4.01;1052;14;1904.00;13
4534;14;621699582;4534;447;5583;5596;5.41;0.33;287.44;4.01;1049;14;1905.00;13
4538;14;621699594;4538;448;5583;5596;5.39;0.33;287.42;4.01;1045;14;1906.00;13
4540;14;621699606;4540;457;5583;5596;5.43;0.33;287.43;4.01;1043;14;1907.00;13
4543;14;621699618;4543;457;5593;5608;5.57;0.34;287.51;4.00;1050;14;1908.00;15
4545;14;621699631;4545;464;5593;5608;5.58;0.34;287.46;4.00;1048;14;1909.00;15
4550;14;621699643;4550;463;5594;5608;5.57;0.34;287.33;4.00;1044;14;1910.00;14
4554;14;621699655;4554;472;5594;5608;5.56;0.34;287.53;4.00;1040;14;1911.00;14
4555;14;621699667;4555;476;5594;5608;5.53;0.33;287.62;4.00;1039;14;1912.00;14
4555;14;621699678;4555;473;5594;5608;5.53;0.34;287.62;4.00;1039;14;1913.00;14
4558;14;621699690;4558;476;5597;5612;5.49;0.33;287.72;4.00;1039;14;1914.00;15
4560;14;621699702;4560;481;5597;5612;5.47;0.33;287.70;4.00;1037;14;1915.00;15
4560;14;621699714;4560;487;5601;5616;5.50;0.33;287.70;4.00;1041;14;1916.00;15
4560;14;621699725;4560;483;5602;5617;5.50;0.33;287.70;4.00;1042;14;1917.00;15
4563;14;621699737;4563;479;5602;5617;5.44;0.33;287.79;4.00;1039;14;1918.00;15
4566;14;621699749;4566;472;5602;5617;5.40;0.33;287.81;4.00;1036;14;1919.00;15
4569;14;621699763;4569;473;5626;5646;5.50;0.33;287.87;3.98;1057;14;1920.00;20
4571;14;621699778;4571;463;5626;5646;5.51;0.34;287.97;3.98;1055;14;1921.00;20
4576;14;621699791;4576;458;5627;5646;5.54;0.34;288.18;3.98;1051;14;1922.00;19
4579;14;621699804;4579;456;5628;5647;5.60;0.34;288.23;3.98;1049;14;1923.00;19
4580;14;621699818;4580;457;5628;5648;5.66;0.34;288.31;3.98;1048;14;1924.00;20
4581;14;621699830;4581;455;5628;5648;5.70;0.35;288.34;3.98;1047;14;1925.00;20
4583;14;621699849;4583;442;5631;5651;5.73;0.35;288.39;4.00;1048;14;1926.00;20
4585;14;621699862;4585;427;5631;5651;5.74;0.35;288.43;4.00;1046;14;1927.00;20
4588;14;621699875;4588;424;5632;5651;5.77;0.35;288.47;4.00;1044;14;1928.00;19
4588;14;621699887;4588;420;5632;5651;5.84;0.36;288.47;4.00;1044;14;1929.00;19
4591;14;621699900;4591;426;5637;5657;5.91;0.36;288.60;4.00;1046;14;1930.00;20
4593;14;621699914;4593;421;5637;5657;5.95;0.36;288.62;4.00;1044;14;1931.00;20
4596;14;621699927;4596;419;5637;5657;5.97;0.36;288.69;4.00;1041;14;1932.00;20
4599;14;621699939;4599;418;5637;5657;5.98;0.36;288.73;4.00;1038;14;1933.00;20
4600;14;621699952;4600;424;5640;5661;5.97;0.36;288.74;4.00;1040;14;1934.00;21
4603;14;621699965;4603;431;5642;5663;6.00;0.37;288.83;4.00;1039;14;1935.00;21
4606;14;621699979;4606;434;5642;5663;6.03;0.37;288.96;4.00;1036;14;1936.00;21
4607;14;621699991;4607;438;5643;5664;6.04;0.37;288.95;4.00;1036;14;1937.00;21
4611;14;621700003;4611;424;5643;5664;6.01;0.37;289.09;4.00;1032;14;1938.00;21
4612;14;621700016;4612;418;5643;5664;5.97;0.36;289.13;4.00;1031;14;1939.00;21
4613;14;621700028;4613;416;5643;5664;5.96;0.36;289.26;4.00;1030;14;1940.00;21
4614;14;621700041;4614;407;5643;5664;5.97;0.36;289.35;4.00;1029;14;1941.00;21
4617;14;621700053;4617;412;5644;5664;5.97;0.36;289.50;4.02;1027;14;1942.00;20
4620;14;621700065;4620;411;5644;5664;6.04;0.37;289.62;4.02;1024;14;1943.00;20
4623;14;621700078;4623;424;5686;5734;6.02;0.37;289.76;3.99;1063;14;1944.00;48
4624;14;621700096;4624;412;5686;5735;6.04;0.37;289.79;3.99;1062;14;1945.00;49
4625;14;621700108;4625;412;5691;5735;6.17;0.38;289.85;3.99;1066;14;1946.00;44
4629;14;621700121;4629;408;5693;5735;6.21;0.38;289.84;3.99;1064;14;1947.00;42
4631;14;621700133;4631;406;5696;5735;6.25;0.38;289.80;3.99;1065;14;1948.00;39
4635;14;621700146;4635;402;5699;5735;6.28;0.38;290.01;3.99;1064;14;1949.00;36
4636;14;621700160;4636;400;5704;5737;6.26;0.38;290.00;3.99;1068;14;1950.00;33
4639;14;621700173;4639;399;5707;5737;6.26;0.38;290.12;3.99;1068;14;1951.00;30
4642;14;621700193;4642;395;5709;5738;6.26;0.38;290.07;3.99;1067;14;1952.00;29
4644;14;621700206;4644;400;5710;5739;6.26;0.38;290.22;3.99;1066;14;1953.00;29
4644;14;621700225;4644;402;5712;5739;6.28;0.38;290.22;3.99;1068;14;1954.00;27
4649;15;621700237;4649;407;5716;5743;6.26;0.38;290.32;3.99;1067;15;1955.00;27
4650;15;621700270;4650;408;5718;5743;6.23;0.38;290.32;4.02;1068;15;1956.00;25
4650;15;621700283;4650;401;5718;5743;6.20;0.38;290.32;4.02;1068;15;1957.00;25
4654;15;621700295;4654;405;5718;5743;6.17;0.38;290.56;4.02;1064;15;1958.00;25
4655;15;621700308;4655;412;5724;5749;6.21;0.38;290.57;4.04;1069;15;1959.00;25
4658;15;621700321;4658;407;5724;5749;6.22;0.38;290.63;4.04;1066;15;1960.00;25
4658;15;621700334;4658;405;5724;5749;6.28;0.38;290.63;4.04;1066;15;1961.00;25
4660;15;621700346;4660;404;5727;5752;6.34;0.39;290.62;4.07;1067;15;1962.00;25
4663;15;621700359;4663;397;5727;5752;6.37;0.39;290.80;4.07;1064;15;1963.00;25
4666;15;621700371;4666;387;5729;5752;6.40;0.39;290.86;4.10;1063;15;1964.00;23
4671;15;621700383;4671;386;5729;5753;6.40;0.39;290.95;4.10;1058;15;1965.00;24
4671;15;621700396;4671;379;5730;5754;6.41;0.39;290.95;4.10;1059;15;1966.00;24
4677;15;621700409;4677;372;5730;5754;6.36;0.38;291.00;4.10;1053;15;1967.00;24
4678;15;621700420;4678;366;5741;5767;6.40;0.39;290.99;4.12;1063;15;1968.00;26
4679;15;621700434;4679;366;5741;5767;6.42;0.39;291.02;4.12;1062;15;1969.00;26
4681;15;621700445;4681;359;5741;5767;6.40;0.39;290.98;4.12;1060;15;1970.00;26
4684;15;621700457;4684;354;5743;5768;6.38;0.39;291.11;4.15;1059;15;1971.00;25
4685;15;621700470;4685;345;5743;5768;6.37;0.39;291.22;4.15;1058;15;1972.00;25
4687;15;621700481;4687;330;5748;5772;6.41;0.39;291.38;4.14;1061;15;1973.00;24
4687;15;621700493;4687;324;5749;5772;6.43;0.39;291.38;4.16;1062;15;1974.00;23
4690;15;621700505;4690;321;5753;5776;6.42;0.39;291.47;4.17;1063;15;1975.00;23
4692;15;621700518;4692;317;5753;5776;6.44;0.39;291.55;4.17;1061;15;1976.00;23
4696;15;621700530;4696;311;5753;5776;6.43;0.39;291.57;4.17;1057;15;1977.00;23
4701;15;621700542;4701;308;5753;5776;6.41;0.39;291.67;4.17;1052;15;1978.00;23
4703;15;621700555;4703;305;5753;5776;6.47;0.39;291.83;4.17;1050;15;1979.00;23
4706;15;621700568;4706;302;5774;5810;6.56;0.40;291.79;4.15;1068;15;1980.00;36
4707;15;621700583;4707;292;5775;5810;6.58;0.40;291.90;4.15;1068;15;1981.00;35
4709;15;621700595;4709;296;5776;5810;6.56;0.40;291.98;4.15;1067;15;1982.00;34
4711;15;621700607;4711;292;5777;5810;6.56;0.40;292.04;4.15;1066;15;1983.00;33
4714;15;621700618;4714;298;5778;5810;6.57;0.40;292.22;4.17;1064;15;1984.00;32
4716;15;621700630;4716;299;5778;5810;6.61;0.40;292.40;4.17;1062;15;1985.00;32
4718;15;621700642;4718;298;5778;5811;6.65;0.40;292.42;4.17;1060;15;1986.00;33
4720;15;621700654;4720;296;5779;5811;6.66;0.40;292.64;4.17;1059;15;1987.00;32
4722;15;621700666;4722;295;5784;5817;6.70;0.41;292.76;4.18;1062;15;1988.00;33
4726;15;621700679;4726;295;5784;5818;6.73;0.41;292.68;4.18;1058;15;1989.00;34
4731;15;621700691;4731;301;5785;5818;6.71;0.41;292.82;4.18;1054;15;1990.00;33
4732;15;621700703;4732;304;5787;5818;6.71;0.41;292.77;4.18;1055;15;1991.00;31
4734;15;621700715;4734;309;5790;5822;6.70;0.41;292.94;4.18;1056;15;1992.00;32
4737;15;621700727;4737;309;5791;5822;6.68;0.41;292.92;4.18;1054;15;1993.00;31
4739;15;621700739;4739;315;5792;5822;6.62;0.40;292.95;4.18;1053;15;1994.00;30
4742;15;621700751;4742;310;5794;5823;6.54;0.40;293.07;4.20;1052;15;1995.00;29
4744;15;621700764;4744;317;5798;5827;6.55;0.40;293.08;4.20;1054;15;1996.00;29
4746;15;621700776;4746;318;5798;5827;6.54;0.40;293.12;4.20;1052;15;1997.00;29
4749;15;621700788;4749;324;5800;5830;6.60;0.40;293.29;4.19;1051;15;1998.00;30
4749;15;621700801;4749;321;5802;5830;6.58;0.40;293.29;4.20;1053;15;1999.00;28
4752;15;621700814;4752;333;5803;5830;6.54;0.40;293.33;4.22;1051;15;2000.00;27
4754;15;621700830;4754;336;5804;5830;6.52;0.40;293.37;4.23;1050;15;2001.00;26
4755;15;621700842;4755;340;5808;5834;6.55;0.40;293.36;4.22;1053;15;2002.00;26
4759;15;621700854;4759;348;5808;5834;6.49;0.39;293.49;4.22;1049;15;2003.00;26
4759;15;621700866;4759;354;5810;5834;6.48;0.39;293.49;4.25;1051;15;2004.00;24
4761;15;621700878;4761;357;5810;5834;6.43;0.39;293.49;4.25;1049;15;2005.00;24
4763;15;621700889;4763;368;5811;5835;6.34;0.39;293.56;4.26;1048;15;2006.00;24
4767;15;621700901;4767;370;5814;5836;6.21;0.38;293.56;4.27;1047;15;2007.00;22
4767;15;621700913;4767;384;5814;5836;6.17;0.38;293.56;4.27;1047;15;2008.00;22
4771;15;621700925;4771;386;5816;5837;6.10;0.37;293.58;4.28;1045;15;2009.00;21
4772;15;621700938;4772;392;5817;5837;6.07;0.37;293.57;4.29;1045;15;2010.00;20
4776;15;621700949;4776;401;5817;5837;6.07;0.37;293.44;4.29;1041;15;2011.00;20
4779;15;621700960;4779;401;5819;5837;6.04;0.37;293.41;4.30;1040;15;2012.00;18
4780;15;621700971;4780;407;5819;5837;5.95;0.36;293.44;4.30;1039;15;2013.00;18
4781;15;621700982;4781;408;5821;5837;5.88;0.36;293.40;4.32;1040;15;2014.00;16
4782;15;621700992;4782;420;5821;5837;5.80;0.35;293.35;4.32;1039;15;2015.00;16
4784;15;621701002;4784;435;5885;5964;6.07;0.38;293.36;4.29;1101;15;2016.00;79
4787;15;621701023;4787;431;5887;5965;6.01;0.37;293.39;4.29;1100;15;2017.00;78
4790;15;621701034;4790;432;5899;5965;6.04;0.38;293.40;4.30;1109;15;2018.00;66
4791;15;621701045;4791;426;5903;5965;6.04;0.37;293.37;4.30;1112;15;2019.00;62
4794;15;621701055;4794;418;5913;5965;6.04;0.37;293.38;4.31;1119;15;2020.00;52
4799;15;621701067;4799;415;5918;5965;6.02;0.37;293.44;4.31;1119;15;2021.00;47
4799;15;621701078;4799;407;5923;5965;6.05;0.37;293.44;4.32;1124;15;2022.00;42
4802;15;621701089;4802;407;5926;5965;6.06;0.37;293.42;4.32;1124;15;2023.00;39
4803;15;621701101;4803;405;5929;5966;6.09;0.38;293.37;4.33;1126;15;2024.00;37
4808;15;621701112;4808;408;5935;5968;6.05;0.37;293.34;4.33;1127;15;2025.00;33
4809;15;621701124;4809;407;5939;5968;6.04;0.37;293.31;4.34;1130;15;2026.00;29
4812;15;621701136;4812;411;5940;5969;6.03;0.37;293.26;4.34;1128;15;2027.00;29
4815;15;621701148;4815;417;5942;5969;5.98;0.37;293.20;4.34;1127;15;2028.00;27
4817;15;621701159;4817;421;5944;5969;5.88;0.36;293.13;4.34;1127;15;2029.00;25
4820;15;621701170;4820;429;5948;5969;5.79;0.36;293.13;4.35;1128;15;2030.00;21
4821;15;621701181;4821;442;5952;5973;5.70;0.35;293.12;4.35;1131;15;2031.00;21
4824;15;621701193;4824;448;5956;5973;5.53;0.34;293.01;4.36;1132;15;2032.00;17
4825;15;621701204;4825;467;5958;5973;5.40;0.33;292.98;4.36;1133;15;2033.00;15
4826;15;621701215;4826;471;5959;5976;5.29;0.33;292.99;4.36;1133;15;2034.00;17
4826;15;621701226;4826;485;5962;5976;5.16;0.32;292.99;4.36;1136;15;2035.00;14
4830;15;621701236;4830;493;5963;5976;5.02;0.31;292.88;4.36;1133;15;2036.00;13
4831;15;621701248;4831;501;5966;5980;4.89;0.30;292.94;4.36;1135;15;2037.00;14
4835;15;621701258;4835;510;5969;5981;4.75;0.29;292.87;4.36;1134;15;2038.00;12
4839;15;621701269;4839;522;5970;5981;4.62;0.28;292.85;4.37;1131;15;2039.00;11
4842;15;621701280;4842;514;5976;5986;4.57;0.28;292.88;4.36;1134;15;2040.00;10
4844;15;621701298;4844;516;5977;5986;4.52;0.28;292.95;4.36;1133;15;2041.00;9
4845;15;621701316;4845;515;5977;5986;4.50;0.28;292.96;4.36;1132;15;2042.00;9
4849;15;621701333;4849;500;5977;5987;4.46;0.27;292.90;4.36;1128;15;2043.00;10
4849;15;621701351;4849;489;5978;5987;4.51;0.28;292.90;4.36;1129;15;2044.00;9
4854;15;621701367;4854;477;5983;5993;4.61;0.28;292.74;4.36;1129;15;2045.00;10
4856;15;621701384;4856;470;5984;5993;4.70;0.29;292.73;4.36;1128;15;2046.00;9
4859;15;621701398;4859;462;5985;5994;4.79;0.29;292.77;4.36;1126;15;2047.00;9
4864;15;621701412;4864;456;5985;5994;4.83;0.29;292.68;4.36;1121;15;2048.00;9
4865;15;621701424;4865;454;5985;5994;4.89;0.30;292.64;4.36;1120;15;2049.00;9
4869;15;621701437;4869;447;5985;5994;4.91;0.30;292.54;4.36;1116;15;2050.00;9
4870;15;621701450;4870;444;5986;5994;4.93;0.30;292.53;4.39;1116;15;2051.00;8
4872;15;621701462;4872;437;5998;6006;5.02;0.31;292.49;4.38;1126;15;2052.00;8
4874;15;621701477;4874;441;5998;6006;5.00;0.30;292.50;4.38;1124;15;2053.00;8
4878;15;621701490;4878;443;5998;6006;4.98;0.30;292.59;4.38;1120;15;2054.00;8
4880;15;621701503;4880;450;5998;6006;5.00;0.30;292.58;4.38;1118;15;2055.00;8
4882;15;621701516;4882;452;5998;6006;5.00;0.30;292.64;4.38;1116;15;2056.00;8
4886;15;621701528;4886;451;5998;6006;5.02;0.30;292.58;4.38;1112;15;2057.00;8
4887;15;621701541;4887;449;6002;6010;5.11;0.31;292.61;4.38;1115;15;2058.00;8
4889;15;621701554;4889;449;6002;6010;5.15;0.31;292.61;4.38;1113;15;2059.00;8
4891;15;621701566;4891;452;6006;6014;5.29;0.32;292.66;4.38;1115;15;2060.00;8
4893;15;621701580;4893;451;6006;6015;5.34;0.32;292.70;4.38;1113;15;2061.00;9
4893;15;621701593;4893;445;6007;6015;5.38;0.33;292.70;4.37;1114;15;2062.00;8
4900;15;621701606;4900;444;6007;6015;5.34;0.32;292.69;4.37;1107;15;2063.00;8
4901;15;621701618;4901;446;6018;6028;5.43;0.33;292.67;4.37;1117;15;2064.00;10
4904;15;621701631;4904;444;6018;6028;5.43;0.33;292.73;4.37;1114;15;2065.00;10
4908;15;621701644;4908;447;6018;6028;5.45;0.33;292.88;4.37;1110;15;2066.00;10
4910;15;621701656;4910;453;6020;6029;5.51;0.33;292.90;4.39;1110;15;2067.00;9
4919;15;621701669;4919;447;6020;6030;5.48;0.33;292.91;4.39;1101;15;2068.00;10
4924;15;621701681;4924;448;6020;6030;5.48;0.33;293.03;4.39;1096;15;2069.00;10
4927;15;621701696;4927;442;6025;6036;5.54;0.34;293.09;4.39;1098;15;2070.00;11
4932;15;621701710;4932;442;6025;6036;5.48;0.33;293.12;4.39;1093;15;2071.00;11
4938;15;621701722;4938;446;6026;6036;5.41;0.33;293.09;4.39;1088;15;2072.00;10
4943;15;621701735;4943;448;6026;6036;5.40;0.33;293.22;4.39;1083;15;2073.00;10
4947;15;621701747;4947;444;6031;6042;5.46;0.33;293.26;4.38;1084;15;2074.00;11
4951;15;621701760;4951;440;6031;6042;5.50;0.34;293.37;4.38;1080;15;2075.00;11
4955;15;621701774;4955;432;6031;6042;5.55;0.34;293.44;4.38;1076;15;2076.00;11
4961;15;621701786;4961;437;6031;6042;5.51;0.34;293.65;4.38;1070;15;2077.00;11
4964;15;621701798;4964;432;6034;6046;5.58;0.34;293.73;4.38;1070;15;2078.00;12
4967;15;621701812;4967;433;6035;6047;5.61;0.34;293.78;4.38;1068;15;2079.00;12
4972;15;621701825;4972;431;6035;6047;5.55;0.34;293.93;4.38;1063;15;2080.00;12
4977;15;621701837;4977;426;6036;6048;5.48;0.33;293.95;4.38;1059;15;2081.00;12
4980;15;621701850;4980;429;6036;6048;5.44;0.33;294.07;4.38;1056;15;2082.00;12
4983;15;621701863;4983;432;6036;6048;5.41;0.33;293.96;4.38;1053;15;2083.00;12
4986;15;621701875;4986;436;6037;6048;5.35;0.33;293.99;4.41;1051;15;2084.00;11
4987;15;621701887;4987;440;6037;6048;5.30;0.32;293.99;4.41;1050;15;2085.00;11
4991;15;621701899;4991;442;6037;6048;5.22;0.32;294.17;4.41;1046;15;2086.00;11
4992;15;621701911;4992;429;6037;6048;5.20;0.32;294.14;4.41;1045;15;2087.00;11
4994;15;621701924;4994;450;6079;6118;5.25;0.32;294.25;4.38;1085;15;2088.00;39
4995;15;621701943;4995;435;6079;6119;5.30;0.33;294.27;4.38;1084;15;2089.00;40
4997;15;621701956;4997;429;6084;6119;5.37;0.33;294.37;4.37;1087;15;2090.00;35
4998;15;621701970;4998;422;6086;6119;5.40;0.33;294.41;4.37;1088;15;2091.00;33
5001;15;621701983;5001;419;6088;6119;5.44;0.33;294.48;4.37;1087;15;2092.00;31
5003;15;621701995;5003;420;6090;6119;5.52;0.34;294.49;4.37;1087;15;2093.00;29
5005;15;621702008;5005;417;6094;6119;5.57;0.34;294.60;4.40;1089;15;2094.00;25
5007;15;621702021;5007;425;6097;6119;5.64;0.34;294.76;4.40;1090;15;2095.00;22
5008;15;621702034;5008;420;6098;6120;5.70;0.35;294.78;4.40;1090;15;2096.00;22
5010;15;621702046;5010;418;6100;6121;5.76;0.35;294.94;4.40;1090;15;2097.00;21
5012;15;621702060;5012;409;6102;6121;5.85;0.36;294.93;4.40;1090;15;2098.00;19
5012;15;621702074;5012;409;6107;6125;5.90;0.36;294.93;4.40;1095;15;2099.00;18
5016;15;621702089;5016;420;6113;6140;5.94;0.36;295.05;4.40;1097;15;2100.00;27
5019;15;621702112;5019;418;6113;6140;5.94;0.36;295.16;4.40;1094;15;2101.00;27
5021;15;621702126;5021;427;6113;6140;5.95;0.36;295.22;4.40;1092;15;2102.00;27
5023;15;621702139;5023;432;6117;6146;5.94;0.36;295.37;4.40;1094;15;2103.00;29
5024;15;621702153;5024;442;6117;6146;5.92;0.36;295.39;4.40;1093;15;2104.00;29
5026;15;621702167;5026;449;6119;6146;5.87;0.36;295.48;4.40;1093;15;2105.00;27
5027;15;621702182;5027;452;6121;6149;5.87;0.36;295.52;4.40;1094;15;2106.00;28
5030;15;621702196;5030;455;6121;6149;5.85;0.36;295.66;4.40;1091;15;2107.00;28
5032;15;621702209;5032;449;6122;6149;5.84;0.36;295.75;4.40;1090;15;2108.00;27
5033;15;621702223;5033;450;6122;6150;5.85;0.36;295.79;4.40;1089;15;2109.00;28
5035;15;621702237;5035;441;6123;6151;5.87;0.36;295.85;4.40;1088;15;2110.00;28
5037;15;621702251;5037;443;6125;6151;5.89;0.36;295.94;4.40;1088;15;2111.00;26
5041;15;621702265;5041;436;6135;6164;5.91;0.36;296.11;4.39;1094;15;2112.00;29
5046;15;621702280;5046;433;6135;6164;5.91;0.36;296.15;4.39;1089;15;2113.00;29
5050;15;621702294;5050;427;6135;6164;5.94;0.36;296.32;4.39;1085;15;2114.00;29
5053;15;621702309;5053;428;6137;6166;5.98;0.36;296.34;4.39;1084;15;2115.00;29
5056;15;621702323;5056;428;6137;6166;6.03;0.37;296.34;4.39;1081;15;2116.00;29
5058;15;621702336;5058;428;6142;6170;6.01;0.36;296.49;4.39;1084;15;2117.00;28
5062;15;621702349;5062;421;6142;6170;5.99;0.36;296.51;4.39;1080;15;2118.00;28
5064;15;621702361;5064;420;6145;6174;5.96;0.36;296.46;4.39;1081;15;2119.00;29
5069;15;621702374;5069;415;6145;6174;5.94;0.36;296.57;4.39;1076;15;2120.00;29
5072;15;621702386;5072;416;6145;6174;5.96;0.36;296.57;4.39;1073;15;2121.00;29
5073;15;621702399;5073;411;6145;6174;5.97;0.36;296.57;4.39;1072;15;2122.00;29
5075;15;621702410;5075;412;6147;6174;5.98;0.36;296.62;4.40;1072;15;2123.00;27
5076;15;621702423;5076;412;6155;6186;5.98;0.36;296.62;4.39;1079;15;2124.00;31
5076;15;621702435;5076;410;6156;6186;6.02;0.37;296.62;4.41;1080;15;2125.00;30
5080;15;621702447;5080;410;6160;6186;6.06;0.37;296.71;4.42;1080;15;2126.00;26
5085;15;621702460;5085;413;6160;6186;6.05;0.37;296.91;4.42;1075;15;2127.00;26
5087;15;621702473;5087;414;6160;6186;6.05;0.37;296.93;4.42;1073;15;2128.00;26
5088;15;621702485;5088;414;6162;6186;6.06;0.37;296.97;4.42;1074;15;2129.00;24
5089;15;621702499;5089;407;6162;6187;6.00;0.36;297.00;4.42;1073;15;2130.00;25
5091;15;621702511;5091;405;6163;6187;6.01;0.36;297.00;4.42;1072;15;2131.00;24
5094;15;621702523;5094;404;6168;6193;6.02;0.36;297.12;4.42;1074;15;2132.00;25
5098;15;621702536;5098;397;6169;6194;5.94;0.36;297.31;4.42;1071;15;2133.00;25
5100;15;621702549;5100;392;6169;6194;5.83;0.35;297.35;4.42;1069;15;2134.00;25
5102;15;621702560;5102;385;6169;6194;5.77;0.35;297.34;4.42;1067;15;2135.00;25
5102;15;621702572;5102;392;6172;6198;5.83;0.35;297.34;4.42;1070;15;2136.00;26
5106;15;621702584;5106;390;6172;6198;5.76;0.35;297.41;4.42;1066;15;2137.00;26
5107;15;621702596;5107;391;6172;6198;5.80;0.35;297.44;4.42;1065;15;2138.00;26
5108;15;621702608;5108;383;6173;6199;5.80;0.35;297.56;4.42;1065;15;2139.00;26
5110;15;621702619;5110;381;6176;6203;5.76;0.35;297.69;4.42;1066;15;2140.00;27
5114;15;621702631;5114;373;6176;6203;5.71;0.35;297.83;4.42;1062;15;2141.00;27
5116;15;621702642;5116;365;6178;6206;5.71;0.35;297.87;4.41;1062;15;2142.00;28
5119;15;621702654;5119;366;6179;6206;5.70;0.35;297.97;4.41;1060;15;2143.00;27
5124;15;621702665;5124;365;6179;6206;5.65;0.34;298.01;4.41;1055;15;2144.00;27
5125;15;621702676;5125;368;6181;6206;5.66;0.34;298.15;4.44;1056;15;2145.00;25
5128;15;621702689;5128;360;6185;6210;5.76;0.35;298.13;4.44;1057;15;2146.00;25
5131;15;621702700;5131;361;6185;6210;5.78;0.35;298.20;4.44;1054;15;2147.00;25
5134;15;621702711;5134;355;6185;6210;5.81;0.35;298.22;4.44;1051;15;2148.00;25
5139;15;621702722;5139;361;6185;6210;5.87;0.36;298.37;4.44;1046;15;2149.00;25
5142;15;621702733;5142;364;6185;6211;5.92;0.36;298.46;4.44;1043;15;2150.00;26
5146;15;621702745;5146;349;6186;6212;5.90;0.36;298.50;4.44;1040;15;2151.00;26
5152;15;621702756;5152;343;6186;6212;5.88;0.36;298.52;4.44;1034;15;2152.00;26
5155;15;621702768;5155;344;6187;6213;5.91;0.36;298.50;4.44;1032;15;2153.00;26
5156;15;621702779;5156;337;6187;6213;5.89;0.36;298.51;4.44;1031;15;2154.00;26
5158;15;621702790;5158;343;6187;6213;5.87;0.36;298.56;4.44;1029;15;2155.00;26
5159;15;621702801;5159;338;6187;6213;5.86;0.36;298.58;4.44;1028;15;2156.00;26
5161;15;621702812;5161;350;6187;6213;5.87;0.36;298.67;4.44;1026;15;2157.00;26
5161;15;621702823;5161;345;6187;6213;5.86;0.36;298.67;4.44;1026;15;2158.00;26
5163;15;621702833;5163;352;6187;6213;5.82;0.36;298.73;4.44;1024;15;2159.00;26
5165;15;621702846;5165;382;6281;6443;6.16;0.39;298.73;4.37;1116;15;2160.00;162
5171;15;621702874;5171;381;6283;6444;6.17;0.39;298.88;4.37;1112;15;2161.00;161
5171;15;621702886;5171;375;6295;6444;6.31;0.40;298.88;4.36;1124;15;2162.00;149
5172;15;621702898;5172;368;6302;6444;6.33;0.40;298.88;4.36;1130;15;2163.00;142
5174;15;621702910;5174;364;6313;6444;6.34;0.40;298.83;4.36;1139;15;2164.00;131
5175;15;621702921;5175;362;6321;6444;6.34;0.40;298.79;4.36;1146;15;2165.00;123
5176;15;621702940;5176;353;6332;6444;6.37;0.40;298.80;4.37;1156;15;2166.00;112
5178;15;621702952;5178;358;6339;6444;6.35;0.39;298.74;4.37;1161;15;2167.00;105
5181;15;621702971;5181;365;6346;6445;6.33;0.39;298.76;4.37;1165;15;2168.00;99
5182;15;621702984;5182;368;6351;6446;6.30;0.39;298.73;4.38;1169;15;2169.00;95
5186;15;621702997;5186;362;6357;6446;6.21;0.39;298.68;4.40;1171;15;2170.00;89
5187;15;621703009;5187;360;6361;6447;6.20;0.38;298.69;4.41;1174;15;2171.00;86
5188;15;621703022;5188;369;6367;6447;6.14;0.38;298.65;4.43;1179;15;2172.00;80
5188;15;621703034;5188;378;6368;6447;6.08;0.38;298.65;4.43;1180;15;2173.00;79
5191;15;621703048;5191;381;6370;6447;5.96;0.37;298.52;4.45;1179;15;2174.00;77
5194;15;621703061;5194;383;6376;6451;5.82;0.36;298.52;4.46;1182;15;2175.00;75
5197;15;621703074;5197;381;6379;6451;5.73;0.35;298.54;4.47;1182;15;2176.00;72
5199;15;621703087;5199;386;6383;6451;5.61;0.35;298.57;4.49;1184;15;2177.00;68
5200;15;621703100;5200;391;6388;6454;5.55;0.34;298.58;4.52;1188;15;2178.00;66
5202;15;621703113;5202;400;6390;6454;5.50;0.34;298.54;4.52;1188;15;2179.00;64
5207;15;621703125;5207;409;6391;6454;5.48;0.34;298.54;4.52;1184;15;2180.00;63
5209;15;621703138;5209;411;6398;6458;5.45;0.34;298.59;4.55;1189;15;2181.00;60
5210;15;621703150;5210;424;6401;6459;5.41;0.33;298.53;4.55;1191;15;2182.00;58
5211;15;621703162;5211;433;6402;6459;5.35;0.33;298.55;4.56;1191;15;2183.00;57
5213;15;621703174;5213;442;6403;6463;5.26;0.33;298.58;4.56;1190;15;2184.00;60
5214;15;621703187;5214;448;6406;6463;5.21;0.32;298.56;4.56;1192;15;2185.00;57
5216;15;621703200;5216;460;6411;6463;5.15;0.32;298.48;4.61;1195;15;2186.00;52
5217;15;621703212;5217;468;6412;6464;5.11;0.32;298.45;4.61;1195;15;2187.00;52
5220;15;621703224;5220;471;6413;6464;5.06;0.31;298.41;4.62;1193;15;2188.00;51
5224;15;621703235;5224;470;6418;6470;5.01;0.31;298.27;4.62;1194;15;2189.00;52
5226;15;621703250;5226;473;6419;6470;5.01;0.31;298.20;4.63;1193;15;2190.00;51
5229;15;621703262;5229;477;6423;6471;4.98;0.31;298.20;4.66;1194;15;2191.00;48
5229;15;621703275;5229;477;6424;6471;4.94;0.30;298.20;4.66;1195;15;2192.00;47
5232;15;621703292;5232;488;6426;6471;4.85;0.30;298.09;4.67;1194;15;2193.00;45
5233;15;621703310;5233;485;6428;6471;4.86;0.30;298.07;4.68;1195;15;2194.00;43
5233;15;621703330;5233;483;6428;6471;4.88;0.30;298.07;4.68;1195;15;2195.00;43
5237;15;621703348;5237;478;6439;6483;4.94;0.30;297.91;4.69;1202;15;2196.00;44
5238;15;621703369;5238;472;6441;6483;4.96;0.30;297.93;4.70;1203;15;2197.00;42
5238;15;621703387;5238;474;6443;6483;5.01;0.31;297.93;4.70;1205;15;2198.00;40
5239;15;621703405;5239;474;6446;6483;5.01;0.31;297.90;4.71;1207;15;2199.00;37
5241;15;621703422;5241;473;6447;6483;5.05;0.31;297.85;4.71;1206;15;2200.00;36
5244;15;621703439;5244;466;6447;6483;5.03;0.31;297.78;4.71;1203;15;2201.00;36
5247;15;621703463;5247;470;6453;6487;4.97;0.30;297.70;4.72;1206;15;2202.00;34
5248;15;621703478;5248;475;6453;6487;4.99;0.31;297.69;4.72;1205;15;2203.00;34
5251;15;621703491;5251;466;6459;6491;5.02;0.31;297.61;4.73;1208;15;2204.00;32
5252;15;621703504;5252;471;6461;6493;4.99;0.31;297.59;4.73;1209;15;2205.00;32
5256;15;621703518;5256;469;6463;6493;4.95;0.30;297.71;4.74;1207;15;2206.00;30
5258;15;621703531;5258;469;6463;6493;4.88;0.30;297.72;4.74;1205;15;2207.00;30
5261;15;621703543;5261;475;6474;6506;4.82;0.30;297.73;4.74;1213;15;2208.00;32
5265;15;621703556;5265;481;6475;6506;4.77;0.29;297.56;4.74;1210;15;2209.00;31
5267;15;621703569;5267;480;6477;6508;4.74;0.29;297.59;4.74;1210;15;2210.00;31
5269;15;621703582;5269;466;6478;6509;4.76;0.29;297.64;4.74;1209;15;2211.00;31
5269;15;621703595;5269;459;6478;6510;4.83;0.30;297.64;4.74;1209;15;2212.00;32
5273;15;621703607;5273;448;6478;6510;4.84;0.30;297.72;4.74;1205;15;2213.00;32
5277;15;621703621;5277;444;6479;6513;4.89;0.30;297.82;4.74;1202;15;2214.00;34
5279;15;621703634;5279;436;6479;6513;4.90;0.30;297.82;4.74;1200;15;2215.00;34
5283;15;621703647;5283;428;6480;6513;4.91;0.30;297.83;4.74;1197;15;2216.00;33
5287;15;621703659;5287;421;6480;6513;4.92;0.30;297.97;4.74;1193;15;2217.00;33
5290;15;621703672;5290;404;6484;6519;4.91;0.30;297.95;4.74;1194;15;2218.00;35
5292;15;621703686;5292;400;6484;6519;4.93;0.30;298.02;4.74;1192;15;2219.00;35
5295;15;621703701;5295;392;6484;6519;4.92;0.30;297.99;4.74;1189;15;2220.00;35
5298;15;621703714;5298;390;6484;6519;4.97;0.30;298.04;4.74;1186;15;2221.00;35
5301;15;621703727;5301;394;6487;6523;5.04;0.31;298.17;4.74;1186;15;2222.00;36
5303;15;621703740;5303;379;6487;6524;5.09;0.31;298.25;4.74;1184;15;2223.00;37
5306;15;621703753;5306;377;6487;6524;5.11;0.31;298.36;4.74;1181;15;2224.00;37
5310;15;621703767;5310;370;6488;6525;5.13;0.31;298.41;4.73;1178;15;2225.00;37
5313;15;621703781;5313;374;6488;6525;5.18;0.32;298.45;4.73;1175;15;2226.00;37
5317;15;621703794;5317;374;6488;6525;5.16;0.32;298.78;4.73;1171;15;2227.00;37
5319;15;621703808;5319;377;6489;6525;5.26;0.32;298.78;4.74;1170;15;2228.00;36
5326;15;621703821;5326;381;6490;6525;5.24;0.32;299.00;4.74;1164;15;2229.00;35
5330;15;621703837;5330;382;6490;6525;5.29;0.32;299.07;4.74;1160;15;2230.00;35
5332;15;621703851;5332;376;6490;6525;5.32;0.33;299.15;4.74;1158;15;2231.00;35
5338;15;621703864;5338;390;6528;6595;5.39;0.33;299.20;4.71;1190;15;2232.00;67
5342;15;621703884;5342;384;6531;6596;5.41;0.33;299.26;4.71;1189;15;2233.00;65
5347;15;621703898;5347;385;6534;6596;5.43;0.33;299.22;4.71;1187;15;2234.00;62
5351;15;621703911;5351;380;6537;6596;5.38;0.33;299.37;4.74;1186;15;2235.00;59
5354;15;621703926;5354;379;6538;6596;5.37;0.33;299.30;4.74;1184;15;2236.00;58
5356;15;621703940;5356;373;6538;6596;5.39;0.33;299.34;4.74;1182;15;2237.00;58
5360;15;621703954;5360;372;6539;6596;5.38;0.33;299.42;4.74;1179;15;2238.00;57
5363;15;621703970;5363;374;6540;6596;5.38;0.33;299.52;4.74;1177;15;2239.00;56
5366;15;621703983;5366;375;6541;6597;5.41;0.33;299.73;4.75;1175;15;2240.00;56
5369;15;621703998;5369;369;6543;6598;5.48;0.34;299.69;4.75;1174;15;2241.00;55
5375;15;621704011;5375;372;6544;6598;5.43;0.33;299.97;4.75;1169;15;2242.00;54
5378;15;621704025;5378;370;6548;6602;5.47;0.34;299.98;4.75;1170;15;2243.00;54
5381;15;621704039;5381;372;6549;6602;5.46;0.33;300.14;4.75;1168;15;2244.00;53
5385;15;621704054;5385;372;6552;6602;5.46;0.33;300.18;4.75;1167;15;2245.00;50
5390;15;621704069;5390;373;6552;6602;5.47;0.33;300.16;4.75;1162;15;2246.00;50
5393;15;621704083;5393;373;6556;6608;5.52;0.34;300.27;4.75;1163;15;2247.00;52
5395;15;621704098;5395;372;6557;6608;5.56;0.34;300.23;4.75;1162;15;2248.00;51
5398;15;621704112;5398;378;6558;6608;5.58;0.34;300.33;4.76;1160;15;2249.00;50
5402;15;621704128;5402;380;6561;6614;5.60;0.34;300.53;4.76;1159;15;2250.00;53
5403;15;621704143;5403;395;6562;6614;5.61;0.34;300.56;4.76;1159;15;2251.00;52
5406;15;621704157;5406;395;6564;6614;5.61;0.34;300.64;4.76;1158;15;2252.00;50
5409;15;621704171;5409;399;6564;6615;5.59;0.34;300.58;4.76;1155;15;2253.00;51
5412;15;621704184;5412;404;6567;6616;5.54;0.34;300.82;4.77;1155;15;2254.00;49
5415;15;621704204;5415;407;6569;6616;5.48;0.33;300.84;4.77;1154;15;2255.00;47
5418;15;621704218;5418;419;6577;6629;5.41;0.33;301.03;4.77;1159;15;2256.00;52
5421;15;621704232;5421;420;6577;6629;5.36;0.33;301.21;4.77;1156;15;2257.00;52
5424;15;621704246;5424;411;6580;6629;5.35;0.33;301.34;4.77;1156;15;2258.00;49
5425;15;621704259;5425;404;6581;6630;5.35;0.33;301.37;4.77;1156;15;2259.00;49
5426;15;621704274;5426;404;6583;6630;5.37;0.33;301.44;4.77;1157;15;2260.00;47
5431;15;621704290;5431;407;6586;6634;5.39;0.33;301.62;4.77;1155;15;2261.00;48
5435;15;621704305;5435;406;6588;6634;5.45;0.33;301.70;4.84;1153;15;2262.00;46
5437;15;621704320;5437;412;6591;6638;5.55;0.34;301.81;4.84;1154;15;2263.00;47
5438;15;621704334;5438;408;6591;6638;5.64;0.34;301.93;4.84;1153;15;2264.00;47
5439;15;621704348;5439;406;6592;6638;5.77;0.35;301.95;4.84;1153;15;2265.00;46
5443;15;621704361;5443;400;6592;6638;5.79;0.35;302.02;4.84;1149;15;2266.00;46
5445;15;621704374;5445;403;6594;6638;5.85;0.35;302.01;4.88;1149;15;2267.00;44
5448;15;621704387;5448;395;6603;6650;5.95;0.36;302.10;4.87;1155;15;2268.00;47
5449;15;621704401;5449;394;6604;6650;6.04;0.37;302.15;4.87;1155;15;2269.00;46
5452;15;621704415;5452;394;6606;6650;6.07;0.37;302.13;4.87;1154;15;2270.00;44
5456;15;621704428;5456;395;6606;6650;6.08;0.37;302.27;4.87;1150;15;2271.00;44
5459;15;621704447;5459;401;6606;6650;6.10;0.37;302.33;4.87;1147;15;2272.00;44
5461;15;621704461;5461;402;6607;6650;6.11;0.37;302.38;4.87;1146;15;2273.00;43
5465;15;621704474;5465;406;6607;6651;6.12;0.37;302.57;4.87;1142;15;2274.00;44
5467;15;621704488;5467;415;6607;6651;6.08;0.37;302.65;4.87;1140;15;2275.00;44
5471;15;621704502;5471;420;6612;6657;6.11;0.37;302.72;4.87;1141;16;2276.00;45
5474;15;621704524;5474;414;6613;6658;6.09;0.37;302.86;4.87;1139;16;2277.00;45
5475;15;621704538;5475;420;6613;6658;6.05;0.37;302.82;4.87;1138;16;2278.00;45
5479;15;621704551;5479;414;6613;6658;6.05;0.37;302.82;4.87;1134;16;2279.00;45
5481;15;621704573;5481;409;6617;6663;6.05;0.37;302.95;4.86;1136;16;2280.00;46
5482;15;621704587;5482;403;6618;6663;6.09;0.37;302.95;4.90;1136;16;2281.00;45
5485;15;621704601;5485;409;6618;6663;6.11;0.37;303.09;4.90;1133;16;2282.00;45
5487;15;621704614;5487;405;6619;6664;6.09;0.37;303.35;4.90;1132;16;2283.00;45
5489;15;621704628;5489;409;6622;6668;6.09;0.37;303.46;4.90;1133;16;2284.00;46
5495;15;621704641;5495;406;6622;6668;6.06;0.37;303.72;4.90;1127;16;2285.00;46
5496;15;621704655;5496;407;6624;6671;6.05;0.37;303.76;4.90;1128;16;2286.00;47
5498;15;621704668;5498;408;6625;6671;6.04;0.37;303.77;4.90;1127;16;2287.00;46
5500;15;621704681;5500;413;6625;6671;5.96;0.36;303.77;4.90;1125;16;2288.00;46
5503;15;621704693;5503;410;6625;6671;5.90;0.36;304.01;4.90;1122;16;2289.00;46
5504;15;621704707;5504;416;6629;6675;5.86;0.36;304.04;4.90;1125;16;2290.00;46
5506;15;621704720;5506;414;6629;6675;5.79;0.35;304.14;4.90;1123;16;2291.00;46
5510;15;621704732;5510;416;6629;6675;5.73;0.35;304.25;4.90;1119;16;2292.00;46
5514;15;621704744;5514;425;6629;6675;5.67;0.34;304.38;4.90;1115;16;2293.00;46
5515;15;621704757;5515;420;6629;6676;5.60;0.34;304.35;4.90;1114;16;2294.00;47
5517;15;621704769;5517;424;6631;6678;5.56;0.34;304.42;4.89;1114;16;2295.00;47
5518;15;621704781;5518;426;6631;6678;5.54;0.34;304.43;4.89;1113;16;2296.00;47
5520;15;621704793;5520;425;6632;6679;5.49;0.33;304.39;4.89;1112;16;2297.00;47
5522;15;621704805;5522;430;6632;6679;5.45;0.33;304.44;4.89;1110;16;2298.00;47
5525;15;621704817;5525;433;6632;6679;5.41;0.33;304.53;4.89;1107;16;2299.00;47
5525;15;621704830;5525;434;6632;6679;5.39;0.33;304.53;4.89;1107;16;2300.00;47
5526;15;621704846;5526;435;6632;6679;5.35;0.33;304.51;4.89;1106;16;2301.00;47
5528;15;621704858;5528;425;6632;6679;5.31;0.32;304.54;4.89;1104;16;2302.00;47
5528;15;621704870;5528;425;6632;6679;5.34;0.33;304.54;4.89;1104;16;2303.00;47
5530;15;621704881;5530;448;6707;6806;5.45;0.34;304.59;4.87;1177;16;2304.00;99
5534;15;621704904;5534;432;6707;6807;5.43;0.34;304.68;4.87;1173;16;2305.00;100
5536;15;621704916;5536;421;6714;6807;5.52;0.34;304.67;4.87;1178;16;2306.00;93
5541;15;621704929;5541;417;6716;6807;5.54;0.34;304.65;4.87;1175;16;2307.00;91
5543;15;621704942;5543;414;6721;6807;5.56;0.34;304.63;4.87;1178;16;2308.00;86
5547;15;621704954;5547;406;6723;6807;5.51;0.34;304.73;4.87;1176;16;2309.00;84
5548;15;621704969;5548;402;6726;6807;5.52;0.34;304.76;4.87;1178;16;2310.00;81
5552;15;621704981;5552;413;6729;6807;5.50;0.34;304.83;4.87;1177;16;2311.00;78
5553;16;621704999;5553;411;6731;6808;5.45;0.34;304.86;4.87;1178;17;2312.00;77
5554;16;621705018;5554;420;6735;6809;5.41;0.33;304.82;4.87;1181;17;2313.00;74
5556;16;621705031;5556;422;6738;6809;5.38;0.33;304.81;4.87;1182;17;2314.00;71
5556;16;621705043;5556;417;6742;6810;5.37;0.33;304.81;4.90;1186;17;2315.00;68
5559;16;621705056;5559;417;6747;6810;5.32;0.33;304.83;4.93;1188;17;2316.00;63
5564;16;621705068;5564;413;6749;6810;5.28;0.32;304.96;4.93;1185;17;2317.00;61
5565;16;621705085;5565;416;6749;6810;5.25;0.32;304.93;4.93;1184;17;2318.00;61
5568;16;621705097;5568;415;6754;6814;5.21;0.32;304.96;4.93;1186;17;2319.00;60
5573;16;621705109;5573;420;6756;6814;5.13;0.32;304.87;4.95;1183;17;2320.00;58
5574;16;621705122;5574;425;6756;6814;5.09;0.31;304.85;4.95;1182;17;2321.00;58
5578;16;621705134;5578;428;6759;6817;5.05;0.31;304.74;4.95;1181;17;2322.00;58
5580;16;621705147;5580;430;6759;6817;5.03;0.31;304.72;4.95;1179;17;2323.00;58
5583;16;621705159;5583;435;6760;6817;5.00;0.31;304.59;4.95;1177;17;2324.00;57
5585;16;621705171;5585;441;6764;6821;5.03;0.31;304.55;4.97;1179;17;2325.00;57
5588;16;621705183;5588;439;6767;6822;5.04;0.31;304.50;4.97;1179;17;2326.00;55
5590;16;621705195;5590;436;6767;6822;5.04;0.31;304.43;4.97;1177;17;2327.00;55
5592;16;621705207;5592;426;6770;6826;5.06;0.31;304.41;4.97;1178;17;2328.00;56
5594;16;621705221;5594;427;6770;6826;5.10;0.31;304.40;4.97;1176;17;2329.00;56
5595;16;621705233;5595;424;6771;6826;5.08;0.31;304.37;4.97;1176;17;2330.00;55
5597;16;621705245;5597;433;6772;6827;5.11;0.31;304.35;4.97;1175;17;2331.00;55
5602;16;621705257;5602;437;6772;6827;5.09;0.31;304.24;4.97;1170;17;2332.00;55
5606;16;621705269;5606;437;6777;6833;5.12;0.31;304.32;4.97;1171;17;2333.00;56
5609;16;621705282;5609;448;6777;6833;5.08;0.31;304.42;4.97;1168;17;2334.00;56
5612;16;621705299;5612;451;6777;6834;5.01;0.31;304.37;4.97;1165;17;2335.00;57
5613;16;621705322;5613;458;6777;6834;4.97;0.30;304.43;4.97;1164;17;2336.00;57
5614;16;621705341;5614;464;6778;6834;4.91;0.30;304.46;4.99;1164;17;2337.00;56
5616;16;621705360;5616;474;6778;6834;4.91;0.30;304.45;4.99;1162;17;2338.00;56
5617;16;621705378;5617;482;6778;6834;4.94;0.30;304.51;4.99;1161;17;2339.00;56
5619;16;621705396;5619;491;6805;6870;5.02;0.31;304.47;5.00;1186;17;2340.00;65
5623;16;621705419;5623;498;6806;6870;4.96;0.30;304.56;5.00;1183;17;2341.00;64
5625;16;621705432;5625;503;6810;6870;4.97;0.30;304.54;5.03;1185;17;2342.00;60
5625;16;621705446;5625;505;6811;6870;4.96;0.30;304.54;5.04;1186;17;2343.00;59
5625;16;621705459;5625;504;6812;6870;4.95;0.30;304.54;5.04;1187;17;2344.00;58
5627;16;621705473;5627;511;6813;6870;4.93;0.30;304.54;5.06;1186;17;2345.00;57
5628;16;621705485;5628;518;6818;6874;4.92;0.30;304.52;5.07;1190;17;2346.00;56
5629;16;621705499;5629;506;6818;6874;4.90;0.30;304.50;5.07;1189;17;2347.00;56
5630;16;621705512;5630;505;6823;6878;4.92;0.30;304.45;5.09;1193;17;2348.00;55
5630;16;621705525;5630;497;6824;6879;4.95;0.30;304.45;5.09;1194;17;2349.00;55
5630;16;621705538;5630;490;6825;6879;4.97;0.30;304.45;5.11;1195;17;2350.00;54
5632;16;621705549;5632;479;6827;6879;4.96;0.30;304.42;5.15;1195;17;2351.00;52
5633;16;621705562;5633;474;6839;6892;4.98;0.30;304.36;5.18;1206;17;2352.00;53
5635;16;621705576;5635;470;6840;6892;4.98;0.30;304.32;5.18;1205;17;2353.00;52
5636;16;621705597;5636;466;6842;6892;5.00;0.31;304.33;5.21;1206;17;2354.00;50
5639;16;621705610;5639;466;6845;6893;5.00;0.30;304.31;5.25;1206;17;2355.00;48
5639;16;621705622;5639;465;6845;6894;5.01;0.31;304.31;5.25;1206;17;2356.00;49
5642;16;621705634;5642;467;6847;6894;4.97;0.30;304.39;5.27;1205;17;2357.00;47
5643;16;621705647;5643;465;6849;6897;4.94;0.30;304.34;5.27;1206;17;2358.00;48
5644;16;621705659;5644;465;6849;6897;4.94;0.30;304.30;5.27;1205;17;2359.00;48
5646;16;621705672;5646;467;6850;6897;4.93;0.30;304.31;5.27;1204;17;2360.00;47
5647;16;621705685;5647;461;6852;6897;4.92;0.30;304.29;5.30;1205;17;2361.00;45
5648;16;621705704;5648;462;6857;6903;4.94;0.30;304.27;5.30;1209;17;2362.00;46
5650;16;621705724;5650;449;6861;6903;4.89;0.30;304.24;5.34;1211;17;2363.00;42
5651;16;621705737;5651;444;6861;6903;4.87;0.30;304.20;5.34;1210;17;2364.00;42
5651;16;621705750;5651;444;6861;6903;4.89;0.30;304.20;5.34;1210;17;2365.00;42
5653;16;621705769;5653;441;6866;6907;4.90;0.30;304.24;5.36;1213;17;2366.00;41
5655;16;621705782;5655;444;6867;6908;4.94;0.30;304.20;5.36;1212;17;2367.00;41
5658;16;621705794;5658;440;6868;6908;4.92;0.30;304.10;5.37;1210;17;2368.00;40
5661;16;621705807;5661;441;6870;6909;4.94;0.30;304.02;5.38;1209;17;2369.00;39
5663;16;621705821;5663;437;6870;6909;4.98;0.30;304.05;5.38;1207;17;2370.00;39
5666;16;621705833;5666;430;6872;6909;5.03;0.31;304.06;5.39;1206;17;2371.00;37
5669;16;621705845;5669;439;6872;6909;5.03;0.31;304.07;5.39;1203;17;2372.00;37
5671;16;621705857;5671;435;6873;6909;5.05;0.31;304.08;5.40;1202;17;2373.00;36
5674;16;621705868;5674;432;6874;6909;5.03;0.31;304.07;5.41;1200;17;2374.00;35
5674;16;621705881;5674;427;6874;6909;5.08;0.31;304.07;5.41;1200;17;2375.00;35
5679;16;621705892;5679;446;6928;6979;5.13;0.31;304.05;5.39;1249;17;2376.00;51
5681;16;621705910;5681;440;6930;6980;5.13;0.31;304.07;5.39;1249;17;2377.00;50
5684;16;621705922;5684;436;6933;6980;5.11;0.31;304.11;5.39;1249;17;2378.00;47
5685;16;621705936;5685;441;6936;6980;5.10;0.31;304.14;5.40;1251;17;2379.00;44
5690;16;621705947;5690;420;6937;6980;5.01;0.31;304.27;5.40;1247;17;2380.00;43
5694;16;621705960;5694;427;6938;6980;4.96;0.30;304.33;5.41;1244;17;2381.00;42
5695;16;621705973;5695;421;6940;6980;4.98;0.31;304.32;5.41;1245;17;2382.00;40
5700;16;621705985;5700;422;6940;6980;4.95;0.30;304.56;5.41;1240;17;2383.00;40
5704;16;621705998;5704;423;6942;6981;4.87;0.30;304.70;5.42;1238;17;2384.00;39
5707;16;621706019;5707;427;6946;6983;4.89;0.30;304.65;5.43;1239;17;2385.00;37
5708;16;621706031;5708;432;6947;6983;4.90;0.30;304.70;5.43;1239;17;2386.00;36
5712;16;621706051;5712;432;6950;6987;4.89;0.30;304.79;5.42;1238;17;2387.00;37
5717;16;621706064;5717;431;6951;6987;4.94;0.30;304.82;5.42;1234;17;2388.00;36
5720;16;621706078;5720;438;6953;6987;5.00;0.31;304.97;5.43;1233;17;2389.00;34
5725;16;621706092;5725;435;6953;6987;5.03;0.31;305.00;5.43;1228;17;2390.00;34
5725;16;621706106;5725;428;6956;6993;5.14;0.31;305.00;5.42;1231;17;2391.00;37
5728;16;621706126;5728;428;6956;6993;5.19;0.32;305.16;5.42;1228;17;2392.00;37
5731;16;621706141;5731;433;6957;6993;5.22;0.32;305.22;5.42;1226;17;2393.00;36
5733;16;621706154;5733;425;6958;6996;5.30;0.32;305.21;5.42;1225;17;2394.00;38
5736;16;621706169;5736;418;6958;6996;5.32;0.32;305.29;5.42;1222;17;2395.00;38
5738;16;621706183;5738;416;6958;6996;5.37;0.33;305.43;5.42;1220;17;2396.00;38
5741;16;621706196;5741;409;6959;6997;5.37;0.33;305.48;5.42;1218;17;2397.00;38
5745;16;621706210;5745;407;6959;6998;5.37;0.33;305.63;5.42;1214;17;2398.00;39
5752;16;621706226;5752;405;6959;6998;5.36;0.33;305.60;5.42;1207;17;2399.00;39
5755;16;621706243;5755;411;6978;7057;5.42;0.33;305.75;5.41;1223;17;2400.00;79
5757;16;621706268;5757;405;6981;7057;5.46;0.33;305.82;5.44;1224;17;2401.00;76
5761;16;621706282;5761;408;6984;7057;5.45;0.33;305.90;5.44;1223;17;2402.00;73
5764;16;621706297;5764;409;6986;7058;5.48;0.33;305.98;5.44;1222;17;2403.00;72
5768;16;621706311;5768;404;6988;7058;5.45;0.33;306.11;5.44;1220;17;2404.00;70
5771;16;621706326;5771;411;6990;7062;5.46;0.33;306.13;5.44;1219;17;2405.00;72
5775;16;621706341;5775;414;6993;7062;5.47;0.33;306.29;5.44;1218;17;2406.00;69
5778;16;621706355;5778;410;6997;7066;5.51;0.34;306.35;5.43;1219;17;2407.00;69
5785;16;621706369;5785;410;6998;7066;5.49;0.34;306.53;5.43;1213;17;2408.00;68
5788;16;621706383;5788;410;6998;7066;5.53;0.34;306.61;5.43;1210;17;2409.00;68
5789;16;621706402;5789;408;6999;7066;5.59;0.34;306.64;5.44;1210;17;2410.00;67
5794;16;621706417;5794;411;7002;7066;5.58;0.34;306.82;5.44;1208;17;2411.00;64
5797;16;621706432;5797;413;7007;7078;5.64;0.34;306.87;5.44;1210;17;2412.00;71
5802;16;621706448;5802;408;7009;7078;5.63;0.34;306.97;5.44;1207;17;2413.00;69
5805;16;621706464;5805;414;7010;7078;5.68;0.35;307.04;5.44;1205;17;2414.00;68
5809;16;621706480;5809;415;7011;7078;5.70;0.35;307.07;5.44;1202;17;2415.00;67
5813;16;621706496;5813;429;7012;7078;5.68;0.35;307.19;5.44;1199;17;2416.00;66
5818;16;621706511;5818;429;7015;7078;5.70;0.35;307.44;5.45;1197;17;2417.00;63
5821;16;621706527;5821;429;7017;7079;5.69;0.35;307.45;5.45;1196;17;2418.00;62
5827;16;621706542;5827;432;7019;7079;5.69;0.35;307.61;5.45;1192;17;2419.00;60
5831;16;621706563;5831;434;7022;7085;5.70;0.35;307.62;5.45;1191;17;2420.00;63
5836;16;621706579;5836;437;7024;7086;5.69;0.35;307.83;5.45;1188;17;2421.00;62
5837;16;621706594;5837;444;7026;7086;5.70;0.35;307.88;5.46;1189;17;2422.00;60
5839;16;621706609;5839;452;7026;7086;5.68;0.35;307.98;5.46;1187;17;2423.00;60
5840;16;621706624;5840;454;7029;7090;5.69;0.35;308.02;5.50;1189;17;2424.00;61
5846;16;621706639;5846;461;7031;7090;5.67;0.34;308.20;5.50;1185;17;2425.00;59
5851;16;621706653;5851;465;7035;7090;5.62;0.34;308.22;5.50;1184;17;2426.00;55
5855;16;621706667;5855;454;7036;7091;5.58;0.34;308.48;5.50;1181;17;2427.00;55
5858;16;621706683;5858;451;7039;7095;5.62;0.34;308.47;5.50;1181;17;2428.00;56
5861;16;621706698;5861;440;7039;7095;5.60;0.34;308.67;5.50;1178;17;2429.00;56
5867;16;621706721;5867;441;7044;7101;5.56;0.34;308.93;5.50;1177;17;2430.00;57
5870;16;621706736;5870;441;7046;7101;5.53;0.34;309.00;5.50;1176;17;2431.00;55
5873;16;621706757;5873;446;7047;7101;5.53;0.34;309.08;5.50;1174;17;2432.00;54
5876;16;621706772;5876;451;7047;7101;5.55;0.34;309.12;5.50;1171;17;2433.00;54
5877;16;621706792;5877;450;7051;7105;5.57;0.34;309.07;5.50;1174;17;2434.00;54
5881;16;621706806;5881;460;7051;7105;5.55;0.34;309.19;5.50;1170;17;2435.00;54
5887;16;621706826;5887;455;7051;7105;5.50;0.33;309.39;5.50;1164;17;2436.00;54
5889;16;621706840;5889;448;7051;7105;5.47;0.33;309.46;5.50;1162;17;2437.00;54
5892;16;621706853;5892;461;7052;7106;5.44;0.33;309.52;5.50;1160;17;2438.00;54
5893;16;621706867;5893;470;7053;7107;5.44;0.33;309.58;5.50;1160;17;2439.00;54
5895;16;621706880;5895;471;7053;7107;5.37;0.32;309.65;5.50;1158;17;2440.00;54
5897;16;621706893;5897;466;7054;7108;5.32;0.32;309.76;5.50;1157;17;2441.00;54
5900;16;621706912;5900;474;7054;7108;5.25;0.32;309.88;5.50;1154;17;2442.00;54
5901;16;621706925;5901;474;7055;7108;5.19;0.31;309.89;5.51;1154;17;2443.00;53
5902;16;621706938;5902;481;7055;7108;5.20;0.31;309.92;5.51;1153;17;2444.00;53
5903;16;621706951;5903;486;7055;7108;5.23;0.32;310.03;5.51;1152;17;2445.00;53
5905;16;621706964;5905;493;7055;7108;5.23;0.32;310.02;5.51;1150;17;2446.00;53
5906;16;621706977;5906;500;7055;7108;5.31;0.32;310.11;5.51;1149;17;2447.00;53
5910;16;621706990;5910;528;7120;7235;5.41;0.33;310.23;5.46;1210;17;2448.00;115
5912;16;621707013;5912;509;7121;7236;5.42;0.33;310.31;5.46;1209;17;2449.00;115
5916;16;621707026;5916;510;7128;7236;5.47;0.34;310.51;5.46;1212;17;2450.00;108
5920;16;621707040;5920;503;7129;7236;5.50;0.34;310.56;5.46;1209;17;2451.00;107
5920;16;621707053;5920;493;7135;7236;5.61;0.35;310.56;5.46;1215;17;2452.00;101
5923;16;621707066;5923;485;7138;7236;5.67;0.35;310.67;5.46;1215;17;2453.00;98
5927;16;621707079;5927;485;7143;7236;5.71;0.35;310.75;5.47;1216;17;2454.00;93
5930;16;621707094;5930;486;7147;7236;5.78;0.35;310.86;5.47;1217;17;2455.00;89
5932;16;621707107;5932;481;7150;7237;5.80;0.36;310.90;5.47;1218;17;2456.00;87
5936;16;621707121;5936;485;7154;7238;5.80;0.36;311.05;5.47;1218;17;2457.00;84
5937;16;621707134;5937;479;7157;7238;5.77;0.35;311.09;5.47;1220;17;2458.00;81
5939;16;621707147;5939;479;7160;7239;5.70;0.35;311.24;5.48;1221;17;2459.00;79
5942;16;621707162;5942;491;7162;7239;5.59;0.34;311.21;5.48;1220;17;2460.00;77
5946;16;621707175;5946;491;7163;7239;5.46;0.33;311.28;5.48;1217;17;2461.00;76
5948;16;621707189;5948;501;7167;7239;5.40;0.33;311.30;5.53;1219;17;2462.00;72
5951;16;621707202;5951;509;7173;7243;5.30;0.33;311.36;5.53;1222;17;2463.00;70
5952;16;621707216;5952;523;7174;7243;5.24;0.32;311.33;5.53;1222;17;2464.00;69
5955;16;621707229;5955;534;7174;7243;5.18;0.32;311.32;5.53;1219;17;2465.00;69
5956;16;621707241;5956;539;7178;7246;5.20;0.32;311.29;5.54;1222;17;2466.00;68
5958;16;621707255;5958;540;7179;7246;5.22;0.32;311.35;5.55;1221;17;2467.00;67
5959;16;621707268;5959;547;7182;7246;5.25;0.32;311.38;5.55;1223;17;2468.00;64
5961;16;621707280;5961;553;7186;7250;5.21;0.32;311.40;5.55;1225;17;2469.00;64
5962;16;621707298;5962;547;7188;7251;5.27;0.32;311.45;5.55;1226;17;2470.00;63
5965;16;621707325;5965;542;7189;7251;5.30;0.33;311.67;5.55;1224;17;2471.00;62
5969;16;621707348;5969;540;7191;7255;5.30;0.33;311.69;5.59;1222;17;2472.00;64
5972;16;621707370;5972;537;7191;7255;5.30;0.32;311.62;5.59;1219;17;2473.00;64
5975;16;621707391;5975;539;7192;7255;5.30;0.32;311.64;5.59;1217;17;2474.00;63
5976;16;621707411;5976;538;7194;7257;5.31;0.32;311.64;5.59;1218;17;2475.00;63
5977;16;621707429;5977;538;7194;7257;5.31;0.32;311.61;5.59;1217;17;2476.00;63
5982;16;621707445;5982;539;7199;7263;5.29;0.32;311.69;5.59;1217;17;2477.00;64
5985;16;621707461;5985;533;7199;7263;5.23;0.32;311.70;5.59;1214;17;2478.00;64
5989;16;621707478;5989;535;7199;7264;5.14;0.31;311.58;5.59;1210;17;2479.00;65
5992;16;621707493;5992;532;7199;7264;5.02;0.31;311.55;5.59;1207;17;2480.00;65
5997;16;621707506;5997;529;7199;7264;4.91;0.30;311.49;5.59;1202;17;2481.00;65
6000;16;621707520;6000;524;7199;7264;4.81;0.29;311.44;5.59;1199;17;2482.00;65
6001;16;621707532;6001;517;7199;7264;4.77;0.29;311.43;5.59;1198;17;2483.00;65
6003;16;621707545;6003;515;7208;7276;4.83;0.30;311.55;5.58;1205;17;2484.00;68
6007;16;621707559;6007;519;7211;7276;4.82;0.30;311.51;5.62;1204;17;2485.00;65
6010;16;621707573;6010;517;7212;7276;4.87;0.30;311.60;5.62;1202;17;2486.00;64
6012;16;621707586;6012;520;7212;7276;4.89;0.30;311.57;5.62;1200;17;2487.00;64
6016;16;621707599;6016;517;7212;7276;4.88;0.30;311.50;5.62;1196;17;2488.00;64
6019;16;621707613;6019;522;7212;7276;4.92;0.30;311.59;5.62;1193;17;2489.00;64
6023;16;621707628;6023;524;7215;7280;4.94;0.30;311.50;5.62;1192;17;2490.00;65
6024;16;621707645;6024;525;7215;7280;4.97;0.30;311.49;5.62;1191;17;2491.00;65
6025;16;621707665;6025;527;7219;7284;5.00;0.31;311.45;5.61;1194;17;2492.00;65
6027;16;621707678;6027;522;7220;7285;5.02;0.31;311.46;5.61;1193;17;2493.00;65
6031;16;621707692;6031;522;7220;7285;5.01;0.31;311.37;5.61;1189;17;2494.00;65
6033;16;621707705;6033;523;7221;7285;5.03;0.31;311.41;5.63;1188;17;2495.00;64
6036;16;621707718;6036;525;7230;7298;5.02;0.31;311.31;5.62;1194;17;2496.00;68
6040;16;621707731;6040;521;7230;7298;5.01;0.31;311.35;5.62;1190;17;2497.00;68
6044;16;621707745;6044;517;7230;7298;4.98;0.30;311.25;5.62;1186;17;2498.00;68
6045;16;621707757;6045;508;7231;7299;5.00;0.31;311.21;5.62;1186;17;2499.00;68
6049;16;621707772;6049;495;7231;7300;5.00;0.30;311.33;5.62;1182;17;2500.00;69
6050;16;621707796;6050;485;7233;7300;5.03;0.31;311.29;5.64;1183;17;2501.00;67
6053;16;621707808;6053;481;7235;7303;5.03;0.31;311.23;5.64;1182;17;2502.00;68
6054;16;621707822;6054;475;7236;7303;5.05;0.31;311.25;5.64;1182;17;2503.00;67
6056;16;621707835;6056;473;7237;7303;5.15;0.31;311.20;5.64;1181;17;2504.00;66
6058;16;621707848;6058;466;7238;7303;5.15;0.31;311.24;5.65;1180;17;2505.00;65
6059;16;621707867;6059;462;7245;7309;5.25;0.32;311.33;5.66;1186;17;2506.00;64
6059;16;621707881;6059;459;7245;7309;5.30;0.32;311.33;5.66;1186;17;2507.00;64
6061;16;621707894;6061;447;7245;7309;5.31;0.32;311.31;5.66;1184;17;2508.00;64
6061;16;621707906;6061;449;7247;7309;5.33;0.32;311.31;5.68;1186;17;2509.00;62
6063;16;621707919;6063;449;7250;7313;5.34;0.32;311.39;5.68;1187;17;2510.00;63
6064;16;621707933;6064;451;7252;7314;5.39;0.33;311.38;5.68;1188;17;2511.00;62
6067;16;621707946;6067;448;7252;7314;5.34;0.32;311.29;5.68;1185;17;2512.00;62
6067;16;621707959;6067;448;7253;7315;5.37;0.33;311.29;5.68;1186;17;2513.00;62
6069;16;621707979;6069;451;7254;7315;5.33;0.32;311.28;5.70;1185;17;2514.00;61
6069;16;621707993;6069;454;7255;7315;5.32;0.32;311.28;5.72;1186;17;2515.00;60
6070;16;621708005;6070;452;7255;7315;5.33;0.32;311.24;5.72;1185;17;2516.00;60
6071;16;621708017;6071;451;7256;7315;5.29;0.32;311.22;5.74;1185;17;2517.00;59
6071;16;621708030;6071;449;7256;7315;5.31;0.32;311.22;5.74;1185;17;2518.00;59
6072;16;621708042;6072;452;7258;7315;5.25;0.32;311.21;5.78;1186;17;2519.00;57
6073;16;621708055;6073;450;7315;7440;5.55;0.34;311.19;5.74;1242;17;2520.00;125
6074;16;621708078;6074;457;7318;7441;5.56;0.34;311.22;5.73;1244;17;2521.00;123
6076;16;621708091;6076;458;7331;7441;5.60;0.34;311.16;5.77;1255;17;2522.00;110
6077;16;621708105;6077;459;7339;7441;5.63;0.35;311.29;5.76;1262;17;2523.00;102
6080;16;621708118;6080;462;7345;7441;5.62;0.35;311.42;5.76;1265;17;2524.00;96
6086;16;621708130;6086;465;7346;7441;5.54;0.34;311.39;5.76;1260;17;2525.00;95
6090;16;621708144;6090;463;7350;7441;5.49;0.33;311.50;5.76;1260;17;2526.00;91
6092;16;621708157;6092;466;7355;7441;5.39;0.33;311.65;5.80;1263;17;2527.00;86
6092;16;621708170;6092;472;7359;7442;5.33;0.33;311.65;5.80;1267;17;2528.00;83
6094;16;621708182;6094;470;7361;7443;5.28;0.32;311.68;5.80;1267;17;2529.00;82
6098;16;621708195;6098;465;7363;7443;5.22;0.32;311.72;5.80;1265;17;2530.00;80
6100;16;621708209;6100;470;7369;7447;5.18;0.32;311.83;5.80;1269;17;2531.00;78
6101;16;621708224;6101;461;7371;7447;5.17;0.32;311.78;5.80;1270;17;2532.00;76
6104;16;621708237;6104;460;7371;7447;5.18;0.32;311.80;5.80;1267;17;2533.00;76
6106;16;621708251;6106;460;7372;7447;5.24;0.32;311.82;5.80;1266;17;2534.00;75
6106;16;621708265;6106;456;7377;7453;5.29;0.32;311.82;5.80;1271;17;2535.00;76
6108;16;621708279;6108;457;7377;7453;5.33;0.33;311.90;5.80;1269;17;2536.00;76
6108;16;621708295;6108;458;7378;7455;5.38;0.33;311.90;5.80;1270;17;2537.00;77
6110;16;621708309;6110;459;7381;7458;5.39;0.33;311.91;5.80;1271;17;2538.00;77
6112;16;621708323;6112;453;7381;7458;5.41;0.33;311.98;5.80;1269;17;2539.00;77
6114;16;621708336;6114;452;7382;7458;5.41;0.33;311.96;5.80;1268;17;2540.00;76
6115;16;621708350;6115;460;7382;7459;5.40;0.33;311.96;5.80;1267;17;2541.00;77
6120;16;621708362;6120;459;7383;7460;5.39;0.33;312.09;5.80;1263;17;2542.00;77
6122;16;621708376;6122;465;7383;7460;5.38;0.33;312.19;5.80;1261;17;2543.00;77
6126;16;621708390;6126;466;7393;7473;5.31;0.33;312.18;5.79;1267;17;2544.00;80
6130;16;621708414;6130;463;7393;7473;5.31;0.32;312.29;5.79;1263;17;2545.00;80
6134;16;621708428;6134;465;7394;7473;5.32;0.33;312.38;5.79;1260;17;2546.00;79
6136;16;621708441;6136;466;7394;7474;5.32;0.33;312.33;5.79;1258;17;2547.00;80
6141;16;621708454;6141;465;7394;7474;5.23;0.32;312.47;5.79;1253;17;2548.00;80
6145;16;621708467;6145;473;7398;7478;5.17;0.32;312.42;5.79;1253;17;2549.00;80
6146;16;621708482;6146;459;7401;7481;5.13;0.32;312.53;5.78;1255;17;2550.00;80
6151;16;621708496;6151;453;7404;7485;5.08;0.31;312.54;5.78;1253;17;2551.00;81
6152;16;621708509;6152;448;7405;7485;5.11;0.31;312.52;5.78;1253;17;2552.00;80
6154;16;621708522;6154;439;7405;7485;5.13;0.32;312.60;5.78;1251;17;2553.00;80
6158;16;621708535;6158;436;7405;7485;5.19;0.32;312.76;5.78;1247;17;2554.00;80
6161;16;621708548;6161;436;7405;7485;5.25;0.32;312.85;5.78;1244;17;2555.00;80
6165;16;621708561;6165;437;7416;7497;5.30;0.33;312.92;5.77;1251;17;2556.00;81
6169;16;621708575;6169;429;7416;7497;5.39;0.33;312.99;5.77;1247;17;2557.00;81
6172;16;621708589;6172;426;7416;7497;5.46;0.34;313.18;5.77;1244;17;2558.00;81
6174;16;621708602;6174;422;7416;7497;5.58;0.34;313.22;5.77;1242;17;2559.00;81
6179;16;621708616;6179;412;7416;7497;5.65;0.35;313.37;5.77;1237;17;2560.00;81
6181;16;621708630;6181;403;7416;7497;5.67;0.35;313.37;5.77;1235;17;2561.00;81
6184;16;621708644;6184;383;7416;7498;5.75;0.35;313.46;5.77;1232;17;2562.00;82
6188;16;621708658;6188;381;7416;7498;5.79;0.36;313.51;5.77;1228;17;2563.00;82
6191;16;621708672;6191;370;7421;7504;5.91;0.36;313.61;5.77;1230;17;2564.00;83
6199;16;621708687;6199;357;7423;7506;5.95;0.36;313.86;5.77;1224;17;2565.00;83
6203;16;621708702;6203;354;7423;7506;5.98;0.37;314.04;5.77;1220;17;2566.00;83
6205;16;621708722;6205;348;7423;7506;6.00;0.37;314.07;5.77;1218;17;2567.00;83
6211;16;621708736;6211;351;7426;7510;6.04;0.37;314.16;5.77;1215;17;2568.00;84
6214;16;621708750;6214;341;7426;7510;6.08;0.37;314.30;5.77;1212;17;2569.00;84
6224;16;621708764;6224;341;7426;7510;6.03;0.37;314.13;5.77;1202;17;2570.00;84
6226;16;621708779;6226;336;7427;7511;6.05;0.37;314.19;5.77;1201;17;2571.00;84
6229;16;621708793;6229;340;7430;7515;6.05;0.37;314.19;5.76;1201;17;2572.00;85
6236;16;621708807;6236;337;7430;7515;6.02;0.37;314.43;5.76;1194;17;2573.00;85
6239;16;621708821;6239;336;7433;7518;6.02;0.37;314.40;5.76;1194;17;2574.00;85
6243;16;621708837;6243;340;7433;7518;5.95;0.36;314.44;5.76;1190;17;2575.00;85
6247;16;621708853;6247;346;7433;7518;5.95;0.36;314.47;5.76;1186;17;2576.00;85
6253;16;621708866;6253;353;7433;7518;5.88;0.36;314.57;5.76;1180;17;2577.00;85
6257;16;621708880;6257;357;7437;7522;5.88;0.36;314.63;5.76;1180;17;2578.00;85
6264;16;621708894;6264;360;7437;7522;5.83;0.35;314.72;5.76;1173;17;2579.00;85
6267;16;621708914;6267;361;7437;7522;5.83;0.35;314.77;5.76;1170;17;2580.00;85
6273;16;621708928;6273;365;7438;7522;5.81;0.35;315.01;5.81;1165;17;2581.00;84
6278;16;621708943;6278;375;7438;7523;5.80;0.35;315.00;5.81;1160;17;2582.00;85
6282;16;621708956;6282;372;7439;7524;5.79;0.35;315.23;5.81;1157;17;2583.00;85
6285;16;621708970;6285;378;7439;7524;5.79;0.35;315.27;5.81;1154;17;2584.00;85
6288;16;621708984;6288;375;7440;7525;5.80;0.35;315.41;5.81;1152;17;2585.00;85
6289;16;621708997;6289;373;7440;7525;5.81;0.35;315.48;5.81;1151;17;2586.00;85
6295;16;621709010;6295;373;7440;7525;5.75;0.35;315.66;5.81;1145;17;2587.00;85
6298;16;621709023;6298;378;7440;7525;5.76;0.35;315.59;5.81;1142;17;2588.00;85
6304;16;621709036;6304;383;7440;7525;5.68;0.35;315.54;5.81;1136;17;2589.00;85
6305;16;621709049;6305;387;7440;7525;5.61;0.34;315.60;5.81;1135;17;2590.00;85
6306;16;621709061;6306;390;7440;7525;5.58;0.34;315.60;5.81;1134;17;2591.00;85
6309;16;621709074;6309;414;7513;7652;5.69;0.35;315.70;5.76;1204;17;2592.00;139
6311;16;621709097;6311;418;7515;7653;5.66;0.35;315.90;5.76;1204;17;2593.00;138
6314;16;621709110;6314;416;7520;7653;5.71;0.35;316.03;5.75;1206;17;2594.00;133
6319;16;621709123;6319;430;7522;7653;5.73;0.36;316.25;5.75;1203;17;2595.00;131
6323;16;621709137;6323;444;7526;7653;5.72;0.36;316.30;5.75;1203;17;2596.00;127
6326;16;621709150;6326;441;7530;7653;5.78;0.36;316.24;5.81;1204;17;2597.00;123
6329;16;621709163;6329;435;7532;7653;5.79;0.36;316.23;5.81;1203;17;2598.00;121
6333;16;621709177;6333;443;7534;7653;5.75;0.36;316.41;5.81;1201;17;2599.00;119
6340;16;621709191;6340;443;7537;7654;5.73;0.35;316.55;5.81;1197;17;2600.00;117
6341;16;621709209;6341;437;7540;7655;5.79;0.36;316.59;5.81;1199;17;2601.00;115
6345;16;621709222;6345;452;7542;7655;5.76;0.35;316.81;5.81;1197;17;2602.00;113
6346;16;621709237;6346;460;7545;7656;5.78;0.36;316.77;5.81;1199;17;2603.00;111
6349;16;621709250;6349;469;7547;7656;5.74;0.35;316.71;5.82;1198;17;2604.00;109
6351;16;621709264;6351;478;7550;7656;5.70;0.35;316.83;5.88;1199;17;2605.00;106
6355;16;621709276;6355;479;7556;7656;5.68;0.35;316.88;5.88;1201;17;2606.00;100
6358;16;621709295;6358;472;7560;7660;5.66;0.35;317.04;5.88;1202;17;2607.00;100
6360;16;621709317;6360;475;7561;7660;5.69;0.35;317.23;5.88;1201;17;2608.00;99
6363;16;621709354;6363;472;7563;7660;5.66;0.35;317.32;5.88;1200;17;2609.00;97
6365;16;621709377;6365;472;7566;7666;5.64;0.35;317.45;5.88;1201;17;2610.00;100
6367;16;621709398;6367;474;7567;7666;5.61;0.34;317.58;5.88;1200;17;2611.00;99
6370;16;621709417;6370;493;7569;7666;5.59;0.34;317.72;5.88;1199;17;2612.00;97
6373;16;621709432;6373;492;7573;7670;5.62;0.34;317.82;5.88;1200;17;2613.00;97
6374;16;621709447;6374;497;7574;7671;5.62;0.34;317.84;5.88;1200;17;2614.00;97
6379;16;621709462;6379;496;7575;7671;5.60;0.34;317.95;5.88;1196;17;2615.00;96
6381;16;621709484;6381;497;7579;7675;5.59;0.34;318.00;5.88;1198;17;2616.00;96
6383;16;621709500;6383;486;7579;7675;5.55;0.34;318.04;5.88;1196;17;2617.00;96
6386;16;621709515;6386;483;7580;7675;5.45;0.33;318.23;5.94;1194;17;2618.00;95
6387;16;621709529;6387;479;7581;7676;5.38;0.33;318.24;5.94;1194;17;2619.00;95
6389;16;621709544;6389;479;7581;7676;5.36;0.33;318.20;5.94;1192;17;2620.00;95
6392;16;621709558;6392;482;7586;7682;5.31;0.32;318.22;5.94;1194;17;2621.00;96
6394;16;621709572;6394;480;7586;7682;5.28;0.32;318.21;5.94;1192;17;2622.00;96
6399;16;621709586;6399;478;7586;7683;5.22;0.32;318.17;5.94;1187;17;2623.00;97
6400;16;621709600;6400;478;7586;7683;5.25;0.32;318.13;5.94;1186;17;2624.00;97
6404;16;621709614;6404;483;7587;7683;5.15;0.31;318.22;6.00;1183;17;2625.00;96
6406;16;621709627;6406;486;7587;7683;5.08;0.31;318.22;6.00;1181;17;2626.00;96
6406;16;621709641;6406;484;7587;7683;5.06;0.31;318.22;6.00;1181;17;2627.00;96
6408;16;621709654;6408;489;7597;7695;5.01;0.30;318.24;5.99;1189;17;2628.00;98
6412;16;621709668;6412;484;7598;7695;4.99;0.30;318.18;5.99;1186;17;2629.00;97
6414;16;621709681;6414;487;7598;7695;4.99;0.30;318.14;5.99;1184;17;2630.00;97
6415;16;621709695;6415;490;7599;7695;4.94;0.30;318.26;6.05;1184;17;2631.00;96
6418;16;621709708;6418;491;7599;7695;4.94;0.30;318.26;6.05;1181;17;2632.00;96
6420;16;621709721;6420;491;7599;7695;4.96;0.30;318.33;6.05;1179;17;2633.00;96
6422;16;621709733;6422;493;7602;7699;4.95;0.30;318.35;6.05;1180;17;2634.00;97
6423;16;621709747;6423;497;7602;7699;4.93;0.30;318.31;6.05;1179;17;2635.00;97
6423;16;621709761;6423;509;7606;7703;4.98;0.30;318.31;6.04;1183;17;2636.00;97
6425;16;621709775;6425;514;7607;7704;4.97;0.30;318.38;6.04;1182;17;2637.00;97
6428;16;621709788;6428;517;7608;7704;4.91;0.30;318.38;6.11;1180;17;2638.00;96
6429;16;621709801;6429;516;7608;7704;4.81;0.29;318.35;6.11;1179;17;2639.00;96
6429;16;621709816;6429;525;7631;7733;4.83;0.30;318.35;6.09;1202;17;2640.00;102
6432;16;621709832;6432;517;7631;7733;4.79;0.29;318.29;6.09;1199;17;2641.00;102
6433;16;621709849;6433;513;7633;7733;4.85;0.30;318.31;6.09;1200;17;2642.00;100
6436;16;621709862;6436;511;7634;7734;4.87;0.30;318.39;6.09;1198;17;2643.00;100
6440;16;621709876;6440;506;7634;7735;4.87;0.30;318.36;6.09;1194;17;2644.00;101
6441;16;621709890;6441;508;7635;7735;4.90;0.30;318.38;6.15;1194;17;2645.00;100
6444;16;621709903;6444;501;7637;7738;4.92;0.30;318.42;6.15;1193;17;2646.00;101
6444;16;621709917;6444;504;7637;7738;4.95;0.30;318.42;6.15;1193;17;2647.00;101
6447;16;621709929;6447;504;7638;7738;4.98;0.30;318.45;6.15;1191;17;2648.00;100
6448;16;621709943;6448;506;7639;7738;4.99;0.30;318.46;6.21;1191;17;2649.00;99
6451;16;621709956;6451;500;7644;7744;4.97;0.30;318.48;6.21;1193;17;2650.00;100
6455;16;621709971;6455;480;7644;7744;4.92;0.30;318.45;6.21;1189;17;2651.00;100
6458;16;621709984;6458;457;7644;7744;4.94;0.30;318.56;6.21;1186;17;2652.00;100
6463;16;621710003;6463;446;7644;7744;4.95;0.30;318.60;6.21;1181;17;2653.00;100
6463;16;621710016;6463;440;7647;7748;4.97;0.30;318.60;6.20;1184;17;2654.00;101
6464;16;621710030;6464;435;7651;7750;5.02;0.31;318.58;6.27;1187;17;2655.00;99
6466;16;621710045;6466;429;7651;7750;5.05;0.31;318.55;6.27;1185;17;2656.00;99
6468;16;621710059;6468;422;7652;7751;5.16;0.31;318.65;6.27;1184;17;2657.00;99
6471;16;621710090;6471;422;7652;7751;5.25;0.32;318.60;6.27;1181;17;2658.00;99
6475;16;621710105;6475;421;7652;7751;5.31;0.32;318.60;6.27;1177;17;2659.00;99
6476;16;621710120;6476;419;7652;7751;5.41;0.33;318.55;6.27;1176;17;2660.00;99
6477;16;621710134;6477;410;7652;7751;5.51;0.34;318.51;6.27;1175;17;2661.00;99
6478;16;621710148;6478;409;7652;7751;5.60;0.34;318.47;6.27;1174;17;2662.00;99
6479;16;621710162;6479;405;7652;7751;5.71;0.35;318.46;6.27;1173;17;2663.00;99
6482;16;621710176;6482;402;7687;7821;5.97;0.36;318.43;6.24;1205;17;2664.00;134
6484;16;621710198;6484;398;7689;7822;5.97;0.36;318.44;6.24;1205;17;2665.00;133
6486;16;621710222;6486;388;7696;7822;6.02;0.37;318.35;6.23;1210;17;2666.00;126
6487;16;621710235;6487;394;7700;7822;6.01;0.37;318.38;6.23;1213;17;2667.00;122
6488;16;621710249;6488;385;7702;7822;5.99;0.36;318.36;6.23;1214;17;2668.00;120
6489;16;621710263;6489;387;7705;7822;6.03;0.37;318.32;6.23;1216;17;2669.00;117
6491;16;621710279;6491;377;7707;7822;6.07;0.37;318.36;6.23;1216;17;2670.00;115
6491;16;621710298;6491;379;7709;7822;6.08;0.37;318.36;6.23;1218;17;2671.00;113
6493;16;621710312;6493;373;7711;7823;6.10;0.37;318.43;6.23;1218;17;2672.00;112
6495;16;621710335;6495;367;7712;7824;6.09;0.37;318.49;6.23;1217;17;2673.00;112
6497;16;621710350;6497;367;7714;7824;6.13;0.37;318.58;6.23;1217;17;2674.00;110
6501;16;621710363;6501;372;7719;7828;6.05;0.37;318.58;6.23;1218;17;2675.00;109
6506;16;621710377;6506;376;7721;7828;6.01;0.36;318.63;6.23;1215;17;2676.00;107
6508;16;621710391;6508;377;7722;7828;6.03;0.37;318.58;6.23;1214;17;2677.00;106
6510;16;621710404;6510;378;7723;7828;6.04;0.37;318.62;6.23;1213;17;2678.00;105
6512;16;621710417;6512;384;7728;7834;6.08;0.37;318.69;6.23;1216;17;2679.00;106
6515;16;621710431;6515;397;7729;7834;6.11;0.37;318.82;6.27;1214;17;2680.00;105
6517;16;621710444;6517;407;7730;7834;6.11;0.37;318.84;6.30;1213;17;2681.00;104
6517;16;621710457;6517;410;7732;7837;6.17;0.38;318.84;6.30;1215;17;2682.00;105
6523;16;621710472;6523;412;7733;7837;6.09;0.37;318.95;6.30;1210;17;2683.00;104
6525;16;621710485;6525;414;7735;7837;6.07;0.37;318.94;6.37;1210;17;2684.00;102
6527;16;621710498;6527;420;7736;7838;6.02;0.37;318.98;6.40;1209;17;2685.00;102
6529;16;621710518;6529;425;7739;7839;5.99;0.36;318.99;6.47;1210;17;2686.00;100
6532;16;621710532;6532;432;7739;7839;5.93;0.36;319.07;6.47;1207;17;2687.00;100
6535;16;621710545;6535;440;7750;7852;5.89;0.36;319.09;6.46;1215;17;2688.00;102
6538;16;621710566;6538;447;7754;7852;5.85;0.36;319.10;6.59;1216;17;2689.00;98
6540;16;621710580;6540;449;7754;7852;5.83;0.36;319.16;6.59;1214;17;2690.00;98
6543;16;621710594;6543;452;7756;7853;5.82;0.35;319.29;6.62;1213;17;2691.00;97
6544;16;621710608;6544;453;7757;7853;5.83;0.36;319.25;6.65;1213;17;2692.00;96
6546;16;621710622;6546;457;7761;7857;5.90;0.36;319.29;6.65;1215;17;2693.00;96
6548;16;621710637;6548;459;7761;7857;5.91;0.36;319.28;6.65;1213;17;2694.00;96
6550;16;621710650;6550;458;7765;7861;5.88;0.36;319.44;6.68;1215;17;2695.00;96
6552;16;621710664;6552;459;7765;7861;5.87;0.36;319.46;6.68;1213;17;2696.00;96
6555;16;621710677;6555;465;7766;7861;5.83;0.36;319.52;6.71;1211;17;2697.00;95
6556;16;621710691;6556;465;7766;7861;5.80;0.35;319.49;6.71;1210;17;2698.00;95
6558;16;621710704;6558;453;7766;7861;5.77;0.35;319.53;6.71;1208;17;2699.00;95
6560;16;621710720;6560;449;7791;7910;5.93;0.36;319.55;6.72;1231;17;2700.00;119
6561;16;621710744;6561;455;7793;7910;5.96;0.36;319.59;6.72;1232;17;2701.00;117
6562;16;621710758;6562;460;7797;7910;6.02;0.37;319.63;6.71;1235;17;2702.00;113
6568;16;621710772;6568;453;7800;7910;6.00;0.37;319.63;6.81;1232;17;2703.00;110
6569;16;621710787;6569;456;7802;7910;6.01;0.37;319.65;6.81;1233;17;2704.00;108
6573;16;621710802;6573;452;7802;7910;5.97;0.36;319.65;6.81;1229;17;2705.00;108
6575;16;621710816;6575;453;7808;7911;5.94;0.36;319.66;6.92;1233;17;2706.00;103
6577;16;621710830;6577;452;7809;7911;5.91;0.36;319.63;6.92;1232;17;2707.00;102
6577;16;621710856;6577;456;7813;7917;5.91;0.36;319.63;6.92;1236;17;2708.00;104
6581;16;621710870;6581;464;7815;7918;5.85;0.35;319.60;6.95;1234;17;2709.00;103
6584;16;621710884;6584;461;7816;7918;5.77;0.35;319.60;6.98;1232;17;2710.00;102
6585;16;621710898;6585;465;7817;7918;5.74;0.35;319.62;7.00;1232;17;2711.00;101
6585;16;621710912;6585;461;7821;7922;5.72;0.35;319.62;7.00;1236;17;2712.00;101
6587;16;621710926;6587;465;7824;7922;5.67;0.35;319.64;7.05;1237;17;2713.00;98
6592;16;621710941;6592;472;7824;7922;5.59;0.34;319.58;7.05;1232;17;2714.00;98
6596;16;621710955;6596;476;7825;7923;5.56;0.34;319.75;7.05;1229;17;2715.00;98
6599;16;621710970;6599;481;7830;7927;5.45;0.33;319.85;7.10;1231;17;2716.00;97
6601;16;621710985;6601;484;7830;7927;5.41;0.33;319.80;7.10;1229;17;2717.00;97
6608;16;621710999;6608;488;7834;7930;5.32;0.32;319.86;7.13;1226;17;2718.00;96
6610;16;621711014;6610;488;7836;7930;5.26;0.32;319.85;7.15;1226;17;2719.00;94
6614;16;621711028;6614;478;7838;7930;5.21;0.32;319.94;7.18;1224;17;2720.00;92
6619;16;621711042;6619;469;7839;7930;5.19;0.32;319.96;7.20;1220;17;2721.00;91
6623;16;621711056;6623;468;7842;7934;5.24;0.32;320.07;7.20;1219;17;2722.00;92
6623;16;621711071;6623;460;7844;7934;5.23;0.32;320.07;7.24;1221;17;2723.00;90
6627;16;621711085;6627;454;7846;7934;5.23;0.32;320.17;7.24;1219;17;2724.00;88
6628;16;621711099;6628;451;7846;7934;5.23;0.32;320.25;7.24;1218;17;2725.00;88
6632;16;621711113;6632;445;7846;7935;5.23;0.32;320.37;7.24;1214;17;2726.00;89
6634;16;621711127;6634;447;7847;7936;5.27;0.32;320.35;7.24;1213;17;2727.00;89
6636;16;621711141;6636;441;7847;7936;5.33;0.33;320.43;7.24;1211;17;2728.00;89
6642;16;621711156;6642;438;7848;7937;5.40;0.33;320.60;7.24;1206;17;2729.00;89
6644;16;621711173;6644;439;7850;7937;5.45;0.33;320.66;7.25;1206;17;2730.00;87
6647;16;621711187;6647;430;7850;7937;5.47;0.33;320.82;7.25;1203;17;2731.00;87
6654;16;621711202;6654;431;7852;7937;5.47;0.33;320.97;7.25;1198;17;2732.00;85
6659;16;621711217;6659;425;7852;7937;5.48;0.33;321.08;7.25;1193;17;2733.00;85
6664;16;621711232;6664;424;7852;7937;5.46;0.33;321.20;7.25;1188;17;2734.00;85
6669;16;621711246;6669;423;7852;7937;5.47;0.33;321.37;7.25;1183;17;2735.00;85
6676;16;621711261;6676;427;7921;8064;5.67;0.35;321.48;7.19;1245;17;2736.00;143
6678;16;621711288;6678;432;7925;8065;5.68;0.35;321.53;7.19;1247;17;2737.00;140
6683;16;621711308;6683;436;7933;8065;5.65;0.35;321.79;7.18;1250;17;2738.00;132
6690;16;621711341;6690;442;7937;8065;5.58;0.34;321.81;7.18;1247;17;2739.00;128
6695;16;621711363;6695;444;7939;8065;5.48;0.34;321.98;7.18;1244;17;2740.00;126
6700;16;621711383;6700;451;7943;8065;5.41;0.33;322.18;7.18;1243;17;2741.00;122
6706;16;621711401;6706;447;7945;8065;5.34;0.33;322.16;7.18;1239;17;2742.00;120
6711;16;621711418;6711;455;7949;8065;5.29;0.33;322.38;7.18;1238;17;2743.00;116
6716;16;621711434;6716;462;7952;8066;5.24;0.32;322.50;7.18;1236;17;2744.00;114
6718;16;621711450;6718;462;7954;8068;5.21;0.32;322.56;7.18;1236;17;2745.00;114
6721;16;621711465;6721;477;7956;8068;5.21;0.32;322.69;7.18;1235;17;2746.00;112
6724;16;621711482;6724;477;7958;8069;5.19;0.32;322.73;7.18;1234;17;2747.00;111
6726;16;621711497;6726;478;7960;8069;5.20;0.32;322.74;7.18;1234;17;2748.00;109
6731;16;621711514;6731;488;7963;8069;5.20;0.32;322.94;7.18;1232;17;2749.00;106
6738;16;621711532;6738;486;7964;8069;5.18;0.32;322.95;7.18;1226;17;2750.00;105
6742;16;621711547;6742;485;7969;8073;5.18;0.32;323.02;7.18;1227;17;2751.00;104
6746;16;621711563;6746;487;7972;8073;5.19;0.32;322.98;7.19;1226;17;2752.00;101
6747;16;621711578;6747;486;7972;8073;5.21;0.32;323.02;7.19;1225;17;2753.00;101
6753;16;621711594;6753;490;7974;8076;5.18;0.32;323.07;7.19;1221;17;2754.00;102
6755;16;621711609;6755;491;7975;8076;5.17;0.32;323.05;7.18;1220;17;2755.00;101
6760;16;621711623;6760;487;7975;8076;5.15;0.32;323.25;7.18;1215;17;2756.00;101
6763;16;621711638;6763;488;7979;8080;5.16;0.32;323.23;7.18;1216;17;2757.00;101
6765;16;621711652;6765;491;7980;8081;5.15;0.31;323.32;7.18;1215;17;2758.00;101
6769;16;621711666;6769;489;7982;8081;5.04;0.31;323.51;7.19;1213;17;2759.00;99
6772;16;621711693;6772;490;7985;8086;4.98;0.30;323.50;7.18;1213;17;2760.00;101
6774;16;621711708;6774;502;7988;8086;4.95;0.30;323.47;7.26;1214;17;2761.00;98
6780;16;621711722;6780;497;7989;8086;4.89;0.30;323.58;7.26;1209;17;2762.00;97
6781;16;621711736;6781;495;7990;8087;4.88;0.30;323.70;7.26;1209;17;2763.00;97
6783;16;621711749;6783;499;7991;8087;4.84;0.30;323.72;7.26;1208;17;2764.00;96
6785;16;621711762;6785;497;7996;8093;4.85;0.30;323.89;7.26;1211;17;2765.00;97
6790;16;621711783;6790;500;7996;8093;4.77;0.29;323.89;7.26;1206;17;2766.00;97
6792;16;621711797;6792;496;7996;8094;4.77;0.29;324.01;7.26;1204;17;2767.00;98
6794;16;621711812;6794;485;7996;8094;4.77;0.29;324.03;7.26;1202;17;2768.00;98
6798;16;621711826;6798;484;7996;8094;4.73;0.29;324.07;7.26;1198;17;2769.00;98
6803;16;621711841;6803;485;7996;8094;4.70;0.29;324.31;7.26;1193;17;2770.00;98
6806;16;621711855;6806;490;7996;8094;4.66;0.28;324.29;7.26;1190;17;2771.00;98
6810;16;621711869;6810;496;8006;8106;4.73;0.29;324.24;7.25;1196;17;2772.00;100
6810;16;621711884;6810;494;8007;8106;4.74;0.29;324.24;7.25;1197;17;2773.00;99
6813;16;621711897;6813;500;8007;8106;4.75;0.29;324.27;7.25;1194;17;2774.00;99
6816;16;621711912;6816;501;8007;8106;4.76;0.29;324.24;7.25;1191;17;2775.00;99
6818;16;621711926;6818;492;8007;8106;4.78;0.29;324.20;7.25;1189;17;2776.00;99
6820;16;621711940;6820;491;8008;8106;4.85;0.30;324.26;7.32;1188;17;2777.00;98
6822;16;621711961;6822;496;8011;8110;4.91;0.30;324.23;7.32;1189;17;2778.00;99
6823;16;621711975;6823;479;8011;8110;4.96;0.30;324.20;7.32;1188;17;2779.00;99
6825;16;621711990;6825;473;8015;8114;5.09;0.31;324.21;7.32;1190;17;2780.00;99
6825;16;621712004;6825;465;8016;8115;5.15;0.32;324.21;7.32;1191;17;2781.00;99
6829;16;621712019;6829;460;8016;8115;5.11;0.31;324.16;7.32;1187;17;2782.00;99
6833;16;621712033;6833;462;8016;8115;5.10;0.31;324.11;7.32;1183;17;2783.00;99
6835;16;621712047;6835;467;8027;8128;5.19;0.32;324.09;7.31;1192;17;2784.00;101
6839;16;621712063;6839;460;8028;8128;5.17;0.31;324.21;7.38;1189;17;2785.00;100
6842;16;621712078;6842;467;8028;8128;5.19;0.32;324.23;7.38;1186;18;2786.00;100
6844;16;621712103;6844;468;8029;8129;5.26;0.32;324.18;7.37;1185;18;2787.00;100
6844;16;621712117;6844;471;8029;8130;5.32;0.32;324.18;7.37;1185;18;2788.00;101
6846;16;621712131;6846;470;8029;8130;5.36;0.33;324.21;7.37;1183;18;2789.00;101
6847;16;621712148;6847;467;8033;8136;5.43;0.33;324.21;7.37;1186;18;2790.00;103
6849;16;621712163;6849;476;8033;8136;5.44;0.33;324.23;7.37;1184;18;2791.00;103
6850;16;621712176;6850;477;8035;8136;5.41;0.33;324.26;7.37;1185;18;2792.00;101
6855;16;621712190;6855;482;8035;8136;5.39;0.33;324.32;7.37;1180;18;2793.00;101
6858;16;621712204;6858;490;8040;8142;5.40;0.33;324.28;7.37;1182;18;2794.00;102
6859;16;621712219;6859;491;8040;8142;5.36;0.33;324.30;7.37;1181;18;2795.00;102
6860;16;621712233;6860;484;8040;8142;5.29;0.32;324.32;7.37;1180;18;2796.00;102
6861;16;621712247;6861;486;8040;8142;5.24;0.32;324.28;7.37;1179;18;2797.00;102
6864;16;621712260;6864;487;8043;8146;5.17;0.32;324.26;7.36;1179;18;2798.00;103
6865;16;621712275;6865;493;8044;8147;5.20;0.32;324.26;7.36;1179;18;2799.00;103
6868;16;621712290;6868;499;8044;8147;5.16;0.31;324.21;7.36;1176;18;2800.00;103
6870;16;621712316;6870;497;8045;8148;5.11;0.31;324.32;7.36;1175;18;2801.00;103
6871;16;621712331;6871;503;8045;8148;5.08;0.31;324.30;7.36;1174;18;2802.00;103
6871;16;621712345;6871;494;8045;8148;5.06;0.31;324.30;7.36;1174;18;2803.00;103
6872;16;621712358;6872;485;8045;8148;5.04;0.31;324.30;7.36;1173;18;2804.00;103
6875;16;621712370;6875;490;8045;8148;5.05;0.31;324.31;7.36;1170;18;2805.00;103
6876;16;621712383;6876;482;8045;8148;5.09;0.31;324.31;7.36;1169;18;2806.00;103
6877;16;621712396;6877;478;8045;8148;5.07;0.31;324.30;7.36;1168;18;2807.00;103
6879;16;621712409;6879;492;8085;8218;5.16;0.31;324.33;7.32;1206;18;2808.00;133
6881;16;621712428;6881;475;8085;8219;5.20;0.32;324.39;7.32;1204;18;2809.00;134
6881;16;621712441;6881;456;8091;8219;5.31;0.32;324.39;7.32;1210;18;2810.00;128
6884;16;621712455;6884;442;8093;8219;5.34;0.33;324.38;7.32;1209;18;2811.00;126
6884;16;621712469;6884;432;8096;8219;5.45;0.33;324.38;7.32;1212;18;2812.00;123
6886;16;621712482;6886;428;8097;8219;5.48;0.33;324.41;7.32;1211;18;2813.00;122
6889;16;621712496;6889;430;8100;8219;5.54;0.34;324.45;7.32;1211;18;2814.00;119
6890;16;621712511;6890;422;8103;8219;5.63;0.34;324.42;7.32;1213;18;2815.00;116
6892;16;621712524;6892;417;8106;8220;5.71;0.35;324.50;7.38;1214;18;2816.00;114
6893;16;621712538;6893;409;8109;8221;5.76;0.35;324.58;7.38;1216;18;2817.00;112
6898;16;621712559;6898;411;8112;8221;5.77;0.35;324.58;7.38;1214;18;2818.00;109
6899;16;621712572;6899;401;8116;8225;5.79;0.35;324.60;7.38;1217;18;2819.00;109
6901;16;621712588;6901;406;8117;8225;5.78;0.35;324.63;7.38;1216;18;2820.00;108
6902;16;621712607;6902;398;8117;8225;5.78;0.35;324.60;7.38;1215;18;2821.00;108
6903;16;621712620;6903;392;8117;8225;5.79;0.35;324.61;7.38;1214;18;2822.00;108
6907;16;621712633;6907;388;8122;8231;5.81;0.35;324.59;7.37;1215;18;2823.00;109
6910;16;621712653;6910;379;8122;8231;5.83;0.35;324.60;7.37;1212;18;2824.00;109
6911;16;621712667;6911;384;8123;8231;5.84;0.36;324.67;7.41;1212;18;2825.00;108
6915;16;621712682;6915;376;8125;8234;5.87;0.36;324.77;7.41;1210;18;2826.00;109
6918;16;621712696;6918;377;8126;8234;5.94;0.36;324.78;7.41;1208;18;2827.00;108
6922;16;621712710;6922;371;8127;8234;5.99;0.36;324.94;7.44;1205;18;2828.00;107
6928;16;621712724;6928;365;8127;8235;5.99;0.36;324.88;7.44;1199;18;2829.00;108
6930;16;621712743;6930;369;8128;8236;6.01;0.37;324.87;7.44;1198;18;2830.00;108
6934;16;621712756;6934;367;8128;8236;5.96;0.36;324.86;7.44;1194;18;2831.00;108
6937;16;621712770;6937;361;8137;8249;5.92;0.36;324.86;7.44;1200;18;2832.00;112
6943;16;621712784;6943;357;8139;8249;5.93;0.36;324.96;7.43;1196;18;2833.00;110
6946;16;621712797;6946;358;8139;8249;5.97;0.36;324.86;7.43;1193;18;2834.00;110
6948;16;621712811;6948;360;8141;8251;6.02;0.37;324.84;7.43;1193;18;2835.00;110
6950;16;621712824;6950;362;8141;8251;6.09;0.37;324.76;7.43;1191;18;2836.00;110
6953;16;621712838;6953;363;8145;8255;6.15;0.37;324.83;7.43;1192;18;2837.00;110
6955;16;621712852;6955;363;8145;8255;6.20;0.38;324.89;7.43;1190;18;2838.00;110
6957;16;621712865;6957;359;8148;8259;6.23;0.38;324.89;7.43;1191;18;2839.00;111
6960;16;621712879;6960;359;8148;8259;6.28;0.38;324.83;7.43;1188;18;2840.00;111
6962;16;621712893;6962;360;8148;8259;6.37;0.39;324.83;7.43;1186;18;2841.00;111
6964;16;621712909;6964;365;8148;8259;6.41;0.39;324.91;7.43;1184;18;2842.00;111
6966;16;621712928;6966;364;8148;8259;6.44;0.39;324.92;7.43;1182;18;2843.00;111
6966;16;621712941;6966;363;8158;8271;6.56;0.40;324.92;7.42;1192;18;2844.00;113
6969;16;621712955;6969;370;8159;8271;6.61;0.40;324.89;7.42;1190;18;2845.00;112
6970;16;621712969;6970;370;8160;8271;6.62;0.40;324.90;7.46;1190;18;2846.00;111
6973;16;621712982;6973;370;8160;8271;6.62;0.40;325.07;7.46;1187;18;2847.00;111
6974;16;621712995;6974;372;8160;8271;6.64;0.40;325.06;7.46;1186;18;2848.00;111
6979;16;621713008;6979;376;8160;8271;6.63;0.40;325.28;7.46;1181;18;2849.00;111
6981;16;621713024;6981;375;8164;8274;6.62;0.40;325.38;7.53;1183;18;2850.00;110
6984;16;621713038;6984;374;8164;8274;6.55;0.40;325.35;7.53;1180;18;2851.00;110
6986;16;621713052;6986;372;8169;8280;6.57;0.40;325.48;7.53;1183;18;2852.00;111
6987;16;621713066;6987;379;8171;8281;6.58;0.40;325.45;7.56;1184;18;2853.00;110
6988;16;621713080;6988;384;8171;8281;6.58;0.40;325.43;7.56;1183;18;2854.00;110
6991;16;621713093;6991;392;8171;8281;6.55;0.40;325.50;7.56;1180;18;2855.00;110
6993;17;621713106;6993;394;8175;8285;6.52;0.40;325.56;7.60;1182;19;2856.00;110
6996;17;621713132;6996;393;8175;8285;6.48;0.40;325.52;7.60;1179;19;2857.00;110
6998;17;621713146;6998;392;8176;8285;6.45;0.40;325.53;7.64;1178;19;2858.00;109
7000;17;621713159;7000;391;8177;8286;6.40;0.39;325.57;7.63;1177;19;2859.00;109
7006;17;621713172;7006;388;8181;8290;6.37;0.39;325.75;7.67;1175;19;2860.00;109
7007;17;621713186;7007;390;8181;8290;6.40;0.39;325.73;7.67;1174;19;2861.00;109
7009;17;621713199;7009;395;8185;8293;6.44;0.39;325.84;7.74;1176;19;2862.00;108
7013;17;621713212;7013;394;8186;8293;6.48;0.40;325.90;7.78;1173;19;2863.00;107
7017;17;621713226;7017;398;8189;8295;6.52;0.40;325.89;7.77;1172;19;2864.00;106
7023;17;621713239;7023;398;8191;8295;6.48;0.39;326.00;7.84;1168;19;2865.00;104
7025;17;621713252;7025;401;8196;8299;6.46;0.39;326.08;7.87;1171;19;2866.00;103
7029;17;621713265;7029;401;8196;8299;6.42;0.39;326.30;7.87;1167;19;2867.00;103
7031;17;621713278;7031;402;8197;8299;6.40;0.39;326.27;7.91;1166;19;2868.00;102
7034;17;621713291;7034;402;8198;8299;6.37;0.39;326.33;7.94;1164;19;2869.00;101
7038;17;621713309;7038;397;8198;8300;6.32;0.39;326.44;7.94;1160;19;2870.00;102
7042;17;621713330;7042;399;8200;8301;6.29;0.38;326.50;7.97;1158;19;2871.00;101
7043;17;621713352;7043;390;8200;8301;6.25;0.38;326.47;7.97;1157;19;2872.00;101
7046;17;621713374;7046;392;8201;8302;6.20;0.38;326.63;7.97;1155;19;2873.00;101
7048;17;621713392;7048;395;8203;8302;6.21;0.38;326.66;8.04;1155;19;2874.00;99
7053;17;621713413;7053;389;8203;8302;6.19;0.38;326.65;8.04;1150;19;2875.00;99
7059;17;621713429;7059;390;8203;8302;6.18;0.38;326.90;8.04;1144;19;2876.00;99
7060;17;621713444;7060;394;8205;8302;6.18;0.38;326.95;8.10;1145;19;2877.00;97
7066;17;621713457;7066;389;8205;8302;6.20;0.38;327.00;8.10;1139;19;2878.00;97
7066;17;621713479;7066;391;8207;8302;6.28;0.38;327.00;8.17;1141;19;2879.00;95
7067;17;621713494;7067;431;8308;8532;6.44;0.40;327.00;8.07;1241;19;2880.00;224
7068;17;621713527;7068;421;8315;8533;6.48;0.40;326.99;8.13;1247;19;2881.00;218
7070;17;621713541;7070;417;8323;8533;6.49;0.40;326.99;8.12;1253;19;2882.00;210
7074;17;621713555;7074;414;8329;8533;6.43;0.40;327.19;8.12;1255;19;2883.00;204
7077;17;621713569;7077;412;8338;8533;6.35;0.39;327.29;8.17;1261;19;2884.00;195
7078;17;621713585;7078;418;8341;8533;6.30;0.39;327.29;8.17;1263;19;2885.00;192
7081;17;621713600;7081;422;8351;8533;6.23;0.39;327.23;8.23;1270;19;2886.00;182
7084;17;621713613;7084;424;8356;8533;6.16;0.38;327.29;8.23;1272;19;2887.00;177
7086;17;621713628;7086;437;8363;8534;6.10;0.38;327.26;8.26;1277;19;2888.00;171
7091;17;621713649;7091;435;8367;8535;5.97;0.37;327.39;8.28;1276;19;2889.00;168
7093;17;621713664;7093;423;8373;8535;5.97;0.37;327.35;8.29;1280;19;2890.00;162
7094;17;621713679;7094;432;8378;8536;5.94;0.37;327.34;8.32;1284;19;2891.00;158
7097;17;621713693;7097;430;8382;8536;5.85;0.36;327.27;8.34;1285;19;2892.00;154
7102;17;621713707;7102;429;8386;8536;5.70;0.35;327.31;8.35;1284;19;2893.00;150
7106;17;621713722;7106;446;8389;8536;5.58;0.35;327.46;8.35;1283;19;2894.00;147
7109;17;621713737;7109;440;8394;8540;5.47;0.34;327.52;8.35;1285;19;2895.00;146
7112;17;621713751;7112;450;8397;8540;5.35;0.33;327.74;8.35;1285;19;2896.00;143
7118;17;621713766;7118;449;8401;8540;5.21;0.32;327.71;8.36;1283;19;2897.00;139
7120;17;621713781;7120;443;8402;8543;5.16;0.32;327.73;8.36;1282;19;2898.00;141
7123;17;621713796;7123;440;8406;8543;5.13;0.32;327.85;8.36;1283;19;2899.00;137
7126;17;621713812;7126;443;8407;8543;5.11;0.31;327.91;8.36;1281;19;2900.00;136
7130;17;621713834;7130;441;8410;8547;5.10;0.31;327.93;8.36;1280;19;2901.00;137
7132;17;621713850;7132;442;8416;8548;5.13;0.32;328.06;8.37;1284;19;2902.00;132
7134;17;621713865;7134;434;8416;8548;5.13;0.32;328.05;8.37;1282;19;2903.00;132
7140;17;621713880;7140;443;8420;8552;5.14;0.32;328.15;8.37;1280;19;2904.00;132
7144;17;621713896;7144;444;8425;8552;5.11;0.32;328.13;8.37;1281;19;2905.00;127
7149;17;621713910;7149;446;8425;8552;5.07;0.31;328.27;8.37;1276;19;2906.00;127
7152;17;621713925;7152;448;8426;8553;5.04;0.31;328.31;8.37;1274;19;2907.00;127
7155;17;621713941;7155;456;8426;8553;5.04;0.31;328.40;8.37;1271;19;2908.00;127
7161;17;621713956;7161;466;8431;8559;5.00;0.31;328.59;8.37;1270;19;2909.00;128
7167;17;621713974;7167;471;8431;8559;4.96;0.30;328.57;8.37;1264;19;2910.00;128
7170;17;621713989;7170;481;8432;8560;4.90;0.30;328.60;8.37;1262;19;2911.00;128
7175;17;621714003;7175;497;8432;8560;4.85;0.30;328.90;8.37;1257;19;2912.00;128
7178;17;621714018;7178;497;8433;8560;4.80;0.29;328.94;8.38;1255;19;2913.00;127
7181;17;621714032;7181;497;8434;8560;4.74;0.29;328.95;8.38;1253;19;2914.00;126
7187;17;621714046;7187;510;8434;8560;4.57;0.28;329.09;8.38;1247;19;2915.00;126
7189;17;621714059;7189;513;8443;8572;4.53;0.28;329.12;8.37;1254;19;2916.00;129
7195;17;621714075;7195;514;8445;8572;4.45;0.27;329.40;8.38;1250;19;2917.00;127
7197;17;621714089;7197;526;8446;8572;4.43;0.27;329.38;8.38;1249;19;2918.00;126
7202;17;621714103;7202;519;8447;8572;4.37;0.27;329.51;8.38;1245;19;2919.00;125
7205;17;621714117;7205;520;8448;8572;4.38;0.27;329.41;8.38;1243;19;2920.00;124
7210;17;621714131;7210;524;8448;8572;4.35;0.27;329.52;8.38;1238;19;2921.00;124
7213;17;621714146;7213;530;8451;8576;4.38;0.27;329.51;8.38;1238;19;2922.00;125
7215;17;621714159;7215;542;8453;8576;4.37;0.27;329.54;8.38;1238;19;2923.00;123
7218;17;621714174;7218;544;8456;8580;4.35;0.27;329.55;8.38;1238;19;2924.00;124
7219;17;621714188;7219;546;8458;8582;4.33;0.27;329.56;8.38;1239;19;2925.00;124
7223;17;621714201;7223;552;8458;8582;4.23;0.26;329.51;8.38;1235;19;2926.00;124
7225;17;621714215;7225;565;8459;8582;4.18;0.26;329.54;8.38;1234;19;2927.00;123
7227;17;621714228;7227;571;8470;8595;4.24;0.26;329.51;8.45;1243;19;2928.00;125
7230;17;621714245;7230;576;8472;8595;4.23;0.26;329.45;8.45;1242;19;2929.00;123
7232;17;621714258;7232;580;8472;8595;4.23;0.26;329.48;8.45;1240;19;2930.00;123
7235;17;621714271;7235;590;8473;8596;4.20;0.26;329.44;8.45;1238;19;2931.00;123
7237;17;621714284;7237;604;8474;8597;4.18;0.26;329.37;8.45;1237;19;2932.00;123
7238;17;621714299;7238;610;8474;8597;4.18;0.26;329.38;8.45;1236;19;2933.00;123
7242;17;621714313;7242;603;8477;8600;4.18;0.26;329.31;8.44;1235;19;2934.00;123
7246;17;621714327;7246;604;8477;8600;4.16;0.26;329.27;8.44;1231;19;2935.00;123
7248;17;621714340;7248;604;8477;8600;4.12;0.25;329.27;8.44;1229;19;2936.00;123
7250;17;621714353;7250;589;8477;8600;4.14;0.25;329.20;8.44;1227;19;2937.00;123
7252;17;621714367;7252;578;8482;8606;4.18;0.25;329.16;8.44;1230;19;2938.00;124
7254;17;621714380;7254;569;8482;8606;4.19;0.26;329.15;8.44;1228;19;2939.00;124
7256;17;621714395;7256;569;8482;8606;4.17;0.25;329.08;8.44;1226;19;2940.00;124
7258;17;621714408;7258;562;8482;8606;4.19;0.26;329.00;8.44;1224;19;2941.00;124
7262;17;621714421;7262;568;8485;8610;4.22;0.26;328.92;8.44;1223;19;2942.00;125
7265;17;621714434;7265;571;8486;8611;4.21;0.26;328.92;8.44;1221;19;2943.00;125
7268;17;621714447;7268;567;8487;8611;4.20;0.25;328.82;8.51;1219;19;2944.00;124
7270;17;621714460;7270;572;8488;8612;4.16;0.25;328.77;8.50;1218;19;2945.00;124
7270;17;621714473;7270;566;8488;8612;4.17;0.25;328.77;8.50;1218;19;2946.00;124
7272;17;621714486;7272;557;8488;8612;4.15;0.25;328.73;8.50;1216;19;2947.00;124
7273;17;621714498;7273;546;8488;8612;4.16;0.25;328.72;8.50;1215;19;2948.00;124
7273;17;621714511;7273;539;8488;8612;4.15;0.25;328.72;8.50;1215;19;2949.00;124
7273;17;621714524;7273;535;8488;8612;4.16;0.25;328.72;8.50;1215;19;2950.00;124
7275;17;621714543;7275;531;8488;8612;4.18;0.25;328.82;8.50;1213;19;2951.00;124
7276;17;621714556;7276;537;8521;8682;4.37;0.27;328.82;8.47;1245;19;2952.00;161
7277;17;621714575;7277;528;8522;8683;4.36;0.27;328.84;8.47;1245;19;2953.00;161
7278;17;621714588;7278;536;8530;8683;4.42;0.27;328.87;8.54;1252;19;2954.00;153
7279;17;621714602;7279;520;8531;8683;4.46;0.27;328.94;8.54;1252;19;2955.00;152
7279;17;621714615;7279;514;8533;8683;4.47;0.27;328.94;8.53;1254;19;2956.00;150
7282;17;621714628;7282;508;8534;8683;4.48;0.27;328.96;8.53;1252;19;2957.00;149
7282;17;621714643;7282;503;8538;8683;4.55;0.28;328.96;8.53;1256;19;2958.00;145
7283;17;621714656;7283;498;8539;8683;4.60;0.28;328.97;8.53;1256;19;2959.00;144
7284;17;621714671;7284;498;8542;8684;4.68;0.29;328.93;8.53;1258;19;2960.00;142
7285;17;621714685;7285;492;8544;8685;4.72;0.29;328.93;8.53;1259;19;2961.00;141
7287;17;621714705;7287;493;8547;8685;4.74;0.29;328.92;8.53;1260;19;2962.00;138
7290;17;621714720;7290;494;8553;8689;4.78;0.29;329.02;8.53;1263;19;2963.00;136
7290;17;621714735;7290;497;8555;8689;4.83;0.30;329.02;8.53;1265;19;2964.00;134
7292;17;621714748;7292;502;8555;8689;4.83;0.29;329.07;8.53;1263;19;2965.00;134
7295;17;621714763;7295;505;8555;8689;4.88;0.30;329.08;8.53;1260;19;2966.00;134
7297;17;621714777;7297;501;8559;8695;4.93;0.30;329.13;8.53;1262;19;2967.00;136
7298;17;621714792;7298;497;8559;8695;4.96;0.30;329.15;8.53;1261;19;2968.00;136
7300;17;621714807;7300;495;8559;8695;4.93;0.30;329.15;8.53;1259;19;2969.00;136
7300;17;621714835;7300;493;8563;8701;4.98;0.30;329.15;8.52;1263;19;2970.00;138
7301;17;621714855;7301;504;8563;8701;4.98;0.30;329.19;8.52;1262;19;2971.00;138
7302;17;621714871;7302;499;8565;8701;5.04;0.31;329.17;8.52;1263;19;2972.00;136
7304;17;621714891;7304;501;8565;8702;5.05;0.31;329.14;8.52;1261;19;2973.00;137
7307;17;621714904;7307;505;8566;8703;5.10;0.31;329.16;8.52;1259;19;2974.00;137
7309;17;621714919;7309;507;8566;8703;5.14;0.31;329.25;8.52;1257;19;2975.00;137
7310;17;621714933;7310;505;8574;8716;5.26;0.32;329.22;8.51;1264;19;2976.00;142
7313;17;621714949;7313;508;8574;8716;5.30;0.32;329.21;8.51;1261;19;2977.00;142
7314;17;621714963;7314;503;8575;8716;5.36;0.32;329.18;8.51;1261;19;2978.00;141
7318;17;621714978;7318;500;8576;8717;5.39;0.33;329.23;8.51;1258;19;2979.00;141
7321;17;621714992;7321;498;8576;8717;5.43;0.33;329.27;8.51;1255;19;2980.00;141
7324;17;621715007;7324;488;8579;8721;5.49;0.33;329.23;8.51;1255;19;2981.00;142
7327;17;621715022;7327;483;8579;8721;5.46;0.33;329.18;8.51;1252;19;2982.00;142
7330;17;621715037;7330;467;8582;8725;5.48;0.33;329.28;8.51;1252;19;2983.00;143
7331;17;621715052;7331;456;8582;8725;5.56;0.34;329.34;8.51;1251;19;2984.00;143
7334;17;621715066;7334;455;8582;8725;5.56;0.34;329.37;8.51;1248;19;2985.00;143
7336;17;621715080;7336;452;8582;8725;5.56;0.34;329.48;8.51;1246;19;2986.00;143
7336;17;621715095;7336;445;8582;8725;5.63;0.34;329.48;8.51;1246;19;2987.00;143
7339;17;621715108;7339;440;8592;8737;5.70;0.34;329.55;8.50;1253;19;2988.00;145
7340;17;621715124;7340;436;8592;8737;5.72;0.35;329.56;8.50;1252;19;2989.00;145
7342;17;621715138;7342;432;8593;8737;5.80;0.35;329.70;8.49;1251;19;2990.00;144
7343;17;621715153;7343;435;8593;8737;5.84;0.35;329.70;8.49;1250;19;2991.00;144
7346;17;621715167;7346;432;8593;8737;5.87;0.36;329.81;8.49;1247;19;2992.00;144
7348;17;621715182;7348;427;8594;8737;5.92;0.36;329.86;8.57;1246;19;2993.00;143
7349;17;621715196;7349;423;8596;8738;5.95;0.36;329.85;8.57;1247;19;2994.00;142
7350;17;621715211;7350;418;8598;8738;5.92;0.36;329.86;8.65;1248;19;2995.00;140
7352;17;621715227;7352;421;8602;8744;6.03;0.36;329.82;8.64;1250;19;2996.00;142
7354;17;621715242;7354;421;8603;8745;6.07;0.37;329.82;8.64;1249;19;2997.00;142
7357;17;621715257;7357;421;8603;8745;6.08;0.37;329.95;8.64;1246;19;2998.00;142
7361;17;621715271;7361;422;8603;8745;6.09;0.37;330.01;8.64;1242;19;2999.00;142
7363;17;621715288;7363;417;8609;8765;6.12;0.37;330.10;8.64;1246;19;3000.00;156
7366;17;621715318;7366;405;8609;8765;6.08;0.37;330.20;8.64;1243;19;3001.00;156
7369;17;621715343;7369;403;8609;8765;6.05;0.37;330.20;8.64;1240;19;3002.00;156
7371;17;621715369;7371;393;8610;8766;6.07;0.37;330.17;8.64;1239;19;3003.00;156
7375;17;621715392;7375;394;8613;8770;6.07;0.37;330.20;8.63;1238;19;3004.00;157
7378;17;621715413;7378;390;8614;8770;6.02;0.36;330.27;8.63;1236;19;3005.00;156
7379;17;621715430;7379;393;8618;8773;6.04;0.37;330.25;8.64;1239;19;3006.00;155
7381;17;621715446;7381;394;8621;8773;6.01;0.36;330.24;8.65;1240;19;3007.00;152
7384;17;621715462;7384;395;8621;8773;5.98;0.36;330.28;8.65;1237;19;3008.00;152
7385;17;621715478;7385;397;8622;8773;5.98;0.36;330.33;8.66;1237;19;3009.00;151
7388;17;621715494;7388;403;8626;8777;5.96;0.36;330.44;8.66;1238;19;3010.00;151
7390;17;621715511;7390;403;8629;8777;5.97;0.36;330.51;8.66;1239;19;3011.00;148
7394;17;621715533;7394;404;8629;8777;5.92;0.36;330.58;8.66;1235;19;3012.00;148
7399;17;621715548;7399;405;8631;8777;5.86;0.35;330.61;8.67;1232;19;3013.00;146
7402;17;621715564;7402;412;8633;8778;5.83;0.35;330.68;8.67;1231;19;3014.00;145
7405;17;621715579;7405;420;8636;8780;5.84;0.35;330.73;8.67;1231;19;3015.00;144
7407;17;621715596;7407;424;8636;8780;5.86;0.35;330.71;8.67;1229;19;3016.00;144
7409;17;621715612;7409;429;8638;8781;5.79;0.35;330.84;8.67;1229;19;3017.00;143
7411;17;621715631;7411;439;8639;8781;5.78;0.35;330.82;8.67;1228;19;3018.00;142
7414;17;621715647;7414;446;8640;8781;5.73;0.35;330.91;8.71;1226;19;3019.00;141
7415;17;621715662;7415;447;8640;8781;5.70;0.35;331.02;8.71;1225;19;3020.00;141
7417;17;621715677;7417;452;8640;8781;5.68;0.34;331.11;8.71;1223;19;3021.00;141
7420;17;621715694;7420;463;8642;8781;5.62;0.34;331.19;8.75;1222;19;3022.00;139
7422;17;621715715;7422;467;8642;8781;5.61;0.34;331.29;8.75;1220;19;3023.00;139
7423;17;621715729;7423;493;8704;8908;5.73;0.35;331.33;8.69;1281;19;3024.00;204
7424;17;621715755;7424;479;8706;8909;5.70;0.35;331.38;8.73;1282;19;3025.00;203
7426;17;621715772;7426;476;8713;8909;5.72;0.35;331.40;8.72;1287;19;3026.00;196
7429;17;621715788;7429;481;8718;8909;5.63;0.35;331.46;8.76;1289;19;3027.00;191
7431;17;621715803;7431;481;8726;8909;5.66;0.35;331.46;8.76;1295;19;3028.00;183
7434;17;621715818;7434;488;8729;8909;5.63;0.35;331.50;8.80;1295;19;3029.00;180
7436;17;621715837;7436;495;8731;8909;5.61;0.35;331.46;8.79;1295;19;3030.00;178
7439;17;621715854;7439;490;8733;8909;5.63;0.35;331.59;8.79;1294;19;3031.00;176
7441;17;621715870;7441;501;8735;8910;5.61;0.34;331.73;8.83;1294;19;3032.00;175
7442;17;621715885;7442;503;8739;8911;5.60;0.34;331.70;8.83;1297;19;3033.00;172
7446;17;621715900;7446;506;8743;8911;5.59;0.34;331.72;8.84;1297;19;3034.00;168
7447;17;621715916;7447;505;8748;8912;5.56;0.34;331.81;8.99;1301;19;3035.00;164
7448;17;621715931;7448;509;8752;8912;5.55;0.34;331.89;8.99;1304;19;3036.00;160
7450;17;621715947;7450;511;8753;8912;5.51;0.34;331.91;8.99;1303;19;3037.00;159
7452;17;621715961;7452;513;8757;8912;5.45;0.34;331.97;9.06;1305;19;3038.00;155
7455;17;621715977;7455;511;8762;8916;5.44;0.33;331.96;9.06;1307;19;3039.00;154
7457;17;621715999;7457;516;8767;8916;5.40;0.33;331.89;9.14;1310;19;3040.00;149
7459;17;621716015;7459;513;8770;8916;5.36;0.33;332.07;9.14;1311;19;3041.00;146
7462;17;621716029;7462;511;8772;8919;5.34;0.33;332.17;9.14;1310;19;3042.00;147
7464;17;621716044;7464;511;8775;8919;5.33;0.33;332.31;9.21;1311;19;3043.00;144
7466;17;621716061;7466;505;8776;8919;5.30;0.32;332.29;9.22;1310;19;3044.00;143
7468;17;621716076;7468;514;8779;8923;5.27;0.32;332.30;9.22;1311;19;3045.00;144
7471;17;621716092;7471;516;8783;8924;5.23;0.32;332.23;9.29;1312;19;3046.00;141
7471;17;621716107;7471;517;8787;8924;5.21;0.32;332.23;9.29;1316;19;3047.00;137
7471;17;621716121;7471;517;8792;8928;5.17;0.32;332.23;9.36;1321;19;3048.00;136
7473;17;621716136;7473;519;8794;8928;5.18;0.32;332.32;9.35;1321;19;3049.00;134
7477;17;621716151;7477;517;8795;8928;5.12;0.31;332.32;9.35;1318;19;3050.00;133
7480;17;621716172;7480;524;8799;8929;5.08;0.31;332.44;9.42;1319;19;3051.00;130
7482;17;621716188;7482;525;8799;8929;5.03;0.31;332.41;9.42;1317;19;3052.00;130
7491;17;621716209;7491;523;8805;8935;4.99;0.31;332.70;9.42;1314;19;3053.00;130
7493;17;621716231;7493;526;8807;8935;4.94;0.30;332.71;9.49;1314;19;3054.00;128
7495;17;621716254;7495;544;8807;8936;4.87;0.30;332.88;9.49;1312;19;3055.00;129
7498;17;621716271;7498;546;8809;8936;4.81;0.30;333.00;9.56;1311;19;3056.00;127
7502;17;621716285;7502;550;8809;8936;4.76;0.29;333.04;9.56;1307;19;3057.00;127
7504;17;621716302;7504;554;8809;8936;4.69;0.29;333.19;9.56;1305;19;3058.00;127
7508;17;621716316;7508;555;8809;8936;4.65;0.29;333.29;9.56;1301;19;3059.00;127
7514;17;621716332;7514;559;8835;8972;4.77;0.30;333.38;9.53;1321;19;3060.00;137
7519;17;621716350;7519;552;8835;8972;4.73;0.29;333.53;9.53;1316;19;3061.00;137
7524;17;621716363;7524;553;8838;8972;4.72;0.29;333.54;9.53;1314;19;3062.00;134
7530;17;621716376;7530;550;8838;8972;4.67;0.29;333.67;9.53;1308;19;3063.00;134
7533;17;621716390;7533;552;8839;8972;4.63;0.29;333.69;9.53;1306;19;3064.00;133
7535;17;621716404;7535;562;8839;8972;4.60;0.28;333.72;9.53;1304;19;3065.00;133
7541;17;621716418;7541;567;8843;8976;4.57;0.28;333.69;9.52;1302;19;3066.00;133
7547;17;621716432;7547;574;8843;8976;4.56;0.28;333.74;9.52;1296;19;3067.00;133
7550;17;621716446;7550;568;8847;8980;4.58;0.28;333.79;9.52;1297;19;3068.00;133
7554;17;621716460;7554;568;8848;8981;4.58;0.28;333.86;9.52;1294;19;3069.00;133
7556;17;621716474;7556;569;8848;8981;4.61;0.28;333.87;9.52;1292;19;3070.00;133
7560;17;621716487;7560;561;8848;8981;4.61;0.28;333.98;9.52;1288;19;3071.00;133
7565;17;621716501;7565;562;8859;8994;4.65;0.28;334.11;9.51;1294;19;3072.00;135
7568;17;621716516;7568;568;8859;8994;4.63;0.28;334.23;9.51;1291;19;3073.00;135
7571;17;621716530;7571;563;8859;8994;4.60;0.28;334.29;9.51;1288;19;3074.00;135
7574;17;621716543;7574;566;8860;8995;4.58;0.28;334.24;9.50;1286;19;3075.00;135
7582;17;621716557;7582;561;8860;8996;4.51;0.28;334.26;9.50;1278;19;3076.00;136
7585;17;621716571;7585;555;8860;8996;4.47;0.27;334.28;9.50;1275;19;3077.00;136
7586;17;621716590;7586;558;8863;8999;4.48;0.28;334.30;9.50;1277;19;3078.00;136
7592;17;621716603;7592;555;8863;8999;4.43;0.27;334.19;9.50;1271;19;3079.00;136
7595;17;621716616;7595;562;8863;8999;4.40;0.27;334.18;9.50;1268;19;3080.00;136
7600;17;621716630;7600;563;8863;8999;4.32;0.27;334.22;9.50;1263;19;3081.00;136
7604;17;621716643;7604;564;8867;9005;4.27;0.26;334.22;9.50;1263;19;3082.00;138
7608;17;621716657;7608;562;8867;9005;4.23;0.26;334.18;9.50;1259;19;3083.00;138
7611;17;621716671;7611;571;8867;9005;4.18;0.26;334.19;9.50;1256;19;3084.00;138
7617;17;621716684;7617;574;8867;9005;4.10;0.25;334.22;9.50;1250;19;3085.00;138
7620;17;621716697;7620;574;8870;9009;4.04;0.25;334.22;9.49;1250;19;3086.00;139
7622;17;621716711;7622;583;8872;9010;3.98;0.24;334.17;9.49;1250;19;3087.00;138
7624;17;621716723;7624;581;8872;9010;3.92;0.24;334.10;9.49;1248;19;3088.00;138
7625;17;621716736;7625;580;8873;9011;3.93;0.24;334.07;9.49;1248;19;3089.00;138
7628;17;621716750;7628;588;8873;9011;3.91;0.24;334.02;9.49;1245;19;3090.00;138
7632;17;621716763;7632;596;8874;9011;3.86;0.24;333.93;9.57;1242;19;3091.00;137
7635;17;621716776;7635;601;8874;9011;3.83;0.23;333.95;9.57;1239;19;3092.00;137
7639;17;621716789;7639;609;8874;9011;3.78;0.23;333.89;9.57;1235;19;3093.00;137
7639;17;621716801;7639;612;8874;9011;3.72;0.23;333.89;9.57;1235;19;3094.00;137
7639;17;621716814;7639;617;8874;9011;3.70;0.23;333.89;9.57;1235;19;3095.00;137
7642;17;621716825;7642;633;8915;9081;3.88;0.24;333.86;9.52;1273;19;3096.00;166
7644;17;621716843;7644;636;8917;9082;3.87;0.24;333.94;9.52;1273;19;3097.00;165
7645;17;621716856;7645;638;8923;9082;3.90;0.24;333.97;9.52;1278;19;3098.00;159
7647;17;621716868;7647;635;8927;9082;3.91;0.24;334.02;9.51;1280;19;3099.00;155
7648;17;621716881;7648;633;8929;9082;3.91;0.24;334.03;9.51;1281;19;3100.00;153
7649;17;621716897;7649;633;8931;9082;3.92;0.24;334.01;9.51;1282;19;3101.00;151
7653;17;621716909;7653;632;8934;9082;3.86;0.23;333.97;9.51;1281;19;3102.00;148
7654;17;621716922;7654;634;8936;9082;3.85;0.23;333.93;9.51;1282;19;3103.00;146
7657;17;621716935;7657;636;8938;9083;3.80;0.23;333.87;9.51;1281;19;3104.00;145
7658;17;621716947;7658;642;8941;9085;3.75;0.23;333.88;9.51;1283;19;3105.00;144
7659;17;621716960;7659;649;8943;9085;3.70;0.23;333.86;9.51;1284;19;3106.00;142
7660;17;621716973;7660;635;8946;9089;3.69;0.22;333.90;9.50;1286;19;3107.00;143
7661;17;621716987;7661;630;8946;9089;3.73;0.23;333.88;9.50;1285;19;3108.00;143
7663;17;621717000;7663;623;8946;9089;3.75;0.23;333.88;9.50;1283;19;3109.00;143
7664;17;621717014;7664;611;8946;9089;3.78;0.23;333.84;9.50;1282;19;3110.00;143
7664;17;621717027;7664;607;8951;9095;3.87;0.24;333.84;9.50;1287;19;3111.00;144
7664;17;621717041;7664;602;8951;9095;3.96;0.24;333.84;9.50;1287;19;3112.00;144
7666;17;621717054;7666;603;8951;9095;4.04;0.25;333.88;9.50;1285;19;3113.00;144
7668;17;621717068;7668;595;8954;9098;4.17;0.25;333.89;9.50;1286;19;3114.00;144
7668;17;621717083;7668;591;8954;9098;4.29;0.26;333.89;9.50;1286;19;3115.00;144
7668;18;621717096;7668;579;8954;9098;4.41;0.27;333.89;9.50;1286;20;3116.00;144
7670;18;621717132;7670;571;8954;9099;4.50;0.27;333.93;9.50;1284;20;3117.00;145
7670;18;621717152;7670;553;8955;9100;4.61;0.28;333.93;9.50;1285;20;3118.00;145
7670;18;621717166;7670;542;8955;9100;4.69;0.29;333.93;9.50;1285;20;3119.00;145
7672;18;621717183;7672;539;8976;9126;4.90;0.30;333.85;9.47;1304;20;3120.00;150
7674;19;621717199;7674;522;8976;9126;5.01;0.30;333.89;9.47;1302;21;3121.00;150
7675;19;621717232;7675;500;8977;9126;5.13;0.31;333.85;9.47;1302;21;3122.00;149
7676;19;621717268;7676;507;8978;9127;5.23;0.32;333.88;9.47;1302;21;3123.00;149
7678;19;621717304;7678;501;8978;9127;5.23;0.32;333.90;9.47;1300;21;3124.00;149
7679;19;621717331;7679;498;8982;9131;5.29;0.32;333.89;9.47;1303;21;3125.00;149
7680;19;621717354;7680;493;8983;9131;5.28;0.32;333.88;9.55;1303;21;3126.00;148
7684;19;621717378;7684;480;8986;9135;5.28;0.32;333.97;9.55;1302;21;3127.00;149
7685;19;621717402;7685;477;8986;9135;5.24;0.32;334.09;9.55;1301;21;3128.00;149
7686;19;621717429;7686;471;8986;9135;5.22;0.32;334.06;9.55;1300;21;3129.00;149
7687;19;621717452;7687;460;8986;9135;5.27;0.32;334.03;9.55;1299;21;3130.00;149
7691;19;621717473;7691;448;8986;9135;5.24;0.32;334.10;9.55;1295;21;3131.00;149
7692;19;621717493;7692;448;8996;9147;5.30;0.32;334.09;9.53;1304;21;3132.00;151
7695;19;621717515;7695;444;8996;9147;5.30;0.32;334.19;9.53;1301;21;3133.00;151
7699;19;621717535;7699;439;8997;9147;5.30;0.32;334.14;9.53;1298;21;3134.00;150
7700;19;621717554;7700;434;8997;9147;5.35;0.32;334.14;9.53;1297;21;3135.00;150
7701;19;621717577;7701;438;8997;9147;5.40;0.33;334.13;9.53;1296;21;3136.00;150
7702;19;621717595;7702;434;8997;9147;5.44;0.33;334.25;9.53;1295;21;3137.00;150
7706;19;621717614;7706;431;8997;9148;5.48;0.33;334.23;9.53;1291;21;3138.00;151
7707;19;621717634;7707;431;8997;9148;5.58;0.34;334.27;9.53;1290;21;3139.00;151
7711;19;621717653;7711;428;9002;9154;5.65;0.34;334.37;9.53;1291;21;3140.00;152
7713;19;621717674;7713;427;9003;9155;5.74;0.35;334.47;9.53;1290;21;3141.00;152
7714;19;621717695;7714;424;9003;9155;5.81;0.35;334.46;9.53;1289;21;3142.00;152
7716;19;621717714;7716;423;9003;9155;5.85;0.35;334.52;9.53;1287;21;3143.00;152
7716;19;621717745;7716;420;9006;9159;5.92;0.36;334.52;9.52;1290;21;3144.00;153
7719;19;621717763;7719;421;9006;9159;5.97;0.36;334.70;9.52;1287;21;3145.00;153
7722;19;621717783;7722;427;9006;9159;5.98;0.36;334.73;9.52;1284;21;3146.00;153
7723;19;621717808;7723;427;9007;9160;6.05;0.37;334.74;9.52;1284;21;3147.00;153
7725;19;621717825;7725;432;9010;9164;6.03;0.37;334.84;9.52;1285;21;3148.00;154
7727;19;621717858;7727;437;9010;9164;6.04;0.37;334.94;9.52;1283;21;3149.00;154
7730;19;621717881;7730;426;9014;9170;6.08;0.37;335.04;9.52;1284;21;3150.00;156
7732;19;621717902;7732;429;9014;9170;6.13;0.37;335.05;9.52;1282;21;3151.00;156
7733;19;621717923;7733;423;9016;9170;6.24;0.38;335.02;9.51;1283;21;3152.00;154
7736;19;621717942;7736;421;9016;9170;6.25;0.38;335.04;9.51;1280;21;3153.00;154
7739;19;621717962;7739;418;9020;9174;6.29;0.38;335.22;9.51;1281;21;3154.00;154
7742;19;621717983;7742;412;9020;9174;6.28;0.38;335.21;9.51;1278;21;3155.00;154
7744;19;621718008;7744;407;9020;9174;6.29;0.38;335.22;9.51;1276;21;3156.00;154
7748;19;621718027;7748;404;9020;9174;6.29;0.38;335.30;9.51;1272;21;3157.00;154
7752;19;621718048;7752;398;9020;9175;6.28;0.38;335.33;9.51;1268;21;3158.00;155
7754;19;621718069;7754;388;9021;9176;6.29;0.38;335.35;9.51;1267;21;3159.00;155
7755;19;621718088;7755;389;9021;9176;6.30;0.38;335.38;9.51;1266;21;3160.00;155
7758;19;621718106;7758;384;9022;9177;6.32;0.38;335.42;9.51;1264;21;3161.00;155
7760;19;621718126;7760;381;9022;9177;6.29;0.38;335.42;9.51;1262;21;3162.00;155
7763;19;621718154;7763;372;9022;9177;6.30;0.38;335.47;9.51;1259;21;3163.00;155
7765;19;621718173;7765;370;9022;9177;6.35;0.39;335.55;9.51;1257;21;3164.00;155
7772;19;621718191;7772;370;9024;9177;6.29;0.38;335.71;9.60;1252;21;3165.00;153
7775;19;621718213;7775;368;9024;9177;6.30;0.38;335.85;9.60;1249;21;3166.00;153
7777;19;621718240;7777;368;9024;9177;6.35;0.39;335.92;9.60;1247;21;3167.00;153
7782;19;621718261;7782;386;9093;9304;6.41;0.39;335.97;9.60;1311;21;3168.00;211
7783;19;621718293;7783;372;9095;9305;6.51;0.40;336.05;9.60;1312;21;3169.00;210
7785;19;621718314;7785;369;9101;9305;6.60;0.41;336.00;9.60;1316;21;3170.00;204
7788;19;621718335;7788;369;9103;9305;6.68;0.41;336.28;9.59;1315;21;3171.00;202
7791;19;621718355;7791;372;9108;9305;6.76;0.42;336.27;9.59;1317;21;3172.00;197
7797;19;621718373;7797;366;9110;9305;6.81;0.42;336.44;9.59;1313;21;3173.00;195
7799;19;621718393;7799;366;9113;9305;6.87;0.42;336.39;9.59;1314;21;3174.00;192
7803;19;621718410;7803;367;9115;9305;6.93;0.43;336.60;9.59;1312;21;3175.00;190
7806;19;621718428;7806;365;9118;9306;7.00;0.43;336.76;9.59;1312;21;3176.00;188
7811;19;621718445;7811;368;9124;9307;7.00;0.43;336.79;9.59;1313;21;3177.00;183
7814;19;621718463;7814;363;9127;9307;6.93;0.42;336.85;9.59;1313;21;3178.00;180
7816;19;621718481;7816;365;9130;9308;6.89;0.42;336.88;9.59;1314;21;3179.00;178
7820;19;621718499;7820;372;9134;9308;6.83;0.42;336.88;9.59;1314;21;3180.00;174
7824;19;621718517;7824;376;9136;9308;6.73;0.41;336.99;9.59;1312;21;3181.00;172
7827;19;621718534;7827;378;9137;9308;6.68;0.41;336.94;9.59;1310;21;3182.00;171
7829;19;621718551;7829;377;9141;9312;6.61;0.40;337.15;9.59;1312;21;3183.00;171
7832;19;621718567;7832;387;9144;9312;6.55;0.40;337.30;9.59;1312;21;3184.00;168
7836;19;621718586;7836;392;9145;9312;6.49;0.40;337.38;9.59;1309;21;3185.00;167
7838;19;621718604;7838;401;9147;9315;6.45;0.39;337.48;9.59;1309;21;3186.00;168
7841;19;621718622;7841;403;9148;9315;6.46;0.40;337.63;9.59;1307;21;3187.00;167
7841;19;621718643;7841;406;9149;9315;6.47;0.40;337.63;9.59;1308;21;3188.00;166
7843;19;621718667;7843;415;9152;9319;6.49;0.40;337.84;9.59;1309;21;3189.00;167
7848;19;621718692;7848;414;9155;9320;6.44;0.40;337.95;9.63;1307;21;3190.00;165
7854;19;621718709;7854;419;9158;9322;6.38;0.39;337.96;9.68;1304;21;3191.00;164
7861;19;621718728;7861;422;9162;9326;6.32;0.39;338.19;9.67;1301;21;3192.00;164
7862;19;621718748;7862;423;9164;9326;6.28;0.38;338.18;9.76;1302;21;3193.00;162
7864;19;621718766;7864;430;9164;9326;6.26;0.38;338.38;9.76;1300;21;3194.00;162
7867;19;621718788;7867;433;9166;9328;6.23;0.38;338.56;9.76;1299;21;3195.00;162
7868;19;621718813;7868;431;9168;9328;6.19;0.38;338.56;9.85;1300;21;3196.00;160
7871;19;621718830;7871;440;9173;9334;6.21;0.38;338.68;9.84;1302;21;3197.00;161
7872;19;621718855;7872;447;9173;9334;6.17;0.38;338.75;9.84;1301;21;3198.00;161
7872;19;621718872;7872;454;9174;9335;6.07;0.37;338.75;9.88;1302;21;3199.00;161
7875;19;621718889;7875;456;9174;9335;6.02;0.37;338.83;9.88;1299;21;3200.00;161
7879;19;621718912;7879;466;9175;9335;5.97;0.36;338.97;9.93;1296;21;3201.00;160
7883;19;621718927;7883;475;9175;9335;5.88;0.36;338.94;9.93;1292;21;3202.00;160
7886;19;621718942;7886;480;9177;9335;5.80;0.35;338.95;10.01;1291;21;3203.00;158
7889;19;621718957;7889;482;9186;9347;5.79;0.35;339.11;10.00;1297;21;3204.00;161
7893;19;621718976;7893;482;9186;9347;5.71;0.35;339.16;10.00;1293;21;3205.00;161
7896;19;621718991;7896;497;9190;9347;5.65;0.34;339.25;10.08;1294;21;3206.00;157
7900;19;621719009;7900;505;9192;9347;5.61;0.34;339.31;10.13;1292;21;3207.00;155
7906;19;621719025;7906;510;9193;9347;5.50;0.34;339.57;10.17;1287;21;3208.00;154
7906;19;621719049;7906;518;9193;9347;5.45;0.33;339.57;10.17;1287;21;3209.00;154
7910;19;621719072;7910;515;9197;9351;5.37;0.33;339.68;10.25;1287;21;3210.00;154
7913;19;621719090;7913;513;9197;9351;5.36;0.33;339.83;10.25;1284;21;3211.00;154
7917;19;621719108;7917;516;9204;9355;5.38;0.33;339.90;10.32;1287;21;3212.00;151
7920;19;621719123;7920;525;9205;9356;5.38;0.33;339.97;10.32;1285;21;3213.00;151
7921;19;621719137;7921;521;9205;9356;5.38;0.33;339.97;10.32;1284;21;3214.00;151
7928;19;621719155;7928;524;9207;9356;5.30;0.32;340.02;10.40;1279;21;3215.00;149
7931;19;621719171;7931;525;9218;9369;5.31;0.32;340.01;10.38;1287;21;3216.00;151
7935;19;621719193;7935;528;9220;9369;5.29;0.32;340.02;10.46;1285;21;3217.00;149
7935;19;621719210;7935;533;9220;9369;5.30;0.32;340.02;10.46;1285;21;3218.00;149
7937;19;621719225;7937;538;9223;9370;5.26;0.32;339.98;10.53;1286;21;3219.00;147
7939;19;621719241;7939;540;9223;9371;5.20;0.32;339.96;10.53;1284;21;3220.00;148
7944;19;621719257;7944;539;9223;9371;5.13;0.31;340.12;10.53;1279;21;3221.00;148
7949;19;621719274;7949;546;9227;9374;5.06;0.31;340.05;10.57;1278;21;3222.00;147
7951;19;621719288;7951;552;9228;9374;5.01;0.30;340.12;10.60;1277;21;3223.00;146
7955;19;621719304;7955;548;9229;9374;4.97;0.30;340.23;10.64;1274;21;3224.00;145
7956;19;621719325;7956;550;9230;9374;4.95;0.30;340.25;10.68;1274;21;3225.00;144
7958;19;621719351;7958;553;9235;9380;4.94;0.30;340.32;10.67;1277;21;3226.00;145
7962;19;621719376;7962;555;9237;9380;4.84;0.29;340.41;10.74;1275;21;3227.00;143
7966;19;621719399;7966;557;9237;9380;4.72;0.29;340.47;10.74;1271;21;3228.00;143
7969;19;621719421;7969;561;9237;9380;4.61;0.28;340.48;10.74;1268;21;3229.00;143
7973;19;621719439;7973;550;9240;9384;4.52;0.28;340.52;10.74;1267;21;3230.00;144
7977;19;621719458;7977;553;9243;9385;4.42;0.27;340.47;10.81;1266;21;3231.00;142
7979;19;621719481;7979;546;9243;9385;4.35;0.27;340.44;10.81;1264;21;3232.00;142
7981;19;621719500;7981;546;9246;9386;4.29;0.26;340.50;10.88;1265;21;3233.00;140
7985;19;621719516;7985;545;9246;9386;4.24;0.26;340.40;10.88;1261;21;3234.00;140
7989;19;621719533;7989;545;9246;9386;4.21;0.26;340.41;10.88;1257;21;3235.00;140
7991;19;621719557;7991;551;9246;9386;4.22;0.26;340.40;10.88;1255;21;3236.00;140
7994;19;621719572;7994;546;9246;9386;4.23;0.26;340.39;10.88;1252;21;3237.00;140
7999;19;621719588;7999;541;9246;9386;4.22;0.26;340.47;10.88;1247;21;3238.00;140
8002;19;621719606;8002;543;9246;9386;4.17;0.25;340.48;10.88;1244;21;3239.00;140
8004;19;621719631;8004;535;9307;9511;4.43;0.27;340.48;10.81;1303;21;3240.00;204
8005;19;621719660;8005;528;9311;9512;4.44;0.28;340.50;10.81;1306;21;3241.00;201
8008;19;621719677;8008;526;9319;9512;4.50;0.28;340.60;10.80;1311;21;3242.00;193
8012;19;621719695;8012;524;9323;9512;4.50;0.28;340.60;10.80;1311;21;3243.00;189
8015;19;621719711;8015;524;9326;9512;4.52;0.28;340.55;10.80;1311;21;3244.00;186
8019;19;621719729;8019;528;9331;9512;4.49;0.28;340.54;10.79;1312;21;3245.00;181
8021;19;621719746;8021;535;9335;9512;4.52;0.28;340.55;10.79;1314;21;3246.00;177
8026;19;621719766;8026;538;9337;9512;4.48;0.27;340.54;10.79;1311;21;3247.00;175
8028;19;621719785;8028;536;9340;9513;4.49;0.28;340.58;10.79;1312;21;3248.00;173
8032;19;621719803;8032;535;9341;9514;4.45;0.27;340.52;10.79;1309;21;3249.00;173
8034;19;621719822;8034;539;9343;9514;4.45;0.27;340.48;10.79;1309;21;3250.00;171
8036;19;621719843;8036;543;9348;9518;4.50;0.28;340.49;10.78;1312;21;3251.00;170
8040;19;621719862;8040;546;9348;9518;4.48;0.27;340.55;10.78;1308;21;3252.00;170
8040;19;621719880;8040;548;9348;9518;4.49;0.28;340.55;10.78;1308;21;3253.00;170
8043;19;621719899;8043;542;9348;9518;4.44;0.27;340.51;10.78;1305;21;3254.00;170
8047;19;621719922;8047;559;9352;9524;4.41;0.27;340.53;10.78;1305;21;3255.00;172
8048;19;621719942;8048;555;9352;9524;4.38;0.27;340.57;10.78;1304;21;3256.00;172
8049;19;621719960;8049;558;9352;9524;4.32;0.26;340.53;10.78;1303;21;3257.00;172
8053;19;621719987;8053;565;9354;9527;4.24;0.26;340.51;10.78;1301;21;3258.00;173
8056;19;621720010;8056;549;9354;9527;4.17;0.25;340.54;10.78;1298;21;3259.00;173
8057;19;621720033;8057;550;9354;9527;4.16;0.25;340.51;10.78;1297;21;3260.00;173
8061;19;621720058;8061;550;9356;9528;4.15;0.25;340.51;10.78;1295;21;3261.00;172
8064;19;621720077;8064;542;9357;9529;4.15;0.25;340.65;10.78;1293;21;3262.00;172
8068;19;621720098;8068;532;9359;9529;4.13;0.25;340.57;10.87;1291;21;3263.00;170
8071;19;621720116;8071;534;9369;9542;4.25;0.26;340.57;10.86;1298;21;3264.00;173
8074;19;621720135;8074;530;9370;9542;4.28;0.26;340.52;10.86;1296;21;3265.00;172
8075;19;621720162;8075;529;9371;9542;4.35;0.27;340.58;10.86;1296;21;3266.00;171
8077;19;621720181;8077;529;9373;9543;4.39;0.27;340.60;10.86;1296;21;3267.00;170
8080;19;621720202;8080;530;9374;9543;4.45;0.27;340.56;10.86;1294;21;3268.00;169
8082;19;621720224;8082;536;9378;9547;4.50;0.28;340.59;10.86;1296;21;3269.00;169
8088;19;621720249;8088;535;9379;9547;4.50;0.27;340.58;10.86;1291;21;3270.00;168
8090;19;621720274;8090;542;9383;9551;4.54;0.28;340.64;10.86;1293;21;3271.00;168
8091;19;621720298;8091;546;9384;9551;4.56;0.28;340.62;10.86;1293;21;3272.00;167
8095;19;621720318;8095;539;9385;9551;4.50;0.28;340.66;10.86;1290;21;3273.00;166
8097;19;621720336;8097;548;9385;9551;4.48;0.27;340.68;10.86;1288;21;3274.00;166
8099;19;621720356;8099;553;9385;9551;4.49;0.27;340.71;10.86;1286;21;3275.00;166
8102;19;621720373;8102;552;9395;9563;4.54;0.28;340.75;10.84;1293;21;3276.00;168
8105;19;621720395;8105;541;9395;9563;4.59;0.28;340.73;10.84;1290;21;3277.00;168
8108;19;621720412;8108;534;9396;9563;4.62;0.28;340.75;10.84;1288;21;3278.00;167
8112;19;621720432;8112;530;9396;9563;4.65;0.28;340.78;10.84;1284;21;3279.00;167
8113;19;621720450;8113;516;9396;9563;4.72;0.29;340.80;10.84;1283;21;3280.00;167
8119;19;621720473;8119;519;9396;9563;4.73;0.29;340.98;10.84;1277;21;3281.00;167
8124;19;621720493;8124;512;9397;9564;4.80;0.29;340.93;10.92;1273;21;3282.00;167
8127;19;621720509;8127;506;9397;9564;4.87;0.30;340.97;10.92;1270;21;3283.00;167
8129;19;621720526;8129;508;9402;9570;4.92;0.30;341.07;10.92;1273;21;3284.00;168
8134;19;621720543;8134;509;9404;9572;4.93;0.30;341.02;10.92;1270;21;3285.00;168
8137;19;621720560;8137;504;9404;9572;4.96;0.30;341.14;10.92;1267;21;3286.00;168
8142;19;621720579;8142;496;9404;9572;5.01;0.31;341.16;10.92;1262;21;3287.00;168
8143;19;621720597;8143;476;9407;9576;5.10;0.31;341.20;10.91;1264;21;3288.00;169
8147;19;621720614;8147;474;9407;9576;5.18;0.32;341.33;10.91;1260;21;3289.00;169
8155;19;621720632;8155;461;9407;9576;5.21;0.32;341.43;10.91;1252;21;3290.00;169
8158;19;621720656;8158;463;9408;9577;5.27;0.32;341.49;10.91;1250;21;3291.00;169
8161;19;621720678;8161;463;9412;9581;5.35;0.33;341.49;10.99;1251;21;3292.00;169
8162;19;621720701;8162;466;9412;9581;5.35;0.33;341.53;10.99;1250;21;3293.00;169
8164;19;621720730;8164;462;9414;9584;5.36;0.33;341.66;10.99;1250;21;3294.00;170
8166;19;621720758;8166;466;9414;9584;5.38;0.33;341.68;10.99;1248;21;3295.00;170
8168;19;621720780;8168;465;9415;9584;5.42;0.33;341.71;10.98;1247;21;3296.00;169
8170;19;621720799;8170;459;9415;9584;5.40;0.33;341.73;10.98;1245;21;3297.00;169
8174;19;621720822;8174;463;9419;9588;5.45;0.33;341.72;10.98;1245;21;3298.00;169
8178;19;621720844;8178;452;9419;9588;5.52;0.34;341.73;10.98;1241;21;3299.00;169
8184;19;621720864;8184;451;9424;9607;5.49;0.34;341.67;10.97;1240;21;3300.00;183
8188;19;621720892;8188;442;9424;9607;5.53;0.34;341.81;10.97;1236;21;3301.00;183
8193;19;621720913;8193;439;9424;9608;5.52;0.34;341.78;10.97;1231;21;3302.00;184
8199;19;621720931;8199;431;9425;9609;5.50;0.33;341.94;10.97;1226;21;3303.00;184
8203;19;621720948;8203;443;9425;9609;5.49;0.33;341.95;10.97;1222;21;3304.00;184
8206;19;621720967;8206;430;9426;9610;5.52;0.34;342.01;10.97;1220;21;3305.00;184
8208;19;621720985;8208;435;9428;9610;5.54;0.34;342.03;10.97;1220;21;3306.00;182
8211;19;621721005;8211;433;9428;9610;5.55;0.34;342.22;10.97;1217;21;3307.00;182
8216;19;621721020;8216;434;9428;9610;5.56;0.34;342.43;10.97;1212;21;3308.00;182
8219;19;621721035;8219;432;9428;9610;5.58;0.34;342.53;10.97;1209;21;3309.00;182
8222;19;621721049;8222;435;9428;9610;5.57;0.34;342.60;10.97;1206;21;3310.00;182
8224;19;621721063;8224;436;9428;9610;5.59;0.34;342.59;10.97;1204;21;3311.00;182
8231;19;621721077;8231;462;9497;9737;5.64;0.35;342.70;10.89;1266;21;3312.00;240
8234;19;621721101;8234;455;9497;9738;5.66;0.35;342.76;10.89;1263;21;3313.00;241
8238;19;621721115;8238;457;9501;9738;5.71;0.35;342.80;10.89;1263;21;3314.00;237
8242;19;621721130;8242;463;9501;9738;5.75;0.35;342.89;10.89;1259;21;3315.00;237
8246;19;621721144;8246;468;9505;9738;5.75;0.35;343.03;10.89;1259;21;3316.00;233
8248;19;621721158;8248;462;9508;9738;5.74;0.35;343.11;10.89;1260;21;3317.00;230
8252;19;621721172;8252;458;9511;9738;5.78;0.35;343.27;10.89;1259;21;3318.00;227
8255;19;621721187;8255;465;9515;9738;5.87;0.36;343.29;10.89;1260;21;3319.00;223
8258;19;621721201;8258;453;9518;9739;5.89;0.36;343.32;10.88;1260;21;3320.00;221
8260;19;621721217;8260;452;9520;9740;5.88;0.36;343.39;10.88;1260;21;3321.00;220
8262;19;621721232;8262;453;9522;9740;5.90;0.36;343.43;10.88;1260;21;3322.00;218
8262;19;621721246;8262;456;9525;9741;5.93;0.36;343.43;10.89;1263;21;3323.00;216
8265;19;621721261;8265;455;9529;9741;5.90;0.36;343.46;10.89;1264;21;3324.00;212
8272;19;621721276;8272;455;9530;9741;5.86;0.36;343.52;10.89;1258;21;3325.00;211
8274;19;621721291;8274;453;9531;9741;5.87;0.36;343.54;10.89;1257;21;3326.00;210
8280;19;621721307;8280;450;9534;9745;5.81;0.36;343.69;10.89;1254;21;3327.00;211
8284;19;621721330;8284;442;9537;9745;5.76;0.35;343.75;10.89;1253;21;3328.00;208
8285;19;621721354;8285;437;9539;9745;5.74;0.35;343.76;10.97;1254;21;3329.00;206
8289;19;621721381;8289;433;9543;9751;5.68;0.35;343.87;10.97;1254;21;3330.00;208
8293;19;621721404;8293;429;9544;9751;5.65;0.34;343.97;10.98;1251;21;3331.00;207
8296;19;621721425;8296;425;9545;9751;5.64;0.34;344.08;10.98;1249;21;3332.00;206
8302;19;621721440;8302;416;9551;9755;5.59;0.34;344.18;10.98;1249;21;3333.00;204
8304;19;621721457;8304;409;9554;9756;5.59;0.34;344.20;10.98;1250;21;3334.00;202
8307;19;621721474;8307;405;9560;9756;5.57;0.34;344.14;11.07;1253;21;3335.00;196
8310;19;621721493;8310;400;9563;9760;5.58;0.34;344.25;11.07;1253;21;3336.00;197
8313;19;621721508;8313;401;9566;9760;5.60;0.34;344.35;11.07;1253;21;3337.00;194
8315;19;621721523;8315;403;9567;9760;5.61;0.34;344.40;11.07;1252;21;3338.00;193
8318;19;621721538;8318;401;9568;9761;5.61;0.34;344.62;11.07;1250;21;3339.00;193
8320;19;621721554;8320;402;9571;9761;5.60;0.34;344.68;11.07;1251;21;3340.00;190
8323;19;621721568;8323;401;9575;9767;5.60;0.34;344.70;11.07;1252;21;3341.00;192
8325;19;621721584;8325;401;9575;9767;5.61;0.34;344.80;11.07;1250;21;3342.00;192
8330;19;621721599;8330;409;9577;9768;5.58;0.34;344.96;11.07;1247;21;3343.00;191
8333;19;621721614;8333;406;9577;9768;5.56;0.34;345.04;11.07;1244;21;3344.00;191
8337;19;621721629;8337;403;9577;9768;5.55;0.34;345.29;11.07;1240;21;3345.00;191
8339;19;621721646;8339;408;9578;9768;5.54;0.34;345.25;11.08;1239;21;3346.00;190
8342;19;621721660;8342;410;9578;9768;5.55;0.34;345.34;11.08;1236;21;3347.00;190
8343;19;621721675;8343;412;9589;9780;5.64;0.34;345.35;11.06;1246;21;3348.00;191
8346;19;621721699;8346;410;9590;9780;5.64;0.34;345.34;11.06;1244;21;3349.00;190
8349;19;621721715;8349;406;9590;9780;5.62;0.34;345.43;11.06;1241;21;3350.00;190
8352;19;621721730;8352;403;9592;9780;5.59;0.34;345.42;11.07;1240;21;3351.00;188
8353;19;621721745;8353;407;9592;9780;5.57;0.34;345.42;11.07;1239;21;3352.00;188
8359;19;621721760;8359;407;9592;9780;5.55;0.34;345.59;11.07;1233;21;3353.00;188
8360;19;621721777;8360;408;9596;9784;5.55;0.34;345.64;11.07;1236;21;3354.00;188
8361;19;621721793;8361;411;9597;9784;5.60;0.34;345.67;11.07;1236;21;3355.00;187
8362;19;621721808;8362;418;9600;9788;5.69;0.35;345.65;11.07;1238;21;3356.00;188
8365;19;621721825;8365;422;9603;9789;5.68;0.35;345.70;11.07;1238;21;3357.00;186
8369;19;621721842;8369;436;9603;9789;5.67;0.35;345.74;11.07;1234;21;3358.00;186
8375;19;621721857;8375;442;9604;9789;5.59;0.34;345.77;11.12;1229;21;3359.00;185
8379;19;621721875;8379;465;9626;9818;5.59;0.34;345.74;11.14;1247;21;3360.00;192
8383;19;621721895;8383;462;9626;9818;5.54;0.34;345.99;11.14;1243;21;3361.00;192
8387;19;621721911;8387;473;9629;9818;5.55;0.34;346.05;11.18;1242;21;3362.00;189
8388;19;621721928;8388;485;9632;9819;5.58;0.34;346.10;11.18;1244;21;3363.00;187
8391;19;621721943;8391;492;9634;9820;5.54;0.34;346.20;11.27;1243;21;3364.00;186
8393;19;621721959;8393;503;9634;9820;5.49;0.34;346.28;11.27;1241;21;3365.00;186
8395;19;621721975;8395;508;9636;9823;5.49;0.33;346.28;11.27;1241;21;3366.00;187
8396;19;621721991;8396;518;9638;9823;5.45;0.33;346.35;11.36;1242;21;3367.00;185
8399;19;621722006;8399;520;9639;9823;5.34;0.33;346.27;11.36;1240;21;3368.00;184
8400;19;621722021;8400;535;9639;9823;5.29;0.32;346.27;11.36;1239;21;3369.00;184
8405;19;621722035;8405;541;9646;9829;5.22;0.32;346.36;11.44;1241;21;3370.00;183
8407;19;621722051;8407;547;9646;9829;5.12;0.31;346.35;11.44;1239;21;3371.00;183
8411;19;621722065;8411;556;9646;9829;4.99;0.30;346.55;11.44;1235;21;3372.00;183
8413;19;621722080;8413;561;9648;9829;4.91;0.30;346.58;11.53;1235;21;3373.00;181
8416;19;621722094;8416;562;9651;9833;4.80;0.29;346.60;11.53;1235;21;3374.00;182
8417;19;621722109;8417;579;9653;9835;4.71;0.29;346.57;11.53;1236;21;3375.00;182
8418;19;621722123;8418;585;9653;9835;4.66;0.28;346.55;11.53;1235;21;3376.00;182
8418;19;621722137;8418;590;9654;9836;4.62;0.28;346.55;11.53;1236;21;3377.00;182
8420;19;621722150;8420;593;9658;9836;4.56;0.28;346.49;11.70;1238;21;3378.00;178
8420;19;621722164;8420;591;9658;9836;4.56;0.28;346.49;11.70;1238;21;3379.00;178
8424;19;621722177;8424;591;9660;9836;4.58;0.28;346.41;11.78;1236;21;3380.00;176
8427;19;621722193;8427;586;9660;9836;4.57;0.28;346.31;11.78;1233;21;3381.00;176
8429;19;621722207;8429;585;9660;9836;4.58;0.28;346.25;11.78;1231;21;3382.00;176
8429;19;621722221;8429;587;9662;9836;4.58;0.28;346.25;11.87;1233;21;3383.00;174
8430;19;621722235;8430;596;9700;9906;4.76;0.29;346.23;11.82;1270;21;3384.00;206
8430;19;621722256;8430;593;9704;9907;4.75;0.29;346.23;11.90;1274;21;3385.00;203
8430;19;621722272;8430;588;9712;9907;4.79;0.30;346.23;11.89;1282;21;3386.00;195
8435;19;621722285;8435;587;9715;9907;4.81;0.30;346.32;11.89;1280;21;3387.00;192
8437;19;621722300;8437;583;9720;9907;4.82;0.30;346.26;11.97;1283;21;3388.00;187
8440;19;621722316;8440;585;9722;9907;4.80;0.29;346.19;11.97;1282;21;3389.00;185
8443;19;621722332;8443;589;9725;9907;4.79;0.29;346.13;11.96;1282;21;3390.00;182
8445;19;621722346;8445;599;9729;9907;4.78;0.29;346.14;12.04;1284;21;3391.00;178
8447;19;621722361;8447;600;9730;9908;4.77;0.29;346.09;12.04;1283;21;3392.00;178
8450;19;621722374;8450;607;9735;9909;4.73;0.29;346.00;12.12;1285;21;3393.00;174
8452;19;621722388;8452;607;9736;9909;4.69;0.29;345.96;12.12;1284;21;3394.00;173
8455;19;621722402;8455;606;9740;9913;4.62;0.28;345.89;12.15;1285;21;3395.00;173
8460;19;621722416;8460;610;9741;9913;4.54;0.28;345.79;12.19;1281;21;3396.00;172
8463;19;621722430;8463;618;9742;9913;4.47;0.27;345.77;12.23;1279;21;3397.00;171
8466;19;621722444;8466;624;9743;9913;4.37;0.27;345.76;12.26;1277;21;3398.00;170
8468;19;621722457;8468;633;9747;9919;4.29;0.26;345.73;12.26;1279;21;3399.00;172
8470;19;621722472;8470;627;9747;9919;4.23;0.26;345.69;12.26;1277;21;3400.00;172
8473;19;621722490;8473;626;9747;9919;4.20;0.26;345.66;12.26;1274;21;3401.00;172
8474;19;621722503;8474;616;9748;9922;4.16;0.25;345.67;12.26;1274;21;3402.00;174
8476;19;621722515;8476;617;9748;9922;4.09;0.25;345.74;12.26;1272;21;3403.00;174
8479;19;621722527;8479;609;9748;9922;4.00;0.24;345.68;12.26;1269;21;3404.00;174
8479;19;621722539;8479;607;9748;9923;3.94;0.24;345.68;12.26;1269;21;3405.00;175
8482;19;621722551;8482;602;9749;9924;3.89;0.24;345.66;12.26;1267;21;3406.00;175
8486;19;621722563;8486;601;9749;9924;3.86;0.24;345.60;12.26;1263;21;3407.00;175
8490;19;621722576;8490;596;9758;9937;3.86;0.24;345.51;12.25;1268;21;3408.00;179
8492;19;621722589;8492;591;9759;9937;3.90;0.24;345.61;12.24;1267;21;3409.00;178
8495;19;621722602;8495;589;9759;9937;3.86;0.24;345.60;12.24;1264;21;3410.00;178
8496;19;621722614;8496;577;9759;9938;3.87;0.24;345.61;12.24;1263;21;3411.00;179
8496;19;621722627;8496;564;9759;9938;3.93;0.24;345.61;12.24;1263;21;3412.00;179
8497;19;621722640;8497;554;9762;9942;4.01;0.25;345.61;12.24;1265;21;3413.00;180
8499;19;621722653;8499;546;9762;9942;4.08;0.25;345.63;12.24;1263;21;3414.00;180
8504;19;621722666;8504;536;9765;9946;4.17;0.26;345.63;12.24;1261;21;3415.00;181
8507;19;621722680;8507;533;9765;9946;4.26;0.26;345.65;12.24;1258;21;3416.00;181
8510;19;621722693;8510;530;9765;9946;4.34;0.27;345.65;12.24;1255;21;3417.00;181
8516;19;621722714;8516;528;9765;9946;4.34;0.27;345.58;12.24;1249;21;3418.00;181
8518;19;621722728;8518;529;9765;9946;4.38;0.27;345.54;12.24;1247;21;3419.00;181
8519;19;621722744;8519;519;9792;9980;4.58;0.28;345.55;12.20;1273;21;3420.00;188
8524;19;621722767;8524;512;9792;9980;4.60;0.28;345.60;12.20;1268;21;3421.00;188
8526;19;621722781;8526;513;9792;9980;4.64;0.28;345.68;12.20;1266;21;3422.00;188
8529;19;621722795;8529;509;9792;9980;4.65;0.28;345.67;12.20;1263;21;3423.00;188
8530;19;621722809;8530;498;9792;9980;4.65;0.28;345.67;12.20;1262;21;3424.00;188
8533;19;621722822;8533;497;9792;9980;4.64;0.28;345.66;12.20;1259;21;3425.00;188
8538;19;621722836;8538;493;9793;9981;4.63;0.28;345.63;12.21;1255;21;3426.00;188
8538;19;621722851;8538;499;9793;9981;4.65;0.28;345.63;12.21;1255;21;3427.00;188
8543;19;621722864;8543;499;9797;9987;4.62;0.28;345.61;12.20;1254;21;3428.00;190
8547;19;621722878;8547;500;9797;9988;4.55;0.28;345.59;12.20;1250;21;3429.00;191
8549;19;621722893;8549;504;9798;9988;4.53;0.28;345.54;12.21;1249;21;3430.00;190
8553;19;621722906;8553;504;9798;9988;4.48;0.27;345.60;12.21;1245;21;3431.00;190
8555;19;621722920;8555;504;9802;9992;4.49;0.27;345.64;12.20;1247;21;3432.00;190
8559;19;621722934;8559;509;9803;9992;4.42;0.27;345.64;12.21;1244;21;3433.00;189
8563;19;621722948;8563;507;9804;9992;4.41;0.27;345.68;12.21;1241;21;3434.00;188
8567;19;621722962;8567;507;9805;9993;4.44;0.27;345.72;12.21;1238;21;3435.00;188
8570;19;621722976;8570;501;9808;9997;4.51;0.27;345.74;12.20;1238;21;3436.00;189
8574;19;621722990;8574;506;9810;9997;4.50;0.27;345.75;12.20;1236;21;3437.00;187
8577;19;621723003;8577;498;9811;10000;4.55;0.28;345.84;12.20;1234;21;3438.00;189
8579;19;621723017;8579;492;9814;10000;4.59;0.28;345.78;12.30;1235;21;3439.00;186
8582;19;621723031;8582;494;9814;10000;4.61;0.28;345.87;12.30;1232;21;3440.00;186
8585;19;621723044;8585;501;9815;10000;4.61;0.28;345.91;12.30;1230;21;3441.00;185
8587;19;621723057;8587;504;9819;10004;4.60;0.28;345.97;12.30;1232;21;3442.00;185
8591;19;621723072;8591;510;9819;10004;4.55;0.28;346.07;12.30;1228;21;3443.00;185
8593;19;621723086;8593;519;9819;10004;4.53;0.28;346.11;12.30;1226;21;3444.00;185
8595;19;621723099;8595;525;9820;10004;4.48;0.27;346.16;12.30;1225;21;3445.00;184
8597;19;621723113;8597;522;9820;10005;4.40;0.27;346.24;12.30;1223;21;3446.00;185
8598;19;621723126;8598;516;9823;10006;4.35;0.27;346.28;12.30;1225;21;3447.00;183
8604;19;621723141;8604;512;9823;10006;4.29;0.26;346.31;12.30;1219;21;3448.00;183
8607;19;621723154;8607;505;9825;10007;4.29;0.26;346.45;12.29;1218;21;3449.00;182
8609;19;621723169;8609;498;9825;10007;4.32;0.26;346.45;12.29;1216;21;3450.00;182
8610;19;621723182;8610;491;9825;10007;4.41;0.27;346.47;12.29;1215;21;3451.00;182
8615;19;621723202;8615;494;9825;10007;4.42;0.27;346.58;12.29;1210;21;3452.00;182
8616;19;621723215;8616;482;9825;10007;4.46;0.27;346.56;12.29;1209;21;3453.00;182
8617;19;621723229;8617;486;9825;10007;4.54;0.28;346.59;12.29;1208;21;3454.00;182
8617;19;621723242;8617;485;9826;10007;4.63;0.28;346.59;12.39;1209;21;3455.00;181
8619;19;621723255;8619;505;9904;10134;4.86;0.30;346.59;12.29;1285;21;3456.00;230
8621;19;621723279;8621;476;9904;10135;4.89;0.30;346.68;12.29;1283;21;3457.00;231
8622;19;621723293;8622;464;9909;10135;5.00;0.31;346.72;12.29;1287;21;3458.00;226
8623;19;621723308;8623;453;9911;10135;5.08;0.31;346.79;12.28;1288;21;3459.00;224
8624;19;621723332;8624;454;9915;10135;5.17;0.32;346.88;12.28;1291;21;3460.00;220
8627;19;621723355;8627;448;9916;10135;5.19;0.32;346.89;12.28;1289;21;3461.00;219
8630;19;621723379;8630;445;9918;10135;5.20;0.32;346.97;12.28;1288;21;3462.00;217
8632;19;621723402;8632;450;9920;10135;5.24;0.32;347.07;12.28;1288;21;3463.00;215
8634;19;621723421;8634;452;9922;10136;5.24;0.32;347.11;12.28;1288;21;3464.00;214
8637;19;621723440;8637;458;9928;10138;5.26;0.32;347.23;12.27;1291;21;3465.00;210
8640;19;621723457;8640;472;9931;10138;5.23;0.32;347.36;12.27;1291;21;3466.00;207
8643;19;621723475;8643;476;9933;10139;5.22;0.32;347.49;12.27;1290;21;3467.00;206
8646;19;621723491;8646;472;9935;10139;5.19;0.32;347.50;12.27;1289;21;3468.00;204
8648;19;621723507;8648;470;9937;10139;5.12;0.31;347.54;12.27;1289;21;3469.00;202
8650;19;621723523;8650;467;9942;10139;5.10;0.31;347.63;12.37;1292;21;3470.00;197
8654;19;621723538;8654;474;9947;10143;5.13;0.32;347.76;12.37;1293;21;3471.00;196
8654;19;621723553;8654;467;9949;10143;5.16;0.32;347.76;12.36;1295;21;3472.00;194
8655;19;621723568;8655;469;9949;10143;5.16;0.32;347.77;12.36;1294;21;3473.00;194
8656;19;621723583;8656;466;9951;10146;5.20;0.32;347.81;12.36;1295;21;3474.00;195
8659;19;621723599;8659;459;9953;10146;5.25;0.32;347.88;12.36;1294;21;3475.00;193
8662;19;621723617;8662;459;9955;10146;5.30;0.33;347.87;12.46;1293;21;3476.00;191
8664;19;621723633;8664;465;9958;10150;5.30;0.32;347.89;12.45;1294;21;3477.00;192
8668;19;621723649;8668;457;9960;10151;5.35;0.33;347.95;12.45;1292;21;3478.00;191
8672;19;621723666;8672;458;9960;10151;5.33;0.33;347.99;12.45;1288;21;3479.00;191
8673;19;621723683;8673;453;9964;10156;5.35;0.33;348.03;12.45;1291;21;3480.00;192
8678;19;621723699;8678;455;9964;10156;5.32;0.33;348.00;12.45;1286;21;3481.00;192
8681;19;621723721;8681;458;9964;10156;5.34;0.33;348.00;12.45;1283;21;3482.00;192
8686;19;621723736;8686;463;9965;10157;5.32;0.32;347.98;12.45;1279;21;3483.00;192
8688;19;621723753;8688;465;9965;10157;5.33;0.33;347.98;12.45;1277;21;3484.00;192
8689;19;621723768;8689;470;9970;10163;5.33;0.32;347.97;12.44;1281;21;3485.00;193
8691;19;621723784;8691;468;9970;10163;5.35;0.33;347.99;12.44;1279;21;3486.00;193
8693;19;621723800;8693;477;9970;10164;5.38;0.33;348.03;12.44;1277;21;3487.00;194
8694;19;621723817;8694;480;9970;10164;5.34;0.33;348.10;12.44;1276;21;3488.00;194
8695;19;621723836;8695;483;9970;10164;5.29;0.32;348.13;12.44;1275;21;3489.00;194
8696;19;621723852;8696;475;9970;10164;5.26;0.32;348.11;12.44;1274;21;3490.00;194
8697;19;621723868;8697;469;9970;10164;5.24;0.32;348.11;12.44;1273;21;3491.00;194
8700;19;621723884;8700;467;9980;10176;5.27;0.32;348.18;12.43;1280;21;3492.00;196
8703;19;621723902;8703;459;9981;10176;5.32;0.32;348.27;12.43;1278;21;3493.00;195
8706;19;621723918;8706;455;9981;10176;5.33;0.32;348.30;12.43;1275;21;3494.00;195
8708;19;621723933;8708;444;9981;10176;5.36;0.32;348.29;12.43;1273;21;3495.00;195
8710;19;621723955;8710;444;9981;10176;5.35;0.32;348.36;12.43;1271;21;3496.00;195
8711;19;621723972;8711;444;9981;10176;5.39;0.33;348.45;12.43;1270;21;3497.00;195
8713;19;621723986;8713;437;9984;10180;5.43;0.33;348.44;12.42;1271;21;3498.00;196
8717;19;621724001;8717;432;9984;10180;5.39;0.33;348.51;12.42;1267;21;3499.00;196
8719;19;621724017;8719;428;9988;10184;5.40;0.33;348.65;12.42;1269;21;3500.00;196
8722;19;621724036;8722;427;9988;10185;5.36;0.32;348.74;12.42;1266;21;3501.00;197
8723;19;621724051;8723;426;9989;10185;5.32;0.32;348.74;12.42;1266;21;3502.00;196
8726;19;621724066;8726;426;9989;10185;5.25;0.32;348.88;12.42;1263;21;3503.00;196
8729;19;621724080;8729;421;10001;10198;5.21;0.31;348.96;12.50;1272;21;3504.00;197
8730;19;621724097;8730;412;10003;10198;5.22;0.32;348.97;12.59;1273;21;3505.00;195
8733;19;621724113;8733;412;10003;10198;5.20;0.31;348.98;12.59;1270;21;3506.00;195
8737;19;621724127;8737;426;10004;10199;5.18;0.31;349.13;12.59;1267;21;3507.00;195
8740;19;621724141;8740;423;10004;10200;5.15;0.31;349.20;12.59;1264;21;3508.00;196
8745;19;621724155;8745;414;10004;10200;5.15;0.31;349.32;12.59;1259;21;3509.00;196
8746;19;621724173;8746;420;10008;10206;5.19;0.31;349.28;12.59;1262;21;3510.00;198
8749;19;621724187;8749;412;10009;10206;5.19;0.31;349.33;12.59;1260;21;3511.00;197
8751;19;621724200;8751;417;10010;10206;5.19;0.32;349.42;12.59;1259;21;3512.00;196
8753;19;621724215;8753;428;10010;10206;5.16;0.31;349.58;12.59;1257;21;3513.00;196
8756;19;621724229;8756;423;10015;10212;5.19;0.32;349.62;12.58;1259;21;3514.00;197
8760;19;621724244;8760;430;10015;10212;5.14;0.31;349.70;12.58;1255;21;3515.00;197
8764;19;621724259;8764;437;10015;10212;5.13;0.31;349.84;12.58;1251;21;3516.00;197
8766;19;621724273;8766;438;10015;10212;5.13;0.31;349.90;12.58;1249;21;3517.00;197
8769;19;621724287;8769;434;10018;10216;5.11;0.31;350.18;12.58;1249;21;3518.00;198
8772;19;621724302;8772;447;10021;10219;5.11;0.31;350.22;12.57;1249;21;3519.00;198
8776;19;621724318;8776;442;10021;10219;5.09;0.31;350.35;12.57;1245;21;3520.00;198
8777;19;621724333;8777;447;10022;10220;5.11;0.31;350.33;12.57;1245;21;3521.00;198
8779;19;621724347;8779;445;10022;10220;5.09;0.31;350.30;12.57;1243;21;3522.00;198
8780;19;621724361;8780;457;10022;10220;5.10;0.31;350.30;12.57;1242;21;3523.00;198
8782;19;621724374;8782;464;10022;10220;5.08;0.31;350.37;12.57;1240;21;3524.00;198
8784;19;621724388;8784;468;10022;10220;5.08;0.31;350.35;12.57;1238;21;3525.00;198
8786;19;621724401;8786;463;10022;10220;5.08;0.31;350.44;12.57;1236;21;3526.00;198
8788;19;621724414;8788;469;10023;10220;5.06;0.31;350.43;12.67;1235;21;3527.00;197
8788;19;621724429;8788;478;10057;10290;5.27;0.32;350.43;12.63;1269;21;3528.00;233
8790;19;621724454;8790;484;10057;10291;5.22;0.32;350.48;12.63;1267;21;3529.00;234
8793;19;621724469;8793;486;10066;10291;5.26;0.32;350.47;12.62;1273;21;3530.00;225
8795;19;621724483;8795;491;10069;10291;5.26;0.32;350.41;12.62;1274;21;3531.00;222
8797;19;621724497;8797;494;10074;10291;5.26;0.32;350.37;12.61;1277;21;3532.00;217
8800;19;621724511;8800;493;10077;10291;5.24;0.32;350.35;12.61;1277;21;3533.00;214
8806;19;621724525;8806;498;10081;10291;5.14;0.32;350.38;12.66;1275;21;3534.00;210
8806;19;621724539;8806;495;10084;10291;5.14;0.32;350.38;12.66;1278;21;3535.00;207
8810;19;621724559;8810;494;10088;10292;5.12;0.31;350.33;12.76;1278;21;3536.00;204
8811;19;621724573;8811;502;10090;10293;5.13;0.31;350.29;12.75;1279;21;3537.00;203
8812;19;621724588;8812;510;10092;10293;5.08;0.31;350.27;12.75;1280;21;3538.00;201
8815;19;621724602;8815;509;10095;10297;5.03;0.31;350.26;12.75;1280;21;3539.00;202
8817;19;621724618;8817;518;10096;10297;4.93;0.30;350.20;12.75;1279;21;3540.00;201
8817;19;621724631;8817;524;10097;10297;4.88;0.30;350.20;12.75;1280;21;3541.00;200
8821;19;621724644;8821;531;10099;10297;4.75;0.29;350.22;12.85;1278;21;3542.00;198
8822;19;621724658;8822;539;10104;10303;4.71;0.29;350.21;12.84;1282;21;3543.00;199
8823;19;621724672;8823;544;10107;10303;4.63;0.28;350.17;12.99;1284;21;3544.00;196
8823;19;621724685;8823;558;10107;10303;4.57;0.28;350.17;12.99;1284;21;3545.00;196
8825;19;621724698;8825;559;10109;10306;4.53;0.28;350.13;12.98;1284;21;3546.00;197
8828;19;621724711;8828;567;10109;10306;4.50;0.28;350.15;12.98;1281;21;3547.00;197
8829;19;621724725;8829;574;10111;10306;4.46;0.27;350.18;13.03;1282;21;3548.00;195
8830;19;621724737;8830;575;10111;10307;4.45;0.27;350.16;13.03;1281;21;3549.00;196
8833;19;621724750;8833;571;10115;10308;4.41;0.27;350.14;13.17;1282;21;3550.00;193
8834;19;621724763;8834;575;10115;10308;4.37;0.27;350.11;13.17;1281;21;3551.00;193
8839;19;621724781;8839;582;10125;10321;4.31;0.26;350.12;13.16;1286;21;3552.00;196
8840;19;621724795;8840;580;10126;10321;4.30;0.26;350.08;13.20;1286;21;3553.00;195
8840;19;621724808;8840;581;10128;10321;4.30;0.26;350.08;13.25;1288;21;3554.00;193
8845;19;621724821;8845;584;10131;10323;4.28;0.26;349.98;13.29;1286;21;3555.00;192
8847;19;621724834;8847;582;10131;10323;4.27;0.26;350.01;13.29;1284;21;3556.00;192
8848;19;621724847;8848;585;10136;10327;4.34;0.26;349.98;13.33;1288;21;3557.00;191
8849;19;621724859;8849;582;10136;10327;4.33;0.26;349.95;13.33;1287;21;3558.00;191
8851;19;621724872;8851;583;10139;10331;4.34;0.26;349.93;13.33;1288;21;3559.00;192
8854;19;621724884;8854;580;10139;10331;4.30;0.26;349.88;13.33;1285;21;3560.00;192
8855;19;621724902;8855;584;10139;10331;4.22;0.26;349.84;13.33;1284;21;3561.00;192
8856;19;621724915;8856;588;10139;10331;4.17;0.25;349.82;13.33;1283;21;3562.00;192
8858;19;621724926;8858;580;10139;10331;4.15;0.25;349.82;13.33;1281;21;3563.00;192
8859;19;621724939;8859;566;10148;10343;4.21;0.26;349.83;13.32;1289;21;3564.00;195
8862;19;621724952;8862;561;10148;10343;4.17;0.25;349.89;13.32;1286;21;3565.00;195
8863;19;621724965;8863;559;10150;10343;4.18;0.25;349.90;13.32;1287;21;3566.00;193
8866;19;621724978;8866;556;10150;10343;4.15;0.25;349.85;13.32;1284;21;3567.00;193
8868;19;621724990;8868;562;10150;10343;4.11;0.25;349.86;13.32;1282;21;3568.00;193
8869;19;621725002;8869;565;10150;10343;4.08;0.25;349.86;13.32;1281;21;3569.00;193
8872;19;621725022;8872;550;10150;10344;4.04;0.25;349.84;13.32;1278;21;3570.00;194
8873;19;621725035;8873;547;10150;10344;4.01;0.24;349.84;13.32;1277;21;3571.00;194
8877;19;621725048;8877;533;10155;10350;4.00;0.24;349.83;13.31;1278;21;3572.00;195
8880;19;621725067;8880;526;10156;10351;3.98;0.24;349.79;13.31;1276;21;3573.00;195
8883;19;621725080;8883;516;10156;10351;4.00;0.24;349.72;13.31;1273;21;3574.00;195
8883;19;621725093;8883;522;10156;10351;4.06;0.25;349.72;13.31;1273;21;3575.00;195
8886;19;621725105;8886;514;10159;10355;4.11;0.25;349.69;13.30;1273;21;3576.00;196
8888;19;621725118;8888;505;10159;10355;4.15;0.25;349.67;13.30;1271;21;3577.00;196
8891;19;621725131;8891;498;10159;10355;4.21;0.26;349.67;13.30;1268;21;3578.00;196
8893;19;621725144;8893;482;10160;10356;4.27;0.26;349.69;13.30;1267;21;3579.00;196
8895;19;621725157;8895;472;10163;10360;4.31;0.26;349.66;13.30;1268;21;3580.00;197
8896;19;621725170;8896;465;10163;10360;4.31;0.26;349.67;13.30;1267;21;3581.00;197
8898;19;621725183;8898;464;10166;10363;4.36;0.27;349.68;13.30;1268;21;3582.00;197
8902;19;621725197;8902;460;10166;10363;4.39;0.27;349.83;13.30;1264;21;3583.00;197
8905;19;621725210;8905;451;10166;10363;4.45;0.27;349.82;13.30;1261;21;3584.00;197
8908;19;621725224;8908;440;10166;10363;4.54;0.28;349.82;13.30;1258;21;3585.00;197
8913;19;621725237;8913;449;10170;10367;4.59;0.28;349.77;13.29;1257;21;3586.00;197
8915;19;621725250;8915;448;10170;10367;4.65;0.28;349.80;13.29;1255;21;3587.00;197
8919;19;621725264;8919;438;10170;10367;4.65;0.28;349.75;13.29;1251;21;3588.00;197
8923;19;621725277;8923;439;10170;10367;4.71;0.29;349.73;13.29;1247;21;3589.00;197
8924;19;621725291;8924;438;10170;10368;4.74;0.29;349.73;13.29;1246;21;3590.00;198
8929;19;621725305;8929;438;10171;10369;4.72;0.29;350.02;13.29;1242;21;3591.00;198
8931;19;621725326;8931;435;10171;10369;4.74;0.29;350.05;13.29;1240;21;3592.00;198
8933;19;621725349;8933;437;10172;10370;4.75;0.29;350.03;13.29;1239;21;3593.00;198
8936;19;621725371;8936;433;10172;10370;4.80;0.29;350.15;13.29;1236;21;3594.00;198
8939;19;621725391;8939;423;10172;10370;4.86;0.30;350.16;13.29;1233;21;3595.00;198
8941;19;621725411;8941;424;10172;10370;4.89;0.30;350.16;13.29;1231;21;3596.00;198
8947;19;621725430;8947;422;10172;10370;4.88;0.30;350.21;13.29;1225;21;3597.00;198
8951;19;621725446;8951;429;10172;10370;4.90;0.30;350.18;13.29;1221;21;3598.00;198
8952;19;621725462;8952;428;10172;10370;4.92;0.30;350.16;13.29;1220;21;3599.00;198
8958;19;621725487;8958;468;10290;10623;5.18;0.32;350.25;13.14;1332;21;3600.00;333
8962;19;621725529;8962;452;10300;10624;5.20;0.32;350.22;13.12;1338;21;3601.00;324
8964;19;621725545;8964;439;10310;10624;5.24;0.33;350.27;13.11;1346;21;3602.00;314
8969;19;621725561;8969;441;10319;10624;5.31;0.33;350.27;13.11;1350;21;3603.00;305
8971;19;621725576;8971;433;10323;10624;5.35;0.33;350.27;13.10;1352;21;3604.00;301
8974;19;621725593;8974;435;10330;10624;5.34;0.33;350.34;13.10;1356;21;3605.00;294
8977;19;621725609;8977;428;10336;10624;5.35;0.33;350.36;13.20;1359;21;3606.00;288
8978;19;621725626;8978;430;10340;10624;5.36;0.33;350.36;13.19;1362;21;3607.00;284
8982;19;621725643;8982;431;10345;10625;5.33;0.33;350.36;13.19;1363;21;3608.00;280
8984;20;621725658;8984;433;10350;10626;5.30;0.33;350.40;13.19;1366;22;3609.00;276
8986;20;621725684;8986;438;10353;10626;5.27;0.33;350.40;13.19;1367;22;3610.00;273
8990;20;621725706;8990;449;10356;10627;5.18;0.32;350.46;13.19;1366;22;3611.00;271
8995;20;621725724;8995;444;10357;10627;5.10;0.32;350.51;13.19;1362;22;3612.00;270
8999;20;621725741;8999;455;10358;10627;5.01;0.31;350.52;13.19;1359;22;3613.00;269
9002;20;621725756;9002;458;10361;10627;4.92;0.30;350.68;13.19;1359;22;3614.00;266
9005;20;621725772;9005;467;10365;10631;4.87;0.30;350.67;13.19;1360;22;3615.00;266
9007;20;621725788;9007;476;10366;10631;4.81;0.30;350.67;13.19;1359;22;3616.00;265
9008;20;621725805;9008;464;10367;10631;4.80;0.30;350.71;13.19;1359;22;3617.00;264
9011;20;621725822;9011;469;10368;10634;4.80;0.30;350.90;13.19;1357;22;3618.00;266
9012;20;621725839;9012;459;10369;10634;4.80;0.30;350.92;13.19;1357;22;3619.00;265
9015;20;621725856;9015;461;10369;10634;4.81;0.30;351.03;13.19;1354;22;3620.00;265
9018;21;621725879;9018;468;10374;10638;4.78;0.29;351.12;13.18;1356;23;3621.00;264
9023;21;621725915;9023;466;10375;10639;4.79;0.29;351.08;13.29;1352;23;3622.00;264
9026;21;621725932;9026;469;10376;10639;4.78;0.29;351.12;13.29;1350;23;3623.00;263
9027;21;621725949;9027;487;10378;10643;4.82;0.29;351.15;13.29;1351;23;3624.00;265
9031;22;621725965;9031;486;10379;10643;4.81;0.29;351.28;13.29;1348;24;3625.00;264
9033;22;621726002;9033;473;10380;10643;4.80;0.29;351.34;13.29;1347;24;3626.00;263
9034;22;621726020;9034;472;10381;10644;4.80;0.29;351.31;13.29;1347;24;3627.00;263
9037;22;621726037;9037;463;10383;10644;4.83;0.29;351.40;13.30;1346;24;3628.00;261
9039;22;621726053;9039;463;10387;10650;4.88;0.30;351.40;13.30;1348;24;3629.00;263
9042;22;621726073;9042;462;10389;10650;4.88;0.30;351.47;13.30;1347;24;3630.00;261
9044;22;621726090;9044;470;10392;10651;4.92;0.30;351.52;13.30;1348;24;3631.00;259
9046;22;621726108;9046;465;10393;10651;4.94;0.30;351.63;13.30;1347;24;3632.00;258
9049;22;621726124;9049;464;10394;10651;4.98;0.30;351.77;13.30;1345;24;3633.00;257
9050;22;621726141;9050;470;10398;10651;4.97;0.30;351.78;13.41;1348;24;3634.00;253
9052;22;621726158;9052;476;10400;10651;4.96;0.30;351.89;13.42;1348;24;3635.00;251
9054;22;621726175;9054;482;10406;10663;4.97;0.30;351.93;13.41;1352;24;3636.00;257
9057;22;621726193;9057;465;10409;10663;5.01;0.30;352.12;13.41;1352;24;3637.00;254
9060;22;621726210;9060;469;10410;10663;5.03;0.31;352.27;13.41;1350;24;3638.00;253
9061;22;621726228;9061;468;10412;10663;5.06;0.31;352.33;13.41;1351;24;3639.00;251
9065;22;621726245;9065;470;10414;10663;5.08;0.31;352.48;13.41;1349;24;3640.00;249
9070;22;621726263;9070;474;10416;10663;5.09;0.31;352.49;13.41;1346;24;3641.00;247
9074;22;621726279;9074;471;10419;10667;5.10;0.31;352.63;13.41;1345;24;3642.00;248
9075;22;621726297;9075;470;10421;10667;5.10;0.31;352.67;13.41;1346;24;3643.00;246
9077;22;621726318;9077;468;10425;10671;5.11;0.31;352.72;13.40;1348;24;3644.00;246
9078;22;621726335;9078;471;10427;10673;5.12;0.31;352.72;13.40;1349;24;3645.00;246
9079;22;621726352;9079;466;10428;10673;5.11;0.31;352.86;13.40;1349;24;3646.00;245
9083;22;621726368;9083;465;10428;10673;5.04;0.31;353.02;13.40;1345;24;3647.00;245
9086;22;621726384;9086;468;10436;10686;5.07;0.31;353.04;13.39;1350;24;3648.00;250
9088;22;621726401;9088;468;10437;10686;5.06;0.31;353.19;13.39;1349;24;3649.00;249
9090;22;621726416;9090;459;10438;10686;5.00;0.30;353.18;13.50;1348;24;3650.00;248
9092;22;621726432;9092;464;10439;10687;4.96;0.30;353.29;13.50;1347;24;3651.00;248
9093;22;621726447;9093;455;10439;10688;4.93;0.30;353.29;13.50;1346;24;3652.00;249
9096;22;621726462;9096;455;10439;10688;4.85;0.29;353.32;13.50;1343;24;3653.00;249
9097;22;621726478;9097;460;10441;10691;4.83;0.29;353.43;13.49;1344;24;3654.00;250
9098;22;621726492;9098;462;10442;10691;4.82;0.29;353.41;13.49;1344;24;3655.00;249
9100;22;621726507;9100;461;10443;10691;4.80;0.29;353.45;13.49;1343;24;3656.00;248
9101;22;621726521;9101;468;10443;10691;4.78;0.29;353.41;13.49;1342;24;3657.00;248
9102;22;621726536;9102;472;10448;10697;4.80;0.29;353.44;13.49;1346;24;3658.00;249
9103;22;621726551;9103;481;10448;10697;4.83;0.29;353.48;13.49;1345;24;3659.00;249
9107;22;621726568;9107;470;10448;10697;4.83;0.30;353.54;13.49;1341;24;3660.00;249
9108;22;621726583;9108;466;10448;10697;4.87;0.30;353.56;13.49;1340;24;3661.00;249
9113;22;621726599;9113;462;10450;10701;4.87;0.30;353.71;13.48;1337;24;3662.00;251
9115;22;621726615;9115;461;10452;10702;4.87;0.30;353.68;13.48;1337;24;3663.00;250
9121;22;621726630;9121;460;10452;10702;4.86;0.30;353.73;13.48;1331;24;3664.00;250
9121;22;621726645;9121;462;10453;10703;4.90;0.30;353.73;13.48;1332;24;3665.00;250
9125;22;621726660;9125;473;10454;10703;4.89;0.30;353.83;13.58;1329;24;3666.00;249
9128;22;621726675;9128;469;10454;10703;4.97;0.30;353.89;13.58;1326;24;3667.00;249
9131;22;621726690;9131;472;10454;10703;4.98;0.30;354.06;13.58;1323;24;3668.00;249
9133;22;621726705;9133;464;10454;10703;4.99;0.30;354.14;13.58;1321;24;3669.00;249
9134;22;621726720;9134;459;10454;10703;4.96;0.30;354.14;13.58;1320;24;3670.00;249
9138;22;621726734;9138;461;10455;10703;4.94;0.30;354.21;13.59;1317;24;3671.00;248
9142;22;621726748;9142;462;10486;10773;4.95;0.30;354.28;13.55;1344;24;3672.00;287
9142;22;621726769;9142;461;10487;10774;4.92;0.30;354.28;13.55;1345;24;3673.00;287
9144;22;621726783;9144;454;10493;10774;4.96;0.30;354.28;13.60;1349;24;3674.00;281
9145;22;621726801;9145;454;10495;10774;4.95;0.30;354.27;13.65;1350;24;3675.00;279
9147;22;621726815;9147;453;10499;10774;4.94;0.30;354.35;13.65;1352;24;3676.00;275
9149;22;621726830;9149;446;10503;10774;5.00;0.30;354.41;13.65;1354;24;3677.00;271
9152;22;621726846;9152;447;10505;10774;5.02;0.31;354.38;13.65;1353;24;3678.00;269
9155;22;621726860;9155;457;10507;10774;5.07;0.31;354.36;13.65;1352;24;3679.00;267
9156;22;621726876;9156;446;10511;10775;5.11;0.31;354.33;13.64;1355;24;3680.00;264
9156;22;621726890;9156;450;10512;10776;5.11;0.31;354.33;13.64;1356;24;3681.00;264
9158;22;621726905;9158;452;10514;10776;5.10;0.31;354.30;13.64;1356;24;3682.00;262
9160;22;621726920;9160;456;10519;10780;5.08;0.31;354.28;13.64;1359;24;3683.00;261
9163;22;621726935;9163;467;10521;10780;5.05;0.31;354.23;13.64;1358;24;3684.00;259
9166;22;621726950;9166;464;10522;10780;5.03;0.31;354.29;13.64;1356;24;3685.00;258
9166;22;621726964;9166;473;10523;10780;5.00;0.31;354.29;13.64;1357;24;3686.00;257
9167;22;621726979;9167;473;10527;10786;5.04;0.31;354.36;13.63;1360;24;3687.00;259
9168;22;621726995;9168;477;10528;10786;5.03;0.31;354.44;13.64;1360;24;3688.00;258
9170;22;621727010;9170;482;10528;10786;5.01;0.31;354.40;13.64;1358;24;3689.00;258
9172;22;621727026;9172;486;10533;10792;5.04;0.31;354.39;13.64;1361;24;3690.00;259
9173;22;621727041;9173;492;10534;10792;5.04;0.31;354.36;13.64;1361;24;3691.00;258
9174;22;621727056;9174;497;10538;10792;5.00;0.31;354.33;13.65;1364;24;3692.00;254
9180;22;621727071;9180;499;10538;10793;4.97;0.30;354.25;13.65;1358;24;3693.00;255
9185;22;621727086;9185;505;10539;10794;4.92;0.30;354.19;13.65;1354;24;3694.00;255
9189;22;621727101;9189;507;10541;10794;4.85;0.30;354.22;13.66;1352;24;3695.00;253
9190;22;621727116;9190;514;10550;10807;4.81;0.29;354.18;13.65;1360;24;3696.00;257
9193;22;621727132;9193;521;10553;10807;4.73;0.29;354.24;13.70;1360;24;3697.00;254
9195;22;621727147;9195;537;10554;10807;4.67;0.28;354.24;13.71;1359;24;3698.00;253
9196;22;621727161;9196;548;10555;10808;4.65;0.28;354.25;13.71;1359;24;3699.00;253
9197;22;621727176;9197;552;10556;10808;4.58;0.28;354.22;13.76;1359;24;3700.00;252
9200;22;621727195;9200;558;10561;10812;4.57;0.28;354.17;13.77;1361;24;3701.00;251
9201;22;621727210;9201;561;10562;10812;4.52;0.28;354.18;13.82;1361;24;3702.00;250
9202;22;621727224;9202;567;10566;10816;4.50;0.27;354.16;13.83;1364;24;3703.00;250
9205;22;621727239;9205;571;10567;10816;4.45;0.27;354.17;13.88;1362;24;3704.00;249
9207;22;621727254;9207;575;10568;10816;4.42;0.27;354.14;13.94;1361;24;3705.00;248
9210;22;621727268;9210;580;10570;10816;4.37;0.27;354.11;14.00;1360;24;3706.00;246
9211;22;621727282;9211;590;10571;10816;4.35;0.27;354.07;14.06;1360;24;3707.00;245
9211;22;621727296;9211;589;10583;10828;4.39;0.27;354.07;14.11;1372;24;3708.00;245
9213;22;621727311;9213;590;10584;10828;4.36;0.27;354.11;14.11;1371;24;3709.00;244
9214;22;621727334;9214;595;10585;10828;4.37;0.27;354.10;14.16;1371;24;3710.00;243
9215;22;621727355;9215;597;10586;10828;4.35;0.27;354.06;14.21;1371;24;3711.00;242
9216;22;621727377;9216;596;10586;10828;4.32;0.26;354.05;14.21;1370;24;3712.00;242
9219;22;621727399;9219;593;10588;10828;4.25;0.26;354.03;14.28;1369;24;3713.00;240
9221;22;621727425;9221;604;10588;10829;4.17;0.26;353.97;14.28;1367;24;3714.00;241
9222;22;621727440;9222;591;10589;10829;4.16;0.26;353.96;14.33;1367;24;3715.00;240
9226;22;621727456;9226;586;10594;10835;4.19;0.26;353.90;14.32;1368;24;3716.00;241
9229;22;621727472;9229;579;10596;10836;4.17;0.26;353.94;14.38;1367;24;3717.00;240
9229;22;621727486;9229;575;10596;10836;4.15;0.25;353.94;14.38;1367;24;3718.00;240
9231;22;621727501;9231;579;10599;10836;4.14;0.25;353.92;14.44;1368;24;3719.00;237
9232;22;621727519;9232;567;10603;10841;4.17;0.26;353.88;14.44;1371;24;3720.00;238
9234;22;621727534;9234;565;10605;10841;4.17;0.26;353.94;14.55;1371;24;3721.00;236
9235;22;621727555;9235;549;10606;10841;4.21;0.26;353.94;14.55;1371;24;3722.00;235
9237;22;621727569;9237;547;10608;10842;4.25;0.26;353.93;14.55;1371;24;3723.00;234
9240;22;621727585;9240;554;10614;10846;4.29;0.26;353.84;14.65;1374;24;3724.00;232
9242;22;621727600;9242;552;10615;10846;4.38;0.27;353.81;14.66;1373;24;3725.00;231
9242;22;621727615;9242;546;10617;10849;4.45;0.27;353.81;14.65;1375;24;3726.00;232
9247;22;621727630;9247;544;10620;10849;4.49;0.27;353.83;14.75;1373;24;3727.00;229
9247;22;621727652;9247;545;10622;10849;4.55;0.28;353.83;14.80;1375;24;3728.00;227
9247;22;621727677;9247;546;10623;10849;4.59;0.28;353.83;14.86;1376;24;3729.00;226
9250;22;621727691;9250;547;10628;10853;4.62;0.28;353.76;14.90;1378;24;3730.00;225
9251;22;621727713;9251;545;10629;10853;4.61;0.28;353.73;14.95;1378;24;3731.00;224
9256;22;621727728;9256;553;10629;10853;4.59;0.28;353.71;14.95;1373;24;3732.00;224
9257;22;621727743;9257;549;10630;10853;4.54;0.28;353.68;15.00;1373;24;3733.00;223
9259;22;621727756;9259;550;10631;10854;4.53;0.27;353.67;15.05;1372;24;3734.00;223
9261;22;621727773;9261;544;10634;10856;4.56;0.28;353.67;15.10;1373;24;3735.00;222
9266;22;621727787;9266;547;10635;10856;4.50;0.27;353.70;15.15;1369;24;3736.00;221
9267;22;621727802;9267;545;10636;10857;4.47;0.27;353.79;15.15;1369;24;3737.00;221
9271;22;621727816;9271;551;10638;10857;4.43;0.27;353.76;15.25;1367;24;3738.00;219
9273;22;621727830;9273;557;10638;10857;4.37;0.27;353.73;15.25;1365;24;3739.00;219
9276;22;621727844;9276;545;10638;10857;4.36;0.26;353.81;15.25;1362;24;3740.00;219
9280;22;621727859;9280;553;10639;10857;4.34;0.26;353.97;15.29;1359;24;3741.00;218
9283;22;621727874;9283;546;10640;10857;4.34;0.26;353.96;15.34;1357;24;3742.00;217
9286;22;621727889;9286;543;10641;10857;4.30;0.26;353.94;15.39;1355;24;3743.00;216
9289;22;621727903;9289;565;10709;10984;4.58;0.28;354.02;15.29;1420;24;3744.00;275
9291;22;621727932;9291;553;10715;10985;4.61;0.28;354.03;15.33;1424;24;3745.00;270
9294;22;621727948;9294;551;10722;10985;4.63;0.29;354.11;15.32;1428;24;3746.00;263
9296;22;621727963;9296;539;10725;10985;4.63;0.29;354.22;15.32;1429;24;3747.00;260
9299;22;621727979;9299;532;10729;10985;4.61;0.28;354.40;15.32;1430;24;3748.00;256
9301;22;621727996;9301;529;10733;10985;4.62;0.28;354.44;15.31;1432;24;3749.00;252
9305;22;621728013;9305;522;10738;10990;4.57;0.28;354.50;15.31;1433;24;3750.00;252
9309;22;621728030;9309;522;10740;10990;4.55;0.28;354.65;15.31;1431;24;3751.00;250
9312;22;621728046;9312;515;10741;10991;4.55;0.28;354.66;15.31;1429;24;3752.00;250
9315;22;621728062;9315;509;10743;10992;4.60;0.28;354.67;15.30;1428;24;3753.00;249
9319;22;621728079;9319;502;10746;10992;4.65;0.29;354.80;15.30;1427;24;3754.00;246
9321;22;621728095;9321;509;10747;10993;4.72;0.29;354.79;15.30;1426;24;3755.00;246
9322;22;621728111;9322;508;10752;10993;4.74;0.29;354.81;15.30;1430;24;3756.00;241
9327;22;621728127;9327;504;10753;10993;4.79;0.29;354.86;15.30;1426;24;3757.00;240
9331;22;621728143;9331;494;10754;10993;4.83;0.30;354.92;15.30;1423;24;3758.00;239
9335;22;621728159;9335;499;10756;10997;4.83;0.30;354.90;15.30;1421;24;3759.00;241
9339;22;621728176;9339;496;10759;10997;4.84;0.30;354.89;15.30;1420;24;3760.00;238
9342;22;621728193;9342;497;10759;10997;4.85;0.30;354.99;15.30;1417;24;3761.00;238
9349;22;621728209;9349;492;10761;11000;4.80;0.29;355.10;15.30;1412;24;3762.00;239
9355;22;621728233;9355;493;10762;11000;4.78;0.29;355.15;15.40;1407;24;3763.00;238
9358;22;621728251;9358;495;10762;11000;4.80;0.29;355.29;15.40;1404;24;3764.00;238
9363;22;621728267;9363;498;10766;11004;4.81;0.29;355.41;15.40;1403;24;3765.00;238
9366;22;621728284;9366;498;10767;11005;4.81;0.29;355.44;15.40;1401;24;3766.00;238
9369;22;621728301;9369;502;10768;11005;4.80;0.29;355.45;15.40;1399;24;3767.00;237
9372;22;621728328;9372;497;10769;11009;4.82;0.29;355.60;15.40;1397;24;3768.00;240
9376;22;621728347;9376;499;10770;11009;4.82;0.29;355.60;15.40;1394;24;3769.00;239
9379;22;621728364;9379;498;10771;11009;4.83;0.29;355.76;15.40;1392;24;3770.00;238
9386;22;621728380;9386;493;10771;11010;4.80;0.29;355.72;15.40;1385;24;3771.00;239
9390;22;621728397;9390;493;10771;11010;4.75;0.29;355.73;15.40;1381;24;3772.00;239
9392;22;621728412;9392;493;10776;11016;4.73;0.29;355.78;15.40;1384;24;3773.00;240
9396;22;621728430;9396;492;10776;11016;4.67;0.28;355.77;15.40;1380;24;3774.00;240
9398;22;621728446;9398;498;10777;11017;4.67;0.28;355.79;15.40;1379;24;3775.00;240
9402;22;621728461;9402;498;10778;11017;4.67;0.28;355.75;15.40;1376;24;3776.00;239
9403;22;621728477;9403;499;10778;11017;4.72;0.29;355.71;15.40;1375;24;3777.00;239
9408;22;621728491;9408;506;10780;11017;4.72;0.29;355.78;15.40;1372;24;3778.00;237
9412;22;621728507;9412;503;10781;11017;4.74;0.29;355.80;15.40;1369;24;3779.00;236
9413;22;621728524;9413;504;10804;11053;4.85;0.30;355.78;15.37;1391;24;3780.00;249
9415;22;621728542;9415;499;10805;11053;4.84;0.30;355.77;15.36;1390;24;3781.00;248
9418;22;621728557;9418;505;10807;11053;4.78;0.29;355.77;15.36;1389;24;3782.00;246
9423;22;621728578;9423;511;10807;11053;4.73;0.29;355.82;15.36;1384;24;3783.00;246
9427;22;621728594;9427;513;10809;11053;4.75;0.29;355.88;15.36;1382;24;3784.00;244
9430;22;621728610;9430;516;10811;11053;4.72;0.29;355.85;15.36;1381;24;3785.00;242
9434;22;621728625;9434;529;10816;11057;4.66;0.29;355.97;15.36;1382;24;3786.00;241
9437;22;621728641;9437;522;10816;11057;4.66;0.28;355.96;15.36;1379;24;3787.00;241
9441;22;621728657;9441;514;10819;11061;4.66;0.28;356.00;15.36;1378;24;3788.00;242
9443;22;621728674;9443;522;10820;11062;4.66;0.28;355.99;15.35;1377;24;3789.00;242
9445;22;621728693;9445;530;10821;11062;4.62;0.28;356.03;15.36;1376;24;3790.00;241
9449;23;621728710;9449;529;10821;11062;4.56;0.28;356.26;15.36;1372;25;3791.00;241
9456;23;621728733;9456;534;10831;11075;4.58;0.28;356.43;15.34;1375;25;3792.00;244
9456;23;621728750;9456;529;10831;11075;4.62;0.28;356.43;15.34;1375;25;3793.00;244
9458;23;621728766;9458;530;10832;11075;4.65;0.28;356.51;15.34;1374;25;3794.00;243
9461;23;621728781;9461;543;10834;11076;4.64;0.28;356.52;15.34;1373;25;3795.00;242
9464;23;621728796;9464;534;10835;11077;4.62;0.28;356.64;15.34;1371;25;3796.00;242
9469;23;621728812;9469;522;10835;11077;4.60;0.28;356.68;15.34;1366;25;3797.00;242
9472;23;621728844;9472;515;10837;11080;4.62;0.28;356.72;15.34;1365;25;3798.00;243
9475;23;621728859;9475;520;10839;11080;4.61;0.28;356.81;15.34;1364;25;3799.00;241
9480;23;621728875;9480;518;10840;11080;4.57;0.28;356.85;15.34;1360;25;3800.00;240
9484;23;621728894;9484;525;10840;11080;4.54;0.27;356.87;15.34;1356;25;3801.00;240
9488;23;621728910;9488;533;10845;11086;4.52;0.27;356.90;15.33;1357;25;3802.00;241
9490;23;621728933;9490;540;10847;11086;4.53;0.27;357.00;15.33;1357;25;3803.00;239
9492;23;621728948;9492;545;10847;11086;4.56;0.28;357.06;15.33;1355;25;3804.00;239
9492;23;621728963;9492;550;10847;11086;4.57;0.28;357.06;15.33;1355;25;3805.00;239
9495;23;621728978;9495;564;10849;11090;4.55;0.28;357.18;15.33;1354;25;3806.00;241
9497;23;621728994;9497;563;10850;11091;4.59;0.28;357.20;15.33;1353;25;3807.00;241
9498;23;621729009;9498;557;10850;11091;4.60;0.28;357.18;15.33;1352;25;3808.00;241
9502;23;621729024;9502;546;10852;11092;4.60;0.28;357.27;15.32;1350;25;3809.00;240
9507;23;621729042;9507;544;10852;11092;4.60;0.28;357.42;15.32;1345;25;3810.00;240
9507;23;621729058;9507;542;10852;11092;4.60;0.28;357.42;15.32;1345;25;3811.00;240
9509;23;621729079;9509;536;10852;11092;4.57;0.28;357.56;15.32;1343;25;3812.00;240
9511;23;621729094;9511;540;10852;11092;4.56;0.28;357.74;15.32;1341;25;3813.00;240
9515;23;621729109;9515;535;10852;11092;4.52;0.27;357.76;15.32;1337;25;3814.00;240
9515;23;621729123;9515;529;10852;11092;4.49;0.27;357.76;15.32;1337;25;3815.00;240
9516;23;621729138;9516;542;10888;11162;4.57;0.28;357.81;15.27;1372;25;3816.00;274
9518;23;621729158;9518;535;10888;11163;4.57;0.28;357.83;15.27;1370;25;3817.00;275
9519;23;621729173;9519;530;10893;11163;4.64;0.28;357.88;15.27;1374;25;3818.00;270
9521;23;621729187;9521;532;10894;11163;4.61;0.28;357.93;15.27;1373;25;3819.00;269
9523;23;621729202;9523;531;10898;11163;4.67;0.28;357.90;15.26;1375;25;3820.00;265
9526;23;621729216;9526;539;10904;11163;4.67;0.28;357.86;15.26;1378;25;3821.00;259
9528;23;621729231;9528;548;10907;11163;4.69;0.29;357.89;15.25;1379;25;3822.00;256
9532;23;621729246;9532;560;10910;11163;4.71;0.29;357.95;15.25;1378;25;3823.00;253
9536;23;621729261;9536;556;10912;11164;4.73;0.29;358.07;15.25;1376;25;3824.00;252
9538;23;621729276;9538;557;10916;11166;4.75;0.29;358.07;15.25;1378;25;3825.00;250
9540;23;621729291;9540;565;10918;11166;4.75;0.29;358.13;15.25;1378;25;3826.00;248
9543;23;621729305;9543;574;10921;11170;4.74;0.29;358.20;15.24;1378;25;3827.00;249
9545;23;621729325;9545;584;10923;11170;4.72;0.29;358.25;15.24;1378;25;3828.00;247
9548;23;621729349;9548;589;10923;11170;4.66;0.28;358.31;15.24;1375;25;3829.00;247
9550;23;621729372;9550;583;10924;11170;4.61;0.28;358.33;15.35;1374;25;3830.00;246
9552;23;621729396;9552;583;10928;11176;4.62;0.28;358.38;15.34;1376;25;3831.00;248
9554;23;621729418;9554;583;10928;11176;4.61;0.28;358.38;15.34;1374;25;3832.00;248
9555;23;621729439;9555;576;10928;11176;4.61;0.28;358.41;15.34;1373;25;3833.00;248
9558;23;621729455;9558;575;10931;11179;4.61;0.28;358.40;15.34;1373;25;3834.00;248
9561;23;621729472;9561;561;10931;11179;4.56;0.28;358.47;15.34;1370;25;3835.00;248
9564;23;621729488;9564;556;10931;11179;4.57;0.28;358.50;15.34;1367;25;3836.00;248
9565;23;621729503;9565;553;10931;11180;4.56;0.28;358.55;15.34;1366;25;3837.00;249
9568;23;621729519;9568;557;10932;11181;4.56;0.28;358.55;15.34;1364;25;3838.00;249
9569;23;621729535;9569;561;10932;11181;4.59;0.28;358.61;15.34;1363;25;3839.00;249
9570;23;621729552;9570;563;10950;11207;4.61;0.28;358.60;15.31;1380;25;3840.00;257
9573;23;621729570;9573;554;10950;11207;4.59;0.28;358.58;15.31;1377;25;3841.00;257
9581;23;621729585;9581;552;10951;11207;4.56;0.28;358.61;15.31;1370;25;3842.00;256
9582;23;621729601;9582;547;10953;11208;4.59;0.28;358.63;15.31;1371;25;3843.00;255
9587;23;621729617;9587;542;10953;11208;4.62;0.28;358.62;15.31;1366;25;3844.00;255
9590;23;621729632;9590;546;10958;11212;4.63;0.28;358.70;15.42;1368;25;3845.00;254
9592;23;621729651;9592;552;10960;11214;4.62;0.28;358.71;15.41;1368;25;3846.00;254
9595;23;621729667;9595;550;10963;11218;4.61;0.28;358.66;15.41;1368;25;3847.00;255
9599;23;621729683;9599;549;10964;11218;4.60;0.28;358.63;15.52;1365;25;3848.00;254
9600;23;621729698;9600;549;10964;11218;4.58;0.28;358.62;15.52;1364;25;3849.00;254
9601;23;621729714;9601;554;10964;11218;4.60;0.28;358.63;15.52;1363;25;3850.00;254
9604;23;621729728;9604;563;10964;11218;4.60;0.28;358.59;15.52;1360;25;3851.00;254
9609;23;621729744;9609;564;10974;11230;4.65;0.28;358.45;15.50;1365;25;3852.00;256
9610;23;621729761;9610;563;10975;11230;4.68;0.29;358.45;15.50;1365;25;3853.00;255
9612;23;621729777;9612;564;10975;11230;4.67;0.29;358.41;15.50;1363;25;3854.00;255
9616;23;621729791;9616;566;10975;11230;4.67;0.29;358.35;15.50;1359;25;3855.00;255
9617;23;621729808;9617;572;10975;11230;4.65;0.28;358.34;15.50;1358;25;3856.00;255
9618;23;621729823;9618;570;10977;11230;4.63;0.28;358.37;15.51;1359;25;3857.00;253
9622;23;621729838;9622;568;10977;11231;4.57;0.28;358.28;15.51;1355;25;3858.00;254
9624;23;621729854;9624;569;10977;11231;4.54;0.28;358.27;15.51;1353;25;3859.00;254
9626;23;621729870;9626;568;10983;11237;4.49;0.27;358.23;15.50;1357;25;3860.00;254
9628;23;621729885;9628;564;10983;11238;4.43;0.27;358.26;15.50;1355;25;3861.00;255
9629;23;621729900;9629;566;10984;11238;4.39;0.27;358.30;15.50;1355;25;3862.00;254
9631;23;621729915;9631;564;10986;11238;4.34;0.26;358.27;15.56;1355;25;3863.00;252
9634;23;621729929;9634;570;10989;11242;4.28;0.26;358.29;15.55;1355;25;3864.00;253
9635;23;621729945;9635;572;10990;11242;4.24;0.26;358.31;15.55;1355;25;3865.00;252
9637;23;621729959;9637;569;10990;11242;4.22;0.26;358.31;15.55;1353;25;3866.00;252
9640;23;621729975;9640;553;10991;11243;4.26;0.26;358.29;15.55;1351;25;3867.00;252
9640;23;621729991;9640;545;10994;11247;4.33;0.26;358.29;15.55;1354;25;3868.00;253
9642;23;621730006;9642;535;10994;11247;4.35;0.27;358.27;15.55;1352;25;3869.00;253
9643;23;621730023;9643;531;10999;11253;4.40;0.27;358.26;15.60;1356;25;3870.00;254
9644;23;621730038;9644;528;11000;11253;4.43;0.27;358.22;15.60;1356;25;3871.00;253
9645;23;621730054;9645;521;11001;11253;4.43;0.27;358.25;15.59;1356;25;3872.00;252
9646;23;621730069;9646;518;11002;11253;4.49;0.27;358.32;15.65;1356;25;3873.00;251
9648;23;621730084;9648;516;11006;11257;4.58;0.28;358.35;15.65;1358;25;3874.00;251
9651;23;621730107;9651;518;11009;11257;4.57;0.28;358.35;15.81;1358;25;3875.00;248
9651;24;621730132;9651;509;11009;11257;4.57;0.28;358.35;15.81;1358;26;3876.00;248
9651;24;621730157;9651;507;11011;11257;4.60;0.28;358.35;15.92;1360;26;3877.00;246
9651;24;621730176;9651;513;11011;11258;4.60;0.28;358.35;15.92;1360;26;3878.00;247
9653;24;621730192;9653;517;11012;11259;4.61;0.28;358.36;15.92;1359;26;3879.00;247
9656;24;621730208;9656;518;11013;11259;4.61;0.28;358.33;15.98;1357;26;3880.00;246
9656;24;621730231;9656;519;11014;11260;4.61;0.28;358.33;15.98;1358;26;3881.00;246
9657;24;621730247;9657;523;11015;11260;4.61;0.28;358.32;16.04;1358;26;3882.00;245
9657;24;621730263;9657;538;11015;11260;4.64;0.28;358.32;16.04;1358;26;3883.00;245
9660;24;621730278;9660;537;11017;11260;4.63;0.28;358.28;16.15;1357;26;3884.00;243
9660;24;621730295;9660;552;11018;11260;4.63;0.28;358.28;16.20;1358;26;3885.00;242
9661;24;621730310;9661;552;11019;11260;4.55;0.28;358.25;16.25;1358;26;3886.00;241
9661;24;621730326;9661;556;11019;11260;4.50;0.27;358.25;16.25;1358;26;3887.00;241
9661;24;621730341;9661;582;11091;11387;4.73;0.29;358.25;16.26;1430;26;3888.00;296
9662;24;621730366;9662;572;11094;11388;4.69;0.29;358.22;16.26;1432;26;3889.00;294
9665;24;621730381;9665;559;11104;11388;4.72;0.29;358.17;16.35;1439;26;3890.00;284
9669;24;621730395;9669;561;11108;11388;4.74;0.29;358.17;16.40;1439;26;3891.00;280
9671;24;621730410;9671;560;11114;11388;4.77;0.29;358.19;16.39;1443;26;3892.00;274
9673;24;621730424;9673;557;11115;11388;4.69;0.29;358.27;16.39;1442;26;3893.00;273
9673;24;621730439;9673;555;11118;11388;4.68;0.29;358.27;16.39;1445;26;3894.00;270
9675;25;621730453;9675;570;11122;11388;4.69;0.29;358.32;16.49;1447;27;3895.00;266
9679;25;621730480;9679;567;11124;11389;4.68;0.29;358.27;16.49;1445;27;3896.00;265
9680;25;621730495;9680;567;11128;11390;4.70;0.29;358.28;16.59;1448;27;3897.00;262
9680;25;621730509;9680;568;11129;11390;4.69;0.29;358.28;16.59;1449;27;3898.00;261
9684;25;621730524;9684;571;11133;11391;4.67;0.29;358.34;16.59;1449;27;3899.00;258
9685;25;621730542;9685;582;11141;11406;4.62;0.28;358.31;16.68;1456;27;3900.00;265
9687;25;621730563;9687;584;11143;11406;4.62;0.28;358.27;16.68;1456;27;3901.00;263
9689;25;621730578;9689;591;11146;11406;4.57;0.28;358.33;16.73;1457;27;3902.00;260
9693;25;621730592;9693;601;11150;11410;4.52;0.28;358.32;16.73;1457;27;3903.00;260
9697;25;621730607;9697;600;11151;11410;4.49;0.28;358.32;16.78;1454;27;3904.00;259
9704;25;621730622;9704;605;11154;11410;4.42;0.27;358.34;16.78;1450;27;3905.00;256
9709;25;621730637;9709;616;11157;11413;4.34;0.27;358.44;16.78;1448;27;3906.00;256
9711;25;621730653;9711;620;11159;11413;4.28;0.26;358.46;16.78;1448;27;3907.00;254
9716;25;621730667;9716;634;11160;11413;4.21;0.26;358.63;16.78;1444;27;3908.00;253
9721;25;621730682;9721;638;11163;11417;4.16;0.26;358.69;16.77;1442;27;3909.00;254
9723;25;621730697;9723;616;11164;11418;4.16;0.26;358.67;16.77;1441;27;3910.00;254
9727;25;621730712;9727;607;11167;11418;4.16;0.26;358.78;16.77;1440;27;3911.00;251
9728;25;621730727;9728;599;11170;11422;4.22;0.26;358.76;16.77;1442;27;3912.00;252
9732;25;621730741;9732;595;11173;11422;4.23;0.26;358.95;16.77;1441;27;3913.00;249
9737;25;621730757;9737;593;11173;11422;4.26;0.26;359.10;16.77;1436;27;3914.00;249
9739;25;621730773;9739;586;11174;11424;4.34;0.27;359.15;16.77;1435;27;3915.00;250
9747;25;621730787;9747;585;11176;11424;4.40;0.27;359.35;16.77;1429;27;3916.00;248
9750;25;621730803;9750;576;11180;11430;4.46;0.27;359.48;16.76;1430;27;3917.00;250
9754;25;621730819;9754;563;11180;11430;4.54;0.28;359.56;16.76;1426;27;3918.00;250
9758;25;621730835;9758;560;11181;11431;4.56;0.28;359.59;16.76;1423;27;3919.00;250
9762;25;621730850;9762;558;11181;11431;4.61;0.28;359.73;16.76;1419;27;3920.00;250
9766;25;621730865;9766;544;11181;11431;4.66;0.28;359.95;16.76;1415;27;3921.00;250
9771;25;621730882;9771;535;11182;11431;4.67;0.28;360.22;16.76;1411;27;3922.00;249
9773;25;621730898;9773;529;11183;11431;4.73;0.29;360.29;16.76;1410;27;3923.00;248
9778;25;621730915;9778;525;11189;11443;4.80;0.29;360.46;16.75;1411;27;3924.00;254
9783;25;621730934;9783;512;11190;11443;4.82;0.29;360.49;16.75;1407;27;3925.00;253
9787;25;621730951;9787;496;11192;11443;4.87;0.30;360.50;16.75;1405;27;3926.00;251
9793;25;621730969;9793;493;11192;11443;4.89;0.30;360.59;16.75;1399;27;3927.00;251
9797;25;621730985;9797;494;11194;11443;4.90;0.30;360.69;16.75;1397;27;3928.00;249
9804;25;621731002;9804;489;11194;11443;4.85;0.29;360.73;16.75;1390;27;3929.00;249
9809;25;621731021;9809;491;11198;11447;4.85;0.29;360.96;16.75;1389;27;3930.00;249
9813;25;621731038;9813;492;11198;11447;4.83;0.29;360.98;16.75;1385;27;3931.00;249
9818;25;621731054;9818;483;11201;11451;4.84;0.29;361.10;16.74;1383;27;3932.00;250
9823;25;621731072;9823;487;11201;11452;4.83;0.29;361.27;16.74;1378;27;3933.00;251
9829;25;621731088;9829;481;11201;11452;4.79;0.29;361.34;16.74;1372;27;3934.00;251
9832;25;621731105;9832;482;11201;11452;4.78;0.29;361.50;16.74;1369;27;3935.00;251
9836;25;621731121;9836;486;11210;11465;4.74;0.29;361.57;16.73;1374;27;3936.00;255
9840;25;621731138;9840;489;11211;11465;4.76;0.29;361.54;16.73;1371;27;3937.00;254
9843;25;621731155;9843;483;11211;11465;4.78;0.29;361.67;16.73;1368;27;3938.00;254
9846;25;621731172;9846;484;11213;11466;4.79;0.29;361.72;16.73;1367;27;3939.00;253
9850;25;621731188;9850;488;11213;11467;4.79;0.29;361.90;16.73;1363;27;3940.00;254
9853;25;621731205;9853;497;11213;11467;4.83;0.30;361.98;16.73;1360;27;3941.00;254
9856;25;621731221;9856;497;11214;11470;4.87;0.30;361.98;16.72;1358;27;3942.00;256
9860;25;621731238;9860;495;11215;11470;4.89;0.30;361.99;16.72;1355;27;3943.00;255
9863;25;621731254;9863;498;11216;11470;4.92;0.30;362.00;16.72;1353;27;3944.00;254
9868;25;621731270;9868;492;11216;11470;4.87;0.30;362.03;16.72;1348;27;3945.00;254
9871;25;621731287;9871;492;11222;11476;4.84;0.29;362.10;16.72;1351;27;3946.00;254
9873;25;621731305;9873;487;11222;11476;4.78;0.29;362.15;16.72;1349;27;3947.00;254
9878;25;621731323;9878;495;11223;11476;4.74;0.29;362.27;16.72;1345;27;3948.00;253
9880;25;621731349;9880;503;11224;11476;4.71;0.29;362.27;16.72;1344;27;3949.00;252
9883;25;621731375;9883;492;11227;11480;4.69;0.28;362.30;16.71;1344;27;3950.00;253
9887;25;621731402;9887;487;11228;11481;4.66;0.28;362.37;16.71;1341;27;3951.00;253
9891;25;621731424;9891;488;11228;11481;4.61;0.28;362.39;16.71;1337;27;3952.00;253
9895;25;621731443;9895;492;11230;11482;4.61;0.28;362.40;16.71;1335;27;3953.00;252
9897;25;621731459;9897;491;11230;11482;4.55;0.28;362.37;16.71;1333;27;3954.00;252
9898;25;621731476;9898;488;11230;11482;4.50;0.27;362.41;16.71;1332;27;3955.00;252
9901;25;621731492;9901;498;11231;11482;4.42;0.27;362.38;16.71;1330;27;3956.00;251
9904;25;621731508;9904;488;11231;11482;4.36;0.27;362.35;16.71;1327;27;3957.00;251
9906;25;621731524;9906;489;11231;11482;4.31;0.26;362.35;16.71;1325;27;3958.00;251
9908;25;621731542;9908;486;11231;11482;4.31;0.26;362.45;16.71;1323;27;3959.00;251
9912;25;621731559;9912;511;11299;11607;4.41;0.27;362.51;16.61;1387;27;3960.00;308
9913;25;621731587;9913;506;11301;11608;4.42;0.27;362.60;16.61;1388;27;3961.00;307
9915;25;621731604;9915;499;11305;11608;4.48;0.28;362.67;16.60;1390;27;3962.00;303
9919;25;621731620;9919;492;11305;11608;4.51;0.28;362.65;16.60;1386;27;3963.00;303
9923;25;621731636;9923;497;11310;11608;4.55;0.28;362.63;16.60;1387;27;3964.00;298
9932;25;621731654;9932;498;11313;11608;4.55;0.28;362.92;16.59;1381;27;3965.00;295
9935;25;621731679;9935;493;11318;11608;4.62;0.28;362.99;16.59;1383;27;3966.00;290
9938;25;621731696;9938;493;11321;11608;4.67;0.29;363.02;16.58;1383;27;3967.00;287
9939;25;621731713;9939;501;11325;11609;4.67;0.29;363.04;16.58;1386;27;3968.00;284
9941;25;621731730;9941;507;11329;11610;4.64;0.29;363.12;16.58;1388;27;3969.00;281
9944;25;621731753;9944;509;11331;11610;4.60;0.28;363.08;16.58;1387;27;3970.00;279
9946;25;621731776;9946;516;11335;11614;4.57;0.28;363.05;16.57;1389;27;3971.00;279
9947;25;621731793;9947;513;11337;11614;4.57;0.28;363.08;16.57;1390;27;3972.00;277
9950;25;621731810;9950;514;11339;11614;4.55;0.28;363.13;16.57;1389;27;3973.00;275
9951;25;621731827;9951;522;11340;11614;4.50;0.28;363.13;16.57;1389;27;3974.00;274
9954;25;621731843;9954;542;11345;11620;4.43;0.27;363.23;16.56;1391;27;3975.00;275
9954;25;621731860;9954;545;11346;11620;4.40;0.27;363.23;16.56;1392;27;3976.00;274
9955;25;621731877;9955;555;11346;11620;4.41;0.27;363.23;16.56;1391;27;3977.00;274
9957;25;621731893;9957;554;11348;11623;4.43;0.27;363.24;16.56;1391;27;3978.00;275
9960;25;621731909;9960;555;11348;11623;4.40;0.27;363.31;16.56;1388;27;3979.00;275
9960;25;621731926;9960;557;11348;11623;4.36;0.27;363.31;16.56;1388;27;3980.00;275
9961;25;621731949;9961;566;11349;11624;4.35;0.27;363.36;16.56;1388;27;3981.00;275
9963;25;621731966;9963;567;11350;11625;4.36;0.27;363.40;16.56;1387;27;3982.00;275
9967;25;621731983;9967;560;11350;11625;4.36;0.27;363.51;16.56;1383;27;3983.00;275
9970;25;621732000;9970;561;11361;11638;4.40;0.27;363.51;16.54;1391;27;3984.00;277
9973;25;621732018;9973;557;11361;11638;4.42;0.27;363.54;16.54;1388;27;3985.00;277
9975;25;621732037;9975;558;11361;11638;4.45;0.27;363.55;16.54;1386;27;3986.00;277
9977;25;621732054;9977;553;11363;11639;4.51;0.28;363.59;16.66;1386;27;3987.00;276
9977;25;621732070;9977;550;11363;11639;4.55;0.28;363.59;16.66;1386;27;3988.00;276
9977;25;621732087;9977;552;11367;11643;4.60;0.28;363.59;16.65;1390;27;3989.00;276
9982;25;621732107;9982;553;11367;11643;4.54;0.28;363.55;16.65;1385;27;3990.00;276
9983;25;621732124;9983;551;11370;11647;4.54;0.28;363.52;16.65;1387;27;3991.00;277
9985;25;621732140;9985;562;11370;11647;4.51;0.27;363.49;16.65;1385;27;3992.00;277
9989;25;621732156;9989;570;11370;11647;4.43;0.27;363.45;16.65;1381;27;3993.00;277
9991;25;621732171;9991;580;11370;11647;4.38;0.27;363.40;16.65;1379;27;3994.00;277
9992;25;621732187;9992;575;11370;11647;4.36;0.27;363.37;16.65;1378;27;3995.00;277
9992;25;621732201;9992;573;11380;11659;4.38;0.27;363.37;16.63;1388;27;3996.00;279
9995;25;621732218;9995;578;11380;11659;4.33;0.26;363.36;16.63;1385;27;3997.00;279
9995;25;621732233;9995;573;11381;11659;4.34;0.27;363.36;16.63;1386;27;3998.00;278
9996;25;621732248;9996;573;11381;11659;4.37;0.27;363.46;16.63;1385;27;3999.00;278
9997;25;621732265;9997;572;11381;11659;4.40;0.27;363.45;16.63;1384;27;4000.00;278
9998;25;621732284;9998;562;11381;11659;4.41;0.27;363.42;16.63;1383;27;4001.00;278
9998;25;621732300;9998;563;11381;11660;4.40;0.27;363.42;16.63;1383;27;4002.00;279
10002;25;621732316;10002;561;11381;11660;4.39;0.27;363.51;16.63;1379;27;4003.00;279
10005;25;621732334;10005;555;11387;11666;4.43;0.27;363.54;16.74;1382;27;4004.00;279
10007;25;621732351;10007;552;11389;11668;4.46;0.27;363.51;16.73;1382;27;4005.00;279
10008;25;621732367;10008;551;11389;11668;4.50;0.28;363.47;16.73;1381;27;4006.00;279
10008;25;621732382;10008;552;11389;11668;4.52;0.28;363.47;16.73;1381;27;4007.00;279
10010;25;621732397;10010;565;11392;11672;4.53;0.28;363.48;16.73;1382;27;4008.00;280
10014;25;621732412;10014;564;11392;11672;4.51;0.28;363.45;16.73;1378;27;4009.00;280
10019;25;621732427;10019;562;11392;11672;4.42;0.27;363.45;16.73;1373;27;4010.00;280
10023;25;621732441;10023;574;11393;11673;4.36;0.27;363.44;16.73;1370;27;4011.00;280
10027;25;621732456;10027;567;11396;11677;4.29;0.26;363.37;16.72;1369;27;4012.00;281
10031;25;621732471;10031;568;11396;11677;4.22;0.26;363.37;16.72;1365;27;4013.00;281
10031;25;621732486;10031;560;11398;11680;4.24;0.26;363.37;16.72;1367;27;4014.00;282
10033;25;621732500;10033;562;11400;11680;4.23;0.26;363.41;16.78;1367;27;4015.00;280
10036;25;621732517;10036;555;11401;11680;4.25;0.26;363.38;16.84;1365;27;4016.00;279
10038;25;621732531;10038;560;11401;11680;4.26;0.26;363.38;16.84;1363;27;4017.00;279
10041;25;621732545;10041;563;11405;11684;4.32;0.26;363.39;16.83;1364;27;4018.00;279
10043;25;621732560;10043;550;11405;11684;4.36;0.27;363.36;16.83;1362;27;4019.00;279
10044;25;621732576;10044;545;11405;11684;4.41;0.27;363.41;16.83;1361;27;4020.00;279
10046;25;621732591;10046;535;11405;11684;4.51;0.28;363.43;16.83;1359;27;4021.00;279
10050;25;621732606;10050;529;11405;11685;4.53;0.28;363.37;16.83;1355;27;4022.00;280
10052;25;621732621;10052;526;11406;11686;4.56;0.28;363.42;16.83;1354;27;4023.00;280
10056;25;621732635;10056;521;11406;11686;4.56;0.28;363.46;16.83;1350;27;4024.00;280
10056;25;621732651;10056;516;11407;11687;4.60;0.28;363.46;16.83;1351;27;4025.00;280
10058;25;621732671;10058;515;11407;11687;4.58;0.28;363.45;16.83;1349;27;4026.00;280
10059;25;621732686;10059;515;11407;11687;4.57;0.28;363.45;16.83;1348;27;4027.00;280
10060;25;621732702;10060;516;11407;11687;4.60;0.28;363.47;16.83;1347;27;4028.00;280
10061;25;621732716;10061;521;11407;11687;4.65;0.28;363.53;16.83;1346;27;4029.00;280
10062;25;621732731;10062;524;11407;11687;4.68;0.28;363.54;16.83;1345;27;4030.00;280
10063;25;621732745;10063;521;11407;11687;4.71;0.29;363.53;16.83;1344;27;4031.00;280
10065;25;621732759;10065;536;11474;11814;4.98;0.31;363.60;16.73;1409;27;4032.00;340
10067;25;621732784;10067;530;11476;11815;4.96;0.30;363.55;16.73;1409;27;4033.00;339
10068;25;621732805;10068;522;11484;11815;5.04;0.31;363.58;16.72;1416;27;4034.00;331
10070;25;621732820;10070;515;11488;11815;5.09;0.31;363.62;16.78;1418;27;4035.00;327
10070;25;621732835;10070;509;11495;11815;5.13;0.32;363.62;16.83;1425;27;4036.00;320
10070;25;621732850;10070;515;11498;11815;5.13;0.32;363.62;16.83;1428;27;4037.00;317
10072;25;621732866;10072;506;11500;11815;5.11;0.31;363.61;16.83;1428;27;4038.00;315
10073;25;621732881;10073;513;11502;11815;5.09;0.31;363.59;16.82;1429;27;4039.00;313
10076;25;621732896;10076;515;11507;11816;5.06;0.31;363.65;16.94;1431;27;4040.00;309
10079;25;621732911;10079;523;11513;11817;5.08;0.31;363.76;16.99;1434;27;4041.00;304
10082;25;621732927;10082;520;11516;11817;5.08;0.31;363.78;16.99;1434;27;4042.00;301
10084;25;621732942;10084;525;11520;11818;5.01;0.31;363.74;17.10;1436;27;4043.00;298
10086;25;621732963;10086;518;11523;11818;4.97;0.30;363.74;17.10;1437;27;4044.00;295
10088;25;621732980;10088;514;11526;11818;4.93;0.30;363.89;17.10;1438;27;4045.00;292
10091;25;621732995;10091;517;11529;11818;4.90;0.30;363.98;17.21;1438;27;4046.00;289
10091;25;621733011;10091;521;11534;11822;4.92;0.30;363.98;17.21;1443;27;4047.00;288
10092;25;621733026;10092;528;11538;11822;4.87;0.30;364.08;17.33;1446;27;4048.00;284
10095;25;621733042;10095;539;11538;11822;4.83;0.30;364.03;17.33;1443;27;4049.00;284
10097;25;621733059;10097;548;11544;11828;4.81;0.30;364.11;17.37;1447;27;4050.00;284
10101;25;621733081;10101;552;11545;11828;4.79;0.29;364.12;17.43;1444;27;4051.00;283
10102;25;621733097;10102;555;11549;11828;4.79;0.29;364.13;17.48;1447;27;4052.00;279
10105;25;621733112;10105;559;11553;11832;4.74;0.29;364.23;17.54;1448;27;4053.00;279
10106;25;621733127;10106;561;11555;11833;4.71;0.29;364.22;17.60;1449;27;4054.00;278
10108;25;621733143;10108;565;11558;11833;4.73;0.29;364.22;17.65;1450;27;4055.00;275
10109;25;621733158;10109;572;11563;11837;4.76;0.29;364.21;17.76;1454;27;4056.00;274
10112;25;621733173;10112;571;11563;11837;4.74;0.29;364.29;17.76;1451;27;4057.00;274
10115;25;621733189;10115;573;11565;11837;4.72;0.29;364.34;17.87;1450;27;4058.00;272
10116;25;621733203;10116;570;11566;11838;4.72;0.29;364.32;17.87;1450;27;4059.00;272
10119;25;621733219;10119;572;11568;11838;4.71;0.29;364.32;17.98;1449;27;4060.00;270
10121;25;621733234;10121;569;11573;11844;4.75;0.29;364.37;17.98;1452;27;4061.00;271
10125;25;621733250;10125;562;11573;11844;4.75;0.29;364.49;17.98;1448;27;4062.00;271
10126;25;621733267;10126;554;11573;11845;4.74;0.29;364.46;17.98;1447;27;4063.00;272
10131;25;621733282;10131;558;11577;11845;4.72;0.29;364.66;18.20;1446;27;4064.00;268
10134;25;621733298;10134;560;11577;11845;4.73;0.29;364.75;18.20;1443;27;4065.00;268
10135;25;621733313;10135;551;11579;11845;4.75;0.29;364.88;18.30;1444;27;4066.00;266
10136;25;621733333;10136;557;11579;11845;4.78;0.29;364.96;18.30;1443;27;4067.00;266
10138;25;621733357;10138;550;11590;11857;4.81;0.29;365.05;18.29;1452;27;4068.00;267
10140;25;621733383;10140;542;11592;11857;4.84;0.29;365.15;18.39;1452;27;4069.00;265
10142;25;621733407;10142;549;11592;11857;4.83;0.29;365.23;18.39;1450;27;4070.00;265
10146;25;621733432;10146;549;11592;11857;4.81;0.29;365.34;18.39;1446;27;4071.00;265
10152;25;621733453;10152;550;11594;11857;4.73;0.29;365.58;18.49;1442;27;4072.00;263
10154;25;621733471;10154;558;11594;11857;4.68;0.28;365.67;18.49;1440;27;4073.00;263
10158;25;621733488;10158;558;11597;11861;4.62;0.28;365.73;18.49;1439;27;4074.00;264
10163;25;621733506;10163;570;11599;11861;4.58;0.28;365.79;18.59;1436;27;4075.00;262
10165;25;621733525;10165;570;11603;11865;4.54;0.28;365.88;18.59;1438;27;4076.00;262
10166;26;621733543;10166;571;11604;11866;4.48;0.27;365.86;18.59;1438;28;4077.00;262
10171;26;621733577;10171;576;11606;11866;4.39;0.27;365.86;18.69;1435;28;4078.00;260
10175;26;621733594;10175;578;11606;11866;4.35;0.26;365.81;18.69;1431;28;4079.00;260
10179;26;621733610;10179;586;11627;11895;4.35;0.26;365.88;18.66;1448;28;4080.00;268
10180;26;621733629;10180;573;11629;11895;4.38;0.27;365.86;18.65;1449;28;4081.00;266
10185;26;621733645;10185;575;11631;11895;4.36;0.27;365.94;18.65;1446;28;4082.00;264
10188;26;621733661;10188;577;11632;11896;4.36;0.27;365.90;18.65;1444;28;4083.00;264
10188;26;621733677;10188;573;11632;11897;4.38;0.27;365.90;18.65;1444;28;4084.00;265
10195;26;621733693;10195;568;11632;11897;4.38;0.27;365.94;18.65;1437;28;4085.00;265
10203;26;621733709;10203;564;11635;11900;4.38;0.27;366.03;18.64;1432;28;4086.00;265
10204;26;621733726;10204;563;11635;11900;4.41;0.27;366.05;18.64;1431;28;4087.00;265
10207;26;621733742;10207;560;11635;11900;4.38;0.27;366.14;18.64;1428;28;4088.00;265
10211;26;621733759;10211;558;11635;11900;4.40;0.27;366.20;18.64;1424;28;4089.00;265
10214;26;621733775;10214;559;11640;11906;4.45;0.27;366.32;18.64;1426;28;4090.00;266
10218;26;621733792;10218;548;11640;11906;4.50;0.27;366.41;18.64;1422;28;4091.00;266
10222;26;621733809;10222;547;11640;11906;4.54;0.28;366.56;18.64;1418;28;4092.00;266
10226;26;621733826;10226;544;11640;11906;4.57;0.28;366.68;18.64;1414;28;4093.00;266
10233;26;621733844;10233;539;11643;11910;4.57;0.28;366.84;18.63;1410;28;4094.00;267
10236;26;621733861;10236;535;11645;11912;4.61;0.28;366.84;18.63;1409;28;4095.00;267
10239;26;621733878;10239;533;11645;11912;4.60;0.28;366.91;18.63;1406;28;4096.00;267
10243;26;621733895;10243;540;11646;11913;4.64;0.28;367.01;18.63;1403;28;4097.00;267
10246;26;621733912;10246;542;11646;11913;4.68;0.29;367.03;18.63;1400;28;4098.00;267
10251;26;621733929;10251;547;11646;11913;4.67;0.28;367.03;18.63;1395;28;4099.00;267
10255;26;621733946;10255;551;11646;11913;4.63;0.28;367.00;18.63;1391;28;4100.00;267
10257;26;621733967;10257;554;11646;11913;4.60;0.28;367.00;18.63;1389;28;4101.00;267
10259;26;621733983;10259;557;11646;11913;4.58;0.28;367.04;18.63;1387;28;4102.00;267
10262;26;621734000;10262;558;11646;11913;4.53;0.28;367.03;18.63;1384;28;4103.00;267
10265;26;621734018;10265;572;11683;11983;4.51;0.27;367.03;18.57;1418;28;4104.00;300
10269;26;621734039;10269;574;11684;11984;4.47;0.27;367.10;18.57;1415;28;4105.00;300
10271;26;621734056;10271;567;11687;11984;4.47;0.27;367.13;18.56;1416;28;4106.00;297
10273;26;621734073;10273;571;11688;11984;4.47;0.27;367.17;18.56;1415;28;4107.00;296
10277;26;621734088;10277;582;11691;11984;4.42;0.27;367.22;18.56;1414;28;4108.00;293
10281;26;621734104;10281;582;11691;11984;4.35;0.27;367.30;18.56;1410;28;4109.00;293
10285;26;621734122;10285;586;11694;11984;4.30;0.26;367.42;18.55;1409;28;4110.00;290
10289;26;621734138;10289;590;11696;11984;4.24;0.26;367.36;18.55;1407;28;4111.00;288
10293;26;621734154;10293;593;11698;11985;4.20;0.25;367.34;18.55;1405;28;4112.00;287
10297;26;621734169;10297;596;11700;11986;4.15;0.25;367.31;18.55;1403;28;4113.00;286
10301;26;621734186;10301;599;11703;11986;4.12;0.25;367.35;18.55;1402;28;4114.00;283
10306;26;621734201;10306;605;11707;11990;4.10;0.25;367.33;18.54;1401;28;4115.00;283
10308;26;621734217;10308;607;11709;11990;4.11;0.25;367.32;18.54;1401;28;4116.00;281
10312;26;621734233;10312;609;11710;11990;4.12;0.25;367.42;18.54;1398;28;4117.00;280
10315;26;621734250;10315;608;11711;11990;4.13;0.25;367.61;18.54;1396;28;4118.00;279
10318;26;621734267;10318;599;11715;11996;4.15;0.25;367.81;18.53;1397;28;4119.00;281
10319;26;621734284;10319;609;11718;11996;4.19;0.26;367.81;18.53;1399;28;4120.00;278
10321;26;621734301;10321;607;11718;11996;4.21;0.26;367.84;18.53;1397;28;4121.00;278
10326;26;621734317;10326;605;11720;11999;4.20;0.26;367.91;18.53;1394;28;4122.00;279
10330;26;621734336;10330;606;11721;11999;4.19;0.26;367.85;18.53;1391;28;4123.00;278
10333;26;621734352;10333;609;11722;11999;4.17;0.25;367.92;18.53;1389;28;4124.00;277
10335;26;621734367;10335;614;11724;12000;4.16;0.25;368.03;18.53;1389;28;4125.00;276
10339;26;621734382;10339;619;11726;12001;4.14;0.25;368.11;18.52;1387;28;4126.00;275
10344;26;621734397;10344;618;11726;12001;4.10;0.25;368.20;18.52;1382;28;4127.00;275
10347;26;621734412;10347;619;11737;12014;4.14;0.25;368.26;18.51;1390;28;4128.00;277
10349;26;621734428;10349;613;11737;12014;4.15;0.25;368.33;18.51;1388;28;4129.00;277
10354;26;621734443;10354;611;11737;12014;4.16;0.25;368.43;18.51;1383;28;4130.00;277
10356;26;621734459;10356;615;11738;12015;4.20;0.26;368.45;18.51;1382;28;4131.00;277
10359;26;621734474;10359;614;11738;12015;4.17;0.25;368.60;18.51;1379;28;4132.00;277
10362;26;621734488;10362;614;11742;12019;4.17;0.25;368.63;18.50;1380;28;4133.00;277
10366;26;621734504;10366;609;11742;12019;4.15;0.25;368.78;18.50;1376;28;4134.00;277
10368;26;621734519;10368;627;11745;12023;4.13;0.25;368.77;18.49;1377;28;4135.00;278
10368;26;621734533;10368;620;11745;12023;4.16;0.25;368.77;18.49;1377;28;4136.00;278
10370;26;621734548;10370;605;11745;12023;4.16;0.25;368.80;18.49;1375;28;4137.00;278
10370;26;621734563;10370;596;11745;12023;4.20;0.26;368.80;18.49;1375;28;4138.00;278
10372;26;621734578;10372;590;11745;12023;4.19;0.26;368.78;18.49;1373;28;4139.00;278
10375;26;621734601;10375;584;11770;12057;4.28;0.26;368.85;18.46;1395;28;4140.00;287
10377;26;621734618;10377;587;11770;12057;4.29;0.26;368.89;18.46;1393;28;4141.00;287
10380;26;621734634;10380;587;11773;12057;4.33;0.26;368.85;18.45;1393;28;4142.00;284
10381;26;621734650;10381;596;11773;12057;4.34;0.27;368.90;18.45;1392;28;4143.00;284
10382;26;621734665;10382;586;11774;12057;4.37;0.27;368.91;18.45;1392;28;4144.00;283
10386;26;621734680;10386;591;11774;12057;4.38;0.27;368.89;18.45;1388;28;4145.00;283
10386;26;621734696;10386;592;11774;12058;4.41;0.27;368.89;18.45;1388;28;4146.00;284
10391;26;621734711;10391;587;11774;12058;4.39;0.27;368.92;18.45;1383;28;4147.00;284
10395;26;621734727;10395;585;11779;12064;4.43;0.27;369.01;18.44;1384;28;4148.00;285
10396;26;621734743;10396;587;11780;12065;4.46;0.27;368.99;18.44;1384;28;4149.00;285
10398;26;621734758;10398;583;11780;12065;4.46;0.27;368.99;18.44;1382;28;4150.00;285
10402;26;621734773;10402;589;11780;12065;4.45;0.27;369.06;18.44;1378;28;4151.00;285
10405;26;621734789;10405;582;11783;12069;4.46;0.27;369.16;18.44;1378;28;4152.00;286
10407;26;621734810;10407;579;11783;12069;4.42;0.27;369.16;18.44;1376;28;4153.00;286
10410;26;621734825;10410;581;11783;12069;4.37;0.27;369.19;18.44;1373;28;4154.00;286
10413;26;621734839;10413;580;11784;12070;4.33;0.26;369.25;18.43;1371;28;4155.00;286
10415;26;621734868;10415;581;11787;12074;4.27;0.26;369.18;18.43;1372;28;4156.00;287
10420;26;621734882;10420;586;11787;12074;4.19;0.25;369.25;18.43;1367;28;4157.00;287
10422;26;621734898;10422;590;11789;12077;4.21;0.26;369.21;18.43;1367;28;4158.00;288
10424;26;621734912;10424;595;11789;12077;4.14;0.25;369.21;18.43;1365;28;4159.00;288
10424;26;621734927;10424;602;11790;12077;4.15;0.25;369.21;18.43;1366;28;4160.00;287
10427;26;621734941;10427;602;11790;12077;4.09;0.25;369.16;18.43;1363;28;4161.00;287
10428;26;621734955;10428;601;11794;12081;4.12;0.25;369.14;18.42;1366;28;4162.00;287
10428;26;621734970;10428;601;11794;12081;4.15;0.25;369.14;18.42;1366;28;4163.00;287
10430;26;621734984;10430;606;11794;12081;4.12;0.25;369.16;18.42;1364;28;4164.00;287
10431;26;621734999;10431;604;11794;12081;4.12;0.25;369.18;18.42;1363;28;4165.00;287
10433;26;621735013;10433;601;11794;12082;4.09;0.25;369.15;18.42;1361;28;4166.00;288
10433;26;621735027;10433;602;11795;12083;4.11;0.25;369.15;18.42;1362;28;4167.00;288
10439;26;621735041;10439;609;11795;12083;4.03;0.25;369.07;18.42;1356;28;4168.00;288
10440;26;621735056;10440;616;11796;12084;4.00;0.24;369.06;18.42;1356;28;4169.00;288
10441;26;621735072;10441;611;11796;12084;3.98;0.24;369.07;18.42;1355;28;4170.00;288
10441;26;621735086;10441;591;11796;12084;4.00;0.24;369.07;18.42;1355;28;4171.00;288
10441;26;621735101;10441;572;11796;12084;4.05;0.25;369.07;18.42;1355;28;4172.00;288
10445;26;621735115;10445;555;11798;12086;4.08;0.25;369.05;18.41;1353;28;4173.00;288
10447;26;621735130;10447;541;11798;12086;4.15;0.25;369.01;18.41;1351;28;4174.00;288
10448;26;621735145;10448;527;11798;12086;4.23;0.26;369.01;18.41;1350;28;4175.00;288
10450;26;621735161;10450;539;11865;12213;4.43;0.27;369.03;18.31;1415;28;4176.00;348
10453;26;621735185;10453;517;11866;12214;4.50;0.28;369.04;18.31;1413;28;4177.00;348
10455;26;621735206;10455;505;11872;12214;4.63;0.28;369.02;18.30;1417;28;4178.00;342
10455;26;621735221;10455;488;11877;12214;4.76;0.29;369.02;18.29;1422;28;4179.00;337
10456;26;621735236;10456;482;11880;12214;4.81;0.30;368.99;18.29;1424;28;4180.00;334
10458;26;621735252;10458;485;11883;12214;4.85;0.30;368.95;18.29;1425;28;4181.00;331
10460;26;621735267;10460;477;11888;12214;4.87;0.30;368.94;18.28;1428;28;4182.00;326
10460;26;621735282;10460;469;11892;12214;4.89;0.30;368.94;18.28;1432;28;4183.00;322
10462;26;621735297;10462;466;11894;12215;4.88;0.30;368.97;18.28;1432;28;4184.00;321
10463;26;621735313;10463;466;11900;12217;4.90;0.30;368.99;18.39;1437;28;4185.00;317
10465;26;621735336;10465;464;11901;12217;4.94;0.30;368.98;18.39;1436;28;4186.00;316
10466;26;621735361;10466;458;11904;12218;4.99;0.31;369.00;18.39;1438;28;4187.00;314
10471;26;621735388;10471;454;11905;12218;5.00;0.31;369.03;18.39;1434;28;4188.00;313
10473;26;621735412;10473;453;11908;12218;5.02;0.31;369.03;18.39;1435;28;4189.00;310
10473;26;621735436;10473;459;11909;12218;5.03;0.31;369.03;18.39;1436;28;4190.00;309
10476;26;621735455;10476;459;11913;12222;5.02;0.31;369.04;18.38;1437;28;4191.00;309
10477;26;621735474;10477;467;11914;12222;5.02;0.31;369.02;18.38;1437;28;4192.00;308
10479;26;621735491;10479;460;11915;12222;5.00;0.31;368.97;18.38;1436;28;4193.00;307
10480;26;621735508;10480;460;11917;12225;5.00;0.31;369.06;18.38;1437;28;4194.00;308
10485;26;621735526;10485;461;11918;12225;4.97;0.30;369.15;18.38;1433;28;4195.00;307
10487;26;621735543;10487;456;11919;12225;4.96;0.30;369.10;18.38;1432;28;4196.00;306
10491;26;621735560;10491;458;11923;12229;4.94;0.30;369.08;18.38;1432;28;4197.00;306
10493;26;621735577;10493;457;11925;12230;4.96;0.30;369.02;18.37;1432;28;4198.00;305
10497;26;621735594;10497;464;11926;12230;4.92;0.30;368.99;18.37;1429;28;4199.00;304
10501;26;621735612;10501;474;11936;12264;4.90;0.30;369.01;18.36;1435;28;4200.00;328
10504;26;621735637;10504;470;11941;12264;4.89;0.30;369.03;18.35;1437;28;4201.00;323
10504;26;621735654;10504;473;11942;12264;4.86;0.29;369.03;18.35;1438;28;4202.00;322
10507;26;621735671;10507;474;11945;12265;4.84;0.29;369.05;18.35;1438;28;4203.00;320
10508;26;621735695;10508;475;11945;12265;4.78;0.29;369.12;18.35;1437;28;4204.00;320
10509;26;621735712;10509;478;11949;12271;4.80;0.29;369.11;18.35;1440;28;4205.00;322
10510;26;621735729;10510;477;11952;12271;4.79;0.29;369.13;18.35;1442;28;4206.00;319
10511;26;621735746;10511;482;11953;12272;4.79;0.29;369.16;18.34;1442;28;4207.00;319
10511;26;621735763;10511;482;11954;12272;4.80;0.29;369.16;18.34;1443;28;4208.00;318
10513;26;621735780;10513;488;11954;12272;4.79;0.29;369.13;18.34;1441;28;4209.00;318
10514;26;621735797;10514;484;11955;12272;4.74;0.29;369.11;18.40;1441;28;4210.00;317
10516;26;621735814;10516;487;11957;12272;4.74;0.29;369.15;18.46;1441;28;4211.00;315
10517;26;621735831;10517;494;11969;12284;4.79;0.29;369.17;18.51;1452;28;4212.00;315
10518;26;621735848;10518;498;11969;12284;4.80;0.29;369.19;18.51;1451;28;4213.00;315
10519;26;621735865;10519;496;11973;12284;4.85;0.30;369.18;18.63;1454;28;4214.00;311
10524;26;621735882;10524;500;11973;12284;4.84;0.29;369.36;18.63;1449;28;4215.00;311
10525;26;621735899;10525;504;11974;12284;4.83;0.29;369.41;18.68;1449;28;4216.00;310
10527;26;621735915;10527;508;11976;12284;4.84;0.29;369.42;18.68;1449;28;4217.00;308
10529;26;621735932;10529;503;11980;12288;4.85;0.30;369.53;18.74;1451;28;4218.00;308
10530;26;621735950;10530;505;11981;12288;4.87;0.30;369.63;18.74;1451;28;4219.00;307
10531;26;621735967;10531;512;11985;12292;4.91;0.30;369.61;18.79;1454;28;4220.00;307
10535;26;621735984;10535;520;11989;12293;4.90;0.30;369.69;18.96;1454;28;4221.00;304
10540;26;621736001;10540;513;11989;12293;4.88;0.30;369.75;18.96;1449;28;4222.00;304
10541;26;621736018;10541;506;11991;12293;4.83;0.29;369.81;18.96;1450;28;4223.00;302
10546;26;621736034;10546;512;12002;12306;4.79;0.29;369.96;19.01;1456;28;4224.00;304
10550;26;621736052;10550;520;12002;12306;4.70;0.29;369.90;19.01;1452;28;4225.00;304
10554;26;621736069;10554;517;12005;12306;4.64;0.28;369.89;19.06;1451;28;4226.00;301
10555;26;621736085;10555;521;12006;12307;4.65;0.28;369.96;19.06;1451;28;4227.00;301
10556;26;621736103;10556;523;12008;12308;4.66;0.28;369.94;19.17;1452;28;4228.00;300
10557;26;621736120;10557;528;12009;12308;4.68;0.29;370.02;19.17;1452;28;4229.00;299
10563;26;621736141;10563;526;12016;12314;4.68;0.29;370.33;19.28;1453;28;4230.00;298
10565;26;621736158;10565;527;12016;12314;4.65;0.28;370.35;19.28;1451;28;4231.00;298
10569;26;621736176;10569;525;12017;12314;4.65;0.28;370.48;19.28;1448;28;4232.00;297
10571;26;621736194;10571;527;12017;12314;4.64;0.28;370.51;19.28;1446;28;4233.00;297
10575;26;621736211;10575;531;12026;12320;4.69;0.28;370.53;19.49;1451;28;4234.00;294
10578;26;621736229;10578;535;12027;12320;4.68;0.28;370.61;19.49;1449;28;4235.00;293
10579;26;621736246;10579;527;12029;12320;4.69;0.29;370.66;19.60;1450;28;4236.00;291
10583;26;621736263;10583;528;12029;12320;4.72;0.29;370.85;19.60;1446;28;4237.00;291
10586;26;621736280;10586;531;12033;12324;4.73;0.29;370.99;19.65;1447;28;4238.00;291
10587;26;621736297;10587;528;12035;12325;4.76;0.29;371.01;19.70;1448;28;4239.00;290
10589;26;621736314;10589;528;12036;12325;4.73;0.29;371.11;19.71;1447;28;4240.00;289
10596;26;621736333;10596;531;12037;12326;4.68;0.28;371.29;19.70;1441;28;4241.00;289
10597;26;621736349;10597;533;12039;12326;4.65;0.28;371.27;19.81;1442;28;4242.00;287
10600;26;621736366;10600;534;12039;12326;4.62;0.28;371.33;19.81;1439;28;4243.00;287
10604;26;621736382;10604;545;12041;12326;4.57;0.28;371.31;19.92;1437;28;4244.00;285
10607;26;621736397;10607;546;12042;12326;4.52;0.28;371.44;19.92;1435;28;4245.00;284
10612;26;621736414;10612;547;12042;12326;4.46;0.27;371.57;19.92;1430;28;4246.00;284
10616;26;621736430;10616;564;12044;12326;4.44;0.27;371.66;20.02;1428;28;4247.00;282
10618;26;621736444;10618;581;12085;12396;4.48;0.27;371.77;19.95;1467;28;4248.00;311
10622;26;621736465;10622;586;12087;12397;4.42;0.27;371.86;19.95;1465;28;4249.00;310
10627;26;621736481;10627;573;12093;12397;4.37;0.27;371.90;20.05;1466;28;4250.00;304
10630;26;621736496;10630;574;12097;12397;4.36;0.27;372.03;20.05;1467;28;4251.00;300
10633;26;621736511;10633;572;12099;12397;4.31;0.26;372.06;20.05;1466;28;4252.00;298
10636;26;621736526;10636;577;12104;12397;4.27;0.26;372.10;20.15;1468;28;4253.00;293
10640;26;621736542;10640;580;12106;12397;4.24;0.26;372.14;20.15;1466;28;4254.00;291
10643;26;621736557;10643;582;12109;12397;4.25;0.26;372.13;20.15;1466;28;4255.00;288
10650;26;621736572;10650;586;12113;12398;4.23;0.26;372.23;20.25;1463;28;4256.00;285
10651;26;621736588;10651;579;12113;12399;4.25;0.26;372.32;20.25;1462;28;4257.00;286
10655;26;621736603;10655;581;12114;12399;4.25;0.26;372.35;20.25;1459;28;4258.00;285
10659;26;621736619;10659;585;12116;12403;4.23;0.26;372.37;20.24;1457;28;4259.00;287
10662;26;621736636;10662;574;12117;12403;4.19;0.26;372.42;20.24;1455;28;4260.00;286
10664;26;621736652;10664;574;12117;12403;4.17;0.26;372.48;20.24;1453;28;4261.00;286
10667;26;621736667;10667;581;12117;12403;4.13;0.25;372.50;20.24;1450;28;4262.00;286
10673;26;621736682;10673;578;12121;12409;4.09;0.25;372.54;20.24;1448;28;4263.00;288
10678;26;621736699;10678;576;12121;12409;4.08;0.25;372.77;20.24;1443;28;4264.00;288
10683;26;621736714;10683;574;12121;12409;4.04;0.25;372.86;20.24;1438;28;4265.00;288
10690;26;621736729;10690;572;12122;12412;4.01;0.25;372.76;20.23;1432;28;4266.00;290
10692;26;621736745;10692;571;12122;12412;4.01;0.25;372.77;20.23;1430;28;4267.00;290
10695;26;621736760;10695;572;12122;12412;3.99;0.25;372.85;20.23;1427;28;4268.00;290
10699;26;621736775;10699;582;12123;12413;4.00;0.25;372.88;20.23;1424;28;4269.00;290
10702;26;621736790;10702;583;12124;12414;4.00;0.25;372.85;20.23;1422;28;4270.00;290
10706;26;621736806;10706;588;12125;12414;4.02;0.25;372.88;20.23;1419;28;4271.00;289
10714;26;621736821;10714;596;12135;12427;4.05;0.25;372.96;20.22;1421;28;4272.00;292
10716;26;621736838;10716;591;12135;12427;4.04;0.25;372.90;20.22;1419;28;4273.00;292
10721;26;621736853;10721;589;12135;12427;4.02;0.25;373.02;20.22;1414;28;4274.00;292
10722;26;621736869;10722;599;12136;12429;4.06;0.25;373.07;20.21;1414;28;4275.00;293
10725;26;621736884;10725;608;12137;12429;4.01;0.25;373.11;20.21;1412;28;4276.00;292
10729;26;621736899;10729;600;12141;12433;4.01;0.25;373.14;20.21;1412;28;4277.00;292
10733;26;621736915;10733;594;12141;12433;3.97;0.24;373.23;20.21;1408;28;4278.00;292
10736;26;621736929;10736;599;12144;12437;3.98;0.24;373.25;20.21;1408;28;4279.00;293
10743;26;621736945;10743;598;12144;12437;3.94;0.24;373.45;20.21;1401;28;4280.00;293
10746;26;621736960;10746;603;12144;12437;3.93;0.24;373.49;20.21;1398;28;4281.00;293
10750;26;621736975;10750;607;12145;12437;3.89;0.24;373.55;20.21;1395;28;4282.00;292
10760;26;621736990;10760;611;12145;12437;3.85;0.23;373.59;20.21;1385;28;4283.00;292
10760;26;621737005;10760;615;12155;12449;3.96;0.24;373.59;20.19;1395;28;4284.00;294
10764;26;621737020;10764;622;12156;12449;3.90;0.24;373.64;20.19;1392;28;4285.00;293
10768;26;621737034;10768;624;12156;12449;3.87;0.24;373.71;20.19;1388;28;4286.00;293
10769;26;621737049;10769;630;12157;12449;3.86;0.24;373.84;20.19;1388;28;4287.00;292
10774;26;621737064;10774;636;12158;12449;3.81;0.23;373.87;20.19;1384;28;4288.00;291
10777;26;621737078;10777;636;12160;12449;3.77;0.23;373.90;20.19;1383;28;4289.00;289
10780;26;621737095;10780;636;12160;12450;3.74;0.23;373.84;20.19;1380;28;4290.00;290
10783;26;621737109;10783;644;12161;12450;3.69;0.23;373.79;20.19;1378;28;4291.00;289
10783;26;621737123;10783;643;12166;12456;3.67;0.22;373.79;20.19;1383;28;4292.00;290
10784;26;621737137;10784;647;12167;12457;3.64;0.22;373.79;20.19;1383;28;4293.00;290
10788;26;621737151;10788;653;12168;12457;3.60;0.22;373.78;20.19;1380;28;4294.00;289
10789;26;621737165;10789;658;12169;12457;3.57;0.22;373.75;20.18;1380;28;4295.00;288
10792;26;621737179;10792;659;12172;12461;3.56;0.22;373.80;20.18;1380;28;4296.00;289
10794;26;621737193;10794;649;12172;12461;3.54;0.22;373.83;20.18;1378;28;4297.00;289
10799;26;621737207;10799;651;12173;12461;3.45;0.21;373.78;20.18;1374;28;4298.00;288
10799;26;621737222;10799;651;12174;12462;3.45;0.21;373.78;20.18;1375;28;4299.00;288
10800;26;621737236;10800;653;12177;12466;3.51;0.21;373.76;20.17;1377;28;4300.00;289
10802;26;621737255;10802;649;12177;12466;3.50;0.21;373.78;20.17;1375;28;4301.00;289
10806;26;621737269;10806;646;12181;12469;3.48;0.21;373.74;20.30;1375;28;4302.00;288
10809;26;621737285;10809;644;12181;12469;3.46;0.21;373.78;20.30;1372;28;4303.00;288
10811;26;621737299;10811;644;12181;12469;3.47;0.21;373.76;20.30;1370;28;4304.00;288
10811;26;621737314;10811;643;12181;12469;3.48;0.21;373.76;20.30;1370;28;4305.00;288
10813;26;621737338;10813;627;12185;12473;3.53;0.22;373.79;20.29;1372;28;4306.00;288
10818;26;621737372;10818;609;12185;12473;3.54;0.22;373.76;20.29;1367;28;4307.00;288
10821;26;621737395;10821;595;12185;12473;3.59;0.22;373.78;20.29;1364;28;4308.00;288
10826;26;621737417;10826;584;12185;12473;3.64;0.22;373.74;20.29;1359;28;4309.00;288
10826;26;621737440;10826;578;12185;12474;3.73;0.23;373.74;20.29;1359;28;4310.00;289
10828;26;621737458;10828;573;12186;12475;3.77;0.23;373.73;20.29;1358;28;4311.00;289
10829;26;621737485;10829;573;12186;12475;3.80;0.23;373.73;20.29;1357;28;4312.00;289
10832;26;621737501;10832;562;12187;12476;3.84;0.23;373.76;20.29;1355;28;4313.00;289
10832;26;621737519;10832;564;12187;12476;3.92;0.24;373.76;20.29;1355;28;4314.00;289
10833;26;621737534;10833;571;12187;12476;3.98;0.24;373.76;20.29;1354;28;4315.00;289
10833;26;621737551;10833;569;12187;12476;4.05;0.25;373.76;20.29;1354;28;4316.00;289
10834;26;621737567;10834;572;12187;12476;4.08;0.25;373.75;20.29;1353;28;4317.00;289
10835;26;621737583;10835;570;12187;12476;4.08;0.25;373.77;20.29;1352;28;4318.00;289
10839;26;621737598;10839;573;12187;12476;4.06;0.25;373.75;20.29;1348;28;4319.00;289
10842;26;621737615;10842;624;12303;12706;4.40;0.27;373.77;20.22;1461;28;4320.00;403
10843;26;621737651;10843;607;12307;12707;4.39;0.27;373.74;20.22;1464;28;4321.00;400
10844;26;621737668;10844;590;12318;12707;4.42;0.28;373.72;20.20;1474;28;4322.00;389
10844;26;621737684;10844;562;12324;12707;4.49;0.28;373.72;20.19;1480;28;4323.00;383
10845;26;621737708;10845;559;12332;12707;4.54;0.28;373.71;20.18;1487;28;4324.00;375
10845;26;621737724;10845;547;12336;12707;4.60;0.29;373.71;20.18;1491;28;4325.00;371
10845;26;621737741;10845;543;12343;12707;4.67;0.29;373.71;20.30;1498;28;4326.00;364
10846;26;621737758;10846;543;12348;12707;4.66;0.29;373.74;20.29;1502;28;4327.00;359
10846;26;621737775;10846;546;12353;12708;4.71;0.29;373.74;20.29;1507;28;4328.00;355
10848;26;621737793;10848;552;12357;12709;4.69;0.29;373.78;20.28;1509;28;4329.00;352
10851;26;621737823;10851;548;12359;12709;4.67;0.29;373.77;20.28;1508;28;4330.00;350
10851;26;621737841;10851;542;12363;12710;4.65;0.29;373.77;20.28;1512;28;4331.00;347
10852;27;621737859;10852;551;12364;12710;4.63;0.29;373.77;20.28;1512;29;4332.00;346
10852;27;621737892;10852;554;12366;12710;4.61;0.28;373.77;20.28;1514;29;4333.00;344
10854;27;621737909;10854;563;12369;12710;4.57;0.28;373.85;20.28;1515;29;4334.00;341
10854;27;621737928;10854;567;12370;12714;4.56;0.28;373.85;20.27;1516;29;4335.00;344
10855;27;621737946;10855;573;12371;12714;4.53;0.28;373.84;20.27;1516;29;4336.00;343
10857;27;621737964;10857;574;12371;12714;4.49;0.27;373.82;20.27;1514;29;4337.00;343
10859;27;621737985;10859;574;12373;12717;4.48;0.27;373.86;20.27;1514;29;4338.00;344
10859;27;621738004;10859;576;12373;12717;4.48;0.27;373.86;20.27;1514;29;4339.00;344
10859;27;621738023;10859;574;12374;12717;4.48;0.27;373.86;20.39;1515;29;4340.00;343
10860;27;621738041;10860;571;12377;12721;4.53;0.28;373.88;20.39;1517;29;4341.00;344
10861;27;621738059;10861;573;12379;12722;4.52;0.28;373.94;20.39;1518;29;4342.00;343
10862;27;621738078;10862;559;12380;12722;4.52;0.28;373.93;20.39;1518;29;4343.00;342
10865;27;621738097;10865;555;12382;12726;4.49;0.27;374.05;20.38;1517;29;4344.00;344
10868;27;621738116;10868;553;12382;12726;4.45;0.27;374.08;20.38;1514;29;4345.00;344
10871;27;621738134;10871;542;12384;12726;4.41;0.27;374.10;20.38;1513;29;4346.00;342
10875;27;621738154;10875;533;12384;12727;4.41;0.27;374.03;20.38;1509;29;4347.00;343
10877;27;621738172;10877;540;12385;12727;4.42;0.27;374.03;20.38;1508;29;4348.00;342
10881;27;621738189;10881;543;12388;12733;4.44;0.27;374.06;20.38;1507;29;4349.00;345
10884;27;621738211;10884;541;12390;12733;4.46;0.27;374.07;20.38;1506;29;4350.00;343
10886;27;621738231;10886;540;12390;12734;4.43;0.27;374.09;20.38;1504;29;4351.00;344
10888;27;621738250;10888;534;12391;12734;4.44;0.27;374.16;20.38;1503;29;4352.00;343
10890;27;621738268;10890;536;12395;12734;4.41;0.27;374.16;20.38;1505;29;4353.00;339
10892;27;621738287;10892;532;12396;12734;4.41;0.27;374.15;20.38;1504;29;4354.00;338
10893;27;621738305;10893;526;12398;12734;4.40;0.27;374.15;20.50;1505;29;4355.00;336
10895;27;621738328;10895;532;12407;12746;4.43;0.27;374.16;20.49;1512;29;4356.00;339
10896;27;621738362;10896;525;12409;12746;4.46;0.27;374.19;20.49;1513;29;4357.00;337
10900;27;621738382;10900;521;12410;12746;4.51;0.27;374.26;20.49;1510;29;4358.00;336
10903;27;621738400;10903;511;12412;12746;4.53;0.27;374.23;20.48;1509;29;4359.00;334
10906;27;621738418;10906;509;12412;12746;4.58;0.28;374.21;20.48;1506;29;4360.00;334
10907;27;621738438;10907;503;12412;12746;4.63;0.28;374.21;20.48;1505;29;4361.00;334
10910;27;621738457;10910;499;12415;12750;4.63;0.28;374.14;20.48;1505;29;4362.00;335
10911;27;621738476;10911;503;12415;12750;4.68;0.28;374.13;20.48;1504;29;4363.00;335
10914;27;621738493;10914;498;12418;12754;4.72;0.29;374.15;20.47;1504;29;4364.00;336
10918;27;621738510;10918;505;12420;12756;4.72;0.29;374.14;20.47;1502;29;4365.00;336
10920;27;621738527;10920;504;12421;12756;4.69;0.28;374.30;20.47;1501;29;4366.00;335
10922;27;621738544;10922;503;12421;12756;4.68;0.29;374.34;20.47;1499;29;4367.00;335
10925;27;621738560;10925;506;12432;12769;4.69;0.29;374.48;20.46;1507;29;4368.00;337
10927;27;621738578;10927;504;12433;12769;4.68;0.29;374.47;20.46;1506;29;4369.00;336
10930;27;621738594;10930;508;12433;12769;4.71;0.29;374.55;20.46;1503;29;4370.00;336
10932;27;621738611;10932;515;12435;12770;4.72;0.29;374.66;20.46;1503;29;4371.00;335
10934;27;621738627;10934;514;12437;12771;4.73;0.29;374.63;20.47;1503;29;4372.00;334
10935;27;621738644;10935;520;12438;12771;4.74;0.29;374.68;20.47;1503;29;4373.00;333
10937;27;621738660;10937;524;12441;12774;4.74;0.29;374.76;20.46;1504;29;4374.00;333
10940;27;621738677;10940;530;12441;12774;4.72;0.29;374.81;20.46;1501;29;4375.00;333
10941;27;621738693;10941;531;12442;12774;4.75;0.29;374.91;20.46;1501;29;4376.00;332
10944;27;621738709;10944;534;12443;12774;4.74;0.29;374.94;20.47;1499;29;4377.00;331
10945;27;621738726;10945;546;12448;12780;4.79;0.29;374.97;20.46;1503;29;4378.00;332
10946;27;621738743;10946;549;12448;12780;4.81;0.29;375.00;20.46;1502;29;4379.00;332
10952;27;621738760;10952;544;12449;12780;4.79;0.29;375.01;20.46;1497;29;4380.00;331
10955;28;621738776;10955;552;12449;12780;4.77;0.29;375.06;20.46;1494;30;4381.00;331
10958;28;621738799;10958;560;12453;12784;4.74;0.29;375.05;20.52;1495;30;4382.00;331
10959;28;621738816;10959;558;12455;12785;4.76;0.29;375.07;20.52;1496;30;4383.00;330
10963;28;621738842;10963;563;12455;12785;4.72;0.29;375.04;20.52;1492;30;4384.00;330
10966;28;621738859;10966;569;12457;12786;4.75;0.29;375.11;20.52;1491;30;4385.00;329
10971;28;621738876;10971;583;12457;12786;4.74;0.29;375.05;20.52;1486;30;4386.00;329
10976;28;621738893;10976;581;12458;12786;4.71;0.29;375.19;20.58;1482;30;4387.00;328
10978;28;621738910;10978;586;12460;12786;4.72;0.29;375.17;20.65;1482;30;4388.00;326
10981;28;621738926;10981;593;12461;12786;4.67;0.28;375.26;20.65;1480;30;4389.00;325
10984;28;621738943;10984;598;12464;12786;4.62;0.28;375.25;20.78;1480;30;4390.00;322
10986;28;621738960;10986;600;12465;12786;4.58;0.28;375.27;20.78;1479;30;4391.00;321
10987;28;621738977;10987;615;12502;12856;4.71;0.29;375.24;20.84;1515;30;4392.00;354
10989;28;621738999;10989;612;12505;12857;4.69;0.29;375.35;20.84;1516;30;4393.00;352
10990;28;621739016;10990;610;12512;12857;4.68;0.29;375.44;20.83;1522;30;4394.00;345
10993;28;621739032;10993;602;12517;12857;4.68;0.29;375.56;21.00;1524;30;4395.00;340
10995;28;621739048;10995;605;12520;12857;4.66;0.28;375.70;21.00;1525;30;4396.00;337
10997;28;621739069;10997;616;12525;12857;4.63;0.28;375.77;21.05;1528;30;4397.00;332
10999;28;621739085;10999;615;12529;12857;4.57;0.28;375.79;21.11;1530;30;4398.00;328
10999;28;621739107;10999;615;12531;12857;4.58;0.28;375.79;21.10;1532;30;4399.00;326
11002;28;621739124;11002;610;12538;12858;4.61;0.28;375.88;21.27;1536;30;4400.00;320
11005;28;621739144;11005;609;12539;12859;4.64;0.28;375.97;21.27;1534;30;4401.00;320
11006;28;621739161;11006;604;12540;12859;4.66;0.29;375.96;21.27;1534;30;4402.00;319
11011;28;621739178;11011;602;12544;12863;4.61;0.28;376.06;21.32;1533;30;4403.00;319
11014;28;621739194;11014;601;12545;12863;4.57;0.28;376.11;21.32;1531;30;4404.00;318
11016;28;621739211;11016;605;12545;12863;4.56;0.28;376.13;21.32;1529;30;4405.00;318
11019;28;621739229;11019;608;12548;12863;4.56;0.28;376.18;21.49;1529;30;4406.00;315
11023;28;621739245;11023;610;12553;12869;4.59;0.28;376.18;21.48;1530;30;4407.00;316
11029;28;621739262;11029;619;12553;12869;4.56;0.28;376.15;21.48;1524;30;4408.00;316
11031;28;621739279;11031;619;12554;12869;4.53;0.28;376.19;21.54;1523;30;4409.00;315
11032;28;621739303;11032;618;12557;12875;4.55;0.28;376.20;21.53;1525;30;4410.00;318
11036;28;621739320;11036;615;12558;12875;4.51;0.27;376.33;21.59;1522;30;4411.00;317
11040;28;621739342;11040;621;12560;12875;4.44;0.27;376.50;21.64;1520;30;4412.00;315
11041;28;621739367;11041;637;12561;12876;4.37;0.26;376.49;21.70;1520;30;4413.00;315
11046;28;621739393;11046;636;12563;12877;4.29;0.26;376.54;21.75;1517;30;4414.00;314
11051;28;621739417;11051;640;12563;12877;4.22;0.26;376.75;21.75;1512;30;4415.00;314
11054;28;621739444;11054;647;12574;12890;4.19;0.25;376.78;21.84;1520;30;4416.00;316
11060;28;621739462;11060;639;12575;12890;4.13;0.25;376.78;21.84;1515;30;4417.00;315
11063;28;621739481;11063;659;12575;12890;4.09;0.25;376.94;21.84;1512;30;4418.00;315
11065;28;621739498;11065;664;12575;12891;4.04;0.25;377.06;21.84;1510;30;4419.00;316
11069;28;621739516;11069;656;12575;12891;3.96;0.24;377.13;21.84;1506;30;4420.00;316
11070;28;621739533;11070;649;12578;12895;3.99;0.24;377.13;21.83;1508;30;4421.00;317
11072;28;621739551;11072;647;12578;12895;3.98;0.24;377.17;21.83;1506;30;4422.00;317
11075;28;621739568;11075;641;12580;12899;3.98;0.24;377.23;21.83;1505;30;4423.00;319
11079;28;621739585;11079;635;12580;12899;4.03;0.25;377.14;21.83;1501;30;4424.00;319
11086;28;621739603;11086;642;12581;12899;4.05;0.25;377.31;21.83;1495;30;4425.00;318
11089;28;621739620;11089;642;12582;12899;4.06;0.25;377.40;21.83;1493;30;4426.00;317
11091;28;621739636;11091;633;12582;12899;4.08;0.25;377.42;21.83;1491;30;4427.00;317
11093;28;621739653;11093;633;12592;12911;4.21;0.26;377.52;21.82;1499;30;4428.00;319
11097;28;621739671;11097;630;12592;12911;4.18;0.26;377.58;21.82;1495;30;4429.00;319
11100;28;621739688;11100;633;12592;12911;4.18;0.26;377.59;21.82;1492;30;4430.00;319
11102;28;621739704;11102;625;12594;12911;4.21;0.26;377.67;21.82;1492;30;4431.00;317
11109;28;621739721;11109;621;12594;12911;4.14;0.25;377.85;21.82;1485;30;4432.00;317
11113;28;621739738;11113;621;12594;12911;4.13;0.25;377.85;21.82;1481;30;4433.00;317
11113;28;621739755;11113;627;12594;12912;4.14;0.25;377.85;21.82;1481;30;4434.00;318
11117;28;621739772;11117;623;12594;12912;4.08;0.25;377.94;21.82;1477;30;4435.00;318
11121;28;621739789;11121;629;12598;12918;4.08;0.25;377.89;21.81;1477;30;4436.00;320
11127;28;621739806;11127;631;12598;12919;3.97;0.24;377.96;21.81;1471;30;4437.00;321
11132;28;621739823;11132;641;12598;12919;3.91;0.24;377.95;21.81;1466;30;4438.00;321
11136;28;621739843;11136;643;12598;12919;3.87;0.24;378.02;21.81;1462;30;4439.00;321
11142;28;621739862;11142;643;12602;12924;3.85;0.24;378.17;21.80;1460;30;4440.00;322
11148;28;621739880;11148;639;12602;12924;3.80;0.23;378.20;21.80;1454;30;4441.00;322
11152;28;621739898;11152;647;12602;12924;3.80;0.23;378.28;21.80;1450;30;4442.00;322
11154;28;621739913;11154;650;12604;12925;3.76;0.23;378.29;21.80;1450;30;4443.00;321
11160;28;621739931;11160;657;12607;12929;3.70;0.23;378.32;21.80;1447;30;4444.00;322
11161;28;621739948;11161;646;12607;12929;3.72;0.23;378.29;21.80;1446;30;4445.00;322
11163;28;621739964;11163;656;12609;12932;3.74;0.23;378.31;21.80;1446;30;4446.00;323
11165;28;621739981;11165;668;12609;12932;3.74;0.23;378.31;21.80;1444;30;4447.00;323
11166;28;621739997;11166;674;12609;12932;3.73;0.23;378.32;21.80;1443;30;4448.00;323
11173;28;621740013;11173;679;12610;12932;3.65;0.22;378.31;21.80;1437;30;4449.00;322
11177;28;621740030;11177;673;12613;12936;3.66;0.22;378.24;21.79;1436;30;4450.00;323
11182;28;621740046;11182;676;12613;12936;3.62;0.22;378.26;21.79;1431;30;4451.00;323
11189;28;621740062;11189;679;12614;12936;3.56;0.22;378.19;21.79;1425;30;4452.00;322
11193;28;621740078;11193;686;12615;12936;3.52;0.22;378.13;21.79;1422;30;4453.00;321
11197;28;621740093;11197;682;12615;12937;3.49;0.21;378.10;21.79;1418;30;4454.00;322
11202;28;621740109;11202;683;12617;12939;3.45;0.21;378.10;21.79;1415;30;4455.00;322
11203;28;621740125;11203;682;12619;12939;3.46;0.21;378.13;21.79;1416;30;4456.00;320
11207;28;621740140;11207;684;12620;12940;3.45;0.21;378.14;21.79;1413;30;4457.00;320
11212;28;621740155;11212;683;12621;12940;3.39;0.21;378.16;21.79;1409;30;4458.00;319
11213;28;621740170;11213;688;12622;12940;3.37;0.21;378.16;21.79;1409;30;4459.00;318
11220;28;621740185;11220;691;12623;12940;3.31;0.20;378.17;21.79;1403;30;4460.00;317
11223;28;621740202;11223;696;12624;12940;3.30;0.20;378.15;21.79;1401;30;4461.00;316
11226;28;621740218;11226;699;12624;12940;3.28;0.20;378.12;21.79;1398;30;4462.00;316
11229;28;621740236;11229;690;12624;12940;3.25;0.20;378.14;21.79;1395;30;4463.00;316
11231;28;621740252;11231;707;12693;13067;3.63;0.23;378.21;21.67;1462;30;4464.00;374
11237;28;621740279;11237;709;12696;13068;3.62;0.23;378.10;21.67;1459;30;4465.00;372
11239;28;621740298;11239;707;12704;13068;3.68;0.23;378.14;21.65;1465;30;4466.00;364
11241;28;621740315;11241;697;12706;13068;3.65;0.23;378.16;21.65;1465;30;4467.00;362
11244;28;621740331;11244;696;12713;13068;3.67;0.23;378.16;21.64;1469;30;4468.00;355
11244;28;621740350;11244;687;12716;13068;3.69;0.23;378.16;21.64;1472;30;4469.00;352
11246;28;621740368;11246;681;12720;13068;3.68;0.23;378.20;21.63;1474;30;4470.00;348
11246;28;621740384;11246;683;12721;13068;3.69;0.23;378.20;21.63;1475;30;4471.00;347
11247;28;621740399;11247;679;12723;13069;3.68;0.23;378.18;21.63;1476;30;4472.00;346
11248;28;621740415;11248;683;12727;13070;3.63;0.22;378.16;21.63;1479;30;4473.00;343
11250;28;621740429;11250;685;12729;13070;3.58;0.22;378.29;21.62;1479;30;4474.00;341
11250;28;621740445;11250;671;12731;13071;3.57;0.22;378.29;21.62;1481;30;4475.00;340
11250;28;621740460;11250;651;12733;13071;3.59;0.22;378.29;21.62;1483;30;4476.00;338
11251;28;621740476;11251;641;12735;13071;3.64;0.22;378.29;21.62;1484;30;4477.00;336
11251;28;621740491;11251;616;12736;13071;3.74;0.23;378.29;21.62;1485;30;4478.00;335
11253;28;621740513;11253;611;12741;13075;3.82;0.23;378.32;21.61;1488;30;4479.00;334
11253;28;621740535;11253;595;12741;13075;3.94;0.24;378.32;21.61;1488;30;4480.00;334
11254;28;621740552;11254;584;12742;13075;4.02;0.25;378.29;21.61;1488;30;4481.00;333
11255;28;621740580;11255;588;12743;13078;4.10;0.25;378.29;21.61;1488;30;4482.00;335
11255;28;621740598;11255;588;12743;13078;4.15;0.25;378.29;21.61;1488;30;4483.00;335
11255;28;621740614;11255;576;12745;13078;4.19;0.26;378.29;21.61;1490;30;4484.00;333
11255;28;621740631;11255;584;12750;13082;4.25;0.26;378.29;21.61;1495;30;4485.00;332
11258;28;621740649;11258;587;12751;13083;4.30;0.26;378.32;21.60;1493;30;4486.00;332
11262;28;621740665;11262;574;12752;13083;4.33;0.26;378.22;21.60;1490;30;4487.00;331
11264;28;621740682;11264;566;12756;13087;4.39;0.27;378.23;21.60;1492;30;4488.00;331
11265;28;621740700;11265;564;12757;13087;4.43;0.27;378.22;21.60;1492;30;4489.00;330
11267;28;621740718;11267;563;12758;13087;4.42;0.27;378.20;21.72;1491;30;4490.00;329
11268;28;621740736;11268;563;12759;13088;4.43;0.27;378.24;21.72;1491;30;4491.00;329
11268;28;621740759;11268;555;12760;13088;4.45;0.27;378.24;21.72;1492;30;4492.00;328
11268;28;621740776;11268;560;12764;13094;4.45;0.27;378.24;21.71;1496;30;4493.00;330
11269;28;621740793;11269;557;12765;13094;4.49;0.27;378.29;21.71;1496;30;4494.00;329
11272;28;621740809;11272;554;12766;13095;4.49;0.27;378.39;21.71;1494;30;4495.00;329
11274;28;621740826;11274;552;12766;13095;4.51;0.27;378.35;21.71;1492;30;4496.00;329
11278;28;621740843;11278;549;12766;13095;4.51;0.27;378.51;21.71;1488;30;4497.00;329
11279;28;621740859;11279;550;12766;13095;4.56;0.28;378.51;21.71;1487;30;4498.00;329
11283;28;621740884;11283;545;12766;13095;4.57;0.28;378.49;21.71;1483;30;4499.00;329
11284;28;621740909;11284;546;12792;13145;4.61;0.28;378.47;21.67;1508;30;4500.00;353
11289;28;621740934;11289;551;12793;13147;4.61;0.28;378.52;21.66;1504;30;4501.00;354
11292;28;621740952;11292;553;12796;13147;4.63;0.28;378.65;21.66;1504;30;4502.00;351
11293;28;621740969;11293;550;12796;13147;4.69;0.29;378.73;21.66;1503;30;4503.00;351
11294;28;621740986;11294;553;12798;13147;4.73;0.29;378.70;21.66;1504;30;4504.00;349
11297;28;621741002;11297;557;12799;13147;4.70;0.29;378.79;21.66;1502;30;4505.00;348
11298;28;621741020;11298;558;12802;13151;4.71;0.29;378.83;21.65;1504;30;4506.00;349
11299;28;621741036;11299;556;12804;13151;4.71;0.29;378.84;21.65;1505;30;4507.00;347
11301;28;621741052;11301;554;12807;13155;4.73;0.29;378.92;21.64;1506;30;4508.00;348
11305;28;621741070;11305;554;12808;13156;4.69;0.29;379.00;21.64;1503;30;4509.00;348
11306;28;621741093;11306;550;12809;13156;4.69;0.29;378.98;21.77;1503;30;4510.00;347
11310;28;621741109;11310;538;12810;13156;4.70;0.29;379.03;21.77;1500;30;4511.00;346
11313;28;621741126;11313;542;12821;13169;4.72;0.29;379.07;21.75;1508;30;4512.00;348
11317;28;621741144;11317;532;12821;13169;4.74;0.29;379.20;21.75;1504;30;4513.00;348
11319;28;621741162;11319;530;12821;13169;4.77;0.29;379.20;21.75;1502;30;4514.00;348
11322;28;621741178;11322;530;12822;13170;4.78;0.29;379.32;21.75;1500;30;4515.00;348
11324;28;621741196;11324;527;12822;13171;4.80;0.29;379.30;21.75;1498;30;4516.00;349
11328;28;621741213;11328;527;12823;13171;4.79;0.29;379.33;21.75;1495;30;4517.00;348
11333;28;621741237;11333;520;12827;13174;4.81;0.29;379.44;21.74;1494;30;4518.00;347
11335;28;621741256;11335;522;12827;13174;4.83;0.29;379.44;21.74;1492;30;4519.00;347
11340;28;621741273;11340;516;12827;13174;4.78;0.29;379.56;21.74;1487;30;4520.00;347
11340;28;621741290;11340;510;12827;13174;4.79;0.29;379.56;21.74;1487;30;4521.00;347
11343;28;621741307;11343;507;12831;13180;4.77;0.29;379.54;21.74;1488;30;4522.00;349
11346;28;621741324;11346;506;12833;13180;4.69;0.28;379.58;21.74;1487;30;4523.00;347
11349;28;621741346;11349;500;12833;13180;4.68;0.28;379.55;21.74;1484;30;4524.00;347
11353;28;621741372;11353;506;12833;13180;4.66;0.28;379.57;21.74;1480;30;4525.00;347
11354;28;621741399;11354;503;12836;13184;4.63;0.28;379.58;21.73;1482;30;4526.00;348
11354;28;621741424;11354;506;12837;13185;4.62;0.28;379.58;21.73;1483;30;4527.00;348
11358;28;621741449;11358;507;12838;13185;4.62;0.28;379.70;21.73;1480;30;4528.00;347
11361;28;621741469;11361;506;12841;13186;4.63;0.28;379.76;21.86;1480;30;4529.00;345
11361;28;621741491;11361;506;12841;13186;4.61;0.28;379.76;21.86;1480;30;4530.00;345
11364;28;621741510;11364;504;12841;13186;4.58;0.28;379.72;21.86;1477;30;4531.00;345
11367;28;621741528;11367;502;12841;13186;4.52;0.27;379.88;21.86;1474;30;4532.00;345
11369;28;621741547;11369;508;12842;13186;4.49;0.27;379.84;21.86;1473;30;4533.00;344
11371;28;621741565;11371;498;12842;13186;4.48;0.27;379.79;21.86;1471;30;4534.00;344
11373;28;621741583;11373;507;12843;13186;4.48;0.27;379.84;21.86;1470;30;4535.00;343
11374;28;621741600;11374;523;12880;13256;4.52;0.28;379.89;21.79;1506;30;4536.00;376
11375;28;621741622;11375;520;12882;13257;4.57;0.28;379.92;21.79;1507;30;4537.00;375
11381;28;621741641;11381;524;12888;13257;4.60;0.28;379.93;21.79;1507;30;4538.00;369
11381;28;621741660;11381;532;12893;13257;4.59;0.28;379.93;21.78;1512;30;4539.00;364
11383;28;621741678;11383;527;12896;13257;4.57;0.28;380.02;21.78;1513;30;4540.00;361
11384;28;621741696;11384;535;12899;13257;4.54;0.28;380.05;21.78;1515;30;4541.00;358
11386;28;621741714;11386;534;12902;13257;4.56;0.28;380.16;21.77;1516;30;4542.00;355
11386;28;621741732;11386;534;12904;13257;4.57;0.28;380.16;21.77;1518;30;4543.00;353
11393;28;621741749;11393;537;12907;13258;4.58;0.28;380.07;21.89;1514;30;4544.00;351
11395;28;621741767;11395;538;12908;13260;4.58;0.28;380.18;21.89;1513;30;4545.00;352
11400;28;621741786;11400;528;12910;13260;4.55;0.28;380.31;21.89;1510;30;4546.00;350
11404;28;621741803;11404;530;12913;13264;4.49;0.27;380.27;21.89;1509;30;4547.00;351
11407;28;621741821;11407;534;12913;13264;4.45;0.27;380.26;21.89;1506;30;4548.00;351
11410;28;621741838;11410;539;12913;13264;4.39;0.27;380.34;21.89;1503;30;4549.00;351
11411;28;621741855;11411;551;12913;13264;4.35;0.27;380.37;21.89;1502;30;4550.00;351
11415;28;621741874;11415;557;12917;13270;4.37;0.27;380.36;21.88;1502;30;4551.00;353
11418;28;621741895;11418;560;12917;13270;4.37;0.27;380.36;21.88;1499;30;4552.00;353
11418;28;621741912;11418;551;12917;13270;4.39;0.27;380.36;21.88;1499;30;4553.00;353
11422;28;621741929;11422;560;12918;13273;4.40;0.27;380.33;21.88;1496;30;4554.00;355
11423;28;621741947;11423;583;12918;13273;4.40;0.27;380.33;21.88;1495;30;4555.00;355
11425;28;621741964;11425;589;12918;13273;4.39;0.27;380.29;21.88;1493;30;4556.00;355
11426;28;621741982;11426;581;12918;13274;4.38;0.27;380.28;21.88;1492;30;4557.00;356
11427;28;621742000;11427;580;12919;13275;4.41;0.27;380.37;21.88;1492;30;4558.00;356
11428;28;621742017;11428;587;12919;13275;4.43;0.27;380.41;21.88;1491;30;4559.00;356
11432;28;621742036;11432;587;12934;13301;4.44;0.27;380.48;21.85;1502;30;4560.00;367
11435;28;621742055;11435;583;12935;13301;4.46;0.27;380.60;21.85;1500;30;4561.00;366
11436;28;621742072;11436;577;12938;13301;4.52;0.28;380.63;21.84;1502;30;4562.00;363
11438;28;621742089;11438;575;12939;13302;4.59;0.28;380.69;21.84;1501;30;4563.00;363
11442;28;621742107;11442;572;12939;13302;4.58;0.28;380.80;21.84;1497;30;4564.00;363
11445;28;621742124;11445;576;12942;13306;4.55;0.28;380.95;21.84;1497;30;4565.00;364
11445;28;621742143;11445;580;12942;13306;4.52;0.28;380.95;21.84;1497;30;4566.00;364
11449;28;621742159;11449;575;12945;13310;4.43;0.27;381.10;21.83;1496;30;4567.00;365
11451;28;621742176;11451;576;12945;13310;4.37;0.27;381.20;21.83;1494;30;4568.00;365
11455;28;621742192;11455;577;12945;13310;4.31;0.26;381.28;21.83;1490;30;4569.00;365
11456;28;621742209;11456;574;12945;13310;4.29;0.26;381.36;21.83;1489;30;4570.00;365
11457;28;621742226;11457;566;12945;13310;4.30;0.26;381.39;21.83;1488;30;4571.00;365
11460;28;621742242;11460;573;12953;13322;4.31;0.26;381.42;21.82;1493;30;4572.00;369
11463;28;621742260;11463;570;12953;13322;4.27;0.26;381.46;21.82;1490;30;4573.00;369
11466;28;621742276;11466;570;12955;13322;4.26;0.26;381.55;21.82;1489;30;4574.00;367
11467;28;621742292;11467;566;12955;13322;4.26;0.26;381.61;21.82;1488;30;4575.00;367
11468;28;621742309;11468;561;12955;13322;4.23;0.26;381.58;21.82;1487;30;4576.00;367
11471;28;621742327;11471;563;12955;13322;4.18;0.26;381.71;21.82;1484;30;4577.00;367
11475;28;621742344;11475;565;12955;13323;4.15;0.25;381.78;21.82;1480;30;4578.00;368
11476;28;621742361;11476;564;12955;13323;4.14;0.25;381.76;21.82;1479;30;4579.00;368
11481;28;621742383;11481;568;12959;13329;4.12;0.25;381.84;21.81;1478;30;4580.00;370
11483;28;621742404;11483;571;12959;13330;4.10;0.25;381.91;21.81;1476;30;4581.00;371
11485;28;621742419;11485;568;12959;13330;4.04;0.25;381.89;21.81;1474;30;4582.00;371
11489;28;621742433;11489;572;12959;13330;3.99;0.24;381.93;21.81;1470;30;4583.00;371
11497;28;621742448;11497;574;12962;13334;3.92;0.24;382.05;21.81;1465;30;4584.00;372
11499;28;621742464;11499;575;12962;13334;3.89;0.24;382.16;21.81;1463;30;4585.00;372
11502;28;621742478;11502;580;12962;13334;3.80;0.23;382.19;21.81;1460;30;4586.00;372
11508;28;621742491;11508;582;12963;13335;3.67;0.22;382.23;21.80;1455;30;4587.00;372
11511;28;621742506;11511;589;12965;13339;3.58;0.22;382.34;21.80;1454;30;4588.00;374
11515;28;621742519;11515;608;12966;13339;3.50;0.21;382.33;21.80;1451;30;4589.00;373
11518;28;621742535;11518;603;12969;13345;3.44;0.21;382.36;21.79;1451;30;4590.00;376
11522;28;621742549;11522;595;12969;13345;3.36;0.21;382.44;21.79;1447;30;4591.00;376
11524;28;621742563;11524;599;12969;13345;3.33;0.20;382.40;21.79;1445;30;4592.00;376
11529;28;621742577;11529;611;12969;13345;3.29;0.20;382.40;21.79;1440;30;4593.00;376
11530;28;621742590;11530;607;12973;13349;3.27;0.20;382.37;21.79;1443;30;4594.00;376
11532;28;621742604;11532;614;12973;13349;3.26;0.20;382.41;21.79;1441;30;4595.00;376
11536;28;621742618;11536;614;12973;13349;3.24;0.20;382.36;21.79;1437;30;4596.00;376
11539;28;621742631;11539;605;12973;13349;3.25;0.20;382.30;21.79;1434;30;4597.00;376
11541;28;621742646;11541;605;12973;13350;3.25;0.20;382.28;21.79;1432;30;4598.00;377
11542;28;621742660;11542;600;12973;13351;3.26;0.20;382.27;21.79;1431;30;4599.00;378
11548;28;621742674;11548;597;12973;13351;3.24;0.20;382.27;21.79;1425;30;4600.00;378
11550;28;621742692;11550;591;12974;13352;3.26;0.20;382.24;21.79;1424;30;4601.00;378
11553;28;621742706;11553;593;12974;13352;3.25;0.20;382.21;21.79;1421;30;4602.00;378
11555;28;621742720;11555;587;12974;13352;3.29;0.20;382.18;21.79;1419;30;4603.00;378
11561;28;621742734;11561;581;12974;13352;3.31;0.20;382.09;21.79;1413;30;4604.00;378
11563;28;621742748;11563;569;12974;13352;3.34;0.20;382.07;21.79;1411;30;4605.00;378
11567;28;621742762;11567;576;12974;13352;3.33;0.20;382.08;21.79;1407;30;4606.00;378
11569;28;621742777;11569;571;12974;13352;3.37;0.21;382.07;21.79;1405;30;4607.00;378
11573;28;621742793;11573;580;13029;13479;3.77;0.24;382.07;21.69;1456;30;4608.00;450
11576;28;621742816;11576;574;13034;13480;3.79;0.24;382.01;21.69;1458;30;4609.00;446
11580;28;621742831;11580;574;13038;13480;3.79;0.24;381.99;21.68;1458;30;4610.00;442
11585;28;621742846;11585;577;13041;13480;3.78;0.24;381.89;21.68;1456;30;4611.00;439
11587;28;621742861;11587;572;13045;13480;3.76;0.23;381.87;21.67;1458;30;4612.00;435
11590;28;621742876;11590;584;13046;13480;3.68;0.23;381.84;21.67;1456;30;4613.00;434
11593;28;621742897;11593;581;13049;13480;3.63;0.23;381.92;21.67;1456;30;4614.00;431
11597;28;621742912;11597;587;13049;13480;3.55;0.22;381.89;21.67;1452;30;4615.00;431
11598;28;621742928;11598;588;13052;13481;3.50;0.22;381.90;21.66;1454;30;4616.00;429
11602;28;621742942;11602;596;13054;13482;3.47;0.21;381.85;21.66;1452;30;4617.00;428
11604;28;621742957;11604;595;13055;13482;3.45;0.21;381.87;21.66;1451;30;4618.00;427
11607;28;621742973;11607;603;13059;13483;3.42;0.21;381.92;21.66;1452;30;4619.00;424
11609;28;621742989;11609;607;13062;13483;3.39;0.21;381.95;21.67;1453;30;4620.00;421
11612;28;621743004;11612;613;13064;13483;3.35;0.21;381.96;21.66;1452;30;4621.00;419
11613;28;621743019;11613;615;13068;13483;3.34;0.21;381.97;21.66;1455;30;4622.00;415
11620;28;621743033;11620;625;13070;13487;3.27;0.20;381.95;21.67;1450;30;4623.00;417
11622;28;621743049;11622;632;13073;13487;3.24;0.20;381.93;21.67;1451;30;4624.00;414
11625;28;621743063;11625;639;13073;13487;3.19;0.20;381.94;21.67;1448;30;4625.00;414
11627;28;621743078;11627;633;13076;13490;3.20;0.20;381.94;21.67;1449;30;4626.00;414
11629;28;621743092;11629;628;13079;13490;3.21;0.20;381.98;21.68;1450;30;4627.00;411
11629;28;621743107;11629;624;13081;13490;3.20;0.20;381.98;21.68;1452;30;4628.00;409
11631;28;621743122;11631;620;13085;13494;3.21;0.20;382.04;21.69;1454;30;4629.00;409
11636;28;621743137;11636;608;13086;13495;3.20;0.20;382.11;21.68;1450;30;4630.00;409
11639;28;621743152;11639;601;13089;13495;3.22;0.20;382.09;21.69;1450;30;4631.00;406
11641;28;621743167;11641;601;13092;13499;3.24;0.20;382.13;21.69;1451;30;4632.00;407
11643;28;621743182;11643;599;13094;13499;3.26;0.20;382.14;21.69;1451;30;4633.00;405
11645;28;621743197;11645;587;13094;13499;3.30;0.20;382.09;21.69;1449;30;4634.00;405
11646;28;621743212;11646;586;13096;13501;3.37;0.21;382.08;21.69;1450;30;4635.00;405
11649;28;621743229;11649;587;13098;13501;3.45;0.21;382.05;21.83;1449;30;4636.00;403
11650;28;621743244;11650;577;13102;13507;3.49;0.21;382.05;21.82;1452;30;4637.00;405
11652;29;621743261;11652;583;13103;13507;3.52;0.22;382.04;21.83;1451;31;4638.00;404
11653;29;621743298;11653;575;13105;13508;3.55;0.22;382.12;21.83;1452;31;4639.00;403
11656;29;621743314;11656;578;13105;13508;3.54;0.22;382.09;21.83;1449;31;4640.00;403
11658;29;621743330;11658;590;13107;13508;3.55;0.22;382.06;21.83;1449;31;4641.00;401
11661;29;621743351;11661;596;13107;13508;3.52;0.21;382.05;21.83;1446;31;4642.00;401
11661;29;621743377;11661;602;13108;13508;3.53;0.22;382.05;21.83;1447;31;4643.00;400
11664;29;621743402;11664;608;13118;13520;3.54;0.22;382.02;21.82;1454;31;4644.00;402
11667;29;621743428;11667;623;13118;13520;3.51;0.21;382.00;21.82;1451;31;4645.00;402
11668;29;621743450;11668;613;13120;13520;3.49;0.21;381.99;21.83;1452;31;4646.00;400
11670;29;621743469;11670;608;13120;13520;3.51;0.21;382.14;21.83;1450;31;4647.00;400
11671;29;621743486;11671;600;13121;13520;3.53;0.22;382.11;21.83;1450;31;4648.00;399
11672;29;621743516;11672;601;13122;13520;3.57;0.22;382.08;21.83;1450;31;4649.00;398
11675;29;621743536;11675;603;13127;13526;3.58;0.22;382.16;21.82;1452;31;4650.00;399
11676;29;621743555;11676;592;13128;13526;3.62;0.22;382.18;21.82;1452;31;4651.00;398
11678;29;621743574;11678;584;13132;13530;3.68;0.22;382.28;21.82;1454;31;4652.00;398
11680;29;621743592;11680;578;13133;13531;3.72;0.23;382.27;21.82;1453;31;4653.00;398
11683;29;621743611;11683;578;13134;13531;3.73;0.23;382.33;21.82;1451;31;4654.00;397
11685;29;621743629;11685;576;13135;13531;3.75;0.23;382.34;21.82;1450;31;4655.00;396
11688;29;621743648;11688;578;13145;13544;3.83;0.23;382.45;21.81;1457;31;4656.00;399
11689;29;621743667;11689;570;13147;13544;3.89;0.24;382.53;21.81;1458;32;4657.00;397
11689;29;621743696;11689;564;13147;13544;3.95;0.24;382.53;21.81;1458;32;4658.00;397
11691;29;621743715;11691;555;13149;13545;3.98;0.24;382.56;21.81;1458;32;4659.00;396
11695;29;621743732;11695;551;13150;13546;3.99;0.24;382.57;21.81;1455;32;4660.00;396
11695;29;621743751;11695;545;13150;13546;4.03;0.25;382.57;21.81;1455;32;4661.00;396
11696;29;621743768;11696;546;13153;13549;4.11;0.25;382.56;21.82;1457;32;4662.00;396
11700;29;621743786;11700;550;13154;13549;4.11;0.25;382.63;21.82;1454;32;4663.00;395
11703;29;621743805;11703;558;13154;13549;4.08;0.25;382.68;21.82;1451;32;4664.00;395
11706;29;621743823;11706;556;13154;13549;4.11;0.25;382.69;21.82;1448;32;4665.00;395
11708;29;621743842;11708;554;13159;13555;4.17;0.25;382.73;21.82;1451;32;4666.00;396
11709;29;621743860;11709;554;13160;13555;4.23;0.26;382.76;21.82;1451;32;4667.00;395
11710;29;621743881;11710;556;13160;13555;4.28;0.26;382.74;21.82;1450;32;4668.00;395
11713;29;621743899;11713;561;13161;13555;4.34;0.26;382.77;21.82;1448;32;4669.00;394
11717;29;621743916;11717;562;13165;13559;4.38;0.27;382.88;21.82;1448;32;4670.00;394
11720;29;621743934;11720;560;13166;13560;4.44;0.27;382.87;21.95;1446;32;4671.00;394
11720;29;621743951;11720;556;13168;13560;4.49;0.27;382.87;21.96;1448;32;4672.00;392
11722;29;621743968;11722;567;13169;13561;4.50;0.27;382.88;21.96;1447;32;4673.00;392
11723;29;621743985;11723;577;13169;13561;4.49;0.27;382.90;21.96;1446;32;4674.00;392
11725;29;621744002;11725;579;13169;13561;4.52;0.28;382.94;21.96;1444;32;4675.00;392
11727;29;621744019;11727;588;13172;13561;4.53;0.28;382.90;21.97;1445;32;4676.00;389
11731;29;621744036;11731;594;13173;13561;4.52;0.28;383.03;21.97;1442;32;4677.00;388
11733;29;621744054;11733;603;13174;13561;4.53;0.28;383.17;21.97;1441;32;4678.00;387
11735;29;621744072;11735;602;13178;13561;4.55;0.28;383.26;22.12;1443;33;4679.00;383
11737;29;621744104;11737;615;13247;13686;4.63;0.29;383.23;22.00;1510;33;4680.00;439
11742;29;621744132;11742;599;13248;13687;4.65;0.29;383.32;22.00;1506;33;4681.00;439
11745;29;621744150;11745;584;13252;13687;4.72;0.29;383.45;22.00;1507;33;4682.00;435
11750;29;621744169;11750;580;13255;13687;4.77;0.29;383.57;22.00;1505;33;4683.00;432
11752;29;621744187;11752;576;13257;13687;4.81;0.30;383.72;21.99;1505;33;4684.00;430
11755;29;621744205;11755;570;13258;13687;4.83;0.30;383.76;21.99;1503;33;4685.00;429
11761;29;621744223;11761;579;13262;13687;4.81;0.29;383.93;22.13;1501;33;4686.00;425
11764;29;621744241;11764;579;13263;13687;4.83;0.30;384.06;22.12;1499;33;4687.00;424
11766;29;621744259;11766;583;13267;13688;4.86;0.30;384.18;22.12;1501;33;4688.00;421
11767;29;621744276;11767;576;13269;13689;4.85;0.30;384.17;22.12;1502;33;4689.00;420
11770;29;621744293;11770;582;13271;13689;4.83;0.30;384.26;22.12;1501;33;4690.00;418
11773;29;621744313;11773;584;13275;13693;4.76;0.29;384.30;22.11;1502;33;4691.00;418
11774;29;621744334;11774;576;13277;13693;4.72;0.29;384.32;22.11;1503;33;4692.00;416
11777;29;621744360;11777;570;13279;13693;4.67;0.29;384.31;22.11;1502;34;4693.00;414
11780;29;621744389;11780;562;13279;13693;4.64;0.28;384.39;22.11;1499;34;4694.00;414
11783;29;621744408;11783;570;13284;13699;4.59;0.28;384.40;22.11;1501;34;4695.00;415
11785;29;621744426;11785;566;13284;13699;4.54;0.28;384.48;22.11;1499;34;4696.00;415
11786;29;621744444;11786;565;13285;13699;4.53;0.28;384.47;22.11;1499;34;4697.00;414
11788;29;621744462;11788;565;13286;13702;4.50;0.27;384.58;22.10;1498;34;4698.00;416
11792;29;621744479;11792;562;13288;13702;4.47;0.27;384.67;22.10;1496;34;4699.00;414
11794;29;621744497;11794;557;13288;13702;4.47;0.27;384.67;22.10;1494;34;4700.00;414
11800;29;621744518;11800;561;13288;13703;4.42;0.27;384.73;22.10;1488;34;4701.00;415
11804;29;621744534;11804;562;13289;13704;4.40;0.27;384.73;22.10;1485;34;4702.00;415
11807;29;621744551;11807;564;13289;13704;4.36;0.27;384.73;22.10;1482;34;4703.00;415
11811;29;621744568;11811;572;13298;13717;4.37;0.27;384.77;22.09;1487;34;4704.00;419
11812;29;621744585;11812;570;13299;13717;4.39;0.27;384.74;22.09;1487;34;4705.00;418
11814;29;621744602;11814;574;13299;13717;4.41;0.27;384.77;22.09;1485;34;4706.00;418
11817;29;621744619;11817;576;13300;13718;4.44;0.27;384.83;22.09;1483;34;4707.00;418
11820;29;621744636;11820;573;13301;13718;4.42;0.27;384.82;22.09;1481;34;4708.00;417
11822;29;621744652;11822;578;13303;13722;4.45;0.27;384.92;22.08;1481;34;4709.00;419
11825;29;621744671;11825;589;13304;13722;4.44;0.27;384.92;22.08;1479;34;4710.00;418
11828;29;621744687;11828;594;13308;13726;4.42;0.27;384.95;22.08;1480;34;4711.00;418
11830;29;621744704;11830;601;13308;13726;4.44;0.27;385.03;22.08;1478;34;4712.00;418
11833;29;621744721;11833;607;13309;13726;4.46;0.27;385.07;22.08;1476;34;4713.00;417
11836;29;621744737;11836;611;13311;13726;4.43;0.27;385.09;22.08;1475;34;4714.00;415
11839;29;621744754;11839;621;13312;13726;4.41;0.27;385.12;22.08;1473;34;4715.00;414
11843;29;621744770;11843;623;13321;13738;4.40;0.27;385.16;22.07;1478;34;4716.00;417
11845;29;621744787;11845;625;13321;13738;4.35;0.26;385.19;22.07;1476;34;4717.00;417
11847;29;621744803;11847;634;13322;13738;4.28;0.26;385.24;22.07;1475;34;4718.00;416
11849;29;621744819;11849;635;13322;13738;4.23;0.26;385.38;22.07;1473;34;4719.00;416
11851;29;621744834;11851;648;13322;13738;4.18;0.25;385.49;22.07;1471;34;4720.00;416
11852;29;621744850;11852;642;13322;13738;4.14;0.25;385.53;22.07;1470;34;4721.00;416
11855;29;621744865;11855;655;13322;13739;4.13;0.25;385.64;22.07;1467;34;4722.00;417
11858;29;621744881;11858;659;13322;13739;4.11;0.25;385.74;22.07;1464;34;4723.00;417
11860;29;621744896;11860;666;13326;13745;4.08;0.25;385.71;22.06;1466;34;4724.00;419
11861;29;621744912;11861;666;13327;13747;4.03;0.25;385.72;22.06;1466;34;4725.00;420
11862;29;621744927;11862;672;13327;13747;3.99;0.24;385.75;22.06;1465;34;4726.00;420
11864;29;621744943;11864;673;13327;13747;3.93;0.24;385.81;22.06;1463;34;4727.00;420
11867;29;621744957;11867;673;13330;13751;3.91;0.24;385.86;22.05;1463;34;4728.00;421
11869;29;621744973;11869;672;13330;13751;3.90;0.24;385.84;22.05;1461;34;4729.00;421
11871;29;621744988;11871;680;13330;13751;3.87;0.24;385.94;22.05;1459;34;4730.00;421
11876;29;621745003;11876;682;13331;13752;3.81;0.23;386.05;22.05;1455;34;4731.00;421
11880;29;621745017;11880;691;13334;13756;3.79;0.23;386.18;22.05;1454;34;4732.00;422
11886;29;621745033;11886;699;13334;13756;3.76;0.23;386.23;22.05;1448;34;4733.00;422
11890;29;621745048;11890;701;13335;13759;3.72;0.23;386.28;22.04;1445;34;4734.00;424
11891;29;621745063;11891;701;13335;13759;3.69;0.22;386.32;22.04;1444;34;4735.00;424
11895;29;621745077;11895;711;13335;13759;3.65;0.22;386.50;22.04;1440;34;4736.00;424
11897;29;621745092;11897;712;13335;13759;3.61;0.22;386.55;22.04;1438;34;4737.00;424
11899;29;621745107;11899;710;13338;13763;3.61;0.22;386.56;22.04;1439;34;4738.00;425
11901;29;621745122;11901;706;13338;13763;3.59;0.22;386.52;22.04;1437;34;4739.00;425
11902;29;621745138;11902;702;13338;13763;3.57;0.22;386.56;22.04;1436;34;4740.00;425
11902;29;621745153;11902;701;13338;13763;3.57;0.22;386.56;22.04;1436;34;4741.00;425
11903;29;621745167;11903;698;13338;13764;3.60;0.22;386.56;22.04;1435;34;4742.00;426
11905;29;621745182;11905;694;13338;13765;3.60;0.22;386.65;22.04;1433;34;4743.00;427
11908;29;621745196;11908;690;13338;13765;3.59;0.22;386.58;22.04;1430;34;4744.00;427
11909;29;621745210;11909;683;13339;13766;3.62;0.22;386.62;22.04;1430;34;4745.00;427
11911;29;621745225;11911;686;13339;13766;3.64;0.22;386.70;22.04;1428;34;4746.00;427
11915;29;621745239;11915;692;13339;13766;3.64;0.22;386.73;22.04;1424;34;4747.00;427
11917;29;621745254;11917;692;13339;13766;3.63;0.22;386.77;22.04;1422;34;4748.00;427
11917;29;621745268;11917;688;13339;13766;3.66;0.22;386.77;22.04;1422;34;4749.00;427
11920;29;621745282;11920;688;13339;13766;3.65;0.22;386.69;22.04;1419;34;4750.00;427
11922;29;621745295;11922;691;13339;13766;3.64;0.22;386.70;22.04;1417;34;4751.00;427
11928;29;621745309;11928;704;13399;13893;3.88;0.24;386.72;21.94;1471;34;4752.00;494
11934;29;621745333;11934;699;13401;13894;3.87;0.24;386.69;21.94;1467;34;4753.00;493
11936;29;621745355;11936;685;13406;13894;3.93;0.24;386.78;21.93;1470;34;4754.00;488
11937;29;621745379;11937;684;13409;13894;3.95;0.25;386.82;21.93;1472;34;4755.00;485
11937;29;621745400;11937;687;13412;13894;3.98;0.25;386.82;21.92;1475;34;4756.00;482
11940;29;621745422;11940;694;13417;13894;3.97;0.25;386.87;21.91;1477;34;4757.00;477
11941;29;621745444;11941;690;13418;13894;3.92;0.24;386.88;21.91;1477;34;4758.00;476
11944;29;621745462;11944;698;13420;13894;3.82;0.24;386.84;21.91;1476;34;4759.00;474
11945;29;621745485;11945;692;13423;13895;3.76;0.23;386.86;21.91;1478;34;4760.00;472
11949;29;621745502;11949;691;13424;13896;3.71;0.23;386.82;21.91;1475;34;4761.00;472
11951;29;621745518;11951;687;13425;13896;3.67;0.23;386.81;21.91;1474;34;4762.00;471
11956;29;621745534;11956;689;13426;13897;3.60;0.22;386.75;21.91;1470;34;4763.00;471
11959;29;621745550;11959;696;13427;13897;3.54;0.22;386.76;21.91;1468;34;4764.00;470
11960;29;621745567;11960;698;13428;13897;3.50;0.22;386.76;21.90;1468;34;4765.00;469
11964;29;621745582;11964;707;13429;13897;3.46;0.21;386.73;21.90;1465;34;4766.00;468
11967;29;621745597;11967;706;13432;13901;3.44;0.21;386.76;21.90;1465;34;4767.00;469
11971;29;621745614;11971;711;13433;13901;3.42;0.21;386.80;21.90;1462;34;4768.00;468
11974;29;621745630;11974;697;13434;13901;3.39;0.21;386.92;21.90;1460;34;4769.00;467
11975;29;621745648;11975;702;13437;13907;3.33;0.20;386.93;21.90;1462;34;4770.00;470
11977;29;621745670;11977;696;13438;13907;3.30;0.20;386.94;21.90;1461;34;4771.00;469
11979;29;621745686;11979;695;13439;13907;3.30;0.20;386.93;21.90;1460;34;4772.00;468
11982;29;621745702;11982;684;13443;13911;3.32;0.20;386.94;21.89;1461;34;4773.00;468
11985;29;621745719;11985;680;13444;13912;3.34;0.20;386.92;21.89;1459;34;4774.00;468
11988;29;621745734;11988;670;13445;13912;3.37;0.21;386.88;21.89;1457;34;4775.00;467
11990;29;621745752;11990;662;13447;13916;3.43;0.21;386.85;21.89;1457;34;4776.00;469
11992;29;621745775;11992;666;13448;13916;3.46;0.21;386.82;21.88;1456;34;4777.00;468
11994;29;621745791;11994;661;13449;13916;3.50;0.21;386.80;21.88;1455;34;4778.00;467
11998;29;621745807;11998;650;13449;13917;3.52;0.21;386.76;21.88;1451;34;4779.00;468
12001;29;621745823;12001;643;13449;13917;3.55;0.22;386.71;21.88;1448;34;4780.00;468
12004;29;621745839;12004;637;13453;13923;3.55;0.22;386.71;21.88;1449;34;4781.00;470
12006;29;621745856;12006;637;13453;13923;3.60;0.22;386.68;21.88;1447;34;4782.00;470
12008;29;621745872;12008;638;13453;13924;3.61;0.22;386.66;21.88;1445;34;4783.00;471
12011;29;621745889;12011;634;13453;13924;3.60;0.22;386.61;21.88;1442;34;4784.00;471
12013;29;621745906;12013;627;13453;13924;3.67;0.22;386.57;21.88;1440;34;4785.00;471
12017;29;621745930;12017;629;13453;13924;3.70;0.23;386.62;21.88;1436;34;4786.00;471
12019;29;621745947;12019;629;13453;13924;3.74;0.23;386.65;21.88;1434;34;4787.00;471
12023;29;621745963;12023;634;13461;13936;3.78;0.23;386.58;21.86;1438;34;4788.00;475
12026;29;621745987;12026;635;13461;13936;3.77;0.23;386.53;21.86;1435;34;4789.00;475
12027;29;621746010;12027;635;13462;13936;3.79;0.23;386.53;21.86;1435;34;4790.00;474
12029;29;621746026;12029;637;13462;13936;3.79;0.23;386.53;21.86;1433;34;4791.00;474
12032;29;621746042;12032;640;13463;13936;3.81;0.23;386.53;21.86;1431;34;4792.00;473
12033;29;621746059;12033;645;13463;13936;3.85;0.23;386.53;21.86;1430;34;4793.00;473
12036;29;621746075;12036;648;13464;13940;3.87;0.24;386.48;21.86;1428;34;4794.00;476
12039;29;621746092;12039;647;13465;13940;3.83;0.23;386.46;21.86;1426;34;4795.00;475
12040;29;621746108;12040;651;13469;13944;3.87;0.24;386.48;21.99;1429;34;4796.00;475
12043;29;621746126;12043;649;13469;13945;3.86;0.23;386.49;21.99;1426;34;4797.00;476
12044;29;621746142;12044;647;13470;13945;3.91;0.24;386.50;21.99;1426;34;4798.00;475
12045;29;621746158;12045;651;13470;13945;3.96;0.24;386.50;21.99;1425;34;4799.00;475
12048;29;621746176;12048;648;13492;13986;4.11;0.25;386.52;21.96;1444;34;4800.00;494
12053;29;621746201;12053;644;13493;13986;4.12;0.25;386.60;21.96;1440;34;4801.00;493
12058;29;621746217;12058;640;13494;13986;4.16;0.25;386.57;21.95;1436;34;4802.00;492
12062;29;621746234;12062;639;13495;13987;4.21;0.26;386.55;21.95;1433;34;4803.00;492
12068;29;621746250;12068;636;13496;13988;4.22;0.26;386.54;21.95;1428;34;4804.00;492
12069;29;621746267;12069;643;13496;13988;4.27;0.26;386.54;21.95;1427;34;4805.00;492
12072;29;621746283;12072;653;13500;13991;4.27;0.26;386.62;21.95;1428;34;4806.00;491
12076;29;621746301;12076;637;13500;13991;4.27;0.26;386.78;21.95;1424;34;4807.00;491
12079;29;621746317;12079;631;13500;13991;4.25;0.26;386.83;21.95;1421;34;4808.00;491
12084;29;621746335;12084;632;13501;13991;4.24;0.26;387.02;21.94;1417;34;4809.00;490
12086;29;621746354;12086;627;13505;13997;4.22;0.26;387.07;21.94;1419;34;4810.00;492
12089;29;621746371;12089;623;13506;13997;4.22;0.26;387.04;21.94;1417;34;4811.00;491
12093;29;621746388;12093;616;13507;13997;4.20;0.26;387.16;21.94;1414;34;4812.00;490
12097;29;621746410;12097;616;13507;13997;4.27;0.26;387.30;21.94;1410;34;4813.00;490
12101;29;621746425;12101;613;13512;14001;4.26;0.26;387.34;22.08;1411;34;4814.00;489
12104;29;621746441;12104;610;13514;14003;4.30;0.26;387.42;22.08;1410;34;4815.00;489
12110;29;621746457;12110;594;13514;14003;4.34;0.27;387.44;22.08;1404;34;4816.00;489
12113;29;621746473;12113;586;13515;14004;4.40;0.27;387.57;22.08;1402;34;4817.00;489
12116;29;621746489;12116;573;13515;14004;4.44;0.27;387.63;22.08;1399;34;4818.00;489
12122;29;621746505;12122;570;13515;14004;4.47;0.27;387.64;22.08;1393;34;4819.00;489
12125;29;621746521;12125;557;13515;14004;4.52;0.28;387.75;22.08;1390;34;4820.00;489
12130;29;621746536;12130;549;13516;14004;4.55;0.28;387.92;22.08;1386;34;4821.00;488
12136;29;621746558;12136;554;13517;14004;4.53;0.28;387.98;22.22;1381;34;4822.00;487
12138;29;621746574;12138;545;13517;14004;4.58;0.28;387.98;22.22;1379;34;4823.00;487
12143;29;621746590;12143;570;13558;14074;4.61;0.28;388.18;22.15;1415;34;4824.00;516
12147;29;621746613;12147;558;13558;14075;4.63;0.28;388.29;22.15;1411;34;4825.00;517
12147;29;621746629;12147;559;13562;14075;4.68;0.29;388.29;22.15;1415;34;4826.00;513
12151;29;621746646;12151;555;13562;14075;4.70;0.29;388.40;22.15;1411;34;4827.00;513
12155;29;621746662;12155;548;13564;14077;4.72;0.29;388.45;22.15;1409;34;4828.00;513
12160;29;621746678;12160;540;13567;14077;4.69;0.29;388.53;22.31;1407;34;4829.00;510
12166;29;621746696;12166;537;13570;14077;4.71;0.29;388.62;22.30;1404;34;4830.00;507
12166;29;621746713;12166;541;13570;14077;4.76;0.29;388.62;22.30;1404;34;4831.00;507
12168;29;621746729;12168;545;13576;14078;4.78;0.29;388.76;22.45;1408;34;4832.00;502
12170;29;621746744;12170;545;13576;14079;4.77;0.29;388.83;22.45;1406;34;4833.00;503
12170;29;621746767;12170;551;13579;14079;4.79;0.29;388.83;22.46;1409;34;4834.00;500
12173;29;621746782;12173;566;13585;14083;4.76;0.29;388.92;22.46;1412;34;4835.00;498
12174;29;621746799;12174;571;13587;14083;4.74;0.29;388.92;22.47;1413;34;4836.00;496
12177;29;621746814;12177;572;13589;14083;4.72;0.29;388.94;22.49;1412;34;4837.00;494
12180;29;621746830;12180;574;13590;14083;4.69;0.29;388.91;22.49;1410;34;4838.00;493
12184;29;621746846;12184;568;13595;14089;4.66;0.28;389.04;22.49;1411;34;4839.00;494
12186;29;621746863;12186;576;13596;14089;4.62;0.28;389.10;22.63;1410;34;4840.00;493
12188;29;621746878;12188;582;13597;14089;4.61;0.28;389.10;22.64;1409;34;4841.00;492
12190;30;621746894;12190;584;13600;14092;4.58;0.28;389.18;22.79;1410;35;4842.00;492
12192;30;621746926;12192;582;13600;14092;4.56;0.28;389.15;22.79;1408;35;4843.00;492
12194;30;621746941;12194;587;13601;14092;4.57;0.28;389.17;22.80;1407;35;4844.00;491
12196;30;621746957;12196;583;13604;14093;4.55;0.28;389.20;22.95;1408;35;4845.00;489
12197;30;621746973;12197;581;13606;14094;4.56;0.28;389.24;22.96;1409;35;4846.00;488
12200;30;621746990;12200;590;13607;14094;4.57;0.28;389.25;23.10;1407;35;4847.00;487
12200;30;621747005;12200;601;13617;14107;4.63;0.28;389.25;23.09;1417;35;4848.00;490
12201;30;621747021;12201;595;13619;14107;4.63;0.28;389.25;23.23;1418;35;4849.00;488
12202;30;621747037;12202;590;13619;14107;4.65;0.28;389.25;23.23;1417;35;4850.00;488
12203;30;621747053;12203;579;13620;14108;4.67;0.28;389.28;23.24;1417;35;4851.00;488
12204;30;621747068;12204;576;13620;14108;4.62;0.28;389.26;23.24;1416;35;4852.00;488
12207;30;621747084;12207;578;13623;14112;4.64;0.28;389.34;23.24;1416;35;4853.00;489
12208;30;621747101;12208;579;13623;14112;4.65;0.28;389.36;23.24;1415;35;4854.00;489
12210;30;621747122;12210;571;13626;14116;4.60;0.28;389.38;23.24;1416;35;4855.00;490
12212;30;621747138;12212;568;13627;14116;4.60;0.28;389.35;23.24;1415;35;4856.00;489
12213;30;621747154;12213;564;13627;14116;4.61;0.28;389.38;23.24;1414;35;4857.00;489
12213;30;621747170;12213;567;13628;14116;4.60;0.28;389.38;23.25;1415;35;4858.00;488
12216;30;621747185;12216;558;13628;14116;4.60;0.28;389.45;23.25;1412;35;4859.00;488
12218;30;621747202;12218;557;13644;14150;4.67;0.29;389.61;23.22;1426;35;4860.00;506
12222;30;621747220;12222;549;13645;14150;4.64;0.29;389.67;23.23;1423;35;4861.00;505
12225;30;621747235;12225;546;13648;14150;4.64;0.29;389.75;23.22;1423;35;4862.00;502
12228;30;621747251;12228;541;13649;14150;4.66;0.29;389.89;23.22;1421;35;4863.00;501
12234;30;621747266;12234;545;13650;14150;4.66;0.29;389.99;23.22;1416;35;4864.00;500
12238;30;621747282;12238;533;13651;14150;4.68;0.29;390.11;23.36;1413;35;4865.00;499
12240;30;621747297;12240;539;13651;14151;4.70;0.29;390.14;23.36;1411;35;4866.00;500
12246;30;621747313;12246;535;13651;14151;4.66;0.29;390.25;23.36;1405;35;4867.00;500
12249;30;621747329;12249;538;13655;14157;4.67;0.29;390.33;23.48;1406;35;4868.00;502
12252;30;621747348;12252;541;13655;14158;4.62;0.28;390.39;23.48;1403;35;4869.00;503
12257;30;621747371;12257;542;13655;14158;4.56;0.28;390.49;23.48;1398;35;4870.00;503
12260;30;621747396;12260;545;13656;14158;4.50;0.28;390.59;23.49;1396;35;4871.00;502
12262;30;621747419;12262;544;13659;14162;4.49;0.27;390.64;23.49;1397;35;4872.00;503
12265;30;621747442;12265;548;13660;14162;4.47;0.27;390.77;23.48;1395;35;4873.00;502
12269;30;621747461;12269;547;13661;14162;4.45;0.27;390.87;23.48;1392;35;4874.00;501
12271;30;621747479;12271;541;13663;14163;4.47;0.27;390.86;23.62;1392;35;4875.00;500
12274;30;621747496;12274;545;13664;14167;4.46;0.27;390.88;23.61;1390;35;4876.00;503
12276;30;621747512;12276;546;13664;14167;4.47;0.27;390.87;23.61;1388;35;4877.00;503
12279;30;621747529;12279;545;13667;14170;4.48;0.27;390.92;23.61;1388;35;4878.00;503
12283;30;621747545;12283;539;13667;14170;4.45;0.27;391.07;23.61;1384;35;4879.00;503
12286;30;621747561;12286;547;13667;14170;4.42;0.27;391.06;23.61;1381;35;4880.00;503
12290;30;621747577;12290;550;13667;14170;4.40;0.27;391.11;23.61;1377;35;4881.00;503
12292;30;621747593;12292;559;13670;14174;4.44;0.27;391.12;23.61;1378;35;4882.00;504
12294;30;621747614;12294;552;13670;14174;4.41;0.27;391.20;23.61;1376;35;4883.00;504
12296;30;621747629;12296;553;13670;14174;4.40;0.27;391.25;23.61;1374;35;4884.00;504
12299;30;621747645;12299;556;13670;14174;4.39;0.27;391.29;23.61;1371;35;4885.00;504
12303;30;621747659;12303;562;13670;14175;4.36;0.27;391.43;23.61;1367;35;4886.00;505
12307;30;621747675;12307;566;13670;14176;4.31;0.26;391.60;23.61;1363;35;4887.00;506
12311;30;621747690;12311;570;13670;14176;4.28;0.26;391.61;23.61;1359;35;4888.00;506
12314;30;621747706;12314;569;13671;14177;4.29;0.26;391.65;23.61;1357;35;4889.00;506
12315;30;621747722;12315;575;13671;14177;4.29;0.26;391.69;23.61;1356;35;4890.00;506
12316;30;621747736;12316;576;13671;14177;4.26;0.26;391.69;23.61;1355;35;4891.00;506
12319;30;621747751;12319;586;13671;14177;4.25;0.26;391.78;23.61;1352;35;4892.00;506
12321;30;621747766;12321;589;13671;14177;4.24;0.26;391.76;23.61;1350;35;4893.00;506
12325;30;621747780;12325;587;13671;14177;4.24;0.26;391.81;23.61;1346;35;4894.00;506
12326;30;621747794;12326;590;13671;14177;4.21;0.26;391.83;23.61;1345;35;4895.00;506
12330;30;621747809;12330;614;13726;14304;4.49;0.28;391.94;23.51;1396;35;4896.00;578
12332;30;621747841;12332;614;13729;14305;4.47;0.28;391.90;23.51;1397;35;4897.00;576
12334;30;621747855;12334;618;13737;14305;4.49;0.28;391.88;23.49;1403;35;4898.00;568
12337;30;621747869;12337;617;13739;14305;4.44;0.28;391.82;23.49;1402;35;4899.00;566
12340;30;621747885;12340;618;13743;14305;4.42;0.27;391.83;23.48;1403;35;4900.00;562
12342;30;621747905;12342;624;13745;14305;4.36;0.27;391.80;23.48;1403;35;4901.00;560
12343;30;621747921;12343;625;13747;14305;4.35;0.27;391.79;23.48;1404;35;4902.00;558
12345;30;621747935;12345;626;13748;14305;4.36;0.27;391.87;23.48;1403;35;4903.00;557
12347;30;621747958;12347;634;13749;14306;4.36;0.27;391.82;23.48;1402;35;4904.00;557
12348;30;621747973;12348;635;13750;14308;4.37;0.27;391.89;23.48;1402;35;4905.00;558
12349;30;621747987;12349;635;13751;14308;4.38;0.27;391.87;23.47;1402;35;4906.00;557
12353;30;621748004;12353;630;13752;14309;4.32;0.27;391.84;23.47;1399;35;4907.00;557
12354;30;621748019;12354;641;13753;14309;4.30;0.27;391.80;23.47;1399;35;4908.00;556
12355;30;621748033;12355;637;13754;14309;4.30;0.27;391.78;23.47;1399;35;4909.00;555
12357;30;621748047;12357;636;13755;14309;4.25;0.26;391.73;23.47;1398;35;4910.00;554
12362;30;621748062;12362;634;13758;14313;4.22;0.26;391.79;23.47;1396;35;4911.00;555
12364;30;621748077;12364;634;13759;14313;4.15;0.26;391.74;23.47;1395;35;4912.00;554
12365;30;621748092;12365;642;13760;14313;4.12;0.25;391.72;23.47;1395;35;4913.00;553
12366;30;621748106;12366;640;13761;14316;4.06;0.25;391.69;23.47;1395;35;4914.00;555
12369;30;621748120;12369;648;13762;14316;4.02;0.25;391.64;23.47;1393;35;4915.00;554
12370;30;621748135;12370;649;13763;14316;4.00;0.25;391.62;23.47;1393;35;4916.00;553
12374;30;621748149;12374;645;13765;14320;3.97;0.24;391.61;23.46;1391;35;4917.00;555
12374;30;621748163;12374;643;13766;14321;3.94;0.24;391.61;23.46;1392;35;4918.00;555
12376;30;621748177;12376;648;13767;14321;3.92;0.24;391.62;23.46;1391;35;4919.00;554
12378;30;621748193;12378;644;13770;14326;3.90;0.24;391.56;23.46;1392;35;4920.00;556
12382;30;621748207;12382;653;13771;14326;3.85;0.23;391.53;23.45;1389;35;4921.00;555
12386;30;621748221;12386;654;13772;14326;3.78;0.23;391.59;23.45;1386;35;4922.00;554
12387;30;621748235;12387;659;13772;14327;3.73;0.23;391.57;23.45;1385;35;4923.00;555
12390;30;621748250;12390;654;13772;14327;3.64;0.22;391.57;23.45;1382;35;4924.00;555
12393;30;621748264;12393;656;13778;14333;3.57;0.22;391.52;23.45;1385;35;4925.00;555
12395;30;621748279;12395;652;13778;14333;3.46;0.21;391.49;23.45;1383;35;4926.00;555
12399;30;621748293;12399;663;13778;14334;3.34;0.20;391.43;23.45;1379;35;4927.00;556
12399;30;621748307;12399;666;13778;14334;3.25;0.20;391.43;23.45;1379;35;4928.00;556
12401;30;621748320;12401;669;13778;14334;3.15;0.19;391.38;23.45;1377;35;4929.00;556
12403;30;621748334;12403;656;13778;14334;3.09;0.19;391.41;23.45;1375;35;4930.00;556
12404;30;621748350;12404;644;13778;14334;3.09;0.19;391.41;23.45;1374;35;4931.00;556
12406;30;621748364;12406;633;13785;14346;3.19;0.19;391.42;23.44;1379;35;4932.00;561
12407;30;621748379;12407;625;13785;14346;3.23;0.20;391.40;23.44;1378;35;4933.00;561
12408;30;621748395;12408;616;13786;14346;3.31;0.20;391.39;23.44;1378;35;4934.00;560
12411;30;621748408;12411;611;13786;14346;3.39;0.21;391.39;23.44;1375;35;4935.00;560
12414;30;621748423;12414;604;13786;14346;3.46;0.21;391.40;23.44;1372;35;4936.00;560
12415;30;621748438;12415;590;13786;14346;3.55;0.22;391.39;23.44;1371;35;4937.00;560
12417;30;621748458;12417;578;13787;14350;3.62;0.22;391.36;23.44;1370;35;4938.00;563
12417;30;621748474;12417;561;13787;14350;3.71;0.23;391.36;23.44;1370;35;4939.00;563
12420;30;621748488;12420;565;13790;14354;3.77;0.23;391.38;23.43;1370;35;4940.00;564
12422;30;621748510;12422;554;13790;14355;3.80;0.23;391.38;23.43;1368;35;4941.00;565
12425;30;621748524;12425;551;13790;14355;3.81;0.23;391.32;23.43;1365;35;4942.00;565
12429;30;621748539;12429;542;13790;14355;3.81;0.23;391.29;23.43;1361;35;4943.00;565
12431;30;621748554;12431;533;13800;14368;3.93;0.24;391.32;23.42;1369;35;4944.00;568
12433;30;621748569;12433;524;13800;14368;3.94;0.24;391.30;23.42;1367;35;4945.00;568
12435;30;621748590;12435;530;13800;14368;3.98;0.24;391.31;23.42;1365;35;4946.00;568
12437;30;621748605;12437;524;13801;14369;4.06;0.25;391.29;23.41;1364;35;4947.00;568
12439;30;621748620;12439;509;13801;14370;4.11;0.25;391.29;23.41;1362;35;4948.00;569
12442;30;621748635;12442;495;13801;14370;4.12;0.25;391.28;23.41;1359;35;4949.00;569
12446;30;621748651;12446;491;13805;14379;4.15;0.25;391.25;23.41;1359;35;4950.00;574
12449;30;621748667;12449;477;13805;14379;4.18;0.25;391.22;23.41;1356;35;4951.00;574
12451;30;621748682;12451;476;13806;14379;4.18;0.25;391.22;23.41;1355;35;4952.00;573
12452;30;621748697;12452;474;13806;14379;4.23;0.26;391.19;23.41;1354;35;4953.00;573
12456;30;621748712;12456;458;13810;14385;4.29;0.26;391.16;23.40;1354;35;4954.00;575
12457;30;621748728;12457;455;13810;14385;4.32;0.26;391.16;23.40;1353;35;4955.00;575
12460;30;621748743;12460;454;13811;14385;4.38;0.27;391.17;23.40;1351;35;4956.00;574
12463;30;621748759;12463;445;13811;14385;4.43;0.27;391.18;23.40;1348;35;4957.00;574
12466;30;621748774;12466;439;13813;14389;4.45;0.27;391.20;23.40;1347;35;4958.00;576
12470;30;621748790;12470;438;13814;14390;4.46;0.27;391.30;23.41;1344;35;4959.00;576
12475;30;621748805;12475;438;13814;14390;4.47;0.27;391.42;23.41;1339;35;4960.00;576
12476;30;621748820;12476;440;13817;14391;4.55;0.28;391.42;23.42;1341;35;4961.00;574
12482;30;621748836;12482;444;13818;14391;4.54;0.28;391.35;23.43;1336;35;4962.00;573
12483;30;621748852;12483;442;13819;14391;4.59;0.28;391.35;23.44;1336;35;4963.00;572
12485;30;621748866;12485;447;13822;14391;4.63;0.28;391.35;23.46;1337;35;4964.00;569
12492;30;621748881;12492;447;13823;14391;4.58;0.28;391.47;23.48;1331;35;4965.00;568
12496;30;621748897;12496;454;13825;14391;4.58;0.28;391.50;23.49;1329;35;4966.00;566
12499;30;621748912;12499;455;13827;14391;4.59;0.28;391.59;23.51;1328;35;4967.00;564
12500;30;621748927;12500;467;13867;14461;4.67;0.28;391.60;23.46;1367;35;4968.00;594
12505;30;621748948;12505;462;13869;14462;4.71;0.29;391.62;23.46;1364;35;4969.00;593
12507;30;621748963;12507;463;13874;14462;4.75;0.29;391.66;23.47;1367;35;4970.00;588
12511;30;621748979;12511;456;13878;14462;4.73;0.29;391.73;23.49;1367;35;4971.00;584
12515;30;621748994;12515;457;13883;14462;4.72;0.29;391.76;23.52;1368;35;4972.00;579
12516;30;621749009;12516;465;13887;14462;4.68;0.29;391.75;23.53;1371;35;4973.00;575
12519;30;621749024;12519;464;13889;14462;4.63;0.28;391.75;23.55;1370;35;4974.00;573
12524;30;621749039;12524;466;13891;14462;4.56;0.28;391.85;23.68;1367;35;4975.00;571
12528;30;621749056;12528;459;13897;14463;4.48;0.27;391.95;23.71;1369;35;4976.00;566
12529;30;621749072;12529;455;13899;14464;4.45;0.27;392.03;23.74;1370;35;4977.00;565
12532;30;621749088;12532;457;13903;14464;4.42;0.27;392.15;23.74;1371;35;4978.00;561
12534;30;621749106;12534;466;13907;14468;4.43;0.27;392.22;23.76;1373;35;4979.00;561
12536;30;621749124;12536;464;13911;14468;4.45;0.27;392.31;23.79;1375;36;4980.00;557
12539;30;621749151;12539;466;13911;14468;4.48;0.27;392.37;23.79;1372;36;4981.00;557
12540;30;621749168;12540;461;13912;14468;4.55;0.28;392.43;23.80;1372;36;4982.00;556
12542;30;621749183;12542;459;13919;14474;4.55;0.28;392.48;23.81;1377;36;4983.00;555
12543;30;621749200;12543;465;13920;14474;4.56;0.28;392.48;23.82;1377;36;4984.00;554
12546;30;621749215;12546;473;13921;14474;4.55;0.28;392.58;23.83;1375;36;4985.00;553
12547;30;621749230;12547;468;13924;14477;4.53;0.27;392.62;23.85;1377;36;4986.00;553
12551;30;621749252;12551;475;13924;14477;4.52;0.27;392.70;23.85;1373;36;4987.00;553
12554;30;621749268;12554;466;13926;14477;4.52;0.27;392.80;23.88;1372;36;4988.00;551
12556;30;621749284;12556;464;13926;14478;4.54;0.28;392.81;23.88;1370;36;4989.00;552
12560;30;621749300;12560;463;13930;14479;4.54;0.28;392.95;24.04;1370;36;4990.00;549
12561;30;621749316;12561;471;13930;14479;4.57;0.28;392.95;24.04;1369;36;4991.00;549
12565;30;621749332;12565;485;13942;14492;4.60;0.28;393.00;24.04;1377;36;4992.00;550
12565;30;621749355;12565;489;13944;14492;4.59;0.28;393.00;24.06;1379;36;4993.00;548
12566;30;621749381;12566;488;13944;14492;4.62;0.28;393.04;24.06;1378;36;4994.00;548
12567;30;621749406;12567;496;13946;14494;4.63;0.28;393.07;24.07;1379;36;4995.00;548
12571;30;621749430;12571;501;13947;14494;4.62;0.28;393.27;24.08;1376;36;4996.00;547
12572;30;621749460;12572;496;13951;14498;4.66;0.28;393.29;24.09;1379;36;4997.00;547
12574;30;621749480;12574;494;13955;14498;4.65;0.28;393.30;24.29;1381;37;4998.00;543
12578;30;621749510;12578;496;13959;14502;4.60;0.28;393.32;24.42;1381;37;4999.00;543
12582;30;621749529;12582;493;13960;14502;4.55;0.28;393.37;24.43;1378;37;5000.00;542
12583;30;621749551;12583;496;13961;14502;4.58;0.28;393.44;24.44;1378;37;5001.00;541
12587;30;621749569;12587;495;13962;14502;4.59;0.28;393.52;24.45;1375;37;5002.00;540
12589;30;621749587;12589;491;13962;14502;4.57;0.28;393.49;24.45;1373;37;5003.00;540
12592;30;621749605;12592;489;13970;14514;4.59;0.28;393.52;24.44;1378;37;5004.00;544
12594;30;621749624;12594;490;13971;14514;4.60;0.28;393.70;24.45;1377;37;5005.00;543
12596;30;621749641;12596;488;13973;14514;4.63;0.28;393.74;24.46;1377;37;5006.00;541
12600;30;621749658;12600;482;13974;14514;4.63;0.28;393.81;24.47;1374;37;5007.00;540
12603;30;621749676;12603;489;13974;14514;4.63;0.28;393.81;24.47;1371;37;5008.00;540
12606;30;621749692;12606;493;13974;14514;4.64;0.28;393.83;24.47;1368;37;5009.00;540
12609;30;621749711;12609;490;13975;14515;4.63;0.28;393.86;24.48;1366;37;5010.00;540
12610;30;621749727;12610;489;13976;14515;4.60;0.28;393.87;24.49;1366;37;5011.00;539
12612;30;621749743;12612;491;13980;14521;4.62;0.28;393.91;24.48;1368;37;5012.00;541
12614;30;621749760;12614;490;13980;14522;4.64;0.28;393.97;24.48;1366;37;5013.00;542
12619;30;621749777;12619;495;13981;14522;4.60;0.28;393.97;24.49;1362;37;5014.00;541
12624;30;621749794;12624;494;13983;14522;4.53;0.27;394.00;24.64;1359;37;5015.00;539
12625;30;621749810;12625;494;13986;14526;4.56;0.28;394.03;24.63;1361;37;5016.00;540
12626;30;621749827;12626;504;13988;14526;4.60;0.28;394.07;24.65;1362;37;5017.00;538
12628;30;621749845;12628;498;13988;14526;4.57;0.28;394.14;24.65;1360;37;5018.00;538
12628;30;621749860;12628;500;13990;14527;4.65;0.28;394.14;24.66;1362;37;5019.00;537
12630;30;621749884;12630;497;13994;14531;4.64;0.28;394.19;24.66;1364;37;5020.00;537
12631;30;621749901;12631;494;13994;14531;4.63;0.28;394.17;24.66;1363;37;5021.00;537
12632;30;621749921;12632;486;13997;14534;4.60;0.28;394.19;24.68;1365;37;5022.00;537
12634;30;621749943;12634;479;13997;14534;4.56;0.28;394.21;24.68;1363;37;5023.00;537
12636;30;621749966;12636;477;13997;14534;4.53;0.28;394.20;24.68;1361;37;5024.00;537
12639;30;621749983;12639;479;13997;14534;4.47;0.27;394.21;24.68;1358;37;5025.00;537
12641;30;621749999;12641;486;14001;14538;4.49;0.27;394.27;24.69;1360;37;5026.00;537
12642;30;621750025;12642;479;14002;14538;4.49;0.27;394.27;24.82;1360;37;5027.00;536
12643;30;621750050;12643;487;14003;14538;4.51;0.27;394.31;24.83;1360;37;5028.00;535
12646;30;621750077;12646;482;14003;14538;4.52;0.28;394.36;24.83;1357;37;5029.00;535
12651;30;621750102;12651;475;14004;14539;4.50;0.27;394.38;24.84;1353;37;5030.00;535
12652;30;621750120;12652;474;14004;14540;4.51;0.27;394.40;24.84;1352;37;5031.00;536
12657;30;621750136;12657;471;14005;14540;4.45;0.27;394.54;24.85;1348;37;5032.00;535
12661;30;621750152;12661;468;14006;14541;4.47;0.27;394.55;24.84;1345;37;5033.00;535
12663;30;621750168;12663;471;14006;14541;4.49;0.27;394.52;24.84;1343;37;5034.00;535
12667;30;621750183;12667;471;14007;14541;4.45;0.27;394.64;24.85;1340;37;5035.00;534
12670;30;621750201;12670;471;14007;14541;4.40;0.27;394.69;24.85;1337;37;5036.00;534
12673;30;621750220;12673;472;14009;14541;4.37;0.27;394.81;24.99;1336;37;5037.00;532
12675;30;621750239;12675;476;14009;14541;4.33;0.26;394.78;24.99;1334;37;5038.00;532
12679;30;621750264;12679;481;14009;14541;4.32;0.26;394.90;24.99;1330;37;5039.00;532
12681;30;621750282;12681;514;14109;14771;4.61;0.29;394.95;24.82;1428;37;5040.00;662
12682;30;621750331;12682;510;14114;14772;4.60;0.29;394.96;24.83;1432;37;5041.00;658
12686;30;621750350;12686;510;14122;14772;4.61;0.29;395.04;24.82;1436;37;5042.00;650
12692;30;621750367;12692;513;14126;14772;4.60;0.29;395.11;24.81;1434;37;5043.00;646
12693;30;621750385;12693;515;14132;14772;4.63;0.29;395.11;24.80;1439;37;5044.00;640
12694;30;621750401;12694;515;14139;14772;4.62;0.29;395.13;24.92;1445;37;5045.00;633
12695;30;621750417;12695;519;14146;14772;4.59;0.29;395.11;24.91;1451;37;5046.00;626
12698;30;621750447;12698;529;14151;14772;4.57;0.28;395.15;24.91;1453;37;5047.00;621
12699;30;621750469;12699;534;14157;14773;4.55;0.28;395.16;24.90;1458;37;5048.00;616
12700;30;621750486;12700;535;14160;14774;4.57;0.28;395.14;24.90;1460;37;5049.00;614
12702;30;621750502;12702;543;14165;14774;4.59;0.29;395.15;24.89;1463;37;5050.00;609
12705;30;621750518;12705;541;14168;14775;4.55;0.28;395.16;24.89;1463;37;5051.00;607
12706;30;621750534;12706;552;14171;14775;4.52;0.28;395.19;24.89;1465;37;5052.00;604
12708;30;621750550;12708;554;14173;14775;4.47;0.28;395.18;24.88;1465;37;5053.00;602
12710;30;621750566;12710;565;14176;14775;4.40;0.27;395.13;24.88;1466;37;5054.00;599
12713;30;621750582;12713;571;14179;14779;4.35;0.27;395.15;24.88;1466;37;5055.00;600
12715;30;621750598;12715;584;14182;14779;4.31;0.27;395.20;24.97;1467;37;5056.00;597
12715;30;621750615;12715;590;14183;14779;4.25;0.26;395.20;24.97;1468;37;5057.00;596
12718;30;621750637;12718;603;14185;14782;4.18;0.26;395.18;24.97;1467;37;5058.00;597
12719;30;621750658;12719;616;14186;14782;4.12;0.25;395.17;24.97;1467;37;5059.00;596
12722;30;621750676;12722;623;14188;14782;4.04;0.25;395.17;25.06;1466;37;5060.00;594
12723;30;621750694;12723;630;14193;14786;4.00;0.25;395.20;25.05;1470;37;5061.00;593
12725;30;621750711;12725;640;14195;14787;3.95;0.24;395.26;25.05;1470;37;5062.00;592
12730;30;621750727;12730;652;14197;14787;3.89;0.24;395.18;25.14;1467;37;5063.00;590
12732;30;621750744;12732;655;14199;14791;3.87;0.24;395.19;25.14;1467;37;5064.00;592
12733;30;621750761;12733;662;14200;14791;3.82;0.24;395.16;25.14;1467;37;5065.00;591
12735;30;621750776;12735;673;14202;14791;3.79;0.23;395.14;25.14;1467;37;5066.00;589
12736;30;621750793;12736;672;14202;14792;3.76;0.23;395.11;25.14;1466;37;5067.00;590
12738;30;621750809;12738;682;14203;14792;3.71;0.23;395.10;25.14;1465;37;5068.00;589
12741;30;621750831;12741;691;14208;14798;3.73;0.23;395.09;25.13;1467;37;5069.00;590
12744;30;621750849;12744;697;14209;14798;3.69;0.23;395.03;25.13;1465;37;5070.00;589
12746;30;621750872;12746;704;14210;14799;3.62;0.22;394.97;25.13;1464;37;5071.00;589
12749;30;621750887;12749;707;14210;14799;3.59;0.22;395.02;25.13;1461;37;5072.00;589
12752;30;621750902;12752;711;14210;14799;3.57;0.22;394.96;25.13;1458;37;5073.00;589
12753;30;621750921;12753;712;14210;14799;3.53;0.22;394.97;25.13;1457;37;5074.00;589
12753;30;621750938;12753;719;14210;14799;3.50;0.21;394.97;25.13;1457;37;5075.00;589
12756;30;621750954;12756;728;14219;14811;3.49;0.21;394.92;25.11;1463;37;5076.00;592
12756;30;621750972;12756;738;14219;14811;3.47;0.21;394.92;25.11;1463;37;5077.00;592
12757;30;621750988;12757;736;14219;14811;3.43;0.21;394.92;25.11;1462;37;5078.00;592
12759;30;621751003;12759;738;14219;14811;3.39;0.21;395.01;25.11;1460;37;5079.00;592
12761;30;621751020;12761;730;14219;14811;3.34;0.21;394.98;25.11;1458;37;5080.00;592
12761;30;621751035;12761;731;14219;14811;3.33;0.20;394.98;25.11;1458;37;5081.00;592
12762;30;621751051;12762;729;14222;14815;3.32;0.20;394.98;25.11;1460;37;5082.00;593
12763;30;621751067;12763;716;14222;14815;3.32;0.20;394.98;25.11;1459;37;5083.00;593
12763;30;621751088;12763;712;14225;14819;3.40;0.21;394.98;25.10;1462;37;5084.00;594
12763;30;621751107;12763;708;14226;14821;3.44;0.21;394.98;25.10;1463;37;5085.00;595
12765;30;621751126;12765;706;14226;14821;3.47;0.21;394.96;25.10;1461;37;5086.00;595
12766;30;621751144;12766;699;14226;14821;3.52;0.22;394.95;25.10;1460;37;5087.00;595
12767;30;621751161;12767;693;14236;14834;3.63;0.22;394.96;25.08;1469;37;5088.00;598
12770;30;621751178;12770;688;14236;14834;3.67;0.23;394.93;25.08;1466;37;5089.00;598
12773;30;621751199;12773;678;14236;14834;3.73;0.23;394.95;25.08;1463;37;5090.00;598
12775;30;621751223;12775;673;14237;14835;3.77;0.23;394.91;25.08;1462;37;5091.00;598
12776;30;621751237;12776;665;14237;14836;3.80;0.23;394.91;25.08;1461;37;5092.00;599
12778;30;621751257;12778;673;14237;14836;3.84;0.24;394.94;25.08;1459;37;5093.00;599
12779;30;621751272;12779;662;14238;14839;3.88;0.24;394.92;25.08;1459;37;5094.00;601
12785;30;621751287;12785;671;14238;14839;3.87;0.24;394.90;25.08;1453;37;5095.00;601
12789;30;621751301;12789;665;14238;14839;3.83;0.24;394.85;25.08;1449;37;5096.00;601
12790;30;621751317;12790;672;14238;14839;3.82;0.23;394.82;25.08;1448;37;5097.00;601
12793;30;621751335;12793;680;14242;14845;3.82;0.23;394.80;25.07;1449;37;5098.00;603
12795;30;621751356;12795;674;14242;14845;3.78;0.23;394.78;25.07;1447;37;5099.00;603
12797;30;621751388;12797;670;14246;14864;3.78;0.23;394.77;25.07;1449;37;5100.00;618
12801;30;621751433;12801;653;14246;14864;3.81;0.23;394.83;25.07;1445;37;5101.00;618
12803;30;621751455;12803;650;14247;14868;3.85;0.24;394.81;25.06;1444;37;5102.00;621
12806;30;621751475;12806;636;14247;14869;3.86;0.24;394.76;25.06;1441;37;5103.00;622
12810;30;621751491;12810;627;14247;14869;3.88;0.24;394.79;25.06;1437;37;5104.00;622
12813;30;621751508;12813;616;14249;14870;3.89;0.24;394.80;25.06;1436;37;5105.00;621
12816;30;621751525;12816;611;14251;14870;3.93;0.24;394.81;25.06;1435;37;5106.00;619
12821;30;621751542;12821;602;14251;14870;3.97;0.24;394.81;25.06;1430;37;5107.00;619
12826;30;621751560;12826;605;14251;14870;4.02;0.25;394.82;25.06;1425;37;5108.00;619
12828;30;621751579;12828;598;14252;14870;4.07;0.25;394.83;25.07;1424;37;5109.00;618
12832;30;621751596;12832;595;14252;14870;4.11;0.25;394.86;25.07;1420;37;5110.00;618
12835;30;621751613;12835;578;14253;14870;4.13;0.25;394.89;25.07;1418;37;5111.00;617
12838;30;621751630;12838;585;14292;14940;4.17;0.26;394.93;25.00;1454;37;5112.00;648
12842;30;621751653;12842;567;14294;14941;4.18;0.26;395.06;25.00;1452;37;5113.00;647
12844;30;621751670;12844;563;14297;14941;4.24;0.26;395.08;25.13;1453;37;5114.00;644
12848;30;621751689;12848;550;14300;14941;4.26;0.26;395.18;25.12;1452;37;5115.00;641
12855;30;621751706;12855;543;14300;14941;4.27;0.26;395.29;25.12;1445;37;5116.00;641
12861;30;621751724;12861;549;14302;14941;4.30;0.26;395.32;25.12;1441;37;5117.00;639
12865;30;621751741;12865;547;14303;14941;4.33;0.26;395.35;25.12;1438;37;5118.00;638
12870;30;621751760;12870;547;14303;14941;4.37;0.27;395.38;25.12;1433;37;5119.00;638
12871;30;621751782;12871;546;14303;14942;4.47;0.27;395.39;25.12;1432;37;5120.00;639
12874;30;621751800;12874;544;14304;14943;4.52;0.27;395.53;25.12;1430;37;5121.00;639
12876;30;621751821;12876;536;14304;14943;4.52;0.27;395.59;25.12;1428;37;5122.00;639
12881;30;621751842;12881;531;14308;14947;4.50;0.27;395.82;25.11;1427;37;5123.00;639
12881;30;621751861;12881;521;14308;14947;4.55;0.28;395.82;25.11;1427;37;5124.00;639
12886;30;621751880;12886;527;14308;14947;4.56;0.28;395.90;25.11;1422;37;5125.00;639
12887;30;621751898;12887;528;14310;14947;4.58;0.28;395.92;25.11;1423;37;5126.00;637
12892;30;621751917;12892;530;14314;14953;4.57;0.28;396.00;25.11;1422;37;5127.00;639
12894;30;621751937;12894;537;14316;14953;4.61;0.28;396.04;25.11;1422;37;5128.00;637
12897;30;621751958;12897;539;14317;14953;4.60;0.28;396.12;25.11;1420;37;5129.00;636
12898;30;621751980;12898;532;14319;14959;4.62;0.28;396.23;25.24;1421;37;5130.00;640
12902;30;621752002;12902;532;14322;14959;4.61;0.28;396.32;25.24;1420;37;5131.00;637
12905;30;621752023;12905;527;14325;14959;4.59;0.28;396.41;25.27;1420;37;5132.00;634
12907;30;621752048;12907;523;14327;14960;4.61;0.28;396.58;25.26;1420;37;5133.00;633
12911;30;621752070;12911;520;14330;14961;4.57;0.28;396.56;25.28;1419;37;5134.00;631
12913;30;621752094;12913;516;14331;14961;4.61;0.28;396.61;25.29;1418;37;5135.00;630
12917;30;621752117;12917;510;14340;14974;4.64;0.28;396.62;25.29;1423;37;5136.00;634
12920;30;621752139;12920;500;14341;14974;4.64;0.28;396.70;25.31;1421;37;5137.00;633
12922;30;621752161;12922;501;14342;14974;4.63;0.28;396.68;25.31;1420;37;5138.00;632
12924;30;621752181;12924;494;14344;14975;4.67;0.28;396.69;25.34;1420;37;5139.00;631
12928;30;621752201;12928;498;14345;14975;4.67;0.28;396.77;25.35;1417;37;5140.00;630
12928;30;621752221;12928;496;14346;14979;4.69;0.28;396.77;25.35;1418;37;5141.00;633
12933;30;621752241;12933;497;14349;14979;4.66;0.28;396.83;25.38;1416;37;5142.00;630
12936;30;621752262;12936;500;14353;14983;4.61;0.28;396.94;25.51;1417;37;5143.00;630
12942;30;621752282;12942;507;14356;14983;4.56;0.28;396.98;25.52;1414;37;5144.00;627
12946;30;621752303;12946;511;14357;14983;4.52;0.27;397.20;25.53;1411;37;5145.00;626
12950;30;621752323;12950;521;14358;14983;4.45;0.27;397.25;25.54;1408;37;5146.00;625
12956;30;621752345;12956;516;14359;14983;4.38;0.26;397.33;25.67;1403;37;5147.00;624
12957;30;621752369;12957;515;14366;14995;4.33;0.26;397.34;25.69;1409;37;5148.00;629
12960;30;621752395;12960;506;14368;14995;4.34;0.26;397.38;25.70;1408;37;5149.00;627
12961;30;621752415;12961;505;14370;14995;4.36;0.26;397.36;25.74;1409;37;5150.00;625
12964;30;621752432;12964;505;14371;14995;4.36;0.27;397.44;25.73;1407;37;5151.00;624
12964;30;621752458;12964;503;14375;14995;4.41;0.27;397.44;25.76;1411;37;5152.00;620
12967;30;621752477;12967;512;14375;14995;4.45;0.27;397.48;25.76;1408;37;5153.00;620
12973;30;621752509;12973;519;14377;14996;4.47;0.27;397.47;25.77;1404;37;5154.00;619
12974;30;621752532;12974;516;14379;14998;4.51;0.27;397.45;25.78;1405;37;5155.00;619
12977;30;621752560;12977;517;14386;15004;4.53;0.28;397.49;25.82;1409;37;5156.00;618
12980;30;621752578;12980;508;14387;15005;4.56;0.28;397.58;25.83;1407;37;5157.00;618
12982;30;621752597;12982;499;14390;15005;4.59;0.28;397.63;25.97;1408;37;5158.00;615
12983;30;621752614;12983;492;14390;15005;4.62;0.28;397.63;25.97;1407;37;5159.00;615
12985;30;621752633;12985;488;14395;15010;4.63;0.28;397.62;25.98;1410;37;5160.00;615
12988;30;621752651;12988;490;14399;15010;4.62;0.28;397.67;25.99;1411;37;5161.00;611
12991;30;621752669;12991;491;14401;15010;4.61;0.28;397.77;26.02;1410;37;5162.00;609
12994;30;621752686;12994;496;14403;15011;4.61;0.28;397.81;26.03;1409;37;5163.00;608
12996;30;621752704;12996;506;14407;15015;4.58;0.28;397.81;26.04;1411;37;5164.00;608
12999;30;621752720;12999;511;14409;15015;4.52;0.27;397.90;26.05;1410;37;5165.00;606
13000;30;621752737;13000;517;14413;15018;4.49;0.27;397.92;26.07;1413;37;5166.00;605
13004;30;621752753;13004;526;14413;15018;4.43;0.27;397.96;26.07;1409;37;5167.00;605
13006;30;621752770;13006;541;14416;15018;4.39;0.27;397.99;26.22;1410;37;5168.00;602
13011;30;621752787;13011;530;14417;15018;4.34;0.26;397.92;26.24;1406;37;5169.00;601
13015;30;621752804;13015;537;14421;15022;4.32;0.26;398.04;26.24;1406;37;5170.00;601
13015;30;621752822;13015;547;14423;15022;4.31;0.26;398.04;26.27;1408;37;5171.00;599
13019;30;621752837;13019;544;14423;15022;4.29;0.26;398.33;26.27;1404;37;5172.00;599
13022;30;621752854;13022;542;14423;15022;4.24;0.26;398.45;26.27;1401;37;5173.00;599
13024;30;621752869;13024;549;14425;15023;4.24;0.26;398.48;26.29;1401;37;5174.00;598
13027;30;621752886;13027;555;14426;15025;4.19;0.26;398.68;26.29;1399;37;5175.00;599
13030;30;621752902;13030;549;14427;15025;4.15;0.25;398.75;26.30;1397;37;5176.00;598
13032;30;621752917;13032;545;14428;15026;4.15;0.25;398.76;26.30;1396;37;5177.00;598
13032;30;621752933;13032;543;14430;15026;4.14;0.25;398.76;26.32;1398;37;5178.00;596
13033;30;621752948;13033;551;14431;15026;4.17;0.25;398.80;26.34;1398;37;5179.00;595
13036;30;621752964;13036;543;14432;15026;4.16;0.25;398.95;26.35;1396;37;5180.00;594
13036;30;621752980;13036;536;14432;15026;4.18;0.25;398.95;26.35;1396;37;5181.00;594
13040;30;621752996;13040;534;14434;15026;4.18;0.25;398.94;26.37;1394;37;5182.00;592
13042;30;621753013;13042;530;14434;15026;4.20;0.26;398.98;26.37;1392;37;5183.00;592
13044;30;621753036;13044;550;14505;15153;4.39;0.27;399.09;26.38;1461;37;5184.00;648
13046;30;621753064;13046;545;14507;15154;4.44;0.27;399.17;26.39;1461;37;5185.00;647
13048;30;621753081;13048;536;14512;15154;4.48;0.28;399.13;26.40;1464;37;5186.00;642
13049;30;621753097;13049;544;14514;15154;4.53;0.28;399.18;26.40;1465;37;5187.00;640
13050;30;621753114;13050;548;14517;15154;4.58;0.28;399.16;26.40;1467;37;5188.00;637
13052;30;621753129;13052;553;14519;15154;4.57;0.28;399.15;26.40;1467;37;5189.00;635
13055;30;621753147;13055;554;14522;15154;4.53;0.28;399.09;26.41;1467;37;5190.00;632
13058;30;621753174;13058;556;14523;15154;4.51;0.28;399.09;26.41;1465;37;5191.00;631
13059;30;621753191;13059;561;14525;15155;4.48;0.28;399.10;26.42;1466;37;5192.00;630
13062;30;621753207;13062;572;14527;15156;4.44;0.27;399.15;26.43;1465;37;5193.00;629
13064;30;621753224;13064;569;14528;15156;4.42;0.27;399.18;26.43;1464;37;5194.00;628
13065;30;621753241;13065;572;14531;15157;4.39;0.27;399.20;26.45;1466;37;5195.00;626
13067;30;621753257;13067;578;14533;15157;4.36;0.27;399.18;26.46;1466;37;5196.00;624
13069;30;621753278;13069;585;14534;15157;4.35;0.27;399.15;26.45;1465;37;5197.00;623
13071;30;621753294;13071;602;14537;15157;4.33;0.27;399.15;26.47;1466;37;5198.00;620
13071;30;621753310;13071;606;14539;15161;4.35;0.27;399.15;26.47;1468;37;5199.00;622
13072;30;621753327;13072;606;14541;15161;4.36;0.27;399.15;26.48;1469;37;5200.00;620
13075;30;621753347;13075;609;14544;15161;4.33;0.26;399.20;26.50;1469;37;5201.00;617
13078;30;621753370;13078;613;14545;15164;4.29;0.26;399.23;26.50;1467;37;5202.00;619
13083;30;621753398;13083;607;14547;15164;4.22;0.26;399.19;26.51;1464;37;5203.00;617
13085;30;621753424;13085;600;14550;15164;4.20;0.26;399.21;26.71;1465;38;5204.00;614
13089;30;621753470;13089;611;14557;15168;4.20;0.26;399.24;26.71;1468;38;5205.00;611
13090;30;621753496;13090;602;14558;15169;4.16;0.25;399.22;26.72;1468;38;5206.00;611
13095;30;621753517;13095;610;14560;15169;4.16;0.25;399.18;26.73;1465;38;5207.00;609
13096;30;621753533;13096;605;14561;15173;4.21;0.26;399.19;26.73;1465;38;5208.00;612
13099;30;621753552;13099;607;14563;15173;4.21;0.26;399.16;26.75;1464;38;5209.00;610
13103;30;621753569;13103;614;14565;15173;4.20;0.26;399.08;26.74;1462;38;5210.00;608
13106;30;621753587;13106;615;14565;15174;4.20;0.26;399.05;26.74;1459;38;5211.00;609
13107;30;621753613;13107;618;14567;15174;4.23;0.26;399.06;26.75;1460;38;5212.00;607
13109;30;621753631;13109;619;14571;15180;4.25;0.26;399.01;26.75;1462;38;5213.00;609
13112;30;621753648;13112;623;14572;15180;4.20;0.26;398.96;26.76;1460;38;5214.00;608
13117;30;621753665;13117;626;14572;15180;4.17;0.25;398.96;26.76;1455;38;5215.00;608
13119;30;621753681;13119;634;14572;15181;4.12;0.25;398.91;26.76;1453;38;5216.00;609
13122;30;621753698;13122;636;14574;15181;4.10;0.25;398.86;26.76;1452;38;5217.00;607
13124;30;621753716;13124;643;14576;15181;4.06;0.25;398.81;26.79;1452;38;5218.00;605
13125;30;621753732;13125;662;14577;15181;4.06;0.25;398.78;26.80;1452;38;5219.00;604
13126;30;621753750;13126;668;14598;15217;4.15;0.26;398.77;26.76;1472;38;5220.00;619
13128;30;621753770;13128;664;14600;15217;4.13;0.25;398.73;26.75;1472;38;5221.00;617
13132;30;621753788;13132;675;14602;15217;4.11;0.25;398.68;26.75;1470;38;5222.00;615
13133;30;621753805;13133;676;14605;15217;4.10;0.25;398.73;26.76;1472;38;5223.00;612
13135;30;621753822;13135;678;14606;15217;4.05;0.25;398.70;26.76;1471;38;5224.00;611
13135;30;621753839;13135;690;14606;15217;4.05;0.25;398.70;26.76;1471;38;5225.00;611
13135;30;621753856;13135;700;14611;15221;4.01;0.25;398.70;26.75;1476;38;5226.00;610
13137;30;621753872;13137;707;14612;15221;3.96;0.24;398.74;26.84;1475;38;5227.00;609
13139;30;621753890;13139;716;14615;15225;3.94;0.24;398.72;26.83;1476;38;5228.00;610
13139;30;621753913;13139;719;14615;15226;3.90;0.24;398.72;26.83;1476;38;5229.00;611
13140;30;621753931;13140;723;14616;15226;3.87;0.24;398.72;26.93;1476;38;5230.00;610
13143;30;621753947;13143;734;14616;15226;3.84;0.24;398.80;26.93;1473;38;5231.00;610
13147;30;621753964;13147;745;14626;15239;3.82;0.24;398.84;26.91;1479;38;5232.00;613
13147;30;621753982;13147;753;14626;15239;3.80;0.23;398.84;26.91;1479;38;5233.00;613
13148;30;621753998;13148;761;14626;15239;3.76;0.23;398.87;26.91;1478;38;5234.00;613
13149;30;621754014;13149;753;14627;15240;3.74;0.23;398.86;26.91;1478;38;5235.00;613
13152;30;621754037;13152;747;14627;15241;3.66;0.23;398.86;26.91;1475;38;5236.00;614
13154;30;621754054;13154;746;14627;15241;3.68;0.23;398.85;26.91;1473;38;5237.00;614
13154;30;621754070;13154;740;14628;15244;3.70;0.23;398.85;26.91;1474;38;5238.00;616
13155;30;621754087;13155;743;14628;15244;3.69;0.23;398.83;26.91;1473;38;5239.00;616
13159;30;621754104;13159;742;14628;15244;3.70;0.23;398.81;26.91;1469;38;5240.00;616
13161;30;621754123;13161;743;14628;15244;3.73;0.23;398.81;26.91;1467;38;5241.00;616
13163;30;621754140;13163;744;14632;15250;3.79;0.23;398.86;26.90;1469;38;5242.00;618
13163;30;621754156;13163;743;14632;15250;3.79;0.23;398.86;26.90;1469;38;5243.00;618
13166;30;621754179;13166;738;14632;15250;3.77;0.23;398.84;26.90;1466;38;5244.00;618
13167;30;621754202;13167;733;14632;15250;3.75;0.23;398.89;26.90;1465;38;5245.00;618
13167;30;621754217;13167;735;14635;15254;3.75;0.23;398.89;26.90;1468;38;5246.00;619
13169;30;621754232;13169;741;14635;15255;3.74;0.23;398.92;26.90;1466;38;5247.00;620
13171;30;621754249;13171;737;14635;15255;3.71;0.23;398.87;26.90;1464;38;5248.00;620
13173;30;621754265;13173;732;14636;15256;3.72;0.23;398.84;26.90;1463;38;5249.00;620
13174;30;621754283;13174;727;14636;15256;3.77;0.23;398.82;26.90;1462;38;5250.00;620
13175;30;621754299;13175;724;14636;15256;3.79;0.23;398.80;26.90;1461;38;5251.00;620
13176;30;621754315;13176;718;14636;15256;3.81;0.23;398.78;26.90;1460;38;5252.00;620
13177;30;621754332;13177;713;14636;15256;3.87;0.24;398.82;26.90;1459;38;5253.00;620
13178;30;621754350;13178;711;14636;15256;3.88;0.24;398.81;26.90;1458;38;5254.00;620
13179;30;621754366;13179;711;14636;15256;3.91;0.24;398.79;26.90;1457;38;5255.00;620
13181;30;621754382;13181;712;14673;15326;4.03;0.25;398.75;26.83;1492;38;5256.00;653
13184;30;621754404;13184;707;14675;15327;4.01;0.24;398.73;26.83;1491;38;5257.00;652
13185;30;621754420;13185;709;14679;15327;4.05;0.25;398.71;26.82;1494;38;5258.00;648
13187;30;621754435;13187;707;14681;15327;4.05;0.25;398.75;26.82;1494;38;5259.00;646
13190;30;621754450;13190;708;14683;15327;4.02;0.25;398.75;26.81;1493;38;5260.00;644
13190;30;621754465;13190;700;14685;15327;4.00;0.24;398.75;26.81;1495;38;5261.00;642
13195;30;621754481;13195;705;14687;15327;3.95;0.24;398.82;26.81;1492;38;5262.00;640
13198;30;621754496;13198;702;14687;15327;3.87;0.24;398.85;26.81;1489;38;5263.00;640
13201;30;621754511;13201;711;14689;15328;3.83;0.23;398.83;26.80;1488;38;5264.00;639
13207;30;621754526;13207;714;14690;15330;3.77;0.23;398.80;26.80;1483;38;5265.00;640
13211;30;621754542;13211;713;14692;15330;3.75;0.23;398.90;26.80;1481;38;5266.00;638
13213;31;621754558;13213;717;14695;15334;3.73;0.23;398.88;26.79;1482;39;5267.00;639
13219;31;621754581;13219;717;14696;15334;3.67;0.22;398.82;26.79;1477;39;5268.00;638
13223;32;621754596;13223;724;14696;15334;3.66;0.22;398.94;26.79;1473;40;5269.00;638
13225;32;621754622;13225;707;14696;15334;3.68;0.22;398.91;26.79;1471;40;5270.00;638
13228;32;621754637;13228;698;14700;15340;3.69;0.22;398.96;26.79;1472;40;5271.00;640
13230;32;621754659;13230;689;14700;15340;3.68;0.22;399.05;26.79;1470;40;5272.00;640
13231;32;621754674;13231;686;14700;15340;3.73;0.23;399.04;26.79;1469;40;5273.00;640
13235;32;621754689;13235;681;14701;15343;3.76;0.23;399.13;26.78;1466;40;5274.00;642
13239;32;621754710;13239;673;14701;15343;3.79;0.23;399.23;26.78;1462;40;5275.00;642
13240;32;621754725;13240;672;14701;15343;3.89;0.24;399.23;26.78;1461;40;5276.00;642
13243;32;621754740;13243;661;14701;15344;3.91;0.24;399.34;26.78;1458;40;5277.00;643
13247;32;621754756;13247;651;14702;15345;3.95;0.24;399.41;26.78;1455;40;5278.00;643
13250;32;621754773;13250;647;14702;15345;3.98;0.24;399.46;26.78;1452;40;5279.00;643
13255;32;621754791;13255;650;14718;15371;4.06;0.25;399.55;26.75;1463;40;5280.00;653
13259;32;621754808;13259;636;14720;15371;4.12;0.25;399.70;26.75;1461;40;5281.00;651
13261;32;621754824;13261;632;14722;15371;4.20;0.25;399.76;26.75;1461;40;5282.00;649
13265;32;621754840;13265;624;14722;15372;4.21;0.26;399.80;26.75;1457;40;5283.00;650
13271;32;621754856;13271;608;14722;15372;4.24;0.26;399.83;26.75;1451;40;5284.00;650
13275;32;621754873;13275;603;14725;15376;4.24;0.26;399.91;26.74;1450;40;5285.00;651
13281;32;621754890;13281;600;14725;15376;4.23;0.26;400.00;26.74;1444;40;5286.00;651
13284;32;621754906;13284;593;14728;15379;4.24;0.26;400.03;26.74;1444;40;5287.00;651
13287;32;621754922;13287;578;14728;15380;4.25;0.26;400.02;26.74;1441;40;5288.00;652
13291;32;621754939;13291;578;14728;15380;4.25;0.26;400.14;26.74;1437;40;5289.00;652
13292;32;621754955;13292;568;14728;15380;4.32;0.26;400.14;26.74;1436;40;5290.00;652
13297;32;621754972;13297;561;14729;15380;4.29;0.26;400.27;26.87;1432;40;5291.00;651
13301;32;621754995;13301;558;14733;15392;4.32;0.26;400.30;26.87;1432;40;5292.00;659
13304;32;621755018;13304;559;14733;15392;4.30;0.26;400.40;26.87;1429;40;5293.00;659
13307;32;621755035;13307;545;14733;15392;4.33;0.26;400.40;26.87;1426;40;5294.00;659
13309;32;621755051;13309;543;14734;15392;4.34;0.26;400.43;26.88;1425;40;5295.00;658
13311;32;621755067;13311;544;14734;15392;4.42;0.27;400.45;26.88;1423;40;5296.00;658
13315;32;621755084;13315;538;14736;15392;4.46;0.27;400.44;26.88;1421;40;5297.00;656
13321;32;621755100;13321;536;14736;15393;4.46;0.27;400.50;26.88;1415;40;5298.00;657
13326;32;621755117;13326;538;14736;15393;4.50;0.27;400.59;26.88;1410;40;5299.00;657
13331;32;621755134;13331;537;14741;15399;4.50;0.27;400.64;26.89;1410;40;5300.00;658
13336;32;621755156;13336;543;14742;15400;4.52;0.27;400.72;26.90;1406;40;5301.00;658
13340;33;621755172;13340;537;14742;15400;4.54;0.27;400.80;26.90;1402;41;5302.00;658
13345;33;621755196;13345;541;14744;15400;4.51;0.27;400.83;26.92;1399;41;5303.00;656
13348;33;621755213;13348;537;14747;15404;4.52;0.27;400.91;26.93;1399;41;5304.00;657
13352;33;621755230;13352;541;14747;15404;4.54;0.27;401.09;26.93;1395;41;5305.00;657
13353;33;621755247;13353;535;14749;15404;4.56;0.28;401.09;26.94;1396;41;5306.00;655
13358;33;621755264;13358;539;14752;15405;4.51;0.27;401.22;26.95;1394;41;5307.00;653
13364;33;621755281;13364;538;14758;15409;4.51;0.27;401.31;26.98;1394;41;5308.00;651
13366;33;621755299;13366;538;14758;15409;4.47;0.27;401.32;26.98;1392;41;5309.00;651
13367;33;621755317;13367;539;14763;15415;4.47;0.27;401.39;27.00;1396;41;5310.00;652
13371;33;621755333;13371;539;14763;15415;4.43;0.27;401.47;27.00;1392;41;5311.00;652
13371;33;621755359;13371;545;14766;15415;4.42;0.27;401.47;27.02;1395;41;5312.00;649
13373;33;621755382;13373;549;14767;15415;4.36;0.26;401.63;27.16;1394;41;5313.00;648
13375;33;621755406;13375;546;14772;15419;4.32;0.26;401.62;27.18;1397;41;5314.00;647
13378;33;621755430;13378;554;14772;15419;4.24;0.26;401.63;27.18;1394;41;5315.00;647
13378;33;621755453;13378;565;14774;15419;4.21;0.26;401.63;27.21;1396;41;5316.00;645
13379;33;621755482;13379;558;14774;15419;4.14;0.25;401.73;27.21;1395;41;5317.00;645
13382;33;621755500;13382;554;14776;15420;4.08;0.25;401.84;27.22;1394;41;5318.00;644
13385;33;621755519;13385;545;14777;15421;4.06;0.25;402.02;27.23;1392;41;5319.00;644
13386;33;621755536;13386;555;14778;15421;4.07;0.25;402.04;27.24;1392;41;5320.00;643
13390;33;621755554;13390;559;14780;15422;4.05;0.25;402.16;27.26;1390;41;5321.00;642
13391;33;621755572;13391;558;14781;15422;4.04;0.25;402.17;27.27;1390;41;5322.00;641
13397;33;621755589;13397;561;14782;15422;4.01;0.24;402.41;27.28;1385;41;5323.00;640
13401;33;621755606;13401;562;14783;15422;4.01;0.24;402.43;27.29;1382;41;5324.00;639
13401;33;621755622;13401;568;14784;15422;4.00;0.24;402.43;27.30;1383;41;5325.00;638
13405;33;621755638;13405;564;14785;15422;3.97;0.24;402.48;27.32;1380;41;5326.00;637
13407;33;621755655;13407;557;14786;15422;3.96;0.24;402.51;27.33;1379;41;5327.00;636
13408;33;621755671;13408;568;14855;15549;4.06;0.25;402.50;27.23;1447;41;5328.00;694
13411;33;621755698;13411;563;14857;15550;4.07;0.25;402.48;27.24;1446;41;5329.00;693
13414;33;621755716;13414;562;14864;15550;4.10;0.25;402.50;27.26;1450;41;5330.00;686
13416;33;621755732;13416;559;14866;15550;4.12;0.25;402.57;27.25;1450;41;5331.00;684
13417;33;621755749;13417;567;14869;15550;4.15;0.26;402.58;27.26;1452;41;5332.00;681
13420;33;621755767;13420;570;14872;15550;4.19;0.26;402.68;27.27;1452;41;5333.00;678
13421;33;621755784;13421;570;14874;15550;4.25;0.26;402.70;27.27;1453;41;5334.00;676
13423;33;621755801;13423;585;14876;15550;4.27;0.26;402.84;27.28;1453;41;5335.00;674
13425;33;621755823;13425;590;14878;15551;4.28;0.26;402.87;27.27;1453;41;5336.00;673
13430;33;621755840;13430;587;14880;15552;4.29;0.26;403.04;27.27;1450;41;5337.00;672
13432;33;621755858;13432;596;14885;15552;4.29;0.26;403.15;27.29;1453;41;5338.00;667
13433;33;621755874;13433;600;14886;15553;4.25;0.26;403.17;27.29;1453;41;5339.00;667
13436;33;621755893;13436;601;14889;15553;4.21;0.26;403.23;27.30;1453;41;5340.00;664
13438;33;621755910;13438;611;14890;15553;4.15;0.26;403.26;27.30;1452;41;5341.00;663
13440;33;621755927;13440;621;14894;15553;4.11;0.25;403.27;27.30;1454;41;5342.00;659
13442;33;621755944;13442;618;14898;15557;4.08;0.25;403.24;27.31;1456;41;5343.00;659
13446;33;621755961;13446;619;14899;15557;4.07;0.25;403.33;27.31;1453;41;5344.00;658
13449;33;621755978;13449;621;14901;15557;4.05;0.25;403.50;27.33;1452;41;5345.00;656
13451;33;621755995;13451;623;14902;15560;4.05;0.25;403.52;27.33;1451;41;5346.00;658
13454;33;621756012;13454;632;14902;15560;4.00;0.25;403.53;27.33;1448;41;5347.00;658
13455;33;621756029;13455;629;14904;15560;3.97;0.24;403.57;27.34;1449;41;5348.00;656
13456;33;621756045;13456;634;14908;15564;3.98;0.24;403.56;27.35;1452;41;5349.00;656
13457;33;621756061;13457;632;14909;15565;4.02;0.25;403.60;27.35;1452;41;5350.00;656
13461;33;621756078;13461;636;14911;15565;4.02;0.25;403.64;27.37;1450;41;5351.00;654
13464;33;621756095;13464;635;14916;15569;4.06;0.25;403.74;27.38;1452;41;5352.00;653
13468;33;621756111;13468;630;14917;15569;4.06;0.25;403.73;27.39;1449;41;5353.00;652
13469;33;621756127;13469;634;14918;15569;4.04;0.25;403.71;27.40;1449;41;5354.00;651
13473;33;621756143;13473;629;14920;15571;3.99;0.24;403.71;27.41;1447;41;5355.00;651
13474;33;621756158;13474;625;14920;15571;3.95;0.24;403.74;27.41;1446;41;5356.00;651
13475;33;621756174;13475;633;14925;15577;3.96;0.24;403.72;27.41;1450;41;5357.00;652
13479;33;621756189;13479;652;14926;15577;3.96;0.24;403.70;27.42;1447;41;5358.00;651
13480;33;621756205;13480;651;14927;15577;3.92;0.24;403.75;27.43;1447;41;5359.00;650
13483;33;621756221;13483;644;14929;15578;3.92;0.24;403.82;27.58;1446;41;5360.00;649
13487;33;621756238;13487;644;14929;15578;3.93;0.24;403.82;27.58;1442;41;5361.00;649
13490;33;621756254;13490;647;14931;15578;3.89;0.24;403.77;27.60;1441;41;5362.00;647
13492;33;621756271;13492;637;14931;15578;3.88;0.24;403.72;27.60;1439;41;5363.00;647
13496;33;621756287;13496;635;14941;15590;3.91;0.24;403.70;27.59;1445;41;5364.00;649
13499;33;621756305;13499;635;14942;15590;3.94;0.24;403.67;27.60;1443;41;5365.00;648
13500;33;621756321;13500;633;14943;15590;3.98;0.24;403.70;27.61;1443;41;5366.00;647
13503;33;621756338;13503;637;14943;15590;3.98;0.24;403.71;27.61;1440;41;5367.00;647
13504;33;621756354;13504;634;14943;15590;4.01;0.25;403.69;27.61;1439;41;5368.00;647
13508;33;621756371;13508;634;14945;15590;4.02;0.25;403.67;27.63;1437;41;5369.00;645
13509;33;621756387;13509;630;14948;15594;4.05;0.25;403.67;27.62;1439;41;5370.00;646
13511;33;621756404;13511;625;14948;15594;4.05;0.25;403.67;27.62;1437;41;5371.00;646
13514;33;621756419;13514;626;14953;15598;4.08;0.25;403.61;27.64;1439;41;5372.00;645
13517;33;621756435;13517;620;14953;15599;4.06;0.25;403.61;27.64;1436;41;5373.00;646
13520;33;621756450;13520;615;14954;15599;4.04;0.25;403.59;27.65;1434;41;5374.00;645
13521;33;621756465;13521;610;14954;15599;4.05;0.25;403.56;27.65;1433;41;5375.00;645
13524;33;621756486;13524;600;14963;15612;4.08;0.25;403.50;27.63;1439;41;5376.00;649
13525;33;621756503;13525;605;14966;15612;4.08;0.25;403.48;27.78;1441;41;5377.00;646
13531;33;621756518;13531;605;14966;15612;4.07;0.25;403.51;27.78;1435;41;5378.00;646
13534;33;621756533;13534;600;14967;15613;4.07;0.25;403.46;27.78;1433;41;5379.00;646
13538;33;621756549;13538;600;14970;15614;4.05;0.25;403.49;27.81;1432;41;5380.00;644
13538;33;621756564;13538;600;14970;15614;4.05;0.25;403.49;27.81;1432;41;5381.00;644
13541;33;621756586;13541;597;14972;15617;4.07;0.25;403.45;27.82;1431;41;5382.00;645
13543;33;621756602;13543;597;14972;15617;4.05;0.25;403.48;27.82;1429;41;5383.00;645
13545;33;621756618;13545;603;14973;15617;4.03;0.25;403.50;27.83;1428;41;5384.00;644
13547;33;621756633;13547;606;14973;15617;3.99;0.24;403.48;27.83;1426;41;5385.00;644
13548;33;621756677;13548;602;14978;15623;4.00;0.24;403.46;27.83;1430;41;5386.00;645
13549;33;621756694;13549;602;14978;15623;4.01;0.24;403.46;27.83;1429;41;5387.00;645
13550;33;621756711;13550;585;14979;15623;3.97;0.24;403.49;27.84;1429;41;5388.00;644
13550;33;621756726;13550;587;14982;15623;3.97;0.24;403.49;27.87;1432;41;5389.00;641
13550;33;621756741;13550;588;14985;15627;4.03;0.25;403.49;27.86;1435;41;5390.00;642
13550;33;621756757;13550;583;14986;15628;4.05;0.25;403.49;27.87;1436;41;5391.00;642
13552;33;621756772;13552;584;14986;15628;4.01;0.24;403.52;27.87;1434;41;5392.00;642
13552;33;621756788;13552;589;14987;15629;4.03;0.25;403.52;27.87;1435;41;5393.00;642
13556;33;621756803;13556;590;14988;15629;4.03;0.25;403.45;27.88;1432;41;5394.00;641
13557;33;621756819;13557;595;14988;15629;4.04;0.25;403.48;27.88;1431;41;5395.00;641
13557;33;621756836;13557;602;14988;15629;4.02;0.24;403.48;27.88;1431;41;5396.00;641
13558;33;621756851;13558;612;14990;15629;4.04;0.25;403.49;28.00;1432;41;5397.00;639
13558;33;621756867;13558;620;14990;15629;4.03;0.25;403.49;28.00;1432;41;5398.00;639
13558;33;621756882;13558;625;14991;15629;4.00;0.24;403.49;28.00;1433;41;5399.00;638
