step_arrived;step_collisions;step_duration;step_ended;step_halting;step_inserted;step_loaded;step_meanSpeed;step_meanSpeedRelative;step_meanTravelTime;step_meanWaitingTime;step_running;step_teleports;step_time;step_waiting
0;0;620703233;0;1;87;245;16.03;1.13;-1.00;0.00;87;0;0.00;158
0;0;620703261;0;2;102;245;15.10;1.05;-1.00;0.15;102;0;1.00;143
0;0;620703263;0;1;122;245;14.41;0.98;-1.00;0.45;122;0;2.00;123
0;0;620703264;0;3;133;245;13.57;0.92;-1.00;0.66;133;0;3.00;112
0;0;620703265;0;4;148;245;12.40;0.83;-1.00;1.00;148;0;4.00;97
0;0;620703267;0;4;156;245;11.76;0.79;-1.00;1.21;156;0;5.00;89
0;0;620703268;0;10;166;245;10.88;0.73;-1.00;1.49;166;0;6.00;79
0;0;620703270;0;14;175;245;10.37;0.69;-1.00;1.78;175;0;7.00;70
0;0;620703271;0;16;182;246;9.89;0.65;-1.00;2.02;182;0;8.00;64
0;0;620703273;0;19;189;247;9.56;0.63;-1.00;2.28;189;0;9.00;58
0;0;620703276;0;22;197;247;9.34;0.62;-1.00;2.59;197;0;10.00;50
0;0;620703278;0;25;203;248;9.19;0.60;-1.00;2.79;203;0;11.00;45
0;0;620703280;0;34;206;248;9.04;0.59;-1.00;2.92;206;0;12.00;42
1;0;620703282;1;35;210;248;8.92;0.58;13.00;3.11;209;0;13.00;38
2;0;620703284;2;39;213;248;8.75;0.57;13.50;3.27;211;0;14.00;35
2;0;620703287;2;41;218;252;8.49;0.55;13.50;3.41;216;0;15.00;34
2;0;620703290;2;49;222;252;8.25;0.53;13.50;3.64;220;0;16.00;30
2;0;620703292;2;51;225;252;8.25;0.53;13.50;3.81;223;0;17.00;27
2;0;620703295;2;55;229;255;8.14;0.52;13.50;4.06;227;0;18.00;26
3;0;620703298;3;60;232;255;8.16;0.52;15.33;4.22;229;0;19.00;23
3;0;620703301;3;66;236;255;8.28;0.53;15.33;4.43;233;0;20.00;19
4;0;620703303;4;68;241;259;8.51;0.54;16.75;4.37;237;0;21.00;18
4;0;620703307;4;74;243;260;8.63;0.54;16.75;4.43;239;0;22.00;17
4;0;620703310;4;77;247;260;8.55;0.54;16.75;4.73;243;0;23.00;13
5;0;620703312;5;78;249;264;8.61;0.54;18.20;4.69;244;0;24.00;15
6;0;620703316;6;82;252;264;8.68;0.55;19.17;4.84;246;0;25.00;12
6;0;620703319;6;83;252;264;8.75;0.55;19.17;4.84;246;0;26.00;12
6;0;620703322;6;83;252;265;8.86;0.55;19.17;4.84;246;0;27.00;13
6;0;620703325;6;84;255;265;8.80;0.55;19.17;5.02;249;0;28.00;10
6;0;620703328;6;89;260;271;8.81;0.55;19.17;4.94;254;0;29.00;11
6;0;620703334;6;90;262;271;8.72;0.54;19.17;5.13;256;0;30.00;9
8;0;620703337;8;91;263;272;8.57;0.53;21.75;5.11;255;0;31.00;9
8;0;620703341;8;94;263;272;8.55;0.53;21.75;5.11;255;0;32.00;9
9;0;620703344;9;95;264;272;8.54;0.53;23.00;5.19;255;0;33.00;8
11;0;620703347;11;100;267;272;8.50;0.53;24.45;5.29;256;0;34.00;5
11;0;620703350;11;103;268;272;8.41;0.52;24.45;5.33;257;0;35.00;4
11;0;620703353;11;107;278;284;8.62;0.53;24.45;5.14;267;0;36.00;6
11;0;620703357;11;107;280;284;8.49;0.52;24.45;5.14;269;0;37.00;4
12;0;620703362;12;111;280;284;8.42;0.52;25.25;5.14;268;0;38.00;4
12;0;620703367;12;113;281;284;8.30;0.52;25.25;5.13;269;0;39.00;3
13;0;620703372;13;117;281;284;8.14;0.51;26.00;5.13;268;0;40.00;3
14;0;620703376;14;119;281;284;8.02;0.50;25.57;5.13;267;0;41.00;3
15;0;620703380;15;124;285;288;7.94;0.50;26.47;5.07;270;0;42.00;3
15;0;620703384;15;127;285;288;7.84;0.49;26.47;5.07;270;0;43.00;3
17;0;620703389;17;129;289;292;7.79;0.49;28.00;5.02;272;0;44.00;3
17;0;620703395;17;131;291;294;7.74;0.48;28.00;4.98;274;0;45.00;3
19;0;620703398;19;130;291;294;7.59;0.47;29.58;4.98;272;0;46.00;3
19;0;620703402;19;131;291;294;7.58;0.47;29.58;4.98;272;0;47.00;3
19;0;620703407;19;137;302;307;7.93;0.49;29.58;4.80;283;0;48.00;5
19;0;620703413;19;137;302;307;7.86;0.49;29.58;4.80;283;0;49.00;5
19;0;620703417;19;138;302;307;7.76;0.49;29.58;4.80;283;0;50.00;5
19;0;620703421;19;141;303;308;7.69;0.48;29.58;4.79;284;0;51.00;5
20;0;620703425;20;141;304;309;7.49;0.47;30.65;4.78;284;0;52.00;5
20;0;620703430;20;143;304;309;7.45;0.46;30.65;4.78;284;0;53.00;5
21;0;620703434;21;144;306;312;7.37;0.46;30.05;4.75;285;0;54.00;6
21;0;620703440;21;146;306;312;7.23;0.45;30.05;4.75;285;0;55.00;6
23;0;620703443;23;136;307;312;7.15;0.44;31.22;4.74;284;0;56.00;5
25;0;620703449;25;133;307;312;7.14;0.44;33.12;4.74;282;0;57.00;5
28;0;620703455;28;135;313;318;7.13;0.44;35.79;4.66;285;0;58.00;5
28;0;620703459;28;136;313;318;7.05;0.43;35.79;4.66;285;0;59.00;5
29;0;620703465;29;140;313;318;7.00;0.43;35.83;4.66;284;0;60.00;5
29;0;620703471;29;141;313;318;7.07;0.43;35.83;4.66;284;0;61.00;5
29;0;620703475;29;147;317;322;7.05;0.43;35.83;4.62;288;0;62.00;5
29;0;620703478;29;149;318;323;7.16;0.44;35.83;4.60;289;0;63.00;5
31;0;620703481;31;152;318;323;7.19;0.44;36.13;4.60;287;0;64.00;5
32;0;620703485;32;153;319;324;7.37;0.45;36.81;4.59;287;0;65.00;5
34;0;620703488;34;156;319;324;7.44;0.45;38.41;4.59;285;0;66.00;5
34;0;620703491;34;146;319;324;7.47;0.45;38.41;4.59;285;0;67.00;5
34;0;620703494;34;142;319;324;7.63;0.46;38.41;4.59;285;0;68.00;5
34;0;620703497;34;136;319;324;7.82;0.48;38.41;4.59;285;0;69.00;5
34;0;620703500;34;134;319;324;7.97;0.48;38.41;4.59;285;0;70.00;5
35;0;620703504;35;131;319;324;8.12;0.49;39.34;4.59;284;0;71.00;5
36;0;620703507;36;132;351;394;8.34;0.51;40.25;4.17;315;0;72.00;43
36;0;620703516;36;126;352;395;8.51;0.52;40.25;4.16;316;0;73.00;43
36;0;620703520;36;121;359;395;8.77;0.54;40.25;4.12;323;0;74.00;36
37;0;620703524;37;118;361;395;8.95;0.55;41.19;4.12;324;0;75.00;34
38;0;620703527;38;119;364;395;9.12;0.55;41.55;4.12;326;0;76.00;31
38;0;620703537;38;117;367;395;9.33;0.57;41.55;4.12;329;0;77.00;28
38;0;620703541;38;120;370;395;9.39;0.57;41.55;4.14;332;0;78.00;25
38;0;620703551;38;121;374;395;9.39;0.57;41.55;4.17;336;0;79.00;21
39;0;620703555;39;121;377;396;9.49;0.57;42.08;4.20;338;0;80.00;19
40;0;620703559;40;120;378;397;9.37;0.57;43.05;4.21;338;0;81.00;19
40;0;620703563;40;124;381;397;9.26;0.56;43.05;4.23;341;0;82.00;16
40;0;620703567;40;134;386;401;9.14;0.55;43.05;4.20;346;0;83.00;15
40;0;620703571;40;131;386;401;9.20;0.56;43.05;4.20;346;0;84.00;15
40;0;620703574;40;131;386;401;9.14;0.56;43.05;4.20;346;0;85.00;15
41;0;620703578;41;134;386;401;9.14;0.55;44.10;4.20;345;0;86.00;15
43;0;620703581;43;133;391;407;9.00;0.55;45.88;4.16;348;0;87.00;16
44;0;620703586;44;134;391;407;8.95;0.54;46.82;4.16;347;0;88.00;16
45;0;620703590;45;136;391;407;8.88;0.54;47.76;4.16;346;0;89.00;16
46;0;620703596;46;131;395;413;8.90;0.54;48.67;4.12;349;0;90.00;18
46;0;620703600;46;132;395;413;8.91;0.54;48.67;4.12;349;0;91.00;18
47;0;620703604;47;134;397;413;8.86;0.54;49.60;4.11;350;0;92.00;16
48;0;620703608;48;134;398;414;8.81;0.53;50.40;4.10;350;0;93.00;16
48;0;620703612;48;131;399;415;8.76;0.53;50.40;4.09;351;0;94.00;16
49;0;620703615;49;131;399;415;8.67;0.53;51.31;4.09;350;0;95.00;16
51;0;620703619;51;134;410;428;8.53;0.52;53.06;3.98;359;0;96.00;18
54;0;620703624;54;131;410;428;8.43;0.51;54.17;3.98;356;0;97.00;18
57;0;620703628;57;133;410;428;8.36;0.51;56.46;3.98;353;0;98.00;18
58;0;620703632;58;131;411;429;8.35;0.51;57.19;3.97;353;0;99.00;18
58;0;620703637;58;131;411;429;8.41;0.51;57.19;3.97;353;0;100.00;18
59;0;620703644;59;130;414;433;8.46;0.52;57.83;3.95;355;0;101.00;19
61;0;620703649;61;124;414;433;8.44;0.51;59.28;3.95;353;0;102.00;19
61;0;620703653;61;117;418;437;8.42;0.51;59.28;3.92;357;0;103.00;19
61;0;620703657;61;109;420;437;8.55;0.52;59.28;4.05;359;0;104.00;17
63;0;620703662;63;103;420;437;8.85;0.54;60.65;4.05;357;0;105.00;17
65;0;620703667;65;97;420;437;9.10;0.55;61.66;4.05;355;0;106.00;17
67;0;620703671;67;94;420;437;9.31;0.57;62.90;4.05;353;0;107.00;17
67;0;620703675;67;89;431;449;9.57;0.58;62.90;3.95;364;0;108.00;18
67;0;620703680;67;84;432;449;9.79;0.60;62.90;3.94;365;0;109.00;17
67;0;620703685;67;81;432;449;9.95;0.61;62.90;3.94;365;0;110.00;17
68;0;620703689;68;79;432;449;10.14;0.62;63.60;3.94;364;0;111.00;17
68;0;620703694;68;77;432;449;10.31;0.63;63.60;3.94;364;0;112.00;17
68;0;620703699;68;75;432;449;10.47;0.64;63.60;3.94;364;0;113.00;17
70;0;620703704;70;72;433;450;10.60;0.65;65.01;3.94;363;0;114.00;17
70;0;620703709;70;73;433;450;10.59;0.65;65.01;3.94;363;0;115.00;17
70;0;620703715;70;73;438;456;10.73;0.65;65.01;3.90;368;0;116.00;18
71;0;620703721;71;72;440;457;10.65;0.65;65.72;4.25;369;0;117.00;17
71;0;620703726;71;75;441;457;10.68;0.65;65.72;4.25;370;0;118.00;16
71;0;620703731;71;76;441;457;10.72;0.66;65.72;4.25;370;0;119.00;16
73;0;620703738;73;82;447;462;10.71;0.65;66.66;4.57;374;0;120.00;15
73;0;620703744;73;80;448;462;10.71;0.65;66.66;4.67;375;0;121.00;14
75;0;620703749;75;82;449;462;10.76;0.66;67.99;4.93;374;0;122.00;13
77;0;620703754;77;80;451;463;10.87;0.66;69.34;5.02;374;0;123.00;12
78;0;620703760;78;83;456;467;10.93;0.67;70.04;5.09;378;0;124.00;11
78;0;620703767;78;86;458;467;11.12;0.68;70.04;5.35;380;0;125.00;9
79;0;620703773;79;87;461;470;11.25;0.69;70.75;5.40;382;0;126.00;9
82;0;620703779;82;86;464;470;11.36;0.69;72.68;5.60;382;0;127.00;6
83;0;620703784;83;87;465;470;11.51;0.70;72.92;5.61;382;0;128.00;5
83;0;620703791;83;88;466;470;11.61;0.71;72.92;5.72;383;0;129.00;4
83;0;620703797;83;86;471;474;11.83;0.72;72.92;5.79;388;0;130.00;3
85;0;620703803;85;84;471;474;11.94;0.73;73.40;5.79;386;0;131.00;3
85;0;620703809;85;86;471;474;12.03;0.74;73.40;5.79;386;0;132.00;3
88;0;620703816;88;87;472;474;11.88;0.73;74.20;5.86;384;0;133.00;2
88;0;620703822;88;89;473;475;11.93;0.73;74.20;5.85;385;0;134.00;2
90;0;620703829;90;90;476;477;11.88;0.73;75.50;5.89;386;0;135.00;1
91;0;620703843;91;90;476;477;11.81;0.72;75.90;5.89;385;0;136.00;1
91;0;620703855;91;93;478;478;11.83;0.72;75.90;5.91;387;0;137.00;0
92;0;620703861;92;96;478;478;11.81;0.72;75.79;5.91;386;0;138.00;0
92;0;620703867;92;96;478;478;11.74;0.72;75.79;5.91;386;0;139.00;0
93;0;620703873;93;98;478;478;11.71;0.72;76.46;5.91;385;0;140.00;0
95;0;620703878;95;99;478;478;11.60;0.72;77.43;5.91;383;0;141.00;0
98;0;620703884;98;99;478;478;11.46;0.71;79.21;5.91;380;0;142.00;0
100;0;620703890;100;101;478;478;11.39;0.71;79.69;5.91;378;0;143.00;0
101;0;620703896;101;125;552;605;11.02;0.70;80.33;5.12;451;0;144.00;53
104;0;620703916;104;119;557;606;10.89;0.69;82.15;5.08;453;0;145.00;49
106;0;620703922;106;113;564;606;10.79;0.68;82.54;5.05;458;0;146.00;42
109;0;620703929;109;109;566;606;10.68;0.67;83.55;5.04;457;0;147.00;40
112;0;620703936;112;117;571;606;10.58;0.67;84.14;5.03;459;0;148.00;35
115;0;620703944;115;115;572;606;10.58;0.66;85.33;5.03;457;0;149.00;34
115;0;620703954;115;119;576;611;10.48;0.66;85.33;5.02;461;0;150.00;35
117;0;620703964;117;117;577;611;10.44;0.65;86.41;5.02;460;0;151.00;34
122;0;620703973;122;117;579;612;10.40;0.64;88.31;5.03;457;0;152.00;33
124;0;620703983;124;118;583;613;10.44;0.65;89.20;5.06;459;0;153.00;30
125;0;620703991;125;118;586;613;10.56;0.65;89.71;5.08;461;0;154.00;27
125;0;620703999;125;122;588;614;10.59;0.66;89.71;5.09;463;0;155.00;26
127;0;620704005;127;129;591;614;10.55;0.65;89.61;5.10;464;0;156.00;23
130;0;620704012;130;129;594;614;10.58;0.65;91.14;5.14;464;0;157.00;20
130;0;620704018;130;134;597;614;10.52;0.65;91.14;5.18;467;0;158.00;17
133;0;620704024;133;137;604;618;10.37;0.64;91.53;5.23;471;0;159.00;14
133;0;620704031;133;141;605;618;10.30;0.64;91.53;5.25;472;0;160.00;13
134;0;620704037;134;143;607;618;10.24;0.63;92.00;5.29;473;0;161.00;11
135;0;620704043;135;149;608;621;10.12;0.62;91.97;5.31;473;0;162.00;13
135;0;620704049;135;149;611;621;10.09;0.62;91.97;5.36;476;0;163.00;10
138;0;620704054;138;151;613;621;9.94;0.61;93.28;5.36;475;0;164.00;8
139;0;620704061;139;153;619;625;9.78;0.60;93.76;5.38;480;0;165.00;6
142;0;620704067;142;156;620;626;9.66;0.60;94.96;5.38;478;0;166.00;6
143;0;620704073;143;152;621;626;9.51;0.59;94.94;5.40;478;0;167.00;5
147;0;620704078;147;152;626;630;9.28;0.57;95.94;5.42;479;0;168.00;4
147;0;620704084;147;156;627;630;9.16;0.57;95.94;5.42;480;0;169.00;3
148;0;620704090;148;145;628;630;9.14;0.57;95.95;5.42;480;0;170.00;2
150;0;620704096;150;136;629;631;9.18;0.57;96.77;5.41;479;0;171.00;2
151;0;620704102;151;135;629;631;9.26;0.57;97.13;5.41;478;0;172.00;2
153;0;620704108;153;135;635;637;9.40;0.58;97.81;5.37;482;0;173.00;2
154;0;620704114;154;136;637;637;9.37;0.58;98.31;5.41;483;0;174.00;0
155;0;620704120;155;129;638;638;9.37;0.58;98.68;5.40;483;0;175.00;0
157;0;620704127;157;130;638;638;9.35;0.58;98.57;5.40;481;0;176.00;0
161;0;620704133;161;127;638;638;9.33;0.57;99.14;5.40;477;0;177.00;0
163;0;620704140;163;123;638;638;9.40;0.58;99.36;5.40;475;0;178.00;0
164;0;620704146;164;122;638;638;9.48;0.58;99.80;5.40;474;0;179.00;0
164;0;620704154;164;117;668;672;9.69;0.60;99.80;5.16;504;0;180.00;4
165;0;620704163;165;121;669;672;9.70;0.60;100.28;5.15;504;0;181.00;3
166;0;620704170;166;120;671;672;9.71;0.60;100.31;5.14;505;0;182.00;1
167;0;620704176;167;118;671;672;9.66;0.60;100.27;5.14;504;0;183.00;1
168;0;620704182;168;124;672;672;9.67;0.60;100.77;5.14;504;0;184.00;0
171;0;620704189;171;124;672;672;9.68;0.60;100.99;5.14;501;0;185.00;0
173;0;620704196;173;136;676;676;9.73;0.60;101.04;5.12;503;0;186.00;0
173;0;620704203;173;142;676;676;9.74;0.60;101.04;5.12;503;0;187.00;0
175;0;620704209;175;145;680;680;9.66;0.59;100.53;5.09;505;0;188.00;0
178;0;620704216;178;152;681;681;9.54;0.59;101.43;5.08;503;0;189.00;0
180;0;620704222;180;159;681;681;9.44;0.58;101.75;5.08;501;0;190.00;0
180;0;620704229;180;166;681;681;9.33;0.57;101.75;5.08;501;0;191.00;0
183;0;620704235;183;174;694;694;9.32;0.57;101.26;4.99;511;0;192.00;0
184;0;620704243;184;179;694;694;9.22;0.57;101.35;4.99;510;0;193.00;0
187;0;620704249;187;179;694;694;9.11;0.56;101.21;4.99;507;0;194.00;0
190;0;620704256;190;182;695;695;9.00;0.55;101.17;4.98;505;0;195.00;0
192;0;620704263;192;181;696;696;8.84;0.54;101.52;4.98;504;0;196.00;0
196;0;620704270;196;182;696;696;8.70;0.53;101.54;4.98;500;0;197.00;0
197;0;620704276;197;189;698;699;8.61;0.53;101.28;4.96;501;0;198.00;1
197;0;620704282;197;194;698;699;8.48;0.52;101.28;4.96;501;0;199.00;1
201;0;620704289;201;198;699;699;8.28;0.51;101.28;4.96;498;0;200.00;0
201;0;620704302;201;200;699;699;8.09;0.50;101.28;4.96;498;0;201.00;0
202;0;620704311;202;207;705;705;7.92;0.49;101.60;4.92;503;0;202.00;0
203;0;620704321;203;212;705;705;7.71;0.48;101.39;4.92;502;0;203.00;0
206;0;620704327;206;217;705;705;7.57;0.47;101.15;4.92;499;0;204.00;0
210;0;620704332;210;223;705;705;7.39;0.45;100.87;4.92;495;0;205.00;0
211;0;620704338;211;233;709;709;7.37;0.45;101.20;4.90;498;0;206.00;0
212;0;620704343;212;236;710;710;7.34;0.45;101.02;4.90;498;0;207.00;0
212;0;620704349;212;239;710;710;7.35;0.45;101.02;4.90;498;0;208.00;0
213;0;620704355;213;245;711;711;7.32;0.45;101.08;4.89;498;0;209.00;0
216;0;620704365;216;248;711;711;7.26;0.44;101.12;4.89;495;0;210.00;0
217;0;620704376;217;253;711;711;7.25;0.45;101.60;4.89;494;0;211.00;0
222;0;620704384;222;254;711;711;7.05;0.43;101.58;4.89;489;0;212.00;0
222;0;620704391;222;256;711;711;6.99;0.43;101.58;4.89;489;0;213.00;0
222;0;620704399;222;262;711;711;6.86;0.42;101.58;4.89;489;0;214.00;0
223;0;620704405;223;265;711;711;6.71;0.41;101.90;4.89;488;0;215.00;0
224;0;620704411;224;281;755;781;6.92;0.43;102.38;4.61;531;0;216.00;26
224;0;620704423;224;265;757;782;6.91;0.43;102.38;4.60;533;0;217.00;25
226;0;620704430;226;258;764;782;7.09;0.44;103.12;4.57;538;0;218.00;18
227;0;620704436;227;239;765;782;7.18;0.44;103.62;4.57;538;0;219.00;17
227;0;620704448;227;226;768;782;7.35;0.45;103.62;4.57;541;0;220.00;14
229;0;620704455;229;222;772;782;7.47;0.46;104.61;4.57;543;0;221.00;10
230;0;620704462;230;223;775;782;7.63;0.47;105.10;4.58;545;0;222.00;7
231;0;620704470;231;219;778;782;7.72;0.47;105.26;4.58;547;0;223.00;4
231;0;620704477;231;223;781;783;7.77;0.47;105.26;4.59;550;0;224.00;2
232;1;620704484;232;223;782;785;7.73;0.47;105.36;4.58;550;1;225.00;3
233;1;620704508;233;213;783;785;7.79;0.48;104.99;4.59;550;1;226.00;2
233;2;620704516;233;203;788;789;7.87;0.48;104.99;4.58;555;2;227.00;1
235;2;620704535;235;196;789;789;8.03;0.49;106.03;4.58;554;2;228.00;0
235;2;620704545;235;195;789;789;8.14;0.50;106.03;4.58;554;2;229.00;0
237;2;620704558;237;191;789;789;8.29;0.51;106.14;4.58;552;2;230.00;0
237;2;620704567;237;184;795;795;8.41;0.51;106.14;4.55;558;2;231.00;0
237;2;620704576;237;178;795;795;8.58;0.53;106.14;4.55;558;2;232.00;0
237;2;620704583;237;171;795;795;8.67;0.53;106.14;4.55;558;2;233.00;0
238;2;620704591;238;170;798;798;8.84;0.54;106.67;4.53;560;2;234.00;0
238;2;620704598;238;166;798;798;8.93;0.55;106.67;4.53;560;2;235.00;0
239;2;620704605;239;165;798;798;9.02;0.55;106.78;4.53;559;2;236.00;0
241;2;620704613;241;156;799;799;9.12;0.56;107.23;4.53;558;2;237.00;0
242;2;620704620;242;151;800;800;9.26;0.57;107.59;4.53;558;2;238.00;0
244;2;620704628;244;146;800;800;9.37;0.57;108.46;4.53;556;2;239.00;0
248;2;620704636;248;153;825;826;9.37;0.58;109.08;4.39;577;2;240.00;1
252;2;620704646;252;148;825;826;9.47;0.58;109.50;4.39;573;2;241.00;1
255;2;620704653;255;141;826;826;9.59;0.59;109.84;4.38;571;2;242.00;0
257;2;620704661;257;134;827;827;9.65;0.59;110.44;4.38;570;2;243.00;0
260;2;620704668;260;127;827;827;9.74;0.60;110.98;4.38;567;2;244.00;0
264;2;620704675;264;125;831;831;9.88;0.60;112.26;4.36;567;2;245.00;0
266;2;620704683;266;129;831;831;9.98;0.61;113.23;4.36;565;2;246.00;0
268;2;620704690;268;131;835;835;9.97;0.61;113.16;4.35;567;2;247.00;0
273;2;620704698;273;128;835;835;9.99;0.61;113.33;4.35;562;2;248.00;0
274;2;620704705;274;132;835;835;9.93;0.60;113.78;4.35;561;2;249.00;0
277;2;620704718;277;130;835;835;9.89;0.60;114.91;4.35;558;2;250.00;0
279;2;620704725;279;131;835;835;9.94;0.60;115.54;4.35;556;2;251.00;0
280;2;620704732;280;139;845;847;10.02;0.61;115.52;4.30;565;2;252.00;2
281;2;620704740;281;135;845;847;10.07;0.61;115.67;4.30;564;2;253.00;2
281;2;620704747;281;139;847;847;10.13;0.62;115.67;4.29;566;2;254.00;0
281;2;620704753;281;143;847;847;10.14;0.62;115.67;4.29;566;2;255.00;0
281;2;620704760;281;147;847;847;10.16;0.62;115.67;4.29;566;2;256.00;0
282;2;620704767;282;151;847;847;10.12;0.62;116.13;4.29;565;2;257.00;0
284;2;620704773;284;155;848;848;10.10;0.61;116.51;4.29;564;2;258.00;0
285;2;620704780;285;157;848;848;10.07;0.61;116.49;4.29;563;2;259.00;0
287;2;620704792;287;157;854;854;10.05;0.61;116.44;4.26;567;2;260.00;0
288;2;620704801;288;154;855;855;10.06;0.61;116.74;4.26;567;2;261.00;0
289;2;620704808;289;149;855;855;10.07;0.61;116.57;4.26;566;2;262.00;0
290;2;620704815;290;150;855;855;10.02;0.61;116.68;4.26;565;2;263.00;0
292;2;620704822;292;147;859;859;10.05;0.61;117.19;4.24;567;2;264.00;0
294;2;620704829;294;146;859;859;10.10;0.61;117.46;4.24;565;2;265.00;0
295;2;620704835;295;145;859;859;10.13;0.61;117.32;4.24;564;2;266.00;0
298;3;620704842;298;142;860;860;10.24;0.62;118.20;4.23;562;3;267.00;0
301;3;620704862;301;139;864;864;10.16;0.62;118.98;4.22;563;3;268.00;0
306;3;620704869;306;136;864;864;10.21;0.62;120.18;4.22;558;3;269.00;0
308;3;620704883;308;134;868;870;10.28;0.62;120.55;4.20;560;3;270.00;2
311;3;620704890;311;130;868;870;10.27;0.62;120.99;4.20;557;3;271.00;2
316;3;620704897;316;121;870;870;10.29;0.62;121.50;4.20;554;3;272.00;0
316;3;620704904;316;116;870;870;10.29;0.62;121.50;4.20;554;3;273.00;0
317;3;620704911;317;111;874;874;10.37;0.63;121.53;4.18;557;3;274.00;0
319;3;620704919;319;108;874;874;10.45;0.63;121.59;4.18;555;3;275.00;0
324;3;620704926;324;103;874;874;10.50;0.64;122.15;4.18;550;3;276.00;0
325;3;620704934;325;106;874;874;10.56;0.64;122.18;4.18;549;3;277.00;0
327;3;620704941;327;99;875;875;10.58;0.64;122.34;4.18;548;3;278.00;0
328;3;620704948;328;95;876;876;10.65;0.64;122.78;4.17;548;3;279.00;0
329;3;620704955;329;89;876;876;10.71;0.65;122.82;4.17;547;3;280.00;0
333;3;620704963;333;87;877;877;10.74;0.65;123.29;4.17;544;3;281.00;0
334;3;620704970;334;83;877;877;10.79;0.65;123.12;4.17;543;3;282.00;0
335;3;620704978;335;84;877;877;10.75;0.65;123.17;4.17;542;3;283.00;0
337;3;620704985;337;84;877;877;10.79;0.65;122.94;4.17;540;3;284.00;0
337;3;620704992;337;86;877;877;10.95;0.66;122.94;4.17;540;3;285.00;0
338;3;620704999;338;84;877;877;11.02;0.67;123.00;4.17;539;3;286.00;0
340;3;620705007;340;81;877;877;11.01;0.67;122.99;4.17;537;3;287.00;0
342;3;620705016;342;97;948;1004;10.80;0.67;123.51;3.86;606;3;288.00;56
343;3;620705034;343;92;953;1005;10.78;0.66;123.97;3.84;610;3;289.00;52
343;3;620705044;343;87;959;1005;10.85;0.67;123.97;3.83;616;3;290.00;46
344;3;620705052;344;88;959;1005;10.76;0.66;124.44;3.83;615;3;291.00;46
345;3;620705060;345;82;967;1005;10.94;0.67;124.91;3.83;622;3;292.00;38
345;3;620705068;345;87;969;1005;10.97;0.68;124.91;3.84;624;3;293.00;36
345;3;620705077;345;87;972;1005;11.08;0.68;124.91;3.84;627;3;294.00;33
346;3;620705085;346;83;975;1005;11.19;0.69;124.98;3.85;629;3;295.00;30
349;3;620705094;349;82;977;1006;11.23;0.69;126.00;3.86;628;3;296.00;29
351;3;620705102;351;86;981;1007;11.31;0.69;126.24;3.88;630;3;297.00;26
352;3;620705112;352;86;984;1007;11.36;0.70;126.67;3.90;632;3;298.00;23
355;3;620705120;355;91;986;1008;11.38;0.70;126.72;3.92;631;3;299.00;22
356;3;620705131;356;93;993;1014;11.34;0.70;126.53;3.95;637;3;300.00;21
356;3;620705145;356;95;995;1014;11.34;0.70;126.53;3.97;639;3;301.00;19
357;3;620705154;357;98;998;1014;11.32;0.70;127.02;4.00;641;3;302.00;16
362;3;620705163;362;102;1003;1018;11.22;0.69;127.83;4.02;641;3;303.00;15
363;3;620705172;363;112;1004;1018;11.19;0.69;127.52;4.01;641;3;304.00;14
365;3;620705182;365;117;1006;1018;11.17;0.69;128.03;4.03;641;3;305.00;12
366;3;620705191;366;124;1010;1021;11.11;0.68;127.93;4.03;644;3;306.00;11
370;3;620705199;370;125;1012;1021;11.10;0.68;128.27;4.06;642;3;307.00;9
373;3;620705208;373;129;1012;1021;11.02;0.67;128.99;4.06;639;3;308.00;9
377;3;620705217;377;136;1017;1025;10.88;0.67;130.28;4.07;640;3;309.00;8
380;3;620705232;380;141;1018;1026;10.79;0.66;130.24;4.07;638;3;310.00;8
380;3;620705242;380;142;1019;1026;10.65;0.66;130.24;4.07;639;3;311.00;7
383;3;620705251;383;149;1025;1030;10.50;0.65;131.32;4.07;642;3;312.00;5
385;3;620705259;385;152;1025;1030;10.40;0.64;132.19;4.07;640;3;313.00;5
387;3;620705268;387;150;1025;1030;10.33;0.64;132.87;4.07;638;3;314.00;5
387;3;620705276;387;158;1028;1032;10.18;0.63;132.87;4.07;641;3;315.00;4
387;3;620705284;387;160;1028;1032;10.13;0.63;132.87;4.07;641;3;316.00;4
388;3;620705291;388;166;1034;1038;10.02;0.62;133.02;4.05;646;3;317.00;4
395;3;620705300;395;174;1034;1038;9.78;0.60;134.80;4.05;639;3;318.00;4
398;3;620705308;398;174;1035;1039;9.50;0.58;135.49;4.05;637;3;319.00;4
399;3;620705323;399;177;1035;1039;9.35;0.58;135.23;4.05;636;3;320.00;4
403;3;620705331;403;180;1035;1039;9.24;0.57;135.41;4.05;632;3;321.00;4
406;3;620705338;406;184;1036;1039;9.22;0.57;135.72;4.08;630;3;322.00;3
407;3;620705346;407;185;1036;1039;9.18;0.56;135.74;4.08;629;3;323.00;3
413;3;620705353;413;192;1049;1051;9.16;0.56;136.10;4.08;636;3;324.00;2
414;3;620705365;414;196;1050;1051;9.18;0.56;135.97;4.11;636;3;325.00;1
417;3;620705378;417;201;1051;1051;9.24;0.57;136.72;4.11;634;3;326.00;0
418;3;620705391;418;206;1051;1051;9.30;0.57;136.90;4.11;633;3;327.00;0
419;3;620705401;419;209;1051;1051;9.33;0.57;136.83;4.11;632;3;328.00;0
419;3;620705413;419;212;1051;1051;9.38;0.58;136.83;4.11;632;3;329.00;0
421;3;620705426;421;217;1055;1055;9.32;0.57;137.04;4.09;634;3;330.00;0
422;3;620705439;422;217;1055;1055;9.29;0.57;137.16;4.09;633;3;331.00;0
423;3;620705449;423;219;1059;1059;9.23;0.57;137.00;4.08;636;3;332.00;0
427;3;620705461;427;222;1060;1060;9.06;0.56;137.68;4.08;633;3;333.00;0
428;3;620705473;428;217;1060;1060;8.88;0.54;137.80;4.08;632;3;334.00;0
435;3;620705481;435;220;1060;1060;8.66;0.53;138.98;4.08;625;3;335.00;0
438;3;620705490;438;221;1073;1073;8.46;0.52;140.33;4.03;635;3;336.00;0
442;3;620705498;442;223;1073;1073;8.36;0.51;140.77;4.03;631;3;337.00;0
448;3;620705507;448;231;1073;1073;8.25;0.51;142.18;4.03;625;3;338.00;0
450;3;620705515;450;237;1074;1074;8.15;0.50;143.06;4.03;624;3;339.00;0
452;3;620705523;452;221;1075;1075;8.04;0.49;143.59;4.02;623;3;340.00;0
454;3;620705530;454;215;1075;1075;7.95;0.49;143.82;4.02;621;3;341.00;0
456;3;620705537;456;214;1078;1078;7.87;0.48;144.32;4.01;622;3;342.00;0
458;3;620705545;458;217;1078;1078;7.88;0.48;144.70;4.01;620;3;343.00;0
461;3;620705552;461;208;1078;1078;7.89;0.48;145.37;4.01;617;3;344.00;0
461;3;620705559;461;213;1078;1078;7.97;0.49;145.37;4.01;617;3;345.00;0
465;3;620705566;465;210;1084;1084;8.09;0.50;146.55;4.00;619;3;346.00;0
467;3;620705574;467;202;1084;1084;8.13;0.50;146.82;4.00;617;3;347.00;0
471;3;620705581;471;202;1084;1084;8.19;0.50;147.40;4.00;613;3;348.00;0
473;3;620705588;473;205;1084;1084;8.26;0.51;147.69;4.00;611;3;349.00;0
475;3;620705595;475;205;1088;1088;8.25;0.51;147.47;3.99;613;3;350.00;0
478;3;620705603;478;206;1089;1089;8.16;0.50;147.77;3.98;611;3;351.00;0
482;3;620705610;482;209;1089;1089;8.12;0.50;147.86;3.98;607;3;352.00;0
484;3;620705618;484;209;1090;1090;8.05;0.50;148.52;3.98;606;3;353.00;0
490;3;620705625;490;212;1090;1090;7.95;0.49;149.17;3.98;600;3;354.00;0
494;3;620705633;494;215;1090;1090;7.82;0.48;149.09;3.98;596;3;355.00;0
498;3;620705640;498;223;1090;1090;7.71;0.47;149.36;3.98;592;3;356.00;0
499;3;620705647;499;225;1090;1090;7.61;0.47;149.34;3.98;591;3;357.00;0
502;3;620705654;502;232;1090;1090;7.51;0.46;149.44;3.98;588;3;358.00;0
504;3;620705661;504;236;1090;1090;7.37;0.46;149.56;3.98;586;3;359.00;0
510;3;620705671;510;243;1154;1215;7.79;0.49;149.29;3.76;644;3;360.00;61
510;3;620705690;510;244;1162;1216;7.74;0.48;149.29;3.74;652;3;361.00;54
515;3;620705698;515;246;1176;1216;7.71;0.48;149.50;3.72;661;3;362.00;40
517;3;620705705;517;248;1183;1216;7.64;0.48;149.37;3.71;666;3;363.00;33
517;3;620705713;517;255;1188;1216;7.53;0.47;149.37;3.72;671;3;364.00;28
520;3;620705721;520;257;1190;1216;7.40;0.46;149.14;3.72;670;3;365.00;26
521;3;620705728;521;256;1196;1216;7.29;0.45;149.13;3.73;675;3;366.00;20
524;3;620705736;524;262;1200;1216;7.07;0.44;149.41;3.74;676;3;367.00;16
525;3;620705743;525;267;1203;1217;6.92;0.43;149.27;3.75;678;3;368.00;14
526;3;620705751;526;277;1209;1218;6.75;0.42;149.42;3.78;683;3;369.00;9
528;3;620705759;528;284;1210;1218;6.62;0.41;149.58;3.78;682;3;370.00;8
530;3;620705767;530;283;1218;1222;6.62;0.41;149.53;3.78;688;3;371.00;4
532;3;620705776;532;272;1219;1222;6.66;0.41;149.26;3.79;687;3;372.00;3
536;3;620705784;536;280;1220;1222;6.61;0.41;149.30;3.80;684;3;373.00;2
536;3;620705793;536;275;1220;1222;6.71;0.41;149.30;3.80;684;3;374.00;2
536;3;620705801;536;272;1226;1228;6.80;0.42;149.30;3.80;690;3;375.00;2
536;3;620705809;536;271;1226;1228;6.84;0.42;149.30;3.80;690;3;376.00;2
537;3;620705818;537;273;1227;1228;6.94;0.43;149.36;3.81;690;3;377.00;1
541;3;620705833;541;274;1228;1231;7.06;0.43;149.02;3.80;687;3;378.00;3
541;3;620705843;541;272;1229;1231;7.12;0.44;149.02;3.80;688;3;379.00;2
543;3;620705851;543;267;1229;1231;7.13;0.44;149.66;3.80;686;3;380.00;2
545;3;620705866;545;266;1230;1232;7.16;0.44;149.97;3.80;685;3;381.00;2
545;3;620705875;545;266;1231;1233;7.22;0.44;149.97;3.80;686;3;382.00;2
549;3;620705883;549;264;1231;1233;7.20;0.44;149.58;3.80;682;3;383.00;2
549;3;620705892;549;265;1244;1246;7.28;0.44;149.58;3.76;695;3;384.00;2
552;3;620705901;552;261;1244;1246;7.28;0.44;149.32;3.76;692;3;385.00;2
555;3;620705910;555;262;1244;1246;7.33;0.45;149.77;3.76;689;3;386.00;2
555;3;620705919;555;255;1244;1247;7.46;0.45;149.77;3.76;689;3;387.00;3
557;3;620705928;557;251;1246;1247;7.55;0.46;149.78;3.77;689;3;388.00;1
558;3;620705937;558;247;1249;1251;7.69;0.47;149.69;3.76;691;3;389.00;2
560;3;620705950;560;243;1250;1251;7.82;0.48;150.06;3.76;690;3;390.00;1
562;3;620705960;562;244;1254;1255;7.95;0.48;150.59;3.75;692;3;391.00;1
565;3;620705970;565;243;1255;1255;8.02;0.49;150.71;3.75;690;3;392.00;0
567;3;620705980;567;249;1255;1255;8.05;0.49;150.84;3.75;688;3;393.00;0
569;3;620705991;569;250;1255;1255;8.09;0.49;150.86;3.75;686;3;394.00;0
572;3;620706000;572;254;1255;1255;8.07;0.49;150.99;3.75;683;3;395.00;0
574;3;620706010;574;239;1266;1267;8.21;0.50;151.02;3.72;692;3;396.00;1
575;3;620706021;575;230;1266;1267;8.28;0.50;151.09;3.72;691;3;397.00;1
576;3;620706030;576;224;1267;1267;8.26;0.50;151.49;3.72;691;3;398.00;0
577;3;620706039;577;220;1267;1267;8.28;0.50;151.85;3.72;690;3;399.00;0
577;3;620706049;577;212;1267;1267;8.36;0.51;151.85;3.72;690;3;400.00;0
578;3;620706062;578;214;1267;1267;8.39;0.51;152.03;3.72;689;3;401.00;0
581;3;620706071;581;208;1268;1268;8.42;0.51;152.39;3.72;687;3;402.00;0
583;3;620706081;583;203;1268;1268;8.45;0.52;152.37;3.72;685;3;403.00;0
586;3;620706090;586;204;1274;1274;8.48;0.52;152.81;3.70;688;3;404.00;0
589;3;620706100;589;204;1276;1276;8.50;0.52;153.39;3.70;687;3;405.00;0
591;3;620706109;591;204;1276;1276;8.59;0.52;154.01;3.70;685;3;406.00;0
594;3;620706120;594;205;1276;1276;8.72;0.53;154.59;3.70;682;3;407.00;0
597;3;620706129;597;195;1280;1280;8.76;0.53;154.96;3.69;683;3;408.00;0
597;3;620706139;597;186;1280;1280;8.78;0.54;154.96;3.69;683;3;409.00;0
601;3;620706148;601;181;1280;1280;8.85;0.54;155.98;3.69;679;3;410.00;0
604;3;620706157;604;176;1281;1281;8.89;0.54;156.26;3.69;677;3;411.00;0
606;3;620706166;606;174;1285;1285;8.96;0.55;156.68;3.68;679;3;412.00;0
608;3;620706176;608;167;1285;1285;9.08;0.56;156.75;3.68;677;3;413.00;0
610;3;620706186;610;166;1287;1288;9.26;0.57;157.12;3.67;677;3;414.00;1
613;3;620706195;613;160;1287;1288;9.26;0.57;157.32;3.67;674;3;415.00;1
615;3;620706204;615;162;1288;1288;9.32;0.57;157.54;3.67;673;3;416.00;0
618;3;620706214;618;162;1288;1288;9.29;0.57;157.94;3.67;670;3;417.00;0
621;3;620706225;621;159;1292;1292;9.28;0.57;158.90;3.66;671;3;418.00;0
622;3;620706241;622;161;1292;1292;9.30;0.57;158.79;3.66;670;3;419.00;0
627;3;620706252;627;157;1292;1292;9.26;0.57;159.51;3.66;665;3;420.00;0
629;3;620706261;629;158;1292;1292;9.23;0.56;159.56;3.66;663;3;421.00;0
630;3;620706271;630;160;1293;1293;9.27;0.57;159.40;3.66;663;3;422.00;0
634;3;620706281;634;160;1294;1294;9.21;0.56;160.07;3.66;660;3;423.00;0
636;3;620706291;636;164;1294;1294;9.15;0.56;160.33;3.66;658;3;424.00;0
638;3;620706299;638;167;1295;1295;9.17;0.56;160.69;3.65;657;3;425.00;0
642;3;620706308;642;164;1295;1295;9.22;0.56;161.84;3.65;653;3;426.00;0
642;3;620706317;642;157;1295;1295;9.27;0.57;161.84;3.65;653;3;427.00;0
643;3;620706325;643;152;1295;1295;9.31;0.57;161.86;3.65;652;3;428.00;0
643;3;620706333;643;156;1295;1295;9.43;0.58;161.86;3.65;652;3;429.00;0
643;3;620706342;643;154;1295;1295;9.52;0.58;161.86;3.65;652;3;430.00;0
646;3;620706351;646;148;1295;1295;9.54;0.58;161.96;3.65;649;3;431.00;0
650;3;620706360;650;179;1376;1422;9.27;0.58;162.82;3.44;726;3;432.00;46
653;3;620706382;653;157;1377;1423;9.35;0.58;162.73;3.44;724;3;433.00;46
658;3;620706393;658;141;1382;1423;9.48;0.59;163.28;3.43;724;3;434.00;41
660;3;620706402;660;141;1382;1423;9.61;0.60;163.67;3.43;722;3;435.00;41
662;3;620706412;662;139;1386;1423;9.71;0.60;164.31;3.44;724;3;436.00;37
664;3;620706422;664;137;1387;1423;9.78;0.61;164.38;3.44;723;3;437.00;36
668;3;620706431;668;140;1388;1423;9.85;0.61;165.00;3.44;720;3;438.00;35
672;3;620706441;672;142;1391;1423;10.07;0.62;165.49;3.45;719;3;439.00;32
677;3;620706450;677;138;1392;1424;10.22;0.63;165.94;3.45;715;3;440.00;32
680;3;620706460;680;136;1397;1425;10.29;0.63;166.60;3.47;717;3;441.00;28
683;3;620706469;683;132;1400;1425;10.40;0.64;166.70;3.48;717;3;442.00;25
684;3;620706477;684;123;1405;1426;10.42;0.64;166.77;3.51;721;3;443.00;21
687;3;620706486;687;118;1407;1426;10.36;0.64;166.94;3.52;720;3;444.00;19
692;3;620706495;692;114;1414;1426;10.32;0.63;167.71;3.56;722;3;445.00;12
694;3;620706505;694;115;1416;1426;10.36;0.63;167.71;3.58;722;3;446.00;10
697;3;620706514;697;116;1420;1430;10.25;0.63;168.37;3.59;723;3;447.00;10
701;3;620706524;701;114;1421;1430;10.23;0.62;168.72;3.59;720;3;448.00;9
706;3;620706533;706;109;1422;1430;10.29;0.63;169.35;3.59;716;3;449.00;8
709;3;620706543;709;114;1426;1436;10.30;0.63;169.99;3.58;717;3;450.00;10
712;3;620706553;712;114;1428;1436;10.25;0.62;170.13;3.61;716;3;451.00;8
712;3;620706563;712;112;1430;1436;10.29;0.63;170.13;3.62;718;3;452.00;6
713;3;620706572;713;115;1434;1440;10.28;0.63;170.02;3.62;721;3;453.00;6
717;3;620706581;717;115;1435;1441;10.31;0.63;170.49;3.61;718;3;454.00;6
722;3;620706591;722;118;1435;1441;10.32;0.63;170.79;3.61;713;3;455.00;6
724;3;620706600;724;122;1438;1445;10.38;0.63;170.90;3.61;714;3;456.00;7
729;3;620706615;729;124;1438;1445;10.34;0.63;171.40;3.61;709;3;457.00;7
732;3;620706624;732;124;1439;1445;10.38;0.63;171.86;3.61;707;3;458.00;6
734;3;620706633;734;121;1440;1446;10.34;0.63;171.96;3.61;706;3;459.00;6
737;3;620706642;737;125;1440;1446;10.31;0.62;172.29;3.61;703;3;460.00;6
739;3;620706652;739;128;1445;1452;10.26;0.62;172.49;3.62;706;3;461.00;7
740;3;620706661;740;134;1445;1452;10.16;0.62;172.64;3.62;705;3;462.00;7
742;3;620706670;742;130;1445;1453;10.08;0.61;173.04;3.62;703;3;463.00;8
743;3;620706679;743;133;1447;1453;9.94;0.60;173.18;3.66;704;3;464.00;6
746;3;620706687;746;132;1447;1453;9.83;0.60;173.06;3.66;701;3;465.00;6
747;3;620706696;747;132;1448;1453;9.77;0.59;173.12;3.67;701;3;466.00;5
748;3;620706705;748;138;1449;1453;9.73;0.59;173.03;3.67;701;3;467.00;4
749;3;620706713;749;145;1459;1465;9.78;0.60;173.23;3.64;710;3;468.00;6
751;3;620706722;751;144;1459;1465;9.80;0.60;173.15;3.64;708;3;469.00;6
753;3;620706731;753;147;1462;1465;9.86;0.60;173.09;3.66;709;3;470.00;3
755;3;620706740;755;148;1462;1465;9.90;0.60;173.49;3.66;707;3;471.00;3
756;3;620706749;756;150;1462;1465;9.99;0.61;173.63;3.66;706;3;472.00;3
758;3;620706758;758;158;1463;1465;10.00;0.61;173.75;3.67;705;3;473.00;2
760;3;620706766;760;158;1466;1469;10.01;0.61;173.59;3.66;706;3;474.00;3
763;3;620706775;763;162;1466;1469;10.03;0.61;173.82;3.66;703;3;475.00;3
764;3;620706784;764;169;1472;1473;10.04;0.62;173.79;3.66;708;3;476.00;1
764;3;620706794;764;170;1473;1474;10.07;0.62;173.79;3.66;709;3;477.00;1
767;3;620706808;767;170;1474;1474;10.07;0.62;174.23;3.66;707;3;478.00;0
770;3;620706816;770;174;1474;1474;10.07;0.62;174.75;3.66;704;3;479.00;0
772;3;620706826;772;181;1496;1500;10.02;0.62;174.47;3.61;724;3;480.00;4
776;3;620706836;776;186;1497;1500;9.91;0.61;174.93;3.61;721;3;481.00;3
780;3;620706845;780;186;1500;1500;9.80;0.60;174.93;3.60;720;3;482.00;0
783;3;620706853;783;189;1501;1501;9.77;0.60;175.00;3.60;718;3;483.00;0
786;3;620706862;786;196;1502;1502;9.74;0.60;174.93;3.60;716;3;484.00;0
789;3;620706870;789;201;1502;1502;9.73;0.60;175.01;3.60;713;3;485.00;0
791;3;620706878;791;207;1504;1505;9.70;0.59;175.07;3.60;713;3;486.00;1
792;3;620706887;792;212;1504;1505;9.65;0.59;175.19;3.60;712;3;487.00;1
795;3;620706895;795;220;1505;1505;9.55;0.59;175.64;3.59;710;3;488.00;0
796;3;620706904;796;216;1505;1505;9.46;0.58;176.01;3.59;709;3;489.00;0
800;3;620706912;800;216;1511;1511;9.41;0.58;176.08;3.58;711;3;490.00;0
802;3;620706921;802;215;1511;1511;9.22;0.57;176.04;3.58;709;3;491.00;0
805;3;620706929;805;215;1511;1511;9.10;0.56;176.10;3.58;706;3;492.00;0
806;3;620706937;806;215;1511;1511;9.03;0.55;175.96;3.58;705;3;493.00;0
810;3;620706945;810;224;1515;1515;8.95;0.55;176.08;3.58;705;3;494.00;0
814;3;620706953;814;225;1517;1517;8.90;0.54;176.10;3.57;703;3;495.00;0
816;3;620706961;816;231;1517;1517;8.91;0.54;176.12;3.57;701;3;496.00;0
818;3;620706969;818;228;1518;1518;8.92;0.55;175.96;3.57;700;3;497.00;0
820;3;620706977;820;232;1518;1518;8.94;0.55;176.03;3.57;698;3;498.00;0
823;3;620706985;823;232;1518;1518;8.94;0.55;175.90;3.57;695;3;499.00;0
823;3;620706993;823;238;1518;1518;8.93;0.55;175.90;3.57;695;3;500.00;0
826;3;620707004;826;240;1518;1518;8.90;0.54;175.80;3.57;692;3;501.00;0
831;3;620707012;831;242;1518;1518;8.79;0.54;175.78;3.57;687;3;502.00;0
832;3;620707020;832;246;1518;1518;8.67;0.53;175.82;3.57;686;3;503.00;0
838;3;620707027;838;257;1560;1588;8.63;0.53;175.93;3.48;722;3;504.00;28
842;3;620707039;842;255;1563;1589;8.47;0.52;176.37;3.47;721;3;505.00;26
843;3;620707046;843;254;1570;1589;8.38;0.51;176.65;3.46;727;3;506.00;19
847;3;620707054;847;254;1572;1589;8.22;0.50;176.79;3.46;725;3;507.00;17
852;3;620707061;852;261;1575;1589;8.07;0.49;177.38;3.46;723;3;508.00;14
856;3;620707068;856;266;1576;1589;7.90;0.48;177.42;3.47;720;3;509.00;13
860;3;620707077;860;257;1579;1589;7.83;0.48;177.54;3.47;719;3;510.00;10
861;3;620707084;861;253;1582;1589;7.84;0.48;177.83;3.48;721;3;511.00;7
863;3;620707091;863;251;1584;1590;7.76;0.47;178.39;3.48;721;3;512.00;6
864;3;620707098;864;251;1586;1591;7.68;0.47;178.36;3.49;722;3;513.00;5
868;3;620707108;868;253;1588;1591;7.53;0.46;178.68;3.50;720;3;514.00;3
870;3;620707126;870;258;1594;1595;7.41;0.45;178.77;3.50;724;3;515.00;1
871;3;620707141;871;264;1594;1595;7.25;0.44;178.66;3.50;723;3;516.00;1
873;3;620707149;873;259;1595;1595;7.16;0.44;178.86;3.50;722;3;517.00;0
875;3;620707157;875;260;1595;1595;7.09;0.43;178.65;3.50;720;3;518.00;0
877;3;620707164;877;258;1600;1601;7.08;0.43;179.14;3.49;723;3;519.00;1
879;3;620707173;879;259;1601;1601;7.02;0.43;179.76;3.49;722;3;520.00;0
880;3;620707180;880;262;1601;1601;7.02;0.43;179.80;3.49;721;3;521.00;0
882;3;620707188;882;261;1604;1604;7.04;0.43;180.22;3.48;722;3;522.00;0
884;3;620707196;884;252;1604;1604;7.01;0.43;180.65;3.48;720;3;523.00;0
886;3;620707204;886;243;1604;1604;7.04;0.43;180.61;3.48;718;3;524.00;0
888;3;620707212;888;238;1605;1605;7.05;0.43;180.98;3.48;717;3;525.00;0
889;3;620707221;889;240;1606;1606;7.15;0.44;180.92;3.48;717;3;526.00;0
893;3;620707229;893;237;1606;1606;7.24;0.44;181.23;3.48;713;3;527.00;0
897;3;620707237;897;239;1618;1619;7.39;0.45;180.77;3.45;721;3;528.00;1
899;3;620707246;899;238;1618;1619;7.39;0.45;180.92;3.45;719;3;529.00;1
900;3;620707264;900;242;1619;1619;7.47;0.46;180.75;3.45;719;3;530.00;0
903;3;620707272;903;245;1620;1620;7.55;0.46;181.31;3.45;717;3;531.00;0
905;3;620707280;905;243;1620;1620;7.62;0.47;181.39;3.45;715;3;532.00;0
909;3;620707289;909;241;1624;1624;7.68;0.47;181.89;3.44;715;3;533.00;0
911;3;620707297;911;243;1624;1624;7.67;0.47;181.95;3.44;713;3;534.00;0
915;3;620707306;915;237;1628;1628;7.66;0.47;182.04;3.44;713;3;535.00;0
918;3;620707315;918;238;1628;1628;7.70;0.47;182.21;3.44;710;3;536.00;0
919;3;620707323;919;243;1628;1628;7.75;0.47;182.08;3.44;709;3;537.00;0
921;3;620707332;921;241;1628;1628;7.75;0.47;182.19;3.44;707;3;538.00;0
924;3;620707340;924;241;1628;1628;7.69;0.47;182.24;3.44;704;3;539.00;0
926;3;620707350;926;247;1658;1662;7.85;0.48;182.42;3.38;732;3;540.00;4
928;3;620707361;928;243;1658;1662;7.94;0.49;182.73;3.38;730;3;541.00;4
929;3;620707375;929;238;1661;1662;8.05;0.49;182.58;3.37;732;3;542.00;1
933;3;620707390;933;231;1661;1662;8.09;0.50;182.68;3.37;728;3;543.00;1
938;3;620707408;938;233;1662;1662;8.13;0.50;182.69;3.37;724;3;544.00;0
940;3;620707425;940;234;1662;1662;8.16;0.50;182.85;3.37;722;3;545.00;0
943;3;620707438;943;234;1663;1663;8.16;0.50;182.96;3.37;720;3;546.00;0
945;3;620707451;945;235;1663;1663;8.13;0.50;183.35;3.37;718;3;547.00;0
946;3;620707465;946;232;1669;1669;8.12;0.50;183.18;3.36;723;3;548.00;0
948;3;620707481;948;232;1670;1670;8.12;0.50;183.21;3.36;722;3;549.00;0
951;3;620707492;951;233;1670;1670;8.05;0.49;183.26;3.36;719;3;550.00;0
953;3;620707501;953;234;1670;1670;8.04;0.49;183.27;3.36;717;3;551.00;0
958;3;620707511;958;234;1674;1674;7.94;0.48;183.59;3.35;716;3;552.00;0
959;3;620707521;959;240;1674;1674;7.94;0.48;183.60;3.35;715;3;553.00;0
960;3;620707531;960;247;1674;1674;7.92;0.48;183.73;3.35;714;3;554.00;0
962;3;620707540;962;243;1675;1675;7.87;0.48;183.90;3.35;713;3;555.00;0
964;3;620707549;964;244;1679;1679;7.87;0.48;184.13;3.35;715;3;556.00;0
964;3;620707565;964;238;1679;1679;7.85;0.48;184.13;3.35;715;3;557.00;0
969;3;620707574;969;232;1681;1682;7.81;0.48;184.29;3.34;712;3;558.00;1
970;3;620707584;970;231;1681;1682;7.79;0.48;184.34;3.34;711;3;559.00;1
972;3;620707594;972;227;1682;1682;7.77;0.47;184.37;3.34;710;3;560.00;0
974;3;620707603;974;223;1682;1682;7.80;0.48;184.60;3.34;708;3;561.00;0
978;3;620707613;978;230;1686;1686;7.83;0.48;185.16;3.34;708;3;562.00;0
980;3;620707623;980;225;1686;1686;7.83;0.48;185.20;3.34;706;3;563.00;0
983;3;620707632;983;223;1686;1686;7.88;0.48;185.21;3.34;703;3;564.00;0
986;4;620707642;986;224;1686;1686;7.91;0.48;185.49;3.34;700;4;565.00;0
986;4;620707663;986;215;1687;1687;7.97;0.49;185.49;3.33;701;4;566.00;0
990;4;620707672;990;209;1688;1688;8.07;0.49;185.75;3.33;698;4;567.00;0
995;4;620707682;995;209;1688;1688;8.11;0.49;186.48;3.33;693;4;568.00;0
996;4;620707692;996;204;1689;1689;8.23;0.50;186.43;3.33;693;4;569.00;0
1000;4;620707703;1000;201;1689;1689;8.25;0.50;186.82;3.33;689;4;570.00;0
1003;4;620707719;1003;203;1689;1689;8.28;0.51;187.55;3.33;686;4;571.00;0
1008;4;620707729;1008;201;1689;1689;8.37;0.51;187.87;3.33;681;4;572.00;0
1011;4;620707739;1011;206;1689;1689;8.44;0.51;188.65;3.33;678;4;573.00;0
1013;4;620707748;1013;207;1689;1689;8.48;0.52;188.95;3.33;676;4;574.00;0
1017;4;620707758;1017;208;1689;1689;8.49;0.52;189.63;3.33;672;4;575.00;0
1019;4;620707767;1019;238;1770;1816;8.59;0.53;189.80;3.18;751;4;576.00;46
1021;4;620707788;1021;225;1773;1817;8.64;0.54;190.02;3.18;752;4;577.00;44
1026;4;620707799;1026;209;1779;1817;8.68;0.54;190.34;3.17;753;4;578.00;38
1028;4;620707809;1028;202;1780;1817;8.76;0.54;190.39;3.17;752;4;579.00;37
1030;4;620707819;1030;195;1784;1817;8.85;0.55;190.71;3.17;754;4;580.00;33
1031;4;620707829;1031;195;1784;1817;8.81;0.54;190.76;3.17;753;4;581.00;33
1034;4;620707838;1034;200;1788;1817;8.85;0.54;191.28;3.18;754;4;582.00;29
1035;4;620707849;1035;197;1789;1817;8.88;0.55;191.29;3.18;754;4;583.00;28
1037;4;620707858;1037;200;1792;1818;8.84;0.54;191.42;3.19;755;4;584.00;26
1037;4;620707869;1037;209;1797;1820;8.81;0.54;191.42;3.20;760;4;585.00;23
1038;4;620707878;1038;214;1800;1820;8.77;0.54;191.68;3.21;762;4;586.00;20
1044;4;620707888;1044;214;1804;1821;8.76;0.53;191.84;3.23;760;4;587.00;17
1048;4;620707898;1048;224;1805;1821;8.70;0.53;192.16;3.23;757;4;588.00;16
1049;4;620707908;1049;216;1808;1821;8.71;0.53;192.40;3.25;759;4;589.00;13
1051;4;620707918;1051;220;1809;1821;8.65;0.53;192.60;3.25;758;4;590.00;12
1051;4;620707928;1051;226;1817;1825;8.61;0.53;192.60;3.29;766;4;591.00;8
1052;4;620707939;1052;226;1817;1825;8.63;0.53;192.63;3.29;765;4;592.00;8
1052;4;620707949;1052;233;1819;1825;8.65;0.53;192.63;3.30;767;4;593.00;6
1053;4;620707965;1053;242;1822;1828;8.62;0.53;192.73;3.31;769;4;594.00;6
1054;4;620707976;1054;245;1823;1828;8.63;0.53;192.83;3.31;769;4;595.00;5
1055;4;620707986;1055;240;1824;1828;8.59;0.52;192.93;3.32;769;4;596.00;4
1056;4;620707996;1056;243;1829;1832;8.58;0.52;192.97;3.32;773;4;597.00;3
1056;4;620708008;1056;243;1831;1833;8.61;0.52;192.97;3.32;775;4;598.00;2
1057;4;620708021;1057;241;1832;1833;8.63;0.52;192.81;3.33;775;4;599.00;1
1058;4;620708036;1058;245;1844;1859;8.59;0.52;192.82;3.31;786;4;600.00;15
1059;4;620708055;1059;229;1846;1859;8.71;0.53;192.70;3.30;787;4;601.00;13
1062;4;620708066;1062;226;1846;1859;8.77;0.53;192.84;3.30;784;4;602.00;13
1063;4;620708076;1063;223;1847;1860;8.86;0.54;192.95;3.30;784;4;603.00;13
1063;4;620708086;1063;219;1848;1860;8.94;0.54;192.95;3.30;785;4;604.00;12
1067;4;620708096;1067;218;1853;1866;8.98;0.55;193.53;3.30;786;4;605.00;13
1070;4;620708108;1070;217;1856;1866;9.01;0.55;193.95;3.30;786;4;606.00;10
1072;4;620708119;1072;217;1857;1867;9.03;0.55;194.20;3.30;785;4;607.00;10
1075;4;620708129;1075;214;1857;1867;9.07;0.55;194.81;3.30;782;4;608.00;10
1079;4;620708140;1079;209;1858;1867;8.97;0.55;195.27;3.30;779;4;609.00;9
1083;4;620708150;1083;205;1858;1867;8.97;0.55;195.88;3.30;775;4;610.00;9
1083;4;620708159;1083;204;1858;1867;8.97;0.55;195.88;3.30;775;4;611.00;9
1088;4;620708167;1088;196;1870;1879;8.88;0.54;196.74;3.29;782;4;612.00;9
1091;4;620708178;1091;192;1870;1879;8.81;0.54;197.13;3.29;779;4;613.00;9
1093;4;620708188;1093;195;1870;1879;8.79;0.54;197.31;3.29;777;4;614.00;9
1094;4;620708204;1094;192;1871;1879;8.81;0.54;197.29;3.29;777;4;615.00;8
1098;4;620708213;1098;194;1871;1879;8.81;0.54;197.85;3.29;773;4;616.00;8
1101;4;620708222;1101;193;1871;1879;8.82;0.54;198.57;3.29;770;4;617.00;8
1104;4;620708231;1104;189;1876;1883;8.80;0.54;198.81;3.30;772;4;618.00;7
1108;4;620708241;1108;193;1876;1883;8.82;0.54;199.07;3.30;768;4;619.00;7
1111;5;620708251;1111;189;1881;1887;8.87;0.54;198.95;3.30;770;5;620.00;6
1114;5;620708279;1114;183;1882;1888;8.94;0.54;199.46;3.30;768;5;621.00;6
1118;5;620708289;1118;183;1882;1888;8.88;0.54;199.59;3.30;764;5;622.00;6
1120;5;620708299;1120;184;1882;1888;8.90;0.54;199.63;3.30;762;5;623.00;6
1122;5;620708308;1122;185;1891;1901;8.84;0.54;199.71;3.30;769;5;624.00;10
1128;5;620708319;1128;180;1891;1901;8.84;0.54;199.84;3.30;763;5;625.00;10
1130;5;620708329;1130;183;1891;1901;8.87;0.54;200.04;3.30;761;5;626.00;10
1133;5;620708338;1133;181;1893;1902;8.86;0.54;200.63;3.31;760;5;627.00;9
1133;5;620708347;1133;186;1893;1903;8.87;0.54;200.63;3.31;760;5;628.00;10
1135;5;620708356;1135;187;1893;1903;8.86;0.54;200.99;3.31;758;5;629.00;10
1136;5;620708369;1136;186;1899;1909;8.87;0.54;201.05;3.32;763;5;630.00;10
1139;5;620708378;1139;191;1900;1909;8.87;0.54;201.17;3.32;761;5;631.00;9
1145;5;620708389;1145;194;1902;1909;8.84;0.54;201.15;3.32;757;5;632.00;7
1148;5;620708399;1148;195;1903;1909;8.77;0.53;201.05;3.34;755;5;633.00;6
1148;5;620708411;1148;197;1908;1915;8.78;0.53;201.05;3.33;760;5;634.00;7
1149;5;620708422;1149;197;1908;1915;8.66;0.53;201.01;3.33;759;5;635.00;7
1149;5;620708431;1149;201;1908;1915;8.53;0.52;201.01;3.33;759;5;636.00;7
1151;5;620708440;1151;208;1908;1915;8.41;0.51;200.89;3.33;757;5;637.00;7
1153;5;620708448;1153;213;1911;1919;8.32;0.51;200.90;3.33;758;5;638.00;8
1154;5;620708458;1154;220;1914;1920;8.29;0.50;200.96;3.35;760;5;639.00;6
1155;5;620708467;1155;233;1915;1920;8.20;0.50;200.88;3.35;760;5;640.00;5
1155;5;620708475;1155;241;1918;1921;8.19;0.50;200.88;3.37;763;5;641.00;3
1156;5;620708484;1156;245;1918;1921;8.17;0.50;200.87;3.37;762;5;642.00;3
1156;5;620708492;1156;251;1919;1921;8.11;0.50;200.87;3.37;763;5;643.00;2
1159;5;620708501;1159;254;1919;1921;8.05;0.49;200.77;3.37;760;5;644.00;2
1164;5;620708509;1164;266;1921;1921;8.01;0.49;200.69;3.38;757;5;645.00;0
1165;5;620708518;1165;269;1921;1921;7.96;0.49;200.66;3.38;756;5;646.00;0
1166;5;620708526;1166;274;1921;1921;7.87;0.48;200.63;3.38;755;5;647.00;0
1168;5;620708534;1168;286;1959;1991;7.98;0.49;200.52;3.32;791;5;648.00;32
1169;5;620708548;1169;287;1961;1992;7.95;0.49;200.41;3.32;792;5;649.00;31
1171;5;620708557;1171;285;1970;1992;7.91;0.49;200.32;3.31;799;5;650.00;22
1173;5;620708565;1173;288;1973;1992;7.88;0.48;200.14;3.31;800;5;651.00;19
1174;5;620708573;1174;292;1976;1992;7.82;0.48;200.07;3.31;802;5;652.00;16
1177;5;620708581;1177;295;1976;1992;7.76;0.48;200.01;3.31;799;5;653.00;16
1177;5;620708590;1177;294;1978;1992;7.74;0.48;200.01;3.31;801;5;654.00;14
1177;5;620708598;1177;295;1980;1992;7.69;0.47;200.01;3.32;803;5;655.00;12
1180;5;620708606;1180;300;1982;1993;7.60;0.47;199.74;3.32;802;5;656.00;11
1182;5;620708614;1182;305;1984;1994;7.50;0.46;199.63;3.33;802;5;657.00;10
1183;5;620708622;1183;303;1986;1994;7.46;0.46;199.53;3.33;803;5;658.00;8
1185;5;620708631;1185;295;1992;1998;7.32;0.45;199.31;3.33;807;5;659.00;6
1188;5;620708641;1188;290;1993;1998;7.23;0.44;199.39;3.34;805;5;660.00;5
1189;5;620708649;1189;297;1994;1998;7.20;0.44;199.40;3.34;805;5;661.00;4
1192;5;620708657;1192;298;1995;1998;7.15;0.44;199.42;3.35;803;5;662.00;3
1196;5;620708666;1196;299;2001;2004;7.06;0.43;199.42;3.35;805;5;663.00;3
1199;5;620708676;1199;298;2002;2004;6.99;0.43;199.14;3.35;803;5;664.00;2
1201;5;620708687;1201;303;2003;2004;6.92;0.42;199.01;3.36;802;5;665.00;1
1204;5;620708696;1204;307;2006;2007;6.90;0.42;199.03;3.35;802;5;666.00;1
1204;5;620708705;1204;309;2007;2007;6.89;0.42;199.03;3.35;803;5;667.00;0
1204;5;620708713;1204;318;2007;2007;6.87;0.42;199.03;3.35;803;5;668.00;0
1208;5;620708721;1208;322;2008;2008;6.77;0.41;198.87;3.35;800;5;669.00;0
1211;5;620708729;1211;325;2009;2009;6.72;0.41;199.05;3.35;798;5;670.00;0
1211;5;620708737;1211;329;2009;2009;6.69;0.41;199.05;3.35;798;5;671.00;0
1212;5;620708744;1212;334;2022;2022;6.65;0.41;199.14;3.33;810;5;672.00;0
1215;5;620708753;1215;337;2022;2022;6.56;0.40;198.94;3.33;807;5;673.00;0
1219;5;620708760;1219;344;2022;2022;6.45;0.39;198.89;3.33;803;5;674.00;0
1224;5;620708768;1224;329;2024;2024;6.39;0.39;198.86;3.33;800;5;675.00;0
1225;5;620708776;1225;317;2024;2024;6.31;0.39;198.92;3.33;799;5;676.00;0
1233;5;620708783;1233;311;2028;2028;6.29;0.38;199.06;3.32;795;5;677.00;0
1235;5;620708792;1235;307;2028;2028;6.27;0.38;199.21;3.32;793;5;678.00;0
1237;5;620708800;1237;310;2032;2032;6.23;0.38;199.38;3.32;795;5;679.00;0
1239;5;620708808;1239;292;2032;2032;6.27;0.38;199.69;3.32;793;5;680.00;0
1240;5;620708817;1240;284;2032;2032;6.32;0.39;199.73;3.32;792;5;681.00;0
1243;5;620708825;1243;277;2032;2032;6.35;0.39;199.88;3.32;789;5;682.00;0
1247;5;620708833;1247;269;2032;2032;6.39;0.39;199.85;3.32;785;5;683.00;0
1248;6;620708841;1248;270;2043;2044;6.56;0.40;199.81;3.30;795;6;684.00;1
1254;6;620708858;1254;274;2043;2044;6.66;0.41;199.57;3.30;789;6;685.00;1
1256;6;620708872;1256;274;2044;2044;6.67;0.41;200.02;3.30;788;6;686.00;0
1257;6;620708885;1257;263;2044;2044;6.80;0.42;200.15;3.30;787;6;687.00;0
1260;6;620708894;1260;264;2044;2044;6.82;0.42;200.57;3.30;784;6;688.00;0
1262;6;620708902;1262;253;2044;2044;6.91;0.42;200.74;3.30;782;6;689.00;0
1264;6;620708913;1264;252;2045;2045;7.00;0.43;200.96;3.30;781;6;690.00;0
1265;6;620708922;1265;242;2045;2045;7.13;0.44;201.12;3.30;780;6;691.00;0
1267;6;620708931;1267;245;2051;2051;7.25;0.44;201.51;3.29;784;6;692.00;0
1268;6;620708940;1268;248;2052;2052;7.39;0.45;201.70;3.29;784;6;693.00;0
1270;6;620708949;1270;247;2052;2052;7.49;0.46;201.92;3.29;782;6;694.00;0
1274;6;620708959;1274;247;2052;2052;7.57;0.46;202.26;3.29;778;6;695.00;0
1278;6;620708968;1278;247;2055;2056;7.63;0.47;202.27;3.28;777;6;696.00;1
1281;6;620708978;1281;241;2056;2056;7.74;0.47;202.59;3.28;775;6;697.00;0
1287;6;620708987;1287;236;2056;2056;7.78;0.47;202.63;3.28;769;6;698.00;0
1289;6;620708996;1289;238;2057;2057;7.84;0.48;202.71;3.28;768;6;699.00;0
1293;6;620709006;1293;238;2061;2061;7.84;0.48;202.95;3.28;768;6;700.00;0
1295;6;620709021;1295;239;2061;2061;7.78;0.47;203.09;3.28;766;6;701.00;0
1302;6;620709030;1302;235;2063;2064;7.67;0.47;203.52;3.27;761;6;702.00;1
1305;6;620709040;1305;236;2063;2064;7.64;0.46;203.42;3.27;758;6;703.00;1
1311;6;620709049;1311;238;2064;2064;7.61;0.46;203.61;3.27;753;6;704.00;0
1316;6;620709058;1316;238;2064;2064;7.58;0.46;204.17;3.27;748;6;705.00;0
1318;6;620709068;1318;234;2068;2068;7.66;0.47;204.30;3.27;750;6;706.00;0
1323;6;620709077;1323;236;2068;2068;7.68;0.47;204.62;3.27;745;6;707.00;0
1327;6;620709087;1327;234;2068;2068;7.68;0.47;205.17;3.27;741;6;708.00;0
1331;6;620709096;1331;232;2068;2068;7.68;0.47;205.42;3.27;737;6;709.00;0
1333;6;620709105;1333;234;2069;2069;7.71;0.47;205.85;3.27;736;6;710.00;0
1336;6;620709115;1336;231;2070;2070;7.82;0.48;205.98;3.27;734;6;711.00;0
1338;6;620709125;1338;226;2070;2070;7.89;0.48;206.33;3.27;732;6;712.00;0
1344;6;620709134;1344;229;2071;2071;7.94;0.48;206.88;3.26;727;6;713.00;0
1350;6;620709144;1350;222;2071;2071;7.93;0.48;207.39;3.26;721;6;714.00;0
1356;6;620709154;1356;226;2071;2071;7.94;0.48;207.66;3.26;715;6;715.00;0
1360;6;620709163;1360;226;2071;2071;7.99;0.49;207.96;3.26;711;6;716.00;0
1362;6;620709173;1362;228;2071;2071;8.03;0.49;208.07;3.26;709;6;717.00;0
1366;6;620709181;1366;222;2071;2071;8.01;0.49;208.33;3.26;705;6;718.00;0
1368;6;620709190;1368;217;2071;2071;8.05;0.49;208.21;3.26;703;6;719.00;0
1372;6;620709201;1372;258;2196;2301;8.15;0.51;208.75;3.08;824;6;720.00;105
1376;6;620709229;1376;253;2206;2302;8.14;0.51;209.18;3.07;830;6;721.00;96
1378;6;620709239;1378;241;2219;2302;8.19;0.51;209.29;3.06;841;6;722.00;83
1381;6;620709249;1381;242;2227;2302;8.15;0.51;209.81;3.06;846;6;723.00;75
1383;6;620709259;1383;239;2234;2302;8.14;0.51;210.20;3.07;851;6;724.00;68
1386;6;620709268;1386;242;2236;2302;8.06;0.50;210.34;3.07;850;6;725.00;66
1387;6;620709278;1387;241;2242;2302;7.96;0.50;210.46;3.08;855;6;726.00;60
1389;6;620709288;1389;237;2247;2302;7.89;0.49;210.53;3.09;858;6;727.00;55
1394;6;620709299;1394;237;2253;2303;7.82;0.49;210.70;3.10;859;6;728.00;50
1395;6;620709310;1395;237;2257;2304;7.75;0.48;210.93;3.11;862;6;729.00;47
1397;6;620709320;1397;241;2261;2304;7.70;0.48;211.00;3.12;864;6;730.00;43
1401;6;620709331;1401;243;2267;2305;7.63;0.47;210.95;3.14;866;6;731.00;38
1402;6;620709341;1402;247;2272;2305;7.59;0.47;211.01;3.16;870;6;732.00;33
1404;6;620709351;1404;249;2272;2305;7.57;0.47;211.10;3.16;868;6;733.00;33
1406;6;620709362;1406;255;2276;2305;7.62;0.47;211.22;3.18;870;6;734.00;29
1410;6;620709377;1410;262;2278;2309;7.59;0.47;211.34;3.17;868;6;735.00;31
1412;6;620709404;1412;263;2281;2309;7.55;0.46;211.32;3.19;869;6;736.00;28
1415;6;620709423;1415;263;2281;2309;7.52;0.46;211.22;3.19;866;6;737.00;28
1418;6;620709442;1418;264;2282;2312;7.50;0.46;211.52;3.20;864;6;738.00;30
1420;6;620709459;1420;259;2284;2312;7.53;0.46;211.59;3.21;864;6;739.00;28
1423;6;620709476;1423;254;2284;2312;7.54;0.46;211.78;3.21;861;6;740.00;28
1425;6;620709489;1425;264;2291;2316;7.52;0.46;211.72;3.23;866;6;741.00;25
1427;6;620709500;1427;267;2292;2317;7.53;0.46;211.74;3.24;865;6;742.00;25
1429;6;620709513;1429;269;2293;2317;7.55;0.46;211.60;3.25;864;6;743.00;24
1431;6;620709525;1431;278;2297;2321;7.50;0.46;211.76;3.26;866;6;744.00;24
1432;6;620709537;1432;289;2298;2321;7.48;0.46;211.78;3.26;866;6;745.00;23
1434;6;620709549;1434;288;2299;2321;7.54;0.46;211.72;3.27;865;6;746.00;22
1436;6;620709562;1436;290;2301;2322;7.54;0.46;211.95;3.29;865;6;747.00;21
1436;6;620709574;1436;284;2302;2322;7.59;0.46;211.95;3.29;866;6;748.00;20
1438;6;620709586;1438;284;2309;2328;7.59;0.46;212.10;3.31;871;6;749.00;19
1439;6;620709601;1439;278;2310;2328;7.70;0.47;212.15;3.31;871;6;750.00;18
1441;6;620709614;1441;271;2312;2329;7.71;0.47;212.29;3.31;871;6;751.00;17
1443;6;620709626;1443;268;2314;2329;7.70;0.47;212.37;3.33;871;6;752.00;15
1445;6;620709637;1445;265;2314;2329;7.76;0.48;212.53;3.33;869;6;753.00;15
1448;6;620709648;1448;266;2314;2329;7.79;0.48;212.91;3.33;866;6;754.00;15
1450;6;620709659;1450;260;2315;2329;7.88;0.48;213.10;3.34;865;6;755.00;14
1454;6;620709671;1454;262;2325;2341;7.96;0.49;213.25;3.34;871;6;756.00;16
1457;6;620709683;1457;260;2326;2341;8.02;0.49;213.30;3.34;869;6;757.00;15
1460;6;620709694;1460;261;2329;2341;8.00;0.49;213.51;3.35;869;6;758.00;12
1461;6;620709705;1461;258;2329;2341;8.10;0.50;213.53;3.35;868;6;759.00;12
1464;6;620709715;1464;257;2330;2341;8.16;0.50;213.77;3.36;866;6;760.00;11
1464;6;620709727;1464;255;2331;2341;8.18;0.50;213.77;3.36;867;6;761.00;10
1467;6;620709738;1467;254;2336;2345;8.12;0.50;213.84;3.35;869;6;762.00;9
1468;6;620709749;1468;253;2336;2345;8.17;0.50;213.84;3.35;868;6;763.00;9
1470;6;620709777;1470;256;2340;2349;8.21;0.50;213.88;3.35;870;6;764.00;9
1472;6;620709789;1472;261;2342;2351;8.21;0.50;213.94;3.35;870;6;765.00;9
1474;6;620709807;1474;263;2342;2351;8.20;0.50;213.90;3.35;868;6;766.00;9
1476;6;620709818;1476;269;2342;2351;8.18;0.50;214.01;3.35;866;6;767.00;9
1478;6;620709828;1478;275;2351;2364;8.14;0.50;214.01;3.33;873;6;768.00;13
1479;6;620709840;1479;277;2351;2364;8.10;0.49;213.93;3.33;872;6;769.00;13
1480;6;620709850;1480;271;2352;2364;8.04;0.49;213.95;3.33;872;6;770.00;12
1482;6;620709860;1482;268;2353;2365;8.00;0.49;213.94;3.33;871;6;771.00;12
1482;6;620709871;1482;266;2353;2366;7.99;0.49;213.94;3.33;871;6;772.00;13
1483;6;620709881;1483;266;2353;2366;7.94;0.49;214.02;3.33;870;6;773.00;13
1483;6;620709891;1483;262;2355;2369;7.96;0.49;214.02;3.33;872;6;774.00;14
1485;6;620709901;1485;259;2355;2369;7.93;0.48;214.38;3.33;870;6;775.00;14
1487;6;620709912;1487;258;2356;2369;7.90;0.48;214.54;3.33;869;6;776.00;13
1489;6;620709923;1489;267;2356;2369;7.88;0.48;214.56;3.33;867;6;777.00;13
1494;6;620709933;1494;262;2361;2375;7.90;0.48;214.95;3.32;867;6;778.00;14
1496;6;620709945;1496;261;2361;2375;7.85;0.48;215.07;3.32;865;6;779.00;14
1499;6;620709957;1499;262;2361;2375;7.73;0.47;214.96;3.32;862;6;780.00;14
1503;6;620709967;1503;260;2361;2375;7.62;0.46;215.29;3.32;858;6;781.00;14
1505;6;620709978;1505;256;2364;2379;7.46;0.45;215.53;3.32;859;6;782.00;15
1509;6;620709988;1509;255;2365;2380;7.39;0.45;215.85;3.32;856;6;783.00;15
1510;6;620709998;1510;258;2365;2380;7.37;0.45;215.99;3.32;855;6;784.00;15
1513;6;620710007;1513;254;2366;2381;7.38;0.45;216.26;3.32;853;6;785.00;15
1514;6;620710018;1514;253;2368;2381;7.36;0.45;216.44;3.33;854;6;786.00;13
1517;6;620710028;1517;247;2368;2381;7.33;0.44;216.54;3.33;851;6;787.00;13
1518;6;620710038;1518;249;2368;2381;7.38;0.45;216.47;3.33;850;6;788.00;13
1518;6;620710048;1518;251;2368;2381;7.42;0.45;216.47;3.33;850;6;789.00;13
1519;6;620710058;1519;254;2368;2381;7.45;0.45;216.73;3.33;849;6;790.00;13
1523;6;620710068;1523;258;2368;2381;7.48;0.45;216.79;3.33;845;6;791.00;13
1525;6;620710078;1525;265;2399;2451;7.63;0.47;216.71;3.29;874;6;792.00;52
1525;6;620710095;1525;260;2399;2452;7.69;0.47;216.71;3.29;874;6;793.00;53
1526;6;620710105;1526;259;2406;2452;7.80;0.48;216.62;3.28;880;6;794.00;46
1528;6;620710122;1528;261;2407;2452;7.85;0.48;216.43;3.28;879;6;795.00;45
1529;6;620710132;1529;262;2411;2452;7.89;0.48;216.42;3.28;882;6;796.00;41
1530;6;620710142;1530;268;2414;2452;7.88;0.48;216.33;3.32;884;6;797.00;38
1533;6;620710152;1533;267;2418;2452;7.90;0.48;216.38;3.32;885;6;798.00;34
1537;6;620710169;1537;267;2421;2452;7.86;0.48;216.15;3.33;884;6;799.00;31
1538;6;620710181;1538;275;2427;2453;7.81;0.48;216.05;3.37;889;6;800.00;26
1540;6;620710196;1540;277;2429;2454;7.80;0.47;215.88;3.37;889;6;801.00;25
1542;6;620710207;1542;279;2433;2454;7.74;0.47;215.70;3.41;891;6;802.00;21
1542;6;620710217;1542;285;2438;2458;7.70;0.47;215.70;3.41;896;6;803.00;20
1544;6;620710227;1544;285;2442;2458;7.62;0.46;215.57;3.45;898;6;804.00;16
1547;6;620710238;1547;288;2442;2458;7.60;0.46;215.57;3.45;895;6;805.00;16
1550;6;620710248;1550;292;2443;2458;7.50;0.46;215.36;3.49;893;6;806.00;15
1551;6;620710259;1551;296;2448;2464;7.46;0.45;215.26;3.48;897;6;807.00;16
1553;6;620710271;1553;295;2449;2464;7.42;0.45;215.33;3.52;896;6;808.00;15
1554;6;620710282;1554;306;2449;2464;7.41;0.45;215.21;3.52;895;6;809.00;15
1556;6;620710295;1556;313;2455;2470;7.38;0.45;215.30;3.56;899;6;810.00;15
1556;6;620710307;1556;318;2455;2470;7.30;0.45;215.30;3.56;899;6;811.00;15
1559;6;620710319;1559;322;2460;2470;7.26;0.44;215.01;3.61;901;6;812.00;10
1561;6;620710331;1561;334;2463;2471;7.19;0.44;215.02;3.66;902;6;813.00;8
1561;6;620710342;1561;342;2464;2472;7.17;0.44;215.02;3.66;903;6;814.00;8
1564;6;620710353;1564;351;2467;2472;7.06;0.43;214.93;3.69;903;6;815.00;5
1565;6;620710364;1565;359;2476;2485;6.99;0.43;214.85;3.67;911;6;816.00;9
1567;6;620710378;1567;361;2477;2485;6.93;0.42;214.80;3.69;910;6;817.00;8
1570;6;620710389;1570;373;2477;2485;6.88;0.42;214.66;3.69;907;6;818.00;8
1572;6;620710399;1572;379;2480;2486;6.87;0.42;214.73;3.70;908;6;819.00;6
1573;6;620710408;1573;387;2483;2486;6.81;0.42;214.83;3.72;910;6;820.00;3
1577;6;620710419;1577;391;2488;2490;6.75;0.41;214.71;3.71;911;6;821.00;2
1580;6;620710429;1580;399;2488;2490;6.68;0.41;214.68;3.71;908;6;822.00;2
1583;6;620710438;1583;399;2493;2494;6.56;0.40;214.42;3.71;910;6;823.00;1
1584;6;620710448;1584;404;2493;2494;6.48;0.40;214.36;3.71;909;6;824.00;1
1586;6;620710457;1586;409;2494;2494;6.40;0.39;214.37;3.71;908;6;825.00;0
1586;6;620710467;1586;413;2494;2494;6.33;0.39;214.37;3.71;908;6;826.00;0
1588;6;620710476;1588;399;2494;2494;6.22;0.38;214.20;3.71;906;6;827.00;0
1588;6;620710485;1588;393;2503;2506;6.21;0.38;214.20;3.70;915;6;828.00;3
1590;6;620710495;1590;387;2506;2506;6.14;0.38;214.17;3.70;916;6;829.00;0
1592;6;620710505;1592;372;2506;2506;6.11;0.37;214.14;3.70;914;6;830.00;0
1592;6;620710515;1592;364;2506;2506;6.17;0.38;214.14;3.70;914;6;831.00;0
1592;6;620710524;1592;360;2506;2506;6.24;0.38;214.14;3.70;914;6;832.00;0
1593;6;620710533;1593;356;2506;2506;6.33;0.39;214.16;3.70;913;6;833.00;0
1593;6;620710543;1593;353;2507;2507;6.41;0.39;214.16;3.69;914;6;834.00;0
1593;6;620710552;1593;355;2507;2507;6.51;0.40;214.16;3.69;914;6;835.00;0
1594;6;620710561;1594;358;2513;2513;6.63;0.41;214.27;3.69;919;6;836.00;0
1595;6;620710572;1595;355;2514;2514;6.70;0.41;214.21;3.69;919;6;837.00;0
1598;6;620710582;1598;353;2514;2514;6.73;0.41;214.27;3.69;916;6;838.00;0
1599;6;620710592;1599;349;2514;2514;6.74;0.41;214.25;3.69;915;6;839.00;0
1602;6;620710609;1602;348;2519;2519;6.67;0.41;214.23;3.68;917;6;840.00;0
1604;7;620710625;1604;343;2519;2519;6.64;0.41;214.21;3.68;915;7;841.00;0
1608;7;620710655;1608;343;2519;2519;6.58;0.40;214.24;3.68;911;7;842.00;0
1609;7;620710665;1609;343;2520;2520;6.52;0.40;214.27;3.68;911;7;843.00;0
1612;7;620710676;1612;346;2524;2524;6.49;0.40;214.33;3.67;912;7;844.00;0
1615;7;620710685;1615;339;2524;2524;6.48;0.40;214.72;3.67;909;7;845.00;0
1617;7;620710695;1617;337;2526;2527;6.49;0.40;214.63;3.67;909;7;846.00;1
1619;7;620710705;1619;333;2527;2527;6.47;0.40;214.89;3.67;908;7;847.00;0
1621;7;620710716;1621;330;2527;2527;6.47;0.40;215.15;3.67;906;7;848.00;0
1624;7;620710732;1624;340;2527;2527;6.47;0.40;215.32;3.67;903;7;849.00;0
1630;7;620710742;1630;326;2531;2531;6.46;0.40;215.74;3.67;901;7;850.00;0
1630;7;620710752;1630;316;2531;2531;6.54;0.40;215.74;3.67;901;7;851.00;0
1634;7;620710763;1634;315;2531;2531;6.59;0.40;215.86;3.67;897;7;852.00;0
1640;7;620710773;1640;303;2531;2531;6.57;0.40;215.96;3.67;891;7;853.00;0
1643;7;620710783;1643;299;2532;2532;6.55;0.40;216.21;3.66;889;7;854.00;0
1647;7;620710792;1647;301;2534;2534;6.58;0.40;216.33;3.66;887;7;855.00;0
1651;7;620710803;1651;296;2534;2534;6.61;0.41;216.56;3.66;883;7;856.00;0
1655;7;620710812;1655;291;2535;2535;6.69;0.41;216.90;3.66;880;7;857.00;0
1656;7;620710822;1656;287;2535;2535;6.79;0.41;216.90;3.66;879;7;858.00;0
1662;7;620710831;1662;281;2535;2535;6.82;0.42;217.36;3.66;873;7;859.00;0
1665;7;620710841;1665;277;2535;2535;6.88;0.42;217.54;3.66;870;7;860.00;0
1668;7;620710851;1668;269;2535;2535;6.92;0.42;217.82;3.66;867;7;861.00;0
1674;7;620710860;1674;263;2535;2535;6.93;0.42;218.68;3.66;861;7;862.00;0
1676;7;620710870;1676;255;2535;2535;6.98;0.42;218.89;3.66;859;7;863.00;0
1679;7;620710879;1679;273;2620;2662;7.19;0.44;218.93;3.54;941;7;864.00;42
1684;7;620710900;1684;263;2624;2663;7.21;0.44;219.26;3.54;940;7;865.00;39
1687;7;620710911;1687;258;2631;2663;7.31;0.45;219.50;3.53;944;7;866.00;32
1693;7;620710923;1693;252;2631;2663;7.38;0.45;219.69;3.53;938;7;867.00;32
1697;7;620710934;1697;252;2635;2663;7.45;0.46;220.12;3.54;938;7;868.00;28
1701;7;620710944;1701;254;2635;2663;7.44;0.46;220.30;3.54;934;7;869.00;28
1704;7;620710956;1704;256;2636;2663;7.44;0.46;220.44;3.54;932;7;870.00;27
1708;7;620710968;1708;259;2637;2663;7.40;0.45;220.96;3.54;929;7;871.00;26
1712;7;620710979;1712;261;2638;2664;7.33;0.45;221.12;3.54;926;7;872.00;26
1717;7;620710990;1717;267;2641;2665;7.30;0.45;221.51;3.55;924;7;873.00;24
1720;7;620711001;1720;267;2643;2665;7.29;0.45;222.09;3.55;923;7;874.00;22
1723;7;620711012;1723;277;2646;2666;7.26;0.45;222.26;3.56;923;7;875.00;20
1727;7;620711029;1727;285;2646;2666;7.29;0.45;222.55;3.56;919;7;876.00;20
1729;7;620711041;1729;289;2648;2666;7.27;0.45;222.59;3.56;919;7;877.00;18
1735;7;620711052;1735;285;2650;2666;7.23;0.44;223.09;3.57;915;7;878.00;16
1738;7;620711064;1738;286;2654;2670;7.27;0.44;223.19;3.57;916;7;879.00;16
1742;7;620711075;1742;283;2654;2670;7.25;0.44;223.42;3.57;912;7;880.00;16
1746;7;620711086;1746;286;2655;2670;7.27;0.44;223.56;3.58;909;7;881.00;15
1750;7;620711098;1750;280;2656;2673;7.23;0.44;223.79;3.58;906;7;882.00;17
1753;7;620711109;1753;280;2656;2673;7.28;0.44;223.95;3.58;903;7;883.00;17
1755;7;620711121;1755;274;2658;2673;7.30;0.44;224.13;3.59;903;7;884.00;15
1759;7;620711138;1759;273;2662;2677;7.37;0.45;224.38;3.59;903;7;885.00;15
1762;7;620711149;1762;280;2663;2678;7.40;0.45;224.75;3.59;901;7;886.00;15
1767;7;620711160;1767;275;2663;2678;7.43;0.45;225.17;3.59;896;7;887.00;15
1770;7;620711171;1770;271;2666;2682;7.47;0.46;225.42;3.59;896;7;888.00;16
1773;7;620711183;1773;272;2666;2682;7.55;0.46;225.55;3.59;893;7;889.00;16
1778;7;620711193;1778;277;2666;2682;7.59;0.46;226.09;3.59;888;7;890.00;16
1783;7;620711205;1783;285;2668;2683;7.55;0.46;226.13;3.59;885;7;891.00;15
1785;7;620711221;1785;288;2668;2683;7.56;0.46;226.53;3.59;883;7;892.00;15
1789;7;620711231;1789;293;2674;2689;7.51;0.46;226.64;3.60;885;7;893.00;15
1793;7;620711243;1793;296;2674;2689;7.45;0.45;226.97;3.60;881;7;894.00;15
1797;7;620711254;1797;297;2675;2690;7.38;0.45;227.19;3.60;878;7;895.00;15
1802;7;620711264;1802;304;2676;2690;7.28;0.44;227.84;3.61;874;7;896.00;14
1806;7;620711275;1806;298;2678;2690;7.24;0.44;228.35;3.63;872;7;897.00;12
1810;7;620711285;1810;296;2679;2690;7.21;0.44;228.73;3.64;869;7;898.00;11
1816;7;620711296;1816;295;2680;2690;7.20;0.44;229.19;3.65;864;7;899.00;10
1819;7;620711309;1819;298;2708;2736;7.22;0.44;229.53;3.61;889;7;900.00;28
1823;7;620711329;1823;297;2710;2736;7.22;0.44;229.72;3.63;887;7;901.00;26
1826;7;620711341;1826;295;2714;2736;7.21;0.44;230.29;3.64;888;7;902.00;22
1828;7;620711351;1828;297;2714;2736;7.25;0.44;230.26;3.64;886;7;903.00;22
1830;7;620711362;1830;302;2716;2736;7.37;0.45;230.33;3.64;886;7;904.00;20
1832;7;620711377;1832;301;2717;2736;7.40;0.45;230.29;3.65;885;7;905.00;19
1835;7;620711405;1835;295;2724;2740;7.35;0.45;230.44;3.66;889;7;906.00;16
1838;7;620711423;1838;284;2726;2740;7.35;0.45;230.55;3.67;888;7;907.00;14
1840;7;620711441;1840;283;2729;2744;7.33;0.45;230.71;3.68;889;7;908.00;15
1843;7;620711460;1843;278;2731;2745;7.33;0.45;230.75;3.68;888;7;909.00;14
1847;7;620711477;1847;277;2732;2745;7.32;0.45;231.09;3.69;885;7;910.00;13
1849;7;620711494;1849;281;2733;2745;7.38;0.45;231.35;3.70;884;7;911.00;12
1851;7;620711506;1851;276;2746;2758;7.39;0.45;231.39;3.70;895;7;912.00;12
1856;7;620711521;1856;279;2746;2758;7.41;0.45;231.68;3.70;890;7;913.00;12
1858;7;620711533;1858;281;2748;2758;7.45;0.45;231.63;3.70;890;7;914.00;10
1859;7;620711546;1859;285;2748;2759;7.46;0.46;231.53;3.70;889;7;915.00;11
1862;7;620711558;1862;289;2751;2760;7.42;0.45;231.60;3.71;889;7;916.00;9
1865;7;620711571;1865;292;2752;2760;7.37;0.45;231.77;3.71;887;7;917.00;8
1867;7;620711583;1867;296;2756;2763;7.35;0.45;231.88;3.72;889;7;918.00;7
1870;7;620711596;1870;295;2756;2763;7.37;0.45;231.88;3.72;886;7;919.00;7
1872;7;620711607;1872;295;2759;2763;7.41;0.45;231.85;3.72;887;7;920.00;4
1874;7;620711619;1874;295;2759;2763;7.45;0.45;231.85;3.72;885;7;921.00;4
1875;7;620711630;1875;296;2766;2769;7.50;0.46;231.91;3.72;891;7;922.00;3
1877;7;620711642;1877;295;2767;2769;7.53;0.46;232.00;3.73;890;7;923.00;2
1878;7;620711654;1878;292;2767;2769;7.57;0.46;231.98;3.73;889;7;924.00;2
1882;7;620711665;1882;297;2767;2769;7.56;0.46;231.96;3.73;885;7;925.00;2
1885;7;620711677;1885;296;2772;2773;7.57;0.46;232.25;3.73;887;7;926.00;1
1886;7;620711689;1886;295;2774;2774;7.56;0.46;232.23;3.73;888;7;927.00;0
1886;7;620711700;1886;296;2774;2774;7.58;0.46;232.23;3.73;888;7;928.00;0
1887;7;620711711;1887;299;2775;2775;7.57;0.46;232.18;3.73;888;7;929.00;0
1889;7;620711724;1889;304;2775;2775;7.53;0.46;232.12;3.73;886;7;930.00;0
1890;7;620711735;1890;297;2775;2775;7.59;0.46;232.09;3.73;885;7;931.00;0
1891;7;620711746;1891;295;2775;2775;7.56;0.46;232.12;3.73;884;7;932.00;0
1892;7;620711756;1892;300;2775;2775;7.60;0.46;232.13;3.73;883;7;933.00;0
1893;7;620711767;1893;302;2775;2775;7.60;0.46;232.12;3.73;882;7;934.00;0
1895;7;620711778;1895;304;2775;2775;7.55;0.46;232.21;3.73;880;7;935.00;0
1896;7;620711789;1896;319;2814;2845;7.51;0.46;232.31;3.68;918;7;936.00;31
1897;7;620711807;1897;322;2815;2846;7.51;0.46;232.30;3.68;918;7;937.00;31
1898;7;620711818;1898;325;2822;2846;7.54;0.46;232.36;3.67;924;7;938.00;24
1903;7;620711829;1903;330;2824;2846;7.43;0.45;232.51;3.67;921;7;939.00;22
1903;7;620711840;1903;327;2827;2846;7.44;0.45;232.51;3.67;924;7;940.00;19
1905;7;620711851;1905;320;2831;2846;7.46;0.45;232.56;3.67;926;7;941.00;15
1905;7;620711863;1905;323;2834;2846;7.46;0.45;232.56;3.68;929;7;942.00;12
1907;7;620711874;1907;318;2837;2846;7.46;0.45;232.57;3.68;930;7;943.00;9
1908;7;620711892;1908;314;2839;2847;7.48;0.45;232.58;3.68;931;7;944.00;8
1910;7;620711903;1910;310;2840;2849;7.48;0.46;232.70;3.68;930;7;945.00;9
1913;7;620711916;1913;306;2841;2849;7.47;0.45;232.73;3.68;928;7;946.00;8
1918;7;620711929;1918;306;2845;2853;7.43;0.45;232.97;3.68;927;7;947.00;8
1920;7;620711940;1920;298;2846;2853;7.37;0.45;233.02;3.68;926;7;948.00;7
1921;7;620711951;1921;306;2846;2853;7.33;0.45;232.97;3.68;925;7;949.00;7
1924;7;620711961;1924;308;2846;2853;7.24;0.44;232.96;3.68;922;7;950.00;7
1927;7;620711972;1927;307;2850;2859;7.16;0.44;233.10;3.68;923;7;951.00;9
1930;7;620711984;1930;300;2850;2859;7.06;0.43;233.41;3.68;920;7;952.00;9
1934;7;620711994;1934;296;2850;2859;6.98;0.43;233.56;3.68;916;7;953.00;9
1940;8;620712005;1940;299;2852;2862;6.89;0.42;233.47;3.67;912;8;954.00;10
1942;8;620712027;1942;305;2857;2862;6.83;0.42;233.41;3.69;915;8;955.00;5
1947;8;620712038;1947;297;2857;2862;6.76;0.41;233.35;3.69;910;8;956.00;5
1951;8;620712048;1951;298;2857;2863;6.74;0.41;233.28;3.69;906;8;957.00;6
1953;8;620712058;1953;295;2858;2864;6.82;0.41;233.50;3.69;905;8;958.00;6
1956;8;620712069;1956;298;2858;2864;6.85;0.42;233.28;3.69;902;8;959.00;6
1959;8;620712081;1959;306;2876;2890;6.90;0.42;233.11;3.67;917;8;960.00;14
1960;8;620712093;1960;306;2876;2890;6.94;0.42;233.00;3.67;916;8;961.00;14
1964;8;620712103;1964;304;2878;2890;6.92;0.42;232.78;3.67;914;8;962.00;12
1965;8;620712114;1965;307;2880;2891;6.94;0.42;232.67;3.67;915;8;963.00;11
1969;8;620712124;1969;309;2881;2891;6.92;0.42;232.60;3.67;912;8;964.00;10
1971;8;620712135;1971;307;2884;2895;6.97;0.42;232.43;3.67;913;8;965.00;11
1973;8;620712145;1973;311;2885;2895;6.96;0.42;232.40;3.67;912;8;966.00;10
1974;8;620712155;1974;307;2888;2899;7.01;0.43;232.41;3.67;914;8;967.00;11
1974;8;620712165;1974;305;2888;2899;7.04;0.43;232.41;3.67;914;8;968.00;11
1974;8;620712175;1974;306;2889;2899;7.04;0.43;232.41;3.67;915;8;969.00;10
1976;8;620712185;1976;309;2889;2899;7.02;0.43;232.38;3.67;913;8;970.00;10
1977;8;620712195;1977;311;2891;2899;7.01;0.43;232.40;3.69;914;8;971.00;8
1977;8;620712206;1977;312;2902;2911;7.04;0.43;232.40;3.68;925;8;972.00;9
1980;8;620712217;1980;312;2902;2911;6.98;0.42;232.24;3.68;922;8;973.00;9
1982;8;620712227;1982;316;2905;2911;6.96;0.42;232.27;3.69;923;8;974.00;6
1983;8;620712238;1983;320;2905;2911;6.94;0.42;232.49;3.69;922;8;975.00;6
1983;8;620712248;1983;323;2905;2911;6.94;0.42;232.49;3.69;922;8;976.00;6
1985;8;620712258;1985;325;2905;2911;6.88;0.42;232.65;3.69;920;8;977.00;6
1987;8;620712268;1987;334;2905;2912;6.87;0.42;232.55;3.69;918;8;978.00;7
1988;8;620712278;1988;327;2905;2912;6.86;0.42;232.55;3.69;917;8;979.00;7
1990;8;620712289;1990;319;2912;2918;6.89;0.42;232.57;3.70;922;8;980.00;6
1991;8;620712301;1991;316;2912;2919;6.95;0.42;232.58;3.70;921;8;981.00;7
1991;8;620712311;1991;311;2913;2919;6.99;0.43;232.58;3.70;922;8;982.00;6
1993;8;620712321;1993;309;2914;2919;6.94;0.42;232.52;3.70;921;8;983.00;5
1994;8;620712332;1994;308;2918;2923;6.98;0.43;232.53;3.70;924;8;984.00;5
1996;8;620712343;1996;303;2918;2923;6.98;0.43;232.44;3.70;922;8;985.00;5
1996;8;620712354;1996;305;2919;2923;6.99;0.43;232.44;3.71;923;8;986.00;4
1999;8;620712365;1999;305;2921;2924;7.03;0.43;232.37;3.72;922;8;987.00;3
2001;8;620712383;2001;307;2925;2928;7.03;0.43;232.36;3.72;924;8;988.00;3
2002;8;620712394;2002;307;2926;2928;7.04;0.43;232.44;3.72;924;8;989.00;2
2004;8;620712406;2004;302;2931;2934;7.08;0.43;232.31;3.72;927;8;990.00;3
2005;8;620712417;2005;303;2933;2934;7.07;0.43;232.21;3.72;928;8;991.00;1
2006;8;620712428;2006;301;2934;2934;7.13;0.44;232.18;3.72;928;8;992.00;0
2007;8;620712438;2007;299;2934;2934;7.16;0.44;232.16;3.72;927;8;993.00;0
2008;8;620712453;2008;300;2938;2938;7.19;0.44;232.12;3.71;930;8;994.00;0
2012;8;620712463;2012;307;2938;2938;7.10;0.43;232.16;3.71;926;8;995.00;0
2013;8;620712473;2013;307;2938;2938;7.03;0.43;232.21;3.71;925;8;996.00;0
2013;8;620712483;2013;307;2938;2938;6.92;0.42;232.21;3.71;925;8;997.00;0
2015;8;620712493;2015;309;2939;2939;6.84;0.42;232.24;3.71;924;8;998.00;0
2016;8;620712503;2016;303;2940;2940;6.79;0.42;232.16;3.71;924;8;999.00;0
2018;8;620712514;2018;303;2940;2940;6.75;0.42;232.06;3.71;922;8;1000.00;0
2019;8;620712526;2019;297;2941;2941;6.68;0.41;232.09;3.71;922;8;1001.00;0
2022;8;620712536;2022;292;2941;2941;6.64;0.41;231.91;3.71;919;8;1002.00;0
2025;8;620712546;2025;291;2941;2941;6.62;0.41;231.99;3.71;916;8;1003.00;0
2028;8;620712555;2028;293;2941;2941;6.59;0.41;232.26;3.71;913;8;1004.00;0
2031;8;620712565;2031;285;2941;2941;6.61;0.41;232.22;3.71;910;8;1005.00;0
2034;8;620712574;2034;283;2941;2941;6.61;0.41;232.25;3.71;907;8;1006.00;0
2035;8;620712584;2035;281;2941;2941;6.66;0.41;232.24;3.71;906;8;1007.00;0
2036;8;620712593;2036;294;3015;3068;6.95;0.43;232.24;3.62;979;8;1008.00;53
2039;8;620712613;2039;289;3019;3069;6.97;0.43;232.12;3.62;980;8;1009.00;50
2042;8;620712622;2042;276;3029;3069;7.01;0.44;232.31;3.61;987;8;1010.00;40
2045;8;620712632;2045;283;3034;3069;7.05;0.44;232.28;3.61;989;8;1011.00;35
2049;8;620712642;2049;276;3039;3069;7.08;0.44;232.31;3.61;990;8;1012.00;30
2054;8;620712652;2054;278;3041;3069;6.98;0.43;232.35;3.61;987;8;1013.00;28
2057;8;620712661;2057;273;3044;3069;6.93;0.43;232.30;3.61;987;8;1014.00;25
2064;8;620712672;2064;275;3047;3069;6.81;0.42;232.28;3.62;983;8;1015.00;22
2065;8;620712682;2065;278;3048;3070;6.74;0.41;232.31;3.62;983;8;1016.00;22
2069;8;620712692;2069;286;3050;3071;6.70;0.41;232.32;3.62;981;8;1017.00;21
2073;8;620712702;2073;295;3051;3071;6.58;0.40;232.45;3.62;978;8;1018.00;20
2077;8;620712712;2077;304;3055;3072;6.47;0.40;232.19;3.63;978;8;1019.00;17
2081;8;620712724;2081;288;3058;3072;6.40;0.39;232.46;3.64;977;8;1020.00;14
2083;8;620712735;2083;289;3061;3072;6.38;0.39;232.53;3.65;978;8;1021.00;11
2085;8;620712745;2085;288;3062;3072;6.35;0.39;232.67;3.65;977;8;1022.00;10
2089;8;620712756;2089;285;3066;3076;6.39;0.39;232.95;3.65;977;8;1023.00;10
2096;8;620712767;2096;279;3068;3076;6.41;0.40;233.33;3.66;972;8;1024.00;8
2097;8;620712778;2097;276;3069;3076;6.50;0.40;233.37;3.66;972;8;1025.00;7
2104;8;620712789;2104;273;3070;3079;6.56;0.40;233.81;3.67;966;8;1026.00;9
2105;8;620712801;2105;265;3072;3079;6.64;0.41;233.88;3.67;967;8;1027.00;7
2107;8;620712812;2107;261;3074;3079;6.76;0.41;233.88;3.67;967;8;1028.00;5
2111;8;620712822;2111;254;3079;3083;6.82;0.42;233.92;3.67;968;8;1029.00;4
2113;8;620712834;2113;248;3080;3084;6.88;0.42;234.08;3.68;967;8;1030.00;4
2116;8;620712846;2116;243;3082;3084;6.92;0.42;234.39;3.68;966;8;1031.00;2
2118;8;620712857;2118;242;3085;3088;6.95;0.43;234.64;3.68;967;8;1032.00;3
2121;8;620712869;2121;244;3086;3088;6.99;0.43;234.98;3.69;965;8;1033.00;2
2124;8;620712880;2124;243;3088;3088;7.03;0.43;235.30;3.69;964;8;1034.00;0
2128;8;620712892;2128;240;3090;3090;7.12;0.44;235.66;3.68;962;8;1035.00;0
2130;8;620712904;2130;245;3090;3090;7.18;0.44;235.89;3.68;960;8;1036.00;0
2136;8;620712915;2136;238;3094;3096;7.26;0.44;236.16;3.68;958;8;1037.00;2
2139;8;620712928;2139;235;3094;3096;7.33;0.45;236.45;3.68;955;8;1038.00;2
2145;8;620712940;2145;241;3096;3097;7.32;0.45;236.71;3.68;951;8;1039.00;1
2149;8;620712952;2149;238;3096;3097;7.34;0.45;237.14;3.68;947;8;1040.00;1
2154;8;620712963;2154;242;3096;3097;7.26;0.44;237.24;3.68;942;8;1041.00;1
2157;8;620712975;2157;245;3096;3097;7.22;0.44;237.49;3.68;939;8;1042.00;1
2160;8;620712987;2160;249;3096;3097;7.21;0.44;237.83;3.68;936;8;1043.00;1
2166;8;620712999;2166;251;3105;3109;7.26;0.44;238.05;3.67;939;8;1044.00;4
2169;8;620713011;2169;258;3106;3109;7.23;0.44;238.39;3.67;937;8;1045.00;3
2173;8;620713023;2173;258;3107;3109;7.20;0.44;238.51;3.67;934;8;1046.00;2
2179;8;620713034;2179;258;3108;3109;7.26;0.44;238.84;3.67;929;8;1047.00;1
2186;8;620713045;2186;258;3109;3109;7.24;0.44;239.08;3.67;923;8;1048.00;0
2190;8;620713056;2190;259;3109;3109;7.26;0.45;239.31;3.67;919;8;1049.00;0
2193;8;620713070;2193;260;3115;3115;7.35;0.45;239.34;3.66;922;8;1050.00;0
2199;8;620713082;2199;257;3115;3115;7.36;0.45;239.79;3.66;916;8;1051.00;0
2201;8;620713094;2201;256;3119;3119;7.42;0.46;239.93;3.66;918;8;1052.00;0
2206;8;620713105;2206;262;3120;3120;7.43;0.46;240.13;3.66;914;8;1053.00;0
2207;8;620713117;2207;265;3120;3120;7.45;0.46;240.29;3.66;913;8;1054.00;0
2212;8;620713128;2212;270;3120;3120;7.49;0.46;240.60;3.66;908;8;1055.00;0
2216;8;620713140;2216;276;3133;3133;7.55;0.46;240.83;3.64;917;8;1056.00;0
2222;8;620713153;2222;269;3133;3133;7.57;0.46;240.94;3.64;911;8;1057.00;0
2224;8;620713164;2224;265;3133;3133;7.55;0.46;240.96;3.64;909;8;1058.00;0
2229;8;620713176;2229;262;3134;3134;7.55;0.46;241.07;3.64;905;8;1059.00;0
2234;8;620713188;2234;266;3135;3135;7.51;0.46;241.26;3.64;901;8;1060.00;0
2236;8;620713199;2236;265;3135;3135;7.49;0.46;241.61;3.64;899;8;1061.00;0
2243;8;620713210;2243;266;3137;3138;7.42;0.45;241.63;3.64;894;8;1062.00;1
2244;8;620713221;2244;264;3137;3138;7.40;0.45;241.59;3.64;893;8;1063.00;1
2249;8;620713232;2249;268;3138;3138;7.36;0.45;241.94;3.64;889;8;1064.00;0
2251;8;620713243;2251;279;3138;3138;7.33;0.45;241.98;3.64;887;8;1065.00;0
2256;8;620713253;2256;286;3144;3144;7.30;0.44;242.23;3.63;888;8;1066.00;0
2259;8;620713265;2259;281;3144;3144;7.20;0.44;242.42;3.63;885;8;1067.00;0
2262;8;620713276;2262;278;3144;3144;7.25;0.44;242.41;3.63;882;8;1068.00;0
2267;8;620713286;2267;283;3144;3144;7.14;0.43;242.50;3.63;877;8;1069.00;0
2269;9;620713297;2269;280;3148;3148;7.10;0.43;242.88;3.63;879;9;1070.00;0
2271;9;620713324;2271;282;3149;3149;7.10;0.43;243.13;3.63;878;9;1071.00;0
2273;9;620713334;2273;289;3149;3149;7.05;0.43;243.36;3.63;876;9;1072.00;0
2276;9;620713345;2276;295;3150;3150;7.04;0.43;243.66;3.63;874;9;1073.00;0
2279;9;620713355;2279;295;3150;3150;7.03;0.43;243.99;3.63;871;9;1074.00;0
2281;9;620713366;2281;302;3150;3150;7.02;0.43;243.87;3.63;869;9;1075.00;0
2285;9;620713386;2285;294;3150;3150;7.05;0.43;243.99;3.63;865;9;1076.00;0
2286;9;620713411;2286;283;3150;3150;7.10;0.43;244.07;3.63;864;9;1077.00;0
2290;9;620713427;2290;277;3150;3150;7.15;0.43;244.39;3.63;860;9;1078.00;0
2292;9;620713444;2292;280;3150;3150;7.21;0.44;244.59;3.63;858;9;1079.00;0
2292;9;620713462;2292;303;3230;3275;7.28;0.45;244.59;3.54;938;9;1080.00;45
2296;9;620713489;2296;302;3235;3276;7.25;0.45;245.06;3.54;939;9;1081.00;41
2299;9;620713503;2299;295;3242;3276;7.33;0.45;245.25;3.53;943;9;1082.00;34
2303;9;620713515;2303;292;3244;3276;7.35;0.45;245.39;3.53;941;9;1083.00;32
2306;9;620713528;2306;293;3249;3276;7.43;0.46;245.61;3.53;943;9;1084.00;27
2307;9;620713541;2307;291;3250;3276;7.47;0.46;245.75;3.53;943;9;1085.00;26
2310;9;620713554;2310;292;3255;3276;7.51;0.46;245.85;3.54;945;9;1086.00;21
2311;9;620713567;2311;294;3258;3276;7.54;0.46;245.99;3.54;947;9;1087.00;18
2313;9;620713580;2313;289;3263;3277;7.54;0.46;246.09;3.55;950;9;1088.00;14
2318;9;620713593;2318;298;3268;3278;7.54;0.46;246.54;3.55;950;9;1089.00;10
2320;9;620713606;2320;301;3272;3278;7.50;0.46;246.78;3.56;952;9;1090.00;6
2324;9;620713618;2324;297;3278;3282;7.42;0.46;247.22;3.56;954;9;1091.00;4
2326;9;620713631;2326;303;3278;3282;7.36;0.45;247.28;3.56;952;9;1092.00;4
2328;9;620713644;2328;310;3279;3282;7.25;0.45;247.56;3.56;951;9;1093.00;3
2332;9;620713656;2332;314;3279;3282;7.20;0.44;247.82;3.56;947;9;1094.00;3
2339;9;620713668;2339;319;3284;3288;7.12;0.44;247.93;3.56;945;9;1095.00;4
2342;9;620713681;2342;322;3285;3288;7.08;0.43;248.00;3.56;943;9;1096.00;3
2344;9;620713692;2344;327;3286;3288;7.03;0.43;247.88;3.56;942;9;1097.00;2
2347;9;620713704;2347;328;3289;3291;7.00;0.43;247.78;3.56;942;9;1098.00;2
2350;9;620713715;2350;330;3289;3291;6.90;0.42;247.68;3.56;939;9;1099.00;2
2352;9;620713728;2352;331;3290;3291;6.87;0.42;247.51;3.57;938;9;1100.00;1
2354;9;620713744;2354;335;3291;3292;6.86;0.42;247.60;3.57;937;9;1101.00;1
2356;9;620713756;2356;335;3292;3293;6.86;0.42;247.65;3.57;936;9;1102.00;1
2359;9;620713768;2359;341;3292;3293;6.82;0.42;247.66;3.57;933;9;1103.00;1
2361;9;620713779;2361;343;3304;3306;6.80;0.41;247.64;3.55;943;9;1104.00;2
2362;9;620713791;2362;338;3305;3306;6.79;0.41;247.58;3.56;943;9;1105.00;1
2366;9;620713803;2366;344;3305;3306;6.82;0.41;247.50;3.56;939;9;1106.00;1
2368;9;620713814;2368;345;3306;3307;6.78;0.41;247.43;3.55;938;9;1107.00;1
2369;9;620713825;2369;347;3306;3307;6.77;0.41;247.36;3.55;937;9;1108.00;1
2370;9;620713837;2370;347;3310;3311;6.73;0.41;247.33;3.55;940;9;1109.00;1
2371;9;620713854;2371;343;3310;3311;6.73;0.41;247.35;3.55;939;9;1110.00;1
2374;9;620713865;2374;342;3313;3315;6.80;0.41;247.20;3.55;939;9;1111.00;2
2376;9;620713876;2376;341;3313;3315;6.83;0.42;247.33;3.55;937;9;1112.00;2
2379;9;620713887;2379;336;3314;3315;6.86;0.42;247.38;3.55;935;9;1113.00;1
2380;9;620713898;2380;334;3314;3315;6.95;0.42;247.35;3.55;934;9;1114.00;1
2382;9;620713909;2382;330;3314;3315;6.98;0.43;247.24;3.55;932;9;1115.00;1
2385;9;620713922;2385;328;3324;3327;7.03;0.43;247.22;3.54;939;9;1116.00;3
2385;9;620713934;2385;328;3325;3327;7.10;0.43;247.22;3.54;940;9;1117.00;2
2385;9;620713945;2385;324;3325;3327;7.12;0.43;247.22;3.54;940;9;1118.00;2
2388;9;620713955;2388;319;3325;3327;7.10;0.43;247.29;3.54;937;9;1119.00;2
2391;9;620713966;2391;317;3325;3327;7.05;0.43;247.42;3.54;934;9;1120.00;2
2395;9;620713977;2395;315;3325;3327;6.94;0.42;247.52;3.54;930;9;1121.00;2
2397;9;620713988;2397;313;3325;3328;6.79;0.41;247.37;3.54;928;9;1122.00;3
2398;9;620713999;2398;311;3325;3328;6.70;0.41;247.41;3.54;927;9;1123.00;3
2401;9;620714009;2401;308;3330;3334;6.64;0.40;247.54;3.54;929;9;1124.00;4
2406;10;620714021;2406;310;3334;3336;6.59;0.40;247.70;3.54;928;10;1125.00;2
2408;10;620714049;2408;308;3334;3336;6.56;0.40;247.74;3.54;926;10;1126.00;2
2411;10;620714060;2411;311;3334;3336;6.49;0.39;247.83;3.54;923;10;1127.00;2
2414;10;620714071;2414;309;3337;3340;6.55;0.40;247.75;3.54;923;10;1128.00;3
2415;10;620714081;2415;309;3337;3340;6.56;0.40;247.70;3.54;922;10;1129.00;3
2417;10;620714091;2417;311;3337;3340;6.55;0.40;247.56;3.54;920;10;1130.00;3
2417;10;620714102;2417;296;3338;3341;6.63;0.40;247.56;3.53;921;10;1131.00;3
2418;10;620714112;2418;285;3341;3345;6.70;0.41;247.57;3.53;923;10;1132.00;4
2418;10;620714123;2418;275;3341;3345;6.83;0.41;247.57;3.53;923;10;1133.00;4
2421;10;620714133;2421;270;3343;3348;6.90;0.42;247.40;3.53;922;10;1134.00;5
2423;10;620714146;2423;267;3344;3348;6.98;0.42;247.21;3.53;921;10;1135.00;4
2424;10;620714157;2424;267;3344;3348;7.00;0.42;247.21;3.53;920;10;1136.00;4
2424;10;620714168;2424;258;3344;3348;7.05;0.43;247.21;3.53;920;10;1137.00;4
2425;10;620714179;2425;262;3348;3352;7.16;0.43;247.13;3.53;923;10;1138.00;4
2425;10;620714191;2425;261;3348;3352;7.24;0.44;247.13;3.53;923;10;1139.00;4
2426;10;620714204;2426;259;3348;3352;7.28;0.44;247.09;3.53;922;10;1140.00;4
2426;10;620714223;2426;253;3348;3352;7.41;0.45;247.09;3.53;922;10;1141.00;4
2426;10;620714233;2426;253;3348;3353;7.45;0.45;247.09;3.53;922;10;1142.00;5
2428;10;620714244;2428;248;3349;3354;7.50;0.46;247.02;3.53;921;10;1143.00;5
2429;10;620714262;2429;244;3349;3354;7.47;0.45;246.95;3.53;920;10;1144.00;5
2429;10;620714273;2429;240;3350;3355;7.48;0.46;246.95;3.52;921;10;1145.00;5
2429;10;620714284;2429;240;3350;3355;7.52;0.46;246.95;3.52;921;10;1146.00;5
2431;10;620714295;2431;239;3350;3355;7.51;0.46;246.88;3.52;919;10;1147.00;5
2432;10;620714306;2432;236;3350;3355;7.56;0.46;246.87;3.52;918;10;1148.00;5
2433;10;620714317;2433;241;3350;3355;7.62;0.46;246.80;3.52;917;10;1149.00;5
2434;10;620714328;2434;241;3352;3355;7.66;0.47;246.92;3.54;918;10;1150.00;3
2435;10;620714338;2435;245;3352;3355;7.73;0.47;246.94;3.54;917;10;1151.00;3
2436;10;620714348;2436;257;3420;3482;7.93;0.49;247.09;3.47;984;10;1152.00;62
2438;10;620714371;2438;246;3423;3483;7.94;0.49;247.16;3.47;985;10;1153.00;60
2440;10;620714384;2440;239;3435;3483;8.00;0.49;247.13;3.47;995;10;1154.00;48
2442;10;620714397;2442;244;3440;3483;7.98;0.49;247.05;3.47;998;10;1155.00;43
2446;10;620714408;2446;246;3447;3483;7.98;0.49;247.19;3.48;1001;10;1156.00;36
2448;10;620714423;2448;240;3450;3483;7.94;0.49;247.31;3.48;1002;10;1157.00;33
2449;10;620714436;2449;244;3453;3483;7.93;0.49;247.27;3.48;1004;10;1158.00;30
2453;10;620714447;2453;247;3456;3483;7.87;0.49;247.31;3.49;1003;10;1159.00;27
2456;10;620714458;2456;244;3463;3484;7.79;0.48;247.66;3.49;1007;10;1160.00;21
2457;11;620714478;2457;250;3466;3485;7.72;0.48;247.68;3.50;1009;11;1161.00;19
2460;12;620714497;2460;251;3469;3485;7.68;0.47;247.80;3.51;1009;12;1162.00;16
2463;12;620714524;2463;259;3472;3486;7.59;0.47;247.96;3.51;1009;12;1163.00;14
2466;12;620714536;2466;262;3477;3486;7.48;0.46;248.03;3.52;1011;12;1164.00;9
2469;12;620714547;2469;267;3478;3486;7.39;0.45;248.17;3.52;1009;12;1165.00;8
2472;12;620714558;2472;278;3480;3486;7.29;0.45;248.21;3.53;1008;12;1166.00;6
2478;12;620714572;2478;281;3485;3490;7.12;0.44;247.99;3.53;1007;12;1167.00;5
2480;12;620714584;2480;284;3486;3490;7.02;0.43;247.92;3.53;1006;12;1168.00;4
2481;12;620714597;2481;286;3486;3490;6.88;0.42;247.96;3.53;1005;12;1169.00;4
2484;12;620714609;2484;294;3490;3496;6.75;0.41;247.98;3.53;1006;12;1170.00;6
2485;12;620714621;2485;291;3491;3496;6.70;0.41;248.13;3.54;1006;12;1171.00;5
2487;12;620714632;2487;295;3493;3496;6.66;0.41;248.15;3.54;1006;12;1172.00;3
2489;12;620714643;2489;297;3497;3500;6.62;0.41;248.21;3.54;1008;12;1173.00;3
2493;12;620714654;2493;299;3498;3501;6.65;0.41;248.23;3.54;1005;12;1174.00;3
2494;12;620714665;2494;296;3500;3501;6.72;0.41;248.25;3.54;1006;12;1175.00;1
2497;12;620714676;2497;294;3504;3505;6.75;0.41;248.51;3.54;1007;12;1176.00;1
2500;12;620714687;2500;294;3505;3505;6.79;0.42;248.63;3.54;1005;12;1177.00;0
2500;12;620714703;2500;293;3505;3505;6.91;0.42;248.63;3.54;1005;12;1178.00;0
2503;12;620714713;2503;295;3506;3506;6.94;0.43;248.74;3.54;1003;12;1179.00;0
2505;12;620714724;2505;293;3506;3506;6.95;0.43;248.85;3.54;1001;12;1180.00;0
2510;12;620714735;2510;294;3512;3512;6.93;0.42;248.89;3.53;1002;12;1181.00;0
2514;12;620714745;2514;294;3512;3512;6.92;0.42;248.68;3.53;998;12;1182.00;0
2519;12;620714761;2519;298;3513;3513;6.88;0.42;248.79;3.53;994;12;1183.00;0
2523;12;620714772;2523;298;3513;3513;6.90;0.42;248.93;3.53;990;12;1184.00;0
2527;12;620714782;2527;300;3513;3513;6.90;0.42;248.99;3.53;986;12;1185.00;0
2530;12;620714792;2530;304;3513;3513;6.92;0.42;249.00;3.53;983;12;1186.00;0
2536;12;620714803;2536;300;3513;3513;6.91;0.42;249.33;3.53;977;12;1187.00;0
2540;12;620714813;2540;305;3523;3525;6.91;0.42;249.22;3.52;983;12;1188.00;2
2546;12;620714824;2546;307;3524;3525;6.83;0.42;249.51;3.52;978;12;1189.00;1
2548;12;620714835;2548;287;3524;3525;6.80;0.42;249.65;3.52;976;12;1190.00;1
2551;12;620714845;2551;287;3524;3525;6.80;0.42;249.72;3.52;973;12;1191.00;1
2554;12;620714855;2554;285;3525;3525;6.78;0.42;249.93;3.52;971;12;1192.00;0
2559;12;620714865;2559;281;3525;3525;6.81;0.42;250.17;3.52;966;12;1193.00;0
2562;12;620714876;2562;282;3529;3529;6.81;0.42;250.53;3.52;967;12;1194.00;0
2566;12;620714887;2566;280;3529;3529;6.87;0.42;250.66;3.52;963;12;1195.00;0
2572;12;620714898;2572;270;3532;3533;6.91;0.42;250.80;3.52;960;12;1196.00;1
2573;12;620714909;2573;268;3534;3534;6.97;0.43;250.91;3.51;961;12;1197.00;0
2576;12;620714920;2576;261;3534;3534;6.96;0.42;251.12;3.51;958;12;1198.00;0
2578;12;620714931;2578;254;3534;3534;6.97;0.42;251.19;3.51;956;12;1199.00;0
2581;12;620714944;2581;256;3560;3575;6.98;0.43;251.56;3.49;979;12;1200.00;15
2583;12;620714965;2583;250;3561;3575;7.00;0.43;251.80;3.49;978;12;1201.00;14
2586;12;620714977;2586;246;3564;3575;7.00;0.43;252.02;3.49;978;12;1202.00;11
2589;12;620714988;2589;251;3565;3576;6.96;0.43;252.27;3.49;976;12;1203.00;11
2596;12;620714999;2596;256;3568;3577;6.89;0.42;252.70;3.49;972;12;1204.00;9
2599;12;620715011;2599;255;3570;3577;6.90;0.42;252.95;3.49;971;12;1205.00;7
2604;12;620715022;2604;256;3572;3580;6.92;0.42;253.24;3.49;968;12;1206.00;8
2609;12;620715033;2609;258;3572;3580;6.91;0.42;253.55;3.49;963;12;1207.00;8
2615;12;620715044;2615;259;3575;3580;6.82;0.42;253.94;3.49;960;12;1208.00;5
2618;12;620715056;2618;262;3575;3580;6.83;0.42;254.11;3.49;957;12;1209.00;5
2622;12;620715066;2622;265;3582;3586;6.86;0.42;254.20;3.48;960;12;1210.00;4
2627;12;620715078;2627;269;3582;3586;6.86;0.42;254.42;3.48;955;12;1211.00;4
2630;12;620715090;2630;269;3582;3586;6.87;0.42;254.37;3.48;952;12;1212.00;4
2636;12;620715107;2636;273;3582;3586;6.87;0.42;254.65;3.48;946;12;1213.00;4
2639;12;620715118;2639;278;3586;3590;6.88;0.42;254.94;3.48;947;12;1214.00;4
2644;12;620715130;2644;278;3588;3592;6.89;0.42;255.05;3.48;944;12;1215.00;4
2648;12;620715141;2648;282;3589;3592;6.84;0.42;255.45;3.48;941;12;1216.00;3
2651;12;620715152;2651;284;3590;3593;6.87;0.42;255.53;3.48;939;12;1217.00;3
2654;12;620715163;2654;289;3590;3593;6.91;0.42;255.77;3.48;936;12;1218.00;3
2658;12;620715174;2658;288;3590;3593;6.94;0.42;255.83;3.48;932;12;1219.00;3
2663;12;620715185;2663;289;3590;3593;6.92;0.42;255.98;3.48;927;12;1220.00;3
2667;12;620715196;2667;290;3591;3593;6.87;0.42;255.80;3.49;924;12;1221.00;2
2673;12;620715208;2673;289;3591;3593;6.80;0.41;256.20;3.49;918;12;1222.00;2
2676;12;620715219;2676;290;3591;3593;6.71;0.41;256.40;3.49;915;12;1223.00;2
2682;12;620715235;2682;310;3630;3663;6.67;0.41;256.57;3.45;948;12;1224.00;33
2686;12;620715251;2686;307;3630;3664;6.64;0.41;256.56;3.45;944;12;1225.00;34
2692;12;620715262;2692;309;3642;3664;6.64;0.41;256.76;3.45;950;12;1226.00;22
2694;12;620715274;2694;309;3642;3664;6.66;0.41;256.81;3.45;948;12;1227.00;22
2696;12;620715285;2696;308;3645;3666;6.76;0.41;256.83;3.45;949;12;1228.00;21
2698;12;620715296;2698;316;3647;3666;6.88;0.42;257.05;3.45;949;12;1229.00;19
2703;12;620715308;2703;313;3649;3666;6.92;0.42;257.29;3.45;946;12;1230.00;17
2704;12;620715319;2704;318;3651;3666;6.97;0.43;257.32;3.46;947;12;1231.00;15
2706;12;620715330;2706;320;3655;3667;6.96;0.43;257.36;3.47;949;12;1232.00;12
2708;12;620715341;2708;328;3656;3668;6.87;0.42;257.53;3.47;948;12;1233.00;12
2712;12;620715352;2712;332;3659;3668;6.78;0.41;257.49;3.47;947;12;1234.00;9
2715;12;620715363;2715;344;3665;3672;6.71;0.41;257.69;3.48;950;12;1235.00;7
2719;12;620715374;2719;354;3669;3672;6.70;0.41;257.96;3.48;950;12;1236.00;3
2721;12;620715391;2721;353;3670;3672;6.70;0.41;257.91;3.49;949;12;1237.00;2
2724;12;620715409;2724;356;3672;3672;6.71;0.41;258.01;3.49;948;12;1238.00;0
2728;12;620715428;2728;359;3678;3678;6.72;0.41;258.12;3.48;950;12;1239.00;0
2731;12;620715446;2731;361;3678;3678;6.77;0.41;258.10;3.48;947;12;1240.00;0
2736;12;620715463;2736;362;3678;3678;6.80;0.41;258.22;3.48;942;12;1241.00;0
2739;12;620715482;2739;359;3680;3681;6.84;0.42;258.31;3.48;941;12;1242.00;1
2740;12;620715498;2740;356;3680;3681;6.85;0.42;258.32;3.48;940;12;1243.00;1
2744;12;620715511;2744;361;3681;3681;6.82;0.41;258.35;3.48;937;12;1244.00;0
2746;12;620715524;2746;369;3682;3682;6.76;0.41;258.56;3.48;936;12;1245.00;0
2750;12;620715543;2750;360;3683;3683;6.76;0.41;258.51;3.48;933;12;1246.00;0
2754;12;620715556;2754;358;3683;3683;6.71;0.41;258.52;3.48;929;12;1247.00;0
2756;12;620715575;2756;362;3696;3696;6.77;0.41;258.48;3.47;940;12;1248.00;0
2759;12;620715589;2759;355;3696;3696;6.75;0.41;258.36;3.47;937;12;1249.00;0
2761;12;620715602;2761;358;3696;3696;6.73;0.41;258.30;3.47;935;12;1250.00;0
2762;12;620715615;2762;357;3697;3697;6.77;0.41;258.26;3.47;935;12;1251.00;0
2762;12;620715628;2762;350;3697;3697;6.80;0.41;258.26;3.47;935;12;1252.00;0
2762;12;620715639;2762;356;3701;3701;6.82;0.41;258.26;3.46;939;12;1253.00;0
2762;12;620715651;2762;361;3701;3701;6.83;0.42;258.26;3.46;939;12;1254.00;0
2764;12;620715663;2764;367;3705;3705;6.81;0.42;258.27;3.46;941;12;1255.00;0
2767;12;620715676;2767;373;3705;3705;6.75;0.41;258.34;3.46;938;12;1256.00;0
2769;12;620715687;2769;366;3705;3705;6.67;0.41;258.27;3.46;936;12;1257.00;0
2769;12;620715698;2769;363;3705;3705;6.62;0.40;258.27;3.46;936;12;1258.00;0
2772;12;620715710;2772;365;3705;3705;6.56;0.40;258.10;3.46;933;12;1259.00;0
2773;12;620715723;2773;373;3736;3739;6.58;0.40;258.03;3.43;963;12;1260.00;3
2773;12;620715737;2773;364;3737;3739;6.58;0.40;258.03;3.43;964;12;1261.00;2
2777;12;620715748;2777;365;3738;3739;6.58;0.40;258.01;3.43;961;12;1262.00;1
2780;12;620715759;2780;365;3738;3739;6.59;0.40;257.77;3.43;958;12;1263.00;1
2781;12;620715770;2781;368;3739;3739;6.63;0.41;257.81;3.43;958;12;1264.00;0
2784;12;620715781;2784;367;3739;3739;6.64;0.41;257.93;3.43;955;12;1265.00;0
2784;12;620715799;2784;373;3740;3740;6.65;0.41;257.93;3.43;956;12;1266.00;0
2784;12;620715810;2784;377;3740;3740;6.69;0.41;257.93;3.43;956;12;1267.00;0
2789;12;620715821;2789;381;3745;3746;6.66;0.41;257.95;3.43;956;12;1268.00;1
2791;12;620715833;2791;377;3746;3747;6.62;0.40;257.86;3.43;955;12;1269.00;1
2794;12;620715851;2794;380;3746;3747;6.54;0.40;257.75;3.43;952;12;1270.00;1
2796;12;620715868;2796;381;3746;3747;6.45;0.39;257.61;3.43;950;12;1271.00;1
2797;12;620715879;2797;386;3749;3751;6.41;0.39;257.59;3.42;952;12;1272.00;2
2797;12;620715890;2797;389;3749;3751;6.43;0.39;257.59;3.42;952;12;1273.00;2
2798;12;620715900;2798;393;3749;3751;6.39;0.39;257.54;3.42;951;12;1274.00;2
2800;12;620715912;2800;394;3750;3752;6.32;0.38;257.51;3.42;950;12;1275.00;2
2803;12;620715925;2803;403;3753;3756;6.30;0.38;257.69;3.42;950;12;1276.00;3
2806;12;620715936;2806;403;3753;3756;6.28;0.38;257.77;3.42;947;12;1277.00;3
2806;12;620715946;2806;403;3755;3759;6.27;0.38;257.77;3.42;949;12;1278.00;4
2808;12;620715957;2808;402;3755;3759;6.24;0.38;257.92;3.42;947;12;1279.00;4
2809;12;620715968;2809;400;3756;3759;6.21;0.38;257.91;3.42;947;12;1280.00;3
2809;12;620715980;2809;395;3756;3759;6.20;0.38;257.91;3.42;947;12;1281.00;3
2810;12;620715991;2810;387;3760;3763;6.28;0.38;257.96;3.42;950;12;1282.00;3
2811;12;620716002;2811;373;3760;3763;6.30;0.38;257.97;3.42;949;12;1283.00;3
2811;12;620716014;2811;358;3760;3763;6.37;0.39;257.97;3.42;949;12;1284.00;3
2812;12;620716024;2812;347;3760;3763;6.45;0.39;258.11;3.42;948;12;1285.00;3
2813;12;620716036;2813;339;3760;3764;6.54;0.40;258.20;3.42;947;12;1286.00;4
2814;12;620716048;2814;329;3761;3765;6.59;0.40;258.28;3.42;947;12;1287.00;4
2818;12;620716062;2818;322;3761;3765;6.66;0.40;258.42;3.42;943;12;1288.00;4
2821;12;620716073;2821;314;3762;3766;6.71;0.41;258.53;3.42;941;12;1289.00;4
2824;12;620716092;2824;304;3762;3766;6.76;0.41;258.50;3.42;938;12;1290.00;4
2828;12;620716104;2828;290;3762;3766;6.76;0.41;258.57;3.42;934;12;1291.00;4
2831;12;620716116;2831;284;3762;3766;6.76;0.41;258.68;3.42;931;12;1292.00;4
2833;12;620716132;2833;275;3762;3766;6.79;0.41;258.67;3.42;929;12;1293.00;4
2834;12;620716143;2834;262;3763;3766;6.84;0.41;258.76;3.42;929;12;1294.00;3
2838;12;620716154;2838;259;3764;3766;6.86;0.41;258.77;3.43;926;12;1295.00;2
2839;12;620716166;2839;261;3827;3893;7.05;0.43;258.84;3.37;988;12;1296.00;66
2840;12;620716188;2840;252;3827;3894;7.09;0.44;258.82;3.37;987;12;1297.00;67
2842;12;620716199;2842;248;3835;3894;7.18;0.44;258.86;3.37;993;12;1298.00;59
2843;12;620716211;2843;237;3836;3894;7.25;0.45;258.81;3.37;993;12;1299.00;58
2844;12;620716223;2844;235;3842;3894;7.31;0.45;258.72;3.37;998;12;1300.00;52
2846;12;620716240;2846;230;3845;3894;7.34;0.45;258.72;3.37;999;12;1301.00;49
2847;12;620716258;2847;220;3848;3894;7.38;0.45;258.78;3.37;1001;12;1302.00;46
2848;12;620716270;2848;217;3852;3894;7.42;0.45;258.73;3.38;1004;12;1303.00;42
2850;12;620716282;2850;211;3855;3895;7.43;0.45;258.80;3.38;1005;12;1304.00;40
2854;12;620716294;2854;208;3861;3897;7.40;0.45;258.94;3.39;1007;12;1305.00;36
2854;12;620716306;2854;210;3863;3897;7.49;0.46;258.94;3.39;1009;12;1306.00;34
2856;12;620716318;2856;199;3865;3898;7.54;0.46;258.94;3.39;1009;12;1307.00;33
2857;12;620716329;2857;199;3870;3898;7.55;0.46;258.95;3.41;1013;12;1308.00;28
2859;12;620716341;2859;194;3872;3898;7.52;0.46;258.96;3.41;1013;12;1309.00;26
2864;12;620716353;2864;197;3875;3898;7.40;0.45;259.14;3.42;1011;12;1310.00;23
2865;12;620716366;2865;193;3879;3902;7.34;0.45;259.06;3.43;1014;12;1311.00;23
2869;12;620716381;2869;202;3883;3902;7.25;0.44;259.21;3.43;1014;12;1312.00;19
2871;12;620716397;2871;201;3883;3902;7.25;0.44;259.17;3.43;1012;12;1313.00;19
2872;12;620716412;2872;202;3886;3905;7.30;0.44;259.28;3.44;1014;12;1314.00;19
2874;12;620716424;2874;205;3887;3905;7.33;0.45;259.36;3.44;1013;12;1315.00;18
2877;12;620716437;2877;209;3891;3905;7.35;0.45;259.47;3.46;1014;12;1316.00;14
2877;12;620716449;2877;210;3895;3909;7.39;0.45;259.47;3.46;1018;12;1317.00;14
2882;12;620716461;2882;208;3897;3910;7.38;0.45;259.61;3.46;1015;12;1318.00;13
2884;12;620716474;2884;218;3900;3910;7.37;0.45;259.68;3.47;1016;12;1319.00;10
2887;12;620716487;2887;230;3905;3915;7.45;0.45;259.65;3.47;1018;12;1320.00;10
2887;12;620716499;2887;235;3905;3915;7.49;0.46;259.65;3.47;1018;12;1321.00;10
2889;12;620716510;2889;236;3905;3915;7.50;0.46;259.66;3.47;1016;12;1322.00;10
2893;12;620716522;2893;245;3907;3916;7.50;0.46;259.64;3.48;1014;12;1323.00;9
2895;12;620716534;2895;254;3907;3916;7.50;0.46;259.82;3.48;1012;12;1324.00;9
2896;12;620716545;2896;261;3913;3922;7.56;0.46;259.82;3.48;1017;12;1325.00;9
2898;12;620716557;2898;257;3914;3922;7.53;0.46;259.74;3.48;1016;12;1326.00;8
2901;12;620716568;2901;254;3914;3923;7.49;0.46;260.00;3.48;1013;12;1327.00;9
2905;12;620716580;2905;257;3915;3923;7.45;0.45;260.11;3.49;1010;12;1328.00;8
2907;12;620716593;2907;255;3916;3923;7.47;0.45;260.24;3.50;1009;12;1329.00;7
2909;12;620716604;2909;257;3917;3923;7.43;0.45;260.55;3.51;1008;12;1330.00;6
2911;12;620716616;2911;264;3918;3923;7.42;0.45;260.70;3.51;1007;12;1331.00;5
2913;12;620716627;2913;268;3928;3935;7.44;0.45;260.64;3.51;1015;12;1332.00;7
2915;12;620716639;2915;269;3929;3935;7.44;0.45;260.83;3.52;1014;12;1333.00;6
2919;12;620716650;2919;274;3932;3935;7.38;0.45;260.91;3.52;1013;12;1334.00;3
2919;12;620716661;2919;276;3934;3935;7.37;0.45;260.91;3.53;1015;12;1335.00;1
2922;12;620716673;2922;276;3935;3935;7.26;0.44;260.89;3.53;1013;12;1336.00;0
2924;12;620716684;2924;280;3935;3935;7.18;0.44;260.97;3.53;1011;12;1337.00;0
2926;12;620716695;2926;284;3939;3939;7.12;0.43;261.06;3.52;1013;12;1338.00;0
2928;12;620716708;2928;281;3939;3939;7.09;0.43;261.20;3.52;1011;12;1339.00;0
2930;12;620716726;2930;278;3943;3943;7.14;0.44;261.21;3.52;1013;12;1340.00;0
2934;12;620716738;2934;279;3944;3944;7.14;0.44;261.27;3.52;1010;12;1341.00;0
2937;12;620716749;2937;274;3944;3944;7.16;0.44;261.43;3.52;1007;12;1342.00;0
2940;12;620716760;2940;278;3944;3944;7.20;0.44;261.54;3.52;1004;12;1343.00;0
2942;12;620716772;2942;283;3957;3957;7.27;0.45;261.53;3.51;1015;12;1344.00;0
2946;12;620716783;2946;275;3957;3957;7.27;0.44;261.40;3.51;1011;12;1345.00;0
2947;12;620716795;2947;274;3957;3957;7.31;0.45;261.36;3.51;1010;12;1346.00;0
2952;12;620716806;2952;279;3958;3958;7.34;0.45;261.32;3.51;1006;12;1347.00;0
2955;12;620716817;2955;275;3959;3959;7.35;0.45;261.63;3.51;1004;12;1348.00;0
2957;12;620716829;2957;275;3959;3959;7.39;0.45;261.59;3.51;1002;12;1349.00;0
2960;12;620716841;2960;278;3966;3968;7.41;0.45;261.66;3.50;1006;12;1350.00;2
2962;12;620716853;2962;277;3966;3968;7.39;0.45;261.72;3.50;1004;12;1351.00;2
2967;12;620716864;2967;285;3967;3968;7.35;0.45;261.67;3.50;1000;12;1352.00;1
2972;12;620716875;2972;286;3967;3968;7.27;0.44;261.75;3.50;995;12;1353.00;1
2975;12;620716886;2975;289;3973;3974;7.26;0.44;261.98;3.50;998;12;1354.00;1
2980;12;620716898;2980;291;3974;3974;7.16;0.44;262.10;3.50;994;12;1355.00;0
2981;13;620716909;2981;291;3974;3974;7.06;0.43;262.13;3.50;993;13;1356.00;0
2984;13;620716935;2984;291;3974;3974;6.92;0.42;262.22;3.50;990;13;1357.00;0
2986;13;620716945;2986;287;3978;3978;6.76;0.41;262.23;3.50;992;13;1358.00;0
2992;13;620716956;2992;290;3979;3979;6.63;0.41;262.30;3.50;987;13;1359.00;0
2996;13;620716967;2996;282;3979;3979;6.59;0.40;262.41;3.50;983;13;1360.00;0
3000;13;620716977;3000;279;3980;3980;6.60;0.40;262.55;3.49;980;13;1361.00;0
3002;13;620716988;3002;277;3980;3980;6.58;0.40;262.63;3.49;978;13;1362.00;0
3005;14;620716998;3005;272;3980;3980;6.56;0.40;262.72;3.49;975;14;1363.00;0
3011;14;620717025;3011;275;3980;3980;6.55;0.40;262.87;3.49;969;14;1364.00;0
3015;14;620717035;3015;280;3980;3980;6.49;0.40;262.91;3.49;965;14;1365.00;0
3019;14;620717046;3019;280;3980;3980;6.43;0.40;263.07;3.49;961;14;1366.00;0
3025;14;620717056;3025;268;3980;3980;6.36;0.39;263.32;3.49;955;14;1367.00;0
3028;14;620717067;3028;271;4018;4050;6.51;0.40;263.37;3.46;990;14;1368.00;32
3030;14;620717082;3030;270;4022;4051;6.53;0.40;263.48;3.46;992;14;1369.00;29
3034;14;620717093;3034;268;4029;4051;6.63;0.41;263.48;3.46;995;14;1370.00;22
3039;14;620717103;3039;273;4029;4051;6.62;0.41;263.60;3.46;990;14;1371.00;22
3041;14;620717114;3041;281;4031;4051;6.62;0.41;263.67;3.46;990;14;1372.00;20
3046;14;620717125;3046;285;4033;4051;6.64;0.41;263.71;3.46;987;14;1373.00;18
3048;14;620717136;3048;293;4035;4051;6.65;0.41;263.91;3.46;987;14;1374.00;16
3053;14;620717147;3053;299;4037;4051;6.61;0.41;264.11;3.46;984;14;1375.00;14
3056;14;620717158;3056;303;4039;4052;6.60;0.40;264.39;3.46;983;14;1376.00;13
3062;14;620717169;3062;307;4040;4053;6.58;0.40;264.33;3.46;978;14;1377.00;13
3066;14;620717180;3066;308;4044;4053;6.55;0.40;264.37;3.47;978;14;1378.00;9
3070;14;620717191;3070;306;4049;4057;6.53;0.40;264.40;3.47;979;14;1379.00;8
3075;14;620717204;3075;314;4051;4057;6.53;0.40;264.74;3.47;976;14;1380.00;6
3079;14;620717214;3079;324;4052;4057;6.52;0.40;264.89;3.48;973;14;1381.00;5
3083;14;620717225;3083;323;4054;4057;6.54;0.40;265.02;3.48;971;14;1382.00;3
3086;14;620717237;3086;329;4061;4063;6.59;0.40;265.14;3.48;975;14;1383.00;2
3090;14;620717249;3090;331;4062;4063;6.58;0.40;265.20;3.48;972;14;1384.00;1
3094;14;620717260;3094;330;4063;4063;6.56;0.40;265.46;3.48;969;14;1385.00;0
3100;14;620717271;3100;337;4065;4066;6.53;0.40;265.58;3.48;965;14;1386.00;1
3106;14;620717288;3106;339;4065;4066;6.47;0.40;265.94;3.48;959;14;1387.00;1
3110;14;620717299;3110;336;4066;4066;6.38;0.39;266.14;3.48;956;14;1388.00;0
3114;14;620717310;3114;345;4067;4067;6.32;0.39;266.42;3.48;953;14;1389.00;0
3119;14;620717320;3119;349;4068;4068;6.27;0.38;266.52;3.48;949;14;1390.00;0
3125;14;620717332;3125;354;4068;4068;6.17;0.38;266.74;3.48;943;14;1391.00;0
3129;14;620717343;3129;354;4081;4081;6.22;0.38;266.67;3.47;952;14;1392.00;0
3134;14;620717354;3134;357;4081;4081;6.13;0.37;266.99;3.47;947;14;1393.00;0
3137;14;620717365;3137;363;4081;4081;6.11;0.37;266.87;3.47;944;14;1394.00;0
3141;14;620717375;3141;366;4083;4083;6.07;0.37;267.20;3.47;942;14;1395.00;0
3146;14;620717392;3146;365;4083;4083;6.00;0.37;267.46;3.47;937;14;1396.00;0
3149;14;620717410;3149;373;4087;4087;6.06;0.37;267.62;3.46;938;14;1397.00;0
3153;14;620717431;3153;373;4087;4087;6.03;0.37;267.95;3.46;934;14;1398.00;0
3158;14;620717447;3158;375;4090;4091;6.01;0.37;268.17;3.46;932;14;1399.00;1
3162;14;620717465;3162;383;4090;4091;5.92;0.36;268.25;3.46;928;14;1400.00;1
3164;14;620717494;3164;385;4091;4091;5.81;0.36;268.29;3.46;927;14;1401.00;0
3165;14;620717506;3165;390;4091;4091;5.73;0.35;268.30;3.46;926;14;1402.00;0
3165;14;620717517;3165;398;4091;4091;5.69;0.35;268.30;3.46;926;14;1403.00;0
3166;14;620717529;3166;404;4102;4103;5.72;0.35;268.25;3.45;936;14;1404.00;1
3169;14;620717541;3169;411;4102;4103;5.68;0.35;268.17;3.45;933;14;1405.00;1
3170;14;620717553;3170;416;4103;4103;5.65;0.35;268.18;3.45;933;14;1406.00;0
3174;14;620717565;3174;410;4103;4103;5.56;0.34;268.17;3.45;929;14;1407.00;0
3175;14;620717577;3175;408;4103;4103;5.58;0.34;268.19;3.45;928;14;1408.00;0
3180;14;620717588;3180;412;4103;4103;5.52;0.34;268.12;3.45;923;14;1409.00;0
3180;14;620717603;3180;401;4104;4104;5.54;0.34;268.12;3.45;924;14;1410.00;0
3182;14;620717614;3182;402;4104;4104;5.58;0.34;268.13;3.45;922;14;1411.00;0
3185;14;620717625;3185;395;4110;4110;5.59;0.34;267.93;3.45;925;14;1412.00;0
3188;14;620717639;3188;398;4111;4111;5.61;0.34;267.88;3.45;923;14;1413.00;0
3190;14;620717651;3190;401;4111;4111;5.62;0.34;267.82;3.45;921;14;1414.00;0
3191;14;620717662;3191;399;4111;4111;5.63;0.34;267.84;3.45;920;14;1415.00;0
3196;14;620717675;3196;387;4115;4115;5.63;0.34;267.72;3.44;919;14;1416.00;0
3196;15;620717688;3196;383;4115;4115;5.72;0.35;267.72;3.44;919;15;1417.00;0
3199;15;620717719;3199;377;4115;4115;5.73;0.35;267.63;3.44;916;15;1418.00;0
3200;15;620717730;3200;368;4116;4116;5.84;0.36;267.61;3.44;916;15;1419.00;0
3202;15;620717741;3202;363;4120;4120;5.82;0.35;267.56;3.44;918;15;1420.00;0
3205;15;620717753;3205;358;4120;4120;5.86;0.36;267.53;3.44;915;15;1421.00;0
3206;15;620717765;3206;360;4122;4123;5.95;0.36;267.45;3.44;916;15;1422.00;1
3208;15;620717776;3208;356;4122;4123;6.00;0.37;267.48;3.44;914;15;1423.00;1
3209;15;620717787;3209;360;4123;4123;6.11;0.37;267.52;3.44;914;15;1424.00;0
3210;15;620717798;3210;360;4123;4123;6.22;0.38;267.53;3.44;913;16;1425.00;0
3211;15;620717820;3211;362;4127;4127;6.33;0.39;267.66;3.44;916;16;1426.00;0
3214;15;620717831;3214;369;4127;4127;6.41;0.39;267.69;3.44;913;16;1427.00;0
3215;15;620717844;3215;364;4127;4127;6.49;0.39;267.65;3.44;912;16;1428.00;0
3217;15;620717855;3217;363;4127;4127;6.53;0.40;267.85;3.44;910;16;1429.00;0
3217;15;620717867;3217;367;4128;4128;6.52;0.40;267.85;3.44;911;16;1430.00;0
3218;15;620717878;3218;364;4129;4129;6.53;0.40;267.90;3.44;911;16;1431.00;0
3219;15;620717889;3219;367;4129;4129;6.49;0.40;267.91;3.44;910;16;1432.00;0
3220;15;620717900;3220;368;4130;4130;6.46;0.39;267.94;3.44;910;16;1433.00;0
3223;15;620717911;3223;367;4130;4130;6.41;0.39;268.03;3.44;907;16;1434.00;0
3225;15;620717923;3225;360;4130;4130;6.38;0.39;268.04;3.44;905;16;1435.00;0
3227;15;620717936;3227;353;4130;4130;6.43;0.39;268.05;3.44;903;16;1436.00;0
3229;15;620717948;3229;350;4130;4130;6.46;0.39;268.07;3.44;901;16;1437.00;0
3230;15;620717958;3230;345;4130;4130;6.54;0.40;268.12;3.44;900;16;1438.00;0
3230;15;620717970;3230;340;4130;4130;6.65;0.40;268.12;3.44;900;16;1439.00;0
3233;15;620717983;3233;388;4253;4360;6.82;0.43;268.17;3.34;1020;16;1440.00;107
3236;15;620718015;3236;378;4259;4361;6.87;0.43;268.30;3.33;1023;16;1441.00;102
3241;15;620718028;3241;357;4270;4361;7.00;0.44;268.32;3.33;1029;16;1442.00;91
3241;16;620718041;3241;350;4276;4361;7.08;0.44;268.32;3.33;1035;17;1443.00;85
3242;16;620718066;3242;340;4282;4361;7.05;0.44;268.24;3.33;1040;17;1444.00;79
3244;16;620718084;3244;335;4286;4361;7.02;0.44;268.28;3.33;1042;17;1445.00;75
3244;16;620718102;3244;334;4294;4361;7.02;0.44;268.28;3.34;1050;17;1446.00;67
3245;16;620718126;3245;339;4299;4361;7.00;0.43;268.25;3.34;1054;17;1447.00;62
3245;16;620718139;3245;340;4304;4362;6.99;0.43;268.25;3.35;1059;17;1448.00;58
3247;16;620718151;3247;345;4307;4363;6.98;0.43;268.30;3.35;1060;17;1449.00;56
3248;16;620718163;3248;341;4311;4363;6.95;0.43;268.38;3.36;1063;17;1450.00;52
3249;16;620718176;3249;336;4316;4364;6.90;0.43;268.41;3.37;1067;17;1451.00;48
3251;16;620718188;3251;340;4318;4364;6.90;0.42;268.61;3.37;1067;17;1452.00;46
3251;16;620718201;3251;342;4321;4364;6.88;0.42;268.61;3.38;1070;17;1453.00;43
3252;16;620718213;3252;343;4322;4364;6.85;0.42;268.62;3.38;1070;17;1454.00;42
3254;16;620718225;3254;340;4325;4368;6.79;0.42;268.68;3.38;1071;17;1455.00;43
3257;16;620718238;3257;334;4326;4368;6.77;0.41;268.81;3.39;1069;17;1456.00;42
3259;16;620718252;3259;332;4327;4368;6.76;0.41;269.02;3.39;1068;17;1457.00;41
3261;16;620718264;3261;329;4329;4371;6.78;0.41;269.19;3.39;1068;17;1458.00;42
3267;16;620718277;3267;328;4330;4371;6.79;0.41;269.18;3.39;1063;17;1459.00;41
3268;16;620718290;3268;324;4332;4371;6.83;0.42;269.19;3.40;1064;17;1460.00;39
3269;16;620718302;3269;328;4336;4375;6.87;0.42;269.30;3.40;1067;17;1461.00;39
3271;16;620718315;3271;317;4338;4376;6.92;0.42;269.22;3.41;1067;17;1462.00;38
3271;16;620718327;3271;315;4342;4376;6.94;0.42;269.22;3.42;1071;17;1463.00;34
3275;16;620718346;3275;311;4343;4380;6.98;0.43;269.28;3.42;1068;17;1464.00;37
3278;16;620718360;3278;308;4346;4380;6.98;0.43;269.50;3.43;1068;17;1465.00;34
3280;16;620718379;3280;302;4346;4380;6.99;0.43;269.63;3.43;1066;17;1466.00;34
3283;16;620718393;3283;296;4346;4381;6.99;0.43;269.76;3.43;1063;17;1467.00;35
3285;16;620718407;3285;287;4346;4381;6.99;0.43;269.80;3.43;1061;17;1468.00;35
3286;16;620718420;3286;286;4349;4387;7.11;0.43;269.74;3.43;1063;17;1469.00;38
3289;16;620718436;3289;275;4349;4387;7.14;0.43;269.84;3.43;1060;17;1470.00;38
3290;16;620718448;3290;272;4349;4388;7.19;0.44;269.77;3.43;1059;17;1471.00;39
3295;16;620718460;3295;271;4350;4388;7.21;0.44;269.74;3.44;1055;17;1472.00;38
3298;16;620718473;3298;266;4350;4388;7.28;0.44;269.79;3.44;1052;17;1473.00;38
3299;16;620718486;3299;263;4351;4388;7.32;0.45;269.83;3.44;1052;17;1474.00;37
3303;16;620718498;3303;267;4352;4388;7.35;0.45;269.95;3.45;1049;17;1475.00;36
3306;16;620718511;3306;266;4360;4400;7.40;0.45;270.16;3.44;1054;17;1476.00;40
3308;16;620718527;3308;267;4363;4400;7.41;0.45;270.26;3.46;1055;17;1477.00;37
3312;16;620718545;3312;270;4365;4400;7.40;0.45;270.50;3.47;1053;17;1478.00;35
3315;16;620718567;3315;269;4365;4400;7.38;0.45;270.67;3.47;1050;17;1479.00;35
3317;16;620718582;3317;262;4368;4400;7.43;0.45;270.79;3.49;1051;17;1480.00;32
3321;16;620718597;3321;263;4370;4400;7.50;0.46;270.81;3.51;1049;17;1481.00;30
3323;16;620718611;3323;264;4375;4404;7.56;0.46;270.76;3.52;1052;17;1482.00;29
3325;16;620718625;3325;264;4375;4404;7.64;0.46;270.93;3.52;1050;17;1483.00;29
3326;16;620718640;3326;263;4382;4408;7.77;0.47;271.07;3.55;1056;17;1484.00;26
3328;16;620718660;3328;262;4385;4410;7.76;0.47;271.16;3.56;1057;17;1485.00;25
3332;16;620718675;3332;267;4386;4410;7.78;0.47;271.19;3.56;1054;17;1486.00;24
3333;16;620718689;3333;264;4389;4410;7.79;0.47;271.27;3.57;1056;17;1487.00;21
3337;16;620718703;3337;269;4397;4423;7.77;0.47;271.42;3.57;1060;17;1488.00;26
3340;16;620718718;3340;274;4400;4423;7.74;0.47;271.32;3.58;1060;17;1489.00;23
3344;16;620718732;3344;281;4403;4423;7.69;0.47;271.35;3.61;1059;17;1490.00;20
3348;16;620718745;3348;282;4405;4424;7.61;0.46;271.58;3.61;1057;17;1491.00;19
3350;16;620718764;3350;284;4407;4425;7.53;0.46;271.76;3.62;1057;17;1492.00;18
3353;16;620718776;3353;287;4409;4425;7.46;0.45;271.68;3.65;1056;17;1493.00;16
3354;16;620718788;3354;293;4413;4428;7.46;0.46;271.74;3.65;1059;17;1494.00;15
3356;16;620718801;3356;298;4415;4428;7.45;0.45;271.65;3.67;1059;17;1495.00;13
3358;16;620718813;3358;299;4417;4428;7.45;0.45;271.73;3.69;1059;17;1496.00;11
3363;16;620718825;3363;301;4420;4428;7.47;0.46;271.78;3.72;1057;17;1497.00;8
3364;16;620718838;3364;311;4425;4434;7.52;0.46;271.72;3.72;1061;17;1498.00;9
3368;16;620718851;3368;317;4428;4434;7.49;0.46;271.83;3.73;1060;17;1499.00;6
3370;16;620718867;3370;325;4433;4453;7.36;0.45;271.87;3.73;1063;17;1500.00;20
3371;16;620718886;3371;321;4435;4453;7.32;0.45;271.85;3.73;1064;17;1501.00;18
3373;16;620718898;3373;324;4439;4457;7.24;0.44;271.97;3.74;1066;17;1502.00;18
3379;16;620718910;3379;328;4441;4458;7.12;0.43;272.05;3.73;1062;17;1503.00;17
3382;16;620718922;3382;335;4442;4458;7.08;0.43;271.97;3.74;1060;17;1504.00;16
3385;16;620718934;3385;334;4445;4459;7.04;0.43;272.07;3.74;1060;17;1505.00;14
3386;16;620718946;3386;339;4447;4459;6.96;0.43;272.08;3.74;1061;17;1506.00;12
3389;16;620718957;3389;345;4447;4459;6.90;0.42;272.14;3.74;1058;17;1507.00;12
3390;16;620718969;3390;350;4447;4459;6.91;0.42;272.12;3.74;1057;17;1508.00;12
3393;16;620718981;3393;352;4449;4459;6.90;0.42;272.22;3.74;1056;17;1509.00;10
3395;16;620718993;3395;342;4449;4459;6.87;0.42;272.29;3.74;1054;17;1510.00;10
3399;16;620719005;3399;337;4449;4459;6.88;0.42;272.33;3.74;1050;17;1511.00;10
3403;16;620719017;3403;346;4493;4529;6.86;0.42;272.34;3.71;1090;17;1512.00;36
3406;16;620719034;3406;337;4497;4530;6.88;0.42;272.43;3.71;1091;17;1513.00;33
3409;16;620719047;3409;332;4502;4530;6.89;0.42;272.38;3.70;1093;17;1514.00;28
3411;16;620719058;3411;335;4502;4530;6.89;0.42;272.36;3.70;1091;17;1515.00;28
3411;16;620719070;3411;338;4504;4530;7.00;0.43;272.36;3.70;1093;17;1516.00;26
3416;16;620719083;3416;340;4507;4530;7.04;0.43;272.39;3.71;1091;17;1517.00;23
3419;16;620719095;3419;341;4510;4530;7.06;0.43;272.43;3.71;1091;17;1518.00;20
3423;16;620719107;3423;339;4512;4530;7.05;0.43;272.59;3.71;1089;17;1519.00;18
3427;16;620719127;3427;350;4514;4531;7.06;0.43;272.57;3.72;1087;17;1520.00;17
3430;16;620719141;3430;352;4516;4532;7.03;0.43;272.59;3.72;1086;17;1521.00;16
3432;16;620719155;3432;355;4518;4532;6.95;0.42;272.78;3.72;1086;17;1522.00;14
3434;16;620719168;3434;357;4522;4536;6.90;0.42;272.75;3.72;1088;17;1523.00;14
3439;16;620719181;3439;362;4523;4536;6.88;0.42;273.11;3.73;1084;17;1524.00;13
3444;16;620719195;3444;361;4523;4536;6.86;0.42;273.04;3.73;1079;17;1525.00;13
3447;16;620719208;3447;364;4523;4536;6.79;0.42;273.23;3.73;1076;17;1526.00;13
3451;16;620719222;3451;368;4528;4542;6.70;0.41;273.33;3.73;1077;17;1527.00;14
3453;16;620719236;3453;372;4528;4542;6.53;0.40;273.48;3.73;1075;17;1528.00;14
3458;16;620719249;3458;370;4529;4542;6.39;0.39;273.70;3.73;1071;17;1529.00;13
3460;16;620719263;3460;364;4531;4548;6.28;0.39;273.76;3.73;1071;17;1530.00;17
3465;16;620719277;3465;365;4531;4548;6.15;0.38;273.93;3.73;1066;17;1531.00;17
3468;16;620719290;3468;363;4533;4548;6.07;0.37;273.89;3.74;1065;17;1532.00;15
3471;16;620719302;3471;363;4536;4549;6.06;0.37;273.87;3.75;1065;17;1533.00;13
3475;16;620719315;3475;361;4539;4550;6.08;0.37;273.88;3.75;1064;17;1534.00;11
3479;16;620719328;3479;361;4541;4550;6.05;0.37;273.99;3.76;1062;17;1535.00;9
3484;16;620719341;3484;363;4551;4563;6.05;0.37;274.08;3.75;1067;17;1536.00;12
3489;16;620719355;3489;362;4554;4563;6.03;0.37;274.15;3.76;1065;17;1537.00;9
3497;16;620719368;3497;364;4556;4563;6.00;0.37;274.08;3.76;1059;17;1538.00;7
3498;16;620719384;3498;366;4556;4564;5.98;0.37;274.14;3.76;1058;17;1539.00;8
3504;16;620719406;3504;363;4556;4564;5.92;0.36;274.20;3.76;1052;17;1540.00;8
3507;16;620719442;3507;368;4562;4568;5.89;0.36;274.42;3.77;1055;17;1541.00;6
3511;16;620719477;3511;364;4563;4568;5.82;0.36;274.53;3.78;1052;17;1542.00;5
3517;16;620719502;3517;359;4568;4572;5.74;0.35;274.75;3.78;1051;17;1543.00;4
3522;16;620719521;3522;360;4570;4572;5.70;0.35;275.01;3.78;1048;17;1544.00;2
3526;16;620719538;3526;359;4570;4572;5.67;0.35;275.03;3.78;1044;17;1545.00;2
3532;16;620719554;3532;365;4570;4572;5.62;0.34;275.15;3.78;1038;17;1546.00;2
3535;16;620719570;3535;369;4572;4572;5.53;0.34;275.09;3.78;1037;17;1547.00;0
3537;16;620719584;3537;376;4584;4584;5.54;0.34;275.18;3.77;1047;17;1548.00;0
3538;16;620719601;3538;373;4584;4584;5.53;0.34;275.24;3.77;1046;17;1549.00;0
3541;16;620719617;3541;373;4584;4584;5.47;0.34;275.30;3.77;1043;17;1550.00;0
3544;16;620719632;3544;380;4584;4584;5.44;0.33;275.33;3.77;1040;17;1551.00;0
3547;16;620719647;3547;383;4584;4584;5.45;0.33;275.37;3.77;1037;17;1552.00;0
3548;16;620719663;3548;387;4584;4584;5.49;0.34;275.40;3.77;1036;17;1553.00;0
3552;16;620719676;3552;398;4585;4585;5.47;0.34;275.51;3.77;1033;17;1554.00;0
3556;16;620719690;3556;409;4587;4587;5.44;0.33;275.41;3.77;1031;17;1555.00;0
3561;16;620719704;3561;413;4593;4593;5.40;0.33;275.50;3.76;1032;17;1556.00;0
3563;16;620719719;3563;422;4594;4594;5.37;0.33;275.48;3.76;1031;17;1557.00;0
3567;16;620719734;3567;424;4594;4594;5.35;0.33;275.58;3.76;1027;17;1558.00;0
3572;16;620719746;3572;424;4594;4594;5.34;0.33;275.57;3.76;1022;17;1559.00;0
3574;16;620719764;3574;436;4599;4599;5.35;0.33;275.67;3.76;1025;17;1560.00;0
3578;16;620719779;3578;440;4599;4599;5.31;0.33;275.62;3.76;1021;17;1561.00;0
3583;16;620719794;3583;442;4599;4599;5.25;0.32;275.64;3.76;1016;17;1562.00;0
3586;16;620719809;3586;451;4600;4600;5.27;0.32;275.74;3.76;1014;17;1563.00;0
3590;16;620719825;3590;456;4604;4604;5.24;0.32;275.70;3.76;1014;17;1564.00;0
3594;16;620719838;3594;463;4604;4604;5.19;0.32;275.63;3.76;1010;17;1565.00;0
3597;16;620719851;3597;466;4606;4607;5.23;0.32;275.58;3.75;1009;17;1566.00;1
3602;16;620719864;3602;471;4607;4607;5.17;0.31;275.74;3.75;1005;17;1567.00;0
3605;16;620719880;3605;478;4607;4607;5.11;0.31;275.76;3.75;1002;17;1568.00;0
3608;16;620719895;3608;478;4607;4607;5.02;0.31;275.81;3.75;999;17;1569.00;0
3612;16;620719908;3612;486;4611;4611;4.97;0.30;275.78;3.75;999;17;1570.00;0
3616;16;620719924;3616;483;4611;4611;4.91;0.30;275.66;3.75;995;17;1571.00;0
3619;16;620719943;3619;480;4611;4611;4.86;0.30;275.72;3.75;992;17;1572.00;0
3622;16;620719966;3622;485;4611;4611;4.82;0.29;275.76;3.75;989;17;1573.00;0
3627;16;620719980;3627;483;4612;4612;4.79;0.29;275.66;3.75;985;17;1574.00;0
3629;16;620719991;3629;486;4614;4614;4.81;0.29;275.53;3.75;985;17;1575.00;0
3629;16;620720004;3629;487;4614;4614;4.83;0.30;275.53;3.75;985;17;1576.00;0
3633;16;620720017;3633;476;4615;4615;4.83;0.29;275.55;3.75;982;17;1577.00;0
3634;16;620720029;3634;473;4615;4615;4.80;0.29;275.56;3.75;981;17;1578.00;0
3635;16;620720049;3635;459;4615;4615;4.78;0.29;275.60;3.75;980;17;1579.00;0
3636;16;620720062;3636;458;4615;4615;4.85;0.30;275.62;3.75;979;17;1580.00;0
3636;16;620720080;3636;454;4615;4615;4.95;0.30;275.62;3.75;979;17;1581.00;0
3640;16;620720095;3640;447;4615;4615;4.96;0.30;275.57;3.75;975;17;1582.00;0
3640;16;620720113;3640;451;4615;4615;5.02;0.31;275.57;3.75;975;17;1583.00;0
3640;16;620720126;3640;473;4690;4742;5.45;0.34;275.57;3.69;1050;17;1584.00;52
3640;16;620720155;3640;463;4694;4743;5.48;0.34;275.57;3.69;1054;17;1585.00;49
3642;16;620720184;3642;447;4703;4743;5.57;0.34;275.56;3.68;1061;17;1586.00;40
3644;16;620720202;3644;418;4707;4743;5.66;0.35;275.55;3.68;1063;17;1587.00;36
3645;16;620720223;3645;408;4713;4743;5.75;0.36;275.48;3.68;1068;17;1588.00;30
3645;16;620720240;3645;398;4716;4743;5.82;0.36;275.48;3.68;1071;17;1589.00;27
3645;16;620720257;3645;389;4719;4743;5.91;0.37;275.48;3.69;1074;17;1590.00;24
3646;16;620720271;3646;385;4721;4743;5.99;0.37;275.44;3.69;1075;17;1591.00;22
3646;16;620720288;3646;373;4723;4744;6.11;0.38;275.44;3.69;1077;17;1592.00;21
3648;16;620720306;3648;376;4728;4745;6.24;0.38;275.48;3.70;1080;17;1593.00;17
3649;16;620720334;3649;376;4730;4745;6.37;0.39;275.50;3.70;1081;17;1594.00;15
3652;16;620720349;3652;375;4732;4746;6.41;0.39;275.48;3.70;1080;17;1595.00;14
3652;16;620720373;3652;375;4733;4746;6.51;0.40;275.48;3.70;1081;17;1596.00;13
3654;16;620720410;3654;376;4734;4746;6.60;0.41;275.47;3.70;1080;17;1597.00;12
3656;16;620720427;3656;370;4738;4746;6.63;0.41;275.46;3.71;1082;17;1598.00;8
3656;16;620720449;3656;377;4740;4750;6.68;0.41;275.46;3.71;1084;17;1599.00;10
3659;16;620720467;3659;377;4744;4750;6.75;0.41;275.42;3.72;1085;17;1600.00;6
3660;16;620720488;3660;385;4745;4750;6.75;0.41;275.44;3.72;1085;17;1601.00;5
3661;16;620720503;3661;379;4748;4753;6.75;0.41;275.45;3.73;1087;17;1602.00;5
3665;16;620720518;3665;379;4748;4753;6.82;0.42;275.47;3.73;1083;17;1603.00;5
3665;16;620720532;3665;375;4748;4753;6.80;0.42;275.47;3.73;1083;17;1604.00;5
3665;16;620720547;3665;381;4752;4757;6.81;0.42;275.47;3.73;1087;17;1605.00;5
3666;16;620720561;3666;381;4755;4758;6.86;0.42;275.44;3.73;1089;17;1606.00;3
3667;16;620720577;3667;377;4755;4758;6.90;0.42;275.43;3.73;1088;17;1607.00;3
3672;16;620720593;3672;374;4759;4762;6.92;0.42;275.50;3.72;1087;17;1608.00;3
3674;16;620720608;3674;364;4759;4762;6.94;0.42;275.55;3.72;1085;17;1609.00;3
3677;16;620720623;3677;367;4759;4762;6.92;0.42;275.53;3.72;1082;17;1610.00;3
3679;16;620720637;3679;366;4760;4763;6.94;0.42;275.62;3.72;1081;17;1611.00;3
3681;16;620720653;3681;366;4760;4763;6.92;0.42;275.71;3.72;1079;17;1612.00;3
3684;16;620720679;3684;361;4765;4769;6.92;0.42;275.76;3.72;1081;17;1613.00;4
3685;16;620720695;3685;364;4765;4769;6.98;0.42;275.80;3.72;1080;17;1614.00;4
3686;16;620720711;3686;368;4765;4770;7.03;0.43;275.84;3.72;1079;17;1615.00;5
3687;16;620720726;3687;371;4765;4770;7.01;0.43;276.00;3.72;1078;17;1616.00;5
3688;16;620720741;3688;373;4765;4770;7.03;0.43;276.04;3.72;1077;17;1617.00;5
3692;16;620720755;3692;372;4765;4770;7.01;0.43;275.91;3.72;1073;17;1618.00;5
3693;16;620720777;3693;376;4765;4770;6.98;0.42;276.03;3.72;1072;17;1619.00;5
3697;16;620720795;3697;372;4792;4806;6.99;0.43;276.21;3.70;1095;17;1620.00;14
3699;16;620720814;3699;364;4794;4806;6.99;0.43;276.19;3.70;1095;17;1621.00;12
3704;16;620720829;3704;359;4796;4806;7.03;0.43;276.50;3.70;1092;17;1622.00;10
3705;16;620720844;3705;358;4797;4806;7.06;0.43;276.45;3.70;1092;17;1623.00;9
3707;16;620720866;3707;355;4797;4806;7.07;0.43;276.67;3.70;1090;17;1624.00;9
3709;16;620720880;3709;353;4798;4806;7.05;0.43;276.68;3.70;1089;17;1625.00;8
3712;16;620720895;3712;348;4801;4810;7.04;0.43;276.88;3.70;1089;17;1626.00;9
3716;16;620720910;3716;348;4801;4810;7.05;0.43;277.02;3.70;1085;17;1627.00;9
3721;16;620720925;3721;358;4805;4814;7.05;0.43;277.18;3.69;1084;17;1628.00;9
3724;16;620720941;3724;345;4806;4815;7.03;0.43;277.39;3.69;1082;17;1629.00;9
3726;16;620720957;3726;333;4806;4815;7.01;0.43;277.52;3.69;1080;17;1630.00;9
3728;16;620720970;3728;330;4806;4815;6.97;0.42;277.55;3.69;1078;17;1631.00;9
3729;16;620720984;3729;325;4817;4828;6.90;0.42;277.67;3.69;1088;17;1632.00;11
3731;16;620720998;3731;319;4817;4828;6.91;0.42;277.74;3.69;1086;17;1633.00;11
3734;16;620721013;3734;315;4817;4828;6.91;0.42;278.03;3.69;1083;17;1634.00;11
3735;16;620721028;3735;312;4819;4829;6.88;0.42;278.09;3.69;1084;17;1635.00;10
3738;16;620721044;3738;306;4819;4830;6.89;0.42;278.23;3.69;1081;17;1636.00;11
3742;16;620721059;3742;304;4819;4830;6.91;0.42;278.38;3.69;1077;17;1637.00;11
3748;16;620721073;3748;302;4821;4833;6.92;0.42;278.57;3.69;1073;17;1638.00;12
3751;16;620721090;3751;305;4821;4833;6.97;0.42;278.58;3.69;1070;17;1639.00;12
3755;16;620721108;3755;300;4822;4833;7.03;0.43;278.56;3.69;1067;17;1640.00;11
3758;16;620721123;3758;300;4822;4833;7.01;0.42;278.70;3.69;1064;17;1641.00;11
3762;16;620721137;3762;301;4827;4839;7.06;0.43;278.80;3.69;1065;17;1642.00;12
3763;16;620721151;3763;300;4827;4839;7.13;0.43;278.92;3.69;1064;17;1643.00;12
3769;16;620721165;3769;303;4827;4839;7.11;0.43;278.85;3.69;1058;17;1644.00;12
3772;16;620721180;3772;304;4827;4839;7.13;0.43;278.96;3.69;1055;17;1645.00;12
3777;16;620721203;3777;306;4830;4843;7.09;0.43;279.13;3.69;1053;17;1646.00;13
3779;16;620721220;3779;303;4832;4844;7.09;0.43;279.15;3.69;1053;17;1647.00;12
3782;16;620721234;3782;295;4832;4844;7.06;0.43;279.33;3.69;1050;17;1648.00;12
3786;16;620721255;3786;300;4833;4845;7.09;0.43;279.38;3.69;1047;17;1649.00;12
3788;16;620721270;3788;302;4833;4845;7.13;0.43;279.30;3.69;1045;17;1650.00;12
3791;16;620721284;3791;306;4833;4845;7.10;0.43;279.37;3.69;1042;17;1651.00;12
3795;16;620721299;3795;295;4833;4845;7.09;0.43;279.43;3.69;1038;17;1652.00;12
3796;16;620721312;3796;298;4833;4845;7.09;0.43;279.42;3.69;1037;17;1653.00;12
3800;16;620721325;3800;294;4833;4845;7.01;0.42;279.64;3.69;1033;17;1654.00;12
3802;16;620721339;3802;291;4833;4845;7.01;0.43;279.79;3.69;1031;17;1655.00;12
3804;16;620721354;3804;293;4870;4915;7.11;0.43;279.89;3.67;1066;17;1656.00;45
3808;16;620721375;3808;290;4870;4916;7.09;0.43;280.02;3.67;1062;17;1657.00;46
3809;16;620721394;3809;291;4877;4916;7.19;0.44;280.02;3.67;1068;17;1658.00;39
3811;16;620721416;3811;297;4880;4916;7.17;0.44;280.14;3.68;1069;17;1659.00;36
3814;16;620721443;3814;293;4886;4916;7.21;0.44;280.34;3.69;1072;17;1660.00;30
3815;16;620721465;3815;289;4887;4916;7.26;0.44;280.36;3.69;1072;17;1661.00;29
3816;16;620721483;3816;293;4891;4916;7.27;0.45;280.36;3.69;1075;17;1662.00;25
3820;16;620721502;3820;295;4893;4916;7.27;0.44;280.46;3.70;1073;17;1663.00;23
3825;16;620721519;3825;300;4895;4917;7.28;0.44;280.61;3.70;1070;17;1664.00;22
3827;16;620721537;3827;300;4900;4919;7.31;0.45;280.65;3.71;1073;17;1665.00;19
3830;16;620721554;3830;297;4905;4919;7.33;0.45;280.66;3.73;1075;17;1666.00;14
3832;16;620721570;3832;300;4910;4923;7.32;0.45;280.75;3.73;1078;17;1667.00;13
3835;16;620721586;3835;303;4914;4923;7.30;0.45;280.78;3.75;1079;17;1668.00;9
3840;16;620721604;3840;305;4914;4923;7.28;0.45;280.89;3.75;1074;17;1669.00;9
3842;16;620721621;3842;310;4914;4923;7.32;0.45;280.90;3.75;1072;17;1670.00;9
3845;16;620721636;3845;316;4921;4929;7.34;0.45;280.94;3.75;1076;17;1671.00;8
3849;16;620721652;3849;317;4921;4929;7.24;0.44;280.90;3.75;1072;17;1672.00;8
3851;16;620721671;3851;315;4922;4929;7.23;0.44;281.07;3.76;1071;17;1673.00;7
3854;17;620721688;3854;317;4925;4932;7.16;0.44;281.07;3.76;1071;18;1674.00;7
3854;17;620721732;3854;322;4926;4932;7.07;0.43;281.07;3.76;1072;18;1675.00;6
3855;18;620721749;3855;326;4926;4932;7.03;0.43;281.20;3.76;1071;19;1676.00;6
3860;18;620721798;3860;335;4929;4933;6.93;0.42;281.26;3.77;1069;19;1677.00;4
3862;18;620721816;3862;335;4930;4934;6.85;0.42;281.33;3.77;1068;19;1678.00;4
3865;18;620721838;3865;339;4931;4934;6.75;0.41;281.49;3.77;1066;19;1679.00;3
3866;18;620721857;3866;346;4948;4960;6.67;0.41;281.59;3.76;1082;19;1680.00;12
3869;18;620721876;3869;330;4953;4960;6.59;0.40;281.70;3.76;1084;19;1681.00;7
3874;18;620721895;3874;332;4955;4960;6.51;0.40;281.56;3.76;1081;19;1682.00;5
3877;18;620721911;3877;326;4957;4961;6.46;0.40;281.74;3.76;1080;19;1683.00;4
3880;18;620721927;3880;322;4957;4961;6.41;0.39;281.91;3.76;1077;19;1684.00;4
3883;18;620721943;3883;322;4961;4965;6.45;0.39;282.08;3.76;1078;19;1685.00;4
3885;18;620721960;3885;324;4962;4965;6.41;0.39;281.99;3.76;1077;19;1686.00;3
3887;18;620721975;3887;333;4965;4969;6.38;0.39;282.07;3.76;1078;19;1687.00;4
3891;18;620721992;3891;333;4965;4969;6.35;0.39;281.97;3.76;1074;19;1688.00;4
3892;18;620722007;3892;335;4966;4969;6.36;0.39;282.10;3.76;1074;19;1689.00;3
3899;18;620722025;3899;342;4968;4969;6.24;0.38;282.19;3.76;1069;19;1690.00;1
3900;18;620722041;3900;351;4968;4969;6.17;0.38;282.24;3.76;1068;19;1691.00;1
3904;18;620722055;3904;353;4980;4981;6.12;0.37;282.30;3.76;1076;19;1692.00;1
3910;18;620722071;3910;358;4980;4981;6.06;0.37;282.36;3.76;1070;19;1693.00;1
3914;18;620722085;3914;360;4981;4981;5.98;0.36;282.40;3.76;1067;19;1694.00;0
3915;18;620722100;3915;372;4981;4981;5.97;0.36;282.43;3.76;1066;19;1695.00;0
3917;18;620722114;3917;370;4981;4981;5.92;0.36;282.72;3.76;1064;19;1696.00;0
3920;18;620722128;3920;371;4981;4981;5.87;0.36;282.78;3.76;1061;19;1697.00;0
3924;18;620722143;3924;378;4982;4982;5.76;0.35;282.85;3.76;1058;19;1698.00;0
3927;18;620722156;3927;387;4982;4982;5.64;0.35;282.77;3.76;1055;19;1699.00;0
3931;18;620722172;3931;384;4988;4988;5.64;0.35;282.81;3.75;1057;19;1700.00;0
3937;18;620722196;3937;380;4989;4989;5.56;0.34;282.84;3.75;1052;19;1701.00;0
3940;18;620722210;3940;380;4989;4989;5.57;0.34;283.05;3.75;1049;19;1702.00;0
3944;18;620722226;3944;380;4989;4989;5.58;0.34;283.20;3.75;1045;19;1703.00;0
3948;18;620722241;3948;380;4993;4993;5.59;0.34;283.25;3.75;1045;19;1704.00;0
3952;18;620722257;3952;386;4993;4993;5.56;0.34;283.18;3.75;1041;19;1705.00;0
3959;18;620722271;3959;387;4993;4993;5.50;0.33;283.13;3.75;1034;19;1706.00;0
3962;18;620722286;3962;384;4994;4994;5.53;0.34;283.02;3.75;1032;19;1707.00;0
3963;18;620722301;3963;377;4998;4998;5.52;0.34;283.02;3.75;1035;19;1708.00;0
3967;18;620722317;3967;385;4998;4998;5.49;0.33;282.93;3.75;1031;19;1709.00;0
3971;18;620722336;3971;384;5002;5004;5.48;0.33;282.99;3.74;1031;19;1710.00;2
3975;18;620722350;3975;387;5003;5004;5.42;0.33;282.87;3.74;1028;19;1711.00;1
3977;18;620722365;3977;384;5004;5004;5.41;0.33;282.99;3.74;1027;19;1712.00;0
3980;18;620722378;3980;388;5004;5004;5.41;0.33;282.98;3.74;1024;19;1713.00;0
3983;18;620722391;3983;397;5008;5008;5.48;0.33;283.07;3.74;1025;19;1714.00;0
3985;18;620722406;3985;393;5008;5008;5.47;0.33;283.06;3.74;1023;19;1715.00;0
3988;18;620722420;3988;394;5008;5008;5.49;0.34;283.04;3.74;1020;19;1716.00;0
3991;18;620722435;3991;398;5008;5008;5.49;0.34;283.08;3.74;1017;19;1717.00;0
3995;18;620722447;3995;398;5009;5009;5.42;0.33;283.03;3.74;1014;19;1718.00;0
3998;18;620722460;3998;402;5010;5010;5.35;0.33;283.05;3.74;1012;19;1719.00;0
4002;18;620722473;4002;406;5010;5010;5.31;0.32;283.03;3.74;1008;19;1720.00;0
4005;18;620722485;4005;412;5011;5011;5.24;0.32;282.92;3.74;1006;19;1721.00;0
4009;18;620722497;4009;421;5011;5011;5.14;0.31;282.90;3.74;1002;19;1722.00;0
4015;18;620722509;4015;423;5011;5011;5.03;0.31;282.74;3.74;996;19;1723.00;0
4019;18;620722522;4019;431;5011;5011;4.93;0.30;282.85;3.74;992;19;1724.00;0
4023;18;620722536;4023;428;5011;5011;4.88;0.30;282.73;3.74;988;19;1725.00;0
4026;18;620722551;4026;428;5011;5011;4.86;0.30;282.74;3.74;985;19;1726.00;0
4030;18;620722566;4030;437;5011;5011;4.83;0.29;282.89;3.74;981;19;1727.00;0
4032;18;620722580;4032;450;5090;5138;5.24;0.33;282.88;3.68;1058;19;1728.00;48
4037;18;620722606;4037;449;5094;5139;5.24;0.33;282.86;3.68;1057;19;1729.00;45
4039;18;620722619;4039;454;5100;5139;5.29;0.33;282.82;3.68;1061;19;1730.00;39
4041;18;620722635;4041;452;5101;5139;5.29;0.33;282.86;3.68;1060;19;1731.00;38
4045;18;620722649;4045;455;5108;5139;5.36;0.33;282.90;3.68;1063;19;1732.00;31
4046;18;620722662;4046;451;5112;5139;5.36;0.33;282.93;3.68;1066;19;1733.00;27
4048;18;620722675;4048;458;5114;5139;5.35;0.33;283.02;3.68;1066;19;1734.00;25
4053;18;620722688;4053;469;5118;5139;5.28;0.33;283.03;3.68;1065;19;1735.00;21
4056;18;620722706;4056;471;5120;5140;5.18;0.32;282.95;3.68;1064;19;1736.00;20
4061;18;620722720;4061;473;5123;5141;5.07;0.31;283.01;3.69;1062;19;1737.00;18
4062;18;620722745;4062;479;5128;5141;5.04;0.31;283.04;3.69;1066;19;1738.00;13
4065;18;620722757;4065;471;5132;5142;5.02;0.31;283.12;3.70;1067;19;1739.00;10
4065;18;620722773;4065;471;5133;5142;5.01;0.31;283.12;3.70;1068;19;1740.00;9
4067;18;620722786;4067;471;5134;5142;5.02;0.31;283.21;3.70;1067;19;1741.00;8
4067;18;620722805;4067;477;5135;5142;5.06;0.31;283.21;3.70;1068;19;1742.00;7
4068;18;620722818;4068;482;5142;5146;5.11;0.32;283.24;3.71;1074;19;1743.00;4
4073;18;620722832;4073;481;5143;5146;5.08;0.31;283.16;3.71;1070;19;1744.00;3
4075;18;620722846;4075;485;5143;5146;5.07;0.31;283.19;3.71;1068;19;1745.00;3
4076;18;620722866;4076;491;5145;5149;5.13;0.32;283.23;3.71;1069;19;1746.00;4
4080;18;620722880;4080;482;5145;5149;5.15;0.32;283.33;3.71;1065;19;1747.00;4
4081;18;620722896;4081;477;5146;5149;5.21;0.32;283.32;3.71;1065;19;1748.00;3
4084;18;620722908;4084;464;5150;5153;5.26;0.32;283.30;3.71;1066;19;1749.00;3
4085;18;620722920;4085;462;5152;5154;5.37;0.33;283.30;3.71;1067;19;1750.00;2
4085;18;620722932;4085;462;5153;5154;5.45;0.34;283.30;3.71;1068;19;1751.00;1
4090;18;620722943;4090;456;5158;5158;5.53;0.34;283.35;3.71;1068;19;1752.00;0
4092;18;620722956;4092;455;5158;5158;5.60;0.34;283.28;3.71;1066;19;1753.00;0
4095;18;620722974;4095;457;5158;5158;5.63;0.34;283.27;3.71;1063;19;1754.00;0
4096;18;620722986;4096;458;5160;5160;5.64;0.35;283.21;3.71;1064;19;1755.00;0
4100;18;620722998;4100;445;5160;5160;5.64;0.35;283.38;3.71;1060;19;1756.00;0
4101;18;620723010;4101;430;5166;5166;5.71;0.35;283.41;3.71;1065;19;1757.00;0
4103;18;620723023;4103;423;5166;5166;5.78;0.35;283.46;3.71;1063;19;1758.00;0
4103;18;620723035;4103;428;5167;5167;5.83;0.36;283.46;3.70;1064;19;1759.00;0
4105;18;620723047;4105;427;5167;5167;5.89;0.36;283.44;3.70;1062;19;1760.00;0
4108;18;620723059;4108;421;5167;5167;5.94;0.36;283.56;3.70;1059;19;1761.00;0
4113;18;620723071;4113;428;5167;5167;5.96;0.36;283.65;3.70;1054;19;1762.00;0
4114;18;620723084;4114;417;5167;5167;6.08;0.37;283.81;3.70;1053;19;1763.00;0
4118;18;620723096;4118;414;5177;5179;6.21;0.38;283.85;3.70;1059;19;1764.00;2
4120;18;620723110;4120;412;5177;5179;6.28;0.38;283.86;3.70;1057;19;1765.00;2
4122;18;620723123;4122;409;5179;5179;6.32;0.38;283.76;3.70;1057;19;1766.00;0
4124;18;620723135;4124;397;5179;5179;6.36;0.39;283.85;3.70;1055;19;1767.00;0
4127;18;620723152;4127;400;5179;5179;6.40;0.39;283.89;3.70;1052;19;1768.00;0
4131;18;620723166;4131;393;5179;5179;6.41;0.39;284.04;3.70;1048;19;1769.00;0
4132;18;620723181;4132;387;5182;5183;6.42;0.39;284.05;3.70;1050;19;1770.00;1
4136;18;620723193;4136;381;5182;5183;6.45;0.39;284.49;3.70;1046;19;1771.00;1
4139;18;620723205;4139;373;5186;5187;6.52;0.40;284.59;3.69;1047;19;1772.00;1
4142;18;620723219;4142;367;5187;5188;6.51;0.40;284.77;3.69;1045;19;1773.00;1
4144;18;620723231;4144;376;5187;5188;6.52;0.40;284.86;3.69;1043;19;1774.00;1
4145;18;620723244;4145;382;5187;5188;6.57;0.40;284.89;3.69;1042;19;1775.00;1
4147;18;620723256;4147;392;5198;5201;6.74;0.41;284.97;3.68;1051;19;1776.00;3
4151;18;620723269;4151;402;5198;5201;6.76;0.41;285.07;3.68;1047;19;1777.00;3
4151;18;620723284;4151;405;5198;5201;6.75;0.41;285.07;3.68;1047;19;1778.00;3
4154;18;620723301;4154;404;5199;5202;6.82;0.41;285.29;3.68;1045;19;1779.00;3
4155;18;620723316;4155;407;5199;5203;6.84;0.42;285.29;3.68;1044;19;1780.00;4
4158;18;620723330;4158;407;5199;5203;6.86;0.42;285.42;3.68;1041;19;1781.00;4
4162;18;620723342;4162;409;5201;5206;6.84;0.41;285.45;3.68;1039;19;1782.00;5
4163;18;620723355;4163;410;5201;5206;6.80;0.41;285.54;3.68;1038;19;1783.00;5
4164;18;620723367;4164;415;5202;5206;6.77;0.41;285.57;3.68;1038;19;1784.00;4
4166;18;620723385;4166;422;5202;5206;6.66;0.40;285.62;3.68;1036;19;1785.00;4
4169;18;620723414;4169;421;5207;5212;6.65;0.40;285.72;3.68;1038;19;1786.00;5
4171;18;620723434;4171;419;5207;5212;6.63;0.40;285.75;3.68;1036;19;1787.00;5
4175;18;620723454;4175;419;5207;5212;6.57;0.40;285.78;3.68;1032;19;1788.00;5
4177;18;620723473;4177;419;5207;5212;6.54;0.40;285.84;3.68;1030;19;1789.00;5
4181;18;620723489;4181;410;5210;5216;6.49;0.39;286.02;3.68;1029;19;1790.00;6
4184;18;620723509;4184;404;5211;5217;6.51;0.40;286.24;3.68;1027;19;1791.00;6
4186;18;620723524;4186;396;5211;5217;6.51;0.40;286.30;3.68;1025;19;1792.00;6
4189;18;620723537;4189;394;5212;5218;6.55;0.40;286.45;3.68;1023;19;1793.00;6
4190;18;620723549;4190;394;5212;5218;6.58;0.40;286.42;3.68;1022;19;1794.00;6
4193;18;620723563;4193;386;5212;5218;6.61;0.40;286.51;3.68;1019;19;1795.00;6
4196;18;620723577;4196;383;5212;5218;6.61;0.40;286.77;3.68;1016;19;1796.00;6
4199;18;620723590;4199;384;5212;5218;6.60;0.40;286.79;3.68;1013;19;1797.00;6
4204;18;620723602;4204;379;5212;5218;6.59;0.40;286.90;3.68;1008;19;1798.00;6
4206;18;620723616;4206;371;5212;5218;6.62;0.40;287.00;3.68;1006;19;1799.00;6
4210;18;620723631;4210;391;5276;5356;6.60;0.41;287.21;3.63;1066;19;1800.00;80
4211;18;620723660;4211;371;5277;5357;6.66;0.41;287.33;3.63;1066;19;1801.00;80
4213;18;620723673;4213;356;5288;5357;6.75;0.42;287.30;3.63;1075;19;1802.00;69
4216;18;620723686;4216;348;5293;5357;6.77;0.42;287.48;3.63;1077;19;1803.00;64
4219;18;620723699;4219;344;5299;5357;6.81;0.42;287.52;3.63;1080;19;1804.00;58
4222;18;620723712;4222;334;5304;5357;6.87;0.42;287.62;3.64;1082;19;1805.00;53
4222;18;620723726;4222;333;5311;5357;6.92;0.42;287.62;3.64;1089;19;1806.00;46
4224;18;620723738;4224;327;5317;5357;6.99;0.43;287.67;3.65;1093;19;1807.00;40
4232;18;620723751;4232;322;5323;5358;6.96;0.43;288.06;3.65;1091;19;1808.00;35
4237;18;620723772;4237;321;5325;5359;6.99;0.43;288.12;3.65;1088;19;1809.00;34
4238;18;620723786;4238;308;5330;5359;7.03;0.43;288.18;3.66;1092;19;1810.00;29
4242;18;620723799;4242;306;5335;5363;7.00;0.43;288.44;3.66;1093;19;1811.00;28
4245;18;620723813;4245;303;5336;5363;6.90;0.42;288.37;3.66;1091;19;1812.00;27
4249;18;620723826;4249;291;5337;5363;6.83;0.42;288.49;3.66;1088;19;1813.00;26
4252;18;620723840;4252;296;5337;5363;6.78;0.41;288.63;3.66;1085;19;1814.00;26
4254;18;620723853;4254;288;5342;5369;6.82;0.41;288.69;3.66;1088;19;1815.00;27
4257;18;620723875;4257;294;5343;5369;6.73;0.41;288.79;3.66;1086;19;1816.00;26
4260;18;620723895;4260;288;5343;5369;6.71;0.41;288.78;3.66;1083;19;1817.00;26
4263;18;620723912;4263;290;5347;5372;6.74;0.41;288.67;3.66;1084;19;1818.00;25
4265;18;620723930;4265;288;5348;5372;6.83;0.42;288.79;3.67;1083;19;1819.00;24
4266;18;620723944;4266;290;5349;5372;6.91;0.42;288.75;3.67;1083;19;1820.00;23
4267;18;620723957;4267;288;5350;5373;6.97;0.43;288.80;3.67;1083;19;1821.00;23
4270;18;620723970;4270;293;5352;5374;7.04;0.43;288.75;3.68;1082;19;1822.00;22
4271;18;620723984;4271;293;5352;5374;7.12;0.43;288.74;3.68;1081;19;1823.00;22
4272;18;620723998;4272;302;5365;5387;7.13;0.44;288.74;3.68;1093;19;1824.00;22
4273;18;620724013;4273;299;5367;5387;7.18;0.44;288.79;3.68;1094;19;1825.00;20
4277;18;620724027;4277;302;5369;5387;7.21;0.44;288.79;3.69;1092;19;1826.00;18
4279;19;620724047;4279;305;5370;5388;7.24;0.44;288.73;3.69;1091;20;1827.00;18
4284;19;620724074;4284;310;5370;5388;7.27;0.44;288.86;3.69;1086;20;1828.00;18
4287;19;620724088;4287;312;5373;5392;7.26;0.44;288.94;3.69;1086;20;1829.00;19
4290;19;620724105;4290;312;5376;5392;7.20;0.44;289.07;3.70;1086;20;1830.00;16
4291;19;620724118;4291;314;5379;5396;7.13;0.43;289.04;3.70;1088;20;1831.00;17
4293;19;620724139;4293;316;5380;5396;7.10;0.43;288.99;3.71;1087;20;1832.00;16
4294;19;620724152;4294;313;5380;5396;7.10;0.43;288.98;3.71;1086;20;1833.00;16
4296;19;620724165;4296;318;5381;5396;7.01;0.43;289.14;3.72;1085;20;1834.00;15
4298;19;620724178;4298;325;5383;5396;6.93;0.42;289.17;3.73;1085;20;1835.00;13
4302;19;620724190;4302;333;5393;5408;6.91;0.42;289.25;3.72;1091;20;1836.00;15
4306;19;620724204;4306;337;5393;5408;6.79;0.41;289.30;3.72;1087;20;1837.00;15
4307;19;620724217;4307;339;5396;5408;6.72;0.41;289.45;3.74;1089;20;1838.00;12
4308;19;620724230;4308;352;5396;5408;6.66;0.41;289.47;3.74;1088;20;1839.00;12
4311;19;620724242;4311;359;5397;5408;6.56;0.40;289.63;3.74;1086;20;1840.00;11
4312;19;620724255;4312;375;5397;5408;6.49;0.40;289.66;3.74;1085;20;1841.00;11
4314;20;620724268;4314;382;5398;5409;6.37;0.39;289.75;3.75;1084;21;1842.00;11
4315;20;620724288;4315;390;5400;5409;6.32;0.39;289.72;3.76;1085;21;1843.00;9
4317;20;620724301;4317;395;5406;5415;6.34;0.39;289.82;3.77;1089;21;1844.00;9
4320;20;620724314;4320;400;5408;5417;6.30;0.39;289.92;3.77;1088;21;1845.00;9
4325;20;620724330;4325;408;5408;5417;6.21;0.38;289.80;3.77;1083;21;1846.00;9
4330;20;620724342;4330;416;5411;5417;6.14;0.38;289.87;3.78;1081;21;1847.00;6
4331;20;620724354;4331;423;5414;5421;6.06;0.37;289.84;3.78;1083;21;1848.00;7
4334;20;620724367;4334;415;5417;5421;5.95;0.36;289.88;3.79;1083;21;1849.00;4
4336;20;620724379;4336;415;5417;5421;5.91;0.36;290.06;3.79;1081;21;1850.00;4
4338;20;620724392;4338;417;5418;5422;5.89;0.36;290.12;3.79;1080;21;1851.00;4
4340;20;620724403;4340;418;5422;5426;5.90;0.36;290.16;3.79;1082;21;1852.00;4
4344;20;620724416;4344;413;5422;5426;5.86;0.36;290.12;3.79;1078;21;1853.00;4
4346;20;620724428;4346;410;5425;5429;5.88;0.36;290.14;3.79;1079;21;1854.00;4
4351;20;620724442;4351;410;5427;5429;5.87;0.36;290.16;3.79;1076;21;1855.00;2
4354;20;620724453;4354;407;5427;5429;5.87;0.36;290.19;3.79;1073;21;1856.00;2
4355;20;620724464;4355;404;5428;5429;5.90;0.36;290.22;3.80;1073;21;1857.00;1
4355;20;620724475;4355;405;5433;5433;6.00;0.37;290.22;3.79;1078;21;1858.00;0
4356;20;620724486;4356;406;5433;5433;6.03;0.37;290.19;3.79;1077;21;1859.00;0
4359;20;620724499;4359;409;5433;5433;5.99;0.37;290.19;3.79;1074;21;1860.00;0
4361;20;620724510;4361;410;5433;5433;5.94;0.36;290.20;3.79;1072;21;1861.00;0
4364;20;620724521;4364;413;5434;5434;5.85;0.36;290.41;3.79;1070;21;1862.00;0
4366;20;620724532;4366;426;5435;5435;5.79;0.36;290.51;3.79;1069;21;1863.00;0
4369;20;620724542;4369;426;5435;5435;5.71;0.35;290.54;3.79;1066;21;1864.00;0
4372;20;620724553;4372;425;5436;5436;5.67;0.35;290.54;3.79;1064;21;1865.00;0
4375;20;620724563;4375;432;5436;5436;5.58;0.34;290.63;3.79;1061;21;1866.00;0
4378;20;620724573;4378;442;5436;5436;5.48;0.34;290.56;3.79;1058;21;1867.00;0
4381;20;620724583;4381;447;5436;5436;5.31;0.33;290.50;3.79;1055;21;1868.00;0
4385;20;620724594;4385;455;5436;5436;5.16;0.32;290.43;3.79;1051;21;1869.00;0
4389;20;620724603;4389;450;5436;5436;5.04;0.31;290.37;3.79;1047;21;1870.00;0
4391;20;620724613;4391;447;5436;5436;4.93;0.30;290.35;3.79;1045;21;1871.00;0
4395;20;620724622;4395;464;5508;5563;5.20;0.33;290.35;3.74;1113;21;1872.00;55
4398;20;620724641;4398;450;5512;5564;5.14;0.32;290.38;3.74;1114;21;1873.00;52
4401;20;620724652;4401;450;5521;5564;5.18;0.32;290.23;3.74;1120;21;1874.00;43
4407;20;620724662;4407;451;5522;5564;5.15;0.32;290.29;3.74;1115;21;1875.00;42
4409;20;620724672;4409;448;5528;5564;5.21;0.33;290.29;3.74;1119;21;1876.00;36
4410;20;620724682;4410;444;5531;5564;5.26;0.33;290.33;3.74;1121;21;1877.00;33
4412;20;620724693;4412;442;5533;5564;5.24;0.33;290.35;3.74;1121;21;1878.00;31
4414;20;620724703;4414;443;5537;5564;5.25;0.33;290.34;3.74;1123;21;1879.00;27
4418;20;620724714;4418;441;5538;5565;5.22;0.32;290.39;3.74;1120;21;1880.00;27
4422;20;620724733;4422;453;5541;5566;5.23;0.32;290.42;3.75;1119;21;1881.00;25
4423;20;620724745;4423;456;5548;5568;5.19;0.32;290.39;3.75;1125;21;1882.00;20
4425;20;620724757;4425;456;5550;5569;5.14;0.32;290.42;3.75;1125;21;1883.00;19
4428;20;620724767;4428;459;5554;5569;5.13;0.32;290.56;3.76;1126;21;1884.00;15
4433;20;620724778;4433;464;5556;5569;5.08;0.32;290.53;3.76;1123;21;1885.00;13
4434;20;620724789;4434;464;5558;5569;5.12;0.32;290.52;3.77;1124;21;1886.00;11
4437;20;620724800;4437;468;5562;5573;5.11;0.32;290.54;3.77;1125;21;1887.00;11
4440;20;620724812;4440;477;5563;5573;5.09;0.31;290.48;3.77;1123;21;1888.00;10
4445;20;620724823;4445;481;5565;5573;5.07;0.31;290.55;3.77;1120;21;1889.00;8
4448;20;620724836;4448;487;5568;5579;5.05;0.31;290.50;3.77;1120;21;1890.00;11
4453;20;620724848;4453;466;5569;5579;5.02;0.31;290.41;3.77;1116;21;1891.00;10
4455;20;620724860;4455;461;5570;5579;5.04;0.31;290.38;3.77;1115;21;1892.00;9
4458;20;620724872;4458;458;5574;5583;5.08;0.31;290.38;3.77;1116;21;1893.00;9
4461;20;620724883;4461;457;5575;5584;5.11;0.32;290.30;3.77;1114;21;1894.00;9
4467;20;620724895;4467;458;5576;5584;5.08;0.31;290.09;3.78;1109;21;1895.00;8
4473;20;620724907;4473;458;5578;5588;5.07;0.31;290.10;3.78;1105;21;1896.00;10
4475;20;620724919;4475;457;5578;5588;5.03;0.31;290.09;3.78;1103;21;1897.00;10
4480;20;620724941;4480;455;5580;5588;5.04;0.31;290.14;3.78;1100;21;1898.00;8
4483;20;620724959;4483;459;5581;5589;5.01;0.31;290.22;3.78;1098;21;1899.00;8
4485;20;620724973;4485;462;5581;5589;5.05;0.31;290.18;3.78;1096;21;1900.00;8
4487;20;620724989;4487;452;5585;5595;5.12;0.32;290.24;3.78;1098;21;1901.00;10
4494;20;620725003;4494;451;5585;5595;5.11;0.32;290.27;3.78;1091;21;1902.00;10
4497;20;620725015;4497;454;5586;5596;5.12;0.32;290.24;3.79;1089;21;1903.00;10
4501;20;620725028;4501;456;5587;5596;5.07;0.31;290.28;3.79;1086;21;1904.00;9
4509;20;620725041;4509;457;5587;5596;5.03;0.31;290.30;3.79;1078;21;1905.00;9
4509;20;620725058;4509;460;5588;5596;5.10;0.31;290.30;3.79;1079;21;1906.00;8
4515;20;620725068;4515;463;5589;5596;5.06;0.31;290.31;3.79;1074;21;1907.00;7
4522;20;620725079;4522;461;5598;5608;5.15;0.32;290.40;3.79;1076;21;1908.00;10
4522;20;620725091;4522;463;5599;5608;5.22;0.32;290.40;3.79;1077;21;1909.00;9
4528;20;620725103;4528;460;5600;5608;5.24;0.32;290.45;3.79;1072;21;1910.00;8
4534;20;620725114;4534;470;5601;5608;5.20;0.32;290.60;3.79;1067;21;1911.00;7
4535;20;620725125;4535;470;5601;5608;5.22;0.32;290.74;3.79;1066;21;1912.00;7
4538;20;620725135;4538;471;5602;5608;5.26;0.32;290.70;3.79;1064;21;1913.00;6
4540;20;620725146;4540;481;5605;5612;5.31;0.32;290.82;3.79;1065;21;1914.00;7
4542;20;620725157;4542;481;5605;5612;5.31;0.32;290.85;3.79;1063;21;1915.00;7
4546;20;620725168;4546;490;5609;5616;5.33;0.32;290.94;3.79;1063;21;1916.00;7
4550;20;620725179;4550;478;5610;5617;5.32;0.32;290.99;3.78;1060;21;1917.00;7
4554;20;620725191;4554;470;5610;5617;5.34;0.32;291.15;3.78;1056;21;1918.00;7
4556;20;620725202;4556;466;5610;5617;5.31;0.32;291.28;3.78;1054;21;1919.00;7
4559;20;620725214;4559;467;5635;5646;5.40;0.33;291.31;3.77;1076;21;1920.00;11
4564;20;620725228;4564;465;5635;5646;5.40;0.33;291.53;3.77;1071;21;1921.00;11
4566;20;620725240;4566;463;5637;5646;5.44;0.33;291.56;3.77;1071;21;1922.00;9
4568;20;620725252;4568;460;5638;5647;5.47;0.33;291.69;3.77;1070;21;1923.00;9
4570;20;620725263;4570;453;5638;5648;5.40;0.33;291.93;3.77;1068;21;1924.00;10
4572;20;620725274;4572;452;5638;5648;5.40;0.33;291.87;3.77;1066;21;1925.00;10
4574;20;620725290;4574;444;5640;5651;5.38;0.33;292.03;3.77;1066;21;1926.00;11
4577;20;620725305;4577;434;5640;5651;5.35;0.33;292.10;3.77;1063;21;1927.00;11
4579;20;620725318;4579;427;5641;5651;5.39;0.33;292.05;3.77;1062;21;1928.00;10
4582;20;620725331;4582;425;5641;5651;5.46;0.33;292.27;3.77;1059;21;1929.00;10
4585;20;620725345;4585;416;5646;5657;5.53;0.34;292.39;3.76;1061;21;1930.00;11
4586;20;620725365;4586;415;5646;5657;5.65;0.34;292.41;3.76;1060;21;1931.00;11
4587;20;620725378;4587;416;5646;5657;5.77;0.35;292.47;3.76;1059;21;1932.00;11
4587;20;620725396;4587;416;5646;5657;5.81;0.35;292.47;3.76;1059;21;1933.00;11
4590;20;620725416;4590;418;5649;5661;5.82;0.35;292.56;3.76;1059;21;1934.00;12
4591;20;620725435;4591;415;5651;5663;5.91;0.36;292.56;3.76;1060;21;1935.00;12
4593;20;620725454;4593;418;5651;5663;5.95;0.36;292.61;3.76;1058;21;1936.00;12
4595;20;620725474;4595;415;5652;5664;6.01;0.36;292.67;3.76;1057;21;1937.00;12
4598;20;620725492;4598;411;5652;5664;6.06;0.37;292.65;3.76;1054;21;1938.00;12
4600;20;620725507;4600;407;5652;5664;6.10;0.37;292.71;3.76;1052;21;1939.00;12
4603;20;620725521;4603;405;5652;5664;6.07;0.37;292.83;3.76;1049;21;1940.00;12
4604;20;620725541;4604;404;5652;5664;6.12;0.37;292.94;3.76;1048;21;1941.00;12
4606;20;620725554;4606;402;5652;5664;6.16;0.37;293.00;3.76;1046;21;1942.00;12
4607;20;620725567;4607;401;5652;5664;6.18;0.38;293.03;3.76;1045;21;1943.00;12
4607;20;620725581;4607;419;5695;5734;6.12;0.37;293.03;3.73;1088;21;1944.00;39
4612;20;620725600;4612;416;5696;5735;6.15;0.37;293.28;3.73;1084;21;1945.00;39
4617;20;620725619;4617;408;5701;5735;6.22;0.38;293.51;3.73;1084;21;1946.00;34
4619;20;620725631;4619;404;5701;5735;6.20;0.38;293.57;3.73;1082;21;1947.00;34
4621;20;620725643;4621;406;5703;5735;6.21;0.38;293.55;3.73;1082;21;1948.00;32
4622;20;620725655;4622;413;5705;5735;6.17;0.38;293.54;3.73;1083;21;1949.00;30
4624;20;620725670;4624;418;5708;5737;6.12;0.37;293.56;3.73;1084;21;1950.00;29
4626;20;620725687;4626;423;5711;5737;6.09;0.37;293.61;3.73;1085;21;1951.00;26
4627;20;620725702;4627;423;5711;5738;6.03;0.37;293.59;3.73;1084;21;1952.00;27
4627;20;620725718;4627;431;5714;5739;6.03;0.37;293.59;3.73;1087;21;1953.00;25
4631;20;620725733;4631;432;5715;5739;5.99;0.36;293.71;3.73;1084;21;1954.00;24
4633;20;620725749;4633;436;5721;5743;5.97;0.36;293.74;3.74;1088;21;1955.00;22
4636;20;620725765;4636;441;5724;5743;5.98;0.36;293.69;3.74;1088;21;1956.00;19
4640;20;620725780;4640;441;5726;5743;5.98;0.36;293.99;3.74;1086;21;1957.00;17
4640;20;620725794;4640;448;5726;5743;6.02;0.37;293.99;3.74;1086;21;1958.00;17
4642;20;620725807;4642;445;5731;5749;6.07;0.37;294.00;3.74;1089;21;1959.00;18
4644;20;620725821;4644;444;5731;5749;6.08;0.37;293.97;3.74;1087;21;1960.00;18
4644;20;620725834;4644;442;5731;5749;6.13;0.37;293.97;3.74;1087;21;1961.00;18
4645;20;620725847;4645;442;5733;5752;6.14;0.37;294.05;3.74;1088;21;1962.00;19
4646;20;620725860;4646;440;5733;5752;6.11;0.37;294.07;3.74;1087;21;1963.00;19
4649;20;620725873;4649;437;5734;5752;6.12;0.37;294.09;3.74;1085;21;1964.00;18
4650;20;620725886;4650;429;5734;5753;6.09;0.37;294.14;3.74;1084;21;1965.00;19
4654;20;620725899;4654;429;5735;5754;6.12;0.37;294.32;3.74;1081;21;1966.00;19
4655;20;620725913;4655;428;5735;5754;6.12;0.37;294.33;3.74;1080;21;1967.00;19
4658;20;620725926;4658;425;5745;5767;6.08;0.37;294.41;3.73;1087;21;1968.00;22
4660;20;620725940;4660;417;5745;5767;6.07;0.37;294.45;3.73;1085;21;1969.00;22
4661;20;620725952;4661;413;5745;5767;6.03;0.37;294.39;3.73;1084;21;1970.00;22
4666;20;620725964;4666;404;5746;5768;5.94;0.36;294.48;3.73;1080;21;1971.00;22
4668;20;620725978;4668;399;5746;5768;5.90;0.36;294.59;3.73;1078;21;1972.00;22
4670;20;620725990;4670;396;5751;5772;5.86;0.36;294.72;3.73;1081;21;1973.00;21
4674;20;620726003;4674;393;5752;5772;5.81;0.35;294.75;3.74;1078;21;1974.00;20
4675;20;620726016;4675;389;5755;5776;5.80;0.35;294.80;3.74;1080;21;1975.00;21
4679;20;620726029;4679;382;5756;5776;5.82;0.35;295.04;3.76;1077;21;1976.00;20
4683;20;620726041;4683;385;5756;5776;5.86;0.36;295.11;3.76;1073;21;1977.00;20
4685;20;620726053;4685;378;5756;5776;5.89;0.36;295.23;3.76;1071;21;1978.00;20
4686;20;620726065;4686;377;5756;5776;5.94;0.36;295.28;3.76;1070;21;1979.00;20
4688;20;620726080;4688;380;5779;5810;6.08;0.37;295.35;3.74;1091;21;1980.00;31
4693;20;620726095;4693;374;5780;5810;6.05;0.37;295.50;3.74;1087;21;1981.00;30
4696;20;620726108;4696;370;5781;5810;6.08;0.37;295.58;3.74;1085;21;1982.00;29
4699;20;620726123;4699;367;5781;5810;6.10;0.37;295.50;3.74;1082;21;1983.00;29
4702;20;620726136;4702;369;5782;5810;6.09;0.37;295.60;3.74;1080;21;1984.00;28
4703;20;620726148;4703;363;5782;5810;6.15;0.37;295.66;3.74;1079;21;1985.00;28
4704;20;620726160;4704;362;5782;5811;6.12;0.37;295.73;3.74;1078;21;1986.00;29
4705;20;620726173;4705;359;5783;5811;6.14;0.37;295.79;3.74;1078;21;1987.00;28
4709;20;620726186;4709;358;5787;5817;6.17;0.38;295.69;3.74;1078;21;1988.00;30
4711;20;620726205;4711;359;5787;5818;6.16;0.38;295.74;3.74;1076;21;1989.00;31
4716;20;620726219;4716;359;5788;5818;6.12;0.37;295.69;3.74;1072;21;1990.00;30
4718;20;620726231;4718;370;5790;5818;6.11;0.37;295.69;3.74;1072;21;1991.00;28
4718;20;620726244;4718;364;5794;5822;6.15;0.37;295.69;3.75;1076;21;1992.00;28
4722;20;620726257;4722;366;5794;5822;6.13;0.37;295.70;3.75;1072;21;1993.00;28
4725;20;620726271;4725;366;5795;5822;6.12;0.37;295.66;3.76;1070;21;1994.00;27
4727;20;620726282;4727;364;5797;5823;6.15;0.37;295.69;3.76;1070;21;1995.00;26
4730;20;620726295;4730;371;5802;5827;6.12;0.37;295.73;3.77;1072;21;1996.00;25
4733;20;620726308;4733;368;5802;5827;6.10;0.37;295.80;3.77;1069;21;1997.00;25
4734;20;620726320;4734;372;5804;5830;6.13;0.37;295.87;3.77;1070;21;1998.00;26
4735;20;620726332;4735;374;5806;5830;6.12;0.37;295.85;3.78;1071;21;1999.00;24
4738;20;620726346;4738;377;5806;5830;6.06;0.37;295.87;3.78;1068;21;2000.00;24
4738;20;620726363;4738;381;5806;5830;6.03;0.37;295.87;3.78;1068;21;2001.00;24
4739;20;620726375;4739;390;5811;5834;6.02;0.37;295.85;3.80;1072;21;2002.00;23
4740;20;620726389;4740;388;5811;5834;5.99;0.37;295.82;3.80;1071;21;2003.00;23
4743;20;620726402;4743;390;5812;5834;5.94;0.36;295.75;3.81;1069;21;2004.00;22
4744;20;620726415;4744;397;5812;5834;5.86;0.36;295.73;3.81;1068;21;2005.00;22
4746;20;620726428;4746;404;5813;5835;5.77;0.35;295.74;3.83;1067;21;2006.00;22
4747;20;620726441;4747;409;5814;5836;5.71;0.35;295.71;3.83;1067;21;2007.00;22
4749;20;620726452;4749;416;5815;5836;5.63;0.34;295.67;3.84;1066;21;2008.00;21
4750;20;620726464;4750;421;5816;5837;5.61;0.34;295.79;3.84;1066;21;2009.00;21
4753;20;620726478;4753;434;5817;5837;5.56;0.34;295.67;3.86;1064;21;2010.00;20
4756;20;620726489;4756;429;5817;5837;5.53;0.34;295.61;3.86;1061;21;2011.00;20
4756;20;620726500;4756;430;5819;5837;5.48;0.34;295.61;3.88;1063;21;2012.00;18
4757;20;620726511;4757;428;5820;5837;5.43;0.33;295.58;3.90;1063;21;2013.00;17
4758;20;620726522;4758;432;5820;5837;5.39;0.33;295.53;3.90;1062;21;2014.00;17
4761;20;620726532;4761;430;5820;5837;5.35;0.33;295.44;3.90;1059;21;2015.00;17
4763;20;620726543;4763;451;5888;5964;5.64;0.35;295.39;3.88;1125;21;2016.00;76
4764;20;620726563;4764;452;5892;5965;5.66;0.35;295.36;3.87;1128;21;2017.00;73
4765;20;620726575;4765;447;5904;5965;5.77;0.36;295.31;3.89;1139;21;2018.00;61
4769;20;620726586;4769;447;5904;5965;5.76;0.36;295.24;3.89;1135;21;2019.00;61
4773;20;620726597;4773;443;5913;5965;5.78;0.36;295.20;3.91;1140;21;2020.00;52
4774;20;620726609;4774;441;5918;5965;5.75;0.36;295.14;3.91;1144;21;2021.00;47
4775;20;620726620;4775;436;5922;5965;5.77;0.36;295.13;3.92;1147;21;2022.00;43
4777;20;620726632;4777;435;5926;5965;5.76;0.36;295.14;3.93;1149;21;2023.00;39
4778;21;620726643;4778;438;5928;5966;5.82;0.36;295.11;3.93;1150;22;2024.00;38
4779;21;620726671;4779;438;5935;5968;5.82;0.36;295.08;3.95;1156;22;2025.00;33
4780;21;620726683;4780;438;5938;5968;5.80;0.36;295.02;3.95;1158;22;2026.00;30
4783;21;620726696;4783;442;5944;5969;5.77;0.35;294.98;3.97;1161;22;2027.00;25
4783;21;620726708;4783;449;5946;5969;5.73;0.35;294.98;3.98;1163;22;2028.00;23
4787;21;620726720;4787;450;5950;5969;5.63;0.35;294.87;3.99;1163;22;2029.00;19
4787;21;620726734;4787;456;5951;5969;5.52;0.34;294.87;3.99;1164;22;2030.00;18
4794;21;620726745;4794;459;5956;5973;5.44;0.33;294.85;4.00;1162;22;2031.00;17
4796;21;620726758;4796;466;5958;5973;5.31;0.33;294.78;4.00;1162;22;2032.00;15
4797;21;620726769;4797;481;5960;5973;5.19;0.32;294.76;4.01;1163;22;2033.00;13
4800;21;620726781;4800;489;5962;5976;5.09;0.31;294.79;4.01;1162;22;2034.00;14
4801;21;620726795;4801;498;5963;5976;5.00;0.31;294.79;4.01;1162;22;2035.00;13
4804;21;620726806;4804;504;5965;5976;4.87;0.30;294.73;4.02;1161;22;2036.00;11
4806;21;620726817;4806;517;5970;5980;4.79;0.29;294.78;4.02;1164;22;2037.00;10
4808;21;620726829;4808;522;5972;5981;4.69;0.29;294.66;4.03;1164;22;2038.00;9
4812;21;620726839;4812;533;5974;5981;4.58;0.28;294.64;4.03;1162;22;2039.00;7
4814;21;620726852;4814;523;5979;5986;4.58;0.28;294.64;4.03;1165;22;2040.00;7
4815;21;620726864;4815;520;5979;5986;4.57;0.28;294.63;4.03;1164;22;2041.00;7
4818;21;620726874;4818;521;5980;5986;4.51;0.28;294.61;4.03;1162;22;2042.00;6
4819;21;620726885;4819;501;5980;5987;4.51;0.28;294.63;4.03;1161;22;2043.00;7
4821;21;620726896;4821;489;5981;5987;4.55;0.28;294.56;4.03;1160;22;2044.00;6
4824;21;620726907;4824;481;5985;5993;4.65;0.29;294.56;4.03;1161;22;2045.00;8
4827;21;620726919;4827;476;5985;5993;4.70;0.29;294.50;4.03;1158;22;2046.00;8
4830;21;620726931;4830;466;5986;5994;4.78;0.29;294.42;4.03;1156;22;2047.00;8
4833;21;620726943;4833;459;5986;5994;4.84;0.30;294.39;4.03;1153;22;2048.00;8
4838;21;620726955;4838;456;5986;5994;4.86;0.30;294.28;4.03;1148;22;2049.00;8
4840;21;620726973;4840;452;5986;5994;4.90;0.30;294.22;4.03;1146;22;2050.00;8
4843;21;620726985;4843;444;5986;5994;4.97;0.30;294.17;4.03;1143;22;2051.00;8
4843;22;620726996;4843;439;5996;6006;5.10;0.31;294.17;4.02;1153;23;2052.00;10
4847;22;620727016;4847;441;5996;6006;5.16;0.32;294.16;4.02;1149;23;2053.00;10
4850;23;620727033;4850;438;5997;6006;5.21;0.32;294.16;4.02;1147;24;2054.00;9
4854;23;620727052;4854;444;5997;6006;5.23;0.32;294.12;4.02;1143;24;2055.00;9
4856;23;620727064;4856;443;5997;6006;5.31;0.32;294.19;4.02;1141;24;2056.00;9
4858;23;620727076;4858;440;5997;6006;5.34;0.33;294.17;4.02;1139;24;2057.00;9
4862;23;620727092;4862;443;6000;6010;5.41;0.33;294.19;4.02;1138;24;2058.00;10
4865;23;620727105;4865;444;6000;6010;5.38;0.33;294.19;4.02;1135;24;2059.00;10
4868;23;620727118;4868;435;6004;6014;5.41;0.33;294.33;4.02;1136;24;2060.00;10
4869;23;620727130;4869;440;6004;6015;5.42;0.33;294.37;4.02;1135;24;2061.00;11
4873;23;620727142;4873;441;6004;6015;5.37;0.33;294.37;4.02;1131;24;2062.00;11
4875;23;620727155;4875;448;6005;6015;5.34;0.33;294.42;4.02;1130;24;2063.00;10
4880;23;620727167;4880;449;6014;6028;5.40;0.33;294.55;4.01;1134;24;2064.00;14
4883;23;620727181;4883;451;6015;6028;5.40;0.33;294.48;4.01;1132;24;2065.00;13
4890;23;620727194;4890;453;6015;6028;5.38;0.33;294.58;4.01;1125;24;2066.00;13
4891;23;620727206;4891;459;6016;6029;5.42;0.33;294.60;4.01;1125;24;2067.00;13
4899;23;620727219;4899;457;6016;6030;5.40;0.33;294.83;4.01;1117;24;2068.00;14
4902;23;620727233;4902;442;6017;6030;5.38;0.33;294.79;4.01;1115;24;2069.00;13
4904;23;620727247;4904;444;6021;6036;5.42;0.33;294.85;4.01;1117;24;2070.00;15
4907;23;620727261;4907;438;6021;6036;5.45;0.33;294.94;4.01;1114;24;2071.00;15
4912;23;620727273;4912;443;6023;6036;5.42;0.33;294.92;4.01;1111;24;2072.00;13
4915;23;620727285;4915;437;6023;6036;5.42;0.33;294.95;4.01;1108;24;2073.00;13
4920;23;620727297;4920;438;6028;6042;5.41;0.33;295.03;4.00;1108;24;2074.00;14
4925;23;620727311;4925;440;6028;6042;5.46;0.33;295.16;4.00;1103;24;2075.00;14
4927;23;620727323;4927;438;6028;6042;5.53;0.34;295.30;4.00;1101;24;2076.00;14
4928;23;620727337;4928;442;6028;6042;5.56;0.34;295.31;4.00;1100;24;2077.00;14
4930;23;620727349;4930;441;6031;6046;5.58;0.34;295.45;4.00;1101;24;2078.00;15
4933;23;620727367;4933;437;6032;6047;5.60;0.34;295.56;4.00;1099;24;2079.00;15
4934;23;620727379;4934;439;6032;6047;5.57;0.34;295.61;4.00;1098;24;2080.00;15
4937;23;620727394;4937;443;6033;6048;5.56;0.34;295.81;4.00;1096;24;2081.00;15
4942;23;620727412;4942;444;6033;6048;5.49;0.33;295.90;4.00;1091;24;2082.00;15
4943;23;620727430;4943;447;6033;6048;5.43;0.33;295.91;4.00;1090;24;2083.00;15
4944;23;620727456;4944;450;6033;6048;5.43;0.33;296.01;4.00;1089;24;2084.00;15
4949;23;620727475;4949;450;6033;6048;5.39;0.33;296.13;4.00;1084;24;2085.00;15
4950;23;620727494;4950;459;6033;6048;5.37;0.33;296.18;4.00;1083;24;2086.00;15
4953;23;620727510;4953;454;6033;6048;5.37;0.33;296.41;4.00;1080;24;2087.00;15
4957;23;620727524;4957;483;6090;6118;5.28;0.32;296.53;3.96;1133;24;2088.00;28
4958;23;620727543;4958;462;6090;6119;5.32;0.33;296.56;3.96;1132;24;2089.00;29
4961;23;620727557;4961;455;6093;6119;5.39;0.33;296.77;3.96;1132;24;2090.00;26
4963;23;620727571;4963;445;6093;6119;5.45;0.33;296.80;3.96;1130;24;2091.00;26
4963;23;620727585;4963;448;6095;6119;5.54;0.34;296.80;3.96;1132;24;2092.00;24
4968;23;620727599;4968;435;6095;6119;5.57;0.34;297.11;3.96;1127;24;2093.00;24
4973;23;620727612;4973;436;6096;6119;5.60;0.34;297.29;3.96;1123;24;2094.00;23
4974;23;620727625;4974;439;6097;6119;5.64;0.34;297.31;3.96;1123;24;2095.00;22
4975;23;620727638;4975;418;6098;6120;5.69;0.35;297.43;3.96;1123;24;2096.00;22
4978;23;620727651;4978;407;6099;6121;5.71;0.35;297.71;3.96;1121;24;2097.00;22
4980;23;620727665;4980;411;6100;6121;5.72;0.35;297.82;3.97;1120;24;2098.00;21
4987;23;620727678;4987;403;6105;6125;5.68;0.34;298.03;3.96;1118;24;2099.00;20
4989;23;620727695;4989;416;6109;6140;5.71;0.35;298.09;3.96;1120;24;2100.00;31
4992;23;620727715;4992;412;6109;6140;5.80;0.35;298.23;3.96;1117;24;2101.00;31
4995;23;620727728;4995;417;6109;6140;5.81;0.35;298.46;3.96;1114;24;2102.00;31
4996;23;620727743;4996;422;6113;6146;5.82;0.35;298.58;3.96;1117;24;2103.00;33
5000;23;620727756;5000;425;6113;6146;5.81;0.35;298.70;3.96;1113;24;2104.00;33
5002;23;620727769;5002;432;6113;6146;5.86;0.36;298.94;3.96;1111;24;2105.00;33
5004;23;620727782;5004;440;6117;6149;5.84;0.36;299.03;3.96;1113;24;2106.00;32
5007;23;620727795;5007;435;6117;6149;5.82;0.35;299.00;3.96;1110;24;2107.00;32
5008;23;620727808;5008;428;6118;6149;5.86;0.36;299.04;3.96;1110;24;2108.00;31
5010;23;620727820;5010;427;6118;6150;5.86;0.36;299.01;3.96;1108;24;2109.00;32
5012;23;620727833;5012;424;6119;6151;5.89;0.36;299.11;3.96;1107;24;2110.00;32
5014;23;620727846;5014;422;6120;6151;5.88;0.36;299.25;3.96;1106;24;2111.00;31
5017;23;620727859;5017;421;6131;6164;5.94;0.36;299.50;3.95;1114;24;2112.00;33
5018;23;620727873;5018;413;6131;6164;5.95;0.36;299.52;3.95;1113;24;2113.00;33
5021;23;620727885;5021;414;6131;6164;5.93;0.36;299.58;3.95;1110;24;2114.00;33
5024;23;620727898;5024;412;6133;6166;5.91;0.36;299.78;3.95;1109;24;2115.00;33
5026;23;620727910;5026;413;6133;6166;5.90;0.36;299.81;3.95;1107;24;2116.00;33
5030;23;620727923;5030;417;6137;6170;5.85;0.36;299.94;3.95;1107;24;2117.00;33
5032;23;620727937;5032;420;6138;6170;5.78;0.35;300.04;3.96;1106;24;2118.00;32
5034;23;620727949;5034;421;6141;6174;5.69;0.35;300.13;3.95;1107;24;2119.00;33
5036;23;620727962;5036;419;6141;6174;5.59;0.34;300.20;3.95;1105;24;2120.00;33
5038;23;620727976;5038;421;6141;6174;5.55;0.34;300.26;3.95;1103;24;2121.00;33
5039;23;620727989;5039;417;6141;6174;5.56;0.34;300.26;3.95;1102;24;2122.00;33
5041;23;620728001;5041;421;6143;6174;5.47;0.33;300.29;3.96;1102;24;2123.00;31
5044;23;620728012;5044;415;6152;6186;5.42;0.33;300.26;3.95;1108;24;2124.00;34
5044;23;620728032;5044;430;6154;6186;5.38;0.33;300.26;3.96;1110;24;2125.00;32
5045;23;620728044;5045;435;6155;6186;5.38;0.33;300.26;3.96;1110;24;2126.00;31
5048;23;620728056;5048;436;6155;6186;5.38;0.33;300.31;3.96;1107;24;2127.00;31
5050;23;620728069;5050;437;6155;6186;5.41;0.33;300.38;3.96;1105;24;2128.00;31
5052;23;620728081;5052;436;6157;6186;5.42;0.33;300.52;3.96;1105;24;2129.00;29
5054;23;620728095;5054;436;6157;6187;5.43;0.33;300.58;3.96;1103;24;2130.00;30
5055;23;620728108;5055;434;6158;6187;5.50;0.33;300.66;3.96;1103;24;2131.00;29
5056;23;620728120;5056;429;6163;6193;5.59;0.34;300.67;3.96;1107;24;2132.00;30
5058;23;620728133;5058;418;6164;6194;5.61;0.34;300.67;3.96;1106;24;2133.00;30
5059;23;620728146;5059;406;6164;6194;5.62;0.34;300.65;3.96;1105;24;2134.00;30
5065;23;620728158;5065;400;6164;6194;5.60;0.34;300.89;3.96;1099;24;2135.00;30
5067;23;620728171;5067;397;6166;6198;5.66;0.34;300.97;3.96;1099;24;2136.00;32
5067;23;620728184;5067;390;6167;6198;5.74;0.35;300.97;3.96;1100;24;2137.00;31
5068;23;620728196;5068;385;6167;6198;5.79;0.35;301.02;3.96;1099;24;2138.00;31
5071;23;620728208;5071;378;6168;6199;5.78;0.35;301.10;3.96;1097;24;2139.00;31
5075;23;620728220;5075;375;6171;6203;5.72;0.35;301.22;3.96;1096;24;2140.00;32
5078;23;620728233;5078;367;6171;6203;5.67;0.34;301.41;3.96;1093;24;2141.00;32
5082;23;620728244;5082;358;6173;6206;5.62;0.34;301.53;3.96;1091;24;2142.00;33
5085;23;620728258;5085;366;6174;6206;5.56;0.34;301.59;3.96;1089;24;2143.00;32
5087;23;620728269;5087;363;6174;6206;5.56;0.34;301.66;3.96;1087;24;2144.00;32
5092;23;620728280;5092;360;6176;6206;5.52;0.34;301.74;4.00;1084;24;2145.00;30
5094;23;620728293;5094;364;6180;6210;5.55;0.34;301.80;3.99;1086;24;2146.00;30
5096;23;620728305;5096;364;6180;6210;5.52;0.34;301.84;3.99;1084;24;2147.00;30
5100;23;620728317;5100;362;6180;6210;5.50;0.34;301.81;3.99;1080;24;2148.00;30
5106;23;620728329;5106;363;6180;6210;5.45;0.33;301.89;3.99;1074;24;2149.00;30
5108;23;620728341;5108;367;6180;6211;5.45;0.33;301.88;3.99;1072;24;2150.00;31
5110;23;620728352;5110;364;6181;6212;5.48;0.33;302.01;3.99;1071;24;2151.00;31
5115;23;620728364;5115;365;6181;6212;5.46;0.33;302.19;3.99;1066;24;2152.00;31
5115;23;620728375;5115;370;6182;6213;5.51;0.33;302.19;3.99;1067;24;2153.00;31
5118;23;620728388;5118;371;6182;6213;5.49;0.33;302.13;3.99;1064;24;2154.00;31
5118;23;620728400;5118;369;6182;6213;5.51;0.33;302.13;3.99;1064;24;2155.00;31
5118;23;620728411;5118;371;6182;6213;5.57;0.34;302.13;3.99;1064;24;2156.00;31
5122;23;620728423;5122;374;6182;6213;5.53;0.34;302.36;3.99;1060;24;2157.00;31
5122;23;620728434;5122;373;6182;6213;5.52;0.34;302.36;3.99;1060;24;2158.00;31
5124;23;620728446;5124;371;6182;6213;5.50;0.33;302.33;3.99;1058;24;2159.00;31
5124;23;620728458;5124;399;6282;6443;5.84;0.37;302.33;3.93;1158;24;2160.00;161
5127;23;620728487;5127;398;6287;6444;5.78;0.36;302.31;3.93;1160;24;2161.00;157
5129;23;620728499;5129;383;6300;6444;5.84;0.37;302.24;3.92;1171;24;2162.00;144
5130;23;620728512;5130;373;6307;6444;5.82;0.37;302.23;3.92;1177;24;2163.00;137
5133;23;620728524;5133;372;6316;6444;5.83;0.37;302.12;3.92;1183;24;2164.00;128
5134;23;620728536;5134;368;6323;6444;5.82;0.37;302.10;3.92;1189;24;2165.00;121
5136;23;620728553;5136;361;6332;6444;5.84;0.37;302.10;3.93;1196;24;2166.00;112
5139;23;620728565;5139;361;6339;6444;5.80;0.36;302.12;3.93;1200;24;2167.00;105
5141;23;620728583;5141;363;6343;6445;5.83;0.36;302.19;3.93;1202;24;2168.00;102
5144;23;620728596;5144;367;6350;6446;5.81;0.36;302.19;3.94;1206;24;2169.00;96
5147;23;620728609;5147;371;6357;6446;5.79;0.36;302.13;3.97;1210;24;2170.00;89
5148;23;620728622;5148;381;6362;6447;5.74;0.36;302.17;3.97;1214;24;2171.00;85
5149;23;620728634;5149;385;6367;6447;5.66;0.35;302.11;4.00;1218;24;2172.00;80
5152;23;620728647;5152;393;6370;6447;5.59;0.35;302.05;4.01;1218;24;2173.00;77
5153;23;620728659;5153;407;6374;6447;5.52;0.34;302.00;4.01;1221;24;2174.00;73
5157;23;620728677;5157;418;6379;6451;5.38;0.33;301.93;4.04;1222;24;2175.00;72
5157;23;620728691;5157;427;6383;6451;5.27;0.33;301.93;4.06;1226;24;2176.00;68
5157;23;620728703;5157;433;6385;6451;5.18;0.32;301.93;4.08;1228;24;2177.00;66
5160;23;620728715;5160;444;6391;6454;5.09;0.32;301.85;4.11;1231;24;2178.00;63
5161;23;620728727;5161;453;6392;6454;5.02;0.31;301.82;4.11;1231;24;2179.00;62
5163;23;620728740;5163;459;6394;6454;4.97;0.31;301.78;4.12;1231;24;2180.00;60
5163;23;620728752;5163;467;6397;6458;4.91;0.30;301.78;4.11;1234;24;2181.00;61
5165;23;620728764;5165;477;6402;6459;4.84;0.30;301.74;4.16;1237;24;2182.00;57
5170;23;620728777;5170;478;6405;6459;4.79;0.30;301.64;4.18;1235;24;2183.00;54
5172;23;620728789;5172;488;6409;6463;4.78;0.29;301.62;4.20;1237;24;2184.00;54
5174;23;620728801;5174;490;6409;6463;4.76;0.29;301.73;4.20;1235;24;2185.00;54
5175;23;620728813;5175;495;6411;6463;4.71;0.29;301.75;4.22;1236;24;2186.00;52
5179;23;620728830;5179;502;6413;6464;4.65;0.28;301.73;4.23;1234;24;2187.00;51
5179;23;620728843;5179;504;6415;6464;4.62;0.28;301.73;4.26;1236;24;2188.00;49
5180;23;620728854;5180;500;6420;6470;4.66;0.29;301.71;4.27;1240;24;2189.00;50
5180;23;620728869;5180;501;6421;6470;4.62;0.28;301.71;4.27;1241;24;2190.00;49
5181;23;620728881;5181;501;6423;6471;4.60;0.28;301.65;4.30;1242;24;2191.00;48
5184;23;620728893;5184;505;6426;6471;4.60;0.28;301.69;4.33;1242;24;2192.00;45
5187;23;620728906;5187;515;6426;6471;4.60;0.28;301.64;4.33;1239;24;2193.00;45
5189;23;620728918;5189;514;6426;6471;4.61;0.28;301.58;4.33;1237;24;2194.00;45
5190;23;620728930;5190;502;6430;6471;4.61;0.28;301.54;4.36;1240;24;2195.00;41
5191;23;620728943;5191;501;6440;6483;4.62;0.28;301.48;4.37;1249;24;2196.00;43
5191;23;620728956;5191;484;6442;6483;4.62;0.28;301.48;4.38;1251;24;2197.00;41
5193;23;620728969;5193;486;6442;6483;4.60;0.28;301.39;4.38;1249;24;2198.00;41
5195;23;620728981;5195;488;6446;6483;4.61;0.28;301.41;4.42;1251;24;2199.00;37
5197;23;620728995;5197;486;6447;6483;4.62;0.28;301.36;4.43;1250;24;2200.00;36
5198;23;620729011;5198;487;6447;6483;4.65;0.28;301.31;4.43;1249;24;2201.00;36
5200;23;620729029;5200;489;6452;6487;4.65;0.28;301.36;4.43;1252;24;2202.00;35
5202;23;620729041;5202;486;6452;6487;4.68;0.29;301.28;4.43;1250;24;2203.00;35
5205;23;620729054;5205;487;6456;6491;4.67;0.29;301.29;4.43;1251;24;2204.00;35
5207;23;620729067;5207;485;6461;6493;4.65;0.29;301.31;4.48;1254;24;2205.00;32
5210;23;620729079;5210;483;6463;6493;4.60;0.28;301.30;4.49;1253;24;2206.00;30
5212;23;620729091;5212;489;6463;6493;4.59;0.28;301.32;4.49;1251;24;2207.00;30
5215;23;620729103;5215;494;6475;6506;4.54;0.28;301.25;4.50;1260;24;2208.00;31
5217;23;620729116;5217;508;6476;6506;4.49;0.28;301.24;4.50;1259;24;2209.00;30
5219;23;620729135;5219;500;6478;6508;4.49;0.28;301.17;4.50;1259;24;2210.00;30
5223;23;620729147;5223;490;6479;6509;4.51;0.28;301.17;4.50;1256;24;2211.00;30
5223;23;620729160;5223;484;6479;6510;4.58;0.28;301.17;4.50;1256;24;2212.00;31
5227;23;620729172;5227;479;6479;6510;4.60;0.28;301.10;4.50;1252;24;2213.00;31
5229;23;620729185;5229;477;6480;6513;4.67;0.29;301.03;4.50;1251;24;2214.00;33
5231;23;620729198;5231;476;6480;6513;4.73;0.29;301.00;4.50;1249;24;2215.00;33
5234;23;620729210;5234;466;6480;6513;4.78;0.29;301.06;4.50;1246;24;2216.00;33
5236;23;620729223;5236;463;6480;6513;4.83;0.30;301.02;4.50;1244;24;2217.00;33
5242;23;620729240;5242;457;6484;6519;4.89;0.30;301.23;4.49;1242;24;2218.00;35
5245;23;620729254;5245;449;6484;6519;4.99;0.31;301.23;4.49;1239;24;2219.00;35
5247;23;620729269;5247;439;6484;6519;5.02;0.31;301.21;4.49;1237;24;2220.00;35
5251;23;620729281;5251;433;6484;6519;5.05;0.31;301.43;4.49;1233;24;2221.00;35
5257;23;620729293;5257;428;6487;6523;5.12;0.31;301.40;4.49;1230;24;2222.00;36
5261;23;620729307;5261;421;6487;6524;5.20;0.32;301.53;4.49;1226;24;2223.00;37
5264;23;620729320;5264;420;6487;6524;5.30;0.33;301.66;4.49;1223;24;2224.00;37
5271;23;620729333;5271;415;6488;6525;5.39;0.33;301.73;4.49;1217;24;2225.00;37
5273;24;620729347;5273;412;6488;6525;5.49;0.34;301.79;4.49;1215;25;2226.00;37
5278;24;620729367;5278;409;6488;6525;5.57;0.34;301.93;4.49;1210;25;2227.00;37
5282;24;620729384;5282;404;6488;6525;5.65;0.35;302.11;4.49;1206;25;2228.00;37
5285;24;620729402;5285;401;6488;6525;5.67;0.35;302.23;4.49;1203;25;2229.00;37
5290;24;620729425;5290;396;6488;6525;5.71;0.35;302.30;4.49;1198;25;2230.00;37
5294;24;620729447;5294;397;6488;6525;5.70;0.35;302.30;4.49;1194;25;2231.00;37
5299;24;620729472;5299;400;6527;6595;5.76;0.35;302.40;4.48;1228;25;2232.00;68
5305;24;620729500;5305;390;6530;6596;5.74;0.35;302.75;4.47;1225;25;2233.00;66
5309;24;620729519;5309;388;6533;6596;5.73;0.35;302.81;4.48;1224;25;2234.00;63
5313;24;620729534;5313;383;6535;6596;5.70;0.35;302.90;4.47;1222;25;2235.00;61
5316;24;620729550;5316;383;6536;6596;5.70;0.35;303.11;4.47;1220;25;2236.00;60
5319;24;620729565;5319;382;6537;6596;5.70;0.35;303.26;4.47;1218;25;2237.00;59
5325;24;620729582;5325;387;6537;6596;5.65;0.35;303.42;4.47;1212;25;2238.00;59
5328;24;620729598;5328;385;6537;6596;5.58;0.34;303.38;4.47;1209;25;2239.00;59
5333;24;620729613;5333;396;6537;6597;5.50;0.34;303.35;4.47;1204;25;2240.00;60
5337;24;620729628;5337;395;6538;6598;5.44;0.33;303.42;4.48;1201;25;2241.00;60
5337;24;620729643;5337;402;6540;6598;5.45;0.33;303.42;4.48;1203;25;2242.00;58
5343;24;620729657;5343;398;6544;6602;5.43;0.33;303.53;4.49;1201;25;2243.00;58
5345;24;620729672;5345;400;6545;6602;5.46;0.33;303.52;4.49;1200;25;2244.00;57
5350;24;620729687;5350;405;6545;6602;5.45;0.33;303.47;4.49;1195;25;2245.00;57
5352;24;620729701;5352;410;6547;6602;5.49;0.33;303.48;4.49;1195;25;2246.00;55
5356;24;620729716;5356;403;6551;6608;5.51;0.34;303.66;4.50;1195;25;2247.00;57
5356;24;620729732;5356;402;6554;6608;5.58;0.34;303.66;4.51;1198;25;2248.00;54
5360;24;620729747;5360;402;6554;6608;5.56;0.34;303.81;4.51;1194;25;2249.00;54
5364;24;620729762;5364;399;6558;6614;5.60;0.34;303.92;4.51;1194;25;2250.00;56
5366;24;620729777;5366;405;6558;6614;5.58;0.34;303.90;4.51;1192;25;2251.00;56
5367;24;620729791;5367;406;6561;6614;5.55;0.34;303.92;4.52;1194;25;2252.00;53
5372;24;620729805;5372;410;6561;6615;5.47;0.33;304.04;4.52;1189;25;2253.00;54
5375;24;620729827;5375;412;6562;6616;5.45;0.33;304.09;4.52;1187;25;2254.00;54
5376;24;620729841;5376;421;6563;6616;5.47;0.33;304.08;4.52;1187;25;2255.00;53
5380;24;620729855;5380;427;6572;6629;5.47;0.33;304.04;4.52;1192;25;2256.00;57
5385;24;620729872;5385;423;6574;6629;5.46;0.33;304.32;4.52;1189;25;2257.00;55
5387;24;620729886;5387;421;6576;6629;5.43;0.33;304.30;4.54;1189;25;2258.00;53
5389;24;620729901;5389;418;6577;6630;5.42;0.33;304.42;4.54;1188;25;2259.00;53
5393;24;620729915;5393;418;6579;6630;5.42;0.33;304.58;4.56;1186;25;2260.00;51
5397;24;620729930;5397;417;6583;6634;5.48;0.33;304.61;4.56;1186;25;2261.00;51
5400;24;620729946;5400;419;6583;6634;5.54;0.34;304.76;4.56;1183;25;2262.00;51
5404;24;620729960;5404;421;6588;6638;5.61;0.34;304.70;4.56;1184;25;2263.00;50
5405;24;620729980;5405;423;6588;6638;5.64;0.34;304.71;4.56;1183;25;2264.00;50
5409;24;620729994;5409;424;6589;6638;5.61;0.34;304.84;4.56;1180;25;2265.00;49
5413;24;620730010;5413;420;6590;6638;5.61;0.34;304.97;4.57;1177;25;2266.00;48
5416;24;620730024;5416;419;6590;6638;5.58;0.34;304.96;4.57;1174;25;2267.00;48
5420;24;620730041;5420;415;6601;6650;5.57;0.34;305.16;4.58;1181;25;2268.00;49
5421;24;620730059;5421;413;6601;6650;5.59;0.34;305.15;4.58;1180;25;2269.00;49
5421;24;620730074;5421;420;6602;6650;5.65;0.34;305.15;4.58;1181;25;2270.00;48
5424;24;620730088;5424;426;6603;6650;5.69;0.35;305.40;4.58;1179;25;2271.00;47
5427;24;620730103;5427;428;6603;6650;5.73;0.35;305.45;4.58;1176;25;2272.00;47
5428;24;620730117;5428;436;6603;6650;5.76;0.35;305.52;4.58;1175;25;2273.00;47
5430;24;620730132;5430;437;6604;6651;5.80;0.35;305.51;4.59;1174;25;2274.00;47
5432;24;620730147;5432;445;6605;6651;5.80;0.35;305.65;4.59;1173;25;2275.00;46
5436;24;620730161;5436;455;6610;6657;5.81;0.35;305.63;4.59;1174;26;2276.00;47
5441;24;620730187;5441;455;6611;6658;5.84;0.36;305.91;4.59;1170;26;2277.00;47
5444;24;620730204;5444;452;6614;6658;5.83;0.35;306.04;4.59;1170;26;2278.00;44
5447;24;620730227;5447;446;6614;6658;5.81;0.35;306.02;4.59;1167;26;2279.00;44
5451;24;620730244;5451;450;6617;6663;5.76;0.35;306.25;4.59;1166;26;2280.00;46
5454;24;620730259;5454;448;6619;6663;5.74;0.35;306.41;4.60;1165;26;2281.00;44
5458;24;620730273;5458;445;6620;6663;5.75;0.35;306.78;4.60;1162;26;2282.00;43
5461;24;620730288;5461;452;6621;6664;5.72;0.35;307.02;4.60;1160;26;2283.00;43
5462;24;620730302;5462;455;6625;6668;5.74;0.35;307.13;4.60;1163;26;2284.00;43
5466;24;620730316;5466;453;6626;6668;5.70;0.35;307.29;4.60;1160;26;2285.00;42
5470;24;620730330;5470;447;6628;6671;5.65;0.34;307.37;4.60;1158;26;2286.00;43
5472;24;620730345;5472;451;6628;6671;5.59;0.34;307.39;4.60;1156;26;2287.00;43
5475;24;620730359;5475;451;6629;6671;5.54;0.34;307.42;4.60;1154;26;2288.00;42
5477;24;620730372;5477;448;6629;6671;5.47;0.33;307.49;4.60;1152;26;2289.00;42
5484;24;620730386;5484;449;6633;6675;5.40;0.33;307.64;4.60;1149;26;2290.00;42
5484;24;620730402;5484;454;6633;6675;5.43;0.33;307.64;4.60;1149;26;2291.00;42
5489;24;620730414;5489;464;6633;6675;5.37;0.33;307.76;4.60;1144;26;2292.00;42
5492;24;620730429;5492;467;6633;6675;5.34;0.33;307.82;4.60;1141;26;2293.00;42
5495;24;620730443;5495;464;6633;6676;5.30;0.32;307.84;4.60;1138;26;2294.00;43
5498;24;620730456;5498;473;6635;6678;5.28;0.32;307.83;4.59;1137;26;2295.00;43
5501;24;620730469;5501;478;6635;6678;5.22;0.32;307.86;4.59;1134;26;2296.00;43
5503;24;620730481;5503;479;6636;6679;5.18;0.32;307.88;4.59;1133;26;2297.00;43
5505;24;620730493;5505;477;6636;6679;5.10;0.31;307.95;4.59;1131;26;2298.00;43
5508;24;620730504;5508;477;6636;6679;5.03;0.31;308.06;4.59;1128;26;2299.00;43
5511;24;620730517;5511;479;6636;6679;4.97;0.30;308.11;4.59;1125;26;2300.00;43
5517;24;620730533;5517;477;6636;6679;4.90;0.30;308.16;4.59;1119;26;2301.00;43
5518;24;620730544;5518;473;6636;6679;4.90;0.30;308.14;4.59;1118;26;2302.00;43
5519;24;620730556;5519;471;6636;6679;4.95;0.30;308.17;4.59;1117;26;2303.00;43
5520;24;620730568;5520;496;6708;6806;5.11;0.31;308.13;4.54;1188;26;2304.00;98
5521;24;620730590;5521;485;6708;6807;5.17;0.32;308.19;4.54;1187;26;2305.00;99
5524;24;620730602;5524;470;6715;6807;5.25;0.32;308.18;4.54;1191;26;2306.00;92
5526;24;620730615;5526;464;6716;6807;5.29;0.33;308.22;4.54;1190;26;2307.00;91
5529;24;620730627;5529;464;6722;6807;5.29;0.32;308.31;4.54;1193;26;2308.00;85
5530;24;620730640;5530;461;6726;6807;5.31;0.33;308.33;4.54;1196;26;2309.00;81
5533;24;620730654;5533;461;6729;6807;5.29;0.32;308.32;4.54;1196;26;2310.00;78
5534;24;620730672;5534;462;6731;6807;5.28;0.32;308.31;4.54;1197;26;2311.00;76
5535;24;620730684;5535;467;6733;6808;5.24;0.32;308.42;4.54;1198;26;2312.00;75
5536;24;620730701;5536;470;6737;6809;5.21;0.32;308.39;4.55;1201;26;2313.00;72
5537;24;620730714;5537;470;6740;6809;5.18;0.32;308.38;4.57;1203;26;2314.00;69
5541;24;620730728;5541;469;6742;6810;5.12;0.31;308.41;4.60;1201;26;2315.00;68
5543;24;620730741;5543;477;6746;6810;5.06;0.31;308.41;4.61;1203;26;2316.00;64
5548;24;620730758;5548;471;6748;6810;4.99;0.31;308.30;4.61;1200;26;2317.00;62
5551;24;620730770;5551;462;6751;6810;4.95;0.30;308.26;4.61;1200;26;2318.00;59
5551;24;620730782;5551;473;6755;6814;4.94;0.30;308.26;4.61;1204;26;2319.00;59
5552;24;620730795;5552;468;6758;6814;4.94;0.30;308.22;4.62;1206;26;2320.00;56
5553;24;620730808;5553;465;6758;6814;4.98;0.30;308.21;4.62;1205;26;2321.00;56
5555;24;620730820;5555;480;6760;6817;4.98;0.30;308.13;4.62;1205;26;2322.00;57
5557;24;620730835;5557;479;6762;6817;4.97;0.30;308.04;4.62;1205;26;2323.00;55
5559;24;620730848;5559;481;6763;6817;4.96;0.30;307.95;4.62;1204;26;2324.00;54
5561;24;620730861;5561;481;6766;6821;4.97;0.30;307.85;4.62;1205;26;2325.00;55
5563;24;620730874;5563;484;6769;6822;4.93;0.30;307.80;4.62;1206;26;2326.00;53
5564;24;620730887;5564;484;6770;6822;4.91;0.30;307.77;4.62;1206;26;2327.00;52
5565;24;620730900;5565;483;6773;6826;4.88;0.30;307.74;4.62;1208;26;2328.00;53
5569;24;620730913;5569;481;6773;6826;4.83;0.29;307.72;4.62;1204;26;2329.00;53
5570;24;620730926;5570;485;6773;6826;4.81;0.29;307.66;4.62;1203;26;2330.00;53
5572;24;620730939;5572;493;6774;6827;4.81;0.29;307.61;4.62;1202;26;2331.00;53
5572;24;620730952;5572;502;6774;6827;4.81;0.29;307.61;4.62;1202;26;2332.00;53
5572;24;620730963;5572;501;6779;6833;4.88;0.30;307.61;4.62;1207;26;2333.00;54
5574;24;620730979;5574;512;6779;6833;4.86;0.30;307.68;4.62;1205;26;2334.00;54
5574;24;620730992;5574;517;6779;6834;4.86;0.30;307.68;4.62;1205;26;2335.00;55
5575;24;620731004;5575;517;6780;6834;4.83;0.30;307.71;4.64;1205;26;2336.00;54
5576;24;620731016;5576;525;6781;6834;4.81;0.29;307.68;4.67;1205;26;2337.00;53
5578;24;620731029;5578;530;6782;6834;4.78;0.29;307.62;4.69;1204;26;2338.00;52
5580;24;620731041;5580;531;6783;6834;4.78;0.29;307.63;4.72;1203;26;2339.00;51
5580;24;620731062;5580;533;6810;6870;4.86;0.30;307.63;4.73;1230;26;2340.00;60
5582;24;620731077;5582;536;6812;6870;4.83;0.30;307.66;4.75;1230;26;2341.00;58
5584;24;620731090;5584;540;6814;6870;4.84;0.30;307.68;4.75;1230;26;2342.00;56
5584;24;620731103;5584;549;6815;6870;4.85;0.30;307.68;4.78;1231;26;2343.00;55
5586;24;620731116;5586;549;6817;6870;4.82;0.30;307.64;4.80;1231;26;2344.00;53
5587;24;620731128;5587;550;6817;6870;4.78;0.29;307.61;4.80;1230;26;2345.00;53
5588;24;620731140;5588;558;6822;6874;4.71;0.29;307.57;4.83;1234;26;2346.00;52
5589;24;620731153;5589;553;6822;6874;4.66;0.28;307.54;4.83;1233;26;2347.00;52
5590;24;620731166;5590;550;6827;6878;4.68;0.29;307.56;4.85;1237;26;2348.00;51
5592;24;620731180;5592;543;6828;6879;4.67;0.29;307.54;4.85;1236;26;2349.00;51
5594;24;620731192;5594;544;6829;6879;4.64;0.28;307.46;4.88;1235;26;2350.00;50
5594;24;620731205;5594;548;6829;6879;4.60;0.28;307.46;4.88;1235;26;2351.00;50
5595;24;620731217;5595;552;6841;6892;4.62;0.28;307.44;4.90;1246;26;2352.00;51
5596;24;620731231;5596;543;6841;6892;4.56;0.28;307.39;4.90;1245;26;2353.00;51
5598;24;620731244;5598;542;6842;6892;4.52;0.28;307.40;4.93;1244;26;2354.00;50
5598;24;620731257;5598;548;6843;6893;4.53;0.28;307.40;4.93;1245;26;2355.00;50
5600;24;620731269;5600;545;6845;6894;4.53;0.28;307.35;4.98;1245;26;2356.00;49
5600;24;620731288;5600;544;6845;6894;4.58;0.28;307.35;4.98;1245;26;2357.00;49
5604;24;620731301;5604;548;6850;6897;4.63;0.28;307.28;5.02;1246;26;2358.00;47
5604;24;620731314;5604;545;6850;6897;4.66;0.28;307.28;5.02;1246;26;2359.00;47
5604;24;620731327;5604;534;6852;6897;4.67;0.28;307.28;5.07;1248;26;2360.00;45
5606;24;620731339;5606;533;6852;6897;4.70;0.29;307.24;5.07;1246;26;2361.00;45
5607;24;620731357;5607;523;6859;6903;4.73;0.29;307.19;5.11;1252;26;2362.00;44
5611;24;620731370;5611;520;6859;6903;4.74;0.29;307.07;5.11;1248;26;2363.00;44
5611;24;620731383;5611;514;6859;6903;4.75;0.29;307.07;5.11;1248;26;2364.00;44
5613;24;620731397;5613;508;6861;6903;4.76;0.29;307.02;5.16;1248;26;2365.00;42
5613;24;620731416;5613;514;6864;6907;4.76;0.29;307.02;5.16;1251;26;2366.00;43
5614;24;620731437;5614;507;6867;6908;4.75;0.29;306.99;5.20;1253;26;2367.00;41
5616;24;620731458;5616;499;6867;6908;4.72;0.29;306.93;5.20;1251;26;2368.00;41
5617;24;620731477;5617;498;6869;6909;4.70;0.29;306.90;5.21;1252;26;2369.00;40
5617;24;620731498;5617;490;6870;6909;4.74;0.29;306.90;5.23;1253;26;2370.00;39
5617;24;620731515;5617;491;6870;6909;4.77;0.29;306.90;5.23;1253;26;2371.00;39
5622;24;620731529;5622;492;6870;6909;4.69;0.29;307.03;5.23;1248;26;2372.00;39
5625;24;620731543;5625;488;6872;6909;4.65;0.28;307.06;5.27;1247;26;2373.00;37
5625;24;620731567;5625;488;6872;6909;4.67;0.28;307.06;5.27;1247;26;2374.00;37
5629;24;620731585;5629;494;6872;6909;4.64;0.28;307.15;5.27;1243;26;2375.00;37
5632;24;620731599;5632;508;6922;6979;4.68;0.29;307.25;5.27;1290;26;2376.00;57
5636;24;620731619;5636;497;6922;6980;4.70;0.29;307.38;5.27;1286;26;2377.00;58
5637;24;620731632;5637;497;6926;6980;4.69;0.29;307.41;5.31;1289;26;2378.00;54
5641;24;620731645;5641;500;6930;6980;4.65;0.28;307.41;5.32;1289;26;2379.00;50
5645;24;620731657;5645;479;6932;6980;4.68;0.29;307.53;5.34;1287;26;2380.00;48
5648;24;620731671;5648;473;6932;6980;4.70;0.29;307.68;5.34;1284;26;2381.00;48
5651;24;620731685;5651;474;6934;6980;4.70;0.29;307.81;5.37;1283;26;2382.00;46
5653;24;620731698;5653;466;6935;6980;4.73;0.29;307.82;5.37;1282;26;2383.00;45
5657;24;620731712;5657;466;6937;6981;4.75;0.29;307.97;5.40;1280;26;2384.00;44
5659;24;620731731;5659;467;6938;6983;4.75;0.29;308.01;5.40;1279;26;2385.00;45
5662;24;620731746;5662;471;6938;6983;4.79;0.29;308.05;5.40;1276;26;2386.00;45
5664;24;620731759;5664;479;6941;6987;4.86;0.30;308.07;5.40;1277;26;2387.00;46
5667;24;620731774;5667;478;6941;6987;4.91;0.30;308.22;5.40;1274;26;2388.00;46
5668;24;620731788;5668;475;6942;6987;5.00;0.31;308.25;5.40;1274;26;2389.00;45
5673;24;620731807;5673;461;6942;6987;5.04;0.31;308.40;5.40;1269;26;2390.00;45
5675;24;620731822;5675;454;6945;6993;5.12;0.31;308.48;5.40;1270;26;2391.00;48
5681;24;620731838;5681;453;6946;6993;5.15;0.31;308.65;5.40;1265;26;2392.00;47
5684;24;620731852;5684;445;6947;6993;5.15;0.31;308.75;5.40;1263;26;2393.00;46
5688;24;620731874;5688;430;6947;6996;5.22;0.32;308.82;5.40;1259;26;2394.00;49
5692;24;620731889;5692;419;6947;6996;5.29;0.32;308.87;5.40;1255;26;2395.00;49
5695;24;620731903;5695;416;6947;6996;5.34;0.33;308.90;5.40;1252;26;2396.00;49
5699;24;620731917;5699;408;6948;6997;5.40;0.33;308.86;5.41;1249;26;2397.00;49
5706;24;620731934;5706;410;6948;6998;5.40;0.33;309.05;5.41;1242;26;2398.00;50
5710;24;620731949;5710;409;6948;6998;5.39;0.33;309.28;5.41;1238;26;2399.00;50
5713;24;620731968;5713;417;6967;7057;5.44;0.33;309.40;5.40;1254;26;2400.00;90
5717;24;620731994;5717;409;6968;7057;5.49;0.34;309.49;5.40;1251;26;2401.00;89
5720;24;620732009;5720;411;6972;7057;5.52;0.34;309.58;5.39;1252;26;2402.00;85
5723;24;620732024;5723;410;6973;7058;5.55;0.34;309.55;5.39;1250;26;2403.00;85
5728;24;620732039;5728;407;6974;7058;5.55;0.34;309.67;5.39;1246;26;2404.00;84
5735;24;620732054;5735;409;6978;7062;5.52;0.34;309.97;5.39;1243;26;2405.00;84
5740;24;620732079;5740;409;6980;7062;5.57;0.34;309.98;5.39;1240;26;2406.00;82
5748;24;620732095;5748;402;6984;7066;5.59;0.34;310.23;5.39;1236;26;2407.00;82
5750;24;620732110;5750;414;6985;7066;5.63;0.34;310.40;5.40;1235;26;2408.00;81
5756;24;620732125;5756;409;6986;7066;5.61;0.34;310.46;5.40;1230;26;2409.00;80
5761;24;620732140;5761;408;6986;7066;5.59;0.34;310.55;5.40;1225;26;2410.00;80
5766;24;620732155;5766;413;6990;7066;5.57;0.34;310.78;5.41;1224;26;2411.00;76
5771;24;620732170;5771;406;6993;7078;5.57;0.34;310.90;5.41;1222;26;2412.00;85
5777;24;620732187;5777;412;6996;7078;5.55;0.34;311.06;5.41;1219;26;2413.00;82
5783;24;620732202;5783;405;6998;7078;5.52;0.34;311.05;5.41;1215;26;2414.00;80
5785;24;620732217;5785;415;6999;7078;5.49;0.34;311.14;5.41;1214;26;2415.00;79
5788;24;620732231;5788;421;7002;7078;5.50;0.34;311.31;5.42;1214;26;2416.00;76
5792;24;620732245;5792;427;7003;7078;5.49;0.33;311.38;5.42;1211;26;2417.00;75
5794;24;620732261;5794;427;7006;7079;5.51;0.34;311.50;5.43;1212;26;2418.00;73
5798;24;620732276;5798;426;7008;7079;5.49;0.33;311.75;5.44;1210;26;2419.00;71
5804;24;620732290;5804;435;7013;7085;5.48;0.33;311.77;5.44;1209;26;2420.00;72
5807;24;620732306;5807;444;7016;7086;5.50;0.34;311.91;5.45;1209;26;2421.00;70
5809;24;620732320;5809;439;7016;7086;5.47;0.33;311.98;5.45;1207;26;2422.00;70
5813;24;620732334;5813;447;7020;7086;5.42;0.33;311.95;5.46;1207;26;2423.00;66
5814;24;620732355;5814;454;7021;7090;5.40;0.33;312.02;5.46;1207;26;2424.00;69
5816;24;620732374;5816;455;7021;7090;5.36;0.33;312.09;5.46;1205;26;2425.00;69
5819;24;620732388;5819;463;7024;7090;5.30;0.32;312.24;5.47;1205;26;2426.00;66
5821;24;620732411;5821;461;7024;7091;5.23;0.32;312.33;5.47;1203;26;2427.00;67
5827;24;620732426;5827;457;7027;7095;5.19;0.32;312.37;5.47;1200;26;2428.00;68
5828;24;620732441;5828;461;7030;7095;5.19;0.32;312.40;5.49;1202;26;2429.00;65
5831;24;620732457;5831;467;7034;7101;5.19;0.32;312.53;5.48;1203;26;2430.00;67
5833;24;620732472;5833;466;7039;7101;5.16;0.31;312.65;5.50;1206;26;2431.00;62
5833;24;620732486;5833;465;7040;7101;5.17;0.31;312.65;5.50;1207;26;2432.00;61
5835;24;620732499;5835;466;7042;7101;5.19;0.32;312.76;5.50;1207;26;2433.00;59
5837;24;620732512;5837;464;7046;7105;5.22;0.32;312.76;5.50;1209;26;2434.00;59
5839;24;620732525;5839;466;7047;7105;5.21;0.32;312.80;5.50;1208;26;2435.00;58
5844;24;620732539;5844;462;7047;7105;5.20;0.32;312.90;5.50;1203;26;2436.00;58
5845;24;620732552;5845;463;7048;7105;5.19;0.32;312.90;5.50;1203;26;2437.00;57
5848;24;620732566;5848;461;7049;7106;5.16;0.31;313.08;5.51;1201;26;2438.00;57
5849;24;620732580;5849;466;7050;7107;5.18;0.32;313.12;5.50;1201;26;2439.00;57
5854;24;620732594;5854;462;7051;7107;5.14;0.31;313.43;5.50;1197;26;2440.00;56
5855;24;620732608;5855;466;7053;7108;5.17;0.31;313.54;5.51;1198;26;2441.00;55
5859;24;620732627;5859;465;7054;7108;5.17;0.31;313.66;5.51;1195;26;2442.00;54
5862;24;620732641;5862;471;7054;7108;5.19;0.32;313.71;5.51;1192;26;2443.00;54
5864;24;620732655;5864;480;7054;7108;5.17;0.31;313.82;5.51;1190;26;2444.00;54
5866;24;620732668;5866;489;7054;7108;5.16;0.31;313.86;5.51;1188;26;2445.00;54
5867;24;620732681;5867;498;7055;7108;5.18;0.32;313.88;5.52;1188;26;2446.00;53
5869;24;620732694;5869;497;7056;7108;5.18;0.32;313.89;5.53;1187;26;2447.00;52
5870;24;620732707;5870;517;7121;7235;5.21;0.32;313.86;5.48;1251;26;2448.00;114
5872;24;620732731;5872;509;7124;7236;5.18;0.32;313.97;5.48;1252;26;2449.00;112
5873;24;620732745;5873;507;7128;7236;5.22;0.32;314.04;5.48;1255;26;2450.00;108
5875;24;620732759;5875;502;7131;7236;5.25;0.32;314.13;5.48;1256;26;2451.00;105
5877;24;620732772;5877;503;7135;7236;5.31;0.33;314.19;5.48;1258;26;2452.00;101
5880;24;620732787;5880;502;7138;7236;5.28;0.33;314.43;5.48;1258;26;2453.00;98
5882;24;620732806;5882;494;7140;7236;5.31;0.33;314.49;5.48;1258;26;2454.00;96
5884;24;620732820;5884;500;7143;7236;5.34;0.33;314.46;5.48;1259;26;2455.00;93
5888;24;620732835;5888;495;7146;7237;5.29;0.32;314.46;5.49;1258;26;2456.00;91
5891;24;620732848;5891;495;7151;7238;5.26;0.32;314.50;5.49;1260;26;2457.00;87
5893;24;620732862;5893;493;7153;7238;5.21;0.32;314.59;5.50;1260;26;2458.00;85
5896;24;620732876;5896;496;7156;7239;5.17;0.32;314.66;5.51;1260;26;2459.00;83
5900;24;620732891;5900;494;7157;7239;5.15;0.32;314.82;5.51;1257;26;2460.00;82
5902;24;620732905;5902;493;7158;7239;5.11;0.31;314.98;5.51;1256;26;2461.00;81
5906;24;620732919;5906;509;7163;7239;5.01;0.31;315.12;5.52;1257;26;2462.00;76
5907;24;620732934;5907;513;7168;7243;4.99;0.31;315.24;5.52;1261;26;2463.00;75
5912;24;620732948;5912;519;7169;7243;4.92;0.30;315.49;5.52;1257;26;2464.00;74
5913;24;620732961;5913;529;7173;7243;4.94;0.30;315.48;5.54;1260;26;2465.00;70
5918;24;620732975;5918;538;7174;7246;4.93;0.30;315.58;5.54;1256;26;2466.00;72
5919;24;620732989;5919;543;7176;7246;4.97;0.30;315.57;5.55;1257;26;2467.00;70
5923;24;620733001;5923;552;7177;7246;4.98;0.30;315.81;5.55;1254;26;2468.00;69
5925;24;620733016;5925;555;7182;7250;4.98;0.30;316.06;5.55;1257;26;2469.00;68
5928;24;620733029;5928;557;7185;7251;4.99;0.30;316.07;5.57;1257;26;2470.00;66
5931;24;620733044;5931;550;7187;7251;5.01;0.31;316.16;5.57;1256;26;2471.00;64
5933;24;620733057;5933;552;7190;7255;5.02;0.31;316.29;5.57;1257;26;2472.00;65
5934;24;620733071;5934;554;7192;7255;5.03;0.31;316.26;5.57;1258;26;2473.00;63
5935;24;620733084;5935;555;7194;7255;5.00;0.31;316.26;5.58;1259;26;2474.00;61
5938;24;620733098;5938;558;7196;7257;5.01;0.31;316.21;5.58;1258;26;2475.00;61
5940;24;620733112;5940;558;7197;7257;5.04;0.31;316.32;5.58;1257;26;2476.00;60
5947;24;620733125;5947;561;7202;7263;5.02;0.31;316.34;5.57;1255;26;2477.00;61
5948;24;620733139;5948;548;7202;7263;5.00;0.31;316.31;5.57;1254;26;2478.00;61
5954;24;620733152;5954;544;7202;7264;4.90;0.30;316.27;5.57;1248;26;2479.00;62
5957;24;620733165;5957;543;7202;7264;4.78;0.29;316.35;5.57;1245;26;2480.00;62
5959;24;620733178;5959;543;7202;7264;4.72;0.29;316.30;5.57;1243;26;2481.00;62
5961;24;620733191;5961;541;7202;7264;4.66;0.29;316.28;5.57;1241;26;2482.00;62
5962;24;620733203;5962;535;7202;7264;4.62;0.28;316.29;5.57;1240;26;2483.00;62
5964;24;620733215;5964;534;7210;7276;4.64;0.28;316.23;5.57;1246;26;2484.00;66
5966;24;620733234;5966;542;7213;7276;4.67;0.29;316.16;5.62;1247;26;2485.00;63
5969;24;620733248;5969;535;7215;7276;4.70;0.29;316.13;5.62;1246;26;2486.00;61
5970;24;620733261;5970;545;7216;7276;4.72;0.29;316.11;5.62;1246;26;2487.00;60
5973;24;620733273;5973;545;7216;7276;4.72;0.29;316.07;5.62;1243;26;2488.00;60
5977;24;620733285;5977;544;7216;7276;4.69;0.29;316.00;5.62;1239;26;2489.00;60
5981;24;620733299;5981;546;7219;7280;4.68;0.29;315.93;5.62;1238;26;2490.00;61
5984;24;620733313;5984;540;7219;7280;4.64;0.28;315.91;5.62;1235;26;2491.00;61
5987;24;620733325;5987;541;7223;7284;4.67;0.29;315.82;5.62;1236;26;2492.00;61
5989;24;620733338;5989;536;7223;7285;4.66;0.29;315.76;5.62;1234;26;2493.00;62
5991;24;620733351;5991;536;7224;7285;4.69;0.29;315.77;5.62;1233;26;2494.00;61
5991;24;620733363;5991;541;7224;7285;4.69;0.29;315.77;5.62;1233;26;2495.00;61
5995;24;620733375;5995;543;7234;7298;4.71;0.29;315.74;5.62;1239;26;2496.00;64
5996;24;620733389;5996;540;7234;7298;4.67;0.29;315.75;5.62;1238;26;2497.00;64
6000;24;620733406;6000;540;7234;7298;4.64;0.28;315.78;5.62;1234;26;2498.00;64
6002;24;620733425;6002;536;7235;7299;4.66;0.28;315.74;5.62;1233;26;2499.00;64
6003;24;620733447;6003;521;7235;7300;4.67;0.28;315.69;5.62;1232;26;2500.00;65
6008;24;620733473;6008;516;7235;7300;4.65;0.28;315.68;5.62;1227;26;2501.00;65
6010;24;620733492;6010;513;7240;7303;4.71;0.29;315.76;5.67;1230;26;2502.00;63
6012;24;620733510;6012;509;7241;7303;4.74;0.29;315.68;5.67;1229;26;2503.00;62
6014;24;620733525;6014;508;7244;7303;4.74;0.29;315.74;5.73;1230;26;2504.00;59
6016;24;620733540;6016;500;7245;7303;4.76;0.29;315.74;5.76;1229;26;2505.00;58
6017;24;620733554;6017;504;7251;7309;4.83;0.29;315.78;5.76;1234;26;2506.00;58
6018;24;620733569;6018;500;7252;7309;4.86;0.29;315.76;5.77;1234;26;2507.00;57
6018;24;620733590;6018;501;7252;7309;4.88;0.30;315.76;5.77;1234;26;2508.00;57
6019;24;620733605;6019;497;7252;7309;4.92;0.30;315.79;5.77;1233;26;2509.00;57
6019;24;620733619;6019;497;7256;7313;4.91;0.30;315.79;5.77;1237;26;2510.00;57
6020;24;620733634;6020;499;7258;7314;4.91;0.30;315.75;5.80;1238;26;2511.00;56
6022;25;620733649;6022;497;7259;7314;4.93;0.30;315.75;5.80;1237;27;2512.00;55
6023;25;620733675;6023;493;7262;7315;4.94;0.30;315.76;5.85;1239;27;2513.00;53
6024;25;620733697;6024;496;7263;7315;4.92;0.30;315.74;5.88;1239;27;2514.00;52
6025;25;620733711;6025;494;7264;7315;4.96;0.30;315.73;5.88;1239;27;2515.00;51
6026;25;620733725;6026;497;7264;7315;4.97;0.30;315.70;5.88;1238;27;2516.00;51
6028;25;620733738;6028;502;7265;7315;4.94;0.30;315.63;5.91;1237;27;2517.00;50
6032;25;620733751;6032;502;7265;7315;4.90;0.30;315.61;5.91;1233;27;2518.00;50
6032;25;620733765;6032;498;7267;7315;4.92;0.30;315.61;5.96;1235;27;2519.00;48
6033;25;620733780;6033;513;7336;7440;5.10;0.32;315.73;5.91;1303;27;2520.00;104
6033;25;620733804;6033;514;7340;7441;5.14;0.32;315.73;5.90;1307;27;2521.00;101
6036;25;620733818;6036;506;7353;7441;5.17;0.32;315.62;5.95;1317;27;2522.00;88
6039;25;620733832;6039;504;7358;7441;5.13;0.32;315.64;5.95;1319;27;2523.00;83
6042;25;620733846;6042;512;7362;7441;5.11;0.31;315.67;5.94;1320;27;2524.00;79
6044;25;620733860;6044;499;7365;7441;5.10;0.31;315.73;5.97;1321;27;2525.00;76
6045;25;620733874;6045;502;7369;7441;5.09;0.31;315.75;5.97;1324;27;2526.00;72
6050;26;620733887;6050;502;7371;7441;5.03;0.31;315.71;5.99;1321;28;2527.00;70
6051;26;620733908;6051;503;7373;7442;5.03;0.31;315.69;5.99;1322;28;2528.00;69
6054;26;620733922;6054;505;7377;7443;4.99;0.30;315.81;6.02;1323;28;2529.00;66
6057;26;620733937;6057;502;7380;7443;4.97;0.30;315.81;6.02;1323;28;2530.00;63
6060;26;620733951;6060;503;7385;7447;4.93;0.30;315.75;6.04;1325;28;2531.00;62
6062;26;620733972;6062;507;7385;7447;4.94;0.30;315.88;6.04;1323;28;2532.00;62
6064;26;620733986;6064;500;7386;7447;4.95;0.30;315.98;6.07;1322;28;2533.00;61
6065;26;620734000;6065;504;7386;7447;4.97;0.30;315.96;6.07;1321;28;2534.00;61
6066;26;620734014;6066;508;7390;7453;4.99;0.30;316.08;6.06;1324;28;2535.00;63
6067;26;620734029;6067;508;7390;7453;4.99;0.30;316.19;6.06;1323;28;2536.00;63
6069;26;620734050;6069;508;7391;7455;5.02;0.31;316.22;6.06;1322;28;2537.00;64
6071;26;620734065;6071;517;7394;7458;5.03;0.31;316.38;6.11;1323;28;2538.00;64
6072;26;620734080;6072;521;7395;7458;5.08;0.31;316.44;6.11;1323;28;2539.00;63
6076;26;620734093;6076;523;7395;7458;5.11;0.31;316.57;6.11;1319;28;2540.00;63
6077;26;620734107;6077;522;7395;7459;5.11;0.31;316.54;6.11;1318;28;2541.00;64
6081;26;620734121;6081;521;7395;7460;5.06;0.31;316.60;6.11;1314;28;2542.00;65
6084;26;620734135;6084;520;7395;7460;5.02;0.31;316.68;6.11;1311;28;2543.00;65
6089;26;620734149;6089;521;7404;7473;4.95;0.30;316.75;6.10;1315;28;2544.00;69
6094;26;620734165;6094;517;7404;7473;4.88;0.30;316.93;6.10;1310;28;2545.00;69
6095;26;620734186;6095;517;7404;7473;4.85;0.30;317.05;6.10;1309;28;2546.00;69
6099;26;620734199;6099;510;7405;7474;4.80;0.29;317.01;6.10;1306;28;2547.00;69
6103;26;620734213;6103;503;7405;7474;4.78;0.29;317.29;6.10;1302;28;2548.00;69
6106;26;620734228;6106;500;7407;7478;4.76;0.29;317.32;6.10;1301;28;2549.00;71
6107;26;620734244;6107;486;7409;7481;4.76;0.29;317.31;6.10;1302;28;2550.00;72
6115;26;620734259;6115;484;7414;7485;4.73;0.29;317.65;6.10;1299;28;2551.00;71
6116;26;620734273;6116;469;7414;7485;4.78;0.29;317.69;6.10;1298;28;2552.00;71
6119;26;620734288;6119;462;7414;7485;4.80;0.30;317.84;6.10;1295;28;2553.00;71
6120;26;620734315;6120;451;7415;7485;4.86;0.30;317.88;6.10;1295;28;2554.00;70
6124;26;620734329;6124;449;7415;7485;4.88;0.30;317.90;6.10;1291;28;2555.00;70
6125;26;620734344;6125;448;7423;7497;4.99;0.31;317.96;6.09;1298;28;2556.00;74
6128;26;620734359;6128;440;7423;7497;5.10;0.31;318.05;6.09;1295;28;2557.00;74
6132;26;620734374;6132;433;7423;7497;5.17;0.32;318.31;6.09;1291;28;2558.00;74
6138;26;620734389;6138;426;7423;7497;5.21;0.32;318.39;6.09;1285;28;2559.00;74
6142;26;620734407;6142;418;7424;7497;5.24;0.32;318.51;6.09;1282;28;2560.00;73
6146;26;620734422;6146;414;7424;7497;5.24;0.32;318.77;6.09;1278;28;2561.00;73
6149;26;620734438;6149;407;7424;7498;5.29;0.33;318.82;6.09;1275;28;2562.00;74
6152;26;620734453;6152;391;7424;7498;5.34;0.33;318.90;6.09;1272;28;2563.00;74
6154;26;620734468;6154;397;7429;7504;5.45;0.34;319.02;6.09;1275;28;2564.00;75
6159;26;620734483;6159;396;7431;7506;5.51;0.34;319.15;6.09;1272;28;2565.00;75
6163;26;620734498;6163;393;7432;7506;5.55;0.34;319.20;6.09;1269;28;2566.00;74
6170;26;620734512;6170;393;7433;7506;5.57;0.34;319.10;6.10;1263;28;2567.00;73
6174;26;620734527;6174;396;7435;7510;5.58;0.34;319.21;6.10;1261;28;2568.00;75
6181;27;620734541;6181;390;7436;7510;5.56;0.34;319.21;6.10;1255;29;2569.00;74
6184;27;620734566;6184;383;7437;7510;5.63;0.34;319.22;6.10;1253;29;2570.00;73
6191;27;620734587;6191;381;7438;7511;5.64;0.35;319.46;6.10;1247;29;2571.00;73
6197;27;620734607;6197;380;7442;7515;5.66;0.35;319.50;6.10;1245;29;2572.00;73
6199;27;620734622;6199;375;7443;7515;5.71;0.35;319.54;6.10;1244;29;2573.00;72
6204;27;620734636;6204;379;7445;7518;5.69;0.35;319.72;6.10;1241;29;2574.00;73
6208;27;620734651;6208;372;7446;7518;5.71;0.35;319.87;6.10;1238;29;2575.00;72
6213;27;620734666;6213;382;7448;7518;5.68;0.35;319.87;6.10;1235;29;2576.00;70
6218;27;620734681;6218;382;7449;7518;5.64;0.34;319.95;6.10;1231;29;2577.00;69
6222;27;620734695;6222;382;7452;7522;5.63;0.34;319.99;6.10;1230;29;2578.00;70
6224;27;620734710;6224;387;7452;7522;5.64;0.35;320.01;6.10;1228;29;2579.00;70
6229;27;620734725;6229;394;7452;7522;5.62;0.34;320.21;6.10;1223;29;2580.00;70
6232;27;620734740;6232;399;7453;7522;5.60;0.34;320.33;6.10;1221;29;2581.00;69
6236;27;620734753;6236;396;7453;7523;5.51;0.34;320.40;6.10;1217;29;2582.00;70
6241;27;620734768;6241;401;7454;7524;5.47;0.34;320.42;6.10;1213;29;2583.00;70
6245;27;620734781;6245;403;7454;7524;5.46;0.33;320.37;6.10;1209;29;2584.00;70
6249;27;620734796;6249;402;7455;7525;5.46;0.33;320.51;6.10;1206;29;2585.00;70
6251;27;620734810;6251;409;7455;7525;5.46;0.33;320.56;6.10;1204;29;2586.00;70
6253;27;620734823;6253;408;7455;7525;5.47;0.33;320.52;6.10;1202;29;2587.00;70
6256;27;620734837;6256;413;7455;7525;5.46;0.33;320.57;6.10;1199;29;2588.00;70
6259;27;620734850;6259;422;7455;7525;5.42;0.33;320.65;6.10;1196;29;2589.00;70
6259;27;620734864;6259;422;7455;7525;5.39;0.33;320.65;6.10;1196;29;2590.00;70
6262;27;620734876;6262;422;7455;7525;5.30;0.32;320.65;6.10;1193;29;2591.00;70
6264;27;620734890;6264;447;7523;7652;5.40;0.34;320.67;6.04;1259;29;2592.00;129
6268;27;620734913;6268;439;7527;7653;5.34;0.33;320.72;6.04;1259;29;2593.00;126
6275;27;620734927;6275;433;7534;7653;5.31;0.33;320.80;6.03;1259;29;2594.00;119
6276;27;620734943;6276;439;7536;7653;5.31;0.33;320.82;6.04;1260;29;2595.00;117
6280;27;620734956;6280;450;7542;7653;5.35;0.33;320.93;6.04;1262;29;2596.00;111
6285;27;620734971;6285;442;7543;7653;5.34;0.33;321.10;6.04;1258;29;2597.00;110
6287;27;620734988;6287;443;7545;7653;5.31;0.33;321.25;6.04;1258;29;2598.00;108
6291;27;620735002;6291;437;7548;7653;5.31;0.33;321.25;6.04;1257;29;2599.00;105
6295;27;620735019;6295;448;7550;7654;5.26;0.32;321.40;6.04;1255;29;2600.00;104
6296;27;620735037;6296;448;7552;7655;5.24;0.32;321.52;6.04;1256;29;2601.00;103
6300;27;620735051;6300;453;7556;7655;5.21;0.32;321.68;6.05;1256;29;2602.00;99
6302;27;620735065;6302;462;7557;7656;5.15;0.32;321.77;6.06;1255;29;2603.00;99
6302;27;620735079;6302;467;7560;7656;5.15;0.32;321.77;6.06;1258;29;2604.00;96
6304;27;620735093;6304;475;7561;7656;5.12;0.32;321.94;6.06;1257;29;2605.00;95
6308;27;620735107;6308;476;7562;7656;5.15;0.32;322.11;6.06;1254;29;2606.00;94
6309;27;620735121;6309;480;7568;7660;5.18;0.32;322.21;6.06;1259;29;2607.00;92
6313;27;620735146;6313;484;7570;7660;5.16;0.32;322.34;6.07;1257;29;2608.00;90
6315;27;620735163;6315;484;7572;7660;5.18;0.32;322.40;6.08;1257;29;2609.00;88
6320;27;620735179;6320;488;7576;7666;5.19;0.32;322.56;6.08;1256;29;2610.00;90
6323;27;620735200;6323;502;7579;7666;5.20;0.32;322.51;6.08;1256;29;2611.00;87
6325;27;620735215;6325;502;7581;7666;5.21;0.32;322.59;6.08;1256;29;2612.00;85
6329;27;620735229;6329;513;7586;7670;5.17;0.32;322.63;6.08;1257;29;2613.00;84
6332;27;620735243;6332;516;7588;7671;5.16;0.31;322.69;6.08;1256;29;2614.00;83
6335;27;620735257;6335;518;7589;7671;5.14;0.31;322.73;6.08;1254;29;2615.00;82
6339;27;620735271;6339;518;7592;7675;5.10;0.31;322.78;6.08;1253;29;2616.00;83
6340;27;620735285;6340;517;7594;7675;5.08;0.31;322.79;6.08;1254;29;2617.00;81
6341;27;620735299;6341;514;7594;7675;5.05;0.31;322.86;6.08;1253;29;2618.00;81
6342;27;620735313;6342;516;7595;7676;5.01;0.31;322.90;6.08;1253;29;2619.00;81
6343;27;620735330;6343;519;7596;7676;5.02;0.31;322.87;6.08;1253;29;2620.00;80
6345;27;620735346;6345;510;7601;7682;5.02;0.31;322.84;6.08;1256;29;2621.00;81
6346;27;620735361;6346;511;7601;7682;4.96;0.30;322.86;6.08;1255;29;2622.00;81
6347;27;620735374;6347;518;7601;7683;4.93;0.30;322.86;6.08;1254;29;2623.00;82
6349;27;620735388;6349;525;7601;7683;4.90;0.30;322.83;6.08;1252;29;2624.00;82
6353;27;620735407;6353;524;7601;7683;4.80;0.29;322.97;6.08;1248;29;2625.00;82
6353;27;620735432;6353;517;7601;7683;4.71;0.29;322.97;6.08;1248;29;2626.00;82
6355;27;620735454;6355;529;7602;7683;4.65;0.28;322.98;6.09;1247;29;2627.00;81
6356;27;620735475;6356;528;7611;7695;4.68;0.29;323.04;6.09;1255;29;2628.00;84
6360;27;620735503;6360;526;7611;7695;4.60;0.28;323.09;6.09;1251;29;2629.00;84
6362;27;620735523;6362;526;7613;7695;4.57;0.28;323.13;6.08;1251;29;2630.00;82
6363;27;620735537;6363;527;7613;7695;4.56;0.28;323.12;6.08;1250;29;2631.00;82
6365;27;620735553;6365;532;7613;7695;4.53;0.28;323.07;6.08;1248;29;2632.00;82
6367;27;620735575;6367;537;7613;7695;4.53;0.28;323.23;6.08;1246;29;2633.00;82
6370;27;620735589;6370;538;7616;7699;4.49;0.27;323.18;6.08;1246;29;2634.00;83
6371;27;620735604;6371;539;7616;7699;4.49;0.27;323.14;6.08;1245;29;2635.00;83
6373;27;620735618;6373;536;7620;7703;4.49;0.27;323.10;6.08;1247;29;2636.00;83
6375;27;620735632;6375;536;7621;7704;4.51;0.28;323.17;6.08;1246;29;2637.00;83
6376;27;620735646;6376;541;7621;7704;4.55;0.28;323.20;6.08;1245;29;2638.00;83
6379;27;620735660;6379;540;7621;7704;4.51;0.28;323.11;6.08;1242;29;2639.00;83
6382;27;620735676;6382;538;7644;7733;4.53;0.28;323.08;6.06;1262;29;2640.00;89
6387;27;620735693;6387;531;7644;7733;4.53;0.28;322.96;6.06;1257;29;2641.00;89
6389;27;620735707;6389;534;7646;7733;4.59;0.28;322.88;6.06;1257;29;2642.00;87
6391;27;620735721;6391;531;7647;7734;4.62;0.28;322.88;6.06;1256;29;2643.00;87
6393;27;620735735;6393;532;7648;7735;4.62;0.28;322.87;6.07;1255;29;2644.00;87
6394;27;620735750;6394;532;7648;7735;4.60;0.28;322.83;6.07;1254;29;2645.00;87
6394;27;620735764;6394;534;7650;7738;4.60;0.28;322.83;6.07;1256;29;2646.00;88
6396;27;620735777;6396;538;7650;7738;4.57;0.28;322.77;6.07;1254;29;2647.00;88
6396;27;620735790;6396;543;7651;7738;4.58;0.28;322.77;6.07;1255;29;2648.00;87
6398;27;620735804;6398;540;7651;7738;4.58;0.28;322.83;6.07;1253;29;2649.00;87
6400;27;620735817;6400;541;7656;7744;4.54;0.28;322.89;6.07;1256;29;2650.00;88
6401;27;620735831;6401;523;7656;7744;4.53;0.27;322.87;6.07;1255;29;2651.00;88
6404;27;620735844;6404;505;7656;7744;4.50;0.27;322.90;6.07;1252;29;2652.00;88
6406;27;620735858;6406;483;7656;7744;4.56;0.28;322.93;6.07;1250;29;2653.00;88
6406;27;620735873;6406;474;7659;7748;4.67;0.28;322.93;6.07;1253;29;2654.00;89
6409;27;620735887;6409;464;7663;7750;4.75;0.29;322.97;6.14;1254;29;2655.00;87
6410;28;620735903;6410;459;7664;7750;4.82;0.29;323.08;6.16;1254;30;2656.00;86
6414;28;620735925;6414;450;7665;7751;4.92;0.30;323.09;6.16;1251;30;2657.00;86
6415;28;620735949;6415;442;7665;7751;5.00;0.30;323.09;6.16;1250;30;2658.00;86
6419;28;620735970;6419;430;7665;7751;5.06;0.31;323.08;6.16;1246;30;2659.00;86
6422;28;620735984;6422;427;7665;7751;5.15;0.31;323.02;6.16;1243;30;2660.00;86
6425;28;620735998;6425;423;7665;7751;5.24;0.32;322.96;6.16;1240;30;2661.00;86
6426;28;620736013;6426;423;7665;7751;5.33;0.32;322.95;6.16;1239;30;2662.00;86
6429;28;620736027;6429;423;7665;7751;5.43;0.33;323.01;6.16;1236;30;2663.00;86
6431;28;620736042;6431;432;7698;7821;5.63;0.34;322.96;6.13;1267;30;2664.00;123
6434;28;620736063;6434;433;7701;7822;5.64;0.34;322.84;6.13;1267;30;2665.00;121
6435;28;620736077;6435;426;7707;7822;5.68;0.35;322.82;6.13;1272;30;2666.00;115
6437;28;620736092;6437;436;7710;7822;5.68;0.35;322.87;6.12;1273;30;2667.00;112
6439;28;620736106;6439;435;7715;7822;5.72;0.35;322.83;6.12;1276;30;2668.00;107
6441;28;620736121;6441;438;7716;7822;5.73;0.35;322.89;6.12;1275;30;2669.00;106
6444;28;620736144;6444;440;7720;7822;5.73;0.35;322.89;6.12;1276;30;2670.00;102
6444;28;620736158;6444;442;7724;7822;5.73;0.35;322.89;6.16;1280;30;2671.00;98
6449;28;620736172;6449;436;7726;7823;5.69;0.34;322.90;6.16;1277;30;2672.00;97
6450;28;620736187;6450;432;7729;7824;5.67;0.34;322.88;6.16;1279;30;2673.00;95
6451;28;620736202;6451;431;7731;7824;5.66;0.34;322.96;6.16;1280;30;2674.00;93
6454;28;620736217;6454;442;7736;7828;5.61;0.34;323.02;6.16;1282;30;2675.00;92
6456;28;620736232;6456;438;7737;7828;5.59;0.34;323.02;6.16;1281;30;2676.00;91
6458;28;620736246;6458;441;7737;7828;5.59;0.34;322.96;6.16;1279;30;2677.00;91
6459;28;620736261;6459;441;7737;7828;5.59;0.34;322.98;6.16;1278;30;2678.00;91
6462;28;620736276;6462;447;7742;7834;5.64;0.34;323.22;6.16;1280;30;2679.00;92
6464;28;620736291;6464;445;7743;7834;5.68;0.34;323.25;6.20;1279;30;2680.00;91
6465;28;620736307;6465;448;7743;7834;5.69;0.35;323.37;6.20;1278;30;2681.00;91
6468;28;620736321;6468;446;7746;7837;5.72;0.35;323.41;6.19;1278;30;2682.00;91
6470;28;620736336;6470;458;7746;7837;5.74;0.35;323.42;6.19;1276;30;2683.00;91
6474;28;620736351;6474;457;7747;7837;5.74;0.35;323.53;6.23;1273;30;2684.00;90
6476;28;620736367;6476;466;7748;7838;5.74;0.35;323.62;6.27;1272;30;2685.00;90
6478;28;620736382;6478;460;7749;7839;5.68;0.34;323.56;6.27;1271;30;2686.00;90
6480;28;620736409;6480;465;7750;7839;5.62;0.34;323.71;6.31;1270;30;2687.00;89
6484;28;620736427;6484;465;7761;7852;5.63;0.34;323.93;6.30;1277;30;2688.00;91
6486;28;620736443;6486;469;7762;7852;5.57;0.34;323.98;6.34;1276;30;2689.00;90
6487;28;620736458;6487;471;7763;7852;5.55;0.34;323.95;6.37;1276;30;2690.00;89
6489;28;620736471;6489;483;7764;7853;5.55;0.34;324.02;6.37;1275;30;2691.00;89
6491;28;620736486;6491;480;7764;7853;5.50;0.34;324.14;6.37;1273;30;2692.00;89
6494;28;620736499;6494;488;7769;7857;5.48;0.33;324.16;6.41;1275;30;2693.00;88
6495;28;620736513;6495;488;7769;7857;5.47;0.33;324.28;6.41;1274;30;2694.00;88
6501;28;620736527;6501;484;7774;7861;5.39;0.33;324.48;6.48;1273;30;2695.00;87
6502;28;620736541;6502;492;7774;7861;5.39;0.33;324.54;6.48;1272;30;2696.00;87
6506;28;620736554;6506;495;7777;7861;5.36;0.33;324.53;6.59;1271;30;2697.00;84
6507;28;620736567;6507;497;7777;7861;5.37;0.33;324.52;6.59;1270;30;2698.00;84
6508;28;620736580;6508;497;7781;7861;5.37;0.33;324.51;6.72;1273;30;2699.00;80
6509;28;620736596;6509;499;7807;7910;5.52;0.34;324.49;6.70;1298;30;2700.00;103
6513;28;620736619;6513;489;7807;7910;5.49;0.34;324.68;6.70;1294;30;2701.00;103
6515;28;620736633;6515;488;7814;7910;5.50;0.34;324.73;6.79;1299;30;2702.00;96
6517;28;620736647;6517;486;7814;7910;5.51;0.34;324.74;6.79;1297;30;2703.00;96
6520;28;620736661;6520;481;7816;7910;5.56;0.34;324.87;6.79;1296;30;2704.00;94
6522;28;620736675;6522;476;7817;7910;5.58;0.34;324.93;6.83;1295;30;2705.00;93
6522;28;620736689;6522;480;7819;7911;5.63;0.34;324.93;6.86;1297;30;2706.00;92
6524;28;620736703;6524;475;7819;7911;5.64;0.34;324.91;6.86;1295;30;2707.00;92
6527;28;620736717;6527;476;7827;7917;5.68;0.35;324.91;6.92;1300;30;2708.00;90
6529;28;620736731;6529;474;7828;7918;5.73;0.35;324.91;6.92;1299;30;2709.00;90
6534;28;620736746;6534;472;7829;7918;5.70;0.35;325.12;6.95;1295;30;2710.00;89
6534;28;620736760;6534;474;7830;7918;5.68;0.35;325.12;6.98;1296;30;2711.00;88
6539;28;620736773;6539;482;7834;7922;5.64;0.34;325.24;6.98;1295;30;2712.00;88
6542;28;620736787;6542;487;7835;7922;5.62;0.34;325.19;7.00;1293;30;2713.00;87
6543;28;620736802;6543;494;7837;7922;5.62;0.34;325.24;7.03;1294;30;2714.00;85
6547;28;620736815;6547;487;7838;7923;5.61;0.34;325.17;7.03;1291;30;2715.00;85
6551;28;620736829;6551;494;7841;7927;5.56;0.34;325.38;7.03;1290;30;2716.00;86
6556;28;620736844;6556;493;7841;7927;5.51;0.34;325.57;7.03;1285;30;2717.00;86
6562;28;620736857;6562;494;7844;7930;5.48;0.34;325.63;7.03;1282;30;2718.00;86
6563;28;620736871;6563;501;7845;7930;5.42;0.33;325.65;7.03;1282;30;2719.00;85
6567;28;620736884;6567;492;7846;7930;5.40;0.33;325.60;7.03;1279;30;2720.00;84
6574;28;620736898;6574;489;7846;7930;5.34;0.33;325.48;7.03;1272;30;2721.00;84
6575;28;620736911;6575;488;7849;7934;5.37;0.33;325.52;7.03;1274;30;2722.00;85
6579;28;620736925;6579;486;7850;7934;5.36;0.33;325.58;7.03;1271;30;2723.00;84
6584;28;620736945;6584;483;7850;7934;5.38;0.33;325.81;7.03;1266;30;2724.00;84
6588;28;620736959;6588;476;7851;7934;5.38;0.33;325.87;7.03;1263;30;2725.00;83
6591;28;620736973;6591;470;7851;7935;5.36;0.33;325.95;7.03;1260;30;2726.00;84
6594;28;620736987;6594;465;7852;7936;5.38;0.33;326.10;7.03;1258;30;2727.00;84
6600;28;620737008;6600;452;7852;7936;5.35;0.33;326.35;7.03;1252;30;2728.00;84
6605;28;620737023;6605;452;7854;7937;5.37;0.33;326.50;7.04;1249;30;2729.00;83
6607;28;620737039;6607;446;7854;7937;5.42;0.33;326.60;7.04;1247;30;2730.00;83
6613;28;620737053;6613;441;7855;7937;5.47;0.33;326.76;7.04;1242;30;2731.00;82
6616;28;620737068;6616;435;7857;7937;5.53;0.34;326.83;7.04;1241;30;2732.00;80
6618;28;620737082;6618;436;7857;7937;5.57;0.34;327.01;7.04;1239;30;2733.00;80
6623;28;620737095;6623;437;7857;7937;5.57;0.34;327.06;7.04;1234;30;2734.00;80
6626;28;620737109;6626;433;7857;7937;5.56;0.34;327.00;7.04;1231;30;2735.00;80
6631;28;620737124;6631;449;7928;8064;5.72;0.35;327.23;6.98;1297;30;2736.00;136
6636;28;620737168;6636;441;7931;8065;5.69;0.35;327.26;6.98;1295;30;2737.00;134
6641;28;620737183;6641;437;7938;8065;5.66;0.35;327.23;6.98;1297;30;2738.00;127
6646;28;620737198;6646;435;7941;8065;5.66;0.35;327.35;6.97;1295;30;2739.00;124
6650;28;620737212;6650;441;7944;8065;5.64;0.35;327.40;6.97;1294;30;2740.00;121
6654;28;620737226;6654;448;7947;8065;5.60;0.35;327.47;6.97;1293;30;2741.00;118
6658;28;620737241;6658;448;7949;8065;5.49;0.34;327.53;6.97;1291;30;2742.00;116
6663;28;620737256;6663;452;7952;8065;5.42;0.33;327.58;6.97;1289;30;2743.00;113
6665;28;620737271;6665;458;7954;8066;5.42;0.33;327.56;6.97;1289;30;2744.00;112
6668;28;620737286;6668;465;7959;8068;5.39;0.33;327.76;6.97;1291;30;2745.00;109
6671;28;620737300;6671;468;7961;8068;5.33;0.33;327.79;6.97;1290;30;2746.00;107
6676;28;620737314;6676;476;7962;8069;5.23;0.32;327.96;6.97;1286;30;2747.00;107
6682;28;620737328;6682;485;7965;8069;5.14;0.32;327.87;6.98;1283;30;2748.00;104
6687;28;620737342;6687;488;7968;8069;5.09;0.31;327.84;6.98;1281;30;2749.00;101
6690;28;620737356;6690;488;7970;8069;5.11;0.32;327.97;6.98;1280;30;2750.00;99
6694;28;620737372;6694;497;7974;8073;5.13;0.32;328.04;6.98;1280;30;2751.00;99
6697;28;620737386;6697;501;7974;8073;5.14;0.32;328.09;6.98;1277;30;2752.00;99
6700;28;620737401;6700;506;7975;8073;5.15;0.32;328.09;6.98;1275;30;2753.00;98
6704;28;620737424;6704;511;7975;8076;5.12;0.31;328.26;6.98;1271;30;2754.00;101
6710;28;620737445;6710;514;7978;8076;5.09;0.31;328.31;6.98;1268;30;2755.00;98
6716;28;620737467;6716;527;7979;8076;5.04;0.31;328.39;6.98;1263;30;2756.00;97
6718;28;620737490;6718;531;7982;8080;5.08;0.31;328.44;6.98;1264;30;2757.00;98
6721;28;620737511;6721;539;7985;8081;5.03;0.31;328.48;6.98;1264;30;2758.00;96
6724;28;620737529;6724;553;7985;8081;4.99;0.31;328.42;6.98;1261;30;2759.00;96
6730;28;620737545;6730;553;7991;8086;4.90;0.30;328.60;6.98;1261;30;2760.00;95
6732;28;620737561;6732;553;7991;8086;4.86;0.30;328.61;6.98;1259;30;2761.00;95
6736;28;620737576;6736;555;7993;8086;4.82;0.29;328.80;6.98;1257;30;2762.00;93
6739;28;620737592;6739;553;7994;8087;4.74;0.29;328.80;6.98;1255;30;2763.00;93
6745;28;620737608;6745;563;7995;8087;4.68;0.29;328.90;6.98;1250;30;2764.00;92
6748;28;620737623;6748;566;8000;8093;4.66;0.28;329.01;6.98;1252;30;2765.00;93
6751;28;620737638;6751;569;8000;8093;4.57;0.28;329.03;6.98;1249;30;2766.00;93
6754;28;620737652;6754;556;8000;8094;4.50;0.28;329.13;6.98;1246;30;2767.00;94
6756;28;620737666;6756;549;8000;8094;4.48;0.27;329.25;6.98;1244;30;2768.00;94
6759;28;620737681;6759;540;8000;8094;4.48;0.27;329.38;6.98;1241;30;2769.00;94
6764;28;620737698;6764;534;8000;8094;4.48;0.27;329.49;6.98;1236;30;2770.00;94
6767;28;620737712;6767;540;8000;8094;4.50;0.27;329.48;6.98;1233;30;2771.00;94
6768;28;620737727;6768;537;8010;8106;4.59;0.28;329.51;6.97;1242;30;2772.00;96
6771;28;620737742;6771;543;8011;8106;4.60;0.28;329.59;6.97;1240;30;2773.00;95
6774;28;620737757;6774;540;8011;8106;4.61;0.28;329.58;6.97;1237;30;2774.00;95
6778;28;620737771;6778;540;8011;8106;4.60;0.28;329.52;6.97;1233;30;2775.00;95
6778;28;620737786;6778;537;8011;8106;4.63;0.28;329.52;6.97;1233;30;2776.00;95
6780;28;620737800;6780;525;8011;8106;4.66;0.28;329.56;6.97;1231;30;2777.00;95
6783;28;620737815;6783;522;8014;8110;4.69;0.29;329.58;6.97;1231;30;2778.00;96
6785;28;620737830;6785;520;8014;8110;4.70;0.29;329.56;6.97;1229;30;2779.00;96
6789;28;620737845;6789;514;8018;8114;4.72;0.29;329.51;6.97;1229;30;2780.00;96
6790;28;620737867;6790;513;8018;8115;4.75;0.29;329.50;6.97;1228;30;2781.00;97
6792;28;620737882;6792;516;8019;8115;4.80;0.29;329.52;6.96;1227;30;2782.00;96
6793;28;620737897;6793;510;8019;8115;4.82;0.29;329.49;6.96;1226;30;2783.00;96
6794;28;620737911;6794;513;8030;8128;4.94;0.30;329.45;6.96;1236;30;2784.00;98
6797;28;620737927;6797;521;8030;8128;4.92;0.30;329.42;6.96;1233;30;2785.00;98
6798;28;620737943;6798;518;8030;8128;4.91;0.30;329.38;6.96;1232;30;2786.00;98
6800;28;620737956;6800;508;8031;8129;4.92;0.30;329.36;6.95;1231;30;2787.00;98
6802;28;620737971;6802;512;8031;8130;4.92;0.30;329.28;6.95;1229;30;2788.00;99
6804;28;620737987;6804;515;8031;8130;4.93;0.30;329.28;6.95;1227;30;2789.00;99
6804;28;620738002;6804;524;8035;8136;4.94;0.30;329.28;6.95;1231;30;2790.00;101
6806;28;620738018;6806;522;8035;8136;4.91;0.30;329.44;6.95;1229;30;2791.00;101
6806;28;620738032;6806;517;8037;8136;4.87;0.30;329.44;6.95;1231;30;2792.00;99
6807;28;620738047;6807;517;8037;8136;4.81;0.29;329.46;6.95;1230;30;2793.00;99
6807;28;620738061;6807;524;8042;8142;4.81;0.29;329.46;6.95;1235;30;2794.00;100
6809;28;620738076;6809;529;8042;8142;4.76;0.29;329.38;6.95;1233;30;2795.00;100
6810;28;620738090;6810;535;8042;8142;4.71;0.29;329.47;6.95;1232;30;2796.00;100
6813;28;620738105;6813;529;8042;8142;4.64;0.28;329.51;6.95;1229;30;2797.00;100
6815;28;620738119;6815;534;8045;8146;4.61;0.28;329.48;6.94;1230;30;2798.00;101
6818;28;620738133;6818;531;8046;8147;4.61;0.28;329.44;6.94;1228;31;2799.00;101
6819;28;620738159;6819;536;8046;8147;4.59;0.28;329.42;6.94;1227;31;2800.00;101
6821;28;620738179;6821;547;8047;8148;4.57;0.28;329.41;6.94;1226;31;2801.00;101
6824;28;620738193;6824;552;8047;8148;4.53;0.27;329.36;6.94;1223;31;2802.00;101
6824;28;620738207;6824;540;8047;8148;4.54;0.27;329.36;6.94;1223;31;2803.00;101
6825;28;620738220;6825;529;8047;8148;4.57;0.28;329.37;6.94;1222;31;2804.00;101
6826;28;620738234;6826;524;8047;8148;4.59;0.28;329.35;6.94;1221;31;2805.00;101
6827;28;620738249;6827;522;8047;8148;4.62;0.28;329.40;6.94;1220;31;2806.00;101
6828;28;620738263;6828;517;8047;8148;4.68;0.28;329.41;6.94;1219;31;2807.00;101
6829;29;620738277;6829;531;8084;8218;4.79;0.29;329.43;6.91;1255;32;2808.00;134
6831;30;620738310;6831;518;8084;8219;4.81;0.29;329.45;6.91;1253;33;2809.00;135
6834;30;620738338;6834;512;8091;8219;4.92;0.30;329.46;6.91;1257;33;2810.00;128
6834;30;620738352;6834;501;8094;8219;5.01;0.30;329.46;6.90;1260;33;2811.00;125
6836;30;620738372;6836;485;8095;8219;5.06;0.31;329.42;6.90;1259;33;2812.00;124
6836;30;620738390;6836;485;8098;8219;5.18;0.31;329.42;6.90;1262;33;2813.00;121
6836;30;620738407;6836;488;8100;8219;5.28;0.32;329.42;6.90;1264;33;2814.00;119
6836;30;620738428;6836;479;8103;8219;5.38;0.33;329.42;6.90;1267;33;2815.00;116
6838;30;620738442;6838;469;8105;8220;5.46;0.33;329.38;6.90;1267;33;2816.00;115
6839;30;620738457;6839;463;8108;8221;5.51;0.33;329.40;6.90;1269;33;2817.00;113
6841;30;620738472;6841;464;8111;8221;5.54;0.34;329.47;6.91;1270;33;2818.00;110
6843;30;620738491;6843;444;8118;8225;5.55;0.34;329.52;6.94;1275;33;2819.00;107
6845;30;620738507;6845;442;8119;8225;5.60;0.34;329.62;6.94;1274;33;2820.00;106
6846;30;620738521;6846;430;8119;8225;5.59;0.34;329.66;6.94;1273;33;2821.00;106
6851;30;620738534;6851;424;8119;8225;5.59;0.34;329.84;6.94;1268;33;2822.00;106
6854;30;620738549;6854;414;8123;8231;5.60;0.34;329.96;6.94;1269;33;2823.00;108
6856;30;620738563;6856;407;8123;8231;5.58;0.34;329.96;6.94;1267;33;2824.00;108
6858;30;620738576;6858;407;8124;8231;5.62;0.34;329.97;6.98;1266;33;2825.00;107
6863;30;620738592;6863;403;8126;8234;5.70;0.35;330.11;6.98;1263;33;2826.00;108
6867;30;620738607;6867;403;8126;8234;5.72;0.35;330.10;6.98;1259;33;2827.00;108
6871;30;620738621;6871;396;8127;8234;5.74;0.35;330.21;6.98;1256;33;2828.00;107
6874;30;620738635;6874;400;8127;8235;5.78;0.35;330.18;6.98;1253;33;2829.00;108
6877;30;620738649;6877;405;8128;8236;5.87;0.36;330.21;6.98;1251;33;2830.00;108
6881;30;620738664;6881;394;8128;8236;5.94;0.36;330.18;6.98;1247;33;2831.00;108
6885;30;620738677;6885;396;8137;8249;5.99;0.36;330.18;6.97;1252;33;2832.00;112
6889;30;620738693;6889;389;8138;8249;6.03;0.37;330.33;6.97;1249;33;2833.00;111
6889;30;620738707;6889;390;8139;8249;6.12;0.37;330.33;6.97;1250;33;2834.00;110
6892;30;620738722;6892;386;8141;8251;6.16;0.37;330.24;6.97;1249;33;2835.00;110
6893;30;620738736;6893;397;8141;8251;6.23;0.38;330.32;6.97;1248;33;2836.00;110
6897;30;620738750;6897;391;8144;8255;6.25;0.38;330.29;6.96;1247;33;2837.00;111
6898;30;620738764;6898;389;8144;8255;6.30;0.38;330.27;6.96;1246;33;2838.00;111
6902;30;620738778;6902;395;8150;8259;6.31;0.38;330.49;7.00;1248;33;2839.00;109
6903;30;620738793;6903;390;8150;8259;6.33;0.38;330.54;7.00;1247;33;2840.00;109
6906;30;620738807;6906;385;8150;8259;6.31;0.38;330.54;7.00;1244;33;2841.00;109
6907;31;620738821;6907;385;8150;8259;6.35;0.38;330.55;7.00;1243;34;2842.00;109
6910;31;620738843;6910;385;8150;8259;6.32;0.38;330.64;7.00;1240;34;2843.00;109
6912;31;620738863;6912;385;8159;8271;6.29;0.38;330.65;6.99;1247;34;2844.00;112
6915;31;620738878;6915;382;8160;8271;6.26;0.38;330.66;6.99;1245;34;2845.00;111
6916;31;620738896;6916;379;8162;8271;6.21;0.38;330.78;7.03;1246;34;2846.00;109
6921;31;620738916;6921;384;8163;8271;6.16;0.37;331.01;7.07;1242;34;2847.00;108
6924;31;620738931;6924;391;8163;8271;6.11;0.37;330.99;7.07;1239;34;2848.00;108
6926;31;620738950;6926;396;8163;8271;6.08;0.37;331.02;7.07;1237;34;2849.00;108
6927;31;620738967;6927;403;8166;8274;6.04;0.37;331.07;7.12;1239;34;2850.00;108
6928;31;620738982;6928;397;8166;8274;6.01;0.36;331.08;7.12;1238;34;2851.00;108
6929;31;620739002;6929;399;8172;8280;6.09;0.37;331.05;7.16;1243;34;2852.00;108
6931;31;620739022;6931;403;8174;8281;6.05;0.37;331.18;7.20;1243;34;2853.00;107
6933;31;620739038;6933;410;8175;8281;6.02;0.36;331.14;7.24;1242;34;2854.00;106
6934;31;620739053;6934;420;8175;8281;5.99;0.36;331.12;7.24;1241;34;2855.00;106
6937;31;620739067;6937;419;8179;8285;6.01;0.36;331.18;7.28;1242;34;2856.00;106
6938;31;620739081;6938;421;8179;8285;6.05;0.37;331.14;7.28;1241;34;2857.00;106
6941;31;620739097;6941;428;8179;8285;6.02;0.37;331.19;7.28;1238;34;2858.00;106
6943;31;620739110;6943;432;8180;8286;6.06;0.37;331.34;7.28;1237;34;2859.00;106
6943;31;620739124;6943;433;8184;8290;6.04;0.37;331.34;7.32;1241;34;2860.00;106
6944;31;620739139;6944;441;8184;8290;6.07;0.37;331.41;7.32;1240;34;2861.00;106
6947;31;620739153;6947;446;8187;8293;6.07;0.37;331.46;7.37;1240;34;2862.00;106
6950;31;620739167;6950;443;8188;8293;6.00;0.36;331.56;7.37;1238;34;2863.00;105
6952;31;620739181;6952;451;8191;8295;5.91;0.36;331.67;7.41;1239;34;2864.00;104
6953;31;620739195;6953;447;8191;8295;5.84;0.35;331.64;7.41;1238;34;2865.00;104
6957;31;620739208;6957;444;8197;8299;5.80;0.35;331.73;7.49;1240;34;2866.00;102
6958;31;620739222;6958;446;8198;8299;5.76;0.35;331.70;7.53;1240;34;2867.00;101
6958;31;620739236;6958;445;8199;8299;5.76;0.35;331.70;7.57;1241;34;2868.00;100
6959;31;620739249;6959;445;8199;8299;5.76;0.35;331.72;7.57;1240;34;2869.00;100
6964;31;620739263;6964;445;8201;8300;5.72;0.35;331.75;7.65;1237;34;2870.00;99
6964;31;620739277;6964;437;8202;8301;5.77;0.35;331.75;7.65;1238;34;2871.00;99
6966;31;620739291;6966;433;8202;8301;5.77;0.35;331.97;7.65;1236;34;2872.00;99
6970;31;620739304;6970;433;8205;8302;5.77;0.35;331.85;7.73;1235;34;2873.00;97
6972;31;620739318;6972;429;8205;8302;5.74;0.35;331.82;7.73;1233;34;2874.00;97
6976;31;620739332;6976;426;8205;8302;5.79;0.35;331.98;7.73;1229;34;2875.00;97
6979;31;620739348;6979;420;8207;8302;5.80;0.35;332.00;7.81;1228;34;2876.00;95
6983;31;620739362;6983;420;8207;8302;5.85;0.36;332.16;7.81;1224;34;2877.00;95
6986;31;620739375;6986;421;8209;8302;5.89;0.36;332.24;7.89;1223;34;2878.00;93
6987;31;620739388;6987;422;8209;8302;5.92;0.36;332.35;7.89;1222;34;2879.00;93
6989;31;620739404;6989;458;8310;8532;6.11;0.38;332.34;7.83;1321;34;2880.00;222
6990;31;620739451;6990;456;8316;8533;6.12;0.38;332.38;7.87;1326;34;2881.00;217
6994;31;620739478;6994;452;8325;8533;6.15;0.38;332.52;7.90;1331;34;2882.00;208
7001;31;620739499;7001;459;8331;8533;6.09;0.38;332.68;7.93;1330;34;2883.00;202
7003;31;620739521;7003;461;8340;8533;6.09;0.38;332.65;7.93;1337;34;2884.00;193
7008;31;620739537;7008;464;8345;8533;6.02;0.37;332.77;7.96;1337;34;2885.00;188
7012;31;620739554;7012;466;8351;8533;5.97;0.37;332.70;8.00;1339;34;2886.00;182
7019;31;620739570;7019;470;8360;8533;5.86;0.36;332.80;8.03;1341;34;2887.00;173
7022;31;620739587;7022;472;8366;8534;5.77;0.36;332.82;8.07;1344;34;2888.00;168
7027;31;620739603;7027;480;8370;8535;5.68;0.35;332.89;8.10;1343;34;2889.00;165
7029;31;620739619;7029;475;8375;8535;5.64;0.35;332.99;8.10;1346;34;2890.00;160
7034;31;620739635;7034;479;8380;8536;5.55;0.34;332.98;8.13;1346;34;2891.00;156
7036;31;620739651;7036;481;8384;8536;5.47;0.34;333.11;8.16;1348;34;2892.00;152
7039;31;620739667;7039;489;8389;8536;5.34;0.33;333.14;8.20;1350;34;2893.00;147
7043;31;620739683;7043;484;8391;8536;5.27;0.33;333.02;8.20;1348;34;2894.00;145
7044;31;620739699;7044;503;8397;8540;5.19;0.32;333.05;8.27;1353;34;2895.00;143
7050;31;620739715;7050;511;8399;8540;5.08;0.31;333.21;8.27;1349;34;2896.00;141
7055;31;620739731;7055;506;8400;8540;5.02;0.31;333.39;8.28;1345;34;2897.00;140
7057;31;620739748;7057;515;8403;8543;4.95;0.31;333.39;8.28;1346;34;2898.00;140
7061;31;620739764;7061;512;8406;8543;4.87;0.30;333.55;8.28;1345;34;2899.00;137
7065;31;620739780;7065;514;8410;8543;4.79;0.30;333.75;8.29;1345;34;2900.00;133
7067;31;620739802;7067;519;8413;8547;4.78;0.30;333.81;8.29;1346;34;2901.00;134
7070;31;620739818;7070;518;8416;8548;4.76;0.29;333.84;8.29;1346;34;2902.00;132
7073;31;620739833;7073;518;8420;8548;4.74;0.29;333.90;8.30;1347;34;2903.00;128
7079;31;620739849;7079;521;8421;8552;4.73;0.29;334.11;8.30;1342;34;2904.00;131
7084;31;620739865;7084;524;8424;8552;4.70;0.29;334.15;8.30;1340;34;2905.00;128
7087;31;620739880;7087;521;8427;8552;4.69;0.29;334.22;8.30;1340;34;2906.00;125
7092;31;620739895;7092;537;8430;8553;4.66;0.29;334.34;8.30;1338;34;2907.00;123
7096;31;620739911;7096;549;8432;8553;4.64;0.28;334.45;8.31;1336;34;2908.00;121
7100;31;620739928;7100;551;8436;8559;4.62;0.28;334.48;8.30;1336;34;2909.00;123
7103;31;620739946;7103;558;8440;8559;4.58;0.28;334.46;8.31;1337;34;2910.00;119
7108;31;620739962;7108;565;8440;8560;4.50;0.28;334.62;8.31;1332;34;2911.00;120
7108;31;620739977;7108;566;8441;8560;4.47;0.27;334.62;8.31;1333;34;2912.00;119
7112;31;620739992;7112;564;8442;8560;4.43;0.27;334.67;8.32;1330;34;2913.00;118
7115;31;620740007;7115;574;8442;8560;4.37;0.27;334.68;8.32;1327;34;2914.00;118
7116;31;620740023;7116;585;8444;8560;4.32;0.27;334.66;8.32;1328;34;2915.00;116
7121;31;620740039;7121;595;8453;8572;4.28;0.26;334.76;8.31;1332;34;2916.00;119
7125;31;620740056;7125;606;8455;8572;4.19;0.26;334.77;8.31;1330;34;2917.00;117
7129;31;620740070;7129;611;8456;8572;4.16;0.26;334.77;8.36;1327;34;2918.00;116
7134;31;620740084;7134;615;8456;8572;4.13;0.25;334.79;8.36;1322;34;2919.00;116
7138;31;620740099;7138;618;8457;8572;4.11;0.25;334.92;8.36;1319;34;2920.00;115
7144;31;620740112;7144;632;8458;8572;4.06;0.25;334.93;8.36;1314;34;2921.00;114
7150;31;620740127;7150;634;8462;8576;4.05;0.25;335.06;8.36;1312;34;2922.00;114
7151;31;620740142;7151;644;8463;8576;4.02;0.25;335.10;8.36;1312;34;2923.00;113
7155;31;620740155;7155;640;8466;8580;3.98;0.24;335.11;8.36;1311;34;2924.00;114
7159;31;620740170;7159;647;8469;8582;3.94;0.24;335.17;8.36;1310;34;2925.00;113
7164;31;620740183;7164;649;8469;8582;3.90;0.24;335.34;8.36;1305;34;2926.00;113
7167;31;620740197;7167;643;8469;8582;3.88;0.24;335.34;8.36;1302;34;2927.00;113
7172;31;620740211;7172;637;8479;8595;3.90;0.24;335.42;8.35;1307;34;2928.00;116
7173;31;620740226;7173;649;8479;8595;3.89;0.24;335.42;8.35;1306;34;2929.00;116
7175;31;620740239;7175;658;8479;8595;3.83;0.23;335.46;8.35;1304;34;2930.00;116
7176;31;620740253;7176;663;8480;8596;3.82;0.23;335.43;8.35;1304;34;2931.00;116
7180;31;620740267;7180;665;8480;8597;3.81;0.23;335.39;8.35;1300;34;2932.00;117
7182;31;620740280;7182;671;8480;8597;3.80;0.23;335.41;8.35;1298;34;2933.00;117
7185;31;620740294;7185;674;8482;8600;3.81;0.23;335.32;8.34;1297;34;2934.00;118
7187;31;620740307;7187;674;8482;8600;3.81;0.23;335.32;8.34;1295;34;2935.00;118
7192;31;620740321;7192;673;8483;8600;3.80;0.23;335.20;8.34;1291;34;2936.00;117
7194;31;620740334;7194;662;8483;8600;3.81;0.23;335.30;8.34;1289;34;2937.00;117
7196;31;620740349;7196;661;8488;8606;3.87;0.24;335.33;8.34;1292;34;2938.00;118
7200;31;620740363;7200;659;8488;8606;3.81;0.23;335.24;8.34;1288;34;2939.00;118
7201;31;620740378;7201;658;8488;8606;3.79;0.23;335.25;8.34;1287;34;2940.00;118
7203;31;620740391;7203;652;8488;8606;3.75;0.23;335.39;8.34;1285;34;2941.00;118
7207;31;620740405;7207;654;8491;8610;3.76;0.23;335.53;8.34;1284;34;2942.00;119
7207;31;620740419;7207;653;8492;8611;3.77;0.23;335.53;8.33;1285;34;2943.00;119
7209;31;620740432;7209;654;8492;8611;3.77;0.23;335.51;8.33;1283;34;2944.00;119
7211;31;620740446;7211;652;8493;8612;3.76;0.23;335.44;8.33;1282;34;2945.00;119
7212;31;620740459;7212;647;8493;8612;3.77;0.23;335.40;8.33;1281;34;2946.00;119
7214;31;620740473;7214;626;8493;8612;3.76;0.23;335.46;8.33;1279;34;2947.00;119
7216;31;620740485;7216;613;8493;8612;3.83;0.23;335.44;8.33;1277;34;2948.00;119
7218;31;620740498;7218;607;8493;8612;3.88;0.24;335.41;8.33;1275;34;2949.00;119
7220;31;620740511;7220;604;8493;8612;3.92;0.24;335.35;8.33;1273;34;2950.00;119
7222;31;620740530;7222;601;8493;8612;3.96;0.24;335.33;8.33;1271;34;2951.00;119
7224;31;620740543;7224;606;8526;8682;4.19;0.26;335.31;8.30;1302;34;2952.00;156
7224;31;620740564;7224;599;8526;8683;4.29;0.26;335.31;8.30;1302;34;2953.00;157
7226;31;620740578;7226;598;8533;8683;4.40;0.27;335.35;8.30;1307;34;2954.00;150
7227;31;620740592;7227;580;8536;8683;4.48;0.28;335.31;8.29;1309;34;2955.00;147
7229;31;620740606;7229;569;8538;8683;4.57;0.28;335.35;8.29;1309;34;2956.00;145
7231;31;620740620;7231;557;8540;8683;4.67;0.29;335.39;8.29;1309;34;2957.00;143
7233;31;620740634;7233;551;8542;8683;4.79;0.29;335.36;8.29;1309;34;2958.00;141
7235;31;620740649;7235;541;8544;8683;4.87;0.30;335.35;8.29;1309;34;2959.00;139
7238;31;620740663;7238;542;8547;8684;4.93;0.30;335.53;8.29;1309;34;2960.00;137
7239;31;620740678;7239;540;8548;8685;4.98;0.30;335.54;8.29;1309;34;2961.00;137
7239;31;620740698;7239;536;8550;8685;5.00;0.31;335.54;8.29;1311;34;2962.00;135
7245;31;620740713;7245;529;8555;8689;5.05;0.31;335.52;8.29;1310;34;2963.00;134
7246;31;620740728;7246;538;8556;8689;5.09;0.31;335.53;8.29;1310;34;2964.00;133
7247;31;620740742;7247;540;8556;8689;5.15;0.31;335.52;8.29;1309;34;2965.00;133
7248;31;620740757;7248;531;8556;8689;5.19;0.32;335.52;8.29;1308;34;2966.00;133
7249;31;620740772;7249;531;8560;8695;5.24;0.32;335.55;8.29;1311;34;2967.00;135
7249;31;620740787;7249;523;8561;8695;5.24;0.32;335.55;8.34;1312;34;2968.00;134
7249;31;620740801;7249;527;8561;8695;5.22;0.32;335.55;8.34;1312;34;2969.00;134
7251;31;620740817;7251;528;8565;8701;5.24;0.32;335.57;8.33;1314;34;2970.00;136
7252;31;620740833;7252;525;8565;8701;5.26;0.32;335.60;8.33;1313;34;2971.00;136
7254;31;620740847;7254;514;8567;8701;5.26;0.32;335.57;8.33;1313;34;2972.00;134
7256;31;620740862;7256;514;8567;8702;5.30;0.32;335.64;8.33;1311;34;2973.00;135
7258;31;620740876;7258;512;8568;8703;5.37;0.33;335.60;8.33;1310;34;2974.00;135
7261;31;620740891;7261;514;8568;8703;5.40;0.33;335.56;8.33;1307;34;2975.00;135
7263;31;620740906;7263;509;8577;8716;5.47;0.33;335.66;8.32;1314;34;2976.00;139
7267;31;620740922;7267;511;8577;8716;5.47;0.33;335.72;8.32;1310;34;2977.00;139
7268;31;620740937;7268;508;8577;8716;5.48;0.33;335.73;8.32;1309;34;2978.00;139
7270;31;620740952;7270;507;8578;8717;5.55;0.34;335.79;8.32;1308;34;2979.00;139
7273;31;620740967;7273;494;8578;8717;5.54;0.34;335.83;8.32;1305;34;2980.00;139
7276;31;620740982;7276;494;8581;8721;5.57;0.34;336.02;8.32;1305;34;2981.00;140
7278;31;620740997;7278;477;8581;8721;5.60;0.34;336.09;8.32;1303;34;2982.00;140
7280;31;620741012;7280;471;8584;8725;5.60;0.34;336.12;8.32;1304;34;2983.00;141
7284;31;620741027;7284;471;8585;8725;5.64;0.34;336.21;8.37;1301;34;2984.00;140
7288;31;620741042;7288;465;8585;8725;5.67;0.34;336.20;8.37;1297;34;2985.00;140
7292;31;620741057;7292;459;8585;8725;5.73;0.35;336.23;8.37;1293;34;2986.00;140
7293;31;620741071;7293;454;8585;8725;5.79;0.35;336.23;8.37;1292;34;2987.00;140
7296;31;620741086;7296;445;8595;8737;5.85;0.36;336.25;8.36;1299;34;2988.00;142
7298;31;620741101;7298;438;8596;8737;5.91;0.36;336.29;8.36;1298;34;2989.00;141
7300;31;620741116;7300;431;8597;8737;5.94;0.36;336.34;8.36;1297;34;2990.00;140
7303;31;620741131;7303;427;8598;8737;5.93;0.36;336.47;8.41;1295;34;2991.00;139
7305;31;620741144;7305;420;8598;8737;5.95;0.36;336.47;8.41;1293;34;2992.00;139
7309;31;620741159;7309;417;8598;8737;5.93;0.36;336.53;8.41;1289;34;2993.00;139
7312;31;620741173;7312;413;8600;8738;5.91;0.36;336.67;8.42;1288;34;2994.00;138
7316;31;620741188;7316;411;8602;8738;5.90;0.36;336.69;8.51;1286;34;2995.00;136
7322;31;620741205;7322;403;8606;8744;5.93;0.36;336.86;8.50;1284;34;2996.00;138
7326;31;620741220;7326;404;8606;8745;5.91;0.36;337.04;8.50;1280;34;2997.00;139
7329;31;620741236;7329;397;8607;8745;5.91;0.36;337.14;8.50;1278;34;2998.00;138
7333;31;620741251;7333;398;8607;8745;5.87;0.35;337.20;8.50;1274;34;2999.00;138
7338;31;620741267;7338;392;8612;8765;5.89;0.35;337.27;8.50;1274;34;3000.00;153
7340;31;620741294;7340;381;8612;8765;5.92;0.36;337.21;8.50;1272;34;3001.00;153
7343;31;620741309;7343;386;8613;8765;5.91;0.36;337.21;8.54;1270;34;3002.00;152
7345;31;620741323;7345;384;8614;8766;5.92;0.36;337.26;8.54;1269;34;3003.00;152
7348;31;620741338;7348;390;8617;8770;5.90;0.36;337.32;8.54;1269;34;3004.00;153
7349;31;620741353;7349;395;8621;8770;5.88;0.36;337.33;8.63;1272;34;3005.00;149
7352;31;620741367;7352;393;8624;8773;5.83;0.35;337.33;8.64;1272;34;3006.00;149
7353;31;620741382;7353;397;8625;8773;5.81;0.35;337.32;8.64;1272;34;3007.00;148
7356;31;620741397;7356;396;8627;8773;5.78;0.35;337.33;8.65;1271;34;3008.00;146
7357;31;620741415;7357;391;8628;8773;5.78;0.35;337.37;8.65;1271;34;3009.00;145
7360;31;620741438;7360;387;8631;8777;5.82;0.35;337.31;8.66;1271;34;3010.00;146
7363;31;620741466;7363;392;8634;8777;5.81;0.35;337.47;8.66;1271;34;3011.00;143
7365;31;620741490;7365;389;8637;8777;5.81;0.35;337.46;8.67;1272;34;3012.00;140
7370;31;620741510;7370;401;8637;8777;5.77;0.35;337.65;8.67;1267;34;3013.00;140
7371;31;620741529;7371;402;8641;8778;5.77;0.35;337.66;8.68;1270;34;3014.00;137
7372;31;620741546;7372;402;8644;8780;5.84;0.35;337.65;8.68;1272;34;3015.00;136
7377;31;620741563;7377;405;8645;8780;5.84;0.35;337.64;8.68;1268;34;3016.00;135
7378;31;620741579;7378;410;8647;8781;5.83;0.35;337.70;8.68;1269;34;3017.00;134
7380;31;620741596;7380;412;8648;8781;5.87;0.36;337.73;8.72;1268;34;3018.00;133
7382;31;620741612;7382;421;8649;8781;5.92;0.36;337.85;8.72;1267;35;3019.00;132
7384;31;620741633;7384;421;8650;8781;5.94;0.36;337.84;8.77;1266;35;3020.00;131
7386;31;620741649;7386;422;8650;8781;5.96;0.36;337.98;8.77;1264;35;3021.00;131
7391;31;620741666;7391;420;8650;8781;5.93;0.36;338.10;8.77;1259;35;3022.00;131
7392;31;620741682;7392;424;8653;8781;5.92;0.36;338.15;8.86;1261;35;3023.00;128
7395;31;620741697;7395;446;8715;8908;6.02;0.37;338.34;8.80;1320;35;3024.00;193
7396;31;620741722;7396;445;8722;8909;5.98;0.37;338.34;8.88;1326;35;3025.00;187
7399;31;620741739;7399;442;8728;8909;5.97;0.37;338.46;8.88;1329;35;3026.00;181
7401;31;620741761;7401;442;8734;8909;5.95;0.37;338.50;8.87;1333;35;3027.00;175
7405;31;620741777;7405;447;8740;8909;5.96;0.37;338.53;8.91;1335;35;3028.00;169
7405;31;620741793;7405;451;8744;8909;5.96;0.37;338.53;8.91;1339;35;3029.00;165
7407;31;620741811;7407;456;8747;8909;5.98;0.37;338.59;8.91;1340;35;3030.00;162
7407;31;620741827;7407;460;8750;8909;6.01;0.37;338.59;8.91;1343;35;3031.00;159
7411;31;620741843;7411;463;8755;8910;6.03;0.37;338.82;8.99;1344;35;3032.00;155
7414;31;620741860;7414;464;8758;8911;6.00;0.37;338.88;8.99;1344;35;3033.00;153
7414;31;620741877;7414;462;8765;8911;6.00;0.37;338.88;9.08;1351;35;3034.00;146
7415;31;620741893;7415;471;8766;8912;5.97;0.37;338.94;9.08;1351;35;3035.00;146
7420;31;620741916;7420;473;8774;8912;5.90;0.36;339.08;9.16;1354;35;3036.00;138
7423;31;620741933;7423;477;8775;8912;5.82;0.36;339.26;9.16;1352;35;3037.00;137
7425;31;620741949;7425;494;8777;8912;5.78;0.36;339.19;9.24;1352;35;3038.00;135
7430;31;620741966;7430;495;8782;8916;5.78;0.36;339.35;9.24;1352;35;3039.00;134
7433;31;620741983;7433;494;8785;8916;5.73;0.35;339.42;9.28;1352;35;3040.00;131
7436;31;620742000;7436;501;8788;8916;5.69;0.35;339.50;9.32;1352;35;3041.00;128
7438;31;620742016;7438;502;8791;8919;5.67;0.35;339.58;9.36;1353;35;3042.00;128
7442;31;620742033;7442;503;8792;8919;5.69;0.35;339.73;9.36;1350;35;3043.00;127
7445;31;620742049;7445;506;8795;8919;5.65;0.35;339.94;9.44;1350;35;3044.00;124
7449;31;620742064;7449;511;8798;8923;5.57;0.34;339.98;9.44;1349;35;3045.00;125
7454;31;620742080;7454;514;8801;8924;5.53;0.34;339.96;9.47;1347;35;3046.00;123
7458;31;620742097;7458;521;8802;8924;5.47;0.33;340.02;9.47;1344;35;3047.00;122
7459;31;620742113;7459;520;8805;8928;5.44;0.33;340.11;9.51;1346;35;3048.00;123
7462;31;620742128;7462;523;8806;8928;5.36;0.33;340.29;9.51;1344;35;3049.00;122
7464;31;620742143;7464;530;8808;8928;5.31;0.32;340.46;9.55;1344;35;3050.00;120
7464;31;620742158;7464;535;8810;8929;5.25;0.32;340.46;9.54;1346;35;3051.00;119
7469;31;620742183;7469;540;8811;8929;5.13;0.31;340.73;9.58;1342;35;3052.00;118
7472;31;620742205;7472;543;8816;8935;5.06;0.31;340.79;9.58;1344;35;3053.00;119
7476;31;620742220;7476;544;8816;8935;4.95;0.30;340.97;9.58;1340;35;3054.00;119
7480;31;620742234;7480;549;8817;8936;4.88;0.30;341.05;9.61;1337;35;3055.00;119
7482;31;620742250;7482;555;8817;8936;4.77;0.29;341.11;9.61;1335;35;3056.00;119
7489;31;620742265;7489;556;8819;8936;4.63;0.28;341.21;9.69;1330;35;3057.00;117
7491;31;620742279;7491;565;8819;8936;4.52;0.28;341.31;9.69;1328;35;3058.00;117
7493;31;620742292;7493;570;8819;8936;4.45;0.27;341.35;9.69;1326;35;3059.00;117
7498;31;620742307;7498;568;8845;8972;4.53;0.28;341.43;9.66;1347;35;3060.00;127
7501;31;620742324;7501;570;8845;8972;4.53;0.28;341.41;9.66;1344;35;3061.00;127
7505;31;620742338;7505;571;8848;8972;4.49;0.28;341.40;9.66;1343;35;3062.00;124
7508;31;620742352;7508;576;8848;8972;4.44;0.27;341.38;9.66;1340;35;3063.00;124
7510;31;620742366;7510;576;8849;8972;4.42;0.27;341.46;9.66;1339;35;3064.00;123
7513;31;620742380;7513;580;8849;8972;4.39;0.27;341.42;9.66;1336;35;3065.00;123
7519;31;620742394;7519;580;8853;8976;4.36;0.27;341.55;9.65;1334;35;3066.00;123
7523;31;620742410;7523;579;8853;8976;4.36;0.27;341.56;9.65;1330;35;3067.00;123
7527;31;620742424;7527;579;8857;8980;4.39;0.27;341.68;9.65;1330;35;3068.00;123
7531;31;620742439;7531;583;8858;8981;4.36;0.27;341.72;9.65;1327;35;3069.00;123
7534;31;620742453;7534;581;8858;8981;4.34;0.27;341.83;9.65;1324;35;3070.00;123
7538;31;620742468;7538;577;8858;8981;4.29;0.27;341.86;9.65;1320;35;3071.00;123
7540;31;620742482;7540;589;8869;8994;4.33;0.27;341.83;9.63;1329;35;3072.00;125
7545;31;620742496;7545;581;8869;8994;4.29;0.26;341.81;9.63;1324;35;3073.00;125
7548;31;620742510;7548;584;8869;8994;4.26;0.26;341.83;9.63;1321;35;3074.00;125
7552;31;620742525;7552;583;8871;8995;4.24;0.26;341.79;9.68;1319;35;3075.00;124
7555;31;620742539;7555;590;8871;8996;4.23;0.26;341.67;9.68;1316;35;3076.00;125
7560;31;620742552;7560;585;8871;8996;4.14;0.26;341.66;9.68;1311;35;3077.00;125
7564;31;620742565;7564;591;8874;8999;4.10;0.25;341.73;9.68;1310;35;3078.00;125
7567;31;620742578;7567;590;8874;8999;4.07;0.25;341.64;9.68;1307;35;3079.00;125
7572;31;620742592;7572;590;8874;8999;4.02;0.25;341.58;9.68;1302;35;3080.00;125
7574;31;620742605;7574;599;8874;8999;4.04;0.25;341.58;9.68;1300;35;3081.00;125
7574;31;620742618;7574;602;8878;9005;4.09;0.25;341.58;9.67;1304;35;3082.00;127
7578;31;620742632;7578;602;8878;9005;4.04;0.25;341.58;9.67;1300;35;3083.00;127
7580;31;620742645;7580;603;8878;9005;4.02;0.25;341.57;9.67;1298;35;3084.00;127
7583;31;620742658;7583;602;8878;9005;4.00;0.25;341.59;9.67;1295;35;3085.00;127
7586;31;620742672;7586;611;8881;9009;4.00;0.25;341.63;9.67;1295;35;3086.00;128
7591;31;620742685;7591;612;8882;9010;3.94;0.24;341.58;9.67;1291;35;3087.00;128
7594;31;620742698;7594;609;8882;9010;3.89;0.24;341.52;9.67;1288;35;3088.00;128
7600;31;620742711;7600;615;8884;9011;3.84;0.24;341.56;9.67;1284;35;3089.00;127
7604;31;620742726;7604;624;8884;9011;3.80;0.23;341.55;9.67;1280;35;3090.00;127
7609;31;620742739;7609;615;8884;9011;3.77;0.23;341.53;9.67;1275;35;3091.00;127
7613;31;620742751;7613;623;8884;9011;3.74;0.23;341.48;9.67;1271;35;3092.00;127
7618;31;620742764;7618;627;8884;9011;3.69;0.23;341.45;9.67;1266;35;3093.00;127
7619;31;620742777;7619;634;8884;9011;3.68;0.23;341.41;9.67;1265;35;3094.00;127
7624;31;620742789;7624;643;8884;9011;3.65;0.22;341.57;9.67;1260;35;3095.00;127
7625;31;620742802;7625;660;8924;9081;3.84;0.24;341.53;9.63;1299;35;3096.00;157
7629;31;620742819;7629;658;8925;9082;3.80;0.23;341.61;9.63;1296;35;3097.00;157
7632;31;620742831;7632;659;8932;9082;3.79;0.23;341.59;9.62;1300;35;3098.00;150
7634;31;620742844;7634;659;8936;9082;3.77;0.23;341.58;9.62;1302;35;3099.00;146
7637;31;620742857;7637;662;8940;9082;3.72;0.23;341.65;9.61;1303;35;3100.00;142
7639;31;620742874;7639;663;8942;9082;3.69;0.23;341.68;9.61;1303;35;3101.00;140
7641;31;620742886;7641;664;8944;9082;3.63;0.22;341.68;9.61;1303;35;3102.00;138
7643;31;620742899;7643;664;8947;9082;3.61;0.22;341.72;9.66;1304;35;3103.00;135
7644;31;620742911;7644;657;8948;9083;3.58;0.22;341.72;9.66;1304;35;3104.00;135
7645;31;620742925;7645;661;8952;9085;3.56;0.22;341.75;9.66;1307;35;3105.00;133
7647;31;620742938;7647;664;8952;9085;3.54;0.22;341.74;9.66;1305;35;3106.00;133
7648;31;620742951;7648;644;8957;9089;3.56;0.22;341.76;9.66;1309;35;3107.00;132
7651;31;620742965;7651;633;8957;9089;3.60;0.22;341.77;9.66;1306;35;3108.00;132
7653;31;620742979;7653;622;8957;9089;3.66;0.22;341.77;9.66;1304;35;3109.00;132
7654;31;620742992;7654;617;8957;9089;3.74;0.23;341.76;9.66;1303;35;3110.00;132
7657;31;620743005;7657;609;8962;9095;3.83;0.23;341.73;9.65;1305;35;3111.00;133
7659;31;620743019;7659;595;8962;9095;3.92;0.24;341.75;9.65;1303;35;3112.00;133
7661;31;620743034;7661;600;8962;9095;4.03;0.25;341.77;9.65;1301;35;3113.00;133
7662;31;620743048;7662;591;8964;9098;4.16;0.25;341.75;9.65;1302;35;3114.00;134
7664;31;620743063;7664;594;8964;9098;4.17;0.25;341.72;9.65;1300;35;3115.00;134
7666;31;620743082;7666;579;8965;9098;4.19;0.25;341.74;9.65;1299;35;3116.00;133
7668;31;620743097;7668;559;8965;9099;4.24;0.26;341.82;9.65;1297;35;3117.00;134
7668;31;620743112;7668;547;8966;9100;4.31;0.26;341.82;9.65;1298;35;3118.00;134
7669;31;620743127;7669;537;8966;9100;4.40;0.27;341.80;9.65;1297;35;3119.00;134
7673;31;620743145;7673;535;8985;9126;4.60;0.28;341.72;9.68;1312;35;3120.00;141
7675;32;620743162;7675;527;8986;9126;4.68;0.28;341.68;9.68;1311;36;3121.00;140
7675;32;620743191;7675;519;8988;9126;4.80;0.29;341.68;9.67;1313;36;3122.00;138
7675;32;620743206;7675;513;8990;9127;4.90;0.30;341.68;9.67;1315;36;3123.00;137
7677;32;620743221;7677;514;8990;9127;4.95;0.30;341.81;9.67;1313;36;3124.00;137
7678;32;620743240;7678;518;8994;9131;5.04;0.31;341.84;9.67;1316;36;3125.00;137
7679;32;620743257;7679;520;8994;9131;5.11;0.31;341.81;9.67;1315;37;3126.00;137
7681;32;620743280;7681;511;8997;9135;5.11;0.31;341.87;9.67;1316;37;3127.00;138
7682;32;620743296;7682;508;8997;9135;5.08;0.31;341.84;9.67;1315;37;3128.00;138
7685;32;620743311;7685;500;8997;9135;5.09;0.31;341.83;9.67;1312;37;3129.00;138
7686;32;620743326;7686;498;8998;9135;5.08;0.31;341.96;9.71;1312;37;3130.00;137
7688;32;620743341;7688;499;8998;9135;5.07;0.31;342.00;9.71;1310;37;3131.00;137
7689;32;620743356;7689;496;9008;9147;5.13;0.31;341.98;9.70;1319;37;3132.00;139
7692;32;620743372;7692;491;9009;9147;5.14;0.31;342.04;9.70;1317;37;3133.00;138
7694;32;620743387;7694;483;9009;9147;5.16;0.31;342.15;9.70;1315;37;3134.00;138
7695;32;620743403;7695;478;9009;9147;5.26;0.32;342.14;9.70;1314;37;3135.00;138
7698;32;620743424;7698;472;9009;9147;5.37;0.33;342.20;9.70;1311;37;3136.00;138
7700;32;620743448;7700;468;9009;9147;5.48;0.33;342.33;9.70;1309;37;3137.00;138
7701;32;620743472;7701;465;9009;9148;5.58;0.34;342.43;9.70;1308;37;3138.00;139
7702;32;620743493;7702;453;9009;9148;5.62;0.34;342.41;9.70;1307;37;3139.00;139
7703;32;620743516;7703;450;9014;9154;5.70;0.35;342.44;9.70;1311;37;3140.00;140
7708;32;620743535;7708;450;9015;9155;5.67;0.34;342.56;9.70;1307;37;3141.00;140
7709;32;620743553;7709;451;9015;9155;5.62;0.34;342.59;9.70;1306;37;3142.00;140
7711;32;620743570;7711;449;9015;9155;5.61;0.34;342.68;9.70;1304;37;3143.00;140
7715;32;620743588;7715;457;9018;9159;5.56;0.34;342.74;9.69;1303;37;3144.00;141
7717;32;620743605;7717;457;9019;9159;5.55;0.34;342.84;9.74;1302;37;3145.00;140
7717;32;620743621;7717;458;9019;9159;5.54;0.33;342.84;9.74;1302;37;3146.00;140
7719;32;620743637;7719;456;9020;9160;5.51;0.33;342.98;9.74;1301;37;3147.00;140
7720;32;620743653;7720;455;9023;9164;5.50;0.33;343.01;9.74;1303;37;3148.00;141
7725;32;620743669;7725;454;9023;9164;5.49;0.33;343.21;9.74;1298;37;3149.00;141
7726;32;620743688;7726;451;9027;9170;5.53;0.33;343.26;9.73;1301;37;3150.00;143
7726;32;620743705;7726;445;9027;9170;5.59;0.34;343.26;9.73;1301;37;3151.00;143
7729;32;620743721;7729;444;9029;9170;5.63;0.34;343.35;9.73;1300;37;3152.00;141
7730;32;620743738;7730;440;9029;9170;5.61;0.34;343.35;9.73;1299;37;3153.00;141
7732;32;620743754;7732;438;9033;9174;5.68;0.34;343.35;9.73;1301;37;3154.00;141
7734;32;620743771;7734;443;9033;9174;5.69;0.34;343.42;9.73;1299;37;3155.00;141
7736;32;620743786;7736;431;9033;9174;5.74;0.35;343.40;9.73;1297;37;3156.00;141
7736;32;620743803;7736;420;9033;9174;5.81;0.35;343.40;9.73;1297;37;3157.00;141
7738;32;620743819;7738;411;9033;9175;5.86;0.36;343.42;9.73;1295;37;3158.00;142
7742;32;620743838;7742;409;9034;9176;5.88;0.36;343.42;9.73;1292;37;3159.00;142
7749;32;620743854;7749;404;9034;9176;5.84;0.35;343.52;9.73;1285;37;3160.00;142
7753;32;620743877;7753;405;9035;9177;5.80;0.35;343.63;9.72;1282;37;3161.00;142
7755;32;620743892;7755;401;9035;9177;5.76;0.35;343.69;9.72;1280;37;3162.00;142
7757;32;620743908;7757;394;9035;9177;5.76;0.35;343.88;9.72;1278;37;3163.00;142
7762;32;620743923;7762;387;9035;9177;5.73;0.35;343.91;9.72;1273;37;3164.00;142
7766;32;620743940;7766;389;9036;9177;5.69;0.35;344.03;9.77;1270;37;3165.00;141
7772;32;620743960;7772;387;9038;9177;5.65;0.34;344.37;9.86;1266;37;3166.00;139
7775;32;620743976;7775;386;9038;9177;5.67;0.35;344.45;9.86;1263;37;3167.00;139
7778;32;620743992;7778;408;9104;9304;5.77;0.36;344.40;9.79;1326;37;3168.00;200
7779;32;620744019;7779;402;9106;9305;5.79;0.36;344.40;9.79;1327;37;3169.00;199
7782;32;620744035;7782;393;9113;9305;5.81;0.36;344.36;9.78;1331;37;3170.00;192
7783;32;620744051;7783;390;9113;9305;5.81;0.36;344.35;9.78;1330;37;3171.00;192
7791;32;620744067;7791;385;9120;9305;5.84;0.36;344.40;9.78;1329;37;3172.00;185
7794;32;620744083;7794;385;9121;9305;5.86;0.36;344.43;9.78;1327;37;3173.00;184
7796;32;620744099;7796;387;9123;9305;5.89;0.36;344.38;9.78;1327;37;3174.00;182
7799;32;620744116;7799;387;9126;9305;5.98;0.37;344.42;9.78;1327;37;3175.00;179
7804;32;620744132;7804;390;9130;9306;5.95;0.36;344.60;9.82;1326;37;3176.00;176
7805;32;620744150;7805;386;9134;9307;5.97;0.37;344.57;9.82;1329;37;3177.00;173
7809;32;620744166;7809;381;9141;9307;5.93;0.36;344.75;9.87;1332;37;3178.00;166
7811;32;620744182;7811;383;9143;9308;5.88;0.36;344.76;9.87;1332;37;3179.00;165
7813;32;620744200;7813;386;9149;9308;5.82;0.36;344.79;9.87;1336;37;3180.00;159
7817;32;620744216;7817;388;9151;9308;5.78;0.35;344.86;9.87;1334;37;3181.00;157
7819;32;620744232;7819;392;9151;9308;5.77;0.35;344.83;9.87;1332;37;3182.00;157
7823;32;620744249;7823;405;9155;9312;5.75;0.35;344.99;9.87;1332;37;3183.00;157
7826;32;620744265;7826;405;9159;9312;5.74;0.35;344.99;9.88;1333;37;3184.00;153
7829;32;620744281;7829;423;9160;9312;5.73;0.35;345.16;9.87;1331;37;3185.00;152
7830;32;620744297;7830;421;9163;9315;5.71;0.35;345.20;9.88;1333;37;3186.00;152
7832;32;620744314;7832;436;9163;9315;5.71;0.35;345.28;9.88;1331;37;3187.00;152
7833;32;620744330;7833;440;9164;9315;5.72;0.35;345.32;9.88;1331;37;3188.00;151
7836;32;620744346;7836;436;9168;9319;5.69;0.35;345.51;9.87;1332;37;3189.00;151
7839;32;620744363;7839;437;9170;9320;5.68;0.35;345.53;9.92;1331;37;3190.00;150
7842;32;620744378;7842;449;9173;9322;5.63;0.34;345.57;9.92;1331;37;3191.00;149
7843;32;620744395;7843;444;9177;9326;5.63;0.34;345.59;9.96;1334;37;3192.00;149
7846;32;620744420;7846;456;9177;9326;5.63;0.34;345.72;9.96;1331;37;3193.00;149
7846;32;620744436;7846;457;9178;9326;5.63;0.34;345.72;9.96;1332;37;3194.00;148
7849;32;620744452;7849;458;9183;9328;5.62;0.34;345.74;10.11;1334;37;3195.00;145
7852;32;620744469;7852;459;9183;9328;5.59;0.34;345.83;10.11;1331;37;3196.00;145
7854;32;620744485;7854;456;9188;9334;5.58;0.34;345.82;10.10;1334;37;3197.00;146
7856;32;620744500;7856;460;9189;9334;5.54;0.34;345.90;10.15;1333;37;3198.00;145
7859;32;620744515;7859;464;9189;9335;5.49;0.34;346.02;10.15;1330;37;3199.00;146
7860;32;620744531;7860;476;9190;9335;5.41;0.33;346.03;10.19;1330;37;3200.00;145
7863;32;620744550;7863;485;9190;9335;5.37;0.33;346.05;10.19;1327;37;3201.00;145
7865;32;620744564;7865;490;9190;9335;5.32;0.33;346.14;10.19;1325;37;3202.00;145
7868;32;620744578;7868;486;9191;9335;5.25;0.32;346.25;10.24;1323;37;3203.00;144
7873;32;620744593;7873;490;9202;9347;5.24;0.32;346.30;10.28;1329;37;3204.00;145
7875;32;620744609;7875;493;9202;9347;5.22;0.32;346.42;10.28;1327;37;3205.00;145
7879;32;620744623;7879;498;9203;9347;5.20;0.32;346.37;10.28;1324;37;3206.00;144
7883;32;620744636;7883;501;9204;9347;5.12;0.31;346.61;10.32;1321;37;3207.00;143
7883;32;620744649;7883;505;9204;9347;5.10;0.31;346.61;10.32;1321;37;3208.00;143
7884;32;620744663;7884;517;9205;9347;5.05;0.31;346.74;10.37;1321;37;3209.00;142
7884;32;620744679;7884;524;9208;9351;5.01;0.31;346.74;10.36;1324;37;3210.00;143
7888;32;620744693;7888;528;9212;9351;4.93;0.30;346.95;10.54;1324;37;3211.00;139
7892;32;620744707;7892;532;9216;9355;4.96;0.30;347.04;10.54;1324;37;3212.00;139
7894;32;620744722;7894;527;9218;9356;4.94;0.30;347.02;10.58;1324;37;3213.00;138
7900;32;620744736;7900;534;9219;9356;4.83;0.29;347.29;10.63;1319;37;3214.00;137
7903;32;620744750;7903;534;9219;9356;4.81;0.29;347.30;10.63;1316;37;3215.00;137
7905;32;620744764;7905;545;9230;9369;4.79;0.29;347.40;10.61;1325;37;3216.00;139
7907;32;620744778;7907;550;9230;9369;4.75;0.29;347.48;10.61;1323;37;3217.00;139
7908;32;620744791;7908;564;9232;9369;4.74;0.29;347.53;10.70;1324;37;3218.00;137
7911;32;620744804;7911;569;9233;9370;4.73;0.29;347.54;10.70;1322;37;3219.00;137
7918;32;620744817;7918;569;9233;9371;4.66;0.28;347.76;10.70;1315;37;3220.00;138
7922;32;620744831;7922;574;9235;9371;4.58;0.28;347.72;10.78;1313;37;3221.00;136
7925;32;620744844;7925;579;9238;9374;4.56;0.28;347.81;10.78;1313;37;3222.00;136
7929;32;620744857;7929;575;9240;9374;4.49;0.27;348.01;10.86;1311;37;3223.00;134
7932;32;620744870;7932;581;9240;9374;4.48;0.27;347.98;10.86;1308;37;3224.00;134
7934;32;620744883;7934;582;9240;9374;4.45;0.27;348.04;10.86;1306;37;3225.00;134
7938;32;620744898;7938;578;9247;9380;4.41;0.27;348.00;10.94;1309;37;3226.00;133
7940;32;620744911;7940;574;9247;9380;4.36;0.27;348.04;10.94;1307;37;3227.00;133
7947;32;620744924;7947;572;9247;9380;4.29;0.26;347.99;10.94;1300;37;3228.00;133
7951;32;620744938;7951;579;9249;9380;4.24;0.26;347.92;11.02;1298;37;3229.00;131
7954;32;620744950;7954;575;9252;9384;4.22;0.26;347.93;11.02;1298;37;3230.00;132
7958;32;620744963;7958;567;9253;9385;4.16;0.25;348.03;11.02;1295;37;3231.00;132
7959;32;620744976;7959;568;9253;9385;4.12;0.25;348.05;11.02;1294;37;3232.00;132
7962;32;620744988;7962;561;9254;9386;4.08;0.25;348.08;11.02;1292;37;3233.00;132
7966;32;620745001;7966;558;9254;9386;4.03;0.25;348.12;11.02;1288;37;3234.00;132
7969;32;620745013;7969;561;9254;9386;4.00;0.25;348.14;11.02;1285;37;3235.00;132
7974;32;620745025;7974;551;9254;9386;4.02;0.25;348.07;11.02;1280;37;3236.00;132
7977;32;620745038;7977;544;9254;9386;4.02;0.25;348.00;11.02;1277;37;3237.00;132
7979;32;620745051;7979;538;9254;9386;4.03;0.25;347.97;11.02;1275;37;3238.00;132
7982;32;620745064;7982;538;9254;9386;4.01;0.25;347.92;11.02;1272;37;3239.00;132
7985;32;620745077;7985;543;9315;9511;4.32;0.27;347.85;10.95;1330;37;3240.00;196
7989;32;620745099;7989;534;9319;9512;4.31;0.27;347.81;10.94;1330;37;3241.00;193
7992;32;620745113;7992;531;9329;9512;4.36;0.27;347.79;10.93;1337;37;3242.00;183
7993;32;620745126;7993;538;9333;9512;4.45;0.28;347.79;10.93;1340;37;3243.00;179
7998;32;620745139;7998;538;9337;9512;4.44;0.27;347.81;10.97;1339;37;3244.00;175
8003;32;620745154;8003;547;9338;9512;4.46;0.28;347.74;10.97;1335;37;3245.00;174
8006;32;620745167;8006;544;9341;9512;4.48;0.28;347.68;10.97;1335;37;3246.00;171
8009;32;620745180;8009;542;9344;9512;4.47;0.28;347.68;10.97;1335;37;3247.00;168
8011;32;620745195;8011;547;9348;9513;4.52;0.28;347.71;10.97;1337;37;3248.00;165
8014;32;620745209;8014;551;9349;9514;4.54;0.28;347.70;10.97;1335;37;3249.00;165
8019;32;620745222;8019;554;9351;9514;4.54;0.28;347.65;10.97;1332;37;3250.00;163
8020;32;620745236;8020;560;9355;9518;4.57;0.28;347.69;10.96;1335;37;3251.00;163
8023;32;620745250;8023;562;9356;9518;4.54;0.28;347.65;10.96;1333;37;3252.00;162
8027;32;620745265;8027;571;9356;9518;4.49;0.28;347.70;10.96;1329;37;3253.00;162
8030;32;620745279;8030;579;9356;9518;4.45;0.28;347.73;10.96;1326;37;3254.00;162
8034;32;620745292;8034;575;9360;9524;4.41;0.27;347.73;10.96;1326;37;3255.00;164
8037;32;620745307;8037;576;9360;9524;4.32;0.27;347.71;10.96;1323;37;3256.00;164
8040;32;620745320;8040;582;9360;9524;4.27;0.26;347.72;10.96;1320;37;3257.00;164
8043;32;620745334;8043;591;9361;9527;4.22;0.26;347.71;10.96;1318;37;3258.00;166
8048;32;620745348;8048;585;9361;9527;4.14;0.25;347.70;10.96;1313;37;3259.00;166
8049;32;620745361;8049;570;9362;9527;4.13;0.25;347.72;11.00;1313;37;3260.00;165
8051;32;620745375;8051;569;9363;9528;4.10;0.25;347.69;11.00;1312;37;3261.00;165
8056;32;620745388;8056;566;9364;9529;4.04;0.25;347.75;11.00;1308;37;3262.00;165
8061;32;620745402;8061;565;9365;9529;3.97;0.24;347.69;11.00;1304;37;3263.00;164
8064;32;620745421;8064;569;9374;9542;4.02;0.25;347.62;10.99;1310;37;3264.00;168
8067;32;620745446;8067;569;9377;9542;3.98;0.24;347.63;10.99;1310;37;3265.00;165
8067;32;620745488;8067;567;9378;9542;4.01;0.24;347.63;10.99;1311;37;3266.00;164
8069;32;620745508;8069;567;9378;9543;4.01;0.24;347.67;10.99;1309;37;3267.00;165
8076;32;620745527;8076;564;9379;9543;4.00;0.24;347.71;10.99;1303;37;3268.00;164
8078;32;620745542;8078;562;9383;9547;4.06;0.25;347.73;10.99;1305;37;3269.00;164
8078;32;620745560;8078;562;9384;9547;4.11;0.25;347.73;10.99;1306;37;3270.00;163
8082;32;620745574;8082;563;9387;9551;4.13;0.25;347.69;10.99;1305;37;3271.00;164
8086;32;620745589;8086;559;9387;9551;4.07;0.25;347.65;10.99;1301;37;3272.00;164
8087;32;620745605;8087;557;9389;9551;4.06;0.25;347.64;10.99;1302;37;3273.00;162
8090;32;620745618;8090;555;9389;9551;4.06;0.25;347.60;10.99;1299;37;3274.00;162
8091;32;620745633;8091;570;9391;9551;4.06;0.25;347.61;10.99;1300;37;3275.00;160
8094;32;620745647;8094;571;9401;9563;4.15;0.25;347.55;10.98;1307;37;3276.00;162
8095;32;620745661;8095;562;9401;9563;4.12;0.25;347.55;10.98;1306;37;3277.00;162
8097;32;620745676;8097;554;9403;9563;4.16;0.25;347.55;10.98;1306;37;3278.00;160
8097;32;620745692;8097;548;9404;9563;4.27;0.26;347.55;10.98;1307;37;3279.00;159
8098;32;620745707;8098;541;9404;9563;4.30;0.26;347.64;10.98;1306;37;3280.00;159
8101;32;620745722;8101;541;9405;9563;4.31;0.26;347.65;10.98;1304;37;3281.00;158
8103;32;620745742;8103;543;9405;9564;4.37;0.27;347.69;10.98;1302;37;3282.00;159
8104;32;620745757;8104;534;9406;9564;4.45;0.27;347.67;11.02;1302;37;3283.00;158
8105;32;620745771;8105;532;9411;9570;4.53;0.28;347.67;11.02;1306;37;3284.00;159
8105;32;620745786;8105;534;9413;9572;4.58;0.28;347.67;11.02;1308;37;3285.00;159
8106;33;620745801;8106;524;9413;9572;4.61;0.28;347.65;11.02;1307;38;3286.00;159
8107;33;620745822;8107;516;9413;9572;4.66;0.28;347.75;11.02;1306;38;3287.00;159
8107;33;620745837;8107;506;9416;9576;4.71;0.29;347.75;11.01;1309;38;3288.00;160
8109;33;620745858;8109;501;9416;9576;4.70;0.29;347.80;11.01;1307;38;3289.00;160
8112;33;620745873;8112;496;9416;9576;4.68;0.29;347.98;11.01;1304;38;3290.00;160
8112;33;620745887;8112;489;9417;9577;4.72;0.29;347.98;11.01;1305;38;3291.00;160
8114;33;620745902;8114;490;9420;9581;4.70;0.29;348.01;11.01;1306;38;3292.00;161
8116;33;620745917;8116;486;9420;9581;4.68;0.29;348.06;11.01;1304;38;3293.00;161
8118;33;620745935;8118;484;9422;9584;4.65;0.28;348.06;11.01;1304;38;3294.00;162
8121;33;620745957;8121;488;9422;9584;4.60;0.28;348.13;11.01;1301;38;3295.00;162
8121;33;620745972;8121;491;9423;9584;4.60;0.28;348.13;11.01;1302;38;3296.00;161
8127;33;620745988;8127;492;9423;9584;4.53;0.28;348.18;11.01;1296;38;3297.00;161
8130;33;620746002;8130;484;9427;9588;4.57;0.28;348.18;11.00;1297;38;3298.00;161
8132;33;620746018;8132;483;9428;9588;4.60;0.28;348.20;11.04;1296;38;3299.00;160
8134;33;620746036;8134;482;9433;9607;4.61;0.28;348.36;11.04;1299;38;3300.00;174
8135;33;620746058;8135;475;9433;9607;4.66;0.28;348.40;11.04;1298;38;3301.00;174
8138;33;620746073;8138;470;9433;9608;4.68;0.28;348.50;11.04;1295;38;3302.00;175
8143;33;620746088;8143;473;9434;9609;4.70;0.29;348.59;11.04;1291;38;3303.00;175
8145;33;620746104;8145;472;9434;9609;4.77;0.29;348.65;11.04;1289;38;3304.00;175
8148;33;620746119;8148;473;9437;9610;4.81;0.29;348.76;11.03;1289;38;3305.00;173
8150;33;620746135;8150;470;9437;9610;4.86;0.30;348.86;11.03;1287;38;3306.00;173
8151;33;620746150;8151;463;9437;9610;4.92;0.30;348.92;11.03;1286;38;3307.00;173
8153;33;620746164;8153;472;9438;9610;4.97;0.30;349.01;11.08;1285;38;3308.00;172
8155;33;620746179;8155;468;9438;9610;5.03;0.31;349.02;11.08;1283;38;3309.00;172
8157;33;620746194;8157;469;9439;9610;5.07;0.31;349.13;11.08;1282;38;3310.00;171
8158;33;620746208;8158;468;9440;9610;5.09;0.31;349.13;11.08;1282;38;3311.00;170
8163;33;620746223;8163;491;9508;9737;5.22;0.32;349.43;11.00;1345;38;3312.00;229
8165;33;620746249;8165;478;9508;9738;5.27;0.32;349.54;11.00;1343;38;3313.00;230
8167;33;620746269;8167;475;9511;9738;5.34;0.33;349.55;11.00;1344;38;3314.00;227
8171;33;620746285;8171;472;9512;9738;5.34;0.33;349.66;11.00;1341;38;3315.00;226
8172;33;620746300;8172;474;9515;9738;5.38;0.33;349.70;11.00;1343;38;3316.00;223
8174;33;620746315;8174;481;9517;9738;5.40;0.33;349.78;11.00;1343;38;3317.00;221
8174;33;620746330;8174;479;9521;9738;5.47;0.34;349.78;10.99;1347;38;3318.00;217
8179;33;620746345;8179;481;9522;9738;5.49;0.34;349.98;10.99;1343;38;3319.00;216
8182;33;620746361;8182;481;9527;9739;5.50;0.34;350.13;10.99;1345;38;3320.00;212
8185;33;620746376;8185;475;9531;9740;5.52;0.34;350.20;10.99;1346;38;3321.00;209
8188;33;620746392;8188;466;9535;9740;5.54;0.34;350.21;10.99;1347;38;3322.00;205
8190;33;620746408;8190;468;9537;9741;5.57;0.34;350.24;10.99;1347;38;3323.00;204
8192;33;620746425;8192;468;9540;9741;5.57;0.34;350.30;10.99;1348;38;3324.00;201
8195;33;620746441;8195;456;9541;9741;5.59;0.34;350.41;10.99;1346;38;3325.00;200
8195;33;620746456;8195;462;9545;9741;5.57;0.34;350.41;11.04;1350;38;3326.00;196
8198;33;620746473;8198;459;9548;9745;5.58;0.34;350.51;11.04;1350;38;3327.00;197
8198;33;620746489;8198;465;9552;9745;5.64;0.34;350.51;11.04;1354;38;3328.00;193
8200;33;620746503;8200;461;9553;9745;5.65;0.35;350.52;11.04;1353;38;3329.00;192
8204;33;620746521;8204;456;9558;9751;5.60;0.34;350.67;11.04;1354;38;3330.00;193
8207;33;620746537;8207;452;9561;9751;5.52;0.34;350.68;11.04;1354;38;3331.00;190
8209;33;620746552;8209;446;9561;9751;5.44;0.33;350.69;11.04;1352;38;3332.00;190
8210;33;620746568;8210;440;9567;9755;5.35;0.33;350.70;11.04;1357;38;3333.00;188
8214;33;620746583;8214;433;9568;9756;5.31;0.32;350.76;11.04;1354;38;3334.00;188
8215;33;620746600;8215;430;9573;9756;5.26;0.32;350.77;11.14;1358;38;3335.00;183
8216;33;620746618;8216;422;9576;9760;5.25;0.32;350.79;11.14;1360;38;3336.00;184
8221;33;620746633;8221;419;9576;9760;5.17;0.31;350.91;11.14;1355;38;3337.00;184
8223;33;620746649;8223;423;9578;9760;5.13;0.31;350.94;11.14;1355;38;3338.00;182
8227;33;620746664;8227;424;9582;9761;5.12;0.31;351.01;11.14;1355;38;3339.00;179
8231;33;620746680;8231;425;9582;9761;5.06;0.31;351.03;11.14;1351;38;3340.00;179
8233;33;620746696;8233;426;9585;9767;5.07;0.31;351.01;11.14;1352;38;3341.00;182
8238;33;620746712;8238;422;9586;9767;5.04;0.31;351.24;11.14;1348;38;3342.00;181
8241;33;620746727;8241;424;9587;9768;5.03;0.31;351.43;11.14;1346;38;3343.00;181
8243;33;620746743;8243;427;9588;9768;5.06;0.31;351.41;11.14;1345;38;3344.00;180
8246;33;620746758;8246;436;9588;9768;5.08;0.31;351.39;11.14;1342;38;3345.00;180
8248;33;620746774;8248;437;9588;9768;5.11;0.31;351.34;11.14;1340;38;3346.00;180
8249;33;620746789;8249;441;9589;9768;5.13;0.31;351.37;11.14;1340;38;3347.00;179
8252;33;620746804;8252;443;9599;9780;5.20;0.32;351.41;11.13;1347;38;3348.00;181
8257;33;620746820;8257;445;9600;9780;5.18;0.31;351.47;11.13;1343;38;3349.00;180
8259;33;620746835;8259;440;9600;9780;5.20;0.32;351.46;11.13;1341;38;3350.00;180
8262;33;620746850;8262;446;9602;9780;5.13;0.31;351.52;11.14;1340;38;3351.00;178
8265;33;620746866;8265;455;9602;9780;5.09;0.31;351.58;11.14;1337;38;3352.00;178
8269;33;620746880;8269;463;9602;9780;5.05;0.31;351.63;11.14;1333;38;3353.00;178
8269;33;620746895;8269;468;9606;9784;5.02;0.31;351.63;11.14;1337;38;3354.00;178
8271;33;620746910;8271;467;9608;9784;5.02;0.31;351.62;11.19;1337;38;3355.00;176
8275;33;620746924;8275;471;9611;9788;5.06;0.31;351.69;11.19;1336;38;3356.00;177
8276;33;620746940;8276;479;9614;9789;5.09;0.31;351.65;11.19;1338;38;3357.00;175
8279;33;620746954;8279;478;9614;9789;5.07;0.31;351.79;11.19;1335;38;3358.00;175
8280;33;620746970;8280;494;9614;9789;5.07;0.31;351.84;11.19;1334;38;3359.00;175
8285;33;620746986;8285;502;9634;9818;5.08;0.31;351.89;11.16;1349;38;3360.00;184
8286;33;620747002;8286;499;9637;9818;5.09;0.31;352.01;11.21;1351;38;3361.00;181
8291;33;620747017;8291;499;9639;9818;5.08;0.31;352.04;11.21;1348;38;3362.00;179
8292;33;620747032;8292;512;9641;9819;5.08;0.31;352.08;11.21;1349;38;3363.00;178
8294;33;620747046;8294;513;9642;9820;5.07;0.31;352.19;11.26;1348;38;3364.00;178
8296;33;620747061;8296;527;9642;9820;5.01;0.31;352.18;11.26;1346;38;3365.00;178
8299;33;620747075;8299;530;9645;9823;5.01;0.31;352.28;11.31;1346;38;3366.00;178
8304;33;620747090;8304;540;9645;9823;4.96;0.30;352.37;11.31;1341;38;3367.00;178
8305;33;620747105;8305;551;9647;9823;4.89;0.30;352.46;11.35;1342;38;3368.00;176
8308;33;620747119;8308;554;9647;9823;4.82;0.30;352.43;11.35;1339;38;3369.00;176
8311;33;620747133;8311;568;9654;9829;4.82;0.30;352.48;11.45;1343;38;3370.00;175
8315;33;620747148;8315;578;9654;9829;4.73;0.29;352.45;11.45;1339;38;3371.00;175
8318;33;620747162;8318;580;9654;9829;4.68;0.29;352.52;11.45;1336;38;3372.00;175
8319;33;620747177;8319;584;9656;9829;4.59;0.28;352.64;11.55;1337;38;3373.00;173
8320;33;620747191;8320;587;9659;9833;4.52;0.28;352.61;11.54;1339;38;3374.00;174
8322;33;620747205;8322;594;9661;9835;4.44;0.27;352.69;11.54;1339;38;3375.00;174
8323;33;620747219;8323;593;9663;9835;4.39;0.27;352.75;11.64;1340;38;3376.00;172
8323;33;620747235;8323;600;9664;9836;4.38;0.27;352.75;11.64;1341;38;3377.00;172
8326;33;620747249;8326;602;9664;9836;4.31;0.26;352.72;11.64;1338;38;3378.00;172
8327;33;620747263;8327;599;9664;9836;4.29;0.26;352.75;11.64;1337;38;3379.00;172
8332;33;620747277;8332;602;9666;9836;4.28;0.26;352.87;11.74;1334;38;3380.00;170
8334;33;620747292;8334;597;9667;9836;4.24;0.26;352.83;11.79;1333;38;3381.00;169
8334;33;620747306;8334;595;9668;9836;4.26;0.26;352.83;11.84;1334;38;3382.00;168
8336;33;620747318;8336;595;9668;9836;4.25;0.26;352.85;11.84;1332;38;3383.00;168
8339;33;620747331;8339;601;9706;9906;4.43;0.27;352.81;11.89;1367;38;3384.00;200
8342;33;620747350;8342;591;9709;9907;4.41;0.27;352.86;11.89;1367;38;3385.00;198
8343;33;620747364;8343;596;9716;9907;4.42;0.27;352.86;11.88;1373;38;3386.00;191
8345;33;620747378;8345;592;9719;9907;4.43;0.27;352.85;11.88;1374;38;3387.00;188
8347;33;620747391;8347;602;9725;9907;4.43;0.27;352.87;11.98;1378;38;3388.00;182
8351;33;620747404;8351;601;9727;9907;4.37;0.27;352.81;11.98;1376;38;3389.00;180
8353;33;620747425;8353;599;9732;9907;4.35;0.27;352.74;12.07;1379;38;3390.00;175
8357;33;620747448;8357;605;9735;9907;4.28;0.26;352.67;12.07;1378;38;3391.00;172
8362;33;620747473;8362;614;9737;9908;4.20;0.26;352.55;12.07;1375;38;3392.00;171
8365;33;620747494;8365;622;9742;9909;4.12;0.25;352.56;12.16;1377;38;3393.00;167
8368;33;620747513;8368;624;9743;9909;4.08;0.25;352.53;12.16;1375;38;3394.00;166
8375;33;620747533;8375;633;9748;9913;4.00;0.24;352.48;12.25;1373;38;3395.00;165
8379;33;620747550;8379;636;9748;9913;3.95;0.24;352.43;12.25;1369;38;3396.00;165
8381;33;620747565;8381;647;9748;9913;3.88;0.24;352.37;12.25;1367;38;3397.00;165
8384;33;620747578;8384;658;9750;9913;3.76;0.23;352.37;12.34;1366;38;3398.00;163
8387;33;620747592;8387;667;9754;9919;3.69;0.23;352.34;12.34;1367;38;3399.00;165
8391;33;620747607;8391;670;9754;9919;3.60;0.22;352.24;12.34;1363;38;3400.00;165
8396;33;620747626;8396;666;9754;9919;3.53;0.22;352.14;12.34;1358;38;3401.00;165
8402;33;620747641;8402;655;9755;9922;3.46;0.21;352.21;12.33;1353;38;3402.00;167
8405;33;620747654;8405;658;9755;9922;3.41;0.21;352.31;12.33;1350;38;3403.00;167
8407;33;620747668;8407;655;9755;9922;3.37;0.21;352.31;12.33;1348;38;3404.00;167
8409;33;620747681;8409;650;9755;9923;3.38;0.21;352.29;12.33;1346;38;3405.00;168
8413;33;620747695;8413;645;9756;9924;3.38;0.21;352.35;12.33;1343;38;3406.00;168
8417;33;620747709;8417;634;9756;9924;3.37;0.21;352.38;12.33;1339;38;3407.00;168
8419;33;620747724;8419;627;9766;9937;3.44;0.21;352.33;12.32;1347;38;3408.00;171
8423;33;620747739;8423;630;9766;9937;3.45;0.21;352.33;12.32;1343;38;3409.00;171
8424;33;620747759;8424;623;9766;9937;3.43;0.21;352.34;12.32;1342;38;3410.00;171
8427;33;620747774;8427;609;9766;9938;3.41;0.21;352.32;12.32;1339;38;3411.00;172
8429;33;620747788;8429;589;9766;9938;3.40;0.21;352.31;12.32;1337;38;3412.00;172
8431;33;620747802;8431;590;9769;9942;3.48;0.21;352.35;12.32;1338;38;3413.00;173
8432;33;620747816;8432;583;9769;9942;3.51;0.21;352.36;12.32;1337;38;3414.00;173
8435;33;620747829;8435;570;9772;9946;3.58;0.22;352.31;12.31;1337;38;3415.00;174
8439;33;620747844;8439;565;9772;9946;3.61;0.22;352.31;12.31;1333;38;3416.00;174
8442;33;620747859;8442;565;9772;9946;3.64;0.22;352.26;12.31;1330;38;3417.00;174
8447;33;620747879;8447;554;9772;9946;3.68;0.22;352.15;12.31;1325;38;3418.00;174
8449;33;620747894;8449;560;9772;9946;3.73;0.23;352.16;12.31;1323;38;3419.00;174
8449;33;620747910;8449;560;9798;9980;3.94;0.24;352.16;12.28;1349;38;3420.00;182
8452;33;620747929;8452;552;9798;9980;3.97;0.24;352.21;12.28;1346;38;3421.00;182
8453;33;620747944;8453;552;9799;9980;4.00;0.24;352.21;12.28;1346;38;3422.00;181
8454;33;620747959;8454;548;9799;9980;4.03;0.25;352.21;12.28;1345;38;3423.00;181
8457;33;620747975;8457;541;9799;9980;4.07;0.25;352.21;12.28;1342;38;3424.00;181
8459;33;620747990;8459;531;9799;9980;4.04;0.25;352.19;12.28;1340;38;3425.00;181
8462;33;620748012;8462;529;9800;9981;3.99;0.24;352.22;12.28;1338;38;3426.00;181
8465;33;620748027;8465;528;9800;9981;4.00;0.24;352.18;12.28;1335;38;3427.00;181
8468;33;620748042;8468;537;9804;9987;3.98;0.24;352.21;12.28;1336;38;3428.00;183
8473;33;620748057;8473;529;9805;9988;3.94;0.24;352.16;12.33;1332;38;3429.00;183
8475;33;620748074;8475;531;9805;9988;3.94;0.24;352.16;12.33;1330;38;3430.00;183
8476;33;620748089;8476;532;9805;9988;3.99;0.24;352.17;12.33;1329;38;3431.00;183
8482;33;620748104;8482;523;9809;9992;3.94;0.24;352.21;12.33;1327;38;3432.00;183
8484;33;620748120;8484;519;9809;9992;3.95;0.24;352.21;12.33;1325;38;3433.00;183
8487;33;620748134;8487;520;9809;9992;3.97;0.24;352.28;12.33;1322;38;3434.00;183
8490;33;620748150;8490;516;9812;9993;3.95;0.24;352.29;12.33;1322;38;3435.00;181
8493;33;620748164;8493;510;9815;9997;3.98;0.24;352.29;12.33;1322;38;3436.00;182
8496;33;620748179;8496;507;9817;9997;4.00;0.24;352.30;12.33;1321;38;3437.00;180
8497;33;620748193;8497;508;9818;10000;4.01;0.25;352.33;12.33;1321;38;3438.00;182
8503;33;620748208;8503;513;9819;10000;3.95;0.24;352.44;12.33;1316;38;3439.00;181
8507;33;620748223;8507;519;9819;10000;3.95;0.24;352.62;12.33;1312;38;3440.00;181
8508;33;620748241;8508;511;9819;10000;3.98;0.24;352.61;12.33;1311;38;3441.00;181
8509;33;620748256;8509;523;9824;10004;3.96;0.24;352.62;12.33;1315;38;3442.00;180
8510;33;620748271;8510;524;9824;10004;4.01;0.25;352.72;12.33;1314;38;3443.00;180
8512;33;620748287;8512;527;9824;10004;4.03;0.25;352.87;12.33;1312;38;3444.00;180
8517;33;620748302;8517;528;9825;10004;4.02;0.25;352.82;12.33;1308;38;3445.00;179
8520;33;620748316;8520;531;9825;10005;4.03;0.25;352.92;12.33;1305;38;3446.00;180
8522;33;620748333;8522;519;9826;10006;4.04;0.25;353.00;12.33;1304;38;3447.00;180
8523;33;620748347;8523;515;9827;10006;4.07;0.25;353.00;12.33;1304;38;3448.00;179
8525;33;620748363;8525;507;9828;10007;4.10;0.25;353.06;12.33;1303;38;3449.00;179
8535;33;620748379;8535;507;9829;10007;4.06;0.25;353.32;12.33;1294;38;3450.00;178
8538;33;620748406;8538;501;9829;10007;4.07;0.25;353.31;12.33;1291;38;3451.00;178
8539;33;620748423;8539;503;9830;10007;4.10;0.25;353.30;12.33;1291;38;3452.00;177
8540;33;620748444;8540;494;9831;10007;4.17;0.25;353.34;12.33;1291;38;3453.00;176
8541;33;620748457;8541;493;9831;10007;4.25;0.26;353.35;12.33;1290;38;3454.00;176
8542;33;620748472;8542;497;9831;10007;4.32;0.26;353.39;12.33;1289;38;3455.00;176
8543;33;620748485;8543;504;9905;10134;4.65;0.29;353.39;12.24;1362;38;3456.00;229
8546;33;620748509;8546;482;9908;10135;4.73;0.29;353.47;12.24;1362;38;3457.00;227
8547;33;620748524;8547;473;9915;10135;4.85;0.30;353.49;12.23;1368;38;3458.00;220
8550;33;620748539;8550;455;9918;10135;4.89;0.30;353.50;12.23;1368;38;3459.00;217
8551;33;620748562;8551;456;9921;10135;4.98;0.31;353.49;12.22;1370;38;3460.00;214
8557;33;620748578;8557;454;9923;10135;4.99;0.31;353.49;12.22;1366;38;3461.00;212
8558;33;620748594;8558;451;9927;10135;5.02;0.31;353.53;12.22;1369;38;3462.00;208
8561;33;620748610;8561;453;9928;10135;4.99;0.31;353.56;12.22;1367;38;3463.00;207
8562;33;620748625;8562;458;9930;10136;4.96;0.30;353.59;12.22;1368;38;3464.00;206
8565;33;620748641;8565;468;9933;10138;4.92;0.30;353.60;12.22;1368;39;3465.00;205
8567;33;620748666;8567;468;9935;10138;4.88;0.30;353.56;12.22;1368;39;3466.00;203
8571;33;620748682;8571;467;9937;10139;4.85;0.30;353.63;12.22;1366;39;3467.00;202
8572;33;620748697;8572;467;9939;10139;4.84;0.30;353.70;12.22;1367;39;3468.00;200
8572;33;620748713;8572;470;9943;10139;4.82;0.29;353.70;12.22;1371;39;3469.00;196
8576;33;620748728;8576;477;9945;10139;4.79;0.29;353.74;12.22;1369;39;3470.00;194
8578;33;620748744;8578;479;9949;10143;4.83;0.30;353.80;12.21;1371;39;3471.00;194
8579;33;620748760;8579;487;9951;10143;4.86;0.30;353.81;12.21;1372;39;3472.00;192
8582;33;620748776;8582;486;9952;10143;4.90;0.30;353.95;12.21;1370;39;3473.00;191
8583;33;620748791;8583;483;9953;10146;4.95;0.30;354.01;12.21;1370;39;3474.00;193
8586;33;620748806;8586;492;9955;10146;4.96;0.30;354.14;12.21;1369;39;3475.00;191
8588;33;620748822;8588;495;9955;10146;4.94;0.30;354.21;12.21;1367;39;3476.00;191
8588;33;620748838;8588;499;9958;10150;4.99;0.30;354.21;12.21;1370;39;3477.00;192
8591;33;620748853;8591;502;9961;10151;5.00;0.31;354.30;12.21;1370;39;3478.00;190
8591;33;620748869;8591;498;9961;10151;5.00;0.31;354.30;12.21;1370;39;3479.00;190
8592;33;620748886;8592;494;9964;10156;5.01;0.31;354.28;12.21;1372;39;3480.00;192
8596;33;620748902;8596;494;9966;10156;5.02;0.31;354.35;12.20;1370;39;3481.00;190
8599;33;620748928;8599;494;9967;10156;4.98;0.30;354.35;12.20;1368;39;3482.00;189
8600;33;620748943;8600;503;9968;10157;5.02;0.31;354.40;12.20;1368;39;3483.00;189
8603;33;620748958;8603;500;9968;10157;5.02;0.31;354.44;12.20;1365;39;3484.00;189
8604;33;620748979;8604;514;9973;10163;5.04;0.31;354.42;12.20;1369;39;3485.00;190
8605;33;620748996;8605;519;9973;10163;5.04;0.31;354.46;12.20;1368;39;3486.00;190
8608;33;620749011;8608;516;9973;10164;5.02;0.31;354.56;12.20;1365;39;3487.00;191
8608;33;620749027;8608;515;9973;10164;5.04;0.31;354.56;12.20;1365;39;3488.00;191
8610;33;620749042;8610;509;9973;10164;5.03;0.31;354.55;12.20;1363;39;3489.00;191
8613;33;620749058;8613;506;9974;10164;4.98;0.30;354.58;12.26;1361;39;3490.00;190
8617;33;620749073;8617;495;9974;10164;4.95;0.30;354.56;12.26;1357;39;3491.00;190
8619;33;620749089;8619;483;9984;10176;5.01;0.30;354.61;12.24;1365;39;3492.00;192
8622;33;620749106;8622;479;9984;10176;5.00;0.30;354.63;12.24;1362;39;3493.00;192
8624;33;620749122;8624;478;9985;10176;5.00;0.30;354.60;12.24;1361;39;3494.00;191
8627;33;620749138;8627;471;9985;10176;4.99;0.30;354.62;12.24;1358;39;3495.00;191
8630;33;620749153;8630;472;9985;10176;4.98;0.30;354.66;12.24;1355;39;3496.00;191
8632;33;620749168;8632;471;9985;10176;4.98;0.30;354.71;12.24;1353;39;3497.00;191
8633;33;620749183;8633;467;9988;10180;4.94;0.30;354.84;12.24;1355;39;3498.00;192
8637;33;620749198;8637;464;9988;10180;4.94;0.30;355.01;12.24;1351;39;3499.00;192
8638;33;620749214;8638;463;9992;10184;4.96;0.30;355.02;12.24;1354;39;3500.00;192
8641;33;620749233;8641;461;9993;10185;4.95;0.30;355.12;12.23;1352;39;3501.00;192
8643;33;620749248;8643;456;9993;10185;4.88;0.29;355.32;12.23;1350;39;3502.00;192
8644;33;620749262;8644;457;9993;10185;4.84;0.29;355.43;12.23;1349;39;3503.00;192
8645;33;620749276;8645;463;10004;10198;4.83;0.29;355.55;12.22;1359;39;3504.00;194
8649;33;620749296;8649;455;10005;10198;4.76;0.29;355.69;12.28;1356;39;3505.00;193
8651;33;620749310;8651;464;10005;10198;4.71;0.28;355.71;12.28;1354;39;3506.00;193
8654;33;620749325;8654;467;10006;10199;4.69;0.28;355.85;12.28;1352;39;3507.00;193
8657;33;620749339;8657;478;10006;10200;4.64;0.28;355.83;12.28;1349;39;3508.00;194
8659;33;620749360;8659;483;10007;10200;4.60;0.28;355.87;12.34;1348;39;3509.00;193
8660;33;620749376;8660;483;10011;10206;4.63;0.28;355.88;12.34;1351;39;3510.00;195
8664;33;620749391;8664;485;10011;10206;4.57;0.28;355.96;12.34;1347;39;3511.00;195
8667;33;620749405;8667;482;10013;10206;4.53;0.28;356.02;12.34;1346;39;3512.00;193
8672;33;620749422;8672;488;10013;10206;4.51;0.27;356.20;12.34;1341;39;3513.00;193
8672;33;620749445;8672;489;10018;10212;4.59;0.28;356.20;12.33;1346;39;3514.00;194
8675;33;620749470;8675;490;10018;10212;4.57;0.28;356.26;12.33;1343;39;3515.00;194
8675;33;620749492;8675;498;10018;10212;4.57;0.28;356.26;12.33;1343;39;3516.00;194
8677;33;620749514;8677;497;10018;10212;4.57;0.28;356.46;12.33;1341;39;3517.00;194
8679;33;620749533;8679;500;10021;10216;4.57;0.28;356.55;12.33;1342;39;3518.00;195
8682;33;620749550;8682;507;10024;10219;4.52;0.28;356.64;12.32;1342;39;3519.00;195
8684;33;620749569;8684;512;10024;10219;4.52;0.28;356.64;12.32;1340;39;3520.00;195
8687;33;620749583;8687;511;10026;10220;4.50;0.27;356.76;12.38;1339;39;3521.00;194
8692;33;620749599;8692;515;10026;10220;4.44;0.27;356.86;12.38;1334;39;3522.00;194
8694;33;620749615;8694;516;10026;10220;4.39;0.27;357.00;12.38;1332;39;3523.00;194
8695;33;620749630;8695;516;10026;10220;4.38;0.27;357.06;12.38;1331;39;3524.00;194
8697;33;620749646;8697;521;10026;10220;4.34;0.26;357.18;12.38;1329;39;3525.00;194
8699;33;620749661;8699;525;10026;10220;4.32;0.26;357.21;12.38;1327;39;3526.00;194
8701;33;620749676;8701;536;10026;10220;4.33;0.26;357.18;12.38;1325;39;3527.00;194
8704;33;620749693;8704;539;10061;10290;4.56;0.28;357.25;12.34;1357;39;3528.00;229
8705;33;620749713;8705;542;10063;10291;4.60;0.28;357.29;12.34;1358;39;3529.00;228
8706;33;620749729;8706;543;10072;10291;4.65;0.29;357.26;12.33;1366;39;3530.00;219
8709;33;620749745;8709;542;10073;10291;4.63;0.28;357.34;12.33;1364;39;3531.00;218
8715;33;620749761;8715;554;10078;10291;4.60;0.28;357.27;12.32;1363;39;3532.00;213
8717;33;620749776;8717;563;10078;10291;4.56;0.28;357.22;12.32;1361;39;3533.00;213
8720;33;620749792;8720;569;10081;10291;4.55;0.28;357.28;12.32;1361;39;3534.00;210
8720;33;620749808;8720;573;10086;10291;4.58;0.28;357.28;12.32;1366;39;3535.00;205
8723;33;620749823;8723;576;10089;10292;4.53;0.28;357.22;12.32;1366;39;3536.00;203
8723;33;620749844;8723;578;10092;10293;4.52;0.28;357.22;12.32;1369;39;3537.00;201
8725;33;620749860;8725;585;10094;10293;4.46;0.27;357.15;12.32;1369;39;3538.00;199
8726;33;620749875;8726;587;10097;10297;4.42;0.27;357.19;12.31;1371;39;3539.00;200
8727;33;620749892;8727;587;10097;10297;4.37;0.27;357.17;12.31;1370;39;3540.00;200
8727;33;620749907;8727;586;10097;10297;4.35;0.27;357.17;12.31;1370;39;3541.00;200
8728;33;620749921;8728;592;10097;10297;4.29;0.26;357.15;12.31;1369;39;3542.00;200
8731;33;620749936;8731;599;10102;10303;4.26;0.26;357.16;12.31;1371;39;3543.00;201
8732;33;620749952;8732;593;10102;10303;4.19;0.26;357.14;12.31;1370;39;3544.00;201
8735;33;620749970;8735;608;10102;10303;4.12;0.25;357.07;12.31;1367;39;3545.00;201
8736;33;620749983;8736;609;10104;10306;4.09;0.25;357.06;12.30;1368;39;3546.00;202
8736;33;620749998;8736;617;10104;10306;4.04;0.25;357.06;12.30;1368;39;3547.00;202
8738;33;620750012;8738;619;10104;10306;3.97;0.24;357.00;12.30;1366;39;3548.00;202
8740;33;620750025;8740;618;10104;10307;3.91;0.24;356.94;12.30;1364;39;3549.00;203
8740;33;620750040;8740;617;10105;10308;3.88;0.24;356.94;12.30;1365;39;3550.00;203
8743;33;620750054;8743;618;10105;10308;3.85;0.24;356.85;12.30;1362;39;3551.00;203
8744;33;620750068;8744;626;10114;10321;3.82;0.23;356.88;12.29;1370;39;3552.00;207
8747;33;620750083;8747;628;10114;10321;3.80;0.23;356.79;12.29;1367;39;3553.00;207
8747;33;620750098;8747;624;10115;10321;3.80;0.23;356.79;12.29;1368;39;3554.00;206
8751;33;620750112;8751;630;10117;10323;3.74;0.23;356.69;12.29;1366;39;3555.00;206
8752;33;620750126;8752;632;10117;10323;3.75;0.23;356.65;12.29;1365;39;3556.00;206
8753;33;620750140;8753;627;10120;10327;3.76;0.23;356.63;12.29;1367;39;3557.00;207
8755;33;620750154;8755;632;10120;10327;3.76;0.23;356.67;12.29;1365;39;3558.00;207
8757;33;620750167;8757;631;10123;10331;3.78;0.23;356.70;12.28;1366;39;3559.00;208
8759;33;620750182;8759;632;10123;10331;3.75;0.23;356.64;12.28;1364;39;3560.00;208
8761;33;620750196;8761;630;10123;10331;3.69;0.22;356.64;12.28;1362;39;3561.00;208
8763;33;620750209;8763;627;10123;10331;3.63;0.22;356.69;12.28;1360;39;3562.00;208
8764;33;620750222;8764;622;10123;10331;3.61;0.22;356.68;12.28;1359;39;3563.00;208
8767;33;620750235;8767;606;10133;10343;3.62;0.22;356.62;12.27;1366;39;3564.00;210
8769;33;620750252;8769;599;10133;10343;3.59;0.22;356.59;12.27;1364;39;3565.00;210
8771;33;620750266;8771;600;10133;10343;3.58;0.22;356.58;12.27;1362;39;3566.00;210
8772;33;620750280;8772;594;10133;10343;3.57;0.22;356.61;12.27;1361;39;3567.00;210
8773;33;620750293;8773;598;10133;10343;3.53;0.22;356.61;12.27;1360;39;3568.00;210
8775;33;620750307;8775;593;10133;10343;3.54;0.22;356.64;12.27;1358;39;3569.00;210
8776;33;620750321;8776;577;10133;10344;3.56;0.22;356.66;12.27;1357;39;3570.00;211
8778;33;620750336;8778;575;10133;10344;3.60;0.22;356.71;12.27;1355;39;3571.00;211
8782;33;620750349;8782;576;10137;10350;3.61;0.22;356.70;12.27;1355;39;3572.00;213
8785;33;620750370;8785;565;10137;10351;3.62;0.22;356.69;12.27;1352;39;3573.00;214
8788;33;620750384;8788;576;10137;10351;3.61;0.22;356.64;12.27;1349;39;3574.00;214
8791;33;620750399;8791;566;10137;10351;3.61;0.22;356.65;12.27;1346;39;3575.00;214
8793;34;620750416;8793;564;10139;10355;3.67;0.22;356.75;12.26;1346;40;3576.00;216
8794;34;620750438;8794;555;10140;10355;3.74;0.23;356.74;12.26;1346;40;3577.00;215
8796;34;620750452;8796;542;10140;10355;3.76;0.23;356.71;12.26;1344;40;3578.00;215
8797;34;620750468;8797;531;10142;10356;3.81;0.23;356.70;12.26;1345;40;3579.00;214
8799;34;620750488;8799;529;10145;10360;3.83;0.23;356.67;12.26;1346;40;3580.00;215
8803;34;620750501;8803;526;10145;10360;3.82;0.23;356.64;12.26;1342;40;3581.00;215
8805;34;620750517;8805;520;10146;10363;3.84;0.23;356.63;12.26;1341;40;3582.00;217
8809;34;620750535;8809;518;10146;10363;3.84;0.23;356.59;12.26;1337;40;3583.00;217
8812;34;620750562;8812;516;10147;10363;3.85;0.23;356.64;12.32;1335;40;3584.00;216
8815;34;620750576;8815;515;10147;10363;3.90;0.24;356.61;12.32;1332;40;3585.00;216
8818;34;620750590;8818;507;10150;10367;3.94;0.24;356.62;12.32;1332;40;3586.00;217
8820;34;620750605;8820;508;10150;10367;4.00;0.24;356.66;12.32;1330;40;3587.00;217
8822;34;620750619;8822;491;10150;10367;4.05;0.25;356.76;12.32;1328;40;3588.00;217
8827;34;620750633;8827;485;10150;10367;4.06;0.25;356.72;12.32;1323;40;3589.00;217
8830;34;620750648;8830;482;10150;10368;4.08;0.25;356.69;12.32;1320;40;3590.00;218
8834;34;620750663;8834;472;10150;10369;4.09;0.25;356.81;12.32;1316;40;3591.00;219
8836;34;620750677;8836;470;10150;10369;4.15;0.25;356.85;12.32;1314;40;3592.00;219
8839;34;620750692;8839;470;10151;10370;4.18;0.25;356.89;12.32;1312;40;3593.00;219
8842;34;620750706;8842;466;10151;10370;4.22;0.26;356.94;12.32;1309;40;3594.00;219
8846;34;620750720;8846;468;10151;10370;4.25;0.26;356.90;12.32;1305;40;3595.00;219
8847;34;620750735;8847;470;10151;10370;4.26;0.26;356.91;12.32;1304;40;3596.00;219
8852;34;620750749;8852;468;10151;10370;4.24;0.26;356.97;12.32;1299;40;3597.00;219
8856;34;620750763;8856;464;10151;10370;4.28;0.26;357.04;12.32;1295;40;3598.00;219
8861;34;620750777;8861;469;10152;10370;4.31;0.26;357.13;12.32;1291;40;3599.00;218
8863;34;620750794;8863;504;10267;10623;4.69;0.29;357.16;12.18;1404;40;3600.00;356
8867;34;620750831;8867;494;10276;10624;4.75;0.30;357.36;12.18;1409;40;3601.00;348
8869;34;620750847;8869;485;10286;10624;4.82;0.30;357.38;12.17;1417;40;3602.00;338
8871;34;620750862;8871;484;10296;10624;4.90;0.31;357.54;12.16;1425;40;3603.00;328
8874;34;620750878;8874;480;10302;10624;4.94;0.31;357.59;12.16;1428;40;3604.00;322
8877;34;620750898;8877;469;10306;10624;4.94;0.31;357.59;12.16;1429;40;3605.00;318
8879;34;620750914;8879;472;10310;10624;4.94;0.31;357.58;12.16;1431;40;3606.00;314
8883;34;620750930;8883;466;10313;10624;4.91;0.30;357.58;12.16;1430;40;3607.00;311
8888;34;620750945;8888;466;10318;10625;4.86;0.30;357.70;12.16;1430;40;3608.00;307
8892;34;620750961;8892;464;10319;10626;4.83;0.30;357.82;12.16;1427;40;3609.00;307
8894;34;620750977;8894;465;10324;10626;4.77;0.30;357.94;12.16;1430;40;3610.00;302
8898;34;620750991;8898;473;10328;10627;4.66;0.29;358.05;12.16;1430;40;3611.00;299
8900;34;620751006;8900;487;10332;10627;4.60;0.29;358.03;12.16;1432;40;3612.00;295
8904;34;620751022;8904;488;10336;10627;4.51;0.28;358.18;12.23;1432;40;3613.00;291
8907;34;620751037;8907;484;10338;10627;4.47;0.28;358.36;12.23;1431;40;3614.00;289
8909;34;620751053;8909;494;10342;10631;4.43;0.28;358.36;12.23;1433;40;3615.00;289
8912;34;620751069;8912;506;10342;10631;4.38;0.27;358.38;12.23;1430;40;3616.00;289
8917;34;620751084;8917;501;10344;10631;4.35;0.27;358.47;12.23;1427;40;3617.00;287
8919;34;620751099;8919;511;10346;10634;4.31;0.27;358.47;12.23;1427;40;3618.00;288
8922;34;620751115;8922;508;10348;10634;4.36;0.27;358.60;12.23;1426;40;3619.00;286
8926;34;620751130;8926;506;10349;10634;4.39;0.27;358.71;12.24;1423;40;3620.00;285
8928;34;620751146;8928;506;10353;10638;4.42;0.27;358.71;12.23;1425;40;3621.00;285
8931;34;620751163;8931;502;10355;10639;4.41;0.27;358.86;12.24;1424;40;3622.00;284
8935;34;620751180;8935;500;10357;10639;4.43;0.27;358.88;12.24;1422;40;3623.00;282
8937;34;620751202;8937;497;10357;10643;4.43;0.27;358.90;12.24;1420;40;3624.00;286
8940;34;620751218;8940;504;10360;10643;4.39;0.27;359.02;12.24;1420;40;3625.00;283
8943;34;620751233;8943;493;10362;10643;4.40;0.27;359.00;12.24;1419;40;3626.00;281
8944;34;620751249;8944;486;10365;10644;4.45;0.27;359.03;12.25;1421;40;3627.00;279
8947;34;620751265;8947;485;10366;10644;4.45;0.27;359.19;12.25;1419;40;3628.00;278
8950;34;620751280;8950;482;10370;10650;4.46;0.27;359.39;12.32;1420;40;3629.00;280
8953;34;620751299;8953;482;10374;10650;4.52;0.27;359.53;12.32;1421;40;3630.00;276
8956;34;620751322;8956;478;10375;10651;4.52;0.28;359.68;12.32;1419;40;3631.00;276
8959;34;620751341;8959;468;10377;10651;4.57;0.28;359.85;12.33;1418;40;3632.00;274
8963;34;620751358;8963;482;10379;10651;4.60;0.28;359.93;12.33;1416;40;3633.00;272
8967;34;620751376;8967;481;10380;10651;4.63;0.28;360.01;12.33;1413;40;3634.00;271
8968;34;620751394;8968;490;10382;10651;4.66;0.28;360.10;12.33;1414;40;3635.00;269
8969;34;620751412;8969;505;10388;10663;4.71;0.29;360.16;12.40;1419;40;3636.00;275
8971;34;620751438;8971;500;10390;10663;4.68;0.29;360.21;12.40;1419;40;3637.00;273
8972;34;620751464;8972;505;10391;10663;4.65;0.28;360.31;12.40;1419;40;3638.00;272
8975;34;620751490;8975;488;10394;10663;4.64;0.28;360.44;12.40;1419;40;3639.00;269
8977;34;620751516;8977;488;10394;10663;4.70;0.29;360.46;12.40;1417;40;3640.00;269
8981;34;620751537;8981;496;10397;10663;4.73;0.29;360.44;12.41;1416;40;3641.00;266
8983;34;620751556;8983;500;10402;10667;4.74;0.29;360.46;12.41;1419;40;3642.00;265
8986;34;620751574;8986;500;10404;10667;4.79;0.29;360.50;12.41;1418;40;3643.00;263
8988;34;620751591;8988;506;10409;10671;4.84;0.30;360.57;12.41;1421;40;3644.00;262
8991;34;620751609;8991;501;10414;10673;4.85;0.30;360.69;12.48;1423;40;3645.00;259
8995;34;620751627;8995;509;10416;10673;4.85;0.30;360.88;12.48;1421;40;3646.00;257
8996;34;620751644;8996;507;10417;10673;4.87;0.30;360.90;12.48;1421;40;3647.00;256
8998;34;620751661;8998;510;10424;10686;4.87;0.30;360.97;12.47;1426;40;3648.00;262
9000;34;620751678;9000;502;10427;10686;4.87;0.30;361.10;12.54;1427;40;3649.00;259
9001;34;620751695;9001;501;10427;10686;4.94;0.30;361.09;12.54;1426;40;3650.00;259
9004;34;620751712;9004;502;10429;10687;5.03;0.31;361.32;12.54;1425;40;3651.00;258
9006;34;620751729;9006;508;10429;10688;5.07;0.31;361.32;12.54;1423;40;3652.00;259
9008;34;620751746;9008;497;10429;10688;5.08;0.31;361.39;12.54;1421;40;3653.00;259
9010;34;620751763;9010;498;10431;10691;5.08;0.31;361.40;12.54;1421;40;3654.00;260
9011;34;620751781;9011;499;10431;10691;5.03;0.31;361.43;12.54;1420;40;3655.00;260
9013;34;620751798;9013;499;10432;10691;4.97;0.30;361.48;12.54;1419;40;3656.00;259
9014;34;620751817;9014;502;10432;10691;4.89;0.30;361.52;12.54;1418;40;3657.00;259
9019;34;620751834;9019;498;10437;10697;4.85;0.30;361.53;12.53;1418;40;3658.00;260
9022;34;620751852;9022;512;10437;10697;4.77;0.29;361.61;12.53;1415;40;3659.00;260
9024;34;620751870;9024;515;10437;10697;4.74;0.29;361.69;12.53;1413;40;3660.00;260
9027;34;620751887;9027;516;10440;10697;4.70;0.29;361.70;12.73;1413;41;3661.00;257
9030;34;620751916;9030;507;10443;10701;4.67;0.28;361.76;12.79;1413;41;3662.00;258
9034;34;620751933;9034;503;10445;10702;4.67;0.28;361.92;12.79;1411;41;3663.00;257
9036;34;620751951;9036;498;10445;10702;4.68;0.28;361.93;12.79;1409;41;3664.00;257
9037;34;620751968;9037;499;10446;10703;4.70;0.29;361.98;12.79;1409;41;3665.00;257
9039;34;620751985;9039;498;10446;10703;4.72;0.29;361.98;12.79;1407;41;3666.00;257
9042;34;620752001;9042;501;10446;10703;4.71;0.29;361.92;12.79;1404;41;3667.00;257
9045;34;620752017;9045;504;10446;10703;4.71;0.29;361.99;12.79;1401;42;3668.00;257
9047;34;620752038;9047;501;10446;10703;4.69;0.29;362.07;12.79;1399;42;3669.00;257
9050;34;620752055;9050;493;10447;10703;4.65;0.28;362.11;12.80;1397;42;3670.00;256
9054;34;620752071;9054;503;10447;10703;4.59;0.28;362.16;12.80;1393;42;3671.00;256
9059;34;620752086;9059;503;10478;10773;4.61;0.28;362.17;12.76;1419;42;3672.00;295
9063;34;620752109;9063;501;10480;10774;4.58;0.28;362.15;12.82;1417;42;3673.00;294
9066;34;620752125;9066;509;10486;10774;4.60;0.28;362.21;12.81;1420;42;3674.00;288
9068;34;620752141;9068;498;10493;10774;4.61;0.28;362.28;12.81;1425;42;3675.00;281
9069;34;620752158;9069;505;10496;10774;4.64;0.28;362.35;12.81;1427;42;3676.00;278
9072;34;620752174;9072;509;10499;10774;4.68;0.29;362.38;12.81;1427;42;3677.00;275
9077;34;620752190;9077;506;10501;10774;4.70;0.29;362.51;12.81;1424;42;3678.00;273
9080;34;620752207;9080;505;10503;10774;4.68;0.29;362.52;12.81;1423;42;3679.00;271
9080;34;620752229;9080;512;10505;10775;4.70;0.29;362.52;12.80;1425;42;3680.00;270
9081;34;620752245;9081;514;10507;10776;4.69;0.29;362.52;12.80;1426;42;3681.00;269
9083;34;620752261;9083;512;10509;10776;4.67;0.29;362.58;12.80;1426;42;3682.00;267
9085;34;620752278;9085;513;10513;10780;4.69;0.29;362.57;12.80;1428;43;3683.00;267
9089;34;620752304;9089;516;10514;10780;4.64;0.28;362.48;12.80;1425;43;3684.00;266
9090;34;620752321;9090;516;10514;10780;4.61;0.28;362.46;12.80;1424;43;3685.00;266
9093;34;620752336;9093;513;10514;10780;4.54;0.28;362.52;12.80;1421;43;3686.00;266
9094;34;620752355;9094;532;10519;10786;4.52;0.28;362.49;12.80;1425;43;3687.00;267
9097;34;620752371;9097;545;10519;10786;4.47;0.27;362.48;12.80;1422;43;3688.00;267
9098;34;620752387;9098;548;10519;10786;4.46;0.27;362.45;12.80;1421;43;3689.00;267
9101;34;620752404;9101;554;10524;10792;4.50;0.28;362.42;12.80;1423;43;3690.00;268
9107;34;620752425;9107;560;10524;10792;4.44;0.27;362.43;12.80;1417;43;3691.00;268
9108;34;620752445;9108;564;10528;10792;4.43;0.27;362.47;12.81;1420;43;3692.00;264
9109;34;620752460;9109;573;10529;10793;4.40;0.27;362.43;12.81;1420;43;3693.00;264
9113;34;620752477;9113;574;10532;10794;4.37;0.27;362.38;12.82;1419;43;3694.00;262
9114;34;620752492;9114;580;10533;10794;4.38;0.27;362.42;12.82;1419;43;3695.00;261
9115;34;620752507;9115;595;10543;10807;4.39;0.27;362.46;12.82;1428;43;3696.00;264
9117;34;620752523;9117;598;10544;10807;4.37;0.27;362.42;12.82;1427;43;3697.00;263
9118;34;620752539;9118;602;10545;10807;4.35;0.27;362.39;12.82;1427;43;3698.00;262
9123;34;620752554;9123;603;10546;10808;4.29;0.26;362.38;12.82;1423;43;3699.00;262
9125;34;620752572;9125;607;10547;10808;4.26;0.26;362.31;12.83;1422;43;3700.00;261
9128;34;620752590;9128;611;10552;10812;4.26;0.26;362.29;12.83;1424;43;3701.00;260
9130;34;620752606;9130;609;10552;10812;4.19;0.26;362.22;12.83;1422;43;3702.00;260
9132;34;620752626;9132;617;10556;10816;4.14;0.25;362.30;12.84;1424;43;3703.00;260
9133;34;620752641;9133;624;10556;10816;4.11;0.25;362.26;12.84;1423;43;3704.00;260
9135;34;620752655;9135;624;10556;10816;4.05;0.25;362.27;12.84;1421;43;3705.00;260
9138;34;620752669;9138;632;10556;10816;4.04;0.25;362.29;12.84;1418;43;3706.00;260
9141;34;620752684;9141;632;10556;10816;4.05;0.25;362.29;12.84;1415;43;3707.00;260
9143;34;620752698;9143;645;10568;10828;4.05;0.25;362.30;12.91;1425;43;3708.00;260
9145;34;620752713;9145;643;10568;10828;4.04;0.25;362.32;12.91;1423;43;3709.00;260
9148;34;620752728;9148;652;10569;10828;4.03;0.25;362.28;12.91;1421;43;3710.00;259
9150;34;620752742;9150;658;10569;10828;3.99;0.24;362.32;12.91;1419;43;3711.00;259
9150;34;620752756;9150;666;10569;10828;3.98;0.24;362.32;12.91;1419;43;3712.00;259
9152;34;620752770;9152;672;10569;10828;3.92;0.24;362.30;12.91;1417;43;3713.00;259
9154;34;620752784;9154;681;10571;10829;3.90;0.24;362.30;12.92;1417;43;3714.00;258
9156;34;620752798;9156;680;10571;10829;3.86;0.24;362.34;12.92;1415;43;3715.00;258
9156;34;620752817;9156;674;10577;10835;3.90;0.24;362.34;12.92;1421;43;3716.00;258
9156;34;620752837;9156;676;10580;10836;3.90;0.24;362.34;12.92;1424;43;3717.00;256
9157;34;620752851;9157;681;10580;10836;3.93;0.24;362.33;12.92;1423;43;3718.00;256
9158;34;620752865;9158;671;10581;10836;3.93;0.24;362.31;12.93;1423;43;3719.00;255
9159;34;620752881;9159;659;10585;10841;3.95;0.24;362.27;12.92;1426;43;3720.00;256
9159;34;620752895;9159;653;10585;10841;3.96;0.24;362.27;12.92;1426;43;3721.00;256
9160;34;620752914;9160;650;10586;10841;3.92;0.24;362.24;12.92;1426;43;3722.00;255
9161;34;620752928;9161;641;10587;10842;3.92;0.24;362.25;12.92;1426;43;3723.00;255
9164;34;620752946;9164;634;10590;10846;3.95;0.24;362.21;12.92;1426;43;3724.00;256
9164;34;620752961;9164;628;10590;10846;4.02;0.25;362.21;12.92;1426;43;3725.00;256
9164;34;620752975;9164;618;10592;10849;4.08;0.25;362.21;12.92;1428;43;3726.00;257
9167;34;620752990;9167;618;10592;10849;4.12;0.25;362.22;12.92;1425;43;3727.00;257
9168;34;620753004;9168;617;10593;10849;4.17;0.25;362.20;12.91;1425;43;3728.00;256
9171;34;620753018;9171;618;10593;10849;4.17;0.25;362.12;12.91;1422;43;3729.00;256
9171;34;620753031;9171;614;10597;10853;4.20;0.26;362.12;12.91;1426;43;3730.00;256
9173;34;620753051;9173;623;10597;10853;4.18;0.25;362.13;12.91;1424;43;3731.00;256
9177;34;620753064;9177;624;10597;10853;4.14;0.25;362.11;12.91;1420;43;3732.00;256
9178;34;620753078;9178;620;10597;10853;4.09;0.25;362.10;12.91;1419;43;3733.00;256
9180;34;620753092;9180;610;10597;10854;4.06;0.25;362.08;12.91;1417;43;3734.00;257
9184;34;620753106;9184;616;10599;10856;4.02;0.24;362.03;12.91;1415;43;3735.00;257
9187;34;620753120;9187;616;10599;10856;3.98;0.24;362.12;12.91;1412;43;3736.00;257
9189;34;620753133;9189;613;10600;10857;3.96;0.24;362.08;12.91;1411;43;3737.00;257
9192;34;620753147;9192;608;10600;10857;3.95;0.24;362.12;12.91;1408;43;3738.00;257
9194;34;620753160;9194;608;10600;10857;3.93;0.24;362.10;12.91;1406;43;3739.00;257
9195;34;620753173;9195;593;10600;10857;3.97;0.24;362.09;12.91;1405;43;3740.00;257
9198;34;620753187;9198;594;10600;10857;4.00;0.24;362.05;12.91;1402;43;3741.00;257
9201;34;620753201;9201;593;10600;10857;4.02;0.24;362.18;12.91;1399;43;3742.00;257
9203;34;620753214;9203;586;10600;10857;4.04;0.25;362.13;12.91;1397;43;3743.00;257
9206;34;620753228;9206;612;10678;10984;4.31;0.27;362.07;12.81;1472;43;3744.00;306
9211;34;620753252;9211;596;10682;10985;4.33;0.27;362.18;12.81;1471;43;3745.00;303
9214;34;620753267;9214;583;10688;10985;4.39;0.27;362.15;12.80;1474;43;3746.00;297
9218;34;620753287;9218;575;10690;10985;4.42;0.27;362.28;12.80;1472;43;3747.00;295
9221;34;620753301;9221;562;10693;10985;4.46;0.28;362.41;12.80;1472;43;3748.00;292
9222;34;620753316;9222;559;10694;10985;4.47;0.28;362.45;12.80;1472;43;3749.00;291
9227;34;620753331;9227;549;10696;10990;4.41;0.27;362.63;12.79;1469;43;3750.00;294
9231;34;620753347;9231;551;10697;10990;4.42;0.27;362.66;12.79;1466;43;3751.00;293
9234;34;620753363;9234;557;10697;10991;4.43;0.27;362.74;12.79;1463;43;3752.00;294
9238;34;620753397;9238;561;10698;10992;4.47;0.28;363.03;12.79;1460;43;3753.00;294
9243;34;620753413;9243;564;10699;10992;4.52;0.28;363.13;12.79;1456;43;3754.00;293
9249;34;620753436;9249;565;10700;10993;4.54;0.28;363.26;12.79;1451;43;3755.00;293
9255;34;620753461;9255;557;10701;10993;4.55;0.28;363.24;12.79;1446;43;3756.00;292
9259;34;620753490;9259;549;10701;10993;4.58;0.28;363.34;12.79;1442;43;3757.00;292
9266;34;620753512;9266;544;10701;10993;4.57;0.28;363.37;12.79;1435;43;3758.00;292
9271;34;620753533;9271;534;10703;10997;4.60;0.28;363.46;12.79;1432;43;3759.00;294
9276;34;620753551;9276;518;10703;10997;4.66;0.29;363.45;12.79;1427;43;3760.00;294
9280;34;620753568;9280;508;10703;10997;4.68;0.29;363.69;12.79;1423;43;3761.00;294
9286;34;620753587;9286;496;10703;11000;4.66;0.29;363.70;12.79;1417;43;3762.00;297
9291;34;620753604;9291;495;10703;11000;4.67;0.29;363.76;12.79;1412;43;3763.00;297
9293;34;620753621;9293;490;10703;11000;4.64;0.28;363.78;12.79;1410;43;3764.00;297
9299;34;620753638;9299;477;10706;11004;4.62;0.28;363.81;12.79;1407;43;3765.00;298
9303;34;620753654;9303;478;10707;11005;4.59;0.28;363.90;12.79;1404;43;3766.00;298
9306;34;620753671;9306;472;10708;11005;4.57;0.28;363.84;12.79;1402;43;3767.00;297
9310;34;620753687;9310;478;10710;11009;4.58;0.28;363.83;12.79;1400;43;3768.00;299
9313;34;620753703;9313;473;10710;11009;4.55;0.28;363.92;12.79;1397;43;3769.00;299
9318;34;620753720;9318;474;10711;11009;4.51;0.27;364.01;12.79;1393;43;3770.00;298
9319;34;620753736;9319;472;10711;11010;4.54;0.28;364.02;12.79;1392;43;3771.00;299
9326;34;620753750;9326;472;10712;11010;4.49;0.27;364.08;12.79;1386;43;3772.00;298
9328;34;620753767;9328;471;10715;11016;4.50;0.27;364.14;12.79;1387;43;3773.00;301
9331;34;620753782;9331;475;10717;11016;4.51;0.27;364.25;12.79;1386;43;3774.00;299
9334;34;620753799;9334;476;10717;11017;4.50;0.27;364.23;12.79;1383;43;3775.00;300
9338;34;620753815;9338;470;10720;11017;4.50;0.27;364.26;12.79;1382;43;3776.00;297
9342;34;620753829;9342;481;10721;11017;4.50;0.27;364.27;12.80;1379;43;3777.00;296
9344;34;620753850;9344;480;10721;11017;4.55;0.28;364.30;12.80;1377;43;3778.00;296
9345;34;620753865;9345;481;10724;11017;4.57;0.28;364.31;12.87;1379;43;3779.00;293
9347;34;620753882;9347;483;10746;11053;4.66;0.28;364.38;12.85;1399;43;3780.00;307
9349;34;620753900;9349;486;10747;11053;4.63;0.28;364.41;12.84;1398;43;3781.00;306
9350;34;620753916;9350;497;10750;11053;4.63;0.28;364.44;12.85;1400;43;3782.00;303
9354;34;620753938;9354;506;10752;11053;4.62;0.28;364.47;12.85;1398;43;3783.00;301
9359;34;620753953;9359;508;10754;11053;4.57;0.28;364.51;12.85;1395;43;3784.00;299
9360;34;620753970;9360;512;10754;11053;4.56;0.28;364.51;12.85;1394;43;3785.00;299
9362;34;620753987;9362;519;10761;11057;4.52;0.28;364.59;12.85;1399;43;3786.00;296
9364;34;620754009;9364;512;10761;11057;4.50;0.27;364.65;12.85;1397;43;3787.00;296
9367;34;620754035;9367;511;10765;11061;4.42;0.27;364.63;12.85;1398;43;3788.00;296
9368;34;620754069;9368;517;10767;11062;4.39;0.27;364.65;12.85;1399;43;3789.00;295
9371;34;620754098;9371;515;10769;11062;4.41;0.27;364.83;12.85;1398;43;3790.00;293
9372;34;620754123;9372;513;10771;11062;4.44;0.27;364.87;12.85;1399;43;3791.00;291
9375;34;620754150;9375;518;10778;11075;4.51;0.28;364.96;12.85;1403;43;3792.00;297
9379;34;620754184;9379;522;10779;11075;4.52;0.28;365.19;12.85;1400;43;3793.00;296
9383;34;620754215;9383;528;10782;11075;4.46;0.27;365.23;12.85;1399;43;3794.00;293
9384;34;620754252;9384;532;10784;11076;4.45;0.27;365.22;12.86;1400;43;3795.00;292
9388;34;620754309;9388;530;10785;11077;4.42;0.27;365.25;12.86;1397;43;3796.00;292
9390;34;620754349;9390;527;10785;11077;4.39;0.27;365.37;12.86;1395;43;3797.00;292
9392;34;620754401;9392;524;10787;11080;4.41;0.27;365.38;12.86;1395;43;3798.00;293
9395;34;620754441;9395;523;10790;11080;4.41;0.27;365.48;12.86;1395;43;3799.00;290
9398;34;620754481;9398;521;10790;11080;4.41;0.27;365.50;12.86;1392;43;3800.00;290
9403;34;620754551;9403;528;10791;11080;4.38;0.27;365.61;12.86;1388;43;3801.00;289
9403;34;620754589;9403;520;10795;11086;4.46;0.27;365.61;12.86;1392;43;3802.00;291
9408;34;620754627;9408;524;10796;11086;4.41;0.27;365.82;12.86;1388;43;3803.00;290
9410;34;620754663;9410;529;10798;11086;4.38;0.27;365.83;12.86;1388;43;3804.00;288
9411;34;620754699;9411;536;10799;11086;4.41;0.27;365.93;12.86;1388;43;3805.00;287
9414;34;620754749;9414;550;10803;11090;4.37;0.27;366.00;12.86;1389;43;3806.00;287
9415;34;620754787;9415;544;10805;11091;4.35;0.27;366.10;12.93;1390;44;3807.00;286
9419;34;620754853;9419;548;10806;11091;4.33;0.26;366.21;12.93;1387;44;3808.00;285
9420;34;620754889;9420;550;10808;11092;4.37;0.27;366.22;12.94;1388;44;3809.00;284
9422;34;620754931;9422;553;10809;11092;4.35;0.27;366.26;12.94;1387;44;3810.00;283
9426;34;620754979;9426;550;10809;11092;4.37;0.27;366.25;12.94;1383;44;3811.00;283
9429;34;620755016;9429;539;10811;11092;4.42;0.27;366.21;13.00;1382;44;3812.00;281
9431;34;620755054;9431;528;10811;11092;4.47;0.27;366.25;13.00;1380;44;3813.00;281
9436;34;620755090;9436;519;10812;11092;4.48;0.27;366.45;13.00;1376;44;3814.00;280
9437;34;620755126;9437;517;10812;11092;4.51;0.27;366.49;13.00;1375;44;3815.00;280
9439;34;620755163;9439;528;10846;11162;4.53;0.28;366.56;12.96;1407;44;3816.00;316
9440;34;620755214;9440;521;10848;11163;4.58;0.28;366.61;12.96;1408;44;3817.00;315
9442;34;620755238;9442;508;10853;11163;4.65;0.28;366.62;12.95;1411;44;3818.00;310
9446;34;620755258;9446;514;10856;11163;4.64;0.28;366.77;12.95;1410;44;3819.00;307
9449;34;620755279;9449;517;10858;11163;4.68;0.29;366.98;12.95;1409;44;3820.00;305
9451;34;620755299;9451;524;10862;11163;4.73;0.29;367.07;12.95;1411;44;3821.00;301
9452;34;620755319;9452;532;10865;11163;4.75;0.29;367.05;12.95;1413;44;3822.00;298
9453;34;620755339;9453;533;10869;11163;4.76;0.29;367.03;12.94;1416;44;3823.00;294
9456;34;620755359;9456;541;10871;11164;4.72;0.29;367.09;12.94;1415;44;3824.00;293
9458;34;620755379;9458;539;10874;11166;4.69;0.29;367.07;13.01;1416;44;3825.00;292
9460;34;620755400;9460;545;10876;11166;4.67;0.28;367.10;13.01;1416;44;3826.00;290
9461;34;620755419;9461;542;10881;11170;4.62;0.28;367.16;13.01;1420;44;3827.00;289
9466;34;620755442;9466;548;10884;11170;4.51;0.27;367.34;13.07;1418;44;3828.00;286
9467;34;620755467;9467;556;10885;11170;4.46;0.27;367.37;13.07;1418;44;3829.00;285
9470;34;620755491;9470;556;10885;11170;4.44;0.27;367.49;13.07;1415;44;3830.00;285
9473;34;620755516;9473;562;10889;11176;4.43;0.27;367.59;13.07;1416;44;3831.00;287
9475;34;620755551;9475;563;10890;11176;4.46;0.27;367.60;13.13;1415;44;3832.00;286
9477;34;620755577;9477;568;10890;11176;4.49;0.27;367.59;13.13;1413;44;3833.00;286
9478;34;620755600;9478;565;10892;11179;4.52;0.28;367.61;13.13;1414;44;3834.00;287
9480;34;620755627;9480;562;10892;11179;4.50;0.28;367.58;13.13;1412;44;3835.00;287
9481;34;620755650;9481;563;10893;11179;4.51;0.28;367.62;13.13;1412;44;3836.00;286
9483;34;620755673;9483;563;10893;11180;4.46;0.27;367.61;13.13;1410;44;3837.00;287
9486;34;620755693;9486;561;10894;11181;4.44;0.27;367.61;13.13;1408;44;3838.00;287
9488;34;620755721;9488;557;10894;11181;4.42;0.27;367.64;13.13;1406;44;3839.00;287
9490;34;620755749;9490;563;10910;11207;4.40;0.27;367.66;13.11;1420;44;3840.00;297
9496;34;620755777;9496;556;10910;11207;4.32;0.26;367.61;13.11;1414;44;3841.00;297
9500;34;620755799;9500;547;10913;11207;4.32;0.26;367.55;13.10;1413;44;3842.00;294
9507;34;620755821;9507;539;10915;11208;4.28;0.26;367.45;13.10;1408;44;3843.00;293
9511;34;620755844;9511;537;10915;11208;4.18;0.26;367.41;13.10;1404;44;3844.00;293
9513;34;620755872;9513;530;10920;11212;4.19;0.26;367.39;13.25;1407;44;3845.00;292
9515;35;620755902;9515;526;10922;11214;4.19;0.26;367.39;13.25;1407;45;3846.00;292
9516;35;620755941;9516;525;10925;11218;4.14;0.25;367.38;13.25;1409;45;3847.00;293
9523;35;620755967;9523;521;10925;11218;4.10;0.25;367.57;13.25;1402;45;3848.00;293
9524;35;620755990;9524;524;10925;11218;4.14;0.25;367.56;13.25;1401;45;3849.00;293
9527;35;620756013;9527;520;10925;11218;4.15;0.25;367.51;13.25;1398;45;3850.00;293
9528;35;620756036;9528;524;10925;11218;4.16;0.25;367.48;13.25;1397;45;3851.00;293
9531;35;620756056;9531;526;10935;11230;4.20;0.26;367.44;13.23;1404;45;3852.00;295
9535;35;620756080;9535;534;10936;11230;4.18;0.26;367.38;13.23;1401;45;3853.00;294
9538;35;620756105;9538;527;10936;11230;4.13;0.25;367.32;13.23;1398;45;3854.00;294
9539;35;620756138;9539;538;10936;11230;4.10;0.25;367.29;13.23;1397;45;3855.00;294
9542;35;620756158;9542;538;10936;11230;4.07;0.25;367.25;13.23;1394;45;3856.00;294
9546;35;620756180;9546;541;10937;11230;4.03;0.25;367.25;13.23;1391;45;3857.00;293
9547;35;620756203;9547;542;10937;11231;4.04;0.25;367.28;13.23;1390;45;3858.00;294
9548;35;620756226;9548;543;10937;11231;4.04;0.25;367.33;13.23;1389;45;3859.00;294
9551;35;620756247;9551;552;10943;11237;4.11;0.25;367.31;13.23;1392;45;3860.00;294
9553;35;620756270;9553;557;10945;11238;4.08;0.25;367.32;13.23;1392;45;3861.00;293
9555;35;620756293;9555;562;10945;11238;4.06;0.25;367.31;13.23;1390;45;3862.00;293
9557;35;620756316;9557;568;10946;11238;4.02;0.25;367.26;13.23;1389;45;3863.00;292
9559;35;620756337;9559;572;10948;11242;4.02;0.25;367.34;13.23;1389;45;3864.00;294
9561;35;620756359;9561;576;10950;11242;3.98;0.24;367.30;13.23;1389;45;3865.00;292
9562;35;620756379;9562;575;10950;11242;3.90;0.24;367.31;13.23;1388;45;3866.00;292
9565;35;620756401;9565;561;10951;11243;3.88;0.24;367.33;13.23;1386;45;3867.00;292
9568;35;620756425;9568;558;10954;11247;3.88;0.24;367.35;13.22;1386;45;3868.00;293
9571;35;620756448;9571;552;10954;11247;3.90;0.24;367.27;13.22;1383;45;3869.00;293
9571;35;620756474;9571;550;10958;11253;3.94;0.24;367.27;13.22;1387;45;3870.00;295
9574;35;620756495;9574;556;10960;11253;3.94;0.24;367.40;13.30;1386;45;3871.00;293
9575;35;620756516;9575;563;10961;11253;3.99;0.24;367.43;13.30;1386;45;3872.00;292
9577;35;620756536;9577;565;10962;11253;3.99;0.24;367.46;13.38;1385;45;3873.00;291
9577;35;620756557;9577;563;10966;11257;4.05;0.25;367.46;13.37;1389;45;3874.00;291
9578;35;620756577;9578;574;10966;11257;4.09;0.25;367.45;13.37;1388;45;3875.00;291
9579;35;620756603;9579;575;10967;11257;4.08;0.25;367.48;13.46;1388;45;3876.00;290
9580;35;620756624;9580;574;10967;11257;4.09;0.25;367.53;13.46;1387;45;3877.00;290
9580;35;620756644;9580;574;10968;11258;4.09;0.25;367.53;13.54;1388;45;3878.00;290
9582;35;620756671;9582;579;10969;11259;4.08;0.25;367.53;13.54;1387;45;3879.00;290
9582;35;620756693;9582;575;10969;11259;4.07;0.25;367.53;13.54;1387;45;3880.00;290
9582;35;620756713;9582;574;10972;11260;4.09;0.25;367.53;13.70;1390;45;3881.00;288
9583;35;620756733;9583;574;10972;11260;4.09;0.25;367.55;13.70;1389;45;3882.00;288
9583;35;620756750;9583;581;10972;11260;4.12;0.25;367.55;13.70;1389;45;3883.00;288
9583;35;620756766;9583;587;10974;11260;4.11;0.25;367.55;13.85;1391;45;3884.00;286
9583;35;620756783;9583;586;10974;11260;4.10;0.25;367.55;13.85;1391;45;3885.00;286
9585;35;620756799;9585;586;10974;11260;4.12;0.25;367.50;13.85;1389;45;3886.00;286
9585;35;620756816;9585;586;10976;11260;4.13;0.25;367.50;14.01;1391;45;3887.00;284
9587;35;620756832;9587;604;11037;11387;4.43;0.27;367.54;13.94;1450;45;3888.00;350
9588;35;620756860;9588;597;11042;11388;4.48;0.28;367.54;13.93;1454;45;3889.00;346
9591;35;620756877;9591;585;11052;11388;4.50;0.28;367.50;13.92;1461;45;3890.00;336
9593;35;620756895;9593;589;11060;11388;4.48;0.28;367.59;13.91;1467;45;3891.00;328
9596;35;620756919;9596;574;11064;11388;4.49;0.28;367.67;13.91;1468;45;3892.00;324
9599;35;620756936;9599;567;11065;11388;4.46;0.27;367.75;13.91;1466;45;3893.00;323
9600;35;620756954;9600;566;11067;11388;4.49;0.28;367.72;13.91;1467;45;3894.00;321
9602;35;620756971;9602;566;11068;11388;4.49;0.28;367.85;13.91;1466;45;3895.00;320
9602;35;620756989;9602;575;11069;11389;4.51;0.28;367.85;13.91;1467;45;3896.00;320
9605;35;620757006;9605;579;11074;11390;4.54;0.28;367.82;13.90;1469;45;3897.00;316
9608;35;620757023;9608;586;11075;11390;4.54;0.28;367.78;13.90;1467;45;3898.00;315
9609;35;620757041;9609;587;11076;11391;4.53;0.28;367.75;13.90;1467;45;3899.00;315
9612;35;620757061;9612;588;11084;11406;4.48;0.27;367.92;13.90;1472;45;3900.00;322
9615;35;620757085;9615;592;11085;11406;4.42;0.27;367.96;13.90;1470;45;3901.00;321
9618;35;620757103;9618;601;11085;11406;4.38;0.27;368.01;13.90;1467;45;3902.00;321
9618;35;620757120;9618;610;11091;11410;4.36;0.27;368.01;13.89;1473;45;3903.00;319
9623;35;620757138;9623;609;11092;11410;4.32;0.26;368.02;13.89;1469;45;3904.00;318
9628;35;620757156;9628;610;11092;11410;4.28;0.26;367.98;13.89;1464;45;3905.00;318
9631;35;620757173;9631;614;11096;11413;4.23;0.26;368.02;13.89;1465;45;3906.00;317
9635;35;620757191;9635;622;11097;11413;4.18;0.26;368.09;13.89;1462;45;3907.00;316
9638;35;620757207;9638;622;11099;11413;4.11;0.25;368.19;13.89;1461;45;3908.00;314
9639;35;620757224;9639;633;11104;11417;4.09;0.25;368.20;13.89;1465;45;3909.00;313
9643;35;620757241;9643;626;11104;11418;4.06;0.25;368.38;13.89;1461;45;3910.00;314
9646;35;620757267;9646;617;11104;11418;4.06;0.25;368.57;13.89;1458;45;3911.00;314
9647;35;620757291;9647;616;11108;11422;4.07;0.25;368.57;13.89;1461;45;3912.00;314
9652;35;620757309;9652;614;11108;11422;4.03;0.25;368.81;13.89;1456;45;3913.00;314
9657;35;620757326;9657;610;11109;11422;3.99;0.25;369.05;13.89;1452;45;3914.00;313
9661;35;620757344;9661;605;11110;11424;4.02;0.25;369.06;13.89;1449;45;3915.00;314
9664;35;620757362;9664;611;11111;11424;4.02;0.25;369.28;13.89;1447;45;3916.00;313
9669;35;620757380;9669;603;11114;11430;4.14;0.25;369.24;13.89;1445;45;3917.00;316
9672;35;620757398;9672;603;11117;11430;4.15;0.25;369.44;13.89;1445;45;3918.00;313
9676;35;620757416;9676;588;11117;11431;4.18;0.25;369.62;13.89;1441;45;3919.00;314
9679;35;620757438;9679;581;11117;11431;4.21;0.26;369.57;13.89;1438;45;3920.00;314
9681;35;620757464;9681;575;11117;11431;4.26;0.26;369.65;13.89;1436;45;3921.00;314
9685;35;620757491;9685;569;11117;11431;4.28;0.26;369.66;13.89;1432;45;3922.00;314
9687;35;620757515;9687;552;11117;11431;4.32;0.26;369.65;13.89;1430;45;3923.00;314
9692;35;620757540;9692;550;11124;11443;4.39;0.27;369.76;13.88;1432;45;3924.00;319
9697;35;620757570;9697;537;11125;11443;4.45;0.27;369.82;13.88;1428;45;3925.00;318
9701;35;620757589;9701;534;11125;11443;4.49;0.27;369.88;13.88;1424;45;3926.00;318
9703;35;620757609;9703;531;11128;11443;4.52;0.28;369.92;13.88;1425;45;3927.00;315
9707;35;620757629;9707;525;11128;11443;4.53;0.28;369.98;13.88;1421;45;3928.00;315
9712;35;620757651;9712;521;11128;11443;4.54;0.28;370.09;13.88;1416;45;3929.00;315
9714;35;620757673;9714;530;11133;11447;4.57;0.28;370.05;13.88;1419;45;3930.00;314
9720;35;620757695;9720;514;11134;11447;4.59;0.28;370.16;13.88;1414;45;3931.00;313
9723;35;620757716;9723;505;11136;11451;4.63;0.28;370.29;13.88;1413;45;3932.00;315
9725;35;620757737;9725;515;11138;11452;4.66;0.28;370.33;13.88;1413;45;3933.00;314
9729;35;620757758;9729;516;11139;11452;4.65;0.28;370.39;13.88;1410;45;3934.00;313
9734;35;620757777;9734;520;11140;11452;4.60;0.28;370.39;13.88;1406;45;3935.00;312
9738;35;620757800;9738;513;11148;11465;4.62;0.28;370.41;13.88;1410;45;3936.00;317
9742;35;620757821;9742;513;11149;11465;4.61;0.28;370.63;13.88;1407;45;3937.00;316
9747;35;620757843;9747;522;11151;11465;4.65;0.28;370.75;13.88;1404;45;3938.00;314
9750;35;620757862;9750;522;11153;11466;4.64;0.28;370.76;13.88;1403;45;3939.00;313
9756;35;620757882;9756;513;11153;11467;4.59;0.28;370.87;13.88;1397;45;3940.00;314
9760;35;620757903;9760;515;11154;11467;4.58;0.28;370.98;13.88;1394;45;3941.00;313
9763;35;620757923;9763;523;11156;11470;4.55;0.28;371.06;13.88;1393;45;3942.00;314
9770;35;620757945;9770;526;11156;11470;4.47;0.27;371.20;13.88;1386;45;3943.00;314
9774;35;620757966;9774;523;11159;11470;4.46;0.27;371.41;13.88;1385;45;3944.00;311
9779;35;620757986;9779;523;11159;11470;4.44;0.27;371.45;13.88;1380;45;3945.00;311
9783;35;620758007;9783;527;11164;11476;4.43;0.27;371.54;13.87;1381;45;3946.00;312
9786;35;620758027;9786;527;11165;11476;4.46;0.27;371.54;13.87;1379;45;3947.00;311
9788;35;620758047;9788;533;11166;11476;4.52;0.28;371.71;13.87;1378;45;3948.00;310
9791;35;620758067;9791;528;11168;11476;4.55;0.28;371.80;13.87;1377;45;3949.00;308
9796;35;620758086;9796;527;11171;11480;4.57;0.28;372.13;13.87;1375;45;3950.00;309
9799;35;620758106;9799;531;11172;11481;4.57;0.28;372.24;13.87;1373;45;3951.00;309
9802;35;620758126;9802;532;11173;11481;4.52;0.28;372.31;13.87;1371;45;3952.00;308
9804;35;620758146;9804;529;11175;11482;4.50;0.27;372.33;13.94;1371;45;3953.00;307
9807;35;620758166;9807;528;11176;11482;4.51;0.28;372.56;13.94;1369;45;3954.00;306
9812;35;620758186;9812;531;11176;11482;4.50;0.27;372.70;13.94;1364;45;3955.00;306
9813;35;620758205;9813;532;11176;11482;4.52;0.28;372.71;13.94;1363;45;3956.00;306
9819;35;620758225;9819;525;11176;11482;4.50;0.27;372.72;13.94;1357;45;3957.00;306
9825;35;620758244;9825;523;11176;11482;4.47;0.27;372.83;13.94;1351;45;3958.00;306
9827;35;620758264;9827;523;11176;11482;4.40;0.27;372.86;13.94;1349;45;3959.00;306
9830;35;620758285;9830;549;11248;11607;4.59;0.28;372.96;13.85;1418;45;3960.00;359
9834;35;620758315;9834;549;11250;11608;4.63;0.29;373.12;13.85;1416;45;3961.00;358
9835;35;620758335;9835;550;11256;11608;4.70;0.29;373.16;13.84;1421;45;3962.00;352
9838;35;620758356;9838;543;11258;11608;4.72;0.29;373.18;13.84;1420;45;3963.00;350
9843;35;620758384;9843;539;11263;11608;4.75;0.29;373.21;13.83;1420;45;3964.00;345
9845;35;620758406;9845;555;11265;11608;4.74;0.29;373.31;13.83;1420;45;3965.00;343
9849;35;620758427;9849;549;11270;11608;4.71;0.29;373.42;13.83;1421;45;3966.00;338
9852;35;620758449;9852;543;11274;11608;4.68;0.29;373.48;13.83;1422;45;3967.00;334
9855;35;620758470;9855;543;11277;11609;4.63;0.28;373.52;13.83;1422;45;3968.00;332
9857;35;620758490;9857;550;11280;11610;4.55;0.28;373.58;13.82;1423;45;3969.00;330
9860;35;620758517;9860;552;11282;11610;4.48;0.27;373.59;13.82;1422;45;3970.00;328
9861;35;620758535;9861;562;11286;11614;4.44;0.27;373.62;13.82;1425;45;3971.00;328
9865;35;620758554;9865;567;11286;11614;4.40;0.27;373.71;13.82;1421;45;3972.00;328
9867;35;620758572;9867;573;11286;11614;4.40;0.27;373.72;13.82;1419;45;3973.00;328
9869;35;620758590;9869;584;11286;11614;4.36;0.27;373.75;13.82;1417;45;3974.00;328
9872;35;620758609;9872;588;11290;11620;4.33;0.26;373.73;13.81;1418;45;3975.00;330
9874;35;620758628;9874;599;11290;11620;4.36;0.27;373.77;13.81;1416;45;3976.00;330
9877;35;620758646;9877;599;11290;11620;4.37;0.27;373.78;13.81;1413;45;3977.00;330
9881;35;620758670;9881;610;11292;11623;4.36;0.27;373.87;13.81;1411;45;3978.00;331
9883;35;620758688;9883;617;11293;11623;4.36;0.26;373.93;13.81;1410;45;3979.00;330
9886;35;620758707;9886;608;11293;11623;4.36;0.27;374.07;13.81;1407;45;3980.00;330
9888;35;620758725;9888;618;11293;11624;4.37;0.27;374.12;13.81;1405;45;3981.00;331
9888;35;620758744;9888;622;11295;11625;4.39;0.27;374.12;13.81;1407;45;3982.00;330
9890;35;620758762;9890;612;11295;11625;4.45;0.27;374.15;13.81;1405;45;3983.00;330
9893;35;620758780;9893;612;11304;11638;4.52;0.28;374.19;13.80;1411;45;3984.00;334
9894;35;620758800;9894;607;11305;11638;4.55;0.28;374.18;13.80;1411;45;3985.00;333
9895;35;620758818;9895;620;11306;11638;4.59;0.28;374.15;13.80;1411;45;3986.00;332
9896;35;620758839;9896;623;11307;11639;4.60;0.28;374.21;13.79;1411;45;3987.00;332
9896;35;620758858;9896;625;11307;11639;4.60;0.28;374.21;13.79;1411;45;3988.00;332
9900;35;620758874;9900;618;11311;11643;4.58;0.28;374.33;13.79;1411;45;3989.00;332
9902;35;620758894;9902;623;11311;11643;4.57;0.28;374.26;13.79;1409;45;3990.00;332
9906;35;620758910;9906;630;11315;11647;4.52;0.28;374.32;13.86;1409;45;3991.00;332
9908;35;620758929;9908;633;11315;11647;4.47;0.27;374.41;13.86;1407;45;3992.00;332
9912;35;620758946;9912;635;11315;11647;4.39;0.27;374.42;13.86;1403;45;3993.00;332
9914;35;620758963;9914;638;11315;11647;4.33;0.26;374.48;13.86;1401;45;3994.00;332
9916;35;620758981;9916;646;11315;11647;4.29;0.26;374.44;13.86;1399;45;3995.00;332
9918;35;620758998;9918;646;11325;11659;4.33;0.26;374.40;13.85;1407;45;3996.00;334
9919;35;620759017;9919;664;11325;11659;4.32;0.26;374.40;13.85;1406;45;3997.00;334
9922;35;620759034;9922;661;11326;11659;4.30;0.26;374.38;13.84;1404;45;3998.00;333
9925;35;620759051;9925;664;11326;11659;4.27;0.26;374.32;13.84;1401;45;3999.00;333
9926;35;620759069;9926;661;11326;11659;4.26;0.26;374.29;13.84;1400;45;4000.00;333
9930;35;620759092;9930;658;11326;11659;4.24;0.26;374.30;13.84;1396;45;4001.00;333
9932;35;620759109;9932;654;11326;11660;4.21;0.26;374.32;13.84;1394;45;4002.00;334
9933;35;620759126;9933;646;11326;11660;4.21;0.26;374.36;13.84;1393;45;4003.00;334
9935;35;620759144;9935;643;11331;11666;4.25;0.26;374.33;13.84;1396;45;4004.00;335
9938;35;620759162;9938;641;11333;11668;4.24;0.26;374.31;13.84;1395;45;4005.00;335
9939;35;620759180;9939;635;11333;11668;4.28;0.26;374.32;13.84;1394;45;4006.00;335
9942;35;620759197;9942;634;11333;11668;4.26;0.26;374.32;13.84;1391;45;4007.00;335
9944;35;620759215;9944;641;11336;11672;4.28;0.26;374.30;13.83;1392;45;4008.00;336
9945;35;620759233;9945;638;11336;11672;4.28;0.26;374.34;13.83;1391;45;4009.00;336
9947;35;620759250;9947;637;11336;11672;4.24;0.26;374.37;13.83;1389;45;4010.00;336
9949;35;620759267;9949;631;11337;11673;4.24;0.26;374.43;13.83;1388;45;4011.00;336
9949;35;620759283;9949;628;11340;11677;4.22;0.26;374.43;13.83;1391;45;4012.00;337
9951;35;620759299;9951;619;11340;11677;4.19;0.26;374.44;13.83;1389;45;4013.00;337
9953;35;620759316;9953;623;11342;11680;4.23;0.26;374.40;13.83;1389;45;4014.00;338
9955;35;620759332;9955;618;11344;11680;4.23;0.26;374.38;13.91;1389;45;4015.00;336
9961;35;620759352;9961;610;11344;11680;4.19;0.25;374.42;13.91;1383;45;4016.00;336
9964;35;620759377;9964;617;11345;11680;4.13;0.25;374.43;14.00;1381;45;4017.00;335
9965;35;620759394;9965;609;11349;11684;4.16;0.25;374.44;13.99;1384;45;4018.00;335
9967;35;620759411;9967;589;11349;11684;4.20;0.26;374.46;13.99;1382;45;4019.00;335
9968;35;620759435;9968;575;11349;11684;4.27;0.26;374.49;13.99;1381;45;4020.00;335
9969;35;620759460;9969;570;11349;11684;4.30;0.26;374.48;13.99;1380;45;4021.00;335
9970;35;620759484;9970;554;11349;11685;4.38;0.27;374.56;13.99;1379;45;4022.00;336
9974;35;620759509;9974;556;11350;11686;4.37;0.27;374.58;13.99;1376;45;4023.00;336
9974;35;620759532;9974;551;11350;11686;4.40;0.27;374.58;13.99;1376;45;4024.00;336
9977;35;620759555;9977;552;11351;11687;4.43;0.27;374.55;13.99;1374;45;4025.00;336
9981;35;620759585;9981;553;11351;11687;4.43;0.27;374.55;13.99;1370;45;4026.00;336
9984;35;620759608;9984;554;11351;11687;4.44;0.27;374.56;13.99;1367;45;4027.00;336
9987;35;620759629;9987;550;11351;11687;4.44;0.27;374.56;13.99;1364;45;4028.00;336
9988;35;620759649;9988;558;11351;11687;4.44;0.27;374.53;13.99;1363;45;4029.00;336
9989;35;620759671;9989;556;11351;11687;4.47;0.27;374.57;13.99;1362;45;4030.00;336
9992;35;620759691;9992;560;11351;11687;4.46;0.27;374.60;13.99;1359;45;4031.00;336
9993;35;620759712;9993;579;11420;11814;4.76;0.29;374.57;13.91;1427;45;4032.00;394
9993;35;620759749;9993;569;11423;11815;4.76;0.29;374.57;13.90;1430;45;4033.00;392
9995;35;620759768;9995;560;11431;11815;4.82;0.30;374.60;13.90;1436;45;4034.00;384
9996;35;620759788;9996;553;11434;11815;4.81;0.30;374.60;13.89;1438;45;4035.00;381
9998;35;620759807;9998;543;11439;11815;4.80;0.29;374.60;13.89;1441;45;4036.00;376
10000;35;620759827;10000;535;11441;11815;4.72;0.29;374.66;13.89;1441;45;4037.00;374
10000;35;620759858;10000;521;11443;11815;4.67;0.29;374.66;13.88;1443;45;4038.00;372
10002;35;620759878;10002;527;11446;11815;4.66;0.29;374.64;13.88;1444;45;4039.00;369
10003;35;620759898;10003;525;11448;11816;4.68;0.29;374.68;13.88;1445;45;4040.00;368
10005;35;620759918;10005;532;11451;11817;4.68;0.29;374.63;13.88;1446;45;4041.00;366
10008;35;620759939;10008;537;11454;11817;4.70;0.29;374.60;13.88;1446;45;4042.00;363
10009;35;620759959;10009;541;11456;11818;4.71;0.29;374.59;13.88;1447;45;4043.00;362
10014;35;620759980;10014;545;11462;11818;4.62;0.28;374.61;13.97;1448;45;4044.00;356
10016;35;620760002;10016;544;11463;11818;4.56;0.28;374.70;13.97;1447;45;4045.00;355
10017;35;620760031;10017;548;11466;11818;4.56;0.28;374.78;14.14;1449;45;4046.00;352
10019;35;620760055;10019;553;11471;11822;4.53;0.28;374.77;14.14;1452;45;4047.00;351
10023;35;620760077;10023;559;11471;11822;4.47;0.27;374.86;14.14;1448;45;4048.00;351
10026;35;620760099;10026;563;11474;11822;4.44;0.27;374.90;14.23;1448;45;4049.00;348
10027;35;620760123;10027;577;11479;11828;4.41;0.27;375.01;14.22;1452;45;4050.00;349
10029;35;620760145;10029;587;11480;11828;4.40;0.27;374.99;14.31;1451;45;4051.00;348
10030;35;620760165;10030;584;11483;11828;4.41;0.27;375.02;14.40;1453;45;4052.00;345
10031;35;620760185;10031;591;11487;11832;4.38;0.27;375.06;14.48;1456;45;4053.00;345
10034;35;620760210;10034;596;11489;11833;4.32;0.26;375.11;14.48;1455;45;4054.00;344
10035;35;620760229;10035;602;11491;11833;4.28;0.26;375.11;14.48;1456;45;4055.00;342
10037;35;620760249;10037;602;11495;11837;4.27;0.26;375.13;14.48;1458;45;4056.00;342
10038;35;620760269;10038;595;11495;11837;4.24;0.26;375.16;14.48;1457;45;4057.00;342
10039;35;620760288;10039;600;11495;11837;4.27;0.26;375.21;14.48;1456;45;4058.00;342
10042;35;620760307;10042;599;11496;11838;4.26;0.26;375.26;14.48;1454;45;4059.00;342
10045;35;620760326;10045;594;11496;11838;4.27;0.26;375.31;14.48;1451;45;4060.00;342
10047;35;620760355;10047;599;11501;11844;4.31;0.26;375.40;14.47;1454;45;4061.00;343
10048;35;620760377;10048;594;11501;11844;4.31;0.26;375.41;14.47;1453;45;4062.00;343
10049;35;620760395;10049;592;11501;11845;4.35;0.27;375.39;14.47;1452;45;4063.00;344
10053;35;620760415;10053;592;11501;11845;4.38;0.27;375.46;14.47;1448;45;4064.00;344
10054;35;620760436;10054;589;11501;11845;4.38;0.27;375.43;14.47;1447;45;4065.00;344
10056;35;620760456;10056;584;11501;11845;4.41;0.27;375.50;14.47;1445;45;4066.00;344
10058;35;620760476;10058;573;11501;11845;4.42;0.27;375.62;14.47;1443;45;4067.00;344
10059;35;620760495;10059;572;11512;11857;4.48;0.27;375.72;14.46;1453;45;4068.00;345
10059;35;620760514;10059;570;11512;11857;4.52;0.28;375.72;14.46;1453;45;4069.00;345
10061;35;620760532;10061;566;11512;11857;4.53;0.28;375.85;14.46;1451;45;4070.00;345
10063;35;620760550;10063;567;11512;11857;4.53;0.28;375.93;14.46;1449;45;4071.00;345
10067;35;620760568;10067;565;11512;11857;4.51;0.28;375.92;14.46;1445;45;4072.00;345
10068;35;620760586;10068;565;11512;11857;4.54;0.28;375.92;14.46;1444;45;4073.00;345
10074;35;620760603;10074;571;11515;11861;4.50;0.27;375.96;14.45;1441;45;4074.00;346
10076;35;620760622;10076;571;11515;11861;4.51;0.27;375.98;14.45;1439;45;4075.00;346
10083;35;620760647;10083;577;11519;11865;4.50;0.27;376.11;14.45;1436;45;4076.00;346
10084;35;620760666;10084;586;11520;11866;4.46;0.27;376.11;14.45;1436;45;4077.00;346
10087;35;620760683;10087;595;11520;11866;4.43;0.27;376.19;14.45;1433;45;4078.00;346
10088;35;620760700;10088;605;11520;11866;4.40;0.27;376.20;14.45;1432;45;4079.00;346
10096;35;620760720;10096;607;11541;11895;4.34;0.27;376.43;14.42;1445;45;4080.00;354
10100;35;620760741;10100;600;11541;11895;4.31;0.26;376.35;14.42;1441;45;4081.00;354
10102;35;620760758;10102;590;11543;11895;4.33;0.27;376.35;14.42;1441;45;4082.00;352
10108;35;620760776;10108;586;11545;11896;4.32;0.26;376.44;14.42;1437;45;4083.00;351
10110;35;620760794;10110;587;11546;11897;4.35;0.27;376.47;14.42;1436;45;4084.00;351
10114;35;620760813;10114;587;11546;11897;4.35;0.27;376.44;14.42;1432;45;4085.00;351
10120;35;620760830;10120;580;11548;11900;4.38;0.27;376.58;14.42;1428;45;4086.00;352
10124;35;620760849;10124;577;11548;11900;4.41;0.27;376.66;14.42;1424;45;4087.00;352
10126;35;620760868;10126;570;11548;11900;4.46;0.27;376.66;14.42;1422;45;4088.00;352
10128;35;620760886;10128;565;11548;11900;4.50;0.28;376.76;14.42;1420;45;4089.00;352
10136;35;620760904;10136;565;11552;11906;4.53;0.28;376.81;14.41;1416;45;4090.00;354
10137;35;620760924;10137;562;11552;11906;4.55;0.28;376.83;14.41;1415;45;4091.00;354
10141;35;620760942;10141;553;11552;11906;4.59;0.28;376.87;14.41;1411;45;4092.00;354
10143;35;620760961;10143;549;11552;11906;4.62;0.28;376.91;14.41;1409;45;4093.00;354
10147;35;620760987;10147;543;11555;11910;4.65;0.28;376.87;14.41;1408;45;4094.00;355
10155;35;620761007;10155;543;11557;11912;4.62;0.28;376.93;14.40;1402;45;4095.00;355
10156;35;620761027;10156;545;11557;11912;4.62;0.28;376.93;14.40;1401;45;4096.00;355
10160;35;620761047;10160;546;11558;11913;4.62;0.28;376.99;14.40;1398;45;4097.00;355
10166;35;620761067;10166;544;11558;11913;4.60;0.28;377.21;14.40;1392;45;4098.00;355
10171;35;620761086;10171;537;11558;11913;4.60;0.28;377.39;14.40;1387;45;4099.00;355
10175;35;620761106;10175;541;11558;11913;4.61;0.28;377.57;14.40;1383;45;4100.00;355
10181;35;620761130;10181;532;11558;11913;4.58;0.28;377.61;14.40;1377;45;4101.00;355
10187;35;620761148;10187;536;11558;11913;4.56;0.28;377.82;14.40;1371;45;4102.00;355
10192;35;620761166;10192;537;11558;11913;4.55;0.28;377.92;14.40;1366;45;4103.00;355
10198;35;620761183;10198;546;11592;11983;4.62;0.28;378.08;14.36;1394;45;4104.00;391
10203;35;620761207;10203;540;11593;11984;4.60;0.28;378.34;14.36;1390;45;4105.00;391
10206;35;620761226;10206;541;11597;11984;4.62;0.28;378.42;14.36;1391;45;4106.00;387
10207;35;620761244;10207;546;11598;11984;4.64;0.28;378.46;14.35;1391;45;4107.00;386
10211;35;620761262;10211;545;11602;11984;4.63;0.28;378.50;14.35;1391;45;4108.00;382
10212;35;620761280;10212;553;11603;11984;4.63;0.28;378.59;14.35;1391;45;4109.00;381
10217;35;620761299;10217;549;11606;11984;4.62;0.28;378.70;14.35;1389;45;4110.00;378
10220;35;620761317;10220;559;11608;11984;4.60;0.28;378.73;14.35;1388;45;4111.00;376
10225;35;620761334;10225;563;11610;11985;4.51;0.28;378.75;14.35;1385;45;4112.00;375
10230;35;620761361;10230;567;11611;11986;4.48;0.27;378.76;14.35;1381;45;4113.00;375
10234;35;620761380;10234;569;11613;11986;4.44;0.27;378.81;14.35;1379;45;4114.00;373
10240;35;620761398;10240;580;11617;11990;4.38;0.27;378.85;14.34;1377;45;4115.00;373
10242;35;620761417;10242;585;11620;11990;4.41;0.27;378.83;14.34;1378;45;4116.00;370
10245;35;620761439;10245;592;11621;11990;4.40;0.27;378.88;14.34;1376;45;4117.00;369
10249;35;620761464;10249;592;11622;11990;4.42;0.27;378.93;14.34;1373;45;4118.00;368
10254;35;620761492;10254;593;11627;11996;4.38;0.27;379.00;14.34;1373;45;4119.00;369
10258;35;620761517;10258;591;11628;11996;4.34;0.27;379.06;14.34;1370;45;4120.00;368
10260;35;620761540;10260;595;11630;11996;4.29;0.26;379.09;14.34;1370;45;4121.00;366
10262;35;620761565;10262;606;11632;11999;4.26;0.26;379.07;14.34;1370;45;4122.00;367
10267;35;620761585;10267;608;11633;11999;4.20;0.26;379.11;14.34;1366;45;4123.00;366
10269;35;620761604;10269;611;11635;11999;4.14;0.25;379.17;14.34;1366;45;4124.00;364
10274;35;620761623;10274;615;11636;12000;4.04;0.25;379.30;14.34;1362;45;4125.00;364
10282;35;620761642;10282;626;11638;12001;3.97;0.24;379.38;14.34;1356;45;4126.00;363
10286;35;620761660;10286;616;11639;12001;3.92;0.24;379.41;14.34;1353;45;4127.00;362
10290;35;620761679;10290;616;11649;12014;3.92;0.24;379.39;14.32;1359;45;4128.00;365
10292;35;620761699;10292;613;11649;12014;3.94;0.24;379.41;14.32;1357;45;4129.00;365
10294;35;620761719;10294;619;11650;12014;3.95;0.24;379.40;14.32;1356;45;4130.00;364
10296;35;620761737;10296;621;11651;12015;3.95;0.24;379.43;14.32;1355;45;4131.00;364
10299;35;620761756;10299;627;11652;12015;3.99;0.24;379.41;14.32;1353;45;4132.00;363
10302;35;620761773;10302;633;11655;12019;4.03;0.25;379.39;14.32;1353;45;4133.00;364
10304;35;620761792;10304;637;11656;12019;4.06;0.25;379.42;14.32;1352;45;4134.00;363
10306;35;620761811;10306;640;11659;12023;4.07;0.25;379.49;14.31;1353;45;4135.00;364
10310;35;620761829;10310;639;11659;12023;4.05;0.25;379.51;14.31;1349;45;4136.00;364
10311;35;620761849;10311;640;11659;12023;4.09;0.25;379.52;14.31;1348;45;4137.00;364
10313;35;620761868;10313;632;11659;12023;4.11;0.25;379.57;14.31;1346;45;4138.00;364
10314;35;620761887;10314;626;11659;12023;4.19;0.26;379.61;14.31;1345;45;4139.00;364
10316;35;620761908;10316;614;11685;12057;4.31;0.27;379.65;14.28;1369;45;4140.00;372
10319;35;620761932;10319;608;11686;12057;4.36;0.27;379.63;14.28;1367;45;4141.00;371
10321;35;620761953;10321;608;11687;12057;4.45;0.27;379.62;14.28;1366;45;4142.00;370
10324;35;620761973;10324;607;11687;12057;4.46;0.27;379.57;14.28;1363;45;4143.00;370
10326;35;620761992;10326;601;11688;12057;4.48;0.28;379.54;14.28;1362;45;4144.00;369
10329;35;620762011;10329;605;11688;12057;4.47;0.27;379.55;14.28;1359;45;4145.00;369
10329;35;620762031;10329;601;11688;12058;4.53;0.28;379.55;14.28;1359;45;4146.00;370
10330;35;620762050;10330;595;11688;12058;4.54;0.28;379.53;14.28;1358;45;4147.00;370
10332;35;620762069;10332;596;11693;12064;4.61;0.28;379.52;14.27;1361;45;4148.00;371
10333;35;620762090;10333;598;11694;12065;4.62;0.28;379.54;14.27;1361;45;4149.00;371
10336;35;620762110;10336;593;11694;12065;4.62;0.28;379.58;14.27;1358;45;4150.00;371
10336;35;620762129;10336;591;11694;12065;4.59;0.28;379.58;14.27;1358;45;4151.00;371
10337;35;620762148;10337;581;11697;12069;4.63;0.28;379.58;14.27;1360;45;4152.00;372
10340;35;620762167;10340;582;11697;12069;4.57;0.28;379.58;14.27;1357;45;4153.00;372
10343;35;620762187;10343;585;11697;12069;4.50;0.27;379.65;14.27;1354;45;4154.00;372
10347;35;620762205;10347;587;11698;12070;4.45;0.27;379.64;14.27;1351;45;4155.00;372
10349;35;620762225;10349;591;11701;12074;4.40;0.27;379.66;14.26;1352;45;4156.00;373
10351;35;620762243;10351;589;11701;12074;4.32;0.26;379.64;14.26;1350;45;4157.00;373
10353;35;620762262;10353;592;11703;12077;4.31;0.26;379.62;14.26;1350;45;4158.00;374
10355;35;620762280;10355;598;11703;12077;4.24;0.26;379.69;14.26;1348;45;4159.00;374
10358;35;620762298;10358;603;11704;12077;4.22;0.26;379.69;14.26;1346;45;4160.00;373
10360;35;620762317;10360;609;11704;12077;4.13;0.25;379.63;14.26;1344;45;4161.00;373
10362;35;620762344;10362;606;11708;12081;4.10;0.25;379.58;14.26;1346;45;4162.00;373
10362;35;620762364;10362;608;11708;12081;4.06;0.25;379.58;14.26;1346;45;4163.00;373
10363;35;620762382;10363;605;11708;12081;4.06;0.25;379.58;14.26;1345;45;4164.00;373
10363;35;620762399;10363;617;11708;12081;4.02;0.24;379.58;14.26;1345;45;4165.00;373
10364;35;620762416;10364;615;11708;12082;3.99;0.24;379.55;14.26;1344;45;4166.00;374
10364;36;620762434;10364;614;11709;12083;3.98;0.24;379.55;14.25;1345;46;4167.00;374
10366;36;620762478;10366;617;11709;12083;3.94;0.24;379.52;14.25;1343;46;4168.00;374
10367;36;620762497;10367;629;11710;12084;3.90;0.24;379.57;14.25;1343;46;4169.00;374
10369;36;620762520;10369;630;11710;12084;3.90;0.24;379.60;14.25;1341;46;4170.00;374
10370;36;620762536;10370;600;11710;12084;3.92;0.24;379.60;14.25;1340;46;4171.00;374
10370;36;620762554;10370;577;11710;12084;4.00;0.24;379.60;14.25;1340;46;4172.00;374
10373;36;620762570;10373;569;11713;12086;4.08;0.25;379.64;14.34;1340;46;4173.00;373
10374;36;620762587;10374;557;11713;12086;4.21;0.26;379.63;14.34;1339;46;4174.00;373
10375;36;620762604;10375;542;11713;12086;4.28;0.26;379.63;14.34;1338;46;4175.00;373
10375;36;620762620;10375;552;11780;12213;4.55;0.28;379.63;14.25;1405;46;4176.00;433
10378;36;620762647;10378;542;11781;12214;4.62;0.29;379.62;14.25;1403;46;4177.00;433
10379;36;620762674;10379;525;11786;12214;4.74;0.29;379.63;14.25;1407;46;4178.00;428
10381;37;620762692;10381;518;11790;12214;4.87;0.30;379.73;14.24;1409;47;4179.00;424
10385;37;620762723;10385;510;11796;12214;4.95;0.30;379.72;14.24;1411;47;4180.00;418
10386;37;620762740;10386;509;11799;12214;4.97;0.31;379.73;14.24;1413;47;4181.00;415
10390;37;620762766;10390;500;11801;12214;4.98;0.31;379.80;14.23;1411;47;4182.00;413
10393;37;620762784;10393;502;11806;12214;4.99;0.31;379.82;14.23;1413;47;4183.00;408
10396;37;620762804;10396;488;11809;12215;5.01;0.31;379.84;14.33;1413;47;4184.00;406
10397;37;620762829;10397;485;11813;12217;5.02;0.31;379.83;14.42;1416;47;4185.00;404
10398;37;620762854;10398;483;11815;12217;5.02;0.31;379.82;14.42;1417;47;4186.00;402
10402;37;620762872;10402;490;11815;12218;5.02;0.31;379.83;14.42;1413;47;4187.00;403
10403;37;620762890;10403;493;11817;12218;5.03;0.31;379.82;14.42;1414;47;4188.00;401
10404;37;620762907;10404;485;11818;12218;5.06;0.31;379.81;14.42;1414;47;4189.00;400
10405;37;620762928;10405;478;11820;12218;5.07;0.31;379.86;14.42;1415;47;4190.00;398
10406;37;620762946;10406;482;11826;12222;5.10;0.31;379.96;14.42;1420;47;4191.00;396
10408;37;620762966;10408;482;11826;12222;5.12;0.31;379.91;14.42;1418;47;4192.00;396
10412;37;620762984;10412;479;11828;12222;5.12;0.31;379.83;14.42;1416;47;4193.00;394
10413;37;620763002;10413;469;11830;12225;5.11;0.31;379.92;14.42;1417;47;4194.00;395
10418;37;620763021;10418;476;11831;12225;5.05;0.31;380.03;14.42;1413;47;4195.00;394
10418;37;620763039;10418;476;11832;12225;5.10;0.31;380.03;14.42;1414;47;4196.00;393
10421;37;620763057;10421;479;11837;12229;5.05;0.31;380.06;14.41;1416;47;4197.00;392
10425;37;620763075;10425;481;11839;12230;5.01;0.30;380.03;14.41;1414;47;4198.00;391
10428;37;620763096;10428;485;11840;12230;4.97;0.30;380.11;14.41;1412;47;4199.00;390
10430;37;620763126;10430;488;11848;12264;4.97;0.30;380.15;14.40;1418;47;4200.00;416
10433;37;620763153;10433;496;11854;12264;4.96;0.30;380.20;14.40;1421;47;4201.00;410
10435;37;620763172;10435;489;11856;12264;5.02;0.31;380.22;14.40;1421;47;4202.00;408
10438;37;620763191;10438;490;11858;12265;5.04;0.31;380.25;14.40;1420;47;4203.00;407
10439;37;620763210;10439;496;11861;12265;5.07;0.31;380.25;14.40;1422;47;4204.00;404
10442;37;620763228;10442;520;11865;12271;5.10;0.31;380.36;14.39;1423;47;4205.00;406
10443;37;620763246;10443;518;11868;12271;5.09;0.31;380.36;14.49;1425;47;4206.00;403
10445;37;620763265;10445;524;11869;12272;5.11;0.31;380.39;14.49;1424;47;4207.00;403
10447;37;620763283;10447;520;11869;12272;5.10;0.31;380.56;14.49;1422;47;4208.00;403
10448;37;620763302;10448;535;11869;12272;5.13;0.31;380.57;14.49;1421;47;4209.00;403
10450;37;620763326;10450;536;11872;12272;5.09;0.31;380.55;14.68;1422;47;4210.00;400
10452;37;620763344;10452;537;11874;12272;5.08;0.31;380.60;14.78;1422;47;4211.00;398
10454;37;620763363;10454;543;11886;12284;5.08;0.31;380.56;14.86;1432;47;4212.00;398
10457;37;620763382;10457;554;11887;12284;5.04;0.31;380.70;14.96;1430;47;4213.00;397
10460;37;620763408;10460;551;11888;12284;5.05;0.31;380.76;14.95;1428;47;4214.00;396
10461;37;620763427;10461;550;11889;12284;5.05;0.31;380.81;15.05;1428;47;4215.00;395
10462;37;620763452;10462;549;11890;12284;5.06;0.31;380.94;15.05;1428;47;4216.00;394
10465;37;620763487;10465;565;11891;12284;5.05;0.31;380.98;15.05;1426;47;4217.00;393
10469;37;620763517;10469;564;11896;12288;5.04;0.31;381.01;15.14;1427;47;4218.00;392
10472;37;620763545;10472;565;11896;12288;4.99;0.30;380.99;15.14;1424;47;4219.00;392
10473;37;620763566;10473;565;11900;12292;5.01;0.31;381.02;15.23;1427;47;4220.00;392
10476;37;620763588;10476;568;11901;12293;5.01;0.31;381.16;15.23;1425;47;4221.00;392
10479;37;620763609;10479;567;11902;12293;5.01;0.31;381.13;15.23;1423;47;4222.00;391
10482;37;620763630;10482;565;11904;12293;4.97;0.30;381.20;15.33;1422;47;4223.00;389
10485;37;620763649;10485;572;11914;12306;4.95;0.30;381.19;15.32;1429;47;4224.00;392
10490;37;620763670;10490;564;11915;12306;4.88;0.30;381.42;15.41;1425;47;4225.00;391
10494;37;620763690;10494;565;11916;12306;4.85;0.30;381.48;15.41;1422;47;4226.00;390
10494;37;620763719;10494;565;11922;12307;4.84;0.29;381.48;15.69;1428;47;4227.00;385
10497;37;620763741;10497;572;11924;12308;4.80;0.29;381.44;15.79;1427;47;4228.00;384
10497;37;620763764;10497;562;11926;12308;4.80;0.29;381.44;15.97;1429;47;4229.00;382
10500;37;620763788;10500;568;11931;12314;4.82;0.29;381.44;15.97;1431;47;4230.00;383
10501;37;620763810;10501;564;11931;12314;4.87;0.30;381.53;15.97;1430;47;4231.00;383
10501;37;620763832;10501;562;11932;12314;4.90;0.30;381.53;15.97;1431;47;4232.00;382
10504;37;620763854;10504;554;11932;12314;4.90;0.30;381.62;15.97;1428;47;4233.00;382
10509;37;620763875;10509;556;11941;12320;4.91;0.30;381.56;16.24;1432;47;4234.00;379
10512;37;620763900;10512;546;11941;12320;4.91;0.30;381.64;16.24;1429;47;4235.00;379
10514;37;620763922;10514;542;11943;12320;4.89;0.30;381.75;16.42;1429;47;4236.00;377
10514;37;620763943;10514;543;11945;12320;4.89;0.30;381.75;16.60;1431;47;4237.00;375
10516;37;620763963;10516;550;11948;12324;4.89;0.30;381.88;16.60;1432;47;4238.00;376
10521;37;620763986;10521;551;11952;12325;4.89;0.30;381.93;16.78;1431;47;4239.00;373
10521;37;620764008;10521;555;11952;12325;4.92;0.30;381.93;16.78;1431;47;4240.00;373
10525;37;620764028;10525;563;11953;12326;4.91;0.30;381.98;16.78;1428;47;4241.00;373
10525;37;620764047;10525;552;11955;12326;4.92;0.30;381.98;16.96;1430;47;4242.00;371
10530;37;620764067;10530;562;11955;12326;4.87;0.30;382.12;16.96;1425;47;4243.00;371
10536;37;620764087;10536;561;11957;12326;4.80;0.29;382.16;17.14;1421;47;4244.00;369
10542;37;620764112;10542;570;11958;12326;4.77;0.29;382.24;17.14;1416;47;4245.00;368
10545;37;620764130;10545;575;11958;12326;4.70;0.29;382.35;17.14;1413;47;4246.00;368
10550;37;620764148;10550;578;11960;12326;4.60;0.28;382.40;17.32;1410;47;4247.00;366
10552;37;620764166;10552;600;12001;12396;4.62;0.28;382.54;17.26;1449;47;4248.00;395
10556;37;620764191;10556;595;12003;12397;4.53;0.28;382.55;17.43;1447;47;4249.00;394
10560;37;620764209;10560;591;12007;12397;4.51;0.27;382.73;17.43;1447;47;4250.00;390
10563;37;620764228;10563;591;12013;12397;4.50;0.27;382.98;17.43;1450;47;4251.00;384
10567;37;620764247;10567;599;12018;12397;4.44;0.27;383.02;17.60;1451;47;4252.00;379
10572;37;620764266;10572;599;12021;12397;4.38;0.27;383.07;17.60;1449;47;4253.00;376
10575;37;620764287;10575;601;12023;12397;4.37;0.27;383.30;17.60;1448;47;4254.00;374
10577;37;620764316;10577;609;12025;12397;4.37;0.27;383.38;17.60;1448;47;4255.00;372
10580;37;620764335;10580;608;12027;12398;4.37;0.27;383.47;17.60;1447;47;4256.00;371
10583;37;620764353;10583;609;12027;12399;4.37;0.27;383.55;17.60;1444;47;4257.00;372
10585;37;620764372;10585;603;12029;12399;4.39;0.27;383.53;17.59;1444;47;4258.00;370
10590;37;620764391;10590;601;12031;12403;4.34;0.27;383.57;17.59;1441;47;4259.00;372
10593;37;620764412;10593;595;12032;12403;4.34;0.27;383.62;17.59;1439;47;4260.00;371
10598;37;620764433;10598;587;12032;12403;4.28;0.26;383.87;17.59;1434;47;4261.00;371
10601;37;620764452;10601;578;12032;12403;4.26;0.26;383.89;17.59;1431;47;4262.00;371
10604;37;620764472;10604;573;12036;12409;4.26;0.26;383.92;17.59;1432;47;4263.00;373
10608;37;620764491;10608;563;12036;12409;4.24;0.26;383.94;17.59;1428;47;4264.00;373
10613;37;620764508;10613;572;12036;12409;4.24;0.26;383.93;17.59;1423;47;4265.00;373
10616;37;620764526;10616;560;12037;12412;4.24;0.26;383.95;17.58;1421;47;4266.00;375
10619;37;620764543;10619;565;12037;12412;4.23;0.26;383.94;17.58;1418;47;4267.00;375
10624;37;620764561;10624;577;12037;12412;4.21;0.26;384.12;17.58;1413;47;4268.00;375
10627;37;620764578;10627;577;12038;12413;4.20;0.26;384.27;17.58;1411;47;4269.00;375
10633;37;620764595;10633;570;12039;12414;4.16;0.25;384.33;17.58;1406;47;4270.00;375
10638;37;620764614;10638;572;12040;12414;4.14;0.25;384.29;17.58;1402;47;4271.00;374
10642;37;620764633;10642;580;12050;12427;4.17;0.25;384.23;17.57;1408;47;4272.00;377
10646;37;620764653;10646;582;12050;12427;4.12;0.25;384.29;17.57;1404;47;4273.00;377
10650;37;620764670;10650;587;12050;12427;4.10;0.25;384.31;17.57;1400;47;4274.00;377
10654;37;620764688;10654;590;12051;12429;4.10;0.25;384.37;17.57;1397;47;4275.00;378
10659;37;620764705;10659;597;12051;12429;4.09;0.25;384.46;17.57;1392;47;4276.00;378
10664;37;620764721;10664;587;12054;12433;4.10;0.25;384.50;17.56;1390;47;4277.00;379
10665;37;620764738;10665;587;12054;12433;4.10;0.25;384.48;17.56;1389;47;4278.00;379
10670;37;620764756;10670;584;12057;12437;4.06;0.25;384.52;17.56;1387;47;4279.00;380
10673;37;620764774;10673;588;12057;12437;4.03;0.25;384.59;17.56;1384;47;4280.00;380
10680;37;620764792;10680;583;12057;12437;3.93;0.24;384.69;17.56;1377;47;4281.00;380
10685;37;620764810;10685;589;12057;12437;3.84;0.23;384.82;17.56;1372;47;4282.00;380
10688;37;620764828;10688;596;12059;12437;3.79;0.23;384.87;17.56;1371;47;4283.00;378
10690;37;620764845;10690;589;12068;12449;3.87;0.24;384.92;17.55;1378;47;4284.00;381
10695;37;620764863;10695;597;12068;12449;3.82;0.23;384.92;17.55;1373;47;4285.00;381
10698;37;620764880;10698;594;12070;12449;3.78;0.23;384.88;17.55;1372;47;4286.00;379
10701;37;620764898;10701;606;12070;12449;3.75;0.23;384.91;17.55;1369;47;4287.00;379
10706;37;620764916;10706;612;12071;12449;3.72;0.23;384.89;17.55;1365;47;4288.00;378
10710;37;620764934;10710;614;12073;12449;3.70;0.22;384.90;17.64;1363;47;4289.00;376
10713;37;620764953;10713;621;12074;12450;3.63;0.22;384.94;17.64;1361;47;4290.00;376
10715;37;620764971;10715;622;12076;12450;3.57;0.22;385.00;17.64;1361;47;4291.00;374
10716;37;620764986;10716;627;12080;12456;3.50;0.21;384.99;17.63;1364;47;4292.00;376
10718;37;620765004;10718;629;12082;12457;3.46;0.21;384.98;17.63;1364;47;4293.00;375
10718;37;620765021;10718;635;12082;12457;3.41;0.21;384.98;17.63;1364;47;4294.00;375
10719;37;620765037;10719;640;12082;12457;3.39;0.21;385.00;17.63;1363;47;4295.00;375
10720;37;620765053;10720;641;12086;12461;3.40;0.21;384.97;17.63;1366;47;4296.00;375
10722;37;620765070;10722;637;12086;12461;3.39;0.21;384.96;17.63;1364;47;4297.00;375
10727;37;620765087;10727;637;12087;12461;3.36;0.21;384.97;17.63;1360;47;4298.00;374
10729;37;620765104;10729;624;12088;12462;3.38;0.21;385.00;17.62;1359;47;4299.00;374
10732;37;620765122;10732;624;12092;12466;3.48;0.21;384.94;17.62;1360;47;4300.00;374
10733;37;620765143;10733;625;12092;12466;3.53;0.22;384.92;17.62;1359;47;4301.00;374
10737;37;620765160;10737;629;12095;12469;3.54;0.22;384.88;17.62;1358;47;4302.00;374
10737;37;620765178;10737;627;12095;12469;3.57;0.22;384.88;17.62;1358;47;4303.00;374
10738;37;620765194;10738;630;12096;12469;3.58;0.22;384.91;17.70;1358;47;4304.00;373
10740;37;620765211;10740;635;12096;12469;3.56;0.22;384.88;17.70;1356;47;4305.00;373
10745;37;620765228;10745;611;12100;12473;3.56;0.22;384.82;17.70;1355;47;4306.00;373
10747;37;620765246;10747;603;12100;12473;3.61;0.22;384.88;17.70;1353;47;4307.00;373
10751;37;620765264;10751;587;12100;12473;3.67;0.22;384.80;17.70;1349;47;4308.00;373
10753;37;620765281;10753;586;12100;12473;3.74;0.23;384.75;17.70;1347;47;4309.00;373
10755;37;620765299;10755;576;12100;12474;3.83;0.23;384.69;17.70;1345;47;4310.00;374
10758;37;620765316;10758;573;12101;12475;3.89;0.24;384.63;17.70;1343;47;4311.00;374
10758;37;620765335;10758;580;12101;12475;3.96;0.24;384.63;17.70;1343;47;4312.00;374
10758;37;620765352;10758;571;12102;12476;4.04;0.25;384.63;17.69;1344;47;4313.00;374
10760;37;620765369;10760;575;12103;12476;4.07;0.25;384.60;17.78;1343;47;4314.00;373
10761;37;620765387;10761;570;12103;12476;4.16;0.25;384.57;17.78;1342;47;4315.00;373
10761;37;620765404;10761;571;12103;12476;4.21;0.26;384.57;17.78;1342;47;4316.00;373
10761;37;620765421;10761;576;12103;12476;4.22;0.26;384.57;17.78;1342;47;4317.00;373
10763;37;620765442;10763;571;12103;12476;4.26;0.26;384.67;17.78;1340;47;4318.00;373
10763;37;620765471;10763;572;12103;12476;4.29;0.26;384.67;17.78;1340;47;4319.00;373
10764;37;620765504;10764;621;12219;12706;4.62;0.29;384.73;17.61;1455;47;4320.00;487
10765;37;620765555;10765;608;12223;12707;4.65;0.29;384.71;17.61;1458;47;4321.00;484
10765;37;620765574;10765;601;12234;12707;4.74;0.30;384.71;17.59;1469;47;4322.00;473
10767;37;620765594;10767;573;12238;12707;4.77;0.30;384.67;17.59;1471;47;4323.00;469
10768;37;620765614;10768;565;12246;12707;4.77;0.30;384.70;17.58;1478;47;4324.00;461
10770;37;620765644;10770;551;12250;12707;4.76;0.30;384.70;17.58;1480;47;4325.00;457
10773;37;620765668;10773;549;12257;12707;4.78;0.30;384.68;17.57;1484;47;4326.00;450
10774;37;620765690;10774;547;12262;12707;4.80;0.30;384.72;17.56;1488;47;4327.00;445
10776;37;620765712;10776;542;12266;12708;4.80;0.30;384.71;17.56;1490;47;4328.00;442
10776;37;620765734;10776;542;12270;12709;4.76;0.29;384.71;17.56;1494;47;4329.00;439
10781;37;620765763;10781;543;12274;12709;4.70;0.29;384.78;17.56;1493;47;4330.00;435
10782;37;620765785;10782;557;12277;12710;4.69;0.29;384.83;17.55;1495;47;4331.00;433
10782;37;620765807;10782;561;12279;12710;4.67;0.29;384.83;17.55;1497;47;4332.00;431
10783;37;620765829;10783;563;12281;12710;4.67;0.29;384.84;17.55;1498;47;4333.00;429
10784;37;620765852;10784;571;12283;12710;4.67;0.29;384.85;17.55;1499;47;4334.00;427
10784;37;620765874;10784;572;12285;12714;4.69;0.29;384.85;17.55;1501;47;4335.00;429
10785;37;620765897;10785;584;12285;12714;4.69;0.29;384.84;17.55;1500;47;4336.00;429
10785;37;620765919;10785;587;12287;12714;4.66;0.29;384.84;17.55;1502;47;4337.00;427
10785;37;620765942;10785;591;12289;12717;4.61;0.28;384.84;17.55;1504;47;4338.00;428
10785;37;620765964;10785;593;12289;12717;4.59;0.28;384.84;17.55;1504;47;4339.00;428
10787;37;620765986;10787;583;12289;12717;4.59;0.28;384.82;17.55;1502;47;4340.00;428
10789;37;620766007;10789;576;12292;12721;4.62;0.28;384.83;17.54;1503;47;4341.00;429
10789;37;620766036;10789;571;12293;12722;4.68;0.29;384.83;17.54;1504;47;4342.00;429
10790;37;620766058;10790;570;12293;12722;4.72;0.29;384.87;17.54;1503;47;4343.00;429
10791;37;620766079;10791;566;12294;12726;4.79;0.29;384.86;17.54;1503;47;4344.00;432
10795;37;620766101;10795;557;12295;12726;4.81;0.29;384.96;17.54;1500;47;4345.00;431
10798;37;620766122;10798;551;12296;12726;4.83;0.29;384.91;17.54;1498;47;4346.00;430
10799;37;620766153;10799;548;12296;12727;4.85;0.30;384.90;17.54;1497;47;4347.00;431
10803;37;620766175;10803;539;12296;12727;4.85;0.30;384.94;17.54;1493;47;4348.00;431
10805;37;620766196;10805;538;12301;12733;4.85;0.30;384.95;17.54;1496;47;4349.00;432
10806;37;620766220;10806;534;12301;12733;4.86;0.30;385.05;17.54;1495;47;4350.00;432
10808;37;620766241;10808;532;12302;12734;4.83;0.29;385.06;17.54;1494;47;4351.00;432
10811;37;620766262;10811;522;12303;12734;4.79;0.29;385.11;17.54;1492;47;4352.00;431
10814;37;620766283;10814;518;12306;12734;4.75;0.29;385.17;17.54;1492;47;4353.00;428
10817;37;620766304;10817;510;12306;12734;4.72;0.29;385.20;17.54;1489;47;4354.00;428
10822;37;620766325;10822;503;12311;12734;4.68;0.29;385.30;17.73;1489;47;4355.00;423
10826;37;620766350;10826;504;12322;12746;4.73;0.29;385.28;17.72;1496;47;4356.00;424
10827;37;620766373;10827;507;12322;12746;4.74;0.29;385.27;17.72;1495;47;4357.00;424
10829;37;620766395;10829;503;12324;12746;4.76;0.29;385.28;17.72;1495;47;4358.00;422
10832;37;620766415;10832;493;12325;12746;4.76;0.29;385.27;17.72;1493;47;4359.00;421
10833;37;620766439;10833;499;12325;12746;4.75;0.29;385.25;17.72;1492;47;4360.00;421
10835;37;620766461;10835;499;12326;12746;4.78;0.29;385.26;17.72;1491;47;4361.00;420
10840;37;620766483;10840;496;12329;12750;4.74;0.29;385.23;17.71;1489;47;4362.00;421
10841;37;620766503;10841;498;12329;12750;4.78;0.29;385.29;17.71;1488;47;4363.00;421
10844;37;620766521;10844;503;12332;12754;4.82;0.29;385.29;17.71;1488;47;4364.00;422
10846;37;620766539;10846;500;12334;12756;4.83;0.29;385.27;17.71;1488;47;4365.00;422
10848;37;620766557;10848;510;12334;12756;4.79;0.29;385.24;17.71;1486;47;4366.00;422
10851;37;620766574;10851;507;12335;12756;4.72;0.29;385.32;17.71;1484;47;4367.00;421
10852;37;620766591;10852;518;12345;12769;4.72;0.29;385.31;17.70;1493;47;4368.00;424
10854;37;620766611;10854;508;12346;12769;4.69;0.28;385.32;17.70;1492;47;4369.00;423
10854;37;620766630;10854;508;12347;12769;4.67;0.28;385.32;17.70;1493;47;4370.00;422
10855;37;620766649;10855;513;12351;12770;4.68;0.28;385.30;17.70;1496;47;4371.00;419
10856;37;620766668;10856;520;12351;12771;4.65;0.28;385.36;17.70;1495;47;4372.00;420
10857;37;620766687;10857;516;12352;12771;4.67;0.28;385.40;17.71;1495;47;4373.00;419
10859;37;620766707;10859;514;12354;12774;4.71;0.29;385.42;17.70;1495;47;4374.00;420
10862;37;620766726;10862;516;12355;12774;4.72;0.29;385.44;17.71;1493;47;4375.00;419
10863;37;620766745;10863;521;12356;12774;4.74;0.29;385.44;17.71;1493;47;4376.00;418
10866;37;620766764;10866;528;12357;12774;4.74;0.29;385.51;17.71;1491;47;4377.00;417
10868;37;620766783;10868;536;12363;12780;4.76;0.29;385.50;17.70;1495;47;4378.00;417
10869;37;620766802;10869;538;12363;12780;4.74;0.29;385.53;17.70;1494;47;4379.00;417
10872;37;620766823;10872;544;12366;12780;4.72;0.29;385.53;17.72;1494;47;4380.00;414
10876;37;620766844;10876;547;12368;12780;4.69;0.28;385.49;17.81;1492;47;4381.00;412
10878;37;620766864;10878;560;12371;12784;4.65;0.28;385.51;17.81;1493;47;4382.00;413
10881;37;620766884;10881;564;12373;12785;4.65;0.28;385.63;17.90;1492;47;4383.00;412
10881;37;620766902;10881;565;12374;12785;4.65;0.28;385.63;17.90;1493;47;4384.00;411
10882;37;620766921;10882;571;12376;12786;4.68;0.28;385.67;17.90;1494;47;4385.00;410
10884;37;620766940;10884;570;12376;12786;4.70;0.29;385.76;17.90;1492;47;4386.00;410
10887;37;620766959;10887;572;12377;12786;4.69;0.29;385.70;18.00;1490;47;4387.00;409
10891;37;620766978;10891;577;12379;12786;4.65;0.28;385.73;18.09;1488;47;4388.00;407
10893;37;620766997;10893;577;12380;12786;4.60;0.28;385.85;18.19;1487;47;4389.00;406
10894;37;620767017;10894;588;12380;12786;4.59;0.28;385.85;18.19;1486;47;4390.00;406
10895;37;620767038;10895;593;12382;12786;4.59;0.28;385.88;18.37;1487;47;4391.00;404
10897;37;620767058;10897;601;12417;12856;4.70;0.29;385.97;18.32;1520;47;4392.00;439
10898;37;620767081;10898;596;12420;12857;4.71;0.29;385.96;18.32;1522;47;4393.00;437
10900;37;620767101;10900;595;12427;12857;4.68;0.29;386.10;18.50;1527;47;4394.00;430
10902;37;620767120;10902;594;12429;12857;4.64;0.28;386.21;18.49;1527;47;4395.00;428
10902;37;620767139;10902;595;12433;12857;4.66;0.28;386.21;18.49;1531;47;4396.00;424
10905;37;620767157;10905;601;12438;12857;4.61;0.28;386.36;18.67;1533;47;4397.00;419
10909;37;620767176;10909;607;12442;12857;4.58;0.28;386.46;18.66;1533;47;4398.00;415
10909;37;620767195;10909;607;12446;12857;4.56;0.28;386.46;18.85;1537;47;4399.00;411
10913;37;620767215;10913;598;12449;12858;4.57;0.28;386.56;18.84;1536;47;4400.00;409
10915;37;620767241;10915;598;12450;12859;4.56;0.28;386.49;18.84;1535;47;4401.00;409
10916;37;620767263;10916;595;12451;12859;4.59;0.28;386.58;18.84;1535;47;4402.00;408
10917;37;620767284;10917;591;12454;12863;4.60;0.28;386.62;18.84;1537;47;4403.00;409
10920;37;620767309;10920;596;12457;12863;4.57;0.28;386.78;19.02;1537;47;4404.00;406
10920;37;620767328;10920;601;12457;12863;4.61;0.28;386.78;19.02;1537;47;4405.00;406
10925;37;620767353;10925;607;12457;12863;4.60;0.28;386.85;19.02;1532;47;4406.00;406
10930;37;620767374;10930;611;12462;12869;4.67;0.29;386.89;19.01;1532;47;4407.00;407
10931;37;620767401;10931;612;12462;12869;4.72;0.29;386.96;19.01;1531;47;4408.00;407
10936;37;620767426;10936;617;12462;12869;4.69;0.29;387.06;19.01;1526;47;4409.00;407
10938;37;620767453;10938;620;12465;12875;4.68;0.29;387.03;19.01;1527;47;4410.00;410
10939;37;620767483;10939;618;12465;12875;4.69;0.29;387.09;19.01;1526;47;4411.00;410
10944;37;620767510;10944;621;12466;12875;4.65;0.28;387.17;19.01;1522;47;4412.00;409
10949;37;620767537;10949;629;12466;12876;4.58;0.28;387.21;19.01;1517;47;4413.00;410
10955;37;620767564;10955;623;12467;12877;4.52;0.28;387.31;19.01;1512;47;4414.00;410
10957;37;620767589;10957;629;12467;12877;4.49;0.27;387.36;19.01;1510;47;4415.00;410
10964;37;620767615;10964;636;12477;12890;4.43;0.27;387.49;18.99;1513;47;4416.00;413
10968;37;620767640;10968;636;12477;12890;4.37;0.27;387.50;18.99;1509;47;4417.00;413
10972;37;620767667;10972;643;12478;12890;4.32;0.26;387.59;18.99;1506;47;4418.00;412
10977;37;620767691;10977;650;12478;12891;4.26;0.26;387.72;18.99;1501;47;4419.00;413
10982;37;620767711;10982;644;12478;12891;4.20;0.26;387.84;18.99;1496;47;4420.00;413
10985;37;620767732;10985;640;12481;12895;4.19;0.26;387.92;18.99;1496;47;4421.00;414
10990;37;620767754;10990;640;12481;12895;4.18;0.26;388.00;18.99;1491;47;4422.00;414
10992;37;620767776;10992;647;12484;12899;4.19;0.26;388.02;18.99;1492;47;4423.00;415
11000;37;620767799;11000;641;12485;12899;4.18;0.26;388.01;18.99;1485;47;4424.00;414
11007;37;620767822;11007;638;12485;12899;4.15;0.25;388.17;18.99;1478;47;4425.00;414
11010;37;620767843;11010;632;12486;12899;4.13;0.25;388.23;18.99;1476;47;4426.00;413
11015;37;620767865;11015;634;12486;12899;4.10;0.25;388.17;18.99;1471;47;4427.00;413
11017;37;620767885;11017;640;12496;12911;4.18;0.26;388.21;18.97;1479;47;4428.00;415
11021;37;620767907;11021;633;12496;12911;4.16;0.25;388.27;18.97;1475;47;4429.00;415
11027;37;620767927;11027;635;12496;12911;4.12;0.25;388.36;18.97;1469;47;4430.00;415
11030;37;620767948;11030;631;12496;12911;4.12;0.25;388.32;18.97;1466;47;4431.00;415
11032;37;620767970;11032;636;12496;12911;4.10;0.25;388.41;18.97;1464;47;4432.00;415
11035;37;620767999;11035;638;12496;12911;4.11;0.25;388.47;18.97;1461;47;4433.00;415
11039;37;620768020;11039;634;12496;12912;4.12;0.25;388.54;18.97;1457;47;4434.00;416
11042;37;620768041;11042;637;12496;12912;4.18;0.25;388.58;18.97;1454;47;4435.00;416
11044;37;620768064;11044;646;12500;12918;4.19;0.26;388.64;18.97;1456;47;4436.00;418
11049;37;620768097;11049;645;12500;12919;4.17;0.25;388.63;18.97;1451;47;4437.00;419
11052;37;620768118;11052;654;12500;12919;4.16;0.25;388.62;18.97;1448;47;4438.00;419
11059;37;620768139;11059;657;12500;12919;4.10;0.25;388.77;18.97;1441;47;4439.00;419
11063;37;620768162;11063;661;12504;12924;4.08;0.25;388.87;18.96;1441;47;4440.00;420
11070;37;620768184;11070;661;12504;12924;4.04;0.25;388.96;18.96;1434;47;4441.00;420
11074;37;620768205;11074;668;12504;12924;4.03;0.25;389.04;18.96;1430;47;4442.00;420
11076;37;620768227;11076;667;12505;12925;3.99;0.24;389.07;18.96;1429;47;4443.00;420
11081;37;620768248;11081;673;12508;12929;3.93;0.24;389.16;18.95;1427;47;4444.00;421
11087;37;620768271;11087;677;12509;12929;3.87;0.24;389.12;18.96;1422;47;4445.00;420
11091;37;620768291;11091;684;12510;12932;3.85;0.23;389.09;18.95;1419;47;4446.00;422
11095;37;620768313;11095;686;12511;12932;3.82;0.23;389.11;18.96;1416;47;4447.00;421
11097;37;620768334;11097;690;12511;12932;3.81;0.23;389.13;18.96;1414;47;4448.00;421
11098;37;620768355;11098;687;12511;12932;3.82;0.23;389.13;18.96;1413;47;4449.00;421
11101;37;620768378;11101;685;12514;12936;3.80;0.23;389.11;18.95;1413;47;4450.00;422
11106;37;620768401;11106;694;12514;12936;3.72;0.23;389.08;18.95;1408;47;4451.00;422
11109;37;620768423;11109;688;12516;12936;3.68;0.23;389.15;18.95;1407;47;4452.00;420
11113;37;620768446;11113;696;12516;12936;3.65;0.22;389.13;18.95;1403;47;4453.00;420
11115;37;620768470;11115;681;12517;12937;3.59;0.22;389.09;18.95;1402;47;4454.00;420
11118;37;620768490;11118;685;12519;12939;3.58;0.22;389.18;18.95;1401;47;4455.00;420
11125;37;620768509;11125;686;12519;12939;3.56;0.22;389.18;18.95;1394;47;4456.00;420
11127;37;620768527;11127;688;12520;12940;3.56;0.22;389.20;18.95;1393;47;4457.00;420
11128;37;620768546;11128;686;12521;12940;3.55;0.22;389.17;18.95;1393;47;4458.00;419
11132;37;620768567;11132;693;12524;12940;3.56;0.22;389.22;18.95;1392;47;4459.00;416
11135;37;620768588;11135;697;12525;12940;3.55;0.22;389.18;18.95;1390;47;4460.00;415
11138;37;620768608;11138;700;12526;12940;3.52;0.21;389.13;18.95;1388;47;4461.00;414
11140;37;620768628;11140;690;12526;12940;3.53;0.21;389.14;18.95;1386;47;4462.00;414
11141;37;620768646;11141;693;12527;12940;3.54;0.22;389.12;18.95;1386;47;4463.00;413
11144;37;620768663;11144;709;12594;13067;3.83;0.24;389.07;18.85;1450;47;4464.00;473
11149;37;620768697;11149;708;12599;13068;3.80;0.24;389.09;18.84;1450;47;4465.00;469
11151;37;620768716;11151;700;12607;13068;3.81;0.24;389.03;18.83;1456;47;4466.00;461
11154;37;620768734;11154;687;12610;13068;3.82;0.24;389.05;18.83;1456;47;4467.00;458
11157;37;620768752;11157;684;12616;13068;3.85;0.24;389.01;18.82;1459;47;4468.00;452
11159;37;620768770;11159;683;12619;13068;3.89;0.24;388.99;18.82;1460;47;4469.00;449
11163;37;620768791;11163;688;12621;13068;3.86;0.24;389.00;18.91;1458;47;4470.00;447
11164;37;620768812;11164;688;12624;13068;3.88;0.24;389.00;18.91;1460;47;4471.00;444
11165;37;620768835;11165;688;12627;13069;3.89;0.24;389.00;18.91;1462;47;4472.00;442
11167;37;620768855;11167;685;12630;13070;3.82;0.24;388.98;18.91;1463;47;4473.00;440
11170;37;620768874;11170;692;12632;13070;3.77;0.23;389.14;18.91;1462;47;4474.00;438
11172;37;620768892;11172;681;12635;13071;3.73;0.23;389.22;18.90;1463;47;4475.00;436
11173;37;620768912;11173;660;12638;13071;3.71;0.23;389.20;18.90;1465;47;4476.00;433
11175;37;620768931;11175;655;12640;13071;3.69;0.23;389.32;18.90;1465;47;4477.00;431
11175;37;620768957;11175;647;12641;13071;3.76;0.23;389.32;18.90;1466;47;4478.00;430
11176;37;620768975;11176;638;12646;13075;3.84;0.24;389.29;18.89;1470;47;4479.00;429
11176;37;620768995;11176;631;12646;13075;3.93;0.24;389.29;18.89;1470;47;4480.00;429
11177;37;620769015;11177;613;12646;13075;4.02;0.25;389.32;18.89;1469;47;4481.00;429
11178;37;620769036;11178;607;12649;13078;4.14;0.25;389.30;18.89;1471;47;4482.00;429
11179;37;620769055;11179;601;12650;13078;4.28;0.26;389.30;18.89;1471;47;4483.00;428
11181;37;620769081;11181;598;12652;13078;4.33;0.27;389.29;18.99;1471;47;4484.00;426
11181;37;620769101;11181;598;12656;13082;4.42;0.27;389.29;18.98;1475;47;4485.00;426
11183;37;620769122;11183;588;12658;13083;4.47;0.27;389.29;18.98;1475;47;4486.00;425
11183;37;620769143;11183;588;12658;13083;4.56;0.28;389.29;18.98;1475;48;4487.00;425
11187;37;620769178;11187;592;12661;13087;4.59;0.28;389.29;19.08;1474;48;4488.00;426
11187;37;620769198;11187;590;12663;13087;4.63;0.28;389.29;19.08;1476;48;4489.00;424
11190;37;620769222;11190;591;12664;13087;4.68;0.29;389.23;19.07;1474;48;4490.00;423
11190;37;620769242;11190;586;12665;13088;4.73;0.29;389.23;19.07;1475;48;4491.00;423
11191;37;620769263;11191;591;12665;13088;4.72;0.29;389.22;19.07;1474;48;4492.00;423
11192;37;620769284;11192;585;12670;13094;4.75;0.29;389.26;19.07;1478;48;4493.00;424
11193;37;620769306;11193;584;12670;13094;4.77;0.29;389.24;19.07;1477;48;4494.00;424
11194;37;620769326;11194;591;12670;13095;4.80;0.29;389.33;19.07;1476;48;4495.00;425
11198;37;620769346;11198;589;12671;13095;4.82;0.29;389.41;19.16;1473;48;4496.00;424
11202;37;620769367;11202;587;12671;13095;4.82;0.29;389.42;19.16;1469;48;4497.00;424
11204;37;620769388;11204;586;12671;13095;4.81;0.29;389.39;19.16;1467;48;4498.00;424
11207;37;620769410;11207;580;12671;13095;4.81;0.29;389.63;19.16;1464;48;4499.00;424
11209;37;620769434;11209;584;12696;13145;4.86;0.30;389.80;19.13;1487;48;4500.00;449
11212;37;620769480;11212;564;12696;13147;4.87;0.30;389.81;19.13;1484;48;4501.00;451
11214;37;620769509;11214;568;12701;13147;4.92;0.30;389.87;19.12;1487;48;4502.00;446
11216;37;620769535;11216;569;12701;13147;4.96;0.30;389.98;19.12;1485;48;4503.00;446
11220;37;620769561;11220;561;12703;13147;4.97;0.30;389.99;19.12;1483;48;4504.00;444
11222;37;620769595;11222;559;12703;13147;4.99;0.30;390.14;19.12;1481;48;4505.00;444
11224;37;620769619;11224;555;12706;13151;5.04;0.31;390.26;19.11;1482;48;4506.00;445
11227;37;620769643;11227;560;12707;13151;5.07;0.31;390.28;19.11;1480;48;4507.00;444
11230;37;620769667;11230;554;12711;13155;5.16;0.31;390.26;19.11;1481;48;4508.00;444
11233;37;620769691;11233;563;12713;13156;5.19;0.32;390.37;19.10;1480;48;4509.00;443
11239;37;620769715;11239;547;12713;13156;5.16;0.31;390.55;19.10;1474;48;4510.00;443
11240;37;620769739;11240;545;12713;13156;5.19;0.32;390.55;19.10;1473;48;4511.00;443
11243;37;620769764;11243;550;12724;13169;5.23;0.32;390.55;19.09;1481;48;4512.00;445
11250;37;620769790;11250;539;12726;13169;5.23;0.32;390.65;19.19;1476;48;4513.00;443
11252;37;620769814;11252;536;12726;13169;5.24;0.32;390.71;19.19;1474;48;4514.00;443
11254;37;620769838;11254;540;12727;13170;5.25;0.32;390.82;19.18;1473;48;4515.00;443
11260;37;620769863;11260;540;12727;13171;5.26;0.32;390.91;19.18;1467;48;4516.00;444
11261;37;620769889;11261;540;12727;13171;5.26;0.32;390.89;19.18;1466;48;4517.00;444
11265;37;620769912;11265;549;12731;13174;5.26;0.32;390.86;19.18;1466;48;4518.00;443
11269;37;620769936;11269;545;12732;13174;5.24;0.32;390.94;19.18;1463;48;4519.00;442
11272;37;620769959;11272;534;12732;13174;5.18;0.31;390.92;19.18;1460;48;4520.00;442
11274;37;620769982;11274;544;12732;13174;5.14;0.31;390.93;19.18;1458;48;4521.00;442
11277;37;620770005;11277;534;12736;13180;5.12;0.31;390.91;19.17;1459;48;4522.00;444
11278;37;620770028;11278;529;12737;13180;5.07;0.31;390.94;19.17;1459;48;4523.00;443
11280;37;620770050;11280;525;12737;13180;5.06;0.31;390.94;19.17;1457;48;4524.00;443
11281;37;620770083;11281;532;12738;13180;5.08;0.31;390.94;19.17;1457;48;4525.00;442
11282;37;620770110;11282;534;12741;13184;5.05;0.31;390.93;19.17;1459;48;4526.00;443
11286;37;620770137;11286;533;12742;13185;5.01;0.30;390.98;19.17;1456;48;4527.00;443
11287;37;620770160;11287;539;12743;13185;5.02;0.31;390.98;19.17;1456;48;4528.00;442
11290;37;620770181;11290;543;12744;13186;5.02;0.31;390.98;19.17;1454;48;4529.00;442
11298;37;620770204;11298;539;12744;13186;4.96;0.30;390.95;19.17;1446;48;4530.00;442
11300;37;620770225;11300;542;12745;13186;4.94;0.30;391.02;19.17;1445;48;4531.00;441
11304;37;620770246;11304;550;12745;13186;4.89;0.30;390.96;19.17;1441;48;4532.00;441
11309;37;620770267;11309;550;12746;13186;4.83;0.29;390.88;19.17;1437;48;4533.00;440
11312;37;620770287;11312;556;12746;13186;4.76;0.29;391.09;19.17;1434;48;4534.00;440
11313;37;620770318;11313;552;12746;13186;4.76;0.29;391.12;19.17;1433;48;4535.00;440
11317;37;620770339;11317;564;12792;13256;4.74;0.29;391.15;19.11;1475;48;4536.00;464
11321;37;620770369;11321;555;12794;13257;4.73;0.29;391.10;19.10;1473;48;4537.00;463
11324;37;620770390;11324;548;12797;13257;4.74;0.29;391.14;19.10;1473;48;4538.00;460
11325;37;620770411;11325;558;12801;13257;4.77;0.29;391.17;19.10;1476;48;4539.00;456
11326;37;620770432;11326;561;12803;13257;4.79;0.29;391.19;19.09;1477;48;4540.00;454
11330;37;620770455;11330;564;12806;13257;4.79;0.29;391.26;19.09;1476;48;4541.00;451
11334;37;620770476;11334;566;12810;13257;4.83;0.29;391.27;19.09;1476;48;4542.00;447
11338;37;620770497;11338;561;12811;13257;4.85;0.30;391.34;19.09;1473;48;4543.00;446
11342;37;620770516;11342;564;12813;13258;4.85;0.30;391.40;19.09;1471;48;4544.00;445
11344;37;620770534;11344;562;12816;13260;4.91;0.30;391.42;19.08;1472;48;4545.00;444
11346;37;620770553;11346;567;12817;13260;4.94;0.30;391.48;19.08;1471;48;4546.00;443
11348;37;620770571;11348;575;12820;13264;4.92;0.30;391.45;19.08;1472;48;4547.00;444
11351;37;620770591;11351;571;12820;13264;4.89;0.30;391.51;19.08;1469;48;4548.00;444
11353;37;620770612;11353;575;12820;13264;4.87;0.30;391.52;19.08;1467;48;4549.00;444
11360;37;620770633;11360;581;12820;13264;4.82;0.29;391.80;19.08;1460;48;4550.00;444
11362;37;620770654;11362;587;12824;13270;4.78;0.29;391.86;19.07;1462;48;4551.00;446
11362;37;620770676;11362;589;12824;13270;4.73;0.29;391.86;19.07;1462;48;4552.00;446
11363;37;620770695;11363;592;12824;13270;4.69;0.29;391.88;19.07;1461;48;4553.00;446
11367;37;620770715;11367;599;12825;13273;4.68;0.28;391.98;19.07;1458;48;4554.00;448
11368;37;620770737;11368;605;12825;13273;4.71;0.29;392.01;19.07;1457;48;4555.00;448
11371;37;620770757;11371;613;12825;13273;4.71;0.29;392.00;19.07;1454;48;4556.00;448
11373;37;620770778;11373;617;12825;13274;4.73;0.29;392.13;19.07;1452;48;4557.00;449
11374;37;620770798;11374;620;12826;13275;4.72;0.29;392.23;19.07;1452;48;4558.00;449
11376;37;620770820;11376;618;12826;13275;4.70;0.29;392.25;19.07;1450;48;4559.00;449
11378;37;620770843;11378;622;12843;13301;4.75;0.29;392.32;19.05;1465;48;4560.00;458
11379;37;620770866;11379;625;12843;13301;4.75;0.29;392.36;19.05;1464;48;4561.00;458
11380;37;620770887;11380;623;12846;13301;4.78;0.29;392.33;19.04;1466;48;4562.00;455
11381;37;620770907;11381;623;12847;13302;4.79;0.29;392.38;19.04;1466;48;4563.00;455
11384;37;620770929;11384;627;12847;13302;4.76;0.29;392.53;19.04;1463;48;4564.00;455
11384;37;620770949;11384;630;12850;13306;4.75;0.29;392.53;19.04;1466;48;4565.00;456
11388;37;620770970;11388;629;12850;13306;4.66;0.28;392.53;19.04;1462;48;4566.00;456
11390;37;620770990;11390;633;12852;13310;4.59;0.28;392.60;19.03;1462;48;4567.00;458
11393;37;620771009;11393;633;12852;13310;4.52;0.28;392.63;19.03;1459;48;4568.00;458
11397;37;620771029;11397;632;12852;13310;4.46;0.27;392.73;19.03;1455;48;4569.00;458
11398;37;620771048;11398;627;12852;13310;4.41;0.27;392.74;19.03;1454;48;4570.00;458
11402;37;620771066;11402;626;12852;13310;4.35;0.27;392.74;19.03;1450;48;4571.00;458
11405;37;620771085;11405;618;12861;13322;4.35;0.27;392.80;19.02;1456;48;4572.00;461
11407;37;620771123;11407;620;12862;13322;4.32;0.26;392.89;19.02;1455;48;4573.00;460
11409;37;620771142;11409;621;12862;13322;4.29;0.26;393.03;19.02;1453;48;4574.00;460
11414;37;620771159;11414;617;12862;13322;4.24;0.26;393.10;19.02;1448;48;4575.00;460
11415;37;620771177;11415;628;12862;13322;4.23;0.26;393.15;19.02;1447;48;4576.00;460
11416;37;620771194;11416;628;12862;13322;4.23;0.26;393.18;19.02;1446;48;4577.00;460
11417;37;620771211;11417;630;12862;13323;4.25;0.26;393.24;19.02;1445;48;4578.00;461
11421;37;620771228;11421;634;12862;13323;4.26;0.26;393.26;19.02;1441;48;4579.00;461
11424;37;620771245;11424;644;12866;13329;4.28;0.26;393.34;19.01;1442;48;4580.00;463
11426;37;620771266;11426;639;12866;13330;4.24;0.26;393.48;19.01;1440;48;4581.00;464
11427;37;620771283;11427;643;12866;13330;4.21;0.26;393.45;19.01;1439;48;4582.00;464
11431;37;620771300;11431;647;12866;13330;4.15;0.25;393.55;19.01;1435;48;4583.00;464
11437;37;620771317;11437;656;12869;13334;4.10;0.25;393.43;19.01;1432;48;4584.00;465
11442;37;620771334;11442;661;12869;13334;4.02;0.25;393.58;19.01;1427;48;4585.00;465
11443;37;620771351;11443;666;12869;13334;3.94;0.24;393.59;19.01;1426;48;4586.00;465
11446;37;620771367;11446;677;12870;13335;3.85;0.24;393.59;19.01;1424;48;4587.00;465
11450;37;620771383;11450;668;12873;13339;3.75;0.23;393.57;19.00;1423;48;4588.00;466
11456;37;620771399;11456;682;12873;13339;3.64;0.22;393.68;19.00;1417;48;4589.00;466
11459;37;620771417;11459;671;12877;13345;3.59;0.22;393.77;19.00;1418;48;4590.00;468
11463;37;620771435;11463;669;12877;13345;3.55;0.22;393.91;19.00;1414;48;4591.00;468
11468;37;620771456;11468;665;12877;13345;3.51;0.21;393.87;19.00;1409;48;4592.00;468
11470;37;620771479;11470;664;12877;13345;3.51;0.21;393.88;19.00;1407;48;4593.00;468
11472;37;620771505;11472;648;12880;13349;3.56;0.22;393.89;18.99;1408;48;4594.00;469
11474;37;620771531;11474;647;12880;13349;3.61;0.22;393.90;18.99;1406;48;4595.00;469
11477;37;620771555;11477;645;12880;13349;3.59;0.22;393.89;18.99;1403;48;4596.00;469
11482;37;620771574;11482;644;12880;13349;3.54;0.22;393.85;18.99;1398;48;4597.00;469
11483;37;620771594;11483;636;12880;13350;3.54;0.22;393.84;18.99;1397;48;4598.00;470
11486;37;620771612;11486;638;12880;13351;3.51;0.21;393.89;18.99;1394;48;4599.00;471
11488;37;620771632;11488;636;12880;13351;3.49;0.21;393.87;18.99;1392;48;4600.00;471
11490;37;620771656;11490;633;12881;13352;3.48;0.21;393.83;18.99;1391;48;4601.00;471
11492;37;620771675;11492;635;12881;13352;3.48;0.21;393.80;18.99;1389;48;4602.00;471
11495;37;620771693;11495;626;12881;13352;3.49;0.22;393.75;18.99;1386;48;4603.00;471
11496;37;620771711;11496;622;12881;13352;3.53;0.22;393.78;18.99;1385;48;4604.00;471
11502;37;620771729;11502;625;12881;13352;3.53;0.22;393.67;18.99;1379;48;4605.00;471
11507;37;620771747;11507;630;12881;13352;3.55;0.22;393.56;18.99;1374;48;4606.00;471
11512;37;620771766;11512;627;12881;13352;3.54;0.22;393.55;18.99;1369;48;4607.00;471
11517;37;620771784;11517;621;12939;13479;3.97;0.25;393.57;18.91;1422;48;4608.00;540
11519;37;620771814;11519;624;12943;13480;4.03;0.25;393.51;18.90;1424;48;4609.00;537
11527;37;620771832;11527;618;12949;13480;4.01;0.25;393.39;18.89;1422;48;4610.00;531
11529;37;620771851;11529;618;12954;13480;4.06;0.25;393.39;18.89;1425;48;4611.00;526
11534;37;620771870;11534;612;12957;13480;4.06;0.25;393.43;18.88;1423;48;4612.00;523
11539;37;620771890;11539;608;12959;13480;4.03;0.25;393.44;18.88;1420;48;4613.00;521
11543;37;620771911;11543;602;12962;13480;4.01;0.25;393.39;18.88;1419;48;4614.00;518
11548;37;620771932;11548;603;12964;13480;3.95;0.24;393.30;18.98;1416;48;4615.00;516
11552;37;620771954;11552;596;12966;13481;3.87;0.24;393.29;18.99;1414;48;4616.00;515
11556;37;620771975;11556;596;12967;13482;3.83;0.24;393.28;18.99;1411;48;4617.00;515
11560;37;620771998;11560;599;12968;13482;3.77;0.23;393.24;18.98;1408;48;4618.00;514
11565;37;620772017;11565;607;12971;13483;3.73;0.23;393.25;18.98;1406;48;4619.00;512
11569;37;620772037;11569;611;12973;13483;3.67;0.23;393.26;18.98;1404;48;4620.00;510
11571;37;620772056;11571;610;12974;13483;3.66;0.23;393.24;18.98;1403;48;4621.00;509
11577;37;620772074;11577;611;12977;13483;3.59;0.22;393.21;18.99;1400;48;4622.00;506
11580;37;620772092;11580;618;12980;13487;3.56;0.22;393.25;18.99;1400;48;4623.00;507
11580;37;620772111;11580;617;12981;13487;3.58;0.22;393.25;18.99;1401;48;4624.00;506
11584;37;620772130;11584;627;12983;13487;3.55;0.22;393.26;19.00;1399;48;4625.00;504
11588;37;620772148;11588;628;12986;13490;3.49;0.22;393.23;19.00;1398;48;4626.00;504
11589;37;620772167;11589;615;12987;13490;3.50;0.22;393.24;19.00;1398;48;4627.00;503
11591;37;620772192;11591;608;12990;13490;3.51;0.22;393.22;19.01;1399;48;4628.00;500
11592;37;620772211;11592;599;12992;13494;3.50;0.22;393.23;19.01;1400;48;4629.00;502
11593;37;620772229;11593;601;12995;13495;3.56;0.22;393.23;19.11;1402;48;4630.00;500
11596;37;620772248;11596;596;12996;13495;3.62;0.22;393.17;19.11;1400;48;4631.00;499
11598;38;620772266;11598;592;12998;13499;3.68;0.23;393.11;19.11;1400;49;4632.00;501
11601;38;620772298;11601;583;13002;13499;3.72;0.23;393.17;19.11;1401;49;4633.00;497
11603;38;620772317;11603;586;13002;13499;3.76;0.23;393.19;19.11;1399;49;4634.00;497
11605;38;620772337;11605;589;13006;13501;3.80;0.23;393.20;19.22;1401;49;4635.00;495
11607;38;620772364;11607;582;13007;13501;3.80;0.23;393.23;19.22;1400;49;4636.00;494
11611;38;620772383;11611;570;13011;13507;3.82;0.23;393.24;19.22;1400;49;4637.00;496
11614;38;620772407;11614;561;13012;13507;3.84;0.24;393.29;19.22;1398;49;4638.00;495
11618;38;620772426;11618;555;13013;13508;3.87;0.24;393.31;19.22;1395;49;4639.00;495
11621;38;620772448;11621;555;13013;13508;3.88;0.24;393.30;19.22;1392;49;4640.00;495
11624;38;620772469;11624;564;13015;13508;3.91;0.24;393.38;19.22;1391;49;4641.00;493
11629;38;620772489;11629;563;13016;13508;3.90;0.24;393.43;19.23;1387;49;4642.00;492
11632;39;620772508;11632;557;13019;13508;3.93;0.24;393.42;19.33;1387;50;4643.00;489
11636;39;620772532;11636;557;13028;13520;4.02;0.25;393.39;19.32;1392;50;4644.00;492
11639;39;620772553;11639;565;13029;13520;4.04;0.25;393.41;19.32;1390;50;4645.00;491
11643;39;620772578;11643;555;13030;13520;4.07;0.25;393.44;19.32;1387;50;4646.00;490
11644;39;620772598;11644;545;13030;13520;4.13;0.25;393.44;19.32;1386;50;4647.00;490
11645;39;620772615;11645;530;13031;13520;4.22;0.26;393.43;19.32;1386;50;4648.00;489
11648;39;620772633;11648;526;13032;13520;4.28;0.26;393.54;19.33;1384;50;4649.00;488
11652;39;620772652;11652;533;13039;13526;4.35;0.27;393.63;19.32;1387;50;4650.00;487
11656;39;620772670;11656;530;13039;13526;4.42;0.27;393.57;19.32;1383;50;4651.00;487
11658;39;620772689;11658;526;13043;13530;4.51;0.27;393.62;19.32;1385;50;4652.00;487
11660;39;620772708;11660;529;13045;13531;4.57;0.28;393.71;19.32;1385;50;4653.00;486
11663;39;620772726;11663;531;13045;13531;4.60;0.28;393.85;19.32;1382;50;4654.00;486
11664;39;620772744;11664;526;13045;13531;4.59;0.28;393.83;19.32;1381;50;4655.00;486
11666;39;620772761;11666;534;13057;13544;4.65;0.28;393.98;19.31;1391;50;4656.00;487
11669;39;620772780;11669;534;13057;13544;4.65;0.28;394.02;19.31;1388;50;4657.00;487
11670;39;620772799;11670;528;13058;13544;4.73;0.29;394.04;19.32;1388;50;4658.00;486
11672;39;620772817;11672;527;13060;13545;4.82;0.29;394.05;19.31;1388;50;4659.00;485
11674;39;620772835;11674;524;13061;13546;4.88;0.30;394.23;19.32;1387;50;4660.00;485
11676;39;620772853;11676;515;13062;13546;4.90;0.30;394.25;19.42;1386;50;4661.00;484
11677;39;620772871;11677;513;13063;13549;4.92;0.30;394.34;19.42;1386;50;4662.00;486
11680;39;620772889;11680;515;13065;13549;4.93;0.30;394.44;19.43;1385;50;4663.00;484
11680;39;620772907;11680;527;13065;13549;4.94;0.30;394.44;19.43;1385;50;4664.00;484
11685;39;620772926;11685;527;13067;13549;4.96;0.30;394.48;19.53;1382;50;4665.00;482
11688;39;620772944;11688;522;13072;13555;4.99;0.30;394.57;19.53;1384;50;4666.00;483
11692;39;620772963;11692;526;13073;13555;4.99;0.30;394.55;19.53;1381;50;4667.00;482
11694;39;620772981;11694;533;13074;13555;4.96;0.30;394.65;19.53;1380;50;4668.00;481
11697;39;620773000;11697;537;13075;13555;4.96;0.30;394.70;19.54;1378;50;4669.00;480
11700;39;620773019;11700;532;13079;13559;4.94;0.30;394.86;19.54;1379;50;4670.00;480
11705;39;620773037;11705;541;13079;13560;4.94;0.30;394.83;19.54;1374;50;4671.00;481
11708;39;620773056;11708;541;13081;13560;4.92;0.30;394.87;19.54;1373;50;4672.00;479
11711;39;620773074;11711;547;13082;13561;4.96;0.30;394.88;19.54;1371;50;4673.00;479
11713;39;620773092;11713;550;13084;13561;4.97;0.30;394.95;19.64;1371;50;4674.00;477
11714;39;620773110;11714;556;13085;13561;5.00;0.30;394.94;19.64;1371;50;4675.00;476
11716;39;620773129;11716;565;13085;13561;4.99;0.30;394.94;19.64;1369;50;4676.00;476
11717;39;620773147;11717;565;13087;13561;4.97;0.30;394.94;19.64;1370;50;4677.00;474
11719;39;620773164;11719;563;13089;13561;4.92;0.30;394.94;19.86;1370;51;4678.00;472
11721;39;620773194;11721;562;13089;13561;4.88;0.30;394.94;19.86;1368;51;4679.00;472
11723;39;620773214;11723;588;13157;13686;4.85;0.30;394.97;19.76;1434;51;4680.00;529
11726;39;620773244;11726;575;13157;13687;4.86;0.30;395.01;19.76;1431;51;4681.00;530
11728;39;620773262;11728;557;13162;13687;4.92;0.30;395.09;19.75;1434;51;4682.00;525
11730;39;620773280;11730;553;13164;13687;4.91;0.30;395.09;19.75;1434;51;4683.00;523
11734;39;620773300;11734;551;13167;13687;4.93;0.30;395.22;19.75;1433;51;4684.00;520
11735;39;620773319;11735;548;13168;13687;4.92;0.30;395.22;19.75;1433;51;4685.00;519
11739;39;620773344;11739;553;13171;13687;4.95;0.30;395.39;19.74;1432;52;4686.00;516
11740;39;620773373;11740;551;13174;13687;4.98;0.31;395.40;19.74;1434;52;4687.00;513
11742;39;620773393;11742;551;13178;13688;5.03;0.31;395.42;19.74;1436;52;4688.00;510
11745;39;620773410;11745;549;13180;13689;5.04;0.31;395.42;19.74;1435;52;4689.00;509
11747;39;620773429;11747;544;13183;13689;5.01;0.31;395.42;19.83;1436;52;4690.00;506
11749;39;620773450;11749;545;13188;13693;4.99;0.31;395.46;19.83;1439;52;4691.00;505
11752;39;620773476;11752;537;13190;13693;4.94;0.30;395.47;19.83;1438;52;4692.00;503
11758;39;620773503;11758;538;13192;13693;4.82;0.30;395.60;19.83;1434;52;4693.00;501
11758;39;620773530;11758;539;13192;13693;4.77;0.29;395.60;19.83;1434;52;4694.00;501
11760;39;620773561;11760;544;13196;13699;4.71;0.29;395.67;19.93;1436;53;4695.00;503
11764;39;620773600;11764;543;13197;13699;4.66;0.29;395.77;20.04;1433;53;4696.00;502
11766;39;620773622;11766;544;13199;13699;4.62;0.28;395.76;20.04;1433;53;4697.00;500
11769;39;620773643;11769;539;13201;13702;4.55;0.28;395.75;20.14;1432;53;4698.00;501
11776;39;620773665;11776;539;13201;13702;4.48;0.27;396.00;20.14;1425;53;4699.00;501
11778;39;620773688;11778;538;13201;13702;4.46;0.27;395.96;20.14;1423;53;4700.00;501
11781;39;620773713;11781;537;13201;13703;4.43;0.27;396.08;20.14;1420;53;4701.00;502
11783;39;620773734;11783;535;13202;13704;4.47;0.27;396.07;20.14;1419;53;4702.00;502
11787;39;620773754;11787;535;13202;13704;4.46;0.27;396.06;20.14;1415;53;4703.00;502
11789;39;620773774;11789;538;13211;13717;4.46;0.27;396.03;20.12;1422;53;4704.00;506
11793;39;620773797;11793;532;13211;13717;4.47;0.27;396.00;20.12;1418;53;4705.00;506
11797;39;620773818;11797;540;13211;13717;4.46;0.27;396.03;20.12;1414;53;4706.00;506
11799;39;620773850;11799;545;13212;13718;4.48;0.27;396.05;20.12;1413;53;4707.00;506
11801;39;620773870;11801;548;13214;13718;4.51;0.27;396.08;20.12;1413;53;4708.00;504
11803;39;620773889;11803;542;13217;13722;4.54;0.28;396.23;20.12;1414;53;4709.00;505
11806;39;620773912;11806;548;13217;13722;4.52;0.27;396.18;20.12;1411;53;4710.00;505
11809;39;620773932;11809;556;13220;13726;4.51;0.27;396.32;20.12;1411;53;4711.00;506
11812;39;620773952;11812;556;13220;13726;4.52;0.27;396.48;20.12;1408;53;4712.00;506
11813;39;620773972;11813;558;13220;13726;4.54;0.28;396.49;20.12;1407;53;4713.00;506
11815;39;620773992;11815;561;13222;13726;4.57;0.28;396.60;20.12;1407;53;4714.00;504
11817;39;620774012;11817;564;13222;13726;4.59;0.28;396.58;20.12;1405;53;4715.00;504
11820;39;620774032;11820;572;13230;13738;4.66;0.28;396.70;20.11;1410;53;4716.00;508
11822;39;620774053;11822;580;13231;13738;4.67;0.28;396.86;20.11;1409;53;4717.00;507
11823;39;620774072;11823;581;13231;13738;4.65;0.28;396.88;20.11;1408;53;4718.00;507
11827;39;620774103;11827;590;13231;13738;4.61;0.28;396.87;20.11;1404;53;4719.00;507
11830;39;620774123;11830;589;13231;13738;4.59;0.28;396.89;20.11;1401;53;4720.00;507
11832;39;620774144;11832;589;13231;13738;4.61;0.28;396.94;20.11;1399;53;4721.00;507
11837;39;620774163;11837;599;13231;13739;4.55;0.28;397.09;20.11;1394;53;4722.00;508
11838;39;620774183;11838;596;13233;13739;4.51;0.27;397.11;20.33;1395;53;4723.00;506
11839;39;620774202;11839;596;13237;13745;4.56;0.28;397.15;20.32;1398;53;4724.00;508
11842;39;620774223;11842;604;13237;13747;4.54;0.28;397.25;20.32;1395;53;4725.00;510
11843;39;620774242;11843;599;13237;13747;4.48;0.27;397.35;20.32;1394;53;4726.00;510
11847;39;620774262;11847;606;13237;13747;4.48;0.27;397.40;20.32;1390;53;4727.00;510
11851;39;620774281;11851;605;13240;13751;4.48;0.27;397.56;20.32;1389;53;4728.00;511
11853;39;620774300;11853;609;13240;13751;4.48;0.27;397.55;20.32;1387;53;4729.00;511
11855;39;620774319;11855;604;13240;13751;4.44;0.27;397.76;20.32;1385;53;4730.00;511
11858;39;620774337;11858;614;13241;13752;4.44;0.27;397.85;20.32;1383;53;4731.00;511
11858;39;620774357;11858;617;13242;13756;4.42;0.27;397.85;20.31;1384;53;4732.00;514
11860;39;620774376;11860;624;13242;13756;4.38;0.27;397.86;20.31;1382;53;4733.00;514
11863;39;620774393;11863;617;13243;13759;4.32;0.26;397.83;20.31;1380;53;4734.00;516
11865;39;620774412;11865;622;13243;13759;4.34;0.26;397.87;20.31;1378;53;4735.00;516
11867;39;620774430;11867;619;13243;13759;4.34;0.26;397.87;20.31;1376;53;4736.00;516
11871;39;620774451;11871;620;13243;13759;4.31;0.26;397.88;20.31;1372;53;4737.00;516
11874;39;620774470;11874;621;13246;13763;4.36;0.27;397.89;20.31;1372;53;4738.00;517
11875;39;620774489;11875;614;13246;13763;4.37;0.27;397.93;20.31;1371;53;4739.00;517
11878;39;620774509;11878;612;13246;13763;4.38;0.27;397.99;20.31;1368;53;4740.00;517
11878;39;620774526;11878;613;13246;13763;4.37;0.27;397.99;20.31;1368;53;4741.00;517
11881;39;620774542;11881;609;13246;13764;4.34;0.27;398.11;20.31;1365;53;4742.00;518
11885;39;620774559;11885;610;13246;13765;4.30;0.26;398.11;20.31;1361;53;4743.00;519
11887;39;620774575;11887;619;13246;13765;4.28;0.26;398.18;20.31;1359;53;4744.00;519
11889;39;620774592;11889;617;13247;13766;4.26;0.26;398.20;20.31;1358;53;4745.00;519
11892;39;620774609;11892;617;13247;13766;4.26;0.26;398.18;20.31;1355;53;4746.00;519
11894;39;620774626;11894;620;13247;13766;4.26;0.26;398.13;20.31;1353;53;4747.00;519
11896;39;620774642;11896;615;13247;13766;4.25;0.26;398.08;20.31;1351;53;4748.00;519
11899;39;620774659;11899;615;13247;13766;4.25;0.26;398.14;20.31;1348;53;4749.00;519
11902;39;620774675;11902;614;13247;13766;4.23;0.26;398.12;20.31;1345;53;4750.00;519
11905;39;620774691;11905;614;13247;13766;4.23;0.26;398.10;20.31;1342;53;4751.00;519
11909;39;620774707;11909;626;13305;13893;4.54;0.28;398.10;20.22;1396;53;4752.00;588
11912;39;620774733;11912;624;13309;13894;4.48;0.28;398.14;20.21;1397;53;4753.00;585
11914;39;620774749;11914;622;13317;13894;4.48;0.28;398.14;20.20;1403;53;4754.00;577
11916;39;620774766;11916;625;13321;13894;4.48;0.28;398.14;20.20;1405;53;4755.00;573
11921;39;620774783;11921;620;13325;13894;4.40;0.27;398.20;20.20;1404;53;4756.00;569
11922;39;620774800;11922;618;13327;13894;4.32;0.27;398.17;20.19;1405;53;4757.00;567
11926;39;620774816;11926;620;13329;13894;4.25;0.26;398.12;20.19;1403;53;4758.00;565
11930;39;620774832;11930;625;13331;13894;4.20;0.26;398.08;20.19;1401;53;4759.00;563
11934;40;620774854;11934;617;13332;13895;4.16;0.26;398.02;20.19;1398;54;4760.00;563
11935;40;620774891;11935;617;13333;13896;4.14;0.26;398.01;20.19;1398;54;4761.00;563
11938;40;620774907;11938;617;13335;13896;4.12;0.25;397.95;20.19;1397;54;4762.00;561
11939;40;620774924;11939;619;13337;13897;4.10;0.25;397.93;20.19;1398;54;4763.00;560
11942;40;620774941;11942;624;13338;13897;4.04;0.25;397.94;20.19;1396;54;4764.00;559
11946;40;620774957;11946;634;13339;13897;3.97;0.24;397.88;20.18;1393;54;4765.00;558
11948;40;620774975;11948;648;13341;13897;3.93;0.24;397.85;20.18;1393;54;4766.00;556
11950;40;620774991;11950;640;13344;13901;3.89;0.24;397.81;20.18;1394;54;4767.00;557
11954;40;620775008;11954;639;13344;13901;3.80;0.23;397.79;20.18;1390;54;4768.00;557
11956;40;620775025;11956;631;13344;13901;3.76;0.23;397.77;20.18;1388;54;4769.00;557
11958;40;620775043;11958;636;13347;13907;3.73;0.23;397.75;20.17;1389;54;4770.00;560
11959;40;620775060;11959;630;13347;13907;3.67;0.23;397.75;20.17;1388;54;4771.00;560
11960;40;620775077;11960;639;13347;13907;3.61;0.22;397.73;20.17;1387;54;4772.00;560
11964;40;620775093;11964;635;13348;13911;3.57;0.22;397.75;20.17;1384;54;4773.00;563
11967;40;620775110;11967;630;13349;13912;3.53;0.22;397.74;20.17;1382;54;4774.00;563
11971;40;620775126;11971;630;13349;13912;3.48;0.21;397.67;20.17;1378;54;4775.00;563
11974;40;620775143;11974;638;13352;13916;3.52;0.22;397.65;20.17;1378;54;4776.00;564
11978;40;620775158;11978;634;13352;13916;3.49;0.21;397.60;20.17;1374;54;4777.00;564
11981;40;620775175;11981;630;13352;13916;3.48;0.21;397.61;20.17;1371;54;4778.00;564
11982;40;620775194;11982;619;13352;13917;3.51;0.21;397.61;20.17;1370;54;4779.00;565
11982;40;620775211;11982;610;13352;13917;3.52;0.22;397.61;20.17;1370;54;4780.00;565
11985;40;620775228;11985;596;13356;13923;3.58;0.22;397.62;20.16;1371;54;4781.00;567
11987;40;620775245;11987;582;13356;13923;3.62;0.22;397.60;20.16;1369;54;4782.00;567
11990;40;620775264;11990;580;13356;13924;3.67;0.22;397.61;20.16;1366;54;4783.00;568
11990;40;620775283;11990;585;13356;13924;3.77;0.23;397.61;20.16;1366;54;4784.00;568
11993;40;620775302;11993;581;13356;13924;3.84;0.23;397.61;20.16;1363;54;4785.00;568
11996;40;620775321;11996;578;13356;13924;3.91;0.24;397.58;20.16;1360;54;4786.00;568
12000;40;620775338;12000;581;13356;13924;3.95;0.24;397.63;20.16;1356;54;4787.00;568
12004;41;620775355;12004;579;13366;13936;4.03;0.25;397.66;20.16;1362;55;4788.00;570
12008;41;620775384;12008;589;13368;13936;4.03;0.25;397.58;20.17;1360;55;4789.00;568
12011;41;620775401;12011;594;13370;13936;4.04;0.25;397.58;20.28;1359;55;4790.00;566
12013;41;620775426;12013;596;13370;13936;4.03;0.25;397.59;20.28;1357;55;4791.00;566
12016;41;620775443;12016;605;13371;13936;4.04;0.25;397.58;20.29;1355;55;4792.00;565
12017;41;620775468;12017;609;13372;13936;4.12;0.25;397.56;20.29;1355;55;4793.00;564
12018;41;620775492;12018;607;13374;13940;4.18;0.25;397.57;20.30;1356;55;4794.00;566
12022;41;620775526;12022;610;13375;13940;4.19;0.26;397.55;20.30;1353;55;4795.00;565
12024;41;620775548;12024;609;13378;13944;4.19;0.26;397.54;20.30;1354;55;4796.00;566
12026;41;620775570;12026;614;13382;13945;4.16;0.25;397.53;20.32;1356;55;4797.00;563
12029;41;620775590;12029;614;13382;13945;4.16;0.25;397.50;20.32;1353;55;4798.00;563
12033;41;620775609;12033;612;13382;13945;4.17;0.25;397.54;20.32;1349;55;4799.00;563
12034;41;620775632;12034;614;13407;13986;4.28;0.26;397.51;20.30;1373;55;4800.00;579
12035;41;620775662;12035;610;13409;13986;4.31;0.26;397.57;20.31;1374;55;4801.00;577
12038;41;620775681;12038;611;13410;13986;4.31;0.26;397.60;20.31;1372;55;4802.00;576
12040;41;620775701;12040;611;13416;13987;4.30;0.26;397.59;20.32;1376;55;4803.00;571
12041;41;620775720;12041;609;13419;13988;4.35;0.27;397.57;20.33;1378;55;4804.00;569
12043;41;620775739;12043;616;13423;13988;4.35;0.27;397.54;20.33;1380;55;4805.00;565
12045;41;620775758;12045;615;13427;13991;4.38;0.27;397.63;20.33;1382;55;4806.00;564
12049;41;620775777;12049;604;13429;13991;4.39;0.27;397.63;20.34;1380;55;4807.00;562
12051;41;620775797;12051;601;13432;13991;4.36;0.27;397.68;20.34;1381;55;4808.00;559
12052;41;620775818;12052;596;13433;13991;4.40;0.27;397.75;20.34;1381;55;4809.00;558
12057;41;620775836;12057;593;13440;13997;4.37;0.27;397.77;20.43;1383;55;4810.00;557
12061;41;620775857;12061;588;13442;13997;4.36;0.27;397.87;20.44;1381;55;4811.00;555
12064;41;620775877;12064;598;13445;13997;4.37;0.27;397.96;20.44;1381;55;4812.00;552
12069;41;620775897;12069;602;13445;13997;4.37;0.27;398.08;20.44;1376;55;4813.00;552
12071;41;620775918;12071;602;13450;14001;4.42;0.27;398.04;20.44;1379;55;4814.00;551
12078;41;620775938;12078;602;13453;14003;4.39;0.27;398.19;20.44;1375;55;4815.00;550
12081;41;620775957;12081;587;13454;14003;4.39;0.27;398.18;20.45;1373;55;4816.00;549
12085;41;620775977;12085;578;13455;14004;4.45;0.27;398.44;20.45;1370;55;4817.00;549
12087;41;620776000;12087;575;13455;14004;4.48;0.27;398.52;20.45;1368;55;4818.00;549
12091;41;620776022;12091;563;13458;14004;4.56;0.28;398.59;20.45;1367;55;4819.00;546
12093;41;620776049;12093;560;13458;14004;4.61;0.28;398.59;20.45;1365;55;4820.00;546
12095;41;620776068;12095;552;13459;14004;4.68;0.29;398.63;20.45;1364;55;4821.00;545
12097;41;620776098;12097;546;13461;14004;4.70;0.29;398.66;20.46;1364;55;4822.00;543
12099;41;620776118;12099;547;13461;14004;4.72;0.29;398.79;20.46;1362;55;4823.00;543
12104;41;620776137;12104;556;13500;14074;4.69;0.29;398.97;20.41;1396;55;4824.00;574
12105;41;620776166;12105;552;13501;14075;4.67;0.29;399.00;20.41;1396;55;4825.00;574
12111;41;620776187;12111;556;13505;14075;4.62;0.28;399.11;20.41;1394;56;4826.00;570
12112;41;620776222;12112;543;13509;14075;4.63;0.28;399.20;20.41;1397;56;4827.00;566
12117;41;620776242;12117;542;13513;14077;4.63;0.28;399.41;20.41;1396;56;4828.00;564
12119;41;620776265;12119;541;13515;14077;4.66;0.28;399.45;20.41;1396;56;4829.00;562
12122;41;620776286;12122;539;13518;14077;4.67;0.29;399.58;20.41;1396;56;4830.00;559
12123;41;620776305;12123;543;13520;14077;4.67;0.29;399.59;20.42;1397;56;4831.00;557
12126;41;620776325;12126;543;13522;14078;4.68;0.29;399.76;20.42;1396;56;4832.00;556
12129;41;620776345;12129;551;13526;14079;4.75;0.29;399.81;20.42;1397;56;4833.00;553
12132;41;620776364;12132;551;13529;14079;4.77;0.29;399.83;20.42;1397;56;4834.00;550
12136;41;620776382;12136;551;13532;14083;4.78;0.29;399.97;20.42;1396;56;4835.00;551
12137;41;620776400;12137;551;13532;14083;4.83;0.29;399.95;20.42;1395;56;4836.00;551
12139;41;620776417;12139;561;13532;14083;4.81;0.29;399.99;20.42;1393;56;4837.00;551
12143;41;620776435;12143;573;13533;14083;4.76;0.29;400.02;20.42;1390;56;4838.00;550
12147;41;620776453;12147;583;13538;14089;4.72;0.29;400.13;20.42;1391;56;4839.00;551
12149;41;620776472;12149;584;13539;14089;4.67;0.29;400.20;20.42;1390;56;4840.00;550
12153;41;620776490;12153;593;13539;14089;4.59;0.28;400.19;20.42;1386;56;4841.00;550
12153;41;620776506;12153;599;13540;14092;4.54;0.28;400.19;20.42;1387;56;4842.00;552
12155;41;620776523;12155;603;13540;14092;4.53;0.28;400.23;20.42;1385;56;4843.00;552
12157;41;620776538;12157;607;13540;14092;4.56;0.28;400.28;20.42;1383;56;4844.00;552
12158;41;620776558;12158;604;13541;14093;4.59;0.28;400.29;20.42;1383;56;4845.00;552
12158;41;620776573;12158;615;13543;14094;4.66;0.28;400.29;20.43;1385;56;4846.00;551
12161;41;620776589;12161;612;13544;14094;4.64;0.28;400.28;20.43;1383;56;4847.00;550
12161;41;620776605;12161;614;13554;14107;4.68;0.29;400.28;20.41;1393;56;4848.00;553
12162;41;620776622;12162;608;13554;14107;4.68;0.29;400.30;20.41;1392;56;4849.00;553
12164;41;620776638;12164;612;13556;14107;4.70;0.29;400.33;20.42;1392;56;4850.00;551
12166;41;620776654;12166;601;13556;14108;4.73;0.29;400.36;20.42;1390;56;4851.00;552
12167;41;620776670;12167;597;13556;14108;4.79;0.29;400.36;20.42;1389;56;4852.00;552
12168;41;620776686;12168;587;13559;14112;4.86;0.30;400.36;20.42;1391;56;4853.00;553
12170;41;620776703;12170;582;13560;14112;4.90;0.30;400.34;20.52;1390;56;4854.00;552
12174;41;620776720;12174;578;13562;14116;4.92;0.30;400.46;20.52;1388;56;4855.00;554
12176;41;620776737;12176;561;13562;14116;4.97;0.30;400.55;20.52;1386;56;4856.00;554
12177;41;620776754;12177;563;13562;14116;5.00;0.30;400.64;20.52;1385;56;4857.00;554
12178;41;620776770;12178;564;13562;14116;5.03;0.31;400.69;20.52;1384;56;4858.00;554
12178;41;620776786;12178;561;13562;14116;5.04;0.31;400.69;20.52;1384;56;4859.00;554
12181;41;620776804;12181;554;13576;14150;5.09;0.31;400.86;20.50;1395;56;4860.00;574
12183;41;620776822;12183;555;13578;14150;5.05;0.31;400.89;20.50;1395;56;4861.00;572
12185;41;620776838;12185;546;13582;14150;5.06;0.31;401.00;20.50;1397;56;4862.00;568
12188;41;620776854;12188;540;13583;14150;5.06;0.31;401.09;20.50;1395;56;4863.00;567
12193;41;620776870;12193;537;13584;14150;5.06;0.31;401.28;20.49;1391;56;4864.00;566
12195;41;620776886;12195;535;13584;14150;5.06;0.31;401.41;20.49;1389;56;4865.00;566
12199;41;620776902;12199;531;13584;14151;5.06;0.31;401.48;20.49;1385;56;4866.00;567
12205;41;620776919;12205;529;13584;14151;5.04;0.31;401.64;20.49;1379;56;4867.00;567
12210;41;620776934;12210;534;13587;14157;5.01;0.30;401.64;20.49;1377;56;4868.00;570
12212;41;620776951;12212;533;13587;14158;4.99;0.30;401.66;20.49;1375;56;4869.00;571
12217;41;620776967;12217;534;13587;14158;4.93;0.30;401.69;20.49;1370;56;4870.00;571
12220;41;620776988;12220;540;13588;14158;4.87;0.30;401.71;20.49;1368;56;4871.00;570
12223;41;620777003;12223;546;13592;14162;4.82;0.29;401.85;20.49;1369;56;4872.00;570
12224;41;620777019;12224;545;13592;14162;4.81;0.29;401.83;20.49;1368;56;4873.00;570
12225;41;620777033;12225;552;13592;14162;4.84;0.29;401.93;20.49;1367;56;4874.00;570
12227;41;620777048;12227;547;13593;14163;4.81;0.29;402.05;20.49;1366;56;4875.00;570
12230;41;620777063;12230;549;13595;14167;4.79;0.29;402.16;20.48;1365;56;4876.00;572
12235;41;620777078;12235;549;13596;14167;4.74;0.29;402.26;20.48;1361;56;4877.00;571
12239;41;620777093;12239;549;13597;14170;4.71;0.29;402.37;20.48;1358;56;4878.00;573
12242;41;620777108;12242;554;13597;14170;4.70;0.29;402.45;20.48;1355;56;4879.00;573
12245;41;620777122;12245;549;13597;14170;4.67;0.28;402.45;20.48;1352;56;4880.00;573
12247;41;620777137;12247;551;13597;14170;4.65;0.28;402.45;20.48;1350;56;4881.00;573
12250;41;620777152;12250;562;13600;14174;4.65;0.28;402.47;20.48;1350;56;4882.00;574
12252;41;620777167;12252;567;13600;14174;4.63;0.28;402.45;20.48;1348;56;4883.00;574
12253;41;620777181;12253;566;13600;14174;4.60;0.28;402.46;20.48;1347;56;4884.00;574
12254;41;620777196;12254;569;13600;14174;4.60;0.28;402.46;20.48;1346;56;4885.00;574
12256;41;620777210;12256;576;13600;14175;4.56;0.28;402.55;20.48;1344;56;4886.00;575
12256;41;620777225;12256;572;13600;14176;4.54;0.28;402.55;20.48;1344;56;4887.00;576
12258;41;620777240;12258;579;13600;14176;4.50;0.27;402.60;20.48;1342;56;4888.00;576
12260;41;620777255;12260;582;13601;14177;4.48;0.27;402.67;20.48;1341;56;4889.00;576
12265;41;620777271;12265;586;13601;14177;4.41;0.27;402.84;20.48;1336;56;4890.00;576
12266;41;620777286;12266;588;13601;14177;4.44;0.27;402.84;20.48;1335;56;4891.00;576
12266;41;620777300;12266;601;13601;14177;4.42;0.27;402.84;20.48;1335;56;4892.00;576
12268;41;620777321;12268;609;13601;14177;4.42;0.27;402.84;20.48;1333;56;4893.00;576
12270;41;620777335;12270;606;13601;14177;4.38;0.27;402.91;20.48;1331;56;4894.00;576
12273;41;620777350;12273;605;13601;14177;4.32;0.26;402.88;20.48;1328;56;4895.00;576
12274;41;620777364;12274;623;13657;14304;4.63;0.29;402.86;20.39;1383;56;4896.00;647
12276;41;620777388;12276;624;13660;14305;4.60;0.29;402.87;20.39;1384;56;4897.00;645
12278;41;620777403;12278;613;13667;14305;4.65;0.29;402.83;20.38;1389;56;4898.00;638
12281;41;620777417;12281;629;13668;14305;4.65;0.29;402.78;20.38;1387;56;4899.00;637
12281;41;620777433;12281;621;13674;14305;4.73;0.29;402.78;20.37;1393;56;4900.00;631
12283;41;620777455;12283;622;13675;14305;4.73;0.29;402.76;20.37;1392;56;4901.00;630
12283;41;620777485;12283;626;13677;14305;4.73;0.29;402.76;20.37;1394;56;4902.00;628
12284;42;620777504;12284;619;13677;14305;4.72;0.29;402.74;20.37;1393;57;4903.00;628
12287;42;620777537;12287;620;13680;14306;4.72;0.29;402.71;20.36;1393;57;4904.00;626
12289;42;620777559;12289;616;13680;14308;4.68;0.29;402.69;20.36;1391;57;4905.00;628
12293;42;620777582;12293;611;13682;14308;4.66;0.29;402.81;20.36;1389;57;4906.00;626
12295;42;620777599;12295;614;13684;14309;4.61;0.28;402.75;20.36;1389;57;4907.00;625
12299;42;620777614;12299;617;13686;14309;4.52;0.28;402.75;20.36;1387;57;4908.00;623
12302;42;620777630;12302;617;13688;14309;4.46;0.27;402.77;20.36;1386;57;4909.00;621
12303;42;620777645;12303;622;13690;14309;4.36;0.27;402.75;20.36;1387;57;4910.00;619
12307;42;620777663;12307;619;13694;14313;4.28;0.26;402.74;20.35;1387;57;4911.00;619
12311;42;620777681;12311;617;13695;14313;4.17;0.26;402.63;20.35;1384;57;4912.00;618
12312;42;620777697;12312;612;13695;14313;4.14;0.25;402.63;20.35;1383;57;4913.00;618
12312;42;620777719;12312;619;13696;14316;4.11;0.25;402.63;20.35;1384;57;4914.00;620
12313;42;620777735;12313;615;13696;14316;4.12;0.25;402.65;20.35;1383;57;4915.00;620
12313;42;620777749;12313;618;13696;14316;4.10;0.25;402.65;20.35;1383;57;4916.00;620
12313;42;620777764;12313;617;13697;14320;4.10;0.25;402.65;20.35;1384;57;4917.00;623
12316;42;620777778;12316;623;13698;14321;4.08;0.25;402.62;20.35;1382;57;4918.00;623
12318;42;620777794;12318;625;13698;14321;4.07;0.25;402.58;20.35;1380;57;4919.00;623
12319;42;620777812;12319;625;13701;14326;4.10;0.25;402.55;20.34;1382;57;4920.00;625
12320;42;620777827;12320;626;13701;14326;4.07;0.25;402.56;20.34;1381;57;4921.00;625
12324;42;620777841;12324;635;13702;14326;3.99;0.24;402.51;20.34;1378;57;4922.00;624
12327;42;620777855;12327;639;13702;14327;3.95;0.24;402.49;20.34;1375;57;4923.00;625
12328;42;620777870;12328;643;13702;14327;3.88;0.24;402.49;20.34;1374;57;4924.00;625
12331;42;620777884;12331;642;13707;14333;3.82;0.23;402.47;20.34;1376;57;4925.00;626
12335;42;620777900;12335;648;13707;14333;3.73;0.23;402.41;20.34;1372;57;4926.00;626
12338;42;620777915;12338;653;13707;14334;3.59;0.22;402.37;20.34;1369;57;4927.00;627
12340;42;620777930;12340;665;13707;14334;3.46;0.21;402.33;20.34;1367;57;4928.00;627
12340;42;620777945;12340;673;13707;14334;3.32;0.20;402.33;20.34;1367;57;4929.00;627
12343;42;620777961;12343;667;13707;14334;3.26;0.20;402.32;20.34;1364;57;4930.00;627
12345;42;620777978;12345;642;13707;14334;3.24;0.20;402.28;20.34;1362;57;4931.00;627
12347;42;620777995;12347;634;13714;14346;3.31;0.20;402.27;20.33;1367;57;4932.00;632
12353;42;620778012;12353;635;13714;14346;3.29;0.20;402.24;20.33;1361;57;4933.00;632
12353;42;620778029;12353;621;13715;14346;3.39;0.21;402.24;20.33;1362;57;4934.00;631
12355;42;620778046;12355;621;13715;14346;3.42;0.21;402.24;20.33;1360;57;4935.00;631
12359;42;620778063;12359;619;13715;14346;3.47;0.21;402.23;20.33;1356;57;4936.00;631
12359;42;620778080;12359;607;13715;14346;3.57;0.22;402.23;20.33;1356;57;4937.00;631
12364;42;620778105;12364;602;13716;14350;3.63;0.22;402.15;20.33;1352;57;4938.00;634
12365;42;620778124;12365;591;13716;14350;3.72;0.23;402.14;20.33;1351;57;4939.00;634
12366;42;620778141;12366;586;13719;14354;3.80;0.23;402.14;20.32;1353;57;4940.00;635
12369;42;620778158;12369;575;13719;14355;3.82;0.23;402.13;20.32;1350;57;4941.00;636
12373;42;620778176;12373;572;13719;14355;3.85;0.23;402.16;20.32;1346;57;4942.00;636
12374;42;620778193;12374;560;13719;14355;3.94;0.24;402.15;20.32;1345;57;4943.00;636
12376;42;620778210;12376;562;13729;14368;4.12;0.25;402.14;20.31;1353;57;4944.00;639
12381;42;620778229;12381;552;13729;14368;4.20;0.26;402.22;20.31;1348;57;4945.00;639
12384;42;620778248;12384;545;13729;14368;4.28;0.26;402.17;20.31;1345;57;4946.00;639
12386;42;620778273;12386;545;13730;14369;4.35;0.26;402.16;20.31;1344;57;4947.00;639
12388;42;620778292;12388;539;13730;14370;4.39;0.27;402.17;20.31;1342;57;4948.00;640
12390;42;620778311;12390;534;13730;14370;4.47;0.27;402.15;20.31;1340;57;4949.00;640
12393;42;620778331;12393;527;13734;14379;4.54;0.28;402.20;20.30;1341;57;4950.00;645
12395;42;620778350;12395;519;13734;14379;4.57;0.28;402.20;20.30;1339;57;4951.00;645
12397;42;620778368;12397;506;13735;14379;4.63;0.28;402.32;20.30;1338;57;4952.00;644
12401;42;620778386;12401;504;13735;14379;4.68;0.28;402.44;20.30;1334;57;4953.00;644
12406;42;620778405;12406;501;13739;14385;4.72;0.29;402.42;20.29;1333;57;4954.00;646
12407;42;620778425;12407;500;13740;14385;4.79;0.29;402.40;20.30;1333;57;4955.00;645
12413;42;620778444;12413;503;13741;14385;4.78;0.29;402.52;20.30;1328;57;4956.00;644
12414;42;620778467;12414;504;13741;14385;4.83;0.29;402.50;20.30;1327;57;4957.00;644
12414;42;620778486;12414;501;13744;14389;4.83;0.29;402.50;20.31;1330;57;4958.00;645
12420;42;620778510;12420;495;13746;14390;4.75;0.29;402.50;20.33;1326;57;4959.00;644
12424;42;620778529;12424;497;13748;14390;4.74;0.29;402.63;20.44;1324;57;4960.00;642
12428;42;620778547;12428;492;13749;14391;4.78;0.29;402.65;20.43;1321;57;4961.00;642
12433;42;620778567;12433;497;13752;14391;4.75;0.29;402.62;20.46;1319;57;4962.00;639
12438;42;620778585;12438;504;13753;14391;4.71;0.29;402.59;20.46;1315;57;4963.00;638
12441;42;620778602;12441;503;13754;14391;4.74;0.29;402.72;20.47;1313;57;4964.00;637
12445;42;620778620;12445;492;13756;14391;4.76;0.29;402.79;20.49;1311;57;4965.00;635
12446;42;620778637;12446;490;13759;14391;4.83;0.29;402.83;20.50;1313;57;4966.00;632
12452;42;620778654;12452;483;13759;14391;4.82;0.29;402.87;20.50;1307;57;4967.00;632
12455;42;620778672;12455;496;13801;14461;4.89;0.30;402.94;20.47;1346;57;4968.00;660
12459;42;620778695;12459;493;13802;14462;4.87;0.30;402.91;20.48;1343;57;4969.00;660
12463;42;620778714;12463;493;13805;14462;4.85;0.30;402.95;20.47;1342;57;4970.00;657
12465;42;620778732;12465;485;13809;14462;4.93;0.30;403.00;20.49;1344;57;4971.00;653
12469;42;620778749;12469;486;13812;14462;4.95;0.30;403.01;20.50;1343;57;4972.00;650
12472;42;620778768;12472;494;13813;14462;5.00;0.30;402.98;20.50;1341;57;4973.00;649
12475;42;620778786;12475;500;13818;14462;5.01;0.30;403.01;20.52;1343;57;4974.00;644
12477;42;620778804;12477;505;13820;14462;5.02;0.30;403.02;20.52;1343;57;4975.00;642
12480;42;620778822;12480;509;13828;14463;4.94;0.30;403.12;20.65;1348;57;4976.00;635
12483;42;620778840;12483;508;13830;14464;4.89;0.30;403.12;20.66;1347;57;4977.00;634
12485;42;620778858;12485;499;13834;14464;4.88;0.30;403.12;20.68;1349;57;4978.00;630
12491;42;620778875;12491;499;13835;14468;4.83;0.29;403.10;20.67;1344;57;4979.00;633
12494;42;620778895;12494;498;13840;14468;4.82;0.29;403.13;20.70;1346;57;4980.00;628
12496;42;620778913;12496;498;13841;14468;4.81;0.29;403.13;20.80;1345;57;4981.00;627
12499;42;620778931;12499;503;13843;14468;4.83;0.29;403.25;20.81;1344;57;4982.00;625
12502;42;620778949;12502;509;13850;14474;4.85;0.30;403.35;20.82;1348;57;4983.00;624
12506;42;620778969;12506;512;13851;14474;4.87;0.30;403.43;20.83;1345;57;4984.00;623
12508;42;620778987;12508;516;13852;14474;4.92;0.30;403.47;20.83;1344;57;4985.00;622
12512;42;620779005;12512;508;13854;14477;4.93;0.30;403.58;20.83;1342;57;4986.00;623
12512;42;620779024;12512;502;13856;14477;5.01;0.31;403.58;20.84;1344;57;4987.00;621
12517;42;620779041;12517;502;13861;14477;4.99;0.30;403.65;20.85;1344;57;4988.00;616
12520;42;620779068;12520;502;13861;14478;4.98;0.30;403.81;20.85;1341;57;4989.00;617
12524;42;620779093;12524;504;13864;14479;4.97;0.30;403.95;20.86;1340;57;4990.00;615
12524;42;620779111;12524;505;13864;14479;4.99;0.30;403.95;20.86;1340;57;4991.00;615
12527;42;620779129;12527;507;13876;14492;5.04;0.31;403.99;20.86;1349;57;4992.00;616
12531;42;620779148;12531;508;13879;14492;5.04;0.31;404.12;20.97;1348;57;4993.00;613
12532;42;620779165;12532;516;13879;14492;5.02;0.31;404.12;20.97;1347;57;4994.00;613
12537;42;620779182;12537;516;13882;14494;4.96;0.30;404.19;20.98;1345;57;4995.00;612
12541;42;620779198;12541;525;13883;14494;4.96;0.30;404.28;20.99;1342;57;4996.00;611
12544;42;620779214;12544;517;13887;14498;4.96;0.30;404.39;20.99;1343;57;4997.00;611
12547;42;620779231;12547;522;13888;14498;4.92;0.30;404.49;21.00;1341;57;4998.00;610
12550;42;620779248;12550;522;13892;14502;4.87;0.30;404.50;21.00;1342;57;4999.00;610
12554;42;620779264;12554;522;13893;14502;4.84;0.29;404.59;21.00;1339;57;5000.00;609
12555;42;620779287;12555;523;13894;14502;4.85;0.29;404.60;21.01;1339;57;5001.00;608
12556;42;620779303;12556;522;13896;14502;4.88;0.30;404.62;21.02;1340;57;5002.00;606
12560;42;620779321;12560;523;13899;14502;4.85;0.29;404.72;21.39;1339;58;5003.00;603
12562;42;620779348;12562;527;13909;14514;4.94;0.30;404.68;21.38;1347;58;5004.00;605
12565;42;620779364;12565;530;13911;14514;4.98;0.30;404.87;21.40;1346;59;5005.00;603
12567;42;620779383;12567;536;13911;14514;4.98;0.30;404.91;21.40;1344;59;5006.00;603
12571;42;620779399;12571;527;13911;14514;4.97;0.30;405.00;21.40;1340;59;5007.00;603
12574;42;620779413;12574;530;13912;14514;4.97;0.30;405.07;21.40;1338;59;5008.00;602
12575;42;620779429;12575;534;13914;14514;5.02;0.30;405.07;21.42;1339;59;5009.00;600
12578;42;620779445;12578;539;13916;14515;5.01;0.30;405.11;21.43;1338;59;5010.00;599
12578;42;620779465;12578;544;13916;14515;4.99;0.30;405.11;21.43;1338;59;5011.00;599
12580;42;620779490;12580;550;13922;14521;5.00;0.30;405.24;21.43;1342;59;5012.00;599
12584;42;620779516;12584;556;13923;14522;4.95;0.30;405.30;21.44;1339;59;5013.00;599
12586;42;620779538;12586;556;13925;14522;4.92;0.30;405.32;21.45;1339;59;5014.00;597
12588;42;620779560;12588;552;13926;14522;4.88;0.30;405.33;21.45;1338;59;5015.00;596
12590;42;620779580;12590;548;13929;14526;4.87;0.30;405.47;21.45;1339;59;5016.00;597
12593;42;620779596;12593;552;13931;14526;4.82;0.29;405.49;21.46;1338;59;5017.00;595
12595;42;620779612;12595;554;13931;14526;4.75;0.29;405.51;21.46;1336;59;5018.00;595
12595;42;620779628;12595;559;13933;14527;4.78;0.29;405.51;21.46;1338;59;5019.00;594
12595;42;620779644;12595;550;13938;14531;4.77;0.29;405.51;21.46;1343;59;5020.00;593
12598;42;620779660;12598;552;13938;14531;4.73;0.29;405.68;21.46;1340;59;5021.00;593
12600;42;620779675;12600;547;13940;14534;4.71;0.29;405.73;21.46;1340;59;5022.00;594
12602;42;620779694;12602;544;13941;14534;4.68;0.29;405.74;21.47;1339;59;5023.00;593
12604;42;620779710;12604;545;13941;14534;4.64;0.28;405.76;21.47;1337;59;5024.00;593
12607;42;620779725;12607;538;13941;14534;4.63;0.28;405.75;21.47;1334;59;5025.00;593
12610;42;620779742;12610;541;13945;14538;4.63;0.28;405.85;21.47;1335;59;5026.00;593
12610;42;620779758;12610;532;13945;14538;4.62;0.28;405.85;21.47;1335;59;5027.00;593
12615;42;620779773;12615;528;13946;14538;4.57;0.28;405.86;21.47;1331;59;5028.00;592
12616;42;620779788;12616;524;13946;14538;4.60;0.28;405.86;21.47;1330;59;5029.00;592
12619;42;620779803;12619;525;13947;14539;4.58;0.28;405.86;21.47;1328;59;5030.00;592
12623;42;620779819;12623;519;13947;14540;4.55;0.28;405.89;21.47;1324;59;5031.00;593
12627;42;620779834;12627;511;13949;14540;4.52;0.27;405.94;21.48;1322;59;5032.00;591
12630;42;620779850;12630;501;13950;14541;4.55;0.28;406.03;21.48;1320;59;5033.00;591
12634;42;620779866;12634;504;13950;14541;4.53;0.28;406.08;21.48;1316;59;5034.00;591
12636;42;620779883;12636;501;13951;14541;4.57;0.28;406.11;21.48;1315;59;5035.00;590
12639;42;620779900;12639;486;13951;14541;4.55;0.28;406.12;21.48;1312;59;5036.00;590
12643;42;620779915;12643;480;13952;14541;4.56;0.28;406.26;21.48;1309;59;5037.00;589
12645;42;620779932;12645;489;13953;14541;4.54;0.28;406.27;21.49;1308;59;5038.00;588
12649;42;620779948;12649;489;13953;14541;4.53;0.28;406.33;21.49;1304;59;5039.00;588
12650;42;620779966;12650;519;14050;14771;4.83;0.30;406.36;21.34;1400;59;5040.00;721
12652;42;620780003;12652;528;14058;14772;4.80;0.30;406.36;21.33;1406;59;5041.00;714
12656;42;620780020;12656;520;14066;14772;4.82;0.30;406.41;21.55;1410;59;5042.00;706
12657;42;620780038;12657;522;14070;14772;4.84;0.30;406.44;21.55;1413;59;5043.00;702
12661;42;620780054;12661;523;14079;14772;4.76;0.30;406.54;21.54;1418;59;5044.00;693
12662;42;620780071;12662;529;14083;14772;4.73;0.30;406.56;21.53;1421;59;5045.00;689
12664;42;620780088;12664;532;14087;14772;4.72;0.29;406.60;21.53;1423;59;5046.00;685
12666;42;620780105;12666;541;14095;14772;4.72;0.29;406.60;21.52;1429;59;5047.00;677
12669;42;620780124;12669;542;14100;14773;4.68;0.29;406.56;21.52;1431;59;5048.00;673
12671;42;620780142;12671;550;14106;14774;4.68;0.29;406.61;21.51;1435;59;5049.00;668
12673;42;620780160;12673;552;14110;14774;4.66;0.29;406.59;21.51;1437;59;5050.00;664
12674;42;620780178;12674;561;14112;14775;4.61;0.29;406.62;21.51;1438;59;5051.00;663
12675;42;620780195;12675;564;14116;14775;4.55;0.28;406.59;21.51;1441;59;5052.00;659
12677;42;620780211;12677;576;14118;14775;4.53;0.28;406.54;21.50;1441;59;5053.00;657
12680;42;620780228;12680;576;14120;14775;4.51;0.28;406.51;21.50;1440;59;5054.00;655
12683;42;620780245;12683;588;14124;14779;4.45;0.28;406.52;21.50;1441;59;5055.00;655
12684;42;620780262;12684;596;14125;14779;4.40;0.27;406.50;21.50;1441;59;5056.00;654
12686;42;620780279;12686;611;14128;14779;4.35;0.27;406.52;21.50;1442;59;5057.00;651
12687;42;620780295;12687;613;14131;14782;4.32;0.27;406.50;21.50;1444;59;5058.00;651
12691;42;620780312;12691;619;14132;14782;4.32;0.27;406.55;21.50;1441;59;5059.00;650
12692;42;620780329;12692;620;14133;14782;4.32;0.27;406.60;21.50;1441;59;5060.00;649
12694;42;620780346;12694;627;14138;14786;4.32;0.27;406.62;21.50;1444;59;5061.00;648
12699;42;620780365;12699;636;14141;14787;4.27;0.26;406.63;21.49;1442;59;5062.00;646
12700;42;620780382;12700;643;14141;14787;4.25;0.26;406.63;21.49;1441;59;5063.00;646
12701;42;620780398;12701;641;14143;14791;4.22;0.26;406.70;21.49;1442;59;5064.00;648
12708;42;620780415;12708;646;14144;14791;4.15;0.26;406.66;21.49;1436;59;5065.00;647
12711;42;620780432;12711;649;14145;14791;4.11;0.25;406.59;21.49;1434;59;5066.00;646
12714;42;620780448;12714;651;14146;14792;4.04;0.25;406.55;21.49;1432;59;5067.00;646
12714;42;620780466;12714;664;14148;14792;4.00;0.25;406.55;21.49;1434;59;5068.00;644
12715;42;620780482;12715;667;14152;14798;4.01;0.25;406.57;21.49;1437;59;5069.00;646
12717;42;620780500;12717;668;14152;14798;3.96;0.24;406.52;21.49;1435;59;5070.00;646
12718;42;620780516;12718;673;14153;14799;3.92;0.24;406.54;21.49;1435;59;5071.00;646
12722;42;620780531;12722;675;14153;14799;3.87;0.24;406.47;21.49;1431;59;5072.00;646
12723;42;620780546;12723;686;14153;14799;3.81;0.23;406.44;21.49;1430;59;5073.00;646
12724;42;620780560;12724;693;14153;14799;3.78;0.23;406.45;21.49;1429;59;5074.00;646
12726;42;620780574;12726;701;14153;14799;3.73;0.23;406.47;21.49;1427;59;5075.00;646
12728;42;620780594;12728;703;14161;14811;3.73;0.23;406.44;21.47;1433;59;5076.00;650
12729;42;620780610;12729;708;14161;14811;3.71;0.23;406.42;21.47;1432;59;5077.00;650
12732;42;620780624;12732;717;14161;14811;3.68;0.23;406.45;21.47;1429;59;5078.00;650
12734;42;620780639;12734;717;14161;14811;3.66;0.22;406.42;21.47;1427;59;5079.00;650
12735;42;620780655;12735;718;14161;14811;3.64;0.22;406.39;21.47;1426;59;5080.00;650
12739;42;620780669;12739;713;14161;14811;3.59;0.22;406.34;21.47;1422;59;5081.00;650
12741;42;620780683;12741;708;14164;14815;3.56;0.22;406.28;21.47;1423;59;5082.00;651
12743;42;620780697;12743;696;14164;14815;3.56;0.22;406.32;21.47;1421;59;5083.00;651
12743;42;620780711;12743;688;14167;14819;3.64;0.22;406.32;21.47;1424;59;5084.00;652
12744;42;620780725;12744;683;14167;14821;3.68;0.23;406.31;21.47;1423;59;5085.00;654
12744;42;620780740;12744;677;14167;14821;3.75;0.23;406.31;21.47;1423;59;5086.00;654
12744;42;620780754;12744;671;14167;14821;3.86;0.24;406.31;21.47;1423;59;5087.00;654
12744;43;620780768;12744;666;14177;14834;3.98;0.24;406.31;21.45;1433;60;5088.00;657
12746;43;620780798;12746;661;14177;14834;4.01;0.25;406.37;21.45;1431;60;5089.00;657
12747;43;620780823;12747;654;14177;14834;4.05;0.25;406.35;21.45;1430;60;5090.00;657
12749;43;620780851;12749;658;14178;14835;4.07;0.25;406.31;21.45;1429;60;5091.00;657
12751;43;620780867;12751;666;14178;14836;4.07;0.25;406.31;21.45;1427;60;5092.00;658
12754;43;620780890;12754;660;14178;14836;4.05;0.25;406.33;21.45;1424;60;5093.00;658
12756;43;620780906;12756;650;14179;14839;4.04;0.25;406.33;21.45;1423;60;5094.00;660
12759;43;620780922;12759;651;14180;14839;4.01;0.25;406.34;21.45;1421;60;5095.00;659
12760;43;620780943;12760;651;14180;14839;3.98;0.24;406.33;21.45;1420;60;5096.00;659
12764;43;620780959;12764;656;14180;14839;3.94;0.24;406.28;21.45;1416;60;5097.00;659
12766;43;620780976;12766;660;14184;14845;3.92;0.24;406.24;21.44;1418;60;5098.00;661
12770;43;620780999;12770;652;14184;14845;3.88;0.24;406.20;21.44;1414;60;5099.00;661
12772;43;620781019;12772;651;14188;14864;3.88;0.24;406.18;21.43;1416;60;5100.00;676
12774;43;620781042;12774;636;14188;14864;3.91;0.24;406.14;21.43;1414;60;5101.00;676
12775;43;620781059;12775;624;14189;14868;3.95;0.24;406.15;21.43;1414;60;5102.00;679
12779;43;620781076;12779;615;14189;14869;3.96;0.24;406.23;21.43;1410;60;5103.00;680
12783;43;620781094;12783;606;14189;14869;3.95;0.24;406.19;21.43;1406;60;5104.00;680
12785;43;620781111;12785;599;14191;14870;3.97;0.24;406.16;21.43;1406;60;5105.00;679
12790;43;620781131;12790;584;14193;14870;3.97;0.24;406.11;21.43;1403;60;5106.00;677
12791;43;620781155;12791;570;14193;14870;4.03;0.25;406.15;21.43;1402;60;5107.00;677
12796;43;620781172;12796;562;14193;14870;4.05;0.25;406.15;21.43;1397;60;5108.00;677
12799;43;620781189;12799;560;14193;14870;4.10;0.25;406.12;21.43;1394;60;5109.00;677
12802;43;620781206;12802;548;14193;14870;4.14;0.25;406.18;21.43;1391;60;5110.00;677
12804;43;620781223;12804;544;14194;14870;4.21;0.26;406.26;21.43;1390;60;5111.00;676
12808;43;620781241;12808;548;14224;14940;4.32;0.26;406.36;21.38;1416;60;5112.00;716
12809;43;620781264;12809;534;14227;14941;4.40;0.27;406.36;21.38;1418;60;5113.00;714
12815;43;620781280;12815;534;14231;14941;4.45;0.27;406.51;21.37;1416;60;5114.00;710
12820;43;620781296;12820;527;14234;14941;4.47;0.27;406.44;21.37;1414;60;5115.00;707
12824;43;620781313;12824;513;14235;14941;4.51;0.27;406.50;21.37;1411;60;5116.00;706
12828;43;620781329;12828;507;14238;14941;4.54;0.28;406.59;21.37;1410;60;5117.00;703
12829;43;620781345;12829;504;14242;14941;4.58;0.28;406.59;21.36;1413;60;5118.00;699
12832;43;620781361;12832;499;14242;14941;4.59;0.28;406.64;21.36;1410;60;5119.00;699
12838;43;620781377;12838;497;14243;14942;4.63;0.28;406.62;21.36;1405;60;5120.00;699
12838;43;620781394;12838;496;14243;14943;4.67;0.28;406.62;21.36;1405;60;5121.00;700
12843;43;620781410;12843;501;14246;14943;4.67;0.28;406.58;21.36;1403;60;5122.00;697
12847;43;620781426;12847;502;14247;14947;4.67;0.29;406.71;21.36;1400;60;5123.00;700
12849;43;620781443;12849;509;14250;14947;4.66;0.28;406.73;21.36;1401;60;5124.00;697
12854;43;620781466;12854;498;14250;14947;4.64;0.28;406.79;21.36;1396;60;5125.00;697
12859;43;620781495;12859;498;14250;14947;4.59;0.28;406.78;21.36;1391;60;5126.00;697
12867;43;620781521;12867;508;14254;14953;4.55;0.28;407.00;21.36;1387;60;5127.00;699
12870;43;620781545;12870;513;14256;14953;4.55;0.28;407.07;21.47;1386;60;5128.00;697
12873;43;620781569;12873;512;14256;14953;4.59;0.28;407.06;21.47;1383;60;5129.00;697
12878;43;620781592;12878;517;14262;14959;4.60;0.28;407.12;21.48;1384;60;5130.00;697
12883;43;620781612;12883;518;14263;14959;4.60;0.28;407.15;21.49;1380;60;5131.00;696
12886;43;620781630;12886;514;14263;14959;4.65;0.28;407.18;21.49;1377;60;5132.00;696
12889;43;620781648;12889;513;14266;14960;4.70;0.29;407.16;21.50;1377;60;5133.00;694
12893;43;620781666;12893;512;14268;14961;4.74;0.29;407.31;21.50;1375;60;5134.00;693
12895;43;620781695;12895;518;14271;14961;4.78;0.29;407.34;21.51;1376;60;5135.00;690
12897;43;620781717;12897;513;14282;14974;4.82;0.29;407.38;21.50;1385;60;5136.00;692
12899;43;620781737;12899;513;14285;14974;4.81;0.29;407.44;21.50;1386;60;5137.00;689
12902;43;620781754;12902;518;14289;14974;4.83;0.29;407.43;21.61;1387;60;5138.00;685
12903;43;620781780;12903;513;14291;14975;4.83;0.29;407.52;21.62;1388;60;5139.00;684
12904;43;620781823;12904;512;14294;14975;4.85;0.29;407.56;21.63;1390;60;5140.00;681
12907;43;620781862;12907;524;14299;14979;4.84;0.29;407.57;21.74;1392;60;5141.00;680
12908;43;620781885;12908;517;14302;14979;4.81;0.29;407.58;21.76;1394;60;5142.00;677
12909;43;620781906;12909;520;14306;14983;4.81;0.29;407.57;21.76;1397;60;5143.00;677
12911;43;620781927;12911;526;14307;14983;4.80;0.29;407.72;21.76;1396;60;5144.00;676
12914;43;620781952;12914;529;14308;14983;4.73;0.29;407.73;21.76;1394;60;5145.00;675
12915;43;620781982;12915;535;14308;14983;4.69;0.28;407.77;21.76;1393;60;5146.00;675
12920;43;620782008;12920;532;14311;14983;4.67;0.28;407.75;21.88;1391;60;5147.00;672
12923;43;620782032;12923;524;14319;14995;4.62;0.28;407.82;21.89;1396;60;5148.00;676
12927;43;620782059;12927;508;14323;14995;4.58;0.28;407.90;21.90;1396;60;5149.00;672
12929;43;620782084;12929;515;14324;14995;4.56;0.28;407.89;21.90;1395;60;5150.00;671
12931;43;620782110;12931;511;14324;14995;4.58;0.28;407.93;21.90;1393;60;5151.00;671
12935;43;620782132;12935;515;14326;14995;4.58;0.28;407.89;21.92;1391;60;5152.00;669
12936;43;620782159;12936;523;14327;14995;4.62;0.28;407.91;21.92;1391;60;5153.00;668
12940;43;620782181;12940;527;14328;14996;4.63;0.28;407.89;21.93;1388;60;5154.00;668
12941;43;620782204;12941;534;14331;14998;4.65;0.28;407.89;21.93;1390;60;5155.00;667
12942;43;620782234;12942;526;14336;15004;4.66;0.28;407.89;21.93;1394;60;5156.00;668
12945;43;620782256;12945;515;14336;15005;4.63;0.28;407.92;21.93;1391;60;5157.00;669
12947;43;620782277;12947;505;14336;15005;4.63;0.28;408.01;21.93;1389;60;5158.00;669
12949;43;620782299;12949;504;14338;15005;4.64;0.28;408.02;21.95;1389;60;5159.00;667
12950;43;620782326;12950;504;14344;15010;4.68;0.29;408.03;22.05;1394;60;5160.00;666
12953;43;620782355;12953;497;14346;15010;4.70;0.29;408.17;22.06;1393;60;5161.00;664
12953;43;620782379;12953;502;14347;15010;4.77;0.29;408.17;22.07;1394;60;5162.00;663
12957;43;620782399;12957;497;14348;15011;4.83;0.29;408.21;22.07;1391;60;5163.00;663
12963;43;620782421;12963;506;14352;15015;4.79;0.29;408.49;22.07;1389;60;5164.00;663
12965;43;620782444;12965;508;14352;15015;4.81;0.29;408.58;22.07;1387;60;5165.00;663
12969;43;620782473;12969;513;14354;15018;4.79;0.29;408.55;22.07;1385;61;5166.00;664
12974;43;620782511;12974;510;14354;15018;4.76;0.29;408.72;22.07;1380;61;5167.00;664
12977;43;620782530;12977;506;14356;15018;4.76;0.29;408.81;22.09;1379;61;5168.00;662
12979;43;620782549;12979;509;14356;15018;4.75;0.29;408.78;22.09;1377;61;5169.00;662
12981;43;620782569;12981;523;14360;15022;4.74;0.29;408.78;22.09;1379;61;5170.00;662
12981;43;620782588;12981;529;14361;15022;4.72;0.29;408.78;22.10;1380;61;5171.00;661
12982;43;620782607;12982;527;14362;15022;4.71;0.29;408.80;22.11;1380;61;5172.00;660
12984;43;620782625;12984;529;14364;15022;4.72;0.29;408.86;22.12;1380;61;5173.00;658
12987;43;620782643;12987;528;14364;15023;4.68;0.29;408.85;22.12;1377;61;5174.00;659
12990;43;620782661;12990;530;14365;15025;4.68;0.29;408.89;22.12;1375;61;5175.00;660
12992;43;620782681;12992;529;14366;15025;4.65;0.28;408.98;22.23;1374;61;5176.00;659
12995;43;620782698;12995;523;14370;15026;4.66;0.28;408.98;22.25;1375;61;5177.00;656
12997;43;620782717;12997;518;14370;15026;4.62;0.28;408.99;22.25;1373;61;5178.00;656
12999;43;620782736;12999;530;14372;15026;4.65;0.28;408.96;22.26;1373;61;5179.00;654
13001;43;620782754;13001;526;14372;15026;4.66;0.28;408.99;22.26;1371;61;5180.00;654
13004;43;620782771;13004;520;14373;15026;4.69;0.29;409.07;22.27;1369;61;5181.00;653
13008;43;620782790;13008;527;14375;15026;4.69;0.29;409.06;22.28;1367;61;5182.00;651
13009;43;620782810;13009;532;14377;15026;4.70;0.29;409.04;22.29;1368;61;5183.00;649
13010;43;620782830;13010;564;14446;15153;4.84;0.30;409.05;22.19;1436;61;5184.00;707
13012;43;620782867;13012;563;14446;15154;4.85;0.30;409.11;22.19;1434;61;5185.00;708
13017;43;620782896;13017;556;14451;15154;4.86;0.30;409.29;22.19;1434;61;5186.00;703
13022;43;620782914;13022;554;14452;15154;4.85;0.30;409.29;22.19;1430;61;5187.00;702
13023;43;620782938;13023;553;14456;15154;4.89;0.30;409.27;22.19;1433;61;5188.00;698
13025;43;620782956;13025;566;14457;15154;4.88;0.30;409.32;22.19;1432;61;5189.00;697
13029;43;620782977;13029;567;14463;15154;4.87;0.30;409.38;22.19;1434;61;5190.00;691
13029;43;620783005;13029;570;14464;15154;4.87;0.30;409.38;22.19;1435;61;5191.00;690
13031;43;620783031;13031;566;14468;15155;4.88;0.30;409.39;22.20;1437;61;5192.00;687
13033;43;620783055;13033;569;14471;15156;4.86;0.30;409.37;22.20;1438;61;5193.00;685
13036;43;620783079;13036;575;14474;15156;4.84;0.30;409.48;22.20;1438;61;5194.00;682
13038;43;620783100;13038;568;14477;15157;4.81;0.30;409.53;22.20;1439;61;5195.00;680
13041;43;620783121;13041;576;14479;15157;4.77;0.29;409.58;22.20;1438;61;5196.00;678
13043;43;620783142;13043;574;14484;15157;4.76;0.29;409.69;22.21;1441;61;5197.00;673
13049;43;620783161;13049;579;14485;15157;4.71;0.29;409.81;22.21;1436;61;5198.00;672
13052;43;620783180;13052;582;14487;15161;4.70;0.29;409.83;22.21;1435;61;5199.00;674
13055;43;620783205;13055;579;14488;15161;4.66;0.29;409.84;22.21;1433;61;5200.00;673
13058;43;620783230;13058;586;14488;15161;4.61;0.28;409.81;22.21;1430;61;5201.00;673
13058;43;620783250;13058;581;14490;15164;4.61;0.28;409.81;22.22;1432;61;5202.00;674
13061;43;620783270;13061;582;14490;15164;4.60;0.28;409.92;22.22;1429;61;5203.00;674
13062;43;620783289;13062;583;14490;15164;4.58;0.28;409.90;22.22;1428;61;5204.00;674
13063;43;620783307;13063;579;14497;15168;4.59;0.28;409.98;22.35;1434;61;5205.00;671
13065;43;620783333;13065;579;14499;15169;4.59;0.28;409.97;22.35;1434;61;5206.00;670
13069;43;620783351;13069;583;14499;15169;4.53;0.28;409.94;22.35;1430;61;5207.00;670
13073;43;620783371;13073;587;14500;15173;4.50;0.28;410.01;22.35;1427;62;5208.00;673
13077;43;620783397;13077;589;14502;15173;4.48;0.28;410.05;22.35;1425;62;5209.00;671
13081;43;620783415;13081;594;14504;15173;4.41;0.27;409.98;22.36;1423;62;5210.00;669
13082;43;620783434;13082;599;14504;15174;4.39;0.27;409.97;22.36;1422;62;5211.00;670
13085;43;620783453;13085;592;14505;15174;4.38;0.27;409.93;22.36;1420;62;5212.00;669
13086;43;620783481;13086;593;14508;15180;4.39;0.27;409.91;22.35;1422;62;5213.00;672
13090;43;620783507;13090;592;14509;15180;4.35;0.27;409.87;22.36;1419;62;5214.00;671
13092;43;620783544;13092;592;14510;15180;4.31;0.26;409.81;22.36;1418;62;5215.00;670
13097;43;620783573;13097;602;14510;15181;4.26;0.26;409.84;22.36;1413;62;5216.00;671
13098;43;620783606;13098;600;14512;15181;4.23;0.26;409.81;22.36;1414;62;5217.00;669
13100;43;620783629;13100;610;14512;15181;4.21;0.26;409.85;22.36;1412;62;5218.00;669
13100;43;620783651;13100;618;14514;15181;4.17;0.26;409.85;22.37;1414;62;5219.00;667
13103;43;620783675;13103;628;14536;15217;4.21;0.26;409.84;22.33;1433;62;5220.00;681
13105;43;620783700;13105;633;14538;15217;4.20;0.26;409.83;22.33;1433;62;5221.00;679
13108;43;620783721;13108;638;14539;15217;4.16;0.26;409.81;22.33;1431;62;5222.00;678
13111;43;620783741;13111;647;14541;15217;4.13;0.25;409.80;22.33;1430;62;5223.00;676
13116;43;620783761;13116;653;14542;15217;4.09;0.25;409.80;22.33;1426;62;5224.00;675
13117;43;620783782;13117;656;14542;15217;4.07;0.25;409.79;22.33;1425;62;5225.00;675
13120;43;620783801;13120;657;14547;15221;4.06;0.25;409.80;22.32;1427;62;5226.00;674
13122;43;620783823;13122;665;14547;15221;4.05;0.25;409.76;22.32;1425;62;5227.00;674
13122;43;620783853;13122;673;14550;15225;4.07;0.25;409.76;22.32;1428;62;5228.00;675
13124;43;620783874;13124;675;14550;15226;4.05;0.25;409.78;22.32;1426;62;5229.00;676
13126;43;620783895;13126;675;14550;15226;3.99;0.24;409.75;22.32;1424;62;5230.00;676
13128;43;620783916;13128;684;14550;15226;3.98;0.24;409.72;22.32;1422;62;5231.00;676
13132;43;620783942;13132;695;14560;15239;3.96;0.24;409.69;22.30;1428;62;5232.00;679
13135;43;620783964;13135;698;14561;15239;3.91;0.24;409.66;22.43;1426;62;5233.00;678
13136;43;620783987;13136;701;14561;15239;3.88;0.24;409.65;22.43;1425;62;5234.00;678
13137;43;620784009;13137;697;14562;15240;3.88;0.24;409.67;22.43;1425;62;5235.00;678
13138;43;620784031;13138;689;14562;15241;3.87;0.24;409.68;22.43;1424;62;5236.00;679
13138;43;620784052;13138;678;14562;15241;3.88;0.24;409.68;22.43;1424;62;5237.00;679
13138;43;620784075;13138;677;14563;15244;3.92;0.24;409.68;22.43;1425;62;5238.00;681
13138;43;620784094;13138;678;14563;15244;3.92;0.24;409.68;22.43;1425;62;5239.00;681
13139;43;620784116;13139;672;14563;15244;3.94;0.24;409.68;22.43;1424;62;5240.00;681
13142;43;620784137;13142;670;14563;15244;3.95;0.24;409.65;22.43;1421;62;5241.00;681
13144;43;620784165;13144;670;14567;15250;3.98;0.24;409.72;22.42;1423;62;5242.00;683
13146;43;620784186;13146;674;14567;15250;3.98;0.24;409.73;22.42;1421;62;5243.00;683
13147;43;620784205;13147;672;14567;15250;3.98;0.24;409.70;22.42;1420;62;5244.00;683
13148;43;620784227;13148;672;14567;15250;3.96;0.24;409.69;22.42;1419;62;5245.00;683
13150;43;620784251;13150;670;14570;15254;3.95;0.24;409.70;22.42;1420;62;5246.00;684
13153;43;620784275;13153;668;14570;15255;3.92;0.24;409.65;22.42;1417;62;5247.00;685
13154;43;620784304;13154;669;14570;15255;3.90;0.24;409.63;22.42;1416;62;5248.00;685
13156;43;620784322;13156;664;14571;15256;3.91;0.24;409.64;22.42;1415;62;5249.00;685
13158;43;620784346;13158;656;14571;15256;3.92;0.24;409.60;22.42;1413;62;5250.00;685
13159;43;620784368;13159;652;14571;15256;3.91;0.24;409.60;22.42;1412;62;5251.00;685
13160;43;620784394;13160;652;14571;15256;3.91;0.24;409.63;22.42;1411;62;5252.00;685
13161;43;620784416;13161;641;14571;15256;3.93;0.24;409.60;22.42;1410;62;5253.00;685
13162;43;620784438;13162;641;14571;15256;3.96;0.24;409.59;22.42;1409;62;5254.00;685
13162;43;620784461;13162;639;14571;15256;3.99;0.24;409.59;22.42;1409;62;5255.00;685
13164;43;620784484;13164;640;14596;15326;4.20;0.26;409.60;22.38;1432;62;5256.00;730
13166;43;620784521;13166;634;14596;15327;4.25;0.26;409.61;22.38;1430;62;5257.00;731
13169;43;620784548;13169;628;14603;15327;4.34;0.26;409.53;22.37;1434;62;5258.00;724
13170;43;620784569;13170;619;14609;15327;4.41;0.27;409.52;22.36;1439;62;5259.00;718
13172;43;620784586;13172;619;14613;15327;4.42;0.27;409.54;22.36;1441;62;5260.00;714
13175;43;620784604;13175;608;14615;15327;4.38;0.27;409.53;22.35;1440;62;5261.00;712
13178;43;620784629;13178;600;14617;15327;4.35;0.27;409.71;22.35;1439;62;5262.00;710
13181;43;620784649;13181;598;14619;15327;4.31;0.26;409.71;22.35;1438;62;5263.00;708
13183;43;620784670;13183;592;14619;15328;4.29;0.26;409.68;22.35;1436;62;5264.00;709
13186;43;620784689;13186;595;14621;15330;4.25;0.26;409.73;22.35;1435;62;5265.00;709
13192;43;620784707;13192;599;14623;15330;4.20;0.26;409.88;22.35;1431;62;5266.00;707
13196;43;620784734;13196;604;14627;15334;4.14;0.25;409.87;22.34;1431;62;5267.00;707
13200;43;620784764;13200;607;14627;15334;4.11;0.25;409.92;22.34;1427;62;5268.00;707
13202;43;620784780;13202;609;14627;15334;4.11;0.25;409.93;22.34;1425;62;5269.00;707
13205;43;620784804;13205;600;14627;15334;4.10;0.25;409.93;22.34;1422;62;5270.00;707
13210;43;620784826;13210;591;14630;15340;4.12;0.25;410.23;22.34;1420;62;5271.00;710
13213;43;620784843;13213;583;14630;15340;4.14;0.25;410.35;22.34;1417;62;5272.00;710
13216;43;620784861;13216;578;14630;15340;4.11;0.25;410.32;22.34;1414;62;5273.00;710
13219;43;620784879;13219;572;14631;15343;4.11;0.25;410.37;22.33;1412;62;5274.00;712
13223;43;620784898;13223;565;14631;15343;4.12;0.25;410.44;22.33;1408;62;5275.00;712
13227;43;620784918;13227;561;14631;15343;4.09;0.25;410.48;22.33;1404;62;5276.00;712
13228;43;620784935;13228;556;14631;15344;4.14;0.25;410.45;22.33;1403;62;5277.00;713
13230;43;620784956;13230;551;14632;15345;4.18;0.25;410.43;22.33;1402;62;5278.00;713
13232;43;620784976;13232;544;14632;15345;4.19;0.25;410.45;22.33;1400;62;5279.00;713
13234;43;620784998;13234;532;14646;15371;4.27;0.26;410.49;22.31;1412;62;5280.00;725
13236;43;620785021;13236;519;14646;15371;4.33;0.26;410.45;22.31;1410;62;5281.00;725
13239;43;620785038;13239;499;14648;15371;4.39;0.27;410.55;22.31;1409;62;5282.00;723
13242;43;620785056;13242;489;14649;15372;4.48;0.27;410.55;22.31;1407;62;5283.00;723
13249;43;620785076;13249;480;14650;15372;4.54;0.28;410.56;22.31;1401;62;5284.00;722
13253;43;620785096;13253;468;14653;15376;4.62;0.28;410.61;22.30;1400;62;5285.00;723
13257;43;620785123;13257;460;14653;15376;4.69;0.28;410.67;22.30;1396;62;5286.00;723
13262;43;620785146;13262;449;14655;15379;4.73;0.29;410.75;22.30;1393;62;5287.00;724
13264;43;620785171;13264;453;14656;15380;4.77;0.29;410.84;22.30;1392;62;5288.00;724
13266;43;620785192;13266;458;14656;15380;4.81;0.29;410.88;22.30;1390;62;5289.00;724
13269;43;620785213;13269;451;14656;15380;4.85;0.29;411.01;22.30;1387;62;5290.00;724
13274;43;620785233;13274;444;14657;15380;4.91;0.30;411.12;22.30;1383;62;5291.00;723
13276;43;620785253;13276;451;14664;15392;4.98;0.30;411.11;22.29;1388;62;5292.00;728
13280;43;620785274;13280;445;14664;15392;4.99;0.30;411.19;22.29;1384;62;5293.00;728
13284;43;620785295;13284;441;14664;15392;4.99;0.30;411.29;22.29;1380;62;5294.00;728
13288;43;620785317;13288;439;14664;15392;5.00;0.31;411.27;22.29;1376;62;5295.00;728
13296;43;620785338;13296;438;14664;15392;4.95;0.30;411.41;22.29;1368;62;5296.00;728
13300;43;620785362;13300;432;14665;15392;4.95;0.30;411.52;22.29;1365;62;5297.00;727
13305;43;620785386;13305;439;14665;15393;4.94;0.30;411.52;22.29;1360;62;5298.00;728
13309;43;620785404;13309;446;14665;15393;4.90;0.30;411.50;22.29;1356;62;5299.00;728
13314;43;620785422;13314;443;14670;15399;4.90;0.30;411.54;22.30;1356;62;5300.00;729
13316;43;620785443;13316;449;14671;15400;4.90;0.30;411.53;22.30;1355;62;5301.00;729
13318;43;620785463;13318;455;14672;15400;4.89;0.30;411.54;22.31;1354;62;5302.00;728
13319;43;620785489;13319;452;14672;15400;4.90;0.30;411.61;22.31;1353;62;5303.00;728
13326;43;620785514;13326;447;14677;15404;4.90;0.30;411.80;22.31;1351;62;5304.00;727
13327;43;620785541;13327;443;14678;15404;4.96;0.30;411.81;22.32;1351;62;5305.00;726
13332;43;620785565;13332;447;14680;15404;4.98;0.30;411.90;22.33;1348;62;5306.00;724
13336;43;620785589;13336;449;14683;15405;5.00;0.30;412.13;22.44;1347;62;5307.00;722
13342;43;620785612;13342;451;14688;15409;5.03;0.31;412.26;22.45;1346;62;5308.00;721
13346;43;620785634;13346;439;14688;15409;5.04;0.31;412.27;22.45;1342;62;5309.00;721
13350;43;620785658;13350;435;14694;15415;4.97;0.30;412.30;22.46;1344;62;5310.00;721
13354;43;620785679;13354;435;14695;15415;4.92;0.30;412.33;22.46;1341;62;5311.00;720
13357;43;620785698;13357;433;14696;15415;4.85;0.30;412.32;22.47;1339;62;5312.00;719
13359;43;620785718;13359;448;14699;15415;4.77;0.29;412.34;22.48;1340;62;5313.00;716
13363;43;620785738;13363;441;14702;15419;4.71;0.29;412.43;22.48;1339;62;5314.00;717
13369;43;620785758;13369;452;14703;15419;4.62;0.28;412.46;22.49;1334;62;5315.00;716
13375;43;620785779;13375;456;14705;15419;4.55;0.28;412.46;22.49;1330;62;5316.00;714
13379;43;620785808;13379;446;14706;15419;4.53;0.28;412.43;22.50;1327;62;5317.00;713
13386;43;620785829;13386;441;14708;15420;4.49;0.27;412.51;22.50;1322;62;5318.00;712
13389;43;620785849;13389;443;14710;15421;4.49;0.27;412.52;22.52;1321;62;5319.00;711
13390;43;620785868;13390;450;14710;15421;4.49;0.27;412.55;22.52;1320;62;5320.00;711
13393;43;620785888;13393;452;14712;15422;4.51;0.27;412.60;22.52;1319;62;5321.00;710
13395;43;620785908;13395;459;14714;15422;4.51;0.27;412.59;22.65;1319;62;5322.00;708
13395;43;620785929;13395;453;14715;15422;4.55;0.28;412.59;22.65;1320;62;5323.00;707
13398;43;620785948;13398;465;14715;15422;4.54;0.28;412.61;22.65;1317;62;5324.00;707
13400;43;620785969;13400;470;14715;15422;4.54;0.28;412.59;22.65;1315;62;5325.00;707
13403;43;620785989;13403;469;14718;15422;4.55;0.28;412.63;22.78;1315;62;5326.00;704
13406;43;620786009;13406;471;14718;15422;4.58;0.28;412.64;22.78;1312;62;5327.00;704
13408;43;620786027;13408;482;14791;15549;4.66;0.29;412.62;22.67;1383;62;5328.00;758
13410;43;620786058;13410;476;14793;15550;4.70;0.29;412.61;22.69;1383;62;5329.00;757
13413;43;620786078;13413;470;14796;15550;4.75;0.29;412.71;22.68;1383;62;5330.00;754
13414;43;620786117;13414;464;14798;15550;4.89;0.30;412.74;22.68;1384;62;5331.00;752
13419;43;620786137;13419;467;14800;15550;4.97;0.31;412.75;22.68;1381;62;5332.00;750
13420;43;620786160;13420;476;14805;15550;5.05;0.31;412.77;22.69;1385;62;5333.00;745
13421;43;620786181;13421;476;14806;15550;5.11;0.32;412.80;22.69;1385;62;5334.00;744
13425;43;620786203;13425;487;14810;15550;5.12;0.32;412.89;22.69;1385;62;5335.00;740
13426;43;620786224;13426;494;14813;15551;5.09;0.31;412.89;22.70;1387;62;5336.00;738
13427;43;620786243;13427;487;14816;15552;5.07;0.31;412.92;22.71;1389;62;5337.00;736
13429;43;620786264;13429;482;14818;15552;5.07;0.31;412.98;22.70;1389;62;5338.00;734
13432;43;620786285;13432;493;14821;15553;5.03;0.31;413.02;22.72;1389;62;5339.00;732
13438;43;620786310;13438;495;14824;15553;4.95;0.31;413.07;22.73;1386;62;5340.00;729
13440;43;620786330;13440;491;14827;15553;4.94;0.31;413.13;22.85;1387;62;5341.00;726
13443;43;620786352;13443;492;14828;15553;4.95;0.31;413.14;22.86;1385;62;5342.00;725
13448;43;620786373;13448;496;14832;15557;4.93;0.30;413.10;22.86;1384;62;5343.00;725
13454;43;620786394;13454;497;14832;15557;4.89;0.30;413.22;22.86;1378;62;5344.00;725
13455;43;620786417;13455;501;14833;15557;4.91;0.30;413.20;22.86;1378;62;5345.00;724
13458;43;620786437;13458;497;14836;15560;4.92;0.30;413.21;22.87;1378;62;5346.00;724
13460;43;620786467;13460;500;14837;15560;4.90;0.30;413.25;22.88;1377;62;5347.00;723
13461;43;620786489;13461;500;14839;15560;4.86;0.30;413.27;22.89;1378;62;5348.00;721
13465;43;620786511;13465;502;14843;15564;4.82;0.30;413.33;22.89;1378;62;5349.00;721
13469;43;620786529;13469;515;14844;15565;4.82;0.29;413.40;22.89;1375;62;5350.00;721
13475;43;620786548;13475;521;14846;15565;4.77;0.29;413.58;22.90;1371;62;5351.00;719
13478;43;620786567;13478;533;14849;15569;4.76;0.29;413.61;22.90;1371;62;5352.00;720
13481;43;620786586;13481;545;14851;15569;4.77;0.29;413.70;22.91;1370;62;5353.00;718
13484;43;620786604;13484;553;14851;15569;4.78;0.29;413.84;22.91;1367;62;5354.00;718
13486;43;620786623;13486;548;14854;15571;4.78;0.29;413.84;22.91;1368;62;5355.00;717
13490;43;620786642;13490;556;14854;15571;4.78;0.29;413.95;22.91;1364;62;5356.00;717
13494;43;620786660;13494;563;14860;15577;4.74;0.29;413.99;22.92;1366;62;5357.00;717
13495;43;620786679;13495;574;14860;15577;4.72;0.29;413.98;22.92;1365;62;5358.00;717
13496;43;620786698;13496;582;14862;15577;4.68;0.28;413.99;22.93;1366;62;5359.00;715
13500;43;620786718;13500;574;14862;15578;4.64;0.28;414.06;22.93;1362;62;5360.00;716
13502;43;620786736;13502;569;14864;15578;4.64;0.28;414.05;23.05;1362;62;5361.00;714
13506;43;620786754;13506;570;14865;15578;4.64;0.28;414.01;23.06;1359;62;5362.00;713
13507;43;620786773;13507;572;14865;15578;4.63;0.28;414.00;23.06;1358;62;5363.00;713
13508;43;620786791;13508;570;14874;15590;4.63;0.28;413.98;23.04;1366;62;5364.00;716
13511;43;620786810;13511;561;14875;15590;4.65;0.28;413.95;23.05;1364;62;5365.00;715
13512;43;620786829;13512;563;14876;15590;4.68;0.29;413.94;23.05;1364;62;5366.00;714
13516;43;620786847;13516;566;14878;15590;4.65;0.28;413.86;23.06;1362;62;5367.00;712
13518;43;620786866;13518;559;14878;15590;4.64;0.28;413.91;23.06;1360;62;5368.00;712
13522;43;620786883;13522;565;14880;15590;4.63;0.28;413.95;23.07;1358;62;5369.00;710
13524;43;620786903;13524;560;14883;15594;4.60;0.28;413.99;23.06;1359;62;5370.00;711
13528;44;620786921;13528;557;14884;15594;4.57;0.28;413.95;23.07;1356;63;5371.00;710
13530;44;620786947;13530;556;14888;15598;4.57;0.28;413.91;23.07;1358;63;5372.00;710
13531;44;620786965;13531;553;14889;15599;4.59;0.28;413.90;23.07;1358;63;5373.00;710
13536;44;620786982;13536;551;14890;15599;4.56;0.28;413.91;23.07;1354;63;5374.00;709
13537;44;620787004;13537;548;14891;15599;4.55;0.28;413.92;23.21;1354;63;5375.00;708
13542;44;620787030;13542;550;14903;15612;4.55;0.28;413.88;23.34;1361;63;5376.00;709
13544;44;620787050;13544;549;14903;15612;4.58;0.28;413.86;23.34;1359;63;5377.00;709
13549;44;620787067;13549;551;14904;15612;4.57;0.28;413.80;23.34;1355;63;5378.00;708
13549;44;620787083;13549;559;14907;15613;4.63;0.28;413.80;23.34;1358;63;5379.00;706
13554;44;620787098;13554;564;14908;15614;4.65;0.28;413.73;23.34;1354;63;5380.00;706
13558;44;620787115;13558;564;14908;15614;4.62;0.28;413.70;23.34;1350;63;5381.00;706
13559;44;620787130;13559;569;14909;15617;4.65;0.28;413.68;23.34;1350;63;5382.00;708
13563;44;620787150;13563;569;14910;15617;4.60;0.28;413.63;23.34;1347;63;5383.00;707
13563;44;620787166;13563;569;14911;15617;4.61;0.28;413.63;23.35;1348;63;5384.00;706
13564;44;620787185;13564;580;14911;15617;4.61;0.28;413.62;23.35;1347;63;5385.00;706
13564;44;620787201;13564;584;14915;15623;4.60;0.28;413.62;23.34;1351;63;5386.00;708
13565;44;620787216;13565;574;14916;15623;4.58;0.28;413.68;23.34;1351;63;5387.00;707
13566;44;620787232;13566;572;14916;15623;4.59;0.28;413.67;23.34;1350;63;5388.00;707
13570;44;620787248;13570;569;14917;15623;4.61;0.28;413.74;23.35;1347;63;5389.00;706
13572;44;620787263;13572;565;14921;15627;4.58;0.28;413.76;23.34;1349;63;5390.00;706
13573;44;620787279;13573;564;14921;15628;4.56;0.28;413.78;23.34;1348;63;5391.00;707
13574;44;620787295;13574;562;14922;15628;4.55;0.28;413.80;23.35;1348;63;5392.00;706
13575;44;620787311;13575;560;14923;15629;4.52;0.28;413.77;23.34;1348;63;5393.00;706
13577;44;620787332;13577;556;14924;15629;4.51;0.28;413.72;23.35;1347;63;5394.00;705
13578;44;620787348;13578;551;14924;15629;4.54;0.28;413.74;23.35;1346;63;5395.00;705
13582;44;620787365;13582;553;14925;15629;4.56;0.28;413.73;23.35;1343;63;5396.00;704
13583;44;620787381;13583;551;14925;15629;4.59;0.28;413.71;23.35;1342;63;5397.00;704
13586;44;620787397;13586;551;14926;15629;4.63;0.28;413.72;23.35;1340;63;5398.00;703
13587;44;620787412;13587;552;14926;15629;4.66;0.29;413.76;23.35;1339;63;5399.00;703
